team,n,rank,w,d,l,gf,ga,gd,pts
SC Rheindorf,0,1,20,11,5,56,37,19,71
FC Salzburg,0,2,17,10,9,59,30,29,61
Vienna,0,3,18,4,14,64,57,7,58
SK Sturm Gra,0,4,16,5,15,51,42,9,53
Rapid Vienna,0,5,14,9,13,53,44,9,51
Admira Wacke,0,6,15,5,16,38,51,-13,50
RZ Pellets W,0,7,14,5,17,47,58,-11,47
St. Pölten,0,8,11,7,18,41,61,-20,40
Mattersburg,0,9,10,8,18,46,55,-9,38
SV Josko Rie,0,10,9,8,19,40,60,-20,35
FC Salzburg,1,1,22,6,8,73,33,40,72
Vienna,1,2,21,4,11,69,47,22,67
SK Sturm Gra,1,3,19,7,10,56,34,22,64
SC Rheindorf,1,4,19,7,10,52,47,5,64
Rapid Vienna,1,5,15,10,11,60,39,21,55
RZ Pellets W,1,6,13,7,16,54,60,-6,46
SV Josko Rie,1,7,13,2,21,45,54,-9,41
Mattersburg,1,8,9,7,20,38,65,-27,34
Admira Wacke,1,9,10,4,22,38,74,-36,34
St. Pölten,1,10,7,10,19,37,69,-32,31
FC Salzburg,2,1,21,8,7,69,32,37,71
SK Sturm Gra,2,2,21,6,9,62,33,29,69
Vienna,2,3,21,4,11,65,46,19,67
SC Rheindorf,2,4,17,7,12,53,42,11,58
Rapid Vienna,2,5,15,8,13,55,39,16,53
Mattersburg,2,6,11,8,17,40,55,-15,41
SV Josko Rie,2,7,11,6,19,33,58,-25,39
Admira Wacke,2,8,10,7,19,35,61,-26,37
St. Pölten,2,9,9,8,19,38,60,-22,35
RZ Pellets W,2,10,9,8,19,39,63,-24,35
SC Rheindorf,3,1,20,8,8,64,43,21,68
Vienna,3,2,21,4,11,69,50,19,67
FC Salzburg,3,3,19,8,9,68,37,31,65
SK Sturm Gra,3,4,19,7,10,61,31,30,64
Rapid Vienna,3,5,14,11,11,56,41,15,53
St. Pölten,3,6,10,10,16,45,63,-18,40
Admira Wacke,3,7,11,7,18,37,61,-24,40
SV Josko Rie,3,8,10,6,20,30,57,-27,36
RZ Pellets W,3,9,10,5,21,39,60,-21,35
Mattersburg,3,10,7,12,17,40,66,-26,33
FC Salzburg,4,1,22,5,9,64,36,28,71
SC Rheindorf,4,2,21,6,9,61,39,22,69
SK Sturm Gra,4,3,20,7,9,57,31,26,67
Vienna,4,4,20,4,12,67,50,17,64
Rapid Vienna,4,5,15,10,11,64,38,26,55
RZ Pellets W,4,6,11,9,16,46,58,-12,42
Admira Wacke,4,7,11,5,20,34,61,-27,38
St. Pölten,4,8,9,8,19,41,71,-30,35
SV Josko Rie,4,9,9,7,20,31,55,-24,34
Mattersburg,4,10,8,7,21,34,60,-26,31
SC Rheindorf,5,1,20,9,7,65,46,19,69
FC Salzburg,5,2,19,8,9,60,31,29,65
RZ Pellets W,5,3,19,5,12,67,51,16,62
Vienna,5,4,18,6,12,66,53,13,60
SK Sturm Gra,5,5,16,7,13,49,33,16,55
Rapid Vienna,5,6,11,15,10,62,45,17,48
Admira Wacke,5,7,10,7,19,34,64,-30,37
SV Josko Rie,5,8,9,8,19,36,56,-20,35
Mattersburg,5,9,8,9,19,37,65,-28,33
St. Pölten,5,10,7,12,17,36,68,-32,33
SC Rheindorf,6,1,22,9,5,66,38,28,75
FC Salzburg,6,2,19,9,8,61,31,30,66
Vienna,6,3,19,6,11,72,54,18,63
SK Sturm Gra,6,4,16,12,8,58,33,25,60
Rapid Vienna,6,5,13,13,10,57,43,14,52
RZ Pellets W,6,6,13,8,15,48,58,-10,47
St. Pölten,6,7,7,13,16,42,58,-16,34
Admira Wacke,6,8,8,10,18,32,65,-33,34
Mattersburg,6,9,6,12,18,35,57,-22,30
SV Josko Rie,6,10,8,6,22,32,66,-34,30
FC Salzburg,7,1,20,10,6,66,31,35,70
SK Sturm Gra,7,2,18,7,11,62,39,23,61
SC Rheindorf,7,3,18,6,12,55,58,-3,60
Rapid Vienna,7,4,15,11,10,62,45,17,56
Vienna,7,5,17,5,14,60,58,2,56
RZ Pellets W,7,6,15,7,14,51,48,3,52
SV Josko Rie,7,7,11,6,19,36,54,-18,39
St. Pölten,7,8,10,8,18,42,61,-19,38
Admira Wacke,7,9,9,10,17,39,60,-21,37
Mattersburg,7,10,7,10,19,40,59,-19,31
FC Salzburg,8,1,23,7,6,76,35,41,76
SC Rheindorf,8,2,18,11,7,57,44,13,65
SK Sturm Gra,8,3,19,4,13,61,34,27,61
Vienna,8,4,17,7,12,55,48,7,58
Rapid Vienna,8,5,14,9,13,55,43,12,51
RZ Pellets W,8,6,12,7,17,46,58,-12,43
Admira Wacke,8,7,11,8,17,44,69,-25,41
St. Pölten,8,8,9,11,16,41,58,-17,38
SV Josko Rie,8,9,10,6,20,34,52,-18,36
Mattersburg,8,10,8,8,20,39,67,-28,32
FC Salzburg,9,1,20,12,4,72,35,37,72
Vienna,9,2,21,6,9,79,51,28,69
SC Rheindorf,9,3,18,8,10,54,42,12,62
SK Sturm Gra,9,4,16,8,12,58,38,20,56
Rapid Vienna,9,5,13,13,10,53,40,13,52
RZ Pellets W,9,6,12,9,15,43,58,-15,45
Mattersburg,9,7,9,11,16,39,50,-11,38
Admira Wacke,9,8,10,8,18,30,58,-28,38
SV Josko Rie,9,9,8,7,21,31,56,-25,31
St. Pölten,9,10,7,10,19,40,71,-31,31
FC Salzburg,10,1,21,7,8,64,33,31,70
Vienna,10,2,19,7,10,61,49,12,64
SK Sturm Gra,10,3,18,8,10,62,36,26,62
SC Rheindorf,10,4,18,8,10,55,43,12,62
Rapid Vienna,10,5,14,11,11,61,47,14,53
Admira Wacke,10,6,15,6,15,44,53,-9,51
RZ Pellets W,10,7,11,10,15,52,57,-5,43
Mattersburg,10,8,9,8,19,37,60,-23,35
SV Josko Rie,10,9,10,4,22,30,57,-27,34
St. Pölten,10,10,7,7,22,34,65,-31,28
FC Salzburg,11,1,19,9,8,64,32,32,66
Vienna,11,2,19,8,9,61,44,17,65
SC Rheindorf,11,3,19,7,10,54,45,9,64
SK Sturm Gra,11,4,16,9,11,54,32,22,57
RZ Pellets W,11,5,14,7,15,49,58,-9,49
Admira Wacke,11,6,14,7,15,36,51,-15,49
Rapid Vienna,11,7,12,11,13,53,44,9,47
Mattersburg,11,8,9,8,19,43,60,-17,35
SV Josko Rie,11,9,10,5,21,31,51,-20,35
St. Pölten,11,10,8,9,19,35,63,-28,33
FC Salzburg,12,1,20,8,8,69,38,31,68
SC Rheindorf,12,2,19,7,10,62,44,18,64
SK Sturm Gra,12,3,18,8,10,58,34,24,62
Vienna,12,4,16,7,13,55,57,-2,55
Admira Wacke,12,5,15,4,17,43,53,-10,49
Rapid Vienna,12,6,12,11,13,51,48,3,47
RZ Pellets W,12,7,12,8,16,47,59,-12,44
St. Pölten,12,8,10,11,15,46,63,-17,41
Mattersburg,12,9,11,7,18,41,49,-8,40
SV Josko Rie,12,10,9,5,22,27,54,-27,32
FC Salzburg,13,1,23,6,7,67,31,36,75
SK Sturm Gra,13,2,19,8,9,58,34,24,65
SC Rheindorf,13,3,17,9,10,50,40,10,60
Rapid Vienna,13,4,13,13,10,56,39,17,52
Vienna,13,5,15,5,16,58,61,-3,50
St. Pölten,13,6,13,8,15,43,52,-9,47
RZ Pellets W,13,7,11,9,16,46,56,-10,42
Admira Wacke,13,8,11,7,18,38,62,-24,40
SV Josko Rie,13,9,10,6,20,40,63,-23,36
Mattersburg,13,10,8,9,19,43,61,-18,33
FC Salzburg,14,1,21,8,7,68,34,34,71
SC Rheindorf,14,2,21,8,7,65,38,27,71
SK Sturm Gra,14,3,19,6,11,62,41,21,63
Vienna,14,4,15,6,15,59,58,1,51
Rapid Vienna,14,5,13,10,13,54,41,13,49
SV Josko Rie,14,6,14,7,15,42,49,-7,49
RZ Pellets W,14,7,13,6,17,44,57,-13,45
Admira Wacke,14,8,10,7,19,38,67,-29,37
St. Pölten,14,9,7,13,16,45,69,-24,34
Mattersburg,14,10,6,11,19,33,56,-23,29
FC Salzburg,15,1,25,6,5,72,32,40,81
SK Sturm Gra,15,2,22,7,7,73,32,41,73
SC Rheindorf,15,3,21,5,10,62,45,17,68
Vienna,15,4,17,8,11,59,47,12,59
Rapid Vienna,15,5,15,10,11,53,42,11,55
RZ Pellets W,15,6,10,13,13,48,57,-9,43
Admira Wacke,15,7,9,9,18,36,61,-25,36
SV Josko Rie,15,8,9,6,21,29,56,-27,33
St. Pölten,15,9,6,9,21,38,67,-29,27
Mattersburg,15,10,5,9,22,34,65,-31,24
FC Salzburg,16,1,23,7,6,74,33,41,76
SC Rheindorf,16,2,21,6,9,58,44,14,69
SK Sturm Gra,16,3,17,9,10,50,28,22,60
Rapid Vienna,16,4,16,9,11,52,33,19,57
Vienna,16,5,17,5,14,68,62,6,56
RZ Pellets W,16,6,11,11,14,41,54,-13,44
Admira Wacke,16,7,12,5,19,36,55,-19,41
SV Josko Rie,16,8,11,3,22,34,56,-22,36
St. Pölten,16,9,8,9,19,44,69,-25,33
Mattersburg,16,10,8,8,20,38,61,-23,32
SC Rheindorf,17,1,20,7,9,51,36,15,67
FC Salzburg,17,2,20,5,11,64,40,24,65
Vienna,17,3,19,4,13,61,48,13,61
Rapid Vienna,17,4,15,10,11,60,42,18,55
SK Sturm Gra,17,5,17,4,15,55,44,11,55
RZ Pellets W,17,6,14,4,18,45,57,-12,46
St. Pölten,17,7,12,9,15,49,56,-7,45
Admira Wacke,17,8,12,5,19,40,60,-20,41
SV Josko Rie,17,9,11,5,20,34,56,-22,38
Mattersburg,17,10,9,9,18,36,56,-20,36
SC Rheindorf,18,1,23,6,7,59,38,21,75
FC Salzburg,18,2,20,6,10,73,37,36,66
SK Sturm Gra,18,3,20,5,11,58,34,24,65
Vienna,18,4,16,7,13,56,52,4,55
Rapid Vienna,18,5,12,12,12,60,41,19,48
RZ Pellets W,18,6,13,5,18,45,58,-13,44
SV Josko Rie,18,7,14,2,20,37,56,-19,44
Admira Wacke,18,8,12,6,18,37,61,-24,42
Mattersburg,18,9,11,7,18,41,54,-13,40
St. Pölten,18,10,7,8,21,42,77,-35,29
Vienna,19,1,23,4,9,66,44,22,73
FC Salzburg,19,2,20,8,8,63,32,31,68
SK Sturm Gra,19,3,19,7,10,58,33,25,64
SC Rheindorf,19,4,19,7,10,48,38,10,64
Rapid Vienna,19,5,13,13,10,53,40,13,52
Mattersburg,19,6,11,10,15,36,41,-5,43
Admira Wacke,19,7,11,6,19,35,57,-22,39
RZ Pellets W,19,8,10,7,19,42,63,-21,37
SV Josko Rie,19,9,10,4,22,33,58,-25,34
St. Pölten,19,10,6,10,20,38,66,-28,28
SC Rheindorf,20,1,21,9,6,68,40,28,72
FC Salzburg,20,2,17,9,10,54,29,25,60
Rapid Vienna,20,3,16,10,10,59,38,21,58
Vienna,20,4,17,7,12,60,50,10,58
SK Sturm Gra,20,5,16,8,12,47,33,14,56
RZ Pellets W,20,6,13,7,16,38,45,-7,46
Admira Wacke,20,7,13,5,18,36,56,-20,44
Mattersburg,20,8,11,6,19,40,63,-23,39
SV Josko Rie,20,9,10,7,19,34,56,-22,37
St. Pölten,20,10,7,10,19,39,65,-26,31
FC Salzburg,21,1,19,7,10,58,31,27,64
SK Sturm Gra,21,2,19,7,10,59,35,24,64
Vienna,21,3,18,6,12,67,51,16,60
SC Rheindorf,21,4,16,11,9,50,39,11,59
Rapid Vienna,21,5,16,9,11,58,34,24,57
Admira Wacke,21,6,13,8,15,34,51,-17,47
RZ Pellets W,21,7,11,7,18,38,53,-15,40
SV Josko Rie,21,8,11,7,18,31,47,-16,40
St. Pölten,21,9,9,11,16,46,65,-19,38
Mattersburg,21,10,7,9,20,30,65,-35,30
SK Sturm Gra,22,1,20,6,10,57,33,24,66
FC Salzburg,22,2,19,7,10,62,33,29,64
SC Rheindorf,22,3,18,9,9,45,41,4,63
Vienna,22,4,18,6,12,64,48,16,60
Rapid Vienna,22,5,15,12,9,56,39,17,57
RZ Pellets W,22,6,12,7,17,47,56,-9,43
SV Josko Rie,22,7,10,9,17,38,58,-20,39
Admira Wacke,22,8,11,6,19,32,60,-28,39
Mattersburg,22,9,9,7,20,45,61,-16,34
St. Pölten,22,10,7,13,16,37,54,-17,34
FC Salzburg,23,1,21,8,7,69,33,36,71
SC Rheindorf,23,2,18,10,8,56,41,15,64
SK Sturm Gra,23,3,18,9,9,56,33,23,63
Rapid Vienna,23,4,17,9,10,62,42,20,60
Vienna,23,5,16,6,14,59,58,1,54
RZ Pellets W,23,6,13,7,16,44,50,-6,46
Admira Wacke,23,7,11,8,17,36,59,-23,41
Mattersburg,23,8,10,8,18,45,59,-14,38
SV Josko Rie,23,9,10,4,22,35,60,-25,34
St. Pölten,23,10,5,13,18,37,64,-27,28
FC Salzburg,24,1,20,8,8,61,32,29,68
SC Rheindorf,24,2,20,7,9,57,41,16,67
SK Sturm Gra,24,3,20,5,11,60,34,26,65
Rapid Vienna,24,4,15,9,12,50,34,16,54
Vienna,24,5,16,5,15,58,56,2,53
RZ Pellets W,24,6,14,8,14,46,52,-6,50
St. Pölten,24,7,12,8,16,54,66,-12,44
Admira Wacke,24,8,12,6,18,42,64,-22,42
SV Josko Rie,24,9,11,3,22,37,60,-23,36
Mattersburg,24,10,7,7,22,35,61,-26,28
SC Rheindorf,25,1,20,10,6,53,36,17,70
FC Salzburg,25,2,20,9,7,67,26,41,69
SK Sturm Gra,25,3,19,8,9,61,33,28,65
Rapid Vienna,25,4,15,10,11,55,36,19,55
Vienna,25,5,15,8,13,57,55,2,53
RZ Pellets W,25,6,11,12,13,45,53,-8,45
SV Josko Rie,25,7,10,8,18,32,49,-17,38
Admira Wacke,25,8,10,7,19,37,66,-29,37
Mattersburg,25,9,7,10,19,33,55,-22,31
St. Pölten,25,10,7,10,19,32,63,-31,31
SC Rheindorf,26,1,21,7,8,63,43,20,70
FC Salzburg,26,2,20,8,8,64,29,35,68
SK Sturm Gra,26,3,20,6,10,59,41,18,66
Vienna,26,4,17,6,13,51,49,2,57
Rapid Vienna,26,5,13,10,13,50,41,9,49
RZ Pellets W,26,6,10,10,16,48,54,-6,40
SV Josko Rie,26,7,11,6,19,31,47,-16,39
Admira Wacke,26,8,10,9,17,33,57,-24,39
St. Pölten,26,9,9,9,18,40,61,-21,36
Mattersburg,26,10,8,11,17,41,58,-17,35
FC Salzburg,27,1,22,6,8,72,36,36,72
SK Sturm Gra,27,2,21,4,11,60,35,25,67
SC Rheindorf,27,3,20,7,9,55,41,14,67
Vienna,27,4,20,3,13,70,52,18,63
Rapid Vienna,27,5,14,11,11,55,43,12,53
RZ Pellets W,27,6,14,8,14,51,54,-3,50
Admira Wacke,27,7,11,7,18,36,55,-19,40
St. Pölten,27,8,8,10,18,41,66,-25,34
Mattersburg,27,9,8,7,21,40,66,-26,31
SV Josko Rie,27,10,7,7,22,34,66,-32,28
FC Salzburg,28,1,21,6,9,68,33,35,69
SC Rheindorf,28,2,19,8,9,59,45,14,65
SK Sturm Gra,28,3,17,10,9,60,38,22,61
Vienna,28,4,18,6,12,67,61,6,60
Rapid Vienna,28,5,14,12,10,59,41,18,54
RZ Pellets W,28,6,12,9,15,48,57,-9,45
Admira Wacke,28,7,13,4,19,42,66,-24,43
St. Pölten,28,8,11,9,16,53,64,-11,42
SV Josko Rie,28,9,9,5,22,33,58,-25,32
Mattersburg,28,10,8,7,21,36,62,-26,31
SC Rheindorf,29,1,21,7,8,64,39,25,70
FC Salzburg,29,2,19,8,9,62,35,27,65
SK Sturm Gra,29,3,20,3,13,57,40,17,63
Vienna,29,4,19,5,12,65,54,11,62
Rapid Vienna,29,5,16,12,8,65,42,23,60
Admira Wacke,29,6,14,6,16,42,56,-14,48
SV Josko Rie,29,7,10,7,19,29,50,-21,37
RZ Pellets W,29,8,10,6,20,47,67,-20,36
Mattersburg,29,9,9,8,19,41,60,-19,35
St. Pölten,29,10,7,8,21,37,66,-29,29
FC Salzburg,30,1,23,6,7,65,32,33,75
Vienna,30,2,21,5,10,63,45,18,68
SK Sturm Gra,30,3,20,6,10,64,36,28,66
SC Rheindorf,30,4,19,8,9,60,41,19,65
Rapid Vienna,30,5,12,13,11,52,40,12,49
St. Pölten,30,6,9,11,16,39,58,-19,38
RZ Pellets W,30,7,10,8,18,36,57,-21,38
Admira Wacke,30,8,10,8,18,37,64,-27,38
Mattersburg,30,9,10,7,19,40,52,-12,37
SV Josko Rie,30,10,8,4,24,26,57,-31,28
SK Sturm Gra,31,1,21,7,8,63,33,30,70
SC Rheindorf,31,2,20,9,7,56,33,23,69
FC Salzburg,31,3,18,10,8,57,28,29,64
Vienna,31,4,17,9,10,54,43,11,60
Rapid Vienna,31,5,13,14,9,55,38,17,53
RZ Pellets W,31,6,9,10,17,42,57,-15,37
St. Pölten,31,7,9,10,17,40,63,-23,37
Admira Wacke,31,8,10,7,19,34,58,-24,37
SV Josko Rie,31,9,10,5,21,34,59,-25,35
Mattersburg,31,10,8,9,19,31,54,-23,33
SK Sturm Gra,32,1,22,4,10,64,30,34,70
FC Salzburg,32,2,19,9,8,58,30,28,66
SC Rheindorf,32,3,18,9,9,62,48,14,63
Vienna,32,4,18,4,14,63,53,10,58
Rapid Vienna,32,5,14,12,10,60,39,21,54
Admira Wacke,32,6,14,7,15,37,50,-13,49
RZ Pellets W,32,7,14,5,17,43,55,-12,47
SV Josko Rie,32,8,11,4,21,35,55,-20,37
St. Pölten,32,9,8,11,17,43,65,-22,35
Mattersburg,32,10,6,7,23,33,73,-40,25
FC Salzburg,33,1,22,7,7,64,28,36,73
SC Rheindorf,33,2,22,5,9,63,41,22,71
Vienna,33,3,20,4,12,70,53,17,64
SK Sturm Gra,33,4,18,8,10,52,31,21,62
RZ Pellets W,33,5,14,4,18,57,63,-6,46
Rapid Vienna,33,6,11,11,14,55,53,2,44
Mattersburg,33,7,11,7,18,44,56,-12,40
Admira Wacke,33,8,10,9,17,41,64,-23,39
SV Josko Rie,33,9,11,5,20,37,65,-28,38
St. Pölten,33,10,7,8,21,38,67,-29,29
SK Sturm Gra,34,1,24,5,7,68,29,39,77
FC Salzburg,34,2,24,5,7,62,27,35,77
SC Rheindorf,34,3,23,5,8,64,41,23,74
Rapid Vienna,34,4,14,7,15,51,47,4,49
Vienna,34,5,14,4,18,50,55,-5,46
RZ Pellets W,34,6,11,8,17,43,54,-11,41
St. Pölten,34,7,11,8,17,47,67,-20,41
Admira Wacke,34,8,10,7,19,36,55,-19,37
Mattersburg,34,9,9,9,18,41,58,-17,36
SV Josko Rie,34,10,9,4,23,27,56,-29,31
FC Salzburg,35,1,23,5,8,74,29,45,74
SC Rheindorf,35,2,22,5,9,52,36,16,71
SK Sturm Gra,35,3,19,3,14,57,38,19,60
Vienna,35,4,19,3,14,61,55,6,60
Rapid Vienna,35,5,16,9,11,56,42,14,57
SV Josko Rie,35,6,13,2,21,38,51,-13,41
RZ Pellets W,35,7,11,8,17,41,55,-14,41
Admira Wacke,35,8,12,5,19,36,62,-26,41
Mattersburg,35,9,8,9,19,43,57,-14,33
St. Pölten,35,10,8,9,19,39,72,-33,33
FC Salzburg,36,1,22,7,7,66,31,35,73
SK Sturm Gra,36,2,21,7,8,63,35,28,70
Vienna,36,3,19,9,8,69,48,21,66
SC Rheindorf,36,4,18,8,10,54,48,6,62
Rapid Vienna,36,5,13,10,13,53,47,6,49
RZ Pellets W,36,6,11,8,17,44,55,-11,41
Admira Wacke,36,7,11,7,18,39,61,-22,40
Mattersburg,36,8,10,7,19,35,50,-15,37
St. Pölten,36,9,8,10,18,44,64,-20,34
SV Josko Rie,36,10,7,7,22,27,55,-28,28
FC Salzburg,37,1,20,10,6,63,29,34,70
Vienna,37,2,21,6,9,60,44,16,69
SK Sturm Gra,37,3,19,8,9,57,30,27,65
SC Rheindorf,37,4,16,11,9,51,43,8,59
RZ Pellets W,37,5,12,11,13,47,50,-3,47
Rapid Vienna,37,6,10,14,12,49,42,7,44
Admira Wacke,37,7,11,8,17,36,52,-16,41
SV Josko Rie,37,8,9,8,19,30,52,-22,35
St. Pölten,37,9,8,8,20,38,65,-27,32
Mattersburg,37,10,7,10,19,33,57,-24,31
SK Sturm Gra,38,1,19,7,10,60,40,20,64
FC Salzburg,38,2,18,8,10,57,34,23,62
SC Rheindorf,38,3,17,11,8,52,43,9,62
Vienna,38,4,18,6,12,69,60,9,60
Rapid Vienna,38,5,15,10,11,59,43,16,55
RZ Pellets W,38,6,15,5,16,52,54,-2,50
SV Josko Rie,38,7,12,8,16,38,47,-9,44
Admira Wacke,38,8,11,5,20,40,61,-21,38
Mattersburg,38,9,8,12,16,37,51,-14,36
St. Pölten,38,10,6,10,20,38,69,-31,28
SC Rheindorf,39,1,22,6,8,57,45,12,72
FC Salzburg,39,2,21,6,9,63,30,33,69
SK Sturm Gra,39,3,20,5,11,62,39,23,65
RZ Pellets W,39,4,18,4,14,60,49,11,58
Rapid Vienna,39,5,15,9,12,60,49,11,54
Vienna,39,6,15,5,16,63,62,1,50
SV Josko Rie,39,7,10,8,18,36,51,-15,38
St. Pölten,39,8,8,12,16,42,64,-22,36
Admira Wacke,39,9,10,4,22,39,66,-27,34
Mattersburg,39,10,7,9,20,31,58,-27,30
SC Rheindorf,40,1,20,10,6,59,37,22,70
FC Salzburg,40,2,20,8,8,66,32,34,68
SK Sturm Gra,40,3,19,7,10,61,35,26,64
Vienna,40,4,19,6,11,58,51,7,63
Rapid Vienna,40,5,11,11,14,59,48,11,44
RZ Pellets W,40,6,12,8,16,44,57,-13,44
Admira Wacke,40,7,11,8,17,39,56,-17,41
St. Pölten,40,8,9,11,16,46,64,-18,38
SV Josko Rie,40,9,10,5,21,28,56,-28,35
Mattersburg,40,10,7,10,19,37,61,-24,31
SK Sturm Gra,41,1,23,6,7,69,26,43,75
SC Rheindorf,41,2,20,6,10,62,50,12,66
Vienna,41,3,19,4,13,63,54,9,61
FC Salzburg,41,4,17,9,10,59,36,23,60
Rapid Vienna,41,5,11,11,14,49,47,2,44
SV Josko Rie,41,6,12,8,16,34,45,-11,44
RZ Pellets W,41,7,11,10,15,55,62,-7,43
Mattersburg,41,8,9,12,15,43,57,-14,39
Admira Wacke,41,9,9,9,18,31,60,-29,36
St. Pölten,41,10,6,11,19,37,65,-28,29
FC Salzburg,42,1,21,7,8,62,33,29,70
SC Rheindorf,42,2,21,7,8,62,39,23,70
SK Sturm Gra,42,3,18,8,10,65,42,23,62
Rapid Vienna,42,4,17,11,8,54,35,19,62
Vienna,42,5,18,5,13,66,55,11,59
RZ Pellets W,42,6,12,6,18,45,56,-11,42
St. Pölten,42,7,9,10,17,41,63,-22,37
SV Josko Rie,42,8,9,8,19,32,54,-22,35
Admira Wacke,42,9,8,9,19,33,63,-30,33
Mattersburg,42,10,7,9,20,39,59,-20,30
FC Salzburg,43,1,22,7,7,66,29,37,73
SC Rheindorf,43,2,21,5,10,60,45,15,68
Vienna,43,3,19,7,10,63,46,17,64
SK Sturm Gra,43,4,18,4,14,54,46,8,58
Rapid Vienna,43,5,14,12,10,55,42,13,54
RZ Pellets W,43,6,12,10,14,46,54,-8,46
Admira Wacke,43,7,13,7,16,45,56,-11,46
SV Josko Rie,43,8,8,8,20,34,58,-24,32
St. Pölten,43,9,8,7,21,42,63,-21,31
Mattersburg,43,10,7,9,20,35,61,-26,30
SC Rheindorf,44,1,22,6,8,61,41,20,72
FC Salzburg,44,2,21,8,7,63,33,30,71
SK Sturm Gra,44,3,19,6,11,59,38,21,63
Rapid Vienna,44,4,17,11,8,66,37,29,62
Vienna,44,5,17,4,15,63,53,10,55
Admira Wacke,44,6,13,6,17,34,57,-23,45
RZ Pellets W,44,7,11,9,16,42,54,-12,42
Mattersburg,44,8,8,9,19,38,58,-20,33
SV Josko Rie,44,9,9,4,23,31,59,-28,31
St. Pölten,44,10,6,11,19,33,60,-27,29
SC Rheindorf,45,1,21,7,8,58,40,18,70
FC Salzburg,45,2,19,10,7,66,29,37,67
SK Sturm Gra,45,3,20,6,10,64,34,30,66
Vienna,45,4,20,2,14,64,55,9,62
Rapid Vienna,45,5,16,10,10,62,42,20,58
SV Josko Rie,45,6,12,6,18,34,49,-15,42
Mattersburg,45,7,10,9,17,38,57,-19,39
RZ Pellets W,45,8,11,6,19,43,63,-20,39
Admira Wacke,45,9,9,6,21,35,64,-29,33
St. Pölten,45,10,7,8,21,39,70,-31,29
SC Rheindorf,46,1,21,8,7,60,38,22,71
FC Salzburg,46,2,20,9,7,66,30,36,69
Vienna,46,3,20,5,11,66,54,12,65
SK Sturm Gra,46,4,20,4,12,56,34,22,64
RZ Pellets W,46,5,16,8,12,51,46,5,56
Rapid Vienna,46,6,14,9,13,56,46,10,51
Admira Wacke,46,7,9,7,20,39,67,-28,34
SV Josko Rie,46,8,8,8,20,39,66,-27,32
Mattersburg,46,9,7,9,20,40,60,-20,30
St. Pölten,46,10,7,9,20,49,81,-32,30
FC Salzburg,47,1,21,8,7,72,32,40,71
SC Rheindorf,47,2,21,6,9,61,43,18,69
Vienna,47,3,19,3,14,66,55,11,60
Rapid Vienna,47,4,16,9,11,57,42,15,57
SK Sturm Gra,47,5,16,8,12,53,37,16,56
SV Josko Rie,47,6,11,7,18,34,48,-14,40
Admira Wacke,47,7,11,7,18,35,61,-26,40
RZ Pellets W,47,8,10,9,17,45,61,-16,39
St. Pölten,47,9,9,11,16,40,62,-22,38
Mattersburg,47,10,7,10,19,31,53,-22,31
SK Sturm Gra,48,1,21,8,7,65,32,33,71
FC Salzburg,48,2,20,8,8,62,29,33,68
Vienna,48,3,16,10,10,57,44,13,58
SC Rheindorf,48,4,15,10,11,47,52,-5,55
Rapid Vienna,48,5,13,10,13,50,41,9,49
Mattersburg,48,6,11,7,18,37,48,-11,40
RZ Pellets W,48,7,10,10,16,39,53,-14,40
Admira Wacke,48,8,10,10,16,32,51,-19,40
SV Josko Rie,48,9,12,4,20,33,54,-21,40
St. Pölten,48,10,9,9,18,48,66,-18,36
FC Salzburg,49,1,21,5,10,71,39,32,68
SC Rheindorf,49,2,20,6,10,58,45,13,66
Vienna,49,3,20,3,13,73,50,23,63
SK Sturm Gra,49,4,17,6,13,57,36,21,57
Rapid Vienna,49,5,15,10,11,55,42,13,55
RZ Pellets W,49,6,14,6,16,51,64,-13,48
SV Josko Rie,49,7,12,6,18,42,58,-16,42
Mattersburg,49,8,10,7,19,37,59,-22,37
St. Pölten,49,9,9,9,18,44,65,-21,36
Admira Wacke,49,10,8,10,18,34,64,-30,34
FC Salzburg,50,1,23,6,7,64,24,40,75
SC Rheindorf,50,2,21,9,6,60,35,25,72
SK Sturm Gra,50,3,19,6,11,56,35,21,63
Vienna,50,4,17,4,15,62,57,5,55
Rapid Vienna,50,5,13,11,12,54,37,17,50
RZ Pellets W,50,6,13,7,16,45,54,-9,46
Admira Wacke,50,7,12,7,17,38,65,-27,43
SV Josko Rie,50,8,10,6,20,37,56,-19,36
St. Pölten,50,9,8,8,20,42,67,-25,32
Mattersburg,50,10,7,10,19,36,64,-28,31
SK Sturm Gra,51,1,23,3,10,62,30,32,72
SC Rheindorf,51,2,21,7,8,61,42,19,70
FC Salzburg,51,3,20,7,9,64,37,27,67
Vienna,51,4,19,4,13,64,59,5,61
Rapid Vienna,51,5,14,11,11,58,38,20,53
RZ Pellets W,51,6,14,6,16,54,55,-1,48
Mattersburg,51,7,10,8,18,43,56,-13,38
SV Josko Rie,51,8,9,7,20,30,55,-25,34
Admira Wacke,51,9,9,6,21,29,60,-31,33
St. Pölten,51,10,8,7,21,37,70,-33,31
FC Salzburg,52,1,21,6,9,65,33,32,69
SC Rheindorf,52,2,20,8,8,59,39,20,68
Rapid Vienna,52,3,19,9,8,60,32,28,66
SK Sturm Gra,52,4,18,5,13,57,38,19,59
Vienna,52,5,17,6,13,56,49,7,57
RZ Pellets W,52,6,12,10,14,45,57,-12,46
Admira Wacke,52,7,10,8,18,37,59,-22,38
SV Josko Rie,52,8,11,4,21,38,58,-20,37
Mattersburg,52,9,9,8,19,36,51,-15,35
St. Pölten,52,10,7,8,21,42,79,-37,29
SC Rheindorf,53,1,22,9,5,59,33,26,75
FC Salzburg,53,2,20,11,5,72,29,43,71
SK Sturm Gra,53,3,18,7,11,57,42,15,61
Rapid Vienna,53,4,14,10,12,61,40,21,52
Vienna,53,5,15,7,14,59,56,3,52
RZ Pellets W,53,6,12,7,17,46,58,-12,43
Admira Wacke,53,7,13,4,19,37,62,-25,43
Mattersburg,53,8,10,8,18,38,58,-20,38
SV Josko Rie,53,9,10,6,20,29,53,-24,36
St. Pölten,53,10,8,7,21,43,70,-27,31
FC Salzburg,54,1,24,6,6,71,31,40,78
Vienna,54,2,22,5,9,80,48,32,71
SC Rheindorf,54,3,20,6,10,58,42,16,66
SK Sturm Gra,54,4,16,7,13,56,42,14,55
Rapid Vienna,54,5,12,13,11,52,43,9,49
Admira Wacke,54,6,13,8,15,44,58,-14,47
RZ Pellets W,54,7,11,10,15,42,59,-17,43
St. Pölten,54,8,8,13,15,47,60,-13,37
Mattersburg,54,9,8,6,22,37,68,-31,30
SV Josko Rie,54,10,7,4,25,28,64,-36,25
SK Sturm Gra,55,1,22,6,8,64,32,32,72
FC Salzburg,55,2,21,8,7,64,24,40,71
SC Rheindorf,55,3,17,8,11,53,42,11,59
Vienna,55,4,17,7,12,59,51,8,58
Rapid Vienna,55,5,14,12,10,53,40,13,54
RZ Pellets W,55,6,13,8,15,46,50,-4,47
Admira Wacke,55,7,11,8,17,37,59,-22,41
SV Josko Rie,55,8,11,7,18,37,56,-19,40
St. Pölten,55,9,7,10,19,40,65,-25,31
Mattersburg,55,10,7,6,23,32,66,-34,27
SC Rheindorf,56,1,22,7,7,57,36,21,73
SK Sturm Gra,56,2,19,10,7,63,29,34,67
FC Salzburg,56,3,19,8,9,66,32,34,65
Vienna,56,4,18,6,12,60,49,11,60
Rapid Vienna,56,5,14,10,12,57,46,11,52
RZ Pellets W,56,6,12,10,14,44,50,-6,46
Admira Wacke,56,7,13,7,16,38,57,-19,46
SV Josko Rie,56,8,8,8,20,35,62,-27,32
Mattersburg,56,9,7,8,21,32,58,-26,29
St. Pölten,56,10,7,8,21,40,73,-33,29
SC Rheindorf,57,1,20,11,5,58,32,26,71
SK Sturm Gra,57,2,21,5,10,58,32,26,68
Vienna,57,3,19,7,10,61,49,12,64
FC Salzburg,57,4,19,6,11,62,34,28,63
Rapid Vienna,57,5,14,10,12,60,45,15,52
SV Josko Rie,57,6,12,7,17,37,51,-14,43
RZ Pellets W,57,7,11,7,18,44,56,-12,40
Admira Wacke,57,8,11,5,20,34,57,-23,38
St. Pölten,57,9,7,11,18,35,63,-28,32
Mattersburg,57,10,8,7,21,32,62,-30,31
FC Salzburg,58,1,19,11,6,61,29,32,68
SK Sturm Gra,58,2,20,7,9,62,36,26,67
SC Rheindorf,58,3,17,10,9,57,47,10,61
Vienna,58,4,18,6,12,64,52,12,60
RZ Pellets W,58,5,15,5,16,48,51,-3,50
Rapid Vienna,58,6,12,13,11,54,43,11,49
St. Pölten,58,7,10,12,14,47,59,-12,42
Admira Wacke,58,8,10,5,21,35,62,-27,35
SV Josko Rie,58,9,9,7,20,31,54,-23,34
Mattersburg,58,10,7,10,19,40,66,-26,31
FC Salzburg,59,1,21,8,7,66,29,37,71
SC Rheindorf,59,2,20,9,7,65,37,28,69
SK Sturm Gra,59,3,18,8,10,64,42,22,62
Vienna,59,4,18,3,15,61,57,4,57
Rapid Vienna,59,5,14,10,12,53,39,14,52
Admira Wacke,59,6,13,8,15,39,52,-13,47
RZ Pellets W,59,7,11,8,17,42,58,-16,41
Mattersburg,59,8,10,8,18,41,53,-12,38
SV Josko Rie,59,9,10,5,21,30,58,-28,35
St. Pölten,59,10,7,9,20,37,73,-36,30
FC Salzburg,60,1,22,8,6,70,34,36,74
SK Sturm Gra,60,2,23,5,8,58,29,29,74
Vienna,60,3,20,3,13,58,48,10,63
SC Rheindorf,60,4,18,9,9,53,46,7,63
Rapid Vienna,60,5,12,12,12,52,41,11,48
RZ Pellets W,60,6,12,8,16,41,52,-11,44
St. Pölten,60,7,10,8,18,46,58,-12,38
SV Josko Rie,60,8,11,4,21,31,55,-24,37
Mattersburg,60,9,6,13,17,39,54,-15,31
Admira Wacke,60,10,8,6,22,31,62,-31,30
FC Salzburg,61,1,23,5,8,72,34,38,74
SC Rheindorf,61,2,21,6,9,52,38,14,69
SK Sturm Gra,61,3,20,5,11,62,29,33,65
Vienna,61,4,19,5,12,60,47,13,62
Rapid Vienna,61,5,16,10,10,62,46,16,58
RZ Pellets W,61,6,15,6,15,45,54,-9,51
SV Josko Rie,61,7,10,7,19,32,51,-19,37
St. Pölten,61,8,8,10,18,44,62,-18,34
Admira Wacke,61,9,8,5,23,32,73,-41,29
Mattersburg,61,10,6,9,21,33,60,-27,27
SC Rheindorf,62,1,22,7,7,61,41,20,73
FC Salzburg,62,2,21,7,8,68,37,31,70
SK Sturm Gra,62,3,21,4,11,66,34,32,67
Vienna,62,4,17,4,15,62,50,12,55
Rapid Vienna,62,5,14,12,10,58,42,16,54
RZ Pellets W,62,6,11,8,17,37,51,-14,41
St. Pölten,62,7,11,8,17,48,66,-18,41
Admira Wacke,62,8,10,6,20,35,67,-32,36
SV Josko Rie,62,9,11,2,23,35,61,-26,35
Mattersburg,62,10,7,12,17,36,57,-21,33
FC Salzburg,63,1,23,6,7,67,23,44,75
SK Sturm Gra,63,2,23,6,7,61,22,39,75
SC Rheindorf,63,3,18,11,7,54,40,14,65
Vienna,63,4,20,4,12,57,45,12,64
Rapid Vienna,63,5,11,11,14,55,52,3,44
RZ Pellets W,63,6,11,7,18,37,50,-13,40
St. Pölten,63,7,8,13,15,44,57,-13,37
Admira Wacke,63,8,10,6,20,36,70,-34,36
SV Josko Rie,63,9,9,8,19,39,64,-25,35
Mattersburg,63,10,7,8,21,34,61,-27,29
FC Salzburg,64,1,21,7,8,68,33,35,70
SK Sturm Gra,64,2,19,9,8,66,36,30,66
Vienna,64,3,19,6,11,68,56,12,63
SC Rheindorf,64,4,18,8,10,53,40,13,62
Rapid Vienna,64,5,14,12,10,54,39,15,54
RZ Pellets W,64,6,14,4,18,46,54,-8,46
Admira Wacke,64,7,12,6,18,36,58,-22,42
SV Josko Rie,64,8,10,4,22,33,59,-26,34
St. Pölten,64,9,8,10,18,37,64,-27,34
Mattersburg,64,10,9,6,21,38,60,-22,33
FC Salzburg,65,1,23,5,8,71,35,36,74
SK Sturm Gra,65,2,20,7,9,59,34,25,67
SC Rheindorf,65,3,18,8,10,55,44,11,62
Vienna,65,4,18,7,11,57,41,16,61
Rapid Vienna,65,5,15,10,11,51,35,16,55
SV Josko Rie,65,6,11,9,16,37,51,-14,42
RZ Pellets W,65,7,11,8,17,41,56,-15,41
Admira Wacke,65,8,11,8,17,35,59,-24,41
St. Pölten,65,9,7,10,19,37,62,-25,31
Mattersburg,65,10,7,6,23,28,54,-26,27
FC Salzburg,66,1,22,9,5,68,30,38,75
SC Rheindorf,66,2,20,6,10,56,47,9,66
SK Sturm Gra,66,3,19,6,11,57,31,26,63
Vienna,66,4,19,2,15,54,51,3,59
Rapid Vienna,66,5,12,12,12,49,40,9,48
Admira Wacke,66,6,12,7,17,39,58,-19,43
RZ Pellets W,66,7,10,10,16,40,54,-14,40
Mattersburg,66,8,10,8,18,45,56,-11,38
St. Pölten,66,9,8,12,16,41,58,-17,36
SV Josko Rie,66,10,10,4,22,35,59,-24,34
FC Salzburg,67,1,23,8,5,79,31,48,77
SC Rheindorf,67,2,19,8,9,56,39,17,65
Vienna,67,3,19,4,13,58,54,4,61
SK Sturm Gra,67,4,17,7,12,58,37,21,58
Rapid Vienna,67,5,15,11,10,62,45,17,56
Admira Wacke,67,6,14,6,16,43,62,-19,48
Mattersburg,67,7,9,9,18,41,55,-14,36
SV Josko Rie,67,8,10,5,21,37,58,-21,35
St. Pölten,67,9,8,10,18,41,69,-28,34
RZ Pellets W,67,10,9,6,21,38,63,-25,33
SC Rheindorf,68,1,21,5,10,58,40,18,68
SK Sturm Gra,68,2,20,6,10,59,37,22,66
FC Salzburg,68,3,19,8,9,66,38,28,65
Vienna,68,4,20,5,11,70,59,11,65
RZ Pellets W,68,5,15,6,15,51,54,-3,51
Rapid Vienna,68,6,11,10,15,52,49,3,43
SV Josko Rie,68,7,11,9,16,35,46,-11,42
Mattersburg,68,8,10,7,19,35,54,-19,37
Admira Wacke,68,9,11,4,21,38,60,-22,37
St. Pölten,68,10,8,8,20,42,69,-27,32
FC Salzburg,69,1,21,8,7,65,28,37,71
SC Rheindorf,69,2,21,5,10,56,43,13,68
SK Sturm Gra,69,3,19,8,9,55,32,23,65
Vienna,69,4,17,5,14,61,52,9,56
RZ Pellets W,69,5,13,9,14,52,57,-5,48
Admira Wacke,69,6,13,9,14,41,56,-15,48
Rapid Vienna,69,7,10,12,14,45,44,1,42
Mattersburg,69,8,9,10,17,40,55,-15,37
SV Josko Rie,69,9,9,8,19,36,56,-20,35
St. Pölten,69,10,5,12,19,39,67,-28,27
FC Salzburg,70,1,24,6,6,68,29,39,78
SC Rheindorf,70,2,24,6,6,61,36,25,78
SK Sturm Gra,70,3,18,6,12,54,35,19,60
Vienna,70,4,18,4,14,56,50,6,58
Rapid Vienna,70,5,14,10,12,52,38,14,52
RZ Pellets W,70,6,10,7,19,38,53,-15,37
St. Pölten,70,7,9,10,17,40,58,-18,37
Mattersburg,70,8,10,7,19,33,54,-21,37
Admira Wacke,70,9,10,6,20,40,67,-27,36
SV Josko Rie,70,10,10,4,22,32,54,-22,34
FC Salzburg,71,1,23,7,6,68,26,42,76
SK Sturm Gra,71,2,19,7,10,56,35,21,64
SC Rheindorf,71,3,17,9,10,56,45,11,60
Vienna,71,4,17,6,13,64,59,5,57
Rapid Vienna,71,5,14,10,12,60,43,17,52
RZ Pellets W,71,6,11,11,14,47,54,-7,44
Admira Wacke,71,7,11,8,17,42,58,-16,41
SV Josko Rie,71,8,11,7,18,34,51,-17,40
Mattersburg,71,9,10,8,18,41,59,-18,38
St. Pölten,71,10,6,9,21,35,73,-38,27
FC Salzburg,72,1,23,7,6,64,29,35,76
SC Rheindorf,72,2,19,8,9,56,37,19,65
SK Sturm Gra,72,3,19,4,13,56,36,20,61
Vienna,72,4,17,9,10,66,48,18,60
Rapid Vienna,72,5,13,11,12,46,39,7,50
RZ Pellets W,72,6,12,9,15,48,55,-7,45
SV Josko Rie,72,7,13,4,19,39,49,-10,43
St. Pölten,72,8,9,11,16,41,63,-22,38
Admira Wacke,72,9,9,8,19,31,62,-31,35
Mattersburg,72,10,5,11,20,31,60,-29,26
SC Rheindorf,73,1,22,6,8,58,40,18,72
FC Salzburg,73,2,20,7,9,65,31,34,67
SK Sturm Gra,73,3,19,5,12,61,41,20,62
Rapid Vienna,73,4,16,9,11,57,39,18,57
Admira Wacke,73,5,14,6,16,36,51,-15,48
RZ Pellets W,73,6,13,7,16,45,50,-5,46
Vienna,73,7,14,3,19,53,62,-9,45
SV Josko Rie,73,8,13,4,19,41,51,-10,43
St. Pölten,73,9,10,7,19,38,66,-28,37
Mattersburg,73,10,9,6,21,36,59,-23,33
FC Salzburg,74,1,22,7,7,64,25,39,73
SC Rheindorf,74,2,19,10,7,54,39,15,67
SK Sturm Gra,74,3,19,7,10,56,33,23,64
Vienna,74,4,17,6,13,62,54,8,57
RZ Pellets W,74,5,12,10,14,50,55,-5,46
Rapid Vienna,74,6,11,12,13,52,49,3,45
SV Josko Rie,74,7,13,4,19,43,57,-14,43
St. Pölten,74,8,9,11,16,42,62,-20,38
Mattersburg,74,9,8,9,19,35,52,-17,33
Admira Wacke,74,10,8,8,20,35,67,-32,32
SC Rheindorf,75,1,20,11,5,59,32,27,71
FC Salzburg,75,2,20,9,7,59,27,32,69
Vienna,75,3,20,4,12,68,56,12,64
SK Sturm Gra,75,4,18,6,12,57,38,19,60
Rapid Vienna,75,5,14,11,11,59,44,15,53
RZ Pellets W,75,6,12,8,16,44,59,-15,44
SV Josko Rie,75,7,10,7,19,35,54,-19,37
Admira Wacke,75,8,10,7,19,38,59,-21,37
St. Pölten,75,9,7,11,18,38,71,-33,32
Mattersburg,75,10,7,10,19,41,58,-17,31
FC Salzburg,76,1,20,8,8,68,33,35,68
SC Rheindorf,76,2,17,11,8,55,43,12,62
Rapid Vienna,76,3,17,8,11,60,46,14,59
Vienna,76,4,18,5,13,61,56,5,59
SK Sturm Gra,76,5,15,10,11,54,40,14,55
RZ Pellets W,76,6,12,8,16,46,56,-10,44
SV Josko Rie,76,7,12,6,18,46,56,-10,42
Admira Wacke,76,8,12,6,18,42,60,-18,42
Mattersburg,76,9,10,10,16,41,49,-8,40
St. Pölten,76,10,7,8,21,36,70,-34,29
SK Sturm Gra,77,1,21,6,9,63,35,28,69
Vienna,77,2,22,2,12,67,50,17,68
FC Salzburg,77,3,20,7,9,65,37,28,67
SC Rheindorf,77,4,18,8,10,50,45,5,62
Rapid Vienna,77,5,12,9,15,53,42,11,45
RZ Pellets W,77,6,12,6,18,48,61,-13,42
Mattersburg,77,7,9,11,16,45,54,-9,38
SV Josko Rie,77,8,11,5,20,31,53,-22,38
Admira Wacke,77,9,10,8,18,37,63,-26,38
St. Pölten,77,10,9,10,17,43,62,-19,37
FC Salzburg,78,1,20,7,9,64,32,32,67
SK Sturm Gra,78,2,18,7,11,63,45,18,61
Vienna,78,3,19,4,13,62,51,11,61
Rapid Vienna,78,4,16,10,10,62,38,24,58
SC Rheindorf,78,5,16,8,12,51,50,1,56
RZ Pellets W,78,6,12,9,15,49,59,-10,45
Mattersburg,78,7,11,7,18,45,54,-9,40
Admira Wacke,78,8,9,11,16,29,50,-21,38
SV Josko Rie,78,9,10,7,19,34,56,-22,37
St. Pölten,78,10,7,14,15,38,62,-24,35
FC Salzburg,79,1,21,8,7,72,39,33,71
SK Sturm Gra,79,2,22,5,9,66,36,30,71
Vienna,79,3,20,8,8,73,48,25,68
SC Rheindorf,79,4,19,7,10,62,48,14,64
Rapid Vienna,79,5,12,12,12,53,43,10,48
RZ Pellets W,79,6,13,6,17,43,53,-10,45
SV Josko Rie,79,7,11,8,17,37,50,-13,41
Admira Wacke,79,8,10,5,21,37,72,-35,35
Mattersburg,79,9,6,11,19,33,58,-25,29
St. Pölten,79,10,6,10,20,39,68,-29,28
FC Salzburg,80,1,21,7,8,71,31,40,70
SK Sturm Gra,80,2,20,7,9,60,33,27,67
Vienna,80,3,19,7,10,63,52,11,64
SC Rheindorf,80,4,18,10,8,53,46,7,64
Rapid Vienna,80,5,12,13,11,54,39,15,49
St. Pölten,80,6,9,13,14,47,57,-10,40
SV Josko Rie,80,7,12,4,20,36,58,-22,40
Admira Wacke,80,8,10,8,18,37,63,-26,38
Mattersburg,80,9,7,11,18,38,58,-20,32
RZ Pellets W,80,10,8,8,20,40,62,-22,32
SC Rheindorf,81,1,21,6,9,56,38,18,69
FC Salzburg,81,2,19,6,11,58,33,25,63
Vienna,81,3,19,6,11,61,48,13,63
SK Sturm Gra,81,4,18,8,10,51,33,18,62
Rapid Vienna,81,5,14,10,12,49,38,11,52
RZ Pellets W,81,6,13,6,17,41,52,-11,45
Admira Wacke,81,7,13,6,17,37,53,-16,45
SV Josko Rie,81,8,11,5,20,39,54,-15,38
St. Pölten,81,9,9,10,17,37,56,-19,37
Mattersburg,81,10,8,7,21,36,60,-24,31
SC Rheindorf,82,1,21,8,7,56,40,16,71
Vienna,82,2,20,7,9,65,40,25,67
FC Salzburg,82,3,19,8,9,70,39,31,65
SK Sturm Gra,82,4,17,7,12,52,38,14,58
Rapid Vienna,82,5,13,11,12,57,41,16,50
RZ Pellets W,82,6,10,12,14,47,55,-8,42
Admira Wacke,82,7,11,8,17,39,60,-21,41
SV Josko Rie,82,8,10,8,18,32,52,-20,38
St. Pölten,82,9,8,10,18,42,65,-23,34
Mattersburg,82,10,7,9,20,30,60,-30,30
FC Salzburg,83,1,21,5,10,64,34,30,68
SC Rheindorf,83,2,20,7,9,59,42,17,67
SK Sturm Gra,83,3,19,6,11,59,38,21,63
Vienna,83,4,19,5,12,63,51,12,62
Rapid Vienna,83,5,12,10,14,52,48,4,46
RZ Pellets W,83,6,13,6,17,44,53,-9,45
Admira Wacke,83,7,13,5,18,40,60,-20,44
SV Josko Rie,83,8,12,5,19,39,53,-14,41
Mattersburg,83,9,10,7,19,35,53,-18,37
St. Pölten,83,10,9,8,19,49,72,-23,35
SK Sturm Gra,84,1,25,3,8,76,33,43,78
FC Salzburg,84,2,23,6,7,73,30,43,75
SC Rheindorf,84,3,19,7,10,54,41,13,64
Vienna,84,4,20,3,13,59,48,11,63
Admira Wacke,84,5,14,4,18,46,60,-14,46
Rapid Vienna,84,6,12,8,16,53,49,4,44
St. Pölten,84,7,11,7,18,46,66,-20,40
RZ Pellets W,84,8,10,6,20,38,58,-20,36
Mattersburg,84,9,10,5,21,36,64,-28,35
SV Josko Rie,84,10,10,3,23,31,63,-32,33
Vienna,85,1,22,6,8,66,45,21,72
FC Salzburg,85,2,20,10,6,58,25,33,70
SC Rheindorf,85,3,20,6,10,56,41,15,66
SK Sturm Gra,85,4,18,8,10,54,32,22,62
Rapid Vienna,85,5,15,11,10,52,37,15,56
SV Josko Rie,85,6,11,5,20,38,56,-18,38
RZ Pellets W,85,7,10,7,19,41,60,-19,37
Admira Wacke,85,8,10,7,19,34,63,-29,37
St. Pölten,85,9,8,9,19,41,61,-20,33
Mattersburg,85,10,7,9,20,30,50,-20,30
FC Salzburg,86,1,22,7,7,65,24,41,73
SC Rheindorf,86,2,20,9,7,58,39,19,69
SK Sturm Gra,86,3,20,6,10,64,42,22,66
Vienna,86,4,19,4,13,67,54,13,61
Rapid Vienna,86,5,13,13,10,56,39,17,52
RZ Pellets W,86,6,15,5,16,50,54,-4,50
SV Josko Rie,86,7,12,7,17,37,49,-12,43
Admira Wacke,86,8,8,7,21,26,65,-39,31
St. Pölten,86,9,7,9,20,43,71,-28,30
Mattersburg,86,10,5,11,20,38,67,-29,26
FC Salzburg,87,1,22,7,7,63,30,33,73
SK Sturm Gra,87,2,20,5,11,57,31,26,65
Vienna,87,3,17,10,9,61,45,16,61
SC Rheindorf,87,4,16,10,10,49,40,9,58
RZ Pellets W,87,5,15,8,13,42,48,-6,53
Rapid Vienna,87,6,12,8,16,48,45,3,44
Admira Wacke,87,7,12,5,19,36,59,-23,41
SV Josko Rie,87,8,10,8,18,38,51,-13,38
St. Pölten,87,9,9,10,17,48,68,-20,37
Mattersburg,87,10,8,7,21,37,62,-25,31
FC Salzburg,88,1,20,9,7,62,29,33,69
SK Sturm Gra,88,2,21,5,10,63,30,33,68
SC Rheindorf,88,3,18,9,9,57,44,13,63
Rapid Vienna,88,4,15,12,9,57,41,16,57
Vienna,88,5,16,5,15,54,51,3,53
SV Josko Rie,88,6,13,4,19,35,53,-18,43
Admira Wacke,88,7,11,7,18,35,51,-16,40
RZ Pellets W,88,8,10,9,17,41,59,-18,39
Mattersburg,88,9,7,12,17,38,56,-18,33
St. Pölten,88,10,6,14,16,36,64,-28,32
FC Salzburg,89,1,22,5,9,66,30,36,71
SK Sturm Gra,89,2,22,4,10,64,31,33,70
SC Rheindorf,89,3,20,5,11,54,43,11,65
Vienna,89,4,18,7,11,56,45,11,61
Rapid Vienna,89,5,15,9,12,60,41,19,54
SV Josko Rie,89,6,13,6,17,32,47,-15,45
Admira Wacke,89,7,10,8,18,31,62,-31,38
Mattersburg,89,8,9,10,17,32,49,-17,37
RZ Pellets W,89,9,9,7,20,39,59,-20,34
St. Pölten,89,10,5,13,18,33,60,-27,28
FC Salzburg,90,1,20,11,5,60,27,33,71
SC Rheindorf,90,2,21,7,8,59,43,16,70
SK Sturm Gra,90,3,18,9,9,60,38,22,63
Vienna,90,4,16,8,12,62,50,12,56
Rapid Vienna,90,5,14,12,10,54,41,13,54
Mattersburg,90,6,11,10,15,46,50,-4,43
Admira Wacke,90,7,10,8,18,35,59,-24,38
SV Josko Rie,90,8,10,7,19,36,51,-15,37
RZ Pellets W,90,9,10,7,19,39,56,-17,37
St. Pölten,90,10,5,11,20,39,75,-36,26
SC Rheindorf,91,1,22,5,9,61,47,14,71
SK Sturm Gra,91,2,21,5,10,65,39,26,68
FC Salzburg,91,3,17,9,10,54,29,25,60
Vienna,91,4,19,3,14,68,49,19,60
Rapid Vienna,91,5,14,12,10,50,34,16,54
RZ Pellets W,91,6,13,6,17,39,50,-11,45
SV Josko Rie,91,7,12,8,16,37,52,-15,44
Admira Wacke,91,8,13,5,18,33,55,-22,44
Mattersburg,91,9,7,9,20,37,58,-21,30
St. Pölten,91,10,6,10,20,33,64,-31,28
FC Salzburg,92,1,23,6,7,67,29,38,75
SK Sturm Gra,92,2,20,7,9,66,34,32,67
Vienna,92,3,17,8,11,65,53,12,59
SC Rheindorf,92,4,17,7,12,53,51,2,58
RZ Pellets W,92,5,13,10,13,57,61,-4,49
Admira Wacke,92,6,14,4,18,48,63,-15,46
Rapid Vienna,92,7,11,11,14,55,51,4,44
SV Josko Rie,92,8,11,6,19,33,52,-19,39
St. Pölten,92,9,8,10,18,42,68,-26,34
Mattersburg,92,10,7,9,20,35,59,-24,30
FC Salzburg,93,1,21,9,6,69,35,34,72
SC Rheindorf,93,2,20,8,8,61,41,20,68
Vienna,93,3,20,6,10,71,49,22,66
SK Sturm Gra,93,4,18,9,9,54,33,21,63
Rapid Vienna,93,5,15,9,12,61,39,22,54
RZ Pellets W,93,6,11,10,15,41,53,-12,43
SV Josko Rie,93,7,11,5,20,36,62,-26,38
Admira Wacke,93,8,8,9,19,34,58,-24,33
St. Pölten,93,9,7,12,17,41,67,-26,33
Mattersburg,93,10,7,7,22,36,67,-31,28
FC Salzburg,94,1,23,6,7,67,30,37,75
SC Rheindorf,94,2,19,8,9,60,42,18,65
SK Sturm Gra,94,3,18,7,11,57,37,20,61
Vienna,94,4,18,4,14,56,51,5,58
Rapid Vienna,94,5,12,15,9,54,39,15,51
RZ Pellets W,94,6,12,8,16,45,57,-12,44
SV Josko Rie,94,7,13,5,18,34,53,-19,44
Admira Wacke,94,8,11,5,20,43,64,-21,38
St. Pölten,94,9,9,10,17,42,59,-17,37
Mattersburg,94,10,7,8,21,43,69,-26,29
SC Rheindorf,95,1,24,6,6,59,34,25,78
FC Salzburg,95,2,19,7,10,63,37,26,64
SK Sturm Gra,95,3,19,7,10,60,37,23,64
Rapid Vienna,95,4,16,10,10,54,36,18,58
Vienna,95,5,17,6,13,59,49,10,57
SV Josko Rie,95,6,12,7,17,35,50,-15,43
RZ Pellets W,95,7,11,7,18,45,58,-13,40
Admira Wacke,95,8,9,8,19,33,62,-29,35
Mattersburg,95,9,8,9,19,36,54,-18,33
St. Pölten,95,10,6,11,19,44,71,-27,29
FC Salzburg,96,1,21,7,8,60,32,28,70
SK Sturm Gra,96,2,20,9,7,53,25,28,69
SC Rheindorf,96,3,19,7,10,53,44,9,64
Vienna,96,4,19,4,13,68,51,17,61
Rapid Vienna,96,5,16,10,10,59,40,19,58
Admira Wacke,96,6,11,8,17,42,59,-17,41
SV Josko Rie,96,7,11,5,20,29,46,-17,38
RZ Pellets W,96,8,10,8,18,46,64,-18,38
Mattersburg,96,9,8,9,19,38,59,-21,33
St. Pölten,96,10,5,13,18,35,63,-28,28
FC Salzburg,97,1,20,10,6,60,23,37,70
SC Rheindorf,97,2,21,6,9,61,40,21,69
SK Sturm Gra,97,3,19,5,12,55,33,22,62
Vienna,97,4,19,4,13,63,50,13,61
Rapid Vienna,97,5,13,11,12,56,43,13,50
Admira Wacke,97,6,13,7,16,40,57,-17,46
RZ Pellets W,97,7,12,7,17,47,66,-19,43
SV Josko Rie,97,8,11,5,20,36,57,-21,38
St. Pölten,97,9,9,9,18,45,65,-20,36
Mattersburg,97,10,6,10,20,35,64,-29,28
SC Rheindorf,98,1,24,4,8,61,41,20,76
Vienna,98,2,22,5,9,68,42,26,71
FC Salzburg,98,3,20,6,10,65,33,32,66
SK Sturm Gra,98,4,18,3,15,60,43,17,57
Rapid Vienna,98,5,14,9,13,54,45,9,51
Admira Wacke,98,6,14,5,17,39,61,-22,47
RZ Pellets W,98,7,13,6,17,46,49,-3,45
Mattersburg,98,8,10,7,19,36,57,-21,37
SV Josko Rie,98,9,8,7,21,25,51,-26,31
St. Pölten,98,10,7,8,21,35,67,-32,29
FC Salzburg,99,1,21,7,8,67,30,37,70
SK Sturm Gra,99,2,22,3,11,55,35,20,69
SC Rheindorf,99,3,20,7,9,61,43,18,67
Vienna,99,4,21,2,13,69,51,18,65
Rapid Vienna,99,5,17,10,9,65,39,26,61
SV Josko Rie,99,6,13,4,19,36,50,-14,43
RZ Pellets W,99,7,12,5,19,40,61,-21,41
Admira Wacke,99,8,9,8,19,35,64,-29,35
St. Pölten,99,9,7,9,20,41,66,-25,30
Mattersburg,99,10,7,7,22,38,68,-30,28
FC Salzburg,100,1,21,6,9,66,36,30,69
SK Sturm Gra,100,2,19,6,11,61,41,20,63
Vienna,100,3,18,5,13,64,60,4,59
SC Rheindorf,100,4,16,9,11,54,45,9,57
Rapid Vienna,100,5,15,9,12,65,41,24,54
RZ Pellets W,100,6,13,9,14,49,64,-15,48
Mattersburg,100,7,11,10,15,42,51,-9,43
SV Josko Rie,100,8,12,6,18,43,52,-9,42
Admira Wacke,100,9,10,5,21,40,72,-32,35
St. Pölten,100,10,7,11,18,47,69,-22,32
FC Salzburg,101,1,22,7,7,67,30,37,73
SK Sturm Gra,101,2,21,6,9,57,29,28,69
SC Rheindorf,101,3,18,6,12,59,51,8,60
Vienna,101,4,17,7,12,59,53,6,58
Rapid Vienna,101,5,16,9,11,59,43,16,57
RZ Pellets W,101,6,14,6,16,46,51,-5,48
Mattersburg,101,7,11,6,19,35,52,-17,39
Admira Wacke,101,8,10,7,19,34,62,-28,37
SV Josko Rie,101,9,10,5,21,37,60,-23,35
St. Pölten,101,10,7,9,20,45,67,-22,30
FC Salzburg,102,1,22,8,6,67,31,36,74
SC Rheindorf,102,2,21,5,10,55,41,14,68
SK Sturm Gra,102,3,20,6,10,61,40,21,66
Vienna,102,4,17,3,16,63,61,2,54
RZ Pellets W,102,5,15,7,14,58,56,2,52
Rapid Vienna,102,6,13,11,12,56,48,8,50
SV Josko Rie,102,7,12,8,16,39,48,-9,44
St. Pölten,102,8,8,12,16,46,59,-13,36
Mattersburg,102,9,6,11,19,30,55,-25,29
Admira Wacke,102,10,7,7,22,31,67,-36,28
FC Salzburg,103,1,21,8,7,64,27,37,71
SC Rheindorf,103,2,19,8,9,60,45,15,65
SK Sturm Gra,103,3,19,6,11,63,39,24,63
Rapid Vienna,103,4,15,11,10,56,37,19,56
Admira Wacke,103,5,17,4,15,43,53,-10,55
Vienna,103,6,14,6,16,58,60,-2,48
RZ Pellets W,103,7,12,6,18,43,54,-11,42
SV Josko Rie,103,8,11,5,20,36,56,-20,38
Mattersburg,103,9,8,9,19,33,58,-25,33
St. Pölten,103,10,8,9,19,38,65,-27,33
FC Salzburg,104,1,20,9,7,63,33,30,69
SC Rheindorf,104,2,20,8,8,59,39,20,68
SK Sturm Gra,104,3,16,9,11,56,35,21,57
Vienna,104,4,16,8,12,62,57,5,56
Rapid Vienna,104,5,15,10,11,55,41,14,55
Admira Wacke,104,6,13,8,15,44,56,-12,47
RZ Pellets W,104,7,12,8,16,46,53,-7,44
SV Josko Rie,104,8,11,4,21,34,61,-27,37
St. Pölten,104,9,9,9,18,44,66,-22,36
Mattersburg,104,10,8,7,21,34,56,-22,31
FC Salzburg,105,1,18,10,8,64,40,24,64
SK Sturm Gra,105,2,18,8,10,53,31,22,62
Vienna,105,3,19,4,13,66,55,11,61
SC Rheindorf,105,4,17,7,12,49,43,6,58
Rapid Vienna,105,5,16,9,11,61,38,23,57
RZ Pellets W,105,6,15,8,13,53,49,4,53
SV Josko Rie,105,7,11,7,18,36,53,-17,40
Admira Wacke,105,8,11,6,19,37,59,-22,39
Mattersburg,105,9,9,10,17,36,59,-23,37
St. Pölten,105,10,8,7,21,34,62,-28,31
FC Salzburg,106,1,21,8,7,70,31,39,71
SC Rheindorf,106,2,21,6,9,62,45,17,69
SK Sturm Gra,106,3,18,6,12,65,40,25,60
Rapid Vienna,106,4,15,10,11,56,38,18,55
Vienna,106,5,17,4,15,66,60,6,55
RZ Pellets W,106,6,14,9,13,55,55,0,51
SV Josko Rie,106,7,13,5,18,39,58,-19,44
St. Pölten,106,8,9,8,19,49,72,-23,35
Admira Wacke,106,9,9,7,20,30,65,-35,34
Mattersburg,106,10,7,9,20,32,60,-28,30
SK Sturm Gra,107,1,23,3,10,63,34,29,72
FC Salzburg,107,2,19,8,9,68,38,30,65
SC Rheindorf,107,3,19,8,9,50,39,11,65
Vienna,107,4,17,7,12,67,62,5,58
Rapid Vienna,107,5,15,11,10,55,40,15,56
RZ Pellets W,107,6,11,10,15,45,53,-8,43
SV Josko Rie,107,7,12,7,17,42,58,-16,43
St. Pölten,107,8,11,8,17,43,61,-18,41
Admira Wacke,107,9,9,8,19,37,57,-20,35
Mattersburg,107,10,5,8,23,27,55,-28,23
FC Salzburg,108,1,23,5,8,71,32,39,74
SC Rheindorf,108,2,20,8,8,58,41,17,68
SK Sturm Gra,108,3,20,7,9,66,38,28,67
Vienna,108,4,18,6,12,62,48,14,60
Rapid Vienna,108,5,12,10,14,46,44,2,46
RZ Pellets W,108,6,12,9,15,45,53,-8,45
Admira Wacke,108,7,11,8,17,37,56,-19,41
SV Josko Rie,108,8,11,4,21,32,56,-24,37
Mattersburg,108,9,9,8,19,35,56,-21,35
St. Pölten,108,10,7,9,20,42,70,-28,30
SK Sturm Gra,109,1,20,9,7,66,29,37,69
SC Rheindorf,109,2,20,7,9,56,41,15,67
FC Salzburg,109,3,17,12,7,55,28,27,63
Vienna,109,4,16,6,14,64,58,6,54
Rapid Vienna,109,5,13,14,9,56,37,19,53
Admira Wacke,109,6,14,6,16,40,57,-17,48
RZ Pellets W,109,7,11,8,17,44,58,-14,41
St. Pölten,109,8,8,13,15,45,62,-17,37
SV Josko Rie,109,9,9,5,22,27,59,-32,32
Mattersburg,109,10,6,12,18,39,63,-24,30
FC Salzburg,110,1,22,6,8,73,32,41,72
SC Rheindorf,110,2,18,9,9,56,43,13,63
Vienna,110,3,19,5,12,57,58,-1,62
SK Sturm Gra,110,4,18,6,12,61,38,23,60
Rapid Vienna,110,5,15,10,11,54,34,20,55
RZ Pellets W,110,6,14,8,14,46,50,-4,50
Admira Wacke,110,7,11,7,18,38,59,-21,40
SV Josko Rie,110,8,10,6,20,34,50,-16,36
Mattersburg,110,9,9,7,20,44,66,-22,34
St. Pölten,110,10,8,8,20,42,75,-33,32
FC Salzburg,111,1,20,10,6,72,35,37,70
SC Rheindorf,111,2,19,10,7,53,37,16,67
Vienna,111,3,20,6,10,68,51,17,66
SK Sturm Gra,111,4,18,7,11,59,37,22,61
Rapid Vienna,111,5,12,9,15,55,52,3,45
Admira Wacke,111,6,11,9,16,39,57,-18,42
RZ Pellets W,111,7,11,8,17,44,60,-16,41
Mattersburg,111,8,9,11,16,34,50,-16,38
SV Josko Rie,111,9,10,7,19,35,53,-18,37
St. Pölten,111,10,6,11,19,46,73,-27,29
FC Salzburg,112,1,21,8,7,65,29,36,71
SK Sturm Gra,112,2,21,6,9,64,31,33,69
SC Rheindorf,112,3,19,8,9,53,39,14,65
Rapid Vienna,112,4,18,8,10,52,32,20,62
Vienna,112,5,16,3,17,52,57,-5,51
RZ Pellets W,112,6,13,6,17,44,49,-5,45
Admira Wacke,112,7,13,6,17,37,56,-19,45
Mattersburg,112,8,9,8,19,37,57,-20,35
St. Pölten,112,9,9,8,19,40,65,-25,35
SV Josko Rie,112,10,8,5,23,29,58,-29,29
FC Salzburg,113,1,19,10,7,58,27,31,67
SK Sturm Gra,113,2,20,7,9,59,33,26,67
Vienna,113,3,21,4,11,69,55,14,67
SC Rheindorf,113,4,17,11,8,49,38,11,62
Rapid Vienna,113,5,15,10,11,56,37,19,55
Admira Wacke,113,6,12,8,16,42,60,-18,44
RZ Pellets W,113,7,12,7,17,46,56,-10,43
Mattersburg,113,8,9,9,18,38,56,-18,36
SV Josko Rie,113,9,9,5,22,31,55,-24,32
St. Pölten,113,10,6,9,21,37,68,-31,27
FC Salzburg,114,1,23,5,8,67,33,34,74
SC Rheindorf,114,2,20,9,7,61,41,20,69
SK Sturm Gra,114,3,19,8,9,64,32,32,65
Vienna,114,4,19,5,12,63,52,11,62
Rapid Vienna,114,5,15,9,12,60,43,17,54
RZ Pellets W,114,6,11,8,17,43,64,-21,41
Admira Wacke,114,7,10,6,20,30,55,-25,36
St. Pölten,114,8,8,12,16,39,66,-27,36
SV Josko Rie,114,9,10,4,22,34,55,-21,34
Mattersburg,114,10,9,6,21,35,55,-20,33
FC Salzburg,115,1,21,8,7,66,30,36,71
SK Sturm Gra,115,2,21,6,9,60,33,27,69
SC Rheindorf,115,3,18,8,10,54,45,9,62
Vienna,115,4,18,6,12,59,48,11,60
Rapid Vienna,115,5,15,9,12,53,41,12,54
Admira Wacke,115,6,14,4,18,41,55,-14,46
SV Josko Rie,115,7,12,5,19,41,52,-11,41
St. Pölten,115,8,10,8,18,41,68,-27,38
Mattersburg,115,9,8,9,19,34,53,-19,33
RZ Pellets W,115,10,8,7,21,37,61,-24,31
FC Salzburg,116,1,22,6,8,70,34,36,72
SK Sturm Gra,116,2,21,8,7,57,26,31,71
SC Rheindorf,116,3,22,5,9,62,42,20,71
Vienna,116,4,19,4,13,61,53,8,61
Rapid Vienna,116,5,15,11,10,53,37,16,56
SV Josko Rie,116,6,11,5,20,34,54,-20,38
RZ Pellets W,116,7,10,7,19,44,60,-16,37
Mattersburg,116,8,10,6,20,39,54,-15,36
St. Pölten,116,9,8,9,19,36,62,-26,33
Admira Wacke,116,10,8,7,21,33,67,-34,31
SK Sturm Gra,117,1,21,7,8,66,32,34,70
SC Rheindorf,117,2,21,7,8,61,41,20,70
Vienna,117,3,20,5,11,64,49,15,65
FC Salzburg,117,4,17,7,12,61,41,20,58
Rapid Vienna,117,5,13,9,14,53,44,9,48
Admira Wacke,117,6,11,10,15,41,57,-16,43
RZ Pellets W,117,7,11,5,20,45,60,-15,38
SV Josko Rie,117,8,11,5,20,38,63,-25,38
Mattersburg,117,9,9,9,18,36,56,-20,36
St. Pölten,117,10,8,12,16,37,59,-22,36
Vienna,118,1,21,7,8,68,49,19,70
FC Salzburg,118,2,19,9,8,66,32,34,66
SC Rheindorf,118,3,17,9,10,53,47,6,60
SK Sturm Gra,118,4,17,6,13,54,45,9,57
RZ Pellets W,118,5,16,7,13,53,53,0,55
Rapid Vienna,118,6,13,12,11,55,44,11,51
SV Josko Rie,118,7,12,4,20,42,55,-13,40
Admira Wacke,118,8,10,7,19,34,56,-22,37
St. Pölten,118,9,9,8,19,47,70,-23,35
Mattersburg,118,10,7,9,20,33,54,-21,30
FC Salzburg,119,1,18,12,6,69,38,31,66
SC Rheindorf,119,2,18,12,6,53,38,15,66
SK Sturm Gra,119,3,17,10,9,56,32,24,61
Rapid Vienna,119,4,17,9,10,66,42,24,60
Vienna,119,5,16,6,14,56,52,4,54
RZ Pellets W,119,6,13,6,17,48,54,-6,45
St. Pölten,119,7,9,13,14,37,49,-12,40
Admira Wacke,119,8,11,7,18,33,60,-27,40
SV Josko Rie,119,9,9,8,19,35,55,-20,35
Mattersburg,119,10,6,9,21,28,61,-33,27
SC Rheindorf,120,1,23,5,8,62,40,22,74
FC Salzburg,120,2,20,7,9,61,30,31,67
SK Sturm Gra,120,3,19,7,10,55,35,20,64
Vienna,120,4,19,4,13,58,47,11,61
Rapid Vienna,120,5,13,11,12,53,44,9,50
Admira Wacke,120,6,12,8,16,39,51,-12,44
SV Josko Rie,120,7,11,8,17,31,48,-17,41
Mattersburg,120,8,9,8,19,38,57,-19,35
RZ Pellets W,120,9,9,7,20,39,59,-20,34
St. Pölten,120,10,8,9,19,41,66,-25,33
SC Rheindorf,121,1,20,8,8,55,38,17,68
FC Salzburg,121,2,19,9,8,71,34,37,66
SK Sturm Gra,121,3,19,8,9,56,30,26,65
Vienna,121,4,19,5,12,68,49,19,62
Rapid Vienna,121,5,13,14,9,56,43,13,53
RZ Pellets W,121,6,12,6,18,45,58,-13,42
Admira Wacke,121,7,11,7,18,31,56,-25,40
St. Pölten,121,8,9,10,17,41,61,-20,37
Mattersburg,121,9,7,13,16,39,62,-23,34
SV Josko Rie,121,10,7,8,21,28,59,-31,29
SC Rheindorf,122,1,22,8,6,62,37,25,74
SK Sturm Gra,122,2,22,5,9,59,28,31,71
Vienna,122,3,21,4,11,59,42,17,67
Rapid Vienna,122,4,16,10,10,56,38,18,58
FC Salzburg,122,5,16,9,11,61,39,22,57
Admira Wacke,122,6,13,4,19,37,61,-24,43
RZ Pellets W,122,7,11,6,19,42,63,-21,39
SV Josko Rie,122,8,10,4,22,32,51,-19,34
St. Pölten,122,9,8,9,19,37,62,-25,33
Mattersburg,122,10,8,7,21,37,61,-24,31
FC Salzburg,123,1,23,8,5,69,28,41,77
SK Sturm Gra,123,2,22,6,8,64,37,27,72
SC Rheindorf,123,3,18,7,11,64,47,17,61
Vienna,123,4,19,4,13,65,55,10,61
Rapid Vienna,123,5,15,10,11,52,35,17,55
Admira Wacke,123,6,13,6,17,34,50,-16,45
RZ Pellets W,123,7,11,7,18,46,60,-14,40
Mattersburg,123,8,9,6,21,33,60,-27,33
SV Josko Rie,123,9,8,8,20,25,50,-25,32
St. Pölten,123,10,6,10,20,39,69,-30,28
SC Rheindorf,124,1,20,8,8,65,44,21,68
SK Sturm Gra,124,2,19,6,11,60,36,24,63
FC Salzburg,124,3,18,8,10,57,30,27,62
Rapid Vienna,124,4,15,10,11,52,41,11,55
Vienna,124,5,16,6,14,64,64,0,54
Admira Wacke,124,6,13,6,17,38,56,-18,45
RZ Pellets W,124,7,12,8,16,41,53,-12,44
St. Pölten,124,8,10,10,16,47,60,-13,40
Mattersburg,124,9,9,8,19,38,55,-17,35
SV Josko Rie,124,10,9,8,19,35,58,-23,35
FC Salzburg,125,1,21,9,6,61,25,36,72
SC Rheindorf,125,2,20,8,8,53,40,13,68
Vienna,125,3,21,3,12,70,49,21,66
SK Sturm Gra,125,4,19,4,13,63,41,22,61
Rapid Vienna,125,5,13,11,12,52,42,10,50
RZ Pellets W,125,6,12,6,18,44,56,-12,42
Admira Wacke,125,7,12,5,19,42,65,-23,41
St. Pölten,125,8,11,6,19,46,68,-22,39
Mattersburg,125,9,9,10,17,39,56,-17,37
SV Josko Rie,125,10,9,4,23,28,56,-28,31
SC Rheindorf,126,1,19,8,9,54,38,16,65
FC Salzburg,126,2,18,10,8,61,30,31,64
SK Sturm Gra,126,3,19,7,10,61,39,22,64
Vienna,126,4,18,6,12,55,44,11,60
Rapid Vienna,126,5,16,8,12,59,41,18,56
RZ Pellets W,126,6,12,10,14,40,50,-10,46
Mattersburg,126,7,9,11,16,39,55,-16,38
SV Josko Rie,126,8,10,7,19,30,52,-22,37
Admira Wacke,126,9,8,10,18,31,56,-25,34
St. Pölten,126,10,8,9,19,40,65,-25,33
FC Salzburg,127,1,21,8,7,66,34,32,71
Vienna,127,2,20,8,8,67,44,23,68
SC Rheindorf,127,3,20,8,8,62,46,16,68
SK Sturm Gra,127,4,19,7,10,52,30,22,64
Rapid Vienna,127,5,11,12,13,50,44,6,45
Admira Wacke,127,6,12,9,15,38,53,-15,45
RZ Pellets W,127,7,12,6,18,41,49,-8,42
St. Pölten,127,8,10,8,18,42,69,-27,38
Mattersburg,127,9,9,6,21,40,62,-22,33
SV Josko Rie,127,10,8,4,24,32,59,-27,28
FC Salzburg,128,1,22,8,6,65,25,40,74
Rapid Vienna,128,2,20,8,8,65,34,31,68
SC Rheindorf,128,3,20,5,11,56,45,11,65
SK Sturm Gra,128,4,19,5,12,57,37,20,62
Vienna,128,5,17,5,14,62,56,6,56
Admira Wacke,128,6,13,6,17,39,55,-16,45
Mattersburg,128,7,11,6,19,40,58,-18,39
SV Josko Rie,128,8,10,4,22,29,53,-24,34
RZ Pellets W,128,9,9,6,21,45,68,-23,33
St. Pölten,128,10,8,9,19,45,72,-27,33
FC Salzburg,129,1,20,6,10,67,35,32,66
Vienna,129,2,20,4,12,69,54,15,64
SK Sturm Gra,129,3,20,4,12,57,46,11,64
SC Rheindorf,129,4,18,8,10,52,44,8,62
Rapid Vienna,129,5,15,10,11,62,42,20,55
SV Josko Rie,129,6,15,5,16,43,49,-6,50
Admira Wacke,129,7,12,4,20,35,60,-25,40
RZ Pellets W,129,8,11,6,19,46,54,-8,39
St. Pölten,129,9,9,9,18,41,65,-24,36
Mattersburg,129,10,7,10,19,39,62,-23,31
FC Salzburg,130,1,21,8,7,70,33,37,71
SK Sturm Gra,130,2,21,6,9,62,31,31,69
SC Rheindorf,130,3,20,7,9,62,40,22,67
Vienna,130,4,19,5,12,55,50,5,62
Rapid Vienna,130,5,17,8,11,59,36,23,59
Admira Wacke,130,6,14,5,17,41,57,-16,47
RZ Pellets W,130,7,10,5,21,40,61,-21,35
St. Pölten,130,8,7,13,16,38,61,-23,34
SV Josko Rie,130,9,9,7,20,30,58,-28,34
Mattersburg,130,10,5,10,21,33,63,-30,25
SC Rheindorf,131,1,22,7,7,65,44,21,73
FC Salzburg,131,2,19,6,11,67,43,24,63
Vienna,131,3,19,5,12,62,45,17,62
SK Sturm Gra,131,4,17,8,11,62,39,23,59
Rapid Vienna,131,5,13,14,9,57,41,16,53
St. Pölten,131,6,13,9,14,48,57,-9,48
Admira Wacke,131,7,13,5,18,41,62,-21,44
RZ Pellets W,131,8,11,10,15,47,56,-9,43
SV Josko Rie,131,9,9,5,22,27,54,-27,32
Mattersburg,131,10,4,11,21,29,64,-35,23
FC Salzburg,132,1,23,6,7,66,31,35,75
SK Sturm Gra,132,2,20,7,9,54,29,25,67
Vienna,132,3,19,3,14,68,55,13,60
SC Rheindorf,132,4,16,9,11,54,44,10,57
Rapid Vienna,132,5,13,11,12,49,37,12,50
RZ Pellets W,132,6,13,10,13,43,52,-9,49
Admira Wacke,132,7,12,5,19,38,61,-23,41
SV Josko Rie,132,8,9,10,17,32,47,-15,37
Mattersburg,132,9,8,10,18,35,54,-19,34
St. Pölten,132,10,7,9,20,37,66,-29,30
SC Rheindorf,133,1,22,7,7,60,39,21,73
SK Sturm Gra,133,2,21,5,10,74,32,42,68
FC Salzburg,133,3,18,9,9,62,33,29,63
Vienna,133,4,17,5,14,57,54,3,56
Rapid Vienna,133,5,13,11,12,48,35,13,50
RZ Pellets W,133,6,12,9,15,49,60,-11,45
Admira Wacke,133,7,13,5,18,39,65,-26,44
Mattersburg,133,8,9,11,16,38,53,-15,38
St. Pölten,133,9,9,7,20,37,65,-28,34
SV Josko Rie,133,10,8,7,21,29,57,-28,31
FC Salzburg,134,1,22,7,7,66,30,36,73
SK Sturm Gra,134,2,20,8,8,55,28,27,68
SC Rheindorf,134,3,17,9,10,48,42,6,60
Vienna,134,4,18,4,14,57,52,5,58
Rapid Vienna,134,5,14,10,12,52,38,14,52
Admira Wacke,134,6,12,7,17,42,56,-14,43
Mattersburg,134,7,12,6,18,39,49,-10,42
RZ Pellets W,134,8,12,6,18,40,59,-19,42
St. Pölten,134,9,9,8,19,40,58,-18,35
SV Josko Rie,134,10,9,5,22,31,58,-27,32
SC Rheindorf,135,1,23,6,7,58,34,24,75
FC Salzburg,135,2,20,5,11,64,34,30,65
SK Sturm Gra,135,3,19,5,12,54,37,17,62
Vienna,135,4,19,3,14,64,49,15,60
RZ Pellets W,135,5,18,5,13,52,50,2,59
Rapid Vienna,135,6,16,8,12,59,37,22,56
Admira Wacke,135,7,14,4,18,40,58,-18,46
SV Josko Rie,135,8,10,4,22,33,60,-27,34
Mattersburg,135,9,8,5,23,34,65,-31,29
St. Pölten,135,10,7,7,22,35,69,-34,28
FC Salzburg,136,1,19,9,8,61,34,27,66
SC Rheindorf,136,2,19,9,8,59,39,20,66
SK Sturm Gra,136,3,18,7,11,56,37,19,61
Vienna,136,4,18,5,13,64,53,11,59
Rapid Vienna,136,5,15,12,9,59,34,25,57
SV Josko Rie,136,6,14,5,17,39,49,-10,47
Mattersburg,136,7,12,8,16,50,57,-7,44
St. Pölten,136,8,8,11,17,39,63,-24,35
Admira Wacke,136,9,9,7,20,33,69,-36,34
RZ Pellets W,136,10,7,9,20,43,68,-25,30
SC Rheindorf,137,1,22,8,6,59,32,27,74
FC Salzburg,137,2,20,9,7,64,27,37,69
SK Sturm Gra,137,3,18,8,10,55,32,23,62
Vienna,137,4,16,8,12,60,55,5,56
Rapid Vienna,137,5,11,15,10,49,39,10,48
RZ Pellets W,137,6,12,9,15,47,58,-11,45
Admira Wacke,137,7,11,7,18,30,50,-20,40
Mattersburg,137,8,10,9,17,36,57,-21,39
SV Josko Rie,137,9,9,5,22,29,51,-22,32
St. Pölten,137,10,7,10,19,39,67,-28,31
FC Salzburg,138,1,23,8,5,71,31,40,77
SC Rheindorf,138,2,20,8,8,52,36,16,68
SK Sturm Gra,138,3,19,6,11,59,36,23,63
Vienna,138,4,19,5,12,60,47,13,62
RZ Pellets W,138,5,14,9,13,50,47,3,51
Admira Wacke,138,6,13,5,18,38,56,-18,44
Rapid Vienna,138,7,11,8,17,46,47,-1,41
Mattersburg,138,8,9,8,19,31,60,-29,35
SV Josko Rie,138,9,9,6,21,31,51,-20,33
St. Pölten,138,10,7,9,20,36,63,-27,30
FC Salzburg,139,1,22,8,6,70,31,39,74
SK Sturm Gra,139,2,22,6,8,67,36,31,72
Vienna,139,3,21,5,10,64,48,16,68
SC Rheindorf,139,4,16,8,12,54,47,7,56
Rapid Vienna,139,5,13,9,14,52,43,9,48
Admira Wacke,139,6,12,6,18,46,60,-14,42
SV Josko Rie,139,7,11,6,19,41,58,-17,39
RZ Pellets W,139,8,10,8,18,43,63,-20,38
Mattersburg,139,9,9,7,20,38,63,-25,34
St. Pölten,139,10,8,9,19,35,61,-26,33
FC Salzburg,140,1,26,5,5,76,25,51,83
SK Sturm Gra,140,2,20,7,9,66,36,30,67
SC Rheindorf,140,3,19,7,10,56,41,15,64
Vienna,140,4,19,5,12,62,54,8,62
Rapid Vienna,140,5,12,11,13,56,51,5,47
RZ Pellets W,140,6,11,10,15,43,53,-10,43
Mattersburg,140,7,10,8,18,39,55,-16,38
Admira Wacke,140,8,10,5,21,41,65,-24,35
St. Pölten,140,9,7,11,18,41,68,-27,32
SV Josko Rie,140,10,9,5,22,31,63,-32,32
FC Salzburg,141,1,22,7,7,76,36,40,73
SK Sturm Gra,141,2,23,4,9,71,39,32,73
SC Rheindorf,141,3,17,9,10,53,41,12,60
Vienna,141,4,18,4,14,62,57,5,58
Rapid Vienna,141,5,12,13,11,54,43,11,49
Mattersburg,141,6,10,11,15,38,50,-12,41
RZ Pellets W,141,7,11,7,18,43,60,-17,40
St. Pölten,141,8,10,10,16,41,60,-19,40
Admira Wacke,141,9,9,7,20,30,58,-28,34
SV Josko Rie,141,10,9,6,21,37,61,-24,33
FC Salzburg,142,1,21,8,7,60,27,33,71
SK Sturm Gra,142,2,20,7,9,55,27,28,67
Vienna,142,3,20,5,11,63,40,23,65
SC Rheindorf,142,4,16,10,10,49,39,10,58
RZ Pellets W,142,5,15,7,14,45,55,-10,52
Rapid Vienna,142,6,13,9,14,56,49,7,48
Admira Wacke,142,7,14,3,19,43,57,-14,45
SV Josko Rie,142,8,11,6,19,35,54,-19,39
Mattersburg,142,9,7,11,18,35,53,-18,32
St. Pölten,142,10,6,8,22,34,74,-40,26
SC Rheindorf,143,1,22,7,7,60,34,26,73
FC Salzburg,143,2,21,7,8,67,29,38,70
Vienna,143,3,21,5,10,64,47,17,68
SK Sturm Gra,143,4,17,8,11,54,35,19,59
Rapid Vienna,143,5,14,10,12,49,41,8,52
Admira Wacke,143,6,10,9,17,40,58,-18,39
St. Pölten,143,7,9,12,15,42,63,-21,39
SV Josko Rie,143,8,10,6,20,29,53,-24,36
RZ Pellets W,143,9,8,9,19,37,63,-26,33
Mattersburg,143,10,6,11,19,30,49,-19,29
SC Rheindorf,144,1,20,6,10,52,46,6,66
FC Salzburg,144,2,18,7,11,55,34,21,61
Vienna,144,3,19,4,13,70,64,6,61
SK Sturm Gra,144,4,17,7,12,53,36,17,58
Rapid Vienna,144,5,14,11,11,56,43,13,53
RZ Pellets W,144,6,13,6,17,47,55,-8,45
SV Josko Rie,144,7,13,5,18,41,50,-9,44
Admira Wacke,144,8,11,8,17,38,58,-20,41
St. Pölten,144,9,9,11,16,40,56,-16,38
Mattersburg,144,10,10,7,19,47,57,-10,37
FC Salzburg,145,1,21,8,7,66,33,33,71
SK Sturm Gra,145,2,20,9,7,62,30,32,69
SC Rheindorf,145,3,16,10,10,47,42,5,58
Vienna,145,4,17,7,12,65,61,4,58
Rapid Vienna,145,5,12,13,11,59,43,16,49
St. Pölten,145,6,9,14,13,42,57,-15,41
SV Josko Rie,145,7,12,5,19,38,53,-15,41
RZ Pellets W,145,8,9,10,17,40,58,-18,37
Admira Wacke,145,9,10,7,19,35,60,-25,37
Mattersburg,145,10,8,9,19,37,54,-17,33
FC Salzburg,146,1,20,7,9,67,37,30,67
SK Sturm Gra,146,2,19,9,8,58,27,31,66
SC Rheindorf,146,3,18,11,7,53,44,9,65
Rapid Vienna,146,4,15,11,10,59,35,24,56
Vienna,146,5,17,4,15,57,49,8,55
Admira Wacke,146,6,13,6,17,42,61,-19,45
RZ Pellets W,146,7,12,8,16,43,57,-14,44
SV Josko Rie,146,8,11,5,20,33,55,-22,38
St. Pölten,146,9,9,8,19,45,66,-21,35
Mattersburg,146,10,7,9,20,33,59,-26,30
FC Salzburg,147,1,22,7,7,63,29,34,73
SC Rheindorf,147,2,22,6,8,55,35,20,72
SK Sturm Gra,147,3,18,10,8,59,29,30,64
Rapid Vienna,147,4,17,8,11,57,38,19,59
Vienna,147,5,17,8,11,62,54,8,59
RZ Pellets W,147,6,12,8,16,41,51,-10,44
SV Josko Rie,147,7,10,8,18,30,50,-20,38
Admira Wacke,147,8,10,8,18,29,53,-24,38
St. Pölten,147,9,7,8,21,35,64,-29,29
Mattersburg,147,10,6,7,23,31,59,-28,25
SC Rheindorf,148,1,20,7,9,54,49,5,67
FC Salzburg,148,2,18,9,9,60,33,27,63
SK Sturm Gra,148,3,18,7,11,61,31,30,61
Rapid Vienna,148,4,16,10,10,52,37,15,58
RZ Pellets W,148,5,16,6,14,51,53,-2,54
Vienna,148,6,16,5,15,56,51,5,53
Admira Wacke,148,7,15,4,17,44,54,-10,49
SV Josko Rie,148,8,11,6,19,37,53,-16,39
St. Pölten,148,9,8,8,20,40,70,-30,32
Mattersburg,148,10,7,8,21,30,54,-24,29
FC Salzburg,149,1,23,8,5,70,30,40,77
SC Rheindorf,149,2,20,8,8,56,41,15,68
SK Sturm Gra,149,3,18,9,9,54,34,20,63
Vienna,149,4,18,6,12,65,53,12,60
Rapid Vienna,149,5,12,14,10,55,37,18,50
RZ Pellets W,149,6,13,7,16,43,52,-9,46
Admira Wacke,149,7,11,8,17,43,63,-20,41
SV Josko Rie,149,8,9,6,21,31,57,-26,33
Mattersburg,149,9,7,10,19,35,57,-22,31
St. Pölten,149,10,6,10,20,36,64,-28,28
FC Salzburg,150,1,20,11,5,64,24,40,71
SC Rheindorf,150,2,20,6,10,55,43,12,66
SK Sturm Gra,150,3,19,6,11,60,37,23,63
Vienna,150,4,17,6,13,63,55,8,57
Rapid Vienna,150,5,15,10,11,54,43,11,55
RZ Pellets W,150,6,13,7,16,50,58,-8,46
St. Pölten,150,7,11,8,17,49,63,-14,41
SV Josko Rie,150,8,10,7,19,31,50,-19,37
Admira Wacke,150,9,10,7,19,31,58,-27,37
Mattersburg,150,10,8,6,22,36,62,-26,30
FC Salzburg,151,1,23,7,6,70,30,40,76
SK Sturm Gra,151,2,23,4,9,63,28,35,73
SC Rheindorf,151,3,21,7,8,59,43,16,70
Vienna,151,4,17,6,13,60,55,5,57
Rapid Vienna,151,5,14,10,12,51,41,10,52
Admira Wacke,151,6,12,6,18,40,59,-19,42
RZ Pellets W,151,7,11,7,18,48,58,-10,40
St. Pölten,151,8,8,8,20,42,66,-24,32
Mattersburg,151,9,8,8,20,36,61,-25,32
SV Josko Rie,151,10,9,5,22,32,60,-28,32
Vienna,152,1,21,5,10,67,48,19,68
SK Sturm Gra,152,2,20,5,11,68,40,28,65
FC Salzburg,152,3,18,10,8,57,31,26,64
SC Rheindorf,152,4,16,8,12,47,45,2,56
Rapid Vienna,152,5,14,10,12,53,44,9,52
St. Pölten,152,6,11,11,14,45,55,-10,44
Admira Wacke,152,7,13,5,18,40,57,-17,44
Mattersburg,152,8,9,9,18,35,52,-17,36
RZ Pellets W,152,9,9,9,18,39,57,-18,36
SV Josko Rie,152,10,9,8,19,31,53,-22,35
FC Salzburg,153,1,21,11,4,63,23,40,74
SK Sturm Gra,153,2,18,10,8,53,27,26,64
Vienna,153,3,19,4,13,62,54,8,61
SC Rheindorf,153,4,17,7,12,52,41,11,58
Rapid Vienna,153,5,13,12,11,51,42,9,51
RZ Pellets W,153,6,14,5,17,51,59,-8,47
Admira Wacke,153,7,13,8,15,46,57,-11,47
St. Pölten,153,8,8,10,18,44,67,-23,34
SV Josko Rie,153,9,9,6,21,28,56,-28,33
Mattersburg,153,10,7,9,20,33,57,-24,30
FC Salzburg,154,1,23,6,7,72,29,43,75
SK Sturm Gra,154,2,21,5,10,63,33,30,68
SC Rheindorf,154,3,20,6,10,64,43,21,66
Vienna,154,4,20,2,14,71,59,12,62
Rapid Vienna,154,5,15,10,11,55,40,15,55
RZ Pellets W,154,6,12,8,16,49,57,-8,44
Admira Wacke,154,7,10,7,19,30,66,-36,37
St. Pölten,154,8,9,8,19,43,65,-22,35
Mattersburg,154,9,7,11,18,36,61,-25,32
SV Josko Rie,154,10,7,9,20,30,60,-30,30
FC Salzburg,155,1,25,5,6,71,29,42,80
SK Sturm Gra,155,2,22,4,10,66,34,32,70
SC Rheindorf,155,3,19,8,9,62,44,18,65
Vienna,155,4,18,4,14,70,58,12,58
Rapid Vienna,155,5,11,12,13,52,47,5,45
RZ Pellets W,155,6,12,8,16,46,60,-14,44
Admira Wacke,155,7,11,8,17,36,60,-24,41
SV Josko Rie,155,8,11,7,18,31,47,-16,40
St. Pölten,155,9,6,12,18,39,66,-27,30
Mattersburg,155,10,6,10,20,31,59,-28,28
SC Rheindorf,156,1,21,8,7,57,39,18,71
SK Sturm Gra,156,2,19,7,10,65,33,32,64
FC Salzburg,156,3,19,7,10,58,36,22,64
Vienna,156,4,20,2,14,64,56,8,62
Rapid Vienna,156,5,14,9,13,56,51,5,51
St. Pölten,156,6,13,8,15,51,58,-7,47
RZ Pellets W,156,7,14,4,18,41,55,-14,46
SV Josko Rie,156,8,10,7,19,35,49,-14,37
Mattersburg,156,9,8,9,19,38,55,-17,33
Admira Wacke,156,10,8,7,21,29,62,-33,31
FC Salzburg,157,1,21,7,8,63,31,32,70
SK Sturm Gra,157,2,20,4,12,61,39,22,64
Vienna,157,3,19,4,13,62,57,5,61
SC Rheindorf,157,4,17,8,11,51,41,10,59
Rapid Vienna,157,5,13,8,15,49,43,6,47
SV Josko Rie,157,6,14,5,17,44,51,-7,47
RZ Pellets W,157,7,13,7,16,52,58,-6,46
St. Pölten,157,8,11,7,18,43,65,-22,40
Mattersburg,157,9,10,8,18,44,58,-14,38
Admira Wacke,157,10,8,10,18,38,64,-26,34
FC Salzburg,158,1,24,5,7,78,31,47,77
SC Rheindorf,158,2,22,6,8,58,39,19,72
Vienna,158,3,19,5,12,62,52,10,62
Rapid Vienna,158,4,16,10,10,55,38,17,58
SK Sturm Gra,158,5,16,8,12,52,40,12,56
St. Pölten,158,6,12,9,15,46,59,-13,45
RZ Pellets W,158,7,11,8,17,49,59,-10,41
Admira Wacke,158,8,11,6,19,34,59,-25,39
SV Josko Rie,158,9,7,7,22,24,53,-29,28
Mattersburg,158,10,6,8,22,31,59,-28,26
FC Salzburg,159,1,21,8,7,71,37,34,71
Vienna,159,2,22,4,10,76,46,30,70
SC Rheindorf,159,3,20,8,8,65,47,18,68
SK Sturm Gra,159,4,17,9,10,60,36,24,60
Rapid Vienna,159,5,11,14,11,50,40,10,47
Admira Wacke,159,6,12,7,17,44,68,-24,43
SV Josko Rie,159,7,11,5,20,39,58,-19,38
Mattersburg,159,8,9,10,17,37,55,-18,37
RZ Pellets W,159,9,10,6,20,39,68,-29,36
St. Pölten,159,10,6,11,19,39,65,-26,29
FC Salzburg,160,1,20,8,8,66,29,37,68
SC Rheindorf,160,2,20,6,10,64,46,18,66
Vienna,160,3,19,4,13,56,48,8,61
SK Sturm Gra,160,4,17,8,11,55,36,19,59
Rapid Vienna,160,5,12,12,12,55,50,5,48
SV Josko Rie,160,6,13,6,17,36,51,-15,45
Admira Wacke,160,7,12,7,17,36,52,-16,43
RZ Pellets W,160,8,11,9,16,44,54,-10,42
Mattersburg,160,9,8,11,17,33,53,-20,35
St. Pölten,160,10,8,9,19,43,69,-26,33
FC Salzburg,161,1,22,7,7,65,30,35,73
SC Rheindorf,161,2,21,6,9,64,45,19,69
Vienna,161,3,20,7,9,67,45,22,67
SK Sturm Gra,161,4,18,7,11,61,32,29,61
Rapid Vienna,161,5,16,8,12,55,45,10,56
RZ Pellets W,161,6,12,6,18,46,58,-12,42
St. Pölten,161,7,11,8,17,49,66,-17,41
SV Josko Rie,161,8,10,7,19,38,56,-18,37
Admira Wacke,161,9,9,7,20,32,66,-34,34
Mattersburg,161,10,5,9,22,32,66,-34,24
FC Salzburg,162,1,23,7,6,65,27,38,76
SK Sturm Gra,162,2,21,5,10,62,33,29,68
SC Rheindorf,162,3,18,6,12,54,49,5,60
Vienna,162,4,18,4,14,56,47,9,58
Rapid Vienna,162,5,11,13,12,56,43,13,46
RZ Pellets W,162,6,12,6,18,52,61,-9,42
Admira Wacke,162,7,12,6,18,34,53,-19,42
SV Josko Rie,162,8,12,5,19,33,51,-18,41
Mattersburg,162,9,10,8,18,41,65,-24,38
St. Pölten,162,10,7,12,17,40,64,-24,33
FC Salzburg,163,1,23,5,8,74,34,40,74
SC Rheindorf,163,2,18,7,11,55,43,12,61
SK Sturm Gra,163,3,18,5,13,58,41,17,59
Vienna,163,4,17,4,15,59,59,0,55
Rapid Vienna,163,5,13,10,13,55,42,13,49
RZ Pellets W,163,6,13,6,17,50,60,-10,45
Admira Wacke,163,7,12,8,16,42,58,-16,44
SV Josko Rie,163,8,13,4,19,39,59,-20,43
Mattersburg,163,9,11,6,19,38,50,-12,39
St. Pölten,163,10,10,9,17,40,64,-24,39
Vienna,164,1,24,3,9,79,48,31,75
SC Rheindorf,164,2,21,5,10,54,44,10,68
SK Sturm Gra,164,3,20,7,9,59,34,25,67
FC Salzburg,164,4,18,11,7,63,31,32,65
Rapid Vienna,164,5,12,10,14,51,44,7,46
RZ Pellets W,164,6,12,10,14,44,51,-7,46
Admira Wacke,164,7,12,7,17,38,56,-18,43
St. Pölten,164,8,10,9,17,42,65,-23,39
Mattersburg,164,9,7,8,21,32,60,-28,29
SV Josko Rie,164,10,6,6,24,32,61,-29,24
FC Salzburg,165,1,20,8,8,63,31,32,68
SC Rheindorf,165,2,20,5,11,57,46,11,65
Vienna,165,3,19,7,10,69,50,19,64
SK Sturm Gra,165,4,18,6,12,51,34,17,60
Rapid Vienna,165,5,13,10,13,52,45,7,49
SV Josko Rie,165,6,14,4,18,37,56,-19,46
RZ Pellets W,165,7,13,6,17,51,60,-9,45
Admira Wacke,165,8,12,5,19,37,58,-21,41
St. Pölten,165,9,9,11,16,45,59,-14,38
Mattersburg,165,10,7,8,21,31,54,-23,29
FC Salzburg,166,1,20,8,8,65,34,31,68
SC Rheindorf,166,2,19,8,9,54,41,13,65
SK Sturm Gra,166,3,20,4,12,63,37,26,64
Rapid Vienna,166,4,17,9,10,55,37,18,60
Vienna,166,5,16,4,16,59,58,1,52
RZ Pellets W,166,6,12,8,16,46,62,-16,44
Mattersburg,166,7,11,9,16,38,50,-12,42
SV Josko Rie,166,8,11,6,19,35,54,-19,39
Admira Wacke,166,9,11,6,19,34,58,-24,39
St. Pölten,166,10,7,10,19,40,58,-18,31
FC Salzburg,167,1,21,8,7,63,26,37,71
Rapid Vienna,167,2,20,7,9,65,34,31,67
SC Rheindorf,167,3,19,9,8,58,45,13,66
SK Sturm Gra,167,4,18,7,11,51,34,17,61
Vienna,167,5,16,6,14,61,54,7,54
RZ Pellets W,167,6,13,6,17,45,55,-10,45
Admira Wacke,167,7,10,10,16,34,57,-23,40
St. Pölten,167,8,7,12,17,39,62,-23,33
SV Josko Rie,167,9,9,5,22,31,54,-23,32
Mattersburg,167,10,8,8,20,37,63,-26,32
SC Rheindorf,168,1,20,5,11,52,43,9,65
FC Salzburg,168,2,16,10,10,61,38,23,58
Vienna,168,3,16,8,12,66,57,9,56
SK Sturm Gra,168,4,16,7,13,55,40,15,55
Rapid Vienna,168,5,14,12,10,57,44,13,54
SV Josko Rie,168,6,15,4,17,46,56,-10,49
Admira Wacke,168,7,11,10,15,35,53,-18,43
Mattersburg,168,8,10,12,14,44,52,-8,42
St. Pölten,168,9,10,9,17,42,57,-15,39
RZ Pellets W,168,10,9,9,18,42,60,-18,36
FC Salzburg,169,1,20,8,8,65,33,32,68
Vienna,169,2,21,4,11,72,55,17,67
SC Rheindorf,169,3,19,7,10,53,47,6,64
SK Sturm Gra,169,4,18,6,12,61,35,26,60
Rapid Vienna,169,5,13,11,12,57,47,10,50
St. Pölten,169,6,12,9,15,42,58,-16,45
RZ Pellets W,169,7,11,9,16,38,54,-16,42
Admira Wacke,169,8,12,6,18,33,54,-21,42
SV Josko Rie,169,9,11,5,20,40,56,-16,38
Mattersburg,169,10,7,7,22,43,65,-22,28
FC Salzburg,170,1,23,5,8,63,33,30,74
SC Rheindorf,170,2,19,8,9,53,37,16,65
Vienna,170,3,19,5,12,68,46,22,62
SK Sturm Gra,170,4,19,5,12,55,33,22,62
Rapid Vienna,170,5,16,10,10,59,33,26,58
RZ Pellets W,170,6,14,7,15,54,58,-4,49
Admira Wacke,170,7,12,4,20,35,63,-28,40
SV Josko Rie,170,8,12,3,21,30,54,-24,39
St. Pölten,170,9,7,11,18,34,64,-30,32
Mattersburg,170,10,6,8,22,31,61,-30,26
FC Salzburg,171,1,21,8,7,61,27,34,71
SC Rheindorf,171,2,22,5,9,57,42,15,71
Vienna,171,3,19,5,12,61,48,13,62
SK Sturm Gra,171,4,17,9,10,54,30,24,60
Rapid Vienna,171,5,11,13,12,46,39,7,46
SV Josko Rie,171,6,12,4,20,38,53,-15,40
Admira Wacke,171,7,11,7,18,38,64,-26,40
RZ Pellets W,171,8,10,9,17,39,53,-14,39
St. Pölten,171,9,10,9,17,40,58,-18,39
Mattersburg,171,10,8,9,19,36,56,-20,33
FC Salzburg,172,1,22,7,7,61,28,33,73
SK Sturm Gra,172,2,20,6,10,58,32,26,66
SC Rheindorf,172,3,20,6,10,62,47,15,66
Vienna,172,4,18,8,10,66,51,15,62
Rapid Vienna,172,5,15,10,11,57,39,18,55
RZ Pellets W,172,6,14,7,15,56,60,-4,49
SV Josko Rie,172,7,13,5,18,36,54,-18,44
Admira Wacke,172,8,8,7,21,36,65,-29,31
St. Pölten,172,9,7,9,20,39,69,-30,30
Mattersburg,172,10,6,9,21,35,61,-26,27
SC Rheindorf,173,1,23,7,6,65,40,25,76
FC Salzburg,173,2,21,6,9,67,32,35,69
SK Sturm Gra,173,3,21,4,11,60,35,25,67
Vienna,173,4,16,3,17,61,58,3,51
Rapid Vienna,173,5,13,11,12,54,45,9,50
RZ Pellets W,173,6,14,8,14,51,50,1,50
Admira Wacke,173,7,11,6,19,36,59,-23,39
SV Josko Rie,173,8,11,5,20,36,59,-23,38
Mattersburg,173,9,9,9,18,36,58,-22,36
St. Pölten,173,10,8,7,21,39,69,-30,31
FC Salzburg,174,1,23,6,7,70,33,37,75
SC Rheindorf,174,2,20,10,6,64,45,19,70
Vienna,174,3,21,3,12,76,55,21,66
SK Sturm Gra,174,4,19,4,13,63,42,21,61
Admira Wacke,174,5,14,5,17,44,62,-18,47
Rapid Vienna,174,6,12,9,15,52,47,5,45
Mattersburg,174,7,11,9,16,45,54,-9,42
RZ Pellets W,174,8,12,6,18,44,60,-16,42
St. Pölten,174,9,7,11,18,44,73,-29,32
SV Josko Rie,174,10,7,5,24,35,66,-31,26
FC Salzburg,175,1,21,6,9,63,29,34,69
SK Sturm Gra,175,2,20,7,9,62,32,30,67
SC Rheindorf,175,3,20,6,10,59,43,16,66
Vienna,175,4,20,4,12,69,55,14,64
RZ Pellets W,175,5,16,5,15,49,52,-3,53
Rapid Vienna,175,6,11,12,13,49,43,6,45
Admira Wacke,175,7,11,5,20,40,67,-27,38
Mattersburg,175,8,9,9,18,38,57,-19,36
SV Josko Rie,175,9,10,4,22,31,53,-22,34
St. Pölten,175,10,8,10,18,42,71,-29,34
FC Salzburg,176,1,20,9,7,61,31,30,69
SK Sturm Gra,176,2,21,5,10,61,35,26,68
SC Rheindorf,176,3,18,7,11,59,47,12,61
Vienna,176,4,17,4,15,57,59,-2,55
Rapid Vienna,176,5,11,15,10,52,40,12,48
St. Pölten,176,6,13,9,14,54,59,-5,48
Admira Wacke,176,7,11,9,16,36,55,-19,42
RZ Pellets W,176,8,11,7,18,42,56,-14,40
Mattersburg,176,9,9,9,18,39,51,-12,36
SV Josko Rie,176,10,10,4,22,35,63,-28,34
FC Salzburg,177,1,26,5,5,78,29,49,83
SC Rheindorf,177,2,18,9,9,57,40,17,63
Vienna,177,3,19,3,14,66,58,8,60
SK Sturm Gra,177,4,18,4,14,58,42,16,58
Rapid Vienna,177,5,12,11,13,53,45,8,47
St. Pölten,177,6,12,8,16,47,63,-16,44
RZ Pellets W,177,7,11,10,15,44,54,-10,43
SV Josko Rie,177,8,12,4,20,32,53,-21,40
Admira Wacke,177,9,10,6,20,38,69,-31,36
Mattersburg,177,10,6,12,18,34,54,-20,30
FC Salzburg,178,1,19,8,9,61,36,25,65
SK Sturm Gra,178,2,18,9,9,58,33,25,63
SC Rheindorf,178,3,18,8,10,57,43,14,62
Vienna,178,4,18,4,14,57,54,3,58
RZ Pellets W,178,5,14,10,12,55,54,1,52
Rapid Vienna,178,6,12,12,12,51,41,10,48
SV Josko Rie,178,7,12,6,18,34,49,-15,42
Admira Wacke,178,8,11,9,16,33,53,-20,42
St. Pölten,178,9,8,11,17,48,71,-23,35
Mattersburg,178,10,8,7,21,38,58,-20,31
SK Sturm Gra,179,1,22,6,8,67,34,33,72
SC Rheindorf,179,2,21,6,9,66,44,22,69
FC Salzburg,179,3,20,6,10,64,32,32,66
Vienna,179,4,20,5,11,67,45,22,65
Rapid Vienna,179,5,12,10,14,50,48,2,46
SV Josko Rie,179,6,12,7,17,37,47,-10,43
RZ Pellets W,179,7,11,9,16,43,61,-18,42
Admira Wacke,179,8,10,7,19,33,64,-31,37
St. Pölten,179,9,8,9,19,44,67,-23,33
Mattersburg,179,10,6,11,19,33,62,-29,29
SK Sturm Gra,180,1,20,9,7,69,36,33,69
FC Salzburg,180,2,19,8,9,69,36,33,65
Vienna,180,3,20,4,12,67,53,14,64
Rapid Vienna,180,4,17,10,9,62,44,18,61
SC Rheindorf,180,5,17,8,11,49,42,7,59
RZ Pellets W,180,6,13,9,14,50,50,0,48
Admira Wacke,180,7,9,10,17,41,65,-24,37
Mattersburg,180,8,8,10,18,39,61,-22,34
SV Josko Rie,180,9,9,5,22,31,54,-23,32
St. Pölten,180,10,6,11,19,33,69,-36,29
SK Sturm Gra,181,1,24,5,7,66,32,34,77
FC Salzburg,181,2,23,7,6,72,28,44,76
SC Rheindorf,181,3,19,5,12,55,46,9,62
Vienna,181,4,16,5,15,62,56,6,53
Rapid Vienna,181,5,12,11,13,50,43,7,47
RZ Pellets W,181,6,13,8,15,48,60,-12,47
Admira Wacke,181,7,11,9,16,40,55,-15,42
SV Josko Rie,181,8,11,4,21,36,60,-24,37
Mattersburg,181,9,9,8,19,38,59,-21,35
St. Pölten,181,10,7,8,21,44,72,-28,29
FC Salzburg,182,1,20,11,5,61,31,30,71
SC Rheindorf,182,2,21,6,9,65,45,20,69
SK Sturm Gra,182,3,17,7,12,55,38,17,58
Vienna,182,4,17,6,13,59,58,1,57
Rapid Vienna,182,5,13,11,12,57,45,12,50
RZ Pellets W,182,6,12,11,13,41,48,-7,47
Admira Wacke,182,7,12,5,19,42,59,-17,41
Mattersburg,182,8,11,6,19,45,62,-17,39
St. Pölten,182,9,8,10,18,42,60,-18,34
SV Josko Rie,182,10,9,7,20,35,56,-21,34
SK Sturm Gra,183,1,21,5,10,60,35,25,68
Vienna,183,2,20,4,12,74,57,17,64
SC Rheindorf,183,3,19,7,10,59,47,12,64
FC Salzburg,183,4,19,5,12,65,36,29,62
Rapid Vienna,183,5,12,13,11,52,44,8,49
Admira Wacke,183,6,13,6,17,42,57,-15,45
St. Pölten,183,7,10,11,15,46,60,-14,41
SV Josko Rie,183,8,12,5,19,37,53,-16,41
Mattersburg,183,9,9,9,18,38,62,-24,36
RZ Pellets W,183,10,8,9,19,40,62,-22,33
SC Rheindorf,184,1,19,6,11,51,39,12,63
Vienna,184,2,18,5,13,64,52,12,59
SK Sturm Gra,184,3,17,6,13,59,44,15,57
Rapid Vienna,184,4,14,12,10,57,42,15,54
FC Salzburg,184,5,16,6,14,55,40,15,54
RZ Pellets W,184,6,15,8,13,55,56,-1,53
Admira Wacke,184,7,13,6,17,44,58,-14,45
St. Pölten,184,8,11,9,16,48,65,-17,42
SV Josko Rie,184,9,10,9,17,32,52,-20,39
Mattersburg,184,10,10,7,19,37,54,-17,37
FC Salzburg,185,1,22,9,5,67,29,38,75
SK Sturm Gra,185,2,20,6,10,63,36,27,66
SC Rheindorf,185,3,18,11,7,54,41,13,65
Vienna,185,4,20,4,12,59,46,13,64
Rapid Vienna,185,5,15,11,10,63,42,21,56
RZ Pellets W,185,6,13,8,15,45,52,-7,47
Admira Wacke,185,7,10,6,20,34,60,-26,36
St. Pölten,185,8,8,11,17,40,65,-25,35
Mattersburg,185,9,7,7,22,40,65,-25,28
SV Josko Rie,185,10,7,7,22,33,62,-29,28
SK Sturm Gra,186,1,22,8,6,66,28,38,74
FC Salzburg,186,2,21,9,6,66,28,38,72
SC Rheindorf,186,3,18,7,11,52,46,6,61
Vienna,186,4,18,5,13,65,55,10,59
Rapid Vienna,186,5,15,11,10,58,44,14,56
RZ Pellets W,186,6,12,6,18,44,57,-13,42
Admira Wacke,186,7,11,4,21,42,67,-25,37
St. Pölten,186,8,9,10,17,41,66,-25,37
SV Josko Rie,186,9,10,4,22,39,62,-23,34
Mattersburg,186,10,7,10,19,36,56,-20,31
FC Salzburg,187,1,19,11,6,61,31,30,68
SK Sturm Gra,187,2,18,10,8,55,33,22,64
SC Rheindorf,187,3,18,8,10,50,39,11,62
Vienna,187,4,18,6,12,60,52,8,60
RZ Pellets W,187,5,14,10,12,53,51,2,52
Rapid Vienna,187,6,12,10,14,54,43,11,46
Mattersburg,187,7,11,7,18,43,53,-10,40
Admira Wacke,187,8,10,10,16,36,59,-23,40
SV Josko Rie,187,9,9,10,17,34,49,-15,37
St. Pölten,187,10,6,8,22,39,75,-36,26
FC Salzburg,188,1,21,9,6,66,32,34,72
SC Rheindorf,188,2,22,6,8,60,39,21,72
Vienna,188,3,19,3,14,61,49,12,60
SK Sturm Gra,188,4,18,5,13,54,37,17,59
Rapid Vienna,188,5,16,9,11,56,39,17,57
RZ Pellets W,188,6,15,6,15,46,48,-2,51
Admira Wacke,188,7,10,8,18,36,64,-28,38
St. Pölten,188,8,8,12,16,39,57,-18,36
SV Josko Rie,188,9,9,5,22,34,60,-26,32
Mattersburg,188,10,6,9,21,32,59,-27,27
SK Sturm Gra,189,1,23,6,7,66,35,31,75
FC Salzburg,189,2,20,8,8,66,31,35,68
SC Rheindorf,189,3,20,8,8,57,35,22,68
Vienna,189,4,17,5,14,65,58,7,56
Rapid Vienna,189,5,12,14,10,51,37,14,50
RZ Pellets W,189,6,11,10,15,42,55,-13,43
Mattersburg,189,7,9,10,17,40,59,-19,37
Admira Wacke,189,8,9,8,19,35,62,-27,35
SV Josko Rie,189,9,10,4,22,33,63,-30,34
St. Pölten,189,10,8,9,19,40,60,-20,33
FC Salzburg,190,1,20,10,6,66,29,37,70
SC Rheindorf,190,2,20,9,7,63,41,22,69
Vienna,190,3,21,4,11,64,54,10,67
SK Sturm Gra,190,4,18,10,8,54,28,26,64
Rapid Vienna,190,5,13,14,9,50,36,14,53
Admira Wacke,190,6,13,5,18,41,58,-17,44
SV Josko Rie,190,7,10,6,20,38,61,-23,36
Mattersburg,190,8,8,9,19,34,54,-20,33
St. Pölten,190,9,8,8,20,39,66,-27,32
RZ Pellets W,190,10,8,7,21,40,62,-22,31
FC Salzburg,191,1,20,10,6,61,28,33,70
SK Sturm Gra,191,2,20,6,10,69,40,29,66
SC Rheindorf,191,3,18,8,10,54,48,6,62
Rapid Vienna,191,4,15,13,8,58,35,23,58
Vienna,191,5,15,9,12,64,55,9,54
RZ Pellets W,191,6,12,9,15,50,61,-11,45
SV Josko Rie,191,7,12,5,19,38,56,-18,41
Admira Wacke,191,8,10,8,18,35,57,-22,38
Mattersburg,191,9,8,9,19,36,56,-20,33
St. Pölten,191,10,7,9,20,42,71,-29,30
FC Salzburg,192,1,23,8,5,69,26,43,77
SK Sturm Gra,192,2,20,7,9,65,36,29,67
SC Rheindorf,192,3,19,7,10,59,46,13,64
Vienna,192,4,18,5,13,67,61,6,59
Rapid Vienna,192,5,12,9,15,58,46,12,45
RZ Pellets W,192,6,12,6,18,42,58,-16,42
SV Josko Rie,192,7,11,8,17,42,54,-12,41
Admira Wacke,192,8,10,9,17,35,62,-27,39
St. Pölten,192,9,9,9,18,41,65,-24,36
Mattersburg,192,10,6,12,18,38,62,-24,30
SK Sturm Gra,193,1,23,4,9,67,33,34,73
FC Salzburg,193,2,20,9,7,62,31,31,69
SC Rheindorf,193,3,17,12,7,60,40,20,63
Vienna,193,4,17,7,12,63,56,7,58
Rapid Vienna,193,5,11,12,13,57,45,12,45
RZ Pellets W,193,6,11,9,16,47,64,-17,42
SV Josko Rie,193,7,10,10,16,40,57,-17,40
Mattersburg,193,8,9,11,16,40,54,-14,38
Admira Wacke,193,9,9,7,20,41,69,-28,34
St. Pölten,193,10,8,9,19,46,74,-28,33
FC Salzburg,194,1,24,6,6,66,26,40,78
SC Rheindorf,194,2,21,5,10,60,41,19,68
SK Sturm Gra,194,3,20,6,10,60,34,26,66
Vienna,194,4,20,4,12,64,53,11,64
Rapid Vienna,194,5,13,10,13,52,45,7,49
RZ Pellets W,194,6,11,9,16,38,49,-11,42
Admira Wacke,194,7,13,3,20,40,63,-23,42
St. Pölten,194,8,8,10,18,40,59,-19,34
SV Josko Rie,194,9,10,4,22,36,66,-30,34
Mattersburg,194,10,7,9,20,35,55,-20,30
FC Salzburg,195,1,21,8,7,63,28,35,71
SC Rheindorf,195,2,18,10,8,56,44,12,64
SK Sturm Gra,195,3,18,5,13,51,31,20,59
Vienna,195,4,18,5,13,59,53,6,59
Rapid Vienna,195,5,14,9,13,53,41,12,51
RZ Pellets W,195,6,14,6,16,48,59,-11,48
St. Pölten,195,7,13,8,15,44,53,-9,47
SV Josko Rie,195,8,10,8,18,38,54,-16,38
Mattersburg,195,9,8,10,18,34,52,-18,34
Admira Wacke,195,10,9,5,22,34,65,-31,32
FC Salzburg,196,1,21,6,9,61,34,27,69
SC Rheindorf,196,2,19,7,10,57,42,15,64
Vienna,196,3,19,4,13,69,56,13,61
SK Sturm Gra,196,4,16,8,12,58,35,23,56
Rapid Vienna,196,5,15,9,12,59,47,12,54
RZ Pellets W,196,6,16,6,14,43,50,-7,54
Admira Wacke,196,7,14,5,17,40,60,-20,47
St. Pölten,196,8,10,10,16,44,59,-15,40
SV Josko Rie,196,9,10,6,20,39,59,-20,36
Mattersburg,196,10,5,9,22,32,60,-28,24
FC Salzburg,197,1,20,8,8,64,35,29,68
Vienna,197,2,20,4,12,68,48,20,64
SK Sturm Gra,197,3,19,6,11,62,28,34,63
SC Rheindorf,197,4,18,9,9,53,41,12,63
Rapid Vienna,197,5,14,12,10,59,41,18,54
RZ Pellets W,197,6,14,5,17,44,57,-13,47
Admira Wacke,197,7,12,6,18,37,62,-25,42
St. Pölten,197,8,11,7,18,45,67,-22,40
Mattersburg,197,9,8,8,20,40,68,-28,32
SV Josko Rie,197,10,8,7,21,27,52,-25,31
FC Salzburg,198,1,22,6,8,63,35,28,72
SK Sturm Gra,198,2,19,9,8,55,28,27,66
SC Rheindorf,198,3,17,10,9,49,40,9,61
Vienna,198,4,16,10,10,55,48,7,58
Rapid Vienna,198,5,15,10,11,53,38,15,55
Mattersburg,198,6,10,9,17,43,52,-9,39
SV Josko Rie,198,7,11,5,20,37,56,-19,38
St. Pölten,198,8,10,7,19,50,65,-15,37
RZ Pellets W,198,9,9,9,18,42,61,-19,36
Admira Wacke,198,10,8,11,17,32,56,-24,35
FC Salzburg,199,1,20,10,6,65,29,36,70
SK Sturm Gra,199,2,19,10,7,63,35,28,67
SC Rheindorf,199,3,19,7,10,52,39,13,64
Vienna,199,4,17,8,11,62,52,10,59
Rapid Vienna,199,5,15,11,10,57,38,19,56
RZ Pellets W,199,6,13,9,14,50,58,-8,48
Admira Wacke,199,7,11,7,18,34,60,-26,40
Mattersburg,199,8,10,8,18,37,57,-20,38
SV Josko Rie,199,9,8,5,23,33,59,-26,29
St. Pölten,199,10,6,9,21,45,71,-26,27
FC Salzburg,200,1,21,6,9,65,33,32,69
SK Sturm Gra,200,2,21,5,10,59,33,26,68
SC Rheindorf,200,3,19,7,10,50,40,10,64
Vienna,200,4,19,4,13,67,54,13,61
Admira Wacke,200,5,14,6,16,36,53,-17,48
Rapid Vienna,200,6,11,11,14,53,44,9,44
RZ Pellets W,200,7,10,10,16,47,61,-14,40
SV Josko Rie,200,8,11,6,19,32,52,-20,39
Mattersburg,200,9,10,7,19,35,53,-18,37
St. Pölten,200,10,8,10,18,39,60,-21,34
FC Salzburg,201,1,23,6,7,62,23,39,75
SC Rheindorf,201,2,21,9,6,58,37,21,72
Vienna,201,3,19,6,11,70,48,22,63
SK Sturm Gra,201,4,17,8,11,58,41,17,59
Rapid Vienna,201,5,12,10,14,55,44,11,46
St. Pölten,201,6,11,11,14,47,62,-15,44
SV Josko Rie,201,7,12,5,19,39,55,-16,41
RZ Pellets W,201,8,11,5,20,38,57,-19,38
Mattersburg,201,9,8,8,20,33,58,-25,32
Admira Wacke,201,10,8,8,20,32,67,-35,32
SK Sturm Gra,202,1,23,5,8,64,28,36,74
SC Rheindorf,202,2,21,9,6,59,36,23,72
Rapid Vienna,202,3,15,10,11,57,40,17,55
FC Salzburg,202,4,15,7,14,53,36,17,52
Vienna,202,5,15,6,15,56,57,-1,51
Admira Wacke,202,6,13,7,16,39,62,-23,46
RZ Pellets W,202,7,11,8,17,43,54,-11,41
St. Pölten,202,8,11,7,18,41,61,-20,40
Mattersburg,202,9,10,9,17,36,53,-17,39
SV Josko Rie,202,10,9,6,21,34,55,-21,33
FC Salzburg,203,1,22,7,7,67,29,38,73
SK Sturm Gra,203,2,19,7,10,64,34,30,64
SC Rheindorf,203,3,19,7,10,51,39,12,64
Vienna,203,4,19,5,12,67,57,10,62
Rapid Vienna,203,5,14,12,10,57,39,18,54
RZ Pellets W,203,6,11,10,15,46,53,-7,43
Admira Wacke,203,7,12,7,17,34,54,-20,43
Mattersburg,203,8,11,5,20,34,55,-21,38
SV Josko Rie,203,9,9,6,21,32,59,-27,33
St. Pölten,203,10,4,14,18,40,73,-33,26
FC Salzburg,204,1,21,7,8,66,31,35,70
SC Rheindorf,204,2,21,6,9,53,43,10,69
SK Sturm Gra,204,3,18,7,11,58,38,20,61
Vienna,204,4,16,8,12,59,57,2,56
Rapid Vienna,204,5,14,10,12,56,43,13,52
Admira Wacke,204,6,13,8,15,44,54,-10,47
RZ Pellets W,204,7,13,7,16,51,55,-4,46
Mattersburg,204,8,9,10,17,43,58,-15,37
St. Pölten,204,9,8,12,16,44,65,-21,36
SV Josko Rie,204,10,7,5,24,30,60,-30,26
FC Salzburg,205,1,23,6,7,74,27,47,75
SC Rheindorf,205,2,22,8,6,68,41,27,74
SK Sturm Gra,205,3,22,4,10,62,34,28,70
Vienna,205,4,16,5,15,64,65,-1,53
Rapid Vienna,205,5,13,9,14,54,49,5,48
RZ Pellets W,205,6,14,5,17,46,54,-8,47
Admira Wacke,205,7,13,5,18,40,57,-17,44
SV Josko Rie,205,8,10,6,20,34,58,-24,36
St. Pölten,205,9,8,10,18,46,69,-23,34
Mattersburg,205,10,5,10,21,34,68,-34,25
FC Salzburg,206,1,25,7,4,76,31,45,82
SC Rheindorf,206,2,20,8,8,53,40,13,68
SK Sturm Gra,206,3,18,9,9,60,31,29,63
Vienna,206,4,18,6,12,62,49,13,60
Rapid Vienna,206,5,15,11,10,57,45,12,56
RZ Pellets W,206,6,12,9,15,50,57,-7,45
Admira Wacke,206,7,11,6,19,37,62,-25,39
SV Josko Rie,206,8,9,5,22,30,58,-28,32
St. Pölten,206,9,5,12,19,36,63,-27,27
Mattersburg,206,10,5,11,20,33,58,-25,26
FC Salzburg,207,1,23,6,7,65,32,33,75
SK Sturm Gra,207,2,22,4,10,65,34,31,70
Rapid Vienna,207,3,19,7,10,69,42,27,64
SC Rheindorf,207,4,19,6,11,49,43,6,63
Vienna,207,5,18,4,14,62,48,14,58
Admira Wacke,207,6,13,6,17,38,55,-17,45
RZ Pellets W,207,7,12,5,19,41,58,-17,41
Mattersburg,207,8,9,7,20,41,61,-20,34
SV Josko Rie,207,9,9,4,23,31,58,-27,31
St. Pölten,207,10,8,7,21,42,72,-30,31
SC Rheindorf,208,1,21,6,9,60,38,22,69
FC Salzburg,208,2,20,7,9,65,33,32,67
Vienna,208,3,18,5,13,56,51,5,59
Rapid Vienna,208,4,16,10,10,60,41,19,58
SK Sturm Gra,208,5,17,7,12,61,50,11,58
Admira Wacke,208,6,13,7,16,38,54,-16,46
SV Josko Rie,208,7,13,6,17,46,52,-6,45
RZ Pellets W,208,8,13,4,19,48,63,-15,43
St. Pölten,208,9,8,11,17,47,67,-20,35
Mattersburg,208,10,4,11,21,34,66,-32,23
FC Salzburg,209,1,21,7,8,69,28,41,70
SC Rheindorf,209,2,21,6,9,64,45,19,69
SK Sturm Gra,209,3,19,9,8,61,39,22,66
Rapid Vienna,209,4,15,10,11,62,44,18,55
Vienna,209,5,16,6,14,58,50,8,54
RZ Pellets W,209,6,14,9,13,49,51,-2,51
Admira Wacke,209,7,12,6,18,38,65,-27,42
SV Josko Rie,209,8,10,7,19,34,54,-20,37
St. Pölten,209,9,7,9,20,40,68,-28,30
Mattersburg,209,10,6,9,21,31,62,-31,27
SK Sturm Gra,210,1,24,4,8,62,31,31,76
FC Salzburg,210,2,21,7,8,65,32,33,70
SC Rheindorf,210,3,19,7,10,61,43,18,64
Vienna,210,4,17,6,13,64,57,7,57
Rapid Vienna,210,5,15,9,12,56,40,16,54
RZ Pellets W,210,6,13,8,15,51,56,-5,47
Admira Wacke,210,7,12,4,20,39,69,-30,40
SV Josko Rie,210,8,10,7,19,38,55,-17,37
St. Pölten,210,9,8,9,19,42,66,-24,33
Mattersburg,210,10,7,7,22,35,64,-29,28
FC Salzburg,211,1,25,4,7,68,30,38,79
SK Sturm Gra,211,2,20,6,10,58,32,26,66
Vienna,211,3,20,5,11,64,49,15,65
SC Rheindorf,211,4,17,9,10,47,39,8,60
RZ Pellets W,211,5,16,6,14,48,45,3,54
Rapid Vienna,211,6,12,12,12,52,44,8,48
Admira Wacke,211,7,13,4,19,38,55,-17,43
Mattersburg,211,8,10,6,20,35,59,-24,36
St. Pölten,211,9,8,8,20,41,65,-24,32
SV Josko Rie,211,10,7,4,25,27,60,-33,25
FC Salzburg,212,1,23,6,7,78,32,46,75
SC Rheindorf,212,2,21,6,9,61,41,20,69
SK Sturm Gra,212,3,19,7,10,58,34,24,64
Vienna,212,4,17,5,14,63,66,-3,56
Rapid Vienna,212,5,14,11,11,59,42,17,53
Admira Wacke,212,6,11,9,16,40,60,-20,42
St. Pölten,212,7,10,10,16,46,61,-15,40
RZ Pellets W,212,8,9,11,16,44,58,-14,38
SV Josko Rie,212,9,8,8,20,32,64,-32,32
Mattersburg,212,10,8,7,21,39,62,-23,31
FC Salzburg,213,1,22,7,7,62,26,36,73
SC Rheindorf,213,2,22,7,7,64,40,24,73
SK Sturm Gra,213,3,21,6,9,60,29,31,69
Vienna,213,4,19,4,13,59,49,10,61
Admira Wacke,213,5,14,5,17,38,57,-19,47
RZ Pellets W,213,6,13,6,17,46,59,-13,45
Rapid Vienna,213,7,11,10,15,47,40,7,43
St. Pölten,213,8,8,10,18,41,61,-20,34
SV Josko Rie,213,9,8,7,21,31,59,-28,31
Mattersburg,213,10,6,10,20,33,61,-28,28
FC Salzburg,214,1,22,9,5,70,26,44,75
SC Rheindorf,214,2,17,12,7,55,42,13,63
SK Sturm Gra,214,3,17,11,8,58,34,24,62
Vienna,214,4,18,6,12,61,54,7,60
Rapid Vienna,214,5,14,10,12,58,42,16,52
Admira Wacke,214,6,12,7,17,39,55,-16,43
St. Pölten,214,7,10,8,18,39,65,-26,38
Mattersburg,214,8,9,9,18,37,57,-20,36
RZ Pellets W,214,9,9,8,19,38,61,-23,35
SV Josko Rie,214,10,10,4,22,31,50,-19,34
SK Sturm Gra,215,1,24,4,8,65,26,39,76
Vienna,215,2,19,5,12,65,53,12,62
SC Rheindorf,215,3,17,8,11,53,46,7,59
FC Salzburg,215,4,17,7,12,54,40,14,58
Rapid Vienna,215,5,14,11,11,61,41,20,53
RZ Pellets W,215,6,15,6,15,53,54,-1,51
Mattersburg,215,7,11,7,18,43,56,-13,40
Admira Wacke,215,8,11,7,18,35,60,-25,40
SV Josko Rie,215,9,11,4,21,36,58,-22,37
St. Pölten,215,10,5,13,18,37,68,-31,28
FC Salzburg,216,1,24,6,6,72,31,41,78
SC Rheindorf,216,2,22,5,9,60,40,20,71
SK Sturm Gra,216,3,21,5,10,61,33,28,68
Vienna,216,4,16,10,10,60,49,11,58
Rapid Vienna,216,5,15,9,12,50,37,13,54
SV Josko Rie,216,6,11,6,19,39,59,-20,39
RZ Pellets W,216,7,10,6,20,44,63,-19,36
Admira Wacke,216,8,9,8,19,35,60,-25,35
Mattersburg,216,9,8,9,19,37,62,-25,33
St. Pölten,216,10,8,8,20,39,63,-24,32
FC Salzburg,217,1,22,9,5,71,29,42,75
SC Rheindorf,217,2,19,8,9,59,47,12,65
SK Sturm Gra,217,3,20,4,12,61,41,20,64
Rapid Vienna,217,4,16,11,9,69,44,25,59
Vienna,217,5,14,8,14,57,55,2,50
RZ Pellets W,217,6,14,6,16,47,53,-6,48
Admira Wacke,217,7,13,5,18,41,64,-23,44
SV Josko Rie,217,8,9,8,19,37,58,-21,35
Mattersburg,217,9,8,10,18,40,59,-19,34
St. Pölten,217,10,6,9,21,38,70,-32,27
SK Sturm Gra,218,1,22,5,9,66,34,32,71
FC Salzburg,218,2,17,10,9,59,34,25,61
Rapid Vienna,218,3,16,11,9,59,36,23,59
SC Rheindorf,218,4,16,9,11,52,45,7,57
Vienna,218,5,17,5,14,66,63,3,56
RZ Pellets W,218,6,13,6,17,46,56,-10,45
Admira Wacke,218,7,11,7,18,32,60,-28,40
SV Josko Rie,218,8,10,8,18,34,50,-16,38
St. Pölten,218,9,9,11,16,41,62,-21,38
Mattersburg,218,10,8,10,18,37,52,-15,34
FC Salzburg,219,1,21,8,7,68,31,37,71
Vienna,219,2,21,4,11,65,50,15,67
SC Rheindorf,219,3,20,7,9,49,43,6,67
SK Sturm Gra,219,4,19,5,12,59,35,24,62
Rapid Vienna,219,5,13,10,13,67,50,17,49
Admira Wacke,219,6,14,4,18,40,58,-18,46
RZ Pellets W,219,7,13,6,17,48,61,-13,45
Mattersburg,219,8,9,9,18,39,58,-19,36
St. Pölten,219,9,8,9,19,42,61,-19,33
SV Josko Rie,219,10,8,6,22,28,58,-30,30
FC Salzburg,220,1,23,7,6,72,29,43,76
SK Sturm Gra,220,2,21,5,10,66,34,32,68
SC Rheindorf,220,3,20,8,8,58,45,13,68
Vienna,220,4,19,5,12,66,53,13,62
Rapid Vienna,220,5,11,11,14,54,48,6,44
St. Pölten,220,6,11,11,14,43,58,-15,44
Admira Wacke,220,7,12,5,19,32,62,-30,41
SV Josko Rie,220,8,9,8,19,37,57,-20,35
RZ Pellets W,220,9,9,6,21,36,57,-21,33
Mattersburg,220,10,7,10,19,34,55,-21,31
SK Sturm Gra,221,1,22,6,8,65,32,33,72
FC Salzburg,221,2,20,7,9,66,33,33,67
SC Rheindorf,221,3,19,6,11,55,41,14,63
Vienna,221,4,16,6,14,63,58,5,54
Rapid Vienna,221,5,14,10,12,55,42,13,52
RZ Pellets W,221,6,12,7,17,44,53,-9,43
St. Pölten,221,7,11,9,16,42,63,-21,42
Mattersburg,221,8,10,10,16,37,52,-15,40
SV Josko Rie,221,9,11,5,20,35,58,-23,38
Admira Wacke,221,10,9,6,21,36,66,-30,33
FC Salzburg,222,1,22,7,7,66,30,36,73
SC Rheindorf,222,2,21,9,6,62,39,23,72
Vienna,222,3,17,9,10,65,54,11,60
SK Sturm Gra,222,4,17,8,11,57,38,19,59
Rapid Vienna,222,5,14,10,12,56,43,13,52
SV Josko Rie,222,6,11,8,17,34,51,-17,41
RZ Pellets W,222,7,9,13,14,40,52,-12,40
St. Pölten,222,8,7,14,15,41,57,-16,35
Admira Wacke,222,9,9,6,21,31,65,-34,33
Mattersburg,222,10,6,10,20,39,62,-23,28
SC Rheindorf,223,1,20,5,11,54,42,12,65
SK Sturm Gra,223,2,18,7,11,55,32,23,61
Vienna,223,3,18,7,11,70,55,15,61
FC Salzburg,223,4,15,10,11,56,35,21,55
Rapid Vienna,223,5,13,13,10,51,41,10,52
SV Josko Rie,223,6,15,3,18,36,44,-8,48
RZ Pellets W,223,7,13,6,17,45,56,-11,45
Admira Wacke,223,8,13,6,17,40,61,-21,45
St. Pölten,223,9,10,7,19,40,61,-21,37
Mattersburg,223,10,8,10,18,38,58,-20,34
SC Rheindorf,224,1,22,6,8,59,39,20,72
SK Sturm Gra,224,2,21,5,10,61,36,25,68
FC Salzburg,224,3,20,7,9,60,33,27,67
Rapid Vienna,224,4,17,12,7,64,33,31,63
Vienna,224,5,16,6,14,58,58,0,54
RZ Pellets W,224,6,11,8,17,42,53,-11,41
Admira Wacke,224,7,10,8,18,37,58,-21,38
St. Pölten,224,8,9,9,18,45,65,-20,36
SV Josko Rie,224,9,9,6,21,31,56,-25,33
Mattersburg,224,10,8,7,21,36,62,-26,31
FC Salzburg,225,1,24,6,6,76,30,46,78
SK Sturm Gra,225,2,21,8,7,63,31,32,71
SC Rheindorf,225,3,20,9,7,61,39,22,69
Vienna,225,4,16,5,15,66,61,5,53
Rapid Vienna,225,5,12,12,12,49,44,5,48
Admira Wacke,225,6,13,8,15,43,60,-17,47
RZ Pellets W,225,7,12,9,15,49,55,-6,45
St. Pölten,225,8,8,10,18,43,64,-21,34
Mattersburg,225,9,6,11,19,36,58,-22,29
SV Josko Rie,225,10,8,2,26,31,75,-44,26
SC Rheindorf,226,1,21,6,9,57,41,16,69
FC Salzburg,226,2,20,7,9,62,31,31,67
Vienna,226,3,19,4,13,63,53,10,61
SK Sturm Gra,226,4,18,6,12,55,35,20,60
Rapid Vienna,226,5,16,8,12,56,39,17,56
RZ Pellets W,226,6,14,6,16,52,54,-2,48
Admira Wacke,226,7,11,6,19,33,55,-22,39
Mattersburg,226,8,10,8,18,34,54,-20,38
St. Pölten,226,9,9,10,17,43,66,-23,37
SV Josko Rie,226,10,8,7,21,27,54,-27,31
FC Salzburg,227,1,19,10,7,63,30,33,67
SC Rheindorf,227,2,20,6,10,53,44,9,66
SK Sturm Gra,227,3,18,7,11,61,41,20,61
Vienna,227,4,19,3,14,59,53,6,60
Admira Wacke,227,5,16,5,15,46,55,-9,53
RZ Pellets W,227,6,15,7,14,47,46,1,52
Rapid Vienna,227,7,12,9,15,54,46,8,45
Mattersburg,227,8,10,8,18,38,55,-17,38
SV Josko Rie,227,9,10,4,22,35,57,-22,34
St. Pölten,227,10,8,7,21,42,71,-29,31
FC Salzburg,228,1,20,7,9,69,39,30,67
SK Sturm Gra,228,2,20,7,9,59,34,25,67
SC Rheindorf,228,3,18,9,9,62,48,14,63
Vienna,228,4,17,7,12,51,41,10,58
Rapid Vienna,228,5,14,10,12,54,42,12,52
St. Pölten,228,6,10,11,15,42,57,-15,41
SV Josko Rie,228,7,12,4,20,33,50,-17,40
Mattersburg,228,8,10,9,17,39,53,-14,39
Admira Wacke,228,9,11,6,19,38,63,-25,39
RZ Pellets W,228,10,9,8,19,39,59,-20,35
FC Salzburg,229,1,23,7,6,67,21,46,76
Vienna,229,2,22,2,12,65,53,12,68
SC Rheindorf,229,3,19,6,11,51,42,9,63
SK Sturm Gra,229,4,17,6,13,52,37,15,57
Rapid Vienna,229,5,15,9,12,52,40,12,54
Admira Wacke,229,6,14,5,17,37,57,-20,47
RZ Pellets W,229,7,11,7,18,46,58,-12,40
St. Pölten,229,8,9,10,17,42,60,-18,37
SV Josko Rie,229,9,9,7,20,38,59,-21,34
Mattersburg,229,10,7,9,20,39,62,-23,30
FC Salzburg,230,1,19,9,8,60,30,30,66
SK Sturm Gra,230,2,20,6,10,62,34,28,66
SC Rheindorf,230,3,19,9,8,54,37,17,66
Vienna,230,4,18,9,9,62,47,15,63
Rapid Vienna,230,5,13,9,14,59,50,9,48
Admira Wacke,230,6,13,9,14,41,60,-19,48
SV Josko Rie,230,7,12,7,17,40,48,-8,43
RZ Pellets W,230,8,11,10,15,38,49,-11,43
Mattersburg,230,9,7,7,22,34,62,-28,28
St. Pölten,230,10,6,9,21,36,69,-33,27
FC Salzburg,231,1,22,7,7,65,32,33,73
SK Sturm Gra,231,2,23,4,9,62,31,31,73
SC Rheindorf,231,3,19,9,8,57,35,22,66
Vienna,231,4,20,5,11,66,49,17,65
Rapid Vienna,231,5,13,10,13,51,44,7,49
RZ Pellets W,231,6,12,6,18,41,56,-15,42
SV Josko Rie,231,7,11,4,21,37,54,-17,37
Admira Wacke,231,8,10,7,19,32,57,-25,37
St. Pölten,231,9,9,7,20,46,72,-26,34
Mattersburg,231,10,8,7,21,35,62,-27,31
FC Salzburg,232,1,23,7,6,69,32,37,76
SC Rheindorf,232,2,21,6,9,62,46,16,69
SK Sturm Gra,232,3,20,5,11,57,33,24,65
RZ Pellets W,232,4,17,7,12,50,48,2,58
Vienna,232,5,16,7,13,60,56,4,55
Rapid Vienna,232,6,11,13,12,57,47,10,46
SV Josko Rie,232,7,11,6,19,31,50,-19,39
Admira Wacke,232,8,11,5,20,35,57,-22,38
Mattersburg,232,9,5,13,18,32,57,-25,28
St. Pölten,232,10,5,11,20,35,62,-27,26
FC Salzburg,233,1,22,7,7,61,24,37,73
SK Sturm Gra,233,2,22,5,9,64,32,32,71
SC Rheindorf,233,3,16,12,8,55,40,15,60
Vienna,233,4,17,4,15,62,60,2,55
Rapid Vienna,233,5,14,9,13,49,41,8,51
Mattersburg,233,6,13,8,15,43,51,-8,47
RZ Pellets W,233,7,12,5,19,47,58,-11,41
Admira Wacke,233,8,11,8,17,34,51,-17,41
SV Josko Rie,233,9,11,5,20,33,53,-20,38
St. Pölten,233,10,7,7,22,34,72,-38,28
FC Salzburg,234,1,19,10,7,66,30,36,67
SC Rheindorf,234,2,18,10,8,60,44,16,64
SK Sturm Gra,234,3,18,8,10,54,31,23,62
Vienna,234,4,18,6,12,58,53,5,60
Rapid Vienna,234,5,12,17,7,48,31,17,53
RZ Pellets W,234,6,14,5,17,43,52,-9,47
Admira Wacke,234,7,11,5,20,36,62,-26,38
SV Josko Rie,234,8,10,7,19,33,52,-19,37
Mattersburg,234,9,9,9,18,37,55,-18,36
St. Pölten,234,10,8,9,19,41,66,-25,33
SC Rheindorf,235,1,23,6,7,61,39,22,75
FC Salzburg,235,2,21,10,5,74,36,38,73
SK Sturm Gra,235,3,21,5,10,59,33,26,68
Vienna,235,4,21,4,11,70,48,22,67
Rapid Vienna,235,5,11,12,13,49,43,6,45
RZ Pellets W,235,6,10,7,19,37,59,-22,37
Admira Wacke,235,7,10,7,19,34,63,-29,37
Mattersburg,235,8,9,8,19,38,55,-17,35
St. Pölten,235,9,9,8,19,40,59,-19,35
SV Josko Rie,235,10,9,5,22,37,64,-27,32
FC Salzburg,236,1,20,7,9,60,29,31,67
SC Rheindorf,236,2,20,6,10,56,43,13,66
SK Sturm Gra,236,3,20,5,11,60,37,23,65
Vienna,236,4,19,4,13,63,54,9,61
Rapid Vienna,236,5,15,11,10,56,42,14,56
Admira Wacke,236,6,13,9,14,42,52,-10,48
RZ Pellets W,236,7,10,8,18,38,55,-17,38
SV Josko Rie,236,8,9,8,19,28,50,-22,35
St. Pölten,236,9,8,10,18,39,61,-22,34
Mattersburg,236,10,8,8,20,36,55,-19,32
SC Rheindorf,237,1,20,9,7,57,39,18,69
FC Salzburg,237,2,19,10,7,56,27,29,67
Vienna,237,3,20,3,13,69,53,16,63
Rapid Vienna,237,4,16,10,10,61,38,23,58
SK Sturm Gra,237,5,14,7,15,52,41,11,49
Admira Wacke,237,6,12,7,17,43,60,-17,43
RZ Pellets W,237,7,11,9,16,49,63,-14,42
St. Pölten,237,8,9,11,16,43,64,-21,38
SV Josko Rie,237,9,9,9,18,33,51,-18,36
Mattersburg,237,10,8,9,19,28,55,-27,33
SK Sturm Gra,238,1,24,4,8,67,32,35,76
FC Salzburg,238,2,17,9,10,58,35,23,60
Vienna,238,3,18,6,12,60,50,10,60
SC Rheindorf,238,4,17,6,13,50,45,5,57
Rapid Vienna,238,5,13,13,10,54,40,14,52
RZ Pellets W,238,6,14,7,15,44,48,-4,49
Admira Wacke,238,7,13,7,16,39,56,-17,46
SV Josko Rie,238,8,11,3,22,37,58,-21,36
St. Pölten,238,9,9,9,18,45,69,-24,36
Mattersburg,238,10,8,8,20,36,57,-21,32
FC Salzburg,239,1,22,9,5,65,31,34,75
SK Sturm Gra,239,2,19,6,11,61,41,20,63
Vienna,239,3,18,7,11,68,47,21,61
SC Rheindorf,239,4,16,11,9,52,45,7,59
Rapid Vienna,239,5,14,13,9,65,42,23,55
SV Josko Rie,239,6,11,8,17,39,50,-11,41
Admira Wacke,239,7,11,8,17,39,60,-21,41
RZ Pellets W,239,8,10,7,19,40,58,-18,37
Mattersburg,239,9,7,12,17,34,55,-21,33
St. Pölten,239,10,7,9,20,41,75,-34,30
SK Sturm Gra,240,1,21,6,9,62,31,31,69
FC Salzburg,240,2,19,10,7,67,33,34,67
SC Rheindorf,240,3,19,7,10,54,41,13,64
Vienna,240,4,18,4,14,66,63,3,58
Rapid Vienna,240,5,13,13,10,57,42,15,52
Admira Wacke,240,6,13,7,16,42,55,-13,46
RZ Pellets W,240,7,13,6,17,52,63,-11,45
Mattersburg,240,8,9,11,16,39,53,-14,38
St. Pölten,240,9,7,11,18,40,66,-26,32
SV Josko Rie,240,10,9,3,24,34,66,-32,30
Vienna,241,1,21,6,9,66,42,24,69
FC Salzburg,241,2,18,10,8,65,33,32,64
SC Rheindorf,241,3,18,9,9,48,38,10,63
SK Sturm Gra,241,4,18,6,12,58,43,15,60
Rapid Vienna,241,5,12,11,13,52,38,14,47
SV Josko Rie,241,6,13,4,19,33,48,-15,43
St. Pölten,241,7,9,13,14,43,59,-16,40
Admira Wacke,241,8,10,9,17,32,53,-21,39
Mattersburg,241,9,9,10,17,35,57,-22,37
RZ Pellets W,241,10,8,10,18,35,56,-21,34
SK Sturm Gra,242,1,20,7,9,61,28,33,67
SC Rheindorf,242,2,19,10,7,54,41,13,67
FC Salzburg,242,3,19,9,8,63,33,30,66
Vienna,242,4,20,4,12,65,48,17,64
Rapid Vienna,242,5,12,12,12,49,37,12,48
Admira Wacke,242,6,12,7,17,37,57,-20,43
SV Josko Rie,242,7,11,7,18,32,47,-15,40
RZ Pellets W,242,8,10,10,16,37,56,-19,40
St. Pölten,242,9,7,11,18,42,69,-27,32
Mattersburg,242,10,6,11,19,37,61,-24,29
FC Salzburg,243,1,21,6,9,66,30,36,69
SK Sturm Gra,243,2,18,10,8,54,32,22,64
SC Rheindorf,243,3,19,6,11,52,46,6,63
Rapid Vienna,243,4,16,10,10,64,41,23,58
RZ Pellets W,243,5,16,7,13,53,49,4,55
Vienna,243,6,15,5,16,53,56,-3,50
SV Josko Rie,243,7,12,6,18,37,50,-13,42
St. Pölten,243,8,10,8,18,44,62,-18,38
Mattersburg,243,9,8,9,19,36,57,-21,33
Admira Wacke,243,10,8,7,21,29,65,-36,31
FC Salzburg,244,1,21,6,9,67,34,33,69
SC Rheindorf,244,2,20,7,9,54,41,13,67
Vienna,244,3,19,8,9,64,44,20,65
Rapid Vienna,244,4,15,12,9,57,36,21,57
SK Sturm Gra,244,5,16,4,16,55,48,7,52
Admira Wacke,244,6,15,7,14,43,50,-7,52
St. Pölten,244,7,12,7,17,43,61,-18,43
SV Josko Rie,244,8,11,5,20,33,54,-21,38
RZ Pellets W,244,9,10,6,20,40,58,-18,36
Mattersburg,244,10,6,8,22,33,63,-30,26
FC Salzburg,245,1,23,6,7,68,28,40,75
SC Rheindorf,245,2,21,7,8,55,37,18,70
SK Sturm Gra,245,3,18,7,11,58,37,21,61
Vienna,245,4,18,5,13,56,47,9,59
Rapid Vienna,245,5,14,11,11,63,38,25,53
RZ Pellets W,245,6,12,9,15,45,53,-8,45
Admira Wacke,245,7,12,7,17,32,50,-18,43
Mattersburg,245,8,11,7,18,36,52,-16,40
SV Josko Rie,245,9,9,5,22,24,57,-33,32
St. Pölten,245,10,6,8,22,34,72,-38,26
SK Sturm Gra,246,1,21,8,7,62,30,32,71
FC Salzburg,246,2,17,10,9,56,34,22,61
Vienna,246,3,17,9,10,65,47,18,60
SC Rheindorf,246,4,17,9,10,48,43,5,60
Rapid Vienna,246,5,14,11,11,53,40,13,53
Admira Wacke,246,6,13,6,17,41,57,-16,45
SV Josko Rie,246,7,12,5,19,42,53,-11,41
Mattersburg,246,8,10,9,17,33,56,-23,39
RZ Pellets W,246,9,9,10,17,42,59,-17,37
St. Pölten,246,10,7,9,20,38,61,-23,30
FC Salzburg,247,1,20,8,8,65,29,36,68
SK Sturm Gra,247,2,20,7,9,59,30,29,67
Vienna,247,3,20,5,11,66,49,17,65
Rapid Vienna,247,4,17,8,11,56,35,21,59
SC Rheindorf,247,5,16,10,10,54,47,7,58
RZ Pellets W,247,6,14,7,15,42,52,-10,49
Admira Wacke,247,7,11,9,16,36,56,-20,42
Mattersburg,247,8,10,6,20,38,59,-21,36
SV Josko Rie,247,9,9,5,22,32,59,-27,32
St. Pölten,247,10,7,7,22,39,71,-32,28
SC Rheindorf,248,1,20,8,8,58,41,17,68
FC Salzburg,248,2,19,9,8,65,30,35,66
SK Sturm Gra,248,3,18,8,10,57,34,23,62
Vienna,248,4,19,5,12,61,49,12,62
Rapid Vienna,248,5,14,10,12,56,41,15,52
RZ Pellets W,248,6,13,6,17,46,61,-15,45
St. Pölten,248,7,11,7,18,47,62,-15,40
SV Josko Rie,248,8,11,6,19,34,56,-22,39
Admira Wacke,248,9,10,7,19,32,58,-26,37
Mattersburg,248,10,9,6,21,37,61,-24,33
SK Sturm Gra,249,1,23,5,8,67,31,36,74
FC Salzburg,249,2,20,8,8,69,33,36,68
SC Rheindorf,249,3,20,7,9,57,41,16,67
Vienna,249,4,20,4,12,67,52,15,64
Rapid Vienna,249,5,14,12,10,51,36,15,54
RZ Pellets W,249,6,12,8,16,45,54,-9,44
Admira Wacke,249,7,10,7,19,32,63,-31,37
Mattersburg,249,8,9,9,18,36,53,-17,36
St. Pölten,249,9,7,9,20,40,71,-31,30
SV Josko Rie,249,10,6,9,21,26,56,-30,27
FC Salzburg,250,1,21,7,8,61,33,28,70
Vienna,250,2,21,5,10,64,46,18,68
SC Rheindorf,250,3,20,6,10,63,45,18,66
SK Sturm Gra,250,4,18,6,12,59,37,22,60
Rapid Vienna,250,5,16,10,10,65,40,25,58
RZ Pellets W,250,6,14,7,15,44,55,-11,49
Mattersburg,250,7,9,10,17,39,56,-17,37
Admira Wacke,250,8,10,6,20,33,60,-27,36
SV Josko Rie,250,9,9,6,21,29,50,-21,33
St. Pölten,250,10,6,9,21,40,75,-35,27
FC Salzburg,251,1,20,10,6,68,34,34,70
SC Rheindorf,251,2,20,5,11,51,41,10,65
SK Sturm Gra,251,3,19,6,11,60,37,23,63
Vienna,251,4,18,6,12,63,49,14,60
Rapid Vienna,251,5,14,9,13,55,40,15,51
RZ Pellets W,251,6,13,7,16,42,53,-11,46
St. Pölten,251,7,12,7,17,42,60,-18,43
Admira Wacke,251,8,11,7,18,38,60,-22,40
SV Josko Rie,251,9,10,5,21,33,51,-18,35
Mattersburg,251,10,8,8,20,33,60,-27,32
FC Salzburg,252,1,24,8,4,72,24,48,80
SC Rheindorf,252,2,22,6,8,54,37,17,72
SK Sturm Gra,252,3,21,6,9,56,31,25,69
Vienna,252,4,16,6,14,52,53,-1,54
Rapid Vienna,252,5,12,11,13,52,44,8,47
Admira Wacke,252,6,12,7,17,42,53,-11,43
SV Josko Rie,252,7,11,6,19,31,48,-17,39
RZ Pellets W,252,8,8,10,18,37,55,-18,34
Mattersburg,252,9,9,7,20,36,54,-18,34
St. Pölten,252,10,7,9,20,37,70,-33,30
SC Rheindorf,253,1,19,8,9,59,43,16,65
FC Salzburg,253,2,20,4,12,59,35,24,64
Vienna,253,3,19,5,12,67,49,18,62
SK Sturm Gra,253,4,19,4,13,56,41,15,61
Rapid Vienna,253,5,15,11,10,60,42,18,56
Admira Wacke,253,6,13,5,18,39,60,-21,44
St. Pölten,253,7,11,9,16,44,65,-21,42
RZ Pellets W,253,8,10,9,17,49,62,-13,39
SV Josko Rie,253,9,10,6,20,32,54,-22,36
Mattersburg,253,10,8,11,17,38,52,-14,35
FC Salzburg,254,1,22,9,5,65,29,36,75
Vienna,254,2,22,6,8,68,43,25,72
SC Rheindorf,254,3,18,10,8,53,38,15,64
SK Sturm Gra,254,4,18,7,11,52,32,20,61
Rapid Vienna,254,5,15,8,13,53,41,12,53
RZ Pellets W,254,6,12,4,20,46,67,-21,40
Mattersburg,254,7,9,11,16,40,51,-11,38
St. Pölten,254,8,9,8,19,44,67,-23,35
Admira Wacke,254,9,9,7,20,41,71,-30,34
SV Josko Rie,254,10,8,6,22,34,57,-23,30
FC Salzburg,255,1,22,6,8,65,36,29,72
SK Sturm Gra,255,2,21,5,10,66,30,36,68
SC Rheindorf,255,3,20,7,9,55,45,10,67
Rapid Vienna,255,4,15,12,9,58,37,21,57
Vienna,255,5,16,4,16,63,65,-2,52
RZ Pellets W,255,6,15,6,15,52,54,-2,51
Admira Wacke,255,7,13,6,17,41,53,-12,45
Mattersburg,255,8,10,6,20,39,59,-20,36
St. Pölten,255,9,8,8,20,38,65,-27,32
SV Josko Rie,255,10,7,6,23,27,60,-33,27
FC Salzburg,256,1,20,10,6,61,31,30,70
SC Rheindorf,256,2,19,9,8,58,41,17,66
Rapid Vienna,256,3,16,12,8,58,40,18,60
SK Sturm Gra,256,4,16,8,12,56,41,15,56
Vienna,256,5,15,8,13,59,57,2,53
RZ Pellets W,256,6,14,9,13,47,51,-4,51
Mattersburg,256,7,10,9,17,39,53,-14,39
Admira Wacke,256,8,10,8,18,40,59,-19,38
SV Josko Rie,256,9,10,7,19,36,53,-17,37
St. Pölten,256,10,7,6,23,43,71,-28,27
SC Rheindorf,257,1,23,6,7,62,42,20,75
FC Salzburg,257,2,23,4,9,70,30,40,73
Vienna,257,3,21,4,11,73,57,16,67
SK Sturm Gra,257,4,20,5,11,59,38,21,65
Rapid Vienna,257,5,13,11,12,51,39,12,50
RZ Pellets W,257,6,13,7,16,54,55,-1,46
Admira Wacke,257,7,10,6,20,34,64,-30,36
St. Pölten,257,8,9,8,19,44,67,-23,35
SV Josko Rie,257,9,9,5,22,33,61,-28,32
Mattersburg,257,10,7,8,21,32,59,-27,29
FC Salzburg,258,1,23,7,6,64,26,38,76
SK Sturm Gra,258,2,21,8,7,60,28,32,71
Vienna,258,3,19,6,11,59,47,12,63
SC Rheindorf,258,4,18,8,10,52,44,8,62
Rapid Vienna,258,5,14,10,12,57,42,15,52
RZ Pellets W,258,6,11,7,18,38,53,-15,40
SV Josko Rie,258,7,11,6,19,35,52,-17,39
St. Pölten,258,8,9,9,18,36,63,-27,36
Mattersburg,258,9,7,11,18,37,49,-12,32
Admira Wacke,258,10,7,8,21,34,68,-34,29
FC Salzburg,259,1,22,5,9,77,39,38,71
SC Rheindorf,259,2,22,5,9,63,43,20,71
SK Sturm Gra,259,3,18,8,10,56,30,26,62
Vienna,259,4,19,5,12,67,60,7,62
RZ Pellets W,259,5,15,8,13,52,51,1,53
Rapid Vienna,259,6,12,12,12,53,49,4,48
Admira Wacke,259,7,12,8,16,45,59,-14,44
St. Pölten,259,8,8,9,19,42,67,-25,33
SV Josko Rie,259,9,10,3,23,34,63,-29,33
Mattersburg,259,10,8,5,23,39,67,-28,29
SC Rheindorf,260,1,23,5,8,62,38,24,74
FC Salzburg,260,2,21,5,10,64,33,31,68
Rapid Vienna,260,3,19,8,9,67,35,32,65
SK Sturm Gra,260,4,18,7,11,62,42,20,61
Vienna,260,5,15,10,11,60,56,4,55
RZ Pellets W,260,6,11,9,16,52,61,-9,42
St. Pölten,260,7,11,8,17,48,61,-13,41
Mattersburg,260,8,10,8,18,33,57,-24,38
SV Josko Rie,260,9,9,5,22,27,56,-29,32
Admira Wacke,260,10,7,7,22,29,65,-36,28
Vienna,261,1,23,3,10,66,47,19,72
FC Salzburg,261,2,20,7,9,61,33,28,67
SC Rheindorf,261,3,18,10,8,53,40,13,64
SK Sturm Gra,261,4,18,7,11,58,38,20,61
Rapid Vienna,261,5,16,8,12,56,37,19,56
Admira Wacke,261,6,11,8,17,39,58,-19,41
SV Josko Rie,261,7,11,6,19,38,55,-17,39
RZ Pellets W,261,8,10,7,19,39,57,-18,37
Mattersburg,261,9,9,8,19,37,59,-22,35
St. Pölten,261,10,7,10,19,43,66,-23,31
FC Salzburg,262,1,24,6,6,74,28,46,78
SC Rheindorf,262,2,22,6,8,56,38,18,72
Vienna,262,3,20,5,11,66,48,18,65
SK Sturm Gra,262,4,20,3,13,68,44,24,63
Rapid Vienna,262,5,16,10,10,55,38,17,58
RZ Pellets W,262,6,12,8,16,47,58,-11,44
St. Pölten,262,7,8,9,19,38,62,-24,33
Admira Wacke,262,8,9,6,21,38,69,-31,33
SV Josko Rie,262,9,9,4,23,28,60,-32,31
Mattersburg,262,10,7,9,20,32,57,-25,30
SC Rheindorf,263,1,21,7,8,60,42,18,70
FC Salzburg,263,2,20,7,9,66,33,33,67
SK Sturm Gra,263,3,18,8,10,61,38,23,62
Vienna,263,4,19,4,13,61,54,7,61
Rapid Vienna,263,5,13,12,11,57,46,11,51
Admira Wacke,263,6,13,10,13,41,50,-9,49
RZ Pellets W,263,7,11,7,18,39,60,-21,40
SV Josko Rie,263,8,10,7,19,31,49,-18,37
St. Pölten,263,9,8,11,17,44,63,-19,35
Mattersburg,263,10,6,9,21,32,57,-25,27
FC Salzburg,264,1,25,5,6,77,31,46,80
SC Rheindorf,264,2,20,6,10,56,41,15,66
SK Sturm Gra,264,3,20,5,11,57,36,21,65
Vienna,264,4,20,5,11,57,46,11,65
Rapid Vienna,264,5,11,12,13,48,42,6,45
RZ Pellets W,264,6,13,5,18,42,55,-13,44
St. Pölten,264,7,12,7,17,46,57,-11,43
SV Josko Rie,264,8,12,4,20,33,51,-18,40
Mattersburg,264,9,8,7,21,37,58,-21,31
Admira Wacke,264,10,8,6,22,30,66,-36,30
FC Salzburg,265,1,23,6,7,71,33,38,75
SC Rheindorf,265,2,20,8,8,61,37,24,68
SK Sturm Gra,265,3,18,10,8,51,28,23,64
Rapid Vienna,265,4,15,10,11,55,43,12,55
RZ Pellets W,265,5,15,7,14,50,46,4,52
Vienna,265,6,14,5,17,54,57,-3,47
Admira Wacke,265,7,11,8,17,39,58,-19,41
Mattersburg,265,8,9,8,19,35,58,-23,35
SV Josko Rie,265,9,9,7,20,29,52,-23,34
St. Pölten,265,10,7,9,20,36,69,-33,30
FC Salzburg,266,1,23,7,6,70,32,38,76
SK Sturm Gra,266,2,21,5,10,62,38,24,68
SC Rheindorf,266,3,18,7,11,56,48,8,61
Vienna,266,4,16,7,13,64,57,7,55
Rapid Vienna,266,5,11,12,13,51,44,7,45
RZ Pellets W,266,6,13,6,17,51,56,-5,45
St. Pölten,266,7,10,11,15,51,63,-12,41
Admira Wacke,266,8,11,8,17,39,54,-15,41
SV Josko Rie,266,9,11,5,20,36,66,-30,38
Mattersburg,266,10,8,8,20,38,60,-22,32
SK Sturm Gra,267,1,21,5,10,65,40,25,68
SC Rheindorf,267,2,20,7,9,60,41,19,67
Vienna,267,3,20,4,12,65,52,13,64
Rapid Vienna,267,4,17,10,9,58,37,21,61
FC Salzburg,267,5,18,7,11,54,33,21,61
RZ Pellets W,267,6,11,7,18,39,56,-17,40
Admira Wacke,267,7,12,4,20,36,55,-19,40
Mattersburg,267,8,10,7,19,40,57,-17,37
SV Josko Rie,267,9,11,4,21,31,53,-22,37
St. Pölten,267,10,8,9,19,38,62,-24,33
SK Sturm Gra,268,1,22,4,10,62,36,26,70
SC Rheindorf,268,2,19,9,8,55,38,17,66
FC Salzburg,268,3,19,7,10,56,35,21,64
Vienna,268,4,17,8,11,58,47,11,59
Rapid Vienna,268,5,13,10,13,50,38,12,49
SV Josko Rie,268,6,13,5,18,41,51,-10,44
RZ Pellets W,268,7,11,10,15,41,56,-15,43
Admira Wacke,268,8,11,6,19,41,59,-18,39
Mattersburg,268,9,8,10,18,31,54,-23,34
St. Pölten,268,10,7,11,18,43,64,-21,32
FC Salzburg,269,1,20,8,8,66,36,30,68
SK Sturm Gra,269,2,19,8,9,55,33,22,65
SC Rheindorf,269,3,19,8,9,58,47,11,65
Vienna,269,4,17,8,11,68,55,13,59
Rapid Vienna,269,5,14,13,9,56,35,21,55
SV Josko Rie,269,6,14,8,14,45,51,-6,50
St. Pölten,269,7,8,12,16,40,57,-17,36
Admira Wacke,269,8,9,9,18,33,60,-27,36
RZ Pellets W,269,9,9,7,20,38,58,-20,34
Mattersburg,269,10,6,9,21,33,60,-27,27
FC Salzburg,270,1,22,8,6,77,32,45,74
SK Sturm Gra,270,2,18,8,10,53,34,19,62
SC Rheindorf,270,3,17,11,8,53,37,16,62
Vienna,270,4,18,4,14,60,58,2,58
RZ Pellets W,270,5,13,7,16,52,58,-6,46
St. Pölten,270,6,12,10,14,53,61,-8,46
Rapid Vienna,270,7,10,12,14,53,46,7,42
Admira Wacke,270,8,11,5,20,34,65,-31,38
Mattersburg,270,9,8,12,16,38,57,-19,36
SV Josko Rie,270,10,9,7,20,30,55,-25,34
FC Salzburg,271,1,21,8,7,69,33,36,71
SC Rheindorf,271,2,20,8,8,60,45,15,68
SK Sturm Gra,271,3,17,8,11,52,33,19,59
Vienna,271,4,16,7,13,60,54,6,55
Rapid Vienna,271,5,14,9,13,48,41,7,51
RZ Pellets W,271,6,12,10,14,50,51,-1,46
SV Josko Rie,271,7,14,4,18,40,50,-10,46
Admira Wacke,271,8,11,8,17,37,56,-19,41
St. Pölten,271,9,8,10,18,43,68,-25,34
Mattersburg,271,10,7,8,21,33,61,-28,29
FC Salzburg,272,1,19,11,6,60,27,33,68
SC Rheindorf,272,2,19,8,9,51,42,9,65
SK Sturm Gra,272,3,17,8,11,50,36,14,59
Vienna,272,4,17,7,12,63,48,15,58
Rapid Vienna,272,5,12,13,11,53,36,17,49
RZ Pellets W,272,6,12,9,15,43,52,-9,45
SV Josko Rie,272,7,13,4,19,35,52,-17,43
Admira Wacke,272,8,11,7,18,34,57,-23,40
St. Pölten,272,9,8,12,16,39,55,-16,36
Mattersburg,272,10,7,11,18,38,61,-23,32
FC Salzburg,273,1,20,9,7,62,29,33,69
SK Sturm Gra,273,2,19,5,12,57,36,21,62
SC Rheindorf,273,3,17,11,8,54,42,12,62
Vienna,273,4,19,4,13,59,53,6,61
Rapid Vienna,273,5,14,14,8,61,40,21,56
Admira Wacke,273,6,14,6,16,36,51,-15,48
RZ Pellets W,273,7,12,8,16,47,53,-6,44
St. Pölten,273,8,10,9,17,43,58,-15,39
Mattersburg,273,9,7,9,20,35,58,-23,30
SV Josko Rie,273,10,7,7,22,29,63,-34,28
FC Salzburg,274,1,22,9,5,70,32,38,75
SC Rheindorf,274,2,20,8,8,57,41,16,68
Vienna,274,3,20,5,11,63,48,15,65
SK Sturm Gra,274,4,18,8,10,54,31,23,62
Rapid Vienna,274,5,10,14,12,51,45,6,44
RZ Pellets W,274,6,11,8,17,44,55,-11,41
Admira Wacke,274,7,10,11,15,36,59,-23,41
SV Josko Rie,274,8,9,8,19,34,52,-18,35
St. Pölten,274,9,8,11,17,39,62,-23,35
Mattersburg,274,10,5,12,19,31,54,-23,27
FC Salzburg,275,1,22,8,6,69,26,43,74
SK Sturm Gra,275,2,21,6,9,64,33,31,69
Vienna,275,3,19,6,11,63,52,11,63
SC Rheindorf,275,4,17,9,10,50,41,9,60
Rapid Vienna,275,5,12,12,12,49,40,9,48
SV Josko Rie,275,6,14,6,16,41,48,-7,48
RZ Pellets W,275,7,11,5,20,41,61,-20,38
Admira Wacke,275,8,10,7,19,38,65,-27,37
St. Pölten,275,9,9,8,19,43,66,-23,35
Mattersburg,275,10,7,9,20,33,59,-26,30
FC Salzburg,276,1,24,5,7,61,23,38,77
SK Sturm Gra,276,2,20,6,10,58,32,26,66
SC Rheindorf,276,3,17,8,11,50,40,10,59
Rapid Vienna,276,4,15,9,12,48,33,15,54
Vienna,276,5,15,9,12,56,49,7,54
RZ Pellets W,276,6,13,9,14,46,48,-2,48
SV Josko Rie,276,7,12,5,19,39,54,-15,41
Admira Wacke,276,8,11,7,18,32,53,-21,40
St. Pölten,276,9,8,10,18,36,65,-29,34
Mattersburg,276,10,6,10,20,32,61,-29,28
FC Salzburg,277,1,20,8,8,64,38,26,68
SK Sturm Gra,277,2,19,9,8,61,31,30,66
SC Rheindorf,277,3,19,7,10,57,47,10,64
Vienna,277,4,17,7,12,58,50,8,58
Rapid Vienna,277,5,15,11,10,57,40,17,56
RZ Pellets W,277,6,16,5,15,52,52,0,53
Mattersburg,277,7,10,8,18,43,58,-15,38
Admira Wacke,277,8,9,9,18,35,58,-23,36
SV Josko Rie,277,9,10,5,21,28,52,-24,35
St. Pölten,277,10,5,11,20,36,65,-29,26
FC Salzburg,278,1,21,7,8,64,33,31,70
SK Sturm Gra,278,2,20,5,11,63,32,31,65
SC Rheindorf,278,3,18,7,11,61,53,8,61
Vienna,278,4,18,6,12,62,54,8,60
Rapid Vienna,278,5,15,11,10,61,39,22,56
RZ Pellets W,278,6,12,8,16,45,57,-12,44
SV Josko Rie,278,7,10,11,15,36,48,-12,41
Admira Wacke,278,8,9,11,16,33,58,-25,38
St. Pölten,278,9,8,9,19,42,64,-22,33
Mattersburg,278,10,8,7,21,33,62,-29,31
SC Rheindorf,279,1,22,7,7,55,33,22,73
FC Salzburg,279,2,19,8,9,58,30,28,65
Vienna,279,3,19,7,10,61,46,15,64
SK Sturm Gra,279,4,19,6,11,56,37,19,63
Rapid Vienna,279,5,15,9,12,52,40,12,54
RZ Pellets W,279,6,11,8,17,45,57,-12,41
Admira Wacke,279,7,11,7,18,40,63,-23,40
St. Pölten,279,8,10,7,19,44,61,-17,37
SV Josko Rie,279,9,11,4,21,33,51,-18,37
Mattersburg,279,10,7,9,20,33,59,-26,30
FC Salzburg,280,1,25,5,6,77,28,49,80
SC Rheindorf,280,2,22,6,8,55,46,9,72
Vienna,280,3,18,5,13,65,55,10,59
SK Sturm Gra,280,4,17,5,14,49,37,12,56
Rapid Vienna,280,5,15,9,12,55,39,16,54
RZ Pellets W,280,6,12,7,17,43,56,-13,43
Mattersburg,280,7,11,7,18,47,54,-7,40
St. Pölten,280,8,9,9,18,39,59,-20,36
Admira Wacke,280,9,9,9,18,37,65,-28,36
SV Josko Rie,280,10,9,4,23,28,56,-28,31
SC Rheindorf,281,1,22,7,7,59,40,19,73
FC Salzburg,281,2,21,7,8,70,31,39,70
SK Sturm Gra,281,3,19,8,9,65,37,28,65
Vienna,281,4,18,7,11,68,54,14,61
Rapid Vienna,281,5,14,12,10,57,40,17,54
RZ Pellets W,281,6,12,10,14,47,53,-6,46
Admira Wacke,281,7,10,7,19,39,65,-26,37
SV Josko Rie,281,8,11,3,22,35,60,-25,36
Mattersburg,281,9,7,10,19,36,61,-25,31
St. Pölten,281,10,6,9,21,39,74,-35,27
FC Salzburg,282,1,21,9,6,71,32,39,72
SC Rheindorf,282,2,19,7,10,53,43,10,64
SK Sturm Gra,282,3,18,6,12,56,40,16,60
Vienna,282,4,18,5,13,59,49,10,59
Rapid Vienna,282,5,16,10,10,54,36,18,58
RZ Pellets W,282,6,14,9,13,46,49,-3,51
SV Josko Rie,282,7,13,2,21,41,56,-15,41
Admira Wacke,282,8,11,7,18,37,58,-21,40
St. Pölten,282,9,9,9,18,45,67,-22,36
Mattersburg,282,10,4,10,22,33,65,-32,22
SK Sturm Gra,283,1,23,5,8,56,24,32,74
FC Salzburg,283,2,21,8,7,60,29,31,71
SC Rheindorf,283,3,18,10,8,51,37,14,64
Rapid Vienna,283,4,18,9,9,64,40,24,63
Vienna,283,5,18,6,12,61,45,16,60
RZ Pellets W,283,6,12,6,18,43,56,-13,42
Admira Wacke,283,7,10,8,18,29,54,-25,38
SV Josko Rie,283,8,11,4,21,34,56,-22,37
Mattersburg,283,9,6,9,21,34,54,-20,27
St. Pölten,283,10,6,9,21,34,71,-37,27
FC Salzburg,284,1,24,7,5,72,26,46,79
SK Sturm Gra,284,2,21,5,10,60,29,31,68
SC Rheindorf,284,3,16,12,8,54,46,8,60
Vienna,284,4,17,7,12,60,48,12,58
RZ Pellets W,284,5,12,11,13,41,45,-4,47
Admira Wacke,284,6,10,10,16,36,61,-25,40
Rapid Vienna,284,7,9,12,15,47,47,0,39
Mattersburg,284,8,10,7,19,35,55,-20,37
SV Josko Rie,284,9,9,9,18,35,56,-21,36
St. Pölten,284,10,8,8,20,38,65,-27,32
SC Rheindorf,285,1,21,9,6,62,40,22,72
Vienna,285,2,19,6,11,62,47,15,63
Rapid Vienna,285,3,15,13,8,58,36,22,58
FC Salzburg,285,4,15,12,9,54,33,21,57
SK Sturm Gra,285,5,14,8,14,51,42,9,50
RZ Pellets W,285,6,12,8,16,50,49,1,44
Admira Wacke,285,7,11,8,17,34,56,-22,41
SV Josko Rie,285,8,11,7,18,32,46,-14,40
Mattersburg,285,9,10,9,17,37,58,-21,39
St. Pölten,285,10,8,8,20,39,72,-33,32
FC Salzburg,286,1,19,11,6,62,29,33,68
SK Sturm Gra,286,2,20,6,10,60,35,25,66
Vienna,286,3,20,6,10,64,50,14,66
SC Rheindorf,286,4,19,8,9,54,41,13,65
Rapid Vienna,286,5,14,10,12,51,39,12,52
RZ Pellets W,286,6,12,9,15,47,51,-4,45
St. Pölten,286,7,10,9,17,45,64,-19,39
Admira Wacke,286,8,9,9,18,34,57,-23,36
SV Josko Rie,286,9,10,4,22,31,57,-26,34
Mattersburg,286,10,7,8,21,31,56,-25,29
SC Rheindorf,287,1,21,7,8,59,42,17,70
FC Salzburg,287,2,19,7,10,62,37,25,64
Vienna,287,3,20,4,12,71,53,18,64
SK Sturm Gra,287,4,19,6,11,63,38,25,63
Rapid Vienna,287,5,17,10,9,59,38,21,61
Admira Wacke,287,6,12,4,20,40,62,-22,40
SV Josko Rie,287,7,11,6,19,36,57,-21,39
St. Pölten,287,8,10,7,19,44,66,-22,37
RZ Pellets W,287,9,9,9,18,45,62,-17,36
Mattersburg,287,10,8,8,20,37,61,-24,32
SK Sturm Gra,288,1,21,5,10,65,37,28,68
FC Salzburg,288,2,19,8,9,63,27,36,65
SC Rheindorf,288,3,20,5,11,57,42,15,65
Vienna,288,4,18,5,13,61,50,11,59
Rapid Vienna,288,5,15,10,11,50,33,17,55
RZ Pellets W,288,6,12,8,16,49,57,-8,44
Mattersburg,288,7,12,8,16,41,54,-13,44
Admira Wacke,288,8,12,6,18,41,65,-24,42
St. Pölten,288,9,7,11,18,39,68,-29,32
SV Josko Rie,288,10,9,4,23,26,59,-33,31
SC Rheindorf,289,1,19,6,11,52,41,11,63
Vienna,289,2,20,3,13,61,51,10,63
SK Sturm Gra,289,3,19,5,12,60,38,22,62
FC Salzburg,289,4,18,7,11,56,36,20,61
SV Josko Rie,289,5,15,4,17,42,48,-6,49
Rapid Vienna,289,6,12,12,12,48,46,2,48
Admira Wacke,289,7,13,7,16,44,55,-11,46
RZ Pellets W,289,8,12,6,18,50,59,-9,42
St. Pölten,289,9,10,9,17,41,58,-17,39
Mattersburg,289,10,9,7,20,41,63,-22,34
FC Salzburg,290,1,21,8,7,69,35,34,71
SK Sturm Gra,290,2,21,7,8,65,35,30,70
SC Rheindorf,290,3,18,8,10,52,42,10,62
Vienna,290,4,16,7,13,59,58,1,55
Rapid Vienna,290,5,14,11,11,55,41,14,53
St. Pölten,290,6,12,9,15,44,57,-13,45
RZ Pellets W,290,7,12,8,16,47,56,-9,44
Mattersburg,290,8,8,10,18,40,58,-18,34
Admira Wacke,290,9,9,7,20,29,54,-25,34
SV Josko Rie,290,10,8,7,21,34,58,-24,31
SC Rheindorf,291,1,21,9,6,54,34,20,72
Vienna,291,2,22,4,10,71,51,20,70
FC Salzburg,291,3,20,9,7,70,33,37,69
SK Sturm Gra,291,4,18,5,13,50,33,17,59
Rapid Vienna,291,5,13,12,11,53,36,17,51
RZ Pellets W,291,6,12,6,18,44,58,-14,42
Mattersburg,291,7,11,7,18,35,50,-15,40
Admira Wacke,291,8,11,3,22,35,65,-30,36
SV Josko Rie,291,9,10,5,21,32,54,-22,35
St. Pölten,291,10,9,6,21,36,66,-30,33
FC Salzburg,292,1,23,5,8,73,35,38,74
SC Rheindorf,292,2,21,6,9,60,44,16,69
SK Sturm Gra,292,3,20,5,11,63,36,27,65
Vienna,292,4,18,6,12,64,56,8,60
Rapid Vienna,292,5,15,8,13,55,46,9,53
Mattersburg,292,6,12,8,16,47,54,-7,44
RZ Pellets W,292,7,12,6,18,46,60,-14,42
Admira Wacke,292,8,10,7,19,42,59,-17,37
SV Josko Rie,292,9,10,4,22,33,62,-29,34
St. Pölten,292,10,8,7,21,36,67,-31,31
FC Salzburg,293,1,22,9,5,70,28,42,75
SC Rheindorf,293,2,20,7,9,54,39,15,67
SK Sturm Gra,293,3,19,8,9,55,32,23,65
Vienna,293,4,16,7,13,65,54,11,55
Rapid Vienna,293,5,14,11,11,50,42,8,53
RZ Pellets W,293,6,11,11,14,43,51,-8,44
Admira Wacke,293,7,10,8,18,38,60,-22,38
Mattersburg,293,8,8,11,17,34,51,-17,35
St. Pölten,293,9,8,10,18,43,70,-27,34
SV Josko Rie,293,10,9,4,23,33,58,-25,31
FC Salzburg,294,1,20,9,7,77,37,40,69
SC Rheindorf,294,2,20,7,9,59,42,17,67
Vienna,294,3,20,6,10,68,51,17,66
Rapid Vienna,294,4,15,11,10,58,42,16,56
SK Sturm Gra,294,5,16,8,12,59,44,15,56
Admira Wacke,294,6,14,6,16,42,60,-18,48
SV Josko Rie,294,7,12,7,17,41,50,-9,43
RZ Pellets W,294,8,10,6,20,46,66,-20,36
St. Pölten,294,9,8,10,18,41,66,-25,34
Mattersburg,294,10,5,10,21,34,67,-33,25
FC Salzburg,295,1,24,6,6,79,35,44,78
SK Sturm Gra,295,2,22,6,8,71,33,38,72
Vienna,295,3,21,3,12,65,48,17,66
SC Rheindorf,295,4,17,10,9,55,46,9,61
Rapid Vienna,295,5,13,10,13,61,44,17,49
Admira Wacke,295,6,12,5,19,32,56,-24,41
RZ Pellets W,295,7,10,8,18,48,69,-21,38
Mattersburg,295,8,10,7,19,37,60,-23,37
St. Pölten,295,9,7,11,18,40,69,-29,32
SV Josko Rie,295,10,8,6,22,34,62,-28,30
SK Sturm Gra,296,1,21,6,9,58,37,21,69
FC Salzburg,296,2,19,8,9,63,35,28,65
SC Rheindorf,296,3,19,8,9,53,38,15,65
Vienna,296,4,17,7,12,56,48,8,58
Rapid Vienna,296,5,15,10,11,58,39,19,55
Admira Wacke,296,6,14,6,16,44,52,-8,48
SV Josko Rie,296,7,12,5,19,36,51,-15,41
RZ Pellets W,296,8,10,8,18,39,56,-17,38
Mattersburg,296,9,9,9,18,36,54,-18,36
St. Pölten,296,10,6,9,21,36,69,-33,27
FC Salzburg,297,1,20,6,10,67,40,27,66
SK Sturm Gra,297,2,20,5,11,67,39,28,65
SC Rheindorf,297,3,19,7,10,57,43,14,64
Rapid Vienna,297,4,18,9,9,71,40,31,63
Vienna,297,5,18,6,12,59,53,6,60
SV Josko Rie,297,6,13,4,19,40,53,-13,43
RZ Pellets W,297,7,11,8,17,47,65,-18,41
Admira Wacke,297,8,11,8,17,43,65,-22,41
Mattersburg,297,9,9,7,20,42,61,-19,34
St. Pölten,297,10,6,10,20,36,70,-34,28
Vienna,298,1,23,4,9,66,43,23,73
FC Salzburg,298,2,21,7,8,60,28,32,70
SK Sturm Gra,298,3,19,6,11,59,41,18,63
SC Rheindorf,298,4,16,12,8,48,39,9,60
Rapid Vienna,298,5,16,9,11,59,39,20,57
RZ Pellets W,298,6,14,7,15,53,54,-1,49
Admira Wacke,298,7,10,5,21,32,66,-34,35
SV Josko Rie,298,8,9,6,21,31,52,-21,33
Mattersburg,298,9,8,8,20,35,57,-22,32
St. Pölten,298,10,7,10,19,34,58,-24,31
FC Salzburg,299,1,22,7,7,62,28,34,73
SK Sturm Gra,299,2,21,7,8,63,30,33,70
SC Rheindorf,299,3,19,10,7,60,45,15,67
Rapid Vienna,299,4,14,12,10,56,41,15,54
Vienna,299,5,16,6,14,56,53,3,54
RZ Pellets W,299,6,9,12,15,41,52,-11,39
SV Josko Rie,299,7,10,9,17,34,48,-14,39
St. Pölten,299,8,9,10,17,44,62,-18,37
Mattersburg,299,9,8,9,19,39,56,-17,33
Admira Wacke,299,10,7,8,21,32,72,-40,29
FC Salzburg,300,1,24,7,5,75,32,43,79
SK Sturm Gra,300,2,18,5,13,55,40,15,59
SC Rheindorf,300,3,15,10,11,49,43,6,55
Vienna,300,4,15,10,11,58,55,3,55
Rapid Vienna,300,5,14,11,11,50,37,13,53
RZ Pellets W,300,6,15,7,14,53,52,1,52
Admira Wacke,300,7,13,7,16,39,57,-18,46
SV Josko Rie,300,8,11,6,19,38,53,-15,39
Mattersburg,300,9,9,8,19,45,63,-18,35
St. Pölten,300,10,6,9,21,37,67,-30,27
SK Sturm Gra,301,1,22,5,9,70,34,36,71
FC Salzburg,301,2,21,6,9,68,34,34,69
SC Rheindorf,301,3,19,9,8,57,44,13,66
Rapid Vienna,301,4,17,10,9,64,36,28,61
Vienna,301,5,17,6,13,62,50,12,57
Admira Wacke,301,6,13,6,17,34,52,-18,45
RZ Pellets W,301,7,9,12,15,45,58,-13,39
St. Pölten,301,8,8,11,17,37,66,-29,35
Mattersburg,301,9,7,8,21,39,69,-30,29
SV Josko Rie,301,10,6,9,21,32,65,-33,27
FC Salzburg,302,1,24,5,7,71,26,45,77
SK Sturm Gra,302,2,19,7,10,64,39,25,64
SC Rheindorf,302,3,17,9,10,59,52,7,60
Vienna,302,4,17,8,11,62,54,8,59
Rapid Vienna,302,5,13,10,13,55,41,14,49
RZ Pellets W,302,6,12,7,17,41,59,-18,43
Admira Wacke,302,7,12,6,18,47,65,-18,42
SV Josko Rie,302,8,12,4,20,42,57,-15,40
St. Pölten,302,9,9,10,17,42,63,-21,37
Mattersburg,302,10,8,8,20,35,62,-27,32
FC Salzburg,303,1,23,8,5,67,24,43,77
SC Rheindorf,303,2,20,7,9,56,44,12,67
Rapid Vienna,303,3,15,12,9,63,37,26,57
SK Sturm Gra,303,4,17,5,14,56,39,17,56
Vienna,303,5,15,7,14,53,54,-1,52
SV Josko Rie,303,6,14,5,17,40,51,-11,47
RZ Pellets W,303,7,12,6,18,42,55,-13,42
Admira Wacke,303,8,12,6,18,35,58,-23,42
St. Pölten,303,9,8,10,18,39,66,-27,34
Mattersburg,303,10,7,8,21,38,61,-23,29
FC Salzburg,304,1,24,5,7,73,34,39,77
SK Sturm Gra,304,2,21,4,11,71,33,38,67
SC Rheindorf,304,3,19,7,10,59,44,15,64
Vienna,304,4,19,4,13,69,64,5,61
Rapid Vienna,304,5,15,11,10,58,37,21,56
RZ Pellets W,304,6,12,8,16,43,60,-17,44
SV Josko Rie,304,7,11,5,20,36,53,-17,38
St. Pölten,304,8,9,9,18,41,63,-22,36
Admira Wacke,304,9,10,6,20,35,68,-33,36
Mattersburg,304,10,8,5,23,31,60,-29,29
FC Salzburg,305,1,23,7,6,67,25,42,76
SK Sturm Gra,305,2,19,9,8,67,34,33,66
SC Rheindorf,305,3,17,9,10,47,39,8,60
Vienna,305,4,18,4,14,59,52,7,58
Rapid Vienna,305,5,13,9,14,51,46,5,48
RZ Pellets W,305,6,13,9,14,45,51,-6,48
St. Pölten,305,7,11,9,16,51,63,-12,42
SV Josko Rie,305,8,12,4,20,38,56,-18,40
Mattersburg,305,9,9,7,20,34,59,-25,34
Admira Wacke,305,10,8,7,21,37,71,-34,31
FC Salzburg,306,1,20,8,8,65,31,34,68
SC Rheindorf,306,2,18,12,6,52,37,15,66
SK Sturm Gra,306,3,17,9,10,55,33,22,60
Vienna,306,4,18,3,15,56,51,5,57
Rapid Vienna,306,5,13,12,11,56,44,12,51
Admira Wacke,306,6,13,9,14,46,59,-13,48
RZ Pellets W,306,7,11,8,17,41,55,-14,41
Mattersburg,306,8,10,7,19,36,56,-20,37
SV Josko Rie,306,9,9,8,19,27,48,-21,35
St. Pölten,306,10,8,10,18,42,62,-20,34
FC Salzburg,307,1,22,7,7,66,29,37,73
SC Rheindorf,307,2,21,6,9,61,37,24,69
SK Sturm Gra,307,3,20,5,11,58,39,19,65
Vienna,307,4,19,5,12,68,56,12,62
Rapid Vienna,307,5,12,12,12,47,40,7,48
SV Josko Rie,307,6,14,4,18,44,51,-7,46
RZ Pellets W,307,7,12,7,17,46,52,-6,43
Admira Wacke,307,8,12,7,17,39,55,-16,43
St. Pölten,307,9,7,8,21,36,73,-37,29
Mattersburg,307,10,7,7,22,30,63,-33,28
SC Rheindorf,308,1,20,8,8,61,41,20,68
FC Salzburg,308,2,19,7,10,60,34,26,64
Rapid Vienna,308,3,18,9,9,58,34,24,63
SK Sturm Gra,308,4,19,6,11,55,35,20,63
Vienna,308,5,19,4,13,69,58,11,61
RZ Pellets W,308,6,10,11,15,46,59,-13,41
Admira Wacke,308,7,12,5,19,43,60,-17,41
St. Pölten,308,8,9,10,17,44,62,-18,37
Mattersburg,308,9,9,8,19,38,59,-21,35
SV Josko Rie,308,10,9,4,23,34,66,-32,31
FC Salzburg,309,1,20,7,9,67,31,36,67
SC Rheindorf,309,2,19,9,8,51,35,16,66
SK Sturm Gra,309,3,18,8,10,58,32,26,62
Vienna,309,4,18,7,11,60,50,10,61
Rapid Vienna,309,5,14,11,11,50,38,12,53
RZ Pellets W,309,6,12,10,14,42,50,-8,46
SV Josko Rie,309,7,12,7,17,39,51,-12,43
Admira Wacke,309,8,11,5,20,31,56,-25,38
Mattersburg,309,9,7,11,18,34,63,-29,32
St. Pölten,309,10,5,13,18,32,58,-26,28
SK Sturm Gra,310,1,23,4,9,64,35,29,73
FC Salzburg,310,2,21,9,6,70,33,37,72
SC Rheindorf,310,3,21,8,7,61,40,21,71
Vienna,310,4,18,4,14,61,53,8,58
Rapid Vienna,310,5,14,9,13,56,48,8,51
Admira Wacke,310,6,12,7,17,41,57,-16,43
RZ Pellets W,310,7,11,6,19,47,61,-14,39
SV Josko Rie,310,8,11,6,19,36,52,-16,39
Mattersburg,310,9,7,10,19,34,57,-23,31
St. Pölten,310,10,5,11,20,34,68,-34,26
FC Salzburg,311,1,23,5,8,70,37,33,74
SC Rheindorf,311,2,23,4,9,68,40,28,73
SK Sturm Gra,311,3,21,6,9,63,33,30,69
Vienna,311,4,20,5,11,66,53,13,65
Rapid Vienna,311,5,14,10,12,54,43,11,52
RZ Pellets W,311,6,12,6,18,46,58,-12,42
Admira Wacke,311,7,12,6,18,40,61,-21,42
Mattersburg,311,8,10,5,21,36,56,-20,35
SV Josko Rie,311,9,8,8,20,40,61,-21,32
St. Pölten,311,10,5,9,22,31,72,-41,24
SC Rheindorf,312,1,19,8,9,56,44,12,65
FC Salzburg,312,2,18,10,8,63,33,30,64
SK Sturm Gra,312,3,17,9,10,52,30,22,60
Vienna,312,4,18,5,13,57,50,7,59
Rapid Vienna,312,5,15,8,13,55,41,14,53
SV Josko Rie,312,6,14,5,17,40,47,-7,47
St. Pölten,312,7,11,11,14,44,56,-12,44
RZ Pellets W,312,8,9,11,16,37,52,-15,38
Mattersburg,312,9,9,9,18,36,60,-24,36
Admira Wacke,312,10,8,8,20,33,60,-27,32
SC Rheindorf,313,1,20,9,7,57,41,16,69
SK Sturm Gra,313,2,18,8,10,55,33,22,62
FC Salzburg,313,3,18,6,12,56,31,25,60
Vienna,313,4,18,3,15,58,55,3,57
Rapid Vienna,313,5,15,9,12,54,43,11,54
RZ Pellets W,313,6,15,8,13,62,54,8,53
Admira Wacke,313,7,12,4,20,33,57,-24,40
Mattersburg,313,8,10,9,17,41,61,-20,39
SV Josko Rie,313,9,10,6,20,31,50,-19,36
St. Pölten,313,10,8,10,18,38,60,-22,34
FC Salzburg,314,1,23,7,6,73,34,39,76
SC Rheindorf,314,2,19,7,10,56,47,9,64
Vienna,314,3,17,8,11,70,56,14,59
SK Sturm Gra,314,4,17,7,12,50,38,12,58
Rapid Vienna,314,5,15,10,11,51,39,12,55
RZ Pellets W,314,6,15,7,14,49,46,3,52
Admira Wacke,314,7,15,5,16,50,56,-6,50
SV Josko Rie,314,8,8,6,22,31,57,-26,30
Mattersburg,314,9,7,8,21,40,63,-23,29
St. Pölten,314,10,6,11,19,36,70,-34,29
FC Salzburg,315,1,24,7,5,70,29,41,79
SC Rheindorf,315,2,19,8,9,61,46,15,65
Vienna,315,3,20,4,12,72,52,20,64
SK Sturm Gra,315,4,18,9,9,55,31,24,63
Rapid Vienna,315,5,15,9,12,51,37,14,54
RZ Pellets W,315,6,13,6,17,47,58,-11,45
Admira Wacke,315,7,11,6,19,47,67,-20,39
Mattersburg,315,8,10,6,20,39,62,-23,36
SV Josko Rie,315,9,10,5,21,35,56,-21,35
St. Pölten,315,10,7,6,23,33,72,-39,27
FC Salzburg,316,1,21,7,8,61,29,32,70
SC Rheindorf,316,2,19,9,8,58,41,17,66
Vienna,316,3,20,4,12,68,53,15,64
SK Sturm Gra,316,4,19,5,12,64,40,24,62
Rapid Vienna,316,5,17,9,10,60,39,21,60
Admira Wacke,316,6,12,6,18,39,54,-15,42
RZ Pellets W,316,7,11,7,18,52,66,-14,40
Mattersburg,316,8,9,8,19,42,62,-20,35
St. Pölten,316,9,8,10,18,42,65,-23,34
SV Josko Rie,316,10,9,5,22,31,68,-37,32
FC Salzburg,317,1,23,6,7,80,29,51,75
SK Sturm Gra,317,2,20,7,9,67,30,37,67
SC Rheindorf,317,3,19,8,9,53,38,15,65
Rapid Vienna,317,4,17,8,11,57,39,18,59
Vienna,317,5,15,9,12,58,55,3,54
RZ Pellets W,317,6,12,9,15,42,56,-14,45
Admira Wacke,317,7,12,6,18,40,55,-15,42
SV Josko Rie,317,8,10,5,21,29,58,-29,35
Mattersburg,317,9,9,7,20,33,56,-23,34
St. Pölten,317,10,6,9,21,35,78,-43,27
FC Salzburg,318,1,20,11,5,68,32,36,71
SC Rheindorf,318,2,21,5,10,65,46,19,68
SK Sturm Gra,318,3,20,6,10,61,34,27,66
Vienna,318,4,18,7,11,68,53,15,61
Rapid Vienna,318,5,15,10,11,64,45,19,55
RZ Pellets W,318,6,12,8,16,44,54,-10,44
St. Pölten,318,7,8,11,17,39,61,-22,35
SV Josko Rie,318,8,9,7,20,30,55,-25,34
Mattersburg,318,9,7,11,18,36,64,-28,32
Admira Wacke,318,10,8,8,20,32,63,-31,32
FC Salzburg,319,1,21,7,8,65,31,34,70
SK Sturm Gra,319,2,20,8,8,59,31,28,68
SC Rheindorf,319,3,20,6,10,57,40,17,66
Vienna,319,4,18,5,13,62,55,7,59
Rapid Vienna,319,5,13,10,13,54,43,11,49
SV Josko Rie,319,6,14,5,17,38,54,-16,47
RZ Pellets W,319,7,12,9,15,52,58,-6,45
Admira Wacke,319,8,10,6,20,32,64,-32,36
St. Pölten,319,9,9,7,20,39,59,-20,34
Mattersburg,319,10,7,9,20,32,55,-23,30
SC Rheindorf,320,1,21,8,7,59,41,18,71
FC Salzburg,320,2,20,6,10,61,32,29,66
SK Sturm Gra,320,3,18,7,11,55,36,19,61
Vienna,320,4,18,4,14,56,53,3,58
Rapid Vienna,320,5,15,10,11,56,39,17,55
St. Pölten,320,6,10,10,16,50,65,-15,40
Admira Wacke,320,7,11,7,18,39,58,-19,40
RZ Pellets W,320,8,11,5,20,46,62,-16,38
Mattersburg,320,9,9,10,17,42,57,-15,37
SV Josko Rie,320,10,9,9,18,29,50,-21,36
SC Rheindorf,321,1,22,4,10,56,40,16,70
FC Salzburg,321,2,20,9,7,64,31,33,69
SK Sturm Gra,321,3,19,7,10,65,40,25,64
Vienna,321,4,18,4,14,63,52,11,58
Rapid Vienna,321,5,13,11,12,58,45,13,50
Mattersburg,321,6,10,10,16,36,46,-10,40
St. Pölten,321,7,10,10,16,44,59,-15,40
Admira Wacke,321,8,12,4,20,32,63,-31,40
RZ Pellets W,321,9,10,9,17,41,61,-20,39
SV Josko Rie,321,10,9,6,21,31,53,-22,33
FC Salzburg,322,1,19,11,6,59,28,31,68
SK Sturm Gra,322,2,20,7,9,62,30,32,67
Vienna,322,3,21,4,11,63,52,11,67
SC Rheindorf,322,4,16,9,11,51,42,9,57
Rapid Vienna,322,5,12,14,10,45,33,12,50
Admira Wacke,322,6,13,6,17,42,57,-15,45
SV Josko Rie,322,7,12,8,16,39,50,-11,44
RZ Pellets W,322,8,10,11,15,37,53,-16,41
St. Pölten,322,9,7,9,20,39,67,-28,30
Mattersburg,322,10,5,11,20,31,56,-25,26
FC Salzburg,323,1,23,6,7,66,27,39,75
SK Sturm Gra,323,2,20,5,11,59,35,24,65
Vienna,323,3,19,5,12,68,50,18,62
SC Rheindorf,323,4,18,7,11,55,47,8,61
Rapid Vienna,323,5,14,9,13,54,38,16,51
Admira Wacke,323,6,12,6,18,32,52,-20,42
Mattersburg,323,7,11,7,18,41,59,-18,40
SV Josko Rie,323,8,12,4,20,37,56,-19,40
RZ Pellets W,323,9,12,4,20,45,66,-21,40
St. Pölten,323,10,8,9,19,42,69,-27,33
FC Salzburg,324,1,23,7,6,64,28,36,76
SK Sturm Gra,324,2,22,5,9,69,37,32,71
SC Rheindorf,324,3,18,8,10,50,42,8,62
Vienna,324,4,19,4,13,70,54,16,61
Rapid Vienna,324,5,13,11,12,52,46,6,50
RZ Pellets W,324,6,14,7,15,49,50,-1,49
Admira Wacke,324,7,12,5,19,34,59,-25,41
SV Josko Rie,324,8,11,3,22,39,60,-21,36
St. Pölten,324,9,8,9,19,47,68,-21,33
Mattersburg,324,10,7,7,22,35,65,-30,28
FC Salzburg,325,1,23,5,8,75,36,39,74
SC Rheindorf,325,2,20,9,7,61,41,20,69
SK Sturm Gra,325,3,21,4,11,60,32,28,67
Vienna,325,4,18,5,13,59,60,-1,59
Rapid Vienna,325,5,15,11,10,60,40,20,56
RZ Pellets W,325,6,12,6,18,51,60,-9,42
St. Pölten,325,7,11,8,17,45,70,-25,41
Admira Wacke,325,8,12,4,20,37,60,-23,40
Mattersburg,325,9,9,8,19,46,57,-11,35
SV Josko Rie,325,10,6,6,24,31,69,-38,24
SC Rheindorf,326,1,21,8,7,64,40,24,71
FC Salzburg,326,2,21,7,8,66,35,31,70
SK Sturm Gra,326,3,20,7,9,64,31,33,67
Vienna,326,4,17,6,13,55,52,3,57
Rapid Vienna,326,5,14,12,10,64,42,22,54
RZ Pellets W,326,6,12,9,15,49,68,-19,45
Mattersburg,326,7,10,8,18,40,50,-10,38
Admira Wacke,326,8,10,8,18,35,59,-24,38
SV Josko Rie,326,9,10,4,22,34,58,-24,34
St. Pölten,326,10,7,7,22,38,74,-36,28
FC Salzburg,327,1,20,7,9,60,29,31,67
SC Rheindorf,327,2,19,10,7,51,37,14,67
Vienna,327,3,19,7,10,63,44,19,64
Rapid Vienna,327,4,16,10,10,57,37,20,58
SK Sturm Gra,327,5,16,9,11,55,35,20,57
RZ Pellets W,327,6,12,9,15,44,57,-13,45
Admira Wacke,327,7,11,8,17,39,58,-19,41
Mattersburg,327,8,8,11,17,38,55,-17,35
SV Josko Rie,327,9,8,9,19,33,58,-25,33
St. Pölten,327,10,7,8,21,38,68,-30,29
Vienna,328,1,21,6,9,65,44,21,69
SK Sturm Gra,328,2,20,8,8,70,33,37,68
FC Salzburg,328,3,18,10,8,61,29,32,64
SC Rheindorf,328,4,17,7,12,53,46,7,58
Rapid Vienna,328,5,14,11,11,51,36,15,53
SV Josko Rie,328,6,11,8,17,36,57,-21,41
RZ Pellets W,328,7,10,8,18,44,59,-15,38
Admira Wacke,328,8,10,8,18,34,60,-26,38
Mattersburg,328,9,9,9,18,36,59,-23,36
St. Pölten,328,10,8,9,19,44,71,-27,33
SK Sturm Gra,329,1,20,7,9,59,33,26,67
FC Salzburg,329,2,20,6,10,64,27,37,66
Vienna,329,3,20,6,10,69,53,16,66
SC Rheindorf,329,4,18,8,10,54,46,8,62
RZ Pellets W,329,5,13,8,15,48,50,-2,47
Rapid Vienna,329,6,11,12,13,48,43,5,45
St. Pölten,329,7,11,8,17,43,71,-28,41
Admira Wacke,329,8,11,6,19,36,60,-24,39
SV Josko Rie,329,9,10,5,21,34,54,-20,35
Mattersburg,329,10,8,10,18,37,55,-18,34
FC Salzburg,330,1,20,6,10,62,36,26,66
SC Rheindorf,330,2,19,9,8,54,46,8,66
Vienna,330,3,19,8,9,62,44,18,65
SK Sturm Gra,330,4,18,7,11,56,35,21,61
Rapid Vienna,330,5,15,10,11,66,44,22,55
SV Josko Rie,330,6,14,6,16,36,42,-6,48
RZ Pellets W,330,7,10,10,16,41,59,-18,40
Admira Wacke,330,8,11,7,18,34,54,-20,40
St. Pölten,330,9,7,9,20,38,67,-29,30
Mattersburg,330,10,6,10,20,36,58,-22,28
FC Salzburg,331,1,23,7,6,71,26,45,76
SK Sturm Gra,331,2,20,9,7,58,27,31,69
SC Rheindorf,331,3,18,8,10,52,43,9,62
Rapid Vienna,331,4,14,12,10,58,40,18,54
Vienna,331,5,16,5,15,54,56,-2,53
RZ Pellets W,331,6,13,8,15,46,52,-6,47
SV Josko Rie,331,7,12,5,19,39,51,-12,41
Admira Wacke,331,8,8,10,18,31,59,-28,34
Mattersburg,331,9,8,9,19,43,72,-29,33
St. Pölten,331,10,8,7,21,42,68,-26,31
FC Salzburg,332,1,22,7,7,67,32,35,73
SK Sturm Gra,332,2,19,7,10,59,36,23,64
SC Rheindorf,332,3,18,8,10,59,42,17,62
Rapid Vienna,332,4,14,12,10,51,37,14,54
Vienna,332,5,13,7,16,49,58,-9,46
RZ Pellets W,332,6,12,8,16,45,54,-9,44
Admira Wacke,332,7,13,5,18,36,61,-25,44
Mattersburg,332,8,9,13,14,45,54,-9,40
SV Josko Rie,332,9,10,7,19,33,48,-15,37
St. Pölten,332,10,8,10,18,48,70,-22,34
SC Rheindorf,333,1,22,8,6,57,34,23,74
FC Salzburg,333,2,20,7,9,64,29,35,67
Vienna,333,3,20,6,10,66,45,21,66
SK Sturm Gra,333,4,20,5,11,53,34,19,65
Rapid Vienna,333,5,14,10,12,56,38,18,52
Admira Wacke,333,6,13,6,17,36,55,-19,45
RZ Pellets W,333,7,11,6,19,44,66,-22,39
Mattersburg,333,8,10,6,20,37,60,-23,36
St. Pölten,333,9,8,9,19,39,63,-24,33
SV Josko Rie,333,10,7,7,22,25,53,-28,28
FC Salzburg,334,1,24,5,7,72,31,41,77
SC Rheindorf,334,2,19,7,10,60,46,14,64
Vienna,334,3,18,6,12,57,48,9,60
SK Sturm Gra,334,4,18,5,13,59,48,11,59
RZ Pellets W,334,5,15,6,15,50,57,-7,51
Rapid Vienna,334,6,12,9,15,50,42,8,45
SV Josko Rie,334,7,13,6,17,38,49,-11,45
Admira Wacke,334,8,11,6,19,33,60,-27,39
St. Pölten,334,9,8,10,18,45,59,-14,34
Mattersburg,334,10,8,8,20,33,57,-24,32
FC Salzburg,335,1,24,6,6,66,22,44,78
SK Sturm Gra,335,2,23,5,8,65,35,30,74
SC Rheindorf,335,3,22,5,9,57,40,17,71
Vienna,335,4,18,5,13,65,47,18,59
Rapid Vienna,335,5,13,9,14,53,46,7,48
RZ Pellets W,335,6,14,6,16,47,60,-13,48
Admira Wacke,335,7,10,7,19,42,61,-19,37
SV Josko Rie,335,8,9,10,17,28,49,-21,37
Mattersburg,335,9,8,7,21,43,60,-17,31
St. Pölten,335,10,5,8,23,29,75,-46,23
SC Rheindorf,336,1,23,8,5,71,34,37,77
FC Salzburg,336,2,21,7,8,61,31,30,70
SK Sturm Gra,336,3,20,5,11,56,31,25,65
Vienna,336,4,19,5,12,64,52,12,62
Rapid Vienna,336,5,14,11,11,57,43,14,53
RZ Pellets W,336,6,11,10,15,46,56,-10,43
Admira Wacke,336,7,9,9,18,31,54,-23,36
Mattersburg,336,8,8,8,20,35,59,-24,32
St. Pölten,336,9,7,10,19,41,71,-30,31
SV Josko Rie,336,10,8,7,21,34,65,-31,31
SK Sturm Gra,337,1,20,6,10,50,26,24,66
Vienna,337,2,20,5,11,65,46,19,65
SC Rheindorf,337,3,19,8,9,53,39,14,65
FC Salzburg,337,4,16,8,12,50,32,18,56
Rapid Vienna,337,5,13,11,12,49,40,9,50
RZ Pellets W,337,6,14,7,15,48,49,-1,49
Admira Wacke,337,7,14,4,18,39,56,-17,46
Mattersburg,337,8,10,11,15,40,52,-12,41
SV Josko Rie,337,9,9,6,21,43,70,-27,33
St. Pölten,337,10,6,12,18,39,66,-27,30
SK Sturm Gra,338,1,23,4,9,66,32,34,73
FC Salzburg,338,2,22,5,9,71,35,36,71
SC Rheindorf,338,3,20,8,8,60,41,19,68
Vienna,338,4,19,5,12,66,53,13,62
Rapid Vienna,338,5,14,10,12,56,44,12,52
Admira Wacke,338,6,11,5,20,39,67,-28,38
St. Pölten,338,7,9,10,17,47,67,-20,37
SV Josko Rie,338,8,10,6,20,30,54,-24,36
RZ Pellets W,338,9,10,5,21,44,59,-15,35
Mattersburg,338,10,9,8,19,36,63,-27,35
FC Salzburg,339,1,20,9,7,62,30,32,69
Vienna,339,2,19,8,9,68,50,18,65
SC Rheindorf,339,3,18,10,8,62,45,17,64
SK Sturm Gra,339,4,17,7,12,55,36,19,58
Rapid Vienna,339,5,14,12,10,53,41,12,54
SV Josko Rie,339,6,12,9,15,42,49,-7,45
Admira Wacke,339,7,11,7,18,34,56,-22,40
Mattersburg,339,8,10,9,17,42,54,-12,39
RZ Pellets W,339,9,10,5,21,39,67,-28,35
St. Pölten,339,10,7,8,21,36,65,-29,29
FC Salzburg,340,1,23,6,7,65,25,40,75
SC Rheindorf,340,2,20,8,8,64,42,22,68
SK Sturm Gra,340,3,19,8,9,53,28,25,65
Vienna,340,4,18,8,10,62,45,17,62
RZ Pellets W,340,5,16,6,14,47,51,-4,54
Rapid Vienna,340,6,11,12,13,49,43,6,45
SV Josko Rie,340,7,10,8,18,32,53,-21,38
Admira Wacke,340,8,8,9,19,28,55,-27,33
Mattersburg,340,9,7,9,20,35,61,-26,30
St. Pölten,340,10,6,10,20,38,70,-32,28
SC Rheindorf,341,1,21,9,6,59,38,21,72
FC Salzburg,341,2,19,8,9,60,32,28,65
SK Sturm Gra,341,3,20,5,11,59,34,25,65
Vienna,341,4,21,2,13,62,52,10,65
Rapid Vienna,341,5,15,9,12,56,39,17,54
SV Josko Rie,341,6,13,5,18,36,46,-10,44
RZ Pellets W,341,7,11,8,17,48,61,-13,41
St. Pölten,341,8,10,9,17,41,63,-22,39
Admira Wacke,341,9,8,7,21,34,61,-27,31
Mattersburg,341,10,6,10,20,32,61,-29,28
FC Salzburg,342,1,21,7,8,61,33,28,70
SC Rheindorf,342,2,19,10,7,55,38,17,67
SK Sturm Gra,342,3,19,5,12,56,34,22,62
Vienna,342,4,19,5,12,59,49,10,62
Rapid Vienna,342,5,14,11,11,54,41,13,53
RZ Pellets W,342,6,13,7,16,47,53,-6,46
Admira Wacke,342,7,10,11,15,35,54,-19,41
St. Pölten,342,8,9,10,17,37,57,-20,37
Mattersburg,342,9,9,8,19,42,58,-16,35
SV Josko Rie,342,10,7,6,23,29,58,-29,27
SK Sturm Gra,343,1,20,9,7,63,36,27,69
FC Salzburg,343,2,20,7,9,65,39,26,67
Vienna,343,3,20,5,11,63,49,14,65
SC Rheindorf,343,4,18,6,12,54,43,11,60
RZ Pellets W,343,5,13,10,13,48,49,-1,49
Rapid Vienna,343,6,11,12,13,50,41,9,45
SV Josko Rie,343,7,12,4,20,38,54,-16,40
Admira Wacke,343,8,11,6,19,32,59,-27,39
St. Pölten,343,9,8,10,18,38,59,-21,34
Mattersburg,343,10,8,9,19,36,58,-22,33
SC Rheindorf,344,1,21,9,6,58,39,19,72
SK Sturm Gra,344,2,21,7,8,65,31,34,70
FC Salzburg,344,3,20,7,9,64,36,28,67
Vienna,344,4,21,2,13,76,56,20,65
Rapid Vienna,344,5,14,10,12,55,43,12,52
Admira Wacke,344,6,12,7,17,37,53,-16,43
SV Josko Rie,344,7,13,4,19,34,53,-19,43
RZ Pellets W,344,8,10,6,20,38,62,-24,36
St. Pölten,344,9,8,8,20,36,64,-28,32
Mattersburg,344,10,6,8,22,33,59,-26,26
SK Sturm Gra,345,1,21,6,9,66,33,33,69
SC Rheindorf,345,2,18,8,10,63,46,17,62
Vienna,345,3,18,6,12,63,55,8,60
Rapid Vienna,345,4,16,11,9,57,37,20,59
FC Salzburg,345,5,16,9,11,64,42,22,57
SV Josko Rie,345,6,15,5,16,46,51,-5,50
RZ Pellets W,345,7,11,10,15,52,57,-5,43
Admira Wacke,345,8,11,7,18,35,64,-29,40
St. Pölten,345,9,7,10,19,41,71,-30,31
Mattersburg,345,10,7,8,21,34,65,-31,29
FC Salzburg,346,1,24,7,5,70,31,39,79
SC Rheindorf,346,2,22,5,9,66,38,28,71
SK Sturm Gra,346,3,22,4,10,66,35,31,70
Vienna,346,4,16,7,13,54,56,-2,55
Rapid Vienna,346,5,14,8,14,55,42,13,50
RZ Pellets W,346,6,14,6,16,46,55,-9,48
Admira Wacke,346,7,12,5,19,36,56,-20,41
Mattersburg,346,8,9,6,21,35,58,-23,33
SV Josko Rie,346,9,9,5,22,30,54,-24,32
St. Pölten,346,10,7,9,20,33,66,-33,30
FC Salzburg,347,1,22,7,7,67,32,35,73
SK Sturm Gra,347,2,21,6,9,60,32,28,69
SC Rheindorf,347,3,20,8,8,57,43,14,68
Vienna,347,4,17,8,11,58,47,11,59
Rapid Vienna,347,5,13,9,14,57,46,11,48
Mattersburg,347,6,11,9,16,41,51,-10,42
Admira Wacke,347,7,11,7,18,38,59,-21,40
RZ Pellets W,347,8,10,7,19,42,59,-17,37
SV Josko Rie,347,9,8,9,19,34,60,-26,33
St. Pölten,347,10,7,10,19,43,68,-25,31
SK Sturm Gra,348,1,22,4,10,62,30,32,70
FC Salzburg,348,2,19,9,8,57,29,28,66
Vienna,348,3,18,7,11,66,51,15,61
SC Rheindorf,348,4,16,9,11,53,48,5,57
Rapid Vienna,348,5,14,11,11,56,41,15,53
RZ Pellets W,348,6,13,8,15,45,60,-15,47
Admira Wacke,348,7,13,7,16,42,57,-15,46
Mattersburg,348,8,10,7,19,40,61,-21,37
St. Pölten,348,9,8,10,18,43,60,-17,34
SV Josko Rie,348,10,8,6,22,29,56,-27,30
SC Rheindorf,349,1,22,7,7,57,40,17,73
FC Salzburg,349,2,18,8,10,62,30,32,62
Vienna,349,3,18,7,11,62,47,15,61
SK Sturm Gra,349,4,17,8,11,56,38,18,59
Rapid Vienna,349,5,15,11,10,61,42,19,56
Admira Wacke,349,6,12,6,18,35,57,-22,42
SV Josko Rie,349,7,11,5,20,36,56,-20,38
St. Pölten,349,8,10,8,18,38,60,-22,38
RZ Pellets W,349,9,9,10,17,40,58,-18,37
Mattersburg,349,10,9,8,19,36,55,-19,35
SC Rheindorf,350,1,22,6,8,60,41,19,72
Vienna,350,2,22,4,10,68,42,26,70
FC Salzburg,350,3,20,6,10,59,34,25,66
SK Sturm Gra,350,4,19,7,10,57,33,24,64
Rapid Vienna,350,5,15,11,10,62,44,18,56
RZ Pellets W,350,6,11,7,18,44,66,-22,40
Mattersburg,350,7,10,9,17,43,55,-12,39
SV Josko Rie,350,8,10,4,22,32,55,-23,34
Admira Wacke,350,9,10,4,22,37,62,-25,34
St. Pölten,350,10,8,8,20,41,71,-30,32
SC Rheindorf,351,1,25,5,6,59,34,25,80
FC Salzburg,351,2,22,7,7,72,33,39,73
Vienna,351,3,19,5,12,66,48,18,62
SK Sturm Gra,351,4,17,6,13,57,42,15,57
Rapid Vienna,351,5,15,11,10,56,37,19,56
RZ Pellets W,351,6,11,8,17,45,58,-13,41
Admira Wacke,351,7,11,8,17,42,62,-20,41
St. Pölten,351,8,8,11,17,43,63,-20,35
SV Josko Rie,351,9,10,5,21,39,62,-23,35
Mattersburg,351,10,6,6,24,32,72,-40,24
FC Salzburg,352,1,19,8,9,63,34,29,65
Vienna,352,2,19,7,10,70,54,16,64
SK Sturm Gra,352,3,19,5,12,61,40,21,62
Rapid Vienna,352,4,16,11,9,56,33,23,59
SC Rheindorf,352,5,16,10,10,56,50,6,58
RZ Pellets W,352,6,13,8,15,51,58,-7,47
Mattersburg,352,7,13,6,17,39,53,-14,45
Admira Wacke,352,8,11,7,18,37,58,-21,40
SV Josko Rie,352,9,11,3,22,34,54,-20,36
St. Pölten,352,10,6,9,21,43,76,-33,27
FC Salzburg,353,1,20,9,7,68,37,31,69
SK Sturm Gra,353,2,17,7,12,52,33,19,58
Rapid Vienna,353,3,16,10,10,64,48,16,58
Vienna,353,4,17,6,13,73,58,15,57
SC Rheindorf,353,5,17,5,14,53,51,2,56
RZ Pellets W,353,6,13,9,14,57,54,3,48
Mattersburg,353,7,12,6,18,48,62,-14,42
St. Pölten,353,8,10,10,16,48,65,-17,40
Admira Wacke,353,9,12,4,20,32,66,-34,40
SV Josko Rie,353,10,10,6,20,33,54,-21,36
SC Rheindorf,354,1,20,8,8,58,42,16,68
SK Sturm Gra,354,2,19,7,10,63,41,22,64
FC Salzburg,354,3,18,8,10,61,33,28,62
Rapid Vienna,354,4,15,12,9,58,37,21,57
Vienna,354,5,17,6,13,62,54,8,57
Admira Wacke,354,6,14,6,16,48,54,-6,48
RZ Pellets W,354,7,10,9,17,44,66,-22,39
Mattersburg,354,8,9,9,18,42,59,-17,36
SV Josko Rie,354,9,9,7,20,33,57,-24,34
St. Pölten,354,10,8,10,18,42,68,-26,34
FC Salzburg,355,1,19,10,7,60,28,32,67
SC Rheindorf,355,2,18,10,8,52,44,8,64
SK Sturm Gra,355,3,17,10,9,61,36,25,61
Vienna,355,4,16,6,14,62,58,4,54
Rapid Vienna,355,5,12,12,12,51,39,12,48
Admira Wacke,355,6,12,10,14,35,51,-16,46
RZ Pellets W,355,7,10,12,14,42,53,-11,42
SV Josko Rie,355,8,11,7,18,30,46,-16,40
Mattersburg,355,9,10,9,17,44,56,-12,39
St. Pölten,355,10,6,12,18,41,67,-26,30
FC Salzburg,356,1,21,8,7,62,29,33,71
SC Rheindorf,356,2,21,8,7,57,37,20,71
SK Sturm Gra,356,3,18,7,11,62,44,18,61
Vienna,356,4,18,5,13,68,52,16,59
Rapid Vienna,356,5,15,8,13,57,43,14,53
RZ Pellets W,356,6,13,5,18,39,53,-14,44
St. Pölten,356,7,12,7,17,47,63,-16,43
Admira Wacke,356,8,10,6,20,36,59,-23,36
Mattersburg,356,9,9,8,19,39,59,-20,35
SV Josko Rie,356,10,10,4,22,27,55,-28,34
FC Salzburg,357,1,22,6,8,68,29,39,72
SC Rheindorf,357,2,20,9,7,58,40,18,69
Vienna,357,3,21,3,12,73,54,19,66
SK Sturm Gra,357,4,16,6,14,53,42,11,54
RZ Pellets W,357,5,15,8,13,55,55,0,53
Rapid Vienna,357,6,11,13,12,54,46,8,46
Admira Wacke,357,7,13,5,18,38,63,-25,44
SV Josko Rie,357,8,10,6,20,34,54,-20,36
St. Pölten,357,9,9,8,19,40,64,-24,35
Mattersburg,357,10,7,8,21,37,63,-26,29
FC Salzburg,358,1,21,8,7,66,31,35,71
SC Rheindorf,358,2,21,7,8,60,45,15,70
SK Sturm Gra,358,3,18,7,11,64,38,26,61
Vienna,358,4,17,6,13,65,55,10,57
RZ Pellets W,358,5,13,7,16,47,52,-5,46
Mattersburg,358,6,12,8,16,42,50,-8,44
SV Josko Rie,358,7,12,8,16,34,45,-11,44
Rapid Vienna,358,8,10,11,15,49,50,-1,41
St. Pölten,358,9,8,10,18,36,66,-30,34
Admira Wacke,358,10,9,6,21,29,60,-31,33
FC Salzburg,359,1,23,8,5,75,34,41,77
SK Sturm Gra,359,2,21,5,10,59,28,31,68
SC Rheindorf,359,3,19,8,9,58,46,12,65
Vienna,359,4,15,7,14,55,57,-2,52
RZ Pellets W,359,5,12,9,15,44,53,-9,45
Admira Wacke,359,6,13,6,17,34,55,-21,45
Rapid Vienna,359,7,11,11,14,55,46,9,44
SV Josko Rie,359,8,13,4,19,44,59,-15,43
St. Pölten,359,9,7,12,17,37,58,-21,33
Mattersburg,359,10,7,8,21,31,56,-25,29
FC Salzburg,360,1,21,6,9,61,30,31,69
SC Rheindorf,360,2,21,6,9,55,37,18,69
Vienna,360,3,20,5,11,68,53,15,65
SK Sturm Gra,360,4,18,4,14,54,41,13,58
Rapid Vienna,360,5,15,12,9,66,45,21,57
RZ Pellets W,360,6,13,9,14,49,55,-6,48
Admira Wacke,360,7,11,8,17,41,66,-25,41
SV Josko Rie,360,8,9,8,19,29,50,-21,35
Mattersburg,360,9,8,8,20,39,62,-23,32
St. Pölten,360,10,5,12,19,35,58,-23,27
FC Salzburg,361,1,21,8,7,59,25,34,71
SC Rheindorf,361,2,20,9,7,52,34,18,69
SK Sturm Gra,361,3,20,7,9,60,31,29,67
Vienna,361,4,19,8,9,62,44,18,65
Rapid Vienna,361,5,18,7,11,57,39,18,61
Admira Wacke,361,6,14,3,19,38,55,-17,45
SV Josko Rie,361,7,11,6,19,35,53,-18,39
RZ Pellets W,361,8,9,6,21,41,68,-27,33
St. Pölten,361,9,7,10,19,37,58,-21,31
Mattersburg,361,10,4,10,22,34,68,-34,22
SC Rheindorf,362,1,23,6,7,61,35,26,75
FC Salzburg,362,2,22,8,6,62,25,37,74
Vienna,362,3,21,4,11,66,47,19,67
SK Sturm Gra,362,4,19,7,10,54,28,26,64
Rapid Vienna,362,5,11,12,13,50,43,7,45
RZ Pellets W,362,6,12,8,16,39,54,-15,44
Admira Wacke,362,7,9,8,19,34,59,-25,35
St. Pölten,362,8,9,8,19,37,64,-27,35
SV Josko Rie,362,9,9,5,22,33,59,-26,32
Mattersburg,362,10,7,10,19,36,58,-22,31
Vienna,363,1,21,5,10,69,43,26,68
SC Rheindorf,363,2,19,7,10,54,43,11,64
FC Salzburg,363,3,18,8,10,55,38,17,62
Rapid Vienna,363,4,17,10,9,57,36,21,61
SK Sturm Gra,363,5,16,11,9,58,38,20,59
RZ Pellets W,363,6,11,9,16,48,58,-10,42
Mattersburg,363,7,9,12,15,37,47,-10,39
SV Josko Rie,363,8,10,5,21,28,47,-19,35
St. Pölten,363,9,7,13,16,43,67,-24,34
Admira Wacke,363,10,10,4,22,31,63,-32,34
FC Salzburg,364,1,21,8,7,66,31,35,71
SC Rheindorf,364,2,18,9,9,58,44,14,63
SK Sturm Gra,364,3,18,8,10,55,28,27,62
Vienna,364,4,19,3,14,61,58,3,60
Rapid Vienna,364,5,13,14,9,56,38,18,53
RZ Pellets W,364,6,12,8,16,46,54,-8,44
Admira Wacke,364,7,11,8,17,35,59,-24,41
SV Josko Rie,364,8,10,7,19,35,52,-17,37
Mattersburg,364,9,8,11,17,36,54,-18,35
St. Pölten,364,10,7,10,19,36,66,-30,31
FC Salzburg,365,1,22,7,7,65,28,37,73
SK Sturm Gra,365,2,19,8,9,60,33,27,65
SC Rheindorf,365,3,19,7,10,51,38,13,64
Rapid Vienna,365,4,13,12,11,55,40,15,51
RZ Pellets W,365,5,14,9,13,49,53,-4,51
Vienna,365,6,14,7,15,54,56,-2,49
SV Josko Rie,365,7,11,8,17,35,50,-15,41
Mattersburg,365,8,9,9,18,41,59,-18,36
St. Pölten,365,9,8,11,17,43,62,-19,35
Admira Wacke,365,10,9,6,21,31,65,-34,33
FC Salzburg,366,1,23,6,7,67,27,40,75
SC Rheindorf,366,2,22,7,7,58,37,21,73
Vienna,366,3,18,6,12,65,50,15,60
SK Sturm Gra,366,4,17,7,12,65,40,25,58
Rapid Vienna,366,5,12,10,14,48,45,3,46
RZ Pellets W,366,6,12,7,17,37,55,-18,43
Admira Wacke,366,7,12,5,19,36,61,-25,41
SV Josko Rie,366,8,12,4,20,35,53,-18,40
Mattersburg,366,9,9,9,18,32,50,-18,36
St. Pölten,366,10,8,9,19,32,57,-25,33
FC Salzburg,367,1,19,8,9,61,29,32,65
SK Sturm Gra,367,2,17,8,11,56,34,22,59
Rapid Vienna,367,3,16,10,10,60,42,18,58
SC Rheindorf,367,4,17,7,12,54,47,7,58
Vienna,367,5,17,5,14,58,52,6,56
SV Josko Rie,367,6,17,3,16,44,50,-6,54
RZ Pellets W,367,7,15,6,15,54,57,-3,51
Mattersburg,367,8,9,8,19,44,65,-21,35
Admira Wacke,367,9,10,5,21,33,62,-29,35
St. Pölten,367,10,8,10,18,39,65,-26,34
SC Rheindorf,368,1,20,8,8,62,45,17,68
SK Sturm Gra,368,2,19,7,10,59,30,29,64
Rapid Vienna,368,3,17,11,8,59,35,24,62
FC Salzburg,368,4,18,6,12,58,37,21,60
Vienna,368,5,16,7,13,66,59,7,55
Admira Wacke,368,6,13,6,17,38,53,-15,45
St. Pölten,368,7,10,10,16,40,56,-16,40
RZ Pellets W,368,8,10,9,17,44,66,-22,39
SV Josko Rie,368,9,10,6,20,35,62,-27,36
Mattersburg,368,10,8,8,20,41,59,-18,32
SK Sturm Gra,369,1,20,9,7,63,33,30,69
FC Salzburg,369,2,20,8,8,68,36,32,68
Vienna,369,3,20,5,11,64,53,11,65
SC Rheindorf,369,4,18,9,9,54,39,15,63
Rapid Vienna,369,5,13,11,12,55,44,11,50
RZ Pellets W,369,6,10,10,16,42,53,-11,40
Admira Wacke,369,7,11,7,18,37,61,-24,40
SV Josko Rie,369,8,11,6,19,37,58,-21,39
Mattersburg,369,9,9,9,18,41,59,-18,36
St. Pölten,369,10,6,10,20,39,64,-25,28
Vienna,370,1,21,7,8,69,45,24,70
SK Sturm Gra,370,2,20,8,8,59,31,28,68
FC Salzburg,370,3,20,7,9,62,33,29,67
SC Rheindorf,370,4,18,10,8,52,40,12,64
RZ Pellets W,370,5,16,6,14,55,54,1,54
Rapid Vienna,370,6,12,13,11,52,39,13,49
Admira Wacke,370,7,10,6,20,32,61,-29,36
SV Josko Rie,370,8,10,5,21,41,63,-22,35
St. Pölten,370,9,7,10,19,37,65,-28,31
Mattersburg,370,10,6,8,22,31,59,-28,26
FC Salzburg,371,1,26,5,5,73,25,48,83
SK Sturm Gra,371,2,21,4,11,58,33,25,67
SC Rheindorf,371,3,19,5,12,59,47,12,62
Vienna,371,4,18,3,15,59,60,-1,57
Rapid Vienna,371,5,15,8,13,62,47,15,53
Admira Wacke,371,6,13,5,18,40,58,-18,44
SV Josko Rie,371,7,12,3,21,35,55,-20,39
RZ Pellets W,371,8,10,8,18,41,57,-16,38
Mattersburg,371,9,10,7,19,35,58,-23,37
St. Pölten,371,10,8,8,20,41,63,-22,32
FC Salzburg,372,1,21,6,9,69,35,34,69
SK Sturm Gra,372,2,21,4,11,58,33,25,67
SC Rheindorf,372,3,18,8,10,48,39,9,62
Vienna,372,4,16,6,14,68,59,9,54
Rapid Vienna,372,5,13,11,12,57,47,10,50
Admira Wacke,372,6,15,4,17,44,61,-17,49
RZ Pellets W,372,7,13,8,15,51,58,-7,47
SV Josko Rie,372,8,10,10,16,38,51,-13,40
St. Pölten,372,9,7,11,18,35,61,-26,32
Mattersburg,372,10,7,10,19,38,62,-24,31
FC Salzburg,373,1,21,9,6,65,28,37,72
SC Rheindorf,373,2,21,7,8,52,36,16,70
SK Sturm Gra,373,3,22,3,11,62,30,32,69
Rapid Vienna,373,4,17,9,10,58,37,21,60
Vienna,373,5,16,6,14,50,50,0,54
RZ Pellets W,373,6,11,10,15,46,55,-9,43
Admira Wacke,373,7,11,8,17,37,53,-16,41
SV Josko Rie,373,8,10,6,20,31,57,-26,36
Mattersburg,373,9,8,10,18,37,54,-17,34
St. Pölten,373,10,6,6,24,34,72,-38,24
SC Rheindorf,374,1,22,6,8,60,39,21,72
Vienna,374,2,20,6,10,60,42,18,66
FC Salzburg,374,3,17,9,10,54,33,21,60
SK Sturm Gra,374,4,17,8,11,53,35,18,59
RZ Pellets W,374,5,15,8,13,47,49,-2,53
Rapid Vienna,374,6,13,12,11,56,39,17,51
SV Josko Rie,374,7,12,5,19,36,47,-11,41
Admira Wacke,374,8,9,8,19,33,63,-30,35
Mattersburg,374,9,7,13,16,37,55,-18,34
St. Pölten,374,10,7,7,22,39,73,-34,28
FC Salzburg,375,1,21,9,6,65,27,38,72
SC Rheindorf,375,2,22,6,8,65,47,18,72
SK Sturm Gra,375,3,17,10,9,63,43,20,61
Vienna,375,4,15,7,14,60,56,4,52
Rapid Vienna,375,5,11,14,11,55,44,11,47
SV Josko Rie,375,6,13,6,17,41,50,-9,45
Admira Wacke,375,7,10,9,17,46,66,-20,39
St. Pölten,375,8,9,11,16,45,58,-13,38
RZ Pellets W,375,9,9,8,19,41,65,-24,35
Mattersburg,375,10,9,8,19,34,59,-25,35
FC Salzburg,376,1,20,7,9,58,31,27,67
SC Rheindorf,376,2,20,7,9,53,41,12,67
SK Sturm Gra,376,3,18,8,10,59,33,26,62
Vienna,376,4,16,8,12,60,49,11,56
Rapid Vienna,376,5,15,9,12,54,33,21,54
Admira Wacke,376,6,13,8,15,38,53,-15,47
St. Pölten,376,7,10,10,16,40,59,-19,40
RZ Pellets W,376,8,9,11,16,39,55,-16,38
Mattersburg,376,9,9,11,16,35,53,-18,38
SV Josko Rie,376,10,8,5,23,31,60,-29,29
FC Salzburg,377,1,20,8,8,70,35,35,68
SC Rheindorf,377,2,19,9,8,56,38,18,66
SK Sturm Gra,377,3,19,8,9,60,36,24,65
Vienna,377,4,19,7,10,67,54,13,64
Rapid Vienna,377,5,15,12,9,60,36,24,57
RZ Pellets W,377,6,13,6,17,47,60,-13,45
Admira Wacke,377,7,10,7,19,36,61,-25,37
St. Pölten,377,8,9,8,19,37,64,-27,35
SV Josko Rie,377,9,8,8,20,25,54,-29,32
Mattersburg,377,10,7,9,20,39,59,-20,30
SC Rheindorf,378,1,21,7,8,62,38,24,70
SK Sturm Gra,378,2,20,8,8,65,40,25,68
FC Salzburg,378,3,19,8,9,62,34,28,65
Vienna,378,4,18,7,11,62,54,8,61
Rapid Vienna,378,5,15,11,10,69,41,28,56
Admira Wacke,378,6,11,7,18,41,65,-24,40
RZ Pellets W,378,7,9,9,18,48,66,-18,36
Mattersburg,378,8,9,9,18,45,66,-21,36
SV Josko Rie,378,9,10,5,21,36,61,-25,35
St. Pölten,378,10,5,15,16,44,69,-25,30
SK Sturm Gra,379,1,20,7,9,61,26,35,67
FC Salzburg,379,2,20,7,9,63,37,26,67
SC Rheindorf,379,3,18,8,10,55,46,9,62
Vienna,379,4,18,5,13,55,49,6,59
Rapid Vienna,379,5,15,10,11,58,38,20,55
RZ Pellets W,379,6,14,8,14,49,53,-4,50
Admira Wacke,379,7,11,6,19,34,54,-20,39
SV Josko Rie,379,8,10,8,18,34,58,-24,38
Mattersburg,379,9,9,8,19,38,60,-22,35
St. Pölten,379,10,5,13,18,36,62,-26,28
SK Sturm Gra,380,1,20,8,8,66,37,29,68
FC Salzburg,380,2,18,10,8,58,25,33,64
SC Rheindorf,380,3,18,8,10,57,42,15,62
Rapid Vienna,380,4,17,10,9,55,33,22,61
Vienna,380,5,16,8,12,57,52,5,56
Mattersburg,380,6,11,9,16,41,53,-12,42
RZ Pellets W,380,7,10,10,16,40,55,-15,40
SV Josko Rie,380,8,9,7,20,29,49,-20,34
St. Pölten,380,9,8,10,18,38,66,-28,34
Admira Wacke,380,10,8,10,18,32,61,-29,34
SC Rheindorf,381,1,22,7,7,58,37,21,73
SK Sturm Gra,381,2,21,6,9,63,34,29,69
FC Salzburg,381,3,19,8,9,74,37,37,65
Rapid Vienna,381,4,15,10,11,60,43,17,55
Vienna,381,5,17,4,15,57,56,1,55
Admira Wacke,381,6,15,6,15,44,52,-8,51
RZ Pellets W,381,7,11,9,16,43,57,-14,42
SV Josko Rie,381,8,12,4,20,40,58,-18,40
St. Pölten,381,9,8,9,19,37,63,-26,33
Mattersburg,381,10,5,7,24,35,74,-39,22
SK Sturm Gra,382,1,23,5,8,72,31,41,74
FC Salzburg,382,2,21,7,8,64,32,32,70
SC Rheindorf,382,3,17,8,11,51,48,3,59
Vienna,382,4,17,6,13,60,55,5,57
Rapid Vienna,382,5,15,8,13,62,44,18,53
Admira Wacke,382,6,11,8,17,40,61,-21,41
RZ Pellets W,382,7,10,9,17,52,68,-16,39
Mattersburg,382,8,10,8,18,42,58,-16,38
SV Josko Rie,382,9,10,6,20,28,51,-23,36
St. Pölten,382,10,8,11,17,47,70,-23,35
FC Salzburg,383,1,22,7,7,66,28,38,73
SK Sturm Gra,383,2,21,6,9,64,32,32,69
SC Rheindorf,383,3,19,8,9,56,44,12,65
Rapid Vienna,383,4,14,10,12,51,40,11,52
Vienna,383,5,16,4,16,60,52,8,52
St. Pölten,383,6,12,8,16,49,58,-9,44
RZ Pellets W,383,7,12,8,16,46,56,-10,44
Admira Wacke,383,8,11,7,18,38,69,-31,40
SV Josko Rie,383,9,8,8,20,28,54,-26,32
Mattersburg,383,10,7,10,19,31,56,-25,31
FC Salzburg,384,1,21,6,9,66,37,29,69
SC Rheindorf,384,2,20,6,10,60,44,16,66
Vienna,384,3,20,4,12,68,51,17,64
SK Sturm Gra,384,4,18,8,10,57,35,22,62
RZ Pellets W,384,5,12,8,16,43,53,-10,44
Mattersburg,384,6,10,10,16,36,53,-17,40
SV Josko Rie,384,6,12,4,20,36,53,-17,40
Admira Wacke,384,8,11,7,18,39,63,-24,40
Rapid Vienna,384,9,9,12,15,49,46,3,39
St. Pölten,384,10,8,13,15,38,57,-19,37
SC Rheindorf,385,1,22,7,7,63,37,26,73
FC Salzburg,385,2,20,9,7,65,32,33,69
SK Sturm Gra,385,3,19,5,12,62,38,24,62
Vienna,385,4,18,7,11,62,50,12,61
RZ Pellets W,385,5,16,7,13,46,48,-2,55
Rapid Vienna,385,6,12,10,14,54,55,-1,46
SV Josko Rie,385,7,12,6,18,38,50,-12,42
Mattersburg,385,8,9,8,19,42,59,-17,35
Admira Wacke,385,9,9,5,22,30,63,-33,32
St. Pölten,385,10,8,6,22,39,69,-30,30
FC Salzburg,386,1,22,9,5,74,28,46,75
SC Rheindorf,386,2,18,8,10,48,37,11,62
SK Sturm Gra,386,3,18,7,11,60,41,19,61
Vienna,386,4,15,10,11,59,55,4,55
RZ Pellets W,386,5,15,8,13,48,49,-1,53
Rapid Vienna,386,6,12,13,11,48,36,12,49
SV Josko Rie,386,7,11,8,17,30,43,-13,41
Admira Wacke,386,8,9,8,19,31,59,-28,35
St. Pölten,386,9,6,13,17,30,54,-24,31
Mattersburg,386,10,7,10,19,33,59,-26,31
SC Rheindorf,387,1,24,6,6,67,34,33,78
FC Salzburg,387,2,21,8,7,69,33,36,71
SK Sturm Gra,387,3,18,6,12,56,39,17,60
Vienna,387,4,16,6,14,57,54,3,54
Rapid Vienna,387,5,13,10,13,56,47,9,49
RZ Pellets W,387,6,13,9,14,49,51,-2,48
Admira Wacke,387,7,10,9,17,38,65,-27,39
SV Josko Rie,387,8,10,5,21,36,57,-21,35
Mattersburg,387,9,9,7,20,37,58,-21,34
St. Pölten,387,10,8,10,18,35,62,-27,34
SC Rheindorf,388,1,20,8,8,60,37,23,68
FC Salzburg,388,2,20,7,9,60,34,26,67
Vienna,388,3,19,5,12,60,51,9,62
SK Sturm Gra,388,4,15,10,11,47,30,17,55
Rapid Vienna,388,5,14,12,10,60,41,19,54
Admira Wacke,388,6,13,8,15,34,49,-15,47
Mattersburg,388,7,11,9,16,42,56,-14,42
RZ Pellets W,388,8,9,10,17,37,54,-17,37
St. Pölten,388,9,7,12,17,42,62,-20,33
SV Josko Rie,388,10,8,7,21,31,59,-28,31
FC Salzburg,389,1,22,6,8,65,27,38,72
SK Sturm Gra,389,2,22,6,8,64,34,30,72
SC Rheindorf,389,3,21,8,7,59,36,23,71
Vienna,389,4,20,3,13,61,55,6,63
Rapid Vienna,389,5,12,13,11,50,40,10,49
RZ Pellets W,389,6,14,7,15,51,57,-6,49
Admira Wacke,389,7,9,8,19,35,60,-25,35
Mattersburg,389,8,8,8,20,39,58,-19,32
St. Pölten,389,9,8,7,21,40,70,-30,31
SV Josko Rie,389,10,7,8,21,26,53,-27,29
FC Salzburg,390,1,22,9,5,67,28,39,75
SK Sturm Gra,390,2,21,6,9,61,31,30,69
SC Rheindorf,390,3,20,8,8,55,39,16,68
Vienna,390,4,14,9,13,56,52,4,51
Rapid Vienna,390,5,13,11,12,51,39,12,50
RZ Pellets W,390,6,14,6,16,52,58,-6,48
SV Josko Rie,390,7,12,6,18,35,51,-16,42
Admira Wacke,390,8,10,6,20,40,67,-27,36
St. Pölten,390,9,8,10,18,40,66,-26,34
Mattersburg,390,10,5,11,20,29,55,-26,26
SK Sturm Gra,391,1,22,7,7,62,27,35,73
FC Salzburg,391,2,19,7,10,55,34,21,64
Vienna,391,3,18,6,12,61,49,12,60
SC Rheindorf,391,4,18,6,12,57,50,7,60
Rapid Vienna,391,5,12,11,13,54,42,12,47
Admira Wacke,391,6,13,8,15,42,57,-15,47
St. Pölten,391,7,11,9,16,49,67,-18,42
RZ Pellets W,391,8,12,5,19,48,61,-13,41
SV Josko Rie,391,9,12,4,20,37,51,-14,40
Mattersburg,391,10,8,7,21,35,62,-27,31
Rapid Vienna,392,1,20,8,8,67,36,31,68
SK Sturm Gra,392,2,21,5,10,59,31,28,68
FC Salzburg,392,3,20,6,10,61,33,28,66
SC Rheindorf,392,4,18,7,11,56,49,7,61
Vienna,392,5,19,2,15,59,59,0,59
St. Pölten,392,6,10,12,14,38,51,-13,42
Admira Wacke,392,7,12,5,19,42,58,-16,41
RZ Pellets W,392,8,11,7,18,46,64,-18,40
SV Josko Rie,392,9,8,7,21,35,59,-24,31
Mattersburg,392,10,6,11,19,37,60,-23,29
FC Salzburg,393,1,21,9,6,62,28,34,72
SC Rheindorf,393,2,18,11,7,59,37,22,65
SK Sturm Gra,393,3,18,3,15,54,36,18,57
Vienna,393,4,17,6,13,57,58,-1,57
Rapid Vienna,393,5,13,9,14,54,44,10,48
Admira Wacke,393,6,14,5,17,44,61,-17,47
RZ Pellets W,393,7,13,7,16,42,53,-11,46
SV Josko Rie,393,8,10,8,18,31,49,-18,38
Mattersburg,393,9,9,9,18,38,56,-18,36
St. Pölten,393,10,9,9,18,47,66,-19,36
FC Salzburg,394,1,22,8,6,76,30,46,74
SK Sturm Gra,394,2,21,7,8,71,37,34,70
SC Rheindorf,394,3,20,10,6,62,42,20,70
Vienna,394,4,15,6,15,61,56,5,51
RZ Pellets W,394,5,11,10,15,50,62,-12,43
Rapid Vienna,394,6,11,9,16,55,53,2,42
Mattersburg,394,7,11,8,17,42,59,-17,41
SV Josko Rie,394,8,11,5,20,34,62,-28,38
Admira Wacke,394,9,10,8,18,31,59,-28,38
St. Pölten,394,10,9,7,20,41,63,-22,34
FC Salzburg,395,1,21,8,7,63,25,38,71
Vienna,395,2,22,3,11,64,42,22,69
SC Rheindorf,395,3,20,6,10,62,43,19,66
SK Sturm Gra,395,4,19,5,12,69,42,27,62
Rapid Vienna,395,5,16,9,11,56,39,17,57
RZ Pellets W,395,6,13,6,17,45,60,-15,45
Admira Wacke,395,7,11,5,20,38,68,-30,38
St. Pölten,395,8,10,7,19,43,65,-22,37
SV Josko Rie,395,9,10,3,23,30,58,-28,33
Mattersburg,395,10,8,8,20,34,62,-28,32
FC Salzburg,396,1,20,9,7,67,28,39,69
SC Rheindorf,396,2,20,7,9,56,42,14,67
SK Sturm Gra,396,3,19,7,10,64,38,26,64
Vienna,396,4,19,4,13,56,53,3,61
Rapid Vienna,396,5,17,9,10,58,35,23,60
RZ Pellets W,396,6,13,9,14,46,50,-4,48
Admira Wacke,396,7,13,3,20,40,58,-18,42
Mattersburg,396,8,8,10,18,31,52,-21,34
SV Josko Rie,396,9,10,3,23,31,56,-25,33
St. Pölten,396,10,6,9,21,29,66,-37,27
FC Salzburg,397,1,20,8,8,66,35,31,68
SC Rheindorf,397,2,20,6,10,52,40,12,66
SK Sturm Gra,397,3,19,4,13,62,37,25,61
Vienna,397,4,19,4,13,61,50,11,61
Rapid Vienna,397,5,16,9,11,57,44,13,57
RZ Pellets W,397,6,12,8,16,46,49,-3,44
SV Josko Rie,397,7,12,6,18,38,53,-15,42
Admira Wacke,397,8,12,6,18,35,61,-26,42
St. Pölten,397,9,8,9,19,38,62,-24,33
Mattersburg,397,10,8,8,20,34,58,-24,32
FC Salzburg,398,1,21,5,10,64,39,25,68
SK Sturm Gra,398,2,19,10,7,62,26,36,67
SC Rheindorf,398,3,19,7,10,58,38,20,64
Vienna,398,4,19,3,14,64,54,10,60
Rapid Vienna,398,5,12,12,12,54,42,12,48
Admira Wacke,398,6,12,8,16,38,61,-23,44
SV Josko Rie,398,7,12,5,19,35,50,-15,41
St. Pölten,398,8,10,9,17,45,64,-19,39
RZ Pellets W,398,9,10,8,18,44,64,-20,38
Mattersburg,398,10,9,7,20,33,59,-26,34
FC Salzburg,399,1,22,10,4,71,30,41,76
Vienna,399,2,21,6,9,64,47,17,69
SC Rheindorf,399,3,17,9,10,58,45,13,60
SK Sturm Gra,399,4,17,7,12,54,36,18,58
Rapid Vienna,399,5,14,10,12,53,40,13,52
RZ Pellets W,399,6,12,8,16,42,55,-13,44
Admira Wacke,399,7,11,8,17,41,61,-20,41
SV Josko Rie,399,8,10,5,21,35,54,-19,35
St. Pölten,399,9,8,9,19,36,63,-27,33
Mattersburg,399,10,7,10,19,32,55,-23,31
FC Salzburg,400,1,22,9,5,71,26,45,75
SC Rheindorf,400,2,20,8,8,57,40,17,68
SK Sturm Gra,400,3,18,7,11,63,35,28,61
Vienna,400,4,16,8,12,59,50,9,56
RZ Pellets W,400,5,14,7,15,43,54,-11,49
Rapid Vienna,400,6,11,13,12,57,45,12,46
SV Josko Rie,400,7,13,5,18,32,49,-17,44
Admira Wacke,400,8,9,8,19,37,67,-30,35
St. Pölten,400,9,8,10,18,37,63,-26,34
Mattersburg,400,10,7,9,20,33,60,-27,30
FC Salzburg,401,1,23,5,8,66,29,37,74
SC Rheindorf,401,2,22,8,6,65,34,31,74
SK Sturm Gra,401,3,17,8,11,51,36,15,59
Rapid Vienna,401,4,15,10,11,56,36,20,55
Vienna,401,5,16,7,13,54,57,-3,55
RZ Pellets W,401,6,11,7,18,41,60,-19,40
Mattersburg,401,7,10,8,18,42,55,-13,38
St. Pölten,401,8,9,10,17,41,62,-21,37
SV Josko Rie,401,9,10,5,21,35,54,-19,35
Admira Wacke,401,10,9,8,19,36,64,-28,35
FC Salzburg,402,1,20,8,8,64,34,30,68
SK Sturm Gra,402,2,19,9,8,62,34,28,66
SC Rheindorf,402,3,19,8,9,54,44,10,65
Vienna,402,4,17,8,11,62,47,15,59
Rapid Vienna,402,5,15,11,10,58,38,20,56
SV Josko Rie,402,6,12,6,18,40,53,-13,42
RZ Pellets W,402,7,10,11,15,42,53,-11,41
Admira Wacke,402,8,8,10,18,35,61,-26,34
St. Pölten,402,9,9,7,20,39,68,-29,34
Mattersburg,402,10,7,10,19,31,55,-24,31
FC Salzburg,403,1,20,9,7,67,37,30,69
SC Rheindorf,403,2,18,11,7,56,37,19,65
Vienna,403,3,19,6,11,61,49,12,63
SK Sturm Gra,403,4,14,13,9,48,33,15,55
Rapid Vienna,403,5,13,11,12,56,44,12,50
RZ Pellets W,403,6,11,11,14,43,52,-9,44
Admira Wacke,403,7,11,7,18,33,56,-23,40
St. Pölten,403,8,9,12,15,42,59,-17,39
Mattersburg,403,9,9,9,18,37,56,-19,36
SV Josko Rie,403,10,9,5,22,35,55,-20,32
SK Sturm Gra,404,1,23,6,7,70,28,42,75
FC Salzburg,404,2,20,8,8,63,34,29,68
Vienna,404,3,18,6,12,60,48,12,60
SC Rheindorf,404,4,17,8,11,51,44,7,59
Rapid Vienna,404,5,14,10,12,61,44,17,52
St. Pölten,404,6,11,9,16,46,62,-16,42
Admira Wacke,404,7,11,6,19,38,66,-28,39
RZ Pellets W,404,8,10,8,18,43,62,-19,38
Mattersburg,404,9,10,7,19,35,55,-20,37
SV Josko Rie,404,10,9,6,21,35,59,-24,33
FC Salzburg,405,1,23,6,7,75,37,38,75
SC Rheindorf,405,2,22,6,8,59,39,20,72
SK Sturm Gra,405,3,19,5,12,58,36,22,62
Rapid Vienna,405,4,16,10,10,58,35,23,58
Vienna,405,5,18,4,14,65,57,8,58
Mattersburg,405,6,12,8,16,44,52,-8,44
Admira Wacke,405,7,11,7,18,36,61,-25,40
RZ Pellets W,405,8,10,7,19,48,72,-24,37
St. Pölten,405,9,8,7,21,41,64,-23,31
SV Josko Rie,405,10,9,4,23,27,58,-31,31
FC Salzburg,406,1,20,8,8,67,34,33,68
SC Rheindorf,406,2,21,5,10,66,41,25,68
Vienna,406,3,19,5,12,62,50,12,62
Rapid Vienna,406,4,16,9,11,55,40,15,57
SK Sturm Gra,406,5,16,8,12,49,37,12,56
Admira Wacke,406,6,15,4,17,43,55,-12,49
RZ Pellets W,406,7,11,9,16,35,54,-19,42
Mattersburg,406,8,11,8,17,40,51,-11,41
SV Josko Rie,406,9,8,7,21,32,58,-26,31
St. Pölten,406,10,7,9,20,35,64,-29,30
FC Salzburg,407,1,22,7,7,66,28,38,73
SC Rheindorf,407,2,19,11,6,55,41,14,68
SK Sturm Gra,407,3,20,7,9,64,38,26,67
Rapid Vienna,407,4,14,11,11,54,41,13,53
Vienna,407,5,16,5,15,58,52,6,53
RZ Pellets W,407,6,12,8,16,49,56,-7,44
Admira Wacke,407,7,11,10,15,33,52,-19,43
SV Josko Rie,407,8,10,5,21,37,55,-18,35
St. Pölten,407,9,8,9,19,37,65,-28,33
Mattersburg,407,10,8,7,21,34,59,-25,31
FC Salzburg,408,1,22,8,6,71,31,40,74
SC Rheindorf,408,2,21,8,7,63,38,25,71
Vienna,408,3,19,6,11,68,58,10,63
SK Sturm Gra,408,4,17,7,12,56,37,19,58
Rapid Vienna,408,5,15,10,11,62,48,14,55
RZ Pellets W,408,6,13,5,18,49,54,-5,44
Admira Wacke,408,7,10,7,19,37,61,-24,37
SV Josko Rie,408,8,10,6,20,32,57,-25,36
Mattersburg,408,9,8,10,18,39,60,-21,34
St. Pölten,408,10,7,9,20,44,77,-33,30
SC Rheindorf,409,1,21,7,8,61,41,20,70
FC Salzburg,409,2,20,9,7,65,31,34,69
SK Sturm Gra,409,3,19,6,11,59,39,20,63
Vienna,409,4,18,6,12,56,50,6,60
Rapid Vienna,409,5,14,10,12,50,36,14,52
Admira Wacke,409,6,13,7,16,37,51,-14,46
RZ Pellets W,409,7,10,7,19,43,56,-13,37
SV Josko Rie,409,8,10,7,19,34,51,-17,37
Mattersburg,409,9,10,7,19,35,58,-23,37
St. Pölten,409,10,8,8,20,41,68,-27,32
SC Rheindorf,410,1,22,7,7,59,35,24,73
SK Sturm Gra,410,2,19,9,8,64,30,34,66
FC Salzburg,410,3,19,6,11,56,33,23,63
Vienna,410,4,19,6,11,66,50,16,63
Rapid Vienna,410,5,14,10,12,52,39,13,52
RZ Pellets W,410,6,12,9,15,43,55,-12,45
Admira Wacke,410,7,12,4,20,42,66,-24,40
SV Josko Rie,410,8,10,7,19,33,53,-20,37
St. Pölten,410,9,8,9,19,42,67,-25,33
Mattersburg,410,10,8,7,21,35,64,-29,31
FC Salzburg,411,1,19,7,10,66,36,30,64
SK Sturm Gra,411,2,17,10,9,56,33,23,61
Vienna,411,3,18,6,12,52,47,5,60
SC Rheindorf,411,4,18,6,12,53,50,3,60
Rapid Vienna,411,5,16,10,10,63,37,26,58
Admira Wacke,411,6,13,7,16,36,55,-19,46
SV Josko Rie,411,7,12,6,18,35,46,-11,42
RZ Pellets W,411,8,11,5,20,43,64,-21,38
St. Pölten,411,9,9,10,17,44,65,-21,37
Mattersburg,411,10,9,9,18,39,54,-15,36
SC Rheindorf,412,1,20,9,7,60,41,19,69
FC Salzburg,412,2,20,8,8,65,29,36,68
Rapid Vienna,412,3,16,11,9,64,38,26,59
SK Sturm Gra,412,4,16,6,14,50,36,14,54
RZ Pellets W,412,5,15,9,12,55,53,2,54
Vienna,412,6,17,3,16,58,59,-1,54
Admira Wacke,412,7,13,6,17,35,54,-19,45
Mattersburg,412,8,10,8,18,38,55,-17,38
SV Josko Rie,412,9,9,7,20,27,51,-24,34
St. Pölten,412,10,7,7,22,36,72,-36,28
FC Salzburg,413,1,20,9,7,65,31,34,69
Vienna,413,2,19,6,11,65,50,15,63
SC Rheindorf,413,3,18,7,11,51,43,8,61
SK Sturm Gra,413,4,17,9,10,53,33,20,60
Rapid Vienna,413,5,15,9,12,55,40,15,54
Admira Wacke,413,6,13,5,18,33,53,-20,44
RZ Pellets W,413,7,11,10,15,46,55,-9,43
Mattersburg,413,8,11,8,17,41,51,-10,41
St. Pölten,413,9,8,10,18,45,71,-26,34
SV Josko Rie,413,10,7,9,20,25,52,-27,30
FC Salzburg,414,1,23,6,7,67,27,40,75
SC Rheindorf,414,2,19,8,9,58,51,7,65
SK Sturm Gra,414,3,18,6,12,60,40,20,60
Vienna,414,4,18,5,13,66,52,14,59
RZ Pellets W,414,5,13,8,15,43,56,-13,47
Rapid Vienna,414,6,11,12,13,51,42,9,45
SV Josko Rie,414,7,12,4,20,39,53,-14,40
St. Pölten,414,8,10,8,18,53,74,-21,38
Admira Wacke,414,9,9,10,17,36,61,-25,37
Mattersburg,414,10,9,9,18,36,53,-17,36
FC Salzburg,415,1,21,8,7,78,33,45,71
SK Sturm Gra,415,2,19,8,9,67,38,29,65
SC Rheindorf,415,3,18,7,11,58,49,9,61
Vienna,415,4,15,7,14,64,61,3,52
Rapid Vienna,415,5,12,13,11,55,40,15,49
RZ Pellets W,415,6,13,7,16,53,64,-11,46
Mattersburg,415,7,13,7,16,49,61,-12,46
Admira Wacke,415,8,12,6,18,43,64,-21,42
SV Josko Rie,415,9,13,2,21,35,61,-26,41
St. Pölten,415,10,7,9,20,39,70,-31,30
SK Sturm Gra,416,1,22,7,7,58,27,31,73
FC Salzburg,416,2,21,7,8,66,27,39,70
SC Rheindorf,416,3,18,9,9,52,43,9,63
Vienna,416,4,17,7,12,62,50,12,58
Rapid Vienna,416,5,13,12,11,57,46,11,51
Admira Wacke,416,6,12,6,18,41,61,-20,42
RZ Pellets W,416,7,11,7,18,40,54,-14,40
SV Josko Rie,416,8,11,7,18,36,51,-15,40
Mattersburg,416,9,9,7,20,34,59,-25,34
St. Pölten,416,10,7,9,20,37,65,-28,30
SC Rheindorf,417,1,22,8,6,65,42,23,74
Vienna,417,2,20,5,11,71,59,12,65
FC Salzburg,417,3,18,8,10,57,28,29,62
SK Sturm Gra,417,4,17,10,9,54,31,23,61
Rapid Vienna,417,5,16,9,11,63,43,20,57
RZ Pellets W,417,6,12,8,16,50,54,-4,44
Admira Wacke,417,7,9,9,18,34,58,-24,36
Mattersburg,417,8,8,10,18,35,57,-22,34
SV Josko Rie,417,9,9,6,21,33,61,-28,33
St. Pölten,417,10,7,11,18,45,74,-29,32
SK Sturm Gra,418,1,23,5,8,67,32,35,74
FC Salzburg,418,2,22,6,8,68,32,36,72
Vienna,418,3,21,5,10,63,44,19,68
SC Rheindorf,418,4,19,8,9,55,47,8,65
Rapid Vienna,418,5,13,12,11,59,47,12,51
SV Josko Rie,418,6,11,5,20,33,51,-18,38
Admira Wacke,418,7,10,7,19,36,61,-25,37
St. Pölten,418,8,9,8,19,46,65,-19,35
RZ Pellets W,418,9,9,8,19,43,68,-25,35
Mattersburg,418,10,7,8,21,28,51,-23,29
FC Salzburg,419,1,20,7,9,59,30,29,67
SC Rheindorf,419,2,20,7,9,59,42,17,67
Vienna,419,3,20,6,10,63,50,13,66
SK Sturm Gra,419,4,19,8,9,54,27,27,65
Rapid Vienna,419,5,14,12,10,54,39,15,54
Admira Wacke,419,6,12,6,18,36,53,-17,42
RZ Pellets W,419,7,10,10,16,44,55,-11,40
SV Josko Rie,419,8,9,8,19,32,54,-22,35
St. Pölten,419,9,8,9,19,40,66,-26,33
Mattersburg,419,10,7,9,20,35,60,-25,30
FC Salzburg,420,1,24,5,7,76,25,51,77
SK Sturm Gra,420,2,21,8,7,65,31,34,71
Vienna,420,3,21,6,9,70,50,20,69
SC Rheindorf,420,4,17,7,12,50,55,-5,58
Rapid Vienna,420,5,13,10,13,55,38,17,49
SV Josko Rie,420,6,13,5,18,36,51,-15,44
Admira Wacke,420,7,11,6,19,42,63,-21,39
St. Pölten,420,8,9,7,20,40,71,-31,34
Mattersburg,420,9,7,11,18,36,57,-21,32
RZ Pellets W,420,10,7,9,20,36,65,-29,30
FC Salzburg,421,1,22,7,7,68,30,38,73
SK Sturm Gra,421,2,23,4,9,62,33,29,73
SC Rheindorf,421,3,21,4,11,58,46,12,67
Vienna,421,4,18,3,15,58,52,6,57
RZ Pellets W,421,5,15,8,13,56,56,0,53
Admira Wacke,421,6,13,5,18,44,61,-17,44
Rapid Vienna,421,7,10,11,15,52,54,-2,41
SV Josko Rie,421,8,11,3,22,37,57,-20,36
St. Pölten,421,9,8,10,18,45,68,-23,34
Mattersburg,421,10,7,9,20,38,61,-23,30
SK Sturm Gra,422,1,22,5,9,63,32,31,71
FC Salzburg,422,2,21,6,9,62,29,33,69
SC Rheindorf,422,3,19,7,10,70,51,19,64
Rapid Vienna,422,4,14,12,10,48,35,13,54
Vienna,422,5,16,5,15,55,56,-1,53
RZ Pellets W,422,6,12,7,17,46,56,-10,43
Admira Wacke,422,7,11,7,18,32,52,-20,40
SV Josko Rie,422,8,10,9,17,38,54,-16,39
Mattersburg,422,9,10,7,19,37,59,-22,37
St. Pölten,422,10,7,11,18,41,68,-27,32
SC Rheindorf,423,1,25,5,6,63,38,25,80
FC Salzburg,423,2,23,6,7,75,27,48,75
SK Sturm Gra,423,3,20,6,10,64,34,30,66
Vienna,423,4,18,4,14,64,62,2,58
Rapid Vienna,423,5,12,10,14,58,51,7,46
RZ Pellets W,423,6,12,6,18,51,69,-18,42
Admira Wacke,423,7,10,8,18,35,62,-27,38
St. Pölten,423,8,9,9,18,38,61,-23,36
SV Josko Rie,423,9,10,4,22,32,53,-21,34
Mattersburg,423,10,8,8,20,35,58,-23,32
FC Salzburg,424,1,24,7,5,75,30,45,79
SC Rheindorf,424,2,19,10,7,63,43,20,67
Vienna,424,3,16,5,15,64,56,8,53
Rapid Vienna,424,4,14,10,12,60,48,12,52
SK Sturm Gra,424,5,15,5,16,49,39,10,50
RZ Pellets W,424,6,13,8,15,43,51,-8,47
Admira Wacke,424,7,14,4,18,41,62,-21,46
SV Josko Rie,424,8,10,8,18,40,54,-14,38
Mattersburg,424,9,10,8,18,43,65,-22,38
St. Pölten,424,10,7,11,18,36,66,-30,32
SC Rheindorf,425,1,22,5,9,55,39,16,71
Vienna,425,2,21,6,9,65,42,23,69
FC Salzburg,425,3,20,8,8,63,30,33,68
SK Sturm Gra,425,4,19,8,9,58,30,28,65
Rapid Vienna,425,5,13,12,11,47,37,10,51
Admira Wacke,425,6,12,6,18,34,58,-24,42
RZ Pellets W,425,7,10,11,15,46,54,-8,41
SV Josko Rie,425,8,9,8,19,32,51,-19,35
Mattersburg,425,9,8,8,20,32,58,-26,32
St. Pölten,425,10,5,10,21,31,64,-33,25
FC Salzburg,426,1,20,11,5,69,34,35,71
SC Rheindorf,426,2,19,9,8,56,43,13,66
SK Sturm Gra,426,3,18,8,10,60,39,21,62
Vienna,426,4,18,4,14,62,57,5,58
Rapid Vienna,426,5,14,12,10,56,38,18,54
Admira Wacke,426,6,11,9,16,40,56,-16,42
RZ Pellets W,426,7,11,7,18,48,62,-14,40
SV Josko Rie,426,8,11,7,18,38,53,-15,40
St. Pölten,426,9,9,11,16,45,64,-19,38
Mattersburg,426,10,5,10,21,30,58,-28,25
FC Salzburg,427,1,23,7,6,67,26,41,76
SC Rheindorf,427,2,18,9,9,54,40,14,63
Rapid Vienna,427,3,16,10,10,55,36,19,58
Vienna,427,4,18,4,14,59,50,9,58
SK Sturm Gra,427,5,16,9,11,50,34,16,57
RZ Pellets W,427,6,13,8,15,39,48,-9,47
Admira Wacke,427,7,11,6,19,33,57,-24,39
SV Josko Rie,427,8,10,7,19,36,54,-18,37
St. Pölten,427,9,6,15,15,41,63,-22,33
Mattersburg,427,10,6,11,19,31,57,-26,29
SK Sturm Gra,428,1,22,5,9,62,35,27,71
FC Salzburg,428,2,21,7,8,58,27,31,70
SC Rheindorf,428,3,19,8,9,50,34,16,65
Vienna,428,4,20,3,13,70,45,25,63
Rapid Vienna,428,5,14,8,14,57,44,13,50
RZ Pellets W,428,6,14,4,18,41,59,-18,46
SV Josko Rie,428,7,11,8,17,34,52,-18,41
Mattersburg,428,8,9,8,19,37,55,-18,35
St. Pölten,428,9,9,8,19,42,64,-22,35
Admira Wacke,428,10,9,5,22,31,67,-36,32
FC Salzburg,429,1,23,7,6,68,31,37,76
SK Sturm Gra,429,2,20,8,8,59,32,27,68
SC Rheindorf,429,3,20,7,9,63,48,15,67
Vienna,429,4,20,6,10,69,42,27,66
Rapid Vienna,429,5,11,13,12,53,43,10,46
RZ Pellets W,429,6,11,8,17,40,50,-10,41
Mattersburg,429,7,10,8,18,33,54,-21,38
Admira Wacke,429,8,10,7,19,32,60,-28,37
SV Josko Rie,429,9,8,7,21,32,61,-29,31
St. Pölten,429,10,6,11,19,40,68,-28,29
FC Salzburg,430,1,21,7,8,68,37,31,70
Vienna,430,2,22,3,11,74,53,21,69
SC Rheindorf,430,3,19,10,7,56,43,13,67
Rapid Vienna,430,4,14,12,10,54,38,16,54
SK Sturm Gra,430,5,14,10,12,57,39,18,52
RZ Pellets W,430,6,11,10,15,49,64,-15,43
St. Pölten,430,7,10,12,14,44,58,-14,42
Admira Wacke,430,8,10,4,22,36,67,-31,34
SV Josko Rie,430,9,9,6,21,37,53,-16,33
Mattersburg,430,10,7,12,17,44,67,-23,33
FC Salzburg,431,1,21,8,7,63,27,36,71
SK Sturm Gra,431,2,21,6,9,63,30,33,69
SC Rheindorf,431,3,19,8,9,53,41,12,65
Vienna,431,4,16,8,12,58,56,2,56
Rapid Vienna,431,5,13,11,12,57,43,14,50
RZ Pellets W,431,6,13,6,17,48,58,-10,45
Admira Wacke,431,7,12,8,16,42,58,-16,44
SV Josko Rie,431,8,11,5,20,33,53,-20,38
St. Pölten,431,9,9,9,18,46,67,-21,36
Mattersburg,431,10,7,7,22,35,65,-30,28
FC Salzburg,432,1,20,8,8,61,31,30,68
SK Sturm Gra,432,2,21,5,10,63,36,27,68
SC Rheindorf,432,3,20,6,10,69,49,20,66
Vienna,432,4,18,5,13,60,52,8,59
Rapid Vienna,432,5,16,10,10,62,35,27,58
RZ Pellets W,432,6,14,7,15,55,57,-2,49
Admira Wacke,432,7,10,9,17,34,59,-25,39
Mattersburg,432,8,8,12,16,39,58,-19,36
SV Josko Rie,432,9,9,4,23,28,58,-30,31
St. Pölten,432,10,6,10,20,39,75,-36,28
FC Salzburg,433,1,19,10,7,63,30,33,67
SK Sturm Gra,433,2,20,5,11,58,38,20,65
SC Rheindorf,433,3,18,8,10,49,38,11,62
Vienna,433,4,17,6,13,52,46,6,57
Rapid Vienna,433,5,14,12,10,55,38,17,54
RZ Pellets W,433,6,15,7,14,51,51,0,52
Admira Wacke,433,7,12,6,18,35,56,-21,42
Mattersburg,433,8,10,10,16,39,56,-17,40
SV Josko Rie,433,9,10,5,21,28,48,-20,35
St. Pölten,433,10,7,7,22,34,63,-29,28
FC Salzburg,434,1,19,7,10,64,38,26,64
SC Rheindorf,434,2,19,7,10,57,44,13,64
SK Sturm Gra,434,3,18,9,9,57,31,26,63
Vienna,434,4,19,5,12,65,54,11,62
Rapid Vienna,434,5,12,12,12,50,41,9,48
RZ Pellets W,434,6,14,6,16,48,54,-6,48
Mattersburg,434,7,11,8,17,46,61,-15,41
St. Pölten,434,8,10,8,18,41,59,-18,38
SV Josko Rie,434,9,11,5,20,39,59,-20,38
Admira Wacke,434,10,10,7,19,34,60,-26,37
FC Salzburg,435,1,22,8,6,63,29,34,74
SK Sturm Gra,435,2,20,6,10,63,34,29,66
SC Rheindorf,435,3,19,7,10,55,43,12,64
Vienna,435,4,16,7,13,56,52,4,55
Rapid Vienna,435,5,11,15,10,48,37,11,48
RZ Pellets W,435,6,13,9,14,55,52,3,48
Admira Wacke,435,7,11,7,18,36,60,-24,40
St. Pölten,435,8,8,12,16,44,61,-17,36
Mattersburg,435,9,8,10,18,36,61,-25,34
SV Josko Rie,435,10,9,5,22,33,60,-27,32
FC Salzburg,436,1,21,7,8,72,30,42,70
SK Sturm Gra,436,2,21,5,10,60,37,23,68
Rapid Vienna,436,3,15,11,10,53,38,15,56
SC Rheindorf,436,4,16,7,13,50,44,6,55
RZ Pellets W,436,5,16,6,14,48,46,2,54
Vienna,436,6,16,2,18,61,59,2,50
Admira Wacke,436,7,15,4,17,42,55,-13,49
Mattersburg,436,8,10,8,18,43,69,-26,38
SV Josko Rie,436,9,10,5,21,29,56,-27,35
St. Pölten,436,10,8,9,19,45,69,-24,33
FC Salzburg,437,1,22,7,7,69,32,37,73
SC Rheindorf,437,2,19,8,9,52,38,14,65
SK Sturm Gra,437,3,19,4,13,61,39,22,61
Rapid Vienna,437,4,14,11,11,53,38,15,53
Vienna,437,5,16,5,15,55,56,-1,53
SV Josko Rie,437,6,14,7,15,37,41,-4,49
RZ Pellets W,437,7,12,10,14,43,51,-8,46
Admira Wacke,437,8,12,7,17,42,59,-17,43
St. Pölten,437,9,10,10,16,39,60,-21,40
Mattersburg,437,10,4,7,25,25,62,-37,19
SC Rheindorf,438,1,23,6,7,59,37,22,75
FC Salzburg,438,2,21,8,7,63,27,36,71
SK Sturm Gra,438,3,21,7,8,66,34,32,70
Vienna,438,4,18,3,15,56,56,0,57
Rapid Vienna,438,5,13,11,12,52,39,13,50
RZ Pellets W,438,6,14,5,17,49,56,-7,47
Admira Wacke,438,7,11,7,18,38,57,-19,40
SV Josko Rie,438,8,10,4,22,35,59,-24,34
St. Pölten,438,9,8,9,19,34,58,-24,33
Mattersburg,438,10,6,10,20,32,61,-29,28
SC Rheindorf,439,1,22,6,8,66,44,22,72
SK Sturm Gra,439,2,20,5,11,71,42,29,65
FC Salzburg,439,3,18,10,8,65,37,28,64
Vienna,439,4,19,5,12,68,62,6,62
Rapid Vienna,439,5,13,12,11,64,46,18,51
RZ Pellets W,439,6,13,9,14,49,55,-6,48
Admira Wacke,439,7,13,6,17,52,69,-17,45
Mattersburg,439,8,9,9,18,44,59,-15,36
St. Pölten,439,9,7,9,20,42,75,-33,30
SV Josko Rie,439,10,8,5,23,30,62,-32,29
SC Rheindorf,440,1,20,9,7,52,38,14,69
FC Salzburg,440,2,19,9,8,69,34,35,66
Vienna,440,3,18,6,12,58,50,8,60
SK Sturm Gra,440,4,16,7,13,54,39,15,55
Rapid Vienna,440,5,14,11,11,54,44,10,53
Mattersburg,440,6,11,10,15,50,53,-3,43
SV Josko Rie,440,7,11,10,15,39,44,-5,43
RZ Pellets W,440,8,10,10,16,51,61,-10,40
St. Pölten,440,9,7,12,17,38,68,-30,33
Admira Wacke,440,10,9,6,21,28,62,-34,33
SK Sturm Gra,441,1,20,7,9,63,32,31,67
Vienna,441,2,20,5,11,65,53,12,65
SC Rheindorf,441,3,16,13,7,50,38,12,61
FC Salzburg,441,4,16,12,8,63,41,22,60
Rapid Vienna,441,5,13,14,9,56,39,17,53
RZ Pellets W,441,6,16,5,15,50,50,0,53
SV Josko Rie,441,7,12,6,18,43,52,-9,42
Admira Wacke,441,8,12,4,20,41,65,-24,40
St. Pölten,441,9,7,10,19,40,67,-27,31
Mattersburg,441,10,5,10,21,31,65,-34,25
SC Rheindorf,442,1,22,6,8,60,37,23,72
FC Salzburg,442,2,20,5,11,68,38,30,65
Rapid Vienna,442,3,17,11,8,67,39,28,62
Vienna,442,4,18,5,13,65,58,7,59
SK Sturm Gra,442,5,16,6,14,45,35,10,54
RZ Pellets W,442,6,12,9,15,46,54,-8,45
Admira Wacke,442,7,12,7,17,42,69,-27,43
SV Josko Rie,442,8,10,6,20,37,56,-19,36
Mattersburg,442,9,9,9,18,37,57,-20,36
St. Pölten,442,10,7,10,19,42,66,-24,31
FC Salzburg,443,1,19,10,7,65,28,37,67
SC Rheindorf,443,2,17,11,8,51,40,11,62
Vienna,443,3,17,7,12,62,53,9,58
SK Sturm Gra,443,4,15,9,12,54,40,14,54
Rapid Vienna,443,5,13,14,9,63,47,16,53
RZ Pellets W,443,6,14,7,15,47,52,-5,49
Admira Wacke,443,7,13,5,18,35,56,-21,44
St. Pölten,443,8,11,8,17,46,64,-18,41
SV Josko Rie,443,9,10,7,19,33,49,-16,37
Mattersburg,443,10,7,10,19,35,62,-27,31
FC Salzburg,444,1,23,7,6,68,25,43,76
SC Rheindorf,444,2,19,9,8,56,41,15,66
SK Sturm Gra,444,3,18,8,10,62,34,28,62
Vienna,444,4,15,9,12,59,55,4,54
Rapid Vienna,444,5,14,9,13,56,45,11,51
Admira Wacke,444,6,12,9,15,43,63,-20,45
SV Josko Rie,444,7,12,6,18,37,48,-11,42
St. Pölten,444,8,8,12,16,35,55,-20,36
RZ Pellets W,444,9,7,11,18,36,58,-22,32
Mattersburg,444,10,7,10,19,32,60,-28,31
SC Rheindorf,445,1,21,7,8,52,38,14,70
FC Salzburg,445,2,20,7,9,66,33,33,67
Vienna,445,3,19,5,12,63,50,13,62
SK Sturm Gra,445,4,17,8,11,64,44,20,59
Rapid Vienna,445,5,16,10,10,62,37,25,58
RZ Pellets W,445,6,13,10,13,45,53,-8,49
SV Josko Rie,445,7,11,4,21,42,60,-18,37
Mattersburg,445,8,9,7,20,39,64,-25,34
Admira Wacke,445,9,9,7,20,38,65,-27,34
St. Pölten,445,10,8,9,19,42,69,-27,33
FC Salzburg,446,1,22,9,5,72,32,40,75
SC Rheindorf,446,2,21,9,6,61,40,21,72
SK Sturm Gra,446,3,22,5,9,72,30,42,71
Vienna,446,4,17,4,15,56,51,5,55
Rapid Vienna,446,5,13,12,11,54,45,9,51
RZ Pellets W,446,6,10,9,17,39,61,-22,39
St. Pölten,446,7,9,9,18,44,66,-22,36
Admira Wacke,446,8,10,6,20,31,55,-24,36
SV Josko Rie,446,9,9,7,20,31,54,-23,34
Mattersburg,446,10,7,10,19,33,59,-26,31
SC Rheindorf,447,1,20,8,8,60,37,23,68
Vienna,447,2,21,5,10,67,48,19,68
SK Sturm Gra,447,3,20,5,11,60,34,26,65
FC Salzburg,447,4,17,10,9,54,33,21,61
Rapid Vienna,447,5,15,9,12,55,38,17,54
RZ Pellets W,447,6,16,6,14,54,53,1,54
Admira Wacke,447,7,11,9,16,31,55,-24,42
SV Josko Rie,447,8,8,7,21,31,60,-29,31
Mattersburg,447,9,7,8,21,31,56,-25,29
St. Pölten,447,10,5,13,18,36,65,-29,28
FC Salzburg,448,1,20,9,7,65,30,35,69
SK Sturm Gra,448,2,20,7,9,65,31,34,67
Vienna,448,3,20,7,9,64,42,22,67
SC Rheindorf,448,4,18,7,11,50,41,9,61
Rapid Vienna,448,5,13,14,9,53,39,14,53
RZ Pellets W,448,6,11,8,17,43,57,-14,41
St. Pölten,448,7,10,8,18,45,61,-16,38
SV Josko Rie,448,8,11,5,20,33,55,-22,38
Admira Wacke,448,9,11,5,20,36,66,-30,38
Mattersburg,448,10,7,8,21,31,63,-32,29
FC Salzburg,449,1,22,5,9,74,31,43,71
SK Sturm Gra,449,2,20,5,11,59,38,21,65
Rapid Vienna,449,3,16,9,11,52,34,18,57
Vienna,449,4,17,6,13,59,53,6,57
SC Rheindorf,449,5,16,7,13,49,47,2,55
Mattersburg,449,6,12,8,16,43,52,-9,44
RZ Pellets W,449,7,12,6,18,47,65,-18,42
Admira Wacke,449,8,12,6,18,37,57,-20,42
St. Pölten,449,9,10,9,17,47,63,-16,39
SV Josko Rie,449,10,9,7,20,31,58,-27,34
SK Sturm Gra,450,1,20,9,7,61,30,31,69
FC Salzburg,450,2,19,11,6,60,29,31,68
SC Rheindorf,450,3,16,9,11,46,46,0,57
Rapid Vienna,450,4,12,15,9,54,39,15,51
RZ Pellets W,450,5,14,9,13,47,47,0,51
Vienna,450,6,15,5,16,58,61,-3,50
Admira Wacke,450,7,12,8,16,38,55,-17,44
St. Pölten,450,8,7,15,14,42,59,-17,36
SV Josko Rie,450,9,9,9,18,34,52,-18,36
Mattersburg,450,10,6,10,20,34,56,-22,28
FC Salzburg,451,1,24,7,5,72,30,42,79
SC Rheindorf,451,2,18,10,8,48,35,13,64
Vienna,451,3,20,3,13,64,49,15,63
SK Sturm Gra,451,4,18,7,11,65,43,22,61
Rapid Vienna,451,5,14,12,10,54,37,17,54
SV Josko Rie,451,6,11,7,18,33,47,-14,40
RZ Pellets W,451,7,10,8,18,42,62,-20,38
Admira Wacke,451,8,11,4,21,31,56,-25,37
St. Pölten,451,9,8,10,18,43,69,-26,34
Mattersburg,451,10,8,8,20,33,57,-24,32
FC Salzburg,452,1,21,10,5,64,29,35,73
SC Rheindorf,452,2,22,7,7,60,36,24,73
SK Sturm Gra,452,3,20,5,11,62,36,26,65
Vienna,452,4,17,5,14,63,60,3,56
Rapid Vienna,452,5,14,12,10,65,46,19,54
RZ Pellets W,452,6,13,7,16,50,55,-5,46
SV Josko Rie,452,7,10,9,17,36,52,-16,39
Admira Wacke,452,8,8,8,20,32,63,-31,32
Mattersburg,452,9,7,10,19,40,60,-20,31
St. Pölten,452,10,7,9,20,37,72,-35,30
FC Salzburg,453,1,21,8,7,70,29,41,71
SC Rheindorf,453,2,20,8,8,57,40,17,68
Vienna,453,3,18,6,12,59,48,11,60
SK Sturm Gra,453,4,17,6,13,56,40,16,57
Rapid Vienna,453,5,13,12,11,56,42,14,51
RZ Pellets W,453,6,12,8,16,47,58,-11,44
Mattersburg,453,7,11,9,16,41,56,-15,42
Admira Wacke,453,8,11,8,17,38,56,-18,41
St. Pölten,453,9,10,8,18,44,64,-20,38
SV Josko Rie,453,10,7,7,22,28,63,-35,28
SK Sturm Gra,454,1,22,7,7,61,30,31,73
FC Salzburg,454,2,20,8,8,72,37,35,68
SC Rheindorf,454,3,18,12,6,55,41,14,66
Vienna,454,4,17,7,12,60,53,7,58
Admira Wacke,454,5,12,9,15,41,56,-15,45
Rapid Vienna,454,6,11,11,14,51,46,5,44
St. Pölten,454,7,10,10,16,38,58,-20,40
SV Josko Rie,454,8,10,5,21,39,62,-23,35
RZ Pellets W,454,9,8,10,18,37,57,-20,34
Mattersburg,454,10,8,9,19,36,50,-14,33
Vienna,455,1,22,4,10,64,45,19,70
Rapid Vienna,455,2,18,9,9,60,38,22,63
FC Salzburg,455,3,18,7,11,62,34,28,61
SC Rheindorf,455,4,18,7,11,52,48,4,61
SK Sturm Gra,455,5,18,5,13,59,36,23,59
RZ Pellets W,455,6,16,6,14,51,53,-2,54
Admira Wacke,455,7,11,8,17,39,60,-21,41
St. Pölten,455,8,9,7,20,44,71,-27,34
SV Josko Rie,455,9,9,6,21,35,58,-23,33
Mattersburg,455,10,8,7,21,37,60,-23,31
FC Salzburg,456,1,22,8,6,70,31,39,74
SK Sturm Gra,456,2,19,8,9,49,25,24,65
SC Rheindorf,456,3,18,10,8,54,35,19,64
Vienna,456,4,18,7,11,63,47,16,61
RZ Pellets W,456,5,15,5,16,48,58,-10,50
Rapid Vienna,456,6,13,10,13,54,44,10,49
SV Josko Rie,456,7,11,8,17,35,52,-17,41
Admira Wacke,456,8,9,7,20,31,61,-30,34
St. Pölten,456,9,8,8,20,38,66,-28,32
Mattersburg,456,10,8,7,21,32,55,-23,31
FC Salzburg,457,1,22,8,6,66,29,37,74
SK Sturm Gra,457,2,22,5,9,63,29,34,71
SC Rheindorf,457,3,20,7,9,52,34,18,67
Vienna,457,4,21,2,13,60,53,7,65
Rapid Vienna,457,5,13,10,13,50,39,11,49
Mattersburg,457,6,12,8,16,40,50,-10,44
SV Josko Rie,457,7,10,8,18,32,52,-20,38
St. Pölten,457,8,8,10,18,39,65,-26,34
RZ Pellets W,457,9,8,9,19,36,54,-18,33
Admira Wacke,457,10,8,5,23,26,59,-33,29
SC Rheindorf,458,1,22,7,7,54,37,17,73
SK Sturm Gra,458,2,21,5,10,70,35,35,68
FC Salzburg,458,3,19,5,12,64,39,25,62
Rapid Vienna,458,4,18,7,11,58,37,21,61
Vienna,458,5,18,2,16,65,57,8,56
Mattersburg,458,6,13,6,17,46,60,-14,45
Admira Wacke,458,7,13,3,20,43,66,-23,42
SV Josko Rie,458,8,12,3,21,32,54,-22,39
RZ Pellets W,458,9,10,5,21,45,65,-20,35
St. Pölten,458,10,9,7,20,37,64,-27,34
FC Salzburg,459,1,19,10,7,62,31,31,67
SK Sturm Gra,459,2,19,10,7,58,31,27,67
SC Rheindorf,459,3,18,7,11,51,43,8,61
Vienna,459,4,18,6,12,60,45,15,60
Rapid Vienna,459,5,15,10,11,55,42,13,55
Admira Wacke,459,6,13,5,18,35,54,-19,44
SV Josko Rie,459,7,12,7,17,42,55,-13,43
RZ Pellets W,459,8,11,6,19,40,58,-18,39
Mattersburg,459,9,9,9,18,38,54,-16,36
St. Pölten,459,10,6,10,20,35,63,-28,28
FC Salzburg,460,1,21,7,8,62,29,33,70
SK Sturm Gra,460,2,20,9,7,68,31,37,69
Vienna,460,3,17,10,9,64,51,13,61
SC Rheindorf,460,4,17,9,10,54,44,10,60
Rapid Vienna,460,5,15,13,8,60,34,26,58
SV Josko Rie,460,6,12,7,17,39,52,-13,43
Admira Wacke,460,7,11,7,18,30,59,-29,40
St. Pölten,460,8,9,9,18,48,72,-24,36
RZ Pellets W,460,9,9,7,20,38,58,-20,34
Mattersburg,460,10,6,8,22,32,65,-33,26
FC Salzburg,461,1,23,6,7,77,41,36,75
SK Sturm Gra,461,2,21,5,10,62,34,28,68
Vienna,461,3,21,5,10,70,46,24,68
SC Rheindorf,461,4,19,8,9,57,42,15,65
Rapid Vienna,461,5,16,9,11,59,45,14,57
RZ Pellets W,461,6,12,9,15,49,51,-2,45
Admira Wacke,461,7,12,4,20,35,61,-26,40
St. Pölten,461,8,7,10,19,37,68,-31,31
SV Josko Rie,461,9,8,5,23,31,63,-32,29
Mattersburg,461,10,5,11,20,32,58,-26,26
SK Sturm Gra,462,1,21,4,11,72,36,36,67
Vienna,462,2,20,7,9,65,45,20,67
FC Salzburg,462,3,19,8,9,64,35,29,65
SC Rheindorf,462,4,18,7,11,51,50,1,61
RZ Pellets W,462,5,12,12,12,45,48,-3,48
Rapid Vienna,462,6,11,13,12,55,47,8,46
SV Josko Rie,462,7,10,8,18,40,53,-13,38
Mattersburg,462,8,8,13,15,34,49,-15,37
Admira Wacke,462,9,9,7,20,27,61,-34,34
St. Pölten,462,10,8,9,19,36,65,-29,33
SC Rheindorf,463,1,23,7,6,62,40,22,76
FC Salzburg,463,2,22,9,5,74,28,46,75
SK Sturm Gra,463,3,20,4,12,65,38,27,64
Rapid Vienna,463,4,15,11,10,60,42,18,56
Vienna,463,5,16,7,13,55,51,4,55
RZ Pellets W,463,6,10,8,18,45,63,-18,38
St. Pölten,463,7,9,11,16,40,58,-18,38
Admira Wacke,463,8,9,10,17,34,60,-26,37
Mattersburg,463,9,8,8,20,37,61,-24,32
SV Josko Rie,463,10,7,7,22,32,63,-31,28
FC Salzburg,464,1,23,5,8,65,29,36,74
SC Rheindorf,464,2,18,8,10,52,44,8,62
Vienna,464,3,18,7,11,59,48,11,61
SK Sturm Gra,464,4,17,9,10,50,32,18,60
Rapid Vienna,464,5,16,9,11,63,40,23,57
SV Josko Rie,464,6,12,5,19,41,55,-14,41
RZ Pellets W,464,7,11,6,19,43,60,-17,39
Mattersburg,464,8,9,11,16,37,55,-18,38
St. Pölten,464,9,8,11,17,47,66,-19,35
Admira Wacke,464,10,10,5,21,32,60,-28,35
SK Sturm Gra,465,1,20,7,9,62,34,28,67
SC Rheindorf,465,2,19,8,9,59,45,14,65
FC Salzburg,465,3,19,7,10,62,34,28,64
RZ Pellets W,465,4,17,6,13,43,44,-1,57
Rapid Vienna,465,5,15,10,11,55,38,17,55
Vienna,465,6,15,7,14,57,54,3,52
Mattersburg,465,7,10,7,19,31,52,-21,37
Admira Wacke,465,8,10,7,19,32,58,-26,37
St. Pölten,465,9,9,9,18,39,55,-16,36
SV Josko Rie,465,10,8,8,20,30,56,-26,32
FC Salzburg,466,1,22,7,7,65,32,33,73
SC Rheindorf,466,2,18,13,5,57,41,16,67
SK Sturm Gra,466,3,19,9,8,63,34,29,66
Vienna,466,4,18,6,12,60,44,16,60
Rapid Vienna,466,5,14,11,11,55,43,12,53
Mattersburg,466,6,11,10,15,44,51,-7,43
RZ Pellets W,466,7,9,11,16,42,59,-17,38
Admira Wacke,466,8,9,9,18,33,60,-27,36
SV Josko Rie,466,9,9,6,21,36,57,-21,33
St. Pölten,466,10,5,10,21,36,70,-34,25
FC Salzburg,467,1,21,8,7,68,33,35,71
SK Sturm Gra,467,2,21,5,10,60,29,31,68
Vienna,467,3,18,5,13,60,55,5,59
SC Rheindorf,467,4,17,7,12,57,53,4,58
Rapid Vienna,467,5,14,9,13,60,46,14,51
RZ Pellets W,467,6,14,6,16,53,57,-4,48
St. Pölten,467,7,11,10,15,47,57,-10,43
SV Josko Rie,467,8,12,5,19,36,49,-13,41
Admira Wacke,467,9,11,5,20,35,67,-32,38
Mattersburg,467,10,6,10,20,34,64,-30,28
FC Salzburg,468,1,20,7,9,71,35,36,67
Vienna,468,2,21,3,12,62,56,6,66
SC Rheindorf,468,3,17,9,10,57,44,13,60
SK Sturm Gra,468,4,18,4,14,57,39,18,58
Rapid Vienna,468,5,14,9,13,54,46,8,51
RZ Pellets W,468,6,13,6,17,48,57,-9,45
St. Pölten,468,7,11,9,16,46,58,-12,42
SV Josko Rie,468,8,12,6,18,37,52,-15,42
Admira Wacke,468,9,12,5,19,34,60,-26,41
Mattersburg,468,10,8,10,18,39,58,-19,34
SK Sturm Gra,469,1,22,7,7,64,31,33,73
FC Salzburg,469,2,21,9,6,71,29,42,72
Vienna,469,3,17,8,11,63,58,5,59
SC Rheindorf,469,4,15,10,11,51,43,8,55
Rapid Vienna,469,5,13,11,12,58,50,8,50
Admira Wacke,469,6,11,9,16,40,60,-20,42
RZ Pellets W,469,7,11,7,18,45,59,-14,40
SV Josko Rie,469,8,10,8,18,34,54,-20,38
St. Pölten,469,9,8,11,17,44,63,-19,35
Mattersburg,469,10,7,10,19,38,61,-23,31
SC Rheindorf,470,1,22,8,6,60,35,25,74
FC Salzburg,470,2,20,8,8,63,30,33,68
SK Sturm Gra,470,3,18,6,12,58,34,24,60
Vienna,470,4,16,6,14,56,54,2,54
Rapid Vienna,470,5,13,11,12,53,41,12,50
St. Pölten,470,6,14,6,16,57,64,-7,48
RZ Pellets W,470,7,14,6,16,45,54,-9,48
Admira Wacke,470,8,11,7,18,31,48,-17,40
SV Josko Rie,470,9,9,5,22,31,63,-32,32
Mattersburg,470,10,7,9,20,30,61,-31,30
FC Salzburg,471,1,22,8,6,69,26,43,74
SC Rheindorf,471,2,22,5,9,60,39,21,71
Vienna,471,3,20,6,10,67,54,13,66
Rapid Vienna,471,4,16,9,11,60,43,17,57
SK Sturm Gra,471,5,16,6,14,49,39,10,54
Admira Wacke,471,6,12,6,18,35,54,-19,42
RZ Pellets W,471,7,11,8,17,44,58,-14,41
St. Pölten,471,8,9,8,19,42,62,-20,35
Mattersburg,471,9,8,9,19,34,56,-22,33
SV Josko Rie,471,10,10,3,23,29,58,-29,33
FC Salzburg,472,1,21,7,8,71,33,38,70
SC Rheindorf,472,2,20,7,9,52,41,11,67
SK Sturm Gra,472,3,20,5,11,63,31,32,65
Vienna,472,4,20,3,13,65,53,12,63
Rapid Vienna,472,5,14,13,9,62,44,18,55
Admira Wacke,472,6,12,6,18,38,58,-20,42
RZ Pellets W,472,7,11,7,18,42,59,-17,40
SV Josko Rie,472,8,11,4,21,33,63,-30,37
Mattersburg,472,9,9,9,18,43,54,-11,36
St. Pölten,472,10,7,9,20,30,63,-33,30
SC Rheindorf,473,1,20,9,7,56,38,18,69
FC Salzburg,473,2,20,8,8,65,34,31,68
Vienna,473,3,20,5,11,68,51,17,65
SK Sturm Gra,473,4,18,7,11,59,33,26,61
Rapid Vienna,473,5,17,8,11,60,41,19,59
RZ Pellets W,473,6,12,9,15,46,60,-14,45
Admira Wacke,473,7,13,6,17,49,65,-16,45
SV Josko Rie,473,8,10,6,20,39,61,-22,36
St. Pölten,473,9,6,11,19,41,72,-31,29
Mattersburg,473,10,5,9,22,32,60,-28,24
SC Rheindorf,474,1,19,11,6,58,46,12,68
FC Salzburg,474,2,20,7,9,73,33,40,67
SK Sturm Gra,474,3,20,7,9,59,35,24,67
Vienna,474,4,18,3,15,67,58,9,57
Rapid Vienna,474,5,15,11,10,60,41,19,56
Mattersburg,474,6,11,8,17,42,51,-9,41
SV Josko Rie,474,7,11,7,18,35,56,-21,40
St. Pölten,474,8,10,8,18,40,63,-23,38
Admira Wacke,474,9,9,7,20,36,66,-30,34
RZ Pellets W,474,10,8,9,19,35,56,-21,33
SC Rheindorf,475,1,20,9,7,61,43,18,69
SK Sturm Gra,475,2,20,6,10,58,29,29,66
FC Salzburg,475,3,18,9,9,63,33,30,63
Rapid Vienna,475,4,17,10,9,61,37,24,61
Vienna,475,5,18,5,13,56,56,0,59
RZ Pellets W,475,6,13,5,18,46,58,-12,44
St. Pölten,475,7,8,13,15,44,62,-18,37
SV Josko Rie,475,8,10,5,21,36,59,-23,35
Admira Wacke,475,9,9,8,19,31,59,-28,35
Mattersburg,475,10,9,6,21,35,55,-20,33
SC Rheindorf,476,1,20,6,10,58,42,16,66
FC Salzburg,476,2,18,9,9,57,34,23,63
Rapid Vienna,476,3,17,9,10,58,35,23,60
SK Sturm Gra,476,4,18,5,13,55,36,19,59
Vienna,476,5,18,5,13,69,58,11,59
RZ Pellets W,476,6,14,8,14,51,56,-5,50
Admira Wacke,476,7,12,7,17,39,58,-19,43
St. Pölten,476,8,9,9,18,40,61,-21,36
SV Josko Rie,476,9,10,5,21,34,57,-23,35
Mattersburg,476,10,7,11,18,33,57,-24,32
FC Salzburg,477,1,22,8,6,65,26,39,74
SK Sturm Gra,477,2,21,7,8,54,26,28,70
SC Rheindorf,477,3,20,6,10,52,40,12,66
Vienna,477,4,16,5,15,57,55,2,53
Rapid Vienna,477,5,12,11,13,49,40,9,47
RZ Pellets W,477,6,12,8,16,42,54,-12,44
SV Josko Rie,477,7,12,6,18,31,47,-16,42
Admira Wacke,477,8,11,6,19,36,60,-24,39
Mattersburg,477,9,10,6,20,40,54,-14,36
St. Pölten,477,10,7,11,18,37,61,-24,32
SC Rheindorf,478,1,20,7,9,58,39,19,67
Vienna,478,2,20,6,10,70,53,17,66
FC Salzburg,478,3,18,10,8,59,34,25,64
SK Sturm Gra,478,4,17,7,12,55,39,16,58
Rapid Vienna,478,5,13,13,10,55,39,16,52
RZ Pellets W,478,6,13,9,14,54,55,-1,48
Admira Wacke,478,7,11,7,18,37,58,-21,40
SV Josko Rie,478,8,10,8,18,37,57,-20,38
St. Pölten,478,9,8,10,18,41,65,-24,34
Mattersburg,478,10,7,9,20,39,66,-27,30
SK Sturm Gra,479,1,21,7,8,60,29,31,70
SC Rheindorf,479,2,17,10,9,52,41,11,61
FC Salzburg,479,3,17,8,11,64,36,28,59
Rapid Vienna,479,4,13,13,10,55,41,14,52
Vienna,479,5,16,4,16,56,58,-2,52
SV Josko Rie,479,6,13,4,19,39,52,-13,43
Admira Wacke,479,7,11,10,15,36,55,-19,43
RZ Pellets W,479,8,10,10,16,45,57,-12,40
Mattersburg,479,9,9,12,15,39,55,-16,39
St. Pölten,479,10,9,10,17,39,61,-22,37
FC Salzburg,480,1,23,7,6,67,28,39,76
SK Sturm Gra,480,2,19,7,10,65,33,32,64
SC Rheindorf,480,3,18,5,13,56,50,6,59
Rapid Vienna,480,4,16,9,11,62,46,16,57
Vienna,480,5,16,7,13,66,60,6,55
RZ Pellets W,480,6,14,4,18,51,62,-11,46
SV Josko Rie,480,7,11,8,17,35,51,-16,41
Admira Wacke,480,8,11,6,19,35,56,-21,39
St. Pölten,480,9,10,6,20,38,67,-29,36
Mattersburg,480,10,9,7,20,38,60,-22,34
SC Rheindorf,481,1,21,5,10,56,37,19,68
FC Salzburg,481,2,20,7,9,62,35,27,67
Vienna,481,3,21,4,11,64,41,23,67
SK Sturm Gra,481,4,19,5,12,58,33,25,62
Rapid Vienna,481,5,14,8,14,55,45,10,50
RZ Pellets W,481,6,13,7,16,43,55,-12,46
Admira Wacke,481,7,12,9,15,39,62,-23,45
SV Josko Rie,481,8,9,9,18,28,47,-19,36
Mattersburg,481,9,9,7,20,36,59,-23,34
St. Pölten,481,10,7,9,20,35,62,-27,30
FC Salzburg,482,1,21,8,7,67,29,38,71
Vienna,482,2,22,5,9,64,41,23,71
SC Rheindorf,482,3,19,6,11,62,46,16,63
SK Sturm Gra,482,4,16,8,12,52,38,14,56
Rapid Vienna,482,5,15,10,11,58,44,14,55
St. Pölten,482,6,12,9,15,51,63,-12,45
RZ Pellets W,482,7,11,9,16,46,55,-9,42
Admira Wacke,482,8,10,8,18,39,65,-26,38
SV Josko Rie,482,9,10,3,23,34,61,-27,33
Mattersburg,482,10,7,8,21,36,67,-31,29
SK Sturm Gra,483,1,21,5,10,65,39,26,68
FC Salzburg,483,2,19,8,9,63,37,26,65
SC Rheindorf,483,3,19,7,10,59,42,17,64
Vienna,483,4,20,4,12,68,59,9,64
Rapid Vienna,483,5,12,11,13,56,48,8,47
Admira Wacke,483,6,12,7,17,46,59,-13,43
RZ Pellets W,483,7,11,7,18,43,58,-15,40
Mattersburg,483,8,11,6,19,53,65,-12,39
SV Josko Rie,483,9,10,7,19,36,57,-21,37
St. Pölten,483,10,9,10,17,42,67,-25,37
FC Salzburg,484,1,26,6,4,75,26,49,84
SK Sturm Gra,484,2,19,7,10,57,31,26,64
SC Rheindorf,484,3,18,7,11,54,44,10,61
Vienna,484,4,18,6,12,64,54,10,60
Rapid Vienna,484,5,16,7,13,61,41,20,55
Admira Wacke,484,6,13,5,18,41,54,-13,44
St. Pölten,484,7,10,9,17,40,58,-18,39
SV Josko Rie,484,8,11,6,19,43,67,-24,39
RZ Pellets W,484,9,9,7,20,38,60,-22,34
Mattersburg,484,10,5,10,21,28,66,-38,25
SC Rheindorf,485,1,23,5,8,65,39,26,74
FC Salzburg,485,2,21,5,10,62,35,27,68
SK Sturm Gra,485,3,21,4,11,62,32,30,67
Vienna,485,4,20,2,14,61,51,10,62
Rapid Vienna,485,5,14,9,13,58,46,12,51
SV Josko Rie,485,6,16,2,18,43,53,-10,50
RZ Pellets W,485,7,14,7,15,49,53,-4,49
Mattersburg,485,8,8,9,19,40,63,-23,33
Admira Wacke,485,9,8,5,23,32,66,-34,29
St. Pölten,485,10,6,10,20,41,75,-34,28
FC Salzburg,486,1,25,5,6,71,27,44,80
SK Sturm Gra,486,2,21,6,9,64,36,28,69
SC Rheindorf,486,3,18,7,11,53,42,11,61
Vienna,486,4,18,5,13,64,52,12,59
Rapid Vienna,486,5,15,10,11,53,42,11,55
RZ Pellets W,486,6,11,8,17,44,55,-11,41
St. Pölten,486,7,9,10,17,39,60,-21,37
SV Josko Rie,486,8,10,6,20,31,52,-21,36
Admira Wacke,486,9,10,6,20,30,57,-27,36
Mattersburg,486,10,8,7,21,33,59,-26,31
FC Salzburg,487,1,20,9,7,63,35,28,69
SK Sturm Gra,487,2,20,4,12,56,31,25,64
SC Rheindorf,487,3,19,5,12,54,44,10,62
Rapid Vienna,487,4,16,8,12,63,45,18,56
Vienna,487,5,16,4,16,56,56,0,52
RZ Pellets W,487,6,14,7,15,46,49,-3,49
SV Josko Rie,487,7,13,6,17,40,50,-10,45
Admira Wacke,487,8,11,6,19,36,59,-23,39
St. Pölten,487,9,10,8,18,45,65,-20,38
Mattersburg,487,10,9,7,20,35,60,-25,34
FC Salzburg,488,1,23,5,8,73,31,42,74
SK Sturm Gra,488,2,22,5,9,68,37,31,71
Vienna,488,3,20,3,13,64,52,12,63
SC Rheindorf,488,4,19,6,11,51,44,7,63
Rapid Vienna,488,5,13,10,13,60,46,14,49
RZ Pellets W,488,6,12,8,16,43,49,-6,44
Admira Wacke,488,7,11,6,19,42,73,-31,39
Mattersburg,488,8,10,7,19,42,63,-21,37
St. Pölten,488,9,9,9,18,46,68,-22,36
SV Josko Rie,488,10,8,7,21,35,61,-26,31
FC Salzburg,489,1,21,8,7,71,33,38,71
SC Rheindorf,489,2,20,7,9,60,42,18,67
Vienna,489,3,19,5,12,62,50,12,62
Rapid Vienna,489,4,17,10,9,74,42,32,61
SK Sturm Gra,489,5,14,8,14,48,42,6,50
RZ Pellets W,489,6,14,7,15,47,52,-5,49
Mattersburg,489,7,11,9,16,40,58,-18,42
Admira Wacke,489,8,10,8,18,36,57,-21,38
SV Josko Rie,489,9,10,5,21,34,61,-27,35
St. Pölten,489,10,7,7,22,38,73,-35,28
FC Salzburg,490,1,23,5,8,73,32,41,74
SK Sturm Gra,490,2,19,7,10,59,34,25,64
SC Rheindorf,490,3,18,8,10,53,41,12,62
Vienna,490,4,18,5,13,60,58,2,59
Rapid Vienna,490,5,14,11,11,53,39,14,53
St. Pölten,490,6,14,8,14,52,61,-9,50
RZ Pellets W,490,7,12,5,19,45,60,-15,41
Admira Wacke,490,8,9,9,18,28,53,-25,36
SV Josko Rie,490,9,8,9,19,30,56,-26,33
Mattersburg,490,10,7,9,20,33,52,-19,30
FC Salzburg,491,1,25,6,5,75,24,51,81
SK Sturm Gra,491,2,20,5,11,62,39,23,65
Rapid Vienna,491,3,17,9,10,61,39,22,60
Vienna,491,4,18,5,13,61,48,13,59
SC Rheindorf,491,5,16,8,12,52,56,-4,56
Admira Wacke,491,6,13,4,19,39,63,-24,43
RZ Pellets W,491,7,12,6,18,47,52,-5,42
St. Pölten,491,8,9,9,18,43,67,-24,36
SV Josko Rie,491,9,9,7,20,31,54,-23,34
Mattersburg,491,10,8,7,21,33,62,-29,31
Vienna,492,1,21,4,11,62,44,18,67
SK Sturm Gra,492,2,20,5,11,65,40,25,65
SC Rheindorf,492,3,19,8,9,55,46,9,65
FC Salzburg,492,4,18,9,9,61,35,26,63
Rapid Vienna,492,5,12,14,10,55,48,7,50
RZ Pellets W,492,6,13,8,15,50,51,-1,47
St. Pölten,492,7,10,9,17,44,65,-21,39
Admira Wacke,492,8,9,11,16,41,61,-20,38
Mattersburg,492,9,7,11,18,37,52,-15,32
SV Josko Rie,492,10,9,5,22,29,57,-28,32
FC Salzburg,493,1,24,6,6,73,27,46,78
SC Rheindorf,493,2,18,11,7,51,38,13,65
SK Sturm Gra,493,3,18,8,10,56,34,22,62
Vienna,493,4,17,7,12,57,49,8,58
Rapid Vienna,493,5,14,9,13,54,43,11,51
SV Josko Rie,493,6,13,5,18,35,46,-11,44
St. Pölten,493,7,10,8,18,45,62,-17,38
Admira Wacke,493,8,10,8,18,39,62,-23,38
RZ Pellets W,493,9,9,10,17,40,61,-21,37
Mattersburg,493,10,6,10,20,37,65,-28,28
FC Salzburg,494,1,19,9,8,63,30,33,66
SK Sturm Gra,494,2,18,10,8,57,35,22,64
SC Rheindorf,494,3,17,12,7,51,37,14,63
Vienna,494,4,18,5,13,56,52,4,59
Rapid Vienna,494,5,15,10,11,51,37,14,55
RZ Pellets W,494,6,13,8,15,51,56,-5,47
SV Josko Rie,494,7,11,7,18,40,51,-11,40
Admira Wacke,494,8,11,6,19,37,59,-22,39
Mattersburg,494,9,6,14,16,34,57,-23,32
St. Pölten,494,10,6,11,19,35,61,-26,29
FC Salzburg,495,1,21,10,5,69,27,42,73
SK Sturm Gra,495,2,21,5,10,68,36,32,68
SC Rheindorf,495,3,20,7,9,58,49,9,67
Vienna,495,4,18,6,12,62,50,12,60
RZ Pellets W,495,5,14,6,16,55,57,-2,48
Rapid Vienna,495,6,12,11,13,51,39,12,47
Admira Wacke,495,7,12,5,19,34,69,-35,41
St. Pölten,495,8,10,9,17,48,65,-17,39
SV Josko Rie,495,9,11,5,20,35,56,-21,38
Mattersburg,495,10,5,8,23,29,61,-32,23
Vienna,496,1,21,7,8,72,52,20,70
FC Salzburg,496,2,20,6,10,64,31,33,66
Rapid Vienna,496,3,16,11,9,59,37,22,59
SK Sturm Gra,496,4,17,7,12,56,39,17,58
SC Rheindorf,496,5,17,7,12,50,48,2,58
RZ Pellets W,496,6,13,10,13,49,52,-3,49
SV Josko Rie,496,7,12,4,20,38,54,-16,40
St. Pölten,496,8,9,9,18,48,67,-19,36
Admira Wacke,496,9,9,7,20,35,66,-31,34
Mattersburg,496,10,7,10,19,33,58,-25,31
Vienna,497,1,20,5,11,59,48,11,65
SC Rheindorf,497,2,18,9,9,48,38,10,63
FC Salzburg,497,3,18,8,10,56,30,26,62
Rapid Vienna,497,4,17,10,9,65,36,29,61
SK Sturm Gra,497,5,17,7,12,49,31,18,58
RZ Pellets W,497,6,14,7,15,46,52,-6,49
Admira Wacke,497,7,12,8,16,34,54,-20,44
SV Josko Rie,497,8,12,3,21,36,50,-14,39
St. Pölten,497,9,8,10,18,35,61,-26,34
Mattersburg,497,10,7,7,22,33,61,-28,28
FC Salzburg,498,1,24,5,7,71,31,40,77
Vienna,498,2,22,4,10,66,44,22,70
SK Sturm Gra,498,3,20,6,10,60,32,28,66
SC Rheindorf,498,4,17,6,13,52,49,3,57
Rapid Vienna,498,5,13,11,12,55,40,15,50
SV Josko Rie,498,6,12,4,20,37,52,-15,40
Mattersburg,498,7,10,9,17,40,56,-16,39
RZ Pellets W,498,8,10,7,19,44,57,-13,37
Admira Wacke,498,9,9,10,17,38,64,-26,37
St. Pölten,498,10,8,8,20,41,79,-38,32
FC Salzburg,499,1,22,6,8,67,30,37,72
SK Sturm Gra,499,2,22,5,9,69,35,34,71
Vienna,499,3,20,5,11,62,48,14,65
Rapid Vienna,499,4,18,10,8,65,37,28,64
SC Rheindorf,499,5,15,9,12,49,50,-1,54
Admira Wacke,499,6,11,7,18,35,56,-21,40
RZ Pellets W,499,7,10,7,19,43,60,-17,37
St. Pölten,499,8,8,10,18,40,61,-21,34
SV Josko Rie,499,9,9,6,21,32,57,-25,33
Mattersburg,499,10,8,9,19,34,62,-28,33
FC Salzburg,500,1,20,10,6,66,32,34,70
SK Sturm Gra,500,2,19,7,10,59,35,24,64
SC Rheindorf,500,3,18,7,11,54,43,11,61
Vienna,500,4,19,4,13,64,55,9,61
Rapid Vienna,500,5,12,13,11,53,37,16,49
RZ Pellets W,500,6,13,7,16,48,55,-7,46
SV Josko Rie,500,7,13,6,17,42,50,-8,45
St. Pölten,500,8,10,10,16,40,61,-21,40
Admira Wacke,500,9,10,6,20,32,60,-28,36
Mattersburg,500,10,6,10,20,37,67,-30,28
FC Salzburg,501,1,21,9,6,66,29,37,72
SK Sturm Gra,501,2,20,8,8,60,30,30,68
SC Rheindorf,501,3,20,7,9,54,45,9,67
Vienna,501,4,15,5,16,57,54,3,50
Admira Wacke,501,5,14,6,16,36,51,-15,48
Rapid Vienna,501,6,11,12,13,52,44,8,45
RZ Pellets W,501,7,11,7,18,44,54,-10,40
SV Josko Rie,501,8,12,3,21,40,57,-17,39
Mattersburg,501,9,10,9,17,35,53,-18,39
St. Pölten,501,10,8,10,18,37,64,-27,34
FC Salzburg,502,1,22,6,8,67,25,42,72
SK Sturm Gra,502,2,21,6,9,62,30,32,69
SC Rheindorf,502,3,20,7,9,52,42,10,67
Rapid Vienna,502,4,14,11,11,56,44,12,53
Vienna,502,5,15,6,15,56,55,1,51
RZ Pellets W,502,6,12,9,15,41,48,-7,45
SV Josko Rie,502,7,10,7,19,37,53,-16,37
St. Pölten,502,8,9,10,17,37,58,-21,37
Admira Wacke,502,9,10,6,20,32,65,-33,36
Mattersburg,502,10,8,10,18,40,60,-20,34
Vienna,503,1,24,3,9,76,52,24,75
SC Rheindorf,503,2,21,5,10,60,43,17,68
FC Salzburg,503,3,19,6,11,68,35,33,63
SK Sturm Gra,503,4,17,7,12,61,39,22,58
Rapid Vienna,503,5,16,10,10,61,42,19,58
RZ Pellets W,503,6,13,8,15,48,57,-9,47
SV Josko Rie,503,7,11,8,17,39,52,-13,41
St. Pölten,503,8,8,9,19,34,67,-33,33
Admira Wacke,503,9,10,3,23,32,67,-35,33
Mattersburg,503,10,8,7,21,37,62,-25,31
FC Salzburg,504,1,23,6,7,70,28,42,75
SC Rheindorf,504,2,19,7,10,60,46,14,64
SK Sturm Gra,504,3,18,9,9,59,36,23,63
Rapid Vienna,504,4,17,9,10,52,37,15,60
Vienna,504,5,18,3,15,61,52,9,57
RZ Pellets W,504,6,12,9,15,49,55,-6,45
Admira Wacke,504,7,13,5,18,37,53,-16,44
SV Josko Rie,504,8,10,6,20,35,65,-30,36
Mattersburg,504,9,9,6,21,40,60,-20,33
St. Pölten,504,10,6,10,20,38,69,-31,28
SC Rheindorf,505,1,21,6,9,55,42,13,69
FC Salzburg,505,2,19,8,9,60,33,27,65
Vienna,505,3,20,5,11,62,44,18,65
SK Sturm Gra,505,4,18,7,11,58,36,22,61
Rapid Vienna,505,5,16,11,9,57,39,18,59
RZ Pellets W,505,6,11,10,15,51,64,-13,43
Mattersburg,505,7,9,9,18,40,57,-17,36
Admira Wacke,505,8,10,6,20,36,57,-21,36
SV Josko Rie,505,9,10,5,21,35,58,-23,35
St. Pölten,505,10,9,7,20,47,71,-24,34
FC Salzburg,506,1,21,8,7,61,29,32,71
SC Rheindorf,506,2,20,10,6,58,40,18,70
SK Sturm Gra,506,3,20,7,9,63,30,33,67
Vienna,506,4,19,5,12,70,60,10,62
Admira Wacke,506,5,13,5,18,36,56,-20,44
RZ Pellets W,506,6,11,8,17,44,60,-16,41
Mattersburg,506,7,10,10,16,45,51,-6,40
Rapid Vienna,506,8,9,12,15,43,48,-5,39
SV Josko Rie,506,9,9,6,21,37,57,-20,33
St. Pölten,506,10,6,13,17,38,64,-26,31
FC Salzburg,507,1,21,7,8,63,36,27,70
Vienna,507,2,22,4,10,68,48,20,70
SC Rheindorf,507,3,20,6,10,55,40,15,66
Rapid Vienna,507,4,16,11,9,63,43,20,59
SK Sturm Gra,507,5,17,6,13,50,36,14,57
Mattersburg,507,6,10,9,17,41,59,-18,39
Admira Wacke,507,7,11,6,19,37,57,-20,39
SV Josko Rie,507,8,11,5,20,30,50,-20,38
St. Pölten,507,9,9,7,20,42,64,-22,34
RZ Pellets W,507,10,8,9,19,43,59,-16,33
FC Salzburg,508,1,22,7,7,67,30,37,73
SK Sturm Gra,508,2,22,6,8,60,27,33,72
SC Rheindorf,508,3,21,7,8,62,41,21,70
Vienna,508,4,16,6,14,57,55,2,54
Rapid Vienna,508,5,14,10,12,58,45,13,52
SV Josko Rie,508,6,13,3,20,40,53,-13,42
Admira Wacke,508,7,12,3,21,38,67,-29,39
St. Pölten,508,8,10,8,18,44,64,-20,38
RZ Pellets W,508,9,11,5,20,41,64,-23,38
Mattersburg,508,10,7,9,20,38,59,-21,30
SK Sturm Gra,509,1,21,3,12,57,34,23,66
SC Rheindorf,509,2,19,7,10,53,41,12,64
FC Salzburg,509,3,16,12,8,55,27,28,60
Rapid Vienna,509,4,17,8,11,58,37,21,59
Vienna,509,5,17,5,14,54,46,8,56
RZ Pellets W,509,6,13,9,14,42,54,-12,48
Admira Wacke,509,7,14,6,16,39,59,-20,48
SV Josko Rie,509,8,12,5,19,37,50,-13,41
St. Pölten,509,9,8,8,20,33,64,-31,32
Mattersburg,509,10,8,7,21,38,54,-16,31
SC Rheindorf,510,1,22,6,8,63,39,24,72
FC Salzburg,510,2,19,8,9,65,36,29,65
SK Sturm Gra,510,3,19,7,10,62,36,26,64
Rapid Vienna,510,4,16,10,10,64,44,20,58
Vienna,510,5,18,3,15,61,61,0,57
Admira Wacke,510,6,13,6,17,38,55,-17,45
RZ Pellets W,510,7,12,7,17,48,57,-9,43
Mattersburg,510,8,9,8,19,37,57,-20,35
SV Josko Rie,510,9,9,6,21,33,58,-25,33
St. Pölten,510,10,8,9,19,36,64,-28,33
SC Rheindorf,511,1,20,7,9,64,43,21,67
FC Salzburg,511,2,19,9,8,61,30,31,66
Vienna,511,3,19,6,11,62,53,9,63
SK Sturm Gra,511,4,16,7,13,51,44,7,55
Rapid Vienna,511,5,14,11,11,52,39,13,53
RZ Pellets W,511,6,13,7,16,45,54,-9,46
Mattersburg,511,7,11,9,16,41,54,-13,42
SV Josko Rie,511,8,11,6,19,43,56,-13,39
Admira Wacke,511,9,10,8,18,32,55,-23,38
St. Pölten,511,10,6,12,18,38,61,-23,30
FC Salzburg,512,1,17,12,7,63,32,31,63
SC Rheindorf,512,2,18,7,11,55,46,9,61
Rapid Vienna,512,3,16,11,9,54,36,18,59
Vienna,512,4,16,9,11,61,53,8,57
SK Sturm Gra,512,5,15,9,12,56,41,15,54
RZ Pellets W,512,6,13,7,16,41,49,-8,46
SV Josko Rie,512,7,12,7,17,38,52,-14,43
Admira Wacke,512,8,12,7,17,36,53,-17,43
Mattersburg,512,9,10,9,17,40,55,-15,39
St. Pölten,512,10,6,12,18,42,69,-27,30
FC Salzburg,513,1,20,7,9,64,32,32,67
SK Sturm Gra,513,2,21,4,11,62,30,32,67
SC Rheindorf,513,3,19,8,9,50,45,5,65
Rapid Vienna,513,4,14,12,10,54,38,16,54
Vienna,513,5,16,6,14,64,58,6,54
RZ Pellets W,513,6,13,9,14,45,49,-4,48
Mattersburg,513,7,11,9,16,35,50,-15,42
Admira Wacke,513,8,11,6,19,35,57,-22,39
SV Josko Rie,513,9,9,7,20,29,51,-22,34
St. Pölten,513,10,6,12,18,36,64,-28,30
SK Sturm Gra,514,1,20,8,8,69,37,32,68
FC Salzburg,514,2,19,9,8,56,30,26,66
Vienna,514,3,20,6,10,77,54,23,66
SC Rheindorf,514,4,19,6,11,55,53,2,63
Rapid Vienna,514,5,15,11,10,63,40,23,56
Admira Wacke,514,6,14,6,16,39,58,-19,48
Mattersburg,514,7,11,8,17,41,51,-10,41
SV Josko Rie,514,8,10,9,17,30,45,-15,39
RZ Pellets W,514,9,8,8,20,36,58,-22,32
St. Pölten,514,10,4,9,23,32,72,-40,21
FC Salzburg,515,1,21,9,6,71,35,36,72
Vienna,515,2,21,4,11,65,52,13,67
SC Rheindorf,515,3,18,8,10,51,38,13,62
SK Sturm Gra,515,4,18,6,12,58,40,18,60
Rapid Vienna,515,5,13,8,15,47,42,5,47
RZ Pellets W,515,6,12,8,16,47,56,-9,44
SV Josko Rie,515,7,12,7,17,39,50,-11,43
Admira Wacke,515,8,11,6,19,37,55,-18,39
St. Pölten,515,9,10,7,19,37,62,-25,37
Mattersburg,515,10,9,7,20,35,57,-22,34
FC Salzburg,516,1,22,9,5,73,34,39,75
SK Sturm Gra,516,2,20,4,12,64,38,26,64
SC Rheindorf,516,3,18,7,11,48,37,11,61
Vienna,516,4,15,6,15,54,55,-1,51
Rapid Vienna,516,5,11,15,10,57,46,11,48
St. Pölten,516,6,12,8,16,48,63,-15,44
Admira Wacke,516,7,13,5,18,40,59,-19,44
RZ Pellets W,516,8,11,8,17,46,61,-15,41
Mattersburg,516,9,9,11,16,38,52,-14,38
SV Josko Rie,516,10,10,5,21,35,58,-23,35
FC Salzburg,517,1,21,8,7,68,29,39,71
SC Rheindorf,517,2,20,9,7,61,48,13,69
SK Sturm Gra,517,3,19,7,10,59,33,26,64
Vienna,517,4,17,5,14,65,64,1,56
Rapid Vienna,517,5,11,14,11,50,43,7,47
Admira Wacke,517,6,12,8,16,37,52,-15,44
Mattersburg,517,7,9,12,15,47,55,-8,39
RZ Pellets W,517,8,10,9,17,38,58,-20,39
SV Josko Rie,517,9,10,6,20,35,56,-21,36
St. Pölten,517,10,7,10,19,39,61,-22,31
FC Salzburg,518,1,23,7,6,68,29,39,76
SC Rheindorf,518,2,22,7,7,52,37,15,73
Vienna,518,3,18,5,13,57,46,11,59
RZ Pellets W,518,4,16,8,12,56,53,3,56
SK Sturm Gra,518,5,17,4,15,52,34,18,55
Rapid Vienna,518,6,12,12,12,53,38,15,48
SV Josko Rie,518,7,11,4,21,31,55,-24,37
St. Pölten,518,8,8,11,17,41,64,-23,35
Admira Wacke,518,9,10,5,21,35,65,-30,35
Mattersburg,518,10,7,9,20,40,64,-24,30
FC Salzburg,519,1,26,4,6,68,26,42,82
SC Rheindorf,519,2,22,6,8,65,44,21,72
Vienna,519,3,20,5,11,58,46,12,65
SK Sturm Gra,519,4,18,7,11,54,30,24,61
Rapid Vienna,519,5,14,9,13,57,45,12,51
RZ Pellets W,519,6,14,6,16,45,54,-9,48
Admira Wacke,519,7,11,5,20,31,56,-25,38
Mattersburg,519,8,9,8,19,36,49,-13,35
SV Josko Rie,519,9,8,4,24,34,65,-31,28
St. Pölten,519,10,6,10,20,40,73,-33,28
FC Salzburg,520,1,22,9,5,61,25,36,75
SK Sturm Gra,520,2,20,6,10,64,34,30,66
SC Rheindorf,520,3,17,12,7,49,34,15,63
Rapid Vienna,520,4,17,9,10,57,37,20,60
Vienna,520,5,16,8,12,57,49,8,56
Mattersburg,520,6,11,8,17,40,51,-11,41
St. Pölten,520,7,9,11,16,43,62,-19,38
RZ Pellets W,520,8,9,9,18,39,62,-23,36
SV Josko Rie,520,9,9,6,21,32,52,-20,33
Admira Wacke,520,10,9,4,23,30,66,-36,31
SC Rheindorf,521,1,23,6,7,62,38,24,75
FC Salzburg,521,2,21,8,7,67,30,37,71
SK Sturm Gra,521,3,22,4,10,62,31,31,70
Vienna,521,4,18,4,14,57,52,5,58
Rapid Vienna,521,5,14,10,12,52,39,13,52
SV Josko Rie,521,6,13,5,18,44,54,-10,44
RZ Pellets W,521,7,11,6,19,37,58,-21,39
Admira Wacke,521,8,12,3,21,37,60,-23,39
St. Pölten,521,9,9,8,19,39,67,-28,35
Mattersburg,521,10,5,10,21,36,64,-28,25
FC Salzburg,522,1,21,6,9,64,35,29,69
SK Sturm Gra,522,2,21,6,9,60,33,27,69
Vienna,522,3,21,4,11,66,48,18,67
Rapid Vienna,522,4,16,11,9,60,42,18,59
SC Rheindorf,522,5,16,6,14,51,51,0,54
Admira Wacke,522,6,12,5,19,38,56,-18,41
RZ Pellets W,522,7,11,6,19,42,56,-14,39
SV Josko Rie,522,8,11,6,19,33,52,-19,39
Mattersburg,522,9,10,7,19,41,61,-20,37
St. Pölten,522,10,9,7,20,44,65,-21,34
FC Salzburg,523,1,22,8,6,70,32,38,74
SC Rheindorf,523,2,21,8,7,56,34,22,71
Vienna,523,3,19,5,12,60,48,12,62
Rapid Vienna,523,4,16,8,12,62,45,17,56
SK Sturm Gra,523,5,14,9,13,54,38,16,51
RZ Pellets W,523,6,11,7,18,47,62,-15,40
Admira Wacke,523,7,11,7,18,38,62,-24,40
Mattersburg,523,8,10,9,17,39,56,-17,39
SV Josko Rie,523,9,10,6,20,35,56,-21,36
St. Pölten,523,10,8,9,19,38,66,-28,33
FC Salzburg,524,1,21,9,6,67,33,34,72
SC Rheindorf,524,2,20,7,9,56,39,17,67
Vienna,524,3,20,6,10,70,50,20,66
SK Sturm Gra,524,4,20,4,12,64,39,25,64
Rapid Vienna,524,5,14,10,12,57,42,15,52
RZ Pellets W,524,6,11,8,17,41,53,-12,41
Mattersburg,524,7,10,8,18,34,55,-21,38
St. Pölten,524,8,9,9,18,39,63,-24,36
SV Josko Rie,524,9,9,8,19,38,53,-15,35
Admira Wacke,524,10,8,7,21,27,66,-39,31
SC Rheindorf,525,1,21,8,7,66,41,25,71
FC Salzburg,525,2,20,9,7,65,30,35,69
Vienna,525,3,18,7,11,57,47,10,61
SK Sturm Gra,525,4,17,7,12,48,33,15,58
Rapid Vienna,525,5,15,12,9,59,35,24,57
RZ Pellets W,525,6,13,9,14,45,48,-3,48
SV Josko Rie,525,7,13,5,18,31,47,-16,44
Admira Wacke,525,8,10,6,20,33,60,-27,36
St. Pölten,525,9,8,6,22,35,70,-35,30
Mattersburg,525,10,6,9,21,31,59,-28,27
FC Salzburg,526,1,23,6,7,62,21,41,75
SK Sturm Gra,526,2,19,10,7,55,27,28,67
SC Rheindorf,526,3,18,7,11,53,52,1,61
Vienna,526,4,17,9,10,58,43,15,60
Rapid Vienna,526,5,12,14,10,49,36,13,50
Admira Wacke,526,6,12,7,17,33,50,-17,43
RZ Pellets W,526,7,11,6,19,47,61,-14,39
SV Josko Rie,526,8,12,2,22,35,56,-21,38
St. Pölten,526,9,9,9,18,43,64,-21,36
Mattersburg,526,10,8,8,20,35,60,-25,32
FC Salzburg,527,1,19,12,5,66,28,38,69
Vienna,527,2,20,6,10,79,48,31,66
SK Sturm Gra,527,3,18,7,11,53,35,18,61
SC Rheindorf,527,4,17,8,11,50,42,8,59
Rapid Vienna,527,5,14,7,15,52,44,8,49
Admira Wacke,527,6,12,7,17,40,61,-21,43
RZ Pellets W,527,7,13,4,19,43,66,-23,43
SV Josko Rie,527,8,11,8,17,38,50,-12,41
Mattersburg,527,9,9,10,17,34,51,-17,37
St. Pölten,527,10,8,9,19,37,67,-30,33
FC Salzburg,528,1,23,6,7,66,26,40,75
Vienna,528,2,21,3,12,60,49,11,66
SC Rheindorf,528,3,19,8,9,52,44,8,65
SK Sturm Gra,528,4,19,7,10,61,29,32,64
RZ Pellets W,528,5,15,6,15,48,52,-4,51
Rapid Vienna,528,6,13,11,12,54,47,7,50
Admira Wacke,528,7,12,4,20,39,65,-26,40
St. Pölten,528,8,10,8,18,45,62,-17,38
SV Josko Rie,528,9,9,3,24,28,57,-29,30
Mattersburg,528,10,7,8,21,34,56,-22,29
FC Salzburg,529,1,23,5,8,70,30,40,74
SC Rheindorf,529,2,22,7,7,62,43,19,73
SK Sturm Gra,529,3,19,5,12,60,34,26,62
Vienna,529,4,19,4,13,65,58,7,61
Rapid Vienna,529,5,15,9,12,58,46,12,54
Admira Wacke,529,6,15,4,17,41,52,-11,49
St. Pölten,529,7,10,8,18,44,64,-20,38
SV Josko Rie,529,8,10,7,19,33,53,-20,37
RZ Pellets W,529,9,9,9,18,43,66,-23,36
Mattersburg,529,10,5,8,23,37,67,-30,23
SK Sturm Gra,530,1,20,6,10,60,35,25,66
FC Salzburg,530,2,19,7,10,61,35,26,64
SC Rheindorf,530,3,17,10,9,48,37,11,61
Vienna,530,4,16,9,11,59,52,7,57
Rapid Vienna,530,5,15,9,12,60,39,21,54
RZ Pellets W,530,6,12,9,15,53,62,-9,45
SV Josko Rie,530,7,13,4,19,38,53,-15,43
Mattersburg,530,8,12,6,18,40,54,-14,42
St. Pölten,530,9,9,8,19,39,64,-25,35
Admira Wacke,530,10,9,8,19,36,63,-27,35
SK Sturm Gra,531,1,23,5,8,64,28,36,74
FC Salzburg,531,2,21,8,7,69,38,31,71
SC Rheindorf,531,3,19,7,10,61,44,17,64
Vienna,531,4,16,5,15,60,58,2,53
Rapid Vienna,531,5,12,11,13,54,44,10,47
Admira Wacke,531,6,13,5,18,41,66,-25,44
RZ Pellets W,531,7,9,13,14,41,53,-12,40
St. Pölten,531,8,9,11,16,43,61,-18,38
SV Josko Rie,531,9,11,5,20,44,64,-20,38
Mattersburg,531,10,8,8,20,32,53,-21,32
SC Rheindorf,532,1,22,7,7,59,36,23,73
FC Salzburg,532,2,21,8,7,64,30,34,71
SK Sturm Gra,532,3,19,6,11,59,38,21,63
Vienna,532,4,18,5,13,61,52,9,59
Rapid Vienna,532,5,15,13,8,56,34,22,58
St. Pölten,532,6,10,10,16,43,64,-21,40
SV Josko Rie,532,7,9,9,18,39,53,-14,36
RZ Pellets W,532,8,10,6,20,41,58,-17,36
Admira Wacke,532,9,9,8,19,32,63,-31,35
Mattersburg,532,10,6,10,20,36,62,-26,28
FC Salzburg,533,1,23,8,5,66,24,42,77
SC Rheindorf,533,2,21,6,9,61,45,16,69
Vienna,533,3,21,3,12,67,47,20,66
SK Sturm Gra,533,4,19,5,12,56,38,18,62
Rapid Vienna,533,5,14,10,12,49,42,7,52
RZ Pellets W,533,6,13,5,18,44,56,-12,44
Admira Wacke,533,7,11,5,20,32,52,-20,38
SV Josko Rie,533,8,11,4,21,38,60,-22,37
Mattersburg,533,9,9,8,19,40,62,-22,35
St. Pölten,533,10,6,10,20,44,71,-27,28
SK Sturm Gra,534,1,22,5,9,65,29,36,71
FC Salzburg,534,2,20,7,9,61,28,33,67
SC Rheindorf,534,3,18,7,11,51,44,7,61
Rapid Vienna,534,4,16,8,12,56,41,15,56
Vienna,534,5,16,4,16,62,56,6,52
RZ Pellets W,534,6,13,10,13,43,50,-7,49
Admira Wacke,534,7,14,5,17,41,59,-18,47
St. Pölten,534,8,10,8,18,43,65,-22,38
Mattersburg,534,9,10,5,21,38,58,-20,35
SV Josko Rie,534,10,9,5,22,33,63,-30,32
FC Salzburg,535,1,22,6,8,68,31,37,72
SC Rheindorf,535,2,20,7,9,56,40,16,67
Rapid Vienna,535,3,17,9,10,58,37,21,60
SK Sturm Gra,535,4,18,6,12,53,37,16,60
Vienna,535,5,17,5,14,56,53,3,56
RZ Pellets W,535,6,12,6,18,41,54,-13,42
Mattersburg,535,7,10,10,16,38,53,-15,40
Admira Wacke,535,8,10,8,18,38,60,-22,38
SV Josko Rie,535,9,10,6,20,31,51,-20,36
St. Pölten,535,10,9,7,20,34,57,-23,34
SC Rheindorf,536,1,22,6,8,58,43,15,72
Vienna,536,2,22,3,11,72,56,16,69
FC Salzburg,536,3,18,8,10,64,40,24,62
SK Sturm Gra,536,4,16,6,14,59,40,19,54
Rapid Vienna,536,5,14,11,11,52,39,13,53
Admira Wacke,536,6,13,7,16,43,59,-16,46
RZ Pellets W,536,7,12,8,16,47,56,-9,44
SV Josko Rie,536,8,11,6,19,33,48,-15,39
Mattersburg,536,9,7,11,18,41,57,-16,32
St. Pölten,536,10,8,8,20,44,75,-31,32
FC Salzburg,537,1,23,7,6,66,24,42,76
SC Rheindorf,537,2,20,8,8,57,35,22,68
Vienna,537,3,18,4,14,61,52,9,58
SK Sturm Gra,537,4,17,6,13,52,41,11,57
Admira Wacke,537,5,15,4,17,37,53,-16,49
Rapid Vienna,537,6,12,10,14,55,51,4,46
St. Pölten,537,7,10,10,16,43,61,-18,40
SV Josko Rie,537,8,12,3,21,35,52,-17,39
Mattersburg,537,9,10,8,18,33,49,-16,38
RZ Pellets W,537,10,10,6,20,45,66,-21,36
SC Rheindorf,538,1,21,7,8,57,39,18,70
SK Sturm Gra,538,2,20,5,11,59,39,20,65
FC Salzburg,538,3,18,8,10,60,29,31,62
Vienna,538,4,17,6,13,63,60,3,57
Rapid Vienna,538,5,14,9,13,56,41,15,51
Admira Wacke,538,6,14,5,17,37,57,-20,47
RZ Pellets W,538,7,12,9,15,45,52,-7,45
Mattersburg,538,8,10,9,17,39,54,-15,39
SV Josko Rie,538,9,11,3,22,34,53,-19,36
St. Pölten,538,10,8,9,19,42,68,-26,33
Vienna,539,1,22,4,10,65,45,20,70
SC Rheindorf,539,2,21,6,9,60,50,10,69
FC Salzburg,539,3,19,10,7,70,32,38,67
SK Sturm Gra,539,4,19,6,11,59,35,24,63
RZ Pellets W,539,5,14,5,17,47,53,-6,47
Rapid Vienna,539,6,10,15,11,50,43,7,45
Admira Wacke,539,7,10,9,17,34,57,-23,39
St. Pölten,539,8,8,11,17,40,62,-22,35
Mattersburg,539,9,7,11,18,35,55,-20,32
SV Josko Rie,539,10,8,7,21,31,59,-28,31
Vienna,540,1,21,7,8,63,40,23,70
SK Sturm Gra,540,2,20,8,8,61,31,30,68
SC Rheindorf,540,3,19,7,10,53,41,12,64
FC Salzburg,540,4,17,10,9,63,36,27,61
Rapid Vienna,540,5,16,9,11,64,44,20,57
SV Josko Rie,540,6,13,5,18,35,44,-9,44
Admira Wacke,540,7,12,5,19,38,69,-31,41
RZ Pellets W,540,8,9,9,18,38,58,-20,36
St. Pölten,540,9,8,8,20,37,63,-26,32
Mattersburg,540,10,8,6,22,36,62,-26,30
FC Salzburg,541,1,23,7,6,68,29,39,76
SC Rheindorf,541,2,21,7,8,60,39,21,70
SK Sturm Gra,541,3,18,9,9,63,34,29,63
Vienna,541,4,15,6,15,60,59,1,51
Rapid Vienna,541,5,12,12,12,56,45,11,48
St. Pölten,541,6,12,8,16,50,63,-13,44
RZ Pellets W,541,7,12,8,16,44,57,-13,44
Admira Wacke,541,8,9,10,17,36,59,-23,37
SV Josko Rie,541,9,9,8,19,35,61,-26,35
Mattersburg,541,10,8,7,21,31,57,-26,31
FC Salzburg,542,1,22,7,7,63,26,37,73
Vienna,542,2,20,6,10,68,50,18,66
SK Sturm Gra,542,3,19,7,10,57,36,21,64
SC Rheindorf,542,4,19,7,10,53,39,14,64
Rapid Vienna,542,5,18,9,9,61,36,25,63
Admira Wacke,542,6,12,4,20,36,54,-18,40
RZ Pellets W,542,7,10,8,18,40,65,-25,38
SV Josko Rie,542,8,10,7,19,37,57,-20,37
Mattersburg,542,9,7,10,19,38,59,-21,31
St. Pölten,542,10,6,9,21,35,66,-31,27
FC Salzburg,543,1,24,6,6,66,33,33,78
SC Rheindorf,543,2,19,6,11,62,47,15,63
Vienna,543,3,20,3,13,66,52,14,63
SK Sturm Gra,543,4,17,7,12,55,39,16,58
Rapid Vienna,543,5,14,11,11,52,38,14,53
SV Josko Rie,543,6,13,5,18,41,50,-9,44
RZ Pellets W,543,7,12,5,19,45,59,-14,41
St. Pölten,543,8,10,9,17,42,57,-15,39
Mattersburg,543,9,9,8,19,34,55,-21,35
Admira Wacke,543,10,9,6,21,31,64,-33,33
SK Sturm Gra,544,1,21,6,9,56,27,29,69
SC Rheindorf,544,2,20,5,11,55,43,12,65
FC Salzburg,544,3,18,9,9,61,33,28,63
Vienna,544,4,18,9,9,59,44,15,63
Rapid Vienna,544,5,13,11,12,51,41,10,50
RZ Pellets W,544,6,13,10,13,48,48,0,49
St. Pölten,544,7,10,8,18,35,64,-29,38
Mattersburg,544,8,9,10,17,40,56,-16,37
Admira Wacke,544,9,10,7,19,35,59,-24,37
SV Josko Rie,544,10,8,5,23,31,56,-25,29
FC Salzburg,545,1,23,7,6,74,29,45,76
SK Sturm Gra,545,2,21,5,10,60,30,30,68
Vienna,545,3,20,4,12,63,49,14,64
Rapid Vienna,545,4,16,10,10,61,43,18,58
SC Rheindorf,545,5,17,4,15,45,46,-1,55
Admira Wacke,545,6,12,6,18,41,59,-18,42
SV Josko Rie,545,7,12,5,19,35,52,-17,41
RZ Pellets W,545,8,10,10,16,44,57,-13,40
St. Pölten,545,9,8,10,18,47,68,-21,34
Mattersburg,545,10,7,7,22,33,70,-37,28
FC Salzburg,546,1,23,8,5,67,27,40,77
SK Sturm Gra,546,2,20,8,8,55,26,29,68
SC Rheindorf,546,3,18,9,9,55,40,15,63
Rapid Vienna,546,4,14,12,10,60,43,17,54
Vienna,546,5,16,5,15,54,58,-4,53
RZ Pellets W,546,6,12,6,18,40,56,-16,42
SV Josko Rie,546,7,12,5,19,42,52,-10,41
Admira Wacke,546,8,10,7,19,39,67,-28,37
Mattersburg,546,9,9,9,18,36,49,-13,36
St. Pölten,546,10,7,9,20,38,68,-30,30
SC Rheindorf,547,1,22,5,9,62,43,19,71
FC Salzburg,547,2,19,8,9,63,32,31,65
Vienna,547,3,18,5,13,62,49,13,59
Rapid Vienna,547,4,16,10,10,59,42,17,58
SK Sturm Gra,547,5,16,6,14,58,41,17,54
SV Josko Rie,547,6,15,3,18,42,55,-13,48
RZ Pellets W,547,7,12,9,15,44,52,-8,45
Admira Wacke,547,8,13,3,20,33,65,-32,42
St. Pölten,547,9,9,7,20,43,66,-23,34
Mattersburg,547,10,9,6,21,42,63,-21,33
FC Salzburg,548,1,19,10,7,63,31,32,67
SC Rheindorf,548,2,20,6,10,58,45,13,66
Vienna,548,3,18,6,12,62,51,11,60
SK Sturm Gra,548,4,17,8,11,52,38,14,59
Rapid Vienna,548,5,12,12,12,53,41,12,48
St. Pölten,548,6,12,9,15,48,56,-8,45
RZ Pellets W,548,7,12,7,17,48,62,-14,43
Admira Wacke,548,8,12,5,19,37,63,-26,41
SV Josko Rie,548,9,11,6,19,37,53,-16,39
Mattersburg,548,10,7,11,18,36,54,-18,32
FC Salzburg,549,1,23,7,6,72,26,46,76
SK Sturm Gra,549,2,22,5,9,58,28,30,71
Vienna,549,3,17,6,13,58,51,7,57
SC Rheindorf,549,4,16,7,13,52,49,3,55
Rapid Vienna,549,5,14,11,11,52,43,9,53
Admira Wacke,549,6,12,5,19,37,53,-16,41
SV Josko Rie,549,7,12,5,19,38,58,-20,41
St. Pölten,549,8,10,9,17,47,65,-18,39
RZ Pellets W,549,9,10,7,19,40,60,-20,37
Mattersburg,549,10,10,6,20,41,62,-21,36
FC Salzburg,550,1,24,5,7,72,33,39,77
SC Rheindorf,550,2,20,7,9,61,47,14,67
Vienna,550,3,18,6,12,62,52,10,60
SK Sturm Gra,550,4,16,9,11,61,41,20,57
Admira Wacke,550,5,14,5,17,42,58,-16,47
RZ Pellets W,550,6,12,10,14,44,53,-9,46
Rapid Vienna,550,7,11,12,13,51,43,8,45
SV Josko Rie,550,8,10,6,20,39,55,-16,36
St. Pölten,550,9,9,9,18,42,65,-23,36
Mattersburg,550,10,8,7,21,32,59,-27,31
SC Rheindorf,551,1,23,6,7,61,39,22,75
FC Salzburg,551,2,19,12,5,62,30,32,69
Vienna,551,3,19,5,12,63,50,13,62
SK Sturm Gra,551,4,17,7,12,53,37,16,58
Rapid Vienna,551,5,13,13,10,52,38,14,52
Admira Wacke,551,6,12,8,16,35,53,-18,44
RZ Pellets W,551,7,12,6,18,47,61,-14,42
St. Pölten,551,8,9,10,17,42,59,-17,37
SV Josko Rie,551,9,10,5,21,36,51,-15,35
Mattersburg,551,10,7,6,23,29,62,-33,27
FC Salzburg,552,1,20,11,5,68,31,37,71
SK Sturm Gra,552,2,19,5,12,56,35,21,62
Vienna,552,3,18,6,12,63,54,9,60
SC Rheindorf,552,4,16,11,9,47,39,8,59
RZ Pellets W,552,5,14,7,15,54,57,-3,49
Rapid Vienna,552,6,12,12,12,53,47,6,48
SV Josko Rie,552,7,11,5,20,33,61,-28,38
Admira Wacke,552,8,9,10,17,36,57,-21,37
St. Pölten,552,9,9,10,17,41,64,-23,37
Mattersburg,552,10,9,9,18,44,50,-6,36
SK Sturm Gra,553,1,21,5,10,70,38,32,68
SC Rheindorf,553,2,20,6,10,59,45,14,66
Vienna,553,3,20,2,14,59,52,7,62
FC Salzburg,553,4,18,7,11,59,30,29,61
Rapid Vienna,553,5,16,10,10,57,37,20,58
SV Josko Rie,553,6,13,4,19,38,54,-16,43
RZ Pellets W,553,7,12,6,18,44,63,-19,42
St. Pölten,553,8,11,8,17,47,64,-17,41
Admira Wacke,553,9,10,7,19,35,59,-24,37
Mattersburg,553,10,7,9,20,32,58,-26,30
FC Salzburg,554,1,20,10,6,77,34,43,70
SK Sturm Gra,554,2,19,10,7,58,32,26,67
SC Rheindorf,554,3,18,7,11,52,43,9,61
Vienna,554,4,18,5,13,62,55,7,59
Rapid Vienna,554,5,14,13,9,62,39,23,55
Admira Wacke,554,6,12,7,17,42,60,-18,43
RZ Pellets W,554,7,11,6,19,47,63,-16,39
Mattersburg,554,8,9,10,17,37,57,-20,37
SV Josko Rie,554,9,11,4,21,32,56,-24,37
St. Pölten,554,10,8,8,20,44,74,-30,32
Vienna,555,1,22,5,9,72,51,21,71
SC Rheindorf,555,2,21,7,8,62,46,16,70
FC Salzburg,555,3,19,8,9,69,41,28,65
SK Sturm Gra,555,4,18,6,12,56,35,21,60
Rapid Vienna,555,5,14,13,9,63,38,25,55
Admira Wacke,555,6,12,4,20,41,63,-22,40
RZ Pellets W,555,7,11,6,19,39,54,-15,39
St. Pölten,555,8,8,11,17,41,63,-22,35
Mattersburg,555,9,8,10,18,39,63,-24,34
SV Josko Rie,555,10,10,4,22,30,58,-28,34
SK Sturm Gra,556,1,22,5,9,67,28,39,71
FC Salzburg,556,2,21,8,7,65,29,36,71
Vienna,556,3,21,5,10,65,43,22,68
SC Rheindorf,556,4,19,6,11,54,44,10,63
Rapid Vienna,556,5,13,13,10,52,40,12,52
RZ Pellets W,556,6,12,7,17,46,55,-9,43
Admira Wacke,556,7,12,5,19,32,56,-24,41
Mattersburg,556,8,8,10,18,30,52,-22,34
SV Josko Rie,556,9,8,7,21,25,52,-27,31
St. Pölten,556,10,6,10,20,37,74,-37,28
FC Salzburg,557,1,20,10,6,64,33,31,70
SK Sturm Gra,557,2,20,7,9,65,31,34,67
SC Rheindorf,557,3,18,9,9,51,46,5,63
Rapid Vienna,557,4,17,9,10,59,39,20,60
Vienna,557,5,18,6,12,66,53,13,60
RZ Pellets W,557,6,12,10,14,47,52,-5,46
Admira Wacke,557,7,10,10,16,38,57,-19,40
SV Josko Rie,557,8,9,6,21,35,58,-23,33
St. Pölten,557,9,8,8,20,39,67,-28,32
Mattersburg,557,10,6,9,21,36,64,-28,27
SC Rheindorf,558,1,20,8,8,56,40,16,68
FC Salzburg,558,2,19,9,8,60,31,29,66
Vienna,558,3,17,9,10,58,50,8,60
SK Sturm Gra,558,4,17,8,11,58,36,22,59
Rapid Vienna,558,5,16,10,10,61,40,21,58
RZ Pellets W,558,6,12,6,18,46,61,-15,42
Mattersburg,558,7,10,9,17,37,55,-18,39
Admira Wacke,558,8,11,6,19,39,60,-21,39
SV Josko Rie,558,9,9,8,19,32,52,-20,35
St. Pölten,558,10,8,9,19,39,61,-22,33
FC Salzburg,559,1,18,12,6,71,32,39,66
Vienna,559,2,20,5,11,65,50,15,65
SC Rheindorf,559,3,18,10,8,56,47,9,64
SK Sturm Gra,559,4,18,7,11,67,40,27,61
Rapid Vienna,559,5,12,12,12,59,51,8,48
RZ Pellets W,559,6,13,8,15,54,64,-10,47
St. Pölten,559,7,10,11,15,45,59,-14,41
Admira Wacke,559,8,10,7,19,39,74,-35,37
SV Josko Rie,559,9,9,7,20,35,55,-20,34
Mattersburg,559,10,7,11,18,44,63,-19,32
SC Rheindorf,560,1,23,4,9,57,43,14,73
FC Salzburg,560,2,21,6,9,63,29,34,69
SK Sturm Gra,560,3,20,6,10,55,29,26,66
Rapid Vienna,560,4,16,10,10,56,34,22,58
RZ Pellets W,560,5,13,8,15,51,54,-3,47
Vienna,560,6,14,5,17,51,57,-6,47
Admira Wacke,560,7,13,7,16,47,60,-13,46
SV Josko Rie,560,8,9,8,19,36,52,-16,35
Mattersburg,560,9,9,7,20,34,62,-28,34
St. Pölten,560,10,6,11,19,38,68,-30,29
SK Sturm Gra,561,1,22,6,8,61,28,33,72
FC Salzburg,561,2,21,8,7,64,31,33,71
Vienna,561,3,18,6,12,60,49,11,60
Rapid Vienna,561,4,17,8,11,63,36,27,59
SC Rheindorf,561,5,17,8,11,51,44,7,59
Admira Wacke,561,6,12,6,18,36,54,-18,42
RZ Pellets W,561,7,9,11,16,39,59,-20,38
St. Pölten,561,8,8,11,17,38,61,-23,35
SV Josko Rie,561,9,10,5,21,30,55,-25,35
Mattersburg,561,10,8,7,21,32,57,-25,31
SC Rheindorf,562,1,23,8,5,65,37,28,77
FC Salzburg,562,2,21,9,6,66,28,38,72
Vienna,562,3,21,7,8,75,48,27,70
SK Sturm Gra,562,4,17,5,14,55,43,12,56
Rapid Vienna,562,5,15,9,12,52,39,13,54
Admira Wacke,562,6,12,6,18,40,62,-22,42
RZ Pellets W,562,7,10,7,19,48,65,-17,37
SV Josko Rie,562,8,9,6,21,39,62,-23,33
Mattersburg,562,9,8,8,20,38,59,-21,32
St. Pölten,562,10,7,9,20,41,76,-35,30
FC Salzburg,563,1,19,12,5,60,27,33,69
SC Rheindorf,563,2,19,8,9,52,38,14,65
SK Sturm Gra,563,3,19,7,10,61,34,27,64
Vienna,563,4,19,6,11,67,56,11,63
RZ Pellets W,563,5,14,8,14,54,57,-3,50
Rapid Vienna,563,6,9,16,11,48,40,8,43
Admira Wacke,563,7,11,7,18,35,60,-25,40
St. Pölten,563,8,7,12,17,43,62,-19,33
SV Josko Rie,563,9,8,9,19,31,57,-26,33
Mattersburg,563,10,7,11,18,32,52,-20,32
SK Sturm Gra,564,1,22,6,8,63,32,31,72
FC Salzburg,564,2,19,11,6,62,25,37,68
Vienna,564,3,20,4,12,63,51,12,64
SC Rheindorf,564,4,18,8,10,52,45,7,62
Rapid Vienna,564,5,13,10,13,54,44,10,49
RZ Pellets W,564,6,12,7,17,46,53,-7,43
Mattersburg,564,7,11,7,18,38,55,-17,40
Admira Wacke,564,8,11,5,20,42,64,-22,38
St. Pölten,564,9,8,10,18,45,72,-27,34
SV Josko Rie,564,10,9,6,21,33,57,-24,33
SK Sturm Gra,565,1,20,6,10,67,39,28,66
FC Salzburg,565,2,18,11,7,68,34,34,65
SC Rheindorf,565,3,18,9,9,56,41,15,63
Vienna,565,4,19,5,12,63,47,16,62
Rapid Vienna,565,5,14,9,13,54,43,11,51
RZ Pellets W,565,6,14,8,14,48,50,-2,50
Admira Wacke,565,7,11,9,16,37,59,-22,42
SV Josko Rie,565,8,11,7,18,34,50,-16,40
St. Pölten,565,9,7,10,19,35,64,-29,31
Mattersburg,565,10,6,10,20,36,71,-35,28
Vienna,566,1,21,4,11,69,47,22,67
FC Salzburg,566,2,19,8,9,61,31,30,65
SC Rheindorf,566,3,19,7,10,57,49,8,64
SK Sturm Gra,566,4,19,6,11,55,31,24,63
Rapid Vienna,566,5,13,13,10,51,38,13,52
SV Josko Rie,566,6,12,6,18,39,53,-14,42
RZ Pellets W,566,7,10,10,16,44,59,-15,40
Mattersburg,566,8,10,8,18,34,56,-22,38
Admira Wacke,566,9,10,7,19,33,54,-21,37
St. Pölten,566,10,8,9,19,43,68,-25,33
SK Sturm Gra,567,1,20,8,8,60,30,30,68
FC Salzburg,567,2,19,7,10,60,37,23,64
Vienna,567,3,19,4,13,62,55,7,61
SC Rheindorf,567,4,17,8,11,57,47,10,59
SV Josko Rie,567,5,16,5,15,43,44,-1,53
RZ Pellets W,567,6,13,6,17,42,55,-13,45
Rapid Vienna,567,7,11,11,14,55,47,8,44
St. Pölten,567,8,10,10,16,41,57,-16,40
Admira Wacke,567,9,10,8,18,41,63,-22,38
Mattersburg,567,10,7,9,20,36,62,-26,30
SK Sturm Gra,568,1,23,4,9,76,33,43,73
FC Salzburg,568,2,20,8,8,72,37,35,68
SC Rheindorf,568,3,18,6,12,56,49,7,60
Vienna,568,4,17,4,15,63,63,0,55
SV Josko Rie,568,5,14,6,16,46,55,-9,48
RZ Pellets W,568,6,13,8,15,47,56,-9,47
Rapid Vienna,568,7,12,9,15,49,45,4,45
Admira Wacke,568,8,12,7,17,40,60,-20,43
Mattersburg,568,9,8,11,17,41,63,-22,35
St. Pölten,568,10,7,9,20,39,68,-29,30
FC Salzburg,569,1,20,7,9,64,37,27,67
SC Rheindorf,569,2,20,5,11,53,45,8,65
SK Sturm Gra,569,3,19,7,10,63,40,23,64
Rapid Vienna,569,4,16,9,11,60,41,19,57
Vienna,569,5,16,4,16,61,62,-1,52
Admira Wacke,569,6,13,7,16,45,61,-16,46
SV Josko Rie,569,7,13,6,17,46,53,-7,45
RZ Pellets W,569,8,12,6,18,44,52,-8,42
St. Pölten,569,9,10,8,18,42,65,-23,38
Mattersburg,569,10,8,7,21,34,56,-22,31
FC Salzburg,570,1,23,7,6,75,35,40,76
Vienna,570,2,20,6,10,60,42,18,66
SC Rheindorf,570,3,18,11,7,58,44,14,65
SK Sturm Gra,570,4,15,11,10,53,37,16,56
Rapid Vienna,570,5,13,13,10,52,40,12,52
RZ Pellets W,570,6,11,10,15,48,58,-10,43
Admira Wacke,570,7,11,5,20,34,56,-22,38
SV Josko Rie,570,8,10,6,20,35,59,-24,36
St. Pölten,570,9,8,10,18,44,65,-21,34
Mattersburg,570,10,6,11,19,37,60,-23,29
SK Sturm Gra,571,1,22,6,8,56,26,30,72
SC Rheindorf,571,2,20,8,8,53,42,11,68
FC Salzburg,571,3,17,9,10,66,38,28,60
Rapid Vienna,571,4,12,13,11,51,37,14,49
Vienna,571,5,14,6,16,54,58,-4,48
RZ Pellets W,571,6,13,8,15,46,49,-3,47
SV Josko Rie,571,7,13,6,17,48,50,-2,45
Mattersburg,571,8,9,12,15,39,53,-14,39
Admira Wacke,571,9,9,9,18,29,60,-31,36
St. Pölten,571,10,7,11,18,38,67,-29,32
FC Salzburg,572,1,21,8,7,64,31,33,71
SK Sturm Gra,572,2,21,6,9,67,34,33,69
SC Rheindorf,572,3,20,9,7,53,40,13,69
Vienna,572,4,17,6,13,67,56,11,57
Rapid Vienna,572,5,14,11,11,51,40,11,53
SV Josko Rie,572,6,12,6,18,40,51,-11,42
St. Pölten,572,7,11,8,17,43,57,-14,41
RZ Pellets W,572,8,10,5,21,43,64,-21,35
Admira Wacke,572,9,10,5,21,31,63,-32,35
Mattersburg,572,10,9,6,21,35,58,-23,33
Vienna,573,1,21,5,10,72,45,27,68
FC Salzburg,573,2,20,6,10,58,33,25,66
SC Rheindorf,573,3,20,6,10,53,36,17,66
SK Sturm Gra,573,4,17,7,12,60,43,17,58
Rapid Vienna,573,5,15,9,12,52,40,12,54
Admira Wacke,573,6,13,6,17,35,58,-23,45
RZ Pellets W,573,7,11,8,17,44,60,-16,41
St. Pölten,573,8,9,9,18,40,61,-21,36
SV Josko Rie,573,9,10,6,20,35,56,-21,36
Mattersburg,573,10,7,12,17,37,54,-17,33
FC Salzburg,574,1,23,6,7,75,28,47,75
SC Rheindorf,574,2,19,7,10,53,44,9,64
SK Sturm Gra,574,3,19,5,12,60,36,24,62
Vienna,574,4,17,5,14,57,56,1,56
Rapid Vienna,574,5,12,13,11,55,45,10,49
Admira Wacke,574,6,12,9,15,41,54,-13,45
St. Pölten,574,7,11,10,15,42,59,-17,43
RZ Pellets W,574,8,11,7,18,45,57,-12,40
Mattersburg,574,9,9,9,18,35,55,-20,36
SV Josko Rie,574,10,8,7,21,31,60,-29,31
SC Rheindorf,575,1,19,10,7,60,37,23,67
SK Sturm Gra,575,2,19,7,10,58,31,27,64
Vienna,575,3,19,5,12,57,49,8,62
FC Salzburg,575,4,17,6,13,56,39,17,57
RZ Pellets W,575,5,16,7,13,51,52,-1,55
Rapid Vienna,575,6,14,10,12,54,43,11,52
Admira Wacke,575,7,14,5,17,46,63,-17,47
Mattersburg,575,8,9,7,20,38,54,-16,34
St. Pölten,575,9,8,10,18,41,69,-28,34
SV Josko Rie,575,10,9,5,22,34,58,-24,32
FC Salzburg,576,1,21,5,10,68,34,34,68
SK Sturm Gra,576,2,20,5,11,61,34,27,65
SC Rheindorf,576,3,17,5,14,49,50,-1,56
Vienna,576,4,16,6,14,56,59,-3,54
RZ Pellets W,576,5,15,8,13,52,48,4,53
Rapid Vienna,576,6,13,13,10,54,37,17,52
St. Pölten,576,7,13,9,14,52,58,-6,48
Admira Wacke,576,8,12,5,19,35,66,-31,41
SV Josko Rie,576,9,11,5,20,35,53,-18,38
Mattersburg,576,10,6,11,19,31,54,-23,29
FC Salzburg,577,1,23,8,5,62,23,39,77
SK Sturm Gra,577,2,21,7,8,64,33,31,70
SC Rheindorf,577,3,20,7,9,58,44,14,67
Vienna,577,4,17,6,13,64,56,8,57
Rapid Vienna,577,5,14,11,11,48,34,14,53
RZ Pellets W,577,6,11,7,18,41,59,-18,40
SV Josko Rie,577,7,12,3,21,36,55,-19,39
Admira Wacke,577,8,11,6,19,32,55,-23,39
Mattersburg,577,9,8,8,20,36,58,-22,32
St. Pölten,577,10,6,11,19,41,65,-24,29
FC Salzburg,578,1,22,7,7,62,27,35,73
SC Rheindorf,578,2,21,5,10,60,40,20,68
Vienna,578,3,20,3,13,61,49,12,63
Rapid Vienna,578,4,16,9,11,60,37,23,57
SK Sturm Gra,578,5,17,5,14,53,41,12,56
RZ Pellets W,578,6,14,6,16,48,57,-9,48
Admira Wacke,578,7,13,5,18,39,60,-21,44
Mattersburg,578,8,7,14,15,38,53,-15,35
St. Pölten,578,9,7,10,19,41,68,-27,31
SV Josko Rie,578,10,9,4,23,29,59,-30,31
FC Salzburg,579,1,23,6,7,68,26,42,75
SC Rheindorf,579,2,20,9,7,60,43,17,69
SK Sturm Gra,579,3,19,7,10,57,36,21,64
Rapid Vienna,579,4,16,11,9,50,31,19,59
Vienna,579,5,17,4,15,64,60,4,55
SV Josko Rie,579,6,12,6,18,36,48,-12,42
Admira Wacke,579,7,9,10,17,31,55,-24,37
RZ Pellets W,579,8,10,6,20,40,65,-25,36
Mattersburg,579,9,9,8,19,34,52,-18,35
St. Pölten,579,10,7,9,20,39,63,-24,30
SC Rheindorf,580,1,20,10,6,60,39,21,70
FC Salzburg,580,2,21,6,9,70,33,37,69
Vienna,580,3,19,4,13,68,62,6,61
SK Sturm Gra,580,4,16,10,10,59,41,18,58
RZ Pellets W,580,5,13,9,14,54,58,-4,48
Rapid Vienna,580,6,12,11,13,53,41,12,47
Mattersburg,580,7,9,11,16,42,50,-8,38
Admira Wacke,580,8,10,7,19,40,75,-35,37
SV Josko Rie,580,9,10,6,20,39,58,-19,36
St. Pölten,580,10,8,10,18,39,67,-28,34
FC Salzburg,581,1,22,8,6,78,30,48,74
SC Rheindorf,581,2,19,9,8,60,46,14,66
SK Sturm Gra,581,3,19,6,11,63,38,25,63
RZ Pellets W,581,4,18,4,14,54,53,1,58
Vienna,581,5,16,4,16,60,61,-1,52
Rapid Vienna,581,6,12,8,16,52,47,5,44
Mattersburg,581,7,11,9,16,38,51,-13,42
Admira Wacke,581,8,9,10,17,37,65,-28,37
St. Pölten,581,9,9,8,19,44,71,-27,35
SV Josko Rie,581,10,10,4,22,36,60,-24,34
SK Sturm Gra,582,1,20,8,8,62,32,30,68
SC Rheindorf,582,2,20,8,8,61,46,15,68
FC Salzburg,582,3,18,11,7,68,35,33,65
Vienna,582,4,20,5,11,61,47,14,65
Rapid Vienna,582,5,15,10,11,58,40,18,55
St. Pölten,582,6,10,11,15,41,59,-18,41
RZ Pellets W,582,7,10,10,16,45,62,-17,40
SV Josko Rie,582,8,10,5,21,31,52,-21,35
Admira Wacke,582,9,9,8,19,32,60,-28,35
Mattersburg,582,10,5,10,21,30,56,-26,25
SK Sturm Gra,583,1,22,7,7,59,28,31,73
FC Salzburg,583,2,21,5,10,69,31,38,68
Vienna,583,3,19,4,13,68,61,7,61
SC Rheindorf,583,4,16,8,12,48,42,6,56
Rapid Vienna,583,5,13,13,10,60,42,18,52
RZ Pellets W,583,6,13,7,16,57,58,-1,46
SV Josko Rie,583,7,13,5,18,41,52,-11,44
Mattersburg,583,8,9,10,17,34,56,-22,37
Admira Wacke,583,9,9,7,20,35,74,-39,34
St. Pölten,583,10,6,12,18,36,63,-27,30
SC Rheindorf,584,1,23,6,7,67,39,28,75
SK Sturm Gra,584,2,21,5,10,68,34,34,68
FC Salzburg,584,3,19,6,11,60,38,22,63
Vienna,584,4,19,4,13,63,58,5,61
Admira Wacke,584,5,16,3,17,42,58,-16,51
RZ Pellets W,584,6,13,7,16,46,52,-6,46
Rapid Vienna,584,7,10,11,15,47,46,1,41
Mattersburg,584,8,9,11,16,46,58,-12,38
St. Pölten,584,9,8,10,18,42,69,-27,34
SV Josko Rie,584,10,9,3,24,30,59,-29,30
FC Salzburg,585,1,19,8,9,62,32,30,65
Vienna,585,2,20,4,12,62,50,12,64
SK Sturm Gra,585,3,19,6,11,57,34,23,63
SC Rheindorf,585,4,17,10,9,58,49,9,61
Rapid Vienna,585,5,14,11,11,57,41,16,53
RZ Pellets W,585,6,12,7,17,44,56,-12,43
Admira Wacke,585,7,12,7,17,38,55,-17,43
SV Josko Rie,585,8,12,6,18,43,53,-10,42
Mattersburg,585,9,8,12,16,33,57,-24,36
St. Pölten,585,10,8,7,21,40,67,-27,31
SC Rheindorf,586,1,23,7,6,62,38,24,76
FC Salzburg,586,2,20,9,7,63,31,32,69
Vienna,586,3,17,10,9,57,44,13,61
SK Sturm Gra,586,4,15,6,15,47,37,10,51
Admira Wacke,586,5,14,9,13,45,51,-6,51
Rapid Vienna,586,6,12,11,13,48,43,5,47
RZ Pellets W,586,7,12,10,14,46,53,-7,46
SV Josko Rie,586,8,10,7,19,33,51,-18,37
St. Pölten,586,9,7,10,19,36,60,-24,31
Mattersburg,586,10,6,9,21,30,59,-29,27
FC Salzburg,587,1,20,10,6,71,31,40,70
SK Sturm Gra,587,2,21,5,10,58,31,27,68
SC Rheindorf,587,3,19,7,10,52,46,6,64
Vienna,587,4,18,5,13,57,48,9,59
Rapid Vienna,587,5,11,14,11,61,48,13,47
St. Pölten,587,6,12,9,15,52,53,-1,45
Admira Wacke,587,7,12,7,17,39,57,-18,43
RZ Pellets W,587,8,11,8,17,45,72,-27,41
SV Josko Rie,587,9,9,6,21,31,58,-27,33
Mattersburg,587,10,7,9,20,41,63,-22,30
SC Rheindorf,588,1,19,11,6,73,45,28,68
FC Salzburg,588,2,17,10,9,65,35,30,61
SK Sturm Gra,588,3,17,7,12,62,49,13,58
Rapid Vienna,588,4,15,12,9,65,41,24,57
Vienna,588,5,16,8,12,56,57,-1,56
RZ Pellets W,588,6,11,10,15,40,52,-12,43
St. Pölten,588,7,11,9,16,43,60,-17,42
Admira Wacke,588,8,11,6,19,45,71,-26,39
SV Josko Rie,588,9,10,7,19,36,54,-18,37
Mattersburg,588,10,8,10,18,40,61,-21,34
SC Rheindorf,589,1,18,10,8,58,39,19,64
Vienna,589,2,19,6,11,70,52,18,63
FC Salzburg,589,3,18,8,10,62,34,28,62
SK Sturm Gra,589,4,17,8,11,51,34,17,59
Rapid Vienna,589,5,16,10,10,57,39,18,58
RZ Pellets W,589,6,12,10,14,47,54,-7,46
Admira Wacke,589,7,12,5,19,40,65,-25,41
SV Josko Rie,589,8,10,8,18,42,63,-21,38
Mattersburg,589,9,8,13,15,41,55,-14,37
St. Pölten,589,10,6,10,20,39,72,-33,28
FC Salzburg,590,1,22,9,5,67,26,41,75
SC Rheindorf,590,2,20,9,7,52,38,14,69
SK Sturm Gra,590,3,20,6,10,69,37,32,66
Vienna,590,4,19,2,15,62,50,12,59
Rapid Vienna,590,5,14,11,11,60,38,22,53
RZ Pellets W,590,6,15,6,15,48,56,-8,51
SV Josko Rie,590,7,10,7,19,32,51,-19,37
Admira Wacke,590,8,11,4,21,35,71,-36,37
St. Pölten,590,9,7,11,18,38,62,-24,32
Mattersburg,590,10,5,9,22,30,64,-34,24
SK Sturm Gra,591,1,20,10,6,61,26,35,70
FC Salzburg,591,2,19,11,6,57,28,29,68
Vienna,591,3,20,5,11,66,50,16,65
SC Rheindorf,591,4,17,10,9,50,43,7,61
Rapid Vienna,591,5,11,11,14,47,41,6,44
RZ Pellets W,591,6,11,9,16,48,65,-17,42
Admira Wacke,591,7,10,9,17,36,55,-19,39
SV Josko Rie,591,8,10,8,18,30,49,-19,38
Mattersburg,591,9,8,10,18,38,60,-22,34
St. Pölten,591,10,7,11,18,43,59,-16,32
FC Salzburg,592,1,20,9,7,64,30,34,69
SC Rheindorf,592,2,18,10,8,50,36,14,64
SK Sturm Gra,592,3,18,7,11,53,35,18,61
Vienna,592,4,17,8,11,69,53,16,59
Rapid Vienna,592,5,13,11,12,51,39,12,50
Admira Wacke,592,6,14,7,15,38,57,-19,49
RZ Pellets W,592,7,12,7,17,46,56,-10,43
St. Pölten,592,8,9,11,16,43,56,-13,38
SV Josko Rie,592,9,11,5,20,34,57,-23,38
Mattersburg,592,10,7,7,22,33,62,-29,28
FC Salzburg,593,1,21,7,8,63,35,28,70
Rapid Vienna,593,2,17,9,10,66,44,22,60
SC Rheindorf,593,3,17,7,12,50,41,9,58
SK Sturm Gra,593,4,17,4,15,62,44,18,55
RZ Pellets W,593,5,16,7,13,44,44,0,55
Vienna,593,6,16,5,15,68,66,2,53
Admira Wacke,593,7,12,7,17,42,60,-18,43
St. Pölten,593,8,11,7,18,45,65,-20,40
SV Josko Rie,593,9,11,6,19,30,49,-19,39
Mattersburg,593,10,9,7,20,36,58,-22,34
FC Salzburg,594,1,20,7,9,66,37,29,67
SC Rheindorf,594,2,17,11,8,55,45,10,62
Rapid Vienna,594,3,16,11,9,58,38,20,59
SK Sturm Gra,594,4,17,7,12,55,41,14,58
Vienna,594,5,17,7,12,66,54,12,58
RZ Pellets W,594,6,14,7,15,47,52,-5,49
SV Josko Rie,594,7,11,8,17,39,51,-12,41
Admira Wacke,594,8,11,6,19,35,60,-25,39
Mattersburg,594,9,9,8,19,46,65,-19,35
St. Pölten,594,10,8,8,20,38,62,-24,32
SC Rheindorf,595,1,22,7,7,59,42,17,73
Vienna,595,2,21,4,11,62,48,14,67
FC Salzburg,595,3,20,6,10,67,38,29,66
SK Sturm Gra,595,4,17,6,13,64,43,21,57
RZ Pellets W,595,5,15,8,13,43,43,0,53
Rapid Vienna,595,6,13,11,12,57,45,12,50
Admira Wacke,595,7,11,10,15,41,58,-17,43
SV Josko Rie,595,8,10,4,22,36,59,-23,34
St. Pölten,595,9,7,11,18,41,64,-23,32
Mattersburg,595,10,6,9,21,31,61,-30,27
SK Sturm Gra,596,1,22,7,7,66,30,36,73
FC Salzburg,596,2,21,7,8,68,32,36,70
SC Rheindorf,596,3,18,8,10,51,39,12,62
Vienna,596,4,16,3,17,57,60,-3,51
Rapid Vienna,596,5,11,12,13,46,41,5,45
SV Josko Rie,596,6,13,4,19,34,52,-18,43
RZ Pellets W,596,7,11,8,17,40,56,-16,41
St. Pölten,596,8,10,10,16,41,56,-15,40
Admira Wacke,596,9,10,10,16,34,57,-23,40
Mattersburg,596,10,9,9,18,45,59,-14,36
SC Rheindorf,597,1,21,6,9,53,43,10,69
FC Salzburg,597,2,19,8,9,67,36,31,65
SK Sturm Gra,597,3,19,6,11,66,41,25,63
Vienna,597,4,18,7,11,64,52,12,61
Rapid Vienna,597,5,15,8,13,59,52,7,53
Admira Wacke,597,6,12,7,17,44,60,-16,43
RZ Pellets W,597,7,12,5,19,44,63,-19,41
SV Josko Rie,597,8,11,5,20,34,48,-14,38
Mattersburg,597,9,10,8,18,38,59,-21,38
St. Pölten,597,10,7,12,17,49,64,-15,33
SK Sturm Gra,598,1,22,5,9,55,23,32,71
SC Rheindorf,598,2,21,6,9,53,34,19,69
FC Salzburg,598,3,19,7,10,59,34,25,64
Vienna,598,4,19,7,10,58,46,12,64
Rapid Vienna,598,5,15,8,13,60,44,16,53
SV Josko Rie,598,6,12,6,18,41,52,-11,42
RZ Pellets W,598,7,12,5,19,42,56,-14,41
Admira Wacke,598,8,11,6,19,40,61,-21,39
St. Pölten,598,9,8,9,19,39,68,-29,33
Mattersburg,598,10,8,7,21,31,60,-29,31
SK Sturm Gra,599,1,21,6,9,62,36,26,69
SC Rheindorf,599,2,20,8,8,62,47,15,68
FC Salzburg,599,3,19,7,10,67,39,28,64
Vienna,599,4,19,5,12,69,58,11,62
Rapid Vienna,599,5,13,12,11,54,41,13,51
RZ Pellets W,599,6,14,7,15,46,51,-5,49
Admira Wacke,599,7,13,5,18,46,66,-20,44
SV Josko Rie,599,8,12,4,20,47,57,-10,40
Mattersburg,599,9,8,6,22,34,58,-24,30
St. Pölten,599,10,7,8,21,39,73,-34,29
FC Salzburg,600,1,22,7,7,65,30,35,73
SK Sturm Gra,600,2,20,8,8,60,32,28,68
SC Rheindorf,600,3,19,7,10,53,42,11,64
Vienna,600,4,17,3,16,59,56,3,54
Rapid Vienna,600,5,12,13,11,53,43,10,49
RZ Pellets W,600,6,14,4,18,47,54,-7,46
Admira Wacke,600,7,12,7,17,33,51,-18,43
Mattersburg,600,8,9,10,17,37,50,-13,37
SV Josko Rie,600,9,11,4,21,31,50,-19,37
St. Pölten,600,10,9,7,20,38,68,-30,34
SC Rheindorf,601,1,19,11,6,52,36,16,68
SK Sturm Gra,601,2,19,7,10,65,36,29,64
FC Salzburg,601,3,18,6,12,55,37,18,60
Vienna,601,4,18,6,12,65,52,13,60
Rapid Vienna,601,5,14,10,12,53,43,10,52
RZ Pellets W,601,6,14,6,16,44,53,-9,48
Admira Wacke,601,7,13,7,16,44,62,-18,46
St. Pölten,601,8,8,11,17,40,56,-16,35
SV Josko Rie,601,9,9,7,20,33,54,-21,34
Mattersburg,601,10,8,9,19,37,59,-22,33
SC Rheindorf,602,1,21,7,8,61,45,16,70
FC Salzburg,602,2,19,7,10,66,35,31,64
Vienna,602,3,20,4,12,73,57,16,64
Rapid Vienna,602,4,16,10,10,61,42,19,58
SK Sturm Gra,602,5,17,6,13,52,40,12,57
RZ Pellets W,602,6,13,6,17,48,55,-7,45
Admira Wacke,602,7,13,6,17,38,54,-16,45
SV Josko Rie,602,8,10,6,20,34,55,-21,36
St. Pölten,602,9,8,10,18,37,66,-29,34
Mattersburg,602,10,8,8,20,34,55,-21,32
SC Rheindorf,603,1,20,7,9,56,45,11,67
FC Salzburg,603,2,17,11,8,60,34,26,62
SK Sturm Gra,603,3,17,9,10,54,32,22,60
Vienna,603,4,16,7,13,60,51,9,55
RZ Pellets W,603,5,15,8,13,59,52,7,53
Rapid Vienna,603,6,12,14,10,52,41,11,50
SV Josko Rie,603,7,10,10,16,34,46,-12,40
St. Pölten,603,8,9,11,16,41,65,-24,38
Mattersburg,603,9,9,7,20,37,61,-24,34
Admira Wacke,603,10,8,10,18,33,59,-26,34
FC Salzburg,604,1,21,8,7,69,33,36,71
SK Sturm Gra,604,2,22,5,9,61,33,28,71
SC Rheindorf,604,3,21,6,9,63,40,23,69
Vienna,604,4,19,5,12,65,50,15,62
Rapid Vienna,604,5,15,11,10,58,40,18,56
Admira Wacke,604,6,11,5,20,36,65,-29,38
Mattersburg,604,7,8,12,16,33,53,-20,36
RZ Pellets W,604,8,9,8,19,40,57,-17,35
St. Pölten,604,9,7,11,18,41,65,-24,32
SV Josko Rie,604,10,9,5,22,25,55,-30,32
FC Salzburg,605,1,23,8,5,73,28,45,77
SK Sturm Gra,605,2,21,5,10,63,32,31,68
Vienna,605,3,19,7,10,62,46,16,64
SC Rheindorf,605,4,18,7,11,56,42,14,61
Rapid Vienna,605,5,13,10,13,53,43,10,49
Admira Wacke,605,6,12,6,18,41,65,-24,42
RZ Pellets W,605,7,10,10,16,45,63,-18,40
St. Pölten,605,8,8,12,16,44,63,-19,36
SV Josko Rie,605,9,9,7,20,33,58,-25,34
Mattersburg,605,10,7,8,21,32,62,-30,29
SK Sturm Gra,606,1,24,5,7,71,23,48,77
FC Salzburg,606,2,18,9,9,68,34,34,63
Vienna,606,3,19,5,12,69,55,14,62
SC Rheindorf,606,4,18,8,10,54,50,4,62
Rapid Vienna,606,5,11,12,13,54,48,6,45
RZ Pellets W,606,6,13,5,18,47,60,-13,44
SV Josko Rie,606,7,13,5,18,41,59,-18,44
Admira Wacke,606,8,11,7,18,41,73,-32,40
Mattersburg,606,9,8,10,18,35,54,-19,34
St. Pölten,606,10,7,10,19,41,65,-24,31
FC Salzburg,607,1,21,5,10,71,34,37,68
SK Sturm Gra,607,2,18,6,12,60,39,21,60
Rapid Vienna,607,3,17,9,10,56,36,20,60
Vienna,607,4,18,6,12,55,43,12,60
SC Rheindorf,607,5,17,9,10,55,46,9,60
RZ Pellets W,607,6,13,7,16,42,51,-9,46
Mattersburg,607,7,13,7,16,38,49,-11,46
St. Pölten,607,8,10,9,17,41,62,-21,39
Admira Wacke,607,9,10,4,22,37,65,-28,34
SV Josko Rie,607,10,10,4,22,28,58,-30,34
FC Salzburg,608,1,19,9,8,60,29,31,66
SC Rheindorf,608,2,20,6,10,60,40,20,66
Vienna,608,3,19,4,13,58,53,5,61
Rapid Vienna,608,4,16,10,10,58,40,18,58
SK Sturm Gra,608,5,17,7,12,53,38,15,58
Admira Wacke,608,6,14,6,16,34,49,-15,48
RZ Pellets W,608,7,13,8,15,50,53,-3,47
SV Josko Rie,608,8,13,4,19,40,60,-20,43
St. Pölten,608,9,8,8,20,44,65,-21,32
Mattersburg,608,10,7,6,23,31,61,-30,27
SC Rheindorf,609,1,21,7,8,56,39,17,70
FC Salzburg,609,2,19,8,9,63,34,29,65
Vienna,609,3,19,4,13,62,55,7,61
SK Sturm Gra,609,4,15,10,11,57,36,21,55
Rapid Vienna,609,5,14,11,11,53,36,17,53
RZ Pellets W,609,6,14,7,15,46,52,-6,49
SV Josko Rie,609,7,11,8,17,37,52,-15,41
Admira Wacke,609,8,10,9,17,39,60,-21,39
Mattersburg,609,9,9,8,19,37,60,-23,35
St. Pölten,609,10,6,12,18,40,66,-26,30
SK Sturm Gra,610,1,22,7,7,65,27,38,73
FC Salzburg,610,2,20,6,10,69,36,33,66
SC Rheindorf,610,3,19,8,9,58,43,15,65
Vienna,610,4,19,5,12,54,45,9,62
Rapid Vienna,610,5,14,13,9,51,34,17,55
RZ Pellets W,610,6,14,9,13,44,50,-6,51
Mattersburg,610,7,9,8,19,37,56,-19,35
Admira Wacke,610,8,10,5,21,31,62,-31,35
St. Pölten,610,9,8,10,18,38,60,-22,34
SV Josko Rie,610,10,8,3,25,31,65,-34,27
SC Rheindorf,611,1,20,10,6,52,35,17,70
FC Salzburg,611,2,19,11,6,64,30,34,68
SK Sturm Gra,611,3,17,8,11,56,33,23,59
Vienna,611,4,17,3,16,58,56,2,54
RZ Pellets W,611,5,16,6,14,48,50,-2,54
Admira Wacke,611,6,15,5,16,40,54,-14,50
Rapid Vienna,611,7,13,10,13,47,40,7,49
SV Josko Rie,611,8,8,9,19,33,54,-21,33
Mattersburg,611,9,7,11,18,39,56,-17,32
St. Pölten,611,10,5,13,18,37,66,-29,28
FC Salzburg,612,1,18,10,8,66,35,31,64
SC Rheindorf,612,2,18,9,9,55,41,14,63
SK Sturm Gra,612,3,18,7,11,61,37,24,61
Rapid Vienna,612,4,15,12,9,66,46,20,57
Vienna,612,5,16,8,12,62,52,10,56
Admira Wacke,612,6,11,10,15,34,51,-17,43
St. Pölten,612,7,11,9,16,51,62,-11,42
RZ Pellets W,612,8,11,6,19,40,64,-24,39
SV Josko Rie,612,9,9,9,18,32,52,-20,36
Mattersburg,612,10,8,10,18,39,66,-27,34
SC Rheindorf,613,1,22,6,8,67,43,24,72
FC Salzburg,613,2,21,7,8,66,34,32,70
SK Sturm Gra,613,3,19,8,9,64,36,28,65
Vienna,613,4,17,8,11,63,52,11,59
Rapid Vienna,613,5,11,14,11,54,46,8,47
SV Josko Rie,613,6,12,9,15,36,42,-6,45
RZ Pellets W,613,7,11,10,15,43,52,-9,43
Admira Wacke,613,8,11,5,20,31,60,-29,38
St. Pölten,613,9,9,8,19,45,69,-24,35
Mattersburg,613,10,4,11,21,32,67,-35,23
SK Sturm Gra,614,1,20,9,7,59,31,28,69
FC Salzburg,614,2,20,8,8,70,36,34,68
Vienna,614,3,19,2,15,64,57,7,59
SC Rheindorf,614,4,16,11,9,48,42,6,59
Rapid Vienna,614,5,13,12,11,56,41,15,51
RZ Pellets W,614,6,14,6,16,55,55,0,48
SV Josko Rie,614,7,14,4,18,42,52,-10,46
Admira Wacke,614,8,11,5,20,37,67,-30,38
St. Pölten,614,9,8,11,17,41,66,-25,35
Mattersburg,614,10,7,8,21,38,63,-25,29
SK Sturm Gra,615,1,21,6,9,62,30,32,69
SC Rheindorf,615,2,21,5,10,56,40,16,68
FC Salzburg,615,3,18,8,10,59,40,19,62
Vienna,615,4,16,9,11,59,50,9,57
Rapid Vienna,615,5,14,10,12,57,43,14,52
SV Josko Rie,615,6,15,6,15,42,45,-3,51
RZ Pellets W,615,7,14,9,13,46,52,-6,51
Mattersburg,615,8,7,10,19,40,61,-21,31
St. Pölten,615,9,7,10,19,44,71,-27,31
Admira Wacke,615,10,8,5,23,34,67,-33,29
FC Salzburg,616,1,20,10,6,66,28,38,70
SK Sturm Gra,616,2,20,6,10,59,34,25,66
SC Rheindorf,616,3,19,8,9,49,35,14,65
Vienna,616,4,18,4,14,58,54,4,58
Rapid Vienna,616,5,14,9,13,55,45,10,51
RZ Pellets W,616,6,12,7,17,44,56,-12,43
Mattersburg,616,7,11,9,16,41,50,-9,42
SV Josko Rie,616,8,11,9,16,32,43,-11,42
Admira Wacke,616,9,9,5,22,28,61,-33,32
St. Pölten,616,10,6,13,17,38,64,-26,31
FC Salzburg,617,1,22,7,7,69,34,35,73
SC Rheindorf,617,2,19,6,11,62,45,17,63
Vienna,617,3,18,7,11,63,48,15,61
SK Sturm Gra,617,4,16,9,11,57,42,15,57
Rapid Vienna,617,5,15,11,10,57,36,21,56
Admira Wacke,617,6,12,7,17,37,56,-19,43
RZ Pellets W,617,7,11,8,17,39,57,-18,41
SV Josko Rie,617,8,11,5,20,31,55,-24,38
Mattersburg,617,9,9,10,17,35,50,-15,37
St. Pölten,617,10,7,10,19,33,60,-27,31
FC Salzburg,618,1,22,7,7,73,32,41,73
SC Rheindorf,618,2,21,5,10,65,50,15,68
SK Sturm Gra,618,3,19,8,9,62,34,28,65
Rapid Vienna,618,4,14,12,10,57,40,17,54
Vienna,618,5,15,6,15,60,59,1,51
Admira Wacke,618,6,13,7,16,39,60,-21,46
RZ Pellets W,618,7,11,9,16,48,63,-15,42
SV Josko Rie,618,8,13,3,20,36,52,-16,42
Mattersburg,618,9,8,8,20,37,61,-24,32
St. Pölten,618,10,7,9,20,41,67,-26,30
FC Salzburg,619,1,21,8,7,64,28,36,71
SC Rheindorf,619,2,19,9,8,53,41,12,66
Vienna,619,3,19,6,11,65,48,17,63
SK Sturm Gra,619,4,17,11,8,57,35,22,62
Rapid Vienna,619,5,13,14,9,60,40,20,53
Admira Wacke,619,6,12,7,17,38,54,-16,43
RZ Pellets W,619,7,10,9,17,40,55,-15,39
St. Pölten,619,8,11,6,19,51,77,-26,39
SV Josko Rie,619,9,8,7,21,32,57,-25,31
Mattersburg,619,10,6,11,19,36,61,-25,29
Vienna,620,1,22,6,8,76,45,31,72
FC Salzburg,620,2,19,8,9,64,34,30,65
SC Rheindorf,620,3,18,11,7,57,41,16,65
SK Sturm Gra,620,4,19,5,12,60,42,18,62
Rapid Vienna,620,5,13,11,12,53,44,9,50
RZ Pellets W,620,6,12,9,15,48,53,-5,45
St. Pölten,620,7,12,9,15,47,66,-19,45
Admira Wacke,620,8,11,6,19,36,56,-20,39
SV Josko Rie,620,9,9,5,22,31,62,-31,32
Mattersburg,620,10,6,8,22,33,62,-29,26
SC Rheindorf,621,1,20,7,9,58,45,13,67
FC Salzburg,621,2,19,9,8,66,33,33,66
SK Sturm Gra,621,3,20,4,12,59,38,21,64
Vienna,621,4,20,3,13,69,55,14,63
Rapid Vienna,621,5,12,10,14,48,39,9,46
RZ Pellets W,621,6,12,8,16,46,57,-11,44
Mattersburg,621,7,12,8,16,39,51,-12,44
Admira Wacke,621,8,12,7,17,39,61,-22,43
St. Pölten,621,9,9,8,19,39,60,-21,35
SV Josko Rie,621,10,8,8,20,32,56,-24,32
SC Rheindorf,622,1,21,7,8,64,43,21,70
FC Salzburg,622,2,19,11,6,63,33,30,68
Vienna,622,3,21,5,10,74,53,21,68
SK Sturm Gra,622,4,18,7,11,49,32,17,61
RZ Pellets W,622,5,13,7,16,48,59,-11,46
Admira Wacke,622,6,12,7,17,42,60,-18,43
Rapid Vienna,622,7,10,12,14,54,48,6,42
SV Josko Rie,622,8,11,5,20,40,56,-16,38
Mattersburg,622,9,8,10,18,40,59,-19,34
St. Pölten,622,10,8,7,21,36,67,-31,31
Vienna,623,1,21,3,12,69,54,15,66
SC Rheindorf,623,2,19,7,10,60,48,12,64
FC Salzburg,623,3,18,9,9,61,36,25,63
Rapid Vienna,623,4,15,11,10,60,42,18,56
SK Sturm Gra,623,5,16,7,13,58,43,15,55
St. Pölten,623,6,11,11,14,50,63,-13,44
RZ Pellets W,623,7,11,8,17,51,62,-11,41
Admira Wacke,623,8,10,9,17,42,63,-21,39
Mattersburg,623,9,10,7,19,35,54,-19,37
SV Josko Rie,623,10,10,6,20,39,60,-21,36
Vienna,624,1,21,5,10,67,51,16,68
FC Salzburg,624,2,17,12,7,59,32,27,63
SK Sturm Gra,624,3,19,6,11,58,35,23,63
SC Rheindorf,624,4,18,8,10,54,41,13,62
Rapid Vienna,624,5,14,14,8,56,36,20,56
Admira Wacke,624,6,13,6,17,35,56,-21,45
SV Josko Rie,624,7,12,8,16,36,50,-14,44
RZ Pellets W,624,8,9,7,20,41,60,-19,34
St. Pölten,624,9,9,6,21,40,65,-25,33
Mattersburg,624,10,7,10,19,41,61,-20,31
FC Salzburg,625,1,20,8,8,72,34,38,68
SC Rheindorf,625,2,19,11,6,51,31,20,68
Rapid Vienna,625,3,17,10,9,59,33,26,61
SK Sturm Gra,625,4,18,6,12,57,39,18,60
Vienna,625,5,19,3,14,55,52,3,60
RZ Pellets W,625,6,11,7,18,47,58,-11,40
Mattersburg,625,7,10,10,16,36,49,-13,40
SV Josko Rie,625,8,10,7,19,32,55,-23,37
Admira Wacke,625,9,10,6,20,30,59,-29,36
St. Pölten,625,10,7,10,19,35,64,-29,31
SC Rheindorf,626,1,21,6,9,58,38,20,69
FC Salzburg,626,2,20,7,9,58,30,28,67
SK Sturm Gra,626,3,21,4,11,58,34,24,67
Vienna,626,4,19,4,13,62,49,13,61
Rapid Vienna,626,5,16,11,9,60,37,23,59
RZ Pellets W,626,6,13,9,14,44,50,-6,48
Admira Wacke,626,7,10,7,19,35,57,-22,37
Mattersburg,626,8,7,12,17,34,57,-23,33
SV Josko Rie,626,9,8,8,20,29,55,-26,32
St. Pölten,626,10,7,8,21,39,70,-31,29
SK Sturm Gra,627,1,22,4,10,66,35,31,70
FC Salzburg,627,2,20,8,8,65,34,31,68
Vienna,627,3,19,8,9,66,49,17,65
SC Rheindorf,627,4,17,7,12,57,48,9,58
Rapid Vienna,627,5,15,11,10,60,44,16,56
RZ Pellets W,627,6,14,8,14,55,57,-2,50
SV Josko Rie,627,7,11,4,21,32,53,-21,37
Mattersburg,627,8,9,7,20,35,58,-23,34
Admira Wacke,627,9,9,6,21,37,71,-34,33
St. Pölten,627,10,7,11,18,41,65,-24,32
FC Salzburg,628,1,21,8,7,69,33,36,71
SC Rheindorf,628,2,21,6,9,57,46,11,69
Rapid Vienna,628,3,16,11,9,64,43,21,59
SK Sturm Gra,628,4,16,9,11,54,38,16,57
Vienna,628,5,17,5,14,62,53,9,56
RZ Pellets W,628,6,14,5,17,45,55,-10,47
Admira Wacke,628,7,13,5,18,39,61,-22,44
SV Josko Rie,628,8,11,5,20,34,48,-14,38
St. Pölten,628,9,9,10,17,41,59,-18,37
Mattersburg,628,10,7,6,23,38,67,-29,27
FC Salzburg,629,1,19,10,7,68,39,29,67
SK Sturm Gra,629,2,19,8,9,60,32,28,65
Vienna,629,3,20,5,11,71,47,24,65
SC Rheindorf,629,4,18,7,11,54,41,13,61
Rapid Vienna,629,5,12,11,13,53,44,9,47
RZ Pellets W,629,6,9,13,14,41,53,-12,40
Mattersburg,629,7,10,10,16,42,56,-14,40
St. Pölten,629,8,11,6,19,41,68,-27,39
Admira Wacke,629,9,11,6,19,36,64,-28,39
SV Josko Rie,629,10,10,6,20,41,63,-22,36
SC Rheindorf,630,1,23,6,7,60,36,24,75
FC Salzburg,630,2,21,5,10,65,36,29,68
SK Sturm Gra,630,3,19,7,10,63,39,24,64
Vienna,630,4,19,4,13,63,52,11,61
Rapid Vienna,630,5,13,13,10,57,42,15,52
RZ Pellets W,630,6,14,6,16,40,51,-11,48
SV Josko Rie,630,7,12,5,19,35,48,-13,41
Mattersburg,630,8,8,9,19,41,58,-17,33
St. Pölten,630,9,9,6,21,40,70,-30,33
Admira Wacke,630,10,8,7,21,32,64,-32,31
FC Salzburg,631,1,22,8,6,58,25,33,74
SC Rheindorf,631,2,21,7,8,61,44,17,70
Vienna,631,3,21,3,12,61,52,9,66
SK Sturm Gra,631,4,18,8,10,68,35,33,62
Rapid Vienna,631,5,12,9,15,56,47,9,45
Admira Wacke,631,6,12,5,19,36,56,-20,41
RZ Pellets W,631,7,11,7,18,41,58,-17,40
St. Pölten,631,8,10,8,18,40,64,-24,38
Mattersburg,631,9,8,10,18,37,55,-18,34
SV Josko Rie,631,10,9,7,20,32,54,-22,34
FC Salzburg,632,1,21,8,7,61,29,32,71
SC Rheindorf,632,2,21,7,8,54,33,21,70
SK Sturm Gra,632,3,19,7,10,62,32,30,64
Vienna,632,4,20,3,13,61,48,13,63
Rapid Vienna,632,5,13,11,12,47,40,7,50
RZ Pellets W,632,6,13,6,17,45,58,-13,45
Admira Wacke,632,7,12,5,19,42,67,-25,41
Mattersburg,632,8,9,9,18,39,56,-17,36
St. Pölten,632,9,9,9,18,41,63,-22,36
SV Josko Rie,632,10,8,5,23,34,60,-26,29
FC Salzburg,633,1,21,7,8,63,30,33,70
Vienna,633,2,20,5,11,62,46,16,65
SC Rheindorf,633,3,17,8,11,55,47,8,59
Rapid Vienna,633,4,16,9,11,61,44,17,57
SK Sturm Gra,633,5,16,7,13,55,40,15,55
RZ Pellets W,633,6,16,6,14,55,53,2,54
SV Josko Rie,633,7,11,8,17,33,52,-19,41
Admira Wacke,633,8,11,7,18,36,59,-23,40
St. Pölten,633,9,9,9,18,45,62,-17,36
Mattersburg,633,10,6,8,22,36,68,-32,26
FC Salzburg,634,1,23,7,6,72,28,44,76
SK Sturm Gra,634,2,19,6,11,59,35,24,63
Vienna,634,3,18,6,12,65,56,9,60
SC Rheindorf,634,4,16,7,13,48,48,0,55
Rapid Vienna,634,5,15,9,12,57,39,18,54
RZ Pellets W,634,6,12,10,14,46,51,-5,46
St. Pölten,634,7,10,11,15,47,59,-12,41
Admira Wacke,634,8,11,6,19,35,59,-24,39
SV Josko Rie,634,9,11,3,22,32,62,-30,36
Mattersburg,634,10,8,9,19,31,55,-24,33
SK Sturm Gra,635,1,21,7,8,62,34,28,70
FC Salzburg,635,2,20,7,9,59,31,28,67
SC Rheindorf,635,3,20,7,9,54,42,12,67
Vienna,635,4,19,5,12,63,48,15,62
RZ Pellets W,635,5,14,7,15,47,54,-7,49
Rapid Vienna,635,6,12,10,14,49,43,6,46
SV Josko Rie,635,7,13,4,19,39,53,-14,43
Mattersburg,635,8,10,7,19,37,55,-18,37
Admira Wacke,635,9,9,8,19,32,56,-24,35
St. Pölten,635,10,6,10,20,39,65,-26,28
FC Salzburg,636,1,20,9,7,57,23,34,69
SK Sturm Gra,636,2,20,5,11,57,33,24,65
SC Rheindorf,636,3,19,8,9,54,42,12,65
Vienna,636,4,19,4,13,57,45,12,61
Rapid Vienna,636,5,13,10,13,54,43,11,49
RZ Pellets W,636,6,12,9,15,40,51,-11,45
SV Josko Rie,636,7,13,5,18,39,53,-14,44
Admira Wacke,636,8,11,6,19,34,54,-20,39
Mattersburg,636,9,9,9,18,35,54,-19,36
St. Pölten,636,10,7,9,20,36,65,-29,30
SC Rheindorf,637,1,20,8,8,60,38,22,68
SK Sturm Gra,637,2,19,8,9,57,32,25,65
FC Salzburg,637,3,18,8,10,60,33,27,62
Vienna,637,4,18,5,13,63,51,12,59
Rapid Vienna,637,5,16,9,11,60,40,20,57
Admira Wacke,637,6,14,5,17,44,63,-19,47
RZ Pellets W,637,7,13,7,16,45,54,-9,46
Mattersburg,637,8,8,9,19,35,60,-25,33
SV Josko Rie,637,9,9,6,21,35,61,-26,33
St. Pölten,637,10,8,9,19,44,71,-27,33
FC Salzburg,638,1,22,5,9,64,35,29,71
SC Rheindorf,638,2,21,8,7,55,36,19,71
Vienna,638,3,20,6,10,69,49,20,66
SK Sturm Gra,638,4,18,6,12,52,38,14,60
Rapid Vienna,638,5,15,11,10,57,34,23,56
RZ Pellets W,638,6,13,5,18,46,55,-9,44
St. Pölten,638,7,9,10,17,47,63,-16,37
Admira Wacke,638,8,9,7,20,34,67,-33,34
SV Josko Rie,638,9,9,6,21,26,51,-25,33
Mattersburg,638,10,8,8,20,36,58,-22,32
FC Salzburg,639,1,23,7,6,71,29,42,76
SC Rheindorf,639,2,21,8,7,57,45,12,71
SK Sturm Gra,639,3,20,6,10,65,35,30,66
Vienna,639,4,17,5,14,58,55,3,56
Rapid Vienna,639,5,15,10,11,63,42,21,55
RZ Pellets W,639,6,12,6,18,42,55,-13,42
SV Josko Rie,639,7,11,5,20,36,53,-17,38
Admira Wacke,639,8,11,5,20,38,65,-27,38
St. Pölten,639,9,9,8,19,43,70,-27,35
Mattersburg,639,10,7,8,21,34,58,-24,29
FC Salzburg,640,1,22,6,8,70,34,36,72
Vienna,640,2,20,7,9,66,51,15,67
SK Sturm Gra,640,3,19,6,11,58,37,21,63
SC Rheindorf,640,4,15,10,11,53,46,7,55
Rapid Vienna,640,5,13,8,15,50,48,2,47
RZ Pellets W,640,6,13,8,15,49,55,-6,47
St. Pölten,640,7,12,7,17,47,58,-11,43
Admira Wacke,640,8,11,6,19,38,64,-26,39
Mattersburg,640,9,8,11,17,42,59,-17,35
SV Josko Rie,640,10,8,9,19,37,58,-21,33
FC Salzburg,641,1,21,8,7,71,32,39,71
SK Sturm Gra,641,2,18,9,9,58,33,25,63
SC Rheindorf,641,3,18,9,9,62,52,10,63
Vienna,641,4,17,7,12,72,58,14,58
Rapid Vienna,641,5,16,9,11,63,41,22,57
Admira Wacke,641,6,13,9,14,42,55,-13,48
RZ Pellets W,641,7,11,12,13,48,56,-8,45
SV Josko Rie,641,8,11,5,20,39,60,-21,38
Mattersburg,641,9,7,8,21,41,71,-30,29
St. Pölten,641,10,5,10,21,37,75,-38,25
FC Salzburg,642,1,22,6,8,69,32,37,72
SK Sturm Gra,642,2,21,6,9,59,30,29,69
SC Rheindorf,642,3,20,6,10,57,36,21,66
Vienna,642,4,20,5,11,74,49,25,65
Rapid Vienna,642,5,13,11,12,60,41,19,50
RZ Pellets W,642,6,15,5,16,50,64,-14,50
Admira Wacke,642,7,12,5,19,37,62,-25,41
St. Pölten,642,8,9,9,18,39,64,-25,36
SV Josko Rie,642,9,9,6,21,28,51,-23,33
Mattersburg,642,10,7,5,24,30,74,-44,26
FC Salzburg,643,1,24,6,6,72,30,42,78
SC Rheindorf,643,2,20,7,9,51,40,11,67
SK Sturm Gra,643,3,20,5,11,64,38,26,65
Vienna,643,4,19,4,13,67,55,12,61
Rapid Vienna,643,5,13,11,12,63,47,16,50
RZ Pellets W,643,6,13,7,16,48,60,-12,46
SV Josko Rie,643,7,12,8,16,36,46,-10,44
Admira Wacke,643,8,10,7,19,37,64,-27,37
Mattersburg,643,9,7,9,20,30,59,-29,30
St. Pölten,643,10,6,8,22,39,68,-29,26
SC Rheindorf,644,1,24,5,7,67,34,33,77
FC Salzburg,644,2,22,5,9,66,30,36,71
SK Sturm Gra,644,3,17,9,10,60,41,19,60
Rapid Vienna,644,4,16,8,12,57,40,17,56
Vienna,644,5,14,7,15,59,63,-4,49
Admira Wacke,644,6,14,5,17,38,52,-14,47
RZ Pellets W,644,7,12,9,15,48,53,-5,45
SV Josko Rie,644,8,10,7,19,37,56,-19,37
St. Pölten,644,9,8,9,19,39,70,-31,33
Mattersburg,644,10,7,8,21,32,64,-32,29
FC Salzburg,645,1,21,7,8,67,34,33,70
SC Rheindorf,645,2,19,8,9,55,44,11,65
Vienna,645,3,19,5,12,58,47,11,62
SK Sturm Gra,645,4,17,6,13,49,32,17,57
Rapid Vienna,645,5,13,13,10,57,42,15,52
RZ Pellets W,645,6,13,7,16,45,54,-9,46
Admira Wacke,645,7,13,6,17,38,55,-17,45
St. Pölten,645,8,11,9,16,45,55,-10,42
SV Josko Rie,645,9,10,4,22,31,58,-27,34
Mattersburg,645,10,8,7,21,37,61,-24,31
SK Sturm Gra,646,1,20,7,9,58,28,30,67
FC Salzburg,646,2,19,6,11,59,38,21,63
SC Rheindorf,646,3,17,8,11,52,42,10,59
Vienna,646,4,16,8,12,55,50,5,56
Rapid Vienna,646,5,15,10,11,57,38,19,55
RZ Pellets W,646,6,11,10,15,49,54,-5,43
St. Pölten,646,7,10,13,13,43,55,-12,43
SV Josko Rie,646,8,11,7,18,35,55,-20,40
Mattersburg,646,9,10,8,18,37,52,-15,38
Admira Wacke,646,10,8,9,19,30,63,-33,33
SK Sturm Gra,647,1,24,4,8,65,29,36,76
FC Salzburg,647,2,22,6,8,75,38,37,72
SC Rheindorf,647,3,19,7,10,54,44,10,64
Vienna,647,4,18,5,13,60,51,9,59
Rapid Vienna,647,5,15,12,9,60,40,20,57
SV Josko Rie,647,6,11,6,19,46,58,-12,39
RZ Pellets W,647,7,9,11,16,46,62,-16,38
St. Pölten,647,8,7,12,17,42,64,-22,33
Admira Wacke,647,9,8,7,21,31,69,-38,31
Mattersburg,647,10,6,12,18,37,61,-24,30
SK Sturm Gra,648,1,22,6,8,68,33,35,72
FC Salzburg,648,2,18,11,7,63,33,30,65
Vienna,648,3,18,5,13,67,53,14,59
SC Rheindorf,648,4,17,5,14,47,50,-3,56
Rapid Vienna,648,5,13,12,11,51,41,10,51
Admira Wacke,648,6,12,8,16,40,57,-17,44
RZ Pellets W,648,7,11,10,15,43,52,-9,43
SV Josko Rie,648,8,12,7,17,36,49,-13,43
St. Pölten,648,9,8,10,18,47,72,-25,34
Mattersburg,648,10,8,8,20,34,56,-22,32
FC Salzburg,649,1,22,8,6,67,25,42,74
SK Sturm Gra,649,2,21,6,9,64,29,35,69
SC Rheindorf,649,3,19,7,10,52,46,6,64
Vienna,649,4,18,5,13,58,51,7,59
Rapid Vienna,649,5,12,14,10,53,41,12,50
RZ Pellets W,649,6,13,5,18,44,52,-8,44
St. Pölten,649,7,10,11,15,42,53,-11,41
Admira Wacke,649,8,11,6,19,39,67,-28,39
SV Josko Rie,649,9,10,6,20,33,57,-24,36
Mattersburg,649,10,5,10,21,34,65,-31,25
FC Salzburg,650,1,21,9,6,68,29,39,72
SK Sturm Gra,650,2,20,5,11,58,36,22,65
SC Rheindorf,650,3,20,5,11,48,37,11,65
Vienna,650,4,15,6,15,59,61,-2,51
Rapid Vienna,650,5,12,12,12,53,41,12,48
Admira Wacke,650,6,14,5,17,41,57,-16,47
SV Josko Rie,650,7,14,4,18,45,54,-9,46
RZ Pellets W,650,8,12,10,14,42,52,-10,46
Mattersburg,650,9,9,11,16,36,52,-16,38
St. Pölten,650,10,4,11,21,32,63,-31,23
FC Salzburg,651,1,23,8,5,69,26,43,77
Vienna,651,2,22,3,11,61,48,13,69
SC Rheindorf,651,3,19,6,11,49,45,4,63
SK Sturm Gra,651,4,17,9,10,56,34,22,60
Rapid Vienna,651,5,13,11,12,62,43,19,50
RZ Pellets W,651,6,14,7,15,48,52,-4,49
Admira Wacke,651,7,11,4,21,37,62,-25,37
Mattersburg,651,8,8,10,18,35,56,-21,34
St. Pölten,651,9,7,11,18,36,59,-23,32
SV Josko Rie,651,10,9,5,22,29,57,-28,32
FC Salzburg,652,1,23,7,6,67,27,40,76
SK Sturm Gra,652,2,19,8,9,58,29,29,65
Rapid Vienna,652,3,18,8,10,57,32,25,62
SC Rheindorf,652,4,18,7,11,52,48,4,61
Vienna,652,5,18,4,14,61,49,12,58
RZ Pellets W,652,6,13,7,16,48,55,-7,46
Admira Wacke,652,7,12,6,18,36,56,-20,42
Mattersburg,652,8,10,6,20,38,59,-21,36
SV Josko Rie,652,9,10,3,23,31,60,-29,33
St. Pölten,652,10,7,8,21,35,68,-33,29
FC Salzburg,653,1,21,8,7,63,29,34,71
SC Rheindorf,653,2,21,8,7,59,36,23,71
SK Sturm Gra,653,3,20,4,12,59,38,21,64
Vienna,653,4,19,5,12,74,58,16,62
Rapid Vienna,653,5,14,12,10,56,42,14,54
RZ Pellets W,653,6,12,6,18,45,59,-14,42
SV Josko Rie,653,7,11,5,20,37,56,-19,38
St. Pölten,653,8,9,9,18,45,60,-15,36
Admira Wacke,653,9,10,6,20,33,66,-33,36
Mattersburg,653,10,7,9,20,37,64,-27,30
FC Salzburg,654,1,23,6,7,71,33,38,75
SK Sturm Gra,654,2,22,5,9,59,30,29,71
SC Rheindorf,654,3,18,9,9,51,38,13,63
Vienna,654,4,18,4,14,62,53,9,58
Rapid Vienna,654,5,13,10,13,52,42,10,49
RZ Pellets W,654,6,12,9,15,45,53,-8,45
Admira Wacke,654,7,12,6,18,39,57,-18,42
SV Josko Rie,654,8,11,5,20,36,55,-19,38
St. Pölten,654,9,9,9,18,37,58,-21,36
Mattersburg,654,10,7,7,22,32,65,-33,28
FC Salzburg,655,1,22,8,6,72,31,41,74
Vienna,655,2,21,5,10,69,51,18,68
SC Rheindorf,655,3,19,8,9,54,48,6,65
SK Sturm Gra,655,4,16,11,9,57,36,21,59
Rapid Vienna,655,5,13,11,12,50,41,9,50
RZ Pellets W,655,6,12,9,15,50,59,-9,45
SV Josko Rie,655,7,13,4,19,43,55,-12,43
Admira Wacke,655,8,10,6,20,38,59,-21,36
Mattersburg,655,9,8,9,19,38,60,-22,33
St. Pölten,655,10,6,9,21,39,70,-31,27
FC Salzburg,656,1,21,8,7,66,29,37,71
SC Rheindorf,656,2,19,9,8,53,42,11,66
SK Sturm Gra,656,3,18,5,13,59,34,25,59
Vienna,656,4,17,5,14,61,55,6,56
Rapid Vienna,656,5,14,10,12,49,38,11,52
RZ Pellets W,656,6,14,5,17,51,50,1,47
Admira Wacke,656,7,12,7,17,36,56,-20,43
St. Pölten,656,8,10,11,15,43,61,-18,41
SV Josko Rie,656,9,10,5,21,34,59,-25,35
Mattersburg,656,10,8,9,19,31,59,-28,33
FC Salzburg,657,1,22,6,8,61,29,32,72
SC Rheindorf,657,2,20,8,8,56,40,16,68
Vienna,657,3,21,5,10,61,47,14,68
SK Sturm Gra,657,4,21,4,11,58,37,21,67
Rapid Vienna,657,5,16,7,13,55,40,15,55
St. Pölten,657,6,9,10,17,42,55,-13,37
Admira Wacke,657,7,10,7,19,35,56,-21,37
RZ Pellets W,657,8,8,10,18,35,54,-19,34
Mattersburg,657,9,8,9,19,31,50,-19,33
SV Josko Rie,657,10,9,6,21,29,55,-26,33
FC Salzburg,658,1,24,6,6,68,24,44,78
SK Sturm Gra,658,2,21,7,8,65,30,35,70
SC Rheindorf,658,3,17,10,9,49,43,6,61
Vienna,658,4,15,7,14,58,58,0,52
Rapid Vienna,658,5,12,13,11,53,40,13,49
SV Josko Rie,658,6,14,6,16,49,51,-2,48
RZ Pellets W,658,7,12,7,17,49,64,-15,43
Admira Wacke,658,8,9,8,19,34,66,-32,35
Mattersburg,658,9,7,11,18,34,59,-25,32
St. Pölten,658,10,8,7,21,41,65,-24,31
FC Salzburg,659,1,24,6,6,73,32,41,78
SC Rheindorf,659,2,21,8,7,60,35,25,71
Vienna,659,3,20,5,11,64,51,13,65
SK Sturm Gra,659,4,19,5,12,56,34,22,62
Rapid Vienna,659,5,13,11,12,52,42,10,50
RZ Pellets W,659,6,13,7,16,47,54,-7,46
Admira Wacke,659,7,10,8,18,40,64,-24,38
St. Pölten,659,8,8,10,18,39,60,-21,34
SV Josko Rie,659,9,8,7,21,31,57,-26,31
Mattersburg,659,10,6,9,21,29,62,-33,27
FC Salzburg,660,1,23,5,8,73,29,44,74
SC Rheindorf,660,2,18,9,9,57,50,7,63
Vienna,660,3,19,5,12,65,53,12,62
Rapid Vienna,660,4,17,10,9,61,37,24,61
SK Sturm Gra,660,5,18,6,12,55,37,18,60
RZ Pellets W,660,6,13,7,16,43,52,-9,46
St. Pölten,660,7,11,7,18,43,57,-14,40
SV Josko Rie,660,8,11,5,20,39,59,-20,38
Admira Wacke,660,9,9,5,22,25,59,-34,32
Mattersburg,660,10,8,7,21,40,68,-28,31
SC Rheindorf,661,1,21,7,8,65,45,20,70
SK Sturm Gra,661,2,21,5,10,65,37,28,68
FC Salzburg,661,3,19,8,9,68,33,35,65
Vienna,661,4,19,5,12,68,57,11,62
Rapid Vienna,661,5,14,11,11,53,41,12,53
Admira Wacke,661,6,12,9,15,41,57,-16,45
RZ Pellets W,661,7,12,8,16,49,58,-9,44
SV Josko Rie,661,8,10,4,22,31,58,-27,34
Mattersburg,661,9,8,9,19,39,58,-19,33
St. Pölten,661,10,6,10,20,35,70,-35,28
SC Rheindorf,662,1,21,8,7,59,41,18,71
FC Salzburg,662,2,20,8,8,64,30,34,68
SK Sturm Gra,662,3,19,8,9,67,39,28,65
Vienna,662,4,17,5,14,65,55,10,56
Rapid Vienna,662,5,13,10,13,56,43,13,49
RZ Pellets W,662,6,13,6,17,49,60,-11,45
SV Josko Rie,662,7,11,8,17,40,55,-15,41
Admira Wacke,662,8,10,9,17,34,58,-24,39
St. Pölten,662,9,8,10,18,43,67,-24,34
Mattersburg,662,10,8,8,20,36,65,-29,32
FC Salzburg,663,1,22,6,8,75,30,45,72
SC Rheindorf,663,2,19,8,9,53,44,9,65
SK Sturm Gra,663,3,18,8,10,57,35,22,62
Vienna,663,4,17,4,15,56,52,4,55
RZ Pellets W,663,5,14,7,15,53,53,0,49
Rapid Vienna,663,6,12,11,13,53,44,9,47
Mattersburg,663,7,13,6,17,42,53,-11,45
Admira Wacke,663,8,13,6,17,35,59,-24,45
SV Josko Rie,663,9,11,3,22,37,70,-33,36
St. Pölten,663,10,6,11,19,38,59,-21,29
FC Salzburg,664,1,22,7,7,69,30,39,73
SC Rheindorf,664,2,22,6,8,66,44,22,72
SK Sturm Gra,664,3,19,9,8,65,39,26,66
Vienna,664,4,21,3,12,72,51,21,66
Rapid Vienna,664,5,15,11,10,61,43,18,56
RZ Pellets W,664,6,10,9,17,41,55,-14,39
Admira Wacke,664,7,10,8,18,35,58,-23,38
SV Josko Rie,664,8,11,4,21,33,62,-29,37
St. Pölten,664,9,7,8,21,36,71,-35,29
Mattersburg,664,10,7,7,22,34,59,-25,28
FC Salzburg,665,1,18,10,8,57,33,24,64
SK Sturm Gra,665,2,19,7,10,59,37,22,64
SC Rheindorf,665,3,19,7,10,51,43,8,64
RZ Pellets W,665,4,16,9,11,51,46,5,57
Vienna,665,5,15,6,15,62,65,-3,51
Rapid Vienna,665,6,14,8,14,56,41,15,50
Admira Wacke,665,7,11,8,17,40,57,-17,41
St. Pölten,665,8,9,10,17,38,58,-20,37
SV Josko Rie,665,9,9,9,18,33,49,-16,36
Mattersburg,665,10,7,12,17,38,56,-18,33
FC Salzburg,666,1,21,7,8,76,34,42,70
SC Rheindorf,666,2,21,7,8,64,43,21,70
Vienna,666,3,20,5,11,69,54,15,65
SK Sturm Gra,666,4,18,5,13,56,42,14,59
Rapid Vienna,666,5,16,10,10,58,41,17,58
Admira Wacke,666,6,14,5,17,42,60,-18,47
St. Pölten,666,7,9,9,18,44,69,-25,36
RZ Pellets W,666,8,10,5,21,43,61,-18,35
SV Josko Rie,666,9,9,8,19,37,58,-21,35
Mattersburg,666,10,8,7,21,38,65,-27,31
FC Salzburg,667,1,21,9,6,64,28,36,72
SK Sturm Gra,667,2,20,7,9,61,35,26,67
Vienna,667,3,18,6,12,62,49,13,60
SC Rheindorf,667,4,17,6,13,53,47,6,57
Rapid Vienna,667,5,14,11,11,58,39,19,53
RZ Pellets W,667,6,13,9,14,42,48,-6,48
SV Josko Rie,667,7,12,6,18,35,51,-16,42
Admira Wacke,667,8,11,5,20,38,66,-28,38
Mattersburg,667,9,9,7,20,35,57,-22,34
St. Pölten,667,10,6,12,18,36,64,-28,30
FC Salzburg,668,1,22,8,6,78,37,41,74
Vienna,668,2,22,6,8,75,47,28,72
SC Rheindorf,668,3,19,8,9,57,43,14,65
SK Sturm Gra,668,4,15,7,14,52,44,8,52
Rapid Vienna,668,5,13,9,14,43,46,-3,48
Mattersburg,668,6,12,7,17,43,53,-10,43
RZ Pellets W,668,7,12,6,18,46,57,-11,42
Admira Wacke,668,8,11,6,19,38,58,-20,39
SV Josko Rie,668,9,9,8,19,31,56,-25,35
St. Pölten,668,10,7,11,18,42,64,-22,32
FC Salzburg,669,1,22,5,9,67,33,34,71
Vienna,669,2,21,5,10,63,43,20,68
SC Rheindorf,669,3,20,7,9,51,40,11,67
SK Sturm Gra,669,4,20,6,10,62,36,26,66
Rapid Vienna,669,5,10,14,12,45,38,7,44
Admira Wacke,669,6,13,4,19,42,64,-22,43
RZ Pellets W,669,7,11,9,16,48,54,-6,42
SV Josko Rie,669,8,12,4,20,31,51,-20,40
St. Pölten,669,9,8,10,18,40,67,-27,34
Mattersburg,669,10,7,8,21,36,59,-23,29
FC Salzburg,670,1,21,7,8,62,30,32,70
SC Rheindorf,670,2,20,6,10,55,44,11,66
SK Sturm Gra,670,3,19,8,9,54,30,24,65
Vienna,670,4,18,4,14,54,52,2,58
RZ Pellets W,670,5,14,8,14,49,49,0,50
Rapid Vienna,670,6,12,12,12,50,40,10,48
St. Pölten,670,7,11,8,17,49,61,-12,41
Admira Wacke,670,8,10,6,20,33,56,-23,36
SV Josko Rie,670,9,11,3,22,30,57,-27,36
Mattersburg,670,10,9,8,19,36,53,-17,35
FC Salzburg,671,1,22,9,5,69,30,39,75
SC Rheindorf,671,2,20,8,8,54,41,13,68
Vienna,671,3,20,5,11,67,49,18,65
SK Sturm Gra,671,4,18,8,10,57,34,23,62
Rapid Vienna,671,5,14,10,12,64,46,18,52
Admira Wacke,671,6,13,5,18,40,63,-23,44
St. Pölten,671,7,10,9,17,40,60,-20,39
RZ Pellets W,671,8,10,7,19,44,61,-17,37
SV Josko Rie,671,9,9,5,22,36,61,-25,32
Mattersburg,671,10,7,8,21,33,59,-26,29
FC Salzburg,672,1,22,8,6,62,28,34,74
SK Sturm Gra,672,2,20,7,9,60,34,26,67
SC Rheindorf,672,3,17,8,11,52,43,9,59
Vienna,672,4,17,5,14,61,54,7,56
Rapid Vienna,672,5,15,10,11,54,40,14,55
Admira Wacke,672,6,15,4,17,44,55,-11,49
RZ Pellets W,672,7,11,9,16,46,56,-10,42
St. Pölten,672,8,9,11,16,44,62,-18,38
Mattersburg,672,9,8,10,18,38,61,-23,34
SV Josko Rie,672,10,7,6,23,25,53,-28,27
Vienna,673,1,22,5,9,73,47,26,71
FC Salzburg,673,2,21,7,8,64,35,29,70
SC Rheindorf,673,3,19,10,7,58,43,15,67
SK Sturm Gra,673,4,18,8,10,61,37,24,62
Rapid Vienna,673,5,14,8,14,56,44,12,50
SV Josko Rie,673,6,12,4,20,34,52,-18,40
RZ Pellets W,673,7,10,9,17,40,58,-18,39
Admira Wacke,673,8,11,6,19,36,60,-24,39
Mattersburg,673,9,10,7,19,40,55,-15,37
St. Pölten,673,10,7,8,21,40,71,-31,29
FC Salzburg,674,1,20,9,7,63,29,34,69
SC Rheindorf,674,2,20,8,8,62,44,18,68
SK Sturm Gra,674,3,19,8,9,70,40,30,65
Vienna,674,4,17,7,12,65,60,5,58
Rapid Vienna,674,5,13,11,12,60,43,17,50
Admira Wacke,674,6,13,7,16,40,56,-16,46
SV Josko Rie,674,7,14,3,19,39,54,-15,45
RZ Pellets W,674,8,10,10,16,50,67,-17,40
Mattersburg,674,9,7,9,20,31,54,-23,30
St. Pölten,674,10,5,12,19,44,77,-33,27
FC Salzburg,675,1,20,11,5,66,35,31,71
Vienna,675,2,18,9,9,67,47,20,63
SC Rheindorf,675,3,17,11,8,56,44,12,62
SK Sturm Gra,675,4,16,7,13,53,35,18,55
Rapid Vienna,675,5,14,12,10,53,34,19,54
Admira Wacke,675,6,11,9,16,36,52,-16,42
RZ Pellets W,675,7,10,9,17,47,62,-15,39
Mattersburg,675,8,10,9,17,41,58,-17,39
SV Josko Rie,675,9,10,9,17,35,53,-18,39
St. Pölten,675,10,5,12,19,35,69,-34,27
FC Salzburg,676,1,20,9,7,60,32,28,69
SC Rheindorf,676,2,21,6,9,58,43,15,69
SK Sturm Gra,676,3,18,7,11,64,34,30,61
Rapid Vienna,676,4,18,7,11,58,35,23,61
Vienna,676,5,15,6,15,57,58,-1,51
Admira Wacke,676,6,12,8,16,37,53,-16,44
RZ Pellets W,676,7,12,7,17,42,53,-11,43
St. Pölten,676,8,11,9,16,47,68,-21,42
SV Josko Rie,676,9,11,8,17,39,55,-16,41
Mattersburg,676,10,6,5,25,33,64,-31,23
FC Salzburg,677,1,21,7,8,66,32,34,70
SK Sturm Gra,677,2,20,6,10,66,40,26,66
Vienna,677,3,18,7,11,65,52,13,61
SC Rheindorf,677,4,17,8,11,53,48,5,59
Rapid Vienna,677,5,15,13,8,65,42,23,58
Admira Wacke,677,6,11,8,17,38,59,-21,41
RZ Pellets W,677,7,10,9,17,40,53,-13,39
SV Josko Rie,677,8,10,7,19,33,50,-17,37
Mattersburg,677,9,9,9,18,32,57,-25,36
St. Pölten,677,10,7,10,19,42,67,-25,31
SK Sturm Gra,678,1,21,8,7,64,26,38,71
FC Salzburg,678,2,19,9,8,61,31,30,66
Vienna,678,3,19,6,11,65,45,20,63
SC Rheindorf,678,4,16,9,11,51,58,-7,57
Rapid Vienna,678,5,13,12,11,60,45,15,51
RZ Pellets W,678,6,13,7,16,47,56,-9,46
Admira Wacke,678,7,11,7,18,38,69,-31,40
SV Josko Rie,678,8,9,10,17,31,46,-15,37
Mattersburg,678,9,8,12,16,37,51,-14,36
St. Pölten,678,10,6,10,20,41,68,-27,28
SK Sturm Gra,679,1,23,6,7,64,28,36,75
SC Rheindorf,679,2,20,6,10,54,35,19,66
Rapid Vienna,679,3,18,8,10,54,33,21,62
Vienna,679,4,17,6,13,55,49,6,57
FC Salzburg,679,5,17,5,14,58,40,18,56
RZ Pellets W,679,6,11,9,16,44,58,-14,42
Admira Wacke,679,7,12,5,19,30,51,-21,41
SV Josko Rie,679,8,11,7,18,34,50,-16,40
Mattersburg,679,9,9,10,17,32,47,-15,37
St. Pölten,679,10,6,10,20,33,67,-34,28
SC Rheindorf,680,1,23,6,7,62,30,32,75
FC Salzburg,680,2,22,5,9,62,27,35,71
SK Sturm Gra,680,3,19,6,11,59,38,21,63
Vienna,680,4,18,5,13,59,57,2,59
Rapid Vienna,680,5,15,9,12,54,40,14,54
Admira Wacke,680,6,13,6,17,34,58,-24,45
RZ Pellets W,680,7,10,7,19,41,59,-18,37
Mattersburg,680,8,9,9,18,40,52,-12,36
St. Pölten,680,9,7,14,15,40,61,-21,35
SV Josko Rie,680,10,7,7,22,24,53,-29,28
SC Rheindorf,681,1,21,7,8,60,41,19,70
SK Sturm Gra,681,2,18,8,10,55,34,21,62
FC Salzburg,681,3,17,10,9,58,34,24,61
Vienna,681,4,18,5,13,62,57,5,59
Rapid Vienna,681,5,13,12,11,52,31,21,51
Admira Wacke,681,6,11,10,15,41,54,-13,43
RZ Pellets W,681,7,11,9,16,40,55,-15,42
St. Pölten,681,8,10,10,16,44,65,-21,40
Mattersburg,681,9,8,11,17,37,58,-21,35
SV Josko Rie,681,10,9,6,21,32,52,-20,33
FC Salzburg,682,1,22,8,6,61,27,34,74
SK Sturm Gra,682,2,22,5,9,62,35,27,71
Vienna,682,3,21,5,10,65,43,22,68
SC Rheindorf,682,4,20,8,8,53,39,14,68
RZ Pellets W,682,5,11,8,17,40,52,-12,41
Mattersburg,682,6,10,10,16,34,50,-16,40
Admira Wacke,682,7,12,4,20,35,60,-25,40
Rapid Vienna,682,8,9,11,16,45,43,2,38
SV Josko Rie,682,9,9,6,21,31,52,-21,33
St. Pölten,682,10,7,9,20,44,69,-25,30
FC Salzburg,683,1,22,8,6,71,33,38,74
SC Rheindorf,683,2,20,6,10,54,42,12,66
SK Sturm Gra,683,3,19,8,9,58,31,27,65
Vienna,683,4,20,4,12,56,45,11,64
Rapid Vienna,683,5,12,11,13,53,43,10,47
RZ Pellets W,683,6,13,5,18,41,57,-16,44
Mattersburg,683,7,11,6,19,36,55,-19,39
St. Pölten,683,8,10,7,19,46,63,-17,37
SV Josko Rie,683,9,10,6,20,37,55,-18,36
Admira Wacke,683,10,10,5,21,31,59,-28,35
FC Salzburg,684,1,21,6,9,56,27,29,69
SC Rheindorf,684,2,21,5,10,56,42,14,68
Vienna,684,3,19,4,13,57,47,10,61
SK Sturm Gra,684,4,18,5,13,56,33,23,59
Rapid Vienna,684,5,12,12,12,56,46,10,48
Admira Wacke,684,6,14,5,17,35,53,-18,47
Mattersburg,684,7,13,6,17,40,49,-9,45
RZ Pellets W,684,8,12,7,17,53,64,-11,43
SV Josko Rie,684,9,10,6,20,29,50,-21,36
St. Pölten,684,10,9,6,21,42,69,-27,33
FC Salzburg,685,1,19,9,8,71,34,37,66
SK Sturm Gra,685,2,20,6,10,57,31,26,66
SC Rheindorf,685,3,19,9,8,57,41,16,66
Vienna,685,4,20,4,12,61,50,11,64
Rapid Vienna,685,5,13,10,13,54,41,13,49
Admira Wacke,685,6,13,6,17,43,65,-22,45
Mattersburg,685,7,10,10,16,43,55,-12,40
RZ Pellets W,685,8,11,7,18,42,62,-20,40
SV Josko Rie,685,9,11,4,21,41,56,-15,37
St. Pölten,685,10,8,7,21,48,82,-34,31
FC Salzburg,686,1,20,10,6,64,32,32,70
SC Rheindorf,686,2,21,6,9,58,41,17,69
Vienna,686,3,18,4,14,70,55,15,58
SK Sturm Gra,686,4,16,6,14,51,40,11,54
Rapid Vienna,686,5,12,14,10,54,38,16,50
RZ Pellets W,686,6,13,6,17,41,55,-14,45
Admira Wacke,686,7,13,6,17,38,58,-20,45
St. Pölten,686,8,9,12,15,38,53,-15,39
SV Josko Rie,686,9,9,9,18,35,52,-17,36
Mattersburg,686,10,9,7,20,36,61,-25,34
SK Sturm Gra,687,1,20,8,8,67,30,37,68
FC Salzburg,687,2,19,10,7,59,29,30,67
SC Rheindorf,687,3,17,9,10,50,39,11,60
Vienna,687,4,19,3,14,61,56,5,60
Rapid Vienna,687,5,15,8,13,53,40,13,53
RZ Pellets W,687,6,12,7,17,47,57,-10,43
Admira Wacke,687,7,11,10,15,35,57,-22,43
St. Pölten,687,8,10,12,14,42,54,-12,42
Mattersburg,687,9,9,7,20,37,61,-24,34
SV Josko Rie,687,10,8,6,22,30,58,-28,30
SC Rheindorf,688,1,22,6,8,56,38,18,72
SK Sturm Gra,688,2,19,7,10,64,40,24,64
Vienna,688,3,19,7,10,60,48,12,64
FC Salzburg,688,4,19,6,11,58,35,23,63
Rapid Vienna,688,5,15,10,11,62,41,21,55
RZ Pellets W,688,6,14,7,15,50,49,1,49
Admira Wacke,688,7,11,5,20,35,68,-33,38
SV Josko Rie,688,8,11,4,21,34,51,-17,37
St. Pölten,688,9,8,11,17,46,64,-18,35
Mattersburg,688,10,6,9,21,35,66,-31,27
FC Salzburg,689,1,20,11,5,62,26,36,71
SC Rheindorf,689,2,20,10,6,53,32,21,70
SK Sturm Gra,689,3,18,7,11,62,38,24,61
Vienna,689,4,17,5,14,59,51,8,56
Rapid Vienna,689,5,12,12,12,53,42,11,48
SV Josko Rie,689,6,14,5,17,42,49,-7,47
RZ Pellets W,689,7,11,6,19,41,61,-20,39
Admira Wacke,689,8,9,11,16,36,56,-20,38
St. Pölten,689,9,8,11,17,39,62,-23,35
Mattersburg,689,10,7,10,19,33,63,-30,31
FC Salzburg,690,1,22,8,6,70,27,43,74
SC Rheindorf,690,2,21,5,10,62,43,19,68
SK Sturm Gra,690,3,21,4,11,64,35,29,67
Vienna,690,4,18,7,11,66,57,9,61
Rapid Vienna,690,5,11,12,13,45,41,4,45
Admira Wacke,690,6,12,7,17,35,56,-21,43
RZ Pellets W,690,7,11,9,16,41,56,-15,42
SV Josko Rie,690,8,11,6,19,35,53,-18,39
St. Pölten,690,9,8,9,19,40,69,-29,33
Mattersburg,690,10,7,9,20,42,63,-21,30
SK Sturm Gra,691,1,21,4,11,58,39,19,67
FC Salzburg,691,2,19,7,10,62,37,25,64
Vienna,691,3,19,6,11,66,48,18,63
SC Rheindorf,691,4,18,8,10,54,43,11,62
Rapid Vienna,691,5,14,8,14,55,42,13,50
RZ Pellets W,691,6,14,8,14,47,52,-5,50
Admira Wacke,691,7,13,5,18,39,56,-17,44
SV Josko Rie,691,8,10,7,19,34,49,-15,37
Mattersburg,691,9,9,8,19,30,55,-25,35
St. Pölten,691,10,9,7,20,42,66,-24,34
FC Salzburg,692,1,23,8,5,69,27,42,77
SC Rheindorf,692,2,19,9,8,54,38,16,66
Vienna,692,3,19,3,14,63,52,11,60
SK Sturm Gra,692,4,18,5,13,61,40,21,59
Rapid Vienna,692,5,15,9,12,53,35,18,54
SV Josko Rie,692,6,13,6,17,32,45,-13,45
RZ Pellets W,692,7,12,7,17,40,58,-18,43
Admira Wacke,692,8,12,5,19,33,58,-25,41
St. Pölten,692,9,8,9,19,38,67,-29,33
Mattersburg,692,10,7,7,22,34,57,-23,28
FC Salzburg,693,1,23,6,7,76,32,44,75
SK Sturm Gra,693,2,22,4,10,61,35,26,70
SC Rheindorf,693,3,21,4,11,55,46,9,67
Vienna,693,4,17,4,15,59,55,4,55
Rapid Vienna,693,5,15,9,12,61,41,20,54
Admira Wacke,693,6,14,5,17,41,59,-18,47
RZ Pellets W,693,7,12,7,17,42,55,-13,43
SV Josko Rie,693,8,11,4,21,38,60,-22,37
Mattersburg,693,9,7,10,19,37,61,-24,31
St. Pölten,693,10,6,11,19,43,69,-26,29
FC Salzburg,694,1,23,6,7,70,34,36,75
SC Rheindorf,694,2,21,6,9,59,44,15,69
SK Sturm Gra,694,3,21,5,10,66,34,32,68
Vienna,694,4,17,4,15,65,60,5,55
RZ Pellets W,694,5,15,5,16,44,48,-4,50
Rapid Vienna,694,6,13,10,13,50,43,7,49
Admira Wacke,694,7,12,6,18,38,60,-22,42
Mattersburg,694,8,8,10,18,38,55,-17,34
St. Pölten,694,9,8,9,19,40,63,-23,33
SV Josko Rie,694,10,9,5,22,36,65,-29,32
FC Salzburg,695,1,22,5,9,70,30,40,71
SC Rheindorf,695,2,21,5,10,58,42,16,68
SK Sturm Gra,695,3,18,7,11,54,38,16,61
Rapid Vienna,695,4,15,10,11,59,37,22,55
Vienna,695,5,17,4,15,58,55,3,55
St. Pölten,695,6,15,8,13,48,54,-6,53
RZ Pellets W,695,7,12,7,17,46,57,-11,43
SV Josko Rie,695,8,10,6,20,35,61,-26,36
Admira Wacke,695,9,9,7,20,40,72,-32,34
Mattersburg,695,10,8,7,21,35,57,-22,31
FC Salzburg,696,1,23,7,6,68,26,42,76
SC Rheindorf,696,2,22,7,7,56,36,20,73
Vienna,696,3,18,7,11,61,50,11,61
Rapid Vienna,696,4,16,9,11,52,33,19,57
SK Sturm Gra,696,5,16,6,14,51,36,15,54
RZ Pellets W,696,6,12,8,16,36,49,-13,44
Admira Wacke,696,7,12,6,18,42,59,-17,42
Mattersburg,696,8,8,10,18,33,54,-21,34
SV Josko Rie,696,9,9,5,22,28,52,-24,32
St. Pölten,696,10,6,11,19,31,63,-32,29
SK Sturm Gra,697,1,22,6,8,57,25,32,72
SC Rheindorf,697,2,21,6,9,55,37,18,69
Vienna,697,3,21,5,10,65,46,19,68
FC Salzburg,697,4,19,8,9,59,34,25,65
Admira Wacke,697,5,13,5,18,43,64,-21,44
Rapid Vienna,697,6,10,12,14,51,46,5,42
St. Pölten,697,7,10,10,16,42,61,-19,40
RZ Pellets W,697,8,10,8,18,45,56,-11,38
Mattersburg,697,9,7,11,18,31,54,-23,32
SV Josko Rie,697,10,9,5,22,34,59,-25,32
FC Salzburg,698,1,23,6,7,77,33,44,75
SC Rheindorf,698,2,19,9,8,57,42,15,66
SK Sturm Gra,698,3,18,8,10,59,35,24,62
Vienna,698,4,19,4,13,59,52,7,61
Rapid Vienna,698,5,15,11,10,59,40,19,56
Admira Wacke,698,6,12,7,17,42,59,-17,43
RZ Pellets W,698,7,11,8,17,42,51,-9,41
St. Pölten,698,8,10,8,18,39,65,-26,38
Mattersburg,698,9,7,10,19,32,56,-24,31
SV Josko Rie,698,10,8,5,23,28,61,-33,29
FC Salzburg,699,1,24,7,5,75,29,46,79
SC Rheindorf,699,2,19,10,7,59,35,24,67
SK Sturm Gra,699,3,17,8,11,60,40,20,59
Vienna,699,4,17,6,13,63,54,9,57
Rapid Vienna,699,5,14,11,11,58,44,14,53
SV Josko Rie,699,6,10,9,17,32,46,-14,39
RZ Pellets W,699,7,10,9,17,37,56,-19,39
Mattersburg,699,8,9,11,16,35,50,-15,38
Admira Wacke,699,9,11,4,21,29,61,-32,37
St. Pölten,699,10,7,9,20,34,67,-33,30
FC Salzburg,700,1,22,7,7,68,28,40,73
Vienna,700,2,21,6,9,73,52,21,69
SK Sturm Gra,700,3,19,7,10,65,33,32,64
SC Rheindorf,700,4,19,7,10,56,50,6,64
Rapid Vienna,700,5,14,10,12,59,42,17,52
RZ Pellets W,700,6,11,10,15,49,60,-11,43
Admira Wacke,700,7,11,7,18,35,61,-26,40
St. Pölten,700,8,7,12,17,46,72,-26,33
Mattersburg,700,9,8,8,20,38,64,-26,32
SV Josko Rie,700,10,9,4,23,29,56,-27,31
SK Sturm Gra,701,1,21,6,9,64,34,30,69
SC Rheindorf,701,2,20,9,7,60,39,21,69
FC Salzburg,701,3,20,7,9,61,33,28,67
Vienna,701,4,19,5,12,68,61,7,62
Rapid Vienna,701,5,15,9,12,56,39,17,54
St. Pölten,701,6,11,8,17,52,66,-14,41
Admira Wacke,701,7,11,7,18,33,54,-21,40
RZ Pellets W,701,8,8,11,17,35,53,-18,35
SV Josko Rie,701,9,10,5,21,34,58,-24,35
Mattersburg,701,10,8,7,21,34,60,-26,31
FC Salzburg,702,1,21,7,8,62,29,33,70
Vienna,702,2,20,6,10,73,52,21,66
SC Rheindorf,702,3,17,8,11,49,47,2,59
SK Sturm Gra,702,4,17,7,12,49,35,14,58
Admira Wacke,702,5,13,6,17,34,52,-18,45
Rapid Vienna,702,6,11,11,14,48,40,8,44
RZ Pellets W,702,7,13,5,18,44,54,-10,44
Mattersburg,702,8,12,8,16,45,56,-11,44
SV Josko Rie,702,9,13,3,20,41,52,-11,42
St. Pölten,702,10,8,9,19,40,68,-28,33
FC Salzburg,703,1,23,6,7,66,31,35,75
SC Rheindorf,703,2,22,6,8,59,38,21,72
SK Sturm Gra,703,3,19,6,11,56,34,22,63
Vienna,703,4,19,3,14,59,53,6,60
Rapid Vienna,703,5,14,10,12,51,38,13,52
Admira Wacke,703,6,14,6,16,41,57,-16,48
RZ Pellets W,703,7,13,6,17,42,50,-8,45
Mattersburg,703,8,10,7,19,38,54,-16,37
SV Josko Rie,703,9,10,5,21,34,55,-21,35
St. Pölten,703,10,5,7,24,34,70,-36,22
SC Rheindorf,704,1,22,7,7,62,39,23,73
FC Salzburg,704,2,19,8,9,67,33,34,65
Vienna,704,3,20,5,11,63,54,9,65
SK Sturm Gra,704,4,19,5,12,64,36,28,62
Rapid Vienna,704,5,13,11,12,53,40,13,50
RZ Pellets W,704,6,13,6,17,43,53,-10,45
Admira Wacke,704,7,11,7,18,32,63,-31,40
Mattersburg,704,8,9,9,18,44,61,-17,36
SV Josko Rie,704,9,10,5,21,38,57,-19,35
St. Pölten,704,10,8,9,19,37,67,-30,33
SK Sturm Gra,705,1,22,5,9,65,31,34,71
FC Salzburg,705,2,20,9,7,67,30,37,69
Vienna,705,3,20,4,12,65,51,14,64
SC Rheindorf,705,4,17,10,9,58,43,15,61
RZ Pellets W,705,5,15,7,14,49,61,-12,52
Rapid Vienna,705,6,13,10,13,56,41,15,49
Mattersburg,705,7,10,9,17,38,56,-18,39
SV Josko Rie,705,8,9,10,17,32,51,-19,37
St. Pölten,705,9,6,11,19,34,66,-32,29
Admira Wacke,705,10,8,5,23,35,69,-34,29
FC Salzburg,706,1,21,6,9,67,33,34,69
SK Sturm Gra,706,2,19,9,8,62,26,36,66
Vienna,706,3,20,5,11,64,47,17,65
SC Rheindorf,706,4,16,10,10,51,44,7,58
Rapid Vienna,706,5,12,14,10,55,44,11,50
RZ Pellets W,706,6,14,7,15,46,51,-5,49
SV Josko Rie,706,7,13,6,17,30,48,-18,45
Mattersburg,706,8,7,11,18,34,56,-22,32
St. Pölten,706,9,7,11,18,42,65,-23,32
Admira Wacke,706,10,8,7,21,30,67,-37,31
SC Rheindorf,707,1,20,9,7,57,41,16,69
SK Sturm Gra,707,2,20,8,8,66,34,32,68
Vienna,707,3,20,6,10,71,48,23,66
FC Salzburg,707,4,17,10,9,58,32,26,61
Rapid Vienna,707,5,15,11,10,55,39,16,56
RZ Pellets W,707,6,12,9,15,45,54,-9,45
Admira Wacke,707,7,12,7,17,44,57,-13,43
SV Josko Rie,707,8,10,8,18,33,54,-21,38
St. Pölten,707,9,5,11,20,36,76,-40,26
Mattersburg,707,10,5,9,22,35,65,-30,24
FC Salzburg,708,1,19,12,5,65,30,35,69
SC Rheindorf,708,2,19,9,8,54,38,16,66
SK Sturm Gra,708,3,20,5,11,58,32,26,65
Rapid Vienna,708,4,17,9,10,59,44,15,60
Vienna,708,5,15,6,15,57,56,1,51
RZ Pellets W,708,6,12,8,16,41,49,-8,44
St. Pölten,708,7,9,11,16,41,57,-16,38
Mattersburg,708,8,8,11,17,41,60,-19,35
Admira Wacke,708,9,9,8,19,34,62,-28,35
SV Josko Rie,708,10,9,7,20,36,58,-22,34
FC Salzburg,709,1,21,6,9,66,33,33,69
SK Sturm Gra,709,2,18,8,10,58,32,26,62
Rapid Vienna,709,3,17,9,10,57,36,21,60
Vienna,709,4,18,5,13,60,49,11,59
SC Rheindorf,709,5,16,7,13,44,48,-4,55
RZ Pellets W,709,6,15,8,13,51,52,-1,53
Admira Wacke,709,7,12,7,17,44,58,-14,43
SV Josko Rie,709,8,10,7,19,38,55,-17,37
Mattersburg,709,9,9,8,19,39,60,-21,35
St. Pölten,709,10,7,9,20,35,69,-34,30
SC Rheindorf,710,1,21,9,6,60,36,24,72
FC Salzburg,710,2,21,6,9,61,30,31,69
SK Sturm Gra,710,3,21,6,9,59,36,23,69
Vienna,710,4,18,5,13,58,51,7,59
Rapid Vienna,710,5,13,12,11,50,37,13,51
RZ Pellets W,710,6,13,5,18,47,59,-12,44
Admira Wacke,710,7,13,3,20,40,60,-20,42
Mattersburg,710,8,9,11,16,34,50,-16,38
SV Josko Rie,710,9,9,4,23,28,50,-22,31
St. Pölten,710,10,8,7,21,40,68,-28,31
FC Salzburg,711,1,19,11,6,65,29,36,68
Vienna,711,2,20,5,11,59,48,11,65
SC Rheindorf,711,3,17,8,11,52,43,9,59
SK Sturm Gra,711,4,16,7,13,58,40,18,55
Rapid Vienna,711,5,13,11,12,53,43,10,50
RZ Pellets W,711,6,13,8,15,41,48,-7,47
Admira Wacke,711,7,11,8,17,33,55,-22,41
SV Josko Rie,711,8,12,4,20,34,53,-19,40
Mattersburg,711,9,10,9,17,36,53,-17,39
St. Pölten,711,10,9,9,18,38,57,-19,36
FC Salzburg,712,1,20,8,8,63,32,31,68
SC Rheindorf,712,2,19,8,9,52,40,12,65
Rapid Vienna,712,3,18,9,9,68,33,35,63
Vienna,712,4,18,4,14,61,54,7,58
SK Sturm Gra,712,5,15,8,13,62,49,13,53
RZ Pellets W,712,6,13,9,14,53,58,-5,48
Admira Wacke,712,7,12,7,17,40,65,-25,43
SV Josko Rie,712,8,10,8,18,35,51,-16,38
St. Pölten,712,9,8,12,16,42,63,-21,36
Mattersburg,712,10,7,7,22,35,66,-31,28
FC Salzburg,713,1,20,8,8,66,33,33,68
SK Sturm Gra,713,2,21,5,10,55,32,23,68
SC Rheindorf,713,3,19,10,7,53,35,18,67
Rapid Vienna,713,4,15,8,13,49,38,11,53
Vienna,713,5,15,4,17,49,57,-8,49
RZ Pellets W,713,6,13,8,15,46,51,-5,47
SV Josko Rie,713,7,14,4,18,33,48,-15,46
Admira Wacke,713,8,11,7,18,36,56,-20,40
Mattersburg,713,9,8,9,19,38,55,-17,33
St. Pölten,713,10,8,9,19,37,57,-20,33
FC Salzburg,714,1,18,11,7,64,32,32,65
SK Sturm Gra,714,2,19,6,11,57,32,25,63
SC Rheindorf,714,3,18,8,10,56,41,15,62
Vienna,714,4,19,5,12,59,50,9,62
RZ Pellets W,714,5,13,7,16,45,57,-12,46
Rapid Vienna,714,6,12,9,15,56,51,5,45
Admira Wacke,714,7,11,8,17,35,51,-16,41
St. Pölten,714,8,11,8,17,42,64,-22,41
SV Josko Rie,714,9,11,7,18,38,54,-16,40
Mattersburg,714,10,10,7,19,43,63,-20,37
FC Salzburg,715,1,22,7,7,68,31,37,73
SC Rheindorf,715,2,19,10,7,53,42,11,67
SK Sturm Gra,715,3,20,6,10,66,34,32,66
Vienna,715,4,19,8,9,60,47,13,65
Rapid Vienna,715,5,13,13,10,53,39,14,52
RZ Pellets W,715,6,11,10,15,46,55,-9,43
SV Josko Rie,715,7,12,5,19,35,52,-17,41
Mattersburg,715,8,8,10,18,40,55,-15,34
St. Pölten,715,9,7,8,21,35,66,-31,29
Admira Wacke,715,10,8,5,23,31,66,-35,29
SK Sturm Gra,716,1,24,5,7,72,24,48,77
FC Salzburg,716,2,19,7,10,64,34,30,64
SC Rheindorf,716,3,20,4,12,54,43,11,64
Rapid Vienna,716,4,15,9,12,55,45,10,54
Vienna,716,5,15,4,17,56,57,-1,49
SV Josko Rie,716,6,15,4,17,39,50,-11,49
RZ Pellets W,716,7,11,9,16,43,63,-20,42
St. Pölten,716,8,11,6,19,46,64,-18,39
Admira Wacke,716,9,9,9,18,34,61,-27,36
Mattersburg,716,10,8,9,19,37,59,-22,33
FC Salzburg,717,1,23,5,8,65,31,34,74
SC Rheindorf,717,2,21,6,9,61,41,20,69
SK Sturm Gra,717,3,18,9,9,59,42,17,63
Rapid Vienna,717,4,16,11,9,66,45,21,59
Vienna,717,5,18,4,14,55,51,4,58
Admira Wacke,717,6,13,4,19,45,61,-16,43
RZ Pellets W,717,7,11,9,16,45,56,-11,42
Mattersburg,717,8,9,10,17,39,52,-13,37
St. Pölten,717,9,7,10,19,42,68,-26,31
SV Josko Rie,717,10,8,4,24,31,61,-30,28
SK Sturm Gra,718,1,24,4,8,67,33,34,76
FC Salzburg,718,2,21,7,8,65,34,31,70
SC Rheindorf,718,3,19,7,10,58,40,18,64
Rapid Vienna,718,4,14,9,13,51,41,10,51
Vienna,718,5,14,7,15,57,59,-2,49
RZ Pellets W,718,6,13,6,17,48,56,-8,45
SV Josko Rie,718,7,13,5,18,42,57,-15,44
St. Pölten,718,8,10,9,17,39,57,-18,39
Admira Wacke,718,9,10,7,19,38,64,-26,37
Mattersburg,718,10,9,5,22,39,63,-24,32
FC Salzburg,719,1,21,8,7,62,30,32,71
SC Rheindorf,719,2,20,8,8,58,38,20,68
Vienna,719,3,19,8,9,64,48,16,65
SK Sturm Gra,719,4,19,7,10,56,33,23,64
Rapid Vienna,719,5,12,10,14,44,40,4,46
RZ Pellets W,719,6,11,10,15,48,54,-6,43
Admira Wacke,719,7,10,8,18,35,60,-25,38
St. Pölten,719,8,8,10,18,43,64,-21,34
SV Josko Rie,719,9,8,10,18,36,58,-22,34
Mattersburg,719,10,8,9,19,40,61,-21,33
FC Salzburg,720,1,21,8,7,61,33,28,71
SK Sturm Gra,720,2,19,7,10,61,37,24,64
SC Rheindorf,720,3,18,9,9,53,42,11,63
Rapid Vienna,720,4,15,9,12,59,40,19,54
Vienna,720,5,16,5,15,58,63,-5,53
RZ Pellets W,720,6,12,7,17,49,58,-9,43
SV Josko Rie,720,7,11,7,18,40,54,-14,40
St. Pölten,720,8,9,11,16,39,59,-20,38
Admira Wacke,720,9,10,8,18,37,59,-22,38
Mattersburg,720,10,10,7,19,42,54,-12,37
SK Sturm Gra,721,1,20,8,8,65,35,30,68
FC Salzburg,721,2,19,10,7,64,30,34,67
SC Rheindorf,721,3,19,7,10,53,51,2,64
Vienna,721,4,15,6,15,65,61,4,51
RZ Pellets W,721,5,15,6,15,48,50,-2,51
Rapid Vienna,721,6,12,13,11,53,41,12,49
Admira Wacke,721,7,12,5,19,32,56,-24,41
SV Josko Rie,721,8,11,6,19,36,53,-17,39
St. Pölten,721,9,9,11,16,43,61,-18,38
Mattersburg,721,10,6,12,18,33,54,-21,30
FC Salzburg,722,1,21,9,6,66,30,36,72
Vienna,722,2,21,5,10,73,47,26,68
SC Rheindorf,722,3,20,8,8,63,37,26,68
SK Sturm Gra,722,4,20,7,9,57,33,24,67
Rapid Vienna,722,5,10,15,11,52,43,9,45
St. Pölten,722,6,11,8,17,44,67,-23,41
SV Josko Rie,722,7,11,4,21,33,57,-24,37
Admira Wacke,722,8,9,8,19,40,64,-24,35
RZ Pellets W,722,9,9,8,19,41,66,-25,35
Mattersburg,722,10,6,12,18,30,55,-25,30
SC Rheindorf,723,1,21,8,7,59,38,21,71
Vienna,723,2,22,3,11,72,51,21,69
FC Salzburg,723,3,20,8,8,64,35,29,68
SK Sturm Gra,723,4,20,7,9,62,33,29,67
Rapid Vienna,723,5,14,9,13,55,46,9,51
RZ Pellets W,723,6,12,7,17,44,60,-16,43
SV Josko Rie,723,7,11,6,19,40,60,-20,39
Admira Wacke,723,8,10,9,17,38,59,-21,39
St. Pölten,723,9,8,9,19,50,72,-22,33
Mattersburg,723,10,5,8,23,32,62,-30,23
FC Salzburg,724,1,19,9,8,66,36,30,66
SC Rheindorf,724,2,19,9,8,59,43,16,66
SK Sturm Gra,724,3,18,7,11,56,33,23,61
Vienna,724,4,19,3,14,59,56,3,60
Rapid Vienna,724,5,14,12,10,50,36,14,54
RZ Pellets W,724,6,11,10,15,48,58,-10,43
St. Pölten,724,7,10,11,15,40,53,-13,41
SV Josko Rie,724,8,11,4,21,37,54,-17,37
Admira Wacke,724,9,10,7,19,36,60,-24,37
Mattersburg,724,10,9,8,19,39,61,-22,35
FC Salzburg,725,1,22,7,7,66,30,36,73
SC Rheindorf,725,2,19,11,6,62,41,21,68
Vienna,725,3,18,6,12,61,55,6,60
SK Sturm Gra,725,4,17,8,11,59,33,26,59
Rapid Vienna,725,5,13,14,9,54,41,13,53
RZ Pellets W,725,6,14,6,16,43,56,-13,48
Admira Wacke,725,7,12,8,16,41,55,-14,44
SV Josko Rie,725,8,9,7,20,34,55,-21,34
St. Pölten,725,9,7,9,20,41,71,-30,30
Mattersburg,725,10,6,10,20,31,55,-24,28
FC Salzburg,726,1,22,7,7,73,29,44,73
SK Sturm Gra,726,2,21,5,10,57,34,23,68
SC Rheindorf,726,3,19,8,9,59,46,13,65
Vienna,726,4,19,6,11,65,46,19,63
Rapid Vienna,726,5,14,12,10,59,40,19,54
SV Josko Rie,726,6,11,7,18,41,53,-12,40
RZ Pellets W,726,7,10,9,17,44,62,-18,39
Admira Wacke,726,8,11,5,20,32,60,-28,38
Mattersburg,726,9,9,8,19,36,62,-26,35
St. Pölten,726,10,6,9,21,38,72,-34,27
Vienna,727,1,21,6,9,62,43,19,69
FC Salzburg,727,2,19,10,7,63,29,34,67
SK Sturm Gra,727,3,18,7,11,61,35,26,61
SC Rheindorf,727,4,17,10,9,47,37,10,61
RZ Pellets W,727,5,14,6,16,42,52,-10,48
Rapid Vienna,727,6,11,11,14,49,44,5,44
SV Josko Rie,727,7,12,5,19,36,51,-15,41
St. Pölten,727,8,10,10,16,41,59,-18,40
Admira Wacke,727,9,9,9,18,35,59,-24,36
Mattersburg,727,10,8,8,20,32,59,-27,32
SC Rheindorf,728,1,20,8,8,54,36,18,68
FC Salzburg,728,2,18,10,8,62,32,30,64
Vienna,728,3,18,7,11,64,50,14,61
SK Sturm Gra,728,4,17,7,12,54,34,20,58
Admira Wacke,728,5,14,8,14,42,52,-10,50
Rapid Vienna,728,6,13,10,13,51,46,5,49
SV Josko Rie,728,7,13,5,18,36,46,-10,44
St. Pölten,728,8,11,9,16,43,57,-14,42
RZ Pellets W,728,9,9,6,21,41,69,-28,33
Mattersburg,728,10,8,8,20,32,57,-25,32
FC Salzburg,729,1,22,8,6,64,31,33,74
SC Rheindorf,729,2,19,10,7,57,37,20,67
SK Sturm Gra,729,3,16,10,10,52,34,18,58
Vienna,729,4,16,3,17,53,53,0,51
Rapid Vienna,729,5,10,17,9,48,38,10,47
RZ Pellets W,729,6,12,10,14,48,54,-6,46
Mattersburg,729,7,10,11,15,43,55,-12,41
Admira Wacke,729,8,9,13,14,37,57,-20,40
St. Pölten,729,9,7,12,17,41,64,-23,33
SV Josko Rie,729,10,8,8,20,41,61,-20,32
SK Sturm Gra,730,1,19,7,10,59,35,24,64
FC Salzburg,730,2,19,5,12,70,40,30,62
Rapid Vienna,730,3,16,10,10,64,37,27,58
SC Rheindorf,730,4,17,6,13,51,49,2,57
Vienna,730,5,17,3,16,66,72,-6,54
RZ Pellets W,730,6,15,7,14,52,52,0,52
Admira Wacke,730,7,13,4,19,38,58,-20,43
St. Pölten,730,8,11,9,16,40,59,-19,42
Mattersburg,730,9,10,10,16,40,54,-14,40
SV Josko Rie,730,10,10,5,21,34,58,-24,35
FC Salzburg,731,1,22,8,6,81,36,45,74
SC Rheindorf,731,2,20,9,7,58,41,17,69
SK Sturm Gra,731,3,18,10,8,62,36,26,64
Vienna,731,4,15,8,13,56,53,3,53
Rapid Vienna,731,5,13,10,13,57,51,6,49
RZ Pellets W,731,6,13,6,17,53,57,-4,45
Admira Wacke,731,7,12,6,18,34,65,-31,42
SV Josko Rie,731,8,11,6,19,36,54,-18,39
Mattersburg,731,9,10,8,18,36,56,-20,38
St. Pölten,731,10,6,9,21,37,61,-24,27
SK Sturm Gra,732,1,21,6,9,62,31,31,69
FC Salzburg,732,2,20,7,9,63,32,31,67
Vienna,732,3,19,7,10,63,48,15,64
SC Rheindorf,732,4,19,7,10,54,45,9,64
Rapid Vienna,732,5,18,9,9,64,40,24,63
RZ Pellets W,732,6,14,7,15,50,58,-8,49
Admira Wacke,732,7,11,6,19,37,58,-21,39
Mattersburg,732,8,8,8,20,35,60,-25,32
SV Josko Rie,732,9,9,3,24,36,64,-28,30
St. Pölten,732,10,7,8,21,43,71,-28,29
FC Salzburg,733,1,18,9,9,62,33,29,63
SK Sturm Gra,733,2,18,9,9,52,31,21,63
SC Rheindorf,733,3,18,8,10,54,44,10,62
Vienna,733,4,17,6,13,63,53,10,57
RZ Pellets W,733,5,16,7,13,50,50,0,55
Rapid Vienna,733,6,13,11,12,52,41,11,50
SV Josko Rie,733,7,12,5,19,42,54,-12,41
St. Pölten,733,8,9,12,15,42,59,-17,39
Admira Wacke,733,9,9,7,20,33,64,-31,34
Mattersburg,733,10,7,12,17,39,60,-21,33
FC Salzburg,734,1,22,8,6,63,26,37,74
SC Rheindorf,734,2,22,5,9,60,35,25,71
SK Sturm Gra,734,3,21,4,11,59,37,22,67
Vienna,734,4,19,2,15,62,49,13,59
Rapid Vienna,734,5,14,9,13,56,43,13,51
RZ Pellets W,734,6,12,6,18,42,60,-18,42
SV Josko Rie,734,7,12,4,20,40,52,-12,40
St. Pölten,734,8,9,10,17,40,65,-25,37
Admira Wacke,734,9,8,10,18,35,65,-30,34
Mattersburg,734,10,8,8,20,35,60,-25,32
FC Salzburg,735,1,23,4,9,68,37,31,73
Vienna,735,2,20,4,12,58,49,9,64
SC Rheindorf,735,3,18,9,9,62,43,19,63
Rapid Vienna,735,4,16,10,10,58,40,18,58
SK Sturm Gra,735,5,16,7,13,54,33,21,55
RZ Pellets W,735,6,16,6,14,47,50,-3,54
Admira Wacke,735,7,14,6,16,42,54,-12,48
SV Josko Rie,735,8,10,5,21,36,61,-25,35
St. Pölten,735,9,7,9,20,43,72,-29,30
Mattersburg,735,10,7,6,23,34,63,-29,27
FC Salzburg,736,1,24,5,7,76,33,43,77
SC Rheindorf,736,2,19,7,10,52,43,9,64
Vienna,736,3,19,6,11,63,53,10,63
SK Sturm Gra,736,4,19,5,12,54,34,20,62
Rapid Vienna,736,5,15,10,11,56,39,17,55
RZ Pellets W,736,6,15,6,15,54,58,-4,51
St. Pölten,736,7,10,9,17,50,64,-14,39
SV Josko Rie,736,8,9,6,21,30,61,-31,33
Mattersburg,736,9,8,8,20,39,57,-18,32
Admira Wacke,736,10,8,6,22,32,64,-32,30
FC Salzburg,737,1,25,7,4,76,31,45,82
SC Rheindorf,737,2,20,10,6,56,34,22,70
SK Sturm Gra,737,3,18,7,11,57,38,19,61
Rapid Vienna,737,4,14,12,10,62,41,21,54
Vienna,737,5,16,6,14,55,53,2,54
SV Josko Rie,737,6,12,6,18,34,50,-16,42
RZ Pellets W,737,7,9,10,17,40,62,-22,37
Admira Wacke,737,8,10,6,20,39,65,-26,36
St. Pölten,737,9,9,7,20,41,64,-23,34
Mattersburg,737,10,7,9,20,35,57,-22,30
FC Salzburg,738,1,19,11,6,59,27,32,68
SC Rheindorf,738,2,19,8,9,53,38,15,65
SK Sturm Gra,738,3,19,7,10,57,35,22,64
Vienna,738,4,17,7,12,60,49,11,58
Rapid Vienna,738,5,16,9,11,55,39,16,57
RZ Pellets W,738,6,12,10,14,44,51,-7,46
Admira Wacke,738,7,11,8,17,31,54,-23,41
SV Josko Rie,738,8,10,5,21,33,53,-20,35
St. Pölten,738,9,9,7,20,42,66,-24,34
Mattersburg,738,10,8,8,20,33,55,-22,32
FC Salzburg,739,1,21,8,7,65,33,32,71
Vienna,739,2,21,6,9,73,55,18,69
SK Sturm Gra,739,3,21,4,11,61,32,29,67
SC Rheindorf,739,4,19,7,10,63,52,11,64
Rapid Vienna,739,5,15,8,13,63,42,21,53
Admira Wacke,739,6,12,5,19,36,61,-25,41
Mattersburg,739,7,9,10,17,40,59,-19,37
RZ Pellets W,739,8,9,9,18,46,65,-19,36
St. Pölten,739,9,8,9,19,39,63,-24,33
SV Josko Rie,739,10,9,6,21,33,57,-24,33
SC Rheindorf,740,1,22,5,9,67,38,29,71
FC Salzburg,740,2,20,7,9,64,41,23,67
SK Sturm Gra,740,3,19,7,10,59,35,24,64
Vienna,740,4,19,6,11,70,56,14,63
Rapid Vienna,740,5,14,10,12,54,40,14,52
RZ Pellets W,740,6,12,8,16,44,60,-16,44
Admira Wacke,740,7,11,6,19,36,58,-22,39
SV Josko Rie,740,8,10,7,19,33,54,-21,37
St. Pölten,740,9,9,8,19,39,64,-25,35
Mattersburg,740,10,8,8,20,42,62,-20,32
SK Sturm Gra,741,1,20,9,7,57,28,29,69
FC Salzburg,741,2,20,7,9,58,30,28,67
SC Rheindorf,741,3,19,6,11,52,41,11,63
Vienna,741,4,17,6,13,57,55,2,57
Rapid Vienna,741,5,13,10,13,53,43,10,49
RZ Pellets W,741,6,13,7,16,47,50,-3,46
Admira Wacke,741,7,13,7,16,39,52,-13,46
St. Pölten,741,8,11,7,18,46,67,-21,40
SV Josko Rie,741,9,11,5,20,36,53,-17,38
Mattersburg,741,10,6,10,20,38,64,-26,28
FC Salzburg,742,1,21,10,5,70,32,38,73
Vienna,742,2,19,7,10,63,42,21,64
SC Rheindorf,742,3,19,6,11,52,40,12,63
SK Sturm Gra,742,4,17,5,14,52,37,15,56
Rapid Vienna,742,5,14,10,12,58,44,14,52
SV Josko Rie,742,6,15,4,17,42,54,-12,49
RZ Pellets W,742,7,12,8,16,40,57,-17,44
St. Pölten,742,8,8,10,18,38,58,-20,34
Admira Wacke,742,9,9,7,20,36,65,-29,34
Mattersburg,742,10,7,11,18,36,58,-22,32
SC Rheindorf,743,1,22,7,7,55,36,19,73
FC Salzburg,743,2,21,7,8,58,28,30,70
Vienna,743,3,19,6,11,62,46,16,63
SK Sturm Gra,743,4,18,6,12,55,38,17,60
Rapid Vienna,743,5,15,11,10,59,36,23,56
RZ Pellets W,743,6,12,7,17,48,64,-16,43
SV Josko Rie,743,7,11,5,20,37,51,-14,38
St. Pölten,743,8,9,9,18,40,65,-25,36
Mattersburg,743,9,7,11,18,34,55,-21,32
Admira Wacke,743,10,9,5,22,34,63,-29,32
SC Rheindorf,744,1,23,8,5,60,33,27,77
FC Salzburg,744,2,19,8,9,71,41,30,65
Rapid Vienna,744,3,16,11,9,64,40,24,59
SK Sturm Gra,744,4,17,7,12,51,39,12,58
Vienna,744,5,17,4,15,68,62,6,55
RZ Pellets W,744,6,15,8,13,44,44,0,53
SV Josko Rie,744,7,11,7,18,32,51,-19,40
Admira Wacke,744,8,9,8,19,35,62,-27,35
Mattersburg,744,9,7,9,20,36,65,-29,30
St. Pölten,744,10,7,8,21,41,65,-24,29
SK Sturm Gra,745,1,22,5,9,59,32,27,71
FC Salzburg,745,2,20,8,8,60,29,31,68
SC Rheindorf,745,3,16,12,8,54,45,9,60
Vienna,745,4,17,8,11,67,57,10,59
Rapid Vienna,745,5,15,9,12,54,42,12,54
RZ Pellets W,745,6,14,5,17,54,59,-5,47
Admira Wacke,745,7,12,5,19,39,56,-17,41
SV Josko Rie,745,8,9,8,19,29,50,-21,35
Mattersburg,745,9,8,10,18,36,60,-24,34
St. Pölten,745,10,7,10,19,42,64,-22,31
SC Rheindorf,746,1,18,11,7,58,48,10,65
FC Salzburg,746,2,19,7,10,61,31,30,64
Rapid Vienna,746,3,15,12,9,55,37,18,57
Vienna,746,4,17,6,13,60,50,10,57
SK Sturm Gra,746,5,15,10,11,50,37,13,55
RZ Pellets W,746,6,12,8,16,39,50,-11,44
St. Pölten,746,7,11,9,16,46,55,-9,42
Admira Wacke,746,8,10,12,14,38,58,-20,42
Mattersburg,746,9,8,10,18,33,52,-19,34
SV Josko Rie,746,10,9,7,20,29,51,-22,34
FC Salzburg,747,1,24,6,6,70,28,42,78
Vienna,747,2,22,4,10,67,49,18,70
SC Rheindorf,747,3,18,7,11,46,37,9,61
SK Sturm Gra,747,4,18,5,13,60,35,25,59
Rapid Vienna,747,5,16,9,11,60,39,21,57
RZ Pellets W,747,6,12,7,17,46,61,-15,43
Mattersburg,747,7,11,8,17,41,58,-17,41
SV Josko Rie,747,8,11,6,19,36,50,-14,39
Admira Wacke,747,9,8,7,21,35,70,-35,31
St. Pölten,747,10,6,9,21,34,68,-34,27
FC Salzburg,748,1,19,9,8,63,33,30,66
SK Sturm Gra,748,2,20,5,11,58,33,25,65
Vienna,748,3,20,5,11,58,45,13,65
SC Rheindorf,748,4,18,6,12,48,47,1,60
Rapid Vienna,748,5,16,10,10,61,36,25,58
Admira Wacke,748,6,13,6,17,30,54,-24,45
RZ Pellets W,748,7,10,10,16,41,52,-11,40
Mattersburg,748,8,9,10,17,36,48,-12,37
St. Pölten,748,9,9,10,17,41,61,-20,37
SV Josko Rie,748,10,9,3,24,34,61,-27,30
SC Rheindorf,749,1,23,7,6,64,36,28,76
FC Salzburg,749,2,21,8,7,62,29,33,71
SK Sturm Gra,749,3,20,6,10,59,33,26,66
RZ Pellets W,749,4,17,5,14,51,46,5,56
Rapid Vienna,749,5,15,8,13,57,40,17,53
Vienna,749,6,15,3,18,50,53,-3,48
SV Josko Rie,749,7,11,4,21,34,58,-24,37
Admira Wacke,749,8,11,3,22,30,62,-32,36
Mattersburg,749,9,8,9,19,40,56,-16,33
St. Pölten,749,10,8,9,19,39,73,-34,33
FC Salzburg,750,1,21,6,9,66,32,34,69
SC Rheindorf,750,2,20,6,10,62,41,21,66
Vienna,750,3,20,3,13,73,58,15,63
SK Sturm Gra,750,4,18,8,10,57,35,22,62
Rapid Vienna,750,5,13,10,13,52,39,13,49
Admira Wacke,750,6,12,7,17,42,64,-22,43
St. Pölten,750,7,11,9,16,45,62,-17,42
SV Josko Rie,750,8,13,3,20,42,61,-19,42
RZ Pellets W,750,9,11,5,20,40,61,-21,38
Mattersburg,750,10,9,7,20,35,61,-26,34
SC Rheindorf,751,1,19,11,6,56,39,17,68
FC Salzburg,751,2,19,10,7,55,25,30,67
Vienna,751,3,20,5,11,64,48,16,65
SK Sturm Gra,751,4,16,9,11,56,40,16,57
Rapid Vienna,751,5,12,11,13,59,49,10,47
Admira Wacke,751,6,13,6,17,46,61,-15,45
RZ Pellets W,751,7,12,8,16,45,57,-12,44
Mattersburg,751,8,11,8,17,49,56,-7,41
SV Josko Rie,751,9,10,5,21,34,51,-17,35
St. Pölten,751,10,8,7,21,38,76,-38,31
FC Salzburg,752,1,21,7,8,69,26,43,70
SC Rheindorf,752,2,20,8,8,56,43,13,68
SK Sturm Gra,752,3,20,4,12,64,37,27,64
Vienna,752,4,18,5,13,66,55,11,59
Rapid Vienna,752,5,13,12,11,49,36,13,51
RZ Pellets W,752,6,13,10,13,48,54,-6,49
SV Josko Rie,752,7,11,8,17,37,50,-13,41
St. Pölten,752,8,9,9,18,34,61,-27,36
Admira Wacke,752,9,8,7,21,29,64,-35,31
Mattersburg,752,10,6,12,18,34,60,-26,30
FC Salzburg,753,1,19,9,8,66,36,30,66
Vienna,753,2,20,4,12,66,46,20,64
Rapid Vienna,753,3,17,9,10,65,37,28,60
SK Sturm Gra,753,4,18,6,12,54,37,17,60
SC Rheindorf,753,5,17,9,10,52,44,8,60
RZ Pellets W,753,6,13,8,15,42,48,-6,47
SV Josko Rie,753,7,11,5,20,40,60,-20,38
St. Pölten,753,8,10,7,19,40,65,-25,37
Admira Wacke,753,9,9,9,18,39,65,-26,36
Mattersburg,753,10,10,6,20,38,64,-26,36
FC Salzburg,754,1,22,8,6,75,32,43,74
SC Rheindorf,754,2,18,10,8,62,47,15,64
SK Sturm Gra,754,3,18,8,10,58,40,18,62
Vienna,754,4,18,8,10,62,51,11,62
RZ Pellets W,754,5,13,9,14,51,50,1,48
Admira Wacke,754,6,13,8,15,43,56,-13,47
Rapid Vienna,754,7,12,9,15,53,47,6,45
SV Josko Rie,754,8,10,6,20,37,61,-24,36
Mattersburg,754,9,7,9,20,35,62,-27,30
St. Pölten,754,10,7,9,20,40,70,-30,30
FC Salzburg,755,1,22,5,9,65,29,36,71
SK Sturm Gra,755,2,21,7,8,60,29,31,70
SC Rheindorf,755,3,19,8,9,50,41,9,65
Vienna,755,4,18,6,12,68,51,17,60
Rapid Vienna,755,5,15,13,8,54,36,18,58
Admira Wacke,755,6,11,8,17,43,60,-17,41
RZ Pellets W,755,7,9,12,15,38,50,-12,39
St. Pölten,755,8,8,12,16,43,66,-23,36
SV Josko Rie,755,9,8,8,20,30,57,-27,32
Mattersburg,755,10,6,7,23,30,62,-32,25
SK Sturm Gra,756,1,21,7,8,64,30,34,70
FC Salzburg,756,2,19,8,9,63,33,30,65
SC Rheindorf,756,3,18,10,8,61,40,21,64
Vienna,756,4,17,6,13,61,55,6,57
Rapid Vienna,756,5,13,12,11,51,38,13,51
SV Josko Rie,756,6,13,4,19,34,58,-24,43
RZ Pellets W,756,7,11,8,17,38,53,-15,41
St. Pölten,756,8,8,12,16,39,60,-21,36
Admira Wacke,756,9,10,6,20,34,66,-32,36
Mattersburg,756,10,7,13,16,41,53,-12,34
FC Salzburg,757,1,21,9,6,70,33,37,72
SK Sturm Gra,757,2,20,6,10,61,36,25,66
Vienna,757,3,21,2,13,66,60,6,65
SC Rheindorf,757,4,16,9,11,49,46,3,57
Rapid Vienna,757,5,15,11,10,60,37,23,56
RZ Pellets W,757,6,11,10,15,45,53,-8,43
Admira Wacke,757,7,10,9,17,34,57,-23,39
Mattersburg,757,8,10,8,18,44,58,-14,38
SV Josko Rie,757,9,9,6,21,30,54,-24,33
St. Pölten,757,10,7,10,19,40,65,-25,31
FC Salzburg,758,1,20,10,6,61,30,31,70
SK Sturm Gra,758,2,20,7,9,54,27,27,67
Vienna,758,3,19,4,13,62,53,9,61
SC Rheindorf,758,4,17,8,11,53,44,9,59
Rapid Vienna,758,5,10,15,11,48,37,11,45
RZ Pellets W,758,6,13,6,17,42,53,-11,45
SV Josko Rie,758,7,11,9,16,38,51,-13,42
St. Pölten,758,8,10,9,17,44,65,-21,39
Admira Wacke,758,9,10,6,20,40,67,-27,36
Mattersburg,758,10,9,8,19,43,58,-15,35
SC Rheindorf,759,1,21,7,8,61,44,17,70
FC Salzburg,759,2,20,6,10,67,37,30,66
Rapid Vienna,759,3,18,9,9,64,37,27,63
SK Sturm Gra,759,4,18,8,10,53,29,24,62
Vienna,759,5,16,9,11,60,52,8,57
Admira Wacke,759,6,12,6,18,47,65,-18,42
RZ Pellets W,759,7,11,6,19,48,60,-12,39
SV Josko Rie,759,8,12,3,21,35,60,-25,39
Mattersburg,759,9,8,10,18,39,59,-20,34
St. Pölten,759,10,7,10,19,36,67,-31,31
FC Salzburg,760,1,22,6,8,66,30,36,72
SC Rheindorf,760,2,19,8,9,56,45,11,65
Vienna,760,3,19,6,11,62,43,19,63
SK Sturm Gra,760,4,17,9,10,57,36,21,60
Rapid Vienna,760,5,16,7,13,63,41,22,55
RZ Pellets W,760,6,13,7,16,45,55,-10,46
SV Josko Rie,760,7,12,4,20,37,49,-12,40
St. Pölten,760,8,11,7,18,39,63,-24,40
Admira Wacke,760,9,9,7,20,28,61,-33,34
Mattersburg,760,10,8,7,21,30,60,-30,31
FC Salzburg,761,1,25,4,7,74,30,44,79
SC Rheindorf,761,2,21,6,9,62,42,20,69
SK Sturm Gra,761,3,20,6,10,68,41,27,66
Vienna,761,4,20,2,14,68,60,8,62
RZ Pellets W,761,5,13,10,13,50,57,-7,49
Rapid Vienna,761,6,11,10,15,56,52,4,43
SV Josko Rie,761,7,10,6,20,34,55,-21,36
Admira Wacke,761,8,9,8,19,34,58,-24,35
St. Pölten,761,9,9,8,19,42,68,-26,35
Mattersburg,761,10,7,10,19,33,58,-25,31
SC Rheindorf,762,1,20,9,7,68,45,23,69
FC Salzburg,762,2,19,7,10,64,34,30,64
SK Sturm Gra,762,3,18,7,11,60,38,22,61
Vienna,762,4,17,5,14,62,59,3,56
Rapid Vienna,762,5,14,10,12,51,42,9,52
RZ Pellets W,762,6,12,9,15,44,51,-7,45
SV Josko Rie,762,7,13,6,17,39,53,-14,45
Admira Wacke,762,8,12,6,18,37,59,-22,42
Mattersburg,762,9,10,7,19,43,61,-18,37
St. Pölten,762,10,6,12,18,31,57,-26,30
FC Salzburg,763,1,21,6,9,69,32,37,69
SK Sturm Gra,763,2,18,7,11,59,35,24,61
SC Rheindorf,763,3,17,10,9,52,40,12,61
Rapid Vienna,763,4,16,10,10,54,34,20,58
Vienna,763,5,18,3,15,66,56,10,57
Admira Wacke,763,6,16,3,17,47,64,-17,51
RZ Pellets W,763,7,10,11,15,41,52,-11,41
SV Josko Rie,763,8,11,4,21,33,65,-32,37
Mattersburg,763,9,8,11,17,36,55,-19,35
St. Pölten,763,10,7,11,18,42,66,-24,32
FC Salzburg,764,1,20,10,6,61,23,38,70
SK Sturm Gra,764,2,20,4,12,59,34,25,64
SC Rheindorf,764,3,19,6,11,52,48,4,63
Vienna,764,4,19,5,12,62,48,14,62
Rapid Vienna,764,5,14,10,12,53,36,17,52
RZ Pellets W,764,6,12,8,16,43,58,-15,44
Admira Wacke,764,7,12,6,18,34,52,-18,42
St. Pölten,764,8,11,7,18,40,62,-22,40
SV Josko Rie,764,9,10,6,20,31,50,-19,36
Mattersburg,764,10,8,8,20,29,53,-24,32
SK Sturm Gra,765,1,21,7,8,58,26,32,70
SC Rheindorf,765,2,21,7,8,62,45,17,70
FC Salzburg,765,3,19,6,11,63,32,31,63
Vienna,765,4,17,6,13,57,54,3,57
Rapid Vienna,765,5,14,9,13,55,46,9,51
Admira Wacke,765,6,15,6,15,42,50,-8,51
RZ Pellets W,765,7,11,8,17,40,55,-15,41
St. Pölten,765,8,8,11,17,42,62,-20,35
SV Josko Rie,765,9,11,2,23,30,56,-26,35
Mattersburg,765,10,8,8,20,37,60,-23,32
SC Rheindorf,766,1,22,7,7,62,35,27,73
FC Salzburg,766,2,20,8,8,64,32,32,68
SK Sturm Gra,766,3,19,6,11,55,37,18,63
Vienna,766,4,18,8,10,62,45,17,62
Rapid Vienna,766,5,16,11,9,60,38,22,59
RZ Pellets W,766,6,10,10,16,37,46,-9,40
SV Josko Rie,766,7,11,6,19,40,59,-19,39
Mattersburg,766,8,9,7,20,43,61,-18,34
Admira Wacke,766,9,9,6,21,30,66,-36,33
St. Pölten,766,10,8,7,21,40,74,-34,31
FC Salzburg,767,1,21,10,5,73,34,39,73
SC Rheindorf,767,2,21,8,7,58,39,19,71
SK Sturm Gra,767,3,18,6,12,57,35,22,60
Vienna,767,4,16,7,13,63,57,6,55
RZ Pellets W,767,5,15,8,13,49,49,0,53
Rapid Vienna,767,6,12,12,12,51,42,9,48
Admira Wacke,767,7,11,6,19,36,61,-25,39
SV Josko Rie,767,8,12,2,22,41,68,-27,38
Mattersburg,767,9,9,10,17,38,53,-15,37
St. Pölten,767,10,6,9,21,35,63,-28,27
SC Rheindorf,768,1,20,8,8,53,36,17,68
FC Salzburg,768,2,19,10,7,63,34,29,67
Vienna,768,3,19,5,12,62,53,9,62
SK Sturm Gra,768,4,17,7,12,56,40,16,58
RZ Pellets W,768,5,13,7,16,46,51,-5,46
Rapid Vienna,768,6,11,12,13,48,40,8,45
SV Josko Rie,768,7,12,6,18,33,45,-12,42
Admira Wacke,768,8,12,6,18,34,52,-18,42
Mattersburg,768,9,9,10,17,42,58,-16,37
St. Pölten,768,10,8,9,19,42,70,-28,33
Vienna,769,1,21,6,9,68,48,20,69
SC Rheindorf,769,2,17,12,7,53,39,14,63
Rapid Vienna,769,3,17,11,8,63,36,27,62
FC Salzburg,769,4,18,8,10,56,30,26,62
SK Sturm Gra,769,5,15,8,13,49,42,7,53
RZ Pellets W,769,6,10,11,15,48,65,-17,41
Admira Wacke,769,7,11,5,20,37,58,-21,38
St. Pölten,769,8,8,13,15,45,59,-14,37
SV Josko Rie,769,9,10,6,20,33,56,-23,36
Mattersburg,769,10,9,8,19,38,57,-19,35
FC Salzburg,770,1,25,6,5,74,25,49,81
SK Sturm Gra,770,2,20,5,11,60,33,27,65
SC Rheindorf,770,3,19,8,9,53,39,14,65
Vienna,770,4,18,6,12,67,59,8,60
Rapid Vienna,770,5,13,10,13,50,41,9,49
SV Josko Rie,770,6,11,9,16,40,50,-10,42
St. Pölten,770,7,10,9,17,44,61,-17,39
RZ Pellets W,770,8,10,8,18,41,63,-22,38
Admira Wacke,770,9,10,5,21,34,67,-33,35
Mattersburg,770,10,6,10,20,39,64,-25,28
FC Salzburg,771,1,18,10,8,63,36,27,64
SK Sturm Gra,771,2,19,6,11,60,39,21,63
SC Rheindorf,771,3,17,8,11,56,50,6,59
Rapid Vienna,771,4,15,11,10,56,40,16,56
Vienna,771,5,16,5,15,61,58,3,53
RZ Pellets W,771,6,14,5,17,51,58,-7,47
St. Pölten,771,7,11,10,15,45,58,-13,43
Admira Wacke,771,8,12,7,17,38,64,-26,43
SV Josko Rie,771,9,13,3,20,40,47,-7,42
Mattersburg,771,10,7,11,18,36,56,-20,32
FC Salzburg,772,1,22,6,8,71,33,38,72
SC Rheindorf,772,2,20,6,10,56,40,16,66
SK Sturm Gra,772,3,18,9,9,54,28,26,63
Vienna,772,4,20,3,13,64,50,14,63
Rapid Vienna,772,5,13,10,13,52,44,8,49
RZ Pellets W,772,6,12,8,16,51,60,-9,44
Admira Wacke,772,7,12,8,16,40,59,-19,44
SV Josko Rie,772,8,12,4,20,32,54,-22,40
St. Pölten,772,9,8,9,19,42,67,-25,33
Mattersburg,772,10,6,11,19,30,57,-27,29
FC Salzburg,773,1,22,9,5,68,31,37,75
SK Sturm Gra,773,2,20,6,10,69,37,32,66
SC Rheindorf,773,3,19,7,10,58,43,15,64
Vienna,773,4,20,3,13,64,55,9,63
Rapid Vienna,773,5,16,11,9,60,33,27,59
Admira Wacke,773,6,12,5,19,40,56,-16,41
SV Josko Rie,773,7,11,5,20,34,61,-27,38
RZ Pellets W,773,8,10,7,19,40,65,-25,37
St. Pölten,773,9,8,9,19,42,68,-26,33
Mattersburg,773,10,6,10,20,37,63,-26,28
FC Salzburg,774,1,22,8,6,71,31,40,74
Vienna,774,2,20,7,9,64,49,15,67
SK Sturm Gra,774,3,17,7,12,60,42,18,58
SC Rheindorf,774,4,17,7,12,54,44,10,58
Rapid Vienna,774,5,13,12,11,59,38,21,51
RZ Pellets W,774,6,13,7,16,45,64,-19,46
SV Josko Rie,774,7,11,5,20,27,49,-22,38
St. Pölten,774,8,10,7,19,38,57,-19,37
Mattersburg,774,9,9,10,17,37,57,-20,37
Admira Wacke,774,10,10,6,20,37,61,-24,36
SC Rheindorf,775,1,22,7,7,57,39,18,73
Vienna,775,2,21,4,11,63,47,16,67
FC Salzburg,775,3,20,6,10,64,34,30,66
SK Sturm Gra,775,4,20,6,10,61,35,26,66
Rapid Vienna,775,5,13,12,11,64,42,22,51
St. Pölten,775,6,11,10,15,45,60,-15,43
RZ Pellets W,775,7,12,4,20,41,58,-17,40
Mattersburg,775,8,9,8,19,36,60,-24,35
SV Josko Rie,775,9,10,4,22,32,56,-24,34
Admira Wacke,775,10,9,5,22,33,65,-32,32
SK Sturm Gra,776,1,20,8,8,61,30,31,68
Rapid Vienna,776,2,17,9,10,59,37,22,60
SC Rheindorf,776,3,17,8,11,52,45,7,59
FC Salzburg,776,4,16,10,10,69,45,24,58
Vienna,776,5,17,7,12,63,53,10,58
Admira Wacke,776,6,14,7,15,40,52,-12,49
RZ Pellets W,776,7,13,8,15,51,53,-2,47
Mattersburg,776,8,11,7,18,39,59,-20,40
SV Josko Rie,776,9,8,9,19,32,55,-23,33
St. Pölten,776,10,6,9,21,33,70,-37,27
SK Sturm Gra,777,1,22,6,8,67,32,35,72
FC Salzburg,777,2,20,10,6,71,30,41,70
SC Rheindorf,777,3,19,6,11,51,47,4,63
Vienna,777,4,16,6,14,53,49,4,54
Rapid Vienna,777,5,13,10,13,51,45,6,49
RZ Pellets W,777,6,11,11,14,44,51,-7,44
Admira Wacke,777,7,12,6,18,37,59,-22,42
St. Pölten,777,8,9,10,17,40,60,-20,37
SV Josko Rie,777,9,9,9,18,40,59,-19,36
Mattersburg,777,10,7,10,19,36,58,-22,31
FC Salzburg,778,1,19,10,7,67,33,34,67
SK Sturm Gra,778,2,21,4,11,60,32,28,67
SC Rheindorf,778,3,19,6,11,51,43,8,63
Vienna,778,4,17,9,10,65,56,9,60
Rapid Vienna,778,5,15,11,10,61,39,22,56
St. Pölten,778,6,9,13,14,44,55,-11,40
RZ Pellets W,778,7,10,8,18,42,61,-19,38
Admira Wacke,778,8,10,7,19,34,66,-32,37
Mattersburg,778,9,9,8,19,36,59,-23,35
SV Josko Rie,778,10,8,10,18,33,49,-16,34
SK Sturm Gra,779,1,21,6,9,54,27,27,69
FC Salzburg,779,2,20,8,8,59,32,27,68
SC Rheindorf,779,3,20,6,10,59,43,16,66
Vienna,779,4,17,5,14,59,49,10,56
Rapid Vienna,779,5,15,9,12,55,41,14,54
RZ Pellets W,779,6,11,10,15,46,59,-13,43
Admira Wacke,779,7,12,7,17,37,54,-17,43
Mattersburg,779,8,11,8,17,41,50,-9,41
SV Josko Rie,779,9,9,7,20,31,55,-24,34
St. Pölten,779,10,7,8,21,39,70,-31,29
Vienna,780,1,21,6,9,65,43,22,69
SC Rheindorf,780,2,20,7,9,53,38,15,67
FC Salzburg,780,3,19,7,10,63,36,27,64
SK Sturm Gra,780,4,17,8,11,56,36,20,59
SV Josko Rie,780,5,15,6,15,41,49,-8,51
RZ Pellets W,780,6,10,13,13,50,53,-3,43
Rapid Vienna,780,7,10,11,15,49,49,0,41
Admira Wacke,780,8,10,6,20,40,64,-24,36
St. Pölten,780,9,7,13,16,38,59,-21,34
Mattersburg,780,10,7,11,18,32,60,-28,32
FC Salzburg,781,1,21,7,8,69,32,37,70
SK Sturm Gra,781,2,20,7,9,63,30,33,67
Vienna,781,3,20,5,11,67,48,19,65
SC Rheindorf,781,4,17,9,10,59,55,4,60
Rapid Vienna,781,5,12,11,13,53,39,14,47
Admira Wacke,781,6,12,8,16,38,55,-17,44
RZ Pellets W,781,7,11,10,15,46,61,-15,43
SV Josko Rie,781,8,13,3,20,39,54,-15,42
St. Pölten,781,9,10,8,18,42,64,-22,38
Mattersburg,781,10,5,10,21,34,72,-38,25
SC Rheindorf,782,1,21,8,7,61,40,21,71
SK Sturm Gra,782,2,21,7,8,64,34,30,70
FC Salzburg,782,3,18,9,9,61,36,25,63
Vienna,782,4,18,6,12,59,46,13,60
RZ Pellets W,782,5,13,8,15,46,55,-9,47
Rapid Vienna,782,6,11,10,15,45,46,-1,43
SV Josko Rie,782,7,11,7,18,37,56,-19,40
Admira Wacke,782,8,10,9,17,38,54,-16,39
St. Pölten,782,9,9,7,20,43,68,-25,34
Mattersburg,782,10,8,9,19,37,56,-19,33
FC Salzburg,783,1,24,7,5,66,26,40,79
SC Rheindorf,783,2,20,6,10,59,37,22,66
SK Sturm Gra,783,3,19,7,10,53,30,23,64
Rapid Vienna,783,4,17,9,10,60,37,23,60
Vienna,783,5,18,6,12,69,55,14,60
Admira Wacke,783,6,11,7,18,42,72,-30,40
Mattersburg,783,7,10,9,17,33,54,-21,39
RZ Pellets W,783,8,8,10,18,42,58,-16,34
St. Pölten,783,9,8,9,19,39,63,-24,33
SV Josko Rie,783,10,8,4,24,31,62,-31,28
FC Salzburg,784,1,23,6,7,65,30,35,75
SK Sturm Gra,784,2,21,4,11,63,31,32,67
SC Rheindorf,784,3,18,8,10,52,45,7,62
Vienna,784,4,17,9,10,64,52,12,60
Rapid Vienna,784,5,13,10,13,53,43,10,49
RZ Pellets W,784,6,12,10,14,43,50,-7,46
SV Josko Rie,784,7,12,5,19,34,50,-16,41
Mattersburg,784,8,10,8,18,35,53,-18,38
Admira Wacke,784,9,10,7,19,35,59,-24,37
St. Pölten,784,10,6,9,21,33,64,-31,27
SK Sturm Gra,785,1,23,5,8,67,29,38,74
FC Salzburg,785,2,22,7,7,78,31,47,73
SC Rheindorf,785,3,20,7,9,55,46,9,67
Vienna,785,4,16,4,16,64,67,-3,52
Rapid Vienna,785,5,13,10,13,50,47,3,49
RZ Pellets W,785,6,12,11,13,53,56,-3,47
Admira Wacke,785,7,13,6,17,42,57,-15,45
SV Josko Rie,785,8,9,6,21,34,60,-26,33
St. Pölten,785,9,8,8,20,47,72,-25,32
Mattersburg,785,10,8,8,20,37,62,-25,32
SK Sturm Gra,786,1,25,3,8,69,29,40,78
FC Salzburg,786,2,22,5,9,67,31,36,71
SC Rheindorf,786,3,21,5,10,63,45,18,68
Rapid Vienna,786,4,17,11,8,65,39,26,62
RZ Pellets W,786,5,14,9,13,50,51,-1,51
Vienna,786,6,15,5,16,50,57,-7,50
Admira Wacke,786,7,11,5,20,35,60,-25,38
SV Josko Rie,786,8,10,6,20,35,58,-23,36
Mattersburg,786,9,5,11,20,33,63,-30,26
St. Pölten,786,10,5,10,21,35,69,-34,25
FC Salzburg,787,1,21,8,7,74,34,40,71
SC Rheindorf,787,2,20,6,10,55,43,12,66
SK Sturm Gra,787,3,19,6,11,60,41,19,63
Vienna,787,4,18,6,12,63,51,12,60
Rapid Vienna,787,5,12,11,13,46,37,9,47
RZ Pellets W,787,6,13,7,16,43,53,-10,46
Admira Wacke,787,7,12,9,15,36,55,-19,45
St. Pölten,787,8,10,9,17,40,59,-19,39
SV Josko Rie,787,9,10,4,22,37,61,-24,34
Mattersburg,787,10,8,8,20,41,61,-20,32
FC Salzburg,788,1,23,7,6,72,29,43,76
SK Sturm Gra,788,2,22,4,10,69,33,36,70
Vienna,788,3,20,5,11,67,48,19,65
SC Rheindorf,788,4,19,8,9,52,38,14,65
Rapid Vienna,788,5,12,11,13,46,44,2,47
RZ Pellets W,788,6,13,7,16,40,53,-13,46
St. Pölten,788,7,10,10,16,44,59,-15,40
Admira Wacke,788,8,10,5,21,30,64,-34,35
Mattersburg,788,9,8,7,21,30,56,-26,31
SV Josko Rie,788,10,8,6,22,32,58,-26,30
FC Salzburg,789,1,23,6,7,75,35,40,75
SC Rheindorf,789,2,21,5,10,58,48,10,68
SK Sturm Gra,789,3,18,8,10,68,33,35,62
Vienna,789,4,18,6,12,61,52,9,60
Rapid Vienna,789,5,15,10,11,50,35,15,55
SV Josko Rie,789,6,12,7,17,40,55,-15,43
Admira Wacke,789,7,12,7,17,41,64,-23,43
RZ Pellets W,789,8,10,6,20,45,74,-29,36
Mattersburg,789,9,9,6,21,35,52,-17,33
St. Pölten,789,10,7,9,20,43,68,-25,30
FC Salzburg,790,1,25,5,6,77,26,51,80
SC Rheindorf,790,2,22,5,9,57,42,15,71
SK Sturm Gra,790,3,21,5,10,67,32,35,68
Rapid Vienna,790,4,16,8,12,61,43,18,56
Vienna,790,5,17,3,16,53,50,3,54
Admira Wacke,790,6,12,5,19,34,66,-32,41
RZ Pellets W,790,7,9,11,16,36,49,-13,38
SV Josko Rie,790,8,11,3,22,36,58,-22,36
St. Pölten,790,9,7,12,17,42,67,-25,33
Mattersburg,790,10,8,7,21,33,63,-30,31
FC Salzburg,791,1,21,7,8,63,27,36,70
SK Sturm Gra,791,2,20,6,10,60,38,22,66
SC Rheindorf,791,3,18,9,9,56,45,11,63
Vienna,791,4,17,4,15,62,55,7,55
Rapid Vienna,791,5,14,10,12,55,42,13,52
RZ Pellets W,791,6,12,10,14,44,51,-7,46
Admira Wacke,791,7,13,7,16,37,51,-14,46
Mattersburg,791,8,9,8,19,33,50,-17,35
SV Josko Rie,791,9,9,8,19,29,54,-25,35
St. Pölten,791,10,7,11,18,34,60,-26,32
FC Salzburg,792,1,21,6,9,66,35,31,69
SK Sturm Gra,792,2,20,7,9,62,37,25,67
SC Rheindorf,792,3,20,6,10,56,45,11,66
Vienna,792,4,19,4,13,61,51,10,61
Rapid Vienna,792,5,13,8,15,49,46,3,47
RZ Pellets W,792,6,13,8,15,49,49,0,47
Admira Wacke,792,7,13,5,18,41,59,-18,44
St. Pölten,792,8,11,7,18,46,64,-18,40
Mattersburg,792,9,7,12,17,40,55,-15,33
SV Josko Rie,792,10,9,5,22,28,57,-29,32
SC Rheindorf,793,1,25,4,7,66,44,22,79
FC Salzburg,793,2,22,5,9,75,33,42,71
SK Sturm Gra,793,3,20,5,11,59,33,26,65
Rapid Vienna,793,4,17,10,9,57,36,21,61
Vienna,793,5,18,4,14,64,55,9,58
RZ Pellets W,793,6,12,8,16,45,51,-6,44
Admira Wacke,793,7,10,5,21,30,68,-38,35
SV Josko Rie,793,8,10,4,22,31,58,-27,34
St. Pölten,793,9,7,11,18,42,67,-25,32
Mattersburg,793,10,7,8,21,39,63,-24,29
Vienna,794,1,22,4,10,63,43,20,70
FC Salzburg,794,2,20,7,9,63,31,32,67
SK Sturm Gra,794,3,21,3,12,61,39,22,66
SC Rheindorf,794,4,20,6,10,52,38,14,66
Rapid Vienna,794,5,18,9,9,66,33,33,63
RZ Pellets W,794,6,14,5,17,51,55,-4,47
Admira Wacke,794,7,11,6,19,40,69,-29,39
SV Josko Rie,794,8,9,5,22,28,58,-30,32
St. Pölten,794,9,7,10,19,35,65,-30,31
Mattersburg,794,10,8,5,23,35,63,-28,29
Vienna,795,1,21,6,9,69,46,23,69
FC Salzburg,795,2,19,10,7,64,36,28,67
SK Sturm Gra,795,3,20,6,10,61,34,27,66
SC Rheindorf,795,4,17,9,10,54,46,8,60
Rapid Vienna,795,5,13,13,10,55,41,14,52
RZ Pellets W,795,6,10,9,17,43,56,-13,39
SV Josko Rie,795,7,11,6,19,42,58,-16,39
Admira Wacke,795,8,9,10,17,40,70,-30,37
Mattersburg,795,9,9,7,20,49,63,-14,34
St. Pölten,795,10,8,10,18,40,67,-27,34
FC Salzburg,796,1,21,7,8,62,29,33,70
SC Rheindorf,796,2,20,6,10,54,42,12,66
SK Sturm Gra,796,3,18,8,10,59,31,28,62
Vienna,796,4,17,9,10,59,48,11,60
RZ Pellets W,796,5,14,7,15,47,55,-8,49
Rapid Vienna,796,6,12,11,13,50,45,5,47
SV Josko Rie,796,7,12,4,20,38,54,-16,40
Admira Wacke,796,8,10,9,17,38,57,-19,39
Mattersburg,796,9,10,6,20,37,58,-21,36
St. Pölten,796,10,7,11,18,43,68,-25,32
FC Salzburg,797,1,22,7,7,58,28,30,73
SC Rheindorf,797,2,18,9,9,63,48,15,63
SK Sturm Gra,797,3,18,8,10,55,33,22,62
Vienna,797,4,18,8,10,65,50,15,62
Rapid Vienna,797,5,13,14,9,50,38,12,53
SV Josko Rie,797,6,11,7,18,39,53,-14,40
RZ Pellets W,797,7,10,9,17,40,59,-19,39
St. Pölten,797,8,8,13,15,42,57,-15,37
Admira Wacke,797,9,8,9,19,34,59,-25,33
Mattersburg,797,10,6,12,18,38,59,-21,30
FC Salzburg,798,1,24,6,6,66,28,38,78
SK Sturm Gra,798,2,20,6,10,55,31,24,66
SC Rheindorf,798,3,18,6,12,47,40,7,60
Vienna,798,4,18,5,13,65,51,14,59
Rapid Vienna,798,5,16,9,11,56,36,20,57
RZ Pellets W,798,6,14,7,15,45,51,-6,49
Admira Wacke,798,7,11,7,18,38,64,-26,40
SV Josko Rie,798,8,11,5,20,39,53,-14,38
Mattersburg,798,9,8,7,21,33,62,-29,31
St. Pölten,798,10,7,8,21,35,63,-28,29
SK Sturm Gra,799,1,22,6,8,64,31,33,72
FC Salzburg,799,2,19,9,8,64,30,34,66
Vienna,799,3,18,8,10,62,50,12,62
SC Rheindorf,799,4,17,9,10,49,43,6,60
Rapid Vienna,799,5,14,10,12,57,38,19,52
RZ Pellets W,799,6,12,10,14,45,54,-9,46
Mattersburg,799,7,10,10,16,39,52,-13,40
Admira Wacke,799,8,9,8,19,34,59,-25,35
St. Pölten,799,9,8,10,18,42,61,-19,34
SV Josko Rie,799,10,9,4,23,29,67,-38,31
FC Salzburg,800,1,23,5,8,69,30,39,74
Vienna,800,2,21,5,10,60,48,12,68
SK Sturm Gra,800,3,17,7,12,52,40,12,58
SC Rheindorf,800,4,17,5,14,48,47,1,56
Rapid Vienna,800,5,14,12,10,49,37,12,54
Admira Wacke,800,6,14,5,17,42,53,-11,47
St. Pölten,800,7,12,8,16,44,59,-15,44
SV Josko Rie,800,8,13,3,20,43,53,-10,42
RZ Pellets W,800,9,11,6,19,44,57,-13,39
Mattersburg,800,10,6,8,22,35,62,-27,26
FC Salzburg,801,1,19,10,7,59,26,33,67
SK Sturm Gra,801,2,19,6,11,58,35,23,63
SC Rheindorf,801,3,18,7,11,54,46,8,61
Vienna,801,4,19,4,13,60,53,7,61
Rapid Vienna,801,5,14,11,11,60,41,19,53
RZ Pellets W,801,6,14,8,14,51,50,1,50
St. Pölten,801,7,10,10,16,43,62,-19,40
Admira Wacke,801,8,11,6,19,38,65,-27,39
Mattersburg,801,9,9,7,20,36,60,-24,34
SV Josko Rie,801,10,8,9,19,28,49,-21,33
FC Salzburg,802,1,22,7,7,66,33,33,73
Rapid Vienna,802,2,17,11,8,62,34,28,62
Vienna,802,3,19,5,12,68,50,18,62
SK Sturm Gra,802,4,17,6,13,57,38,19,57
SC Rheindorf,802,5,15,9,12,48,47,1,54
RZ Pellets W,802,6,14,8,14,49,57,-8,50
Admira Wacke,802,7,12,6,18,42,55,-13,42
St. Pölten,802,8,9,10,17,35,57,-22,37
SV Josko Rie,802,9,9,7,20,26,55,-29,34
Mattersburg,802,10,6,11,19,34,61,-27,29
Vienna,803,1,22,6,8,72,44,28,72
SK Sturm Gra,803,2,21,6,9,66,29,37,69
FC Salzburg,803,3,17,11,8,60,33,27,62
SC Rheindorf,803,4,17,8,11,54,46,8,59
Rapid Vienna,803,5,12,14,10,53,41,12,50
SV Josko Rie,803,6,13,4,19,39,58,-19,43
RZ Pellets W,803,7,10,10,16,37,53,-16,40
Admira Wacke,803,8,11,5,20,31,61,-30,38
St. Pölten,803,9,8,12,16,44,66,-22,36
Mattersburg,803,10,6,10,20,31,56,-25,28
SC Rheindorf,804,1,19,10,7,61,45,16,67
FC Salzburg,804,2,19,7,10,66,36,30,64
Vienna,804,3,17,8,11,64,61,3,59
SK Sturm Gra,804,4,15,7,14,51,40,11,52
RZ Pellets W,804,5,15,7,14,52,53,-1,52
Rapid Vienna,804,6,13,11,12,59,42,17,50
Admira Wacke,804,7,13,7,16,39,53,-14,46
SV Josko Rie,804,8,11,5,20,34,51,-17,38
Mattersburg,804,9,10,7,19,37,60,-23,37
St. Pölten,804,10,8,11,17,44,66,-22,35
SC Rheindorf,805,1,21,6,9,63,46,17,69
FC Salzburg,805,2,19,9,8,64,36,28,66
SK Sturm Gra,805,3,18,7,11,61,38,23,61
Vienna,805,4,17,9,10,65,52,13,60
Rapid Vienna,805,5,13,10,13,55,46,9,49
RZ Pellets W,805,6,12,8,16,47,60,-13,44
Admira Wacke,805,7,12,8,16,39,55,-16,44
St. Pölten,805,8,11,9,16,44,57,-13,42
SV Josko Rie,805,9,9,6,21,28,52,-24,33
Mattersburg,805,10,6,12,18,37,61,-24,30
FC Salzburg,806,1,24,7,5,74,27,47,79
SC Rheindorf,806,2,22,8,6,59,41,18,74
SK Sturm Gra,806,3,17,7,12,55,37,18,58
Vienna,806,4,17,5,14,61,53,8,56
Rapid Vienna,806,5,15,8,13,49,39,10,53
Admira Wacke,806,6,14,5,17,40,54,-14,47
St. Pölten,806,7,9,10,17,46,62,-16,37
SV Josko Rie,806,8,10,7,19,36,61,-25,37
RZ Pellets W,806,9,10,6,20,41,62,-21,36
Mattersburg,806,10,6,9,21,35,60,-25,27
FC Salzburg,807,1,20,8,8,66,35,31,68
SC Rheindorf,807,2,19,7,10,50,36,14,64
SK Sturm Gra,807,3,18,7,11,59,40,19,61
Vienna,807,4,18,6,12,60,49,11,60
RZ Pellets W,807,5,15,8,13,51,51,0,53
Rapid Vienna,807,6,13,12,11,52,41,11,51
SV Josko Rie,807,7,10,8,18,36,56,-20,38
Admira Wacke,807,8,11,5,20,36,61,-25,38
St. Pölten,807,9,8,11,17,45,66,-21,35
Mattersburg,807,10,7,10,19,33,53,-20,31
FC Salzburg,808,1,21,8,7,68,30,38,71
SK Sturm Gra,808,2,20,7,9,67,35,32,67
SC Rheindorf,808,3,19,8,9,49,36,13,65
Rapid Vienna,808,4,16,9,11,59,45,14,57
Vienna,808,5,17,5,14,60,55,5,56
RZ Pellets W,808,6,14,7,15,54,59,-5,49
SV Josko Rie,808,7,11,7,18,32,49,-17,40
Admira Wacke,808,8,10,9,17,36,60,-24,39
Mattersburg,808,9,7,9,20,38,62,-24,30
St. Pölten,808,10,7,7,22,42,74,-32,28
SC Rheindorf,809,1,21,8,7,67,40,27,71
SK Sturm Gra,809,2,19,8,9,62,34,28,65
FC Salzburg,809,3,19,8,9,61,34,27,65
Rapid Vienna,809,4,16,9,11,56,39,17,57
Vienna,809,5,16,3,17,63,73,-10,51
SV Josko Rie,809,6,14,7,15,38,43,-5,49
Admira Wacke,809,7,12,6,18,37,61,-24,42
RZ Pellets W,809,8,10,6,20,43,64,-21,36
St. Pölten,809,9,8,11,17,43,61,-18,35
Mattersburg,809,10,8,8,20,36,57,-21,32
FC Salzburg,810,1,22,8,6,65,26,39,74
SK Sturm Gra,810,2,20,7,9,58,29,29,67
SC Rheindorf,810,3,18,7,11,54,48,6,61
Vienna,810,4,18,5,13,59,53,6,59
Rapid Vienna,810,5,15,10,11,53,37,16,55
Admira Wacke,810,6,11,9,16,34,52,-18,42
Mattersburg,810,7,11,7,18,39,51,-12,40
St. Pölten,810,8,9,11,16,42,60,-18,38
RZ Pellets W,810,9,9,8,19,36,59,-23,35
SV Josko Rie,810,10,7,8,21,28,53,-25,29
FC Salzburg,811,1,22,10,4,69,27,42,76
Vienna,811,2,20,7,9,66,45,21,67
SK Sturm Gra,811,3,17,8,11,61,40,21,59
SC Rheindorf,811,4,17,8,11,49,39,10,59
RZ Pellets W,811,5,13,8,15,50,59,-9,47
Rapid Vienna,811,6,10,12,14,46,46,0,42
St. Pölten,811,7,10,11,15,44,55,-11,41
SV Josko Rie,811,8,12,4,20,37,57,-20,40
Admira Wacke,811,9,12,4,20,41,69,-28,40
Mattersburg,811,10,6,10,20,37,63,-26,28
FC Salzburg,812,1,20,9,7,68,29,39,69
SC Rheindorf,812,2,20,7,9,57,45,12,67
Rapid Vienna,812,3,19,9,8,67,37,30,66
Vienna,812,4,17,10,9,63,49,14,61
SK Sturm Gra,812,5,17,9,10,64,40,24,60
RZ Pellets W,812,6,9,10,17,41,58,-17,37
St. Pölten,812,7,9,10,17,41,62,-21,37
Admira Wacke,812,8,10,7,19,32,62,-30,37
SV Josko Rie,812,9,9,7,20,34,57,-23,34
Mattersburg,812,10,6,10,20,31,59,-28,28
SK Sturm Gra,813,1,23,5,8,70,30,40,74
Vienna,813,2,23,4,9,66,43,23,73
SC Rheindorf,813,3,20,6,10,60,52,8,66
FC Salzburg,813,4,17,7,12,62,41,21,58
Rapid Vienna,813,5,14,11,11,58,41,17,53
Admira Wacke,813,6,12,7,17,39,60,-21,43
RZ Pellets W,813,7,11,7,18,41,60,-19,40
SV Josko Rie,813,8,10,5,21,35,53,-18,35
Mattersburg,813,9,7,11,18,34,57,-23,32
St. Pölten,813,10,7,9,20,43,71,-28,30
FC Salzburg,814,1,21,8,7,65,31,34,71
SK Sturm Gra,814,2,21,6,9,55,31,24,69
Vienna,814,3,19,5,12,62,48,14,62
SC Rheindorf,814,4,17,10,9,50,40,10,61
Rapid Vienna,814,5,13,11,12,58,44,14,50
Admira Wacke,814,6,11,8,17,41,63,-22,41
SV Josko Rie,814,7,11,5,20,34,49,-15,38
St. Pölten,814,8,9,10,17,42,57,-15,37
RZ Pellets W,814,9,10,7,19,41,67,-26,37
Mattersburg,814,10,9,8,19,40,58,-18,35
SC Rheindorf,815,1,22,7,7,61,37,24,73
FC Salzburg,815,2,20,9,7,69,33,36,69
Vienna,815,3,22,3,11,67,55,12,69
SK Sturm Gra,815,4,20,6,10,58,36,22,66
Rapid Vienna,815,5,14,10,12,52,39,13,52
Admira Wacke,815,6,12,5,19,43,65,-22,41
RZ Pellets W,815,7,10,7,19,49,67,-18,37
SV Josko Rie,815,8,10,6,20,38,55,-17,36
St. Pölten,815,9,9,9,18,50,72,-22,36
Mattersburg,815,10,6,8,22,34,62,-28,26
FC Salzburg,816,1,21,8,7,70,36,34,71
SC Rheindorf,816,2,22,5,9,61,42,19,71
SK Sturm Gra,816,3,19,6,11,61,32,29,63
Vienna,816,4,18,5,13,61,49,12,59
Rapid Vienna,816,5,11,14,11,49,43,6,47
SV Josko Rie,816,6,13,4,19,40,54,-14,43
Admira Wacke,816,7,12,7,17,35,53,-18,43
RZ Pellets W,816,8,9,11,16,42,59,-17,38
St. Pölten,816,9,9,10,17,47,71,-24,37
Mattersburg,816,10,7,8,21,33,60,-27,29
FC Salzburg,817,1,24,6,6,77,28,49,78
Vienna,817,2,21,5,10,68,51,17,68
SC Rheindorf,817,3,19,10,7,64,39,25,67
SK Sturm Gra,817,4,16,7,13,50,43,7,55
Rapid Vienna,817,5,15,8,13,64,46,18,53
RZ Pellets W,817,6,15,6,15,48,53,-5,51
Admira Wacke,817,7,11,5,20,39,64,-25,38
SV Josko Rie,817,8,10,6,20,36,56,-20,36
St. Pölten,817,9,9,9,18,40,69,-29,36
Mattersburg,817,10,6,6,24,31,68,-37,24
SC Rheindorf,818,1,21,10,5,60,38,22,73
SK Sturm Gra,818,2,20,7,9,70,37,33,67
FC Salzburg,818,3,19,8,9,65,37,28,65
Vienna,818,4,15,10,11,55,45,10,55
Rapid Vienna,818,5,12,11,13,52,49,3,47
Mattersburg,818,6,12,6,18,44,57,-13,42
SV Josko Rie,818,7,12,6,18,39,52,-13,42
Admira Wacke,818,8,13,3,20,40,63,-23,42
RZ Pellets W,818,9,12,5,19,47,62,-15,41
St. Pölten,818,10,6,10,20,34,66,-32,28
FC Salzburg,819,1,22,10,4,78,28,50,76
Vienna,819,2,21,7,8,69,42,27,70
SC Rheindorf,819,3,19,9,8,55,46,9,66
SK Sturm Gra,819,4,15,9,12,47,38,9,54
Rapid Vienna,819,5,12,12,12,49,36,13,48
Mattersburg,819,6,11,10,15,42,47,-5,43
Admira Wacke,819,7,9,10,17,36,63,-27,37
RZ Pellets W,819,8,9,9,18,38,59,-21,36
SV Josko Rie,819,9,8,8,20,29,57,-28,32
St. Pölten,819,10,6,12,18,37,64,-27,30
FC Salzburg,820,1,23,6,7,66,28,38,75
SK Sturm Gra,820,2,21,5,10,62,39,23,68
SC Rheindorf,820,3,19,10,7,59,43,16,67
Vienna,820,4,20,3,13,64,50,14,63
Rapid Vienna,820,5,13,13,10,52,39,13,52
SV Josko Rie,820,6,11,5,20,41,55,-14,38
Mattersburg,820,7,10,7,19,40,56,-16,37
RZ Pellets W,820,8,10,6,20,42,62,-20,36
Admira Wacke,820,9,10,5,21,39,67,-28,35
St. Pölten,820,10,8,10,18,40,66,-26,34
FC Salzburg,821,1,23,7,6,66,26,40,76
SC Rheindorf,821,2,19,10,7,51,37,14,67
Vienna,821,3,19,6,11,73,54,19,63
SK Sturm Gra,821,4,15,7,14,50,39,11,52
Rapid Vienna,821,5,13,11,12,52,40,12,50
Admira Wacke,821,6,12,7,17,39,57,-18,43
RZ Pellets W,821,7,10,8,18,41,61,-20,38
SV Josko Rie,821,8,10,7,19,35,56,-21,37
Mattersburg,821,9,8,12,16,38,55,-17,36
St. Pölten,821,10,7,13,16,37,57,-20,34
SC Rheindorf,822,1,22,8,6,62,40,22,74
FC Salzburg,822,2,19,6,11,66,39,27,63
SK Sturm Gra,822,3,17,8,11,59,35,24,59
Vienna,822,4,18,4,14,60,54,6,58
Rapid Vienna,822,5,13,12,11,57,44,13,51
RZ Pellets W,822,6,14,8,14,51,53,-2,50
Admira Wacke,822,7,12,5,19,37,62,-25,41
Mattersburg,822,8,9,10,17,36,60,-24,37
SV Josko Rie,822,9,10,5,21,36,53,-17,35
St. Pölten,822,10,9,8,19,46,70,-24,35
FC Salzburg,823,1,21,8,7,70,37,33,71
SC Rheindorf,823,2,20,7,9,62,47,15,67
SK Sturm Gra,823,3,19,7,10,57,28,29,64
Vienna,823,4,18,3,15,61,55,6,57
Rapid Vienna,823,5,14,12,10,53,38,15,54
Admira Wacke,823,6,12,8,16,36,54,-18,44
SV Josko Rie,823,7,11,5,20,36,52,-16,38
RZ Pellets W,823,8,9,9,18,38,58,-20,36
St. Pölten,823,9,9,9,18,39,67,-28,36
Mattersburg,823,10,8,10,18,43,59,-16,34
FC Salzburg,824,1,19,9,8,64,30,34,66
SK Sturm Gra,824,2,20,6,10,63,35,28,66
SC Rheindorf,824,3,19,9,8,54,45,9,66
Vienna,824,4,16,6,14,68,66,2,54
Rapid Vienna,824,5,11,14,11,52,41,11,47
RZ Pellets W,824,6,13,6,17,48,63,-15,45
Mattersburg,824,7,11,11,14,52,51,1,44
Admira Wacke,824,8,12,7,17,37,54,-17,43
SV Josko Rie,824,9,10,5,21,35,58,-23,35
St. Pölten,824,10,6,13,17,42,72,-30,31
FC Salzburg,825,1,23,7,6,68,25,43,76
SC Rheindorf,825,2,20,10,6,55,39,16,70
SK Sturm Gra,825,3,18,8,10,64,41,23,62
Vienna,825,4,19,3,14,59,52,7,60
St. Pölten,825,5,11,12,13,45,54,-9,45
Rapid Vienna,825,6,11,11,14,52,51,1,44
SV Josko Rie,825,7,11,7,18,33,50,-17,40
Admira Wacke,825,8,11,7,18,34,53,-19,40
Mattersburg,825,9,8,8,20,35,54,-19,32
RZ Pellets W,825,10,8,7,21,42,68,-26,31
Vienna,826,1,24,4,8,78,45,33,76
FC Salzburg,826,2,21,6,9,68,31,37,69
SK Sturm Gra,826,3,21,6,9,64,37,27,69
SC Rheindorf,826,4,17,7,12,49,51,-2,58
Rapid Vienna,826,5,13,12,11,51,40,11,51
RZ Pellets W,826,6,13,8,15,52,52,0,47
SV Josko Rie,826,7,10,8,18,35,52,-17,38
Mattersburg,826,8,8,9,19,33,56,-23,33
Admira Wacke,826,9,9,6,21,34,63,-29,33
St. Pölten,826,10,6,10,20,30,67,-37,28
SC Rheindorf,827,1,20,7,9,55,35,20,67
SK Sturm Gra,827,2,19,8,9,57,32,25,65
FC Salzburg,827,3,19,6,11,55,32,23,63
Vienna,827,4,17,7,12,53,45,8,58
Rapid Vienna,827,5,15,9,12,52,37,15,54
RZ Pellets W,827,6,12,10,14,42,49,-7,46
Admira Wacke,827,7,9,13,14,33,52,-19,40
St. Pölten,827,8,8,12,16,40,61,-21,36
Mattersburg,827,9,9,8,19,35,55,-20,35
SV Josko Rie,827,10,8,8,20,28,52,-24,32
SC Rheindorf,828,1,21,6,9,55,41,14,69
FC Salzburg,828,2,20,8,8,63,32,31,68
SK Sturm Gra,828,3,20,6,10,57,30,27,66
Vienna,828,4,18,7,11,67,48,19,61
Rapid Vienna,828,5,13,11,12,49,39,10,50
RZ Pellets W,828,6,13,6,17,38,52,-14,45
Mattersburg,828,7,10,10,16,46,52,-6,40
SV Josko Rie,828,8,10,5,21,36,57,-21,35
Admira Wacke,828,9,8,10,18,34,64,-30,34
St. Pölten,828,10,7,11,18,37,67,-30,32
FC Salzburg,829,1,25,4,7,79,31,48,79
Vienna,829,2,21,5,10,74,51,23,68
SK Sturm Gra,829,3,19,8,9,61,39,22,65
SC Rheindorf,829,4,20,5,11,56,41,15,65
Admira Wacke,829,5,13,7,16,41,61,-20,46
Rapid Vienna,829,6,12,9,15,50,45,5,45
RZ Pellets W,829,7,12,6,18,51,65,-14,42
Mattersburg,829,8,9,6,21,41,64,-23,33
St. Pölten,829,9,9,6,21,39,67,-28,33
SV Josko Rie,829,10,9,6,21,29,57,-28,33
FC Salzburg,830,1,23,7,6,64,26,38,76
SC Rheindorf,830,2,20,7,9,58,41,17,67
SK Sturm Gra,830,3,19,7,10,56,34,22,64
Vienna,830,4,19,4,13,69,60,9,61
Rapid Vienna,830,5,16,9,11,55,39,16,57
SV Josko Rie,830,6,12,5,19,32,47,-15,41
St. Pölten,830,7,9,11,16,45,61,-16,38
RZ Pellets W,830,8,11,5,20,44,63,-19,38
Admira Wacke,830,9,10,6,20,30,58,-28,36
Mattersburg,830,10,7,7,22,32,56,-24,28
FC Salzburg,831,1,23,7,6,68,28,40,76
Vienna,831,2,20,5,11,59,41,18,65
SK Sturm Gra,831,3,20,4,12,52,32,20,64
SC Rheindorf,831,4,18,7,11,52,45,7,61
Rapid Vienna,831,5,15,9,12,58,43,15,54
Mattersburg,831,6,12,5,19,42,58,-16,41
Admira Wacke,831,7,12,4,20,37,60,-23,40
RZ Pellets W,831,8,10,8,18,41,57,-16,38
St. Pölten,831,9,10,8,18,40,58,-18,38
SV Josko Rie,831,10,9,5,22,28,55,-27,32
FC Salzburg,832,1,21,9,6,67,28,39,72
SK Sturm Gra,832,2,19,4,13,63,39,24,61
SC Rheindorf,832,3,18,7,11,52,47,5,61
Rapid Vienna,832,4,15,11,10,56,41,15,56
Vienna,832,5,15,8,13,55,54,1,53
Mattersburg,832,6,12,10,14,45,51,-6,46
RZ Pellets W,832,7,12,10,14,52,61,-9,46
St. Pölten,832,8,10,8,18,43,61,-18,38
Admira Wacke,832,9,9,7,20,38,65,-27,34
SV Josko Rie,832,10,9,6,21,34,58,-24,33
FC Salzburg,833,1,21,8,7,71,35,36,71
SC Rheindorf,833,2,19,8,9,54,39,15,65
Vienna,833,3,19,4,13,66,46,20,61
Rapid Vienna,833,4,16,12,8,60,40,20,60
SK Sturm Gra,833,5,17,6,13,52,39,13,57
RZ Pellets W,833,6,13,7,16,47,60,-13,46
SV Josko Rie,833,7,12,4,20,35,61,-26,40
St. Pölten,833,8,9,10,17,40,63,-23,37
Mattersburg,833,9,9,8,19,39,51,-12,35
Admira Wacke,833,10,8,7,21,31,61,-30,31
FC Salzburg,834,1,21,7,8,65,34,31,70
Vienna,834,2,19,7,10,68,51,17,64
Rapid Vienna,834,3,17,12,7,65,38,27,63
SK Sturm Gra,834,4,17,7,12,53,41,12,58
SC Rheindorf,834,5,16,10,10,53,46,7,58
RZ Pellets W,834,6,12,8,16,43,58,-15,44
Mattersburg,834,7,10,9,17,42,54,-12,39
Admira Wacke,834,8,9,9,18,34,55,-21,36
St. Pölten,834,9,8,11,17,41,61,-20,35
SV Josko Rie,834,10,9,4,23,30,56,-26,31
FC Salzburg,835,1,23,6,7,67,25,42,75
SK Sturm Gra,835,2,21,6,9,59,29,30,69
SC Rheindorf,835,3,20,8,8,54,44,10,68
Vienna,835,4,19,2,15,62,57,5,59
Admira Wacke,835,5,15,4,17,41,57,-16,49
RZ Pellets W,835,6,13,8,15,49,52,-3,47
SV Josko Rie,835,7,13,4,19,36,51,-15,43
Rapid Vienna,835,8,9,10,17,43,49,-6,37
Mattersburg,835,9,10,6,20,42,54,-12,36
St. Pölten,835,10,6,8,22,38,73,-35,26
FC Salzburg,836,1,21,8,7,62,29,33,71
SC Rheindorf,836,2,20,6,10,55,44,11,66
SK Sturm Gra,836,3,19,7,10,64,35,29,64
Vienna,836,4,17,7,12,61,51,10,58
Mattersburg,836,5,13,9,14,42,46,-4,48
RZ Pellets W,836,6,13,8,15,44,50,-6,47
Rapid Vienna,836,7,11,12,13,56,48,8,45
Admira Wacke,836,8,11,4,21,36,66,-30,37
SV Josko Rie,836,9,10,6,20,35,57,-22,36
St. Pölten,836,10,7,9,20,41,70,-29,30
FC Salzburg,837,1,21,7,8,65,33,32,70
SK Sturm Gra,837,2,20,8,8,66,32,34,68
SC Rheindorf,837,3,19,8,9,55,40,15,65
Rapid Vienna,837,4,16,9,11,65,44,21,57
Vienna,837,5,16,8,12,56,51,5,56
RZ Pellets W,837,6,12,10,14,43,47,-4,46
SV Josko Rie,837,7,12,6,18,39,50,-11,42
Admira Wacke,837,8,9,7,20,32,61,-29,34
St. Pölten,837,9,7,10,19,36,66,-30,31
Mattersburg,837,10,7,9,20,34,67,-33,30
SK Sturm Gra,838,1,23,7,6,62,26,36,76
FC Salzburg,838,2,20,7,9,60,32,28,67
SC Rheindorf,838,3,18,9,9,55,44,11,63
Vienna,838,4,17,4,15,56,51,5,55
RZ Pellets W,838,5,12,10,14,50,52,-2,46
Rapid Vienna,838,6,11,10,15,55,50,5,43
Admira Wacke,838,7,11,7,18,43,60,-17,40
SV Josko Rie,838,8,12,3,21,33,56,-23,39
Mattersburg,838,9,10,8,18,37,58,-21,38
St. Pölten,838,10,8,11,17,42,64,-22,35
FC Salzburg,839,1,20,6,10,60,31,29,66
SK Sturm Gra,839,2,18,7,11,57,36,21,61
SC Rheindorf,839,3,18,7,11,51,43,8,61
Vienna,839,4,18,5,13,62,56,6,59
Rapid Vienna,839,5,15,13,8,55,37,18,58
SV Josko Rie,839,6,13,5,18,39,55,-16,44
RZ Pellets W,839,7,12,7,17,43,55,-12,43
Admira Wacke,839,8,12,4,20,39,57,-18,40
St. Pölten,839,9,9,12,15,44,60,-16,39
Mattersburg,839,10,9,6,21,37,57,-20,33
Vienna,840,1,20,7,9,63,44,19,67
SC Rheindorf,840,2,19,10,7,50,32,18,67
FC Salzburg,840,3,18,11,7,56,28,28,65
SK Sturm Gra,840,4,19,7,10,59,33,26,64
Rapid Vienna,840,5,11,13,12,51,43,8,46
Admira Wacke,840,6,12,5,19,36,58,-22,41
Mattersburg,840,7,10,9,17,41,58,-17,39
St. Pölten,840,8,9,11,16,42,61,-19,38
SV Josko Rie,840,9,9,8,19,31,52,-21,35
RZ Pellets W,840,10,8,9,19,43,63,-20,33
SC Rheindorf,841,1,21,7,8,65,42,23,70
FC Salzburg,841,2,20,8,8,63,24,39,68
Rapid Vienna,841,3,17,10,9,58,33,25,61
SK Sturm Gra,841,4,18,7,11,55,36,19,61
Vienna,841,5,17,7,12,57,56,1,58
SV Josko Rie,841,6,11,8,17,37,57,-20,41
Admira Wacke,841,7,10,9,17,35,55,-20,39
St. Pölten,841,8,9,10,17,41,64,-23,37
RZ Pellets W,841,9,8,9,19,38,60,-22,33
Mattersburg,841,10,7,9,20,33,55,-22,30
FC Salzburg,842,1,21,7,8,65,33,32,70
SC Rheindorf,842,2,21,7,8,62,42,20,70
SK Sturm Gra,842,3,19,6,11,60,35,25,63
Vienna,842,4,20,3,13,69,54,15,63
RZ Pellets W,842,5,15,5,16,53,54,-1,50
Rapid Vienna,842,6,12,11,13,54,47,7,47
SV Josko Rie,842,7,12,5,19,37,58,-21,41
Admira Wacke,842,8,11,8,17,33,54,-21,41
Mattersburg,842,9,7,9,20,35,60,-25,30
St. Pölten,842,10,7,9,20,35,66,-31,30
FC Salzburg,843,1,23,7,6,70,30,40,76
SC Rheindorf,843,2,20,10,6,61,37,24,70
SK Sturm Gra,843,3,20,3,13,65,41,24,63
Vienna,843,4,17,8,11,66,49,17,59
RZ Pellets W,843,5,14,7,15,49,48,1,49
Admira Wacke,843,6,13,5,18,35,61,-26,44
Rapid Vienna,843,7,10,10,16,48,47,1,40
Mattersburg,843,8,11,7,18,35,56,-21,40
SV Josko Rie,843,9,10,4,22,30,57,-27,34
St. Pölten,843,10,7,9,20,39,72,-33,30
FC Salzburg,844,1,22,7,7,65,32,33,73
SC Rheindorf,844,2,19,10,7,59,38,21,67
Rapid Vienna,844,3,17,8,11,55,34,21,59
SK Sturm Gra,844,4,17,6,13,52,37,15,57
Vienna,844,5,16,6,14,58,57,1,54
SV Josko Rie,844,6,13,5,18,39,55,-16,44
RZ Pellets W,844,7,11,8,17,43,57,-14,41
Admira Wacke,844,8,12,4,20,42,59,-17,40
Mattersburg,844,9,9,10,17,42,52,-10,37
St. Pölten,844,10,6,12,18,39,73,-34,30
FC Salzburg,845,1,23,8,5,76,32,44,77
Vienna,845,2,20,6,10,65,48,17,66
Rapid Vienna,845,3,18,7,11,71,42,29,61
SC Rheindorf,845,4,18,7,11,49,41,8,61
SK Sturm Gra,845,5,18,6,12,55,38,17,60
RZ Pellets W,845,6,15,6,15,49,55,-6,51
St. Pölten,845,7,9,9,18,36,57,-21,36
Admira Wacke,845,8,10,6,20,34,63,-29,36
SV Josko Rie,845,9,10,4,22,32,58,-26,34
Mattersburg,845,10,5,9,22,30,63,-33,24
FC Salzburg,846,1,22,6,8,61,28,33,72
SK Sturm Gra,846,2,18,7,11,58,41,17,61
Vienna,846,3,17,8,11,66,56,10,59
Rapid Vienna,846,4,14,11,11,58,40,18,53
SC Rheindorf,846,5,16,5,15,52,50,2,53
RZ Pellets W,846,6,13,10,13,42,48,-6,49
Admira Wacke,846,7,13,9,14,44,55,-11,48
Mattersburg,846,8,10,8,18,40,58,-18,38
SV Josko Rie,846,9,11,5,20,40,59,-19,38
St. Pölten,846,10,7,9,20,39,65,-26,30
SC Rheindorf,847,1,23,7,6,60,38,22,76
FC Salzburg,847,2,19,8,9,66,35,31,65
SK Sturm Gra,847,3,18,5,13,54,38,16,59
Vienna,847,4,17,6,13,58,55,3,57
Rapid Vienna,847,5,12,12,12,50,43,7,48
RZ Pellets W,847,6,12,9,15,51,57,-6,45
SV Josko Rie,847,7,13,6,17,44,51,-7,45
Admira Wacke,847,8,11,5,20,41,65,-24,38
Mattersburg,847,9,9,8,19,42,60,-18,35
St. Pölten,847,10,7,12,17,41,65,-24,33
FC Salzburg,848,1,23,6,7,80,33,47,75
SK Sturm Gra,848,2,23,4,9,67,33,34,73
SC Rheindorf,848,3,20,5,11,53,43,10,65
Rapid Vienna,848,4,15,9,12,53,37,16,54
Vienna,848,5,16,3,17,59,66,-7,51
Admira Wacke,848,6,13,7,16,43,64,-21,46
RZ Pellets W,848,7,11,6,19,44,62,-18,39
St. Pölten,848,7,10,9,17,44,62,-18,39
SV Josko Rie,848,9,11,5,20,37,58,-21,38
Mattersburg,848,10,7,8,21,44,66,-22,29
FC Salzburg,849,1,21,8,7,67,35,32,71
SC Rheindorf,849,2,20,10,6,57,38,19,70
Vienna,849,3,17,9,10,59,47,12,60
SK Sturm Gra,849,4,15,8,13,56,43,13,53
Rapid Vienna,849,5,13,12,11,51,44,7,51
Admira Wacke,849,6,14,9,13,43,45,-2,51
RZ Pellets W,849,7,10,10,16,45,56,-11,40
St. Pölten,849,8,8,12,16,37,55,-18,36
SV Josko Rie,849,9,9,8,19,34,60,-26,35
Mattersburg,849,10,5,10,21,35,61,-26,25
SK Sturm Gra,850,1,23,4,9,63,32,31,73
FC Salzburg,850,2,21,6,9,64,34,30,69
SC Rheindorf,850,3,20,9,7,58,38,20,69
Vienna,850,4,20,5,11,66,53,13,65
Rapid Vienna,850,5,12,9,15,50,44,6,45
RZ Pellets W,850,6,13,5,18,54,65,-11,44
St. Pölten,850,7,10,8,18,43,68,-25,38
Mattersburg,850,8,10,6,20,44,60,-16,36
SV Josko Rie,850,9,10,5,21,35,57,-22,35
Admira Wacke,850,10,8,9,19,35,61,-26,33
FC Salzburg,851,1,23,8,5,69,30,39,77
SK Sturm Gra,851,2,22,5,9,69,38,31,71
SC Rheindorf,851,3,18,9,9,56,40,16,63
Vienna,851,4,17,5,14,57,49,8,56
Rapid Vienna,851,5,13,10,13,56,45,11,49
Admira Wacke,851,6,14,6,16,38,55,-17,48
RZ Pellets W,851,7,11,8,17,48,59,-11,41
Mattersburg,851,8,11,8,17,45,56,-11,41
St. Pölten,851,9,8,9,19,40,69,-29,33
SV Josko Rie,851,10,7,4,25,29,66,-37,25
SK Sturm Gra,852,1,23,6,7,64,28,36,75
SC Rheindorf,852,2,23,6,7,67,40,27,75
FC Salzburg,852,3,20,11,5,69,30,39,71
RZ Pellets W,852,4,15,7,14,57,59,-2,52
Rapid Vienna,852,5,14,9,13,51,39,12,51
Vienna,852,6,15,5,16,57,60,-3,50
Admira Wacke,852,7,10,7,19,44,69,-25,37
SV Josko Rie,852,8,10,4,22,40,62,-22,34
St. Pölten,852,9,8,8,20,40,71,-31,32
Mattersburg,852,10,7,7,22,39,70,-31,28
FC Salzburg,853,1,21,6,9,63,32,31,69
SK Sturm Gra,853,2,20,5,11,62,39,23,65
Vienna,853,3,19,6,11,57,43,14,63
SC Rheindorf,853,4,17,9,10,49,40,9,60
Rapid Vienna,853,5,17,8,11,66,42,24,59
RZ Pellets W,853,6,13,8,15,45,54,-9,47
SV Josko Rie,853,7,12,3,21,35,50,-15,39
St. Pölten,853,8,9,10,17,38,61,-23,37
Admira Wacke,853,9,11,4,21,35,66,-31,37
Mattersburg,853,10,7,9,20,34,57,-23,30
FC Salzburg,854,1,20,9,7,67,31,36,69
Vienna,854,2,20,4,12,77,60,17,64
SC Rheindorf,854,3,19,6,11,59,50,9,63
SK Sturm Gra,854,4,17,7,12,55,35,20,58
Rapid Vienna,854,5,13,13,10,53,45,8,52
Admira Wacke,854,6,11,10,15,43,61,-18,43
RZ Pellets W,854,7,11,9,16,47,53,-6,42
St. Pölten,854,8,8,14,14,40,57,-17,38
SV Josko Rie,854,9,9,10,17,33,52,-19,37
Mattersburg,854,10,7,8,21,31,61,-30,29
SC Rheindorf,855,1,21,8,7,53,36,17,71
FC Salzburg,855,2,18,8,10,60,31,29,62
SK Sturm Gra,855,3,18,8,10,54,32,22,62
Vienna,855,4,18,4,14,55,52,3,58
Rapid Vienna,855,5,14,12,10,54,37,17,54
Admira Wacke,855,6,13,8,15,39,53,-14,47
RZ Pellets W,855,7,10,10,16,35,49,-14,40
Mattersburg,855,8,9,11,16,36,50,-14,38
St. Pölten,855,9,6,14,16,35,58,-23,32
SV Josko Rie,855,10,9,5,22,33,56,-23,32
SK Sturm Gra,856,1,22,5,9,61,31,30,71
FC Salzburg,856,2,20,9,7,62,28,34,69
SC Rheindorf,856,3,19,8,9,54,38,16,65
Vienna,856,4,18,8,10,69,55,14,62
Rapid Vienna,856,5,15,10,11,61,42,19,55
RZ Pellets W,856,6,12,8,16,46,54,-8,44
Admira Wacke,856,7,12,6,18,40,58,-18,42
SV Josko Rie,856,8,8,8,20,33,54,-21,32
Mattersburg,856,9,8,8,20,36,62,-26,32
St. Pölten,856,10,7,8,21,33,73,-40,29
FC Salzburg,857,1,23,6,7,73,27,46,75
SC Rheindorf,857,2,23,4,9,60,38,22,73
SK Sturm Gra,857,3,17,8,11,51,36,15,59
Vienna,857,4,17,6,13,63,57,6,57
Rapid Vienna,857,5,13,9,14,47,39,8,48
SV Josko Rie,857,6,13,6,17,38,51,-13,45
RZ Pellets W,857,7,12,8,16,42,49,-7,44
St. Pölten,857,8,10,6,20,39,65,-26,36
Mattersburg,857,9,9,8,19,34,56,-22,35
Admira Wacke,857,10,8,9,19,34,63,-29,33
FC Salzburg,858,1,20,7,9,66,31,35,67
SK Sturm Gra,858,2,19,9,8,62,36,26,66
Vienna,858,3,20,4,12,61,43,18,64
SC Rheindorf,858,4,18,7,11,56,44,12,61
Rapid Vienna,858,5,14,11,11,56,42,14,53
SV Josko Rie,858,6,15,4,17,42,54,-12,49
RZ Pellets W,858,7,13,5,18,51,62,-11,44
St. Pölten,858,8,10,8,18,44,66,-22,38
Admira Wacke,858,9,11,5,20,35,64,-29,38
Mattersburg,858,10,7,6,23,33,64,-31,27
FC Salzburg,859,1,23,7,6,65,27,38,76
SK Sturm Gra,859,2,21,4,11,62,32,30,67
Vienna,859,3,19,4,13,60,51,9,61
SC Rheindorf,859,4,17,7,12,56,54,2,58
Rapid Vienna,859,5,14,10,12,62,42,20,52
RZ Pellets W,859,6,14,5,17,51,56,-5,47
Admira Wacke,859,7,12,8,16,40,56,-16,44
SV Josko Rie,859,8,12,4,20,37,58,-21,40
St. Pölten,859,9,9,8,19,43,69,-26,35
Mattersburg,859,10,7,7,22,29,60,-31,28
SC Rheindorf,860,1,21,8,7,60,42,18,71
Vienna,860,2,20,4,12,67,47,20,64
FC Salzburg,860,3,18,7,11,60,35,25,61
Rapid Vienna,860,4,16,11,9,54,36,18,59
SK Sturm Gra,860,5,17,7,12,52,38,14,58
RZ Pellets W,860,6,14,7,15,49,55,-6,49
St. Pölten,860,7,10,10,16,47,64,-17,40
Admira Wacke,860,8,11,7,18,35,61,-26,40
Mattersburg,860,9,8,7,21,34,56,-22,31
SV Josko Rie,860,10,9,4,23,31,55,-24,31
SC Rheindorf,861,1,22,6,8,52,35,17,72
FC Salzburg,861,2,19,10,7,60,27,33,67
SK Sturm Gra,861,3,17,9,10,53,34,19,60
Rapid Vienna,861,4,13,14,9,55,35,20,53
Vienna,861,5,15,8,13,53,55,-2,53
Admira Wacke,861,6,12,9,15,44,63,-19,45
RZ Pellets W,861,7,11,9,16,44,53,-9,42
Mattersburg,861,8,10,7,19,35,53,-18,37
SV Josko Rie,861,9,9,7,20,37,54,-17,34
St. Pölten,861,10,7,11,18,41,65,-24,32
FC Salzburg,862,1,20,10,6,59,27,32,70
Vienna,862,2,19,7,10,67,48,19,64
SC Rheindorf,862,3,18,10,8,54,40,14,64
SK Sturm Gra,862,4,18,7,11,63,40,23,61
RZ Pellets W,862,5,12,9,15,43,54,-11,45
Mattersburg,862,6,13,6,17,39,52,-13,45
Rapid Vienna,862,7,11,11,14,49,45,4,44
St. Pölten,862,8,9,10,17,42,58,-16,37
Admira Wacke,862,9,10,6,20,30,58,-28,36
SV Josko Rie,862,10,7,10,19,27,51,-24,31
SK Sturm Gra,863,1,20,8,8,65,32,33,68
Vienna,863,2,20,7,9,64,45,19,67
SC Rheindorf,863,3,19,8,9,55,46,9,65
FC Salzburg,863,4,18,8,10,67,40,27,62
Rapid Vienna,863,5,13,10,13,59,49,10,49
SV Josko Rie,863,6,12,6,18,39,51,-12,42
RZ Pellets W,863,7,12,6,18,41,54,-13,42
Admira Wacke,863,8,11,7,18,33,58,-25,40
Mattersburg,863,9,8,11,17,38,58,-20,35
St. Pölten,863,10,7,9,20,36,64,-28,30
FC Salzburg,864,1,19,9,8,65,29,36,66
SK Sturm Gra,864,2,20,6,10,57,33,24,66
Vienna,864,3,18,7,11,71,59,12,61
SC Rheindorf,864,4,15,9,12,53,51,2,54
Rapid Vienna,864,5,14,11,11,57,40,17,53
RZ Pellets W,864,6,15,8,13,49,50,-1,53
Admira Wacke,864,7,13,5,18,36,60,-24,44
Mattersburg,864,8,9,9,18,40,57,-17,36
St. Pölten,864,9,8,11,17,42,62,-20,35
SV Josko Rie,864,10,8,7,21,30,59,-29,31
FC Salzburg,865,1,22,8,6,62,28,34,74
SC Rheindorf,865,2,19,7,10,59,46,13,64
SK Sturm Gra,865,3,17,7,12,51,36,15,58
Vienna,865,4,18,3,15,62,56,6,57
Rapid Vienna,865,5,15,8,13,55,39,16,53
Admira Wacke,865,6,14,8,14,34,50,-16,50
RZ Pellets W,865,7,11,8,17,44,55,-11,41
St. Pölten,865,8,9,10,17,38,58,-20,37
SV Josko Rie,865,9,9,9,18,30,47,-17,36
Mattersburg,865,10,7,10,19,39,59,-20,31
FC Salzburg,866,1,21,10,5,68,28,40,73
SC Rheindorf,866,2,20,8,8,58,38,20,68
Vienna,866,3,19,5,12,65,54,11,62
SK Sturm Gra,866,4,17,9,10,54,35,19,60
Rapid Vienna,866,5,12,12,12,54,44,10,48
Admira Wacke,866,6,14,6,16,42,54,-12,48
RZ Pellets W,866,7,12,9,15,47,58,-11,45
St. Pölten,866,8,11,7,18,48,68,-20,40
Mattersburg,866,9,7,9,20,35,62,-27,30
SV Josko Rie,866,10,8,3,25,31,61,-30,27
FC Salzburg,867,1,20,9,7,66,29,37,69
SC Rheindorf,867,2,20,8,8,54,37,17,68
SK Sturm Gra,867,3,20,7,9,59,28,31,67
Vienna,867,4,17,6,13,57,53,4,57
Rapid Vienna,867,5,14,11,11,50,39,11,53
RZ Pellets W,867,6,15,5,16,50,52,-2,50
Admira Wacke,867,7,12,6,18,36,56,-20,42
SV Josko Rie,867,8,9,9,18,31,50,-19,36
St. Pölten,867,9,8,7,21,34,70,-36,31
Mattersburg,867,10,6,10,20,33,56,-23,28
FC Salzburg,868,1,21,8,7,64,30,34,71
SC Rheindorf,868,2,21,6,9,57,39,18,69
Vienna,868,3,20,5,11,69,52,17,65
SK Sturm Gra,868,4,16,8,12,57,36,21,56
Rapid Vienna,868,5,12,13,11,48,37,11,49
RZ Pellets W,868,6,12,8,16,42,53,-11,44
SV Josko Rie,868,7,11,5,20,35,53,-18,38
Admira Wacke,868,8,10,8,18,34,62,-28,38
St. Pölten,868,9,9,9,18,41,67,-26,36
Mattersburg,868,10,7,12,17,31,49,-18,33
SC Rheindorf,869,1,22,7,7,57,36,21,73
SK Sturm Gra,869,2,21,6,9,58,31,27,69
FC Salzburg,869,3,20,7,9,64,34,30,67
Vienna,869,4,16,7,13,59,57,2,55
Rapid Vienna,869,5,12,11,13,52,40,12,47
Admira Wacke,869,6,12,9,15,34,50,-16,45
RZ Pellets W,869,7,12,6,18,49,64,-15,42
SV Josko Rie,869,8,11,3,22,39,60,-21,36
Mattersburg,869,9,8,11,17,38,56,-18,35
St. Pölten,869,10,7,11,18,35,57,-22,32
FC Salzburg,870,1,23,5,8,70,34,36,74
SK Sturm Gra,870,2,20,6,10,62,33,29,66
SC Rheindorf,870,3,19,8,9,58,45,13,65
Vienna,870,4,19,6,11,65,52,13,63
Rapid Vienna,870,5,13,10,13,54,44,10,49
RZ Pellets W,870,6,13,7,16,47,55,-8,46
SV Josko Rie,870,7,12,4,20,32,52,-20,40
Admira Wacke,870,8,12,4,20,34,61,-27,40
St. Pölten,870,9,10,7,19,43,66,-23,37
Mattersburg,870,10,7,7,22,35,58,-23,28
FC Salzburg,871,1,24,7,5,70,24,46,79
SK Sturm Gra,871,2,20,6,10,63,33,30,66
SC Rheindorf,871,3,19,8,9,55,42,13,65
Vienna,871,4,18,7,11,59,53,6,61
Rapid Vienna,871,5,12,13,11,55,42,13,49
RZ Pellets W,871,6,11,9,16,49,58,-9,42
Admira Wacke,871,7,11,6,19,39,64,-25,39
Mattersburg,871,8,8,12,16,40,58,-18,36
St. Pölten,871,9,8,8,20,35,60,-25,32
SV Josko Rie,871,10,9,4,23,32,63,-31,31
FC Salzburg,872,1,24,5,7,64,29,35,77
Vienna,872,2,22,4,10,69,48,21,70
SK Sturm Gra,872,3,18,8,10,58,34,24,62
SC Rheindorf,872,4,18,5,13,54,50,4,59
Rapid Vienna,872,5,13,12,11,52,45,7,51
RZ Pellets W,872,6,13,8,15,49,57,-8,47
Admira Wacke,872,7,11,8,17,36,57,-21,41
SV Josko Rie,872,8,11,5,20,38,54,-16,38
St. Pölten,872,9,7,9,20,39,61,-22,30
Mattersburg,872,10,7,8,21,35,59,-24,29
FC Salzburg,873,1,23,7,6,70,30,40,76
SK Sturm Gra,873,2,22,5,9,63,29,34,71
SC Rheindorf,873,3,19,8,9,51,42,9,65
Rapid Vienna,873,4,15,10,11,57,41,16,55
Vienna,873,5,13,8,15,53,57,-4,47
RZ Pellets W,873,6,12,8,16,44,58,-14,44
Admira Wacke,873,7,12,8,16,41,57,-16,44
SV Josko Rie,873,8,11,6,19,34,47,-13,39
St. Pölten,873,9,6,12,18,38,64,-26,30
Mattersburg,873,10,7,8,21,32,58,-26,29
SC Rheindorf,874,1,23,7,6,57,37,20,76
FC Salzburg,874,2,19,9,8,63,34,29,66
SK Sturm Gra,874,3,18,9,9,53,32,21,63
Vienna,874,4,16,7,13,57,52,5,55
Rapid Vienna,874,5,13,11,12,56,41,15,50
RZ Pellets W,874,6,11,9,16,43,57,-14,42
Admira Wacke,874,7,11,6,19,39,55,-16,39
St. Pölten,874,8,9,12,15,37,58,-21,39
SV Josko Rie,874,9,11,3,22,29,48,-19,36
Mattersburg,874,10,8,9,19,38,58,-20,33
SK Sturm Gra,875,1,21,7,8,67,34,33,70
SC Rheindorf,875,2,20,8,8,60,45,15,68
FC Salzburg,875,3,18,10,8,65,40,25,64
Vienna,875,4,15,9,12,55,54,1,54
Rapid Vienna,875,5,13,13,10,57,43,14,52
RZ Pellets W,875,6,13,9,14,50,53,-3,48
SV Josko Rie,875,7,11,8,17,37,51,-14,41
Admira Wacke,875,8,11,6,19,46,69,-23,39
Mattersburg,875,9,7,10,19,38,58,-20,31
St. Pölten,875,10,5,12,19,39,67,-28,27
FC Salzburg,876,1,23,9,4,72,25,47,78
Vienna,876,2,21,4,11,68,53,15,67
SC Rheindorf,876,3,19,8,9,56,43,13,65
SK Sturm Gra,876,4,18,10,8,58,34,24,64
Rapid Vienna,876,5,14,11,11,57,44,13,53
RZ Pellets W,876,6,11,8,17,43,53,-10,41
SV Josko Rie,876,7,11,4,21,44,61,-17,37
Admira Wacke,876,8,10,6,20,37,68,-31,36
St. Pölten,876,9,9,8,19,40,66,-26,35
Mattersburg,876,10,6,8,22,34,62,-28,26
SC Rheindorf,877,1,21,9,6,56,33,23,72
FC Salzburg,877,2,18,12,6,65,32,33,66
SK Sturm Gra,877,3,17,8,11,55,36,19,59
Vienna,877,4,18,5,13,62,55,7,59
Rapid Vienna,877,5,16,8,12,62,40,22,56
SV Josko Rie,877,6,12,7,17,43,52,-9,43
RZ Pellets W,877,7,11,7,18,48,63,-15,40
St. Pölten,877,8,9,10,17,46,64,-18,37
Admira Wacke,877,9,10,7,19,37,69,-32,37
Mattersburg,877,10,7,9,20,43,73,-30,30
FC Salzburg,878,1,21,8,7,57,25,32,71
Vienna,878,2,21,6,9,72,49,23,69
SK Sturm Gra,878,3,20,5,11,62,39,23,65
SC Rheindorf,878,4,19,8,9,55,39,16,65
Rapid Vienna,878,5,12,10,14,46,39,7,46
SV Josko Rie,878,6,13,7,16,37,46,-9,46
RZ Pellets W,878,7,13,7,16,48,60,-12,46
St. Pölten,878,8,9,10,17,39,58,-19,37
Admira Wacke,878,9,8,7,21,38,70,-32,31
Mattersburg,878,10,6,8,22,35,64,-29,26
FC Salzburg,879,1,20,7,9,64,32,32,67
SK Sturm Gra,879,2,20,7,9,63,34,29,67
SC Rheindorf,879,3,18,6,12,56,44,12,60
Rapid Vienna,879,4,16,11,9,54,32,22,59
Vienna,879,5,16,7,13,57,55,2,55
RZ Pellets W,879,6,15,7,14,44,45,-1,52
Admira Wacke,879,7,12,8,16,36,50,-14,44
SV Josko Rie,879,8,10,7,19,32,54,-22,37
St. Pölten,879,9,6,12,18,37,68,-31,30
Mattersburg,879,10,5,12,19,30,59,-29,27
FC Salzburg,880,1,21,8,7,65,30,35,71
Vienna,880,2,19,7,10,59,43,16,64
SC Rheindorf,880,3,16,9,11,50,46,4,57
SK Sturm Gra,880,4,16,8,12,51,36,15,56
Rapid Vienna,880,5,12,15,9,53,37,16,51
Admira Wacke,880,6,12,11,13,40,50,-10,47
RZ Pellets W,880,7,10,11,15,43,56,-13,41
SV Josko Rie,880,8,11,7,18,37,53,-16,40
St. Pölten,880,9,8,10,18,36,60,-24,34
Mattersburg,880,10,5,14,17,27,50,-23,29
FC Salzburg,881,1,23,7,6,66,26,40,76
SK Sturm Gra,881,2,21,6,9,72,35,37,69
Vienna,881,3,19,5,12,60,51,9,62
Rapid Vienna,881,4,15,11,10,56,42,14,56
SC Rheindorf,881,5,16,8,12,47,39,8,56
Mattersburg,881,6,10,8,18,39,57,-18,38
RZ Pellets W,881,7,10,8,18,43,62,-19,38
SV Josko Rie,881,8,9,9,18,30,52,-22,36
Admira Wacke,881,9,10,6,20,33,58,-25,36
St. Pölten,881,10,9,8,19,42,66,-24,35
FC Salzburg,882,1,19,11,6,60,28,32,68
SC Rheindorf,882,2,18,11,7,60,43,17,65
Vienna,882,3,19,5,12,64,53,11,62
SK Sturm Gra,882,4,16,6,14,49,39,10,54
Rapid Vienna,882,5,13,13,10,51,35,16,52
RZ Pellets W,882,6,12,10,14,43,52,-9,46
Admira Wacke,882,7,11,13,12,38,52,-14,46
St. Pölten,882,8,9,12,15,38,52,-14,39
Mattersburg,882,9,7,9,20,34,56,-22,30
SV Josko Rie,882,10,8,6,22,29,56,-27,30
FC Salzburg,883,1,23,7,6,65,28,37,76
SK Sturm Gra,883,2,20,7,9,62,30,32,67
SC Rheindorf,883,3,20,7,9,57,45,12,67
Vienna,883,4,17,6,13,60,49,11,57
Rapid Vienna,883,5,13,12,11,49,41,8,51
RZ Pellets W,883,6,11,9,16,39,47,-8,42
Admira Wacke,883,7,11,7,18,37,59,-22,40
SV Josko Rie,883,8,10,6,20,37,60,-23,36
Mattersburg,883,9,8,10,18,43,64,-21,34
St. Pölten,883,10,7,9,20,40,66,-26,30
FC Salzburg,884,1,22,7,7,63,28,35,73
SK Sturm Gra,884,2,21,6,9,65,36,29,69
Vienna,884,3,20,4,12,60,47,13,64
SC Rheindorf,884,4,19,4,13,55,47,8,61
Rapid Vienna,884,5,12,13,11,47,35,12,49
Admira Wacke,884,6,13,6,17,37,58,-21,45
St. Pölten,884,7,10,10,16,44,66,-22,40
RZ Pellets W,884,8,10,6,20,43,59,-16,36
Mattersburg,884,9,9,9,18,40,56,-16,36
SV Josko Rie,884,10,9,5,22,32,54,-22,32
SC Rheindorf,885,1,19,7,10,59,41,18,64
Vienna,885,2,20,4,12,66,49,17,64
FC Salzburg,885,3,19,6,11,63,36,27,63
SK Sturm Gra,885,4,18,7,11,56,37,19,61
Admira Wacke,885,5,14,10,12,41,52,-11,52
Rapid Vienna,885,6,11,14,11,46,38,8,47
RZ Pellets W,885,7,11,9,16,47,59,-12,42
SV Josko Rie,885,8,11,7,18,36,54,-18,40
Mattersburg,885,9,9,7,20,43,66,-23,34
St. Pölten,885,10,8,9,19,37,62,-25,33
FC Salzburg,886,1,24,4,8,72,32,40,76
SK Sturm Gra,886,2,20,8,8,66,35,31,68
Vienna,886,3,18,8,10,59,48,11,62
Rapid Vienna,886,4,16,11,9,60,35,25,59
SC Rheindorf,886,5,17,7,12,53,46,7,58
RZ Pellets W,886,6,12,7,17,50,59,-9,43
SV Josko Rie,886,7,11,4,21,34,55,-21,37
Admira Wacke,886,8,10,7,19,36,66,-30,37
Mattersburg,886,9,8,8,20,39,66,-27,32
St. Pölten,886,9,8,8,20,39,66,-27,32
FC Salzburg,887,1,18,9,9,63,36,27,63
SK Sturm Gra,887,2,18,7,11,53,34,19,61
SC Rheindorf,887,3,17,9,10,49,41,8,60
Vienna,887,4,17,8,11,62,52,10,59
Admira Wacke,887,5,15,7,14,43,53,-10,52
Rapid Vienna,887,6,13,10,13,53,41,12,49
RZ Pellets W,887,7,12,9,15,45,54,-9,45
Mattersburg,887,8,11,10,15,37,49,-12,43
SV Josko Rie,887,9,11,5,20,35,50,-15,38
St. Pölten,887,10,5,12,19,33,63,-30,27
FC Salzburg,888,1,20,9,7,66,34,32,69
SK Sturm Gra,888,2,18,7,11,58,35,23,61
SC Rheindorf,888,3,18,7,11,58,48,10,61
Vienna,888,4,17,8,11,65,54,11,59
Rapid Vienna,888,5,16,10,10,67,41,26,58
Admira Wacke,888,6,13,7,16,49,66,-17,46
St. Pölten,888,7,11,9,16,47,65,-18,42
RZ Pellets W,888,8,9,9,18,39,60,-21,36
Mattersburg,888,9,8,11,17,36,57,-21,35
SV Josko Rie,888,10,9,5,22,36,61,-25,32
SC Rheindorf,889,1,20,8,8,61,39,22,68
FC Salzburg,889,2,18,11,7,64,38,26,65
Vienna,889,3,17,5,14,60,58,2,56
SK Sturm Gra,889,4,15,8,13,52,41,11,53
RZ Pellets W,889,5,14,8,14,40,44,-4,50
Rapid Vienna,889,6,12,12,12,46,38,8,48
Admira Wacke,889,7,14,4,18,41,59,-18,46
SV Josko Rie,889,8,12,5,19,39,55,-16,41
St. Pölten,889,9,10,10,16,42,54,-12,40
Mattersburg,889,10,9,7,20,38,57,-19,34
FC Salzburg,890,1,20,8,8,65,32,33,68
SK Sturm Gra,890,2,19,9,8,63,32,31,66
SC Rheindorf,890,3,18,12,6,52,36,16,66
Vienna,890,4,17,7,12,56,50,6,58
Rapid Vienna,890,5,12,14,10,58,44,14,50
RZ Pellets W,890,6,12,8,16,40,53,-13,44
St. Pölten,890,7,10,11,15,41,60,-19,41
Mattersburg,890,8,9,12,15,41,51,-10,39
Admira Wacke,890,9,8,7,21,30,63,-33,31
SV Josko Rie,890,10,8,6,22,27,52,-25,30
FC Salzburg,891,1,18,12,6,55,28,27,66
SC Rheindorf,891,2,19,7,10,63,42,21,64
Vienna,891,3,19,7,10,64,51,13,64
SK Sturm Gra,891,4,17,10,9,52,33,19,61
Rapid Vienna,891,5,12,11,13,51,43,8,47
RZ Pellets W,891,6,12,10,14,47,51,-4,46
St. Pölten,891,7,10,11,15,44,60,-16,41
Admira Wacke,891,8,11,8,17,33,55,-22,41
SV Josko Rie,891,9,9,6,21,32,56,-24,33
Mattersburg,891,10,8,8,20,34,56,-22,32
FC Salzburg,892,1,22,7,7,63,30,33,73
SC Rheindorf,892,2,18,8,10,53,44,9,62
SK Sturm Gra,892,3,19,4,13,61,40,21,61
Rapid Vienna,892,4,17,9,10,58,34,24,60
Vienna,892,5,18,5,13,64,55,9,59
St. Pölten,892,6,11,9,16,41,63,-22,42
RZ Pellets W,892,7,12,5,19,51,61,-10,41
Mattersburg,892,8,10,8,18,39,57,-18,38
Admira Wacke,892,9,11,4,21,39,66,-27,37
SV Josko Rie,892,10,10,5,21,34,53,-19,35
SC Rheindorf,893,1,21,8,7,65,43,22,71
FC Salzburg,893,2,19,9,8,64,36,28,66
Rapid Vienna,893,3,16,10,10,56,38,18,58
SK Sturm Gra,893,4,16,10,10,55,40,15,58
RZ Pellets W,893,5,17,6,13,57,48,9,57
Vienna,893,6,16,5,15,59,57,2,53
Admira Wacke,893,7,12,5,19,44,60,-16,41
Mattersburg,893,8,10,8,18,37,53,-16,38
SV Josko Rie,893,9,9,5,22,38,65,-27,32
St. Pölten,893,10,6,10,20,37,72,-35,28
FC Salzburg,894,1,22,9,5,66,27,39,75
SC Rheindorf,894,2,19,9,8,61,46,15,66
Rapid Vienna,894,3,17,9,10,57,38,19,60
Vienna,894,4,18,6,12,69,56,13,60
SK Sturm Gra,894,5,15,10,11,52,34,18,55
RZ Pellets W,894,6,12,11,13,46,50,-4,47
SV Josko Rie,894,7,10,5,21,37,62,-25,35
Admira Wacke,894,8,9,7,20,35,63,-28,34
Mattersburg,894,9,8,9,19,41,62,-21,33
St. Pölten,894,10,8,9,19,40,66,-26,33
FC Salzburg,895,1,22,6,8,68,31,37,72
SC Rheindorf,895,2,20,7,9,57,47,10,67
Vienna,895,3,19,6,11,67,54,13,63
SK Sturm Gra,895,4,17,9,10,58,41,17,60
Rapid Vienna,895,5,12,12,12,56,46,10,48
RZ Pellets W,895,6,12,9,15,43,50,-7,45
Mattersburg,895,7,10,8,18,40,59,-19,38
St. Pölten,895,8,9,10,17,47,58,-11,37
Admira Wacke,895,9,10,7,19,33,57,-24,37
SV Josko Rie,895,10,10,4,22,32,58,-26,34
FC Salzburg,896,1,22,7,7,66,28,38,73
SC Rheindorf,896,2,20,9,7,57,37,20,69
SK Sturm Gra,896,3,21,4,11,63,34,29,67
Vienna,896,4,17,7,12,64,49,15,58
Rapid Vienna,896,5,12,11,13,51,45,6,47
Mattersburg,896,6,12,8,16,41,54,-13,44
Admira Wacke,896,7,12,5,19,36,61,-25,41
RZ Pellets W,896,8,9,8,19,38,58,-20,35
St. Pölten,896,9,8,10,18,40,65,-25,34
SV Josko Rie,896,10,8,9,19,31,56,-25,33
FC Salzburg,897,1,23,8,5,77,31,46,77
SK Sturm Gra,897,2,22,8,6,59,27,32,74
SC Rheindorf,897,3,16,12,8,48,42,6,60
Rapid Vienna,897,4,13,12,11,51,36,15,51
Vienna,897,5,13,9,14,61,60,1,48
RZ Pellets W,897,6,14,6,16,48,53,-5,48
Admira Wacke,897,7,10,10,16,36,58,-22,40
St. Pölten,897,8,9,9,18,42,67,-25,36
Mattersburg,897,9,7,10,19,33,55,-22,31
SV Josko Rie,897,10,7,8,21,34,60,-26,29
SC Rheindorf,898,1,23,5,8,59,38,21,74
FC Salzburg,898,2,21,4,11,65,40,25,67
SK Sturm Gra,898,3,20,6,10,58,40,18,66
Vienna,898,4,21,2,13,65,51,14,65
RZ Pellets W,898,5,16,4,16,48,50,-2,52
Rapid Vienna,898,6,14,9,13,61,43,18,51
St. Pölten,898,7,9,11,16,48,63,-15,38
SV Josko Rie,898,8,10,7,19,38,56,-18,37
Admira Wacke,898,9,9,5,22,37,72,-35,32
Mattersburg,898,10,7,7,22,30,56,-26,28
FC Salzburg,899,1,25,5,6,62,24,38,80
SK Sturm Gra,899,2,21,6,9,66,34,32,69
SC Rheindorf,899,3,20,8,8,53,42,11,68
Vienna,899,4,19,4,13,64,48,16,61
Rapid Vienna,899,5,13,11,12,50,41,9,50
RZ Pellets W,899,6,14,5,17,50,48,2,47
Admira Wacke,899,7,11,6,19,31,56,-25,39
St. Pölten,899,8,9,8,19,39,60,-21,35
SV Josko Rie,899,9,9,6,21,28,54,-26,33
Mattersburg,899,10,5,9,22,27,63,-36,24
SC Rheindorf,900,1,22,7,7,65,40,25,73
FC Salzburg,900,2,20,6,10,63,28,35,66
Vienna,900,3,20,5,11,59,55,4,65
SK Sturm Gra,900,4,16,10,10,64,41,23,58
Rapid Vienna,900,5,10,16,10,49,41,8,46
St. Pölten,900,6,12,7,17,44,61,-17,43
Admira Wacke,900,7,11,8,17,36,59,-23,41
RZ Pellets W,900,8,10,9,17,45,55,-10,39
SV Josko Rie,900,9,10,6,20,34,49,-15,36
Mattersburg,900,10,8,8,20,33,63,-30,32
FC Salzburg,901,1,20,10,6,67,33,34,70
SK Sturm Gra,901,2,19,7,10,63,32,31,64
SC Rheindorf,901,3,18,10,8,56,44,12,64
Vienna,901,4,15,8,13,61,63,-2,53
Rapid Vienna,901,5,13,11,12,51,39,12,50
SV Josko Rie,901,6,11,9,16,35,47,-12,42
RZ Pellets W,901,7,10,12,14,42,55,-13,42
St. Pölten,901,8,10,10,16,43,60,-17,40
Mattersburg,901,9,7,13,16,34,51,-17,34
Admira Wacke,901,10,8,8,20,39,67,-28,32
FC Salzburg,902,1,20,11,5,64,29,35,71
SK Sturm Gra,902,2,20,5,11,68,41,27,65
SC Rheindorf,902,3,17,9,10,52,48,4,60
Vienna,902,4,17,8,11,65,56,9,59
Rapid Vienna,902,5,15,9,12,59,39,20,54
RZ Pellets W,902,6,14,8,14,51,52,-1,50
Admira Wacke,902,7,12,8,16,34,55,-21,44
Mattersburg,902,8,8,12,16,46,62,-16,36
St. Pölten,902,9,5,13,18,38,65,-27,28
SV Josko Rie,902,10,7,7,22,31,61,-30,28
FC Salzburg,903,1,21,6,9,65,35,30,69
Vienna,903,2,20,8,8,63,42,21,68
SK Sturm Gra,903,3,17,8,11,55,36,19,59
SC Rheindorf,903,4,18,5,13,54,52,2,59
Rapid Vienna,903,5,12,12,12,55,42,13,48
RZ Pellets W,903,6,12,11,13,46,51,-5,47
SV Josko Rie,903,7,10,8,18,36,54,-18,38
St. Pölten,903,8,10,8,18,42,63,-21,38
Admira Wacke,903,9,11,5,20,33,58,-25,38
Mattersburg,903,10,9,9,18,42,58,-16,36
FC Salzburg,904,1,20,9,7,60,25,35,69
SC Rheindorf,904,2,20,7,9,58,44,14,67
SK Sturm Gra,904,3,15,11,10,56,36,20,56
Vienna,904,4,16,6,14,58,56,2,54
Rapid Vienna,904,5,14,9,13,56,45,11,51
RZ Pellets W,904,6,14,5,17,48,61,-13,47
Mattersburg,904,7,12,7,17,46,56,-10,43
SV Josko Rie,904,8,11,6,19,32,48,-16,39
Admira Wacke,904,9,11,6,19,38,59,-21,39
St. Pölten,904,10,8,12,16,46,68,-22,36
FC Salzburg,905,1,21,7,8,74,35,39,70
SK Sturm Gra,905,2,19,7,10,59,31,28,64
SC Rheindorf,905,3,19,6,11,58,44,14,63
Vienna,905,4,18,7,11,70,58,12,61
Rapid Vienna,905,5,14,13,9,52,37,15,55
SV Josko Rie,905,6,13,6,17,40,52,-12,45
RZ Pellets W,905,7,10,7,19,46,61,-15,37
Admira Wacke,905,8,9,10,17,35,64,-29,37
St. Pölten,905,9,10,6,20,39,67,-28,36
Mattersburg,905,10,9,7,20,40,64,-24,34
SC Rheindorf,906,1,23,6,7,66,43,23,75
FC Salzburg,906,2,21,7,8,72,31,41,70
Vienna,906,3,18,5,13,57,52,5,59
Rapid Vienna,906,4,14,15,7,57,34,23,57
SK Sturm Gra,906,5,16,9,11,55,36,19,57
RZ Pellets W,906,6,14,7,15,50,54,-4,49
Admira Wacke,906,7,11,7,18,39,60,-21,40
SV Josko Rie,906,8,8,9,19,26,56,-30,33
Mattersburg,906,9,7,8,21,36,63,-27,29
St. Pölten,906,10,6,11,19,34,63,-29,29
SC Rheindorf,907,1,21,7,8,56,36,20,70
FC Salzburg,907,2,19,6,11,60,36,24,63
Vienna,907,3,17,10,9,59,49,10,61
SK Sturm Gra,907,4,17,6,13,56,38,18,57
Rapid Vienna,907,5,14,11,11,55,43,12,53
RZ Pellets W,907,6,11,9,16,43,55,-12,42
SV Josko Rie,907,7,12,3,21,39,55,-16,39
St. Pölten,907,8,9,12,15,39,58,-19,39
Admira Wacke,907,9,11,6,19,36,60,-24,39
Mattersburg,907,10,9,10,17,37,50,-13,37
FC Salzburg,908,1,22,8,6,63,25,38,74
SK Sturm Gra,908,2,20,7,9,57,29,28,67
SC Rheindorf,908,3,19,6,11,48,41,7,63
Vienna,908,4,18,5,13,65,53,12,59
Rapid Vienna,908,5,13,10,13,53,52,1,49
Admira Wacke,908,6,14,4,18,40,57,-17,46
RZ Pellets W,908,7,11,8,17,46,58,-12,41
St. Pölten,908,8,10,9,17,46,66,-20,39
Mattersburg,908,9,8,11,17,39,50,-11,35
SV Josko Rie,908,10,8,6,22,30,56,-26,30
SC Rheindorf,909,1,20,8,8,54,39,15,68
Vienna,909,2,20,6,10,64,47,17,66
SK Sturm Gra,909,3,19,7,10,60,29,31,64
FC Salzburg,909,4,18,9,9,69,36,33,63
Rapid Vienna,909,5,14,13,9,57,39,18,55
Admira Wacke,909,6,10,9,17,42,58,-16,39
SV Josko Rie,909,7,10,8,18,30,53,-23,38
RZ Pellets W,909,8,10,7,19,42,62,-20,37
St. Pölten,909,9,9,10,17,40,63,-23,37
Mattersburg,909,10,7,9,20,28,60,-32,30
SC Rheindorf,910,1,22,8,6,68,37,31,74
SK Sturm Gra,910,2,20,7,9,62,35,27,67
FC Salzburg,910,3,18,12,6,66,30,36,66
Vienna,910,4,17,7,12,61,53,8,58
Rapid Vienna,910,5,13,13,10,54,43,11,52
RZ Pellets W,910,6,13,7,16,45,53,-8,46
SV Josko Rie,910,7,11,7,18,37,57,-20,40
Admira Wacke,910,8,9,5,22,31,60,-29,32
St. Pölten,910,9,7,10,19,39,66,-27,31
Mattersburg,910,10,7,10,19,31,60,-29,31
FC Salzburg,911,1,22,5,9,65,35,30,71
Vienna,911,2,21,4,11,67,44,23,67
SK Sturm Gra,911,3,19,6,11,57,36,21,63
SC Rheindorf,911,4,18,8,10,50,44,6,62
Rapid Vienna,911,5,14,9,13,63,48,15,51
RZ Pellets W,911,6,14,4,18,53,57,-4,46
St. Pölten,911,7,11,10,15,41,61,-20,43
Admira Wacke,911,8,11,9,16,36,56,-20,42
SV Josko Rie,911,9,8,7,21,36,59,-23,31
Mattersburg,911,10,7,8,21,32,60,-28,29
SK Sturm Gra,912,1,23,4,9,70,38,32,73
SC Rheindorf,912,2,21,7,8,67,41,26,70
FC Salzburg,912,3,20,8,8,66,33,33,68
Vienna,912,4,18,4,14,67,60,7,58
Rapid Vienna,912,5,14,9,13,55,41,14,51
RZ Pellets W,912,6,12,8,16,48,53,-5,44
SV Josko Rie,912,7,12,5,19,36,59,-23,41
Admira Wacke,912,8,8,10,18,38,64,-26,34
Mattersburg,912,9,9,6,21,33,61,-28,33
St. Pölten,912,10,8,9,19,41,71,-30,33
FC Salzburg,913,1,21,5,10,64,34,30,68
SC Rheindorf,913,2,19,8,9,58,44,14,65
SK Sturm Gra,913,3,17,7,12,59,41,18,58
Vienna,913,4,18,3,15,62,56,6,57
Rapid Vienna,913,5,15,10,11,58,43,15,55
SV Josko Rie,913,6,14,6,16,36,44,-8,48
RZ Pellets W,913,7,12,7,17,46,59,-13,43
St. Pölten,913,8,11,9,16,47,65,-18,42
Admira Wacke,913,9,10,8,18,30,56,-26,38
Mattersburg,913,10,7,9,20,41,59,-18,30
FC Salzburg,914,1,23,5,8,63,28,35,74
SK Sturm Gra,914,2,20,7,9,59,28,31,67
SC Rheindorf,914,3,20,7,9,52,37,15,67
Vienna,914,4,15,9,12,56,51,5,54
RZ Pellets W,914,5,13,8,15,45,48,-3,47
Rapid Vienna,914,6,12,9,15,48,47,1,45
Admira Wacke,914,7,12,6,18,35,56,-21,42
SV Josko Rie,914,8,10,7,19,36,52,-16,37
Mattersburg,914,9,9,9,18,37,60,-23,36
St. Pölten,914,10,8,9,19,37,61,-24,33
SK Sturm Gra,915,1,21,5,10,66,36,30,68
FC Salzburg,915,2,18,8,10,53,30,23,62
Rapid Vienna,915,3,16,11,9,63,37,26,59
SC Rheindorf,915,4,15,12,9,52,47,5,57
Vienna,915,5,17,5,14,62,58,4,56
SV Josko Rie,915,6,13,8,15,45,53,-8,47
RZ Pellets W,915,7,11,10,15,44,50,-6,43
Admira Wacke,915,8,10,7,19,39,67,-28,37
Mattersburg,915,9,10,6,20,33,53,-20,36
St. Pölten,915,10,8,10,18,42,68,-26,34
SC Rheindorf,916,1,22,6,8,56,37,19,72
Vienna,916,2,20,6,10,66,46,20,66
SK Sturm Gra,916,3,19,8,9,56,29,27,65
FC Salzburg,916,4,18,9,9,62,36,26,63
Rapid Vienna,916,5,16,10,10,60,38,22,58
SV Josko Rie,916,6,11,7,18,33,46,-13,40
St. Pölten,916,7,10,9,17,42,65,-23,39
Admira Wacke,916,8,10,5,21,33,66,-33,35
RZ Pellets W,916,9,9,6,21,41,62,-21,33
Mattersburg,916,10,8,8,20,37,61,-24,32
FC Salzburg,917,1,24,5,7,70,30,40,77
SC Rheindorf,917,2,21,5,10,58,41,17,68
SK Sturm Gra,917,3,18,7,11,59,36,23,61
Vienna,917,4,18,5,13,65,52,13,59
Rapid Vienna,917,5,14,13,9,64,39,25,55
Admira Wacke,917,6,13,8,15,35,53,-18,47
RZ Pellets W,917,7,11,6,19,38,62,-24,39
SV Josko Rie,917,8,11,5,20,36,57,-21,38
St. Pölten,917,9,8,8,20,42,71,-29,32
Mattersburg,917,10,8,6,22,36,62,-26,30
FC Salzburg,918,1,21,5,10,62,37,25,68
SK Sturm Gra,918,2,18,7,11,60,37,23,61
SC Rheindorf,918,3,18,7,11,47,38,9,61
Vienna,918,4,19,4,13,59,53,6,61
SV Josko Rie,918,5,18,3,15,41,44,-3,57
Rapid Vienna,918,6,15,8,13,59,43,16,53
RZ Pellets W,918,7,12,6,18,49,60,-11,42
Admira Wacke,918,8,11,7,18,37,56,-19,40
St. Pölten,918,9,10,8,18,38,60,-22,38
Mattersburg,918,10,7,7,22,32,56,-24,28
FC Salzburg,919,1,20,9,7,67,30,37,69
Vienna,919,2,20,7,9,64,45,19,67
SC Rheindorf,919,3,18,9,9,51,41,10,63
SK Sturm Gra,919,4,18,7,11,54,33,21,61
Rapid Vienna,919,5,14,11,11,55,40,15,53
RZ Pellets W,919,6,14,6,16,41,55,-14,48
St. Pölten,919,7,11,9,16,50,62,-12,42
Admira Wacke,919,8,9,8,19,29,55,-26,35
SV Josko Rie,919,9,9,6,21,29,54,-25,33
Mattersburg,919,10,6,10,20,30,55,-25,28
FC Salzburg,920,1,24,5,7,78,29,49,77
SK Sturm Gra,920,2,19,6,11,58,35,23,63
Vienna,920,3,19,3,14,62,54,8,60
SC Rheindorf,920,4,16,6,14,55,57,-2,54
St. Pölten,920,5,13,8,15,47,56,-9,47
Rapid Vienna,920,6,12,9,15,59,58,1,45
RZ Pellets W,920,7,12,6,18,42,58,-16,42
Mattersburg,920,8,11,8,17,40,58,-18,41
SV Josko Rie,920,9,11,7,18,36,50,-14,40
Admira Wacke,920,10,11,6,19,39,61,-22,39
SC Rheindorf,921,1,20,10,6,65,41,24,70
SK Sturm Gra,921,2,19,9,8,58,35,23,66
FC Salzburg,921,3,18,10,8,60,34,26,64
Rapid Vienna,921,4,15,10,11,54,41,13,55
Vienna,921,5,16,6,14,55,53,2,54
RZ Pellets W,921,6,12,9,15,44,52,-8,45
Admira Wacke,921,7,11,7,18,39,57,-18,40
SV Josko Rie,921,8,9,8,19,34,54,-20,35
Mattersburg,921,9,9,7,20,32,53,-21,34
St. Pölten,921,10,7,12,17,38,59,-21,33
FC Salzburg,922,1,19,9,8,59,28,31,66
SK Sturm Gra,922,2,19,6,11,60,37,23,63
Vienna,922,3,19,5,12,63,51,12,62
SC Rheindorf,922,4,18,5,13,49,46,3,59
Rapid Vienna,922,5,15,11,10,58,41,17,56
RZ Pellets W,922,6,13,8,15,49,56,-7,47
Admira Wacke,922,7,12,7,17,38,55,-17,43
St. Pölten,922,8,8,12,16,41,62,-21,36
SV Josko Rie,922,9,9,8,19,31,48,-17,35
Mattersburg,922,10,8,9,19,36,60,-24,33
FC Salzburg,923,1,23,6,7,67,28,39,75
SK Sturm Gra,923,2,22,6,8,63,29,34,72
SC Rheindorf,923,3,19,8,9,51,37,14,65
RZ Pellets W,923,4,16,6,14,56,54,2,54
Vienna,923,5,16,5,15,63,56,7,53
Rapid Vienna,923,6,12,13,11,56,45,11,49
Admira Wacke,923,7,10,8,18,38,67,-29,38
SV Josko Rie,923,8,10,5,21,33,63,-30,35
Mattersburg,923,9,9,7,20,38,58,-20,34
St. Pölten,923,10,7,8,21,41,69,-28,29
FC Salzburg,924,1,22,10,4,76,31,45,76
SK Sturm Gra,924,2,17,7,12,52,36,16,58
Vienna,924,3,17,6,13,57,52,5,57
SC Rheindorf,924,4,15,11,10,44,37,7,56
Rapid Vienna,924,5,15,10,11,53,39,14,55
RZ Pellets W,924,6,13,6,17,47,55,-8,45
Admira Wacke,924,7,12,7,17,42,60,-18,43
SV Josko Rie,924,8,13,2,21,36,54,-18,41
St. Pölten,924,9,9,10,17,44,65,-21,37
Mattersburg,924,10,9,7,20,34,56,-22,34
FC Salzburg,925,1,23,5,8,71,38,33,74
SK Sturm Gra,925,2,19,7,10,58,35,23,64
SC Rheindorf,925,3,18,8,10,51,42,9,62
Vienna,925,4,18,4,14,65,57,8,58
Rapid Vienna,925,5,13,12,11,56,37,19,51
Admira Wacke,925,6,14,7,15,39,52,-13,49
St. Pölten,925,7,10,7,19,45,65,-20,37
RZ Pellets W,925,8,8,12,16,42,56,-14,36
SV Josko Rie,925,9,9,8,19,33,53,-20,35
Mattersburg,925,10,8,10,18,39,64,-25,34
SC Rheindorf,926,1,20,10,6,55,38,17,70
SK Sturm Gra,926,2,19,7,10,57,31,26,64
FC Salzburg,926,3,17,11,8,59,34,25,62
Vienna,926,4,17,7,12,62,47,15,58
Rapid Vienna,926,5,13,11,12,50,38,12,50
Admira Wacke,926,6,12,9,15,40,59,-19,45
RZ Pellets W,926,7,11,7,18,46,61,-15,40
SV Josko Rie,926,8,10,6,20,30,52,-22,36
St. Pölten,926,9,7,14,15,39,60,-21,35
Mattersburg,926,10,7,12,17,40,58,-18,33
FC Salzburg,927,1,23,6,7,65,29,36,75
SC Rheindorf,927,2,19,9,8,49,35,14,66
SK Sturm Gra,927,3,18,7,11,68,41,27,61
Vienna,927,4,18,6,12,63,52,11,60
Rapid Vienna,927,5,15,11,10,52,37,15,56
RZ Pellets W,927,6,12,6,18,38,52,-14,42
SV Josko Rie,927,7,12,6,18,35,52,-17,42
Admira Wacke,927,8,10,5,21,30,56,-26,35
Mattersburg,927,9,9,7,20,34,53,-19,34
St. Pölten,927,10,9,7,20,39,66,-27,34
FC Salzburg,928,1,23,7,6,71,30,41,76
Vienna,928,2,20,7,9,72,51,21,67
SK Sturm Gra,928,3,19,7,10,65,40,25,64
SC Rheindorf,928,4,18,7,11,57,45,12,61
Rapid Vienna,928,5,14,10,12,50,39,11,52
RZ Pellets W,928,6,12,10,14,45,51,-6,46
St. Pölten,928,7,9,9,18,42,65,-23,36
Admira Wacke,928,8,9,7,20,36,68,-32,34
Mattersburg,928,9,7,11,18,33,53,-20,32
SV Josko Rie,928,10,8,7,21,32,61,-29,31
FC Salzburg,929,1,23,7,6,79,35,44,76
Vienna,929,2,22,3,11,70,51,19,69
SK Sturm Gra,929,3,17,7,12,49,34,15,58
SC Rheindorf,929,4,16,10,10,54,51,3,58
Rapid Vienna,929,5,15,12,9,62,37,25,57
RZ Pellets W,929,6,11,9,16,42,52,-10,42
SV Josko Rie,929,7,11,7,18,32,50,-18,40
Admira Wacke,929,8,9,7,20,33,64,-31,34
Mattersburg,929,9,7,12,17,37,55,-18,33
St. Pölten,929,10,8,8,20,33,62,-29,32
SK Sturm Gra,930,1,21,7,8,66,33,33,70
FC Salzburg,930,2,21,6,9,67,34,33,69
SC Rheindorf,930,3,20,7,9,55,46,9,67
Vienna,930,4,16,6,14,51,45,6,54
Rapid Vienna,930,5,13,10,13,59,50,9,49
St. Pölten,930,6,12,8,16,48,58,-10,44
RZ Pellets W,930,7,12,7,17,44,61,-17,43
Admira Wacke,930,8,12,7,17,34,54,-20,43
Mattersburg,930,9,9,9,18,38,58,-20,36
SV Josko Rie,930,10,7,7,22,31,54,-23,28
FC Salzburg,931,1,21,6,9,72,34,38,69
SC Rheindorf,931,2,20,9,7,59,39,20,69
Vienna,931,3,21,4,11,71,56,15,67
SK Sturm Gra,931,4,17,8,11,54,31,23,59
Rapid Vienna,931,5,10,17,9,53,40,13,47
Admira Wacke,931,6,11,8,17,38,62,-24,41
RZ Pellets W,931,7,10,9,17,43,58,-15,39
St. Pölten,931,8,11,6,19,41,64,-23,39
Mattersburg,931,9,9,9,18,38,59,-21,36
SV Josko Rie,931,10,10,4,22,38,64,-26,34
FC Salzburg,932,1,23,5,8,74,31,43,74
SC Rheindorf,932,2,20,8,8,60,42,18,68
SK Sturm Gra,932,3,19,7,10,57,35,22,64
Vienna,932,4,19,5,12,59,50,9,62
RZ Pellets W,932,5,13,8,15,41,49,-8,47
Rapid Vienna,932,6,11,12,13,52,47,5,45
Mattersburg,932,7,10,9,17,36,52,-16,39
St. Pölten,932,8,8,11,17,39,57,-18,35
SV Josko Rie,932,9,10,5,21,35,60,-25,35
Admira Wacke,932,10,9,6,21,31,61,-30,33
FC Salzburg,933,1,21,9,6,69,33,36,72
SC Rheindorf,933,2,22,6,8,54,39,15,72
SK Sturm Gra,933,3,17,5,14,53,43,10,56
Rapid Vienna,933,4,14,13,9,62,42,20,55
Vienna,933,5,15,6,15,55,55,0,51
Admira Wacke,933,6,13,7,16,42,57,-15,46
RZ Pellets W,933,7,12,9,15,48,55,-7,45
St. Pölten,933,8,9,10,17,42,59,-17,37
Mattersburg,933,9,8,9,19,37,56,-19,33
SV Josko Rie,933,10,9,6,21,36,59,-23,33
FC Salzburg,934,1,26,4,6,87,28,59,82
SK Sturm Gra,934,2,20,7,9,64,36,28,67
SC Rheindorf,934,3,19,9,8,56,42,14,66
Vienna,934,4,16,7,13,69,55,14,55
Rapid Vienna,934,5,13,13,10,57,46,11,52
Admira Wacke,934,6,12,7,17,40,60,-20,43
RZ Pellets W,934,7,10,7,19,47,72,-25,37
Mattersburg,934,8,8,10,18,41,62,-21,34
St. Pölten,934,9,8,9,19,48,77,-29,33
SV Josko Rie,934,10,8,7,21,36,67,-31,31
FC Salzburg,935,1,26,4,6,78,32,46,82
SC Rheindorf,935,2,22,6,8,59,42,17,72
SK Sturm Gra,935,3,17,7,12,54,38,16,58
Vienna,935,4,16,6,14,60,56,4,54
RZ Pellets W,935,5,15,7,14,56,53,3,52
Rapid Vienna,935,6,14,9,13,56,42,14,51
SV Josko Rie,935,7,11,6,19,38,60,-22,39
Mattersburg,935,8,10,6,20,40,56,-16,36
St. Pölten,935,9,8,9,19,36,64,-28,33
Admira Wacke,935,10,7,8,21,35,69,-34,29
SC Rheindorf,936,1,18,10,8,58,44,14,64
Vienna,936,2,19,5,12,65,52,13,62
FC Salzburg,936,3,16,13,7,56,33,23,61
Rapid Vienna,936,4,15,12,9,63,42,21,57
SK Sturm Gra,936,5,16,8,12,53,36,17,56
RZ Pellets W,936,6,13,8,15,47,54,-7,47
SV Josko Rie,936,7,13,6,17,41,47,-6,45
Admira Wacke,936,8,12,7,17,36,59,-23,43
St. Pölten,936,9,7,10,19,38,68,-30,31
Mattersburg,936,10,6,11,19,39,61,-22,29
FC Salzburg,937,1,20,9,7,66,31,35,69
SC Rheindorf,937,2,18,8,10,51,42,9,62
SK Sturm Gra,937,3,18,6,12,59,36,23,60
Vienna,937,4,19,3,14,61,52,9,60
RZ Pellets W,937,5,15,5,16,50,53,-3,50
Rapid Vienna,937,6,12,13,11,57,42,15,49
Admira Wacke,937,7,11,7,18,33,59,-26,40
SV Josko Rie,937,8,11,6,19,33,51,-18,39
Mattersburg,937,9,10,8,18,38,59,-21,38
St. Pölten,937,10,9,9,18,47,70,-23,36
FC Salzburg,938,1,22,8,6,70,29,41,74
SC Rheindorf,938,2,19,10,7,55,42,13,67
SK Sturm Gra,938,3,19,7,10,58,34,24,64
Rapid Vienna,938,4,15,11,10,58,39,19,56
Vienna,938,5,16,8,12,56,49,7,56
RZ Pellets W,938,6,12,8,16,43,51,-8,44
Admira Wacke,938,7,10,8,18,33,60,-27,38
SV Josko Rie,938,8,8,11,17,33,47,-14,35
St. Pölten,938,9,7,11,18,37,65,-28,32
Mattersburg,938,10,7,8,21,31,58,-27,29
FC Salzburg,939,1,21,7,8,61,27,34,70
SC Rheindorf,939,2,21,6,9,53,38,15,69
SK Sturm Gra,939,3,19,6,11,58,32,26,63
Rapid Vienna,939,4,17,9,10,60,37,23,60
Vienna,939,5,17,8,11,59,45,14,59
RZ Pellets W,939,6,13,8,15,43,49,-6,47
Admira Wacke,939,7,11,4,21,31,62,-31,37
SV Josko Rie,939,8,10,4,22,30,52,-22,34
St. Pölten,939,9,8,10,18,37,65,-28,34
Mattersburg,939,10,9,6,21,35,60,-25,33
FC Salzburg,940,1,19,12,5,65,31,34,69
SK Sturm Gra,940,2,19,6,11,66,38,28,63
SC Rheindorf,940,3,18,9,9,51,46,5,63
Vienna,940,4,17,7,12,66,53,13,58
RZ Pellets W,940,5,14,8,14,49,55,-6,50
Rapid Vienna,940,6,12,12,12,56,43,13,48
Admira Wacke,940,7,11,7,18,35,60,-25,40
St. Pölten,940,8,9,11,16,48,62,-14,38
SV Josko Rie,940,9,10,6,20,40,63,-23,36
Mattersburg,940,10,7,10,19,36,61,-25,31
SK Sturm Gra,941,1,21,6,9,57,27,30,69
SC Rheindorf,941,2,18,11,7,61,47,14,65
FC Salzburg,941,3,19,7,10,60,38,22,64
Vienna,941,4,18,8,10,63,49,14,62
RZ Pellets W,941,5,15,9,12,53,48,5,54
Rapid Vienna,941,6,13,12,11,51,39,12,51
Admira Wacke,941,7,11,7,18,36,57,-21,40
SV Josko Rie,941,8,9,6,21,35,62,-27,33
St. Pölten,941,9,7,9,20,39,63,-24,30
Mattersburg,941,10,7,9,20,31,56,-25,30
FC Salzburg,942,1,22,6,8,58,26,32,72
Vienna,942,2,21,4,11,70,53,17,67
SK Sturm Gra,942,3,18,7,11,57,41,16,61
SC Rheindorf,942,4,18,7,11,55,48,7,61
RZ Pellets W,942,5,16,5,15,53,51,2,53
Rapid Vienna,942,6,11,13,12,53,42,11,46
Admira Wacke,942,7,13,6,17,36,53,-17,45
SV Josko Rie,942,8,9,8,19,34,54,-20,35
St. Pölten,942,9,8,9,19,44,67,-23,33
Mattersburg,942,10,7,9,20,37,62,-25,30
FC Salzburg,943,1,22,7,7,63,27,36,73
SC Rheindorf,943,2,19,10,7,56,42,14,67
Rapid Vienna,943,3,16,12,8,61,36,25,60
SK Sturm Gra,943,4,16,7,13,58,41,17,55
Vienna,943,5,16,7,13,58,52,6,55
RZ Pellets W,943,6,11,10,15,43,55,-12,43
Admira Wacke,943,7,12,7,17,34,54,-20,43
SV Josko Rie,943,8,11,7,18,35,51,-16,40
St. Pölten,943,9,8,10,18,38,61,-23,34
Mattersburg,943,10,6,9,21,36,63,-27,27
SK Sturm Gra,944,1,24,3,9,74,40,34,75
FC Salzburg,944,2,21,7,8,64,29,35,70
SC Rheindorf,944,3,20,7,9,57,44,13,67
Vienna,944,4,17,5,14,67,58,9,56
Rapid Vienna,944,5,15,8,13,46,36,10,53
SV Josko Rie,944,6,12,6,18,41,54,-13,42
RZ Pellets W,944,7,10,8,18,44,64,-20,38
St. Pölten,944,8,9,9,18,46,65,-19,36
Mattersburg,944,9,9,8,19,38,58,-20,35
Admira Wacke,944,10,9,7,20,33,62,-29,34
FC Salzburg,945,1,22,8,6,76,31,45,74
SC Rheindorf,945,2,20,7,9,53,38,15,67
SK Sturm Gra,945,3,18,9,9,58,33,25,63
Vienna,945,4,19,6,11,61,52,9,63
Rapid Vienna,945,5,14,13,9,64,41,23,55
RZ Pellets W,945,6,13,8,15,46,52,-6,47
Admira Wacke,945,7,9,10,17,36,63,-27,37
SV Josko Rie,945,8,8,8,20,30,54,-24,32
St. Pölten,945,9,7,9,20,37,69,-32,30
Mattersburg,945,10,7,8,21,30,58,-28,29
SK Sturm Gra,946,1,23,4,9,60,31,29,73
FC Salzburg,946,2,22,6,8,72,32,40,72
SC Rheindorf,946,3,19,7,10,60,45,15,64
Vienna,946,4,17,5,14,61,56,5,56
RZ Pellets W,946,5,15,5,16,47,60,-13,50
SV Josko Rie,946,6,12,6,18,44,53,-9,42
Admira Wacke,946,7,12,6,18,38,59,-21,42
Rapid Vienna,946,8,10,11,15,53,47,6,41
Mattersburg,946,9,10,10,16,37,51,-14,40
St. Pölten,946,10,5,10,21,31,69,-38,25
FC Salzburg,947,1,21,7,8,67,36,31,70
SC Rheindorf,947,2,21,7,8,61,41,20,70
SK Sturm Gra,947,3,19,8,9,62,33,29,65
Vienna,947,4,20,5,11,68,47,21,65
Rapid Vienna,947,5,14,10,12,57,39,18,52
Admira Wacke,947,6,11,10,15,39,58,-19,43
RZ Pellets W,947,7,10,9,17,39,63,-24,39
Mattersburg,947,8,9,9,18,33,53,-20,36
SV Josko Rie,947,9,8,7,21,29,55,-26,31
St. Pölten,947,10,5,12,19,36,66,-30,27
SK Sturm Gra,948,1,22,5,9,65,33,32,71
FC Salzburg,948,2,22,5,9,64,35,29,71
SC Rheindorf,948,3,19,7,10,59,47,12,64
Vienna,948,4,18,7,11,69,58,11,61
Rapid Vienna,948,5,13,13,10,60,41,19,52
SV Josko Rie,948,6,12,8,16,39,48,-9,44
RZ Pellets W,948,7,11,8,17,46,59,-13,41
St. Pölten,948,8,9,8,19,40,66,-26,35
Admira Wacke,948,9,9,8,19,34,62,-28,35
Mattersburg,948,10,7,7,22,32,59,-27,28
FC Salzburg,949,1,21,7,8,67,31,36,70
SK Sturm Gra,949,2,19,8,9,55,31,24,65
SC Rheindorf,949,3,16,9,11,47,48,-1,57
Rapid Vienna,949,4,14,12,10,67,41,26,54
Vienna,949,5,15,8,13,51,48,3,53
Admira Wacke,949,6,14,6,16,45,54,-9,48
RZ Pellets W,949,7,11,10,15,41,57,-16,43
SV Josko Rie,949,8,13,3,20,35,54,-19,42
Mattersburg,949,9,8,10,18,40,57,-17,34
St. Pölten,949,10,7,11,18,39,66,-27,32
FC Salzburg,950,1,23,8,5,76,33,43,77
SC Rheindorf,950,2,21,6,9,56,46,10,69
SK Sturm Gra,950,3,19,7,10,57,32,25,64
Vienna,950,4,20,4,12,61,47,14,64
Rapid Vienna,950,5,13,8,15,56,44,12,47
SV Josko Rie,950,6,12,6,18,40,58,-18,42
Admira Wacke,950,7,12,6,18,37,55,-18,42
RZ Pellets W,950,8,11,7,18,40,58,-18,40
Mattersburg,950,9,8,8,20,39,58,-19,32
St. Pölten,950,10,6,10,20,40,71,-31,28
SK Sturm Gra,951,1,20,5,11,58,33,25,65
FC Salzburg,951,2,17,12,7,58,31,27,63
Vienna,951,3,17,8,11,63,52,11,59
SC Rheindorf,951,4,15,14,7,53,43,10,59
SV Josko Rie,951,5,13,8,15,42,47,-5,47
RZ Pellets W,951,6,12,9,15,49,57,-8,45
Rapid Vienna,951,7,10,13,13,49,43,6,43
Admira Wacke,951,8,10,9,17,33,55,-22,39
St. Pölten,951,9,8,12,16,48,66,-18,36
Mattersburg,951,10,7,12,17,32,58,-26,33
FC Salzburg,952,1,22,7,7,63,30,33,73
Vienna,952,2,20,6,10,68,49,19,66
SC Rheindorf,952,3,17,10,9,53,42,11,61
SK Sturm Gra,952,4,16,8,12,52,40,12,56
Rapid Vienna,952,5,15,10,11,62,43,19,55
RZ Pellets W,952,6,12,9,15,45,50,-5,45
Admira Wacke,952,7,11,8,17,38,58,-20,41
Mattersburg,952,8,8,11,17,30,50,-20,35
St. Pölten,952,9,8,10,18,42,64,-22,34
SV Josko Rie,952,10,9,5,22,36,63,-27,32
SC Rheindorf,953,1,22,4,10,58,45,13,70
FC Salzburg,953,2,20,9,7,64,35,29,69
Vienna,953,3,20,6,10,59,42,17,66
SK Sturm Gra,953,4,19,5,12,50,35,15,62
Rapid Vienna,953,5,16,9,11,55,41,14,57
RZ Pellets W,953,6,13,6,17,47,56,-9,45
SV Josko Rie,953,7,11,8,17,47,54,-7,41
Admira Wacke,953,8,9,9,18,31,52,-21,36
Mattersburg,953,9,7,8,21,38,60,-22,29
St. Pölten,953,10,7,8,21,34,63,-29,29
SK Sturm Gra,954,1,19,8,9,58,32,26,65
Vienna,954,2,20,5,11,64,52,12,65
SC Rheindorf,954,3,18,9,9,53,43,10,63
FC Salzburg,954,4,17,10,9,65,34,31,61
Rapid Vienna,954,5,14,12,10,58,41,17,54
Admira Wacke,954,6,12,9,15,42,56,-14,45
RZ Pellets W,954,7,10,9,17,44,58,-14,39
Mattersburg,954,8,9,9,18,37,60,-23,36
SV Josko Rie,954,9,10,5,21,34,59,-25,35
St. Pölten,954,10,8,10,18,47,67,-20,34
SK Sturm Gra,955,1,22,5,9,69,34,35,71
FC Salzburg,955,2,19,12,5,67,33,34,69
SC Rheindorf,955,3,17,10,9,60,45,15,61
Vienna,955,4,19,4,13,63,55,8,61
Rapid Vienna,955,5,12,14,10,53,37,16,50
SV Josko Rie,955,6,13,6,17,43,51,-8,45
RZ Pellets W,955,7,11,6,19,39,59,-20,39
Admira Wacke,955,8,10,6,20,34,59,-25,36
St. Pölten,955,9,9,9,18,42,70,-28,36
Mattersburg,955,10,6,12,18,39,66,-27,30
SC Rheindorf,956,1,19,8,9,55,43,12,65
FC Salzburg,956,2,18,10,8,62,33,29,64
Vienna,956,3,19,7,10,73,48,25,64
SK Sturm Gra,956,4,17,9,10,58,37,21,60
Rapid Vienna,956,5,14,13,9,57,40,17,55
RZ Pellets W,956,6,15,7,14,48,54,-6,52
Admira Wacke,956,7,13,6,17,41,56,-15,45
SV Josko Rie,956,8,11,8,17,41,57,-16,41
St. Pölten,956,9,6,8,22,38,74,-36,26
Mattersburg,956,10,5,10,21,29,60,-31,25
SK Sturm Gra,957,1,21,6,9,66,34,32,69
FC Salzburg,957,2,17,10,9,58,35,23,61
Vienna,957,3,19,4,13,62,55,7,61
SC Rheindorf,957,4,16,9,11,55,50,5,57
Rapid Vienna,957,5,14,11,11,57,38,19,53
St. Pölten,957,6,12,10,14,44,53,-9,46
Admira Wacke,957,7,14,4,18,36,50,-14,46
RZ Pellets W,957,8,11,7,18,43,55,-12,40
SV Josko Rie,957,9,11,4,21,35,62,-27,37
Mattersburg,957,10,10,5,21,36,60,-24,35
SC Rheindorf,958,1,22,7,7,63,37,26,73
Vienna,958,2,21,3,12,64,44,20,66
SK Sturm Gra,958,3,19,7,10,56,31,25,64
FC Salzburg,958,4,18,7,11,56,37,19,61
RZ Pellets W,958,5,15,6,15,49,58,-9,51
Rapid Vienna,958,6,11,11,14,49,46,3,44
St. Pölten,958,7,11,6,19,42,60,-18,39
SV Josko Rie,958,8,11,5,20,35,57,-22,38
Admira Wacke,958,9,11,5,20,38,66,-28,38
Mattersburg,958,10,7,11,18,39,55,-16,32
FC Salzburg,959,1,22,10,4,73,26,47,76
SK Sturm Gra,959,2,21,8,7,66,31,35,71
SC Rheindorf,959,3,20,9,7,54,38,16,69
Vienna,959,4,17,7,12,61,54,7,58
Rapid Vienna,959,5,14,9,13,50,43,7,51
RZ Pellets W,959,6,13,7,16,49,55,-6,46
Admira Wacke,959,7,11,5,20,32,57,-25,38
SV Josko Rie,959,8,8,8,20,36,53,-17,32
Mattersburg,959,9,8,7,21,36,65,-29,31
St. Pölten,959,10,6,10,20,41,76,-35,28
FC Salzburg,960,1,20,9,7,63,31,32,69
SK Sturm Gra,960,2,20,5,11,60,30,30,65
Rapid Vienna,960,3,17,11,8,60,35,25,62
SC Rheindorf,960,4,17,10,9,46,39,7,61
Vienna,960,5,16,5,15,53,54,-1,53
RZ Pellets W,960,6,12,8,16,44,59,-15,44
SV Josko Rie,960,7,12,5,19,35,52,-17,41
Admira Wacke,960,8,11,7,18,37,56,-19,40
Mattersburg,960,9,8,9,19,41,57,-16,33
St. Pölten,960,10,8,9,19,34,60,-26,33
FC Salzburg,961,1,22,7,7,66,28,38,73
SC Rheindorf,961,2,20,9,7,52,32,20,69
SK Sturm Gra,961,3,19,8,9,59,32,27,65
Vienna,961,4,18,5,13,61,55,6,59
Rapid Vienna,961,5,13,12,11,54,41,13,51
St. Pölten,961,6,11,12,13,56,59,-3,45
RZ Pellets W,961,7,12,8,16,38,49,-11,44
SV Josko Rie,961,8,9,7,20,34,58,-24,34
Admira Wacke,961,9,8,8,20,28,57,-29,32
Mattersburg,961,10,6,8,22,29,66,-37,26
FC Salzburg,962,1,22,8,6,71,34,37,74
SK Sturm Gra,962,2,20,7,9,59,33,26,67
Rapid Vienna,962,3,18,8,10,66,41,25,62
SC Rheindorf,962,4,18,5,13,52,42,10,59
Vienna,962,5,17,6,13,57,58,-1,57
RZ Pellets W,962,6,11,8,17,45,55,-10,41
SV Josko Rie,962,7,11,8,17,37,49,-12,41
Admira Wacke,962,8,11,4,21,42,69,-27,37
Mattersburg,962,9,8,10,18,33,54,-21,34
St. Pölten,962,10,7,10,19,36,63,-27,31
SK Sturm Gra,963,1,21,9,6,63,24,39,72
FC Salzburg,963,2,19,8,9,64,37,27,65
SC Rheindorf,963,3,18,9,9,55,43,12,63
Vienna,963,4,18,7,11,58,49,9,61
Rapid Vienna,963,5,14,8,14,56,46,10,50
Admira Wacke,963,6,12,8,16,36,54,-18,44
SV Josko Rie,963,7,12,5,19,37,50,-13,41
RZ Pellets W,963,8,12,4,20,43,59,-16,40
Mattersburg,963,9,9,7,20,38,61,-23,34
St. Pölten,963,10,8,9,19,39,66,-27,33
FC Salzburg,964,1,21,7,8,66,33,33,70
SK Sturm Gra,964,2,20,5,11,64,38,26,65
Vienna,964,3,20,4,12,65,59,6,64
SC Rheindorf,964,4,17,8,11,55,47,8,59
Rapid Vienna,964,5,16,10,10,66,41,25,58
RZ Pellets W,964,6,14,9,13,53,51,2,51
Admira Wacke,964,7,14,4,18,43,58,-15,46
Mattersburg,964,8,7,10,19,38,59,-21,31
St. Pölten,964,9,8,7,21,43,74,-31,31
SV Josko Rie,964,10,9,4,23,37,70,-33,31
FC Salzburg,965,1,22,8,6,66,30,36,74
SC Rheindorf,965,2,19,8,9,54,38,16,65
SK Sturm Gra,965,3,18,8,10,57,37,20,62
Vienna,965,4,19,5,12,65,48,17,62
Rapid Vienna,965,5,16,8,12,58,42,16,56
RZ Pellets W,965,6,13,10,13,49,51,-2,49
Mattersburg,965,7,10,9,17,40,56,-16,39
Admira Wacke,965,8,11,5,20,33,59,-26,38
SV Josko Rie,965,9,8,6,22,30,56,-26,30
St. Pölten,965,10,6,9,21,41,76,-35,27
FC Salzburg,966,1,21,9,6,72,28,44,72
Vienna,966,2,21,4,11,66,44,22,67
SK Sturm Gra,966,3,19,8,9,61,37,24,65
SC Rheindorf,966,4,18,10,8,55,43,12,64
Rapid Vienna,966,5,12,12,12,55,44,11,48
RZ Pellets W,966,6,13,7,16,47,58,-11,46
Admira Wacke,966,7,11,7,18,37,65,-28,40
St. Pölten,966,8,9,9,18,39,60,-21,36
SV Josko Rie,966,9,9,6,21,33,59,-26,33
Mattersburg,966,10,7,8,21,35,62,-27,29
FC Salzburg,967,1,19,7,10,59,32,27,64
Vienna,967,2,19,7,10,67,46,21,64
SC Rheindorf,967,3,19,7,10,53,45,8,64
SK Sturm Gra,967,4,17,10,9,59,38,21,61
Rapid Vienna,967,5,12,10,14,58,51,7,46
RZ Pellets W,967,6,13,6,17,46,60,-14,45
Admira Wacke,967,7,11,10,15,33,52,-19,43
SV Josko Rie,967,8,12,5,19,44,60,-16,41
St. Pölten,967,9,10,8,18,48,65,-17,38
Mattersburg,967,10,9,8,19,35,53,-18,35
FC Salzburg,968,1,23,4,9,63,29,34,73
Vienna,968,2,22,3,11,72,53,19,69
SC Rheindorf,968,3,20,7,9,55,34,21,67
SK Sturm Gra,968,4,18,6,12,53,31,22,60
Rapid Vienna,968,5,14,9,13,54,39,15,51
RZ Pellets W,968,6,15,6,15,52,59,-7,51
Admira Wacke,968,7,13,5,18,35,59,-24,44
SV Josko Rie,968,8,10,7,19,29,51,-22,37
St. Pölten,968,9,8,7,21,38,68,-30,31
Mattersburg,968,10,5,10,21,30,58,-28,25
FC Salzburg,969,1,21,6,9,73,39,34,69
SC Rheindorf,969,2,20,8,8,51,40,11,68
SK Sturm Gra,969,3,20,5,11,59,34,25,65
Vienna,969,4,16,8,12,57,49,8,56
Rapid Vienna,969,5,12,11,13,49,42,7,47
Admira Wacke,969,6,13,7,16,42,54,-12,46
St. Pölten,969,7,10,13,13,45,58,-13,43
Mattersburg,969,8,10,8,18,38,50,-12,38
RZ Pellets W,969,9,10,7,19,37,57,-20,37
SV Josko Rie,969,10,9,5,22,34,62,-28,32
FC Salzburg,970,1,21,6,9,58,30,28,69
SC Rheindorf,970,2,20,5,11,59,44,15,65
SK Sturm Gra,970,3,16,10,10,53,34,19,58
Vienna,970,4,15,7,14,58,56,2,52
RZ Pellets W,970,5,15,7,14,47,50,-3,52
Rapid Vienna,970,6,14,9,13,59,44,15,51
SV Josko Rie,970,7,13,5,18,43,54,-11,44
Mattersburg,970,8,11,9,16,43,55,-12,42
Admira Wacke,970,9,10,8,18,31,57,-26,38
St. Pölten,970,10,8,8,20,45,72,-27,32
FC Salzburg,971,1,21,10,5,72,30,42,73
SK Sturm Gra,971,2,22,6,8,59,26,33,72
SC Rheindorf,971,3,17,10,9,61,47,14,61
Vienna,971,4,19,4,13,60,54,6,61
Rapid Vienna,971,5,12,15,9,52,38,14,51
Admira Wacke,971,6,11,7,18,33,60,-27,40
RZ Pellets W,971,7,10,9,17,40,54,-14,39
SV Josko Rie,971,8,11,5,20,37,56,-19,38
St. Pölten,971,9,8,9,19,39,63,-24,33
Mattersburg,971,10,5,13,18,30,55,-25,28
SC Rheindorf,972,1,21,8,7,53,34,19,71
FC Salzburg,972,2,21,7,8,69,32,37,70
Vienna,972,3,19,5,12,64,49,15,62
SK Sturm Gra,972,4,16,8,12,48,33,15,56
Rapid Vienna,972,5,14,11,11,58,41,17,53
RZ Pellets W,972,6,14,6,16,45,59,-14,48
Admira Wacke,972,7,12,7,17,37,59,-22,43
Mattersburg,972,8,9,10,17,40,58,-18,37
St. Pölten,972,9,7,10,19,40,63,-23,31
SV Josko Rie,972,10,7,8,21,29,55,-26,29
FC Salzburg,973,1,21,7,8,65,29,36,70
SC Rheindorf,973,2,20,8,8,65,39,26,68
Vienna,973,3,19,7,10,63,55,8,64
Rapid Vienna,973,4,18,9,9,65,39,26,63
SK Sturm Gra,973,5,18,6,12,54,35,19,60
Admira Wacke,973,6,12,5,19,35,58,-23,41
RZ Pellets W,973,7,11,7,18,49,62,-13,40
Mattersburg,973,8,8,11,17,36,57,-21,35
St. Pölten,973,9,9,6,21,48,76,-28,33
SV Josko Rie,973,10,8,6,22,33,63,-30,30
SK Sturm Gra,974,1,25,4,7,75,30,45,79
FC Salzburg,974,2,23,8,5,68,27,41,77
SC Rheindorf,974,3,16,10,10,47,45,2,58
Vienna,974,4,18,3,15,62,54,8,57
RZ Pellets W,974,5,13,7,16,56,56,0,46
SV Josko Rie,974,6,12,7,17,38,52,-14,43
Rapid Vienna,974,7,10,12,14,51,49,2,42
St. Pölten,974,8,9,9,18,39,63,-24,36
Admira Wacke,974,9,10,6,20,35,66,-31,36
Mattersburg,974,10,7,8,21,39,68,-29,29
SC Rheindorf,975,1,23,5,8,60,40,20,74
FC Salzburg,975,2,20,11,5,67,32,35,71
SK Sturm Gra,975,3,19,7,10,60,36,24,64
Vienna,975,4,18,7,11,65,48,17,61
Rapid Vienna,975,5,15,11,10,58,38,20,56
RZ Pellets W,975,6,13,7,16,43,55,-12,46
Admira Wacke,975,7,11,5,20,36,67,-31,38
St. Pölten,975,8,8,11,17,48,65,-17,35
SV Josko Rie,975,9,8,5,23,30,64,-34,29
Mattersburg,975,10,7,7,22,38,60,-22,28
SK Sturm Gra,976,1,21,6,9,63,33,30,69
SC Rheindorf,976,2,21,6,9,64,44,20,69
FC Salzburg,976,3,20,8,8,72,36,36,68
Vienna,976,4,16,7,13,64,57,7,55
Rapid Vienna,976,5,14,12,10,57,41,16,54
RZ Pellets W,976,6,11,11,14,53,57,-4,44
Admira Wacke,976,7,12,6,18,40,67,-27,42
Mattersburg,976,8,9,10,17,41,57,-16,37
SV Josko Rie,976,9,9,6,21,33,64,-31,33
St. Pölten,976,10,7,8,21,40,71,-31,29
FC Salzburg,977,1,24,5,7,70,27,43,77
SC Rheindorf,977,2,22,6,8,53,37,16,72
SK Sturm Gra,977,3,19,6,11,62,33,29,63
Rapid Vienna,977,4,15,9,12,55,41,14,54
Vienna,977,5,16,5,15,50,57,-7,53
St. Pölten,977,6,11,9,16,48,60,-12,42
RZ Pellets W,977,7,11,9,16,44,59,-15,42
Mattersburg,977,8,10,7,19,43,60,-17,37
Admira Wacke,977,9,10,6,20,38,62,-24,36
SV Josko Rie,977,10,8,6,22,28,55,-27,30
FC Salzburg,978,1,22,6,8,67,29,38,72
SC Rheindorf,978,2,18,10,8,56,43,13,64
SK Sturm Gra,978,3,18,6,12,47,33,14,60
Vienna,978,4,18,5,13,66,57,9,59
Rapid Vienna,978,5,15,9,12,60,42,18,54
Admira Wacke,978,6,13,9,14,44,55,-11,48
SV Josko Rie,978,7,12,6,18,38,56,-18,42
RZ Pellets W,978,8,11,8,17,43,58,-15,41
St. Pölten,978,9,6,13,17,41,61,-20,31
Mattersburg,978,10,7,8,21,30,58,-28,29
FC Salzburg,979,1,22,7,7,70,31,39,73
SK Sturm Gra,979,2,20,7,9,61,34,27,67
SC Rheindorf,979,3,18,8,10,57,43,14,62
Vienna,979,4,19,4,13,62,53,9,61
RZ Pellets W,979,5,14,6,16,45,53,-8,48
Rapid Vienna,979,6,13,8,15,54,49,5,47
Admira Wacke,979,7,13,8,15,43,57,-14,47
SV Josko Rie,979,8,9,7,20,38,60,-22,34
St. Pölten,979,9,7,12,17,40,63,-23,33
Mattersburg,979,10,7,9,20,33,60,-27,30
FC Salzburg,980,1,21,9,6,63,28,35,72
SC Rheindorf,980,2,21,8,7,62,37,25,71
Rapid Vienna,980,3,17,12,7,59,31,28,63
SK Sturm Gra,980,4,17,11,8,55,32,23,62
Vienna,980,5,19,5,12,61,53,8,62
Admira Wacke,980,6,10,8,18,38,59,-21,38
SV Josko Rie,980,7,9,7,20,37,59,-22,34
Mattersburg,980,8,8,8,20,39,58,-19,32
RZ Pellets W,980,9,8,8,20,43,67,-24,32
St. Pölten,980,10,7,10,19,38,71,-33,31
FC Salzburg,981,1,22,7,7,70,28,42,73
SC Rheindorf,981,2,19,10,7,56,42,14,67
SK Sturm Gra,981,3,19,8,9,60,37,23,65
Vienna,981,4,20,4,12,66,58,8,64
Rapid Vienna,981,5,14,12,10,59,39,20,54
RZ Pellets W,981,6,13,7,16,41,50,-9,46
Admira Wacke,981,7,10,8,18,31,51,-20,38
SV Josko Rie,981,8,10,6,20,37,57,-20,36
Mattersburg,981,9,7,8,21,33,61,-28,29
St. Pölten,981,10,6,10,20,36,66,-30,28
FC Salzburg,982,1,21,8,7,65,32,33,71
SC Rheindorf,982,2,20,8,8,60,41,19,68
SK Sturm Gra,982,3,20,4,12,53,33,20,64
Vienna,982,4,18,7,11,70,57,13,61
Rapid Vienna,982,5,14,8,14,52,43,9,50
Admira Wacke,982,6,12,8,16,40,58,-18,44
RZ Pellets W,982,7,12,6,18,49,65,-16,42
SV Josko Rie,982,8,11,6,19,36,51,-15,39
Mattersburg,982,9,9,8,19,39,58,-19,35
St. Pölten,982,10,7,9,20,39,65,-26,30
SK Sturm Gra,983,1,21,6,9,54,32,22,69
FC Salzburg,983,2,19,9,8,64,33,31,66
SC Rheindorf,983,3,18,9,9,58,43,15,63
Vienna,983,4,19,4,13,62,48,14,61
Rapid Vienna,983,5,12,10,14,53,50,3,46
RZ Pellets W,983,6,12,9,15,48,56,-8,45
Admira Wacke,983,7,13,5,18,41,57,-16,44
St. Pölten,983,8,9,11,16,49,65,-16,38
Mattersburg,983,9,9,8,19,35,54,-19,35
SV Josko Rie,983,10,10,5,21,33,59,-26,35
FC Salzburg,984,1,21,7,8,67,34,33,70
SC Rheindorf,984,2,21,7,8,56,36,20,70
Vienna,984,3,21,3,12,63,48,15,66
SK Sturm Gra,984,4,18,4,14,49,38,11,58
Rapid Vienna,984,5,13,10,13,61,41,20,49
RZ Pellets W,984,6,12,10,14,49,56,-7,46
SV Josko Rie,984,7,13,3,20,37,53,-16,42
Admira Wacke,984,8,12,5,19,43,60,-17,41
St. Pölten,984,9,10,8,18,41,67,-26,38
Mattersburg,984,10,7,7,22,37,70,-33,28
SK Sturm Gra,985,1,21,6,9,64,33,31,69
SC Rheindorf,985,2,20,8,8,56,42,14,68
FC Salzburg,985,3,20,7,9,66,34,32,67
Vienna,985,4,21,3,12,65,52,13,66
Rapid Vienna,985,5,15,8,13,56,40,16,53
SV Josko Rie,985,6,12,6,18,35,46,-11,42
RZ Pellets W,985,7,11,6,19,44,58,-14,39
Admira Wacke,985,8,10,9,17,31,55,-24,39
Mattersburg,985,9,8,8,20,37,65,-28,32
St. Pölten,985,10,7,9,20,40,69,-29,30
FC Salzburg,986,1,21,8,7,64,26,38,71
Vienna,986,2,19,9,8,65,42,23,66
SK Sturm Gra,986,3,18,8,10,55,37,18,62
SC Rheindorf,986,4,17,11,8,58,43,15,62
RZ Pellets W,986,5,14,8,14,50,51,-1,50
Rapid Vienna,986,6,13,9,14,54,43,11,48
Admira Wacke,986,7,11,8,17,33,60,-27,41
St. Pölten,986,8,10,8,18,38,59,-21,38
SV Josko Rie,986,9,9,6,21,35,55,-20,33
Mattersburg,986,10,7,7,22,32,68,-36,28
FC Salzburg,987,1,21,9,6,67,34,33,72
SC Rheindorf,987,2,22,6,8,64,36,28,72
SK Sturm Gra,987,3,22,5,9,59,26,33,71
Vienna,987,4,19,4,13,65,60,5,61
SV Josko Rie,987,5,14,3,19,38,49,-11,45
RZ Pellets W,987,6,12,6,18,44,62,-18,42
Rapid Vienna,987,7,9,11,16,52,51,1,38
St. Pölten,987,8,10,7,19,43,64,-21,37
Admira Wacke,987,9,11,4,21,35,66,-31,37
Mattersburg,987,10,9,7,20,44,63,-19,34
SK Sturm Gra,988,1,22,6,8,69,33,36,72
FC Salzburg,988,2,21,8,7,69,33,36,71
SC Rheindorf,988,3,20,6,10,57,43,14,66
Vienna,988,4,17,5,14,56,48,8,56
Rapid Vienna,988,5,11,12,13,57,45,12,45
St. Pölten,988,6,12,6,18,45,70,-25,42
RZ Pellets W,988,7,12,5,19,45,56,-11,41
Admira Wacke,988,8,11,7,18,34,58,-24,40
Mattersburg,988,9,10,9,17,42,61,-19,39
SV Josko Rie,988,10,9,6,21,33,60,-27,33
FC Salzburg,989,1,21,8,7,67,32,35,71
SC Rheindorf,989,2,20,8,8,54,40,14,68
SK Sturm Gra,989,3,18,7,11,65,39,26,61
Vienna,989,4,18,7,11,66,53,13,61
Rapid Vienna,989,5,12,13,11,51,41,10,49
RZ Pellets W,989,6,13,8,15,48,58,-10,47
Admira Wacke,989,7,13,5,18,39,57,-18,44
Mattersburg,989,8,9,9,18,34,55,-21,36
SV Josko Rie,989,9,10,5,21,31,53,-22,35
St. Pölten,989,10,7,8,21,38,65,-27,29
FC Salzburg,990,1,21,8,7,69,35,34,71
SC Rheindorf,990,2,19,8,9,56,45,11,65
SK Sturm Gra,990,3,19,6,11,57,37,20,63
Vienna,990,4,19,5,12,59,54,5,62
Rapid Vienna,990,5,14,9,13,56,42,14,51
St. Pölten,990,6,14,8,14,52,55,-3,50
RZ Pellets W,990,7,12,6,18,48,56,-8,42
Admira Wacke,990,8,12,6,18,36,55,-19,42
Mattersburg,990,9,8,7,21,45,61,-16,31
SV Josko Rie,990,10,8,5,23,30,68,-38,29
FC Salzburg,991,1,21,8,7,67,34,33,71
SC Rheindorf,991,2,18,10,8,61,49,12,64
Rapid Vienna,991,3,17,9,10,60,41,19,60
SK Sturm Gra,991,4,17,7,12,63,43,20,58
Vienna,991,5,17,6,13,59,53,6,57
RZ Pellets W,991,6,13,7,16,45,48,-3,46
Admira Wacke,991,7,11,7,18,39,60,-21,40
Mattersburg,991,8,10,9,17,39,57,-18,39
SV Josko Rie,991,9,11,4,21,34,56,-22,37
St. Pölten,991,10,7,9,20,39,65,-26,30
FC Salzburg,992,1,24,6,6,72,28,44,78
SC Rheindorf,992,2,21,8,7,58,39,19,71
SK Sturm Gra,992,3,19,8,9,64,34,30,65
Vienna,992,4,16,6,14,54,60,-6,54
Rapid Vienna,992,5,13,10,13,56,43,13,49
Admira Wacke,992,6,13,4,19,37,61,-24,43
RZ Pellets W,992,7,11,7,18,42,57,-15,40
Mattersburg,992,8,10,7,19,41,56,-15,37
St. Pölten,992,9,9,9,18,44,67,-23,36
SV Josko Rie,992,10,10,3,23,29,52,-23,33
SC Rheindorf,993,1,22,5,9,56,37,19,71
SK Sturm Gra,993,2,20,6,10,54,35,19,66
FC Salzburg,993,3,20,5,11,61,36,25,65
Vienna,993,4,17,6,13,55,51,4,57
RZ Pellets W,993,5,13,8,15,52,55,-3,47
Rapid Vienna,993,6,10,13,13,46,42,4,43
SV Josko Rie,993,7,12,7,17,38,52,-14,43
Admira Wacke,993,8,11,7,18,35,52,-17,40
Mattersburg,993,9,8,11,17,35,50,-15,35
St. Pölten,993,10,8,10,18,46,68,-22,34
FC Salzburg,994,1,21,8,7,63,25,38,71
SK Sturm Gra,994,2,19,9,8,57,35,22,66
SC Rheindorf,994,3,19,6,11,63,51,12,63
Vienna,994,4,19,6,11,63,53,10,63
Rapid Vienna,994,5,15,11,10,65,36,29,56
SV Josko Rie,994,6,12,6,18,39,53,-14,42
RZ Pellets W,994,7,11,7,18,43,57,-14,40
Admira Wacke,994,8,11,4,21,32,61,-29,37
St. Pölten,994,9,9,9,18,43,66,-23,36
Mattersburg,994,10,8,6,22,34,65,-31,30
Vienna,995,1,23,4,9,75,46,29,73
FC Salzburg,995,2,21,9,6,73,29,44,72
SK Sturm Gra,995,3,20,7,9,66,33,33,67
Rapid Vienna,995,4,14,9,13,54,40,14,51
SC Rheindorf,995,5,14,8,14,45,58,-13,50
St. Pölten,995,6,12,8,16,47,59,-12,44
RZ Pellets W,995,7,11,9,16,47,64,-17,42
Admira Wacke,995,8,10,7,19,37,66,-29,37
SV Josko Rie,995,9,9,9,18,32,53,-21,36
Mattersburg,995,10,6,10,20,37,65,-28,28
FC Salzburg,996,1,22,10,4,71,30,41,76
SC Rheindorf,996,2,20,7,9,59,38,21,67
SK Sturm Gra,996,3,19,7,10,62,37,25,64
Vienna,996,4,15,10,11,58,49,9,55
Rapid Vienna,996,5,13,10,13,59,42,17,49
SV Josko Rie,996,6,12,6,18,39,52,-13,42
RZ Pellets W,996,7,10,10,16,41,56,-15,40
Mattersburg,996,8,10,9,17,40,56,-16,39
Admira Wacke,996,9,11,6,19,34,63,-29,39
St. Pölten,996,10,6,9,21,35,75,-40,27
FC Salzburg,997,1,23,5,8,68,33,35,74
SC Rheindorf,997,2,22,7,7,60,45,15,73
SK Sturm Gra,997,3,20,5,11,62,34,28,65
Vienna,997,4,17,5,14,56,50,6,56
Rapid Vienna,997,5,14,10,12,54,40,14,52
RZ Pellets W,997,6,12,8,16,39,48,-9,44
Admira Wacke,997,7,11,7,18,32,56,-24,40
St. Pölten,997,8,8,10,18,38,56,-18,34
Mattersburg,997,9,7,11,18,33,56,-23,32
SV Josko Rie,997,10,8,8,20,30,54,-24,32
SK Sturm Gra,998,1,20,9,7,65,28,37,69
FC Salzburg,998,2,20,8,8,63,31,32,68
SC Rheindorf,998,3,20,7,9,60,42,18,67
Vienna,998,4,17,6,13,64,57,7,57
RZ Pellets W,998,5,13,9,14,42,47,-5,48
Rapid Vienna,998,6,11,14,11,51,40,11,47
SV Josko Rie,998,7,10,9,17,34,50,-16,39
Admira Wacke,998,8,10,7,19,35,62,-27,37
St. Pölten,998,9,8,9,19,44,71,-27,33
Mattersburg,998,10,8,8,20,32,62,-30,32
SK Sturm Gra,999,1,21,6,9,71,37,34,69
FC Salzburg,999,2,19,10,7,64,35,29,67
Vienna,999,3,19,6,11,62,52,10,63
SC Rheindorf,999,4,18,6,12,47,41,6,60
Rapid Vienna,999,5,13,10,13,52,42,10,49
Admira Wacke,999,6,13,9,14,41,51,-10,48
RZ Pellets W,999,7,11,7,18,41,59,-18,40
Mattersburg,999,8,9,10,17,35,51,-16,37
SV Josko Rie,999,9,9,10,17,30,46,-16,37
St. Pölten,999,10,7,8,21,41,70,-29,29
SC Rheindorf,1000,1,25,4,7,61,37,24,79
SK Sturm Gra,1000,2,19,8,9,70,44,26,65
FC Salzburg,1000,3,18,10,8,55,28,27,64
Vienna,1000,4,16,4,16,60,59,1,52
RZ Pellets W,1000,5,14,7,15,51,58,-7,49
Admira Wacke,1000,6,14,5,17,38,56,-18,47
Rapid Vienna,1000,7,10,12,14,45,41,4,42
St. Pölten,1000,8,9,11,16,47,64,-17,38
Mattersburg,1000,9,8,11,17,37,53,-16,35
SV Josko Rie,1000,10,7,8,21,32,56,-24,29
FC Salzburg,1001,1,21,5,10,71,43,28,68
SK Sturm Gra,1001,2,19,6,11,57,37,20,63
SC Rheindorf,1001,3,18,8,10,53,43,10,62
Rapid Vienna,1001,4,16,9,11,51,40,11,57
Vienna,1001,5,16,8,12,62,55,7,56
RZ Pellets W,1001,6,14,6,16,48,52,-4,48
SV Josko Rie,1001,7,12,7,17,40,51,-11,43
Admira Wacke,1001,8,11,5,20,35,62,-27,38
St. Pölten,1001,9,9,10,17,51,65,-14,37
Mattersburg,1001,10,9,6,21,41,61,-20,33
FC Salzburg,1002,1,21,8,7,64,33,31,71
SC Rheindorf,1002,2,20,7,9,61,44,17,67
SK Sturm Gra,1002,3,20,6,10,62,33,29,66
Vienna,1002,4,18,6,12,65,58,7,60
Rapid Vienna,1002,5,14,12,10,57,38,19,54
RZ Pellets W,1002,6,12,9,15,49,54,-5,45
Admira Wacke,1002,7,11,6,19,35,61,-26,39
Mattersburg,1002,8,8,10,18,40,58,-18,34
SV Josko Rie,1002,9,8,7,21,32,58,-26,31
St. Pölten,1002,10,6,13,17,36,64,-28,31
FC Salzburg,1003,1,22,8,6,62,28,34,74
SK Sturm Gra,1003,2,18,7,11,52,32,20,61
SC Rheindorf,1003,3,18,7,11,50,40,10,61
Vienna,1003,4,17,3,16,56,50,6,54
RZ Pellets W,1003,5,14,9,13,50,54,-4,51
Rapid Vienna,1003,6,12,10,14,49,40,9,46
SV Josko Rie,1003,7,14,4,18,32,47,-15,46
Admira Wacke,1003,8,12,7,17,44,61,-17,43
St. Pölten,1003,9,11,7,18,41,61,-20,40
Mattersburg,1003,10,7,8,21,34,57,-23,29
SC Rheindorf,1004,1,21,7,8,63,44,19,70
FC Salzburg,1004,2,20,8,8,64,28,36,68
SK Sturm Gra,1004,3,20,5,11,65,42,23,65
Vienna,1004,4,19,4,13,66,62,4,61
Rapid Vienna,1004,5,14,11,11,60,43,17,53
RZ Pellets W,1004,6,12,6,18,47,55,-8,42
St. Pölten,1004,7,10,10,16,47,68,-21,40
SV Josko Rie,1004,8,11,5,20,30,51,-21,38
Admira Wacke,1004,9,10,8,18,40,62,-22,38
Mattersburg,1004,10,6,10,20,31,58,-27,28
FC Salzburg,1005,1,22,8,6,68,30,38,74
SK Sturm Gra,1005,2,22,4,10,60,36,24,70
SC Rheindorf,1005,3,19,8,9,55,43,12,65
Rapid Vienna,1005,4,17,9,10,60,38,22,60
Vienna,1005,5,18,5,13,63,58,5,59
RZ Pellets W,1005,6,12,7,17,43,54,-11,43
Mattersburg,1005,7,10,7,19,38,57,-19,37
Admira Wacke,1005,8,9,7,20,36,63,-27,34
St. Pölten,1005,9,7,11,18,42,64,-22,32
SV Josko Rie,1005,10,8,6,22,33,55,-22,30
SC Rheindorf,1006,1,23,6,7,55,33,22,75
FC Salzburg,1006,2,21,10,5,69,27,42,73
SK Sturm Gra,1006,3,22,4,10,61,31,30,70
Vienna,1006,4,16,8,12,54,52,2,56
Admira Wacke,1006,5,14,7,15,35,49,-14,49
Rapid Vienna,1006,6,12,11,13,49,41,8,47
SV Josko Rie,1006,7,9,8,19,35,53,-18,35
RZ Pellets W,1006,8,8,11,17,37,57,-20,35
Mattersburg,1006,9,8,8,20,41,58,-17,32
St. Pölten,1006,10,5,11,20,37,72,-35,26
FC Salzburg,1007,1,22,4,10,67,30,37,70
SK Sturm Gra,1007,2,20,7,9,63,34,29,67
SC Rheindorf,1007,3,20,6,10,48,39,9,66
Vienna,1007,4,18,6,12,61,47,14,60
Rapid Vienna,1007,5,15,11,10,53,36,17,56
RZ Pellets W,1007,6,10,11,15,38,51,-13,41
Admira Wacke,1007,7,9,10,17,31,57,-26,37
St. Pölten,1007,8,8,12,16,38,57,-19,36
Mattersburg,1007,9,9,8,19,34,53,-19,35
SV Josko Rie,1007,10,9,5,22,27,56,-29,32
FC Salzburg,1008,1,22,6,8,64,24,40,72
SK Sturm Gra,1008,2,20,7,9,57,31,26,67
SC Rheindorf,1008,3,20,7,9,60,41,19,67
Vienna,1008,4,16,7,13,52,52,0,55
Rapid Vienna,1008,5,11,12,13,50,41,9,45
RZ Pellets W,1008,6,11,9,16,48,59,-11,42
Mattersburg,1008,7,12,6,18,38,51,-13,42
SV Josko Rie,1008,8,11,7,18,32,42,-10,40
Admira Wacke,1008,9,10,9,17,34,59,-25,39
St. Pölten,1008,10,8,8,20,33,68,-35,32
FC Salzburg,1009,1,21,8,7,71,32,39,71
Vienna,1009,2,21,4,11,68,49,19,67
SK Sturm Gra,1009,3,20,5,11,63,36,27,65
SC Rheindorf,1009,4,17,8,11,49,43,6,59
Rapid Vienna,1009,5,12,14,10,53,37,16,50
SV Josko Rie,1009,6,12,7,17,37,49,-12,43
RZ Pellets W,1009,7,12,5,19,43,57,-14,41
Admira Wacke,1009,8,10,7,19,36,71,-35,37
Mattersburg,1009,9,8,11,17,40,62,-22,35
St. Pölten,1009,10,7,11,18,35,59,-24,32
Vienna,1010,1,21,6,9,67,44,23,69
SC Rheindorf,1010,2,20,7,9,56,44,12,67
Rapid Vienna,1010,3,19,8,9,62,38,24,65
FC Salzburg,1010,4,18,9,9,59,31,28,63
SK Sturm Gra,1010,5,14,11,11,54,40,14,53
RZ Pellets W,1010,6,13,7,16,43,53,-10,46
Admira Wacke,1010,7,10,7,19,34,63,-29,37
Mattersburg,1010,8,9,8,19,37,53,-16,35
SV Josko Rie,1010,9,8,9,19,26,47,-21,33
St. Pölten,1010,10,8,8,20,35,60,-25,32
FC Salzburg,1011,1,18,9,9,59,31,28,63
SC Rheindorf,1011,2,17,10,9,56,46,10,61
Rapid Vienna,1011,3,17,9,10,64,42,22,60
SK Sturm Gra,1011,4,17,8,11,57,34,23,59
Vienna,1011,5,18,3,15,61,58,3,57
RZ Pellets W,1011,6,16,6,14,49,48,1,54
SV Josko Rie,1011,7,13,7,16,31,43,-12,46
Admira Wacke,1011,8,10,7,19,33,58,-25,37
Mattersburg,1011,9,8,9,19,35,54,-19,33
St. Pölten,1011,10,8,8,20,37,68,-31,32
FC Salzburg,1012,1,20,8,8,64,32,32,68
SC Rheindorf,1012,2,20,7,9,61,52,9,67
Vienna,1012,3,19,7,10,66,52,14,64
SK Sturm Gra,1012,4,18,6,12,62,37,25,60
Rapid Vienna,1012,5,15,9,12,58,40,18,54
RZ Pellets W,1012,6,14,7,15,46,51,-5,49
SV Josko Rie,1012,7,11,5,20,36,57,-21,38
St. Pölten,1012,8,9,10,17,44,62,-18,37
Admira Wacke,1012,9,10,6,20,38,67,-29,36
Mattersburg,1012,10,7,9,20,39,64,-25,30
FC Salzburg,1013,1,23,5,8,70,34,36,74
SK Sturm Gra,1013,2,18,8,10,55,39,16,62
SC Rheindorf,1013,3,17,9,10,54,44,10,60
Vienna,1013,4,16,7,13,65,56,9,55
RZ Pellets W,1013,5,15,7,14,54,58,-4,52
Rapid Vienna,1013,6,13,11,12,58,43,15,50
Admira Wacke,1013,7,14,5,17,41,60,-19,47
St. Pölten,1013,8,9,10,17,46,62,-16,37
Mattersburg,1013,9,8,9,19,37,58,-21,33
SV Josko Rie,1013,10,10,3,23,29,55,-26,33
FC Salzburg,1014,1,25,5,6,65,23,42,80
SC Rheindorf,1014,2,18,11,7,55,38,17,65
SK Sturm Gra,1014,3,17,5,14,59,39,20,56
Vienna,1014,4,17,4,15,64,56,8,55
Admira Wacke,1014,5,12,11,13,42,56,-14,47
Rapid Vienna,1014,6,11,13,12,56,45,11,46
SV Josko Rie,1014,7,11,8,17,37,57,-20,41
St. Pölten,1014,8,10,9,17,45,62,-17,39
RZ Pellets W,1014,9,10,9,17,45,63,-18,39
Mattersburg,1014,10,6,11,19,36,65,-29,29
FC Salzburg,1015,1,22,7,7,73,34,39,73
SC Rheindorf,1015,2,20,7,9,61,41,20,67
SK Sturm Gra,1015,3,17,9,10,53,34,19,60
Vienna,1015,4,19,3,14,65,57,8,60
Rapid Vienna,1015,5,16,11,9,56,31,25,59
RZ Pellets W,1015,6,12,11,13,52,56,-4,47
SV Josko Rie,1015,7,10,8,18,32,51,-19,38
Admira Wacke,1015,8,8,11,17,34,67,-33,35
St. Pölten,1015,9,7,12,17,36,64,-28,33
Mattersburg,1015,10,5,9,22,31,58,-27,24
Vienna,1016,1,20,7,9,63,46,17,67
FC Salzburg,1016,2,19,8,9,64,34,30,65
Rapid Vienna,1016,3,18,9,9,61,34,27,63
SC Rheindorf,1016,4,18,9,9,59,49,10,63
SK Sturm Gra,1016,5,17,9,10,55,34,21,60
Admira Wacke,1016,6,12,4,20,44,71,-27,40
St. Pölten,1016,7,10,8,18,45,65,-20,38
RZ Pellets W,1016,8,10,6,20,38,59,-21,36
Mattersburg,1016,9,8,10,18,37,54,-17,34
SV Josko Rie,1016,10,8,10,18,32,52,-20,34
SC Rheindorf,1017,1,20,9,7,58,36,22,69
SK Sturm Gra,1017,2,19,7,10,58,34,24,64
FC Salzburg,1017,3,19,6,11,66,32,34,63
Vienna,1017,4,17,7,12,65,59,6,58
Rapid Vienna,1017,5,14,10,12,52,40,12,52
RZ Pellets W,1017,6,11,12,13,43,51,-8,45
SV Josko Rie,1017,7,12,5,19,34,56,-22,41
Mattersburg,1017,8,9,10,17,35,48,-13,37
Admira Wacke,1017,9,10,6,20,33,59,-26,36
St. Pölten,1017,10,7,12,17,37,66,-29,33
FC Salzburg,1018,1,21,8,7,62,28,34,71
SC Rheindorf,1018,2,19,8,9,59,41,18,65
SK Sturm Gra,1018,3,16,10,10,53,38,15,58
Vienna,1018,4,16,8,12,58,55,3,56
RZ Pellets W,1018,5,15,6,15,49,54,-5,51
Rapid Vienna,1018,6,13,11,12,59,44,15,50
Mattersburg,1018,7,12,7,17,41,53,-12,43
Admira Wacke,1018,8,10,7,19,36,62,-26,37
St. Pölten,1018,9,8,11,17,38,57,-19,35
SV Josko Rie,1018,10,9,6,21,35,58,-23,33
FC Salzburg,1019,1,20,7,9,65,37,28,67
SC Rheindorf,1019,2,18,9,9,51,36,15,63
Vienna,1019,3,19,6,11,62,51,11,63
SK Sturm Gra,1019,4,18,7,11,54,33,21,61
Rapid Vienna,1019,5,13,12,11,55,41,14,51
RZ Pellets W,1019,6,11,10,15,41,51,-10,43
SV Josko Rie,1019,7,12,7,17,34,49,-15,43
Admira Wacke,1019,8,11,6,19,34,55,-21,39
Mattersburg,1019,9,9,9,18,41,58,-17,36
St. Pölten,1019,10,8,9,19,41,67,-26,33
SC Rheindorf,1020,1,21,6,9,53,40,13,69
Vienna,1020,2,21,5,10,68,49,19,68
FC Salzburg,1020,3,19,9,8,54,29,25,66
SK Sturm Gra,1020,4,20,5,11,60,31,29,65
Rapid Vienna,1020,5,14,11,11,54,39,15,53
RZ Pellets W,1020,6,11,9,16,45,60,-15,42
Admira Wacke,1020,7,11,7,18,46,67,-21,40
SV Josko Rie,1020,8,11,5,20,35,52,-17,38
Mattersburg,1020,9,8,9,19,36,54,-18,33
St. Pölten,1020,10,7,8,21,33,63,-30,29
SK Sturm Gra,1021,1,21,6,9,71,36,35,69
SC Rheindorf,1021,2,20,7,9,54,37,17,67
Rapid Vienna,1021,3,19,7,10,64,38,26,64
FC Salzburg,1021,4,19,6,11,62,35,27,63
Vienna,1021,5,18,5,13,64,56,8,59
RZ Pellets W,1021,6,15,7,14,53,58,-5,52
Mattersburg,1021,7,10,7,19,34,54,-20,37
Admira Wacke,1021,8,10,5,21,35,64,-29,35
SV Josko Rie,1021,9,9,6,21,35,59,-24,33
St. Pölten,1021,10,8,6,22,35,70,-35,30
SK Sturm Gra,1022,1,24,5,7,64,26,38,77
FC Salzburg,1022,2,20,8,8,62,29,33,68
SC Rheindorf,1022,3,19,7,10,50,36,14,64
Vienna,1022,4,19,5,12,56,44,12,62
Rapid Vienna,1022,5,14,11,11,60,40,20,53
Admira Wacke,1022,6,14,6,16,38,59,-21,48
St. Pölten,1022,7,10,9,17,43,62,-19,39
SV Josko Rie,1022,8,11,3,22,36,55,-19,36
Mattersburg,1022,9,7,9,20,34,58,-24,30
RZ Pellets W,1022,10,8,5,23,35,69,-34,29
FC Salzburg,1023,1,20,9,7,68,29,39,69
SK Sturm Gra,1023,2,21,5,10,57,33,24,68
SC Rheindorf,1023,3,19,8,9,55,44,11,65
Vienna,1023,4,18,6,12,69,54,15,60
Rapid Vienna,1023,5,12,10,14,51,46,5,46
RZ Pellets W,1023,6,11,10,15,39,51,-12,43
SV Josko Rie,1023,7,12,4,20,38,57,-19,40
Mattersburg,1023,8,10,8,18,42,56,-14,38
St. Pölten,1023,9,9,10,17,39,62,-23,37
Admira Wacke,1023,10,10,6,20,35,61,-26,36
FC Salzburg,1024,1,23,6,7,72,27,45,75
SK Sturm Gra,1024,2,17,9,10,59,40,19,60
SC Rheindorf,1024,3,15,12,9,54,48,6,57
Vienna,1024,4,16,8,12,60,52,8,56
Rapid Vienna,1024,5,14,11,11,57,45,12,53
RZ Pellets W,1024,6,15,8,13,50,48,2,53
SV Josko Rie,1024,7,13,6,17,40,49,-9,45
St. Pölten,1024,8,9,8,19,41,70,-29,35
Admira Wacke,1024,9,8,9,19,29,56,-27,33
Mattersburg,1024,10,8,7,21,35,62,-27,31
SK Sturm Gra,1025,1,22,5,9,69,32,37,71
FC Salzburg,1025,2,21,5,10,67,32,35,68
Vienna,1025,3,20,6,10,58,44,14,66
SC Rheindorf,1025,4,19,5,12,52,47,5,62
Rapid Vienna,1025,5,12,14,10,57,43,14,50
RZ Pellets W,1025,6,10,11,15,42,59,-17,41
SV Josko Rie,1025,7,10,7,19,35,55,-20,37
Admira Wacke,1025,8,10,7,19,34,61,-27,37
St. Pölten,1025,9,9,9,18,43,63,-20,36
Mattersburg,1025,10,9,7,20,38,59,-21,34
FC Salzburg,1026,1,25,7,4,72,23,49,82
SK Sturm Gra,1026,2,22,4,10,61,34,27,70
SC Rheindorf,1026,3,19,8,9,57,42,15,65
Vienna,1026,4,17,5,14,57,50,7,56
Rapid Vienna,1026,5,13,9,14,56,49,7,48
RZ Pellets W,1026,6,12,6,18,50,59,-9,42
Admira Wacke,1026,7,11,7,18,35,59,-24,40
SV Josko Rie,1026,8,11,4,21,38,61,-23,37
St. Pölten,1026,9,10,6,20,44,70,-26,36
Mattersburg,1026,10,7,10,19,39,62,-23,31
FC Salzburg,1027,1,22,6,8,76,30,46,72
SC Rheindorf,1027,2,21,6,9,60,38,22,69
SK Sturm Gra,1027,3,19,7,10,63,37,26,64
Vienna,1027,4,18,6,12,58,58,0,60
Rapid Vienna,1027,5,14,12,10,60,38,22,54
St. Pölten,1027,6,11,7,18,44,69,-25,40
RZ Pellets W,1027,7,10,8,18,43,54,-11,38
SV Josko Rie,1027,8,10,8,18,36,51,-15,38
Admira Wacke,1027,9,11,4,21,34,70,-36,37
Mattersburg,1027,10,8,8,20,32,61,-29,32
FC Salzburg,1028,1,21,5,10,64,36,28,68
SC Rheindorf,1028,2,20,7,9,50,39,11,67
SK Sturm Gra,1028,3,20,4,12,58,37,21,64
Rapid Vienna,1028,4,17,9,10,59,42,17,60
Vienna,1028,5,18,3,15,65,53,12,57
RZ Pellets W,1028,6,12,6,18,42,54,-12,42
SV Josko Rie,1028,7,12,6,18,39,52,-13,42
Admira Wacke,1028,8,11,7,18,32,59,-27,40
St. Pölten,1028,9,9,8,19,38,56,-18,35
Mattersburg,1028,10,8,9,19,40,59,-19,33
FC Salzburg,1029,1,23,6,7,73,33,40,75
SK Sturm Gra,1029,2,21,6,9,61,36,25,69
SC Rheindorf,1029,3,18,10,8,53,43,10,64
Vienna,1029,4,18,6,12,62,52,10,60
Admira Wacke,1029,5,13,7,16,40,55,-15,46
Rapid Vienna,1029,6,12,9,15,51,47,4,45
RZ Pellets W,1029,7,11,9,16,53,57,-4,42
SV Josko Rie,1029,8,9,11,16,40,53,-13,38
St. Pölten,1029,9,8,8,20,44,77,-33,32
Mattersburg,1029,10,6,10,20,38,62,-24,28
FC Salzburg,1030,1,20,7,9,64,34,30,67
Vienna,1030,2,21,4,11,67,47,20,67
SC Rheindorf,1030,3,19,7,10,58,45,13,64
SK Sturm Gra,1030,4,17,9,10,55,35,20,60
Rapid Vienna,1030,5,13,14,9,59,40,19,53
RZ Pellets W,1030,6,15,7,14,49,60,-11,52
Admira Wacke,1030,7,11,6,19,40,64,-24,39
St. Pölten,1030,8,10,8,18,45,64,-19,38
Mattersburg,1030,9,10,7,19,48,58,-10,37
SV Josko Rie,1030,10,8,3,25,27,65,-38,27
SC Rheindorf,1031,1,20,9,7,60,47,13,69
FC Salzburg,1031,2,20,8,8,57,26,31,68
SK Sturm Gra,1031,3,19,6,11,66,35,31,63
Vienna,1031,4,17,5,14,63,58,5,56
Mattersburg,1031,5,12,10,14,43,50,-7,46
RZ Pellets W,1031,6,11,10,15,45,54,-9,43
Rapid Vienna,1031,7,10,10,16,44,44,0,40
Admira Wacke,1031,8,12,4,20,33,55,-22,40
St. Pölten,1031,9,9,11,16,45,63,-18,38
SV Josko Rie,1031,10,11,5,20,34,58,-24,38
FC Salzburg,1032,1,25,5,6,74,23,51,80
SK Sturm Gra,1032,2,20,4,12,63,39,24,64
SC Rheindorf,1032,3,18,9,9,50,38,12,63
Vienna,1032,4,17,5,14,56,55,1,56
Rapid Vienna,1032,5,12,13,11,50,40,10,49
RZ Pellets W,1032,6,12,11,13,46,47,-1,47
Admira Wacke,1032,7,12,5,19,38,60,-22,41
SV Josko Rie,1032,8,10,6,20,29,51,-22,36
St. Pölten,1032,9,7,13,16,34,64,-30,34
Mattersburg,1032,10,7,9,20,34,57,-23,30
FC Salzburg,1033,1,24,7,5,74,27,47,79
SC Rheindorf,1033,2,20,5,11,56,48,8,65
SK Sturm Gra,1033,3,19,7,10,64,36,28,64
Vienna,1033,4,17,7,12,60,50,10,58
Rapid Vienna,1033,5,13,11,12,54,44,10,50
St. Pölten,1033,6,10,10,16,42,58,-16,40
SV Josko Rie,1033,7,11,6,19,36,53,-17,39
Admira Wacke,1033,8,10,7,19,35,62,-27,37
Mattersburg,1033,9,9,9,18,40,62,-22,36
RZ Pellets W,1033,10,9,7,20,41,62,-21,34
FC Salzburg,1034,1,19,9,8,75,39,36,66
SC Rheindorf,1034,2,19,9,8,56,43,13,66
Rapid Vienna,1034,3,17,9,10,61,38,23,60
SK Sturm Gra,1034,4,17,9,10,51,32,19,60
Vienna,1034,5,17,8,11,66,57,9,59
RZ Pellets W,1034,6,13,9,14,48,53,-5,48
Admira Wacke,1034,7,10,8,18,36,62,-26,38
St. Pölten,1034,8,9,10,17,48,61,-13,37
SV Josko Rie,1034,9,10,6,20,40,62,-22,36
Mattersburg,1034,10,5,11,20,37,71,-34,26
FC Salzburg,1035,1,21,8,7,66,31,35,71
SC Rheindorf,1035,2,20,8,8,62,45,17,68
SK Sturm Gra,1035,3,20,6,10,62,34,28,66
Vienna,1035,4,15,9,12,66,56,10,54
Rapid Vienna,1035,5,14,10,12,55,43,12,52
RZ Pellets W,1035,6,13,8,15,49,56,-7,47
Admira Wacke,1035,7,11,7,18,40,59,-19,40
SV Josko Rie,1035,8,10,7,19,34,56,-22,37
Mattersburg,1035,9,9,8,19,33,55,-22,35
St. Pölten,1035,10,7,9,20,35,67,-32,30
FC Salzburg,1036,1,20,7,9,70,42,28,67
SC Rheindorf,1036,2,20,7,9,52,36,16,67
SK Sturm Gra,1036,3,19,7,10,56,34,22,64
Rapid Vienna,1036,4,15,12,9,53,31,22,57
RZ Pellets W,1036,5,16,4,16,54,56,-2,52
Vienna,1036,6,15,4,17,58,59,-1,49
Admira Wacke,1036,7,13,4,19,36,55,-19,43
Mattersburg,1036,8,9,10,17,35,52,-17,37
SV Josko Rie,1036,9,8,10,18,34,57,-23,34
St. Pölten,1036,10,7,11,18,33,59,-26,32
FC Salzburg,1037,1,21,7,8,66,29,37,70
SK Sturm Gra,1037,2,20,7,9,58,28,30,67
SC Rheindorf,1037,3,17,13,6,52,39,13,64
Rapid Vienna,1037,4,17,11,8,55,30,25,62
Vienna,1037,5,18,5,13,64,58,6,59
RZ Pellets W,1037,6,15,6,15,48,45,3,51
Admira Wacke,1037,7,11,9,16,35,58,-23,42
St. Pölten,1037,8,8,9,19,35,62,-27,33
SV Josko Rie,1037,9,8,5,23,23,55,-32,29
Mattersburg,1037,10,5,8,23,32,64,-32,23
SC Rheindorf,1038,1,19,10,7,58,38,20,67
FC Salzburg,1038,2,19,9,8,60,28,32,66
Vienna,1038,3,19,7,10,63,50,13,64
SK Sturm Gra,1038,4,18,7,11,56,32,24,61
Admira Wacke,1038,5,13,8,15,45,60,-15,47
Rapid Vienna,1038,6,10,16,10,44,34,10,46
St. Pölten,1038,7,12,8,16,47,57,-10,44
RZ Pellets W,1038,8,12,8,16,43,58,-15,44
Mattersburg,1038,9,6,13,17,36,57,-21,31
SV Josko Rie,1038,10,7,4,25,25,63,-38,25
FC Salzburg,1039,1,22,5,9,65,35,30,71
Vienna,1039,2,19,8,9,68,51,17,65
Rapid Vienna,1039,3,18,8,10,69,44,25,62
SK Sturm Gra,1039,4,19,5,12,60,37,23,62
SC Rheindorf,1039,5,17,8,11,52,48,4,59
RZ Pellets W,1039,6,13,7,16,47,57,-10,46
St. Pölten,1039,7,10,8,18,40,62,-22,38
SV Josko Rie,1039,8,10,6,20,30,50,-20,36
Admira Wacke,1039,9,10,6,20,38,61,-23,36
Mattersburg,1039,10,8,7,21,38,62,-24,31
FC Salzburg,1040,1,21,10,5,71,31,40,73
SC Rheindorf,1040,2,18,7,11,53,50,3,61
Vienna,1040,3,18,5,13,58,49,9,59
SK Sturm Gra,1040,4,15,13,8,52,32,20,58
Rapid Vienna,1040,5,12,15,9,53,37,16,51
RZ Pellets W,1040,6,13,8,15,55,58,-3,47
SV Josko Rie,1040,7,12,6,18,39,49,-10,42
Admira Wacke,1040,8,8,11,17,33,63,-30,35
St. Pölten,1040,9,7,12,17,43,64,-21,33
Mattersburg,1040,10,7,11,18,38,62,-24,32
SC Rheindorf,1041,1,22,8,6,56,32,24,74
FC Salzburg,1041,2,20,6,10,67,40,27,66
SK Sturm Gra,1041,3,19,4,13,62,37,25,61
Vienna,1041,4,18,4,14,64,56,8,58
Rapid Vienna,1041,5,14,10,12,60,42,18,52
RZ Pellets W,1041,6,12,8,16,41,60,-19,44
Admira Wacke,1041,7,13,5,18,35,54,-19,44
St. Pölten,1041,8,10,9,17,45,70,-25,39
SV Josko Rie,1041,9,10,5,21,34,52,-18,35
Mattersburg,1041,10,9,7,20,45,66,-21,34
FC Salzburg,1042,1,22,6,8,71,34,37,72
SC Rheindorf,1042,2,19,8,9,51,36,15,65
SK Sturm Gra,1042,3,17,9,10,46,27,19,60
Rapid Vienna,1042,4,15,11,10,58,36,22,56
Vienna,1042,5,16,7,13,61,52,9,55
RZ Pellets W,1042,6,13,6,17,40,54,-14,45
Admira Wacke,1042,7,13,5,18,40,56,-16,44
SV Josko Rie,1042,8,13,4,19,38,52,-14,43
Mattersburg,1042,9,8,8,20,29,52,-23,32
St. Pölten,1042,10,5,14,17,35,70,-35,29
FC Salzburg,1043,1,22,8,6,75,31,44,74
SK Sturm Gra,1043,2,21,7,8,64,33,31,70
Vienna,1043,3,20,4,12,61,50,11,64
SC Rheindorf,1043,4,18,8,10,52,43,9,62
RZ Pellets W,1043,5,13,7,16,47,53,-6,46
Rapid Vienna,1043,6,10,13,13,48,46,2,43
Admira Wacke,1043,7,11,7,18,34,56,-22,40
SV Josko Rie,1043,8,10,7,19,32,54,-22,37
Mattersburg,1043,9,8,9,19,37,61,-24,33
St. Pölten,1043,10,8,8,20,43,66,-23,32
FC Salzburg,1044,1,20,8,8,67,34,33,68
SC Rheindorf,1044,2,20,6,10,67,49,18,66
Vienna,1044,3,20,4,12,58,50,8,64
Rapid Vienna,1044,4,14,13,9,60,46,14,55
SK Sturm Gra,1044,5,17,4,15,56,42,14,55
RZ Pellets W,1044,6,12,8,16,46,58,-12,44
Admira Wacke,1044,7,12,8,16,41,58,-17,44
Mattersburg,1044,8,10,7,19,39,52,-13,37
SV Josko Rie,1044,9,10,6,20,35,54,-19,36
St. Pölten,1044,10,8,10,18,40,66,-26,34
SK Sturm Gra,1045,1,20,6,10,65,38,27,66
SC Rheindorf,1045,2,18,10,8,52,37,15,64
Vienna,1045,3,20,4,12,60,48,12,64
FC Salzburg,1045,4,17,11,8,60,31,29,62
Admira Wacke,1045,5,14,10,12,47,47,0,52
Rapid Vienna,1045,6,12,14,10,56,42,14,50
RZ Pellets W,1045,7,12,8,16,44,57,-13,44
SV Josko Rie,1045,8,10,5,21,30,55,-25,35
Mattersburg,1045,9,7,9,20,35,60,-25,30
St. Pölten,1045,10,7,9,20,33,67,-34,30
FC Salzburg,1046,1,20,9,7,64,27,37,69
SC Rheindorf,1046,2,20,9,7,62,40,22,69
SK Sturm Gra,1046,3,19,4,13,62,39,23,61
Rapid Vienna,1046,4,17,9,10,57,35,22,60
Vienna,1046,5,16,6,14,58,52,6,54
RZ Pellets W,1046,6,14,6,16,53,60,-7,48
Admira Wacke,1046,7,14,5,17,38,62,-24,47
SV Josko Rie,1046,8,11,5,20,33,55,-22,38
St. Pölten,1046,9,7,9,20,34,67,-33,30
Mattersburg,1046,10,7,8,21,40,64,-24,29
SK Sturm Gra,1047,1,20,8,8,57,30,27,68
FC Salzburg,1047,2,18,13,5,65,30,35,67
SC Rheindorf,1047,3,19,6,11,52,37,15,63
Vienna,1047,4,19,5,12,64,49,15,62
Rapid Vienna,1047,5,14,13,9,52,38,14,55
RZ Pellets W,1047,6,12,7,17,41,50,-9,43
Mattersburg,1047,7,10,7,19,34,49,-15,37
SV Josko Rie,1047,8,10,6,20,31,54,-23,36
Admira Wacke,1047,9,8,10,18,31,65,-34,34
St. Pölten,1047,10,8,9,19,33,58,-25,33
FC Salzburg,1048,1,21,8,7,63,32,31,71
SC Rheindorf,1048,2,20,7,9,61,44,17,67
SK Sturm Gra,1048,3,19,8,9,61,32,29,65
Vienna,1048,4,20,2,14,61,49,12,62
Rapid Vienna,1048,5,14,8,14,47,40,7,50
RZ Pellets W,1048,6,12,8,16,47,56,-9,44
St. Pölten,1048,7,9,10,17,46,61,-15,37
Mattersburg,1048,8,10,7,19,35,54,-19,37
Admira Wacke,1048,9,10,7,19,33,64,-31,37
SV Josko Rie,1048,10,10,5,21,33,55,-22,35
FC Salzburg,1049,1,22,9,5,65,25,40,75
SK Sturm Gra,1049,2,21,6,9,58,32,26,69
Vienna,1049,3,19,5,12,58,52,6,62
Rapid Vienna,1049,4,15,11,10,57,41,16,56
SC Rheindorf,1049,5,16,8,12,50,47,3,56
RZ Pellets W,1049,6,10,12,14,45,53,-8,42
SV Josko Rie,1049,7,11,4,21,34,49,-15,37
St. Pölten,1049,8,9,10,17,40,57,-17,37
Admira Wacke,1049,9,9,8,19,31,59,-28,35
Mattersburg,1049,10,7,9,20,34,57,-23,30
SC Rheindorf,1050,1,25,5,6,63,35,28,80
FC Salzburg,1050,2,21,6,9,68,33,35,69
Vienna,1050,3,20,6,10,65,50,15,66
SK Sturm Gra,1050,4,15,8,13,48,38,10,53
Rapid Vienna,1050,5,13,11,12,50,37,13,50
RZ Pellets W,1050,6,11,8,17,46,60,-14,41
Admira Wacke,1050,7,10,9,17,34,54,-20,39
St. Pölten,1050,8,9,10,17,40,58,-18,37
Mattersburg,1050,9,8,9,19,31,52,-21,33
SV Josko Rie,1050,10,9,6,21,30,58,-28,33
SC Rheindorf,1051,1,21,8,7,62,40,22,71
FC Salzburg,1051,2,20,8,8,60,28,32,68
SK Sturm Gra,1051,3,18,7,11,56,33,23,61
Vienna,1051,4,18,4,14,57,48,9,58
Rapid Vienna,1051,5,14,10,12,63,43,20,52
Admira Wacke,1051,6,14,5,17,40,55,-15,47
Mattersburg,1051,7,11,8,17,38,57,-19,41
RZ Pellets W,1051,8,10,8,18,42,57,-15,38
SV Josko Rie,1051,9,10,7,19,34,58,-24,37
St. Pölten,1051,10,7,9,20,33,66,-33,30
FC Salzburg,1052,1,22,8,6,69,29,40,74
SC Rheindorf,1052,2,21,6,9,54,41,13,69
Vienna,1052,3,18,6,12,58,47,11,60
SK Sturm Gra,1052,4,18,5,13,58,38,20,59
Rapid Vienna,1052,5,14,14,8,53,34,19,56
RZ Pellets W,1052,6,12,9,15,43,54,-11,45
SV Josko Rie,1052,7,10,5,21,33,56,-23,35
Admira Wacke,1052,8,9,8,19,33,57,-24,35
St. Pölten,1052,9,8,10,18,42,65,-23,34
Mattersburg,1052,10,8,9,19,31,53,-22,33
FC Salzburg,1053,1,23,7,6,64,22,42,76
SC Rheindorf,1053,2,20,9,7,53,35,18,69
SK Sturm Gra,1053,3,18,6,12,56,36,20,60
Vienna,1053,4,17,7,12,55,45,10,58
Rapid Vienna,1053,5,13,10,13,52,45,7,49
RZ Pellets W,1053,6,12,10,14,52,54,-2,46
Admira Wacke,1053,7,13,4,19,35,58,-23,43
SV Josko Rie,1053,8,10,7,19,32,51,-19,37
Mattersburg,1053,9,8,8,20,43,67,-24,32
St. Pölten,1053,10,7,10,19,42,71,-29,31
FC Salzburg,1054,1,21,8,7,63,30,33,71
SC Rheindorf,1054,2,19,9,8,61,40,21,66
Vienna,1054,3,19,7,10,63,50,13,64
SK Sturm Gra,1054,4,18,9,9,63,36,27,63
Rapid Vienna,1054,5,12,13,11,56,42,14,49
St. Pölten,1054,6,11,9,16,46,62,-16,42
Admira Wacke,1054,7,12,6,18,38,60,-22,42
RZ Pellets W,1054,8,10,6,20,36,60,-24,36
SV Josko Rie,1054,9,9,7,20,37,60,-23,34
Mattersburg,1054,10,8,8,20,33,56,-23,32
SK Sturm Gra,1055,1,21,7,8,60,30,30,70
Vienna,1055,2,21,5,10,70,44,26,68
FC Salzburg,1055,3,20,7,9,64,32,32,67
Rapid Vienna,1055,4,16,11,9,57,36,21,59
SC Rheindorf,1055,5,17,8,11,48,43,5,59
SV Josko Rie,1055,6,13,4,19,38,54,-16,43
Mattersburg,1055,7,10,7,19,43,58,-15,37
RZ Pellets W,1055,8,10,6,20,43,68,-25,36
St. Pölten,1055,9,7,11,18,36,62,-26,32
Admira Wacke,1055,10,8,8,20,31,63,-32,32
FC Salzburg,1056,1,22,7,7,65,34,31,73
Vienna,1056,2,22,4,10,80,48,32,70
SC Rheindorf,1056,3,20,6,10,59,48,11,66
SK Sturm Gra,1056,4,16,9,11,53,37,16,57
Rapid Vienna,1056,5,15,10,11,65,46,19,55
RZ Pellets W,1056,6,12,7,17,46,59,-13,43
Mattersburg,1056,7,11,7,18,40,55,-15,40
Admira Wacke,1056,8,11,5,20,37,68,-31,38
SV Josko Rie,1056,9,9,6,21,37,58,-21,33
St. Pölten,1056,10,6,11,19,42,71,-29,29
SC Rheindorf,1057,1,20,10,6,58,35,23,70
FC Salzburg,1057,2,20,8,8,62,31,31,68
SK Sturm Gra,1057,3,19,8,9,63,34,29,65
Vienna,1057,4,15,9,12,62,61,1,54
Rapid Vienna,1057,5,12,11,13,54,47,7,47
RZ Pellets W,1057,6,13,8,15,48,57,-9,47
Admira Wacke,1057,7,10,11,15,38,56,-18,41
SV Josko Rie,1057,8,9,8,19,35,57,-22,35
St. Pölten,1057,9,8,10,18,42,66,-24,34
Mattersburg,1057,10,8,9,19,39,57,-18,33
FC Salzburg,1058,1,23,8,5,66,29,37,77
SK Sturm Gra,1058,2,19,5,12,56,35,21,62
SC Rheindorf,1058,3,18,6,12,47,46,1,60
Vienna,1058,4,16,6,14,61,55,6,54
Rapid Vienna,1058,5,14,10,12,52,39,13,52
Admira Wacke,1058,6,13,6,17,42,55,-13,45
RZ Pellets W,1058,7,11,10,15,51,62,-11,43
Mattersburg,1058,8,11,8,17,40,50,-10,41
SV Josko Rie,1058,9,10,7,19,35,53,-18,37
St. Pölten,1058,10,8,8,20,41,67,-26,32
SC Rheindorf,1059,1,17,13,6,51,39,12,64
FC Salzburg,1059,2,17,12,7,62,40,22,63
SK Sturm Gra,1059,3,18,6,12,57,40,17,60
Vienna,1059,4,18,6,12,66,56,10,60
Rapid Vienna,1059,5,15,10,11,60,40,20,55
RZ Pellets W,1059,6,14,7,15,58,59,-1,49
Admira Wacke,1059,7,13,4,19,39,60,-21,43
SV Josko Rie,1059,8,10,8,18,37,52,-15,38
St. Pölten,1059,9,8,10,18,43,67,-24,34
Mattersburg,1059,10,7,10,19,37,57,-20,31
FC Salzburg,1060,1,23,7,6,71,29,42,76
SK Sturm Gra,1060,2,21,6,9,67,26,41,69
SC Rheindorf,1060,3,20,9,7,56,35,21,69
Rapid Vienna,1060,4,16,10,10,59,37,22,58
Vienna,1060,5,17,4,15,57,55,2,55
Mattersburg,1060,6,10,8,18,41,58,-17,38
Admira Wacke,1060,7,11,5,20,36,67,-31,38
RZ Pellets W,1060,8,10,6,20,42,67,-25,36
St. Pölten,1060,9,8,11,17,39,65,-26,35
SV Josko Rie,1060,10,8,6,22,28,57,-29,30
SK Sturm Gra,1061,1,19,9,8,58,30,28,66
SC Rheindorf,1061,2,20,6,10,56,43,13,66
FC Salzburg,1061,3,19,8,9,66,37,29,65
Rapid Vienna,1061,4,16,11,9,59,36,23,59
Vienna,1061,5,17,4,15,67,60,7,55
Admira Wacke,1061,6,13,10,13,41,53,-12,49
RZ Pellets W,1061,7,13,6,17,45,59,-14,45
Mattersburg,1061,8,11,8,17,41,51,-10,41
St. Pölten,1061,9,8,9,19,40,68,-28,33
SV Josko Rie,1061,10,7,3,26,25,61,-36,24
FC Salzburg,1062,1,21,6,9,60,26,34,69
Vienna,1062,2,20,4,12,67,54,13,64
SC Rheindorf,1062,3,19,6,11,52,40,12,63
SK Sturm Gra,1062,4,18,8,10,57,33,24,62
Rapid Vienna,1062,5,13,13,10,56,44,12,52
Admira Wacke,1062,6,11,8,17,42,63,-21,41
SV Josko Rie,1062,7,11,7,18,33,49,-16,40
St. Pölten,1062,8,10,9,17,40,61,-21,39
RZ Pellets W,1062,9,10,7,19,41,56,-15,37
Mattersburg,1062,10,9,8,19,33,55,-22,35
FC Salzburg,1063,1,22,9,5,71,30,41,75
SC Rheindorf,1063,2,20,7,9,60,44,16,67
SK Sturm Gra,1063,3,19,6,11,53,34,19,63
Vienna,1063,4,19,5,12,63,50,13,62
Rapid Vienna,1063,5,14,12,10,56,39,17,54
RZ Pellets W,1063,6,14,8,14,52,52,0,50
St. Pölten,1063,7,9,10,17,45,65,-20,37
Mattersburg,1063,8,8,10,18,43,64,-21,34
Admira Wacke,1063,9,10,4,22,32,69,-37,34
SV Josko Rie,1063,10,6,7,23,31,59,-28,25
SC Rheindorf,1064,1,21,9,6,58,38,20,72
FC Salzburg,1064,2,20,7,9,64,32,32,67
Vienna,1064,3,20,3,13,61,51,10,63
SK Sturm Gra,1064,4,19,5,12,68,42,26,62
Rapid Vienna,1064,5,14,11,11,55,43,12,53
St. Pölten,1064,6,11,10,15,48,59,-11,43
RZ Pellets W,1064,7,11,7,18,45,64,-19,40
SV Josko Rie,1064,8,10,6,20,32,54,-22,36
Admira Wacke,1064,9,11,3,22,37,64,-27,36
Mattersburg,1064,10,7,11,18,34,55,-21,32
FC Salzburg,1065,1,22,7,7,66,32,34,73
SK Sturm Gra,1065,2,21,6,9,67,30,37,69
SC Rheindorf,1065,3,21,6,9,61,40,21,69
Vienna,1065,4,19,3,14,64,54,10,60
Rapid Vienna,1065,5,16,9,11,57,39,18,57
RZ Pellets W,1065,6,13,6,17,46,65,-19,45
Admira Wacke,1065,7,10,9,17,35,62,-27,39
Mattersburg,1065,8,9,9,18,39,53,-14,36
St. Pölten,1065,9,7,10,19,43,69,-26,31
SV Josko Rie,1065,10,7,5,24,28,62,-34,26
FC Salzburg,1066,1,21,9,6,74,32,42,72
SC Rheindorf,1066,2,21,8,7,59,36,23,71
SK Sturm Gra,1066,3,19,6,11,58,37,21,63
Rapid Vienna,1066,4,18,8,10,62,39,23,62
Vienna,1066,5,18,6,12,71,60,11,60
Mattersburg,1066,6,12,5,19,45,62,-17,41
SV Josko Rie,1066,7,11,5,20,35,57,-22,38
RZ Pellets W,1066,8,10,7,19,39,55,-16,37
Admira Wacke,1066,9,10,6,20,40,68,-28,36
St. Pölten,1066,10,5,10,21,33,70,-37,25
SK Sturm Gra,1067,1,22,4,10,66,32,34,70
FC Salzburg,1067,2,20,7,9,71,36,35,67
SC Rheindorf,1067,3,19,7,10,57,43,14,64
Rapid Vienna,1067,4,17,9,10,59,40,19,60
Vienna,1067,5,18,4,14,63,55,8,58
SV Josko Rie,1067,6,13,4,19,36,49,-13,43
Admira Wacke,1067,7,11,7,18,37,60,-23,40
RZ Pellets W,1067,8,10,9,17,38,59,-21,39
St. Pölten,1067,9,9,10,17,42,66,-24,37
Mattersburg,1067,10,7,7,22,39,68,-29,28
FC Salzburg,1068,1,23,7,6,70,28,42,76
SC Rheindorf,1068,2,22,5,9,52,42,10,71
SK Sturm Gra,1068,3,20,3,13,55,37,18,63
Vienna,1068,4,17,4,15,64,62,2,55
RZ Pellets W,1068,5,16,5,15,51,51,0,53
Admira Wacke,1068,6,14,5,17,45,53,-8,47
Rapid Vienna,1068,7,12,9,15,50,46,4,45
SV Josko Rie,1068,8,11,6,19,36,55,-19,39
St. Pölten,1068,9,9,8,19,43,62,-19,35
Mattersburg,1068,10,6,8,22,38,68,-30,26
FC Salzburg,1069,1,18,10,8,58,30,28,64
SC Rheindorf,1069,2,18,8,10,51,48,3,62
Vienna,1069,3,18,6,12,61,55,6,60
Rapid Vienna,1069,4,16,11,9,64,35,29,59
SK Sturm Gra,1069,5,15,11,10,52,36,16,56
Admira Wacke,1069,6,13,6,17,39,54,-15,45
St. Pölten,1069,7,10,12,14,39,50,-11,42
RZ Pellets W,1069,8,11,6,19,41,56,-15,39
SV Josko Rie,1069,9,11,5,20,33,53,-20,38
Mattersburg,1069,10,8,9,19,34,55,-21,33
SC Rheindorf,1070,1,24,7,5,69,39,30,79
SK Sturm Gra,1070,2,18,8,10,59,38,21,62
Vienna,1070,3,18,5,13,64,56,8,59
FC Salzburg,1070,4,16,10,10,64,35,29,58
Rapid Vienna,1070,5,15,12,9,54,37,17,57
RZ Pellets W,1070,6,12,7,17,40,51,-11,43
Admira Wacke,1070,7,10,8,18,35,57,-22,38
Mattersburg,1070,8,10,7,19,44,62,-18,37
SV Josko Rie,1070,9,9,9,18,35,59,-24,36
St. Pölten,1070,10,7,9,20,40,70,-30,30
FC Salzburg,1071,1,20,11,5,65,27,38,71
Vienna,1071,2,22,5,9,72,45,27,71
SK Sturm Gra,1071,3,18,8,10,53,33,20,62
SC Rheindorf,1071,4,17,10,9,51,46,5,61
Rapid Vienna,1071,5,12,12,12,58,50,8,48
RZ Pellets W,1071,6,13,5,18,50,58,-8,44
Mattersburg,1071,7,9,10,17,41,58,-17,37
Admira Wacke,1071,8,10,7,19,33,58,-25,37
St. Pölten,1071,9,9,9,18,41,63,-22,36
SV Josko Rie,1071,10,8,7,21,31,57,-26,31
FC Salzburg,1072,1,21,8,7,63,28,35,71
Vienna,1072,2,22,4,10,60,42,18,70
Rapid Vienna,1072,3,17,9,10,59,35,24,60
SK Sturm Gra,1072,4,18,6,12,54,36,18,60
SC Rheindorf,1072,5,17,8,11,53,44,9,59
RZ Pellets W,1072,6,13,6,17,41,53,-12,45
St. Pölten,1072,7,10,9,17,40,53,-13,39
Mattersburg,1072,8,10,7,19,35,56,-21,37
SV Josko Rie,1072,9,9,6,21,30,57,-27,33
Admira Wacke,1072,10,8,7,21,27,58,-31,31
FC Salzburg,1073,1,22,7,7,76,36,40,73
SC Rheindorf,1073,2,22,4,10,58,40,18,70
SK Sturm Gra,1073,3,20,7,9,73,36,37,67
Rapid Vienna,1073,4,18,8,10,63,43,20,62
Vienna,1073,5,17,5,14,54,56,-2,56
RZ Pellets W,1073,6,13,5,18,52,59,-7,44
Mattersburg,1073,7,12,6,18,44,56,-12,42
SV Josko Rie,1073,8,11,2,23,33,63,-30,35
Admira Wacke,1073,9,10,4,22,36,72,-36,34
St. Pölten,1073,10,7,8,21,40,68,-28,29
FC Salzburg,1074,1,22,8,6,71,34,37,74
SC Rheindorf,1074,2,21,7,8,57,41,16,70
SK Sturm Gra,1074,3,18,5,13,61,44,17,59
Rapid Vienna,1074,4,16,9,11,68,48,20,57
Vienna,1074,5,17,5,14,64,57,7,56
RZ Pellets W,1074,6,16,6,14,50,56,-6,54
Admira Wacke,1074,7,10,9,17,37,59,-22,39
SV Josko Rie,1074,8,10,5,21,30,50,-20,35
St. Pölten,1074,9,7,9,20,37,60,-23,30
Mattersburg,1074,10,7,9,20,34,60,-26,30
FC Salzburg,1075,1,22,7,7,67,28,39,73
SC Rheindorf,1075,2,18,10,8,53,39,14,64
SK Sturm Gra,1075,3,18,8,10,57,34,23,62
Vienna,1075,4,19,4,13,57,47,10,61
Admira Wacke,1075,5,13,6,17,43,58,-15,45
RZ Pellets W,1075,6,11,10,15,43,51,-8,43
Rapid Vienna,1075,7,10,10,16,43,47,-4,40
St. Pölten,1075,8,9,13,14,45,58,-13,40
SV Josko Rie,1075,9,11,6,19,32,55,-23,39
Mattersburg,1075,10,7,10,19,35,58,-23,31
FC Salzburg,1076,1,22,6,8,71,28,43,72
SK Sturm Gra,1076,2,21,6,9,59,32,27,69
Vienna,1076,3,17,9,10,58,47,11,60
SC Rheindorf,1076,4,15,9,12,49,47,2,54
Rapid Vienna,1076,5,14,9,13,55,44,11,51
Mattersburg,1076,6,11,11,14,44,52,-8,44
RZ Pellets W,1076,7,12,6,18,42,62,-20,42
Admira Wacke,1076,8,12,6,18,37,59,-22,42
St. Pölten,1076,9,11,8,17,43,58,-15,41
SV Josko Rie,1076,10,8,4,24,26,55,-29,28
SK Sturm Gra,1077,1,22,5,9,64,32,32,71
FC Salzburg,1077,2,21,7,8,68,28,40,70
Vienna,1077,3,20,3,13,68,56,12,63
SC Rheindorf,1077,4,17,7,12,49,49,0,58
Rapid Vienna,1077,5,13,10,13,55,44,11,49
RZ Pellets W,1077,6,13,8,15,47,59,-12,47
Admira Wacke,1077,7,11,7,18,34,61,-27,40
St. Pölten,1077,8,9,11,16,41,59,-18,38
SV Josko Rie,1077,9,9,7,20,36,55,-19,34
Mattersburg,1077,10,8,9,19,35,54,-19,33
FC Salzburg,1078,1,22,7,7,69,23,46,73
Vienna,1078,2,20,4,12,68,56,12,64
SC Rheindorf,1078,3,19,6,11,52,48,4,63
Rapid Vienna,1078,4,17,10,9,59,36,23,61
SK Sturm Gra,1078,5,15,10,11,50,38,12,55
SV Josko Rie,1078,6,13,8,15,42,46,-4,47
RZ Pellets W,1078,7,14,5,17,50,58,-8,47
Admira Wacke,1078,8,10,6,20,40,65,-25,36
Mattersburg,1078,9,7,10,19,33,59,-26,31
St. Pölten,1078,10,5,10,21,33,67,-34,25
FC Salzburg,1079,1,18,9,9,59,35,24,63
SC Rheindorf,1079,2,18,9,9,61,39,22,63
SK Sturm Gra,1079,3,18,9,9,55,33,22,63
Vienna,1079,4,17,7,12,64,53,11,58
Rapid Vienna,1079,5,15,12,9,63,39,24,57
RZ Pellets W,1079,6,13,7,16,50,61,-11,46
Admira Wacke,1079,7,13,3,20,42,64,-22,42
SV Josko Rie,1079,8,12,5,19,32,54,-22,41
Mattersburg,1079,9,9,8,19,38,56,-18,35
St. Pölten,1079,10,6,13,17,41,71,-30,31
SC Rheindorf,1080,1,23,7,6,52,32,20,76
Vienna,1080,2,19,7,10,68,48,20,64
FC Salzburg,1080,3,17,10,9,55,31,24,61
SK Sturm Gra,1080,4,16,10,10,57,39,18,58
Rapid Vienna,1080,5,12,13,11,57,45,12,49
RZ Pellets W,1080,6,11,8,17,44,56,-12,41
Admira Wacke,1080,7,11,7,18,33,60,-27,40
St. Pölten,1080,8,9,10,17,37,59,-22,37
Mattersburg,1080,9,9,9,18,37,50,-13,36
SV Josko Rie,1080,10,10,5,21,36,56,-20,35
FC Salzburg,1081,1,20,8,8,69,31,38,68
SK Sturm Gra,1081,2,18,6,12,51,29,22,60
SC Rheindorf,1081,3,17,9,10,61,51,10,60
Rapid Vienna,1081,4,15,12,9,60,39,21,57
Vienna,1081,5,16,7,13,56,55,1,55
RZ Pellets W,1081,6,14,8,14,50,55,-5,50
Admira Wacke,1081,7,12,7,17,42,59,-17,43
St. Pölten,1081,8,9,11,16,47,70,-23,38
Mattersburg,1081,9,10,6,20,42,64,-22,36
SV Josko Rie,1081,10,9,6,21,34,59,-25,33
FC Salzburg,1082,1,19,11,6,66,38,28,68
Vienna,1082,2,20,6,10,71,50,21,66
SC Rheindorf,1082,3,18,10,8,67,52,15,64
SK Sturm Gra,1082,4,18,9,9,58,36,22,63
Rapid Vienna,1082,5,16,11,9,72,46,26,59
RZ Pellets W,1082,6,12,6,18,49,64,-15,42
Mattersburg,1082,7,8,11,17,40,60,-20,35
Admira Wacke,1082,8,9,7,20,30,55,-25,34
SV Josko Rie,1082,9,10,4,22,35,63,-28,34
St. Pölten,1082,10,8,9,19,54,78,-24,33
FC Salzburg,1083,1,23,7,6,72,31,41,76
SK Sturm Gra,1083,2,21,4,11,63,31,32,67
Vienna,1083,3,19,4,13,61,57,4,61
SC Rheindorf,1083,4,17,7,12,52,45,7,58
RZ Pellets W,1083,5,13,9,14,51,55,-4,48
Rapid Vienna,1083,6,12,11,13,48,43,5,47
Mattersburg,1083,7,12,9,15,41,48,-7,45
SV Josko Rie,1083,8,12,3,21,37,54,-17,39
Admira Wacke,1083,9,11,6,19,38,64,-26,39
St. Pölten,1083,10,5,10,21,35,70,-35,25
SC Rheindorf,1084,1,23,6,7,57,33,24,75
SK Sturm Gra,1084,2,20,6,10,60,34,26,66
FC Salzburg,1084,3,19,7,10,63,39,24,64
Vienna,1084,4,19,5,12,61,54,7,62
Rapid Vienna,1084,5,16,10,10,58,37,21,58
RZ Pellets W,1084,6,13,8,15,50,54,-4,47
Admira Wacke,1084,7,11,4,21,31,59,-28,37
SV Josko Rie,1084,8,10,6,20,28,50,-22,36
Mattersburg,1084,9,7,9,20,36,61,-25,30
St. Pölten,1084,10,6,11,19,39,62,-23,29
FC Salzburg,1085,1,22,7,7,68,28,40,73
SC Rheindorf,1085,2,20,8,8,56,44,12,68
Vienna,1085,3,20,6,10,59,44,15,66
SK Sturm Gra,1085,4,18,5,13,57,37,20,59
Rapid Vienna,1085,5,16,9,11,56,39,17,57
RZ Pellets W,1085,6,13,10,13,47,52,-5,49
Admira Wacke,1085,7,11,6,19,33,59,-26,39
Mattersburg,1085,8,7,10,19,32,53,-21,31
SV Josko Rie,1085,9,8,7,21,31,56,-25,31
St. Pölten,1085,10,6,10,20,39,66,-27,28
FC Salzburg,1086,1,20,9,7,75,33,42,69
SC Rheindorf,1086,2,18,10,8,51,38,13,64
Vienna,1086,3,19,4,13,64,56,8,61
SK Sturm Gra,1086,4,19,3,14,62,39,23,60
Rapid Vienna,1086,5,13,12,11,59,45,14,51
RZ Pellets W,1086,6,12,9,15,50,57,-7,45
Mattersburg,1086,7,12,8,16,47,61,-14,44
SV Josko Rie,1086,8,11,7,18,37,54,-17,40
Admira Wacke,1086,9,9,7,20,35,66,-31,34
St. Pölten,1086,10,7,11,18,43,74,-31,32
FC Salzburg,1087,1,20,9,7,64,31,33,69
SC Rheindorf,1087,2,19,9,8,52,37,15,66
Rapid Vienna,1087,3,17,10,9,52,34,18,61
Vienna,1087,4,18,7,11,56,46,10,61
SK Sturm Gra,1087,5,15,8,13,49,35,14,53
Admira Wacke,1087,6,11,11,14,39,52,-13,44
RZ Pellets W,1087,7,12,7,17,49,64,-15,43
St. Pölten,1087,8,8,10,18,42,62,-20,34
SV Josko Rie,1087,9,10,4,22,36,61,-25,34
Mattersburg,1087,10,8,9,19,36,53,-17,33
SC Rheindorf,1088,1,21,7,8,65,42,23,70
SK Sturm Gra,1088,2,20,5,11,64,34,30,65
FC Salzburg,1088,3,18,9,9,56,28,28,63
Vienna,1088,4,18,4,14,60,53,7,58
Rapid Vienna,1088,5,14,12,10,55,39,16,54
Admira Wacke,1088,6,15,3,18,48,63,-15,48
SV Josko Rie,1088,7,11,7,18,41,57,-16,40
RZ Pellets W,1088,8,12,4,20,45,62,-17,40
St. Pölten,1088,9,9,9,18,40,68,-28,36
Mattersburg,1088,10,9,6,21,35,63,-28,33
SK Sturm Gra,1089,1,19,8,9,65,40,25,65
SC Rheindorf,1089,2,19,8,9,58,41,17,65
FC Salzburg,1089,3,18,9,9,66,35,31,63
RZ Pellets W,1089,4,14,11,11,58,58,0,53
Rapid Vienna,1089,5,13,12,11,53,42,11,51
Vienna,1089,6,15,5,16,61,65,-4,50
SV Josko Rie,1089,7,10,10,16,44,57,-13,40
Mattersburg,1089,8,9,12,15,39,51,-12,39
Admira Wacke,1089,9,10,8,18,35,59,-24,38
St. Pölten,1089,10,6,11,19,42,73,-31,29
SC Rheindorf,1090,1,22,8,6,57,40,17,74
FC Salzburg,1090,2,21,5,10,70,37,33,68
Vienna,1090,3,18,6,12,66,56,10,60
SK Sturm Gra,1090,4,15,8,13,53,37,16,53
Admira Wacke,1090,5,15,7,14,45,52,-7,52
Rapid Vienna,1090,6,13,10,13,56,45,11,49
RZ Pellets W,1090,7,10,9,17,41,58,-17,39
SV Josko Rie,1090,8,10,8,18,39,55,-16,38
St. Pölten,1090,9,8,11,17,42,65,-23,35
Mattersburg,1090,10,7,10,19,35,59,-24,31
FC Salzburg,1091,1,22,7,7,67,26,41,73
Vienna,1091,2,19,5,12,68,55,13,62
SC Rheindorf,1091,3,18,8,10,54,42,12,62
Rapid Vienna,1091,4,16,9,11,63,39,24,57
SK Sturm Gra,1091,5,16,8,12,57,43,14,56
Admira Wacke,1091,6,13,9,14,40,53,-13,48
RZ Pellets W,1091,7,11,8,17,41,54,-13,41
St. Pölten,1091,8,8,11,17,41,63,-22,35
SV Josko Rie,1091,9,9,7,20,33,60,-27,34
Mattersburg,1091,10,8,8,20,30,59,-29,32
FC Salzburg,1092,1,22,8,6,71,29,42,74
Vienna,1092,2,22,4,10,70,45,25,70
SC Rheindorf,1092,3,21,7,8,58,36,22,70
Rapid Vienna,1092,4,15,10,11,64,42,22,55
SK Sturm Gra,1092,5,16,5,15,49,40,9,53
RZ Pellets W,1092,6,14,7,15,45,51,-6,49
Admira Wacke,1092,7,11,9,16,37,57,-20,42
Mattersburg,1092,8,10,6,20,38,61,-23,36
SV Josko Rie,1092,9,9,5,22,34,67,-33,32
St. Pölten,1092,10,6,7,23,41,79,-38,25
FC Salzburg,1093,1,20,8,8,69,35,34,68
SK Sturm Gra,1093,2,19,5,12,53,34,19,62
SC Rheindorf,1093,3,17,8,11,57,45,12,59
Vienna,1093,4,18,4,14,63,55,8,58
Rapid Vienna,1093,5,14,12,10,57,43,14,54
RZ Pellets W,1093,6,15,7,14,48,51,-3,52
Admira Wacke,1093,7,14,6,16,44,60,-16,48
SV Josko Rie,1093,8,10,7,19,43,63,-20,37
St. Pölten,1093,9,9,9,18,45,63,-18,36
Mattersburg,1093,10,6,10,20,39,69,-30,28
FC Salzburg,1094,1,21,8,7,70,31,39,71
SC Rheindorf,1094,2,21,6,9,57,40,17,69
SK Sturm Gra,1094,3,19,5,12,57,31,26,62
Vienna,1094,4,18,5,13,60,56,4,59
Rapid Vienna,1094,5,12,11,13,51,43,8,47
RZ Pellets W,1094,6,13,6,17,43,56,-13,45
Admira Wacke,1094,7,12,6,18,36,56,-20,42
SV Josko Rie,1094,8,10,8,18,34,59,-25,38
Mattersburg,1094,9,8,11,17,37,53,-16,35
St. Pölten,1094,10,8,10,18,43,63,-20,34
SC Rheindorf,1095,1,20,9,7,60,34,26,69
FC Salzburg,1095,2,19,9,8,60,36,24,66
SK Sturm Gra,1095,3,19,8,9,64,34,30,65
Vienna,1095,4,18,5,13,67,54,13,59
Rapid Vienna,1095,5,14,10,12,55,43,12,52
RZ Pellets W,1095,6,13,7,16,46,55,-9,46
SV Josko Rie,1095,7,11,7,18,35,49,-14,40
Admira Wacke,1095,8,11,7,18,38,66,-28,40
St. Pölten,1095,9,9,8,19,38,65,-27,35
Mattersburg,1095,10,7,8,21,31,58,-27,29
FC Salzburg,1096,1,25,5,6,77,27,50,80
Vienna,1096,2,19,6,11,63,48,15,63
SK Sturm Gra,1096,3,18,5,13,59,41,18,59
SC Rheindorf,1096,4,16,9,11,48,43,5,57
Rapid Vienna,1096,5,15,9,12,50,41,9,54
RZ Pellets W,1096,6,12,7,17,44,52,-8,43
St. Pölten,1096,7,10,12,14,46,58,-12,42
Admira Wacke,1096,8,10,7,19,32,63,-31,37
Mattersburg,1096,9,8,10,18,33,54,-21,34
SV Josko Rie,1096,10,9,6,21,38,63,-25,33
FC Salzburg,1097,1,22,5,9,70,35,35,71
SC Rheindorf,1097,2,21,6,9,58,43,15,69
SK Sturm Gra,1097,3,21,5,10,60,36,24,68
Vienna,1097,4,19,4,13,63,54,9,61
RZ Pellets W,1097,5,14,4,18,44,52,-8,46
Rapid Vienna,1097,6,11,10,15,50,48,2,43
Admira Wacke,1097,7,11,9,16,39,58,-19,42
SV Josko Rie,1097,8,13,3,20,39,61,-22,42
Mattersburg,1097,9,10,6,20,49,58,-9,36
St. Pölten,1097,10,8,8,20,43,70,-27,32
SC Rheindorf,1098,1,22,6,8,64,45,19,72
SK Sturm Gra,1098,2,21,6,9,58,28,30,69
FC Salzburg,1098,3,17,8,11,61,40,21,59
Rapid Vienna,1098,4,15,9,12,56,38,18,54
Vienna,1098,5,14,8,14,54,55,-1,50
RZ Pellets W,1098,6,13,10,13,51,59,-8,49
Admira Wacke,1098,7,14,5,17,41,57,-16,47
SV Josko Rie,1098,8,11,6,19,35,52,-17,39
Mattersburg,1098,9,10,7,19,40,59,-19,37
St. Pölten,1098,10,6,9,21,36,63,-27,27
SC Rheindorf,1099,1,23,4,9,65,44,21,73
Vienna,1099,2,19,4,13,73,63,10,61
FC Salzburg,1099,3,17,9,10,67,38,29,60
SK Sturm Gra,1099,4,17,8,11,55,36,19,59
Rapid Vienna,1099,5,16,8,12,55,41,14,56
Admira Wacke,1099,6,14,7,15,48,61,-13,49
RZ Pellets W,1099,7,12,6,18,43,56,-13,42
St. Pölten,1099,8,10,9,17,46,61,-15,39
SV Josko Rie,1099,9,9,6,21,37,63,-26,33
Mattersburg,1099,10,8,9,19,33,59,-26,33
FC Salzburg,1100,1,22,5,9,67,36,31,71
SK Sturm Gra,1100,2,19,5,12,48,31,17,62
SC Rheindorf,1100,3,16,10,10,52,42,10,58
Vienna,1100,4,17,5,14,59,55,4,56
RZ Pellets W,1100,5,15,9,12,50,51,-1,54
Rapid Vienna,1100,6,14,9,13,54,42,12,51
Mattersburg,1100,7,9,13,14,40,50,-10,40
Admira Wacke,1100,8,10,8,18,36,58,-22,38
SV Josko Rie,1100,9,10,6,20,36,52,-16,36
St. Pölten,1100,10,8,10,18,37,62,-25,34
FC Salzburg,1101,1,22,10,4,69,25,44,76
SC Rheindorf,1101,2,20,5,11,52,40,12,65
SK Sturm Gra,1101,3,19,6,11,56,33,23,63
Vienna,1101,4,17,7,12,59,51,8,58
Rapid Vienna,1101,5,15,9,12,54,43,11,54
St. Pölten,1101,6,12,9,15,50,59,-9,45
RZ Pellets W,1101,7,11,9,16,44,58,-14,42
Admira Wacke,1101,8,12,5,19,37,55,-18,41
SV Josko Rie,1101,9,10,4,22,33,59,-26,34
Mattersburg,1101,10,6,8,22,30,61,-31,26
FC Salzburg,1102,1,20,9,7,64,32,32,69
SC Rheindorf,1102,2,19,8,9,66,44,22,65
SK Sturm Gra,1102,3,19,7,10,59,35,24,64
Vienna,1102,4,18,4,14,54,52,2,58
Rapid Vienna,1102,5,12,13,11,59,46,13,49
Admira Wacke,1102,6,13,9,14,50,58,-8,48
Mattersburg,1102,7,10,11,15,44,56,-12,41
RZ Pellets W,1102,8,11,6,19,43,61,-18,39
St. Pölten,1102,9,7,12,17,38,64,-26,33
SV Josko Rie,1102,10,8,7,21,32,61,-29,31
FC Salzburg,1103,1,23,7,6,74,30,44,76
SK Sturm Gra,1103,2,23,6,7,65,26,39,75
SC Rheindorf,1103,3,17,8,11,47,42,5,59
Vienna,1103,4,18,5,13,60,56,4,59
Rapid Vienna,1103,5,12,14,10,51,41,10,50
RZ Pellets W,1103,6,13,9,14,49,51,-2,48
Admira Wacke,1103,7,11,7,18,33,58,-25,40
SV Josko Rie,1103,8,11,4,21,38,53,-15,37
St. Pölten,1103,9,7,9,20,40,73,-33,30
Mattersburg,1103,10,5,11,20,37,64,-27,26
FC Salzburg,1104,1,21,7,8,59,29,30,70
SC Rheindorf,1104,2,18,9,9,55,46,9,63
SK Sturm Gra,1104,3,18,8,10,60,39,21,62
Vienna,1104,4,17,5,14,57,54,3,56
RZ Pellets W,1104,5,15,5,16,47,54,-7,50
Rapid Vienna,1104,6,12,13,11,54,40,14,49
Mattersburg,1104,7,10,9,17,37,49,-12,39
Admira Wacke,1104,8,11,6,19,32,52,-20,39
SV Josko Rie,1104,9,10,7,19,38,57,-19,37
St. Pölten,1104,10,8,11,17,42,61,-19,35
FC Salzburg,1105,1,22,6,8,70,31,39,72
SC Rheindorf,1105,2,22,6,8,63,46,17,72
SK Sturm Gra,1105,3,21,5,10,65,37,28,68
Vienna,1105,4,17,5,14,55,56,-1,56
Rapid Vienna,1105,5,15,9,12,57,42,15,54
RZ Pellets W,1105,6,13,7,16,45,53,-8,46
Admira Wacke,1105,7,12,5,19,49,68,-19,41
SV Josko Rie,1105,8,12,4,20,35,51,-16,40
Mattersburg,1105,9,8,7,21,35,57,-22,31
St. Pölten,1105,10,6,10,20,41,74,-33,28
FC Salzburg,1106,1,23,7,6,68,29,39,76
SK Sturm Gra,1106,2,23,6,7,76,34,42,75
Vienna,1106,3,19,4,13,69,54,15,61
SC Rheindorf,1106,4,18,7,11,52,44,8,61
RZ Pellets W,1106,5,15,7,14,49,52,-3,52
Rapid Vienna,1106,6,12,11,13,47,40,7,47
St. Pölten,1106,7,10,9,17,43,60,-17,39
Admira Wacke,1106,8,9,8,19,35,70,-35,35
Mattersburg,1106,9,6,10,20,34,61,-27,28
SV Josko Rie,1106,10,7,7,22,33,62,-29,28
FC Salzburg,1107,1,24,6,6,72,26,46,78
SK Sturm Gra,1107,2,22,6,8,61,28,33,72
SC Rheindorf,1107,3,20,6,10,52,45,7,66
Vienna,1107,4,20,4,12,69,55,14,64
Rapid Vienna,1107,5,16,10,10,56,37,19,58
St. Pölten,1107,6,10,9,17,46,66,-20,39
Admira Wacke,1107,7,10,7,19,39,59,-20,37
RZ Pellets W,1107,8,9,5,22,46,72,-26,32
Mattersburg,1107,9,8,8,20,38,65,-27,32
SV Josko Rie,1107,10,9,3,24,30,56,-26,30
SC Rheindorf,1108,1,24,5,7,64,38,26,77
FC Salzburg,1108,2,22,6,8,67,31,36,72
Vienna,1108,3,18,6,12,58,53,5,60
SK Sturm Gra,1108,4,17,8,11,59,38,21,59
SV Josko Rie,1108,5,14,3,19,44,53,-9,45
RZ Pellets W,1108,6,12,7,17,41,57,-16,43
Rapid Vienna,1108,7,10,12,14,46,43,3,42
St. Pölten,1108,8,10,9,17,44,57,-13,39
Admira Wacke,1108,9,11,5,20,31,57,-26,38
Mattersburg,1108,10,8,7,21,36,63,-27,31
FC Salzburg,1109,1,21,7,8,60,27,33,70
SK Sturm Gra,1109,2,19,7,10,59,39,20,64
SC Rheindorf,1109,3,19,7,10,59,45,14,64
Vienna,1109,4,19,5,12,58,45,13,62
Rapid Vienna,1109,5,13,11,12,52,37,15,50
Admira Wacke,1109,6,14,5,17,44,55,-11,47
RZ Pellets W,1109,7,12,8,16,50,62,-12,44
Mattersburg,1109,8,10,8,18,41,62,-21,38
SV Josko Rie,1109,9,9,7,20,34,56,-22,34
St. Pölten,1109,10,7,9,20,39,68,-29,30
FC Salzburg,1110,1,19,7,10,62,42,20,64
SC Rheindorf,1110,2,19,6,11,52,42,10,63
Rapid Vienna,1110,3,17,11,8,70,35,35,62
Vienna,1110,4,18,4,14,60,55,5,58
SK Sturm Gra,1110,5,16,8,12,56,42,14,56
Admira Wacke,1110,6,14,6,16,39,58,-19,48
RZ Pellets W,1110,7,13,8,15,46,50,-4,47
Mattersburg,1110,8,10,9,17,39,56,-17,39
SV Josko Rie,1110,9,10,8,18,34,47,-13,38
St. Pölten,1110,10,6,9,21,35,66,-31,27
FC Salzburg,1111,1,24,6,6,70,28,42,78
SC Rheindorf,1111,2,20,7,9,52,39,13,67
Rapid Vienna,1111,3,17,9,10,65,36,29,60
Vienna,1111,4,18,5,13,60,49,11,59
SK Sturm Gra,1111,5,17,7,12,56,37,19,58
RZ Pellets W,1111,6,11,7,18,40,56,-16,40
Admira Wacke,1111,7,11,7,18,32,58,-26,40
SV Josko Rie,1111,8,11,5,20,35,60,-25,38
Mattersburg,1111,9,8,9,19,36,62,-26,33
St. Pölten,1111,10,7,10,19,43,64,-21,31
SK Sturm Gra,1112,1,21,7,8,63,34,29,70
FC Salzburg,1112,2,20,8,8,59,28,31,68
Vienna,1112,3,21,5,10,67,52,15,68
Rapid Vienna,1112,4,16,9,11,55,37,18,57
SC Rheindorf,1112,5,15,7,14,44,43,1,52
RZ Pellets W,1112,6,10,10,16,46,60,-14,40
Admira Wacke,1112,7,10,10,16,39,58,-19,40
St. Pölten,1112,8,9,9,18,40,59,-19,36
SV Josko Rie,1112,9,9,8,19,32,55,-23,35
Mattersburg,1112,10,8,9,19,33,52,-19,33
FC Salzburg,1113,1,21,7,8,65,27,38,70
SK Sturm Gra,1113,2,19,7,10,62,36,26,64
SC Rheindorf,1113,3,17,9,10,47,41,6,60
Rapid Vienna,1113,4,15,12,9,56,39,17,57
Vienna,1113,5,17,5,14,58,57,1,56
Mattersburg,1113,6,14,6,16,41,46,-5,48
RZ Pellets W,1113,7,12,7,17,44,55,-11,43
Admira Wacke,1113,8,12,5,19,33,54,-21,41
SV Josko Rie,1113,9,11,3,22,36,56,-20,36
St. Pölten,1113,10,7,9,20,35,66,-31,30
FC Salzburg,1114,1,20,7,9,61,32,29,67
Vienna,1114,2,21,4,11,65,53,12,67
SC Rheindorf,1114,3,18,7,11,52,41,11,61
SK Sturm Gra,1114,4,17,6,13,62,37,25,57
Admira Wacke,1114,5,15,5,16,46,54,-8,50
Rapid Vienna,1114,6,12,13,11,54,44,10,49
RZ Pellets W,1114,7,11,8,17,40,54,-14,41
Mattersburg,1114,8,11,7,18,41,58,-17,40
SV Josko Rie,1114,9,10,7,19,29,54,-25,37
St. Pölten,1114,10,8,10,18,47,70,-23,34
FC Salzburg,1115,1,21,7,8,63,27,36,70
SK Sturm Gra,1115,2,21,6,9,59,27,32,69
Vienna,1115,3,19,5,12,64,52,12,62
SC Rheindorf,1115,4,18,6,12,54,45,9,60
Rapid Vienna,1115,5,11,11,14,48,47,1,44
SV Josko Rie,1115,6,13,5,18,41,55,-14,44
RZ Pellets W,1115,7,12,7,17,42,58,-16,43
Admira Wacke,1115,8,12,5,19,37,61,-24,41
St. Pölten,1115,9,9,9,18,44,64,-20,36
Mattersburg,1115,10,8,11,17,38,54,-16,35
FC Salzburg,1116,1,21,6,9,62,35,27,69
SC Rheindorf,1116,2,21,6,9,54,37,17,69
SK Sturm Gra,1116,3,20,6,10,66,38,28,66
Vienna,1116,4,17,7,12,65,49,16,58
Rapid Vienna,1116,5,13,12,11,52,38,14,51
Admira Wacke,1116,6,14,5,17,41,62,-21,47
St. Pölten,1116,7,10,11,15,42,55,-13,41
RZ Pellets W,1116,8,11,6,19,43,62,-19,39
Mattersburg,1116,9,9,8,19,37,57,-20,35
SV Josko Rie,1116,10,8,5,23,34,63,-29,29
SC Rheindorf,1117,1,21,7,8,55,39,16,70
SK Sturm Gra,1117,2,19,8,9,57,30,27,65
FC Salzburg,1117,3,17,12,7,59,32,27,63
Vienna,1117,4,16,7,13,56,52,4,55
Rapid Vienna,1117,5,14,10,12,52,41,11,52
RZ Pellets W,1117,6,12,9,15,46,55,-9,45
Admira Wacke,1117,7,11,9,16,38,53,-15,42
St. Pölten,1117,8,10,9,17,46,61,-15,39
SV Josko Rie,1117,9,8,9,19,34,58,-24,33
Mattersburg,1117,10,5,14,17,32,54,-22,29
FC Salzburg,1118,1,23,8,5,63,22,41,77
Vienna,1118,2,21,5,10,56,40,16,68
SC Rheindorf,1118,3,18,9,9,61,46,15,63
SK Sturm Gra,1118,4,18,7,11,56,35,21,61
Rapid Vienna,1118,5,11,13,12,49,42,7,46
RZ Pellets W,1118,6,12,6,18,43,57,-14,42
SV Josko Rie,1118,7,11,8,17,38,51,-13,41
Mattersburg,1118,8,10,9,17,39,53,-14,39
Admira Wacke,1118,9,10,7,19,32,55,-23,37
St. Pölten,1118,10,5,10,21,34,70,-36,25
SC Rheindorf,1119,1,20,7,9,59,36,23,67
SK Sturm Gra,1119,2,19,9,8,60,31,29,66
Vienna,1119,3,20,5,11,63,47,16,65
FC Salzburg,1119,4,18,8,10,61,35,26,62
Rapid Vienna,1119,5,16,9,11,59,37,22,57
SV Josko Rie,1119,6,13,3,20,37,59,-22,42
Admira Wacke,1119,7,11,7,18,35,60,-25,40
RZ Pellets W,1119,8,10,9,17,44,63,-19,39
St. Pölten,1119,9,10,7,19,45,69,-24,37
Mattersburg,1119,10,6,10,20,32,58,-26,28
FC Salzburg,1120,1,20,7,9,61,32,29,67
SK Sturm Gra,1120,2,19,7,10,63,36,27,64
Vienna,1120,3,18,7,11,62,52,10,61
SC Rheindorf,1120,4,16,8,12,52,46,6,56
RZ Pellets W,1120,5,15,8,13,47,53,-6,53
Rapid Vienna,1120,6,12,12,12,53,38,15,48
SV Josko Rie,1120,7,14,3,19,38,52,-14,45
Admira Wacke,1120,8,10,7,19,29,58,-29,37
St. Pölten,1120,9,9,9,18,47,66,-19,36
Mattersburg,1120,10,8,10,18,41,60,-19,34
FC Salzburg,1121,1,19,12,5,65,33,32,69
SC Rheindorf,1121,2,19,8,9,54,43,11,65
Rapid Vienna,1121,3,16,11,9,64,40,24,59
Vienna,1121,4,16,8,12,65,54,11,56
SK Sturm Gra,1121,5,16,6,14,52,41,11,54
SV Josko Rie,1121,6,13,5,18,40,51,-11,44
Mattersburg,1121,7,11,7,18,42,56,-14,40
Admira Wacke,1121,8,10,9,17,35,58,-23,39
RZ Pellets W,1121,9,10,8,18,45,61,-16,38
St. Pölten,1121,10,9,8,19,43,68,-25,35
FC Salzburg,1122,1,23,7,6,75,28,47,76
SK Sturm Gra,1122,2,20,6,10,64,37,27,66
SC Rheindorf,1122,3,19,9,8,57,44,13,66
Vienna,1122,4,18,6,12,66,53,13,60
Rapid Vienna,1122,5,11,11,14,53,46,7,44
Admira Wacke,1122,6,12,8,16,38,55,-17,44
RZ Pellets W,1122,7,11,7,18,44,62,-18,40
SV Josko Rie,1122,8,10,7,19,30,55,-25,37
St. Pölten,1122,9,9,8,19,39,59,-20,35
Mattersburg,1122,10,7,11,18,32,59,-27,32
Vienna,1123,1,21,5,10,60,42,18,68
FC Salzburg,1123,2,19,9,8,65,29,36,66
SK Sturm Gra,1123,3,20,5,11,56,32,24,65
SC Rheindorf,1123,4,17,8,11,47,40,7,59
RZ Pellets W,1123,5,13,8,15,46,51,-5,47
Rapid Vienna,1123,6,10,13,13,48,44,4,43
Admira Wacke,1123,7,11,9,16,38,61,-23,42
SV Josko Rie,1123,8,11,7,18,36,53,-17,40
Mattersburg,1123,9,9,8,19,36,56,-20,35
St. Pölten,1123,10,8,10,18,40,64,-24,34
FC Salzburg,1124,1,23,5,8,70,32,38,74
Vienna,1124,2,20,4,12,69,52,17,64
SK Sturm Gra,1124,3,17,11,8,55,34,21,62
SC Rheindorf,1124,4,18,6,12,51,47,4,60
Rapid Vienna,1124,5,15,11,10,57,42,15,56
RZ Pellets W,1124,6,14,6,16,46,52,-6,48
Admira Wacke,1124,7,10,7,19,42,64,-22,37
St. Pölten,1124,8,8,11,17,42,59,-17,35
SV Josko Rie,1124,9,9,6,21,31,55,-24,33
Mattersburg,1124,10,8,9,19,37,63,-26,33
FC Salzburg,1125,1,21,8,7,66,35,31,71
SC Rheindorf,1125,2,19,8,9,54,42,12,65
SK Sturm Gra,1125,3,17,7,12,61,36,25,58
Vienna,1125,4,17,7,12,65,51,14,58
Rapid Vienna,1125,5,16,8,12,54,40,14,56
Mattersburg,1125,6,11,8,17,44,60,-16,41
RZ Pellets W,1125,7,11,7,18,52,69,-17,40
St. Pölten,1125,8,11,7,18,48,66,-18,40
Admira Wacke,1125,9,11,7,18,37,63,-26,40
SV Josko Rie,1125,10,10,5,21,37,56,-19,35
SK Sturm Gra,1126,1,21,6,9,61,31,30,69
FC Salzburg,1126,2,20,7,9,66,34,32,67
Vienna,1126,3,20,5,11,68,48,20,65
SC Rheindorf,1126,4,18,10,8,48,34,14,64
Rapid Vienna,1126,5,14,9,13,56,42,14,51
RZ Pellets W,1126,6,14,6,16,50,53,-3,48
Admira Wacke,1126,7,13,5,18,38,62,-24,44
St. Pölten,1126,8,9,12,15,47,66,-19,39
SV Josko Rie,1126,9,9,3,24,36,69,-33,30
Mattersburg,1126,10,5,11,20,30,61,-31,26
FC Salzburg,1127,1,21,7,8,66,27,39,70
SC Rheindorf,1127,2,21,6,9,59,41,18,69
SK Sturm Gra,1127,3,18,8,10,59,39,20,62
Vienna,1127,4,18,4,14,53,51,2,58
Rapid Vienna,1127,5,14,12,10,61,45,16,54
Admira Wacke,1127,6,14,6,16,43,61,-18,48
RZ Pellets W,1127,7,11,8,17,52,60,-8,41
St. Pölten,1127,8,9,9,18,39,63,-24,36
SV Josko Rie,1127,9,9,6,21,33,57,-24,33
Mattersburg,1127,10,7,10,19,34,55,-21,31
FC Salzburg,1128,1,22,9,5,67,26,41,75
SC Rheindorf,1128,2,20,8,8,60,37,23,68
SK Sturm Gra,1128,3,19,6,11,58,40,18,63
Vienna,1128,4,17,5,14,58,54,4,56
Rapid Vienna,1128,5,14,9,13,59,49,10,51
Admira Wacke,1128,6,14,6,16,41,55,-14,48
Mattersburg,1128,7,10,10,16,42,56,-14,40
RZ Pellets W,1128,8,10,8,18,44,56,-12,38
St. Pölten,1128,9,8,10,18,38,63,-25,34
SV Josko Rie,1128,10,6,9,21,29,60,-31,27
FC Salzburg,1129,1,24,5,7,71,29,42,77
SC Rheindorf,1129,2,20,8,8,58,42,16,68
Rapid Vienna,1129,3,18,9,9,65,37,28,63
Vienna,1129,4,18,8,10,69,50,19,62
SK Sturm Gra,1129,5,18,7,11,64,42,22,61
St. Pölten,1129,6,10,9,17,40,66,-26,39
Admira Wacke,1129,7,11,5,20,35,66,-31,38
RZ Pellets W,1129,8,9,6,21,40,63,-23,33
Mattersburg,1129,9,9,6,21,39,62,-23,33
SV Josko Rie,1129,10,8,7,21,32,56,-24,31
FC Salzburg,1130,1,20,7,9,68,34,34,67
SC Rheindorf,1130,2,19,10,7,51,38,13,67
SK Sturm Gra,1130,3,19,5,12,57,36,21,62
Vienna,1130,4,18,3,15,57,59,-2,57
Admira Wacke,1130,5,15,4,17,39,52,-13,49
Rapid Vienna,1130,6,12,9,15,51,47,4,45
RZ Pellets W,1130,7,11,9,16,42,53,-11,42
SV Josko Rie,1130,8,11,7,18,37,51,-14,40
Mattersburg,1130,9,10,8,18,39,55,-16,38
St. Pölten,1130,10,8,12,16,39,55,-16,36
SC Rheindorf,1131,1,20,7,9,57,41,16,67
FC Salzburg,1131,2,20,6,10,59,31,28,66
SK Sturm Gra,1131,3,19,5,12,67,41,26,62
Vienna,1131,4,17,5,14,61,54,7,56
Rapid Vienna,1131,5,14,9,13,55,43,12,51
St. Pölten,1131,6,13,8,15,45,60,-15,47
RZ Pellets W,1131,7,12,8,16,50,60,-10,44
Admira Wacke,1131,8,12,7,17,39,60,-21,43
Mattersburg,1131,9,8,12,16,37,58,-21,36
SV Josko Rie,1131,10,9,5,22,28,50,-22,32
SK Sturm Gra,1132,1,22,7,7,68,29,39,73
FC Salzburg,1132,2,22,6,8,71,31,40,72
SC Rheindorf,1132,3,19,8,9,53,39,14,65
Vienna,1132,4,18,3,15,60,55,5,57
Rapid Vienna,1132,5,12,9,15,52,47,5,45
Admira Wacke,1132,6,13,5,18,33,63,-30,44
SV Josko Rie,1132,7,12,6,18,35,47,-12,42
RZ Pellets W,1132,8,12,6,18,43,57,-14,42
Mattersburg,1132,9,7,13,16,34,56,-22,34
St. Pölten,1132,10,5,13,18,40,65,-25,28
FC Salzburg,1133,1,21,7,8,68,27,41,70
Vienna,1133,2,21,6,9,59,40,19,69
SK Sturm Gra,1133,3,18,9,9,60,34,26,63
SC Rheindorf,1133,4,16,7,13,49,49,0,55
Rapid Vienna,1133,5,13,12,11,56,45,11,51
Mattersburg,1133,6,12,7,17,47,58,-11,43
RZ Pellets W,1133,7,11,8,17,45,59,-14,41
Admira Wacke,1133,8,11,8,17,38,56,-18,41
St. Pölten,1133,9,10,7,19,44,69,-25,37
SV Josko Rie,1133,10,10,3,23,31,60,-29,33
SK Sturm Gra,1134,1,21,4,11,59,36,23,67
FC Salzburg,1134,2,19,9,8,65,33,32,66
SC Rheindorf,1134,3,19,8,9,51,39,12,65
Rapid Vienna,1134,4,18,9,9,59,34,25,63
Vienna,1134,5,19,6,11,56,49,7,63
RZ Pellets W,1134,6,11,7,18,43,59,-16,40
Admira Wacke,1134,7,11,7,18,42,61,-19,40
Mattersburg,1134,8,8,11,17,38,57,-19,35
SV Josko Rie,1134,9,10,5,21,32,51,-19,35
St. Pölten,1134,10,6,10,20,42,68,-26,28
SC Rheindorf,1135,1,24,6,6,67,35,32,78
FC Salzburg,1135,2,20,10,6,60,25,35,70
Vienna,1135,3,20,6,10,67,47,20,66
SK Sturm Gra,1135,4,18,7,11,62,43,19,61
Rapid Vienna,1135,5,15,11,10,61,37,24,56
RZ Pellets W,1135,6,10,8,18,42,61,-19,38
Mattersburg,1135,7,9,8,19,39,60,-21,35
Admira Wacke,1135,8,9,8,19,32,61,-29,35
SV Josko Rie,1135,9,9,6,21,31,64,-33,33
St. Pölten,1135,10,6,10,20,44,72,-28,28
FC Salzburg,1136,1,22,8,6,67,27,40,74
SK Sturm Gra,1136,2,21,4,11,62,35,27,67
SC Rheindorf,1136,3,18,8,10,56,43,13,62
Vienna,1136,4,16,6,14,57,55,2,54
Rapid Vienna,1136,5,13,10,13,52,40,12,49
RZ Pellets W,1136,6,14,7,15,48,48,0,49
Admira Wacke,1136,7,11,9,16,39,59,-20,42
SV Josko Rie,1136,8,9,8,19,33,53,-20,35
Mattersburg,1136,9,9,8,19,34,66,-32,35
St. Pölten,1136,10,8,10,18,40,62,-22,34
SK Sturm Gra,1137,1,22,6,8,58,31,27,72
FC Salzburg,1137,2,21,8,7,67,28,39,71
SC Rheindorf,1137,3,19,10,7,62,42,20,67
Vienna,1137,4,19,5,12,62,47,15,62
Admira Wacke,1137,5,12,6,18,33,55,-22,42
Rapid Vienna,1137,6,10,11,15,49,48,1,41
RZ Pellets W,1137,7,11,8,17,46,57,-11,41
Mattersburg,1137,8,9,11,16,38,57,-19,38
SV Josko Rie,1137,9,10,6,20,30,55,-25,36
St. Pölten,1137,10,6,11,19,36,61,-25,29
FC Salzburg,1138,1,21,9,6,64,30,34,72
SK Sturm Gra,1138,2,19,5,12,61,33,28,62
Vienna,1138,3,17,10,9,64,53,11,61
SC Rheindorf,1138,4,17,8,11,55,45,10,59
Rapid Vienna,1138,5,12,11,13,51,42,9,47
RZ Pellets W,1138,6,13,7,16,48,57,-9,46
Admira Wacke,1138,7,13,6,17,39,58,-19,45
St. Pölten,1138,8,11,8,17,43,64,-21,41
SV Josko Rie,1138,9,11,4,21,36,60,-24,37
Mattersburg,1138,10,9,6,21,38,57,-19,33
FC Salzburg,1139,1,21,8,7,67,29,38,71
SC Rheindorf,1139,2,21,7,8,59,39,20,70
Rapid Vienna,1139,3,17,8,11,60,37,23,59
Vienna,1139,4,18,5,13,55,50,5,59
SK Sturm Gra,1139,5,17,7,12,54,37,17,58
RZ Pellets W,1139,6,12,8,16,40,51,-11,44
Admira Wacke,1139,7,11,6,19,37,60,-23,39
Mattersburg,1139,8,9,11,16,42,55,-13,38
SV Josko Rie,1139,9,9,6,21,31,58,-27,33
St. Pölten,1139,10,6,12,18,39,68,-29,30
FC Salzburg,1140,1,23,7,6,73,26,47,76
SC Rheindorf,1140,2,19,10,7,60,47,13,67
Vienna,1140,3,20,6,10,61,40,21,66
SK Sturm Gra,1140,4,18,5,13,61,46,15,59
Rapid Vienna,1140,5,13,10,13,52,42,10,49
RZ Pellets W,1140,6,13,8,15,48,55,-7,47
St. Pölten,1140,7,10,12,14,53,63,-10,42
Admira Wacke,1140,8,9,8,19,26,56,-30,35
SV Josko Rie,1140,9,9,5,22,25,54,-29,32
Mattersburg,1140,10,7,7,22,34,64,-30,28
FC Salzburg,1141,1,20,9,7,64,31,33,69
Rapid Vienna,1141,2,19,7,10,58,36,22,64
SK Sturm Gra,1141,3,16,10,10,67,36,31,58
SC Rheindorf,1141,4,16,10,10,55,43,12,58
Vienna,1141,5,17,6,13,59,59,0,57
RZ Pellets W,1141,6,14,8,14,47,48,-1,50
Admira Wacke,1141,7,11,7,18,35,60,-25,40
Mattersburg,1141,8,10,9,17,38,54,-16,39
SV Josko Rie,1141,9,10,5,21,37,65,-28,35
St. Pölten,1141,10,7,9,20,38,66,-28,30
FC Salzburg,1142,1,23,5,8,69,32,37,74
SK Sturm Gra,1142,2,21,4,11,60,33,27,67
Rapid Vienna,1142,3,18,10,8,58,33,25,64
SC Rheindorf,1142,4,18,9,9,55,41,14,63
Vienna,1142,5,19,6,11,68,57,11,63
RZ Pellets W,1142,6,12,8,16,44,57,-13,44
SV Josko Rie,1142,7,10,5,21,36,57,-21,35
Mattersburg,1142,8,8,9,19,40,59,-19,33
Admira Wacke,1142,9,8,9,19,28,55,-27,33
St. Pölten,1142,10,7,7,22,42,76,-34,28
Vienna,1143,1,21,6,9,61,43,18,69
SC Rheindorf,1143,2,19,11,6,58,39,19,68
FC Salzburg,1143,3,18,11,7,59,27,32,65
Rapid Vienna,1143,4,16,10,10,57,34,23,58
SK Sturm Gra,1143,5,15,7,14,53,42,11,52
RZ Pellets W,1143,6,11,10,15,42,54,-12,43
Mattersburg,1143,7,9,10,17,36,57,-21,37
Admira Wacke,1143,8,9,10,17,31,52,-21,37
SV Josko Rie,1143,9,9,9,18,31,50,-19,36
St. Pölten,1143,10,7,8,21,36,66,-30,29
FC Salzburg,1144,1,22,7,7,67,29,38,73
SC Rheindorf,1144,2,19,7,10,54,39,15,64
SK Sturm Gra,1144,3,17,7,12,54,36,18,58
Rapid Vienna,1144,4,16,9,11,64,42,22,57
Vienna,1144,5,16,5,15,63,59,4,53
Admira Wacke,1144,6,14,5,17,40,61,-21,47
St. Pölten,1144,7,11,9,16,45,60,-15,42
RZ Pellets W,1144,8,11,7,18,39,57,-18,40
Mattersburg,1144,9,11,6,19,36,54,-18,39
SV Josko Rie,1144,10,10,4,22,31,56,-25,34
FC Salzburg,1145,1,23,5,8,69,34,35,74
SC Rheindorf,1145,2,18,11,7,61,42,19,65
Vienna,1145,3,20,5,11,64,47,17,65
SK Sturm Gra,1145,4,19,7,10,57,31,26,64
Rapid Vienna,1145,5,15,10,11,61,45,16,55
RZ Pellets W,1145,6,12,8,16,42,55,-13,44
Admira Wacke,1145,7,11,9,16,43,64,-21,42
Mattersburg,1145,8,8,9,19,37,59,-22,33
SV Josko Rie,1145,9,9,6,21,42,65,-23,33
St. Pölten,1145,10,6,8,22,40,74,-34,26
FC Salzburg,1146,1,22,7,7,68,27,41,73
SC Rheindorf,1146,2,20,10,6,58,38,20,70
SK Sturm Gra,1146,3,17,6,13,55,34,21,57
Vienna,1146,4,16,7,13,53,49,4,55
Rapid Vienna,1146,5,15,9,12,54,40,14,54
Admira Wacke,1146,6,15,4,17,42,58,-16,49
RZ Pellets W,1146,7,13,7,16,52,59,-7,46
St. Pölten,1146,8,9,10,17,42,65,-23,37
SV Josko Rie,1146,9,9,6,21,30,53,-23,33
Mattersburg,1146,10,6,10,20,41,72,-31,28
FC Salzburg,1147,1,21,10,5,64,24,40,73
SK Sturm Gra,1147,2,19,8,9,65,37,28,65
SC Rheindorf,1147,3,18,7,11,53,47,6,61
Vienna,1147,4,17,7,12,54,49,5,58
Rapid Vienna,1147,5,15,8,13,56,45,11,53
Admira Wacke,1147,6,16,5,15,44,55,-11,53
SV Josko Rie,1147,7,12,6,18,35,47,-12,42
St. Pölten,1147,8,9,8,19,43,64,-21,35
RZ Pellets W,1147,9,9,8,19,38,59,-21,35
Mattersburg,1147,10,7,7,22,31,56,-25,28
SK Sturm Gra,1148,1,22,6,8,62,26,36,72
FC Salzburg,1148,2,21,9,6,62,27,35,72
SC Rheindorf,1148,3,18,6,12,52,49,3,60
Rapid Vienna,1148,4,16,10,10,58,40,18,58
Vienna,1148,5,16,4,16,58,58,0,52
RZ Pellets W,1148,6,13,9,14,51,56,-5,48
SV Josko Rie,1148,7,13,5,18,40,50,-10,44
Admira Wacke,1148,8,11,6,19,37,56,-19,39
St. Pölten,1148,9,7,11,18,40,68,-28,32
Mattersburg,1148,10,7,6,23,32,62,-30,27
FC Salzburg,1149,1,24,6,6,67,23,44,78
SK Sturm Gra,1149,2,20,7,9,62,34,28,67
SC Rheindorf,1149,3,19,8,9,55,42,13,65
Vienna,1149,4,19,4,13,61,49,12,61
RZ Pellets W,1149,5,17,5,14,59,54,5,56
Rapid Vienna,1149,6,12,9,15,50,50,0,45
Mattersburg,1149,7,10,8,18,41,57,-16,38
SV Josko Rie,1149,8,11,3,22,31,50,-19,36
Admira Wacke,1149,9,8,7,21,31,65,-34,31
St. Pölten,1149,10,7,9,20,36,69,-33,30
FC Salzburg,1150,1,22,7,7,63,33,30,73
Vienna,1150,2,21,5,10,68,48,20,68
SC Rheindorf,1150,3,19,6,11,54,41,13,63
SK Sturm Gra,1150,4,18,4,14,56,40,16,58
Rapid Vienna,1150,5,12,15,9,59,44,15,51
Admira Wacke,1150,6,14,5,17,40,54,-14,47
RZ Pellets W,1150,7,11,8,17,39,53,-14,41
St. Pölten,1150,8,8,11,17,42,65,-23,35
Mattersburg,1150,9,8,10,18,36,57,-21,34
SV Josko Rie,1150,10,10,3,23,33,55,-22,33
FC Salzburg,1151,1,21,6,9,63,31,32,69
SC Rheindorf,1151,2,20,7,9,60,41,19,67
SK Sturm Gra,1151,3,19,6,11,58,35,23,63
Vienna,1151,4,17,8,11,61,52,9,59
Rapid Vienna,1151,5,15,9,12,61,47,14,54
RZ Pellets W,1151,6,12,9,15,47,59,-12,45
SV Josko Rie,1151,7,11,6,19,38,54,-16,39
Mattersburg,1151,8,10,8,18,39,55,-16,38
St. Pölten,1151,9,9,8,19,41,66,-25,35
Admira Wacke,1151,10,9,7,20,34,62,-28,34
SC Rheindorf,1152,1,23,6,7,64,39,25,75
FC Salzburg,1152,2,22,6,8,70,29,41,72
SK Sturm Gra,1152,3,19,7,10,58,33,25,64
Vienna,1152,4,16,5,15,59,56,3,53
Rapid Vienna,1152,5,13,10,13,55,47,8,49
RZ Pellets W,1152,6,14,5,17,46,57,-11,47
SV Josko Rie,1152,7,12,8,16,35,53,-18,44
Admira Wacke,1152,8,11,5,20,38,64,-26,38
Mattersburg,1152,9,9,8,19,46,64,-18,35
St. Pölten,1152,10,7,8,21,41,70,-29,29
FC Salzburg,1153,1,19,10,7,69,36,33,67
SC Rheindorf,1153,2,20,7,9,56,42,14,67
Vienna,1153,3,19,6,11,64,53,11,63
SK Sturm Gra,1153,4,18,4,14,52,34,18,58
Rapid Vienna,1153,5,13,10,13,54,46,8,49
RZ Pellets W,1153,6,14,7,15,52,56,-4,49
Admira Wacke,1153,7,11,9,16,38,56,-18,42
SV Josko Rie,1153,8,11,7,18,36,55,-19,40
Mattersburg,1153,9,9,6,21,37,57,-20,33
St. Pölten,1153,10,7,12,17,41,64,-23,33
SK Sturm Gra,1154,1,23,5,8,67,26,41,74
FC Salzburg,1154,2,22,7,7,66,27,39,73
SC Rheindorf,1154,3,19,7,10,54,42,12,64
Vienna,1154,4,18,6,12,56,50,6,60
Rapid Vienna,1154,5,12,10,14,51,44,7,46
St. Pölten,1154,6,12,8,16,43,54,-11,44
RZ Pellets W,1154,7,11,5,20,44,67,-23,38
SV Josko Rie,1154,8,10,6,20,35,56,-21,36
Mattersburg,1154,9,9,8,19,38,56,-18,35
Admira Wacke,1154,10,9,8,19,32,64,-32,35
SK Sturm Gra,1155,1,22,5,9,61,30,31,71
FC Salzburg,1155,2,19,11,6,68,31,37,68
SC Rheindorf,1155,3,18,8,10,50,41,9,62
Vienna,1155,4,18,7,11,59,48,11,61
Rapid Vienna,1155,5,15,12,9,55,35,20,57
Admira Wacke,1155,6,11,6,19,38,62,-24,39
RZ Pellets W,1155,7,9,9,18,40,60,-20,36
St. Pölten,1155,7,9,9,18,40,60,-20,36
SV Josko Rie,1155,9,9,7,20,29,49,-20,34
Mattersburg,1155,10,8,10,18,32,56,-24,34
Vienna,1156,1,23,2,11,72,45,27,71
SK Sturm Gra,1156,2,21,6,9,64,37,27,69
FC Salzburg,1156,3,20,8,8,62,29,33,68
SC Rheindorf,1156,4,19,7,10,48,35,13,64
Rapid Vienna,1156,5,15,9,12,58,37,21,54
RZ Pellets W,1156,6,12,5,19,43,56,-13,41
Mattersburg,1156,7,11,8,17,35,52,-17,41
Admira Wacke,1156,8,10,6,20,39,68,-29,36
St. Pölten,1156,9,9,8,19,42,70,-28,35
SV Josko Rie,1156,10,7,7,22,29,63,-34,28
FC Salzburg,1157,1,20,11,5,66,31,35,71
SC Rheindorf,1157,2,21,7,8,60,42,18,70
SK Sturm Gra,1157,3,19,4,13,57,35,22,61
Vienna,1157,4,17,8,11,61,51,10,59
Rapid Vienna,1157,5,12,11,13,51,43,8,47
RZ Pellets W,1157,6,13,6,17,49,60,-11,45
Admira Wacke,1157,7,12,8,16,40,54,-14,44
SV Josko Rie,1157,8,11,7,18,35,54,-19,40
St. Pölten,1157,9,8,9,19,40,63,-23,33
Mattersburg,1157,10,8,7,21,40,66,-26,31
FC Salzburg,1158,1,19,11,6,64,36,28,68
SC Rheindorf,1158,2,20,8,8,52,39,13,68
SK Sturm Gra,1158,3,17,9,10,54,35,19,60
Rapid Vienna,1158,4,16,10,10,59,41,18,58
Vienna,1158,5,17,7,12,60,54,6,58
Admira Wacke,1158,6,11,9,16,45,60,-15,42
St. Pölten,1158,7,10,10,16,40,59,-19,40
SV Josko Rie,1158,8,10,5,21,41,57,-16,35
Mattersburg,1158,9,8,9,19,36,52,-16,33
RZ Pellets W,1158,10,7,12,17,39,57,-18,33
FC Salzburg,1159,1,26,5,5,75,23,52,83
SC Rheindorf,1159,2,22,6,8,57,36,21,72
SK Sturm Gra,1159,3,19,4,13,57,40,17,61
Vienna,1159,4,16,7,13,55,52,3,55
Rapid Vienna,1159,5,15,8,13,55,49,6,53
RZ Pellets W,1159,6,12,5,19,47,55,-8,41
Admira Wacke,1159,7,10,9,17,34,59,-25,39
SV Josko Rie,1159,8,10,7,19,32,54,-22,37
St. Pölten,1159,9,8,9,19,41,63,-22,33
Mattersburg,1159,10,8,8,20,37,59,-22,32
SK Sturm Gra,1160,1,23,5,8,64,28,36,74
FC Salzburg,1160,2,21,9,6,72,28,44,72
SC Rheindorf,1160,3,19,6,11,61,50,11,63
Vienna,1160,4,18,5,13,63,48,15,59
Rapid Vienna,1160,5,12,15,9,59,44,15,51
SV Josko Rie,1160,6,14,4,18,34,49,-15,46
RZ Pellets W,1160,7,12,9,15,46,56,-10,45
Admira Wacke,1160,8,8,11,17,31,56,-25,35
St. Pölten,1160,9,7,10,19,35,69,-34,31
Mattersburg,1160,10,4,10,22,31,68,-37,22
FC Salzburg,1161,1,21,8,7,71,32,39,71
SC Rheindorf,1161,2,18,12,6,62,44,18,66
SK Sturm Gra,1161,3,19,7,10,58,35,23,64
Vienna,1161,4,18,7,11,69,56,13,61
Rapid Vienna,1161,5,12,12,12,53,44,9,48
RZ Pellets W,1161,6,12,10,14,43,52,-9,46
Admira Wacke,1161,7,12,8,16,35,58,-23,44
SV Josko Rie,1161,8,9,6,21,29,55,-26,33
St. Pölten,1161,9,7,11,18,41,64,-23,32
Mattersburg,1161,10,6,11,19,36,57,-21,29
FC Salzburg,1162,1,22,8,6,72,30,42,74
SC Rheindorf,1162,2,20,10,6,56,36,20,70
Rapid Vienna,1162,3,17,9,10,55,34,21,60
SK Sturm Gra,1162,4,15,7,14,56,42,14,52
Vienna,1162,5,15,4,17,50,51,-1,49
RZ Pellets W,1162,6,13,7,16,43,61,-18,46
Admira Wacke,1162,7,11,8,17,42,55,-13,41
St. Pölten,1162,8,9,11,16,41,61,-20,38
SV Josko Rie,1162,9,10,7,19,33,50,-17,37
Mattersburg,1162,10,9,7,20,33,61,-28,34
FC Salzburg,1163,1,20,7,9,58,28,30,67
SC Rheindorf,1163,2,19,9,8,54,40,14,66
Vienna,1163,3,19,5,12,70,51,19,62
SK Sturm Gra,1163,4,18,6,12,54,39,15,60
Rapid Vienna,1163,5,16,10,10,54,39,15,58
RZ Pellets W,1163,6,13,7,16,47,52,-5,46
St. Pölten,1163,7,10,10,16,36,54,-18,40
Admira Wacke,1163,8,11,7,18,35,58,-23,40
SV Josko Rie,1163,9,9,5,22,34,60,-26,32
Mattersburg,1163,10,6,12,18,30,51,-21,30
FC Salzburg,1164,1,21,8,7,67,29,38,71
Vienna,1164,2,19,6,11,65,48,17,63
SC Rheindorf,1164,3,18,8,10,52,42,10,62
SK Sturm Gra,1164,4,18,6,12,55,41,14,60
Rapid Vienna,1164,5,15,10,11,67,40,27,55
RZ Pellets W,1164,6,14,8,14,55,56,-1,50
Mattersburg,1164,7,10,9,17,37,53,-16,39
St. Pölten,1164,8,10,8,18,41,70,-29,38
SV Josko Rie,1164,9,10,5,21,38,63,-25,35
Admira Wacke,1164,10,8,6,22,32,67,-35,30
FC Salzburg,1165,1,22,7,7,68,32,36,73
Vienna,1165,2,20,7,9,65,49,16,67
SK Sturm Gra,1165,3,20,5,11,60,31,29,65
SC Rheindorf,1165,4,19,7,10,54,41,13,64
Rapid Vienna,1165,5,15,8,13,64,46,18,53
Admira Wacke,1165,6,12,6,18,39,60,-21,42
Mattersburg,1165,7,11,7,18,35,50,-15,40
SV Josko Rie,1165,8,11,6,19,42,61,-19,39
RZ Pellets W,1165,9,9,6,21,42,66,-24,33
St. Pölten,1165,10,8,7,21,38,71,-33,31
FC Salzburg,1166,1,21,10,5,69,29,40,73
SK Sturm Gra,1166,2,21,6,9,62,31,31,69
SC Rheindorf,1166,3,17,9,10,54,45,9,60
Vienna,1166,4,15,8,13,56,53,3,53
Rapid Vienna,1166,5,13,13,10,50,36,14,52
RZ Pellets W,1166,6,11,10,15,43,54,-11,43
Mattersburg,1166,7,10,9,17,37,55,-18,39
Admira Wacke,1166,8,10,9,17,36,60,-24,39
SV Josko Rie,1166,9,10,6,20,31,49,-18,36
St. Pölten,1166,10,7,10,19,41,67,-26,31
FC Salzburg,1167,1,21,10,5,64,25,39,73
SK Sturm Gra,1167,2,21,6,9,61,33,28,69
SC Rheindorf,1167,3,17,11,8,56,45,11,62
Rapid Vienna,1167,4,14,12,10,65,44,21,54
Vienna,1167,5,16,5,15,56,59,-3,53
RZ Pellets W,1167,6,11,10,15,46,53,-7,43
SV Josko Rie,1167,7,12,4,20,33,50,-17,40
Admira Wacke,1167,8,11,6,19,37,60,-23,39
St. Pölten,1167,9,8,12,16,45,69,-24,36
Mattersburg,1167,10,6,10,20,39,64,-25,28
FC Salzburg,1168,1,24,6,6,74,28,46,78
SK Sturm Gra,1168,2,21,5,10,62,31,31,68
Vienna,1168,3,22,2,12,63,46,17,68
SC Rheindorf,1168,4,18,8,10,54,41,13,62
RZ Pellets W,1168,5,14,5,17,49,57,-8,47
Rapid Vienna,1168,6,11,11,14,48,41,7,44
SV Josko Rie,1168,7,10,6,20,36,54,-18,36
Mattersburg,1168,8,8,11,17,35,58,-23,35
St. Pölten,1168,9,7,12,17,40,69,-29,33
Admira Wacke,1168,10,9,6,21,29,65,-36,33
SK Sturm Gra,1169,1,21,9,6,62,25,37,72
FC Salzburg,1169,2,20,9,7,65,35,30,69
SC Rheindorf,1169,3,19,8,9,55,41,14,65
Vienna,1169,4,19,5,12,59,56,3,62
Rapid Vienna,1169,5,12,15,9,52,36,16,51
Admira Wacke,1169,6,12,8,16,37,51,-14,44
RZ Pellets W,1169,7,12,5,19,47,64,-17,41
Mattersburg,1169,8,10,7,19,35,50,-15,37
St. Pölten,1169,9,6,12,18,35,62,-27,30
SV Josko Rie,1169,10,8,4,24,34,61,-27,28
FC Salzburg,1170,1,21,7,8,68,30,38,70
SC Rheindorf,1170,2,19,7,10,52,39,13,64
Vienna,1170,3,19,6,11,65,49,16,63
SK Sturm Gra,1170,4,16,10,10,50,36,14,58
Rapid Vienna,1170,5,13,10,13,56,44,12,49
RZ Pellets W,1170,6,14,5,17,45,51,-6,47
St. Pölten,1170,7,9,13,14,41,54,-13,40
SV Josko Rie,1170,8,12,4,20,34,55,-21,40
Admira Wacke,1170,9,11,6,19,36,66,-30,39
Mattersburg,1170,10,7,10,19,37,60,-23,31
SC Rheindorf,1171,1,20,7,9,60,42,18,67
FC Salzburg,1171,2,19,8,9,60,27,33,65
Vienna,1171,3,18,4,14,57,46,11,58
SK Sturm Gra,1171,4,16,9,11,49,34,15,57
Rapid Vienna,1171,5,14,13,9,55,35,20,55
RZ Pellets W,1171,6,12,9,15,42,52,-10,45
Admira Wacke,1171,7,12,8,16,37,53,-16,44
SV Josko Rie,1171,8,13,3,20,34,55,-21,42
Mattersburg,1171,9,11,8,17,41,54,-13,41
St. Pölten,1171,10,7,7,22,31,68,-37,28
SK Sturm Gra,1172,1,21,5,10,54,27,27,68
FC Salzburg,1172,2,19,7,10,61,34,27,64
SC Rheindorf,1172,3,18,9,9,59,43,16,63
Vienna,1172,4,18,6,12,61,51,10,60
Rapid Vienna,1172,5,14,12,10,54,36,18,54
Admira Wacke,1172,6,12,6,18,37,58,-21,42
SV Josko Rie,1172,7,12,5,19,33,50,-17,41
RZ Pellets W,1172,8,10,10,16,40,54,-14,40
St. Pölten,1172,9,8,13,15,42,56,-14,37
Mattersburg,1172,10,6,11,19,28,60,-32,29
FC Salzburg,1173,1,22,8,6,67,26,41,74
SK Sturm Gra,1173,2,21,4,11,66,35,31,67
Vienna,1173,3,20,6,10,64,49,15,66
SC Rheindorf,1173,4,19,6,11,54,46,8,63
RZ Pellets W,1173,5,18,5,13,58,52,6,59
Rapid Vienna,1173,6,10,10,16,50,48,2,40
Admira Wacke,1173,7,11,6,19,36,64,-28,39
Mattersburg,1173,8,10,7,19,46,64,-18,37
SV Josko Rie,1173,9,10,5,21,34,59,-25,35
St. Pölten,1173,10,7,7,22,39,71,-32,28
FC Salzburg,1174,1,22,7,7,72,29,43,73
SC Rheindorf,1174,2,20,6,10,52,36,16,66
SK Sturm Gra,1174,3,18,9,9,59,37,22,63
Vienna,1174,4,19,6,11,71,53,18,63
RZ Pellets W,1174,5,16,5,15,52,52,0,53
Rapid Vienna,1174,6,12,11,13,51,44,7,47
SV Josko Rie,1174,7,13,4,19,40,53,-13,43
Admira Wacke,1174,8,12,4,20,32,62,-30,40
St. Pölten,1174,9,6,11,19,38,71,-33,29
Mattersburg,1174,10,5,11,20,32,62,-30,26
FC Salzburg,1175,1,25,5,6,78,29,49,80
SC Rheindorf,1175,2,17,9,10,56,44,12,60
Vienna,1175,3,17,7,12,60,63,-3,58
SK Sturm Gra,1175,4,15,7,14,51,43,8,52
Rapid Vienna,1175,5,12,11,13,55,46,9,47
RZ Pellets W,1175,6,12,8,16,44,49,-5,44
Admira Wacke,1175,7,12,6,18,33,57,-24,42
St. Pölten,1175,8,11,8,17,42,61,-19,41
Mattersburg,1175,9,9,12,15,42,53,-11,39
SV Josko Rie,1175,10,9,9,18,34,50,-16,36
SK Sturm Gra,1176,1,22,6,8,64,29,35,72
FC Salzburg,1176,2,21,7,8,65,31,34,70
SC Rheindorf,1176,3,21,7,8,54,36,18,70
Vienna,1176,4,18,4,14,54,54,0,58
Rapid Vienna,1176,5,15,9,12,52,37,15,54
RZ Pellets W,1176,6,15,6,15,52,54,-2,51
SV Josko Rie,1176,7,11,6,19,32,53,-21,39
Mattersburg,1176,8,9,6,21,33,51,-18,33
St. Pölten,1176,9,8,8,20,37,62,-25,32
Admira Wacke,1176,10,9,3,24,34,70,-36,30
SK Sturm Gra,1177,1,21,8,7,71,28,43,71
FC Salzburg,1177,2,21,7,8,69,32,37,70
SC Rheindorf,1177,3,17,13,6,58,41,17,64
Vienna,1177,4,17,5,14,57,51,6,56
Rapid Vienna,1177,5,10,13,13,54,50,4,43
Admira Wacke,1177,6,12,6,18,37,69,-32,42
RZ Pellets W,1177,7,11,8,17,50,61,-11,41
SV Josko Rie,1177,8,10,8,18,37,51,-14,38
Mattersburg,1177,9,9,10,17,36,59,-23,37
St. Pölten,1177,10,8,10,18,43,70,-27,34
FC Salzburg,1178,1,20,11,5,60,28,32,71
Vienna,1178,2,21,4,11,66,49,17,67
RZ Pellets W,1178,3,17,7,12,46,46,0,58
Rapid Vienna,1178,4,15,12,9,60,38,22,57
SC Rheindorf,1178,5,16,9,11,55,45,10,57
SK Sturm Gra,1178,6,15,9,12,55,39,16,54
SV Josko Rie,1178,7,12,4,20,34,52,-18,40
Admira Wacke,1178,8,11,5,20,36,62,-26,38
St. Pölten,1178,9,7,11,18,39,66,-27,32
Mattersburg,1178,10,6,8,22,35,61,-26,26
SC Rheindorf,1179,1,20,9,7,49,37,12,69
FC Salzburg,1179,2,19,5,12,60,35,25,62
SK Sturm Gra,1179,3,18,8,10,55,32,23,62
Vienna,1179,4,18,5,13,64,49,15,59
Rapid Vienna,1179,5,12,14,10,47,37,10,50
Mattersburg,1179,6,11,11,14,46,50,-4,44
RZ Pellets W,1179,7,12,7,17,47,56,-9,43
Admira Wacke,1179,8,11,7,18,35,58,-23,40
St. Pölten,1179,9,9,9,18,36,62,-26,36
SV Josko Rie,1179,10,9,7,20,32,55,-23,34
FC Salzburg,1180,1,21,10,5,68,30,38,73
SC Rheindorf,1180,2,19,10,7,56,42,14,67
SK Sturm Gra,1180,3,17,6,13,57,42,15,57
Rapid Vienna,1180,4,14,12,10,64,44,20,54
Vienna,1180,5,14,8,14,49,50,-1,50
RZ Pellets W,1180,6,11,10,15,43,56,-13,43
Admira Wacke,1180,7,12,7,17,38,55,-17,43
St. Pölten,1180,8,10,8,18,43,63,-20,38
SV Josko Rie,1180,9,8,11,17,31,46,-15,35
Mattersburg,1180,10,7,12,17,34,55,-21,33
SK Sturm Gra,1181,1,23,5,8,64,27,37,74
SC Rheindorf,1181,2,21,8,7,60,37,23,71
FC Salzburg,1181,3,18,9,9,61,35,26,63
Vienna,1181,4,18,5,13,60,51,9,59
Rapid Vienna,1181,5,13,12,11,51,47,4,51
Admira Wacke,1181,6,13,6,17,40,56,-16,45
RZ Pellets W,1181,7,11,10,15,42,52,-10,43
Mattersburg,1181,8,8,9,19,35,55,-20,33
SV Josko Rie,1181,9,9,5,22,35,62,-27,32
St. Pölten,1181,10,7,9,20,41,67,-26,30
SC Rheindorf,1182,1,22,6,8,59,39,20,72
FC Salzburg,1182,2,19,10,7,61,28,33,67
Vienna,1182,3,16,10,10,61,46,15,58
SK Sturm Gra,1182,4,16,8,12,55,39,16,56
Rapid Vienna,1182,5,12,11,13,54,47,7,47
St. Pölten,1182,6,11,11,14,46,62,-16,44
Mattersburg,1182,7,11,9,16,46,57,-11,42
RZ Pellets W,1182,8,11,8,17,40,54,-14,41
SV Josko Rie,1182,9,10,9,17,32,46,-14,39
Admira Wacke,1182,10,8,6,22,27,63,-36,30
FC Salzburg,1183,1,22,8,6,70,36,34,74
SC Rheindorf,1183,2,20,9,7,61,41,20,69
SK Sturm Gra,1183,3,18,7,11,60,33,27,61
Vienna,1183,4,17,7,12,59,49,10,58
Rapid Vienna,1183,5,13,10,13,49,38,11,49
RZ Pellets W,1183,6,13,6,17,39,51,-12,45
Admira Wacke,1183,7,13,6,17,43,59,-16,45
SV Josko Rie,1183,8,11,5,20,34,53,-19,38
St. Pölten,1183,9,9,8,19,38,61,-23,35
Mattersburg,1183,10,6,10,20,30,62,-32,28
SC Rheindorf,1184,1,20,8,8,53,41,12,68
FC Salzburg,1184,2,18,8,10,57,34,23,62
SK Sturm Gra,1184,3,16,9,11,62,40,22,57
RZ Pellets W,1184,4,16,8,12,54,46,8,56
Vienna,1184,5,16,8,12,64,59,5,56
Rapid Vienna,1184,6,13,12,11,55,39,16,51
Admira Wacke,1184,7,13,4,19,41,61,-20,43
SV Josko Rie,1184,8,10,6,20,31,57,-26,36
St. Pölten,1184,9,8,11,17,45,67,-22,35
Mattersburg,1184,10,7,12,17,35,53,-18,33
SC Rheindorf,1185,1,21,8,7,58,39,19,71
FC Salzburg,1185,2,19,7,10,58,31,27,64
SK Sturm Gra,1185,3,18,5,13,60,36,24,59
Vienna,1185,4,17,8,11,59,49,10,59
Rapid Vienna,1185,5,13,12,11,54,44,10,51
Admira Wacke,1185,6,15,6,15,48,60,-12,51
RZ Pellets W,1185,7,11,9,16,47,59,-12,42
SV Josko Rie,1185,8,11,7,18,37,55,-18,40
Mattersburg,1185,9,7,12,17,34,55,-21,33
St. Pölten,1185,10,7,8,21,40,67,-27,29
FC Salzburg,1186,1,21,5,10,63,29,34,68
SK Sturm Gra,1186,2,21,5,10,57,34,23,68
SC Rheindorf,1186,3,19,7,10,57,45,12,64
Vienna,1186,4,18,2,16,59,52,7,56
Rapid Vienna,1186,5,13,10,13,48,37,11,49
RZ Pellets W,1186,6,12,11,13,44,49,-5,47
St. Pölten,1186,7,9,13,14,42,53,-11,40
SV Josko Rie,1186,8,12,4,20,39,54,-15,40
Admira Wacke,1186,9,12,3,21,37,69,-32,39
Mattersburg,1186,10,9,8,19,36,60,-24,35
SK Sturm Gra,1187,1,22,6,8,63,32,31,72
Vienna,1187,2,22,2,12,67,55,12,68
FC Salzburg,1187,3,19,9,8,66,36,30,66
SC Rheindorf,1187,4,16,6,14,47,47,0,54
Admira Wacke,1187,5,16,6,14,42,49,-7,54
Rapid Vienna,1187,6,13,12,11,53,39,14,51
RZ Pellets W,1187,7,10,8,18,48,62,-14,38
SV Josko Rie,1187,8,10,4,22,39,59,-20,34
St. Pölten,1187,9,8,10,18,44,67,-23,34
Mattersburg,1187,10,8,9,19,36,59,-23,33
SC Rheindorf,1188,1,21,8,7,60,45,15,71
Vienna,1188,2,19,5,12,64,58,6,62
FC Salzburg,1188,3,17,8,11,58,35,23,59
SK Sturm Gra,1188,4,17,7,12,53,34,19,58
RZ Pellets W,1188,5,13,8,15,48,52,-4,47
Rapid Vienna,1188,6,11,13,12,60,42,18,46
Mattersburg,1188,7,13,7,16,46,52,-6,46
Admira Wacke,1188,8,11,10,15,41,61,-20,43
St. Pölten,1188,9,10,9,17,42,60,-18,39
SV Josko Rie,1188,10,7,7,22,34,67,-33,28
FC Salzburg,1189,1,20,8,8,73,36,37,68
SC Rheindorf,1189,2,18,9,9,59,43,16,63
SK Sturm Gra,1189,3,17,11,8,52,33,19,62
Vienna,1189,4,17,7,12,66,52,14,58
Rapid Vienna,1189,5,14,13,9,57,38,19,55
RZ Pellets W,1189,6,13,7,16,47,53,-6,46
Admira Wacke,1189,7,11,9,16,38,58,-20,42
SV Josko Rie,1189,8,11,7,18,40,60,-20,40
St. Pölten,1189,9,8,11,17,45,69,-24,35
Mattersburg,1189,10,6,8,22,32,67,-35,26
Vienna,1190,1,21,3,12,59,48,11,66
SC Rheindorf,1190,2,19,7,10,53,43,10,64
FC Salzburg,1190,3,18,8,10,63,39,24,62
SK Sturm Gra,1190,4,19,3,14,52,34,18,60
Rapid Vienna,1190,5,16,10,10,57,38,19,58
Admira Wacke,1190,6,15,3,18,44,59,-15,48
Mattersburg,1190,7,11,9,16,42,52,-10,42
RZ Pellets W,1190,8,11,7,18,48,57,-9,40
SV Josko Rie,1190,9,12,4,20,42,55,-13,40
St. Pölten,1190,10,5,12,19,34,69,-35,27
FC Salzburg,1191,1,22,5,9,66,29,37,71
SK Sturm Gra,1191,2,21,5,10,57,31,26,68
Rapid Vienna,1191,3,16,9,11,56,42,14,57
SC Rheindorf,1191,4,16,9,11,49,47,2,57
Vienna,1191,5,16,5,15,58,57,1,53
SV Josko Rie,1191,6,14,5,17,38,47,-9,47
RZ Pellets W,1191,7,13,7,16,44,51,-7,46
St. Pölten,1191,8,10,7,19,37,57,-20,37
Mattersburg,1191,9,8,11,17,38,59,-21,35
Admira Wacke,1191,10,10,5,21,32,55,-23,35
FC Salzburg,1192,1,20,8,8,64,32,32,68
SC Rheindorf,1192,2,19,9,8,57,42,15,66
SK Sturm Gra,1192,3,17,8,11,62,43,19,59
Vienna,1192,4,18,5,13,66,54,12,59
Rapid Vienna,1192,5,15,9,12,57,41,16,54
Admira Wacke,1192,6,15,4,17,44,62,-18,49
St. Pölten,1192,7,11,8,17,49,63,-14,41
RZ Pellets W,1192,8,9,11,16,42,52,-10,38
SV Josko Rie,1192,9,9,7,20,28,59,-31,34
Mattersburg,1192,10,7,11,18,41,62,-21,32
FC Salzburg,1193,1,25,5,6,74,25,49,80
SC Rheindorf,1193,2,19,8,9,52,41,11,65
Vienna,1193,3,19,5,12,56,50,6,62
SK Sturm Gra,1193,4,18,6,12,60,41,19,60
Rapid Vienna,1193,5,14,9,13,52,41,11,51
Admira Wacke,1193,6,15,3,18,42,55,-13,48
RZ Pellets W,1193,7,13,6,17,44,55,-11,45
SV Josko Rie,1193,8,11,5,20,32,54,-22,38
St. Pölten,1193,9,8,9,19,40,62,-22,33
Mattersburg,1193,10,7,6,23,32,60,-28,27
FC Salzburg,1194,1,20,6,10,65,33,32,66
SK Sturm Gra,1194,2,19,8,9,59,36,23,65
SC Rheindorf,1194,3,18,9,9,54,48,6,63
Vienna,1194,4,18,5,13,62,50,12,59
RZ Pellets W,1194,5,15,6,15,56,55,1,51
Rapid Vienna,1194,6,13,11,12,57,41,16,50
Admira Wacke,1194,7,13,5,18,33,53,-20,44
SV Josko Rie,1194,8,11,4,21,36,54,-18,37
Mattersburg,1194,9,9,10,17,42,63,-21,37
St. Pölten,1194,10,7,10,19,37,68,-31,31
Vienna,1195,1,19,5,12,62,51,11,62
SC Rheindorf,1195,2,17,10,9,57,44,13,61
SK Sturm Gra,1195,3,17,9,10,52,31,21,60
FC Salzburg,1195,4,15,10,11,54,34,20,55
Rapid Vienna,1195,5,14,11,11,53,37,16,53
Admira Wacke,1195,6,15,5,16,35,52,-17,50
RZ Pellets W,1195,7,11,11,14,38,53,-15,44
St. Pölten,1195,8,11,8,17,46,59,-13,41
SV Josko Rie,1195,9,11,5,20,34,49,-15,38
Mattersburg,1195,10,9,8,19,35,56,-21,35
FC Salzburg,1196,1,21,7,8,67,33,34,70
SC Rheindorf,1196,2,19,7,10,61,41,20,64
SK Sturm Gra,1196,3,19,6,11,52,33,19,63
Rapid Vienna,1196,4,15,11,10,52,39,13,56
Vienna,1196,5,16,6,14,55,52,3,54
St. Pölten,1196,6,11,14,11,47,52,-5,47
Admira Wacke,1196,7,12,7,17,42,60,-18,43
RZ Pellets W,1196,8,10,7,19,41,59,-18,37
SV Josko Rie,1196,9,11,3,22,36,57,-21,36
Mattersburg,1196,10,7,10,19,32,59,-27,31
SC Rheindorf,1197,1,21,9,6,62,36,26,72
FC Salzburg,1197,2,19,7,10,63,40,23,64
Rapid Vienna,1197,3,18,8,10,61,40,21,62
Vienna,1197,4,19,4,13,64,51,13,61
SK Sturm Gra,1197,5,18,6,12,55,37,18,60
RZ Pellets W,1197,6,12,7,17,52,61,-9,43
SV Josko Rie,1197,7,12,4,20,46,59,-13,40
Mattersburg,1197,8,11,6,19,45,65,-20,39
Admira Wacke,1197,9,10,5,21,35,63,-28,35
St. Pölten,1197,10,8,8,20,37,68,-31,32
Rapid Vienna,1198,1,19,9,8,65,38,27,66
Vienna,1198,2,20,5,11,63,47,16,65
SK Sturm Gra,1198,3,18,8,10,57,30,27,62
FC Salzburg,1198,4,17,10,9,55,31,24,61
SC Rheindorf,1198,5,16,9,11,54,48,6,57
St. Pölten,1198,6,11,10,15,46,56,-10,43
SV Josko Rie,1198,7,10,8,18,38,61,-23,38
Admira Wacke,1198,8,10,8,18,35,61,-26,38
RZ Pellets W,1198,9,9,9,18,53,69,-16,36
Mattersburg,1198,10,9,6,21,35,60,-25,33
FC Salzburg,1199,1,20,10,6,67,34,33,70
SK Sturm Gra,1199,2,21,4,11,66,37,29,67
SC Rheindorf,1199,3,20,7,9,62,43,19,67
Vienna,1199,4,15,6,15,56,61,-5,51
Rapid Vienna,1199,5,11,11,14,46,43,3,44
RZ Pellets W,1199,6,12,8,16,46,56,-10,44
Mattersburg,1199,7,10,11,15,38,52,-14,41
St. Pölten,1199,8,9,12,15,50,61,-11,39
Admira Wacke,1199,9,10,8,18,38,58,-20,38
SV Josko Rie,1199,10,10,7,19,30,54,-24,37
FC Salzburg,1200,1,21,8,7,69,31,38,71
SK Sturm Gra,1200,2,19,8,9,55,30,25,65
Vienna,1200,3,20,3,13,66,53,13,63
SC Rheindorf,1200,4,18,8,10,56,50,6,62
St. Pölten,1200,5,13,7,16,53,63,-10,46
RZ Pellets W,1200,6,12,8,16,51,59,-8,44
Rapid Vienna,1200,7,10,11,15,47,47,0,41
Mattersburg,1200,8,11,7,18,42,60,-18,40
SV Josko Rie,1200,9,10,7,19,38,58,-20,37
Admira Wacke,1200,10,9,7,20,38,64,-26,34
SK Sturm Gra,1201,1,19,8,9,65,36,29,65
SC Rheindorf,1201,2,18,8,10,51,43,8,62
FC Salzburg,1201,3,17,9,10,61,38,23,60
Vienna,1201,4,16,8,12,58,51,7,56
Rapid Vienna,1201,5,14,12,10,62,42,20,54
Admira Wacke,1201,6,11,10,15,36,58,-22,43
RZ Pellets W,1201,7,10,11,15,40,54,-14,41
Mattersburg,1201,8,10,9,17,41,54,-13,39
St. Pölten,1201,9,9,11,16,38,58,-20,38
SV Josko Rie,1201,10,10,6,20,31,49,-18,36
FC Salzburg,1202,1,18,12,6,62,29,33,66
SK Sturm Gra,1202,2,20,6,10,62,32,30,66
SC Rheindorf,1202,3,18,9,9,48,36,12,63
Vienna,1202,4,18,6,12,66,54,12,60
Rapid Vienna,1202,5,15,12,9,57,38,19,57
RZ Pellets W,1202,6,12,8,16,44,60,-16,44
Admira Wacke,1202,7,11,5,20,38,63,-25,38
SV Josko Rie,1202,8,10,7,19,34,52,-18,37
Mattersburg,1202,9,9,7,20,39,62,-23,34
St. Pölten,1202,10,7,12,17,34,58,-24,33
FC Salzburg,1203,1,21,8,7,69,30,39,71
SC Rheindorf,1203,2,19,7,10,62,47,15,64
SK Sturm Gra,1203,3,18,6,12,55,37,18,60
Vienna,1203,4,17,6,13,68,60,8,57
RZ Pellets W,1203,5,14,9,13,51,58,-7,51
Rapid Vienna,1203,6,13,11,12,56,45,11,50
Admira Wacke,1203,7,10,9,17,40,61,-21,39
SV Josko Rie,1203,8,10,7,19,42,63,-21,37
St. Pölten,1203,9,7,15,14,48,63,-15,36
Mattersburg,1203,10,8,8,20,38,65,-27,32
SC Rheindorf,1204,1,23,7,6,63,35,28,76
FC Salzburg,1204,2,19,7,10,64,33,31,64
SK Sturm Gra,1204,3,16,10,10,53,32,21,58
Vienna,1204,4,16,6,14,59,55,4,54
Rapid Vienna,1204,5,14,11,11,56,39,17,53
RZ Pellets W,1204,6,13,8,15,45,55,-10,47
Mattersburg,1204,7,12,7,17,38,56,-18,43
St. Pölten,1204,8,9,8,19,40,59,-19,35
SV Josko Rie,1204,9,9,8,19,26,51,-25,35
Admira Wacke,1204,10,9,8,19,29,58,-29,35
SC Rheindorf,1205,1,22,7,7,64,40,24,73
FC Salzburg,1205,2,21,8,7,73,31,42,71
SK Sturm Gra,1205,3,18,8,10,58,33,25,62
Rapid Vienna,1205,4,14,10,12,56,45,11,52
Vienna,1205,5,16,4,16,66,64,2,52
RZ Pellets W,1205,6,13,7,16,51,57,-6,46
Admira Wacke,1205,7,12,5,19,40,70,-30,41
SV Josko Rie,1205,8,10,7,19,36,56,-20,37
St. Pölten,1205,9,9,9,18,39,69,-30,36
Mattersburg,1205,10,8,9,19,39,57,-18,33
FC Salzburg,1206,1,21,10,5,63,29,34,73
SK Sturm Gra,1206,2,21,9,6,72,31,41,72
SC Rheindorf,1206,3,17,11,8,53,41,12,62
Vienna,1206,4,16,7,13,61,53,8,55
Rapid Vienna,1206,5,11,13,12,56,42,14,46
Admira Wacke,1206,6,12,7,17,39,56,-17,43
RZ Pellets W,1206,7,10,10,16,43,66,-23,40
Mattersburg,1206,8,9,10,17,37,54,-17,37
SV Josko Rie,1206,9,8,9,19,29,52,-23,33
St. Pölten,1206,10,7,10,19,40,69,-29,31
SC Rheindorf,1207,1,23,8,5,69,36,33,77
FC Salzburg,1207,2,19,9,8,61,28,33,66
SK Sturm Gra,1207,3,17,6,13,50,34,16,57
Vienna,1207,4,17,5,14,60,58,2,56
Rapid Vienna,1207,5,15,9,12,60,41,19,54
RZ Pellets W,1207,6,14,7,15,51,54,-3,49
Admira Wacke,1207,7,14,5,17,40,52,-12,47
Mattersburg,1207,8,10,9,17,40,56,-16,39
SV Josko Rie,1207,9,9,5,22,32,62,-30,32
St. Pölten,1207,10,7,7,22,33,75,-42,28
FC Salzburg,1208,1,19,8,9,63,35,28,65
SC Rheindorf,1208,2,19,7,10,58,42,16,64
Vienna,1208,3,18,5,13,64,52,12,59
SK Sturm Gra,1208,4,17,7,12,50,33,17,58
Rapid Vienna,1208,5,14,12,10,60,39,21,54
RZ Pellets W,1208,6,14,9,13,46,53,-7,51
Admira Wacke,1208,7,12,6,18,37,60,-23,42
Mattersburg,1208,8,11,8,17,41,54,-13,41
SV Josko Rie,1208,9,8,9,19,32,57,-25,33
St. Pölten,1208,10,7,11,18,40,66,-26,32
SC Rheindorf,1209,1,21,7,8,59,40,19,70
FC Salzburg,1209,2,19,8,9,65,36,29,65
SK Sturm Gra,1209,3,19,7,10,53,30,23,64
Rapid Vienna,1209,4,14,10,12,56,39,17,52
Vienna,1209,5,14,7,15,55,59,-4,49
SV Josko Rie,1209,6,13,6,17,46,57,-11,45
RZ Pellets W,1209,7,12,7,17,38,50,-12,43
St. Pölten,1209,8,11,8,17,37,58,-21,41
Admira Wacke,1209,9,10,10,16,37,56,-19,40
Mattersburg,1209,10,7,10,19,40,61,-21,31
FC Salzburg,1210,1,22,9,5,68,27,41,75
SK Sturm Gra,1210,2,22,5,9,59,29,30,71
Vienna,1210,3,17,9,10,61,51,10,60
SC Rheindorf,1210,4,17,9,10,57,48,9,60
Rapid Vienna,1210,5,12,14,10,49,37,12,50
St. Pölten,1210,6,11,11,14,46,58,-12,44
Admira Wacke,1210,7,10,8,18,33,54,-21,38
SV Josko Rie,1210,8,10,6,20,32,52,-20,36
RZ Pellets W,1210,9,9,8,19,43,66,-23,35
Mattersburg,1210,10,5,11,20,31,57,-26,26
FC Salzburg,1211,1,23,6,7,69,26,43,75
SK Sturm Gra,1211,2,19,7,10,55,33,22,64
Vienna,1211,3,19,5,12,68,52,16,62
SC Rheindorf,1211,4,18,7,11,52,44,8,61
Rapid Vienna,1211,5,13,12,11,56,40,16,51
RZ Pellets W,1211,6,13,8,15,44,58,-14,47
Admira Wacke,1211,7,11,9,16,38,53,-15,42
SV Josko Rie,1211,8,10,5,21,34,57,-23,35
Mattersburg,1211,9,7,11,18,34,57,-23,32
St. Pölten,1211,10,7,10,19,38,68,-30,31
FC Salzburg,1212,1,25,5,6,75,27,48,80
SC Rheindorf,1212,2,20,9,7,53,39,14,69
SK Sturm Gra,1212,3,20,6,10,68,32,36,66
Rapid Vienna,1212,4,14,11,11,55,42,13,53
Vienna,1212,5,16,5,15,59,57,2,53
RZ Pellets W,1212,6,14,7,15,47,55,-8,49
Admira Wacke,1212,7,10,7,19,35,58,-23,37
Mattersburg,1212,8,9,7,20,42,68,-26,34
SV Josko Rie,1212,9,9,5,22,33,57,-24,32
St. Pölten,1212,10,8,8,20,42,74,-32,32
FC Salzburg,1213,1,20,8,8,62,35,27,68
SK Sturm Gra,1213,2,19,10,7,58,30,28,67
SC Rheindorf,1213,3,20,6,10,63,43,20,66
Vienna,1213,4,18,8,10,60,46,14,62
Rapid Vienna,1213,5,11,14,11,56,41,15,47
RZ Pellets W,1213,6,12,9,15,44,53,-9,45
St. Pölten,1213,7,11,7,18,40,67,-27,40
Admira Wacke,1213,8,11,5,20,38,59,-21,38
SV Josko Rie,1213,9,10,6,20,33,57,-24,36
Mattersburg,1213,10,7,9,20,37,60,-23,30
FC Salzburg,1214,1,23,5,8,74,36,38,74
SC Rheindorf,1214,2,21,8,7,57,35,22,71
SK Sturm Gra,1214,3,19,9,8,59,34,25,66
Rapid Vienna,1214,4,16,9,11,55,38,17,57
Vienna,1214,5,15,7,14,57,54,3,52
Admira Wacke,1214,6,13,6,17,39,57,-18,45
SV Josko Rie,1214,7,13,5,18,41,53,-12,44
RZ Pellets W,1214,8,8,10,18,41,62,-21,34
St. Pölten,1214,9,8,6,22,43,69,-26,30
Mattersburg,1214,10,7,9,20,37,65,-28,30
FC Salzburg,1215,1,24,5,7,68,27,41,77
SK Sturm Gra,1215,2,22,5,9,59,29,30,71
SC Rheindorf,1215,3,19,9,8,56,41,15,66
Vienna,1215,4,18,5,13,60,52,8,59
Rapid Vienna,1215,5,14,11,11,54,40,14,53
Admira Wacke,1215,6,12,5,19,35,60,-25,41
SV Josko Rie,1215,7,10,7,19,34,55,-21,37
RZ Pellets W,1215,8,9,9,18,42,55,-13,36
Mattersburg,1215,9,9,8,19,43,63,-20,35
St. Pölten,1215,10,6,10,20,38,67,-29,28
FC Salzburg,1216,1,24,6,6,70,27,43,78
SK Sturm Gra,1216,2,20,7,9,58,32,26,67
SC Rheindorf,1216,3,19,7,10,54,43,11,64
Vienna,1216,4,17,5,14,54,52,2,56
Rapid Vienna,1216,5,13,10,13,54,42,12,49
St. Pölten,1216,6,10,10,16,46,66,-20,40
Admira Wacke,1216,7,11,7,18,38,61,-23,40
RZ Pellets W,1216,8,11,6,19,50,62,-12,39
Mattersburg,1216,9,10,8,18,36,50,-14,38
SV Josko Rie,1216,10,10,4,22,37,62,-25,34
Vienna,1217,1,22,5,9,75,50,25,71
SC Rheindorf,1217,2,20,9,7,59,43,16,69
FC Salzburg,1217,3,20,5,11,61,34,27,65
SK Sturm Gra,1217,4,19,6,11,58,34,24,63
Rapid Vienna,1217,5,14,9,13,52,37,15,51
RZ Pellets W,1217,6,15,6,15,48,53,-5,51
Mattersburg,1217,7,9,10,17,41,56,-15,37
St. Pölten,1217,8,9,8,19,44,70,-26,35
SV Josko Rie,1217,9,10,5,21,36,62,-26,35
Admira Wacke,1217,10,9,3,24,34,69,-35,30
SK Sturm Gra,1218,1,24,6,6,72,28,44,78
FC Salzburg,1218,2,24,6,6,70,27,43,78
SC Rheindorf,1218,3,17,10,9,52,41,11,61
Vienna,1218,4,17,5,14,59,52,7,56
Rapid Vienna,1218,5,12,9,15,55,45,10,45
RZ Pellets W,1218,6,12,6,18,41,58,-17,42
SV Josko Rie,1218,7,12,6,18,36,58,-22,42
Mattersburg,1218,8,10,8,18,39,59,-20,38
Admira Wacke,1218,9,10,5,21,35,64,-29,35
St. Pölten,1218,10,6,11,19,44,71,-27,29
FC Salzburg,1219,1,21,6,9,58,25,33,69
SK Sturm Gra,1219,2,21,6,9,65,33,32,69
SC Rheindorf,1219,3,19,7,10,52,40,12,64
Vienna,1219,4,18,5,13,59,55,4,59
Rapid Vienna,1219,5,14,13,9,57,41,16,55
Admira Wacke,1219,6,12,8,16,43,59,-16,44
RZ Pellets W,1219,7,12,5,19,44,59,-15,41
SV Josko Rie,1219,8,10,8,18,42,52,-10,38
Mattersburg,1219,9,9,8,19,39,60,-21,35
St. Pölten,1219,10,7,8,21,40,75,-35,29
FC Salzburg,1220,1,21,7,8,68,40,28,70
SK Sturm Gra,1220,2,18,10,8,59,32,27,64
SC Rheindorf,1220,3,19,7,10,52,40,12,64
Vienna,1220,4,20,3,13,59,54,5,63
Rapid Vienna,1220,5,15,11,10,54,36,18,56
RZ Pellets W,1220,6,12,9,15,52,58,-6,45
Admira Wacke,1220,7,11,5,20,40,57,-17,38
Mattersburg,1220,8,10,7,19,38,56,-18,37
SV Josko Rie,1220,9,10,4,22,29,52,-23,34
St. Pölten,1220,10,7,11,18,42,68,-26,32
SK Sturm Gra,1221,1,23,4,9,66,32,34,73
FC Salzburg,1221,2,20,9,7,68,34,34,69
Vienna,1221,3,21,5,10,63,48,15,68
SC Rheindorf,1221,4,17,9,10,50,42,8,60
Rapid Vienna,1221,5,15,11,10,54,36,18,56
RZ Pellets W,1221,6,10,10,16,40,54,-14,40
St. Pölten,1221,7,9,11,16,44,63,-19,38
Admira Wacke,1221,8,11,4,21,32,63,-31,37
SV Josko Rie,1221,9,9,5,22,37,60,-23,32
Mattersburg,1221,10,8,6,22,42,64,-22,30
FC Salzburg,1222,1,22,8,6,72,34,38,74
SC Rheindorf,1222,2,20,8,8,58,42,16,68
SK Sturm Gra,1222,3,17,8,11,59,40,19,59
Vienna,1222,4,18,4,14,58,50,8,58
Rapid Vienna,1222,5,14,11,11,62,42,20,53
RZ Pellets W,1222,6,13,9,14,49,58,-9,48
SV Josko Rie,1222,7,13,5,18,36,53,-17,44
St. Pölten,1222,8,8,10,18,40,62,-22,34
Admira Wacke,1222,9,9,5,22,33,67,-34,32
Mattersburg,1222,10,5,14,17,34,53,-19,29
SK Sturm Gra,1223,1,24,4,8,69,35,34,76
FC Salzburg,1223,2,20,9,7,63,31,32,69
SC Rheindorf,1223,3,21,5,10,57,44,13,68
Vienna,1223,4,19,4,13,60,49,11,61
Rapid Vienna,1223,5,16,11,9,59,33,26,59
RZ Pellets W,1223,6,12,5,19,41,55,-14,41
St. Pölten,1223,7,9,11,16,44,62,-18,38
Admira Wacke,1223,8,10,5,21,32,63,-31,35
SV Josko Rie,1223,9,10,3,23,31,56,-25,33
Mattersburg,1223,10,6,9,21,34,62,-28,27
FC Salzburg,1224,1,21,10,5,66,33,33,73
SC Rheindorf,1224,2,20,7,9,53,42,11,67
SK Sturm Gra,1224,3,19,7,10,59,37,22,64
Vienna,1224,4,20,4,12,67,53,14,64
Rapid Vienna,1224,5,12,11,13,55,48,7,47
SV Josko Rie,1224,6,13,6,17,46,56,-10,45
RZ Pellets W,1224,7,10,9,17,45,58,-13,39
Admira Wacke,1224,8,11,6,19,38,60,-22,39
Mattersburg,1224,9,7,10,19,39,58,-19,31
St. Pölten,1224,10,6,12,18,44,67,-23,30
FC Salzburg,1225,1,24,6,6,68,28,40,78
SC Rheindorf,1225,2,22,7,7,67,39,28,73
SK Sturm Gra,1225,3,18,8,10,60,43,17,62
Vienna,1225,4,18,7,11,69,49,20,61
Rapid Vienna,1225,5,12,11,13,60,44,16,47
RZ Pellets W,1225,6,12,6,18,52,63,-11,42
Admira Wacke,1225,7,11,8,17,34,63,-29,41
St. Pölten,1225,8,8,11,17,43,65,-22,35
Mattersburg,1225,9,9,7,20,36,65,-29,34
SV Josko Rie,1225,10,7,7,22,29,59,-30,28
FC Salzburg,1226,1,22,7,7,68,24,44,73
SK Sturm Gra,1226,2,21,6,9,64,37,27,69
Vienna,1226,3,19,4,13,65,54,11,61
SC Rheindorf,1226,4,18,7,11,54,46,8,61
Rapid Vienna,1226,5,15,12,9,56,40,16,57
RZ Pellets W,1226,6,13,7,16,50,54,-4,46
Admira Wacke,1226,7,11,7,18,41,66,-25,40
Mattersburg,1226,8,9,7,20,40,61,-21,34
St. Pölten,1226,9,9,7,20,39,67,-28,34
SV Josko Rie,1226,10,9,4,23,35,63,-28,31
FC Salzburg,1227,1,21,10,5,64,29,35,73
SK Sturm Gra,1227,2,20,7,9,66,34,32,67
SC Rheindorf,1227,3,16,12,8,53,43,10,60
Vienna,1227,4,17,5,14,57,54,3,56
Rapid Vienna,1227,5,12,13,11,55,42,13,49
RZ Pellets W,1227,6,14,7,15,47,50,-3,49
St. Pölten,1227,7,12,9,15,49,63,-14,45
Admira Wacke,1227,8,10,6,20,33,59,-26,36
Mattersburg,1227,9,7,11,18,36,60,-24,32
SV Josko Rie,1227,10,8,6,22,34,60,-26,30
FC Salzburg,1228,1,23,6,7,68,28,40,75
SK Sturm Gra,1228,2,21,7,8,62,30,32,70
SC Rheindorf,1228,3,20,7,9,54,46,8,67
Vienna,1228,4,17,7,12,64,51,13,58
RZ Pellets W,1228,5,14,7,15,52,56,-4,49
Rapid Vienna,1228,6,11,10,15,45,44,1,43
Admira Wacke,1228,7,11,6,19,41,61,-20,39
SV Josko Rie,1228,8,10,7,19,32,55,-23,37
Mattersburg,1228,9,8,8,20,34,56,-22,32
St. Pölten,1228,10,6,13,17,35,60,-25,31
SK Sturm Gra,1229,1,20,6,10,59,34,25,66
FC Salzburg,1229,2,19,8,9,58,31,27,65
Vienna,1229,3,20,4,12,64,47,17,64
SC Rheindorf,1229,4,18,8,10,53,41,12,62
Rapid Vienna,1229,5,16,9,11,54,36,18,57
St. Pölten,1229,6,12,11,13,40,50,-10,47
RZ Pellets W,1229,7,10,9,17,39,45,-6,39
Admira Wacke,1229,8,10,6,20,34,66,-32,36
SV Josko Rie,1229,9,10,5,21,32,57,-25,35
Mattersburg,1229,10,8,8,20,33,59,-26,32
FC Salzburg,1230,1,20,8,8,68,30,38,68
SK Sturm Gra,1230,2,20,4,12,63,32,31,64
SC Rheindorf,1230,3,17,13,6,60,43,17,64
Vienna,1230,4,18,8,10,61,48,13,62
Rapid Vienna,1230,5,13,10,13,54,40,14,49
RZ Pellets W,1230,6,13,10,13,49,58,-9,49
Admira Wacke,1230,7,12,5,19,34,59,-25,41
St. Pölten,1230,8,9,10,17,39,67,-28,37
SV Josko Rie,1230,9,10,4,22,29,54,-25,34
Mattersburg,1230,10,7,10,19,38,64,-26,31
FC Salzburg,1231,1,20,6,10,63,28,35,66
Vienna,1231,2,19,6,11,67,52,15,63
SK Sturm Gra,1231,3,19,5,12,53,32,21,62
SC Rheindorf,1231,4,18,7,11,54,48,6,61
Rapid Vienna,1231,5,16,12,8,58,36,22,60
Admira Wacke,1231,6,13,7,16,38,53,-15,46
SV Josko Rie,1231,7,12,4,20,34,55,-21,40
RZ Pellets W,1231,8,10,8,18,45,61,-16,38
Mattersburg,1231,9,11,5,20,38,57,-19,38
St. Pölten,1231,10,8,8,20,44,72,-28,32
SC Rheindorf,1232,1,21,6,9,66,47,19,69
Vienna,1232,2,20,5,11,65,51,14,65
FC Salzburg,1232,3,20,4,12,63,38,25,64
Rapid Vienna,1232,4,16,7,13,55,41,14,55
SK Sturm Gra,1232,5,15,7,14,54,40,14,52
Admira Wacke,1232,6,15,5,16,43,61,-18,50
RZ Pellets W,1232,7,13,6,17,47,57,-10,45
St. Pölten,1232,8,10,10,16,44,60,-16,40
SV Josko Rie,1232,9,11,5,20,34,53,-19,38
Mattersburg,1232,10,8,7,21,36,59,-23,31
FC Salzburg,1233,1,22,5,9,72,39,33,71
Vienna,1233,2,20,7,9,62,47,15,67
SC Rheindorf,1233,3,18,10,8,51,40,11,64
SK Sturm Gra,1233,4,16,9,11,48,31,17,57
Rapid Vienna,1233,5,13,11,12,56,41,15,50
Admira Wacke,1233,6,11,11,14,35,53,-18,44
RZ Pellets W,1233,7,10,10,16,48,57,-9,40
St. Pölten,1233,8,10,10,16,50,60,-10,40
SV Josko Rie,1233,9,8,10,18,31,48,-17,34
Mattersburg,1233,10,6,9,21,32,69,-37,27
SC Rheindorf,1234,1,21,7,8,66,46,20,70
SK Sturm Gra,1234,2,21,6,9,62,32,30,69
FC Salzburg,1234,3,20,7,9,65,35,30,67
Vienna,1234,4,19,3,14,59,50,9,60
Rapid Vienna,1234,5,13,11,12,54,44,10,50
RZ Pellets W,1234,6,13,7,16,54,56,-2,46
Admira Wacke,1234,7,11,6,19,37,62,-25,39
St. Pölten,1234,8,9,9,18,43,61,-18,36
SV Josko Rie,1234,9,10,6,20,31,57,-26,36
Mattersburg,1234,10,7,10,19,34,62,-28,31
SK Sturm Gra,1235,1,24,4,8,63,28,35,76
FC Salzburg,1235,2,19,8,9,65,37,28,65
SC Rheindorf,1235,3,19,8,9,55,43,12,65
Vienna,1235,4,19,5,12,60,47,13,62
Rapid Vienna,1235,5,13,10,13,58,42,16,49
Mattersburg,1235,6,11,6,19,45,60,-15,39
RZ Pellets W,1235,7,11,6,19,39,60,-21,39
SV Josko Rie,1235,8,11,5,20,33,51,-18,38
Admira Wacke,1235,9,11,5,20,35,64,-29,38
St. Pölten,1235,10,9,9,18,50,71,-21,36
FC Salzburg,1236,1,23,5,8,79,33,46,74
Vienna,1236,2,21,5,10,72,50,22,68
SC Rheindorf,1236,3,20,7,9,53,39,14,67
SK Sturm Gra,1236,4,16,10,10,50,32,18,58
Rapid Vienna,1236,5,15,11,10,62,48,14,56
RZ Pellets W,1236,6,13,8,15,54,56,-2,47
SV Josko Rie,1236,7,11,6,19,37,59,-22,39
Admira Wacke,1236,8,10,6,20,30,65,-35,36
St. Pölten,1236,9,8,7,21,40,67,-27,31
Mattersburg,1236,10,5,11,20,34,62,-28,26
SK Sturm Gra,1237,1,24,3,9,62,27,35,75
FC Salzburg,1237,2,19,9,8,66,29,37,66
SC Rheindorf,1237,3,20,6,10,52,38,14,66
Vienna,1237,4,20,3,13,62,55,7,63
Rapid Vienna,1237,5,14,10,12,50,36,14,52
Mattersburg,1237,6,13,5,18,38,54,-16,44
RZ Pellets W,1237,7,12,7,17,46,54,-8,43
Admira Wacke,1237,8,12,3,21,40,65,-25,39
SV Josko Rie,1237,9,9,6,21,36,59,-23,33
St. Pölten,1237,10,7,8,21,31,66,-35,29
FC Salzburg,1238,1,21,7,8,66,32,34,70
Vienna,1238,2,21,5,10,60,41,19,68
SC Rheindorf,1238,3,20,8,8,55,39,16,68
SK Sturm Gra,1238,4,17,4,15,55,44,11,55
Rapid Vienna,1238,5,13,10,13,53,41,12,49
RZ Pellets W,1238,6,12,9,15,47,51,-4,45
Admira Wacke,1238,7,13,6,17,37,58,-21,45
SV Josko Rie,1238,8,11,4,21,31,59,-28,37
Mattersburg,1238,9,9,8,19,36,54,-18,35
St. Pölten,1238,10,8,9,19,43,64,-21,33
SC Rheindorf,1239,1,21,8,7,60,36,24,71
FC Salzburg,1239,2,18,11,7,60,31,29,65
SK Sturm Gra,1239,3,19,8,9,57,35,22,65
Vienna,1239,4,19,7,10,65,44,21,64
Rapid Vienna,1239,5,16,9,11,58,38,20,57
RZ Pellets W,1239,6,12,6,18,49,60,-11,42
St. Pölten,1239,7,10,6,20,44,67,-23,36
SV Josko Rie,1239,8,9,7,20,28,54,-26,34
Admira Wacke,1239,9,9,7,20,30,62,-32,34
Mattersburg,1239,10,8,9,19,35,59,-24,33
Vienna,1240,1,22,4,10,69,50,19,70
FC Salzburg,1240,2,21,6,9,70,37,33,69
SK Sturm Gra,1240,3,21,5,10,64,32,32,68
SC Rheindorf,1240,4,20,6,10,56,45,11,66
Rapid Vienna,1240,5,16,10,10,59,36,23,58
RZ Pellets W,1240,6,12,5,19,45,61,-16,41
Mattersburg,1240,7,10,7,19,37,61,-24,37
Admira Wacke,1240,8,10,5,21,41,71,-30,35
SV Josko Rie,1240,9,9,7,20,34,53,-19,34
St. Pölten,1240,10,7,9,20,32,61,-29,30
FC Salzburg,1241,1,24,6,6,68,29,39,78
SK Sturm Gra,1241,2,20,8,8,66,36,30,68
Vienna,1241,3,20,3,13,61,56,5,63
SC Rheindorf,1241,4,17,8,11,54,44,10,59
Rapid Vienna,1241,5,14,12,10,52,35,17,54
SV Josko Rie,1241,6,15,3,18,38,49,-11,48
Admira Wacke,1241,7,11,6,19,39,60,-21,39
RZ Pellets W,1241,8,8,9,19,42,68,-26,33
Mattersburg,1241,9,7,10,19,43,60,-17,31
St. Pölten,1241,10,5,13,18,44,70,-26,28
FC Salzburg,1242,1,23,7,6,73,36,37,76
SK Sturm Gra,1242,2,19,7,10,59,35,24,64
SC Rheindorf,1242,3,18,8,10,53,44,9,62
Vienna,1242,4,19,4,13,61,52,9,61
Rapid Vienna,1242,5,13,10,13,59,43,16,49
RZ Pellets W,1242,6,12,7,17,44,53,-9,43
SV Josko Rie,1242,7,12,7,17,34,48,-14,43
Mattersburg,1242,8,10,7,19,35,53,-18,37
St. Pölten,1242,9,9,9,18,41,63,-22,36
Admira Wacke,1242,10,10,4,22,30,62,-32,34
FC Salzburg,1243,1,20,10,6,73,38,35,70
SC Rheindorf,1243,2,18,9,9,54,40,14,63
Vienna,1243,3,19,5,12,66,53,13,62
Rapid Vienna,1243,4,15,11,10,57,40,17,56
SK Sturm Gra,1243,5,15,9,12,51,39,12,54
Admira Wacke,1243,6,12,9,15,39,48,-9,45
St. Pölten,1243,7,11,10,15,42,55,-13,43
Mattersburg,1243,8,9,10,17,38,54,-16,37
RZ Pellets W,1243,9,9,7,20,38,66,-28,34
SV Josko Rie,1243,10,8,8,20,27,52,-25,32
FC Salzburg,1244,1,21,6,9,66,31,35,69
Vienna,1244,2,21,4,11,69,50,19,67
SC Rheindorf,1244,3,19,8,9,55,44,11,65
Rapid Vienna,1244,4,17,10,9,55,34,21,61
SK Sturm Gra,1244,5,15,7,14,46,37,9,52
RZ Pellets W,1244,6,12,8,16,50,63,-13,44
Admira Wacke,1244,7,13,3,20,42,62,-20,42
St. Pölten,1244,8,10,9,17,40,61,-21,39
SV Josko Rie,1244,9,11,5,20,38,54,-16,38
Mattersburg,1244,10,7,8,21,33,58,-25,29
FC Salzburg,1245,1,24,5,7,70,30,40,77
SK Sturm Gra,1245,2,21,4,11,60,37,23,67
SC Rheindorf,1245,3,19,7,10,53,38,15,64
Vienna,1245,4,16,7,13,53,49,4,55
Rapid Vienna,1245,5,11,10,15,50,43,7,43
RZ Pellets W,1245,6,13,4,19,44,58,-14,43
Admira Wacke,1245,7,12,6,18,36,56,-20,42
SV Josko Rie,1245,8,12,4,20,38,57,-19,40
Mattersburg,1245,9,10,9,17,40,54,-14,39
St. Pölten,1245,10,10,8,18,45,67,-22,38
FC Salzburg,1246,1,24,6,6,67,27,40,78
SC Rheindorf,1246,2,22,5,9,63,37,26,71
Vienna,1246,3,21,4,11,62,48,14,67
SK Sturm Gra,1246,4,18,6,12,51,31,20,60
Rapid Vienna,1246,5,13,12,11,51,40,11,51
SV Josko Rie,1246,6,13,3,20,42,58,-16,42
RZ Pellets W,1246,7,11,7,18,42,55,-13,40
Mattersburg,1246,8,9,8,19,41,61,-20,35
St. Pölten,1246,9,7,10,19,39,67,-28,31
Admira Wacke,1246,10,8,7,21,29,63,-34,31
Vienna,1247,1,22,4,10,69,46,23,70
SC Rheindorf,1247,2,21,6,9,56,39,17,69
FC Salzburg,1247,3,19,9,8,66,29,37,66
SK Sturm Gra,1247,4,17,6,13,57,39,18,57
Rapid Vienna,1247,5,13,12,11,54,43,11,51
St. Pölten,1247,6,12,7,17,44,64,-20,43
Admira Wacke,1247,7,12,6,18,39,61,-22,42
Mattersburg,1247,8,10,8,18,36,54,-18,38
RZ Pellets W,1247,9,8,10,18,44,64,-20,34
SV Josko Rie,1247,10,10,4,22,35,61,-26,34
FC Salzburg,1248,1,22,8,6,71,24,47,74
SC Rheindorf,1248,2,19,7,10,52,49,3,64
SK Sturm Gra,1248,3,18,5,13,58,39,19,59
Vienna,1248,4,17,5,14,54,50,4,56
Rapid Vienna,1248,5,13,12,11,51,36,15,51
RZ Pellets W,1248,6,15,6,15,47,48,-1,51
Admira Wacke,1248,7,12,9,15,49,56,-7,45
Mattersburg,1248,8,10,7,19,40,59,-19,37
SV Josko Rie,1248,9,10,7,19,35,60,-25,37
St. Pölten,1248,10,6,10,20,32,68,-36,28
SK Sturm Gra,1249,1,20,8,8,62,34,28,68
FC Salzburg,1249,2,20,6,10,71,40,31,66
SC Rheindorf,1249,3,18,9,9,57,44,13,63
Vienna,1249,4,18,5,13,63,50,13,59
Rapid Vienna,1249,5,15,11,10,56,39,17,56
Mattersburg,1249,6,11,10,15,44,51,-7,43
Admira Wacke,1249,7,12,5,19,37,62,-25,41
RZ Pellets W,1249,8,11,7,18,47,61,-14,40
St. Pölten,1249,9,9,9,18,36,64,-28,36
SV Josko Rie,1249,10,8,6,22,30,58,-28,30
FC Salzburg,1250,1,21,9,6,69,29,40,72
SC Rheindorf,1250,2,20,6,10,56,48,8,66
SK Sturm Gra,1250,3,20,5,11,63,35,28,65
Vienna,1250,4,18,5,13,61,53,8,59
RZ Pellets W,1250,5,13,9,14,51,61,-10,48
Rapid Vienna,1250,6,12,11,13,51,41,10,47
Admira Wacke,1250,7,12,6,18,42,62,-20,42
SV Josko Rie,1250,8,11,4,21,42,59,-17,37
St. Pölten,1250,9,9,8,19,46,72,-26,35
Mattersburg,1250,10,8,9,19,43,64,-21,33
FC Salzburg,1251,1,22,7,7,67,31,36,73
SK Sturm Gra,1251,2,19,8,9,61,31,30,65
Vienna,1251,3,19,5,12,66,50,16,62
SC Rheindorf,1251,4,17,7,12,50,44,6,58
Rapid Vienna,1251,5,15,11,10,56,42,14,56
SV Josko Rie,1251,6,14,7,15,38,46,-8,49
RZ Pellets W,1251,7,11,11,14,42,51,-9,44
St. Pölten,1251,8,8,10,18,33,59,-26,34
Admira Wacke,1251,9,8,8,20,34,62,-28,32
Mattersburg,1251,10,7,6,23,35,66,-31,27
SK Sturm Gra,1252,1,22,6,8,66,35,31,72
Vienna,1252,2,20,6,10,68,46,22,66
SC Rheindorf,1252,3,20,6,10,55,48,7,66
FC Salzburg,1252,4,19,8,9,65,30,35,65
Rapid Vienna,1252,5,14,10,12,58,43,15,52
Admira Wacke,1252,6,13,6,17,37,54,-17,45
St. Pölten,1252,7,12,7,17,51,66,-15,43
Mattersburg,1252,8,9,8,19,30,58,-28,35
RZ Pellets W,1252,9,9,6,21,43,65,-22,33
SV Josko Rie,1252,10,9,3,24,27,55,-28,30
FC Salzburg,1253,1,21,10,5,64,27,37,73
SC Rheindorf,1253,2,19,9,8,55,41,14,66
Vienna,1253,3,17,10,9,66,51,15,61
SK Sturm Gra,1253,4,18,6,12,54,38,16,60
Rapid Vienna,1253,5,15,11,10,57,40,17,56
RZ Pellets W,1253,6,14,7,15,48,55,-7,49
Admira Wacke,1253,7,11,6,19,33,56,-23,39
Mattersburg,1253,8,8,9,19,33,52,-19,33
SV Josko Rie,1253,9,9,5,22,33,54,-21,32
St. Pölten,1253,10,6,11,19,34,63,-29,29
FC Salzburg,1254,1,21,8,7,78,37,41,71
SK Sturm Gra,1254,2,18,8,10,50,29,21,62
SC Rheindorf,1254,3,17,8,11,52,45,7,59
Vienna,1254,4,18,5,13,59,54,5,59
Rapid Vienna,1254,5,15,10,11,55,37,18,55
RZ Pellets W,1254,6,11,11,14,44,58,-14,44
Admira Wacke,1254,7,11,6,19,37,59,-22,39
St. Pölten,1254,8,9,11,16,42,58,-16,38
Mattersburg,1254,9,10,6,20,44,65,-21,36
SV Josko Rie,1254,10,8,11,17,35,54,-19,35
FC Salzburg,1255,1,23,5,8,70,34,36,74
SK Sturm Gra,1255,2,22,6,8,61,28,33,72
Vienna,1255,3,19,5,12,60,50,10,62
SC Rheindorf,1255,4,18,6,12,62,51,11,60
Rapid Vienna,1255,5,16,8,12,57,39,18,56
RZ Pellets W,1255,6,12,7,17,47,59,-12,43
SV Josko Rie,1255,7,12,5,19,36,51,-15,41
Admira Wacke,1255,8,11,4,21,37,66,-29,37
St. Pölten,1255,9,8,9,19,40,71,-31,33
Mattersburg,1255,10,7,9,20,38,59,-21,30
SC Rheindorf,1256,1,22,6,8,60,39,21,72
FC Salzburg,1256,2,20,8,8,65,33,32,68
Vienna,1256,3,20,6,10,64,47,17,66
Rapid Vienna,1256,4,16,11,9,61,38,23,59
SK Sturm Gra,1256,5,16,7,13,55,39,16,55
RZ Pellets W,1256,6,14,7,15,46,52,-6,49
Admira Wacke,1256,7,8,11,17,25,51,-26,35
SV Josko Rie,1256,8,8,8,20,23,49,-26,32
Mattersburg,1256,9,7,10,19,31,55,-24,31
St. Pölten,1256,10,7,10,19,44,71,-27,31
FC Salzburg,1257,1,21,8,7,67,27,40,71
SC Rheindorf,1257,2,20,8,8,59,39,20,68
Vienna,1257,3,19,4,13,64,52,12,61
SK Sturm Gra,1257,4,17,7,12,54,40,14,58
Rapid Vienna,1257,5,11,12,13,48,40,8,45
SV Josko Rie,1257,6,12,6,18,35,50,-15,42
St. Pölten,1257,7,10,10,16,37,54,-17,40
Admira Wacke,1257,8,10,10,16,36,55,-19,40
RZ Pellets W,1257,9,10,9,17,40,58,-18,39
Mattersburg,1257,10,9,8,19,34,59,-25,35
SC Rheindorf,1258,1,23,6,7,64,45,19,75
FC Salzburg,1258,2,19,6,11,64,36,28,63
SK Sturm Gra,1258,3,17,6,13,53,32,21,57
Vienna,1258,4,16,7,13,56,56,0,55
RZ Pellets W,1258,5,13,9,14,46,52,-6,48
SV Josko Rie,1258,6,15,2,19,41,53,-12,47
Rapid Vienna,1258,7,11,12,13,53,43,10,45
Admira Wacke,1258,8,12,6,18,36,60,-24,42
Mattersburg,1258,9,10,9,17,39,53,-14,39
St. Pölten,1258,10,7,11,18,44,66,-22,32
SK Sturm Gra,1259,1,21,4,11,61,36,25,67
SC Rheindorf,1259,2,20,5,11,59,50,9,65
FC Salzburg,1259,3,18,10,8,59,34,25,64
Vienna,1259,4,19,6,11,82,58,24,63
Rapid Vienna,1259,5,17,11,8,57,37,20,62
SV Josko Rie,1259,6,9,11,16,38,52,-14,38
Admira Wacke,1259,7,10,7,19,36,59,-23,37
RZ Pellets W,1259,8,10,7,19,39,65,-26,37
St. Pölten,1259,9,9,9,18,42,61,-19,36
Mattersburg,1259,10,8,8,20,39,60,-21,32
SC Rheindorf,1260,1,23,8,5,57,29,28,77
FC Salzburg,1260,2,20,10,6,63,27,36,70
SK Sturm Gra,1260,3,17,8,11,57,36,21,59
Vienna,1260,4,17,6,13,57,54,3,57
Rapid Vienna,1260,5,13,12,11,48,35,13,51
RZ Pellets W,1260,6,12,8,16,50,53,-3,44
St. Pölten,1260,7,11,10,15,44,59,-15,43
SV Josko Rie,1260,8,12,4,20,32,51,-19,40
Admira Wacke,1260,9,8,7,21,29,61,-32,31
Mattersburg,1260,10,6,9,21,33,65,-32,27
SC Rheindorf,1261,1,22,7,7,59,37,22,73
FC Salzburg,1261,2,21,6,9,72,34,38,69
SK Sturm Gra,1261,3,19,6,11,54,31,23,63
Vienna,1261,4,17,7,12,64,58,6,58
Rapid Vienna,1261,5,13,11,12,48,38,10,50
RZ Pellets W,1261,6,13,10,13,44,49,-5,49
Mattersburg,1261,7,10,7,19,35,57,-22,37
Admira Wacke,1261,8,9,8,19,36,59,-23,35
SV Josko Rie,1261,9,10,5,21,33,57,-24,35
St. Pölten,1261,10,7,11,18,35,60,-25,32
FC Salzburg,1262,1,20,11,5,64,28,36,71
SK Sturm Gra,1262,2,20,6,10,64,38,26,66
SC Rheindorf,1262,3,19,7,10,54,43,11,64
Vienna,1262,4,18,4,14,61,53,8,58
Rapid Vienna,1262,5,13,14,9,53,39,14,53
SV Josko Rie,1262,6,13,7,16,37,46,-9,46
St. Pölten,1262,7,11,7,18,44,62,-18,40
Admira Wacke,1262,8,10,8,18,36,58,-22,38
RZ Pellets W,1262,9,9,9,18,39,57,-18,36
Mattersburg,1262,10,6,9,21,32,60,-28,27
SK Sturm Gra,1263,1,19,9,8,61,33,28,66
Vienna,1263,2,19,7,10,70,48,22,64
FC Salzburg,1263,3,18,8,10,62,39,23,62
SC Rheindorf,1263,4,17,7,12,47,49,-2,58
Rapid Vienna,1263,5,15,12,9,55,36,19,57
RZ Pellets W,1263,6,12,8,16,43,54,-11,44
Mattersburg,1263,7,11,9,16,41,48,-7,42
SV Josko Rie,1263,8,10,5,21,34,52,-18,35
St. Pölten,1263,9,8,11,17,37,60,-23,35
Admira Wacke,1263,10,9,8,19,34,65,-31,35
Vienna,1264,1,21,4,11,68,48,20,67
SC Rheindorf,1264,2,20,6,10,58,41,17,66
FC Salzburg,1264,3,18,7,11,58,38,20,61
SK Sturm Gra,1264,4,17,9,10,57,31,26,60
Rapid Vienna,1264,5,15,10,11,59,39,20,55
Admira Wacke,1264,6,13,8,15,40,58,-18,47
RZ Pellets W,1264,7,11,7,18,47,65,-18,40
Mattersburg,1264,8,9,12,15,44,52,-8,39
SV Josko Rie,1264,9,11,3,22,34,61,-27,36
St. Pölten,1264,10,7,10,19,40,72,-32,31
Vienna,1265,1,22,4,10,65,48,17,70
SC Rheindorf,1265,2,20,7,9,60,43,17,67
SK Sturm Gra,1265,3,20,5,11,58,36,22,65
FC Salzburg,1265,4,18,9,9,60,38,22,63
Rapid Vienna,1265,5,12,14,10,52,38,14,50
SV Josko Rie,1265,6,15,4,17,48,50,-2,49
RZ Pellets W,1265,7,12,8,16,47,60,-13,44
Admira Wacke,1265,8,9,6,21,30,57,-27,33
St. Pölten,1265,9,7,11,18,42,64,-22,32
Mattersburg,1265,10,7,8,21,36,64,-28,29
FC Salzburg,1266,1,19,10,7,64,36,28,67
SC Rheindorf,1266,2,19,9,8,55,40,15,66
Vienna,1266,3,20,5,11,63,41,22,65
SK Sturm Gra,1266,4,17,7,12,51,35,16,58
Rapid Vienna,1266,5,15,11,10,57,35,22,56
RZ Pellets W,1266,6,14,7,15,46,56,-10,49
Admira Wacke,1266,7,11,6,19,35,60,-25,39
Mattersburg,1266,8,9,11,16,41,51,-10,38
St. Pölten,1266,9,7,10,19,36,64,-28,31
SV Josko Rie,1266,10,8,6,22,35,65,-30,30
FC Salzburg,1267,1,22,5,9,70,35,35,71
SC Rheindorf,1267,2,21,7,8,61,42,19,70
SK Sturm Gra,1267,3,19,7,10,56,33,23,64
Rapid Vienna,1267,4,16,8,12,63,39,24,56
Vienna,1267,5,15,9,12,60,56,4,54
RZ Pellets W,1267,6,12,8,16,54,55,-1,44
Admira Wacke,1267,7,12,7,17,35,55,-20,43
Mattersburg,1267,8,11,7,18,39,61,-22,40
SV Josko Rie,1267,9,9,7,20,33,55,-22,34
St. Pölten,1267,10,6,9,21,42,82,-40,27
FC Salzburg,1268,1,25,6,5,63,24,39,81
SK Sturm Gra,1268,2,20,6,10,64,30,34,66
SC Rheindorf,1268,3,19,7,10,55,40,15,64
Rapid Vienna,1268,4,16,8,12,55,44,11,56
Vienna,1268,5,16,6,14,59,56,3,54
Admira Wacke,1268,6,13,5,18,39,58,-19,44
SV Josko Rie,1268,7,12,5,19,40,58,-18,41
RZ Pellets W,1268,8,11,5,20,49,66,-17,38
Mattersburg,1268,9,8,10,18,36,56,-20,34
St. Pölten,1268,10,8,6,22,39,67,-28,30
FC Salzburg,1269,1,21,9,6,67,32,35,72
SC Rheindorf,1269,2,21,7,8,61,37,24,70
SK Sturm Gra,1269,3,20,6,10,61,33,28,66
Vienna,1269,4,20,5,11,69,54,15,65
RZ Pellets W,1269,5,18,6,12,54,52,2,60
Rapid Vienna,1269,6,13,10,13,55,43,12,49
Admira Wacke,1269,7,11,6,19,37,60,-23,39
SV Josko Rie,1269,8,9,4,23,34,59,-25,31
St. Pölten,1269,9,7,7,22,35,64,-29,28
Mattersburg,1269,10,7,6,23,33,72,-39,27
FC Salzburg,1270,1,23,7,6,66,31,35,76
Vienna,1270,2,22,4,10,68,43,25,70
SK Sturm Gra,1270,3,20,4,12,60,31,29,64
Rapid Vienna,1270,4,17,9,10,57,42,15,60
SC Rheindorf,1270,5,15,9,12,44,44,0,54
RZ Pellets W,1270,6,12,6,18,46,64,-18,42
St. Pölten,1270,7,11,8,17,46,64,-18,41
Admira Wacke,1270,8,10,5,21,43,64,-21,35
Mattersburg,1270,9,8,9,19,36,57,-21,33
SV Josko Rie,1270,10,9,5,22,37,63,-26,32
SK Sturm Gra,1271,1,20,5,11,64,39,25,65
Rapid Vienna,1271,2,18,8,10,65,41,24,62
Vienna,1271,3,19,3,14,63,51,12,60
SC Rheindorf,1271,4,16,12,8,51,41,10,60
FC Salzburg,1271,5,17,7,12,58,36,22,58
RZ Pellets W,1271,6,16,4,16,51,56,-5,52
Admira Wacke,1271,7,12,6,18,38,57,-19,42
St. Pölten,1271,8,10,9,17,46,67,-21,39
Mattersburg,1271,9,10,7,19,36,57,-21,37
SV Josko Rie,1271,10,10,3,23,34,61,-27,33
SC Rheindorf,1272,1,22,7,7,60,39,21,73
FC Salzburg,1272,2,19,12,5,61,25,36,69
SK Sturm Gra,1272,3,18,6,12,57,37,20,60
Vienna,1272,4,17,7,12,65,57,8,58
RZ Pellets W,1272,5,13,9,14,50,53,-3,48
Rapid Vienna,1272,6,11,12,13,50,39,11,45
SV Josko Rie,1272,7,12,5,19,34,51,-17,41
Admira Wacke,1272,8,10,8,18,37,59,-22,38
Mattersburg,1272,9,10,7,19,43,60,-17,37
St. Pölten,1272,10,6,11,19,38,75,-37,29
FC Salzburg,1273,1,24,6,6,69,29,40,78
SK Sturm Gra,1273,2,20,6,10,55,34,21,66
SC Rheindorf,1273,3,19,5,12,53,39,14,62
Vienna,1273,4,18,3,15,56,55,1,57
Rapid Vienna,1273,5,15,8,13,54,40,14,53
RZ Pellets W,1273,6,13,8,15,56,58,-2,47
SV Josko Rie,1273,7,14,3,19,36,47,-11,45
Mattersburg,1273,8,9,9,18,33,51,-18,36
St. Pölten,1273,9,9,8,19,36,62,-26,35
Admira Wacke,1273,10,9,4,23,33,66,-33,31
FC Salzburg,1274,1,21,7,8,58,29,29,70
SC Rheindorf,1274,2,18,8,10,52,44,8,62
Rapid Vienna,1274,3,17,10,9,63,42,21,61
SK Sturm Gra,1274,4,16,9,11,58,41,17,57
Vienna,1274,5,15,7,14,61,55,6,52
Admira Wacke,1274,6,12,8,16,39,57,-18,44
St. Pölten,1274,7,11,9,16,47,57,-10,42
RZ Pellets W,1274,8,11,8,17,51,62,-11,41
SV Josko Rie,1274,9,11,7,18,36,51,-15,40
Mattersburg,1274,10,7,9,20,34,61,-27,30
FC Salzburg,1275,1,22,6,8,61,27,34,72
SK Sturm Gra,1275,2,20,7,9,60,34,26,67
Vienna,1275,3,19,5,12,70,51,19,62
SC Rheindorf,1275,4,18,7,11,52,44,8,61
Rapid Vienna,1275,5,14,13,9,59,38,21,55
RZ Pellets W,1275,6,12,9,15,43,53,-10,45
Admira Wacke,1275,7,12,9,15,44,59,-15,45
SV Josko Rie,1275,8,9,7,20,29,60,-31,34
St. Pölten,1275,9,7,10,19,36,63,-27,31
Mattersburg,1275,10,6,9,21,33,58,-25,27
FC Salzburg,1276,1,20,7,9,70,35,35,67
Vienna,1276,2,21,4,11,69,50,19,67
SC Rheindorf,1276,3,19,8,9,53,39,14,65
SK Sturm Gra,1276,4,18,8,10,55,37,18,62
Mattersburg,1276,5,14,6,16,42,54,-12,48
Rapid Vienna,1276,6,11,12,13,42,37,5,45
SV Josko Rie,1276,7,13,3,20,40,58,-18,42
Admira Wacke,1276,8,11,5,20,41,61,-20,38
RZ Pellets W,1276,9,10,7,19,41,55,-14,37
St. Pölten,1276,10,9,8,19,37,64,-27,35
FC Salzburg,1277,1,21,8,7,68,30,38,71
SK Sturm Gra,1277,2,19,5,12,56,38,18,62
SC Rheindorf,1277,3,17,8,11,55,48,7,59
Vienna,1277,4,17,6,13,58,52,6,57
Rapid Vienna,1277,5,14,11,11,58,43,15,53
Admira Wacke,1277,6,15,4,17,44,55,-11,49
RZ Pellets W,1277,7,12,9,15,41,48,-7,45
SV Josko Rie,1277,8,12,7,17,38,52,-14,43
Mattersburg,1277,9,8,11,17,35,54,-19,35
St. Pölten,1277,10,7,7,22,37,70,-33,28
FC Salzburg,1278,1,20,11,5,65,32,33,71
SC Rheindorf,1278,2,20,6,10,56,41,15,66
SK Sturm Gra,1278,3,20,4,12,54,33,21,64
Rapid Vienna,1278,4,14,13,9,57,41,16,55
Vienna,1278,5,16,5,15,63,58,5,53
Admira Wacke,1278,6,12,6,18,40,59,-19,42
SV Josko Rie,1278,7,12,5,19,35,53,-18,41
RZ Pellets W,1278,8,10,10,16,39,53,-14,40
St. Pölten,1278,9,8,11,17,39,60,-21,35
Mattersburg,1278,10,8,9,19,39,57,-18,33
FC Salzburg,1279,1,24,5,7,69,28,41,77
SC Rheindorf,1279,2,19,8,9,52,42,10,65
SK Sturm Gra,1279,3,18,5,13,56,34,22,59
Rapid Vienna,1279,4,14,10,12,57,41,16,52
RZ Pellets W,1279,5,14,8,14,50,50,0,50
Vienna,1279,6,13,10,13,50,52,-2,49
Admira Wacke,1279,7,13,8,15,36,57,-21,47
St. Pölten,1279,8,9,10,17,42,56,-14,37
SV Josko Rie,1279,9,8,8,20,31,57,-26,32
Mattersburg,1279,10,8,8,20,28,54,-26,32
FC Salzburg,1280,1,20,7,9,57,30,27,67
Vienna,1280,2,21,3,12,65,49,16,66
SK Sturm Gra,1280,3,18,8,10,53,31,22,62
SC Rheindorf,1280,4,17,7,12,54,51,3,58
Rapid Vienna,1280,5,15,10,11,61,43,18,55
SV Josko Rie,1280,6,13,6,17,38,50,-12,45
Mattersburg,1280,7,11,7,18,41,54,-13,40
Admira Wacke,1280,8,11,6,19,39,61,-22,39
RZ Pellets W,1280,9,9,9,18,42,58,-16,36
St. Pölten,1280,10,8,11,17,41,64,-23,35
FC Salzburg,1281,1,23,6,7,69,31,38,75
SC Rheindorf,1281,2,18,8,10,51,45,6,62
SK Sturm Gra,1281,3,17,8,11,52,32,20,59
Vienna,1281,4,17,4,15,57,51,6,55
Rapid Vienna,1281,5,15,9,12,55,41,14,54
Admira Wacke,1281,6,17,3,16,42,53,-11,54
RZ Pellets W,1281,7,11,7,18,45,56,-11,40
Mattersburg,1281,8,9,11,16,40,51,-11,38
St. Pölten,1281,9,9,8,19,35,60,-25,35
SV Josko Rie,1281,10,10,4,22,29,55,-26,34
SK Sturm Gra,1282,1,24,6,6,71,29,42,78
SC Rheindorf,1282,2,21,7,8,56,44,12,70
FC Salzburg,1282,3,19,11,6,68,31,37,68
Vienna,1282,4,17,4,15,59,57,2,55
Rapid Vienna,1282,5,14,8,14,60,45,15,50
RZ Pellets W,1282,6,12,5,19,45,61,-16,41
Admira Wacke,1282,7,11,7,18,41,65,-24,40
St. Pölten,1282,8,10,8,18,44,61,-17,38
SV Josko Rie,1282,9,10,5,21,37,60,-23,35
Mattersburg,1282,10,7,9,20,36,64,-28,30
FC Salzburg,1283,1,21,9,6,72,29,43,72
SC Rheindorf,1283,2,19,8,9,53,40,13,65
SK Sturm Gra,1283,3,18,10,8,59,35,24,64
Vienna,1283,4,19,7,10,63,49,14,64
Rapid Vienna,1283,5,15,9,12,54,39,15,54
SV Josko Rie,1283,6,13,3,20,33,51,-18,42
RZ Pellets W,1283,7,9,11,16,45,55,-10,38
St. Pölten,1283,8,7,14,15,36,57,-21,35
Mattersburg,1283,9,7,11,18,32,53,-21,32
Admira Wacke,1283,10,8,6,22,37,76,-39,30
FC Salzburg,1284,1,22,7,7,64,31,33,73
SK Sturm Gra,1284,2,21,6,9,61,32,29,69
SC Rheindorf,1284,3,19,8,9,60,48,12,65
Vienna,1284,4,18,7,11,68,48,20,61
Admira Wacke,1284,5,14,6,16,37,52,-15,48
Rapid Vienna,1284,6,12,10,14,51,47,4,46
SV Josko Rie,1284,7,11,6,19,37,49,-12,39
RZ Pellets W,1284,8,10,9,17,42,59,-17,39
St. Pölten,1284,9,7,13,16,38,61,-23,34
Mattersburg,1284,10,5,10,21,29,60,-31,25
Vienna,1285,1,21,7,8,83,45,38,70
FC Salzburg,1285,2,18,11,7,62,31,31,65
SC Rheindorf,1285,3,18,8,10,52,50,2,62
SK Sturm Gra,1285,4,17,8,11,52,33,19,59
Rapid Vienna,1285,5,12,13,11,55,42,13,49
Admira Wacke,1285,6,11,11,14,38,54,-16,44
RZ Pellets W,1285,7,11,9,16,49,66,-17,42
SV Josko Rie,1285,8,10,7,19,34,55,-21,37
Mattersburg,1285,9,8,10,18,38,57,-19,34
St. Pölten,1285,10,6,12,18,40,70,-30,30
FC Salzburg,1286,1,23,8,5,65,25,40,77
SC Rheindorf,1286,2,21,4,11,58,45,13,67
SK Sturm Gra,1286,3,19,7,10,56,31,25,64
Vienna,1286,4,17,5,14,57,49,8,56
Rapid Vienna,1286,5,11,12,13,54,45,9,45
St. Pölten,1286,6,11,8,17,51,70,-19,41
Admira Wacke,1286,7,12,5,19,37,60,-23,41
SV Josko Rie,1286,8,12,4,20,38,55,-17,40
Mattersburg,1286,9,9,10,17,44,61,-17,37
RZ Pellets W,1286,10,8,11,17,44,63,-19,35
FC Salzburg,1287,1,23,6,7,71,29,42,75
Rapid Vienna,1287,2,21,7,8,67,37,30,70
Vienna,1287,3,19,7,10,62,49,13,64
SC Rheindorf,1287,4,18,9,9,48,39,9,63
SK Sturm Gra,1287,5,17,7,12,56,35,21,58
RZ Pellets W,1287,6,12,7,17,37,57,-20,43
Admira Wacke,1287,7,11,6,19,36,60,-24,39
SV Josko Rie,1287,8,10,8,18,30,51,-21,38
Mattersburg,1287,9,5,11,20,33,59,-26,26
St. Pölten,1287,10,5,10,21,40,64,-24,25
SC Rheindorf,1288,1,24,7,5,63,38,25,79
FC Salzburg,1288,2,23,7,6,65,29,36,76
SK Sturm Gra,1288,3,20,4,12,64,31,33,64
Rapid Vienna,1288,4,17,8,11,55,35,20,59
Vienna,1288,5,18,3,15,57,53,4,57
St. Pölten,1288,6,10,8,18,39,58,-19,38
Mattersburg,1288,7,9,8,19,36,55,-19,35
RZ Pellets W,1288,8,9,7,20,38,57,-19,34
Admira Wacke,1288,9,10,4,22,34,69,-35,34
SV Josko Rie,1288,10,9,6,21,33,59,-26,33
FC Salzburg,1289,1,21,8,7,59,29,30,71
SK Sturm Gra,1289,2,21,7,8,64,33,31,70
SC Rheindorf,1289,3,21,5,10,58,49,9,68
Vienna,1289,4,17,3,16,60,56,4,54
Rapid Vienna,1289,5,12,10,14,54,46,8,46
St. Pölten,1289,6,12,9,15,50,61,-11,45
SV Josko Rie,1289,7,12,5,19,44,56,-12,41
Admira Wacke,1289,8,11,7,18,37,60,-23,40
Mattersburg,1289,9,10,8,18,45,57,-12,38
RZ Pellets W,1289,10,10,4,22,45,69,-24,34
SC Rheindorf,1290,1,23,8,5,53,31,22,77
FC Salzburg,1290,2,22,4,10,65,36,29,70
SK Sturm Gra,1290,3,19,7,10,64,39,25,64
Vienna,1290,4,20,3,13,62,50,12,63
Rapid Vienna,1290,5,12,8,16,54,49,5,44
Admira Wacke,1290,6,12,7,17,44,61,-17,43
RZ Pellets W,1290,7,10,9,17,39,54,-15,39
St. Pölten,1290,8,9,10,17,40,59,-19,37
Mattersburg,1290,9,9,8,19,35,58,-23,35
SV Josko Rie,1290,10,10,4,22,39,58,-19,34
SC Rheindorf,1291,1,23,5,8,58,36,22,74
FC Salzburg,1291,2,22,6,8,63,31,32,72
SK Sturm Gra,1291,3,18,8,10,52,30,22,62
Rapid Vienna,1291,4,17,9,10,66,37,29,60
Vienna,1291,5,17,2,17,58,57,1,53
St. Pölten,1291,6,12,7,17,53,63,-10,43
SV Josko Rie,1291,7,13,3,20,37,55,-18,42
RZ Pellets W,1291,8,11,7,18,43,64,-21,40
Admira Wacke,1291,9,8,8,20,35,70,-35,32
Mattersburg,1291,10,6,11,19,30,52,-22,29
FC Salzburg,1292,1,19,8,9,58,31,27,65
Rapid Vienna,1292,2,18,9,9,66,37,29,63
SC Rheindorf,1292,3,17,11,8,57,46,11,62
SK Sturm Gra,1292,4,18,7,11,61,37,24,61
Vienna,1292,5,18,7,11,63,46,17,61
RZ Pellets W,1292,6,14,8,14,47,52,-5,50
Mattersburg,1292,7,10,10,16,42,51,-9,40
Admira Wacke,1292,8,10,5,21,37,66,-29,35
SV Josko Rie,1292,9,10,3,23,38,61,-23,33
St. Pölten,1292,10,7,10,19,36,78,-42,31
SC Rheindorf,1293,1,20,10,6,59,38,21,70
Vienna,1293,2,19,8,9,63,44,19,65
FC Salzburg,1293,3,18,9,9,63,32,31,63
SK Sturm Gra,1293,4,19,5,12,56,35,21,62
Rapid Vienna,1293,5,15,9,12,55,39,16,54
Admira Wacke,1293,6,12,6,18,34,61,-27,42
RZ Pellets W,1293,7,9,11,16,41,55,-14,38
St. Pölten,1293,8,10,8,18,41,60,-19,38
Mattersburg,1293,9,9,8,19,38,61,-23,35
SV Josko Rie,1293,10,10,4,22,33,58,-25,34
SK Sturm Gra,1294,1,22,8,6,69,25,44,74
FC Salzburg,1294,2,21,10,5,68,31,37,73
SC Rheindorf,1294,3,21,8,7,54,43,11,71
Vienna,1294,4,20,3,13,68,49,19,63
Rapid Vienna,1294,5,12,12,12,55,43,12,48
RZ Pellets W,1294,6,12,6,18,44,62,-18,42
Admira Wacke,1294,7,9,7,20,31,63,-32,34
St. Pölten,1294,8,8,9,19,42,63,-21,33
Mattersburg,1294,9,8,9,19,37,60,-23,33
SV Josko Rie,1294,10,9,4,23,38,67,-29,31
FC Salzburg,1295,1,22,6,8,67,30,37,72
SC Rheindorf,1295,2,21,6,9,56,44,12,69
SK Sturm Gra,1295,3,20,7,9,61,37,24,67
Vienna,1295,4,18,3,15,57,47,10,57
Rapid Vienna,1295,5,11,11,14,50,48,2,44
SV Josko Rie,1295,6,13,5,18,32,46,-14,44
Mattersburg,1295,7,11,9,16,37,52,-15,42
Admira Wacke,1295,8,12,5,19,35,53,-18,41
RZ Pellets W,1295,9,11,7,18,43,53,-10,40
St. Pölten,1295,10,7,9,20,42,70,-28,30
SK Sturm Gra,1296,1,22,5,9,55,30,25,71
FC Salzburg,1296,2,21,7,8,61,31,30,70
SC Rheindorf,1296,3,21,5,10,50,41,9,68
Vienna,1296,4,18,4,14,64,54,10,58
Rapid Vienna,1296,5,15,8,13,58,37,21,53
Admira Wacke,1296,6,12,6,18,42,58,-16,42
RZ Pellets W,1296,7,12,6,18,45,62,-17,42
Mattersburg,1296,8,11,6,19,38,58,-20,39
SV Josko Rie,1296,9,10,5,21,31,54,-23,35
St. Pölten,1296,10,9,6,21,42,61,-19,33
FC Salzburg,1297,1,22,7,7,67,32,35,73
SK Sturm Gra,1297,2,21,5,10,66,38,28,68
SC Rheindorf,1297,3,18,7,11,52,46,6,61
Rapid Vienna,1297,4,16,9,11,63,37,26,57
Vienna,1297,5,16,8,12,64,55,9,56
RZ Pellets W,1297,6,12,8,16,45,54,-9,44
Mattersburg,1297,7,11,8,17,35,48,-13,41
St. Pölten,1297,8,10,7,19,46,67,-21,37
Admira Wacke,1297,9,10,6,20,35,65,-30,36
SV Josko Rie,1297,10,9,5,22,27,58,-31,32
FC Salzburg,1298,1,22,6,8,63,31,32,72
SC Rheindorf,1298,2,21,6,9,61,44,17,69
Vienna,1298,3,20,6,10,70,52,18,66
SK Sturm Gra,1298,4,17,7,12,51,36,15,58
Rapid Vienna,1298,5,13,13,10,70,47,23,52
RZ Pellets W,1298,6,12,9,15,42,55,-13,45
Mattersburg,1298,7,10,11,15,43,53,-10,41
Admira Wacke,1298,8,9,9,18,32,60,-28,36
SV Josko Rie,1298,9,9,5,22,31,55,-24,32
St. Pölten,1298,10,6,10,20,44,74,-30,28
SC Rheindorf,1299,1,20,11,5,58,36,22,71
FC Salzburg,1299,2,20,8,8,67,34,33,68
SK Sturm Gra,1299,3,20,5,11,57,35,22,65
Vienna,1299,4,15,7,14,53,51,2,52
RZ Pellets W,1299,5,14,9,13,54,52,2,51
Rapid Vienna,1299,6,11,12,13,48,44,4,45
Admira Wacke,1299,7,12,5,19,32,56,-24,41
St. Pölten,1299,8,9,9,18,45,64,-19,36
SV Josko Rie,1299,9,10,6,20,33,57,-24,36
Mattersburg,1299,10,8,10,18,34,52,-18,34
FC Salzburg,1300,1,20,8,8,64,30,34,68
SC Rheindorf,1300,2,20,8,8,51,33,18,68
Vienna,1300,3,20,4,12,62,46,16,64
SK Sturm Gra,1300,4,16,8,12,60,40,20,56
Rapid Vienna,1300,5,12,13,11,50,40,10,49
Admira Wacke,1300,6,13,7,16,40,57,-17,46
St. Pölten,1300,7,9,12,15,40,59,-19,39
Mattersburg,1300,8,9,10,17,38,57,-19,37
RZ Pellets W,1300,9,8,11,17,47,67,-20,35
SV Josko Rie,1300,10,8,9,19,31,54,-23,33
Vienna,1301,1,19,6,11,72,53,19,63
SC Rheindorf,1301,2,18,9,9,54,44,10,63
FC Salzburg,1301,3,18,7,11,59,40,19,61
SK Sturm Gra,1301,4,17,9,10,62,38,24,60
Rapid Vienna,1301,5,14,12,10,57,33,24,54
RZ Pellets W,1301,6,15,6,15,49,57,-8,51
Admira Wacke,1301,7,13,5,18,35,58,-23,44
Mattersburg,1301,8,12,7,17,39,54,-15,43
SV Josko Rie,1301,9,8,7,21,28,49,-21,31
St. Pölten,1301,10,7,10,19,38,67,-29,31
FC Salzburg,1302,1,17,13,6,56,29,27,64
SC Rheindorf,1302,2,18,10,8,50,36,14,64
SK Sturm Gra,1302,3,19,5,12,59,37,22,62
Vienna,1302,4,17,6,13,61,54,7,57
Rapid Vienna,1302,5,15,10,11,54,38,16,55
Mattersburg,1302,6,12,9,15,48,53,-5,45
RZ Pellets W,1302,7,11,9,16,45,59,-14,42
SV Josko Rie,1302,8,12,4,20,43,56,-13,40
Admira Wacke,1302,9,11,7,18,36,62,-26,40
St. Pölten,1302,10,6,11,19,38,66,-28,29
FC Salzburg,1303,1,24,6,6,68,27,41,78
Vienna,1303,2,19,6,11,64,53,11,63
SK Sturm Gra,1303,3,19,5,12,59,33,26,62
SC Rheindorf,1303,4,18,8,10,50,46,4,62
Rapid Vienna,1303,5,17,10,9,58,36,22,61
SV Josko Rie,1303,6,12,6,18,38,53,-15,42
Admira Wacke,1303,7,11,7,18,35,53,-18,40
St. Pölten,1303,8,8,11,17,47,66,-19,35
RZ Pellets W,1303,9,9,8,19,40,62,-22,35
Mattersburg,1303,10,5,9,22,34,64,-30,24
SC Rheindorf,1304,1,22,8,6,61,37,24,74
FC Salzburg,1304,2,21,8,7,68,32,36,71
Vienna,1304,3,19,6,11,71,50,21,63
SK Sturm Gra,1304,4,18,7,11,57,42,15,61
Rapid Vienna,1304,5,16,10,10,61,38,23,58
SV Josko Rie,1304,6,12,7,17,38,51,-13,43
RZ Pellets W,1304,7,12,5,19,47,63,-16,41
St. Pölten,1304,8,9,8,19,41,62,-21,35
Mattersburg,1304,9,7,9,20,33,59,-26,30
Admira Wacke,1304,10,7,6,23,34,77,-43,27
FC Salzburg,1305,1,23,8,5,69,26,43,77
Vienna,1305,2,20,5,11,60,45,15,65
SC Rheindorf,1305,3,19,7,10,56,44,12,64
SK Sturm Gra,1305,4,15,9,12,54,35,19,54
Rapid Vienna,1305,5,13,14,9,54,40,14,53
RZ Pellets W,1305,6,12,7,17,40,49,-9,43
St. Pölten,1305,7,10,10,16,38,56,-18,40
SV Josko Rie,1305,8,10,8,18,34,48,-14,38
Admira Wacke,1305,9,9,6,21,30,66,-36,33
Mattersburg,1305,10,7,10,19,32,58,-26,31
SC Rheindorf,1306,1,21,6,9,63,42,21,69
FC Salzburg,1306,2,20,8,8,63,34,29,68
SK Sturm Gra,1306,3,19,7,10,56,31,25,64
Vienna,1306,4,17,6,13,62,54,8,57
Rapid Vienna,1306,5,12,13,11,56,45,11,49
Admira Wacke,1306,6,14,4,18,42,64,-22,46
SV Josko Rie,1306,7,10,9,17,40,54,-14,39
St. Pölten,1306,8,9,10,17,48,66,-18,37
RZ Pellets W,1306,9,10,7,19,38,58,-20,37
Mattersburg,1306,10,8,10,18,34,54,-20,34
SK Sturm Gra,1307,1,20,9,7,69,37,32,69
SC Rheindorf,1307,2,19,9,8,57,47,10,66
FC Salzburg,1307,3,18,8,10,59,36,23,62
Vienna,1307,4,18,6,12,61,46,15,60
Rapid Vienna,1307,5,15,9,12,55,41,14,54
RZ Pellets W,1307,6,14,6,16,50,56,-6,48
St. Pölten,1307,7,11,9,16,43,56,-13,42
Admira Wacke,1307,8,12,5,19,41,67,-26,41
SV Josko Rie,1307,9,9,4,23,32,60,-28,31
Mattersburg,1307,10,6,11,19,39,60,-21,29
FC Salzburg,1308,1,22,8,6,69,31,38,74
SK Sturm Gra,1308,2,22,5,9,58,29,29,71
SC Rheindorf,1308,3,20,6,10,50,40,10,66
Vienna,1308,4,19,5,12,62,53,9,62
RZ Pellets W,1308,5,14,6,16,55,57,-2,48
Rapid Vienna,1308,6,11,9,16,47,49,-2,42
St. Pölten,1308,7,10,8,18,49,67,-18,38
Mattersburg,1308,8,9,10,17,46,61,-15,37
SV Josko Rie,1308,9,10,5,21,41,62,-21,35
Admira Wacke,1308,10,9,6,21,36,64,-28,33
Vienna,1309,1,20,7,9,65,44,21,67
SK Sturm Gra,1309,2,18,11,7,56,29,27,65
FC Salzburg,1309,3,19,7,10,63,33,30,64
SC Rheindorf,1309,4,15,13,8,51,41,10,58
Rapid Vienna,1309,5,13,13,10,52,37,15,52
SV Josko Rie,1309,6,13,7,16,31,44,-13,46
St. Pölten,1309,7,9,12,15,36,54,-18,39
RZ Pellets W,1309,8,9,8,19,45,68,-23,35
Admira Wacke,1309,9,8,10,18,38,64,-26,34
Mattersburg,1309,10,9,6,21,37,60,-23,33
SK Sturm Gra,1310,1,20,8,8,59,31,28,68
Vienna,1310,2,20,6,10,64,44,20,66
FC Salzburg,1310,3,19,7,10,61,33,28,64
SC Rheindorf,1310,4,17,8,11,55,48,7,59
RZ Pellets W,1310,5,16,6,14,51,50,1,54
Rapid Vienna,1310,6,13,12,11,57,43,14,51
Admira Wacke,1310,7,14,4,18,41,60,-19,46
St. Pölten,1310,8,7,11,18,43,62,-19,32
SV Josko Rie,1310,9,9,5,22,32,60,-28,32
Mattersburg,1310,10,6,11,19,34,66,-32,29
SK Sturm Gra,1311,1,21,6,9,58,30,28,69
FC Salzburg,1311,2,20,7,9,60,34,26,67
Vienna,1311,3,20,5,11,68,49,19,65
SC Rheindorf,1311,4,17,11,8,53,42,11,62
Rapid Vienna,1311,5,12,12,12,56,41,15,48
St. Pölten,1311,6,11,9,16,42,55,-13,42
RZ Pellets W,1311,7,11,8,17,41,58,-17,41
Admira Wacke,1311,8,10,8,18,35,61,-26,38
Mattersburg,1311,9,10,6,20,36,56,-20,36
SV Josko Rie,1311,10,8,8,20,31,54,-23,32
FC Salzburg,1312,1,22,5,9,65,29,36,71
SK Sturm Gra,1312,2,21,6,9,65,40,25,69
Vienna,1312,3,19,4,13,60,55,5,61
SC Rheindorf,1312,4,17,8,11,58,46,12,59
Rapid Vienna,1312,5,14,10,12,59,46,13,52
St. Pölten,1312,6,12,8,16,51,69,-18,44
Admira Wacke,1312,7,12,5,19,40,58,-18,41
Mattersburg,1312,8,11,7,18,35,53,-18,40
RZ Pellets W,1312,9,10,6,20,43,59,-16,36
SV Josko Rie,1312,10,11,3,22,37,58,-21,36
FC Salzburg,1313,1,20,9,7,63,27,36,69
Vienna,1313,2,21,5,10,60,40,20,68
SK Sturm Gra,1313,3,20,4,12,62,43,19,64
SC Rheindorf,1313,4,19,7,10,56,51,5,64
Rapid Vienna,1313,5,17,8,11,57,39,18,59
RZ Pellets W,1313,6,15,8,13,46,46,0,53
Admira Wacke,1313,7,10,7,19,35,57,-22,37
SV Josko Rie,1313,8,8,7,21,30,56,-26,31
Mattersburg,1313,9,8,6,22,33,56,-23,30
St. Pölten,1313,10,7,9,20,42,69,-27,30
FC Salzburg,1314,1,20,9,7,63,33,30,69
SK Sturm Gra,1314,2,20,6,10,55,28,27,66
SC Rheindorf,1314,3,19,8,9,52,42,10,65
Vienna,1314,4,17,8,11,62,52,10,59
Rapid Vienna,1314,5,12,12,12,48,40,8,48
RZ Pellets W,1314,6,12,9,15,48,50,-2,45
SV Josko Rie,1314,7,12,9,15,37,47,-10,45
Admira Wacke,1314,8,11,9,16,39,62,-23,42
Mattersburg,1314,9,6,10,20,33,57,-24,28
St. Pölten,1314,10,5,12,19,35,61,-26,27
FC Salzburg,1315,1,23,8,5,67,26,41,77
SK Sturm Gra,1315,2,19,7,10,56,33,23,64
SC Rheindorf,1315,3,17,9,10,52,46,6,60
Vienna,1315,4,15,6,15,52,51,1,51
RZ Pellets W,1315,5,14,8,14,46,52,-6,50
Rapid Vienna,1315,6,11,13,12,52,45,7,46
St. Pölten,1315,7,11,9,16,45,55,-10,42
Admira Wacke,1315,8,12,5,19,36,51,-15,41
SV Josko Rie,1315,9,11,4,21,32,56,-24,37
Mattersburg,1315,10,8,9,19,40,63,-23,33
FC Salzburg,1316,1,20,8,8,70,34,36,68
SC Rheindorf,1316,2,20,7,9,54,42,12,67
Vienna,1316,3,18,5,13,67,51,16,59
SK Sturm Gra,1316,4,16,9,11,55,42,13,57
Rapid Vienna,1316,5,14,13,9,59,38,21,55
Admira Wacke,1316,6,13,10,13,39,51,-12,49
RZ Pellets W,1316,7,11,9,16,50,64,-14,42
Mattersburg,1316,8,9,11,16,40,55,-15,38
St. Pölten,1316,9,10,6,20,42,67,-25,36
SV Josko Rie,1316,10,6,8,22,29,61,-32,26
FC Salzburg,1317,1,21,8,7,60,26,34,71
SC Rheindorf,1317,2,20,7,9,56,39,17,67
SK Sturm Gra,1317,3,18,8,10,52,35,17,62
Vienna,1317,4,18,6,12,55,48,7,60
Rapid Vienna,1317,5,11,12,13,57,50,7,45
Admira Wacke,1317,6,13,6,17,37,52,-15,45
RZ Pellets W,1317,7,10,12,14,41,52,-11,42
SV Josko Rie,1317,8,11,5,20,37,54,-17,38
St. Pölten,1317,9,9,8,19,46,65,-19,35
Mattersburg,1317,10,8,10,18,31,51,-20,34
FC Salzburg,1318,1,21,5,10,64,35,29,68
Vienna,1318,2,21,3,12,59,49,10,66
SK Sturm Gra,1318,3,19,7,10,58,33,25,64
SC Rheindorf,1318,4,17,7,12,52,48,4,58
Rapid Vienna,1318,5,15,10,11,56,38,18,55
RZ Pellets W,1318,6,14,6,16,47,53,-6,48
Mattersburg,1318,7,13,6,17,43,53,-10,45
SV Josko Rie,1318,8,11,5,20,36,56,-20,38
St. Pölten,1318,9,9,8,19,39,57,-18,35
Admira Wacke,1318,10,8,7,21,30,62,-32,31
FC Salzburg,1319,1,21,6,9,66,35,31,69
SK Sturm Gra,1319,2,20,6,10,62,39,23,66
SC Rheindorf,1319,3,19,7,10,56,42,14,64
Vienna,1319,4,18,5,13,56,52,4,59
Rapid Vienna,1319,5,15,11,10,69,47,22,56
Admira Wacke,1319,6,15,6,15,44,51,-7,51
RZ Pellets W,1319,7,11,10,15,45,57,-12,43
SV Josko Rie,1319,8,10,5,21,39,55,-16,35
Mattersburg,1319,9,7,10,19,35,62,-27,31
St. Pölten,1319,10,5,12,19,35,67,-32,27
SC Rheindorf,1320,1,20,9,7,60,35,25,69
SK Sturm Gra,1320,2,20,7,9,59,32,27,67
FC Salzburg,1320,3,19,7,10,64,37,27,64
Vienna,1320,4,19,6,11,69,62,7,63
Rapid Vienna,1320,5,13,14,9,54,36,18,53
Admira Wacke,1320,6,12,7,17,33,53,-20,43
RZ Pellets W,1320,7,9,13,14,40,53,-13,40
Mattersburg,1320,8,10,9,17,39,51,-12,39
St. Pölten,1320,9,8,9,19,40,68,-28,33
SV Josko Rie,1320,10,8,3,25,34,65,-31,27
SK Sturm Gra,1321,1,20,7,9,58,35,23,67
FC Salzburg,1321,2,18,10,8,59,30,29,64
Rapid Vienna,1321,3,16,10,10,64,41,23,58
SC Rheindorf,1321,4,16,9,11,51,46,5,57
Vienna,1321,5,17,4,15,61,58,3,55
Admira Wacke,1321,6,13,7,16,35,51,-16,46
SV Josko Rie,1321,7,11,8,17,40,53,-13,41
RZ Pellets W,1321,8,11,8,17,38,54,-16,41
Mattersburg,1321,9,9,9,18,36,51,-15,36
St. Pölten,1321,10,7,12,17,40,63,-23,33
FC Salzburg,1322,1,20,7,9,60,33,27,67
SK Sturm Gra,1322,2,20,6,10,58,36,22,66
Rapid Vienna,1322,3,17,12,7,69,37,32,63
Vienna,1322,4,18,6,12,65,58,7,60
SC Rheindorf,1322,5,18,5,13,54,46,8,59
RZ Pellets W,1322,6,11,11,14,50,58,-8,44
Admira Wacke,1322,7,12,8,16,39,58,-19,44
Mattersburg,1322,8,10,11,15,36,48,-12,41
SV Josko Rie,1322,9,8,5,23,31,59,-28,29
St. Pölten,1322,10,4,13,19,33,62,-29,25
FC Salzburg,1323,1,21,7,8,60,25,35,70
SK Sturm Gra,1323,2,20,6,10,60,36,24,66
Vienna,1323,3,20,6,10,66,46,20,66
SC Rheindorf,1323,4,18,9,9,56,47,9,63
Rapid Vienna,1323,5,14,11,11,54,39,15,53
RZ Pellets W,1323,6,14,6,16,44,52,-8,48
Admira Wacke,1323,7,12,5,19,38,58,-20,41
St. Pölten,1323,8,8,11,17,40,62,-22,35
SV Josko Rie,1323,9,10,5,21,35,57,-22,35
Mattersburg,1323,10,6,8,22,34,65,-31,26
SK Sturm Gra,1324,1,22,5,9,59,31,28,71
Vienna,1324,2,22,4,10,74,44,30,70
SC Rheindorf,1324,3,20,8,8,51,38,13,68
FC Salzburg,1324,4,20,6,10,67,38,29,66
Rapid Vienna,1324,5,12,12,12,54,44,10,48
Admira Wacke,1324,6,12,7,17,40,63,-23,43
RZ Pellets W,1324,7,11,7,18,38,59,-21,40
SV Josko Rie,1324,8,10,7,19,34,49,-15,37
St. Pölten,1324,9,8,7,21,34,64,-30,31
Mattersburg,1324,10,6,11,19,38,59,-21,29
FC Salzburg,1325,1,23,8,5,73,25,48,77
SC Rheindorf,1325,2,19,10,7,61,43,18,67
SK Sturm Gra,1325,3,19,7,10,61,35,26,64
Vienna,1325,4,18,5,13,66,56,10,59
Rapid Vienna,1325,5,11,15,10,61,47,14,48
RZ Pellets W,1325,6,12,10,14,54,57,-3,46
SV Josko Rie,1325,7,11,7,18,35,59,-24,40
Admira Wacke,1325,8,11,5,20,35,59,-24,38
Mattersburg,1325,9,7,9,20,35,66,-31,30
St. Pölten,1325,10,7,8,21,41,75,-34,29
SC Rheindorf,1326,1,19,10,7,63,40,23,67
SK Sturm Gra,1326,2,20,6,10,60,33,27,66
FC Salzburg,1326,3,18,10,8,57,29,28,64
Vienna,1326,4,18,5,13,63,56,7,59
Rapid Vienna,1326,5,14,11,11,55,40,15,53
RZ Pellets W,1326,6,12,9,15,47,56,-9,45
Admira Wacke,1326,7,12,7,17,36,55,-19,43
SV Josko Rie,1326,8,10,6,20,33,54,-21,36
St. Pölten,1326,9,8,10,18,40,66,-26,34
Mattersburg,1326,10,7,10,19,33,58,-25,31
FC Salzburg,1327,1,21,7,8,63,35,28,70
Vienna,1327,2,22,3,11,67,46,21,69
SC Rheindorf,1327,3,18,10,8,55,38,17,64
Rapid Vienna,1327,4,14,10,12,58,44,14,52
SK Sturm Gra,1327,5,14,8,14,53,39,14,50
RZ Pellets W,1327,6,13,9,14,51,59,-8,48
Admira Wacke,1327,7,11,7,18,40,63,-23,40
St. Pölten,1327,8,9,10,17,46,64,-18,37
Mattersburg,1327,9,9,9,18,39,62,-23,36
SV Josko Rie,1327,10,9,7,20,33,55,-22,34
FC Salzburg,1328,1,23,7,6,57,22,35,76
SC Rheindorf,1328,2,18,10,8,49,36,13,64
SK Sturm Gra,1328,3,16,11,9,53,33,20,59
Vienna,1328,4,16,4,16,58,55,3,52
Rapid Vienna,1328,5,13,12,11,53,39,14,51
Mattersburg,1328,6,11,7,18,41,55,-14,40
RZ Pellets W,1328,7,11,7,18,43,60,-17,40
SV Josko Rie,1328,8,12,4,20,32,49,-17,40
St. Pölten,1328,9,10,9,17,42,59,-17,39
Admira Wacke,1328,10,9,11,16,30,50,-20,38
FC Salzburg,1329,1,21,7,8,69,31,38,70
SC Rheindorf,1329,2,20,8,8,66,47,19,68
SK Sturm Gra,1329,3,20,5,11,63,34,29,65
Rapid Vienna,1329,4,18,8,10,62,41,21,62
Vienna,1329,5,20,2,14,65,55,10,62
RZ Pellets W,1329,6,13,7,16,44,52,-8,46
SV Josko Rie,1329,7,12,5,19,34,56,-22,41
Admira Wacke,1329,8,10,5,21,34,65,-31,35
Mattersburg,1329,9,6,11,19,33,59,-26,29
St. Pölten,1329,10,7,8,21,34,64,-30,29
FC Salzburg,1330,1,20,8,8,63,29,34,68
SK Sturm Gra,1330,2,21,5,10,66,38,28,68
SC Rheindorf,1330,3,20,7,9,48,37,11,67
Vienna,1330,4,16,6,14,56,51,5,54
Rapid Vienna,1330,5,14,8,14,54,43,11,50
RZ Pellets W,1330,6,12,9,15,41,53,-12,45
Admira Wacke,1330,7,12,7,17,40,55,-15,43
SV Josko Rie,1330,8,11,6,19,28,47,-19,39
Mattersburg,1330,9,9,9,18,35,54,-19,36
St. Pölten,1330,10,8,9,19,43,67,-24,33
SC Rheindorf,1331,1,22,7,7,66,36,30,73
FC Salzburg,1331,2,17,10,9,50,26,24,61
Rapid Vienna,1331,3,16,10,10,55,40,15,58
SK Sturm Gra,1331,4,16,9,11,49,35,14,57
Vienna,1331,5,16,5,15,53,53,0,53
RZ Pellets W,1331,6,13,7,16,46,55,-9,46
Admira Wacke,1331,7,12,8,16,37,53,-16,44
SV Josko Rie,1331,8,13,3,20,46,58,-12,42
St. Pölten,1331,9,10,9,17,40,64,-24,39
Mattersburg,1331,10,5,12,19,30,52,-22,27
FC Salzburg,1332,1,23,7,6,69,31,38,76
SK Sturm Gra,1332,2,19,7,10,68,39,29,64
Rapid Vienna,1332,3,17,10,9,57,34,23,61
SC Rheindorf,1332,4,17,9,10,56,48,8,60
Vienna,1332,5,18,4,14,61,58,3,58
RZ Pellets W,1332,6,12,8,16,45,55,-10,44
St. Pölten,1332,7,10,7,19,40,58,-18,37
Mattersburg,1332,8,9,8,19,34,53,-19,35
Admira Wacke,1332,9,9,7,20,30,63,-33,34
SV Josko Rie,1332,10,8,9,19,31,52,-21,33
FC Salzburg,1333,1,21,7,8,72,35,37,70
SK Sturm Gra,1333,2,21,4,11,64,40,24,67
SC Rheindorf,1333,3,19,7,10,52,38,14,64
Rapid Vienna,1333,4,18,8,10,55,32,23,62
Vienna,1333,5,17,4,15,56,53,3,55
RZ Pellets W,1333,6,12,6,18,49,54,-5,42
SV Josko Rie,1333,7,11,7,18,38,56,-18,40
Mattersburg,1333,8,11,6,19,35,55,-20,39
St. Pölten,1333,9,8,10,18,41,66,-25,34
Admira Wacke,1333,10,9,7,20,35,68,-33,34
SK Sturm Gra,1334,1,20,6,10,64,34,30,66
SC Rheindorf,1334,2,19,7,10,61,49,12,64
Vienna,1334,3,19,6,11,69,57,12,63
FC Salzburg,1334,4,17,7,12,63,41,22,58
RZ Pellets W,1334,5,15,9,12,53,49,4,54
Rapid Vienna,1334,6,12,11,13,52,43,9,47
SV Josko Rie,1334,7,12,9,15,40,51,-11,45
Admira Wacke,1334,8,12,5,19,40,70,-30,41
Mattersburg,1334,9,7,11,18,35,56,-21,32
St. Pölten,1334,10,7,9,20,36,63,-27,30
FC Salzburg,1335,1,22,8,6,77,30,47,74
SK Sturm Gra,1335,2,22,5,9,60,30,30,71
SC Rheindorf,1335,3,22,5,9,60,37,23,71
Vienna,1335,4,16,4,16,58,64,-6,52
Rapid Vienna,1335,5,14,9,13,57,45,12,51
RZ Pellets W,1335,6,11,9,16,40,55,-15,42
SV Josko Rie,1335,7,10,8,18,36,50,-14,38
Mattersburg,1335,8,10,8,18,40,64,-24,38
Admira Wacke,1335,9,10,6,20,38,65,-27,36
St. Pölten,1335,10,7,10,19,38,64,-26,31
FC Salzburg,1336,1,21,7,8,64,26,38,70
SK Sturm Gra,1336,2,20,7,9,60,34,26,67
Vienna,1336,3,19,2,15,59,56,3,59
Rapid Vienna,1336,4,15,12,9,55,37,18,57
SC Rheindorf,1336,5,16,9,11,48,38,10,57
SV Josko Rie,1336,6,14,3,19,36,49,-13,45
RZ Pellets W,1336,7,12,8,16,54,60,-6,44
Admira Wacke,1336,8,10,7,19,33,61,-28,37
Mattersburg,1336,9,9,8,19,36,57,-21,35
St. Pölten,1336,10,9,7,20,39,66,-27,34
FC Salzburg,1337,1,22,5,9,66,32,34,71
SC Rheindorf,1337,2,18,7,11,51,43,8,61
Vienna,1337,3,17,5,14,59,54,5,56
SK Sturm Gra,1337,4,15,9,12,52,38,14,54
Rapid Vienna,1337,5,14,11,11,60,43,17,53
RZ Pellets W,1337,6,13,10,13,46,53,-7,49
Mattersburg,1337,7,14,6,16,49,56,-7,48
Admira Wacke,1337,8,12,7,17,38,59,-21,43
St. Pölten,1337,9,9,9,18,44,62,-18,36
SV Josko Rie,1337,10,9,5,22,30,55,-25,32
SC Rheindorf,1338,1,21,6,9,54,36,18,69
Vienna,1338,2,20,6,10,69,44,25,66
FC Salzburg,1338,3,19,8,9,57,29,28,65
Rapid Vienna,1338,4,19,7,10,61,40,21,64
SK Sturm Gra,1338,5,19,6,11,55,34,21,63
Admira Wacke,1338,6,13,5,18,37,57,-20,44
Mattersburg,1338,7,10,9,17,38,56,-18,39
SV Josko Rie,1338,8,9,7,20,36,57,-21,34
RZ Pellets W,1338,9,7,9,20,38,63,-25,30
St. Pölten,1338,10,6,11,19,38,67,-29,29
SK Sturm Gra,1339,1,24,5,7,71,33,38,77
FC Salzburg,1339,2,19,10,7,60,31,29,67
Vienna,1339,3,20,6,10,74,53,21,66
SC Rheindorf,1339,4,15,11,10,48,49,-1,56
Rapid Vienna,1339,5,14,11,11,52,35,17,53
RZ Pellets W,1339,6,12,8,16,51,60,-9,44
SV Josko Rie,1339,7,10,7,19,34,53,-19,37
St. Pölten,1339,8,8,10,18,39,58,-19,34
Admira Wacke,1339,9,8,9,19,31,64,-33,33
Mattersburg,1339,10,6,11,19,28,52,-24,29
SC Rheindorf,1340,1,22,7,7,63,44,19,73
FC Salzburg,1340,2,21,8,7,70,34,36,71
SK Sturm Gra,1340,3,18,8,10,61,39,22,62
Vienna,1340,4,19,5,12,67,47,20,62
Rapid Vienna,1340,5,15,10,11,53,37,16,55
RZ Pellets W,1340,6,12,9,15,45,56,-11,45
Admira Wacke,1340,7,10,7,19,38,65,-27,37
SV Josko Rie,1340,8,10,6,20,32,54,-22,36
St. Pölten,1340,9,7,10,19,40,65,-25,31
Mattersburg,1340,10,6,10,20,39,67,-28,28
SK Sturm Gra,1341,1,24,4,8,67,32,35,76
SC Rheindorf,1341,2,22,7,7,59,40,19,73
FC Salzburg,1341,3,19,8,9,58,34,24,65
Rapid Vienna,1341,4,15,11,10,56,39,17,56
Vienna,1341,5,16,6,14,59,55,4,54
RZ Pellets W,1341,6,13,6,17,49,59,-10,45
SV Josko Rie,1341,7,10,5,21,40,55,-15,35
Mattersburg,1341,8,9,8,19,38,55,-17,35
St. Pölten,1341,9,9,8,19,41,68,-27,35
Admira Wacke,1341,10,8,7,21,37,67,-30,31
FC Salzburg,1342,1,25,7,4,67,23,44,82
SC Rheindorf,1342,2,21,5,10,56,46,10,68
SK Sturm Gra,1342,3,18,5,13,57,43,14,59
Vienna,1342,4,17,6,13,62,55,7,57
Rapid Vienna,1342,5,14,9,13,62,41,21,51
RZ Pellets W,1342,6,14,4,18,47,58,-11,46
Mattersburg,1342,7,11,7,18,39,54,-15,40
Admira Wacke,1342,8,10,9,17,37,55,-18,39
St. Pölten,1342,9,8,9,19,43,71,-28,33
SV Josko Rie,1342,10,9,5,22,29,53,-24,32
FC Salzburg,1343,1,19,9,8,62,31,31,66
SC Rheindorf,1343,2,19,7,10,58,40,18,64
SK Sturm Gra,1343,3,18,6,12,61,43,18,60
Vienna,1343,4,18,3,15,53,49,4,57
RZ Pellets W,1343,5,17,6,13,52,54,-2,57
Rapid Vienna,1343,6,13,13,10,53,38,15,52
SV Josko Rie,1343,7,11,8,17,41,52,-11,41
St. Pölten,1343,8,8,12,16,44,69,-25,36
Admira Wacke,1343,9,10,5,21,38,64,-26,35
Mattersburg,1343,10,8,9,19,42,64,-22,33
SC Rheindorf,1344,1,20,7,9,53,38,15,67
SK Sturm Gra,1344,2,20,6,10,54,28,26,66
FC Salzburg,1344,3,17,10,9,63,36,27,61
Rapid Vienna,1344,4,16,11,9,64,40,24,59
Vienna,1344,5,16,9,11,61,46,15,57
RZ Pellets W,1344,6,13,7,16,42,52,-10,46
SV Josko Rie,1344,7,10,8,18,31,50,-19,38
St. Pölten,1344,8,9,11,16,41,66,-25,38
Admira Wacke,1344,9,10,7,19,34,69,-35,37
Mattersburg,1344,10,7,8,21,35,53,-18,29
FC Salzburg,1345,1,19,11,6,61,25,36,68
SC Rheindorf,1345,2,18,8,10,56,44,12,62
Vienna,1345,3,18,6,12,63,46,17,60
Rapid Vienna,1345,4,16,9,11,55,39,16,57
SK Sturm Gra,1345,5,16,8,12,54,44,10,56
RZ Pellets W,1345,6,16,7,13,49,47,2,55
SV Josko Rie,1345,7,13,6,17,37,51,-14,45
Admira Wacke,1345,8,10,7,19,38,65,-27,37
Mattersburg,1345,9,9,7,20,41,61,-20,34
St. Pölten,1345,10,5,11,20,38,70,-32,26
FC Salzburg,1346,1,20,7,9,65,38,27,67
Vienna,1346,2,21,2,13,68,56,12,65
SC Rheindorf,1346,3,19,7,10,55,39,16,64
Rapid Vienna,1346,4,18,9,9,62,38,24,63
SK Sturm Gra,1346,5,18,8,10,57,35,22,62
RZ Pellets W,1346,6,14,8,14,49,50,-1,50
SV Josko Rie,1346,7,11,7,18,38,51,-13,40
Mattersburg,1346,8,9,8,19,42,62,-20,35
Admira Wacke,1346,9,10,3,23,32,60,-28,33
St. Pölten,1346,10,6,9,21,42,81,-39,27
SC Rheindorf,1347,1,20,11,5,61,40,21,71
SK Sturm Gra,1347,2,20,6,10,63,34,29,66
FC Salzburg,1347,3,18,9,9,58,31,27,63
Rapid Vienna,1347,4,17,9,10,61,40,21,60
Vienna,1347,5,15,8,13,54,53,1,53
RZ Pellets W,1347,6,13,5,18,48,59,-11,44
Admira Wacke,1347,7,12,6,18,42,58,-16,42
Mattersburg,1347,8,10,8,18,41,60,-19,38
St. Pölten,1347,9,8,9,19,38,66,-28,33
SV Josko Rie,1347,10,9,5,22,31,56,-25,32
FC Salzburg,1348,1,21,8,7,70,27,43,71
SK Sturm Gra,1348,2,19,5,12,62,40,22,62
SC Rheindorf,1348,3,18,8,10,53,42,11,62
Vienna,1348,4,19,4,13,60,48,12,61
St. Pölten,1348,5,12,10,14,47,59,-12,46
Rapid Vienna,1348,6,12,8,16,56,55,1,44
RZ Pellets W,1348,7,12,8,16,49,57,-8,44
Mattersburg,1348,8,10,10,16,38,50,-12,40
SV Josko Rie,1348,9,9,9,18,32,58,-26,36
Admira Wacke,1348,10,8,10,18,38,69,-31,34
SK Sturm Gra,1349,1,21,6,9,68,36,32,69
SC Rheindorf,1349,2,20,9,7,57,39,18,69
FC Salzburg,1349,3,18,9,9,57,32,25,63
Vienna,1349,4,18,8,10,65,50,15,62
Rapid Vienna,1349,5,14,12,10,57,44,13,54
RZ Pellets W,1349,6,13,6,17,46,58,-12,45
SV Josko Rie,1349,7,12,5,19,35,56,-21,41
Admira Wacke,1349,8,10,4,22,35,59,-24,34
Mattersburg,1349,9,7,12,17,32,53,-21,33
St. Pölten,1349,10,6,11,19,38,63,-25,29
FC Salzburg,1350,1,22,6,8,63,32,31,72
SK Sturm Gra,1350,2,22,5,9,71,38,33,71
SC Rheindorf,1350,3,18,9,9,55,41,14,63
Rapid Vienna,1350,4,17,10,9,62,37,25,61
Vienna,1350,5,18,6,12,61,47,14,60
RZ Pellets W,1350,6,11,8,17,46,60,-14,41
St. Pölten,1350,7,9,10,17,42,64,-22,37
Mattersburg,1350,8,9,9,18,36,54,-18,36
Admira Wacke,1350,9,8,7,21,30,67,-37,31
SV Josko Rie,1350,10,8,6,22,31,57,-26,30
SK Sturm Gra,1351,1,21,6,9,65,31,34,69
FC Salzburg,1351,2,20,7,9,62,33,29,67
Vienna,1351,3,18,8,10,62,47,15,62
SC Rheindorf,1351,4,15,10,11,44,44,0,55
Rapid Vienna,1351,5,13,13,10,64,39,25,52
Admira Wacke,1351,6,14,5,17,36,56,-20,47
SV Josko Rie,1351,7,12,6,18,33,49,-16,42
Mattersburg,1351,8,10,10,16,38,57,-19,40
RZ Pellets W,1351,9,9,9,18,42,64,-22,36
St. Pölten,1351,10,5,12,19,34,60,-26,27
SK Sturm Gra,1352,1,21,7,8,66,31,35,70
SC Rheindorf,1352,2,20,8,8,56,39,17,68
FC Salzburg,1352,3,18,11,7,59,33,26,65
Vienna,1352,4,16,7,13,68,56,12,55
Admira Wacke,1352,5,13,10,13,39,50,-11,49
Rapid Vienna,1352,6,12,12,12,59,51,8,48
SV Josko Rie,1352,7,13,7,16,44,53,-9,46
RZ Pellets W,1352,8,12,8,16,46,57,-11,44
Mattersburg,1352,9,7,6,23,35,66,-31,27
St. Pölten,1352,10,6,8,22,33,69,-36,26
FC Salzburg,1353,1,22,7,7,66,31,35,73
SC Rheindorf,1353,2,20,8,8,60,42,18,68
SK Sturm Gra,1353,3,20,7,9,58,33,25,67
Vienna,1353,4,17,6,13,66,60,6,57
Rapid Vienna,1353,5,16,8,12,56,37,19,56
RZ Pellets W,1353,6,12,7,17,41,58,-17,43
SV Josko Rie,1353,7,12,5,19,44,58,-14,41
Mattersburg,1353,8,8,10,18,32,54,-22,34
Admira Wacke,1353,9,9,7,20,39,71,-32,34
St. Pölten,1353,10,8,7,21,40,58,-18,31
Vienna,1354,1,21,4,11,65,48,17,67
SK Sturm Gra,1354,2,20,6,10,65,34,31,66
FC Salzburg,1354,3,19,8,9,60,31,29,65
SC Rheindorf,1354,4,19,7,10,54,42,12,64
Rapid Vienna,1354,5,12,13,11,52,38,14,49
RZ Pellets W,1354,6,14,7,15,47,58,-11,49
Admira Wacke,1354,7,13,4,19,38,62,-24,43
SV Josko Rie,1354,8,11,4,21,34,59,-25,37
St. Pölten,1354,9,8,10,18,37,60,-23,34
Mattersburg,1354,10,7,9,20,40,60,-20,30
FC Salzburg,1355,1,19,9,8,61,30,31,66
SK Sturm Gra,1355,2,20,6,10,55,29,26,66
SC Rheindorf,1355,3,18,8,10,49,42,7,62
Rapid Vienna,1355,4,16,10,10,54,33,21,58
Vienna,1355,5,17,7,12,61,51,10,58
Admira Wacke,1355,6,12,7,17,29,54,-25,43
RZ Pellets W,1355,7,10,10,16,36,52,-16,40
Mattersburg,1355,8,8,12,16,33,48,-15,36
SV Josko Rie,1355,9,8,11,17,30,47,-17,35
St. Pölten,1355,10,8,8,20,34,56,-22,32
FC Salzburg,1356,1,18,11,7,66,33,33,65
SC Rheindorf,1356,2,19,8,9,49,40,9,65
SK Sturm Gra,1356,3,19,7,10,61,38,23,64
Vienna,1356,4,19,5,12,63,47,16,62
Rapid Vienna,1356,5,16,11,9,57,34,23,59
RZ Pellets W,1356,6,12,8,16,42,56,-14,44
Admira Wacke,1356,7,10,9,17,36,54,-18,39
St. Pölten,1356,8,10,9,17,39,58,-19,39
SV Josko Rie,1356,9,8,8,20,26,49,-23,32
Mattersburg,1356,10,7,8,21,27,57,-30,29
FC Salzburg,1357,1,21,7,8,72,33,39,70
SK Sturm Gra,1357,2,20,7,9,61,34,27,67
SC Rheindorf,1357,3,19,9,8,59,43,16,66
Vienna,1357,4,17,5,14,57,57,0,56
Rapid Vienna,1357,5,15,8,13,53,43,10,53
RZ Pellets W,1357,6,13,8,15,55,53,2,47
St. Pölten,1357,7,11,10,15,42,55,-13,43
Admira Wacke,1357,8,12,5,19,40,62,-22,41
SV Josko Rie,1357,9,11,4,21,32,61,-29,37
Mattersburg,1357,10,5,9,22,34,64,-30,24
FC Salzburg,1358,1,21,8,7,63,32,31,71
Vienna,1358,2,22,5,9,76,53,23,71
SK Sturm Gra,1358,3,17,9,10,65,42,23,60
SC Rheindorf,1358,4,16,7,13,50,44,6,55
Rapid Vienna,1358,5,14,12,10,56,41,15,54
Admira Wacke,1358,6,12,7,17,35,56,-21,43
RZ Pellets W,1358,7,10,9,17,45,59,-14,39
St. Pölten,1358,8,10,9,17,40,58,-18,39
SV Josko Rie,1358,9,10,6,20,37,57,-20,36
Mattersburg,1358,10,7,10,19,35,60,-25,31
FC Salzburg,1359,1,23,7,6,74,31,43,76
SK Sturm Gra,1359,2,20,6,10,60,37,23,66
SC Rheindorf,1359,3,18,10,8,55,43,12,64
Vienna,1359,4,16,4,16,56,57,-1,52
Admira Wacke,1359,5,15,5,16,39,50,-11,50
SV Josko Rie,1359,6,14,6,16,38,47,-9,48
RZ Pellets W,1359,7,13,8,15,47,54,-7,47
Rapid Vienna,1359,8,10,9,17,46,46,0,39
St. Pölten,1359,9,8,8,20,43,63,-20,32
Mattersburg,1359,10,9,5,22,33,63,-30,32
FC Salzburg,1360,1,24,6,6,76,25,51,78
SC Rheindorf,1360,2,23,7,6,67,44,23,76
SK Sturm Gra,1360,3,18,8,10,63,39,24,62
Vienna,1360,4,17,5,14,61,60,1,56
Admira Wacke,1360,5,13,10,13,44,52,-8,49
RZ Pellets W,1360,6,12,7,17,42,55,-13,43
Rapid Vienna,1360,7,10,12,14,51,44,7,42
Mattersburg,1360,8,8,10,18,32,59,-27,34
SV Josko Rie,1360,9,9,5,22,33,61,-28,32
St. Pölten,1360,10,6,10,20,42,72,-30,28
SC Rheindorf,1361,1,23,8,5,64,34,30,77
FC Salzburg,1361,2,20,9,7,58,28,30,69
Vienna,1361,3,17,8,11,66,56,10,59
SK Sturm Gra,1361,4,16,9,11,53,39,14,57
Rapid Vienna,1361,5,14,11,11,55,38,17,53
RZ Pellets W,1361,6,13,9,14,45,48,-3,48
St. Pölten,1361,7,9,10,17,42,61,-19,37
Admira Wacke,1361,8,10,7,19,38,59,-21,37
SV Josko Rie,1361,9,9,4,23,29,61,-32,31
Mattersburg,1361,10,7,9,20,34,60,-26,30
FC Salzburg,1362,1,23,7,6,63,25,38,76
SC Rheindorf,1362,2,21,7,8,63,37,26,70
SK Sturm Gra,1362,3,19,8,9,61,35,26,65
Vienna,1362,4,17,3,16,59,60,-1,54
Rapid Vienna,1362,5,15,8,13,53,43,10,53
Admira Wacke,1362,6,14,6,16,38,53,-15,48
RZ Pellets W,1362,7,12,9,15,41,53,-12,45
SV Josko Rie,1362,8,10,6,20,33,50,-17,36
St. Pölten,1362,9,8,7,21,44,69,-25,31
Mattersburg,1362,10,6,9,21,29,59,-30,27
FC Salzburg,1363,1,25,4,7,68,27,41,79
SC Rheindorf,1363,2,20,6,10,58,48,10,66
Rapid Vienna,1363,3,17,8,11,58,46,12,59
Vienna,1363,4,18,5,13,62,51,11,59
SK Sturm Gra,1363,5,17,5,14,51,39,12,56
Admira Wacke,1363,6,14,5,17,37,50,-13,47
SV Josko Rie,1363,7,12,6,18,43,56,-13,42
Mattersburg,1363,8,10,7,19,37,56,-19,37
St. Pölten,1363,9,9,7,20,44,66,-22,34
RZ Pellets W,1363,10,9,5,22,37,56,-19,32
FC Salzburg,1364,1,21,5,10,59,30,29,68
SC Rheindorf,1364,2,19,7,10,52,43,9,64
SK Sturm Gra,1364,3,19,6,11,54,32,22,63
Vienna,1364,4,18,6,12,68,56,12,60
RZ Pellets W,1364,5,12,10,14,46,56,-10,46
Rapid Vienna,1364,6,12,9,15,59,48,11,45
Admira Wacke,1364,7,12,6,18,41,62,-21,42
St. Pölten,1364,8,11,8,17,41,57,-16,41
SV Josko Rie,1364,9,12,5,19,34,54,-20,41
Mattersburg,1364,10,10,6,20,40,56,-16,36
FC Salzburg,1365,1,24,6,6,73,33,40,78
SK Sturm Gra,1365,2,20,9,7,63,29,34,69
SC Rheindorf,1365,3,21,5,10,58,40,18,68
Vienna,1365,4,17,5,14,60,53,7,56
Rapid Vienna,1365,5,13,10,13,49,46,3,49
RZ Pellets W,1365,6,14,7,15,52,55,-3,49
Admira Wacke,1365,7,10,8,18,32,56,-24,38
St. Pölten,1365,8,9,8,19,41,64,-23,35
Mattersburg,1365,9,8,8,20,40,64,-24,32
SV Josko Rie,1365,10,8,6,22,28,56,-28,30
FC Salzburg,1366,1,22,8,6,65,29,36,74
SC Rheindorf,1366,2,20,7,9,62,41,21,67
SK Sturm Gra,1366,3,18,7,11,55,32,23,61
Vienna,1366,4,16,7,13,57,60,-3,55
Rapid Vienna,1366,5,14,9,13,59,40,19,51
RZ Pellets W,1366,6,12,8,16,45,61,-16,44
Admira Wacke,1366,7,12,7,17,43,63,-20,43
St. Pölten,1366,8,9,10,17,41,60,-19,37
Mattersburg,1366,9,9,9,18,38,52,-14,36
SV Josko Rie,1366,10,9,6,21,34,61,-27,33
SC Rheindorf,1367,1,22,8,6,64,46,18,74
Vienna,1367,2,19,7,10,68,53,15,64
FC Salzburg,1367,3,18,8,10,72,45,27,62
SK Sturm Gra,1367,4,18,7,11,54,34,20,61
RZ Pellets W,1367,5,14,6,16,44,47,-3,48
Rapid Vienna,1367,6,12,9,15,57,58,-1,45
SV Josko Rie,1367,7,12,6,18,43,53,-10,42
Admira Wacke,1367,8,11,8,17,39,55,-16,41
St. Pölten,1367,9,9,8,19,46,73,-27,35
Mattersburg,1367,10,5,13,18,33,56,-23,28
FC Salzburg,1368,1,23,5,8,67,31,36,74
SC Rheindorf,1368,2,21,7,8,60,40,20,70
Vienna,1368,3,22,3,11,64,44,20,69
SK Sturm Gra,1368,4,18,5,13,53,40,13,59
Rapid Vienna,1368,5,14,8,14,55,43,12,50
RZ Pellets W,1368,6,13,8,15,52,60,-8,47
SV Josko Rie,1368,7,12,5,19,38,55,-17,41
Admira Wacke,1368,8,11,5,20,38,60,-22,38
St. Pölten,1368,9,10,6,20,42,67,-25,36
Mattersburg,1368,10,7,6,23,35,64,-29,27
FC Salzburg,1369,1,22,6,8,72,29,43,72
SC Rheindorf,1369,2,19,9,8,52,37,15,66
Vienna,1369,3,19,4,13,55,53,2,61
SK Sturm Gra,1369,4,16,8,12,64,40,24,56
Rapid Vienna,1369,5,14,9,13,52,40,12,51
RZ Pellets W,1369,6,12,7,17,46,61,-15,43
SV Josko Rie,1369,7,12,6,18,36,46,-10,42
Admira Wacke,1369,8,11,8,17,33,60,-27,41
St. Pölten,1369,9,9,9,18,37,61,-24,36
Mattersburg,1369,10,9,8,19,44,64,-20,35
SC Rheindorf,1370,1,21,6,9,59,36,23,69
SK Sturm Gra,1370,2,21,5,10,63,35,28,68
FC Salzburg,1370,3,19,9,8,61,35,26,66
Vienna,1370,4,17,7,12,59,51,8,58
Rapid Vienna,1370,5,16,9,11,59,41,18,57
Admira Wacke,1370,6,14,4,18,47,60,-13,46
RZ Pellets W,1370,7,13,6,17,43,58,-15,45
SV Josko Rie,1370,8,14,2,20,38,55,-17,44
St. Pölten,1370,9,7,8,21,39,63,-24,29
Mattersburg,1370,10,6,8,22,33,67,-34,26
SK Sturm Gra,1371,1,21,5,10,67,34,33,68
Vienna,1371,2,20,5,11,67,47,20,65
FC Salzburg,1371,3,18,9,9,65,34,31,63
SC Rheindorf,1371,4,19,6,11,56,50,6,63
Rapid Vienna,1371,5,15,10,11,55,40,15,55
RZ Pellets W,1371,6,14,6,16,44,51,-7,48
SV Josko Rie,1371,7,14,5,17,37,48,-11,47
Admira Wacke,1371,8,10,7,19,33,62,-29,37
St. Pölten,1371,9,7,11,18,33,59,-26,32
Mattersburg,1371,10,6,8,22,30,62,-32,26
SC Rheindorf,1372,1,20,9,7,57,38,19,69
SK Sturm Gra,1372,2,20,6,10,52,30,22,66
Vienna,1372,3,20,5,11,67,54,13,65
FC Salzburg,1372,4,18,10,8,59,35,24,64
Rapid Vienna,1372,5,14,10,12,60,42,18,52
Admira Wacke,1372,6,13,8,15,41,54,-13,47
RZ Pellets W,1372,7,11,10,15,43,51,-8,43
Mattersburg,1372,8,8,11,17,33,52,-19,35
SV Josko Rie,1372,9,7,8,21,37,63,-26,29
St. Pölten,1372,10,4,13,19,33,63,-30,25
FC Salzburg,1373,1,23,7,6,76,32,44,76
SC Rheindorf,1373,2,19,9,8,59,40,19,66
SK Sturm Gra,1373,3,17,11,8,57,30,27,62
Vienna,1373,4,16,7,13,53,58,-5,55
Rapid Vienna,1373,5,14,12,10,52,41,11,54
RZ Pellets W,1373,6,11,11,14,45,51,-6,44
Admira Wacke,1373,7,11,10,15,42,55,-13,43
SV Josko Rie,1373,8,11,8,17,43,54,-11,41
St. Pölten,1373,9,7,8,21,37,73,-36,29
Mattersburg,1373,10,5,9,22,31,61,-30,24
FC Salzburg,1374,1,22,7,7,61,24,37,73
SK Sturm Gra,1374,2,19,9,8,53,26,27,66
Vienna,1374,3,20,3,13,61,51,10,63
SC Rheindorf,1374,4,17,8,11,56,49,7,59
Rapid Vienna,1374,5,13,11,12,51,42,9,50
SV Josko Rie,1374,6,13,3,20,41,54,-13,42
Mattersburg,1374,7,11,7,18,40,58,-18,40
RZ Pellets W,1374,8,10,8,18,38,54,-16,38
Admira Wacke,1374,9,10,7,19,33,53,-20,37
St. Pölten,1374,10,9,9,18,42,65,-23,36
SC Rheindorf,1375,1,21,8,7,62,48,14,71
FC Salzburg,1375,2,20,10,6,67,32,35,70
SK Sturm Gra,1375,3,18,9,9,57,28,29,63
Vienna,1375,4,18,7,11,73,57,16,61
Rapid Vienna,1375,5,13,11,12,54,42,12,50
RZ Pellets W,1375,6,12,8,16,42,50,-8,44
SV Josko Rie,1375,7,11,6,19,31,51,-20,39
Mattersburg,1375,8,9,8,19,33,55,-22,35
St. Pölten,1375,9,8,10,18,43,65,-22,34
Admira Wacke,1375,10,8,7,21,34,68,-34,31
SC Rheindorf,1376,1,20,10,6,58,38,20,70
Vienna,1376,2,20,8,8,73,48,25,68
FC Salzburg,1376,3,20,6,10,67,33,34,66
SK Sturm Gra,1376,4,18,9,9,56,31,25,63
RZ Pellets W,1376,5,15,8,13,51,56,-5,53
Rapid Vienna,1376,6,13,8,15,56,49,7,47
Mattersburg,1376,7,9,9,18,44,55,-11,36
SV Josko Rie,1376,8,9,6,21,30,57,-27,33
St. Pölten,1376,9,8,9,19,37,67,-30,33
Admira Wacke,1376,10,8,7,21,35,73,-38,31
FC Salzburg,1377,1,23,6,7,65,25,40,75
SK Sturm Gra,1377,2,21,5,10,63,37,26,68
Vienna,1377,3,19,3,14,67,52,15,60
SC Rheindorf,1377,4,16,10,10,52,48,4,58
RZ Pellets W,1377,5,16,7,13,52,51,1,55
Rapid Vienna,1377,6,15,9,12,55,40,15,54
SV Josko Rie,1377,7,13,4,19,34,50,-16,43
Admira Wacke,1377,8,10,5,21,36,64,-28,35
St. Pölten,1377,9,8,7,21,43,73,-30,31
Mattersburg,1377,10,7,8,21,35,62,-27,29
SC Rheindorf,1378,1,22,8,6,58,34,24,74
FC Salzburg,1378,2,21,8,7,63,30,33,71
Vienna,1378,3,18,4,14,54,53,1,58
SK Sturm Gra,1378,4,15,6,15,55,41,14,51
RZ Pellets W,1378,5,14,8,14,45,48,-3,50
Rapid Vienna,1378,6,12,12,12,50,38,12,48
SV Josko Rie,1378,7,13,8,15,38,46,-8,47
Admira Wacke,1378,8,11,8,17,34,51,-17,41
Mattersburg,1378,9,7,10,19,35,59,-24,31
St. Pölten,1378,10,6,10,20,39,71,-32,28
FC Salzburg,1379,1,19,7,10,60,32,28,64
Vienna,1379,2,19,4,13,59,46,13,61
SC Rheindorf,1379,3,15,11,10,46,40,6,56
SK Sturm Gra,1379,4,15,8,13,45,36,9,53
Rapid Vienna,1379,5,14,10,12,57,42,15,52
St. Pölten,1379,6,13,8,15,47,57,-10,47
Admira Wacke,1379,7,13,6,17,44,56,-12,45
RZ Pellets W,1379,8,13,6,17,44,57,-13,45
Mattersburg,1379,9,10,11,15,43,54,-11,41
SV Josko Rie,1379,10,11,5,20,31,56,-25,38
SK Sturm Gra,1380,1,23,6,7,69,27,42,75
FC Salzburg,1380,2,21,6,9,66,35,31,69
Vienna,1380,3,22,3,11,66,55,11,69
SC Rheindorf,1380,4,15,11,10,55,46,9,56
St. Pölten,1380,5,12,9,15,43,57,-14,45
RZ Pellets W,1380,6,11,9,16,45,51,-6,42
Admira Wacke,1380,7,12,6,18,38,54,-16,42
Rapid Vienna,1380,8,11,8,17,51,54,-3,41
Mattersburg,1380,9,8,9,19,39,66,-27,33
SV Josko Rie,1380,10,10,3,23,30,57,-27,33
SC Rheindorf,1381,1,21,9,6,57,36,21,72
FC Salzburg,1381,2,20,9,7,70,34,36,69
Vienna,1381,3,19,7,10,61,49,12,64
SK Sturm Gra,1381,4,17,7,12,55,37,18,58
Rapid Vienna,1381,5,13,13,10,57,42,15,52
Mattersburg,1381,6,10,9,17,43,55,-12,39
SV Josko Rie,1381,7,11,6,19,42,59,-17,39
RZ Pellets W,1381,8,11,6,19,41,59,-18,39
St. Pölten,1381,9,9,9,18,40,61,-21,36
Admira Wacke,1381,10,9,5,22,34,68,-34,32
FC Salzburg,1382,1,19,11,6,66,29,37,68
SC Rheindorf,1382,2,19,6,11,49,37,12,63
SK Sturm Gra,1382,3,18,8,10,57,33,24,62
Vienna,1382,4,19,4,13,60,51,9,61
Rapid Vienna,1382,5,15,14,7,55,37,18,59
RZ Pellets W,1382,6,13,7,16,51,60,-9,46
St. Pölten,1382,7,10,8,18,41,65,-24,38
SV Josko Rie,1382,8,11,4,21,38,51,-13,37
Mattersburg,1382,9,9,9,18,41,54,-13,36
Admira Wacke,1382,10,9,5,22,29,70,-41,32
SK Sturm Gra,1383,1,20,8,8,59,34,25,68
FC Salzburg,1383,2,19,9,8,66,35,31,66
Vienna,1383,3,17,11,8,67,48,19,62
SC Rheindorf,1383,4,17,9,10,56,48,8,60
Rapid Vienna,1383,5,12,13,11,54,46,8,49
RZ Pellets W,1383,6,12,9,15,47,52,-5,45
Admira Wacke,1383,7,11,8,17,33,55,-22,41
Mattersburg,1383,8,9,9,18,36,53,-17,36
St. Pölten,1383,9,9,9,18,41,66,-25,36
SV Josko Rie,1383,10,8,7,21,34,56,-22,31
FC Salzburg,1384,1,22,7,7,69,35,34,73
SK Sturm Gra,1384,2,18,9,9,61,30,31,63
Rapid Vienna,1384,3,16,11,9,61,43,18,59
SC Rheindorf,1384,4,17,8,11,53,52,1,59
Vienna,1384,5,14,5,17,55,64,-9,47
Admira Wacke,1384,6,13,6,17,43,58,-15,45
RZ Pellets W,1384,7,11,11,14,58,59,-1,44
St. Pölten,1384,8,10,9,17,42,61,-19,39
Mattersburg,1384,9,9,10,17,43,58,-15,37
SV Josko Rie,1384,10,10,4,22,32,57,-25,34
FC Salzburg,1385,1,24,5,7,66,26,40,77
SK Sturm Gra,1385,2,20,6,10,60,33,27,66
SC Rheindorf,1385,3,20,5,11,53,46,7,65
Vienna,1385,4,16,8,12,61,52,9,56
SV Josko Rie,1385,5,15,4,17,42,49,-7,49
Rapid Vienna,1385,6,13,8,15,49,41,8,47
RZ Pellets W,1385,7,11,8,17,44,59,-15,41
St. Pölten,1385,8,10,9,17,44,63,-19,39
Admira Wacke,1385,9,10,5,21,33,64,-31,35
Mattersburg,1385,10,8,8,20,38,57,-19,32
SC Rheindorf,1386,1,24,6,6,54,30,24,78
FC Salzburg,1386,2,20,9,7,62,32,30,69
SK Sturm Gra,1386,3,19,7,10,59,35,24,64
Vienna,1386,4,16,4,16,50,49,1,52
Rapid Vienna,1386,5,13,9,14,56,40,16,48
Admira Wacke,1386,6,13,9,14,42,54,-12,48
RZ Pellets W,1386,7,10,11,15,42,59,-17,41
Mattersburg,1386,8,8,10,18,40,55,-15,34
SV Josko Rie,1386,9,9,6,21,33,57,-24,33
St. Pölten,1386,10,6,13,17,41,68,-27,31
FC Salzburg,1387,1,22,7,7,70,30,40,73
SC Rheindorf,1387,2,21,7,8,58,36,22,70
SK Sturm Gra,1387,3,18,7,11,65,39,26,61
Vienna,1387,4,16,8,12,63,64,-1,56
RZ Pellets W,1387,5,13,7,16,41,52,-11,46
SV Josko Rie,1387,6,12,6,18,40,57,-17,42
Admira Wacke,1387,7,11,8,17,36,52,-16,41
Rapid Vienna,1387,8,10,10,16,48,50,-2,40
Mattersburg,1387,9,10,8,18,42,60,-18,38
St. Pölten,1387,10,9,8,19,40,63,-23,35
FC Salzburg,1388,1,20,7,9,65,33,32,67
SK Sturm Gra,1388,2,20,7,9,66,35,31,67
Vienna,1388,3,20,5,11,71,54,17,65
SC Rheindorf,1388,4,19,7,10,57,43,14,64
Rapid Vienna,1388,5,18,8,10,59,38,21,62
SV Josko Rie,1388,6,13,5,18,36,50,-14,44
St. Pölten,1388,7,9,11,16,41,59,-18,38
RZ Pellets W,1388,8,10,7,19,44,64,-20,37
Admira Wacke,1388,9,8,7,21,31,61,-30,31
Mattersburg,1388,10,6,10,20,38,71,-33,28
FC Salzburg,1389,1,22,7,7,68,25,43,73
SC Rheindorf,1389,2,20,7,9,57,45,12,67
SK Sturm Gra,1389,3,20,6,10,54,33,21,66
Vienna,1389,4,16,7,13,58,52,6,55
Rapid Vienna,1389,5,14,9,13,51,43,8,51
RZ Pellets W,1389,6,13,9,14,50,54,-4,48
St. Pölten,1389,7,10,10,16,45,58,-13,40
Admira Wacke,1389,8,9,9,18,43,62,-19,36
SV Josko Rie,1389,9,11,3,22,36,59,-23,36
Mattersburg,1389,10,8,7,21,36,67,-31,31
FC Salzburg,1390,1,20,7,9,65,32,33,67
Vienna,1390,2,20,5,11,65,49,16,65
SK Sturm Gra,1390,3,19,7,10,61,41,20,64
SC Rheindorf,1390,4,17,8,11,63,53,10,59
Rapid Vienna,1390,5,14,9,13,55,45,10,51
SV Josko Rie,1390,6,12,6,18,41,52,-11,42
Admira Wacke,1390,7,11,7,18,33,59,-26,40
St. Pölten,1390,8,10,9,17,45,62,-17,39
Mattersburg,1390,9,9,11,16,39,52,-13,38
RZ Pellets W,1390,10,10,7,19,39,61,-22,37
FC Salzburg,1391,1,19,11,6,62,32,30,68
SC Rheindorf,1391,2,19,11,6,57,35,22,68
SK Sturm Gra,1391,3,18,7,11,50,30,20,61
Rapid Vienna,1391,4,14,12,10,59,37,22,54
RZ Pellets W,1391,5,15,6,15,44,47,-3,51
Vienna,1391,6,14,6,16,54,58,-4,48
SV Josko Rie,1391,7,13,3,20,41,57,-16,42
Admira Wacke,1391,8,11,6,19,29,49,-20,39
St. Pölten,1391,9,10,7,19,35,59,-24,37
Mattersburg,1391,10,7,11,18,38,65,-27,32
FC Salzburg,1392,1,21,9,6,67,28,39,72
SK Sturm Gra,1392,2,21,8,7,63,27,36,71
SC Rheindorf,1392,3,20,9,7,52,37,15,69
Vienna,1392,4,16,5,15,58,57,1,53
Rapid Vienna,1392,5,14,10,12,56,39,17,52
RZ Pellets W,1392,6,13,6,17,45,59,-14,45
SV Josko Rie,1392,7,12,6,18,37,52,-15,42
Admira Wacke,1392,8,10,6,20,33,60,-27,36
St. Pölten,1392,9,8,10,18,40,64,-24,34
Mattersburg,1392,10,6,9,21,36,64,-28,27
SK Sturm Gra,1393,1,22,5,9,62,33,29,71
FC Salzburg,1393,2,20,10,6,60,26,34,70
SC Rheindorf,1393,3,19,7,10,55,47,8,64
Vienna,1393,4,19,6,11,60,46,14,63
Rapid Vienna,1393,5,14,11,11,52,34,18,53
RZ Pellets W,1393,6,12,9,15,47,56,-9,45
SV Josko Rie,1393,7,12,4,20,33,53,-20,40
Mattersburg,1393,8,10,8,18,33,53,-20,38
Admira Wacke,1393,9,11,5,20,35,56,-21,38
St. Pölten,1393,10,4,9,23,31,64,-33,21
FC Salzburg,1394,1,22,7,7,69,31,38,73
SK Sturm Gra,1394,2,20,7,9,69,34,35,67
SC Rheindorf,1394,3,17,7,12,49,42,7,58
Vienna,1394,4,17,6,13,57,49,8,57
Rapid Vienna,1394,5,14,10,12,55,42,13,52
Admira Wacke,1394,6,14,6,16,36,53,-17,48
SV Josko Rie,1394,7,10,9,17,36,50,-14,39
RZ Pellets W,1394,8,10,9,17,39,57,-18,39
Mattersburg,1394,9,10,9,17,36,55,-19,39
St. Pölten,1394,10,6,10,20,36,69,-33,28
FC Salzburg,1395,1,21,7,8,66,32,34,70
SC Rheindorf,1395,2,21,6,9,62,42,20,69
Vienna,1395,3,21,5,10,69,47,22,68
SK Sturm Gra,1395,4,18,6,12,52,35,17,60
Admira Wacke,1395,5,14,8,14,42,52,-10,50
Rapid Vienna,1395,6,13,9,14,54,43,11,48
RZ Pellets W,1395,7,12,8,16,43,54,-11,44
Mattersburg,1395,8,7,12,17,37,63,-26,33
SV Josko Rie,1395,9,9,5,22,33,59,-26,32
St. Pölten,1395,10,7,8,21,37,68,-31,29
SK Sturm Gra,1396,1,21,5,10,60,31,29,68
SC Rheindorf,1396,2,20,7,9,55,46,9,67
FC Salzburg,1396,3,20,6,10,66,30,36,66
Vienna,1396,4,17,6,13,53,48,5,57
Rapid Vienna,1396,5,14,12,10,60,40,20,54
RZ Pellets W,1396,6,13,5,18,44,54,-10,44
Admira Wacke,1396,7,12,6,18,39,68,-29,42
SV Josko Rie,1396,8,11,7,18,38,53,-15,40
St. Pölten,1396,9,8,10,18,39,64,-25,34
Mattersburg,1396,10,8,8,20,39,59,-20,32
SK Sturm Gra,1397,1,22,7,7,71,35,36,73
FC Salzburg,1397,2,19,10,7,63,32,31,67
SC Rheindorf,1397,3,18,9,9,52,40,12,63
Vienna,1397,4,15,6,15,58,57,1,51
RZ Pellets W,1397,5,14,8,14,48,53,-5,50
Rapid Vienna,1397,6,11,12,13,59,54,5,45
Admira Wacke,1397,7,12,9,15,37,53,-16,45
SV Josko Rie,1397,8,10,10,16,36,51,-15,40
Mattersburg,1397,9,8,10,18,39,56,-17,34
St. Pölten,1397,10,5,11,20,39,71,-32,26
SK Sturm Gra,1398,1,22,6,8,67,36,31,72
FC Salzburg,1398,2,19,11,6,61,28,33,68
SC Rheindorf,1398,3,20,8,8,63,43,20,68
Vienna,1398,4,17,7,12,69,55,14,58
Rapid Vienna,1398,5,13,13,10,57,43,14,52
RZ Pellets W,1398,6,13,8,15,44,53,-9,47
SV Josko Rie,1398,7,11,4,21,40,58,-18,37
Admira Wacke,1398,8,9,9,18,38,65,-27,36
St. Pölten,1398,9,7,10,19,38,70,-32,31
Mattersburg,1398,10,7,8,21,34,60,-26,29
FC Salzburg,1399,1,22,7,7,67,31,36,73
SC Rheindorf,1399,2,21,7,8,61,46,15,70
Vienna,1399,3,18,7,11,62,50,12,61
SK Sturm Gra,1399,4,17,9,10,57,33,24,60
Rapid Vienna,1399,5,12,13,11,59,45,14,49
Admira Wacke,1399,6,12,6,18,32,52,-20,42
RZ Pellets W,1399,7,10,9,17,39,55,-16,39
SV Josko Rie,1399,8,10,8,18,41,56,-15,38
St. Pölten,1399,9,9,10,17,41,64,-23,37
Mattersburg,1399,10,8,6,22,35,62,-27,30
FC Salzburg,1400,1,22,6,8,69,32,37,72
SK Sturm Gra,1400,2,21,6,9,61,32,29,69
SC Rheindorf,1400,3,20,6,10,63,46,17,66
Vienna,1400,4,18,3,15,63,65,-2,57
Rapid Vienna,1400,5,13,10,13,55,44,11,49
RZ Pellets W,1400,6,12,7,17,44,56,-12,43
Admira Wacke,1400,7,11,8,17,39,59,-20,41
Mattersburg,1400,8,10,7,19,42,54,-12,37
St. Pölten,1400,9,8,12,16,42,59,-17,36
SV Josko Rie,1400,10,10,5,21,28,59,-31,35
SC Rheindorf,1401,1,20,9,7,59,41,18,69
SK Sturm Gra,1401,2,19,7,10,59,32,27,64
FC Salzburg,1401,3,18,7,11,60,34,26,61
Rapid Vienna,1401,4,17,9,10,58,36,22,60
Vienna,1401,5,16,6,14,54,56,-2,54
RZ Pellets W,1401,6,12,11,13,44,49,-5,47
Admira Wacke,1401,7,12,10,14,39,56,-17,46
Mattersburg,1401,8,7,11,18,38,59,-21,32
St. Pölten,1401,9,7,11,18,36,62,-26,32
SV Josko Rie,1401,10,7,9,20,26,48,-22,30
FC Salzburg,1402,1,21,8,7,65,30,35,71
Vienna,1402,2,21,4,11,68,55,13,67
SC Rheindorf,1402,3,19,8,9,56,41,15,65
SK Sturm Gra,1402,4,18,7,11,63,38,25,61
Rapid Vienna,1402,5,13,12,11,55,42,13,51
Admira Wacke,1402,6,12,8,16,40,57,-17,44
St. Pölten,1402,7,12,7,17,45,66,-21,43
RZ Pellets W,1402,8,11,9,16,43,57,-14,42
SV Josko Rie,1402,9,8,5,23,35,58,-23,29
Mattersburg,1402,10,6,10,20,37,63,-26,28
SK Sturm Gra,1403,1,19,9,8,67,31,36,66
FC Salzburg,1403,2,19,7,10,59,32,27,64
Rapid Vienna,1403,3,17,10,9,57,33,24,61
SC Rheindorf,1403,4,18,7,11,54,52,2,61
Vienna,1403,5,18,6,12,60,52,8,60
Admira Wacke,1403,6,15,5,16,42,51,-9,50
SV Josko Rie,1403,7,10,7,19,38,55,-17,37
RZ Pellets W,1403,8,10,7,19,42,62,-20,37
Mattersburg,1403,9,8,10,18,32,52,-20,34
St. Pölten,1403,10,7,10,19,39,70,-31,31
FC Salzburg,1404,1,22,9,5,73,33,40,75
SK Sturm Gra,1404,2,18,7,11,57,34,23,61
Rapid Vienna,1404,3,16,12,8,59,33,26,60
SC Rheindorf,1404,4,17,8,11,56,48,8,59
Vienna,1404,5,18,5,13,62,57,5,59
RZ Pellets W,1404,6,14,4,18,45,57,-12,46
Mattersburg,1404,7,11,7,18,41,60,-19,40
SV Josko Rie,1404,8,10,8,18,40,52,-12,38
Admira Wacke,1404,9,10,6,20,40,68,-28,36
St. Pölten,1404,10,6,10,20,41,72,-31,28
FC Salzburg,1405,1,19,11,6,66,31,35,68
SC Rheindorf,1405,2,19,6,11,50,43,7,63
SK Sturm Gra,1405,3,17,9,10,53,35,18,60
Rapid Vienna,1405,4,16,10,10,59,37,22,58
Vienna,1405,5,18,3,15,64,48,16,57
RZ Pellets W,1405,6,11,10,15,49,62,-13,43
Admira Wacke,1405,7,11,8,17,41,67,-26,41
Mattersburg,1405,8,9,10,17,47,60,-13,37
SV Josko Rie,1405,9,10,6,20,37,62,-25,36
St. Pölten,1405,10,8,11,17,40,61,-21,35
SK Sturm Gra,1406,1,22,5,9,64,31,33,71
FC Salzburg,1406,2,21,7,8,68,34,34,70
SC Rheindorf,1406,3,20,8,8,62,42,20,68
Vienna,1406,4,18,4,14,59,58,1,58
Rapid Vienna,1406,5,15,9,12,53,39,14,54
RZ Pellets W,1406,6,12,9,15,50,59,-9,45
Admira Wacke,1406,7,11,5,20,36,62,-26,38
St. Pölten,1406,8,9,9,18,40,61,-21,36
Mattersburg,1406,9,8,10,18,40,65,-25,34
SV Josko Rie,1406,10,9,4,23,35,56,-21,31
SC Rheindorf,1407,1,23,8,5,63,35,28,77
FC Salzburg,1407,2,19,8,9,59,28,31,65
Vienna,1407,3,19,5,12,59,54,5,62
SK Sturm Gra,1407,4,15,10,11,53,39,14,55
Rapid Vienna,1407,5,14,11,11,55,41,14,53
Admira Wacke,1407,6,12,7,17,38,58,-20,43
RZ Pellets W,1407,7,11,9,16,43,50,-7,42
Mattersburg,1407,8,9,12,15,40,54,-14,39
SV Josko Rie,1407,9,11,3,22,30,53,-23,36
St. Pölten,1407,10,7,7,22,41,69,-28,28
SC Rheindorf,1408,1,20,7,9,59,38,21,67
FC Salzburg,1408,2,20,6,10,60,36,24,66
Vienna,1408,3,19,6,11,61,54,7,63
SK Sturm Gra,1408,4,19,5,12,58,36,22,62
Rapid Vienna,1408,5,17,10,9,58,31,27,61
RZ Pellets W,1408,6,14,8,14,54,60,-6,50
Admira Wacke,1408,7,13,4,19,48,72,-24,43
Mattersburg,1408,8,9,8,19,36,53,-17,35
SV Josko Rie,1408,9,10,3,23,39,58,-19,33
St. Pölten,1408,10,7,7,22,41,76,-35,28
FC Salzburg,1409,1,23,7,6,68,28,40,76
SK Sturm Gra,1409,2,21,5,10,68,37,31,68
SC Rheindorf,1409,3,18,10,8,58,43,15,64
Vienna,1409,4,18,7,11,63,54,9,61
Rapid Vienna,1409,5,14,12,10,58,41,17,54
SV Josko Rie,1409,6,12,6,18,37,52,-15,42
RZ Pellets W,1409,7,9,10,17,44,61,-17,37
Admira Wacke,1409,8,10,6,20,36,61,-25,36
St. Pölten,1409,9,7,11,18,39,63,-24,32
Mattersburg,1409,10,5,12,19,38,69,-31,27
FC Salzburg,1410,1,21,6,9,64,32,32,69
SK Sturm Gra,1410,2,19,7,10,54,31,23,64
SC Rheindorf,1410,3,18,7,11,49,41,8,61
Rapid Vienna,1410,4,16,11,9,62,41,21,59
Vienna,1410,5,17,6,13,56,46,10,57
RZ Pellets W,1410,6,14,7,15,44,47,-3,49
St. Pölten,1410,7,12,8,16,39,54,-15,44
SV Josko Rie,1410,8,11,5,20,34,53,-19,38
Admira Wacke,1410,9,10,4,22,27,60,-33,34
Mattersburg,1410,10,7,9,20,38,62,-24,30
SC Rheindorf,1411,1,20,7,9,56,44,12,67
FC Salzburg,1411,2,18,8,10,60,34,26,62
Vienna,1411,3,17,8,11,62,52,10,59
SK Sturm Gra,1411,4,16,7,13,57,36,21,55
Rapid Vienna,1411,5,15,10,11,56,39,17,55
RZ Pellets W,1411,6,13,7,16,46,55,-9,46
Admira Wacke,1411,7,12,6,18,40,61,-21,42
SV Josko Rie,1411,8,12,5,19,34,48,-14,41
St. Pölten,1411,9,10,11,15,43,61,-18,41
Mattersburg,1411,10,7,11,18,35,59,-24,32
FC Salzburg,1412,1,22,8,6,67,24,43,74
Vienna,1412,2,21,4,11,69,47,22,67
SC Rheindorf,1412,3,18,8,10,48,41,7,62
Rapid Vienna,1412,4,17,9,10,55,37,18,60
SK Sturm Gra,1412,5,18,6,12,61,44,17,60
RZ Pellets W,1412,6,12,6,18,48,62,-14,42
SV Josko Rie,1412,7,13,3,20,31,52,-21,42
Admira Wacke,1412,8,10,7,19,37,62,-25,37
St. Pölten,1412,9,8,8,20,40,63,-23,32
Mattersburg,1412,10,7,9,20,31,55,-24,30
FC Salzburg,1413,1,24,7,5,62,24,38,79
SK Sturm Gra,1413,2,21,8,7,61,25,36,71
SC Rheindorf,1413,3,18,6,12,51,42,9,60
Rapid Vienna,1413,4,16,8,12,62,44,18,56
Vienna,1413,5,17,5,14,56,48,8,56
Admira Wacke,1413,6,13,6,17,40,57,-17,45
RZ Pellets W,1413,7,11,8,17,45,59,-14,41
SV Josko Rie,1413,8,11,3,22,31,54,-23,36
Mattersburg,1413,9,8,10,18,32,52,-20,34
St. Pölten,1413,10,6,9,21,34,69,-35,27
SK Sturm Gra,1414,1,20,9,7,57,24,33,69
SC Rheindorf,1414,2,20,6,10,54,41,13,66
Vienna,1414,3,19,6,11,60,47,13,63
FC Salzburg,1414,4,18,8,10,60,33,27,62
Rapid Vienna,1414,5,13,13,10,54,42,12,52
SV Josko Rie,1414,6,13,5,18,37,51,-14,44
RZ Pellets W,1414,7,12,6,18,46,58,-12,42
Admira Wacke,1414,8,9,9,18,28,57,-29,36
Mattersburg,1414,9,8,10,18,40,56,-16,34
St. Pölten,1414,10,8,8,20,40,67,-27,32
SC Rheindorf,1415,1,22,6,8,59,42,17,72
SK Sturm Gra,1415,2,21,7,8,67,36,31,70
FC Salzburg,1415,3,17,9,10,64,35,29,60
Vienna,1415,4,18,6,12,61,52,9,60
Admira Wacke,1415,5,16,5,15,47,59,-12,53
RZ Pellets W,1415,6,12,8,16,51,59,-8,44
Rapid Vienna,1415,7,9,13,14,45,46,-1,40
Mattersburg,1415,8,8,10,18,41,56,-15,34
SV Josko Rie,1415,9,8,10,18,33,52,-19,34
St. Pölten,1415,10,7,10,19,41,72,-31,31
FC Salzburg,1416,1,20,10,6,65,31,34,70
SC Rheindorf,1416,2,18,9,9,60,46,14,63
SK Sturm Gra,1416,3,18,8,10,61,38,23,62
Rapid Vienna,1416,4,16,10,10,60,39,21,58
Vienna,1416,5,17,7,12,64,51,13,58
RZ Pellets W,1416,6,13,9,14,50,59,-9,48
Admira Wacke,1416,7,13,4,19,41,61,-20,43
SV Josko Rie,1416,8,8,9,19,33,54,-21,33
Mattersburg,1416,9,8,8,20,37,65,-28,32
St. Pölten,1416,10,7,10,19,40,67,-27,31
FC Salzburg,1417,1,22,7,7,64,32,32,73
Vienna,1417,2,21,3,12,68,51,17,66
SC Rheindorf,1417,3,17,9,10,54,42,12,60
SK Sturm Gra,1417,4,18,5,13,54,36,18,59
Rapid Vienna,1417,5,13,12,11,52,34,18,51
RZ Pellets W,1417,6,14,7,15,45,54,-9,49
Admira Wacke,1417,7,12,8,16,36,57,-21,44
SV Josko Rie,1417,8,11,6,19,32,44,-12,39
St. Pölten,1417,9,7,11,18,43,71,-28,32
Mattersburg,1417,10,4,14,18,33,60,-27,26
FC Salzburg,1418,1,24,6,6,71,31,40,78
SK Sturm Gra,1418,2,20,7,9,62,36,26,67
SC Rheindorf,1418,3,20,7,9,56,42,14,67
Vienna,1418,4,14,7,15,61,63,-2,49
Rapid Vienna,1418,5,10,15,11,51,43,8,45
RZ Pellets W,1418,6,12,6,18,47,57,-10,42
Admira Wacke,1418,7,11,8,17,39,55,-16,41
St. Pölten,1418,8,10,10,16,43,58,-15,40
SV Josko Rie,1418,9,11,5,20,38,56,-18,38
Mattersburg,1418,10,9,7,20,38,65,-27,34
FC Salzburg,1419,1,20,9,7,68,34,34,69
SC Rheindorf,1419,2,20,5,11,58,41,17,65
SK Sturm Gra,1419,3,19,7,10,54,28,26,64
Vienna,1419,4,19,6,11,63,51,12,63
RZ Pellets W,1419,5,14,7,15,49,55,-6,49
Rapid Vienna,1419,6,12,9,15,50,43,7,45
SV Josko Rie,1419,7,12,7,17,35,50,-15,43
Admira Wacke,1419,8,12,6,18,35,53,-18,42
Mattersburg,1419,9,10,5,21,37,69,-32,35
St. Pölten,1419,10,6,11,19,32,57,-25,29
SK Sturm Gra,1420,1,21,7,8,58,27,31,70
FC Salzburg,1420,2,19,10,7,65,33,32,67
SC Rheindorf,1420,3,19,9,8,59,48,11,66
Vienna,1420,4,17,6,13,59,50,9,57
RZ Pellets W,1420,5,15,7,14,47,48,-1,52
Rapid Vienna,1420,6,9,14,13,48,39,9,41
Admira Wacke,1420,7,10,9,17,34,58,-24,39
SV Josko Rie,1420,8,10,8,18,41,62,-21,38
Mattersburg,1420,9,9,7,20,38,57,-19,34
St. Pölten,1420,10,7,11,18,38,65,-27,32
SK Sturm Gra,1421,1,22,7,7,68,30,38,73
FC Salzburg,1421,2,22,7,7,62,28,34,73
SC Rheindorf,1421,3,19,9,8,56,39,17,66
Rapid Vienna,1421,4,17,9,10,56,36,20,60
Vienna,1421,5,14,8,14,56,58,-2,50
Admira Wacke,1421,6,12,7,17,37,53,-16,43
SV Josko Rie,1421,7,11,8,17,35,50,-15,41
St. Pölten,1421,8,9,9,18,39,61,-22,36
RZ Pellets W,1421,9,9,7,20,40,63,-23,34
Mattersburg,1421,10,6,7,23,30,61,-31,25
SK Sturm Gra,1422,1,20,7,9,67,36,31,67
FC Salzburg,1422,2,18,12,6,57,24,33,66
Vienna,1422,3,17,7,12,54,49,5,58
RZ Pellets W,1422,4,17,7,12,51,48,3,58
SC Rheindorf,1422,5,16,8,12,49,47,2,56
Rapid Vienna,1422,6,15,8,13,53,41,12,53
SV Josko Rie,1422,7,12,6,18,37,48,-11,42
St. Pölten,1422,8,9,9,18,40,63,-23,36
Mattersburg,1422,9,6,13,17,29,50,-21,31
Admira Wacke,1422,10,8,7,21,30,61,-31,31
SK Sturm Gra,1423,1,21,6,9,70,37,33,69
FC Salzburg,1423,2,19,9,8,70,34,36,66
Vienna,1423,3,19,6,11,66,50,16,63
SC Rheindorf,1423,4,19,6,11,59,51,8,63
Rapid Vienna,1423,5,14,11,11,59,45,14,53
RZ Pellets W,1423,6,13,6,17,48,59,-11,45
Mattersburg,1423,7,10,9,17,41,59,-18,39
SV Josko Rie,1423,8,10,7,19,35,52,-17,37
St. Pölten,1423,9,8,10,18,45,66,-21,34
Admira Wacke,1423,10,9,6,21,36,76,-40,33
FC Salzburg,1424,1,22,6,8,74,27,47,72
Rapid Vienna,1424,2,18,10,8,64,32,32,64
SK Sturm Gra,1424,3,18,6,12,62,44,18,60
SC Rheindorf,1424,4,18,6,12,53,47,6,60
Vienna,1424,5,16,6,14,57,57,0,54
Admira Wacke,1424,6,12,9,15,42,57,-15,45
RZ Pellets W,1424,7,11,10,15,42,54,-12,43
St. Pölten,1424,8,10,9,17,41,64,-23,39
SV Josko Rie,1424,9,10,7,19,28,54,-26,37
Mattersburg,1424,10,5,11,20,32,59,-27,26
FC Salzburg,1425,1,22,8,6,70,24,46,74
SC Rheindorf,1425,2,18,11,7,58,41,17,65
Vienna,1425,3,18,7,11,58,45,13,61
SK Sturm Gra,1425,4,15,10,11,51,35,16,55
Rapid Vienna,1425,5,13,10,13,52,41,11,49
Admira Wacke,1425,6,14,5,17,34,60,-26,47
RZ Pellets W,1425,7,11,11,14,48,53,-5,44
SV Josko Rie,1425,8,11,6,19,38,54,-16,39
St. Pölten,1425,9,9,9,18,39,63,-24,36
Mattersburg,1425,10,6,9,21,28,60,-32,27
FC Salzburg,1426,1,25,5,6,76,25,51,80
SC Rheindorf,1426,2,22,5,9,59,42,17,71
SK Sturm Gra,1426,3,18,7,11,62,39,23,61
Vienna,1426,4,18,4,14,66,60,6,58
Rapid Vienna,1426,5,14,10,12,61,44,17,52
St. Pölten,1426,6,11,9,16,41,57,-16,42
RZ Pellets W,1426,7,11,6,19,45,65,-20,39
Admira Wacke,1426,8,11,6,19,37,65,-28,39
Mattersburg,1426,9,9,8,19,42,63,-21,35
SV Josko Rie,1426,10,8,6,22,26,55,-29,30
FC Salzburg,1427,1,22,6,8,66,30,36,72
SK Sturm Gra,1427,2,20,9,7,62,33,29,69
Vienna,1427,3,20,5,11,70,51,19,65
SC Rheindorf,1427,4,18,9,9,56,49,7,63
Rapid Vienna,1427,5,11,10,15,48,42,6,43
St. Pölten,1427,6,11,10,15,48,62,-14,43
RZ Pellets W,1427,7,11,5,20,44,58,-14,38
SV Josko Rie,1427,8,10,7,19,35,57,-22,37
Mattersburg,1427,9,9,9,18,41,60,-19,36
Admira Wacke,1427,10,10,6,20,38,66,-28,36
FC Salzburg,1428,1,20,10,6,65,29,36,70
SC Rheindorf,1428,2,21,6,9,55,37,18,69
SK Sturm Gra,1428,3,19,9,8,58,31,27,66
Rapid Vienna,1428,4,16,10,10,58,34,24,58
Vienna,1428,5,16,10,10,62,47,15,58
RZ Pellets W,1428,6,10,8,18,48,64,-16,38
St. Pölten,1428,7,9,10,17,40,67,-27,37
SV Josko Rie,1428,8,10,6,20,27,47,-20,36
Mattersburg,1428,9,9,6,21,35,63,-28,33
Admira Wacke,1428,10,8,9,19,33,62,-29,33
FC Salzburg,1429,1,20,7,9,68,34,34,67
SC Rheindorf,1429,2,20,7,9,59,39,20,67
SK Sturm Gra,1429,3,19,6,11,55,35,20,63
Vienna,1429,4,19,4,13,65,57,8,61
Rapid Vienna,1429,5,15,8,13,56,43,13,53
RZ Pellets W,1429,6,14,8,14,46,49,-3,50
Mattersburg,1429,7,11,10,15,39,50,-11,43
SV Josko Rie,1429,8,10,5,21,39,62,-23,35
Admira Wacke,1429,9,9,7,20,30,62,-32,34
St. Pölten,1429,10,7,10,19,42,68,-26,31
FC Salzburg,1430,1,22,7,7,67,31,36,73
SC Rheindorf,1430,2,19,8,9,55,37,18,65
SK Sturm Gra,1430,3,18,8,10,60,35,25,62
Vienna,1430,4,17,6,13,57,57,0,57
Rapid Vienna,1430,5,12,9,15,50,44,6,45
St. Pölten,1430,6,11,10,15,49,67,-18,43
SV Josko Rie,1430,7,12,5,19,32,49,-17,41
Admira Wacke,1430,8,12,5,19,39,61,-22,41
RZ Pellets W,1430,9,11,6,19,44,56,-12,39
Mattersburg,1430,10,8,12,16,40,56,-16,36
FC Salzburg,1431,1,23,6,7,71,28,43,75
SK Sturm Gra,1431,2,18,8,10,56,36,20,62
Vienna,1431,3,19,5,12,62,49,13,62
SC Rheindorf,1431,4,18,7,11,52,41,11,61
Rapid Vienna,1431,5,16,11,9,61,40,21,59
RZ Pellets W,1431,6,14,5,17,49,53,-4,47
St. Pölten,1431,7,9,10,17,42,66,-24,37
Admira Wacke,1431,8,10,6,20,31,65,-34,36
Mattersburg,1431,9,7,13,16,37,56,-19,34
SV Josko Rie,1431,10,8,5,23,33,60,-27,29
FC Salzburg,1432,1,23,6,7,65,31,34,75
SK Sturm Gra,1432,2,20,6,10,55,32,23,66
Vienna,1432,3,19,6,11,65,48,17,63
SC Rheindorf,1432,4,17,9,10,54,52,2,60
Rapid Vienna,1432,5,16,10,10,70,43,27,58
RZ Pellets W,1432,6,13,5,18,46,57,-11,44
SV Josko Rie,1432,7,10,8,18,35,53,-18,38
Admira Wacke,1432,8,10,8,18,36,57,-21,38
St. Pölten,1432,9,6,12,18,40,67,-27,30
Mattersburg,1432,10,6,10,20,34,60,-26,28
FC Salzburg,1433,1,22,8,6,76,33,43,74
SK Sturm Gra,1433,2,20,7,9,62,32,30,67
Vienna,1433,3,21,4,11,63,47,16,67
SC Rheindorf,1433,4,18,9,9,52,43,9,63
Rapid Vienna,1433,5,12,11,13,55,39,16,47
Admira Wacke,1433,6,11,8,17,38,64,-26,41
RZ Pellets W,1433,7,11,7,18,40,57,-17,40
SV Josko Rie,1433,8,9,8,19,37,57,-20,35
Mattersburg,1433,9,9,7,20,37,63,-26,34
St. Pölten,1433,10,8,9,19,44,69,-25,33
SC Rheindorf,1434,1,18,10,8,53,36,17,64
FC Salzburg,1434,2,17,9,10,58,38,20,60
Vienna,1434,3,17,8,11,62,50,12,59
SK Sturm Gra,1434,4,16,8,12,54,41,13,56
Rapid Vienna,1434,5,15,9,12,50,44,6,54
RZ Pellets W,1434,6,13,6,17,48,57,-9,45
Admira Wacke,1434,7,12,7,17,37,56,-19,43
St. Pölten,1434,8,9,12,15,41,58,-17,39
Mattersburg,1434,9,9,11,16,39,47,-8,38
SV Josko Rie,1434,10,9,10,17,35,50,-15,37
FC Salzburg,1435,1,22,8,6,72,34,38,74
SK Sturm Gra,1435,2,19,8,9,56,32,24,65
Rapid Vienna,1435,3,17,8,11,57,37,20,59
SC Rheindorf,1435,4,17,8,11,55,45,10,59
Vienna,1435,5,14,9,13,58,55,3,51
Admira Wacke,1435,6,13,5,18,37,59,-22,44
Mattersburg,1435,7,11,9,16,41,51,-10,42
SV Josko Rie,1435,8,12,6,18,41,53,-12,42
RZ Pellets W,1435,9,9,7,20,42,65,-23,34
St. Pölten,1435,10,8,8,20,44,72,-28,32
FC Salzburg,1436,1,24,7,5,72,26,46,79
SC Rheindorf,1436,2,18,9,9,62,44,18,63
Vienna,1436,3,19,5,12,63,55,8,62
Rapid Vienna,1436,4,15,11,10,54,37,17,56
SK Sturm Gra,1436,5,16,8,12,50,37,13,56
RZ Pellets W,1436,6,13,7,16,48,56,-8,46
Mattersburg,1436,7,10,8,18,41,60,-19,38
SV Josko Rie,1436,8,10,6,20,32,54,-22,36
Admira Wacke,1436,9,9,8,19,35,63,-28,35
St. Pölten,1436,10,7,9,20,38,63,-25,30
FC Salzburg,1437,1,23,7,6,74,31,43,76
SC Rheindorf,1437,2,24,4,8,69,42,27,76
SK Sturm Gra,1437,3,21,5,10,64,34,30,68
Vienna,1437,4,19,5,12,71,59,12,62
Rapid Vienna,1437,5,17,8,11,60,39,21,59
Admira Wacke,1437,6,12,4,20,40,64,-24,40
RZ Pellets W,1437,7,9,8,19,45,67,-22,35
SV Josko Rie,1437,8,8,7,21,30,56,-26,31
Mattersburg,1437,9,7,9,20,37,64,-27,30
St. Pölten,1437,10,7,9,20,35,69,-34,30
FC Salzburg,1438,1,22,10,4,81,28,53,76
SC Rheindorf,1438,2,21,7,8,56,39,17,70
Vienna,1438,3,20,4,12,65,53,12,64
SK Sturm Gra,1438,4,19,5,12,60,36,24,62
Rapid Vienna,1438,5,15,10,11,52,39,13,55
St. Pölten,1438,6,10,11,15,45,62,-17,41
RZ Pellets W,1438,7,9,9,18,47,68,-21,36
Admira Wacke,1438,8,10,5,21,33,65,-32,35
Mattersburg,1438,9,9,7,20,36,54,-18,34
SV Josko Rie,1438,10,10,2,24,39,70,-31,32
SC Rheindorf,1439,1,21,8,7,62,40,22,71
FC Salzburg,1439,2,19,9,8,67,36,31,66
Rapid Vienna,1439,3,17,9,10,63,33,30,60
Vienna,1439,4,17,6,13,55,49,6,57
SK Sturm Gra,1439,5,14,9,13,48,41,7,51
RZ Pellets W,1439,6,13,9,14,47,52,-5,48
Admira Wacke,1439,7,12,9,15,38,51,-13,45
Mattersburg,1439,8,9,9,18,40,62,-22,36
St. Pölten,1439,9,7,11,18,36,63,-27,32
SV Josko Rie,1439,10,7,9,20,25,54,-29,30
FC Salzburg,1440,1,23,7,6,72,36,36,76
SC Rheindorf,1440,2,21,6,9,61,50,11,69
Vienna,1440,3,19,6,11,73,50,23,63
Rapid Vienna,1440,4,16,10,10,59,35,24,58
SK Sturm Gra,1440,5,16,10,10,62,40,22,58
RZ Pellets W,1440,6,13,11,12,48,49,-1,50
St. Pölten,1440,7,9,8,19,39,65,-26,35
SV Josko Rie,1440,8,10,4,22,37,64,-27,34
Mattersburg,1440,9,8,6,22,40,64,-24,30
Admira Wacke,1440,10,8,6,22,31,69,-38,30
SC Rheindorf,1441,1,20,7,9,56,42,14,67
FC Salzburg,1441,2,19,9,8,70,36,34,66
SK Sturm Gra,1441,3,20,6,10,61,30,31,66
Vienna,1441,4,16,8,12,61,53,8,56
RZ Pellets W,1441,5,15,5,16,41,52,-11,50
Rapid Vienna,1441,6,12,10,14,51,44,7,46
Admira Wacke,1441,7,11,10,15,35,51,-16,43
Mattersburg,1441,8,10,8,18,41,61,-20,38
SV Josko Rie,1441,9,11,5,20,35,61,-26,38
St. Pölten,1441,10,8,8,20,44,65,-21,32
FC Salzburg,1442,1,20,9,7,56,27,29,69
Vienna,1442,2,20,5,11,71,50,21,65
SK Sturm Gra,1442,3,18,8,10,57,36,21,62
SC Rheindorf,1442,4,17,8,11,51,47,4,59
Rapid Vienna,1442,5,13,11,12,51,36,15,50
RZ Pellets W,1442,6,12,10,14,48,54,-6,46
Admira Wacke,1442,7,13,5,18,32,57,-25,44
SV Josko Rie,1442,8,11,5,20,30,47,-17,38
Mattersburg,1442,9,9,8,19,40,58,-18,35
St. Pölten,1442,10,7,11,18,46,70,-24,32
FC Salzburg,1443,1,23,6,7,66,30,36,75
SC Rheindorf,1443,2,19,11,6,69,44,25,68
SK Sturm Gra,1443,3,17,11,8,57,32,25,62
Vienna,1443,4,17,6,13,55,51,4,57
Admira Wacke,1443,5,13,7,16,39,56,-17,46
Rapid Vienna,1443,6,10,15,11,50,41,9,45
RZ Pellets W,1443,7,10,8,18,38,54,-16,38
St. Pölten,1443,8,9,11,16,40,57,-17,38
SV Josko Rie,1443,9,9,6,21,33,57,-24,33
Mattersburg,1443,10,8,9,19,34,59,-25,33
SK Sturm Gra,1444,1,23,4,9,60,29,31,73
FC Salzburg,1444,2,19,7,10,60,34,26,64
Rapid Vienna,1444,3,17,9,10,59,37,22,60
Vienna,1444,4,18,6,12,67,53,14,60
SC Rheindorf,1444,5,15,11,10,52,43,9,56
Admira Wacke,1444,6,13,6,17,34,58,-24,45
St. Pölten,1444,7,10,10,16,48,65,-17,40
RZ Pellets W,1444,8,10,7,19,40,58,-18,37
SV Josko Rie,1444,9,9,7,20,28,51,-23,34
Mattersburg,1444,10,7,11,18,39,59,-20,32
FC Salzburg,1445,1,23,5,8,64,29,35,74
SC Rheindorf,1445,2,23,5,8,64,36,28,74
SK Sturm Gra,1445,3,20,5,11,63,32,31,65
Vienna,1445,4,17,4,15,60,63,-3,55
Rapid Vienna,1445,5,13,11,12,54,45,9,50
Admira Wacke,1445,6,14,4,18,39,55,-16,46
RZ Pellets W,1445,7,11,7,18,43,57,-14,40
Mattersburg,1445,8,9,8,19,38,58,-20,35
St. Pölten,1445,9,9,8,19,43,68,-25,35
SV Josko Rie,1445,10,10,5,21,36,61,-25,35
SC Rheindorf,1446,1,21,8,7,58,39,19,71
Vienna,1446,2,20,8,8,64,41,23,68
FC Salzburg,1446,3,20,7,9,66,30,36,67
SK Sturm Gra,1446,4,17,6,13,55,35,20,57
Rapid Vienna,1446,5,13,10,13,52,44,8,49
Admira Wacke,1446,6,12,6,18,43,67,-24,42
RZ Pellets W,1446,7,10,11,15,42,57,-15,41
SV Josko Rie,1446,8,11,4,21,37,56,-19,37
St. Pölten,1446,9,9,9,18,42,64,-22,36
Mattersburg,1446,10,7,11,18,34,60,-26,32
FC Salzburg,1447,1,21,7,8,73,34,39,70
SC Rheindorf,1447,2,19,8,9,56,44,12,65
SK Sturm Gra,1447,3,17,6,13,54,38,16,57
Vienna,1447,4,15,6,15,62,53,9,51
Rapid Vienna,1447,5,12,14,10,50,39,11,50
RZ Pellets W,1447,6,13,10,13,55,57,-2,49
Admira Wacke,1447,7,12,7,17,33,61,-28,43
St. Pölten,1447,8,10,11,15,44,60,-16,41
Mattersburg,1447,9,9,9,18,38,54,-16,36
SV Josko Rie,1447,10,10,6,20,34,59,-25,36
FC Salzburg,1448,1,20,8,8,65,33,32,68
SC Rheindorf,1448,2,19,9,8,57,36,21,66
SK Sturm Gra,1448,3,19,6,11,59,36,23,63
Rapid Vienna,1448,4,17,9,10,62,41,21,60
Vienna,1448,5,15,6,15,54,58,-4,51
SV Josko Rie,1448,6,12,8,16,33,46,-13,44
Admira Wacke,1448,7,10,10,16,35,53,-18,40
RZ Pellets W,1448,8,11,6,19,41,57,-16,39
Mattersburg,1448,9,8,10,18,37,59,-22,34
St. Pölten,1448,10,7,12,17,37,61,-24,33
SK Sturm Gra,1449,1,20,7,9,73,43,30,67
SC Rheindorf,1449,2,19,9,8,60,38,22,66
Vienna,1449,3,20,6,10,74,53,21,66
FC Salzburg,1449,4,19,8,9,62,33,29,65
Rapid Vienna,1449,5,14,12,10,63,45,18,54
Mattersburg,1449,6,10,10,16,38,58,-20,40
Admira Wacke,1449,7,10,10,16,34,62,-28,40
RZ Pellets W,1449,8,10,6,20,45,67,-22,36
St. Pölten,1449,9,7,11,18,47,68,-21,32
SV Josko Rie,1449,10,8,7,21,31,60,-29,31
FC Salzburg,1450,1,21,9,6,64,31,33,72
SK Sturm Gra,1450,2,20,5,11,65,38,27,65
Vienna,1450,3,20,5,11,62,46,16,65
SC Rheindorf,1450,4,20,5,11,60,48,12,65
Rapid Vienna,1450,5,15,10,11,63,44,19,55
Admira Wacke,1450,6,12,6,18,40,60,-20,42
RZ Pellets W,1450,7,11,7,18,41,56,-15,40
Mattersburg,1450,8,10,6,20,35,58,-23,36
SV Josko Rie,1450,9,10,4,22,30,55,-25,34
St. Pölten,1450,10,8,9,19,49,73,-24,33
SK Sturm Gra,1451,1,22,6,8,68,37,31,72
FC Salzburg,1451,2,20,9,7,67,30,37,69
Vienna,1451,3,18,6,12,61,51,10,60
SC Rheindorf,1451,4,18,6,12,47,44,3,60
Rapid Vienna,1451,5,13,12,11,54,42,12,51
Admira Wacke,1451,6,13,5,18,42,57,-15,44
SV Josko Rie,1451,7,12,7,17,35,48,-13,43
RZ Pellets W,1451,8,11,8,17,47,58,-11,41
Mattersburg,1451,9,6,12,18,33,54,-21,30
St. Pölten,1451,10,6,11,19,34,67,-33,29
FC Salzburg,1452,1,20,7,9,64,32,32,67
SK Sturm Gra,1452,2,20,7,9,54,33,21,67
Vienna,1452,3,20,4,12,61,53,8,64
SC Rheindorf,1452,4,18,5,13,53,48,5,59
Rapid Vienna,1452,5,14,12,10,53,36,17,54
RZ Pellets W,1452,6,13,9,14,47,53,-6,48
Admira Wacke,1452,7,10,9,17,35,55,-20,39
Mattersburg,1452,8,8,12,16,41,51,-10,36
SV Josko Rie,1452,9,9,8,19,35,53,-18,35
St. Pölten,1452,10,7,9,20,40,69,-29,30
SK Sturm Gra,1453,1,23,6,7,64,29,35,75
FC Salzburg,1453,2,18,12,6,65,31,34,66
SC Rheindorf,1453,3,19,9,8,54,41,13,66
Vienna,1453,4,19,4,13,64,50,14,61
Rapid Vienna,1453,5,14,12,10,57,43,14,54
SV Josko Rie,1453,6,14,4,18,41,50,-9,46
RZ Pellets W,1453,7,12,7,17,46,61,-15,43
Admira Wacke,1453,8,10,7,19,38,62,-24,37
Mattersburg,1453,9,5,11,20,37,65,-28,26
St. Pölten,1453,10,5,10,21,42,76,-34,25
SC Rheindorf,1454,1,20,9,7,55,39,16,69
SK Sturm Gra,1454,2,21,5,10,57,29,28,68
FC Salzburg,1454,3,18,7,11,57,37,20,61
Vienna,1454,4,17,6,13,59,52,7,57
Rapid Vienna,1454,5,15,10,11,58,39,19,55
RZ Pellets W,1454,6,13,8,15,49,55,-6,47
SV Josko Rie,1454,7,13,5,18,41,52,-11,44
Admira Wacke,1454,8,11,6,19,35,60,-25,39
Mattersburg,1454,9,9,7,20,40,59,-19,34
St. Pölten,1454,10,7,9,20,35,64,-29,30
FC Salzburg,1455,1,21,9,6,69,34,35,72
SC Rheindorf,1455,2,19,10,7,60,38,22,67
SK Sturm Gra,1455,3,17,8,11,53,35,18,59
Vienna,1455,4,17,4,15,66,61,5,55
Rapid Vienna,1455,5,13,10,13,51,42,9,49
Admira Wacke,1455,6,12,7,17,37,63,-26,43
SV Josko Rie,1455,7,11,9,16,33,45,-12,42
RZ Pellets W,1455,8,11,7,18,49,59,-10,40
Mattersburg,1455,9,10,7,19,39,50,-11,37
St. Pölten,1455,10,8,11,17,38,68,-30,35
SC Rheindorf,1456,1,22,7,7,63,40,23,73
FC Salzburg,1456,2,21,8,7,65,29,36,71
SK Sturm Gra,1456,3,19,9,8,54,28,26,66
Vienna,1456,4,18,4,14,55,51,4,58
Rapid Vienna,1456,5,14,10,12,52,37,15,52
Admira Wacke,1456,6,14,6,16,37,51,-14,48
RZ Pellets W,1456,7,12,5,19,42,55,-13,41
St. Pölten,1456,8,9,10,17,38,60,-22,37
SV Josko Rie,1456,9,9,3,24,30,59,-29,30
Mattersburg,1456,10,7,8,21,33,59,-26,29
FC Salzburg,1457,1,22,5,9,69,35,34,71
SC Rheindorf,1457,2,20,8,8,65,47,18,68
SK Sturm Gra,1457,3,19,8,9,63,37,26,65
Vienna,1457,4,19,4,13,66,52,14,61
Rapid Vienna,1457,5,14,10,12,56,43,13,52
RZ Pellets W,1457,6,15,5,16,55,61,-6,50
SV Josko Rie,1457,7,13,2,21,41,64,-23,41
Admira Wacke,1457,8,11,5,20,34,58,-24,38
Mattersburg,1457,9,9,6,21,34,58,-24,33
St. Pölten,1457,10,6,11,19,41,69,-28,29
SC Rheindorf,1458,1,23,6,7,63,39,24,75
FC Salzburg,1458,2,20,6,10,62,32,30,66
Vienna,1458,3,21,3,12,76,56,20,66
SK Sturm Gra,1458,4,16,8,12,58,39,19,56
Rapid Vienna,1458,5,14,9,13,57,40,17,51
Admira Wacke,1458,6,13,7,16,39,60,-21,46
RZ Pellets W,1458,7,12,8,16,44,54,-10,44
Mattersburg,1458,8,10,7,19,36,56,-20,37
SV Josko Rie,1458,9,10,5,21,33,59,-26,35
St. Pölten,1458,10,6,11,19,37,70,-33,29
FC Salzburg,1459,1,18,8,10,63,38,25,62
Vienna,1459,2,19,5,12,63,55,8,62
SC Rheindorf,1459,3,18,7,11,58,48,10,61
Rapid Vienna,1459,4,16,11,9,59,36,23,59
SK Sturm Gra,1459,5,16,8,12,56,42,14,56
RZ Pellets W,1459,6,13,7,16,46,56,-10,46
SV Josko Rie,1459,7,11,7,18,35,51,-16,40
St. Pölten,1459,8,10,9,17,47,65,-18,39
Admira Wacke,1459,9,10,8,18,36,58,-22,38
Mattersburg,1459,10,8,12,16,43,57,-14,36
FC Salzburg,1460,1,22,6,8,63,29,34,72
SK Sturm Gra,1460,2,19,7,10,63,39,24,64
SC Rheindorf,1460,3,19,5,12,54,39,15,62
Vienna,1460,4,18,6,12,59,46,13,60
Rapid Vienna,1460,5,16,9,11,64,43,21,57
St. Pölten,1460,6,12,7,17,39,63,-24,43
RZ Pellets W,1460,7,11,8,17,36,54,-18,41
SV Josko Rie,1460,8,11,5,20,36,57,-21,38
Admira Wacke,1460,9,10,8,18,37,59,-22,38
Mattersburg,1460,10,7,9,20,34,56,-22,30
SK Sturm Gra,1461,1,22,6,8,64,31,33,72
FC Salzburg,1461,2,21,5,10,67,34,33,68
Rapid Vienna,1461,3,18,9,9,58,32,26,63
SC Rheindorf,1461,4,18,8,10,59,47,12,62
Vienna,1461,5,19,4,13,58,50,8,61
Admira Wacke,1461,6,12,7,17,42,59,-17,43
RZ Pellets W,1461,7,12,5,19,44,64,-20,41
St. Pölten,1461,8,7,11,18,38,62,-24,32
SV Josko Rie,1461,9,9,5,22,29,54,-25,32
Mattersburg,1461,10,8,8,20,35,61,-26,32
SC Rheindorf,1462,1,21,8,7,58,36,22,71
FC Salzburg,1462,2,21,5,10,58,31,27,68
Vienna,1462,3,21,5,10,59,44,15,68
SK Sturm Gra,1462,4,18,7,11,53,30,23,61
Rapid Vienna,1462,5,16,10,10,57,39,18,58
RZ Pellets W,1462,6,13,8,15,43,51,-8,47
Admira Wacke,1462,7,11,5,20,31,55,-24,38
Mattersburg,1462,8,7,11,18,35,53,-18,32
SV Josko Rie,1462,9,8,7,21,32,60,-28,31
St. Pölten,1462,10,7,8,21,31,58,-27,29
FC Salzburg,1463,1,21,9,6,67,30,37,72
SK Sturm Gra,1463,2,20,7,9,68,40,28,67
SC Rheindorf,1463,3,18,9,9,51,40,11,63
Vienna,1463,4,17,7,12,60,51,9,58
SV Josko Rie,1463,5,13,8,15,36,48,-12,47
Rapid Vienna,1463,6,12,10,14,49,43,6,46
RZ Pellets W,1463,7,11,8,17,48,61,-13,41
St. Pölten,1463,8,10,9,17,47,66,-19,39
Admira Wacke,1463,9,10,8,18,44,66,-22,38
Mattersburg,1463,10,6,9,21,34,59,-25,27
SK Sturm Gra,1464,1,21,6,9,57,25,32,69
FC Salzburg,1464,2,20,6,10,60,35,25,66
SC Rheindorf,1464,3,17,6,13,48,45,3,57
RZ Pellets W,1464,4,16,6,14,51,48,3,54
Rapid Vienna,1464,5,14,10,12,52,35,17,52
Vienna,1464,6,16,4,16,53,52,1,52
SV Josko Rie,1464,7,13,5,18,33,44,-11,44
Admira Wacke,1464,8,11,10,15,35,55,-20,43
Mattersburg,1464,9,11,7,18,39,54,-15,40
St. Pölten,1464,10,7,8,21,36,71,-35,29
FC Salzburg,1465,1,21,8,7,70,26,44,71
Vienna,1465,2,22,5,9,68,44,24,71
SC Rheindorf,1465,3,21,6,9,61,44,17,69
SK Sturm Gra,1465,4,19,7,10,62,34,28,64
Rapid Vienna,1465,5,12,13,11,50,38,12,49
RZ Pellets W,1465,6,12,8,16,44,61,-17,44
Admira Wacke,1465,7,11,6,19,36,66,-30,39
SV Josko Rie,1465,8,10,5,21,36,58,-22,35
St. Pölten,1465,9,7,10,19,42,69,-27,31
Mattersburg,1465,10,6,10,20,38,67,-29,28
SC Rheindorf,1466,1,22,6,8,63,39,24,72
Vienna,1466,2,21,5,10,68,50,18,68
SK Sturm Gra,1466,3,18,8,10,57,37,20,62
FC Salzburg,1466,4,17,10,9,56,30,26,61
Rapid Vienna,1466,5,14,10,12,54,37,17,52
SV Josko Rie,1466,6,11,8,17,37,50,-13,41
St. Pölten,1466,7,10,10,16,43,63,-20,40
RZ Pellets W,1466,8,11,6,19,41,61,-20,39
Admira Wacke,1466,9,11,4,21,36,63,-27,37
Mattersburg,1466,10,8,7,21,32,57,-25,31
FC Salzburg,1467,1,21,8,7,64,32,32,71
Vienna,1467,2,22,4,10,62,48,14,70
SC Rheindorf,1467,3,20,9,7,58,39,19,69
SK Sturm Gra,1467,4,19,5,12,55,33,22,62
Rapid Vienna,1467,5,16,8,12,53,37,16,56
RZ Pellets W,1467,6,12,8,16,50,53,-3,44
SV Josko Rie,1467,7,11,3,22,33,56,-23,36
Admira Wacke,1467,8,10,6,20,29,53,-24,36
Mattersburg,1467,9,8,7,21,38,59,-21,31
St. Pölten,1467,10,7,10,19,34,66,-32,31
SC Rheindorf,1468,1,24,7,5,63,34,29,79
FC Salzburg,1468,2,20,8,8,65,30,35,68
SK Sturm Gra,1468,3,18,6,12,54,33,21,60
Vienna,1468,4,17,7,12,60,49,11,58
Admira Wacke,1468,5,13,10,13,41,52,-11,49
Rapid Vienna,1468,6,12,11,13,56,46,10,47
RZ Pellets W,1468,7,12,7,17,43,57,-14,43
SV Josko Rie,1468,8,9,6,21,34,58,-24,33
Mattersburg,1468,9,8,8,20,38,60,-22,32
St. Pölten,1468,10,8,8,20,44,79,-35,32
FC Salzburg,1469,1,22,6,8,67,30,37,72
Vienna,1469,2,19,6,11,59,47,12,63
SC Rheindorf,1469,3,17,7,12,48,43,5,58
SK Sturm Gra,1469,4,16,7,13,49,36,13,55
Admira Wacke,1469,5,15,5,16,41,55,-14,50
RZ Pellets W,1469,6,14,7,15,46,49,-3,49
Rapid Vienna,1469,7,13,8,15,58,50,8,47
St. Pölten,1469,8,10,10,16,44,61,-17,40
Mattersburg,1469,9,10,8,18,40,57,-17,38
SV Josko Rie,1469,10,9,6,21,31,55,-24,33
Rapid Vienna,1470,1,20,9,7,64,34,30,69
SC Rheindorf,1470,2,20,6,10,59,42,17,66
SK Sturm Gra,1470,3,19,6,11,57,34,23,63
FC Salzburg,1470,4,18,8,10,61,38,23,62
Vienna,1470,5,17,3,16,62,63,-1,54
Admira Wacke,1470,6,14,4,18,44,61,-17,46
St. Pölten,1470,7,11,9,16,43,61,-18,42
SV Josko Rie,1470,8,11,5,20,42,59,-17,38
RZ Pellets W,1470,9,10,6,20,42,56,-14,36
Mattersburg,1470,10,7,10,19,32,58,-26,31
FC Salzburg,1471,1,23,6,7,68,30,38,75
SC Rheindorf,1471,2,19,9,8,58,42,16,66
SK Sturm Gra,1471,3,19,6,11,58,34,24,63
Vienna,1471,4,19,6,11,60,45,15,63
Rapid Vienna,1471,5,13,12,11,50,39,11,51
RZ Pellets W,1471,6,14,5,17,49,59,-10,47
Admira Wacke,1471,7,11,7,18,42,57,-15,40
Mattersburg,1471,8,8,9,19,33,56,-23,33
SV Josko Rie,1471,8,9,6,21,33,56,-23,33
St. Pölten,1471,10,8,8,20,36,69,-33,32
FC Salzburg,1472,1,22,7,7,69,31,38,73
SK Sturm Gra,1472,2,21,9,6,70,31,39,72
SC Rheindorf,1472,3,20,9,7,58,41,17,69
Vienna,1472,4,17,7,12,57,55,2,58
Rapid Vienna,1472,5,13,10,13,59,46,13,49
RZ Pellets W,1472,6,11,8,17,48,58,-10,41
Mattersburg,1472,7,9,10,17,46,60,-14,37
SV Josko Rie,1472,8,9,9,18,35,57,-22,36
St. Pölten,1472,9,7,11,18,36,64,-28,32
Admira Wacke,1472,10,8,6,22,32,67,-35,30
FC Salzburg,1473,1,21,8,7,68,33,35,71
SC Rheindorf,1473,2,20,6,10,54,42,12,66
SK Sturm Gra,1473,3,19,6,11,59,36,23,63
Vienna,1473,4,18,3,15,58,54,4,57
Rapid Vienna,1473,5,13,13,10,54,37,17,52
RZ Pellets W,1473,6,14,5,17,50,54,-4,47
SV Josko Rie,1473,7,12,5,19,43,61,-18,41
Admira Wacke,1473,8,11,7,18,35,59,-24,40
St. Pölten,1473,9,8,11,17,42,59,-17,35
Mattersburg,1473,10,8,8,20,32,60,-28,32
SK Sturm Gra,1474,1,22,8,6,70,30,40,74
FC Salzburg,1474,2,20,8,8,64,32,32,68
SC Rheindorf,1474,3,20,7,9,57,41,16,67
Vienna,1474,4,18,8,10,65,49,16,62
Rapid Vienna,1474,5,11,13,12,51,38,13,46
Admira Wacke,1474,6,13,7,16,35,51,-16,46
RZ Pellets W,1474,7,11,6,19,41,59,-18,39
St. Pölten,1474,8,8,11,17,36,62,-26,35
Mattersburg,1474,9,9,5,22,33,60,-27,32
SV Josko Rie,1474,10,9,5,22,33,63,-30,32
FC Salzburg,1475,1,21,7,8,60,33,27,70
SK Sturm Gra,1475,2,19,7,10,60,32,28,64
SC Rheindorf,1475,3,19,7,10,51,35,16,64
Rapid Vienna,1475,4,15,11,10,60,39,21,56
Vienna,1475,5,17,3,16,63,54,9,54
Admira Wacke,1475,6,14,5,17,38,57,-19,47
RZ Pellets W,1475,7,13,7,16,48,57,-9,46
Mattersburg,1475,8,9,9,18,41,62,-21,36
SV Josko Rie,1475,9,10,5,21,33,54,-21,35
St. Pölten,1475,10,8,9,19,37,68,-31,33
SK Sturm Gra,1476,1,20,6,10,60,33,27,66
FC Salzburg,1476,2,19,7,10,61,33,28,64
Vienna,1476,3,18,6,12,59,50,9,60
SC Rheindorf,1476,4,17,8,11,52,44,8,59
Rapid Vienna,1476,5,15,13,8,54,31,23,58
Admira Wacke,1476,6,14,7,15,36,52,-16,49
RZ Pellets W,1476,7,11,10,15,38,50,-12,43
SV Josko Rie,1476,8,11,5,20,36,56,-20,38
St. Pölten,1476,9,8,8,20,36,62,-26,32
Mattersburg,1476,10,7,10,19,34,55,-21,31
FC Salzburg,1477,1,18,9,9,67,38,29,63
Vienna,1477,2,18,9,9,67,50,17,63
SC Rheindorf,1477,3,18,8,10,51,47,4,62
Rapid Vienna,1477,4,17,10,9,58,38,20,61
SK Sturm Gra,1477,5,17,8,11,53,37,16,59
Admira Wacke,1477,6,12,8,16,40,59,-19,44
SV Josko Rie,1477,7,12,7,17,42,49,-7,43
RZ Pellets W,1477,8,9,10,17,38,51,-13,37
Mattersburg,1477,9,7,11,18,33,53,-20,32
St. Pölten,1477,10,6,12,18,39,66,-27,30
SC Rheindorf,1478,1,23,7,6,63,35,28,76
FC Salzburg,1478,2,19,9,8,67,38,29,66
SK Sturm Gra,1478,3,16,9,11,55,39,16,57
Vienna,1478,4,17,6,13,65,58,7,57
Rapid Vienna,1478,5,14,14,8,60,32,28,56
Admira Wacke,1478,6,12,10,14,36,53,-17,46
RZ Pellets W,1478,7,11,10,15,41,50,-9,43
SV Josko Rie,1478,8,11,4,21,32,53,-21,37
St. Pölten,1478,9,7,9,20,36,70,-34,30
Mattersburg,1478,10,7,8,21,32,59,-27,29
SC Rheindorf,1479,1,21,9,6,54,37,17,72
FC Salzburg,1479,2,18,14,4,60,29,31,68
SK Sturm Gra,1479,3,20,5,11,62,37,25,65
Vienna,1479,4,17,6,13,60,54,6,57
Rapid Vienna,1479,5,13,10,13,51,37,14,49
Admira Wacke,1479,6,11,8,17,40,61,-21,41
Mattersburg,1479,7,10,8,18,44,58,-14,38
RZ Pellets W,1479,8,10,7,19,39,61,-22,37
St. Pölten,1479,9,8,12,16,47,64,-17,36
SV Josko Rie,1479,10,9,7,20,32,51,-19,34
FC Salzburg,1480,1,22,9,5,71,31,40,75
SC Rheindorf,1480,2,22,6,8,67,46,21,72
SK Sturm Gra,1480,3,17,7,12,63,41,22,58
Vienna,1480,4,16,7,13,63,56,7,55
Rapid Vienna,1480,5,13,10,13,58,45,13,49
Admira Wacke,1480,6,14,6,16,32,50,-18,48
St. Pölten,1480,7,11,8,17,48,63,-15,41
RZ Pellets W,1480,8,11,8,17,41,56,-15,41
SV Josko Rie,1480,9,9,7,20,31,56,-25,34
Mattersburg,1480,10,7,8,21,39,69,-30,29
SK Sturm Gra,1481,1,21,6,9,61,35,26,69
FC Salzburg,1481,2,20,8,8,65,31,34,68
SC Rheindorf,1481,3,17,10,9,51,41,10,61
Vienna,1481,4,17,7,12,62,57,5,58
Rapid Vienna,1481,5,14,12,10,51,34,17,54
RZ Pellets W,1481,6,11,10,15,46,54,-8,43
SV Josko Rie,1481,7,10,8,18,33,49,-16,38
St. Pölten,1481,8,9,11,16,43,65,-22,38
Admira Wacke,1481,9,10,6,20,30,56,-26,36
Mattersburg,1481,10,7,10,19,38,58,-20,31
SK Sturm Gra,1482,1,22,6,8,61,27,34,72
FC Salzburg,1482,2,21,6,9,64,36,28,69
Vienna,1482,3,20,5,11,74,52,22,65
SC Rheindorf,1482,4,19,7,10,55,44,11,64
Rapid Vienna,1482,5,15,10,11,58,37,21,55
SV Josko Rie,1482,6,13,3,20,36,51,-15,42
Admira Wacke,1482,7,11,8,17,36,56,-20,41
St. Pölten,1482,8,8,11,17,39,61,-22,35
RZ Pellets W,1482,9,9,7,20,40,71,-31,34
Mattersburg,1482,10,6,9,21,33,61,-28,27
FC Salzburg,1483,1,22,8,6,65,28,37,74
SC Rheindorf,1483,2,20,7,9,60,42,18,67
Vienna,1483,3,18,5,13,58,46,12,59
SK Sturm Gra,1483,4,16,9,11,59,45,14,57
Rapid Vienna,1483,5,14,11,11,58,36,22,53
RZ Pellets W,1483,6,13,8,15,52,57,-5,47
SV Josko Rie,1483,7,10,9,17,33,52,-19,39
Mattersburg,1483,8,9,8,19,35,58,-23,35
Admira Wacke,1483,9,9,8,19,33,63,-30,35
St. Pölten,1483,10,7,11,18,47,73,-26,32
FC Salzburg,1484,1,21,7,8,66,32,34,70
Vienna,1484,2,19,6,11,63,49,14,63
SC Rheindorf,1484,3,19,6,11,51,45,6,63
SK Sturm Gra,1484,4,17,7,12,62,39,23,58
Rapid Vienna,1484,5,14,10,12,55,42,13,52
RZ Pellets W,1484,6,13,8,15,44,50,-6,47
St. Pölten,1484,7,11,10,15,47,58,-11,43
Admira Wacke,1484,8,10,8,18,27,54,-27,38
SV Josko Rie,1484,9,10,7,19,35,55,-20,37
Mattersburg,1484,10,7,9,20,39,65,-26,30
SK Sturm Gra,1485,1,24,4,8,61,26,35,76
FC Salzburg,1485,2,19,9,8,63,34,29,66
SC Rheindorf,1485,3,19,9,8,59,40,19,66
Vienna,1485,4,19,6,11,68,56,12,63
Rapid Vienna,1485,5,15,11,10,62,44,18,56
St. Pölten,1485,6,11,8,17,46,65,-19,41
Admira Wacke,1485,7,10,8,18,35,59,-24,38
RZ Pellets W,1485,8,9,8,19,47,65,-18,35
SV Josko Rie,1485,9,8,7,21,32,59,-27,31
Mattersburg,1485,10,6,10,20,35,60,-25,28
SC Rheindorf,1486,1,22,6,8,56,37,19,72
SK Sturm Gra,1486,2,20,6,10,56,28,28,66
FC Salzburg,1486,3,17,10,9,55,30,25,61
Rapid Vienna,1486,4,17,9,10,62,37,25,60
Vienna,1486,5,17,7,12,53,47,6,58
Admira Wacke,1486,6,12,9,15,34,48,-14,45
RZ Pellets W,1486,7,12,5,19,38,59,-21,41
SV Josko Rie,1486,8,10,6,20,31,55,-24,36
St. Pölten,1486,9,8,9,19,41,64,-23,33
Mattersburg,1486,10,6,11,19,34,55,-21,29
FC Salzburg,1487,1,21,6,9,62,27,35,69
SK Sturm Gra,1487,2,17,10,9,57,34,23,61
Vienna,1487,3,18,5,13,59,50,9,59
SC Rheindorf,1487,4,16,10,10,51,42,9,58
RZ Pellets W,1487,5,15,7,14,51,52,-1,52
Rapid Vienna,1487,6,13,11,12,50,37,13,50
Admira Wacke,1487,7,11,7,18,36,62,-26,40
SV Josko Rie,1487,8,11,6,19,38,56,-18,39
St. Pölten,1487,9,9,11,16,42,58,-16,38
Mattersburg,1487,10,9,7,20,35,63,-28,34
SC Rheindorf,1488,1,21,7,8,61,41,20,70
FC Salzburg,1488,2,20,8,8,64,32,32,68
Vienna,1488,3,21,4,11,72,52,20,67
SK Sturm Gra,1488,4,18,12,6,65,35,30,66
Rapid Vienna,1488,5,14,10,12,48,37,11,52
Admira Wacke,1488,6,10,10,16,38,64,-26,40
SV Josko Rie,1488,7,10,8,18,31,48,-17,38
RZ Pellets W,1488,8,10,7,19,35,50,-15,37
St. Pölten,1488,9,8,7,21,32,65,-33,31
Mattersburg,1488,10,7,9,20,38,60,-22,30
FC Salzburg,1489,1,23,7,6,70,27,43,76
SK Sturm Gra,1489,2,21,4,11,63,36,27,67
SC Rheindorf,1489,3,17,9,10,49,42,7,60
Vienna,1489,4,18,5,13,64,57,7,59
Rapid Vienna,1489,5,13,11,12,51,40,11,50
RZ Pellets W,1489,6,12,6,18,51,62,-11,42
Admira Wacke,1489,7,11,9,16,39,56,-17,42
SV Josko Rie,1489,8,11,5,20,40,61,-21,38
St. Pölten,1489,9,10,8,18,36,60,-24,38
Mattersburg,1489,10,6,12,18,39,61,-22,30
FC Salzburg,1490,1,24,7,5,69,26,43,79
SK Sturm Gra,1490,2,21,4,11,57,34,23,67
SC Rheindorf,1490,3,17,9,10,55,44,11,60
Rapid Vienna,1490,4,16,11,9,62,38,24,59
Vienna,1490,5,17,4,15,62,56,6,55
Admira Wacke,1490,6,13,7,16,42,57,-15,46
RZ Pellets W,1490,7,11,5,20,39,62,-23,38
Mattersburg,1490,8,8,12,16,38,54,-16,36
SV Josko Rie,1490,9,10,5,21,35,58,-23,35
St. Pölten,1490,10,6,10,20,35,65,-30,28
FC Salzburg,1491,1,21,9,6,69,29,40,72
SK Sturm Gra,1491,2,22,6,8,67,27,40,72
SC Rheindorf,1491,3,19,8,9,54,45,9,65
Vienna,1491,4,19,5,12,69,57,12,62
Rapid Vienna,1491,5,13,9,14,53,49,4,48
RZ Pellets W,1491,6,11,7,18,46,60,-14,40
Admira Wacke,1491,7,11,7,18,36,59,-23,40
St. Pölten,1491,8,10,9,17,46,67,-21,39
SV Josko Rie,1491,9,10,7,19,37,58,-21,37
Mattersburg,1491,10,6,9,21,35,61,-26,27
FC Salzburg,1492,1,22,5,9,64,31,33,71
SK Sturm Gra,1492,2,20,6,10,61,34,27,66
SC Rheindorf,1492,3,18,8,10,54,43,11,62
Vienna,1492,4,18,4,14,61,53,8,58
Rapid Vienna,1492,5,16,9,11,67,44,23,57
Admira Wacke,1492,6,15,4,17,35,54,-19,49
RZ Pellets W,1492,7,11,8,17,42,62,-20,41
Mattersburg,1492,8,11,7,18,39,52,-13,40
SV Josko Rie,1492,9,9,6,21,31,56,-25,33
St. Pölten,1492,10,7,9,20,40,65,-25,30
SC Rheindorf,1493,1,20,8,8,58,42,16,68
Vienna,1493,2,21,3,12,65,49,16,66
FC Salzburg,1493,3,18,8,10,61,36,25,62
SK Sturm Gra,1493,4,16,6,14,54,40,14,54
Rapid Vienna,1493,5,15,8,13,52,42,10,53
RZ Pellets W,1493,6,15,7,14,50,48,2,52
SV Josko Rie,1493,7,11,9,16,39,54,-15,42
Admira Wacke,1493,8,12,5,19,32,53,-21,41
St. Pölten,1493,9,10,9,17,40,61,-21,39
Mattersburg,1493,10,5,11,20,36,62,-26,26
SC Rheindorf,1494,1,22,5,9,59,39,20,71
SK Sturm Gra,1494,2,21,6,9,66,34,32,69
FC Salzburg,1494,3,19,6,11,66,36,30,63
Rapid Vienna,1494,4,18,7,11,61,37,24,61
Vienna,1494,5,17,5,14,59,55,4,56
St. Pölten,1494,6,11,10,15,44,60,-16,43
RZ Pellets W,1494,7,12,6,18,37,52,-15,42
Admira Wacke,1494,8,11,6,19,34,63,-29,39
SV Josko Rie,1494,9,10,6,20,33,56,-23,36
Mattersburg,1494,10,8,5,23,32,59,-27,29
FC Salzburg,1495,1,22,6,8,63,33,30,72
SK Sturm Gra,1495,2,18,7,11,59,39,20,61
Vienna,1495,3,18,6,12,70,53,17,60
SC Rheindorf,1495,4,16,8,12,52,48,4,56
Rapid Vienna,1495,5,15,9,12,56,43,13,54
Admira Wacke,1495,6,14,5,17,42,58,-16,47
Mattersburg,1495,7,12,8,16,52,54,-2,44
RZ Pellets W,1495,8,11,8,17,37,52,-15,41
SV Josko Rie,1495,9,11,3,22,33,62,-29,36
St. Pölten,1495,10,9,8,19,52,74,-22,35
FC Salzburg,1496,1,20,5,11,61,31,30,65
Vienna,1496,2,19,5,12,67,52,15,62
SK Sturm Gra,1496,3,18,7,11,53,33,20,61
Rapid Vienna,1496,4,17,9,10,59,37,22,60
RZ Pellets W,1496,5,17,6,13,49,48,1,57
SC Rheindorf,1496,6,16,6,14,53,54,-1,54
SV Josko Rie,1496,7,14,5,17,48,57,-9,47
Admira Wacke,1496,8,12,5,19,41,64,-23,41
Mattersburg,1496,9,8,7,21,39,64,-25,31
St. Pölten,1496,10,7,9,20,36,66,-30,30
FC Salzburg,1497,1,23,6,7,65,27,38,75
SC Rheindorf,1497,2,20,8,8,51,36,15,68
SK Sturm Gra,1497,3,18,8,10,57,33,24,62
Rapid Vienna,1497,4,16,10,10,55,37,18,58
Vienna,1497,5,17,7,12,66,55,11,58
RZ Pellets W,1497,6,12,7,17,41,62,-21,43
Admira Wacke,1497,7,11,6,19,42,58,-16,39
St. Pölten,1497,8,10,9,17,43,62,-19,39
SV Josko Rie,1497,9,10,7,19,33,52,-19,37
Mattersburg,1497,10,6,6,24,31,62,-31,24
FC Salzburg,1498,1,19,10,7,62,34,28,67
SC Rheindorf,1498,2,19,7,10,62,50,12,64
Vienna,1498,3,18,7,11,66,55,11,61
Rapid Vienna,1498,4,16,9,11,63,39,24,57
SK Sturm Gra,1498,5,15,7,14,51,41,10,52
RZ Pellets W,1498,6,13,6,17,53,57,-4,45
SV Josko Rie,1498,7,11,8,17,37,48,-11,41
Mattersburg,1498,8,10,11,15,38,53,-15,41
Admira Wacke,1498,9,10,8,18,33,67,-34,38
St. Pölten,1498,10,7,11,18,44,65,-21,32
FC Salzburg,1499,1,22,5,9,66,29,37,71
SC Rheindorf,1499,2,19,7,10,58,44,14,64
Vienna,1499,3,19,6,11,62,52,10,63
SK Sturm Gra,1499,4,16,11,9,53,33,20,59
Rapid Vienna,1499,5,15,11,10,56,39,17,56
RZ Pellets W,1499,6,12,9,15,42,51,-9,45
Admira Wacke,1499,7,11,7,18,33,57,-24,40
SV Josko Rie,1499,8,10,8,18,33,52,-19,38
St. Pölten,1499,9,9,10,17,44,65,-21,37
Mattersburg,1499,10,6,8,22,39,64,-25,26
FC Salzburg,1500,1,20,9,7,62,28,34,69
SK Sturm Gra,1500,2,20,7,9,63,33,30,67
Vienna,1500,3,20,3,13,62,50,12,63
SC Rheindorf,1500,4,18,8,10,51,40,11,62
Rapid Vienna,1500,5,16,12,8,60,36,24,60
RZ Pellets W,1500,6,11,7,18,42,58,-16,40
SV Josko Rie,1500,7,11,6,19,36,57,-21,39
Admira Wacke,1500,8,10,9,17,37,59,-22,39
Mattersburg,1500,9,8,9,19,33,54,-21,33
St. Pölten,1500,10,6,10,20,36,67,-31,28
FC Salzburg,1501,1,21,7,8,67,33,34,70
SC Rheindorf,1501,2,19,7,10,58,41,17,64
SK Sturm Gra,1501,3,18,7,11,58,40,18,61
Rapid Vienna,1501,4,13,15,8,53,35,18,54
Vienna,1501,5,16,6,14,61,60,1,54
St. Pölten,1501,6,13,8,15,42,56,-14,47
RZ Pellets W,1501,7,10,9,17,42,52,-10,39
Mattersburg,1501,8,10,8,18,40,53,-13,38
SV Josko Rie,1501,9,11,5,20,36,57,-21,38
Admira Wacke,1501,10,11,4,21,33,63,-30,37
SK Sturm Gra,1502,1,20,8,8,63,37,26,68
FC Salzburg,1502,2,18,11,7,61,33,28,65
SC Rheindorf,1502,3,19,8,9,64,51,13,65
Vienna,1502,4,15,8,13,55,52,3,53
Rapid Vienna,1502,5,13,12,11,54,41,13,51
RZ Pellets W,1502,6,9,12,15,41,54,-13,39
Admira Wacke,1502,7,9,12,15,37,55,-18,39
SV Josko Rie,1502,8,10,9,17,36,55,-19,39
Mattersburg,1502,9,8,11,17,41,54,-13,35
St. Pölten,1502,10,8,11,17,43,63,-20,35
FC Salzburg,1503,1,21,7,8,70,36,34,70
Vienna,1503,2,22,4,10,68,52,16,70
SC Rheindorf,1503,3,20,8,8,53,39,14,68
SK Sturm Gra,1503,4,20,5,11,58,30,28,65
Rapid Vienna,1503,5,15,11,10,55,40,15,56
RZ Pellets W,1503,6,12,7,17,45,56,-11,43
Admira Wacke,1503,7,13,4,19,41,65,-24,43
SV Josko Rie,1503,8,10,5,21,36,57,-21,35
St. Pölten,1503,9,7,10,19,39,63,-24,31
Mattersburg,1503,10,5,9,22,32,59,-27,24
SC Rheindorf,1504,1,23,6,7,62,37,25,75
FC Salzburg,1504,2,21,6,9,64,33,31,69
Vienna,1504,3,17,8,11,63,52,11,59
SK Sturm Gra,1504,4,17,6,13,61,39,22,57
Rapid Vienna,1504,5,12,12,12,52,42,10,48
Admira Wacke,1504,6,13,5,18,38,66,-28,44
RZ Pellets W,1504,7,11,9,16,48,56,-8,42
SV Josko Rie,1504,8,11,6,19,35,49,-14,39
Mattersburg,1504,9,9,8,19,37,60,-23,35
St. Pölten,1504,10,9,8,19,38,64,-26,35
FC Salzburg,1505,1,21,9,6,68,28,40,72
Vienna,1505,2,20,3,13,59,52,7,63
SC Rheindorf,1505,3,17,8,11,46,39,7,59
SK Sturm Gra,1505,4,15,7,14,53,39,14,52
Rapid Vienna,1505,5,14,10,12,54,41,13,52
RZ Pellets W,1505,6,12,10,14,48,52,-4,46
Admira Wacke,1505,7,13,6,17,37,57,-20,45
St. Pölten,1505,8,10,10,16,39,61,-22,40
SV Josko Rie,1505,9,11,6,19,36,52,-16,39
Mattersburg,1505,10,8,9,19,39,58,-19,33
FC Salzburg,1506,1,22,6,8,65,27,38,72
SC Rheindorf,1506,2,20,9,7,57,42,15,69
Rapid Vienna,1506,3,16,9,11,58,41,17,57
Vienna,1506,4,16,6,14,58,54,4,54
Admira Wacke,1506,5,16,6,14,47,57,-10,54
SK Sturm Gra,1506,6,14,9,13,51,39,12,51
RZ Pellets W,1506,7,11,9,16,44,55,-11,42
SV Josko Rie,1506,8,11,6,19,37,48,-11,39
Mattersburg,1506,9,8,9,19,37,59,-22,33
St. Pölten,1506,10,8,7,21,37,69,-32,31
SC Rheindorf,1507,1,22,7,7,56,34,22,73
SK Sturm Gra,1507,2,21,6,9,53,28,25,69
Vienna,1507,3,21,5,10,66,46,20,68
FC Salzburg,1507,4,19,9,8,67,37,30,66
Rapid Vienna,1507,5,14,11,11,54,40,14,53
RZ Pellets W,1507,6,13,5,18,43,57,-14,44
Admira Wacke,1507,7,10,8,18,34,59,-25,38
SV Josko Rie,1507,8,10,6,20,32,51,-19,36
St. Pölten,1507,9,8,9,19,34,58,-24,33
Mattersburg,1507,10,5,8,23,30,59,-29,23
SK Sturm Gra,1508,1,19,8,9,56,29,27,65
SC Rheindorf,1508,2,18,11,7,60,47,13,65
FC Salzburg,1508,3,18,9,9,61,35,26,63
Vienna,1508,4,17,6,13,60,51,9,57
Rapid Vienna,1508,5,13,14,9,63,39,24,53
Admira Wacke,1508,6,12,8,16,37,54,-17,44
SV Josko Rie,1508,7,11,7,18,42,66,-24,40
RZ Pellets W,1508,8,9,10,17,39,58,-19,37
St. Pölten,1508,9,8,11,17,49,68,-19,35
Mattersburg,1508,10,8,10,18,39,59,-20,34
FC Salzburg,1509,1,20,8,8,63,33,30,68
Vienna,1509,2,21,3,12,68,51,17,66
SC Rheindorf,1509,3,20,6,10,54,42,12,66
SK Sturm Gra,1509,4,20,5,11,70,34,36,65
Rapid Vienna,1509,5,16,11,9,61,41,20,59
Admira Wacke,1509,6,12,7,17,39,66,-27,43
RZ Pellets W,1509,7,12,5,19,44,63,-19,41
St. Pölten,1509,8,9,8,19,43,62,-19,35
SV Josko Rie,1509,9,10,5,21,29,51,-22,35
Mattersburg,1509,10,7,8,21,32,60,-28,29
FC Salzburg,1510,1,24,6,6,77,28,49,78
SC Rheindorf,1510,2,18,7,11,55,45,10,61
SK Sturm Gra,1510,3,17,9,10,54,38,16,60
Vienna,1510,4,17,5,14,57,49,8,56
Rapid Vienna,1510,5,14,9,13,53,44,9,51
RZ Pellets W,1510,6,12,9,15,41,55,-14,45
SV Josko Rie,1510,7,12,5,19,37,51,-14,41
Admira Wacke,1510,8,11,5,20,32,57,-25,38
St. Pölten,1510,9,8,12,16,41,60,-19,36
Mattersburg,1510,10,9,9,18,40,60,-20,36
FC Salzburg,1511,1,24,4,8,76,30,46,76
SK Sturm Gra,1511,2,23,3,10,62,36,26,72
Vienna,1511,3,20,4,12,62,50,12,64
SC Rheindorf,1511,4,17,8,11,55,40,15,59
RZ Pellets W,1511,5,16,5,15,49,50,-1,53
Rapid Vienna,1511,6,10,12,14,44,41,3,42
Admira Wacke,1511,7,12,5,19,36,60,-24,41
SV Josko Rie,1511,8,12,4,20,36,54,-18,40
St. Pölten,1511,9,9,8,19,36,63,-27,35
Mattersburg,1511,10,7,7,22,32,64,-32,28
FC Salzburg,1512,1,23,9,4,72,27,45,78
Vienna,1512,2,19,6,11,63,48,15,63
SC Rheindorf,1512,3,19,6,11,56,47,9,63
SK Sturm Gra,1512,4,17,8,11,54,37,17,59
Rapid Vienna,1512,5,12,13,11,52,40,12,49
RZ Pellets W,1512,6,14,6,16,53,54,-1,48
St. Pölten,1512,7,12,9,15,43,59,-16,45
Admira Wacke,1512,8,11,6,19,40,63,-23,39
SV Josko Rie,1512,9,9,6,21,32,59,-27,33
Mattersburg,1512,10,5,9,22,31,62,-31,24
FC Salzburg,1513,1,20,9,7,63,32,31,69
Vienna,1513,2,20,4,12,66,49,17,64
SC Rheindorf,1513,3,19,6,11,60,49,11,63
SK Sturm Gra,1513,4,17,7,12,53,30,23,58
Rapid Vienna,1513,5,16,9,11,60,43,17,57
RZ Pellets W,1513,6,13,7,16,45,57,-12,46
Admira Wacke,1513,7,10,9,17,40,56,-16,39
SV Josko Rie,1513,8,11,6,19,36,54,-18,39
St. Pölten,1513,9,7,13,16,39,63,-24,34
Mattersburg,1513,10,7,10,19,37,66,-29,31
SC Rheindorf,1514,1,22,7,7,60,37,23,73
Vienna,1514,2,21,4,11,68,50,18,67
FC Salzburg,1514,3,17,11,8,62,37,25,62
SK Sturm Gra,1514,4,16,6,14,54,38,16,54
Rapid Vienna,1514,5,14,8,14,52,42,10,50
RZ Pellets W,1514,6,14,8,14,53,50,3,50
SV Josko Rie,1514,7,14,3,19,37,55,-18,45
Admira Wacke,1514,8,12,7,17,37,61,-24,43
St. Pölten,1514,9,8,8,20,38,63,-25,32
Mattersburg,1514,10,6,10,20,29,57,-28,28
Vienna,1515,1,23,5,8,76,51,25,74
SK Sturm Gra,1515,2,21,6,9,62,32,30,69
FC Salzburg,1515,3,19,5,12,61,36,25,62
SC Rheindorf,1515,4,18,8,10,57,47,10,62
Rapid Vienna,1515,5,15,12,9,56,35,21,57
RZ Pellets W,1515,6,12,7,17,47,64,-17,43
SV Josko Rie,1515,7,11,5,20,38,60,-22,38
Admira Wacke,1515,8,11,5,20,41,64,-23,38
Mattersburg,1515,9,7,11,18,38,59,-21,32
St. Pölten,1515,10,6,10,20,42,70,-28,28
FC Salzburg,1516,1,23,5,8,64,28,36,74
SC Rheindorf,1516,2,20,8,8,58,38,20,68
SK Sturm Gra,1516,3,18,7,11,58,36,22,61
Vienna,1516,4,18,6,12,59,49,10,60
RZ Pellets W,1516,5,14,6,16,48,53,-5,48
Rapid Vienna,1516,6,12,10,14,44,42,2,46
Mattersburg,1516,7,13,5,18,42,54,-12,44
SV Josko Rie,1516,8,11,4,21,32,51,-19,37
St. Pölten,1516,9,9,8,19,39,62,-23,35
Admira Wacke,1516,10,10,5,21,34,65,-31,35
SC Rheindorf,1517,1,21,7,8,55,37,18,70
FC Salzburg,1517,2,19,10,7,63,33,30,67
SK Sturm Gra,1517,3,19,6,11,62,35,27,63
Vienna,1517,4,16,7,13,59,55,4,55
Rapid Vienna,1517,5,11,13,12,54,44,10,46
RZ Pellets W,1517,6,12,7,17,44,62,-18,43
SV Josko Rie,1517,7,11,9,16,35,51,-16,42
St. Pölten,1517,8,9,11,16,48,63,-15,38
Mattersburg,1517,9,9,9,18,38,54,-16,36
Admira Wacke,1517,10,9,9,18,38,62,-24,36
SC Rheindorf,1518,1,22,9,5,62,40,22,75
SK Sturm Gra,1518,2,19,9,8,59,34,25,66
FC Salzburg,1518,3,19,8,9,62,33,29,65
Vienna,1518,4,17,7,12,52,48,4,58
Rapid Vienna,1518,5,15,7,14,55,44,11,52
RZ Pellets W,1518,6,15,5,16,51,53,-2,50
SV Josko Rie,1518,7,13,2,21,41,54,-13,41
Mattersburg,1518,8,10,8,18,40,58,-18,38
Admira Wacke,1518,9,10,6,20,35,59,-24,36
St. Pölten,1518,10,5,9,22,32,66,-34,24
FC Salzburg,1519,1,20,7,9,62,36,26,67
SK Sturm Gra,1519,2,20,4,12,58,41,17,64
SC Rheindorf,1519,3,18,9,9,53,41,12,63
Rapid Vienna,1519,4,16,9,11,53,37,16,57
Vienna,1519,5,16,5,15,57,52,5,53
Admira Wacke,1519,6,14,7,15,44,57,-13,49
RZ Pellets W,1519,7,14,5,17,48,55,-7,47
SV Josko Rie,1519,8,11,6,19,34,50,-16,39
St. Pölten,1519,9,8,10,18,35,58,-23,34
Mattersburg,1519,10,8,8,20,36,53,-17,32
FC Salzburg,1520,1,21,7,8,71,32,39,70
SC Rheindorf,1520,2,18,10,8,54,37,17,64
SK Sturm Gra,1520,3,19,5,12,61,36,25,62
Vienna,1520,4,18,4,14,58,54,4,58
Admira Wacke,1520,5,14,8,14,40,51,-11,50
Rapid Vienna,1520,6,12,11,13,53,50,3,47
St. Pölten,1520,7,11,9,16,39,60,-21,42
RZ Pellets W,1520,8,11,7,18,49,62,-13,40
Mattersburg,1520,9,10,6,20,41,61,-20,36
SV Josko Rie,1520,10,10,5,21,34,57,-23,35
SC Rheindorf,1521,1,20,10,6,54,34,20,70
FC Salzburg,1521,2,19,10,7,64,34,30,67
Vienna,1521,3,18,5,13,59,50,9,59
SK Sturm Gra,1521,4,17,7,12,52,37,15,58
Rapid Vienna,1521,5,14,12,10,57,39,18,54
Admira Wacke,1521,6,14,7,15,47,56,-9,49
RZ Pellets W,1521,7,11,7,18,40,56,-16,40
St. Pölten,1521,8,10,8,18,39,58,-19,38
SV Josko Rie,1521,9,10,5,21,33,54,-21,35
Mattersburg,1521,10,7,9,20,33,60,-27,30
FC Salzburg,1522,1,21,8,7,68,29,39,71
Vienna,1522,2,21,4,11,69,55,14,67
SC Rheindorf,1522,3,18,10,8,54,36,18,64
SK Sturm Gra,1522,4,18,7,11,55,38,17,61
Rapid Vienna,1522,5,12,12,12,52,37,15,48
Admira Wacke,1522,6,13,6,17,39,60,-21,45
SV Josko Rie,1522,7,12,4,20,39,55,-16,40
RZ Pellets W,1522,8,10,6,20,43,64,-21,36
Mattersburg,1522,9,9,8,19,42,63,-21,35
St. Pölten,1522,10,8,11,17,44,68,-24,35
FC Salzburg,1523,1,21,9,6,66,26,40,72
Vienna,1523,2,19,7,10,70,53,17,64
SK Sturm Gra,1523,3,18,6,12,60,40,20,60
SC Rheindorf,1523,4,18,6,12,52,55,-3,60
Admira Wacke,1523,5,17,7,12,47,49,-2,58
Rapid Vienna,1523,6,13,10,13,55,36,19,49
RZ Pellets W,1523,7,11,8,17,39,55,-16,41
Mattersburg,1523,8,9,8,19,41,59,-18,35
SV Josko Rie,1523,9,9,5,22,33,61,-28,32
St. Pölten,1523,10,7,10,19,42,71,-29,31
SK Sturm Gra,1524,1,21,8,7,64,33,31,71
FC Salzburg,1524,2,20,8,8,67,32,35,68
Vienna,1524,3,19,5,12,60,53,7,62
SC Rheindorf,1524,4,17,9,10,50,43,7,60
Admira Wacke,1524,5,13,7,16,39,58,-19,46
Rapid Vienna,1524,6,12,9,15,55,48,7,45
RZ Pellets W,1524,7,12,7,17,53,61,-8,43
St. Pölten,1524,8,9,12,15,46,57,-11,39
Mattersburg,1524,9,9,9,18,43,61,-18,36
SV Josko Rie,1524,10,7,8,21,35,66,-31,29
SK Sturm Gra,1525,1,21,7,8,59,29,30,70
FC Salzburg,1525,2,19,8,9,58,28,30,65
SC Rheindorf,1525,3,17,8,11,51,45,6,59
Vienna,1525,4,17,7,12,64,50,14,58
Rapid Vienna,1525,5,16,9,11,56,34,22,57
RZ Pellets W,1525,6,13,6,17,50,63,-13,45
SV Josko Rie,1525,7,12,7,17,31,46,-15,43
St. Pölten,1525,8,10,10,16,40,56,-16,40
Admira Wacke,1525,9,10,4,22,30,63,-33,34
Mattersburg,1525,10,6,12,18,33,58,-25,30
FC Salzburg,1526,1,21,10,5,67,25,42,73
SC Rheindorf,1526,2,20,8,8,56,37,19,68
SK Sturm Gra,1526,3,20,5,11,60,34,26,65
Vienna,1526,4,15,8,13,61,57,4,53
Rapid Vienna,1526,5,13,10,13,52,45,7,49
RZ Pellets W,1526,6,13,6,17,45,56,-11,45
SV Josko Rie,1526,7,11,10,15,40,56,-16,43
Admira Wacke,1526,8,12,7,17,38,57,-19,43
St. Pölten,1526,9,7,11,18,34,56,-22,32
Mattersburg,1526,10,6,9,21,33,63,-30,27
FC Salzburg,1527,1,21,9,6,71,35,36,72
SC Rheindorf,1527,2,21,9,6,68,43,25,72
SK Sturm Gra,1527,3,19,5,12,55,38,17,62
Vienna,1527,4,17,6,13,66,57,9,57
Rapid Vienna,1527,5,14,11,11,52,42,10,53
Admira Wacke,1527,6,12,7,17,39,56,-17,43
RZ Pellets W,1527,7,11,9,16,43,60,-17,42
SV Josko Rie,1527,8,10,5,21,35,59,-24,35
St. Pölten,1527,9,8,9,19,42,62,-20,33
Mattersburg,1527,10,7,10,19,38,57,-19,31
Vienna,1528,1,22,5,9,73,41,32,71
SC Rheindorf,1528,2,20,8,8,57,42,15,68
FC Salzburg,1528,3,19,8,9,62,34,28,65
SK Sturm Gra,1528,4,18,10,8,58,37,21,64
Rapid Vienna,1528,5,14,10,12,54,46,8,52
Admira Wacke,1528,6,12,7,17,36,56,-20,43
RZ Pellets W,1528,7,11,8,17,49,56,-7,41
SV Josko Rie,1528,8,12,3,21,38,57,-19,39
Mattersburg,1528,9,6,11,19,32,56,-24,29
St. Pölten,1528,10,7,8,21,42,76,-34,29
SC Rheindorf,1529,1,24,5,7,63,38,25,77
FC Salzburg,1529,2,20,8,8,67,37,30,68
SK Sturm Gra,1529,3,20,4,12,64,37,27,64
Vienna,1529,4,18,5,13,61,51,10,59
Rapid Vienna,1529,5,15,9,12,53,33,20,54
RZ Pellets W,1529,6,11,6,19,40,65,-25,39
St. Pölten,1529,7,10,8,18,46,63,-17,38
SV Josko Rie,1529,8,11,5,20,35,56,-21,38
Mattersburg,1529,9,9,9,18,41,58,-17,36
Admira Wacke,1529,10,10,5,21,31,63,-32,35
FC Salzburg,1530,1,22,8,6,74,29,45,74
SC Rheindorf,1530,2,20,6,10,57,50,7,66
SK Sturm Gra,1530,3,19,5,12,60,39,21,62
Vienna,1530,4,17,6,13,60,58,2,57
Rapid Vienna,1530,5,12,11,13,61,51,10,47
RZ Pellets W,1530,6,13,7,16,51,57,-6,46
SV Josko Rie,1530,7,12,7,17,40,50,-10,43
St. Pölten,1530,8,11,8,17,43,60,-17,41
Admira Wacke,1530,9,10,7,19,37,61,-24,37
Mattersburg,1530,10,7,9,20,36,64,-28,30
SC Rheindorf,1531,1,20,6,10,54,39,15,66
FC Salzburg,1531,2,18,9,9,68,38,30,63
SK Sturm Gra,1531,3,18,7,11,56,40,16,61
Rapid Vienna,1531,4,14,13,9,63,41,22,55
Vienna,1531,5,15,5,16,57,56,1,50
RZ Pellets W,1531,6,13,9,14,43,53,-10,48
Admira Wacke,1531,7,13,6,17,39,61,-22,45
St. Pölten,1531,8,11,9,16,47,59,-12,42
Mattersburg,1531,9,10,7,19,45,59,-14,37
SV Josko Rie,1531,10,10,5,21,32,58,-26,35
FC Salzburg,1532,1,21,9,6,61,30,31,72
SC Rheindorf,1532,2,21,7,8,57,40,17,70
SK Sturm Gra,1532,3,18,9,9,54,31,23,63
Vienna,1532,4,17,4,15,55,52,3,55
Rapid Vienna,1532,5,12,12,12,51,37,14,48
RZ Pellets W,1532,6,11,10,15,39,50,-11,43
Mattersburg,1532,7,10,9,17,44,54,-10,39
SV Josko Rie,1532,8,10,8,18,40,60,-20,38
Admira Wacke,1532,9,9,10,17,36,58,-22,37
St. Pölten,1532,10,6,12,18,38,63,-25,30
FC Salzburg,1533,1,23,7,6,65,23,42,76
SC Rheindorf,1533,2,20,6,10,58,38,20,66
SK Sturm Gra,1533,3,18,6,12,62,37,25,60
Vienna,1533,4,18,6,12,57,50,7,60
Rapid Vienna,1533,5,16,8,12,60,39,21,56
RZ Pellets W,1533,6,10,11,15,47,57,-10,41
Admira Wacke,1533,7,10,9,17,32,60,-28,39
Mattersburg,1533,8,10,7,19,34,58,-24,37
SV Josko Rie,1533,9,9,7,20,30,55,-25,34
St. Pölten,1533,10,8,9,19,40,68,-28,33
FC Salzburg,1534,1,22,8,6,71,30,41,74
SK Sturm Gra,1534,2,17,10,9,57,34,23,61
Vienna,1534,3,18,7,11,63,49,14,61
SC Rheindorf,1534,4,16,9,11,46,41,5,57
Rapid Vienna,1534,5,15,9,12,56,40,16,54
RZ Pellets W,1534,6,15,9,12,49,44,5,54
SV Josko Rie,1534,7,10,9,17,35,50,-15,39
Mattersburg,1534,8,9,9,18,35,60,-25,36
Admira Wacke,1534,9,10,4,22,35,63,-28,34
St. Pölten,1534,10,7,8,21,36,72,-36,29
SC Rheindorf,1535,1,18,12,6,57,39,18,66
FC Salzburg,1535,2,19,8,9,59,33,26,65
SK Sturm Gra,1535,3,19,7,10,62,41,21,64
Vienna,1535,4,19,6,11,72,52,20,63
Rapid Vienna,1535,5,12,12,12,54,44,10,48
Admira Wacke,1535,6,11,9,16,37,59,-22,42
St. Pölten,1535,7,9,12,15,48,59,-11,39
RZ Pellets W,1535,8,9,12,15,46,66,-20,39
SV Josko Rie,1535,9,9,7,20,33,53,-20,34
Mattersburg,1535,10,8,9,19,34,56,-22,33
FC Salzburg,1536,1,22,6,8,73,32,41,72
SC Rheindorf,1536,2,20,8,8,58,43,15,68
SK Sturm Gra,1536,3,19,5,12,57,38,19,62
Vienna,1536,4,18,6,12,66,50,16,60
Rapid Vienna,1536,5,15,11,10,60,37,23,56
SV Josko Rie,1536,6,12,4,20,37,59,-22,40
RZ Pellets W,1536,7,11,6,19,43,64,-21,39
Mattersburg,1536,8,9,11,16,39,56,-17,38
St. Pölten,1536,9,9,8,19,37,61,-24,35
Admira Wacke,1536,10,10,5,21,34,64,-30,35
FC Salzburg,1537,1,22,9,5,64,25,39,75
SC Rheindorf,1537,2,20,6,10,57,48,9,66
SK Sturm Gra,1537,3,19,5,12,52,33,19,62
Vienna,1537,4,18,4,14,63,56,7,58
Rapid Vienna,1537,5,13,11,12,46,36,10,50
RZ Pellets W,1537,6,12,10,14,43,48,-5,46
Admira Wacke,1537,7,12,6,18,36,56,-20,42
Mattersburg,1537,8,9,10,17,36,54,-18,37
St. Pölten,1537,9,9,9,18,40,59,-19,36
SV Josko Rie,1537,10,8,6,22,29,51,-22,30
FC Salzburg,1538,1,23,5,8,69,33,36,74
SK Sturm Gra,1538,2,22,6,8,61,29,32,72
SC Rheindorf,1538,3,21,8,7,54,36,18,71
Rapid Vienna,1538,4,15,12,9,57,40,17,57
Vienna,1538,5,15,4,17,50,53,-3,49
Admira Wacke,1538,6,12,6,18,41,56,-15,42
RZ Pellets W,1538,7,11,7,18,45,59,-14,40
Mattersburg,1538,8,10,6,20,39,57,-18,36
St. Pölten,1538,9,6,15,15,36,57,-21,33
SV Josko Rie,1538,10,7,7,22,31,63,-32,28
SC Rheindorf,1539,1,20,8,8,50,34,16,68
FC Salzburg,1539,2,19,9,8,57,29,28,66
SK Sturm Gra,1539,3,19,5,12,59,33,26,62
Rapid Vienna,1539,4,17,9,10,52,33,19,60
Vienna,1539,5,17,5,14,65,60,5,56
RZ Pellets W,1539,6,13,9,14,51,54,-3,48
Mattersburg,1539,7,10,7,19,42,58,-16,37
Admira Wacke,1539,8,10,7,19,35,58,-23,37
SV Josko Rie,1539,9,9,8,19,34,58,-24,35
St. Pölten,1539,10,8,9,19,38,66,-28,33
FC Salzburg,1540,1,21,9,6,67,34,33,72
SK Sturm Gra,1540,2,20,8,8,64,32,32,68
SC Rheindorf,1540,3,17,11,8,54,41,13,62
Vienna,1540,4,18,4,14,64,57,7,58
RZ Pellets W,1540,5,14,8,14,47,55,-8,50
SV Josko Rie,1540,6,14,7,15,45,50,-5,49
Rapid Vienna,1540,7,12,10,14,61,50,11,46
Admira Wacke,1540,8,10,8,18,36,61,-25,38
Mattersburg,1540,9,8,7,21,41,66,-25,31
St. Pölten,1540,10,5,10,21,41,74,-33,25
FC Salzburg,1541,1,21,8,7,67,31,36,71
SK Sturm Gra,1541,2,22,5,9,61,26,35,71
Vienna,1541,3,20,5,11,59,45,14,65
SC Rheindorf,1541,4,17,10,9,52,46,6,61
Rapid Vienna,1541,5,13,10,13,52,43,9,49
RZ Pellets W,1541,6,14,7,15,53,57,-4,49
SV Josko Rie,1541,7,11,6,19,32,48,-16,39
Admira Wacke,1541,8,10,8,18,39,58,-19,38
St. Pölten,1541,9,9,8,19,38,65,-27,35
Mattersburg,1541,10,4,11,21,30,64,-34,23
FC Salzburg,1542,1,22,8,6,69,26,43,74
SK Sturm Gra,1542,2,21,6,9,59,31,28,69
SC Rheindorf,1542,3,21,5,10,58,51,7,68
Vienna,1542,4,18,6,12,62,54,8,60
Rapid Vienna,1542,5,13,10,13,52,44,8,49
St. Pölten,1542,6,11,8,17,45,59,-14,41
SV Josko Rie,1542,7,12,4,20,42,60,-18,40
RZ Pellets W,1542,8,10,9,17,39,51,-12,39
Admira Wacke,1542,9,8,8,20,35,61,-26,32
Mattersburg,1542,10,7,10,19,33,57,-24,31
FC Salzburg,1543,1,19,9,8,59,30,29,66
SC Rheindorf,1543,2,17,10,9,52,43,9,61
SK Sturm Gra,1543,3,18,6,12,64,47,17,60
Rapid Vienna,1543,4,16,10,10,57,38,19,58
Vienna,1543,5,17,6,13,64,52,12,57
RZ Pellets W,1543,6,14,5,17,45,55,-10,47
SV Josko Rie,1543,7,13,7,16,38,54,-16,46
Mattersburg,1543,8,10,8,18,39,57,-18,38
Admira Wacke,1543,9,10,7,19,36,54,-18,37
St. Pölten,1543,10,6,12,18,44,68,-24,30
FC Salzburg,1544,1,20,10,6,58,25,33,70
SC Rheindorf,1544,2,18,10,8,52,40,12,64
SK Sturm Gra,1544,3,19,6,11,63,36,27,63
Vienna,1544,4,16,6,14,73,67,6,54
Rapid Vienna,1544,5,11,12,13,54,46,8,45
Admira Wacke,1544,6,12,9,15,45,56,-11,45
SV Josko Rie,1544,7,13,5,18,43,55,-12,44
Mattersburg,1544,8,9,12,15,36,53,-17,39
RZ Pellets W,1544,9,10,8,18,43,66,-23,38
St. Pölten,1544,10,7,12,17,47,70,-23,33
FC Salzburg,1545,1,22,7,7,70,25,45,73
SC Rheindorf,1545,2,22,6,8,57,34,23,72
Vienna,1545,3,21,4,11,66,53,13,67
SK Sturm Gra,1545,4,19,6,11,57,33,24,63
Rapid Vienna,1545,5,12,13,11,45,33,12,49
RZ Pellets W,1545,6,11,8,17,47,64,-17,41
St. Pölten,1545,7,8,14,14,36,56,-20,38
Mattersburg,1545,8,8,10,18,33,54,-21,34
SV Josko Rie,1545,9,9,5,22,29,53,-24,32
Admira Wacke,1545,10,9,5,22,34,69,-35,32
FC Salzburg,1546,1,20,10,6,66,29,37,70
SK Sturm Gra,1546,2,19,8,9,54,29,25,65
Vienna,1546,3,19,5,12,66,49,17,62
SC Rheindorf,1546,4,17,8,11,57,45,12,59
Rapid Vienna,1546,5,13,12,11,53,42,11,51
Mattersburg,1546,6,11,9,16,40,52,-12,42
SV Josko Rie,1546,7,12,4,20,45,62,-17,40
RZ Pellets W,1546,8,11,6,19,39,59,-20,39
Admira Wacke,1546,9,10,8,18,34,63,-29,38
St. Pölten,1546,10,7,12,17,36,60,-24,33
FC Salzburg,1547,1,20,9,7,66,35,31,69
SK Sturm Gra,1547,2,20,6,10,55,33,22,66
Rapid Vienna,1547,3,15,13,8,56,36,20,58
SC Rheindorf,1547,4,16,10,10,60,51,9,58
Vienna,1547,5,17,5,14,73,60,13,56
RZ Pellets W,1547,6,14,6,16,52,56,-4,48
Admira Wacke,1547,7,12,6,18,37,59,-22,42
St. Pölten,1547,8,9,10,17,40,61,-21,37
SV Josko Rie,1547,9,10,7,19,39,60,-21,37
Mattersburg,1547,10,7,8,21,35,62,-27,29
FC Salzburg,1548,1,20,7,9,60,33,27,67
Rapid Vienna,1548,2,18,9,9,57,34,23,63
Vienna,1548,3,19,6,11,62,46,16,63
SK Sturm Gra,1548,4,19,5,12,50,31,19,62
SC Rheindorf,1548,5,18,6,12,58,47,11,60
RZ Pellets W,1548,6,13,6,17,48,60,-12,45
St. Pölten,1548,7,11,9,16,43,58,-15,42
Admira Wacke,1548,8,10,8,18,34,60,-26,38
SV Josko Rie,1548,9,10,5,21,40,60,-20,35
Mattersburg,1548,10,9,5,22,31,54,-23,32
FC Salzburg,1549,1,21,7,8,67,31,36,70
SC Rheindorf,1549,2,21,4,11,55,42,13,67
Vienna,1549,3,19,6,11,67,50,17,63
SK Sturm Gra,1549,4,19,5,12,56,38,18,62
Rapid Vienna,1549,5,14,10,12,56,43,13,52
RZ Pellets W,1549,6,14,6,16,47,50,-3,48
Admira Wacke,1549,7,14,4,18,42,58,-16,46
Mattersburg,1549,8,8,10,18,32,55,-23,34
SV Josko Rie,1549,9,10,4,22,34,59,-25,34
St. Pölten,1549,10,7,10,19,37,67,-30,31
SC Rheindorf,1550,1,24,7,5,63,35,28,79
FC Salzburg,1550,2,18,9,9,59,33,26,63
SK Sturm Gra,1550,3,18,8,10,60,36,24,62
Vienna,1550,4,19,4,13,60,57,3,61
Rapid Vienna,1550,5,11,15,10,56,44,12,48
RZ Pellets W,1550,6,14,5,17,53,60,-7,47
SV Josko Rie,1550,7,11,4,21,34,53,-19,37
Admira Wacke,1550,8,9,9,18,31,55,-24,36
Mattersburg,1550,9,8,10,18,41,57,-16,34
St. Pölten,1550,10,8,9,19,37,64,-27,33
FC Salzburg,1551,1,22,7,7,60,25,35,73
SK Sturm Gra,1551,2,19,7,10,63,38,25,64
Vienna,1551,3,20,3,13,63,53,10,63
SC Rheindorf,1551,4,19,5,12,55,44,11,62
RZ Pellets W,1551,5,15,8,13,54,50,4,53
Rapid Vienna,1551,6,12,11,13,50,40,10,47
SV Josko Rie,1551,7,12,3,21,34,57,-23,39
Admira Wacke,1551,8,11,5,20,35,61,-26,38
Mattersburg,1551,9,9,9,18,33,53,-20,36
St. Pölten,1551,10,7,10,19,40,66,-26,31
FC Salzburg,1552,1,22,6,8,70,32,38,72
SK Sturm Gra,1552,2,20,7,9,58,30,28,67
SC Rheindorf,1552,3,17,13,6,52,37,15,64
Vienna,1552,4,17,7,12,64,60,4,58
RZ Pellets W,1552,5,16,6,14,51,51,0,54
Rapid Vienna,1552,6,12,9,15,53,52,1,45
Admira Wacke,1552,7,10,9,17,39,56,-17,39
SV Josko Rie,1552,8,10,6,20,35,51,-16,36
Mattersburg,1552,9,8,9,19,33,58,-25,33
St. Pölten,1552,10,7,10,19,39,67,-28,31
SK Sturm Gra,1553,1,22,6,8,73,35,38,72
SC Rheindorf,1553,2,20,9,7,63,39,24,69
FC Salzburg,1553,3,18,10,8,58,30,28,64
Vienna,1553,4,15,8,13,57,53,4,53
Rapid Vienna,1553,5,13,11,12,54,41,13,50
RZ Pellets W,1553,6,12,7,17,51,67,-16,43
Admira Wacke,1553,7,11,8,17,33,57,-24,41
SV Josko Rie,1553,8,11,7,18,30,49,-19,40
Mattersburg,1553,9,10,8,18,38,58,-20,38
St. Pölten,1553,10,6,10,20,38,66,-28,28
SK Sturm Gra,1554,1,23,4,9,62,34,28,73
FC Salzburg,1554,2,22,5,9,65,32,33,71
SC Rheindorf,1554,3,20,4,12,57,40,17,64
Rapid Vienna,1554,4,16,9,11,64,38,26,57
Vienna,1554,5,18,3,15,58,52,6,57
RZ Pellets W,1554,6,16,6,14,53,53,0,54
St. Pölten,1554,7,10,9,17,37,57,-20,39
Admira Wacke,1554,8,11,6,19,37,67,-30,39
SV Josko Rie,1554,9,10,5,21,35,60,-25,35
Mattersburg,1554,10,6,5,25,38,73,-35,23
Vienna,1555,1,22,4,10,71,54,17,70
SC Rheindorf,1555,2,20,7,9,61,45,16,67
FC Salzburg,1555,3,19,8,9,62,33,29,65
Rapid Vienna,1555,4,15,11,10,58,41,17,56
SK Sturm Gra,1555,5,14,9,13,55,46,9,51
Admira Wacke,1555,6,12,9,15,45,56,-11,45
RZ Pellets W,1555,7,12,8,16,47,60,-13,44
St. Pölten,1555,8,8,11,17,41,61,-20,35
Mattersburg,1555,9,9,7,20,43,62,-19,34
SV Josko Rie,1555,10,8,8,20,37,62,-25,32
FC Salzburg,1556,1,21,9,6,67,31,36,72
Vienna,1556,2,22,3,11,69,48,21,69
SK Sturm Gra,1556,3,19,7,10,63,37,26,64
SC Rheindorf,1556,4,18,9,9,49,43,6,63
Rapid Vienna,1556,5,11,12,13,53,46,7,45
Admira Wacke,1556,6,11,10,15,38,54,-16,43
RZ Pellets W,1556,7,11,9,16,41,56,-15,42
Mattersburg,1556,8,10,7,19,38,56,-18,37
St. Pölten,1556,9,9,8,19,44,63,-19,35
SV Josko Rie,1556,10,9,4,23,40,68,-28,31
FC Salzburg,1557,1,22,8,6,70,29,41,74
SC Rheindorf,1557,2,20,9,7,53,37,16,69
SK Sturm Gra,1557,3,20,7,9,62,34,28,67
Vienna,1557,4,16,6,14,65,61,4,54
RZ Pellets W,1557,5,13,8,15,46,53,-7,47
Rapid Vienna,1557,6,12,10,14,51,40,11,46
Admira Wacke,1557,7,12,8,16,37,58,-21,44
Mattersburg,1557,8,11,7,18,39,57,-18,40
SV Josko Rie,1557,9,10,7,19,41,60,-19,37
St. Pölten,1557,10,5,8,23,32,67,-35,23
FC Salzburg,1558,1,22,7,7,70,33,37,73
SC Rheindorf,1558,2,21,8,7,69,44,25,71
SK Sturm Gra,1558,3,16,9,11,55,38,17,57
Vienna,1558,4,17,5,14,58,57,1,56
RZ Pellets W,1558,5,13,10,13,48,46,2,49
Rapid Vienna,1558,6,12,12,12,52,44,8,48
St. Pölten,1558,7,10,11,15,42,62,-20,41
Admira Wacke,1558,8,10,6,20,40,65,-25,36
SV Josko Rie,1558,9,9,8,19,31,53,-22,35
Mattersburg,1558,10,8,8,20,45,68,-23,32
FC Salzburg,1559,1,22,10,4,73,29,44,76
SK Sturm Gra,1559,2,21,4,11,59,38,21,67
SC Rheindorf,1559,3,20,7,9,61,47,14,67
Vienna,1559,4,20,3,13,61,54,7,63
Rapid Vienna,1559,5,16,9,11,63,42,21,57
RZ Pellets W,1559,6,13,9,14,50,57,-7,48
Admira Wacke,1559,7,11,5,20,40,66,-26,38
SV Josko Rie,1559,8,9,6,21,37,55,-18,33
Mattersburg,1559,9,7,8,21,38,65,-27,29
St. Pölten,1559,10,6,9,21,38,67,-29,27
FC Salzburg,1560,1,22,6,8,72,32,40,72
Vienna,1560,2,20,5,11,64,52,12,65
SK Sturm Gra,1560,3,20,4,12,61,43,18,64
SC Rheindorf,1560,4,19,7,10,56,39,17,64
Rapid Vienna,1560,5,15,8,13,52,47,5,53
RZ Pellets W,1560,6,12,8,16,49,55,-6,44
SV Josko Rie,1560,7,13,4,19,35,54,-19,43
St. Pölten,1560,8,11,7,18,51,62,-11,40
Admira Wacke,1560,9,9,6,21,36,68,-32,33
Mattersburg,1560,10,8,7,21,40,64,-24,31
FC Salzburg,1561,1,21,7,8,71,32,39,70
SK Sturm Gra,1561,2,19,7,10,60,33,27,64
SC Rheindorf,1561,3,17,10,9,52,46,6,61
Rapid Vienna,1561,4,16,11,9,53,33,20,59
Vienna,1561,5,18,4,14,66,56,10,58
RZ Pellets W,1561,6,13,9,14,47,52,-5,48
Admira Wacke,1561,7,13,5,18,39,67,-28,44
St. Pölten,1561,8,9,10,17,39,56,-17,37
Mattersburg,1561,9,8,7,21,32,60,-28,31
SV Josko Rie,1561,10,8,6,22,36,60,-24,30
FC Salzburg,1562,1,21,10,5,61,23,38,73
SK Sturm Gra,1562,2,23,4,9,67,31,36,73
SC Rheindorf,1562,3,21,7,8,52,34,18,70
Vienna,1562,4,13,6,17,54,57,-3,45
Rapid Vienna,1562,5,10,14,12,46,36,10,44
Admira Wacke,1562,6,12,7,17,33,50,-17,43
RZ Pellets W,1562,7,11,8,17,43,63,-20,41
SV Josko Rie,1562,8,11,7,18,29,47,-18,40
Mattersburg,1562,9,8,11,17,40,58,-18,35
St. Pölten,1562,10,8,10,18,37,63,-26,34
FC Salzburg,1563,1,22,6,8,74,36,38,72
SC Rheindorf,1563,2,21,6,9,62,42,20,69
Vienna,1563,3,22,3,11,66,49,17,69
SK Sturm Gra,1563,4,17,7,12,62,40,22,58
Rapid Vienna,1563,5,13,10,13,52,41,11,49
RZ Pellets W,1563,6,14,6,16,47,53,-6,48
Mattersburg,1563,7,11,6,19,39,59,-20,39
Admira Wacke,1563,8,11,5,20,36,63,-27,38
SV Josko Rie,1563,9,10,5,21,35,59,-24,35
St. Pölten,1563,10,7,10,19,38,69,-31,31
SC Rheindorf,1564,1,21,7,8,59,35,24,70
FC Salzburg,1564,2,19,9,8,58,28,30,66
SK Sturm Gra,1564,3,20,6,10,62,41,21,66
Vienna,1564,4,17,3,16,58,57,1,54
Rapid Vienna,1564,5,13,11,12,53,45,8,50
RZ Pellets W,1564,6,14,7,15,44,53,-9,49
Admira Wacke,1564,7,13,4,19,44,58,-14,43
Mattersburg,1564,8,10,9,17,42,54,-12,39
SV Josko Rie,1564,9,10,4,22,35,55,-20,34
St. Pölten,1564,10,8,10,18,37,66,-29,34
FC Salzburg,1565,1,19,10,7,68,33,35,67
SC Rheindorf,1565,2,19,8,9,53,40,13,65
SK Sturm Gra,1565,3,18,8,10,54,34,20,62
Vienna,1565,4,16,7,13,61,51,10,55
Rapid Vienna,1565,5,13,12,11,54,42,12,51
RZ Pellets W,1565,6,14,7,15,48,56,-8,49
Mattersburg,1565,7,12,6,18,45,54,-9,42
Admira Wacke,1565,8,10,9,17,30,57,-27,39
SV Josko Rie,1565,9,9,8,19,31,50,-19,35
St. Pölten,1565,10,6,13,17,37,64,-27,31
SK Sturm Gra,1566,1,22,7,7,63,27,36,73
FC Salzburg,1566,2,18,10,8,61,35,26,64
SC Rheindorf,1566,3,19,7,10,56,49,7,64
Vienna,1566,4,18,9,9,59,44,15,63
Rapid Vienna,1566,5,14,9,13,64,46,18,51
RZ Pellets W,1566,6,14,6,16,51,57,-6,48
Admira Wacke,1566,7,10,8,18,31,63,-32,38
St. Pölten,1566,8,9,8,19,47,65,-18,35
SV Josko Rie,1566,9,8,9,19,32,57,-25,33
Mattersburg,1566,10,7,9,20,36,57,-21,30
SC Rheindorf,1567,1,21,5,10,59,44,15,68
FC Salzburg,1567,2,19,10,7,68,30,38,67
SK Sturm Gra,1567,3,17,8,11,62,37,25,59
Vienna,1567,4,15,6,15,56,61,-5,51
Admira Wacke,1567,5,12,10,14,40,53,-13,46
Rapid Vienna,1567,6,10,15,11,46,43,3,45
RZ Pellets W,1567,7,11,11,14,47,56,-9,44
Mattersburg,1567,8,10,9,17,41,51,-10,39
SV Josko Rie,1567,9,10,9,17,35,53,-18,39
St. Pölten,1567,10,9,9,18,41,67,-26,36
FC Salzburg,1568,1,20,8,8,67,35,32,68
SK Sturm Gra,1568,2,20,6,10,64,37,27,66
Vienna,1568,3,19,4,13,63,54,9,61
SC Rheindorf,1568,4,16,10,10,54,46,8,58
RZ Pellets W,1568,5,14,9,13,64,61,3,51
SV Josko Rie,1568,6,14,5,17,41,53,-12,47
Rapid Vienna,1568,7,11,11,14,50,44,6,44
Admira Wacke,1568,8,11,6,19,40,67,-27,39
St. Pölten,1568,9,9,10,17,46,69,-23,37
Mattersburg,1568,10,8,7,21,37,60,-23,31
FC Salzburg,1569,1,22,7,7,66,30,36,73
Vienna,1569,2,21,5,10,69,52,17,68
SK Sturm Gra,1569,3,19,7,10,55,31,24,64
SC Rheindorf,1569,4,19,6,11,49,46,3,63
Rapid Vienna,1569,5,12,16,8,54,37,17,52
RZ Pellets W,1569,6,12,6,18,45,57,-12,42
Admira Wacke,1569,7,11,8,17,35,57,-22,41
St. Pölten,1569,8,9,9,18,46,63,-17,36
SV Josko Rie,1569,9,10,5,21,31,52,-21,35
Mattersburg,1569,10,7,7,22,35,60,-25,28
SC Rheindorf,1570,1,22,8,6,63,37,26,74
FC Salzburg,1570,2,20,10,6,60,28,32,70
SK Sturm Gra,1570,3,20,7,9,59,32,27,67
Rapid Vienna,1570,4,16,9,11,57,38,19,57
Vienna,1570,5,16,6,14,57,51,6,54
RZ Pellets W,1570,6,14,9,13,50,49,1,51
Admira Wacke,1570,7,10,8,18,36,60,-24,38
St. Pölten,1570,8,8,12,16,41,64,-23,36
SV Josko Rie,1570,9,10,3,23,30,57,-27,33
Mattersburg,1570,10,5,6,25,30,67,-37,21
SC Rheindorf,1571,1,20,8,8,53,35,18,68
SK Sturm Gra,1571,2,20,6,10,62,36,26,66
FC Salzburg,1571,3,18,9,9,62,35,27,63
Vienna,1571,4,17,5,14,58,50,8,56
SV Josko Rie,1571,5,15,5,16,42,48,-6,50
Admira Wacke,1571,6,15,4,17,43,62,-19,49
RZ Pellets W,1571,7,11,9,16,42,54,-12,42
Rapid Vienna,1571,8,9,11,16,48,50,-2,38
St. Pölten,1571,9,9,10,17,40,60,-20,37
Mattersburg,1571,10,9,7,20,34,54,-20,34
FC Salzburg,1572,1,22,6,8,76,36,40,72
Rapid Vienna,1572,2,17,9,10,60,39,21,60
SC Rheindorf,1572,3,17,8,11,54,49,5,59
Vienna,1572,4,17,6,13,59,51,8,57
SK Sturm Gra,1572,5,16,7,13,51,33,18,55
RZ Pellets W,1572,6,16,6,14,59,51,8,54
Admira Wacke,1572,7,14,3,19,39,61,-22,45
SV Josko Rie,1572,8,10,7,19,37,56,-19,37
St. Pölten,1572,9,10,7,19,39,72,-33,37
Mattersburg,1572,10,7,9,20,32,58,-26,30
SK Sturm Gra,1573,1,22,7,7,73,34,39,73
FC Salzburg,1573,2,20,8,8,63,30,33,68
Vienna,1573,3,20,5,11,65,49,16,65
SC Rheindorf,1573,4,18,8,10,57,47,10,62
Rapid Vienna,1573,5,15,9,12,60,49,11,54
RZ Pellets W,1573,6,13,6,17,47,60,-13,45
SV Josko Rie,1573,7,12,6,18,39,52,-13,42
Admira Wacke,1573,8,11,4,21,36,64,-28,37
St. Pölten,1573,9,9,6,21,32,63,-31,33
Mattersburg,1573,10,5,11,20,36,60,-24,26
FC Salzburg,1574,1,20,8,8,67,33,34,68
SC Rheindorf,1574,2,18,9,9,60,45,15,63
Vienna,1574,3,19,6,11,61,51,10,63
SK Sturm Gra,1574,4,18,6,12,59,41,18,60
RZ Pellets W,1574,5,15,7,14,47,55,-8,52
Rapid Vienna,1574,6,10,11,15,48,43,5,41
St. Pölten,1574,7,9,12,15,40,55,-15,39
SV Josko Rie,1574,8,11,6,19,32,51,-19,39
Admira Wacke,1574,9,10,8,18,35,59,-24,38
Mattersburg,1574,10,8,11,17,42,58,-16,35
FC Salzburg,1575,1,21,7,8,64,33,31,70
SC Rheindorf,1575,2,19,10,7,58,38,20,67
SK Sturm Gra,1575,3,19,8,9,58,33,25,65
Vienna,1575,4,18,9,9,64,46,18,63
Rapid Vienna,1575,5,13,15,8,55,39,16,54
SV Josko Rie,1575,6,13,5,18,47,55,-8,44
Admira Wacke,1575,7,12,7,17,42,67,-25,43
RZ Pellets W,1575,8,9,12,15,38,54,-16,39
Mattersburg,1575,9,6,10,20,30,54,-24,28
St. Pölten,1575,10,5,7,24,35,72,-37,22
SC Rheindorf,1576,1,20,6,10,54,42,12,66
SK Sturm Gra,1576,2,20,5,11,62,36,26,65
Vienna,1576,3,20,5,11,64,48,16,65
FC Salzburg,1576,4,18,6,12,55,33,22,60
Rapid Vienna,1576,5,15,9,12,63,45,18,54
RZ Pellets W,1576,6,13,6,17,48,60,-12,45
Admira Wacke,1576,7,13,6,17,42,59,-17,45
St. Pölten,1576,8,10,10,16,44,59,-15,40
Mattersburg,1576,9,9,9,18,38,53,-15,36
SV Josko Rie,1576,10,9,4,23,27,62,-35,31
SK Sturm Gra,1577,1,21,5,10,66,35,31,68
FC Salzburg,1577,2,21,5,10,64,34,30,68
SC Rheindorf,1577,3,20,6,10,52,38,14,66
Vienna,1577,4,20,4,12,69,54,15,64
Rapid Vienna,1577,5,16,8,12,64,45,19,56
Admira Wacke,1577,6,15,5,16,43,55,-12,50
RZ Pellets W,1577,7,11,6,19,47,67,-20,39
Mattersburg,1577,8,9,8,19,45,65,-20,35
St. Pölten,1577,9,7,11,18,36,62,-26,32
SV Josko Rie,1577,10,9,4,23,31,62,-31,31
FC Salzburg,1578,1,22,8,6,61,28,33,74
SC Rheindorf,1578,2,22,6,8,55,35,20,72
SK Sturm Gra,1578,3,19,8,9,67,35,32,65
Vienna,1578,4,15,8,13,57,50,7,53
Rapid Vienna,1578,5,13,10,13,52,38,14,49
RZ Pellets W,1578,6,12,6,18,39,58,-19,42
Mattersburg,1578,7,10,10,16,41,57,-16,40
SV Josko Rie,1578,8,12,4,20,39,55,-16,40
Admira Wacke,1578,9,10,7,19,32,59,-27,37
St. Pölten,1578,10,7,9,20,39,67,-28,30
FC Salzburg,1579,1,20,10,6,64,31,33,70
Vienna,1579,2,19,7,10,70,53,17,64
SC Rheindorf,1579,3,17,11,8,50,39,11,62
SK Sturm Gra,1579,4,16,9,11,54,29,25,57
Rapid Vienna,1579,5,13,9,14,50,44,6,48
Admira Wacke,1579,6,13,8,15,40,53,-13,47
RZ Pellets W,1579,7,11,9,16,47,54,-7,42
SV Josko Rie,1579,8,11,5,20,41,58,-17,38
St. Pölten,1579,9,9,9,18,36,67,-31,36
Mattersburg,1579,10,9,7,20,36,60,-24,34
FC Salzburg,1580,1,20,6,10,63,33,30,66
SK Sturm Gra,1580,2,18,8,10,54,35,19,62
SC Rheindorf,1580,3,18,7,11,53,47,6,61
Rapid Vienna,1580,4,15,12,9,52,35,17,57
Vienna,1580,5,14,9,13,54,57,-3,51
Admira Wacke,1580,6,13,9,14,49,58,-9,48
RZ Pellets W,1580,7,12,8,16,40,49,-9,44
SV Josko Rie,1580,8,12,3,21,38,53,-15,39
St. Pölten,1580,9,9,9,18,38,61,-23,36
Mattersburg,1580,10,7,13,16,38,51,-13,34
FC Salzburg,1581,1,20,7,9,67,37,30,67
Vienna,1581,2,21,4,11,73,50,23,67
SK Sturm Gra,1581,3,19,8,9,60,33,27,65
SC Rheindorf,1581,4,17,9,10,55,43,12,60
Rapid Vienna,1581,5,16,10,10,61,39,22,58
Admira Wacke,1581,6,13,7,16,44,63,-19,46
RZ Pellets W,1581,7,10,10,16,41,60,-19,40
St. Pölten,1581,8,9,10,17,41,65,-24,37
SV Josko Rie,1581,9,10,4,22,30,60,-30,34
Mattersburg,1581,10,7,7,22,34,56,-22,28
FC Salzburg,1582,1,23,8,5,80,26,54,77
Vienna,1582,2,20,4,12,62,53,9,64
SK Sturm Gra,1582,3,19,6,11,60,36,24,63
SC Rheindorf,1582,4,17,6,13,49,43,6,57
Rapid Vienna,1582,5,12,13,11,51,42,9,49
RZ Pellets W,1582,6,12,6,18,49,58,-9,42
St. Pölten,1582,7,11,9,16,46,63,-17,42
Admira Wacke,1582,8,11,9,16,38,63,-25,42
SV Josko Rie,1582,9,10,6,20,40,59,-19,36
Mattersburg,1582,10,7,9,20,29,61,-32,30
FC Salzburg,1583,1,21,7,8,63,29,34,70
Vienna,1583,2,22,4,10,75,51,24,70
SC Rheindorf,1583,3,16,10,10,50,49,1,58
SK Sturm Gra,1583,4,15,7,14,54,45,9,52
Rapid Vienna,1583,5,11,18,7,52,37,15,51
St. Pölten,1583,6,12,9,15,41,53,-12,45
RZ Pellets W,1583,7,11,10,15,41,52,-11,43
Admira Wacke,1583,8,10,9,17,33,54,-21,39
SV Josko Rie,1583,9,10,6,20,35,54,-19,36
Mattersburg,1583,10,6,12,18,32,52,-20,30
FC Salzburg,1584,1,23,8,5,74,27,47,77
SC Rheindorf,1584,2,18,10,8,59,44,15,64
SK Sturm Gra,1584,3,19,6,11,58,41,17,63
Vienna,1584,4,15,7,14,58,63,-5,52
Rapid Vienna,1584,5,12,12,12,52,42,10,48
RZ Pellets W,1584,6,13,9,14,48,52,-4,48
Admira Wacke,1584,7,12,6,18,40,57,-17,42
Mattersburg,1584,8,9,10,17,41,58,-17,37
SV Josko Rie,1584,9,10,5,21,34,53,-19,35
St. Pölten,1584,10,7,11,18,39,66,-27,32
FC Salzburg,1585,1,23,6,7,77,29,48,75
Vienna,1585,2,22,3,11,69,55,14,69
SC Rheindorf,1585,3,18,8,10,61,47,14,62
SK Sturm Gra,1585,4,17,7,12,55,39,16,58
RZ Pellets W,1585,5,14,6,16,54,62,-8,48
Rapid Vienna,1585,6,12,10,14,56,50,6,46
Admira Wacke,1585,7,11,10,15,38,60,-22,43
Mattersburg,1585,8,10,8,18,48,61,-13,38
SV Josko Rie,1585,9,10,4,22,38,59,-21,34
St. Pölten,1585,10,7,10,19,38,72,-34,31
FC Salzburg,1586,1,22,6,8,63,30,33,72
SC Rheindorf,1586,2,22,6,8,67,37,30,72
Vienna,1586,3,19,5,12,59,48,11,62
SK Sturm Gra,1586,4,17,7,12,54,38,16,58
Rapid Vienna,1586,5,15,11,10,49,34,15,56
RZ Pellets W,1586,6,13,5,18,45,57,-12,44
SV Josko Rie,1586,7,9,8,19,27,49,-22,35
Admira Wacke,1586,8,9,8,19,33,56,-23,35
St. Pölten,1586,9,8,11,17,44,70,-26,35
Mattersburg,1586,10,9,7,20,33,55,-22,34
FC Salzburg,1587,1,24,6,6,67,29,38,78
Vienna,1587,2,22,3,11,64,51,13,69
SC Rheindorf,1587,3,19,5,12,53,49,4,62
SK Sturm Gra,1587,4,15,5,16,52,42,10,50
RZ Pellets W,1587,5,14,8,14,53,55,-2,50
Rapid Vienna,1587,6,11,12,13,50,44,6,45
Admira Wacke,1587,7,13,4,19,40,58,-18,43
SV Josko Rie,1587,8,12,4,20,31,46,-15,40
St. Pölten,1587,9,10,9,17,48,62,-14,39
Mattersburg,1587,10,7,10,19,33,55,-22,31
Vienna,1588,1,20,7,9,60,43,17,67
FC Salzburg,1588,2,20,6,10,57,34,23,66
SC Rheindorf,1588,3,19,7,10,54,39,15,64
SK Sturm Gra,1588,4,19,5,12,58,37,21,62
Rapid Vienna,1588,5,17,9,10,57,37,20,60
RZ Pellets W,1588,6,13,8,15,44,51,-7,47
Admira Wacke,1588,7,12,8,16,37,52,-15,44
Mattersburg,1588,8,8,8,20,39,60,-21,32
SV Josko Rie,1588,9,9,5,22,32,54,-22,32
St. Pölten,1588,10,7,9,20,33,64,-31,30
FC Salzburg,1589,1,22,8,6,73,31,42,74
SK Sturm Gra,1589,2,22,5,9,64,30,34,71
Vienna,1589,3,20,4,12,60,46,14,64
SC Rheindorf,1589,4,18,6,12,48,44,4,60
SV Josko Rie,1589,5,13,5,18,37,50,-13,44
Rapid Vienna,1589,6,10,13,13,50,44,6,43
St. Pölten,1589,7,10,10,16,45,61,-16,40
RZ Pellets W,1589,8,11,6,19,38,55,-17,39
Mattersburg,1589,9,9,8,19,35,58,-23,35
Admira Wacke,1589,10,9,7,20,32,63,-31,34
FC Salzburg,1590,1,21,8,7,65,30,35,71
SK Sturm Gra,1590,2,20,6,10,60,33,27,66
Vienna,1590,3,20,5,11,65,50,15,65
Rapid Vienna,1590,4,17,8,11,64,43,21,59
SC Rheindorf,1590,5,17,6,13,52,50,2,57
SV Josko Rie,1590,6,12,7,17,42,50,-8,43
RZ Pellets W,1590,7,10,9,17,43,63,-20,39
Admira Wacke,1590,8,10,8,18,37,61,-24,38
St. Pölten,1590,9,9,8,19,40,69,-29,35
Mattersburg,1590,10,8,7,21,41,60,-19,31
FC Salzburg,1591,1,22,10,4,64,24,40,76
SC Rheindorf,1591,2,20,8,8,61,46,15,68
SK Sturm Gra,1591,3,19,8,9,64,34,30,65
Vienna,1591,4,19,7,10,64,49,15,64
RZ Pellets W,1591,5,12,6,18,47,60,-13,42
Admira Wacke,1591,6,11,8,17,31,57,-26,41
Rapid Vienna,1591,7,9,13,14,46,43,3,40
Mattersburg,1591,8,9,10,17,37,53,-16,37
St. Pölten,1591,9,7,11,18,35,58,-23,32
SV Josko Rie,1591,10,9,5,22,31,56,-25,32
SC Rheindorf,1592,1,20,7,9,53,36,17,67
FC Salzburg,1592,2,18,11,7,65,33,32,65
Rapid Vienna,1592,3,17,9,10,64,43,21,60
SK Sturm Gra,1592,4,18,6,12,55,39,16,60
Vienna,1592,5,18,6,12,59,51,8,60
St. Pölten,1592,6,10,12,14,48,58,-10,42
SV Josko Rie,1592,7,11,7,18,37,52,-15,40
Admira Wacke,1592,8,11,7,18,35,61,-26,40
RZ Pellets W,1592,9,10,6,20,38,56,-18,36
Mattersburg,1592,10,8,7,21,32,57,-25,31
SK Sturm Gra,1593,1,23,6,7,74,31,43,75
FC Salzburg,1593,2,20,9,7,65,30,35,69
SC Rheindorf,1593,3,17,7,12,47,47,0,58
Vienna,1593,4,17,4,15,61,57,4,55
Rapid Vienna,1593,5,13,9,14,55,40,15,48
RZ Pellets W,1593,6,14,4,18,50,58,-8,46
Mattersburg,1593,7,12,7,17,40,53,-13,43
Admira Wacke,1593,8,12,6,18,37,60,-23,42
SV Josko Rie,1593,9,12,4,20,39,54,-15,40
St. Pölten,1593,10,8,8,20,33,71,-38,32
FC Salzburg,1594,1,22,6,8,71,30,41,72
SK Sturm Gra,1594,2,21,7,8,62,34,28,70
SC Rheindorf,1594,3,20,8,8,56,42,14,68
Vienna,1594,4,17,6,13,60,51,9,57
Rapid Vienna,1594,5,14,11,11,60,42,18,53
SV Josko Rie,1594,6,14,5,17,35,45,-10,47
RZ Pellets W,1594,7,10,7,19,43,63,-20,37
Admira Wacke,1594,8,10,7,19,32,55,-23,37
Mattersburg,1594,9,8,9,19,35,65,-30,33
St. Pölten,1594,10,6,10,20,36,63,-27,28
SC Rheindorf,1595,1,20,8,8,57,40,17,68
Vienna,1595,2,20,6,10,64,50,14,66
FC Salzburg,1595,3,18,8,10,55,33,22,62
SK Sturm Gra,1595,4,17,8,11,63,37,26,59
Admira Wacke,1595,5,14,8,14,43,51,-8,50
RZ Pellets W,1595,6,13,8,15,48,59,-11,47
Rapid Vienna,1595,7,11,11,14,49,41,8,44
SV Josko Rie,1595,8,13,4,19,34,52,-18,43
St. Pölten,1595,9,8,9,19,44,64,-20,33
Mattersburg,1595,10,6,10,20,36,66,-30,28
FC Salzburg,1596,1,21,7,8,65,30,35,70
SC Rheindorf,1596,2,19,9,8,58,44,14,66
SK Sturm Gra,1596,3,18,5,13,60,38,22,59
Rapid Vienna,1596,4,16,11,9,57,37,20,59
Vienna,1596,5,16,7,13,61,55,6,55
Admira Wacke,1596,6,13,6,17,40,57,-17,45
Mattersburg,1596,7,10,10,16,37,53,-16,40
RZ Pellets W,1596,8,11,5,20,46,61,-15,38
St. Pölten,1596,9,8,12,16,38,61,-23,36
SV Josko Rie,1596,10,8,8,20,35,61,-26,32
FC Salzburg,1597,1,20,9,7,67,31,36,69
Vienna,1597,2,19,5,12,61,52,9,62
SC Rheindorf,1597,3,18,8,10,52,43,9,62
SK Sturm Gra,1597,4,18,6,12,58,41,17,60
Rapid Vienna,1597,5,15,11,10,68,46,22,56
Admira Wacke,1597,6,12,6,18,34,58,-24,42
Mattersburg,1597,7,10,9,17,42,53,-11,39
RZ Pellets W,1597,8,10,8,18,44,62,-18,38
SV Josko Rie,1597,9,9,10,17,37,54,-17,37
St. Pölten,1597,10,8,10,18,43,66,-23,34
SK Sturm Gra,1598,1,23,5,8,70,29,41,74
FC Salzburg,1598,2,18,7,11,57,34,23,61
Rapid Vienna,1598,3,17,7,12,61,42,19,58
Vienna,1598,4,18,3,15,57,51,6,57
SC Rheindorf,1598,5,17,5,14,50,52,-2,56
Admira Wacke,1598,6,13,6,17,40,52,-12,45
RZ Pellets W,1598,7,12,6,18,43,63,-20,42
SV Josko Rie,1598,8,12,5,19,38,58,-20,41
Mattersburg,1598,9,11,7,18,43,56,-13,40
St. Pölten,1598,10,9,9,18,45,67,-22,36
FC Salzburg,1599,1,20,6,10,66,33,33,66
SC Rheindorf,1599,2,19,8,9,56,42,14,65
SK Sturm Gra,1599,3,19,6,11,57,34,23,63
Vienna,1599,4,19,5,12,63,55,8,62
Rapid Vienna,1599,5,14,12,10,56,40,16,54
SV Josko Rie,1599,6,13,6,17,40,53,-13,45
Admira Wacke,1599,7,13,6,17,38,54,-16,45
RZ Pellets W,1599,8,11,7,18,42,59,-17,40
St. Pölten,1599,9,10,9,17,42,58,-16,39
Mattersburg,1599,10,6,7,23,29,61,-32,25
SC Rheindorf,1600,1,20,7,9,58,43,15,67
FC Salzburg,1600,2,17,12,7,64,35,29,63
SK Sturm Gra,1600,3,17,8,11,52,32,20,59
Vienna,1600,4,17,7,12,66,53,13,58
Rapid Vienna,1600,5,14,14,8,54,40,14,56
Admira Wacke,1600,6,12,7,17,40,54,-14,43
RZ Pellets W,1600,7,12,7,17,41,59,-18,43
SV Josko Rie,1600,8,12,4,20,36,53,-17,40
St. Pölten,1600,9,11,7,18,45,63,-18,40
Mattersburg,1600,10,6,11,19,35,59,-24,29
SC Rheindorf,1601,1,22,7,7,57,32,25,73
Vienna,1601,2,20,4,12,59,48,11,64
FC Salzburg,1601,3,19,6,11,63,35,28,63
SK Sturm Gra,1601,4,18,7,11,57,37,20,61
Rapid Vienna,1601,5,15,12,9,64,38,26,57
RZ Pellets W,1601,6,14,7,15,44,54,-10,49
SV Josko Rie,1601,7,11,5,20,35,53,-18,38
Mattersburg,1601,8,9,8,19,33,58,-25,35
Admira Wacke,1601,9,9,7,20,30,56,-26,34
St. Pölten,1601,10,7,9,20,32,63,-31,30
SC Rheindorf,1602,1,21,6,9,58,42,16,69
FC Salzburg,1602,2,20,8,8,67,34,33,68
Vienna,1602,3,21,4,11,76,51,25,67
SK Sturm Gra,1602,4,18,7,11,61,40,21,61
Rapid Vienna,1602,5,13,12,11,50,38,12,51
RZ Pellets W,1602,6,14,5,17,49,60,-11,47
Admira Wacke,1602,7,14,3,19,42,66,-24,45
SV Josko Rie,1602,8,12,3,21,34,58,-24,39
Mattersburg,1602,9,9,6,21,32,54,-22,33
St. Pölten,1602,10,7,8,21,43,69,-26,29
SC Rheindorf,1603,1,21,7,8,58,33,25,70
FC Salzburg,1603,2,20,7,9,67,32,35,67
SK Sturm Gra,1603,3,17,9,10,49,36,13,60
Vienna,1603,4,17,8,11,62,52,10,59
Rapid Vienna,1603,5,12,14,10,52,35,17,50
St. Pölten,1603,6,10,12,14,44,60,-16,42
RZ Pellets W,1603,7,11,8,17,39,54,-15,41
Admira Wacke,1603,8,10,9,17,36,59,-23,39
Mattersburg,1603,9,8,10,18,33,56,-23,34
SV Josko Rie,1603,10,9,6,21,34,57,-23,33
SK Sturm Gra,1604,1,20,8,8,65,35,30,68
FC Salzburg,1604,2,19,8,9,72,35,37,65
Vienna,1604,3,19,8,9,55,47,8,65
SC Rheindorf,1604,4,17,7,12,46,41,5,58
Rapid Vienna,1604,5,14,10,12,60,46,14,52
SV Josko Rie,1604,6,14,6,16,42,49,-7,48
RZ Pellets W,1604,7,12,7,17,50,58,-8,43
Admira Wacke,1604,8,12,7,17,39,57,-18,43
St. Pölten,1604,9,7,10,19,36,69,-33,31
Mattersburg,1604,10,8,5,23,33,61,-28,29
FC Salzburg,1605,1,24,8,4,74,28,46,80
Vienna,1605,2,21,4,11,63,46,17,67
SK Sturm Gra,1605,3,18,8,10,56,30,26,62
SC Rheindorf,1605,4,18,6,12,55,49,6,60
Rapid Vienna,1605,5,17,8,11,59,36,23,59
RZ Pellets W,1605,6,15,4,17,46,57,-11,49
SV Josko Rie,1605,7,12,3,21,29,55,-26,39
Admira Wacke,1605,8,10,4,22,34,60,-26,34
St. Pölten,1605,9,7,9,20,33,61,-28,30
Mattersburg,1605,10,6,10,20,31,58,-27,28
SK Sturm Gra,1606,1,20,9,7,58,26,32,69
SC Rheindorf,1606,2,19,6,11,53,40,13,63
FC Salzburg,1606,3,18,8,10,55,31,24,62
Vienna,1606,4,18,6,12,62,52,10,60
Admira Wacke,1606,5,13,7,16,37,48,-11,46
RZ Pellets W,1606,6,13,7,16,42,55,-13,46
SV Josko Rie,1606,7,14,4,18,34,52,-18,46
Rapid Vienna,1606,8,11,10,15,48,41,7,43
Mattersburg,1606,9,8,10,18,39,58,-19,34
St. Pölten,1606,10,9,7,20,39,64,-25,34
FC Salzburg,1607,1,23,5,8,65,31,34,74
SC Rheindorf,1607,2,20,7,9,56,45,11,67
Vienna,1607,3,20,4,12,65,48,17,64
SK Sturm Gra,1607,4,19,6,11,61,37,24,63
Rapid Vienna,1607,5,15,8,13,52,39,13,53
RZ Pellets W,1607,6,11,8,17,43,57,-14,41
Admira Wacke,1607,7,11,8,17,38,53,-15,41
Mattersburg,1607,8,9,9,18,40,54,-14,36
St. Pölten,1607,9,9,9,18,41,64,-23,36
SV Josko Rie,1607,10,9,4,23,26,59,-33,31
FC Salzburg,1608,1,22,7,7,66,33,33,73
SK Sturm Gra,1608,2,21,5,10,62,33,29,68
SC Rheindorf,1608,3,20,7,9,61,43,18,67
Vienna,1608,4,20,4,12,66,52,14,64
Rapid Vienna,1608,5,10,13,13,47,46,1,43
SV Josko Rie,1608,6,12,7,17,44,52,-8,43
Admira Wacke,1608,7,11,8,17,34,58,-24,41
RZ Pellets W,1608,8,11,6,19,46,62,-16,39
St. Pölten,1608,9,8,10,18,50,73,-23,34
Mattersburg,1608,10,8,7,21,35,59,-24,31
FC Salzburg,1609,1,22,5,9,65,30,35,71
SC Rheindorf,1609,2,20,10,6,53,36,17,70
SK Sturm Gra,1609,3,21,6,9,58,32,26,69
Vienna,1609,4,14,7,15,52,55,-3,49
Rapid Vienna,1609,5,12,12,12,46,38,8,48
RZ Pellets W,1609,6,12,8,16,49,56,-7,44
St. Pölten,1609,7,10,9,17,39,57,-18,39
Admira Wacke,1609,8,11,6,19,38,58,-20,39
SV Josko Rie,1609,9,11,5,20,37,57,-20,38
Mattersburg,1609,10,9,8,19,41,59,-18,35
SK Sturm Gra,1610,1,22,7,7,60,30,30,73
Vienna,1610,2,19,8,9,66,46,20,65
SC Rheindorf,1610,3,17,10,9,58,49,9,61
FC Salzburg,1610,4,16,9,11,56,40,16,57
Rapid Vienna,1610,5,13,13,10,54,38,16,52
RZ Pellets W,1610,6,11,8,17,50,62,-12,41
Admira Wacke,1610,7,11,7,18,35,56,-21,40
Mattersburg,1610,8,10,9,17,36,49,-13,39
St. Pölten,1610,9,9,11,16,45,60,-15,38
SV Josko Rie,1610,10,8,6,22,27,57,-30,30
SC Rheindorf,1611,1,20,9,7,61,42,19,69
Vienna,1611,2,22,3,11,65,48,17,69
SK Sturm Gra,1611,3,20,5,11,60,39,21,65
FC Salzburg,1611,4,18,10,8,60,34,26,64
Rapid Vienna,1611,5,14,8,14,59,45,14,50
RZ Pellets W,1611,6,12,8,16,42,51,-9,44
Admira Wacke,1611,7,10,10,16,35,54,-19,40
SV Josko Rie,1611,8,10,5,21,33,58,-25,35
Mattersburg,1611,9,8,10,18,38,53,-15,34
St. Pölten,1611,10,7,10,19,36,65,-29,31
FC Salzburg,1612,1,22,8,6,63,34,29,74
SC Rheindorf,1612,2,19,7,10,51,41,10,64
Rapid Vienna,1612,3,16,10,10,59,35,24,58
SK Sturm Gra,1612,4,16,10,10,54,35,19,58
Vienna,1612,5,14,8,14,56,53,3,50
RZ Pellets W,1612,6,11,7,18,44,54,-10,40
Mattersburg,1612,7,10,10,16,43,53,-10,40
SV Josko Rie,1612,8,12,3,21,33,54,-21,39
Admira Wacke,1612,9,11,6,19,31,56,-25,39
St. Pölten,1612,10,8,13,15,46,65,-19,37
FC Salzburg,1613,1,19,9,8,65,37,28,66
Vienna,1613,2,17,8,11,60,45,15,59
SC Rheindorf,1613,3,16,11,9,49,44,5,59
Rapid Vienna,1613,4,16,9,11,65,43,22,57
SK Sturm Gra,1613,5,17,5,14,54,39,15,56
RZ Pellets W,1613,6,13,6,17,43,59,-16,45
Admira Wacke,1613,7,12,9,15,32,49,-17,45
Mattersburg,1613,8,10,9,17,37,51,-14,39
SV Josko Rie,1613,9,10,8,18,35,48,-13,38
St. Pölten,1613,10,8,10,18,41,66,-25,34
FC Salzburg,1614,1,20,9,7,68,33,35,69
SC Rheindorf,1614,2,21,5,10,57,39,18,68
SK Sturm Gra,1614,3,19,9,8,59,33,26,66
Vienna,1614,4,19,4,13,70,56,14,61
Rapid Vienna,1614,5,15,11,10,59,41,18,56
RZ Pellets W,1614,6,11,9,16,50,58,-8,42
Mattersburg,1614,7,10,8,18,44,63,-19,38
St. Pölten,1614,8,9,9,18,44,65,-21,36
SV Josko Rie,1614,9,10,3,23,32,62,-30,33
Admira Wacke,1614,10,8,9,19,34,67,-33,33
FC Salzburg,1615,1,20,9,7,71,34,37,69
SC Rheindorf,1615,2,19,8,9,54,43,11,65
Vienna,1615,3,19,5,12,61,57,4,62
SK Sturm Gra,1615,4,18,7,11,61,36,25,61
Rapid Vienna,1615,5,14,11,11,60,45,15,53
Admira Wacke,1615,6,14,5,17,37,53,-16,47
SV Josko Rie,1615,7,11,6,19,39,52,-13,39
RZ Pellets W,1615,8,10,9,17,39,54,-15,39
Mattersburg,1615,9,9,9,18,40,62,-22,36
St. Pölten,1615,10,7,9,20,40,66,-26,30
FC Salzburg,1616,1,23,8,5,77,36,41,77
Vienna,1616,2,19,9,8,75,55,20,66
SK Sturm Gra,1616,3,18,8,10,61,41,20,62
SC Rheindorf,1616,4,17,7,12,56,51,5,58
Rapid Vienna,1616,5,13,9,14,53,49,4,48
SV Josko Rie,1616,6,13,7,16,46,55,-9,46
Admira Wacke,1616,7,11,7,18,42,60,-18,40
RZ Pellets W,1616,8,9,9,18,41,61,-20,36
Mattersburg,1616,9,7,11,18,34,53,-19,32
St. Pölten,1616,10,6,13,17,38,62,-24,31
FC Salzburg,1617,1,20,9,7,59,33,26,69
SK Sturm Gra,1617,2,21,4,11,62,36,26,67
SC Rheindorf,1617,3,19,7,10,59,40,19,64
Vienna,1617,4,18,4,14,60,57,3,58
RZ Pellets W,1617,5,17,6,13,46,43,3,57
Rapid Vienna,1617,6,15,9,12,58,42,16,54
Admira Wacke,1617,7,11,5,20,36,63,-27,38
SV Josko Rie,1617,8,10,6,20,34,53,-19,36
Mattersburg,1617,9,7,11,18,29,52,-23,32
St. Pölten,1617,10,6,11,19,35,59,-24,29
SK Sturm Gra,1618,1,21,5,10,69,37,32,68
FC Salzburg,1618,2,19,8,9,59,34,25,65
SC Rheindorf,1618,3,18,9,9,51,44,7,63
Rapid Vienna,1618,4,16,7,13,60,45,15,55
Vienna,1618,5,14,9,13,59,53,6,51
SV Josko Rie,1618,6,13,6,17,46,52,-6,45
Mattersburg,1618,7,12,9,15,43,56,-13,45
RZ Pellets W,1618,8,11,6,19,49,67,-18,39
Admira Wacke,1618,9,10,6,20,37,62,-25,36
St. Pölten,1618,10,7,13,16,42,65,-23,34
FC Salzburg,1619,1,19,7,10,67,38,29,64
SC Rheindorf,1619,2,19,6,11,56,44,12,63
SK Sturm Gra,1619,3,18,6,12,61,36,25,60
Vienna,1619,4,18,5,13,66,55,11,59
Rapid Vienna,1619,5,15,8,13,58,43,15,53
Admira Wacke,1619,6,14,5,17,43,62,-19,47
RZ Pellets W,1619,7,13,6,17,48,61,-13,45
Mattersburg,1619,8,12,8,16,43,55,-12,44
SV Josko Rie,1619,9,11,7,18,33,51,-18,40
St. Pölten,1619,10,8,8,20,39,69,-30,32
FC Salzburg,1620,1,23,9,4,71,29,42,78
SK Sturm Gra,1620,2,20,7,9,56,29,27,67
SC Rheindorf,1620,3,18,9,9,53,46,7,63
Vienna,1620,4,17,5,14,67,54,13,56
Rapid Vienna,1620,5,12,12,12,59,51,8,48
RZ Pellets W,1620,6,12,8,16,48,56,-8,44
Mattersburg,1620,7,11,7,18,38,54,-16,40
Admira Wacke,1620,8,11,7,18,45,64,-19,40
St. Pölten,1620,9,9,9,18,38,58,-20,36
SV Josko Rie,1620,10,8,5,23,34,68,-34,29
SK Sturm Gra,1621,1,20,6,10,61,33,28,66
FC Salzburg,1621,2,19,7,10,61,41,20,64
Vienna,1621,3,20,4,12,70,51,19,64
Rapid Vienna,1621,4,16,11,9,62,38,24,59
SC Rheindorf,1621,5,16,9,11,53,47,6,57
Admira Wacke,1621,6,14,4,18,43,63,-20,46
RZ Pellets W,1621,7,13,5,18,44,62,-18,44
St. Pölten,1621,8,11,7,18,49,64,-15,40
Mattersburg,1621,9,8,9,19,33,55,-22,33
SV Josko Rie,1621,10,8,8,20,31,53,-22,32
SC Rheindorf,1622,1,21,6,9,61,41,20,69
FC Salzburg,1622,2,20,6,10,64,36,28,66
SK Sturm Gra,1622,3,18,8,10,53,31,22,62
Vienna,1622,4,18,7,11,60,52,8,61
Rapid Vienna,1622,5,14,12,10,56,39,17,54
Admira Wacke,1622,6,12,7,17,38,56,-18,43
SV Josko Rie,1622,7,12,5,19,34,49,-15,41
RZ Pellets W,1622,8,11,7,18,40,56,-16,40
St. Pölten,1622,9,7,14,15,37,57,-20,35
Mattersburg,1622,10,7,8,21,40,66,-26,29
FC Salzburg,1623,1,23,8,5,71,27,44,77
SK Sturm Gra,1623,2,20,6,10,66,36,30,66
SC Rheindorf,1623,3,19,8,9,55,44,11,65
Vienna,1623,4,16,3,17,63,59,4,51
RZ Pellets W,1623,5,14,5,17,50,64,-14,47
Admira Wacke,1623,6,14,5,17,43,61,-18,47
Rapid Vienna,1623,7,11,10,15,56,56,0,43
St. Pölten,1623,8,9,10,17,40,56,-16,37
Mattersburg,1623,9,9,9,18,38,54,-16,36
SV Josko Rie,1623,10,9,8,19,34,59,-25,35
FC Salzburg,1624,1,22,7,7,65,29,36,73
SK Sturm Gra,1624,2,20,7,9,62,34,28,67
SC Rheindorf,1624,3,20,7,9,60,47,13,67
Vienna,1624,4,16,8,12,57,50,7,56
Rapid Vienna,1624,5,13,10,13,53,42,11,49
Admira Wacke,1624,6,12,8,16,39,54,-15,44
SV Josko Rie,1624,7,12,6,18,35,50,-15,42
RZ Pellets W,1624,8,9,7,20,38,58,-20,34
Mattersburg,1624,9,8,10,18,39,61,-22,34
St. Pölten,1624,10,7,12,17,40,63,-23,33
FC Salzburg,1625,1,22,8,6,73,34,39,74
SC Rheindorf,1625,2,19,7,10,56,45,11,64
Rapid Vienna,1625,3,17,9,10,58,41,17,60
SK Sturm Gra,1625,4,18,4,14,50,36,14,58
Vienna,1625,5,18,2,16,55,51,4,56
Admira Wacke,1625,6,12,8,16,46,61,-15,44
RZ Pellets W,1625,7,11,9,16,41,51,-10,42
St. Pölten,1625,8,10,7,19,47,68,-21,37
Mattersburg,1625,9,9,9,18,38,54,-16,36
SV Josko Rie,1625,10,10,5,21,31,54,-23,35
SK Sturm Gra,1626,1,22,6,8,64,31,33,72
SC Rheindorf,1626,2,19,8,9,60,46,14,65
FC Salzburg,1626,3,17,9,10,59,37,22,60
Vienna,1626,4,18,6,12,65,56,9,60
Rapid Vienna,1626,5,14,11,11,53,42,11,53
Mattersburg,1626,6,10,11,15,43,52,-9,41
RZ Pellets W,1626,7,9,11,16,41,56,-15,38
SV Josko Rie,1626,8,10,7,19,36,52,-16,37
St. Pölten,1626,9,9,9,18,39,58,-19,36
Admira Wacke,1626,10,9,8,19,32,62,-30,35
FC Salzburg,1627,1,19,10,7,65,34,31,67
SC Rheindorf,1627,2,19,9,8,58,37,21,66
SK Sturm Gra,1627,3,18,8,10,58,36,22,62
Vienna,1627,4,17,8,11,63,54,9,59
Rapid Vienna,1627,5,14,11,11,58,41,17,53
RZ Pellets W,1627,6,13,10,13,44,47,-3,49
SV Josko Rie,1627,7,13,3,20,34,50,-16,42
Mattersburg,1627,8,9,8,19,39,62,-23,35
Admira Wacke,1627,9,10,4,22,32,61,-29,34
St. Pölten,1627,10,8,9,19,35,64,-29,33
SC Rheindorf,1628,1,21,7,8,54,37,17,70
FC Salzburg,1628,2,20,7,9,64,34,30,67
SK Sturm Gra,1628,3,18,10,8,61,34,27,64
Vienna,1628,4,19,5,12,60,51,9,62
Rapid Vienna,1628,5,15,9,12,61,49,12,54
RZ Pellets W,1628,6,10,10,16,42,54,-12,40
St. Pölten,1628,7,10,10,16,47,60,-13,40
SV Josko Rie,1628,8,11,7,18,33,49,-16,40
Admira Wacke,1628,9,8,8,20,33,64,-31,32
Mattersburg,1628,10,8,7,21,36,59,-23,31
FC Salzburg,1629,1,19,13,4,74,33,41,70
SK Sturm Gra,1629,2,18,9,9,55,34,21,63
Vienna,1629,3,19,5,12,69,49,20,62
SC Rheindorf,1629,4,18,8,10,56,41,15,62
Rapid Vienna,1629,5,12,11,13,48,43,5,47
Admira Wacke,1629,6,12,7,17,33,53,-20,43
RZ Pellets W,1629,7,11,9,16,43,54,-11,42
SV Josko Rie,1629,8,11,6,19,33,55,-22,39
St. Pölten,1629,9,8,11,17,37,60,-23,35
Mattersburg,1629,10,8,9,19,32,58,-26,33
FC Salzburg,1630,1,22,9,5,75,31,44,75
SC Rheindorf,1630,2,22,9,5,62,39,23,75
SK Sturm Gra,1630,3,20,6,10,54,31,23,66
Vienna,1630,4,20,4,12,67,51,16,64
Rapid Vienna,1630,5,14,9,13,56,47,9,51
RZ Pellets W,1630,6,12,8,16,47,56,-9,44
SV Josko Rie,1630,7,10,6,20,40,59,-19,36
Admira Wacke,1630,8,8,9,19,34,63,-29,33
St. Pölten,1630,9,7,10,19,39,69,-30,31
Mattersburg,1630,10,6,8,22,34,62,-28,26
SC Rheindorf,1631,1,25,6,5,62,33,29,81
FC Salzburg,1631,2,21,7,8,69,33,36,70
Vienna,1631,3,18,6,12,69,53,16,60
SK Sturm Gra,1631,4,18,5,13,58,38,20,59
Rapid Vienna,1631,5,14,10,12,59,49,10,52
Admira Wacke,1631,6,13,6,17,35,54,-19,45
RZ Pellets W,1631,7,11,10,15,45,53,-8,43
Mattersburg,1631,8,10,9,17,38,57,-19,39
SV Josko Rie,1631,9,8,4,24,29,62,-33,28
St. Pölten,1631,10,6,9,21,39,71,-32,27
SC Rheindorf,1632,1,20,10,6,55,36,19,70
FC Salzburg,1632,2,19,9,8,61,32,29,66
SK Sturm Gra,1632,3,19,7,10,55,33,22,64
Vienna,1632,4,19,7,10,61,46,15,64
Rapid Vienna,1632,5,13,12,11,53,39,14,51
Admira Wacke,1632,6,10,11,15,34,51,-17,41
RZ Pellets W,1632,7,10,8,18,38,57,-19,38
SV Josko Rie,1632,8,9,8,19,35,51,-16,35
St. Pölten,1632,9,8,9,19,38,61,-23,33
Mattersburg,1632,10,8,9,19,35,59,-24,33
Vienna,1633,1,21,6,9,61,43,18,69
FC Salzburg,1633,2,20,8,8,72,36,36,68
SK Sturm Gra,1633,3,19,9,8,59,34,25,66
SC Rheindorf,1633,4,19,9,8,58,42,16,66
Rapid Vienna,1633,5,12,12,12,51,44,7,48
Admira Wacke,1633,6,10,11,15,41,61,-20,41
RZ Pellets W,1633,7,10,9,17,44,57,-13,39
SV Josko Rie,1633,8,10,6,20,32,54,-22,36
Mattersburg,1633,9,8,9,19,36,56,-20,33
St. Pölten,1633,10,5,13,18,39,66,-27,28
SK Sturm Gra,1634,1,23,5,8,71,31,40,74
FC Salzburg,1634,2,21,6,9,67,32,35,69
Vienna,1634,3,20,2,14,66,48,18,62
SC Rheindorf,1634,4,19,5,12,50,47,3,62
Rapid Vienna,1634,5,14,11,11,51,39,12,53
RZ Pellets W,1634,6,12,5,19,38,53,-15,41
Admira Wacke,1634,7,10,9,17,38,66,-28,39
St. Pölten,1634,8,8,11,17,42,63,-21,35
SV Josko Rie,1634,9,9,8,19,34,59,-25,35
Mattersburg,1634,10,8,10,18,35,54,-19,34
SC Rheindorf,1635,1,21,9,6,64,39,25,72
SK Sturm Gra,1635,2,19,6,11,59,33,26,63
FC Salzburg,1635,3,17,11,8,63,35,28,62
Rapid Vienna,1635,4,15,9,12,51,44,7,54
Vienna,1635,5,16,5,15,59,57,2,53
SV Josko Rie,1635,6,13,5,18,39,53,-14,44
Admira Wacke,1635,7,13,5,18,33,55,-22,44
RZ Pellets W,1635,8,10,8,18,43,58,-15,38
St. Pölten,1635,9,8,13,15,39,57,-18,37
Mattersburg,1635,10,7,11,18,44,63,-19,32
SC Rheindorf,1636,1,22,6,8,59,41,18,72
FC Salzburg,1636,2,20,7,9,68,32,36,67
Vienna,1636,3,20,7,9,65,47,18,67
SK Sturm Gra,1636,4,18,5,13,57,39,18,59
Rapid Vienna,1636,5,12,13,11,54,42,12,49
Mattersburg,1636,6,12,8,16,44,54,-10,44
RZ Pellets W,1636,7,11,9,16,46,59,-13,42
Admira Wacke,1636,8,11,7,18,36,55,-19,40
SV Josko Rie,1636,9,10,6,20,33,60,-27,36
St. Pölten,1636,10,6,8,22,40,73,-33,26
FC Salzburg,1637,1,23,6,7,70,29,41,75
SC Rheindorf,1637,2,21,8,7,58,44,14,71
Vienna,1637,3,20,4,12,63,44,19,64
SK Sturm Gra,1637,4,18,6,12,61,33,28,60
Rapid Vienna,1637,5,14,10,12,54,40,14,52
Admira Wacke,1637,6,13,6,17,32,52,-20,45
RZ Pellets W,1637,7,12,8,16,47,60,-13,44
SV Josko Rie,1637,8,10,4,22,32,62,-30,34
St. Pölten,1637,9,7,10,19,43,66,-23,31
Mattersburg,1637,10,7,8,21,38,68,-30,29
FC Salzburg,1638,1,21,6,9,64,31,33,69
SK Sturm Gra,1638,2,21,4,11,72,45,27,67
Vienna,1638,3,19,6,11,64,44,20,63
SC Rheindorf,1638,4,17,11,8,49,40,9,62
Rapid Vienna,1638,5,17,10,9,63,37,26,61
RZ Pellets W,1638,6,13,10,13,48,50,-2,49
St. Pölten,1638,7,9,11,16,42,61,-19,38
SV Josko Rie,1638,8,10,6,20,30,52,-22,36
Admira Wacke,1638,9,9,5,22,32,70,-38,32
Mattersburg,1638,10,6,7,23,33,67,-34,25
FC Salzburg,1639,1,21,8,7,70,30,40,71
SK Sturm Gra,1639,2,22,5,9,68,32,36,71
SC Rheindorf,1639,3,19,8,9,60,45,15,65
Vienna,1639,4,18,6,12,61,52,9,60
Rapid Vienna,1639,5,16,10,10,60,39,21,58
RZ Pellets W,1639,6,11,7,18,38,59,-21,40
St. Pölten,1639,7,9,11,16,43,62,-19,38
Admira Wacke,1639,8,10,8,18,42,65,-23,38
SV Josko Rie,1639,9,9,5,22,35,64,-29,32
Mattersburg,1639,10,7,8,21,33,62,-29,29
FC Salzburg,1640,1,21,5,10,69,33,36,68
SC Rheindorf,1640,2,20,8,8,57,41,16,68
Vienna,1640,3,20,6,10,70,50,20,66
SK Sturm Gra,1640,4,17,7,12,55,41,14,58
Rapid Vienna,1640,5,14,10,12,54,41,13,52
St. Pölten,1640,6,12,10,14,48,62,-14,46
RZ Pellets W,1640,7,11,9,16,46,58,-12,42
Admira Wacke,1640,8,11,8,17,36,53,-17,41
Mattersburg,1640,9,9,6,21,35,57,-22,33
SV Josko Rie,1640,10,7,7,22,31,65,-34,28
FC Salzburg,1641,1,20,9,7,61,23,38,69
SK Sturm Gra,1641,2,21,4,11,61,32,29,67
SC Rheindorf,1641,3,18,9,9,51,37,14,63
Vienna,1641,4,20,3,13,59,51,8,63
Rapid Vienna,1641,5,16,10,10,56,36,20,58
RZ Pellets W,1641,6,13,7,16,41,51,-10,46
Admira Wacke,1641,7,13,6,17,32,54,-22,45
SV Josko Rie,1641,8,12,5,19,36,48,-12,41
Mattersburg,1641,9,7,9,20,35,61,-26,30
St. Pölten,1641,10,5,8,23,29,68,-39,23
FC Salzburg,1642,1,22,7,7,73,31,42,73
SK Sturm Gra,1642,2,20,8,8,60,34,26,68
SC Rheindorf,1642,3,16,12,8,54,44,10,60
Vienna,1642,4,18,3,15,61,51,10,57
Rapid Vienna,1642,5,14,8,14,49,42,7,50
RZ Pellets W,1642,6,11,9,16,40,59,-19,42
Admira Wacke,1642,7,11,7,18,42,61,-19,40
SV Josko Rie,1642,8,11,6,19,38,58,-20,39
Mattersburg,1642,9,9,9,18,37,59,-22,36
St. Pölten,1642,10,8,11,17,47,62,-15,35
FC Salzburg,1643,1,23,6,7,66,26,40,75
SC Rheindorf,1643,2,21,6,9,55,41,14,69
SK Sturm Gra,1643,3,21,5,10,59,30,29,68
Rapid Vienna,1643,4,15,13,8,64,39,25,58
Vienna,1643,5,18,4,14,62,56,6,58
RZ Pellets W,1643,6,15,6,15,46,54,-8,51
SV Josko Rie,1643,7,10,6,20,32,50,-18,36
Admira Wacke,1643,8,11,3,22,36,65,-29,36
Mattersburg,1643,9,8,7,21,33,55,-22,31
St. Pölten,1643,10,6,8,22,32,69,-37,26
FC Salzburg,1644,1,21,6,9,63,33,30,69
Vienna,1644,2,19,7,10,57,45,12,64
SC Rheindorf,1644,3,19,6,11,58,48,10,63
SK Sturm Gra,1644,4,18,8,10,60,34,26,62
Rapid Vienna,1644,5,15,13,8,57,34,23,58
Admira Wacke,1644,6,13,7,16,43,60,-17,46
RZ Pellets W,1644,7,13,6,17,50,58,-8,45
Mattersburg,1644,8,10,6,20,40,55,-15,36
SV Josko Rie,1644,9,8,7,21,34,58,-24,31
St. Pölten,1644,10,6,10,20,35,72,-37,28
FC Salzburg,1645,1,22,6,8,65,30,35,72
SC Rheindorf,1645,2,18,8,10,56,52,4,62
SK Sturm Gra,1645,3,16,11,9,52,32,20,59
Vienna,1645,4,17,4,15,61,59,2,55
Rapid Vienna,1645,5,14,12,10,49,31,18,54
RZ Pellets W,1645,6,14,10,12,57,53,4,52
Admira Wacke,1645,7,10,10,16,35,58,-23,40
St. Pölten,1645,8,10,8,18,44,64,-20,38
SV Josko Rie,1645,9,10,7,19,37,55,-18,37
Mattersburg,1645,10,7,8,21,37,59,-22,29
FC Salzburg,1646,1,23,6,7,75,30,45,75
SK Sturm Gra,1646,2,19,6,11,60,37,23,63
SC Rheindorf,1646,3,18,9,9,51,39,12,63
Vienna,1646,4,18,6,12,60,51,9,60
Rapid Vienna,1646,5,17,8,11,61,41,20,59
Admira Wacke,1646,6,13,4,19,37,58,-21,43
Mattersburg,1646,7,10,8,18,41,56,-15,38
RZ Pellets W,1646,8,10,7,19,42,65,-23,37
St. Pölten,1646,9,8,11,17,42,64,-22,35
SV Josko Rie,1646,10,8,7,21,32,60,-28,31
FC Salzburg,1647,1,21,6,9,61,26,35,69
SC Rheindorf,1647,2,21,6,9,55,44,11,69
SK Sturm Gra,1647,3,20,7,9,63,35,28,67
RZ Pellets W,1647,4,17,8,11,55,49,6,59
Vienna,1647,5,18,3,15,62,53,9,57
Rapid Vienna,1647,6,11,14,11,53,45,8,47
St. Pölten,1647,7,8,14,14,43,59,-16,38
SV Josko Rie,1647,8,10,5,21,32,52,-20,35
Admira Wacke,1647,9,9,7,20,34,66,-32,34
Mattersburg,1647,10,6,8,22,29,58,-29,26
SC Rheindorf,1648,1,22,8,6,63,41,22,74
FC Salzburg,1648,2,19,8,9,62,34,28,65
SK Sturm Gra,1648,3,18,7,11,65,40,25,61
Vienna,1648,4,19,4,13,74,61,13,61
Rapid Vienna,1648,5,15,9,12,53,40,13,54
Admira Wacke,1648,6,12,7,17,35,59,-24,43
St. Pölten,1648,7,10,10,16,47,63,-16,40
RZ Pellets W,1648,8,10,7,19,41,56,-15,37
SV Josko Rie,1648,9,10,6,20,35,58,-23,36
Mattersburg,1648,10,9,6,21,37,60,-23,33
SC Rheindorf,1649,1,23,7,6,68,40,28,76
FC Salzburg,1649,2,21,7,8,73,35,38,70
SK Sturm Gra,1649,3,17,7,12,62,44,18,58
RZ Pellets W,1649,4,17,5,14,52,55,-3,56
Rapid Vienna,1649,5,15,8,13,57,46,11,53
Vienna,1649,6,16,5,15,59,56,3,53
Admira Wacke,1649,7,11,4,21,31,64,-33,37
SV Josko Rie,1649,8,10,6,20,41,56,-15,36
Mattersburg,1649,9,9,8,19,38,57,-19,35
St. Pölten,1649,10,7,11,18,39,67,-28,32
FC Salzburg,1650,1,22,7,7,63,34,29,73
SC Rheindorf,1650,2,20,8,8,58,40,18,68
Rapid Vienna,1650,3,16,12,8,62,39,23,60
SK Sturm Gra,1650,4,17,8,11,52,37,15,59
Vienna,1650,5,16,4,16,60,57,3,52
RZ Pellets W,1650,6,13,8,15,48,52,-4,47
Admira Wacke,1650,7,11,9,16,34,59,-25,42
Mattersburg,1650,8,10,7,19,37,55,-18,37
SV Josko Rie,1650,9,10,5,21,37,51,-14,35
St. Pölten,1650,10,6,10,20,41,68,-27,28
FC Salzburg,1651,1,23,7,6,72,32,40,76
SK Sturm Gra,1651,2,20,7,9,64,29,35,67
Rapid Vienna,1651,3,18,9,9,60,33,27,63
SC Rheindorf,1651,4,17,9,10,51,44,7,60
Vienna,1651,5,15,4,17,52,56,-4,49
SV Josko Rie,1651,6,12,5,19,36,57,-21,41
Mattersburg,1651,7,11,7,18,38,49,-11,40
Admira Wacke,1651,8,11,7,18,33,60,-27,40
RZ Pellets W,1651,9,10,8,18,39,57,-18,38
St. Pölten,1651,10,7,9,20,36,64,-28,30
SC Rheindorf,1652,1,21,6,9,57,40,17,69
FC Salzburg,1652,2,20,6,10,59,32,27,66
Vienna,1652,3,19,5,12,58,47,11,62
SK Sturm Gra,1652,4,16,7,13,55,44,11,55
Rapid Vienna,1652,5,13,10,13,54,43,11,49
RZ Pellets W,1652,6,14,7,15,49,56,-7,49
Mattersburg,1652,7,10,11,15,43,53,-10,41
St. Pölten,1652,8,10,9,17,50,62,-12,39
Admira Wacke,1652,9,11,5,20,37,65,-28,38
SV Josko Rie,1652,10,11,4,21,33,53,-20,37
SK Sturm Gra,1653,1,23,4,9,65,31,34,73
FC Salzburg,1653,2,20,9,7,59,27,32,69
Vienna,1653,3,21,4,11,60,48,12,67
SC Rheindorf,1653,4,19,5,12,54,46,8,62
Rapid Vienna,1653,5,14,11,11,55,41,14,53
Admira Wacke,1653,6,11,6,19,35,57,-22,39
Mattersburg,1653,7,9,11,16,38,52,-14,38
RZ Pellets W,1653,7,10,8,18,38,52,-14,38
St. Pölten,1653,9,10,7,19,46,67,-21,37
SV Josko Rie,1653,10,9,3,24,30,59,-29,30
SC Rheindorf,1654,1,21,8,7,61,40,21,71
FC Salzburg,1654,2,21,6,9,75,36,39,69
SK Sturm Gra,1654,3,21,6,9,64,30,34,69
Vienna,1654,4,22,3,11,64,50,14,69
Rapid Vienna,1654,5,14,9,13,58,45,13,51
RZ Pellets W,1654,6,11,7,18,40,53,-13,40
St. Pölten,1654,7,9,11,16,40,59,-19,38
SV Josko Rie,1654,8,10,4,22,29,59,-30,34
Admira Wacke,1654,9,9,6,21,33,69,-36,33
Mattersburg,1654,10,8,8,20,38,61,-23,32
FC Salzburg,1655,1,21,8,7,63,31,32,71
SC Rheindorf,1655,2,22,5,9,59,42,17,71
Vienna,1655,3,18,6,12,64,50,14,60
SK Sturm Gra,1655,4,17,8,11,55,35,20,59
RZ Pellets W,1655,5,14,8,14,46,50,-4,50
Rapid Vienna,1655,6,12,13,11,53,41,12,49
Admira Wacke,1655,7,11,8,17,31,55,-24,41
SV Josko Rie,1655,8,10,4,22,31,54,-23,34
St. Pölten,1655,9,8,10,18,41,65,-24,34
Mattersburg,1655,10,8,8,20,39,59,-20,32
FC Salzburg,1656,1,24,6,6,67,24,43,78
SK Sturm Gra,1656,2,23,4,9,78,42,36,73
SC Rheindorf,1656,3,19,8,9,52,39,13,65
Vienna,1656,4,18,6,12,66,54,12,60
Rapid Vienna,1656,5,11,11,14,58,51,7,44
RZ Pellets W,1656,6,11,8,17,47,63,-16,41
Mattersburg,1656,7,11,7,18,45,59,-14,40
St. Pölten,1656,8,10,9,17,45,61,-16,39
Admira Wacke,1656,9,9,6,21,39,73,-34,33
SV Josko Rie,1656,10,8,7,21,29,60,-31,31
FC Salzburg,1657,1,22,8,6,73,31,42,74
SC Rheindorf,1657,2,21,6,9,56,45,11,69
SK Sturm Gra,1657,3,18,5,13,62,39,23,59
Vienna,1657,4,18,5,13,59,50,9,59
Rapid Vienna,1657,5,15,10,11,53,36,17,55
Admira Wacke,1657,6,14,5,17,41,57,-16,47
RZ Pellets W,1657,7,12,7,17,45,56,-11,43
SV Josko Rie,1657,8,10,6,20,30,56,-26,36
St. Pölten,1657,9,8,10,18,47,68,-21,34
Mattersburg,1657,10,7,8,21,31,59,-28,29
FC Salzburg,1658,1,21,8,7,60,26,34,71
Vienna,1658,2,22,4,10,67,52,15,70
SK Sturm Gra,1658,3,21,5,10,64,35,29,68
SC Rheindorf,1658,4,20,5,11,60,46,14,65
Rapid Vienna,1658,5,14,8,14,61,49,12,50
RZ Pellets W,1658,6,13,6,17,44,54,-10,45
St. Pölten,1658,7,9,10,17,44,64,-20,37
Admira Wacke,1658,8,10,5,21,35,71,-36,35
SV Josko Rie,1658,9,9,7,20,37,56,-19,34
Mattersburg,1658,10,8,8,20,34,53,-19,32
SC Rheindorf,1659,1,23,8,5,67,37,30,77
FC Salzburg,1659,2,21,6,9,66,32,34,69
SK Sturm Gra,1659,3,19,8,9,57,34,23,65
Vienna,1659,4,19,6,11,61,47,14,63
RZ Pellets W,1659,5,13,7,16,44,52,-8,46
SV Josko Rie,1659,6,13,6,17,41,52,-11,45
Rapid Vienna,1659,7,11,11,14,50,44,6,44
Admira Wacke,1659,8,12,6,18,36,58,-22,42
Mattersburg,1659,9,7,8,21,33,60,-27,29
St. Pölten,1659,10,5,8,23,32,71,-39,23
FC Salzburg,1660,1,20,9,7,56,24,32,69
SC Rheindorf,1660,2,19,10,7,53,37,16,67
Vienna,1660,3,19,5,12,63,50,13,62
SK Sturm Gra,1660,4,17,9,10,54,35,19,60
Rapid Vienna,1660,5,16,9,11,53,38,15,57
Admira Wacke,1660,6,12,8,16,38,55,-17,44
St. Pölten,1660,7,10,10,16,37,56,-19,40
RZ Pellets W,1660,8,8,11,17,37,55,-18,35
SV Josko Rie,1660,9,9,6,21,35,57,-22,33
Mattersburg,1660,10,6,11,19,36,55,-19,29
SC Rheindorf,1661,1,22,6,8,58,40,18,72
Vienna,1661,2,21,4,11,74,62,12,67
SK Sturm Gra,1661,3,20,4,12,66,36,30,64
FC Salzburg,1661,4,19,6,11,68,37,31,63
Rapid Vienna,1661,5,14,11,11,62,41,21,53
SV Josko Rie,1661,6,12,6,18,36,56,-20,42
RZ Pellets W,1661,7,12,5,19,49,59,-10,41
Admira Wacke,1661,8,11,8,17,36,65,-29,41
St. Pölten,1661,9,8,9,19,41,65,-24,33
Mattersburg,1661,10,8,7,21,38,67,-29,31
SC Rheindorf,1662,1,21,8,7,57,36,21,71
FC Salzburg,1662,2,19,10,7,72,33,39,67
Vienna,1662,3,19,7,10,61,50,11,64
SK Sturm Gra,1662,4,15,10,11,53,35,18,55
RZ Pellets W,1662,5,13,9,14,48,53,-5,48
St. Pölten,1662,6,13,9,14,54,60,-6,48
Admira Wacke,1662,7,13,7,16,35,61,-26,46
Rapid Vienna,1662,8,10,11,15,50,47,3,41
Mattersburg,1662,9,8,8,20,41,62,-21,32
SV Josko Rie,1662,10,6,7,23,30,64,-34,25
FC Salzburg,1663,1,22,6,8,67,31,36,72
SK Sturm Gra,1663,2,20,7,9,61,30,31,67
SC Rheindorf,1663,3,19,7,10,51,40,11,64
Vienna,1663,4,19,3,14,62,56,6,60
Rapid Vienna,1663,5,14,11,11,62,40,22,53
SV Josko Rie,1663,6,12,7,17,35,48,-13,43
RZ Pellets W,1663,7,11,8,17,46,57,-11,41
Admira Wacke,1663,8,10,7,19,36,59,-23,37
Mattersburg,1663,9,9,10,17,35,58,-23,37
St. Pölten,1663,10,7,8,21,43,79,-36,29
FC Salzburg,1664,1,19,10,7,61,29,32,67
SK Sturm Gra,1664,2,18,9,9,55,31,24,63
SC Rheindorf,1664,3,17,9,10,51,42,9,60
Vienna,1664,4,16,6,14,59,57,2,54
Rapid Vienna,1664,5,13,13,10,60,37,23,52
RZ Pellets W,1664,6,14,9,13,49,59,-10,51
St. Pölten,1664,7,10,11,15,45,62,-17,41
SV Josko Rie,1664,8,11,5,20,36,54,-18,38
Mattersburg,1664,9,9,9,18,42,57,-15,36
Admira Wacke,1664,10,10,5,21,34,64,-30,35
FC Salzburg,1665,1,22,6,8,65,29,36,72
SC Rheindorf,1665,2,19,8,9,52,41,11,65
SK Sturm Gra,1665,3,18,10,8,61,30,31,64
Rapid Vienna,1665,4,15,9,12,58,42,16,54
Vienna,1665,5,16,4,16,54,56,-2,52
RZ Pellets W,1665,6,13,6,17,45,59,-14,45
St. Pölten,1665,7,11,9,16,38,56,-18,42
Admira Wacke,1665,8,12,5,19,41,55,-14,41
SV Josko Rie,1665,9,11,7,18,41,53,-12,40
Mattersburg,1665,10,6,10,20,34,68,-34,28
FC Salzburg,1666,1,25,7,4,69,26,43,82
SK Sturm Gra,1666,2,20,6,10,61,34,27,66
SC Rheindorf,1666,3,19,7,10,55,42,13,64
Vienna,1666,4,19,4,13,56,51,5,61
Rapid Vienna,1666,5,14,8,14,50,39,11,50
RZ Pellets W,1666,6,13,7,16,45,53,-8,46
Admira Wacke,1666,7,10,8,18,34,58,-24,38
Mattersburg,1666,8,10,7,19,42,61,-19,37
St. Pölten,1666,9,8,10,18,42,62,-20,34
SV Josko Rie,1666,10,8,4,24,34,62,-28,28
FC Salzburg,1667,1,20,9,7,62,31,31,69
SK Sturm Gra,1667,2,19,7,10,61,43,18,64
SC Rheindorf,1667,3,19,7,10,55,46,9,64
Vienna,1667,4,19,5,12,65,53,12,62
Rapid Vienna,1667,5,14,10,12,58,40,18,52
SV Josko Rie,1667,6,14,6,16,39,43,-4,48
RZ Pellets W,1667,7,11,10,15,50,61,-11,43
St. Pölten,1667,8,8,11,17,43,63,-20,35
Admira Wacke,1667,9,8,7,21,31,60,-29,31
Mattersburg,1667,10,6,12,18,36,60,-24,30
FC Salzburg,1668,1,24,6,6,75,29,46,78
SC Rheindorf,1668,2,18,10,8,59,47,12,64
Vienna,1668,3,20,3,13,66,55,11,63
SK Sturm Gra,1668,4,19,5,12,56,38,18,62
Rapid Vienna,1668,5,14,12,10,59,43,16,54
RZ Pellets W,1668,6,14,6,16,48,56,-8,48
Admira Wacke,1668,7,11,6,19,40,62,-22,39
SV Josko Rie,1668,8,10,6,20,33,51,-18,36
St. Pölten,1668,9,7,11,18,41,67,-26,32
Mattersburg,1668,10,7,7,22,33,62,-29,28
FC Salzburg,1669,1,20,7,9,64,32,32,67
Vienna,1669,2,20,6,10,62,50,12,66
SC Rheindorf,1669,3,18,9,9,55,41,14,63
SK Sturm Gra,1669,4,17,7,12,54,34,20,58
Rapid Vienna,1669,5,15,12,9,62,44,18,57
St. Pölten,1669,6,11,9,16,47,60,-13,42
Admira Wacke,1669,7,9,10,17,37,65,-28,37
Mattersburg,1669,8,9,9,18,40,57,-17,36
SV Josko Rie,1669,9,9,9,18,34,53,-19,36
RZ Pellets W,1669,10,9,8,19,48,67,-19,35
FC Salzburg,1670,1,21,7,8,72,34,38,70
Vienna,1670,2,20,6,10,64,48,16,66
SC Rheindorf,1670,3,19,8,9,53,46,7,65
SK Sturm Gra,1670,4,18,8,10,56,38,18,62
Rapid Vienna,1670,5,14,8,14,50,44,6,50
RZ Pellets W,1670,6,14,6,16,51,54,-3,48
St. Pölten,1670,7,10,8,18,46,63,-17,38
SV Josko Rie,1670,8,11,4,21,32,53,-21,37
Admira Wacke,1670,9,8,10,18,36,61,-25,34
Mattersburg,1670,10,7,11,18,36,55,-19,32
FC Salzburg,1671,1,22,6,8,69,32,37,72
SK Sturm Gra,1671,2,21,6,9,59,31,28,69
SC Rheindorf,1671,3,19,6,11,55,47,8,63
Vienna,1671,4,18,6,12,63,52,11,60
RZ Pellets W,1671,5,15,6,15,51,56,-5,51
Rapid Vienna,1671,6,12,13,11,55,45,10,49
SV Josko Rie,1671,7,11,4,21,40,56,-16,37
Mattersburg,1671,8,10,7,19,41,61,-20,37
Admira Wacke,1671,9,10,6,20,39,66,-27,36
St. Pölten,1671,10,8,8,20,43,69,-26,32
FC Salzburg,1672,1,21,6,9,61,30,31,69
SC Rheindorf,1672,2,19,8,9,55,38,17,65
Vienna,1672,3,19,4,13,61,49,12,61
SK Sturm Gra,1672,4,17,8,11,59,41,18,59
Rapid Vienna,1672,5,14,11,11,58,37,21,53
SV Josko Rie,1672,6,15,5,16,42,51,-9,50
RZ Pellets W,1672,7,12,7,17,40,56,-16,43
Admira Wacke,1672,8,12,5,19,36,56,-20,41
Mattersburg,1672,9,9,6,21,32,56,-24,33
St. Pölten,1672,10,7,10,19,32,62,-30,31
SK Sturm Gra,1673,1,22,7,7,68,36,32,73
FC Salzburg,1673,2,20,7,9,58,38,20,67
SC Rheindorf,1673,3,20,5,11,59,47,12,65
Rapid Vienna,1673,4,17,11,8,58,35,23,62
Vienna,1673,5,18,5,13,65,56,9,59
RZ Pellets W,1673,6,12,7,17,46,54,-8,43
SV Josko Rie,1673,7,11,7,18,40,52,-12,40
Admira Wacke,1673,8,10,6,20,36,60,-24,36
Mattersburg,1673,9,8,7,21,35,59,-24,31
St. Pölten,1673,10,6,10,20,40,68,-28,28
FC Salzburg,1674,1,25,6,5,68,27,41,81
SK Sturm Gra,1674,2,18,7,11,50,30,20,61
Rapid Vienna,1674,3,16,11,9,60,37,23,59
Vienna,1674,4,18,3,15,64,52,12,57
SC Rheindorf,1674,5,15,9,12,43,48,-5,54
RZ Pellets W,1674,6,13,7,16,45,53,-8,46
Mattersburg,1674,7,9,12,15,38,52,-14,39
SV Josko Rie,1674,8,9,9,18,35,53,-18,36
Admira Wacke,1674,9,8,10,18,31,60,-29,34
St. Pölten,1674,10,6,12,18,30,52,-22,30
FC Salzburg,1675,1,23,7,6,63,23,40,76
SC Rheindorf,1675,2,21,6,9,56,36,20,69
Vienna,1675,3,20,5,11,60,50,10,65
SK Sturm Gra,1675,4,19,7,10,58,35,23,64
Rapid Vienna,1675,5,10,11,15,50,41,9,41
RZ Pellets W,1675,6,10,9,17,37,56,-19,39
St. Pölten,1675,7,10,9,17,41,62,-21,39
SV Josko Rie,1675,8,11,5,20,35,54,-19,38
Admira Wacke,1675,9,11,4,21,37,58,-21,37
Mattersburg,1675,10,9,9,18,32,54,-22,36
FC Salzburg,1676,1,26,5,5,68,24,44,83
SC Rheindorf,1676,2,19,8,9,51,38,13,65
SK Sturm Gra,1676,3,18,7,11,54,32,22,61
Vienna,1676,4,19,3,14,61,51,10,60
Rapid Vienna,1676,5,12,12,12,49,40,9,48
RZ Pellets W,1676,6,12,9,15,45,54,-9,45
SV Josko Rie,1676,7,13,6,17,35,48,-13,45
Mattersburg,1676,8,10,6,20,43,61,-18,36
Admira Wacke,1676,9,9,9,18,33,58,-25,36
St. Pölten,1676,10,6,7,23,39,72,-33,25
SK Sturm Gra,1677,1,20,8,8,69,36,33,68
FC Salzburg,1677,2,20,8,8,67,34,33,68
SC Rheindorf,1677,3,19,9,8,56,42,14,66
Vienna,1677,4,19,4,13,73,54,19,61
Rapid Vienna,1677,5,15,11,10,58,40,18,56
RZ Pellets W,1677,6,12,7,17,42,56,-14,43
SV Josko Rie,1677,7,12,6,18,39,52,-13,42
Admira Wacke,1677,8,12,6,18,34,65,-31,42
Mattersburg,1677,9,7,9,20,37,66,-29,30
St. Pölten,1677,10,6,8,22,38,68,-30,26
FC Salzburg,1678,1,23,8,5,70,27,43,77
SC Rheindorf,1678,2,20,7,9,62,46,16,67
Vienna,1678,3,17,9,10,61,48,13,60
SK Sturm Gra,1678,4,17,6,13,52,42,10,57
Rapid Vienna,1678,5,13,9,14,49,41,8,48
Admira Wacke,1678,6,12,8,16,43,55,-12,44
RZ Pellets W,1678,7,10,11,15,44,55,-11,41
St. Pölten,1678,8,10,11,15,47,63,-16,41
SV Josko Rie,1678,9,10,5,21,31,53,-22,35
Mattersburg,1678,10,6,10,20,33,62,-29,28
FC Salzburg,1679,1,21,9,6,68,30,38,72
Vienna,1679,2,22,4,10,64,45,19,70
SC Rheindorf,1679,3,18,7,11,55,47,8,61
SK Sturm Gra,1679,4,18,5,13,60,38,22,59
Rapid Vienna,1679,5,13,10,13,51,44,7,49
RZ Pellets W,1679,6,13,8,15,51,55,-4,47
Admira Wacke,1679,7,11,7,18,35,58,-23,40
St. Pölten,1679,8,10,9,17,46,70,-24,39
SV Josko Rie,1679,9,10,5,21,31,53,-22,35
Mattersburg,1679,10,7,10,19,37,58,-21,31
FC Salzburg,1680,1,21,5,10,61,28,33,68
SC Rheindorf,1680,2,19,8,9,54,45,9,65
Vienna,1680,3,19,5,12,60,46,14,62
SK Sturm Gra,1680,4,19,4,13,60,35,25,61
Admira Wacke,1680,5,16,4,16,40,51,-11,52
Rapid Vienna,1680,6,13,9,14,55,44,11,48
SV Josko Rie,1680,7,13,5,18,38,53,-15,44
RZ Pellets W,1680,8,11,10,15,41,52,-11,43
St. Pölten,1680,9,8,10,18,40,63,-23,34
Mattersburg,1680,10,8,6,22,30,62,-32,30
SC Rheindorf,1681,1,20,9,7,54,40,14,69
FC Salzburg,1681,2,20,7,9,68,36,32,67
SK Sturm Gra,1681,3,19,8,9,56,29,27,65
Vienna,1681,4,18,5,13,68,58,10,59
Rapid Vienna,1681,5,13,14,9,57,38,19,53
SV Josko Rie,1681,6,13,5,18,38,59,-21,44
RZ Pellets W,1681,7,11,9,16,46,58,-12,42
Admira Wacke,1681,8,10,8,18,36,62,-26,38
St. Pölten,1681,9,7,11,18,38,59,-21,32
Mattersburg,1681,10,6,10,20,33,55,-22,28
FC Salzburg,1682,1,23,6,7,71,31,40,75
SC Rheindorf,1682,2,22,5,9,68,43,25,71
Vienna,1682,3,19,6,11,62,49,13,63
SK Sturm Gra,1682,4,18,3,15,57,38,19,57
Rapid Vienna,1682,5,16,8,12,57,40,17,56
RZ Pellets W,1682,6,14,6,16,50,59,-9,48
Mattersburg,1682,7,11,5,20,35,52,-17,38
SV Josko Rie,1682,8,11,5,20,31,55,-24,38
St. Pölten,1682,9,9,7,20,47,77,-30,34
Admira Wacke,1682,10,9,5,22,41,75,-34,32
FC Salzburg,1683,1,20,10,6,65,30,35,70
SC Rheindorf,1683,2,22,4,10,58,43,15,70
SK Sturm Gra,1683,3,20,6,10,64,42,22,66
Rapid Vienna,1683,4,16,10,10,64,41,23,58
Vienna,1683,5,18,3,15,60,56,4,57
RZ Pellets W,1683,6,14,5,17,49,56,-7,47
Admira Wacke,1683,7,10,7,19,41,65,-24,37
St. Pölten,1683,8,9,9,18,41,57,-16,36
SV Josko Rie,1683,9,9,6,21,35,60,-25,33
Mattersburg,1683,10,8,8,20,34,61,-27,32
SK Sturm Gra,1684,1,22,5,9,61,32,29,71
FC Salzburg,1684,2,19,10,7,55,25,30,67
SC Rheindorf,1684,3,18,7,11,51,41,10,61
Rapid Vienna,1684,4,14,11,11,51,36,15,53
Vienna,1684,5,14,8,14,59,55,4,50
SV Josko Rie,1684,6,13,7,16,32,45,-13,46
Admira Wacke,1684,7,12,7,17,34,56,-22,43
RZ Pellets W,1684,8,11,7,18,50,62,-12,40
St. Pölten,1684,9,11,7,18,51,65,-14,40
Mattersburg,1684,10,8,7,21,31,58,-27,31
FC Salzburg,1685,1,20,9,7,60,27,33,69
SC Rheindorf,1685,2,20,9,7,60,40,20,69
Vienna,1685,3,18,5,13,55,51,4,59
Rapid Vienna,1685,4,16,10,10,57,36,21,58
SK Sturm Gra,1685,5,13,11,12,55,43,12,50
Admira Wacke,1685,6,12,8,16,40,50,-10,44
RZ Pellets W,1685,7,11,9,16,44,58,-14,42
St. Pölten,1685,8,9,11,16,43,61,-18,38
Mattersburg,1685,9,9,8,19,40,66,-26,35
SV Josko Rie,1685,10,9,6,21,39,61,-22,33
FC Salzburg,1686,1,23,6,7,68,34,34,75
SC Rheindorf,1686,2,21,8,7,56,34,22,71
SK Sturm Gra,1686,3,21,6,9,54,34,20,69
Vienna,1686,4,18,5,13,62,50,12,59
Rapid Vienna,1686,5,12,13,11,54,36,18,49
RZ Pellets W,1686,6,12,6,18,41,54,-13,42
Admira Wacke,1686,7,11,6,19,30,57,-27,39
Mattersburg,1686,8,10,8,18,42,54,-12,38
SV Josko Rie,1686,9,8,7,21,34,62,-28,31
St. Pölten,1686,10,7,9,20,35,61,-26,30
FC Salzburg,1687,1,22,9,5,62,23,39,75
SC Rheindorf,1687,2,19,7,10,58,43,15,64
Vienna,1687,3,20,3,13,65,55,10,63
SK Sturm Gra,1687,4,16,10,10,55,38,17,58
Rapid Vienna,1687,5,14,9,13,55,44,11,51
RZ Pellets W,1687,6,13,5,18,45,60,-15,44
Admira Wacke,1687,7,13,5,18,42,58,-16,44
SV Josko Rie,1687,8,10,7,19,38,55,-17,37
Mattersburg,1687,9,9,8,19,40,57,-17,35
St. Pölten,1687,10,9,7,20,41,68,-27,34
FC Salzburg,1688,1,21,7,8,64,33,31,70
SK Sturm Gra,1688,2,21,4,11,64,33,31,67
SC Rheindorf,1688,3,18,8,10,59,49,10,62
Vienna,1688,4,18,7,11,66,53,13,61
Rapid Vienna,1688,5,15,9,12,57,39,18,54
RZ Pellets W,1688,6,11,9,16,42,53,-11,42
Mattersburg,1688,7,12,6,18,39,56,-17,42
Admira Wacke,1688,8,11,5,20,39,70,-31,38
St. Pölten,1688,9,10,7,19,38,60,-22,37
SV Josko Rie,1688,10,9,6,21,31,53,-22,33
FC Salzburg,1689,1,22,6,8,64,29,35,72
SC Rheindorf,1689,2,20,6,10,66,48,18,66
SK Sturm Gra,1689,3,19,7,10,61,40,21,64
Vienna,1689,4,17,7,12,67,55,12,58
Rapid Vienna,1689,5,15,8,13,59,40,19,53
RZ Pellets W,1689,6,12,8,16,44,53,-9,44
Admira Wacke,1689,7,12,8,16,36,54,-18,44
SV Josko Rie,1689,8,9,8,19,27,53,-26,35
Mattersburg,1689,9,8,10,18,35,59,-24,34
St. Pölten,1689,10,7,10,19,39,67,-28,31
FC Salzburg,1690,1,21,8,7,64,25,39,71
SK Sturm Gra,1690,2,20,6,10,64,29,35,66
SC Rheindorf,1690,3,19,8,9,59,41,18,65
Vienna,1690,4,17,8,11,57,46,11,59
Rapid Vienna,1690,5,16,10,10,59,40,19,58
RZ Pellets W,1690,6,13,9,14,44,51,-7,48
Admira Wacke,1690,7,11,5,20,34,66,-32,38
Mattersburg,1690,8,10,7,19,36,55,-19,37
SV Josko Rie,1690,9,9,5,22,28,59,-31,32
St. Pölten,1690,10,6,10,20,32,65,-33,28
FC Salzburg,1691,1,21,7,8,67,26,41,70
SK Sturm Gra,1691,2,21,7,8,63,34,29,70
Vienna,1691,3,20,6,10,63,41,22,66
SC Rheindorf,1691,4,19,8,9,56,39,17,65
Rapid Vienna,1691,5,14,10,12,54,45,9,52
RZ Pellets W,1691,6,11,9,16,42,56,-14,42
SV Josko Rie,1691,7,12,6,18,34,49,-15,42
Admira Wacke,1691,8,9,7,20,26,62,-36,34
Mattersburg,1691,9,8,9,19,33,54,-21,33
St. Pölten,1691,10,7,7,22,42,74,-32,28
SK Sturm Gra,1692,1,21,7,8,68,34,34,70
SC Rheindorf,1692,2,20,8,8,53,40,13,68
Vienna,1692,3,20,6,10,60,44,16,66
FC Salzburg,1692,4,19,7,10,55,34,21,64
Rapid Vienna,1692,5,12,12,12,58,46,12,48
RZ Pellets W,1692,6,12,8,16,48,60,-12,44
Admira Wacke,1692,7,11,7,18,39,57,-18,40
SV Josko Rie,1692,8,11,4,21,33,53,-20,37
St. Pölten,1692,9,8,9,19,36,62,-26,33
Mattersburg,1692,10,8,8,20,43,63,-20,32
FC Salzburg,1693,1,21,8,7,71,37,34,71
SK Sturm Gra,1693,2,20,10,6,73,33,40,70
SC Rheindorf,1693,3,18,8,10,65,48,17,62
Vienna,1693,4,18,4,14,60,55,5,58
RZ Pellets W,1693,5,14,6,16,49,61,-12,48
Rapid Vienna,1693,6,11,13,12,50,41,9,46
SV Josko Rie,1693,7,13,3,20,39,60,-21,42
Mattersburg,1693,8,10,8,18,39,55,-16,38
Admira Wacke,1693,9,10,7,19,34,61,-27,37
St. Pölten,1693,10,7,9,20,44,73,-29,30
FC Salzburg,1694,1,22,6,8,68,30,38,72
SK Sturm Gra,1694,2,21,7,8,66,31,35,70
Vienna,1694,3,16,8,12,62,56,6,56
SC Rheindorf,1694,4,16,8,12,51,55,-4,56
Rapid Vienna,1694,5,11,14,11,55,44,11,47
SV Josko Rie,1694,6,13,5,18,42,55,-13,44
Admira Wacke,1694,7,11,9,16,36,58,-22,42
RZ Pellets W,1694,8,11,7,18,45,56,-11,40
Mattersburg,1694,9,10,8,18,38,55,-17,38
St. Pölten,1694,10,7,12,17,40,63,-23,33
FC Salzburg,1695,1,22,8,6,64,27,37,74
SC Rheindorf,1695,2,22,5,9,58,40,18,71
SK Sturm Gra,1695,3,18,8,10,57,39,18,62
Vienna,1695,4,18,7,11,61,50,11,61
Rapid Vienna,1695,5,15,11,10,58,37,21,56
RZ Pellets W,1695,6,13,7,16,42,52,-10,46
Admira Wacke,1695,7,11,4,21,31,56,-25,37
SV Josko Rie,1695,8,9,7,20,30,51,-21,34
St. Pölten,1695,9,8,8,20,41,66,-25,32
Mattersburg,1695,10,8,7,21,33,57,-24,31
FC Salzburg,1696,1,24,6,6,70,30,40,78
SC Rheindorf,1696,2,19,10,7,53,38,15,67
Vienna,1696,3,18,7,11,62,54,8,61
SK Sturm Gra,1696,4,15,10,11,50,32,18,55
Rapid Vienna,1696,5,13,11,12,58,44,14,50
RZ Pellets W,1696,6,12,8,16,43,54,-11,44
Admira Wacke,1696,7,11,7,18,30,54,-24,40
SV Josko Rie,1696,8,10,7,19,31,48,-17,37
St. Pölten,1696,9,8,13,15,36,55,-19,37
Mattersburg,1696,10,8,5,23,35,59,-24,29
SK Sturm Gra,1697,1,22,5,9,64,33,31,71
SC Rheindorf,1697,2,19,8,9,52,47,5,65
Vienna,1697,3,19,4,13,61,56,5,61
FC Salzburg,1697,4,16,10,10,64,39,25,58
Rapid Vienna,1697,5,15,12,9,56,34,22,57
RZ Pellets W,1697,6,12,7,17,42,51,-9,43
Mattersburg,1697,7,10,10,16,39,50,-11,40
St. Pölten,1697,8,11,7,18,44,61,-17,40
SV Josko Rie,1697,9,9,7,20,28,51,-23,34
Admira Wacke,1697,10,9,6,21,34,62,-28,33
SC Rheindorf,1698,1,22,7,7,62,39,23,73
FC Salzburg,1698,2,20,10,6,65,27,38,70
SK Sturm Gra,1698,3,19,7,10,60,34,26,64
Vienna,1698,4,17,6,13,56,48,8,57
Rapid Vienna,1698,5,12,11,13,47,43,4,47
Admira Wacke,1698,6,12,5,19,39,60,-21,41
RZ Pellets W,1698,7,10,10,16,38,51,-13,40
Mattersburg,1698,8,10,8,18,34,54,-20,38
SV Josko Rie,1698,9,10,6,20,37,61,-24,36
St. Pölten,1698,10,8,10,18,35,56,-21,34
SK Sturm Gra,1699,1,20,6,10,63,34,29,66
SC Rheindorf,1699,2,19,9,8,50,42,8,66
FC Salzburg,1699,3,18,11,7,56,28,28,65
Vienna,1699,4,19,5,12,63,47,16,62
Rapid Vienna,1699,5,13,9,14,54,40,14,48
RZ Pellets W,1699,6,11,10,15,45,57,-12,43
Mattersburg,1699,7,11,8,17,38,51,-13,41
Admira Wacke,1699,8,10,8,18,39,61,-22,38
SV Josko Rie,1699,9,10,6,20,35,58,-23,36
St. Pölten,1699,10,7,12,17,40,65,-25,33
FC Salzburg,1700,1,21,10,5,65,24,41,73
SC Rheindorf,1700,2,17,11,8,58,38,20,62
Vienna,1700,3,19,5,12,65,52,13,62
SK Sturm Gra,1700,4,17,7,12,53,41,12,58
Rapid Vienna,1700,5,15,11,10,58,36,22,56
RZ Pellets W,1700,6,12,10,14,51,55,-4,46
Admira Wacke,1700,7,13,4,19,37,60,-23,43
Mattersburg,1700,8,9,11,16,36,57,-21,38
SV Josko Rie,1700,9,8,6,22,31,58,-27,30
St. Pölten,1700,10,7,9,20,36,69,-33,30
FC Salzburg,1701,1,20,10,6,68,30,38,70
SK Sturm Gra,1701,2,20,6,10,58,33,25,66
SC Rheindorf,1701,3,20,6,10,51,38,13,66
Vienna,1701,4,16,6,14,55,53,2,54
Rapid Vienna,1701,5,13,10,13,52,43,9,49
RZ Pellets W,1701,6,12,7,17,44,58,-14,43
Admira Wacke,1701,7,10,10,16,34,56,-22,40
St. Pölten,1701,8,10,9,17,43,61,-18,39
SV Josko Rie,1701,9,10,8,18,39,54,-15,38
Mattersburg,1701,10,9,8,19,41,59,-18,35
FC Salzburg,1702,1,22,8,6,67,32,35,74
SK Sturm Gra,1702,2,18,9,9,59,33,26,63
Vienna,1702,3,19,5,12,59,47,12,62
SC Rheindorf,1702,4,17,10,9,53,43,10,61
Rapid Vienna,1702,5,13,11,12,51,42,9,50
Admira Wacke,1702,6,12,9,15,44,56,-12,45
SV Josko Rie,1702,7,13,3,20,34,45,-11,42
RZ Pellets W,1702,8,11,9,16,41,57,-16,42
Mattersburg,1702,9,7,9,20,37,63,-26,30
St. Pölten,1702,10,7,9,20,32,59,-27,30
FC Salzburg,1703,1,24,5,7,71,29,42,77
SC Rheindorf,1703,2,20,7,9,54,43,11,67
SK Sturm Gra,1703,3,20,5,11,58,32,26,65
Rapid Vienna,1703,4,15,9,12,60,45,15,54
Vienna,1703,5,16,5,15,62,58,4,53
SV Josko Rie,1703,6,13,3,20,37,48,-11,42
Mattersburg,1703,7,11,8,17,37,50,-13,41
RZ Pellets W,1703,8,10,9,17,35,56,-21,39
Admira Wacke,1703,9,10,9,17,36,59,-23,39
St. Pölten,1703,10,5,12,19,39,69,-30,27
FC Salzburg,1704,1,24,6,6,71,32,39,78
SC Rheindorf,1704,2,21,6,9,58,37,21,69
SK Sturm Gra,1704,3,17,8,11,55,35,20,59
Vienna,1704,4,18,5,13,67,55,12,59
Rapid Vienna,1704,5,14,10,12,58,40,18,52
Admira Wacke,1704,6,13,5,18,37,56,-19,44
SV Josko Rie,1704,7,13,2,21,40,58,-18,41
RZ Pellets W,1704,8,10,9,17,39,52,-13,39
Mattersburg,1704,9,9,8,19,40,63,-23,35
St. Pölten,1704,10,8,7,21,32,69,-37,31
FC Salzburg,1705,1,21,8,7,67,28,39,71
Vienna,1705,2,22,3,11,67,52,15,69
SK Sturm Gra,1705,3,19,6,11,58,42,16,63
SC Rheindorf,1705,4,17,10,9,55,44,11,61
Rapid Vienna,1705,5,14,9,13,56,44,12,51
Admira Wacke,1705,6,13,6,17,40,56,-16,45
SV Josko Rie,1705,7,12,5,19,43,58,-15,41
RZ Pellets W,1705,8,10,6,20,40,62,-22,36
Mattersburg,1705,9,9,8,19,33,55,-22,35
St. Pölten,1705,10,8,9,19,42,60,-18,33
SK Sturm Gra,1706,1,22,6,8,72,37,35,72
FC Salzburg,1706,2,21,6,9,63,33,30,69
SC Rheindorf,1706,3,19,10,7,59,43,16,67
Vienna,1706,4,19,5,12,66,51,15,62
Rapid Vienna,1706,5,15,9,12,51,40,11,54
Admira Wacke,1706,6,10,9,17,38,57,-19,39
St. Pölten,1706,7,9,9,18,45,69,-24,36
RZ Pellets W,1706,8,9,8,19,42,60,-18,35
SV Josko Rie,1706,9,9,8,19,31,51,-20,35
Mattersburg,1706,10,7,10,19,43,69,-26,31
SK Sturm Gra,1707,1,22,6,8,72,40,32,72
SC Rheindorf,1707,2,18,10,8,56,40,16,64
FC Salzburg,1707,3,17,9,10,59,35,24,60
Vienna,1707,4,18,5,13,67,57,10,59
Rapid Vienna,1707,5,14,12,10,62,43,19,54
RZ Pellets W,1707,6,13,9,14,48,55,-7,48
Admira Wacke,1707,7,14,5,17,40,61,-21,47
Mattersburg,1707,8,8,9,19,42,58,-16,33
St. Pölten,1707,9,7,10,19,37,68,-31,31
SV Josko Rie,1707,10,7,9,20,31,57,-26,30
FC Salzburg,1708,1,19,10,7,59,26,33,67
SC Rheindorf,1708,2,19,10,7,57,41,16,67
Vienna,1708,3,20,3,13,66,52,14,63
SK Sturm Gra,1708,4,18,5,13,60,40,20,59
Rapid Vienna,1708,5,15,10,11,57,40,17,55
RZ Pellets W,1708,6,12,8,16,42,57,-15,44
Admira Wacke,1708,7,12,5,19,35,58,-23,41
SV Josko Rie,1708,8,12,4,20,31,49,-18,40
St. Pölten,1708,9,9,8,19,36,57,-21,35
Mattersburg,1708,10,8,9,19,34,57,-23,33
FC Salzburg,1709,1,19,8,9,61,35,26,65
Vienna,1709,2,20,2,14,63,52,11,62
SC Rheindorf,1709,3,18,6,12,53,47,6,60
SK Sturm Gra,1709,4,17,6,13,52,41,11,57
Rapid Vienna,1709,5,13,11,12,48,40,8,50
Mattersburg,1709,6,14,7,15,45,50,-5,49
Admira Wacke,1709,7,14,5,17,42,52,-10,47
SV Josko Rie,1709,8,13,3,20,35,50,-15,42
RZ Pellets W,1709,9,12,5,19,44,60,-16,41
St. Pölten,1709,10,10,7,19,48,64,-16,37
FC Salzburg,1710,1,24,5,7,66,30,36,77
Vienna,1710,2,20,6,10,67,49,18,66
SC Rheindorf,1710,3,20,6,10,58,48,10,66
SK Sturm Gra,1710,4,19,5,12,58,38,20,62
Rapid Vienna,1710,5,15,10,11,55,42,13,55
Admira Wacke,1710,6,11,8,17,37,56,-19,41
RZ Pellets W,1710,7,10,8,18,43,55,-12,38
Mattersburg,1710,8,10,7,19,44,63,-19,37
SV Josko Rie,1710,9,10,4,22,44,63,-19,34
St. Pölten,1710,10,6,11,19,40,68,-28,29
FC Salzburg,1711,1,20,7,9,70,34,36,67
SK Sturm Gra,1711,2,18,9,9,56,31,25,63
SC Rheindorf,1711,3,18,6,12,47,49,-2,60
Vienna,1711,4,17,6,13,56,51,5,57
Rapid Vienna,1711,5,14,10,12,58,45,13,52
RZ Pellets W,1711,6,14,10,12,44,47,-3,52
SV Josko Rie,1711,7,13,8,15,40,46,-6,47
Admira Wacke,1711,8,10,8,18,34,54,-20,38
St. Pölten,1711,9,8,9,19,40,65,-25,33
Mattersburg,1711,10,8,7,21,37,60,-23,31
FC Salzburg,1712,1,24,7,5,70,25,45,79
SC Rheindorf,1712,2,21,7,8,56,37,19,70
SK Sturm Gra,1712,3,19,6,11,62,43,19,63
Vienna,1712,4,20,2,14,67,52,15,62
Rapid Vienna,1712,5,14,8,14,59,42,17,50
Admira Wacke,1712,6,14,5,17,43,61,-18,47
RZ Pellets W,1712,7,12,5,19,48,67,-19,41
St. Pölten,1712,8,11,7,18,41,63,-22,40
SV Josko Rie,1712,9,11,3,22,38,59,-21,36
Mattersburg,1712,10,5,8,23,27,62,-35,23
FC Salzburg,1713,1,23,6,7,66,28,38,75
SK Sturm Gra,1713,2,21,7,8,60,33,27,70
SC Rheindorf,1713,3,19,9,8,55,40,15,66
Vienna,1713,4,19,5,12,61,52,9,62
Rapid Vienna,1713,5,14,10,12,55,34,21,52
RZ Pellets W,1713,6,12,9,15,40,48,-8,45
St. Pölten,1713,7,9,10,17,43,58,-15,37
Admira Wacke,1713,8,9,8,19,30,57,-27,35
Mattersburg,1713,9,8,8,20,34,57,-23,32
SV Josko Rie,1713,10,8,4,24,21,58,-37,28
SC Rheindorf,1714,1,22,5,9,62,35,27,71
SK Sturm Gra,1714,2,19,8,9,62,34,28,65
FC Salzburg,1714,3,17,11,8,60,36,24,62
Vienna,1714,4,18,7,11,60,52,8,61
Rapid Vienna,1714,5,14,11,11,53,40,13,53
RZ Pellets W,1714,6,13,9,14,45,52,-7,48
St. Pölten,1714,7,8,13,15,44,63,-19,37
Admira Wacke,1714,8,9,9,18,33,56,-23,36
Mattersburg,1714,9,8,9,19,31,58,-27,33
SV Josko Rie,1714,10,7,8,21,33,57,-24,29
FC Salzburg,1715,1,23,9,4,65,25,40,78
SC Rheindorf,1715,2,20,8,8,55,37,18,68
SK Sturm Gra,1715,3,20,6,10,59,34,25,66
Vienna,1715,4,17,7,12,59,53,6,58
Rapid Vienna,1715,5,12,8,16,53,48,5,44
Admira Wacke,1715,6,12,7,17,35,55,-20,43
SV Josko Rie,1715,7,12,5,19,32,47,-15,41
RZ Pellets W,1715,8,10,8,18,40,57,-17,38
St. Pölten,1715,9,10,7,19,41,53,-12,37
Mattersburg,1715,10,8,7,21,28,58,-30,31
SK Sturm Gra,1716,1,21,7,8,62,29,33,70
FC Salzburg,1716,2,21,6,9,65,33,32,69
Vienna,1716,3,21,5,10,59,46,13,68
SC Rheindorf,1716,4,19,8,9,56,43,13,65
Rapid Vienna,1716,5,13,10,13,51,43,8,49
RZ Pellets W,1716,6,12,11,13,48,52,-4,47
Admira Wacke,1716,7,11,5,20,35,58,-23,38
SV Josko Rie,1716,8,10,4,22,33,54,-21,34
St. Pölten,1716,9,7,12,17,41,65,-24,33
Mattersburg,1716,10,6,10,20,33,60,-27,28
FC Salzburg,1717,1,22,7,7,69,31,38,73
SC Rheindorf,1717,2,22,5,9,61,46,15,71
SK Sturm Gra,1717,3,18,9,9,65,38,27,63
Rapid Vienna,1717,4,16,10,10,57,35,22,58
Vienna,1717,5,16,7,13,59,53,6,55
RZ Pellets W,1717,6,12,7,17,46,58,-12,43
Admira Wacke,1717,7,10,8,18,36,64,-28,38
St. Pölten,1717,8,10,7,19,44,62,-18,37
SV Josko Rie,1717,9,10,6,20,35,63,-28,36
Mattersburg,1717,10,6,10,20,34,56,-22,28
Vienna,1718,1,22,4,10,68,46,22,70
FC Salzburg,1718,2,20,8,8,64,34,30,68
SK Sturm Gra,1718,3,18,5,13,57,38,19,59
SC Rheindorf,1718,4,16,8,12,53,48,5,56
RZ Pellets W,1718,5,15,8,13,51,50,1,53
Rapid Vienna,1718,6,12,12,12,53,44,9,48
Mattersburg,1718,7,13,6,17,39,50,-11,45
SV Josko Rie,1718,8,13,5,18,32,46,-14,44
Admira Wacke,1718,9,9,5,22,30,62,-32,32
St. Pölten,1718,10,5,13,18,38,67,-29,28
FC Salzburg,1719,1,19,8,9,61,33,28,65
SK Sturm Gra,1719,2,19,8,9,60,33,27,65
Vienna,1719,3,19,7,10,59,45,14,64
SC Rheindorf,1719,4,20,4,12,56,43,13,64
Rapid Vienna,1719,5,13,14,9,60,42,18,53
RZ Pellets W,1719,6,14,6,16,42,51,-9,48
Mattersburg,1719,7,11,8,17,41,55,-14,41
St. Pölten,1719,8,10,9,17,46,70,-24,39
Admira Wacke,1719,9,8,8,20,36,65,-29,32
SV Josko Rie,1719,10,9,4,23,29,53,-24,31
FC Salzburg,1720,1,21,8,7,66,33,33,71
SC Rheindorf,1720,2,22,4,10,57,41,16,70
SK Sturm Gra,1720,3,18,7,11,57,32,25,61
Vienna,1720,4,18,5,13,59,54,5,59
Rapid Vienna,1720,5,12,11,13,51,42,9,47
RZ Pellets W,1720,6,13,6,17,48,56,-8,45
Admira Wacke,1720,7,11,7,18,40,61,-21,40
St. Pölten,1720,8,10,9,17,44,63,-19,39
Mattersburg,1720,9,10,7,19,42,61,-19,37
SV Josko Rie,1720,10,11,4,21,37,58,-21,37
SC Rheindorf,1721,1,23,6,7,66,38,28,75
FC Salzburg,1721,2,19,9,8,67,33,34,66
SK Sturm Gra,1721,3,19,8,9,65,38,27,65
Rapid Vienna,1721,4,13,15,8,54,42,12,54
Vienna,1721,5,14,9,13,56,58,-2,51
RZ Pellets W,1721,6,13,7,16,41,48,-7,46
St. Pölten,1721,7,10,11,15,56,73,-17,41
Mattersburg,1721,8,11,6,19,36,56,-20,39
SV Josko Rie,1721,9,9,6,21,36,58,-22,33
Admira Wacke,1721,10,7,7,22,28,61,-33,28
SC Rheindorf,1722,1,22,8,6,59,36,23,74
SK Sturm Gra,1722,2,21,6,9,61,37,24,69
FC Salzburg,1722,3,16,8,12,57,44,13,56
Vienna,1722,4,16,7,13,58,54,4,55
Rapid Vienna,1722,5,14,11,11,60,41,19,53
RZ Pellets W,1722,6,11,10,15,47,55,-8,43
SV Josko Rie,1722,7,13,3,20,36,52,-16,42
Admira Wacke,1722,8,10,9,17,41,61,-20,39
St. Pölten,1722,9,10,8,18,44,66,-22,38
Mattersburg,1722,10,9,6,21,39,56,-17,33
FC Salzburg,1723,1,22,7,7,68,32,36,73
SK Sturm Gra,1723,2,20,6,10,67,40,27,66
Vienna,1723,3,18,7,11,67,55,12,61
SC Rheindorf,1723,4,17,10,9,53,45,8,61
Admira Wacke,1723,5,14,4,18,38,51,-13,46
Rapid Vienna,1723,6,11,12,13,50,40,10,45
SV Josko Rie,1723,7,13,5,18,34,49,-15,44
RZ Pellets W,1723,8,12,5,19,42,63,-21,41
St. Pölten,1723,9,8,10,18,45,62,-17,34
Mattersburg,1723,10,7,10,19,34,61,-27,31
FC Salzburg,1724,1,19,10,7,60,28,32,67
Vienna,1724,2,20,6,10,69,53,16,66
SK Sturm Gra,1724,3,18,8,10,59,37,22,62
SC Rheindorf,1724,4,17,8,11,46,40,6,59
Rapid Vienna,1724,5,15,11,10,58,40,18,56
RZ Pellets W,1724,6,14,5,17,51,55,-4,47
St. Pölten,1724,7,11,9,16,45,68,-23,42
Mattersburg,1724,8,9,8,19,36,56,-20,35
SV Josko Rie,1724,9,10,5,21,39,60,-21,35
Admira Wacke,1724,10,10,4,22,36,62,-26,34
FC Salzburg,1725,1,20,9,7,71,38,33,69
SK Sturm Gra,1725,2,20,8,8,62,36,26,68
Vienna,1725,3,18,7,11,60,53,7,61
Rapid Vienna,1725,4,16,10,10,61,43,18,58
SC Rheindorf,1725,5,14,12,10,54,50,4,54
RZ Pellets W,1725,6,14,7,15,43,45,-2,49
St. Pölten,1725,7,10,12,14,51,62,-11,42
SV Josko Rie,1725,8,10,7,19,34,51,-17,37
Admira Wacke,1725,9,9,7,20,35,63,-28,34
Mattersburg,1725,10,6,7,23,33,63,-30,25
FC Salzburg,1726,1,21,7,8,74,39,35,70
SC Rheindorf,1726,2,19,11,6,63,44,19,68
SK Sturm Gra,1726,3,19,10,7,65,37,28,67
Vienna,1726,4,19,5,12,67,57,10,62
RZ Pellets W,1726,5,15,6,15,51,57,-6,51
Rapid Vienna,1726,6,12,14,10,55,42,13,50
Admira Wacke,1726,7,12,6,18,43,61,-18,42
SV Josko Rie,1726,8,9,5,22,32,57,-25,32
St. Pölten,1726,9,6,11,19,41,69,-28,29
Mattersburg,1726,10,6,9,21,33,61,-28,27
FC Salzburg,1727,1,21,6,9,63,31,32,69
SK Sturm Gra,1727,2,20,7,9,63,34,29,67
SC Rheindorf,1727,3,20,6,10,57,39,18,66
Vienna,1727,4,20,4,12,61,51,10,64
RZ Pellets W,1727,5,15,8,13,52,50,2,53
Admira Wacke,1727,6,13,6,17,44,62,-18,45
Rapid Vienna,1727,7,11,9,16,50,44,6,42
SV Josko Rie,1727,8,10,6,20,35,59,-24,36
St. Pölten,1727,9,9,7,20,36,67,-31,34
Mattersburg,1727,10,8,7,21,36,60,-24,31
SK Sturm Gra,1728,1,23,4,9,61,28,33,73
FC Salzburg,1728,2,21,6,9,61,29,32,69
SC Rheindorf,1728,3,15,7,14,51,49,2,52
Vienna,1728,4,15,5,16,59,57,2,50
St. Pölten,1728,5,13,9,14,49,60,-11,48
Admira Wacke,1728,6,14,6,16,40,56,-16,48
RZ Pellets W,1728,7,12,10,14,46,48,-2,46
Rapid Vienna,1728,8,11,9,16,44,47,-3,42
SV Josko Rie,1728,9,11,6,19,32,51,-19,39
Mattersburg,1728,10,10,8,18,36,54,-18,38
FC Salzburg,1729,1,22,6,8,66,30,36,72
SK Sturm Gra,1729,2,21,6,9,53,26,27,69
SC Rheindorf,1729,3,20,8,8,52,39,13,68
Vienna,1729,4,20,5,11,68,52,16,65
Rapid Vienna,1729,5,13,9,14,54,41,13,48
RZ Pellets W,1729,6,13,7,16,44,50,-6,46
Mattersburg,1729,7,11,7,18,37,57,-20,40
SV Josko Rie,1729,8,10,4,22,31,53,-22,34
Admira Wacke,1729,9,9,7,20,40,67,-27,34
St. Pölten,1729,10,7,9,20,34,64,-30,30
FC Salzburg,1730,1,22,7,7,66,32,34,73
SK Sturm Gra,1730,2,19,6,11,56,32,24,63
Vienna,1730,3,20,3,13,64,54,10,63
Rapid Vienna,1730,4,16,11,9,66,34,32,59
SC Rheindorf,1730,5,16,8,12,48,43,5,56
RZ Pellets W,1730,6,15,5,16,46,61,-15,50
Admira Wacke,1730,7,12,7,17,39,57,-18,43
St. Pölten,1730,8,9,11,16,44,61,-17,38
SV Josko Rie,1730,9,9,5,22,30,56,-26,32
Mattersburg,1730,10,6,9,21,31,60,-29,27
FC Salzburg,1731,1,20,11,5,68,29,39,71
SC Rheindorf,1731,2,20,8,8,56,41,15,68
SK Sturm Gra,1731,3,20,6,10,60,33,27,66
Vienna,1731,4,16,5,15,57,54,3,53
Rapid Vienna,1731,5,12,13,11,55,42,13,49
Admira Wacke,1731,6,14,4,18,38,62,-24,46
SV Josko Rie,1731,7,11,7,18,33,50,-17,40
RZ Pellets W,1731,8,11,6,19,43,56,-13,39
St. Pölten,1731,9,9,9,18,43,67,-24,36
Mattersburg,1731,10,8,9,19,36,55,-19,33
FC Salzburg,1732,1,22,8,6,70,31,39,74
SC Rheindorf,1732,2,20,10,6,59,39,20,70
SK Sturm Gra,1732,3,19,5,12,59,36,23,62
Vienna,1732,4,18,4,14,61,55,6,58
Rapid Vienna,1732,5,14,10,12,53,38,15,52
RZ Pellets W,1732,6,13,7,16,46,52,-6,46
Mattersburg,1732,7,12,7,17,47,56,-9,43
Admira Wacke,1732,8,10,6,20,33,65,-32,36
SV Josko Rie,1732,9,9,6,21,40,63,-23,33
St. Pölten,1732,10,7,9,20,35,68,-33,30
Vienna,1733,1,22,3,11,66,45,21,69
SK Sturm Gra,1733,2,20,6,10,64,40,24,66
SC Rheindorf,1733,3,19,8,9,51,42,9,65
FC Salzburg,1733,4,18,10,8,59,30,29,64
RZ Pellets W,1733,5,13,10,13,43,46,-3,49
Rapid Vienna,1733,6,11,12,13,45,42,3,45
Admira Wacke,1733,7,10,9,17,38,62,-24,39
Mattersburg,1733,8,9,9,18,34,55,-21,36
St. Pölten,1733,9,8,10,18,45,63,-18,34
SV Josko Rie,1733,10,9,5,22,36,56,-20,32
FC Salzburg,1734,1,20,8,8,63,32,31,68
Vienna,1734,2,19,7,10,68,51,17,64
SK Sturm Gra,1734,3,18,8,10,60,37,23,62
SC Rheindorf,1734,4,18,8,10,56,48,8,62
RZ Pellets W,1734,5,13,9,14,47,51,-4,48
Rapid Vienna,1734,6,10,16,10,52,38,14,46
SV Josko Rie,1734,7,13,4,19,39,53,-14,43
Admira Wacke,1734,8,12,4,20,43,65,-22,40
St. Pölten,1734,9,8,12,16,41,62,-21,36
Mattersburg,1734,10,6,10,20,33,65,-32,28
FC Salzburg,1735,1,20,9,7,67,30,37,69
SK Sturm Gra,1735,2,19,6,11,63,39,24,63
Rapid Vienna,1735,3,16,12,8,59,39,20,60
SC Rheindorf,1735,4,18,6,12,50,38,12,60
Vienna,1735,5,18,5,13,56,56,0,59
Admira Wacke,1735,6,14,6,16,41,58,-17,48
RZ Pellets W,1735,7,11,9,16,45,51,-6,42
Mattersburg,1735,8,10,8,18,40,56,-16,38
SV Josko Rie,1735,9,9,4,23,36,59,-23,31
St. Pölten,1735,10,6,13,17,38,69,-31,31
FC Salzburg,1736,1,25,7,4,73,23,50,82
SK Sturm Gra,1736,2,19,6,11,58,35,23,63
SC Rheindorf,1736,3,18,9,9,56,48,8,63
Vienna,1736,4,18,5,13,62,53,9,59
RZ Pellets W,1736,5,14,6,16,51,53,-2,48
Rapid Vienna,1736,6,12,11,13,55,46,9,47
Admira Wacke,1736,7,13,7,16,42,62,-20,46
SV Josko Rie,1736,8,12,5,19,42,58,-16,41
St. Pölten,1736,9,7,9,20,32,64,-32,30
Mattersburg,1736,10,5,9,22,33,62,-29,24
SC Rheindorf,1737,1,21,8,7,57,38,19,71
Vienna,1737,2,19,7,10,62,47,15,64
FC Salzburg,1737,3,18,8,10,61,39,22,62
SK Sturm Gra,1737,4,16,8,12,55,40,15,56
Rapid Vienna,1737,5,12,12,12,53,46,7,48
SV Josko Rie,1737,6,12,6,18,36,57,-21,42
RZ Pellets W,1737,7,10,9,17,46,54,-8,39
St. Pölten,1737,8,10,9,17,46,59,-13,39
Admira Wacke,1737,9,10,9,17,41,59,-18,39
Mattersburg,1737,10,9,10,17,40,58,-18,37
Vienna,1738,1,21,5,10,63,45,18,68
FC Salzburg,1738,2,18,10,8,59,31,28,64
SC Rheindorf,1738,3,18,9,9,59,46,13,63
SK Sturm Gra,1738,4,18,6,12,56,35,21,60
Rapid Vienna,1738,5,12,14,10,55,41,14,50
RZ Pellets W,1738,6,11,9,16,39,51,-12,42
Admira Wacke,1738,7,10,9,17,41,64,-23,39
SV Josko Rie,1738,8,10,8,18,37,55,-18,38
Mattersburg,1738,9,8,12,16,38,54,-16,36
St. Pölten,1738,10,8,10,18,36,61,-25,34
FC Salzburg,1739,1,23,8,5,70,27,43,77
SK Sturm Gra,1739,2,21,5,10,66,32,34,68
SC Rheindorf,1739,3,18,8,10,53,47,6,62
Vienna,1739,4,17,6,13,62,59,3,57
Rapid Vienna,1739,5,13,11,12,55,45,10,50
RZ Pellets W,1739,6,13,10,13,51,52,-1,49
SV Josko Rie,1739,7,10,9,17,41,56,-15,39
Admira Wacke,1739,8,9,6,21,35,68,-33,33
Mattersburg,1739,9,7,11,18,30,51,-21,32
St. Pölten,1739,10,7,10,19,40,66,-26,31
SC Rheindorf,1740,1,21,7,8,55,38,17,70
SK Sturm Gra,1740,2,21,6,9,62,31,31,69
FC Salzburg,1740,3,19,11,6,64,30,34,68
Vienna,1740,4,16,4,16,56,63,-7,52
Rapid Vienna,1740,5,12,10,14,56,48,8,46
RZ Pellets W,1740,6,11,10,15,52,55,-3,43
Admira Wacke,1740,7,12,6,18,31,54,-23,42
St. Pölten,1740,8,11,8,17,43,68,-25,41
SV Josko Rie,1740,9,11,6,19,34,47,-13,39
Mattersburg,1740,10,7,10,19,32,51,-19,31
FC Salzburg,1741,1,21,8,7,68,34,34,71
SC Rheindorf,1741,2,20,8,8,56,41,15,68
SK Sturm Gra,1741,3,19,8,9,62,37,25,65
Vienna,1741,4,19,4,13,60,50,10,61
Rapid Vienna,1741,5,11,13,12,45,36,9,46
Admira Wacke,1741,6,13,7,16,44,57,-13,46
RZ Pellets W,1741,7,12,8,16,45,53,-8,44
St. Pölten,1741,8,8,10,18,40,65,-25,34
Mattersburg,1741,9,8,9,19,36,57,-21,33
SV Josko Rie,1741,10,9,5,22,34,60,-26,32
SK Sturm Gra,1742,1,22,7,7,60,25,35,73
FC Salzburg,1742,2,18,10,8,56,32,24,64
Vienna,1742,3,19,6,11,67,55,12,63
SC Rheindorf,1742,4,18,8,10,51,41,10,62
Rapid Vienna,1742,5,14,11,11,60,41,19,53
RZ Pellets W,1742,6,13,9,14,51,57,-6,48
Admira Wacke,1742,7,11,6,19,39,62,-23,39
SV Josko Rie,1742,8,10,7,19,39,55,-16,37
St. Pölten,1742,9,6,13,17,42,70,-28,31
Mattersburg,1742,10,7,7,22,32,59,-27,28
FC Salzburg,1743,1,21,10,5,75,36,39,73
SK Sturm Gra,1743,2,18,8,10,57,33,24,62
Vienna,1743,3,18,5,13,63,53,10,59
SC Rheindorf,1743,4,17,7,12,55,49,6,58
Rapid Vienna,1743,5,13,11,12,58,42,16,50
Admira Wacke,1743,6,14,5,17,42,57,-15,47
SV Josko Rie,1743,7,13,5,18,34,51,-17,44
Mattersburg,1743,8,10,8,18,47,63,-16,38
RZ Pellets W,1743,9,10,6,20,43,69,-26,36
St. Pölten,1743,10,8,11,17,50,71,-21,35
SC Rheindorf,1744,1,20,7,9,63,43,20,67
FC Salzburg,1744,2,18,10,8,65,36,29,64
SK Sturm Gra,1744,3,18,9,9,60,33,27,63
Vienna,1744,4,16,6,14,55,52,3,54
Rapid Vienna,1744,5,12,12,12,49,41,8,48
RZ Pellets W,1744,6,13,7,16,45,54,-9,46
SV Josko Rie,1744,7,10,10,16,33,51,-18,40
Mattersburg,1744,8,10,9,17,39,59,-20,39
Admira Wacke,1744,9,10,9,17,31,53,-22,39
St. Pölten,1744,10,9,9,18,41,59,-18,36
FC Salzburg,1745,1,22,7,7,70,30,40,73
SK Sturm Gra,1745,2,19,9,8,57,33,24,66
SC Rheindorf,1745,3,18,11,7,55,37,18,65
Vienna,1745,4,17,7,12,61,51,10,58
Rapid Vienna,1745,5,14,12,10,56,39,17,54
RZ Pellets W,1745,6,13,6,17,49,60,-11,45
Admira Wacke,1745,7,12,9,15,36,53,-17,45
SV Josko Rie,1745,8,9,5,22,31,54,-23,32
Mattersburg,1745,9,7,10,19,31,55,-24,31
St. Pölten,1745,10,5,12,19,38,72,-34,27
FC Salzburg,1746,1,24,6,6,62,25,37,78
SK Sturm Gra,1746,2,23,5,8,67,33,34,74
SC Rheindorf,1746,3,18,9,9,52,40,12,63
Vienna,1746,4,16,6,14,65,58,7,54
Rapid Vienna,1746,5,14,11,11,64,47,17,53
RZ Pellets W,1746,6,11,10,15,47,56,-9,43
Admira Wacke,1746,7,12,4,20,34,60,-26,40
St. Pölten,1746,8,9,11,16,44,61,-17,38
SV Josko Rie,1746,9,9,6,21,31,58,-27,33
Mattersburg,1746,10,6,8,22,33,61,-28,26
FC Salzburg,1747,1,22,6,8,71,34,37,72
SK Sturm Gra,1747,2,19,6,11,58,40,18,63
SC Rheindorf,1747,3,18,9,9,65,48,17,63
Vienna,1747,4,17,6,13,60,48,12,57
Rapid Vienna,1747,5,15,11,10,59,41,18,56
RZ Pellets W,1747,6,13,6,17,47,62,-15,45
Mattersburg,1747,7,12,8,16,44,54,-10,44
Admira Wacke,1747,8,10,8,18,40,60,-20,38
St. Pölten,1747,9,8,10,18,42,68,-26,34
SV Josko Rie,1747,10,8,6,22,27,58,-31,30
FC Salzburg,1748,1,22,7,7,70,29,41,73
SC Rheindorf,1748,2,20,7,9,58,43,15,67
SK Sturm Gra,1748,3,19,8,9,59,32,27,65
Vienna,1748,4,17,5,14,62,53,9,56
Rapid Vienna,1748,5,15,9,12,54,39,15,54
RZ Pellets W,1748,6,11,8,17,39,58,-19,41
SV Josko Rie,1748,7,11,6,19,39,57,-18,39
St. Pölten,1748,8,10,8,18,40,63,-23,38
Mattersburg,1748,9,9,10,17,37,51,-14,37
Admira Wacke,1748,10,9,6,21,33,66,-33,33
FC Salzburg,1749,1,26,5,5,75,30,45,83
SC Rheindorf,1749,2,19,6,11,54,46,8,63
SK Sturm Gra,1749,3,19,5,12,59,35,24,62
Vienna,1749,4,19,5,12,66,48,18,62
Rapid Vienna,1749,5,13,12,11,56,40,16,51
RZ Pellets W,1749,6,13,6,17,45,52,-7,45
SV Josko Rie,1749,7,13,4,19,37,53,-16,43
Admira Wacke,1749,8,11,6,19,38,66,-28,39
Mattersburg,1749,9,8,7,21,34,60,-26,31
St. Pölten,1749,10,7,8,21,34,68,-34,29
SC Rheindorf,1750,1,21,6,9,64,42,22,69
SK Sturm Gra,1750,2,20,5,11,62,45,17,65
FC Salzburg,1750,3,17,9,10,63,39,24,60
Vienna,1750,4,16,9,11,64,55,9,57
Rapid Vienna,1750,5,14,11,11,54,42,12,53
RZ Pellets W,1750,6,13,7,16,47,53,-6,46
SV Josko Rie,1750,7,13,5,18,40,56,-16,44
Admira Wacke,1750,8,11,8,17,38,58,-20,41
St. Pölten,1750,9,8,11,17,38,64,-26,35
Mattersburg,1750,10,8,7,21,35,51,-16,31
FC Salzburg,1751,1,20,9,7,65,34,31,69
SK Sturm Gra,1751,2,19,6,11,65,36,29,63
SC Rheindorf,1751,3,17,9,10,56,45,11,60
Rapid Vienna,1751,4,15,12,9,52,34,18,57
Vienna,1751,5,16,8,12,61,56,5,56
RZ Pellets W,1751,6,14,9,13,51,54,-3,51
Admira Wacke,1751,7,12,7,17,41,56,-15,43
SV Josko Rie,1751,8,10,6,20,36,57,-21,36
St. Pölten,1751,9,9,8,19,42,70,-28,35
Mattersburg,1751,10,7,8,21,37,64,-27,29
Vienna,1752,1,20,7,9,66,44,22,67
SC Rheindorf,1752,2,19,8,9,56,38,18,65
FC Salzburg,1752,3,18,9,9,61,28,33,63
Rapid Vienna,1752,4,17,9,10,66,41,25,60
SK Sturm Gra,1752,5,15,11,10,53,33,20,56
Admira Wacke,1752,6,14,5,17,41,59,-18,47
St. Pölten,1752,7,9,10,17,43,66,-23,37
RZ Pellets W,1752,8,9,9,18,37,68,-31,36
Mattersburg,1752,9,9,8,19,39,57,-18,35
SV Josko Rie,1752,10,9,6,21,29,57,-28,33
SC Rheindorf,1753,1,22,8,6,58,38,20,74
FC Salzburg,1753,2,20,9,7,61,29,32,69
SK Sturm Gra,1753,3,19,7,10,63,38,25,64
Vienna,1753,4,19,4,13,62,57,5,61
RZ Pellets W,1753,5,13,6,17,42,48,-6,45
Admira Wacke,1753,6,12,9,15,43,54,-11,45
Rapid Vienna,1753,7,11,11,14,53,50,3,44
St. Pölten,1753,8,9,10,17,38,60,-22,37
SV Josko Rie,1753,9,8,8,20,30,53,-23,32
Mattersburg,1753,10,7,8,21,39,62,-23,29
FC Salzburg,1754,1,26,5,5,67,25,42,83
SK Sturm Gra,1754,2,20,4,12,57,36,21,64
Vienna,1754,3,19,5,12,68,50,18,62
SC Rheindorf,1754,4,17,7,12,56,46,10,58
Rapid Vienna,1754,5,14,11,11,54,40,14,53
Admira Wacke,1754,6,14,4,18,38,57,-19,46
RZ Pellets W,1754,7,13,6,17,44,49,-5,45
SV Josko Rie,1754,8,11,5,20,37,60,-23,38
Mattersburg,1754,9,7,9,20,36,61,-25,30
St. Pölten,1754,10,7,8,21,39,72,-33,29
FC Salzburg,1755,1,23,6,7,79,30,49,75
SC Rheindorf,1755,2,20,8,8,52,41,11,68
SK Sturm Gra,1755,3,19,8,9,55,29,26,65
Vienna,1755,4,19,6,11,70,57,13,63
Rapid Vienna,1755,5,12,13,11,51,43,8,49
RZ Pellets W,1755,6,12,9,15,45,55,-10,45
Admira Wacke,1755,7,10,8,18,36,59,-23,38
SV Josko Rie,1755,8,9,6,21,32,58,-26,33
St. Pölten,1755,9,7,11,18,40,64,-24,32
Mattersburg,1755,10,6,11,19,35,59,-24,29
FC Salzburg,1756,1,19,9,8,59,26,33,66
Vienna,1756,2,18,7,11,72,51,21,61
SC Rheindorf,1756,3,18,7,11,53,47,6,61
SK Sturm Gra,1756,4,16,8,12,54,38,16,56
RZ Pellets W,1756,5,16,7,13,55,50,5,55
Rapid Vienna,1756,6,14,10,12,52,37,15,52
SV Josko Rie,1756,7,12,6,18,35,47,-12,42
Admira Wacke,1756,8,11,7,18,36,67,-31,40
Mattersburg,1756,9,8,11,17,39,61,-22,35
St. Pölten,1756,10,8,8,20,34,65,-31,32
FC Salzburg,1757,1,22,7,7,59,24,35,73
Vienna,1757,2,22,5,9,69,42,27,71
SK Sturm Gra,1757,3,20,8,8,52,25,27,68
SC Rheindorf,1757,4,20,8,8,57,39,18,68
Rapid Vienna,1757,5,13,10,13,50,38,12,49
Admira Wacke,1757,6,11,8,17,34,54,-20,41
RZ Pellets W,1757,7,12,5,19,42,65,-23,41
St. Pölten,1757,8,10,10,16,44,55,-11,40
SV Josko Rie,1757,9,8,6,22,28,60,-32,30
Mattersburg,1757,10,4,9,23,27,60,-33,21
SC Rheindorf,1758,1,20,11,5,56,34,22,71
FC Salzburg,1758,2,19,10,7,59,29,30,67
SK Sturm Gra,1758,3,20,6,10,61,32,29,66
Vienna,1758,4,18,7,11,65,58,7,61
Rapid Vienna,1758,5,13,10,13,57,43,14,49
Admira Wacke,1758,6,13,6,17,38,56,-18,45
Mattersburg,1758,7,9,10,17,32,50,-18,37
SV Josko Rie,1758,8,11,4,21,33,57,-24,37
RZ Pellets W,1758,9,10,6,20,42,56,-14,36
St. Pölten,1758,10,9,6,21,39,67,-28,33
FC Salzburg,1759,1,20,10,6,61,31,30,70
SC Rheindorf,1759,2,21,6,9,63,45,18,69
Vienna,1759,3,17,10,9,67,50,17,61
SK Sturm Gra,1759,4,16,10,10,54,33,21,58
Rapid Vienna,1759,5,13,12,11,52,39,13,51
RZ Pellets W,1759,6,12,6,18,47,59,-12,42
Mattersburg,1759,7,11,8,17,37,49,-12,41
SV Josko Rie,1759,8,11,4,21,30,59,-29,37
Admira Wacke,1759,9,8,11,17,38,59,-21,35
St. Pölten,1759,10,8,9,19,42,67,-25,33
FC Salzburg,1760,1,23,8,5,63,29,34,77
SK Sturm Gra,1760,2,19,7,10,59,35,24,64
Vienna,1760,3,20,4,12,67,55,12,64
SC Rheindorf,1760,4,17,8,11,54,44,10,59
RZ Pellets W,1760,5,15,9,12,50,45,5,54
Rapid Vienna,1760,6,12,12,12,52,42,10,48
Admira Wacke,1760,7,10,8,18,36,62,-26,38
SV Josko Rie,1760,8,9,6,21,34,60,-26,33
St. Pölten,1760,9,7,11,18,44,66,-22,32
Mattersburg,1760,10,7,9,20,38,59,-21,30
FC Salzburg,1761,1,20,10,6,69,31,38,70
SC Rheindorf,1761,2,21,7,8,65,40,25,70
SK Sturm Gra,1761,3,20,6,10,59,35,24,66
Vienna,1761,4,18,4,14,66,56,10,58
Rapid Vienna,1761,5,12,13,11,57,44,13,49
Mattersburg,1761,6,11,8,17,43,63,-20,41
RZ Pellets W,1761,7,10,10,16,46,63,-17,40
SV Josko Rie,1761,8,12,3,21,39,56,-17,39
St. Pölten,1761,9,10,8,18,39,58,-19,38
Admira Wacke,1761,10,8,7,21,36,73,-37,31
FC Salzburg,1762,1,22,6,8,69,37,32,72
SK Sturm Gra,1762,2,20,8,8,64,33,31,68
Vienna,1762,3,18,7,11,58,50,8,61
SC Rheindorf,1762,4,16,9,11,55,51,4,57
Rapid Vienna,1762,5,15,10,11,54,36,18,55
RZ Pellets W,1762,6,13,7,16,41,51,-10,46
Mattersburg,1762,7,10,8,18,37,51,-14,38
St. Pölten,1762,8,10,8,18,43,59,-16,38
Admira Wacke,1762,9,10,7,19,36,60,-24,37
SV Josko Rie,1762,10,9,4,23,30,59,-29,31
SC Rheindorf,1763,1,21,7,8,54,35,19,70
FC Salzburg,1763,2,20,5,11,65,39,26,65
Rapid Vienna,1763,3,18,8,10,63,37,26,62
SK Sturm Gra,1763,4,18,8,10,59,33,26,62
Vienna,1763,5,18,5,13,69,54,15,59
SV Josko Rie,1763,6,14,4,18,39,56,-17,46
Admira Wacke,1763,7,12,6,18,38,62,-24,42
Mattersburg,1763,8,9,9,18,37,57,-20,36
RZ Pellets W,1763,9,8,9,19,39,58,-19,33
St. Pölten,1763,10,8,7,21,37,69,-32,31
SK Sturm Gra,1764,1,21,6,9,62,33,29,69
FC Salzburg,1764,2,20,8,8,71,35,36,68
SC Rheindorf,1764,3,18,12,6,55,42,13,66
Rapid Vienna,1764,4,16,11,9,60,42,18,59
Vienna,1764,5,17,5,14,57,53,4,56
RZ Pellets W,1764,6,14,6,16,51,61,-10,48
Mattersburg,1764,7,13,8,15,46,51,-5,47
Admira Wacke,1764,8,9,9,18,35,58,-23,36
SV Josko Rie,1764,9,7,5,24,29,56,-27,26
St. Pölten,1764,10,6,8,22,42,77,-35,26
FC Salzburg,1765,1,21,6,9,70,41,29,69
SC Rheindorf,1765,2,18,9,9,51,42,9,63
SK Sturm Gra,1765,3,17,8,11,56,32,24,59
Rapid Vienna,1765,4,17,8,11,59,44,15,59
Vienna,1765,5,15,8,13,53,48,5,53
RZ Pellets W,1765,6,13,8,15,47,54,-7,47
Admira Wacke,1765,7,13,6,17,46,56,-10,45
SV Josko Rie,1765,8,12,6,18,35,51,-16,42
St. Pölten,1765,9,6,14,16,42,63,-21,32
Mattersburg,1765,10,8,7,21,37,65,-28,31
SK Sturm Gra,1766,1,20,9,7,61,34,27,69
SC Rheindorf,1766,2,21,6,9,58,39,19,69
FC Salzburg,1766,3,18,8,10,61,36,25,62
Vienna,1766,4,18,3,15,68,65,3,57
Rapid Vienna,1766,5,13,11,12,52,43,9,50
RZ Pellets W,1766,6,11,9,16,49,57,-8,42
St. Pölten,1766,7,10,10,16,44,60,-16,40
SV Josko Rie,1766,8,12,4,20,36,53,-17,40
Mattersburg,1766,9,10,9,17,43,53,-10,39
Admira Wacke,1766,10,9,7,20,39,71,-32,34
SK Sturm Gra,1767,1,22,7,7,69,33,36,73
SC Rheindorf,1767,2,19,10,7,53,36,17,67
Vienna,1767,3,19,7,10,66,50,16,64
FC Salzburg,1767,4,17,8,11,54,35,19,59
Rapid Vienna,1767,5,12,11,13,47,37,10,47
RZ Pellets W,1767,6,12,8,16,45,53,-8,44
Admira Wacke,1767,7,12,7,17,40,59,-19,43
St. Pölten,1767,8,8,11,17,40,64,-24,35
Mattersburg,1767,9,8,10,18,36,56,-20,34
SV Josko Rie,1767,10,9,5,22,29,56,-27,32
FC Salzburg,1768,1,22,5,9,66,31,35,71
SK Sturm Gra,1768,2,20,7,9,70,35,35,67
Vienna,1768,3,20,4,12,66,54,12,64
SC Rheindorf,1768,4,19,7,10,56,45,11,64
Rapid Vienna,1768,5,11,15,10,55,37,18,48
RZ Pellets W,1768,6,12,9,15,45,58,-13,45
SV Josko Rie,1768,7,11,7,18,37,55,-18,40
Mattersburg,1768,8,9,9,18,38,59,-21,36
Admira Wacke,1768,9,10,6,20,31,59,-28,36
St. Pölten,1768,10,7,9,20,35,66,-31,30
SC Rheindorf,1769,1,19,10,7,61,38,23,67
Vienna,1769,2,19,5,12,66,55,11,62
FC Salzburg,1769,3,18,7,11,58,36,22,61
SK Sturm Gra,1769,4,18,7,11,55,40,15,61
Rapid Vienna,1769,5,14,11,11,56,35,21,53
RZ Pellets W,1769,6,13,7,16,47,55,-8,46
Admira Wacke,1769,7,11,7,18,41,61,-20,40
St. Pölten,1769,8,9,11,16,46,66,-20,38
Mattersburg,1769,9,8,12,16,35,55,-20,36
SV Josko Rie,1769,10,10,5,21,39,63,-24,35
FC Salzburg,1770,1,21,8,7,68,30,38,71
SC Rheindorf,1770,2,20,8,8,58,42,16,68
Vienna,1770,3,16,10,10,66,52,14,58
SK Sturm Gra,1770,4,17,7,12,53,44,9,58
Rapid Vienna,1770,5,12,13,11,57,41,16,49
Mattersburg,1770,6,12,8,16,41,54,-13,44
RZ Pellets W,1770,7,12,6,18,47,64,-17,42
SV Josko Rie,1770,8,11,6,19,38,55,-17,39
Admira Wacke,1770,9,10,9,17,41,61,-20,39
St. Pölten,1770,10,6,11,19,32,58,-26,29
FC Salzburg,1771,1,20,9,7,62,30,32,69
SK Sturm Gra,1771,2,20,7,9,51,29,22,67
SC Rheindorf,1771,3,19,9,8,55,41,14,66
Vienna,1771,4,18,4,14,63,54,9,58
Rapid Vienna,1771,5,14,10,12,49,38,11,52
Admira Wacke,1771,6,11,10,15,37,51,-14,43
RZ Pellets W,1771,7,11,7,18,44,58,-14,40
SV Josko Rie,1771,8,11,5,20,45,61,-16,38
St. Pölten,1771,9,8,12,16,40,58,-18,36
Mattersburg,1771,10,6,11,19,33,59,-26,29
FC Salzburg,1772,1,22,6,8,64,26,38,72
SC Rheindorf,1772,2,20,9,7,52,37,15,69
SK Sturm Gra,1772,3,17,6,13,55,32,23,57
Rapid Vienna,1772,4,15,10,11,56,43,13,55
Vienna,1772,5,16,6,14,59,54,5,54
RZ Pellets W,1772,6,10,11,15,41,57,-16,41
Mattersburg,1772,7,10,10,16,39,52,-13,40
Admira Wacke,1772,8,10,8,18,37,57,-20,38
SV Josko Rie,1772,9,10,6,20,31,51,-20,36
St. Pölten,1772,10,8,12,16,33,58,-25,36
FC Salzburg,1773,1,20,8,8,64,31,33,68
SK Sturm Gra,1773,2,20,7,9,62,29,33,67
Vienna,1773,3,18,6,12,62,50,12,60
SC Rheindorf,1773,4,17,7,12,49,45,4,58
Admira Wacke,1773,5,13,9,14,42,55,-13,48
Rapid Vienna,1773,6,13,8,15,59,45,14,47
RZ Pellets W,1773,7,13,6,17,46,55,-9,45
SV Josko Rie,1773,8,11,6,19,36,56,-20,39
Mattersburg,1773,9,9,9,18,35,57,-22,36
St. Pölten,1773,10,8,10,18,37,69,-32,34
FC Salzburg,1774,1,22,6,8,63,28,35,72
SC Rheindorf,1774,2,20,6,10,60,42,18,66
Vienna,1774,3,20,3,13,59,53,6,63
SK Sturm Gra,1774,4,17,5,14,55,45,10,56
Rapid Vienna,1774,5,14,7,15,57,51,6,49
SV Josko Rie,1774,6,15,3,18,45,53,-8,48
RZ Pellets W,1774,7,12,5,19,50,60,-10,41
Mattersburg,1774,8,11,7,18,41,54,-13,40
Admira Wacke,1774,9,11,7,18,39,61,-22,40
St. Pölten,1774,10,10,7,19,47,69,-22,37
FC Salzburg,1775,1,22,8,6,67,26,41,74
SK Sturm Gra,1775,2,21,7,8,59,28,31,70
SC Rheindorf,1775,3,17,9,10,49,40,9,60
Rapid Vienna,1775,4,17,8,11,55,37,18,59
Vienna,1775,5,17,6,13,58,52,6,57
RZ Pellets W,1775,6,12,9,15,39,53,-14,45
Admira Wacke,1775,7,10,7,19,37,62,-25,37
Mattersburg,1775,8,7,12,17,34,51,-17,33
SV Josko Rie,1775,9,9,6,21,31,59,-28,33
St. Pölten,1775,10,8,8,20,40,61,-21,32
FC Salzburg,1776,1,21,9,6,69,34,35,72
SC Rheindorf,1776,2,21,7,8,53,35,18,70
SK Sturm Gra,1776,3,19,9,8,67,38,29,66
Vienna,1776,4,18,3,15,65,57,8,57
Rapid Vienna,1776,5,15,10,11,65,45,20,55
RZ Pellets W,1776,6,12,5,19,43,61,-18,41
Mattersburg,1776,7,10,8,18,39,55,-16,38
Admira Wacke,1776,8,10,7,19,46,73,-27,37
St. Pölten,1776,9,9,8,19,40,67,-27,35
SV Josko Rie,1776,10,10,4,22,32,54,-22,34
SK Sturm Gra,1777,1,21,6,9,64,32,32,69
FC Salzburg,1777,2,19,8,9,70,38,32,65
SC Rheindorf,1777,3,16,8,12,46,46,0,56
Vienna,1777,4,16,5,15,61,57,4,53
Rapid Vienna,1777,5,14,10,12,60,46,14,52
RZ Pellets W,1777,6,15,6,15,49,54,-5,51
Mattersburg,1777,7,11,9,16,48,57,-9,42
St. Pölten,1777,8,11,8,17,44,65,-21,41
SV Josko Rie,1777,9,12,4,20,38,58,-20,40
Admira Wacke,1777,10,10,6,20,28,55,-27,36
FC Salzburg,1778,1,21,6,9,71,36,35,69
Vienna,1778,2,20,7,9,77,47,30,67
SK Sturm Gra,1778,3,19,5,12,60,40,20,62
Rapid Vienna,1778,4,17,10,9,73,44,29,61
SC Rheindorf,1778,5,17,9,10,50,50,0,60
SV Josko Rie,1778,6,13,4,19,37,50,-13,43
Admira Wacke,1778,7,12,5,19,42,70,-28,41
RZ Pellets W,1778,8,10,6,20,42,68,-26,36
St. Pölten,1778,9,9,9,18,45,72,-27,36
Mattersburg,1778,10,7,9,20,42,62,-20,30
FC Salzburg,1779,1,21,10,5,68,28,40,73
SK Sturm Gra,1779,2,20,8,8,58,34,24,68
Vienna,1779,3,20,5,11,71,51,20,65
SC Rheindorf,1779,4,19,7,10,56,46,10,64
Rapid Vienna,1779,5,11,11,14,46,44,2,44
RZ Pellets W,1779,6,12,8,16,37,50,-13,44
Admira Wacke,1779,7,12,6,18,42,59,-17,42
St. Pölten,1779,8,10,11,15,44,56,-12,41
SV Josko Rie,1779,9,11,4,21,37,56,-19,37
Mattersburg,1779,10,6,6,24,34,69,-35,24
FC Salzburg,1780,1,23,6,7,65,27,38,75
SK Sturm Gra,1780,2,21,5,10,65,36,29,68
SC Rheindorf,1780,3,16,9,11,53,47,6,57
Vienna,1780,4,17,5,14,59,57,2,56
RZ Pellets W,1780,5,15,7,14,47,50,-3,52
Rapid Vienna,1780,6,12,11,13,49,43,6,47
SV Josko Rie,1780,7,13,5,18,45,56,-11,44
Admira Wacke,1780,8,12,7,17,39,57,-18,43
Mattersburg,1780,9,7,13,16,35,50,-15,34
St. Pölten,1780,10,6,8,22,39,73,-34,26
FC Salzburg,1781,1,23,6,7,68,32,36,75
SK Sturm Gra,1781,2,19,8,9,55,31,24,65
Vienna,1781,3,19,4,13,64,50,14,61
SC Rheindorf,1781,4,18,7,11,52,42,10,61
Rapid Vienna,1781,5,15,11,10,56,41,15,56
Admira Wacke,1781,6,13,9,14,43,52,-9,48
RZ Pellets W,1781,7,11,11,14,43,53,-10,44
SV Josko Rie,1781,8,9,7,20,31,55,-24,34
St. Pölten,1781,9,6,11,19,41,68,-27,29
Mattersburg,1781,10,7,6,23,34,63,-29,27
SC Rheindorf,1782,1,21,5,10,55,41,14,68
FC Salzburg,1782,2,20,7,9,69,33,36,67
SK Sturm Gra,1782,3,20,6,10,61,35,26,66
Vienna,1782,4,18,4,14,61,55,6,58
Rapid Vienna,1782,5,13,12,11,51,41,10,51
Mattersburg,1782,6,11,10,15,46,52,-6,43
RZ Pellets W,1782,7,12,7,17,46,60,-14,43
Admira Wacke,1782,8,11,5,20,34,66,-32,38
St. Pölten,1782,9,9,10,17,43,61,-18,37
SV Josko Rie,1782,10,9,6,21,36,58,-22,33
FC Salzburg,1783,1,21,8,7,61,28,33,71
SC Rheindorf,1783,2,20,7,9,49,39,10,67
SK Sturm Gra,1783,3,19,5,12,59,39,20,62
Rapid Vienna,1783,4,15,12,9,50,33,17,57
RZ Pellets W,1783,5,14,8,14,48,48,0,50
Vienna,1783,6,14,7,15,55,57,-2,49
St. Pölten,1783,7,10,10,16,37,52,-15,40
Admira Wacke,1783,8,11,7,18,36,57,-21,40
SV Josko Rie,1783,9,8,9,19,34,55,-21,33
Mattersburg,1783,10,7,9,20,39,60,-21,30
SK Sturm Gra,1784,1,23,6,7,67,29,38,75
SC Rheindorf,1784,2,23,5,8,59,36,23,74
Vienna,1784,3,19,5,12,62,53,9,62
FC Salzburg,1784,4,17,8,11,55,35,20,59
Mattersburg,1784,5,13,8,15,48,48,0,47
Rapid Vienna,1784,6,10,12,14,45,40,5,42
RZ Pellets W,1784,7,10,8,18,42,61,-19,38
Admira Wacke,1784,8,9,8,19,33,56,-23,35
St. Pölten,1784,9,8,11,17,39,63,-24,35
SV Josko Rie,1784,10,10,5,21,35,64,-29,35
FC Salzburg,1785,1,21,8,7,69,30,39,71
SK Sturm Gra,1785,2,21,6,9,68,34,34,69
SC Rheindorf,1785,3,19,9,8,59,42,17,66
Vienna,1785,4,16,8,12,67,61,6,56
Rapid Vienna,1785,5,12,12,12,57,49,8,48
RZ Pellets W,1785,6,12,9,15,46,57,-11,45
St. Pölten,1785,7,9,11,16,41,69,-28,38
SV Josko Rie,1785,8,11,4,21,40,58,-18,37
Admira Wacke,1785,9,10,5,21,40,66,-26,35
Mattersburg,1785,10,8,10,18,37,58,-21,34
FC Salzburg,1786,1,23,4,9,65,26,39,73
SK Sturm Gra,1786,2,21,4,11,62,30,32,67
SC Rheindorf,1786,3,19,6,11,47,42,5,63
Vienna,1786,4,19,5,12,57,46,11,62
RZ Pellets W,1786,5,18,6,12,52,52,0,60
Rapid Vienna,1786,6,13,10,13,55,41,14,49
Admira Wacke,1786,7,11,5,20,35,63,-28,38
SV Josko Rie,1786,8,11,2,23,32,57,-25,35
Mattersburg,1786,9,9,6,21,38,60,-22,33
St. Pölten,1786,10,9,6,21,38,64,-26,33
FC Salzburg,1787,1,24,4,8,64,28,36,76
SC Rheindorf,1787,2,21,6,9,54,35,19,69
Vienna,1787,3,19,4,13,56,49,7,61
SK Sturm Gra,1787,4,18,6,12,60,37,23,60
Rapid Vienna,1787,5,14,7,15,59,42,17,49
RZ Pellets W,1787,6,12,8,16,43,58,-15,44
Admira Wacke,1787,7,12,5,19,38,56,-18,41
St. Pölten,1787,8,10,9,17,40,62,-22,39
SV Josko Rie,1787,9,11,5,20,34,57,-23,38
Mattersburg,1787,10,9,6,21,38,62,-24,33
FC Salzburg,1788,1,23,7,6,68,26,42,76
SC Rheindorf,1788,2,19,7,10,55,44,11,64
SK Sturm Gra,1788,3,18,8,10,57,40,17,62
Vienna,1788,4,15,7,14,57,58,-1,52
Admira Wacke,1788,5,13,9,14,44,56,-12,48
St. Pölten,1788,6,12,10,14,50,56,-6,46
Rapid Vienna,1788,7,11,11,14,54,48,6,44
RZ Pellets W,1788,8,12,6,18,50,62,-12,42
Mattersburg,1788,9,9,8,19,42,57,-15,35
SV Josko Rie,1788,10,8,7,21,34,64,-30,31
FC Salzburg,1789,1,20,7,9,63,30,33,67
SC Rheindorf,1789,2,19,8,9,53,40,13,65
Vienna,1789,3,20,3,13,62,57,5,63
SK Sturm Gra,1789,4,16,8,12,57,35,22,56
Rapid Vienna,1789,5,14,12,10,57,39,18,54
RZ Pellets W,1789,6,14,9,13,57,56,1,51
Admira Wacke,1789,7,13,5,18,38,57,-19,44
Mattersburg,1789,8,9,9,18,42,62,-20,36
SV Josko Rie,1789,9,8,9,19,27,50,-23,33
St. Pölten,1789,10,7,10,19,38,68,-30,31
SC Rheindorf,1790,1,22,6,8,57,42,15,72
FC Salzburg,1790,2,19,8,9,68,35,33,65
SK Sturm Gra,1790,3,19,6,11,61,40,21,63
Vienna,1790,4,18,6,12,68,57,11,60
Rapid Vienna,1790,5,12,10,14,54,47,7,46
Admira Wacke,1790,6,14,4,18,44,63,-19,46
SV Josko Rie,1790,7,11,7,18,40,60,-20,40
RZ Pellets W,1790,8,11,6,19,40,53,-13,39
St. Pölten,1790,9,10,9,17,39,57,-18,39
Mattersburg,1790,10,8,10,18,38,55,-17,34
SK Sturm Gra,1791,1,22,6,8,66,29,37,72
FC Salzburg,1791,2,20,8,8,61,34,27,68
SC Rheindorf,1791,3,18,7,11,58,46,12,61
Vienna,1791,4,16,6,14,60,58,2,54
Rapid Vienna,1791,5,13,12,11,51,40,11,51
Admira Wacke,1791,6,12,8,16,35,53,-18,44
RZ Pellets W,1791,7,10,10,16,39,50,-11,40
SV Josko Rie,1791,8,11,6,19,33,55,-22,39
Mattersburg,1791,9,9,10,17,40,56,-16,37
St. Pölten,1791,10,9,7,20,36,58,-22,34
SC Rheindorf,1792,1,21,9,6,56,36,20,72
FC Salzburg,1792,2,22,5,9,69,32,37,71
Vienna,1792,3,19,5,12,76,57,19,62
Rapid Vienna,1792,4,14,11,11,51,40,11,53
SK Sturm Gra,1792,5,14,10,12,51,37,14,52
Admira Wacke,1792,6,13,6,17,39,62,-23,45
RZ Pellets W,1792,7,10,11,15,48,57,-9,41
St. Pölten,1792,8,10,10,16,39,59,-20,40
Mattersburg,1792,9,7,11,18,35,57,-22,32
SV Josko Rie,1792,10,7,8,21,31,58,-27,29
SC Rheindorf,1793,1,23,6,7,61,38,23,75
FC Salzburg,1793,2,21,6,9,64,34,30,69
SK Sturm Gra,1793,3,21,5,10,63,33,30,68
Vienna,1793,4,16,7,13,62,53,9,55
RZ Pellets W,1793,5,13,8,15,47,57,-10,47
Admira Wacke,1793,6,13,6,17,36,52,-16,45
Rapid Vienna,1793,7,9,12,15,45,44,1,39
SV Josko Rie,1793,8,10,7,19,37,54,-17,37
St. Pölten,1793,9,9,10,17,38,65,-27,37
Mattersburg,1793,10,6,11,19,39,62,-23,29
SC Rheindorf,1794,1,22,8,6,63,39,24,74
SK Sturm Gra,1794,2,20,7,9,57,32,25,67
FC Salzburg,1794,3,19,8,9,61,31,30,65
Vienna,1794,4,16,9,11,62,55,7,57
Rapid Vienna,1794,5,14,10,12,54,40,14,52
RZ Pellets W,1794,6,13,9,14,51,53,-2,48
SV Josko Rie,1794,7,13,4,19,32,48,-16,43
Admira Wacke,1794,8,10,6,20,35,66,-31,36
Mattersburg,1794,9,8,10,18,40,56,-16,34
St. Pölten,1794,10,4,11,21,40,75,-35,23
FC Salzburg,1795,1,19,11,6,67,32,35,68
Rapid Vienna,1795,2,18,10,8,69,41,28,64
SC Rheindorf,1795,3,19,7,10,52,45,7,64
SK Sturm Gra,1795,4,17,8,11,56,40,16,59
Vienna,1795,5,18,4,14,60,51,9,58
RZ Pellets W,1795,6,13,8,15,44,51,-7,47
Admira Wacke,1795,7,11,7,18,43,61,-18,40
Mattersburg,1795,8,9,9,18,38,57,-19,36
SV Josko Rie,1795,9,9,6,21,30,55,-25,33
St. Pölten,1795,10,8,8,20,46,72,-26,32
FC Salzburg,1796,1,23,8,5,70,25,45,77
SK Sturm Gra,1796,2,19,8,9,58,32,26,65
Vienna,1796,3,19,5,12,62,51,11,62
SC Rheindorf,1796,4,17,9,10,55,46,9,60
Rapid Vienna,1796,5,12,13,11,52,43,9,49
SV Josko Rie,1796,6,14,6,16,38,50,-12,48
RZ Pellets W,1796,7,10,10,16,45,56,-11,40
Mattersburg,1796,8,8,9,19,33,54,-21,33
Admira Wacke,1796,9,8,8,20,36,66,-30,32
St. Pölten,1796,10,7,10,19,35,61,-26,31
FC Salzburg,1797,1,23,5,8,64,30,34,74
SC Rheindorf,1797,2,19,8,9,51,44,7,65
SK Sturm Gra,1797,3,19,6,11,64,37,27,63
Vienna,1797,4,16,6,14,61,55,6,54
Rapid Vienna,1797,5,14,11,11,47,38,9,53
RZ Pellets W,1797,6,12,7,17,45,58,-13,43
SV Josko Rie,1797,7,13,4,19,33,53,-20,43
St. Pölten,1797,8,9,12,15,44,57,-13,39
Admira Wacke,1797,9,11,6,19,34,54,-20,39
Mattersburg,1797,10,7,9,20,37,54,-17,30
FC Salzburg,1798,1,23,6,7,72,29,43,75
SK Sturm Gra,1798,2,22,5,9,64,35,29,71
SC Rheindorf,1798,3,21,7,8,56,38,18,70
Vienna,1798,4,16,5,15,60,59,1,53
RZ Pellets W,1798,5,13,6,17,46,55,-9,45
Admira Wacke,1798,6,13,6,17,41,59,-18,45
Rapid Vienna,1798,7,11,11,14,49,42,7,44
Mattersburg,1798,8,10,9,17,44,61,-17,39
SV Josko Rie,1798,9,9,5,22,30,56,-26,32
St. Pölten,1798,10,8,8,20,38,66,-28,32
FC Salzburg,1799,1,21,10,5,72,36,36,73
SK Sturm Gra,1799,2,20,5,11,70,40,30,65
SC Rheindorf,1799,3,18,5,13,53,50,3,59
Vienna,1799,4,18,5,13,56,57,-1,59
Rapid Vienna,1799,5,14,10,12,58,43,15,52
RZ Pellets W,1799,6,14,8,14,48,51,-3,50
SV Josko Rie,1799,7,12,5,19,38,56,-18,41
Admira Wacke,1799,8,9,11,16,33,54,-21,38
St. Pölten,1799,9,9,9,18,47,63,-16,36
Mattersburg,1799,10,7,8,21,35,60,-25,29
FC Salzburg,1800,1,21,9,6,70,29,41,72
SK Sturm Gra,1800,2,19,7,10,56,32,24,64
SC Rheindorf,1800,3,16,11,9,54,45,9,59
Vienna,1800,4,16,8,12,57,54,3,56
Rapid Vienna,1800,5,10,14,12,48,47,1,44
RZ Pellets W,1800,6,11,11,14,46,63,-17,44
St. Pölten,1800,7,11,10,15,43,55,-12,43
SV Josko Rie,1800,8,12,4,20,45,57,-12,40
Admira Wacke,1800,9,12,4,20,43,59,-16,40
Mattersburg,1800,10,8,10,18,37,58,-21,34
FC Salzburg,1801,1,21,8,7,69,31,38,71
SK Sturm Gra,1801,2,18,11,7,63,33,30,65
SC Rheindorf,1801,3,18,9,9,55,41,14,63
Vienna,1801,4,19,3,14,60,50,10,60
Rapid Vienna,1801,5,13,12,11,60,40,20,51
RZ Pellets W,1801,6,12,8,16,41,54,-13,44
Admira Wacke,1801,7,13,5,18,38,60,-22,44
SV Josko Rie,1801,8,11,8,17,33,48,-15,41
Mattersburg,1801,9,9,7,20,38,62,-24,34
St. Pölten,1801,10,5,11,20,36,74,-38,26
Vienna,1802,1,20,5,11,70,54,16,65
SK Sturm Gra,1802,2,17,10,9,55,32,23,61
SC Rheindorf,1802,3,17,10,9,53,41,12,61
FC Salzburg,1802,4,17,9,10,58,35,23,60
Rapid Vienna,1802,5,13,13,10,55,36,19,52
Admira Wacke,1802,6,12,7,17,38,52,-14,43
Mattersburg,1802,7,11,9,16,41,50,-9,42
SV Josko Rie,1802,8,12,4,20,30,52,-22,40
St. Pölten,1802,9,10,9,17,40,67,-27,39
RZ Pellets W,1802,10,10,6,20,36,57,-21,36
SK Sturm Gra,1803,1,22,7,7,65,28,37,73
FC Salzburg,1803,2,21,7,8,71,32,39,70
SC Rheindorf,1803,3,18,7,11,49,47,2,61
Vienna,1803,4,16,7,13,64,56,8,55
RZ Pellets W,1803,5,13,11,12,53,50,3,50
Rapid Vienna,1803,6,11,13,12,50,43,7,46
St. Pölten,1803,7,11,11,14,46,59,-13,44
Admira Wacke,1803,8,10,6,20,37,68,-31,36
SV Josko Rie,1803,9,9,6,21,33,63,-30,33
Mattersburg,1803,10,6,11,19,33,55,-22,29
SK Sturm Gra,1804,1,22,4,10,59,33,26,70
FC Salzburg,1804,2,21,6,9,65,37,28,69
SC Rheindorf,1804,3,20,5,11,53,41,12,65
Vienna,1804,4,18,5,13,62,54,8,59
RZ Pellets W,1804,5,15,9,12,51,51,0,54
Rapid Vienna,1804,6,12,11,13,54,43,11,47
St. Pölten,1804,7,12,8,16,47,60,-13,44
Admira Wacke,1804,8,11,5,20,31,57,-26,38
Mattersburg,1804,9,9,7,20,37,55,-18,34
SV Josko Rie,1804,10,7,6,23,32,60,-28,27
FC Salzburg,1805,1,21,7,8,61,33,28,70
SK Sturm Gra,1805,2,19,8,9,59,30,29,65
Vienna,1805,3,19,5,12,62,49,13,62
SC Rheindorf,1805,4,18,8,10,54,45,9,62
Rapid Vienna,1805,5,14,12,10,59,45,14,54
Admira Wacke,1805,6,13,6,17,40,57,-17,45
Mattersburg,1805,7,10,8,18,40,56,-16,38
St. Pölten,1805,8,10,8,18,50,71,-21,38
RZ Pellets W,1805,9,9,10,17,42,57,-15,37
SV Josko Rie,1805,10,10,2,24,35,59,-24,32
SK Sturm Gra,1806,1,21,5,10,66,39,27,68
Vienna,1806,2,22,2,12,71,51,20,68
SC Rheindorf,1806,3,20,7,9,57,43,14,67
FC Salzburg,1806,4,20,6,10,64,31,33,66
Rapid Vienna,1806,5,14,12,10,58,38,20,54
Mattersburg,1806,6,11,9,16,39,50,-11,42
RZ Pellets W,1806,7,10,7,19,39,64,-25,37
Admira Wacke,1806,8,10,7,19,38,66,-28,37
St. Pölten,1806,9,9,9,18,40,60,-20,36
SV Josko Rie,1806,10,9,4,23,36,66,-30,31
FC Salzburg,1807,1,21,7,8,70,36,34,70
SC Rheindorf,1807,2,21,7,8,58,43,15,70
SK Sturm Gra,1807,3,20,6,10,54,31,23,66
Vienna,1807,4,20,5,11,62,48,14,65
Rapid Vienna,1807,5,16,11,9,56,32,24,59
RZ Pellets W,1807,6,11,6,19,44,65,-21,39
Mattersburg,1807,7,10,8,18,44,57,-13,38
Admira Wacke,1807,8,10,5,21,37,64,-27,35
SV Josko Rie,1807,9,9,7,20,31,54,-23,34
St. Pölten,1807,10,8,6,22,42,68,-26,30
SC Rheindorf,1808,1,20,8,8,57,43,14,68
FC Salzburg,1808,2,19,9,8,68,33,35,66
Vienna,1808,3,19,7,10,64,47,17,64
SK Sturm Gra,1808,4,19,5,12,62,39,23,62
Rapid Vienna,1808,5,13,11,12,55,38,17,50
RZ Pellets W,1808,6,11,8,17,44,54,-10,41
Admira Wacke,1808,7,11,7,18,33,59,-26,40
SV Josko Rie,1808,8,10,9,17,35,57,-22,39
Mattersburg,1808,9,7,12,17,36,56,-20,33
St. Pölten,1808,10,7,12,17,41,69,-28,33
SC Rheindorf,1809,1,22,6,8,59,42,17,72
SK Sturm Gra,1809,2,18,10,8,58,30,28,64
Vienna,1809,3,20,4,12,64,50,14,64
FC Salzburg,1809,4,16,10,10,57,36,21,58
Rapid Vienna,1809,5,13,12,11,59,43,16,51
RZ Pellets W,1809,6,12,6,18,46,59,-13,42
Admira Wacke,1809,7,11,8,17,35,53,-18,41
St. Pölten,1809,8,10,9,17,41,61,-20,39
Mattersburg,1809,9,10,7,19,40,59,-19,37
SV Josko Rie,1809,10,9,6,21,30,56,-26,33
FC Salzburg,1810,1,22,8,6,73,31,42,74
SK Sturm Gra,1810,2,20,6,10,63,38,25,66
SC Rheindorf,1810,3,16,10,10,49,43,6,58
Vienna,1810,4,16,8,12,60,57,3,56
Rapid Vienna,1810,5,13,12,11,53,41,12,51
Admira Wacke,1810,6,13,9,14,42,55,-13,48
SV Josko Rie,1810,7,10,8,18,40,55,-15,38
St. Pölten,1810,8,8,13,15,44,61,-17,37
RZ Pellets W,1810,9,8,10,18,38,57,-19,34
Mattersburg,1810,10,6,12,18,30,54,-24,30
SC Rheindorf,1811,1,24,4,8,63,40,23,76
FC Salzburg,1811,2,20,9,7,62,29,33,69
SK Sturm Gra,1811,3,20,6,10,62,38,24,66
Vienna,1811,4,17,5,14,65,56,9,56
Rapid Vienna,1811,5,14,12,10,60,42,18,54
SV Josko Rie,1811,6,14,3,19,38,51,-13,45
St. Pölten,1811,7,10,8,18,53,68,-15,38
RZ Pellets W,1811,8,10,8,18,47,68,-21,38
Admira Wacke,1811,9,10,8,18,35,62,-27,38
Mattersburg,1811,10,5,9,22,35,66,-31,24
FC Salzburg,1812,1,23,5,8,67,29,38,74
SK Sturm Gra,1812,2,20,8,8,59,35,24,68
SC Rheindorf,1812,3,18,8,10,58,43,15,62
Vienna,1812,4,17,8,11,66,51,15,59
Rapid Vienna,1812,5,14,10,12,54,45,9,52
RZ Pellets W,1812,6,13,8,15,46,53,-7,47
Admira Wacke,1812,7,10,10,16,32,52,-20,40
SV Josko Rie,1812,8,10,7,19,33,52,-19,37
Mattersburg,1812,9,8,8,20,33,56,-23,32
St. Pölten,1812,10,5,12,19,34,66,-32,27
FC Salzburg,1813,1,20,8,8,62,29,33,68
SC Rheindorf,1813,2,19,10,7,55,39,16,67
SK Sturm Gra,1813,3,19,6,11,66,40,26,63
Vienna,1813,4,17,6,13,62,51,11,57
Rapid Vienna,1813,5,12,11,13,52,47,5,47
St. Pölten,1813,6,11,10,15,40,57,-17,43
RZ Pellets W,1813,7,10,11,15,46,55,-9,41
SV Josko Rie,1813,8,11,6,19,38,52,-14,39
Admira Wacke,1813,9,10,8,18,42,73,-31,38
Mattersburg,1813,10,9,8,19,34,54,-20,35
FC Salzburg,1814,1,20,9,7,64,34,30,69
SC Rheindorf,1814,2,21,6,9,59,37,22,69
SK Sturm Gra,1814,3,20,6,10,59,31,28,66
Rapid Vienna,1814,4,15,12,9,58,39,19,57
Vienna,1814,5,16,6,14,59,52,7,54
Admira Wacke,1814,6,12,8,16,35,52,-17,44
RZ Pellets W,1814,7,12,6,18,40,54,-14,42
St. Pölten,1814,8,9,10,17,41,60,-19,37
SV Josko Rie,1814,9,10,5,21,33,62,-29,35
Mattersburg,1814,10,7,8,21,33,60,-27,29
FC Salzburg,1815,1,20,8,8,70,37,33,68
Vienna,1815,2,18,5,13,70,62,8,59
SK Sturm Gra,1815,3,18,4,14,60,47,13,58
SC Rheindorf,1815,4,17,7,12,54,45,9,58
Rapid Vienna,1815,5,14,12,10,57,38,19,54
Admira Wacke,1815,6,14,8,14,44,52,-8,50
RZ Pellets W,1815,7,13,8,15,45,57,-12,47
Mattersburg,1815,8,10,9,17,40,52,-12,39
SV Josko Rie,1815,9,11,5,20,34,52,-18,38
St. Pölten,1815,10,8,8,20,37,69,-32,32
SK Sturm Gra,1816,1,21,7,8,63,31,32,70
SC Rheindorf,1816,2,20,8,8,58,42,16,68
FC Salzburg,1816,3,19,9,8,68,39,29,66
Vienna,1816,4,17,5,14,60,57,3,56
Rapid Vienna,1816,5,13,12,11,62,47,15,51
RZ Pellets W,1816,6,12,9,15,43,52,-9,45
SV Josko Rie,1816,7,11,7,18,34,51,-17,40
Admira Wacke,1816,8,10,6,20,37,59,-22,36
St. Pölten,1816,9,9,9,18,39,64,-25,36
Mattersburg,1816,10,7,10,19,35,57,-22,31
FC Salzburg,1817,1,21,8,7,64,26,38,71
SC Rheindorf,1817,2,20,7,9,60,41,19,67
Rapid Vienna,1817,3,19,8,9,57,30,27,65
Vienna,1817,4,19,5,12,62,47,15,62
SK Sturm Gra,1817,5,17,6,13,56,38,18,57
RZ Pellets W,1817,6,11,11,14,43,52,-9,44
SV Josko Rie,1817,7,11,6,19,32,56,-24,39
Mattersburg,1817,8,9,8,19,36,62,-26,35
Admira Wacke,1817,9,8,8,20,30,57,-27,32
St. Pölten,1817,10,7,9,20,43,74,-31,30
SC Rheindorf,1818,1,20,8,8,61,41,20,68
Vienna,1818,2,20,7,9,71,51,20,67
FC Salzburg,1818,3,19,9,8,61,32,29,66
SK Sturm Gra,1818,4,18,9,9,66,40,26,63
Rapid Vienna,1818,5,13,11,12,55,42,13,50
Admira Wacke,1818,6,11,10,15,41,61,-20,43
RZ Pellets W,1818,7,11,7,18,42,58,-16,40
Mattersburg,1818,8,9,8,19,37,62,-25,35
SV Josko Rie,1818,9,8,9,19,32,55,-23,33
St. Pölten,1818,10,6,12,18,40,64,-24,30
FC Salzburg,1819,1,20,7,9,62,33,29,67
SC Rheindorf,1819,2,19,8,9,56,40,16,65
Vienna,1819,3,19,6,11,61,51,10,63
SK Sturm Gra,1819,4,18,5,13,56,34,22,59
Rapid Vienna,1819,5,16,11,9,53,35,18,59
SV Josko Rie,1819,6,13,4,19,50,59,-9,43
RZ Pellets W,1819,7,10,9,17,41,50,-9,39
Mattersburg,1819,8,9,10,17,37,59,-22,37
Admira Wacke,1819,9,11,4,21,38,68,-30,37
St. Pölten,1819,10,8,10,18,45,70,-25,34
FC Salzburg,1820,1,23,6,7,68,35,33,75
Vienna,1820,2,19,6,11,65,49,16,63
SK Sturm Gra,1820,3,17,8,11,59,44,15,59
SC Rheindorf,1820,4,17,8,11,59,49,10,59
Rapid Vienna,1820,5,14,10,12,58,42,16,52
RZ Pellets W,1820,6,11,10,15,44,50,-6,43
SV Josko Rie,1820,7,12,7,17,36,50,-14,43
Admira Wacke,1820,8,11,6,19,36,62,-26,39
St. Pölten,1820,9,8,13,15,44,63,-19,37
Mattersburg,1820,10,8,6,22,38,63,-25,30
SC Rheindorf,1821,1,21,9,6,65,44,21,72
SK Sturm Gra,1821,2,20,7,9,63,33,30,67
Vienna,1821,3,19,7,10,66,51,15,64
FC Salzburg,1821,4,18,9,9,59,29,30,63
Admira Wacke,1821,5,14,4,18,32,54,-22,46
RZ Pellets W,1821,6,12,7,17,46,58,-12,43
Rapid Vienna,1821,7,9,15,12,51,48,3,42
Mattersburg,1821,8,9,10,17,37,57,-20,37
SV Josko Rie,1821,9,10,5,21,31,52,-21,35
St. Pölten,1821,10,7,9,20,41,65,-24,30
SC Rheindorf,1822,1,21,9,6,56,33,23,72
FC Salzburg,1822,2,22,5,9,67,31,36,71
SK Sturm Gra,1822,3,17,10,9,59,38,21,61
Vienna,1822,4,16,6,14,57,54,3,54
Rapid Vienna,1822,5,14,9,13,55,38,17,51
RZ Pellets W,1822,6,13,7,16,48,59,-11,46
SV Josko Rie,1822,7,12,5,19,39,53,-14,41
Admira Wacke,1822,8,10,8,18,35,60,-25,38
Mattersburg,1822,9,8,10,18,33,56,-23,34
St. Pölten,1822,10,8,9,19,39,66,-27,33
FC Salzburg,1823,1,24,6,6,70,28,42,78
SK Sturm Gra,1823,2,23,5,8,67,29,38,74
SC Rheindorf,1823,3,20,8,8,55,44,11,68
Vienna,1823,4,19,6,11,62,51,11,63
RZ Pellets W,1823,5,13,9,14,46,52,-6,48
Rapid Vienna,1823,6,12,11,13,51,45,6,47
SV Josko Rie,1823,7,10,7,19,35,55,-20,37
Admira Wacke,1823,8,8,6,22,34,58,-24,30
Mattersburg,1823,9,7,9,20,37,64,-27,30
St. Pölten,1823,10,6,9,21,39,70,-31,27
FC Salzburg,1824,1,24,7,5,73,24,49,79
SC Rheindorf,1824,2,21,9,6,59,34,25,72
SK Sturm Gra,1824,3,18,6,12,62,40,22,60
Rapid Vienna,1824,4,14,10,12,60,50,10,52
Vienna,1824,5,15,4,17,57,61,-4,49
RZ Pellets W,1824,6,14,6,16,45,57,-12,48
Admira Wacke,1824,7,13,8,15,40,54,-14,47
St. Pölten,1824,8,8,12,16,41,61,-20,36
SV Josko Rie,1824,9,8,6,22,30,64,-34,30
Mattersburg,1824,10,7,8,21,31,53,-22,29
SK Sturm Gra,1825,1,20,8,8,63,33,30,68
FC Salzburg,1825,2,19,8,9,59,31,28,65
SC Rheindorf,1825,3,18,8,10,55,46,9,62
Vienna,1825,4,18,5,13,57,48,9,59
Rapid Vienna,1825,5,14,12,10,50,38,12,54
RZ Pellets W,1825,6,12,9,15,42,50,-8,45
Admira Wacke,1825,7,13,4,19,40,57,-17,43
SV Josko Rie,1825,8,12,6,18,39,50,-11,42
Mattersburg,1825,9,8,12,16,44,59,-15,36
St. Pölten,1825,10,6,8,22,36,73,-37,26
FC Salzburg,1826,1,20,10,6,64,29,35,70
SC Rheindorf,1826,2,20,7,9,59,45,14,67
SK Sturm Gra,1826,3,19,7,10,57,34,23,64
Vienna,1826,4,19,5,12,66,53,13,62
Rapid Vienna,1826,5,12,13,11,50,39,11,49
Admira Wacke,1826,6,12,8,16,40,57,-17,44
RZ Pellets W,1826,7,11,6,19,41,55,-14,39
Mattersburg,1826,8,9,10,17,40,53,-13,37
SV Josko Rie,1826,9,10,6,20,34,55,-21,36
St. Pölten,1826,10,7,10,19,40,71,-31,31
FC Salzburg,1827,1,22,7,7,61,25,36,73
SC Rheindorf,1827,2,19,7,10,54,44,10,64
Vienna,1827,3,19,5,12,63,54,9,62
SK Sturm Gra,1827,4,17,10,9,60,35,25,61
Rapid Vienna,1827,5,17,9,10,58,37,21,60
RZ Pellets W,1827,6,13,6,17,46,56,-10,45
Admira Wacke,1827,7,11,7,18,33,55,-22,40
Mattersburg,1827,8,8,9,19,35,53,-18,33
SV Josko Rie,1827,9,9,5,22,31,56,-25,32
St. Pölten,1827,10,7,11,18,39,65,-26,32
FC Salzburg,1828,1,21,7,8,60,31,29,70
SC Rheindorf,1828,2,21,6,9,62,49,13,69
Vienna,1828,3,21,3,12,70,49,21,66
SK Sturm Gra,1828,4,18,8,10,55,35,20,62
Rapid Vienna,1828,5,15,11,10,58,40,18,56
RZ Pellets W,1828,6,12,9,15,43,53,-10,45
Mattersburg,1828,7,10,8,18,41,54,-13,38
SV Josko Rie,1828,8,10,5,21,31,48,-17,35
Admira Wacke,1828,9,8,8,20,30,60,-30,32
St. Pölten,1828,10,8,7,21,46,77,-31,31
SC Rheindorf,1829,1,19,12,5,57,34,23,69
SK Sturm Gra,1829,2,19,8,9,65,34,31,65
Vienna,1829,3,19,5,12,64,50,14,62
FC Salzburg,1829,4,17,10,9,60,35,25,61
Rapid Vienna,1829,5,14,12,10,56,41,15,54
Admira Wacke,1829,6,13,7,16,48,62,-14,46
SV Josko Rie,1829,7,13,4,19,38,53,-15,43
RZ Pellets W,1829,8,12,5,19,43,61,-18,41
Mattersburg,1829,9,8,9,19,44,64,-20,33
St. Pölten,1829,10,5,10,21,38,79,-41,25
SK Sturm Gra,1830,1,22,6,8,62,34,28,72
FC Salzburg,1830,2,21,8,7,69,28,41,71
Vienna,1830,3,16,10,10,66,58,8,58
Rapid Vienna,1830,4,15,12,9,65,36,29,57
SC Rheindorf,1830,5,16,8,12,50,49,1,56
RZ Pellets W,1830,6,12,7,17,44,56,-12,43
SV Josko Rie,1830,7,12,6,18,37,52,-15,42
Admira Wacke,1830,8,10,10,16,34,55,-21,40
St. Pölten,1830,9,9,8,19,42,69,-27,35
Mattersburg,1830,10,7,5,24,34,66,-32,26
Vienna,1831,1,23,6,7,71,47,24,75
SC Rheindorf,1831,2,21,7,8,63,36,27,70
FC Salzburg,1831,3,18,9,9,59,30,29,63
SK Sturm Gra,1831,4,16,9,11,55,37,18,57
Rapid Vienna,1831,5,12,14,10,49,38,11,50
SV Josko Rie,1831,6,11,8,17,33,48,-15,41
St. Pölten,1831,7,10,10,16,42,54,-12,40
Admira Wacke,1831,8,10,8,18,29,62,-33,38
RZ Pellets W,1831,9,9,8,19,41,63,-22,35
Mattersburg,1831,10,5,11,20,31,58,-27,26
FC Salzburg,1832,1,23,6,7,68,27,41,75
SC Rheindorf,1832,2,21,9,6,60,38,22,72
SK Sturm Gra,1832,3,19,6,11,59,38,21,63
Vienna,1832,4,19,6,11,63,49,14,63
Rapid Vienna,1832,5,13,10,13,56,45,11,49
RZ Pellets W,1832,6,12,6,18,46,66,-20,42
Admira Wacke,1832,7,12,5,19,38,59,-21,41
SV Josko Rie,1832,8,9,7,20,39,61,-22,34
Mattersburg,1832,9,7,11,18,39,61,-22,32
St. Pölten,1832,10,7,10,19,42,66,-24,31
FC Salzburg,1833,1,24,4,8,69,31,38,76
SC Rheindorf,1833,2,20,8,8,59,45,14,68
Vienna,1833,3,20,5,11,63,46,17,65
SK Sturm Gra,1833,4,20,4,12,61,36,25,64
Rapid Vienna,1833,5,14,10,12,53,42,11,52
Admira Wacke,1833,6,12,7,17,37,56,-19,43
Mattersburg,1833,7,10,9,17,40,54,-14,39
RZ Pellets W,1833,8,10,9,17,39,55,-16,39
SV Josko Rie,1833,9,8,5,23,30,57,-27,29
St. Pölten,1833,10,6,11,19,37,66,-29,29
SK Sturm Gra,1834,1,21,8,7,62,31,31,71
FC Salzburg,1834,2,20,10,6,66,31,35,70
SC Rheindorf,1834,3,20,7,9,56,43,13,67
Vienna,1834,4,16,7,13,57,46,11,55
Rapid Vienna,1834,5,11,15,10,62,52,10,48
RZ Pellets W,1834,6,11,8,17,46,61,-15,41
Admira Wacke,1834,7,10,11,15,32,54,-22,41
Mattersburg,1834,8,8,12,16,41,56,-15,36
St. Pölten,1834,9,8,9,19,51,74,-23,33
SV Josko Rie,1834,10,8,7,21,33,58,-25,31
Vienna,1835,1,20,7,9,65,43,22,67
SC Rheindorf,1835,2,20,6,10,57,47,10,66
FC Salzburg,1835,3,18,11,7,62,31,31,65
SK Sturm Gra,1835,4,17,6,13,56,42,14,57
Rapid Vienna,1835,5,15,10,11,60,40,20,55
RZ Pellets W,1835,6,11,10,15,45,58,-13,43
St. Pölten,1835,7,10,9,17,40,57,-17,39
Admira Wacke,1835,8,10,9,17,36,59,-23,39
SV Josko Rie,1835,9,11,5,20,37,55,-18,38
Mattersburg,1835,10,7,9,20,34,60,-26,30
FC Salzburg,1836,1,22,7,7,63,30,33,73
SC Rheindorf,1836,2,19,7,10,52,41,11,64
SK Sturm Gra,1836,3,18,8,10,60,34,26,62
Vienna,1836,4,19,5,12,64,54,10,62
RZ Pellets W,1836,5,13,9,14,49,54,-5,48
Rapid Vienna,1836,6,12,11,13,51,42,9,47
Admira Wacke,1836,7,11,7,18,36,55,-19,40
SV Josko Rie,1836,8,11,7,18,33,54,-21,40
St. Pölten,1836,9,9,9,18,39,58,-19,36
Mattersburg,1836,10,7,8,21,34,59,-25,29
Vienna,1837,1,22,4,10,68,39,29,70
Rapid Vienna,1837,2,20,9,7,64,32,32,69
SC Rheindorf,1837,3,18,8,10,53,41,12,62
FC Salzburg,1837,4,17,7,12,62,38,24,58
SK Sturm Gra,1837,5,15,9,12,45,33,12,54
Admira Wacke,1837,6,12,8,16,38,55,-17,44
RZ Pellets W,1837,7,11,9,16,40,54,-14,42
SV Josko Rie,1837,8,10,6,20,32,56,-24,36
Mattersburg,1837,9,9,8,19,40,59,-19,35
St. Pölten,1837,10,7,10,19,41,76,-35,31
FC Salzburg,1838,1,24,6,6,73,31,42,78
SC Rheindorf,1838,2,22,6,8,60,45,15,72
SK Sturm Gra,1838,3,17,6,13,59,42,17,57
Rapid Vienna,1838,4,14,12,10,63,41,22,54
Vienna,1838,5,16,6,14,66,60,6,54
RZ Pellets W,1838,6,12,6,18,41,53,-12,42
Mattersburg,1838,7,11,8,17,34,46,-12,41
St. Pölten,1838,8,11,7,18,44,65,-21,40
SV Josko Rie,1838,9,11,6,19,38,54,-16,39
Admira Wacke,1838,10,8,5,23,30,71,-41,29
FC Salzburg,1839,1,21,9,6,66,33,33,72
Vienna,1839,2,21,4,11,65,47,18,67
SC Rheindorf,1839,3,18,9,9,52,40,12,63
SK Sturm Gra,1839,4,18,6,12,56,38,18,60
Rapid Vienna,1839,5,16,10,10,60,37,23,58
Admira Wacke,1839,6,12,7,17,41,57,-16,43
RZ Pellets W,1839,7,11,7,18,42,56,-14,40
Mattersburg,1839,8,10,8,18,40,52,-12,38
St. Pölten,1839,9,10,8,18,40,66,-26,38
SV Josko Rie,1839,10,7,4,25,24,60,-36,25
FC Salzburg,1840,1,21,9,6,71,33,38,72
SC Rheindorf,1840,2,19,7,10,54,44,10,64
Vienna,1840,3,19,6,11,58,45,13,63
SK Sturm Gra,1840,4,18,7,11,55,32,23,61
RZ Pellets W,1840,5,13,8,15,40,49,-9,47
SV Josko Rie,1840,6,14,3,19,41,49,-8,45
Rapid Vienna,1840,7,11,11,14,47,39,8,44
St. Pölten,1840,8,10,12,14,46,61,-15,42
Admira Wacke,1840,9,11,7,18,37,60,-23,40
Mattersburg,1840,10,6,6,24,30,67,-37,24
FC Salzburg,1841,1,20,10,6,64,33,31,70
Vienna,1841,2,21,7,8,64,42,22,70
SC Rheindorf,1841,3,18,10,8,53,39,14,64
SK Sturm Gra,1841,4,17,8,11,50,31,19,59
St. Pölten,1841,5,11,12,13,47,60,-13,45
Rapid Vienna,1841,6,10,14,12,53,47,6,44
RZ Pellets W,1841,7,9,13,14,45,54,-9,40
SV Josko Rie,1841,8,11,5,20,38,57,-19,38
Admira Wacke,1841,9,9,7,20,33,61,-28,34
Mattersburg,1841,10,6,10,20,32,55,-23,28
FC Salzburg,1842,1,22,6,8,74,34,40,72
SC Rheindorf,1842,2,21,7,8,59,41,18,70
SK Sturm Gra,1842,3,19,4,13,61,41,20,61
Vienna,1842,4,18,5,13,57,53,4,59
Rapid Vienna,1842,5,13,10,13,60,48,12,49
RZ Pellets W,1842,6,13,7,16,45,59,-14,46
SV Josko Rie,1842,7,12,4,20,39,57,-18,40
Admira Wacke,1842,8,11,7,18,41,65,-24,40
Mattersburg,1842,9,10,7,19,41,61,-20,37
St. Pölten,1842,10,8,9,19,47,65,-18,33
SK Sturm Gra,1843,1,22,7,7,69,27,42,73
FC Salzburg,1843,2,19,7,10,62,41,21,64
SC Rheindorf,1843,3,18,9,9,48,37,11,63
Rapid Vienna,1843,4,14,12,10,54,35,19,54
Vienna,1843,5,15,6,15,60,59,1,51
Admira Wacke,1843,6,12,9,15,38,54,-16,45
RZ Pellets W,1843,7,11,9,16,45,56,-11,42
SV Josko Rie,1843,8,11,5,20,35,60,-25,38
Mattersburg,1843,9,9,10,17,42,57,-15,37
St. Pölten,1843,10,6,12,18,36,63,-27,30
SC Rheindorf,1844,1,21,7,8,63,38,25,70
SK Sturm Gra,1844,2,19,7,10,65,41,24,64
Vienna,1844,3,18,7,11,56,43,13,61
FC Salzburg,1844,4,16,10,10,56,39,17,58
Rapid Vienna,1844,5,15,11,10,54,38,16,56
SV Josko Rie,1844,6,13,2,21,36,50,-14,41
Admira Wacke,1844,7,11,7,18,34,61,-27,40
RZ Pellets W,1844,8,10,9,17,46,58,-12,39
Mattersburg,1844,9,10,7,19,39,58,-19,37
St. Pölten,1844,10,8,11,17,38,61,-23,35
FC Salzburg,1845,1,23,6,7,70,30,40,75
SC Rheindorf,1845,2,22,7,7,64,37,27,73
Vienna,1845,3,17,9,10,66,50,16,60
Rapid Vienna,1845,4,13,13,10,59,42,17,52
SK Sturm Gra,1845,5,15,7,14,54,49,5,52
RZ Pellets W,1845,6,12,8,16,39,57,-18,44
Admira Wacke,1845,7,11,7,18,44,63,-19,40
St. Pölten,1845,8,8,11,17,45,67,-22,35
SV Josko Rie,1845,9,9,8,19,34,57,-23,35
Mattersburg,1845,10,7,10,19,42,65,-23,31
SC Rheindorf,1846,1,21,8,7,55,38,17,71
SK Sturm Gra,1846,2,20,8,8,63,28,35,68
FC Salzburg,1846,3,18,12,6,60,28,32,66
Vienna,1846,4,17,4,15,54,55,-1,55
RZ Pellets W,1846,5,14,7,15,51,52,-1,49
Rapid Vienna,1846,6,10,14,12,55,47,8,44
Admira Wacke,1846,7,12,6,18,37,58,-21,42
St. Pölten,1846,8,9,12,15,43,64,-21,39
SV Josko Rie,1846,9,11,5,20,31,54,-23,38
Mattersburg,1846,10,5,10,21,36,61,-25,25
SC Rheindorf,1847,1,18,11,7,53,38,15,65
FC Salzburg,1847,2,19,7,10,62,33,29,64
Vienna,1847,3,19,5,12,67,51,16,62
Rapid Vienna,1847,4,15,13,8,63,41,22,58
SK Sturm Gra,1847,5,16,6,14,50,36,14,54
Admira Wacke,1847,6,14,6,16,44,61,-17,48
RZ Pellets W,1847,7,13,8,15,51,57,-6,47
SV Josko Rie,1847,8,11,6,19,37,62,-25,39
St. Pölten,1847,9,10,8,18,39,63,-24,38
Mattersburg,1847,10,5,10,21,29,53,-24,25
FC Salzburg,1848,1,21,8,7,60,26,34,71
SC Rheindorf,1848,2,21,6,9,60,39,21,69
SK Sturm Gra,1848,3,20,6,10,63,36,27,66
Rapid Vienna,1848,4,15,10,11,53,38,15,55
Vienna,1848,5,17,4,15,55,52,3,55
Mattersburg,1848,6,10,9,17,41,58,-17,39
St. Pölten,1848,7,9,11,16,44,63,-19,38
RZ Pellets W,1848,8,10,7,19,40,61,-21,37
Admira Wacke,1848,9,10,7,19,33,56,-23,37
SV Josko Rie,1848,10,9,8,19,29,49,-20,35
FC Salzburg,1849,1,22,7,7,72,26,46,73
SK Sturm Gra,1849,2,19,8,9,62,38,24,65
SC Rheindorf,1849,3,20,5,11,61,44,17,65
Rapid Vienna,1849,4,16,9,11,60,44,16,57
Vienna,1849,5,16,6,14,62,60,2,54
RZ Pellets W,1849,6,11,9,16,47,60,-13,42
SV Josko Rie,1849,7,13,3,20,37,54,-17,42
Admira Wacke,1849,8,11,8,17,41,64,-23,41
Mattersburg,1849,9,9,6,21,43,63,-20,33
St. Pölten,1849,10,8,9,19,42,74,-32,33
SK Sturm Gra,1850,1,23,5,8,69,31,38,74
SC Rheindorf,1850,2,23,4,9,61,40,21,73
FC Salzburg,1850,3,18,8,10,58,39,19,62
Vienna,1850,4,19,5,12,67,52,15,62
Rapid Vienna,1850,5,15,11,10,68,46,22,56
SV Josko Rie,1850,6,14,5,17,36,49,-13,47
RZ Pellets W,1850,7,13,7,16,47,55,-8,46
Mattersburg,1850,8,8,7,21,34,60,-26,31
Admira Wacke,1850,9,9,4,23,30,59,-29,31
St. Pölten,1850,10,6,8,22,36,75,-39,26
FC Salzburg,1851,1,22,9,5,66,27,39,75
SC Rheindorf,1851,2,18,8,10,56,46,10,62
SK Sturm Gra,1851,3,18,6,12,56,35,21,60
Vienna,1851,4,18,5,13,63,55,8,59
Rapid Vienna,1851,5,14,12,10,56,41,15,54
RZ Pellets W,1851,6,13,6,17,44,58,-14,45
SV Josko Rie,1851,7,13,4,19,40,55,-15,43
Mattersburg,1851,8,10,7,19,40,58,-18,37
Admira Wacke,1851,9,9,8,19,34,58,-24,35
St. Pölten,1851,10,8,9,19,49,71,-22,33
FC Salzburg,1852,1,21,9,6,61,27,34,72
SC Rheindorf,1852,2,22,6,8,63,42,21,72
SK Sturm Gra,1852,3,19,6,11,60,38,22,63
Vienna,1852,4,18,5,13,63,51,12,59
Rapid Vienna,1852,5,14,9,13,48,40,8,51
RZ Pellets W,1852,6,13,6,17,50,57,-7,45
St. Pölten,1852,7,11,7,18,43,63,-20,40
Mattersburg,1852,8,11,5,20,37,55,-18,38
Admira Wacke,1852,9,10,5,21,31,61,-30,35
SV Josko Rie,1852,10,8,8,20,35,57,-22,32
FC Salzburg,1853,1,20,7,9,63,31,32,67
SK Sturm Gra,1853,2,18,9,9,53,35,18,63
Vienna,1853,3,19,6,11,68,54,14,63
SC Rheindorf,1853,4,16,9,11,53,50,3,57
Rapid Vienna,1853,5,14,10,12,54,39,15,52
RZ Pellets W,1853,6,14,7,15,46,50,-4,49
SV Josko Rie,1853,7,15,3,18,43,48,-5,48
Admira Wacke,1853,8,13,6,17,43,60,-17,45
Mattersburg,1853,9,9,5,22,33,57,-24,32
St. Pölten,1853,10,7,8,21,44,76,-32,29
FC Salzburg,1854,1,22,8,6,63,27,36,74
SC Rheindorf,1854,2,21,9,6,58,39,19,72
Rapid Vienna,1854,3,16,10,10,57,38,19,58
SK Sturm Gra,1854,4,16,7,13,58,41,17,55
Vienna,1854,5,15,7,14,58,57,1,52
Admira Wacke,1854,6,12,8,16,36,53,-17,44
RZ Pellets W,1854,7,10,9,17,49,64,-15,39
Mattersburg,1854,8,9,10,17,38,55,-17,37
SV Josko Rie,1854,9,10,5,21,37,55,-18,35
St. Pölten,1854,10,8,9,19,44,69,-25,33
SK Sturm Gra,1855,1,20,8,8,58,31,27,68
SC Rheindorf,1855,2,20,5,11,50,43,7,65
FC Salzburg,1855,3,19,7,10,62,34,28,64
Vienna,1855,4,18,5,13,65,53,12,59
Rapid Vienna,1855,5,14,10,12,53,40,13,52
RZ Pellets W,1855,6,14,9,13,48,53,-5,51
Admira Wacke,1855,7,11,6,19,38,57,-19,39
Mattersburg,1855,8,10,7,19,34,53,-19,37
SV Josko Rie,1855,9,11,4,21,34,55,-21,37
St. Pölten,1855,10,8,9,19,43,66,-23,33
FC Salzburg,1856,1,24,5,7,68,29,39,77
SK Sturm Gra,1856,2,21,5,10,59,32,27,68
Vienna,1856,3,21,3,12,69,53,16,66
SC Rheindorf,1856,4,19,8,9,61,44,17,65
Rapid Vienna,1856,5,15,10,11,64,42,22,55
RZ Pellets W,1856,6,12,10,14,48,53,-5,46
Admira Wacke,1856,7,10,6,20,33,65,-32,36
St. Pölten,1856,8,7,13,16,43,63,-20,34
Mattersburg,1856,9,7,8,21,37,66,-29,29
SV Josko Rie,1856,10,7,6,23,27,62,-35,27
FC Salzburg,1857,1,21,8,7,66,30,36,71
SC Rheindorf,1857,2,21,6,9,62,39,23,69
SK Sturm Gra,1857,3,20,8,8,63,33,30,68
Vienna,1857,4,18,3,15,61,57,4,57
Rapid Vienna,1857,5,14,10,12,52,40,12,52
RZ Pellets W,1857,6,13,8,15,50,55,-5,47
Admira Wacke,1857,7,12,7,17,38,55,-17,43
SV Josko Rie,1857,8,11,4,21,33,57,-24,37
Mattersburg,1857,9,8,8,20,28,52,-24,32
St. Pölten,1857,10,6,10,20,39,74,-35,28
SK Sturm Gra,1858,1,21,5,10,57,30,27,68
Vienna,1858,2,20,4,12,71,60,11,64
SC Rheindorf,1858,3,18,7,11,59,46,13,61
FC Salzburg,1858,4,16,8,12,56,42,14,56
Rapid Vienna,1858,5,15,10,11,56,39,17,55
RZ Pellets W,1858,6,13,8,15,45,57,-12,47
Admira Wacke,1858,7,12,8,16,45,60,-15,44
SV Josko Rie,1858,8,12,4,20,39,51,-12,40
St. Pölten,1858,9,10,8,18,44,65,-21,38
Mattersburg,1858,10,8,8,20,33,55,-22,32
SC Rheindorf,1859,1,22,8,6,59,38,21,74
SK Sturm Gra,1859,2,19,8,9,56,33,23,65
Vienna,1859,3,20,4,12,67,51,16,64
Rapid Vienna,1859,4,15,12,9,54,34,20,57
FC Salzburg,1859,5,15,11,10,57,41,16,56
Admira Wacke,1859,6,13,9,14,37,51,-14,48
Mattersburg,1859,7,10,8,18,35,51,-16,38
SV Josko Rie,1859,8,10,7,19,38,54,-16,37
RZ Pellets W,1859,9,10,4,22,38,60,-22,34
St. Pölten,1859,10,6,9,21,41,69,-28,27
FC Salzburg,1860,1,21,5,10,66,35,31,68
SC Rheindorf,1860,2,19,7,10,60,45,15,64
SK Sturm Gra,1860,3,17,10,9,56,36,20,61
Vienna,1860,4,18,5,13,66,57,9,59
Rapid Vienna,1860,5,12,12,12,52,46,6,48
Mattersburg,1860,6,13,9,14,46,48,-2,48
RZ Pellets W,1860,7,12,8,16,50,55,-5,44
SV Josko Rie,1860,8,11,6,19,38,57,-19,39
Admira Wacke,1860,9,10,9,17,37,66,-29,39
St. Pölten,1860,10,6,11,19,42,68,-26,29
FC Salzburg,1861,1,23,8,5,71,26,45,77
SC Rheindorf,1861,2,20,7,9,54,41,13,67
SK Sturm Gra,1861,3,20,6,10,60,36,24,66
Vienna,1861,4,17,4,15,56,54,2,55
Rapid Vienna,1861,5,14,8,14,62,44,18,50
RZ Pellets W,1861,6,12,9,15,49,58,-9,45
Admira Wacke,1861,7,11,7,18,37,60,-23,40
SV Josko Rie,1861,8,11,5,20,36,52,-16,38
St. Pölten,1861,9,7,13,16,42,66,-24,34
Mattersburg,1861,10,7,9,20,32,62,-30,30
FC Salzburg,1862,1,22,9,5,77,34,43,75
SK Sturm Gra,1862,2,17,10,9,63,38,25,61
Vienna,1862,3,18,6,12,60,52,8,60
SC Rheindorf,1862,4,16,11,9,57,47,10,59
Rapid Vienna,1862,5,15,12,9,55,38,17,57
RZ Pellets W,1862,6,14,8,14,57,53,4,50
Mattersburg,1862,7,11,8,17,39,56,-17,41
Admira Wacke,1862,8,9,7,20,35,69,-34,34
SV Josko Rie,1862,9,9,6,21,34,55,-21,33
St. Pölten,1862,10,6,9,21,39,74,-35,27
FC Salzburg,1863,1,22,8,6,71,33,38,74
SC Rheindorf,1863,2,22,7,7,62,40,22,73
SK Sturm Gra,1863,3,16,10,10,52,36,16,58
Vienna,1863,4,17,7,12,61,55,6,58
Rapid Vienna,1863,5,11,13,12,46,40,6,46
RZ Pellets W,1863,6,12,8,16,54,56,-2,44
Admira Wacke,1863,7,11,9,16,41,63,-22,42
SV Josko Rie,1863,8,11,4,21,31,53,-22,37
Mattersburg,1863,9,8,10,18,42,56,-14,34
St. Pölten,1863,10,8,8,20,37,65,-28,32
FC Salzburg,1864,1,22,6,8,66,26,40,72
Rapid Vienna,1864,2,17,10,9,55,33,22,61
SC Rheindorf,1864,3,18,7,11,53,43,10,61
SK Sturm Gra,1864,4,18,6,12,63,44,19,60
Vienna,1864,5,18,4,14,62,51,11,58
RZ Pellets W,1864,6,12,7,17,45,60,-15,43
St. Pölten,1864,7,11,8,17,48,63,-15,41
SV Josko Rie,1864,8,11,5,20,36,59,-23,38
Admira Wacke,1864,9,10,8,18,32,56,-24,38
Mattersburg,1864,10,9,7,20,33,58,-25,34
FC Salzburg,1865,1,22,6,8,64,32,32,72
Vienna,1865,2,21,5,10,77,52,25,68
SK Sturm Gra,1865,3,18,8,10,58,41,17,62
SC Rheindorf,1865,4,16,9,11,50,44,6,57
Rapid Vienna,1865,5,15,8,13,55,41,14,53
Admira Wacke,1865,6,12,7,17,33,49,-16,43
Mattersburg,1865,7,11,8,17,37,52,-15,41
St. Pölten,1865,8,9,12,15,42,57,-15,39
RZ Pellets W,1865,9,8,9,19,37,60,-23,33
SV Josko Rie,1865,10,9,6,21,33,58,-25,33
FC Salzburg,1866,1,23,6,7,71,29,42,75
SC Rheindorf,1866,2,21,7,8,59,44,15,70
SK Sturm Gra,1866,3,21,4,11,64,40,24,67
Rapid Vienna,1866,4,15,8,13,60,47,13,53
Vienna,1866,5,16,5,15,64,58,6,53
RZ Pellets W,1866,6,15,8,13,49,46,3,53
SV Josko Rie,1866,7,11,7,18,37,52,-15,40
Admira Wacke,1866,8,10,7,19,40,68,-28,37
Mattersburg,1866,9,9,7,20,33,58,-25,34
St. Pölten,1866,10,6,7,23,37,72,-35,25
FC Salzburg,1867,1,19,10,7,66,32,34,67
SC Rheindorf,1867,2,18,11,7,48,37,11,65
SK Sturm Gra,1867,3,18,7,11,60,45,15,61
Vienna,1867,4,16,8,12,61,54,7,56
RZ Pellets W,1867,5,13,9,14,49,54,-5,48
Rapid Vienna,1867,6,11,13,12,46,39,7,46
Admira Wacke,1867,7,12,8,16,43,56,-13,44
St. Pölten,1867,8,8,13,15,46,60,-14,37
SV Josko Rie,1867,9,10,6,20,33,56,-23,36
Mattersburg,1867,10,7,11,18,36,55,-19,32
SK Sturm Gra,1868,1,22,5,9,69,39,30,71
SC Rheindorf,1868,2,20,9,7,61,42,19,69
FC Salzburg,1868,3,20,7,9,72,39,33,67
Vienna,1868,4,16,7,13,67,56,11,55
Rapid Vienna,1868,5,13,11,12,53,42,11,50
SV Josko Rie,1868,6,13,3,20,37,55,-18,42
RZ Pellets W,1868,7,11,7,18,47,68,-21,40
Mattersburg,1868,8,11,5,20,41,56,-15,38
Admira Wacke,1868,9,11,5,20,37,64,-27,38
St. Pölten,1868,10,9,9,18,41,64,-23,36
FC Salzburg,1869,1,22,6,8,69,28,41,72
SC Rheindorf,1869,2,18,9,9,54,43,11,63
SK Sturm Gra,1869,3,18,5,13,64,44,20,59
Rapid Vienna,1869,4,16,11,9,60,40,20,59
Vienna,1869,5,17,6,13,59,57,2,57
RZ Pellets W,1869,6,16,7,13,47,44,3,55
Admira Wacke,1869,7,11,7,18,35,60,-25,40
SV Josko Rie,1869,8,11,4,21,38,54,-16,37
St. Pölten,1869,9,7,11,18,40,68,-28,32
Mattersburg,1869,10,6,10,20,32,60,-28,28
FC Salzburg,1870,1,24,5,7,70,28,42,77
SC Rheindorf,1870,2,21,5,10,61,46,15,68
SK Sturm Gra,1870,3,17,7,12,50,35,15,58
Vienna,1870,4,18,4,14,58,52,6,58
RZ Pellets W,1870,5,14,10,12,51,51,0,52
Rapid Vienna,1870,6,12,10,14,54,41,13,46
Mattersburg,1870,7,10,9,17,45,56,-11,39
SV Josko Rie,1870,8,11,4,21,34,56,-22,37
St. Pölten,1870,9,9,10,17,39,62,-23,37
Admira Wacke,1870,10,10,4,22,33,68,-35,34
FC Salzburg,1871,1,20,9,7,65,31,34,69
SC Rheindorf,1871,2,18,6,12,56,49,7,60
SK Sturm Gra,1871,3,15,11,10,54,38,16,56
Vienna,1871,4,16,7,13,59,57,2,55
Rapid Vienna,1871,5,12,13,11,58,44,14,49
RZ Pellets W,1871,6,13,8,15,48,49,-1,47
SV Josko Rie,1871,7,13,7,16,42,54,-12,46
Admira Wacke,1871,8,11,9,16,39,55,-16,42
St. Pölten,1871,9,9,10,17,41,65,-24,37
Mattersburg,1871,10,7,12,17,32,52,-20,33
FC Salzburg,1872,1,23,8,5,74,30,44,77
SC Rheindorf,1872,2,18,11,7,53,35,18,65
SK Sturm Gra,1872,3,18,10,8,64,34,30,64
Vienna,1872,4,19,3,14,68,57,11,60
Rapid Vienna,1872,5,14,9,13,55,45,10,51
RZ Pellets W,1872,6,15,6,15,44,53,-9,51
Admira Wacke,1872,7,10,6,20,41,63,-22,36
St. Pölten,1872,8,9,8,19,37,67,-30,35
Mattersburg,1872,9,7,10,19,35,60,-25,31
SV Josko Rie,1872,10,8,7,21,27,54,-27,31
SK Sturm Gra,1873,1,24,6,6,71,27,44,78
FC Salzburg,1873,2,17,11,8,59,30,29,62
SC Rheindorf,1873,3,17,10,9,51,42,9,61
Vienna,1873,4,15,6,15,55,59,-4,51
Rapid Vienna,1873,5,11,12,13,45,36,9,45
RZ Pellets W,1873,6,12,8,16,41,53,-12,44
Admira Wacke,1873,7,12,8,16,37,56,-19,44
Mattersburg,1873,8,11,9,16,39,51,-12,42
SV Josko Rie,1873,9,10,7,19,29,47,-18,37
St. Pölten,1873,10,7,11,18,35,61,-26,32
FC Salzburg,1874,1,21,6,9,69,30,39,69
SK Sturm Gra,1874,2,20,6,10,61,35,26,66
SC Rheindorf,1874,3,19,7,10,53,42,11,64
Rapid Vienna,1874,4,16,10,10,54,36,18,58
Vienna,1874,5,16,5,15,60,59,1,53
RZ Pellets W,1874,6,13,7,16,44,54,-10,46
Mattersburg,1874,7,10,9,17,42,54,-12,39
St. Pölten,1874,8,10,9,17,41,63,-22,39
SV Josko Rie,1874,9,11,4,21,32,55,-23,37
Admira Wacke,1874,10,8,9,19,31,59,-28,33
FC Salzburg,1875,1,22,7,7,64,30,34,73
SK Sturm Gra,1875,2,22,5,9,63,34,29,71
SC Rheindorf,1875,3,18,8,10,53,42,11,62
Vienna,1875,4,17,5,14,61,57,4,56
Rapid Vienna,1875,5,14,10,12,56,42,14,52
Admira Wacke,1875,6,12,5,19,41,62,-21,41
SV Josko Rie,1875,7,11,7,18,40,57,-17,40
Mattersburg,1875,8,10,8,18,37,50,-13,38
St. Pölten,1875,9,9,10,17,37,57,-20,37
RZ Pellets W,1875,10,9,7,20,43,64,-21,34
FC Salzburg,1876,1,23,8,5,76,33,43,77
SC Rheindorf,1876,2,20,7,9,64,47,17,67
Vienna,1876,3,20,5,11,65,52,13,65
Rapid Vienna,1876,4,15,11,10,59,39,20,56
SK Sturm Gra,1876,5,16,8,12,58,46,12,56
Admira Wacke,1876,6,14,5,17,44,56,-12,47
RZ Pellets W,1876,7,11,8,17,47,54,-7,41
Mattersburg,1876,8,10,7,19,38,61,-23,37
SV Josko Rie,1876,9,9,7,20,41,60,-19,34
St. Pölten,1876,10,5,8,23,31,75,-44,23
SC Rheindorf,1877,1,23,6,7,57,36,21,75
FC Salzburg,1877,2,22,6,8,68,31,37,72
Vienna,1877,3,18,6,12,66,59,7,60
SK Sturm Gra,1877,4,17,6,13,59,43,16,57
Rapid Vienna,1877,5,14,12,10,56,41,15,54
Admira Wacke,1877,6,14,4,18,41,56,-15,46
St. Pölten,1877,7,11,9,16,44,56,-12,42
RZ Pellets W,1877,8,9,11,16,44,60,-16,38
SV Josko Rie,1877,9,11,4,21,36,55,-19,37
Mattersburg,1877,10,5,8,23,29,63,-34,23
SK Sturm Gra,1878,1,21,8,7,65,31,34,71
FC Salzburg,1878,2,20,7,9,65,38,27,67
Vienna,1878,3,21,4,11,61,44,17,67
SC Rheindorf,1878,4,16,9,11,54,46,8,57
Rapid Vienna,1878,5,15,11,10,60,39,21,56
Admira Wacke,1878,6,14,4,18,46,61,-15,46
RZ Pellets W,1878,7,12,6,18,44,62,-18,42
St. Pölten,1878,8,8,10,18,40,63,-23,34
SV Josko Rie,1878,9,8,8,20,32,59,-27,32
Mattersburg,1878,10,7,9,20,35,59,-24,30
FC Salzburg,1879,1,22,6,8,66,32,34,72
Vienna,1879,2,22,4,10,73,51,22,70
SC Rheindorf,1879,3,19,7,10,54,45,9,64
SK Sturm Gra,1879,4,17,8,11,53,38,15,59
Rapid Vienna,1879,5,12,10,14,53,48,5,46
Mattersburg,1879,6,11,11,14,40,51,-11,44
Admira Wacke,1879,7,11,7,18,34,54,-20,40
RZ Pellets W,1879,8,10,7,19,44,63,-19,37
St. Pölten,1879,9,9,9,18,47,64,-17,36
SV Josko Rie,1879,10,10,5,21,36,54,-18,35
FC Salzburg,1880,1,23,6,7,71,34,37,75
SC Rheindorf,1880,2,22,5,9,62,46,16,71
SK Sturm Gra,1880,3,19,8,9,65,36,29,65
Rapid Vienna,1880,4,16,8,12,56,32,24,56
Vienna,1880,5,16,7,13,56,55,1,55
RZ Pellets W,1880,6,12,9,15,47,56,-9,45
Admira Wacke,1880,7,11,5,20,37,65,-28,38
SV Josko Rie,1880,8,11,4,21,36,54,-18,37
St. Pölten,1880,9,9,9,18,39,63,-24,36
Mattersburg,1880,10,8,5,23,36,64,-28,29
Vienna,1881,1,21,4,11,63,48,15,67
SK Sturm Gra,1881,2,19,7,10,59,36,23,64
FC Salzburg,1881,3,18,9,9,56,30,26,63
SC Rheindorf,1881,4,19,5,12,59,54,5,62
RZ Pellets W,1881,5,15,6,15,49,52,-3,51
Rapid Vienna,1881,6,11,13,12,54,46,8,46
SV Josko Rie,1881,7,12,4,20,36,46,-10,40
Mattersburg,1881,8,10,10,16,44,58,-14,40
St. Pölten,1881,9,9,9,18,47,68,-21,36
Admira Wacke,1881,10,10,5,21,34,63,-29,35
SC Rheindorf,1882,1,20,8,8,60,38,22,68
Vienna,1882,2,21,4,11,65,46,19,67
SK Sturm Gra,1882,3,20,6,10,64,33,31,66
FC Salzburg,1882,4,19,7,10,56,30,26,64
Rapid Vienna,1882,5,14,10,12,50,35,15,52
RZ Pellets W,1882,6,13,8,15,49,62,-13,47
Admira Wacke,1882,7,10,7,19,35,64,-29,37
SV Josko Rie,1882,8,10,6,20,31,51,-20,36
Mattersburg,1882,9,8,11,17,30,53,-23,35
St. Pölten,1882,10,7,9,20,40,68,-28,30
FC Salzburg,1883,1,23,9,4,66,23,43,78
SK Sturm Gra,1883,2,20,5,11,59,36,23,65
Vienna,1883,3,19,4,13,63,53,10,61
SC Rheindorf,1883,4,16,11,9,50,45,5,59
Rapid Vienna,1883,5,11,14,11,56,42,14,47
Admira Wacke,1883,6,13,6,17,35,52,-17,45
SV Josko Rie,1883,7,12,5,19,37,57,-20,41
RZ Pellets W,1883,8,12,4,20,45,58,-13,40
Mattersburg,1883,9,9,8,19,41,59,-18,35
St. Pölten,1883,10,8,8,20,43,70,-27,32
FC Salzburg,1884,1,23,8,5,76,31,45,77
Vienna,1884,2,20,5,11,67,52,15,65
SK Sturm Gra,1884,3,19,5,12,56,32,24,62
SC Rheindorf,1884,4,18,8,10,54,45,9,62
Rapid Vienna,1884,5,13,12,11,50,43,7,51
RZ Pellets W,1884,6,11,8,17,41,54,-13,41
St. Pölten,1884,7,10,10,16,48,64,-16,40
Admira Wacke,1884,8,11,7,18,40,63,-23,40
Mattersburg,1884,9,8,8,20,36,60,-24,32
SV Josko Rie,1884,10,9,5,22,31,55,-24,32
FC Salzburg,1885,1,21,7,8,67,33,34,70
SC Rheindorf,1885,2,20,6,10,53,43,10,66
Vienna,1885,3,19,6,11,62,53,9,63
SK Sturm Gra,1885,4,17,8,11,60,36,24,59
Rapid Vienna,1885,5,16,10,10,60,41,19,58
RZ Pellets W,1885,6,15,5,16,52,56,-4,50
SV Josko Rie,1885,7,11,7,18,32,46,-14,40
Admira Wacke,1885,8,9,7,20,32,62,-30,34
Mattersburg,1885,9,7,11,18,39,60,-21,32
St. Pölten,1885,10,7,9,20,43,70,-27,30
FC Salzburg,1886,1,23,6,7,77,35,42,75
SC Rheindorf,1886,2,20,8,8,71,50,21,68
SK Sturm Gra,1886,3,20,5,11,65,40,25,65
Vienna,1886,4,18,4,14,61,55,6,58
Rapid Vienna,1886,5,15,8,13,60,44,16,53
RZ Pellets W,1886,6,14,7,15,52,55,-3,49
St. Pölten,1886,7,11,6,19,44,66,-22,39
SV Josko Rie,1886,8,11,5,20,37,59,-22,38
Admira Wacke,1886,9,9,6,21,32,65,-33,33
Mattersburg,1886,10,7,9,20,35,65,-30,30
SC Rheindorf,1887,1,23,7,6,70,39,31,76
FC Salzburg,1887,2,21,7,8,66,34,32,70
SK Sturm Gra,1887,3,19,6,11,67,37,30,63
Vienna,1887,4,19,6,11,66,56,10,63
Rapid Vienna,1887,5,13,10,13,54,43,11,49
RZ Pellets W,1887,6,11,9,16,51,68,-17,42
St. Pölten,1887,7,9,11,16,44,65,-21,38
Admira Wacke,1887,8,10,8,18,41,63,-22,38
SV Josko Rie,1887,9,11,2,23,34,59,-25,35
Mattersburg,1887,10,8,6,22,34,63,-29,30
FC Salzburg,1888,1,19,9,8,60,31,29,66
SC Rheindorf,1888,2,18,9,9,50,43,7,63
Vienna,1888,3,18,7,11,59,47,12,61
SK Sturm Gra,1888,4,17,8,11,61,36,25,59
RZ Pellets W,1888,5,16,7,13,50,55,-5,55
Rapid Vienna,1888,6,12,12,12,52,39,13,48
SV Josko Rie,1888,7,11,8,17,41,54,-13,41
Mattersburg,1888,8,10,9,17,42,53,-11,39
St. Pölten,1888,9,8,9,19,37,65,-28,33
Admira Wacke,1888,10,8,8,20,31,60,-29,32
FC Salzburg,1889,1,21,10,5,63,29,34,73
SK Sturm Gra,1889,2,21,4,11,69,39,30,67
SC Rheindorf,1889,3,19,9,8,47,33,14,66
Vienna,1889,4,18,4,14,62,50,12,58
RZ Pellets W,1889,5,14,8,14,50,53,-3,50
Rapid Vienna,1889,6,12,10,14,57,46,11,46
Mattersburg,1889,7,12,7,17,34,48,-14,43
SV Josko Rie,1889,8,11,4,21,33,55,-22,37
Admira Wacke,1889,9,9,8,19,28,62,-34,35
St. Pölten,1889,10,6,10,20,29,57,-28,28
SK Sturm Gra,1890,1,23,3,10,65,32,33,72
FC Salzburg,1890,2,21,7,8,68,35,33,70
Vienna,1890,3,21,4,11,69,49,20,67
SC Rheindorf,1890,4,20,7,9,58,44,14,67
Rapid Vienna,1890,5,14,9,13,59,48,11,51
RZ Pellets W,1890,6,14,5,17,49,67,-18,47
SV Josko Rie,1890,7,12,5,19,32,48,-16,41
Admira Wacke,1890,8,12,3,21,37,60,-23,39
Mattersburg,1890,9,8,6,22,34,60,-26,30
St. Pölten,1890,10,5,11,20,39,67,-28,26
SK Sturm Gra,1891,1,20,8,8,59,32,27,68
SC Rheindorf,1891,2,20,7,9,59,42,17,67
Vienna,1891,3,18,8,10,61,45,16,62
FC Salzburg,1891,4,17,10,9,62,34,28,61
Rapid Vienna,1891,5,14,9,13,51,43,8,51
Admira Wacke,1891,6,12,7,17,34,54,-20,43
St. Pölten,1891,7,10,12,14,43,57,-14,42
RZ Pellets W,1891,8,10,9,17,38,52,-14,39
SV Josko Rie,1891,9,10,3,23,32,58,-26,33
Mattersburg,1891,10,7,11,18,37,59,-22,32
SC Rheindorf,1892,1,22,6,8,61,38,23,72
SK Sturm Gra,1892,2,20,5,11,62,34,28,65
FC Salzburg,1892,3,18,10,8,53,29,24,64
Vienna,1892,4,19,6,11,65,55,10,63
Rapid Vienna,1892,5,16,8,12,54,37,17,56
Admira Wacke,1892,6,14,5,17,43,61,-18,47
RZ Pellets W,1892,7,11,8,17,42,54,-12,41
Mattersburg,1892,8,9,8,19,36,53,-17,35
SV Josko Rie,1892,9,10,4,22,31,55,-24,34
St. Pölten,1892,10,7,8,21,34,65,-31,29
SC Rheindorf,1893,1,23,8,5,63,37,26,77
FC Salzburg,1893,2,21,10,5,69,32,37,73
SK Sturm Gra,1893,3,16,9,11,57,38,19,57
Vienna,1893,4,17,6,13,53,51,2,57
Rapid Vienna,1893,5,12,10,14,54,45,9,46
Mattersburg,1893,6,12,6,18,46,57,-11,42
Admira Wacke,1893,7,11,9,16,43,63,-20,42
St. Pölten,1893,8,11,8,17,45,61,-16,41
RZ Pellets W,1893,9,9,9,18,43,60,-17,36
SV Josko Rie,1893,10,8,5,23,28,57,-29,29
SC Rheindorf,1894,1,21,6,9,59,39,20,69
FC Salzburg,1894,2,20,6,10,67,36,31,66
SK Sturm Gra,1894,3,19,8,9,58,35,23,65
Vienna,1894,4,20,3,13,61,53,8,63
RZ Pellets W,1894,5,16,5,15,46,49,-3,53
Rapid Vienna,1894,6,12,10,14,51,42,9,46
Admira Wacke,1894,7,13,6,17,42,53,-11,45
SV Josko Rie,1894,8,11,5,20,34,59,-25,38
St. Pölten,1894,9,8,10,18,39,64,-25,34
Mattersburg,1894,10,7,7,22,32,59,-27,28
FC Salzburg,1895,1,23,6,7,70,34,36,75
SK Sturm Gra,1895,2,20,8,8,62,31,31,68
SC Rheindorf,1895,3,18,8,10,61,48,13,62
Rapid Vienna,1895,4,15,11,10,62,41,21,56
Vienna,1895,5,15,7,14,63,59,4,52
Mattersburg,1895,6,13,6,17,47,55,-8,45
Admira Wacke,1895,7,11,9,16,44,67,-23,42
RZ Pellets W,1895,8,12,5,19,44,64,-20,41
St. Pölten,1895,9,7,10,19,40,66,-26,31
SV Josko Rie,1895,10,7,8,21,29,57,-28,29
FC Salzburg,1896,1,25,5,6,77,29,48,80
SC Rheindorf,1896,2,23,8,5,59,37,22,77
SK Sturm Gra,1896,3,18,5,13,59,37,22,59
Rapid Vienna,1896,4,15,8,13,58,43,15,53
Vienna,1896,5,15,7,14,57,57,0,52
RZ Pellets W,1896,6,15,4,17,52,61,-9,49
Admira Wacke,1896,7,12,3,21,33,62,-29,39
SV Josko Rie,1896,8,11,5,20,37,56,-19,38
St. Pölten,1896,9,9,10,17,42,59,-17,37
Mattersburg,1896,10,5,9,22,31,64,-33,24
FC Salzburg,1897,1,22,9,5,60,25,35,75
SC Rheindorf,1897,2,21,8,7,55,37,18,71
SK Sturm Gra,1897,3,20,5,11,55,33,22,65
Vienna,1897,4,19,5,12,64,47,17,62
Rapid Vienna,1897,5,13,9,14,56,45,11,48
RZ Pellets W,1897,6,10,8,18,46,63,-17,38
Mattersburg,1897,7,9,10,17,36,51,-15,37
St. Pölten,1897,8,9,9,18,36,58,-22,36
SV Josko Rie,1897,9,9,8,19,32,54,-22,35
Admira Wacke,1897,10,9,7,20,33,60,-27,34
FC Salzburg,1898,1,20,8,8,68,36,32,68
SC Rheindorf,1898,2,20,7,9,56,40,16,67
SK Sturm Gra,1898,3,19,5,12,60,39,21,62
Vienna,1898,4,17,5,14,55,48,7,56
Rapid Vienna,1898,5,14,12,10,61,38,23,54
SV Josko Rie,1898,6,13,3,20,38,50,-12,42
Admira Wacke,1898,7,11,7,18,31,58,-27,40
RZ Pellets W,1898,8,10,9,17,37,55,-18,39
Mattersburg,1898,9,9,11,16,34,53,-19,38
St. Pölten,1898,10,7,13,16,32,55,-23,34
FC Salzburg,1899,1,21,8,7,68,30,38,71
SK Sturm Gra,1899,2,20,5,11,59,36,23,65
SC Rheindorf,1899,3,19,7,10,52,45,7,64
Vienna,1899,4,19,4,13,63,55,8,61
Rapid Vienna,1899,5,13,8,15,51,39,12,47
RZ Pellets W,1899,6,13,6,17,44,55,-11,45
Mattersburg,1899,7,12,7,17,41,48,-7,43
St. Pölten,1899,8,11,8,17,48,62,-14,41
Admira Wacke,1899,9,9,8,19,34,65,-31,35
SV Josko Rie,1899,10,9,7,20,33,58,-25,34
FC Salzburg,1900,1,23,6,7,75,32,43,75
SC Rheindorf,1900,2,19,6,11,59,51,8,63
Vienna,1900,3,18,6,12,61,54,7,60
SK Sturm Gra,1900,4,18,4,14,58,42,16,58
RZ Pellets W,1900,5,15,8,13,57,56,1,53
Rapid Vienna,1900,6,11,10,15,50,49,1,43
Admira Wacke,1900,7,12,6,18,39,58,-19,42
St. Pölten,1900,8,10,10,16,51,63,-12,40
SV Josko Rie,1900,9,11,4,21,34,55,-21,37
Mattersburg,1900,10,8,10,18,38,62,-24,34
SK Sturm Gra,1901,1,21,7,8,71,33,38,70
SC Rheindorf,1901,2,19,9,8,58,45,13,66
FC Salzburg,1901,3,19,8,9,62,31,31,65
RZ Pellets W,1901,4,18,5,13,57,52,5,59
Vienna,1901,5,17,7,12,58,50,8,58
Rapid Vienna,1901,6,11,14,11,54,47,7,47
Admira Wacke,1901,7,12,6,18,35,57,-22,42
St. Pölten,1901,8,6,13,17,46,71,-25,31
SV Josko Rie,1901,9,7,8,21,32,62,-30,29
Mattersburg,1901,10,5,13,18,32,57,-25,28
FC Salzburg,1902,1,23,5,8,66,27,39,74
SC Rheindorf,1902,2,20,7,9,56,42,14,67
SK Sturm Gra,1902,3,20,6,10,61,36,25,66
Vienna,1902,4,17,6,13,58,51,7,57
Rapid Vienna,1902,5,10,16,10,46,39,7,46
Mattersburg,1902,6,13,6,17,45,54,-9,45
Admira Wacke,1902,7,12,8,16,36,52,-16,44
SV Josko Rie,1902,8,11,6,19,33,50,-17,39
RZ Pellets W,1902,9,9,7,20,35,60,-25,34
St. Pölten,1902,10,7,9,20,45,70,-25,30
SK Sturm Gra,1903,1,22,4,10,65,32,33,70
Vienna,1903,2,20,7,9,64,46,18,67
SC Rheindorf,1903,3,20,6,10,53,44,9,66
FC Salzburg,1903,4,19,5,12,64,41,23,62
Rapid Vienna,1903,5,16,10,10,68,40,28,58
RZ Pellets W,1903,6,14,5,17,48,53,-5,47
Admira Wacke,1903,7,12,7,17,34,61,-27,43
Mattersburg,1903,8,9,9,18,34,53,-19,36
SV Josko Rie,1903,9,9,4,23,27,56,-29,31
St. Pölten,1903,10,6,9,21,38,69,-31,27
FC Salzburg,1904,1,21,8,7,66,39,27,71
SC Rheindorf,1904,2,21,6,9,64,46,18,69
SK Sturm Gra,1904,3,20,6,10,57,34,23,66
Vienna,1904,4,20,4,12,71,52,19,64
Rapid Vienna,1904,5,16,8,12,63,38,25,56
Admira Wacke,1904,6,14,6,16,42,51,-9,48
RZ Pellets W,1904,7,12,9,15,46,58,-12,45
Mattersburg,1904,8,6,11,19,36,61,-25,29
St. Pölten,1904,9,7,8,21,39,71,-32,29
SV Josko Rie,1904,10,8,4,24,27,61,-34,28
SC Rheindorf,1905,1,21,7,8,53,35,18,70
FC Salzburg,1905,2,20,7,9,64,29,35,67
SK Sturm Gra,1905,3,20,4,12,57,35,22,64
Vienna,1905,4,20,4,12,61,48,13,64
Rapid Vienna,1905,5,13,13,10,54,34,20,52
Admira Wacke,1905,6,12,6,18,37,59,-22,42
RZ Pellets W,1905,7,10,9,17,39,53,-14,39
SV Josko Rie,1905,8,11,5,20,32,52,-20,38
St. Pölten,1905,9,8,10,18,36,61,-25,34
Mattersburg,1905,10,9,7,20,36,63,-27,34
SC Rheindorf,1906,1,20,7,9,61,42,19,67
SK Sturm Gra,1906,2,20,6,10,64,39,25,66
FC Salzburg,1906,3,18,9,9,62,33,29,63
Rapid Vienna,1906,4,14,12,10,55,38,17,54
Vienna,1906,5,16,6,14,70,62,8,54
RZ Pellets W,1906,6,15,7,14,47,47,0,52
Admira Wacke,1906,7,12,8,16,35,55,-20,44
SV Josko Rie,1906,8,9,7,20,30,51,-21,34
St. Pölten,1906,9,8,9,19,36,65,-29,33
Mattersburg,1906,10,7,11,18,32,60,-28,32
SK Sturm Gra,1907,1,21,5,10,58,34,24,68
SC Rheindorf,1907,2,20,6,10,54,50,4,66
Vienna,1907,3,20,5,11,68,49,19,65
FC Salzburg,1907,4,19,6,11,59,34,25,63
Rapid Vienna,1907,5,12,13,11,51,37,14,49
Admira Wacke,1907,6,14,5,17,46,54,-8,47
St. Pölten,1907,7,11,8,17,48,59,-11,41
SV Josko Rie,1907,8,12,5,19,41,58,-17,41
RZ Pellets W,1907,9,10,8,18,42,60,-18,38
Mattersburg,1907,10,6,9,21,30,62,-32,27
SC Rheindorf,1908,1,20,8,8,61,39,22,68
FC Salzburg,1908,2,17,11,8,57,30,27,62
SK Sturm Gra,1908,3,17,8,11,52,36,16,59
Rapid Vienna,1908,4,16,10,10,61,40,21,58
Vienna,1908,5,17,6,13,60,56,4,57
Admira Wacke,1908,6,14,7,15,44,58,-14,49
RZ Pellets W,1908,7,13,5,18,45,59,-14,44
SV Josko Rie,1908,8,9,12,15,37,50,-13,39
Mattersburg,1908,9,5,14,17,34,56,-22,29
St. Pölten,1908,10,6,11,19,30,57,-27,29
FC Salzburg,1909,1,20,9,7,67,28,39,69
Vienna,1909,2,21,3,12,74,53,21,66
SC Rheindorf,1909,3,20,5,11,65,53,12,65
SK Sturm Gra,1909,4,19,5,12,60,42,18,62
SV Josko Rie,1909,5,14,6,16,38,46,-8,48
Rapid Vienna,1909,6,10,13,13,54,47,7,43
Admira Wacke,1909,7,12,6,18,38,57,-19,42
St. Pölten,1909,8,11,8,17,47,63,-16,41
RZ Pellets W,1909,9,10,7,19,40,64,-24,37
Mattersburg,1909,10,7,10,19,33,63,-30,31
SK Sturm Gra,1910,1,22,5,9,61,35,26,71
FC Salzburg,1910,2,19,8,9,64,29,35,65
Vienna,1910,3,19,4,13,61,53,8,61
SC Rheindorf,1910,4,18,7,11,50,42,8,61
Rapid Vienna,1910,5,13,13,10,56,37,19,52
Admira Wacke,1910,6,12,7,17,41,58,-17,43
RZ Pellets W,1910,7,12,6,18,46,63,-17,42
SV Josko Rie,1910,8,12,5,19,47,51,-4,41
Mattersburg,1910,9,10,7,19,39,59,-20,37
St. Pölten,1910,10,7,10,19,36,74,-38,31
SK Sturm Gra,1911,1,20,8,8,67,33,34,68
SC Rheindorf,1911,2,20,8,8,56,44,12,68
FC Salzburg,1911,3,19,9,8,62,31,31,66
Vienna,1911,4,18,8,10,66,52,14,62
Rapid Vienna,1911,5,11,13,12,52,43,9,46
RZ Pellets W,1911,6,11,10,15,49,59,-10,43
Admira Wacke,1911,7,10,10,16,41,63,-22,40
St. Pölten,1911,8,9,10,17,41,59,-18,37
SV Josko Rie,1911,9,9,6,21,30,58,-28,33
Mattersburg,1911,10,7,10,19,34,56,-22,31
FC Salzburg,1912,1,21,8,7,71,31,40,71
SK Sturm Gra,1912,2,20,7,9,64,36,28,67
Rapid Vienna,1912,3,18,8,10,64,43,21,62
Vienna,1912,4,18,7,11,65,54,11,61
SC Rheindorf,1912,5,17,10,9,52,42,10,61
RZ Pellets W,1912,6,12,7,17,49,57,-8,43
St. Pölten,1912,7,9,11,16,45,67,-22,38
Admira Wacke,1912,8,8,10,18,30,60,-30,34
Mattersburg,1912,9,6,12,18,35,54,-19,30
SV Josko Rie,1912,10,7,8,21,30,61,-31,29
FC Salzburg,1913,1,22,9,5,72,33,39,75
SK Sturm Gra,1913,2,21,3,12,65,36,29,66
Vienna,1913,3,20,5,11,65,48,17,65
SC Rheindorf,1913,4,17,6,13,50,50,0,57
Admira Wacke,1913,5,13,6,17,40,58,-18,45
Rapid Vienna,1913,6,11,9,16,51,46,5,42
RZ Pellets W,1913,7,11,9,16,42,52,-10,42
SV Josko Rie,1913,8,12,4,20,35,59,-24,40
St. Pölten,1913,9,10,8,18,45,62,-17,38
Mattersburg,1913,10,10,7,19,38,59,-21,37
FC Salzburg,1914,1,24,5,7,69,31,38,77
SC Rheindorf,1914,2,20,9,7,61,44,17,69
SK Sturm Gra,1914,3,18,6,12,59,37,22,60
Vienna,1914,4,17,9,10,65,51,14,60
Rapid Vienna,1914,5,15,11,10,59,42,17,56
RZ Pellets W,1914,6,11,8,17,47,61,-14,41
St. Pölten,1914,7,10,8,18,41,61,-20,38
Admira Wacke,1914,8,9,8,19,38,62,-24,35
SV Josko Rie,1914,9,8,8,20,34,62,-28,32
Mattersburg,1914,10,6,12,18,37,59,-22,30
FC Salzburg,1915,1,21,8,7,66,28,38,71
SK Sturm Gra,1915,2,20,6,10,63,36,27,66
SC Rheindorf,1915,3,19,5,12,54,46,8,62
Vienna,1915,4,19,4,13,65,50,15,61
Admira Wacke,1915,5,14,5,17,37,57,-20,47
Rapid Vienna,1915,6,11,11,14,51,45,6,44
RZ Pellets W,1915,7,12,8,16,46,58,-12,44
Mattersburg,1915,8,11,10,15,43,54,-11,43
St. Pölten,1915,9,11,8,17,46,61,-15,41
SV Josko Rie,1915,10,8,3,25,29,65,-36,27
FC Salzburg,1916,1,23,7,6,70,24,46,76
Vienna,1916,2,20,6,10,65,43,22,66
SK Sturm Gra,1916,3,18,7,11,60,36,24,61
SC Rheindorf,1916,4,17,9,10,53,47,6,60
Rapid Vienna,1916,5,15,11,10,57,40,17,56
RZ Pellets W,1916,6,12,9,15,42,52,-10,45
Admira Wacke,1916,7,12,4,20,37,61,-24,40
St. Pölten,1916,8,7,12,17,37,61,-24,33
SV Josko Rie,1916,9,9,6,21,29,55,-26,33
Mattersburg,1916,10,7,9,20,38,69,-31,30
FC Salzburg,1917,1,21,10,5,64,28,36,73
SK Sturm Gra,1917,2,21,7,8,64,31,33,70
SC Rheindorf,1917,3,18,10,8,56,45,11,64
Vienna,1917,4,16,9,11,57,49,8,57
Rapid Vienna,1917,5,13,13,10,64,45,19,52
SV Josko Rie,1917,6,13,4,19,40,53,-13,43
Admira Wacke,1917,7,9,9,18,30,56,-26,36
RZ Pellets W,1917,8,9,8,19,39,62,-23,35
St. Pölten,1917,9,8,9,19,45,72,-27,33
Mattersburg,1917,10,6,13,17,36,54,-18,31
FC Salzburg,1918,1,24,5,7,71,35,36,77
Vienna,1918,2,21,5,10,66,47,19,68
SC Rheindorf,1918,3,19,7,10,59,40,19,64
SK Sturm Gra,1918,4,16,11,9,56,36,20,59
Rapid Vienna,1918,5,14,10,12,59,47,12,52
RZ Pellets W,1918,6,12,9,15,46,53,-7,45
St. Pölten,1918,7,9,9,18,45,69,-24,36
Mattersburg,1918,8,9,8,19,38,58,-20,35
Admira Wacke,1918,9,9,7,20,39,65,-26,34
SV Josko Rie,1918,10,8,7,21,36,65,-29,31
FC Salzburg,1919,1,21,8,7,66,29,37,71
SK Sturm Gra,1919,2,21,6,9,63,33,30,69
SC Rheindorf,1919,3,19,9,8,57,40,17,66
Vienna,1919,4,16,7,13,61,54,7,55
Rapid Vienna,1919,5,14,8,14,61,48,13,50
Mattersburg,1919,6,13,7,16,44,54,-10,46
RZ Pellets W,1919,7,12,7,17,47,62,-15,43
Admira Wacke,1919,8,10,7,19,38,65,-27,37
SV Josko Rie,1919,9,9,7,20,37,64,-27,34
St. Pölten,1919,10,6,12,18,41,66,-25,30
FC Salzburg,1920,1,23,6,7,65,31,34,75
Vienna,1920,2,21,5,10,74,50,24,68
SK Sturm Gra,1920,3,20,7,9,56,30,26,67
SC Rheindorf,1920,4,19,8,9,59,47,12,65
Rapid Vienna,1920,5,14,10,12,61,41,20,52
RZ Pellets W,1920,6,13,8,15,48,56,-8,47
Mattersburg,1920,7,9,8,19,36,58,-22,35
St. Pölten,1920,8,8,8,20,42,68,-26,32
SV Josko Rie,1920,9,9,5,22,28,55,-27,32
Admira Wacke,1920,10,8,7,21,37,70,-33,31
FC Salzburg,1921,1,21,6,9,67,35,32,69
SK Sturm Gra,1921,2,20,9,7,65,38,27,69
SC Rheindorf,1921,3,19,10,7,58,43,15,67
Vienna,1921,4,19,5,12,60,45,15,62
Rapid Vienna,1921,5,13,13,10,58,45,13,52
RZ Pellets W,1921,6,12,9,15,46,54,-8,45
Admira Wacke,1921,7,11,5,20,41,68,-27,38
SV Josko Rie,1921,8,8,9,19,41,57,-16,33
St. Pölten,1921,9,7,11,18,38,68,-30,32
Mattersburg,1921,10,7,9,20,34,55,-21,30
SK Sturm Gra,1922,1,23,4,9,67,36,31,73
SC Rheindorf,1922,2,22,6,8,63,44,19,72
FC Salzburg,1922,3,21,8,7,62,30,32,71
Vienna,1922,4,18,5,13,62,58,4,59
Rapid Vienna,1922,5,15,11,10,60,36,24,56
RZ Pellets W,1922,6,13,8,15,52,59,-7,47
St. Pölten,1922,7,9,8,19,46,69,-23,35
Admira Wacke,1922,8,8,10,18,34,60,-26,34
SV Josko Rie,1922,9,8,6,22,35,58,-23,30
Mattersburg,1922,10,5,10,21,35,66,-31,25
SC Rheindorf,1923,1,22,8,6,58,35,23,74
FC Salzburg,1923,2,19,7,10,73,41,32,64
SK Sturm Gra,1923,3,19,6,11,61,34,27,63
Vienna,1923,4,16,6,14,56,54,2,54
Rapid Vienna,1923,5,13,10,13,56,40,16,49
RZ Pellets W,1923,6,13,8,15,43,51,-8,47
Admira Wacke,1923,7,13,7,16,38,56,-18,46
SV Josko Rie,1923,8,12,5,19,40,60,-20,41
St. Pölten,1923,9,9,8,19,42,63,-21,35
Mattersburg,1923,10,8,7,21,34,67,-33,31
SK Sturm Gra,1924,1,21,6,9,68,30,38,69
SC Rheindorf,1924,2,20,6,10,60,47,13,66
Rapid Vienna,1924,3,18,8,10,57,30,27,62
FC Salzburg,1924,4,17,9,10,67,40,27,60
Vienna,1924,5,15,8,13,63,63,0,53
RZ Pellets W,1924,6,12,7,17,49,61,-12,43
St. Pölten,1924,7,11,8,17,45,67,-22,41
Admira Wacke,1924,8,10,8,18,37,68,-31,38
SV Josko Rie,1924,9,10,7,19,37,54,-17,37
Mattersburg,1924,10,9,7,20,33,56,-23,34
FC Salzburg,1925,1,20,11,5,68,29,39,71
Vienna,1925,2,21,3,12,65,52,13,66
SC Rheindorf,1925,3,19,7,10,56,45,11,64
SK Sturm Gra,1925,4,18,7,11,62,32,30,61
RZ Pellets W,1925,5,13,10,13,48,53,-5,49
Rapid Vienna,1925,6,10,13,13,51,43,8,43
Admira Wacke,1925,7,11,7,18,34,60,-26,40
St. Pölten,1925,8,8,11,17,38,64,-26,35
Mattersburg,1925,9,7,13,16,41,58,-17,34
SV Josko Rie,1925,10,10,4,22,33,60,-27,34
FC Salzburg,1926,1,25,5,6,77,31,46,80
Vienna,1926,2,18,6,12,59,52,7,60
SC Rheindorf,1926,3,18,6,12,56,50,6,60
SK Sturm Gra,1926,4,17,8,11,56,41,15,59
Rapid Vienna,1926,5,13,11,12,56,47,9,50
RZ Pellets W,1926,6,13,7,16,52,58,-6,46
Admira Wacke,1926,7,12,8,16,41,54,-13,44
SV Josko Rie,1926,8,12,3,21,36,54,-18,39
Mattersburg,1926,9,9,8,19,44,58,-14,35
St. Pölten,1926,10,7,10,19,34,66,-32,31
FC Salzburg,1927,1,23,7,6,68,30,38,76
SC Rheindorf,1927,2,21,7,8,61,44,17,70
SK Sturm Gra,1927,3,20,7,9,67,34,33,67
Vienna,1927,4,19,4,13,71,53,18,61
Rapid Vienna,1927,5,13,10,13,56,45,11,49
St. Pölten,1927,6,10,10,16,47,60,-13,40
RZ Pellets W,1927,7,9,11,16,42,60,-18,38
Admira Wacke,1927,8,9,9,18,29,59,-30,36
SV Josko Rie,1927,9,10,5,21,35,60,-25,35
Mattersburg,1927,10,6,10,20,33,64,-31,28
FC Salzburg,1928,1,22,7,7,71,32,39,73
SK Sturm Gra,1928,2,20,7,9,62,40,22,67
Vienna,1928,3,21,4,11,70,53,17,67
SC Rheindorf,1928,4,16,10,10,60,47,13,58
Rapid Vienna,1928,5,12,11,13,54,46,8,47
SV Josko Rie,1928,6,12,5,19,36,56,-20,41
Admira Wacke,1928,7,12,5,19,39,62,-23,41
Mattersburg,1928,8,11,7,18,40,56,-16,40
RZ Pellets W,1928,9,9,8,19,42,64,-22,35
St. Pölten,1928,10,8,10,18,48,66,-18,34
FC Salzburg,1929,1,23,8,5,71,27,44,77
Vienna,1929,2,19,6,11,64,50,14,63
SK Sturm Gra,1929,3,18,7,11,55,38,17,61
SC Rheindorf,1929,4,17,9,10,53,45,8,60
Rapid Vienna,1929,5,10,15,11,49,40,9,45
RZ Pellets W,1929,6,12,8,16,46,54,-8,44
Admira Wacke,1929,7,13,4,19,41,62,-21,43
St. Pölten,1929,8,9,11,16,45,61,-16,38
Mattersburg,1929,9,10,8,18,36,54,-18,38
SV Josko Rie,1929,10,8,6,22,34,63,-29,30
SC Rheindorf,1930,1,21,5,10,54,45,9,68
FC Salzburg,1930,2,20,6,10,65,37,28,66
SK Sturm Gra,1930,3,20,6,10,56,30,26,66
Rapid Vienna,1930,4,15,10,11,58,43,15,55
Vienna,1930,5,15,8,13,54,49,5,53
SV Josko Rie,1930,6,13,6,17,37,49,-12,45
RZ Pellets W,1930,7,11,9,16,48,56,-8,42
Admira Wacke,1930,8,11,6,19,38,59,-21,39
Mattersburg,1930,9,9,10,17,36,52,-16,37
St. Pölten,1930,10,7,10,19,37,63,-26,31
SK Sturm Gra,1931,1,24,4,8,65,25,40,76
FC Salzburg,1931,2,20,8,8,60,27,33,68
SC Rheindorf,1931,3,18,9,9,56,45,11,63
Vienna,1931,4,19,4,13,64,52,12,61
Rapid Vienna,1931,5,14,12,10,53,37,16,54
RZ Pellets W,1931,6,12,8,16,44,51,-7,44
SV Josko Rie,1931,7,10,5,21,31,55,-24,35
St. Pölten,1931,8,8,10,18,40,70,-30,34
Mattersburg,1931,9,7,12,17,36,57,-21,33
Admira Wacke,1931,10,9,6,21,30,60,-30,33
FC Salzburg,1932,1,25,5,6,77,28,49,80
SC Rheindorf,1932,2,20,6,10,55,48,7,66
SK Sturm Gra,1932,3,19,8,9,61,33,28,65
Vienna,1932,4,15,7,14,55,49,6,52
RZ Pellets W,1932,5,15,4,17,47,49,-2,49
Rapid Vienna,1932,6,13,9,14,56,49,7,48
SV Josko Rie,1932,7,12,5,19,39,58,-19,41
Admira Wacke,1932,8,12,5,19,35,63,-28,41
St. Pölten,1932,9,8,10,18,36,59,-23,34
Mattersburg,1932,10,7,9,20,36,61,-25,30
FC Salzburg,1933,1,23,5,8,66,27,39,74
SC Rheindorf,1933,2,20,6,10,60,46,14,66
Rapid Vienna,1933,3,19,8,9,65,33,32,65
Vienna,1933,4,20,2,14,63,55,8,62
SK Sturm Gra,1933,5,18,7,11,63,44,19,61
SV Josko Rie,1933,6,13,5,18,40,53,-13,44
RZ Pellets W,1933,7,10,6,20,39,59,-20,36
St. Pölten,1933,8,9,8,19,38,63,-25,35
Admira Wacke,1933,9,10,5,21,37,65,-28,35
Mattersburg,1933,10,8,8,20,33,59,-26,32
SK Sturm Gra,1934,1,22,8,6,64,24,40,74
FC Salzburg,1934,2,21,8,7,68,31,37,71
SC Rheindorf,1934,3,18,9,9,48,37,11,63
Vienna,1934,4,14,9,13,53,54,-1,51
RZ Pellets W,1934,5,12,10,14,45,51,-6,46
Rapid Vienna,1934,6,11,12,13,49,42,7,45
SV Josko Rie,1934,7,12,4,20,34,53,-19,40
Mattersburg,1934,8,10,9,17,38,51,-13,39
St. Pölten,1934,9,9,9,18,40,62,-22,36
Admira Wacke,1934,10,8,8,20,28,62,-34,32
FC Salzburg,1935,1,21,8,7,70,36,34,71
SC Rheindorf,1935,2,19,8,9,60,39,21,65
SK Sturm Gra,1935,3,19,5,12,56,35,21,62
Rapid Vienna,1935,4,15,11,10,60,39,21,56
RZ Pellets W,1935,5,15,7,14,55,52,3,52
Vienna,1935,6,16,4,16,60,61,-1,52
Admira Wacke,1935,7,14,7,15,36,51,-15,49
SV Josko Rie,1935,8,10,5,21,37,61,-24,35
St. Pölten,1935,9,9,6,21,34,61,-27,33
Mattersburg,1935,10,8,7,21,43,76,-33,31
FC Salzburg,1936,1,21,9,6,71,32,39,72
Vienna,1936,2,22,4,10,75,53,22,70
SC Rheindorf,1936,3,18,8,10,51,40,11,62
Rapid Vienna,1936,4,16,9,11,62,41,21,57
SK Sturm Gra,1936,5,16,8,12,58,36,22,56
RZ Pellets W,1936,6,14,7,15,47,54,-7,49
Admira Wacke,1936,7,12,4,20,37,67,-30,40
SV Josko Rie,1936,8,10,4,22,35,59,-24,34
Mattersburg,1936,9,9,7,20,35,62,-27,34
St. Pölten,1936,10,6,12,18,40,67,-27,30
FC Salzburg,1937,1,23,8,5,79,31,48,77
Vienna,1937,2,20,6,10,72,47,25,66
SC Rheindorf,1937,3,18,9,9,55,44,11,63
SK Sturm Gra,1937,4,18,6,12,54,41,13,60
Rapid Vienna,1937,5,14,12,10,57,41,16,54
RZ Pellets W,1937,6,12,8,16,54,59,-5,44
SV Josko Rie,1937,7,10,8,18,38,52,-14,38
St. Pölten,1937,8,7,13,16,42,65,-23,34
Admira Wacke,1937,9,10,4,22,30,68,-38,34
Mattersburg,1937,10,7,8,21,35,68,-33,29
FC Salzburg,1938,1,22,6,8,74,32,42,72
SC Rheindorf,1938,2,21,6,9,56,41,15,69
SK Sturm Gra,1938,3,18,9,9,57,36,21,63
Vienna,1938,4,19,5,12,59,50,9,62
Rapid Vienna,1938,5,14,9,13,58,44,14,51
Admira Wacke,1938,6,12,8,16,34,54,-20,44
RZ Pellets W,1938,7,12,6,18,43,58,-15,42
SV Josko Rie,1938,8,12,5,19,45,59,-14,41
St. Pölten,1938,9,8,7,21,42,71,-29,31
Mattersburg,1938,10,7,9,20,36,59,-23,30
FC Salzburg,1939,1,18,11,7,64,29,35,65
SK Sturm Gra,1939,2,20,5,11,60,35,25,65
SC Rheindorf,1939,3,20,5,11,65,46,19,65
Vienna,1939,4,19,6,11,71,50,21,63
Rapid Vienna,1939,5,14,10,12,56,44,12,52
RZ Pellets W,1939,6,12,9,15,47,56,-9,45
Admira Wacke,1939,7,11,8,17,39,67,-28,41
Mattersburg,1939,8,11,6,19,38,61,-23,39
SV Josko Rie,1939,9,11,5,20,36,62,-26,38
St. Pölten,1939,10,8,7,21,47,73,-26,31
FC Salzburg,1940,1,22,7,7,76,31,45,73
SK Sturm Gra,1940,2,21,6,9,53,25,28,69
SC Rheindorf,1940,3,20,6,10,51,39,12,66
Vienna,1940,4,18,6,12,58,49,9,60
Rapid Vienna,1940,5,13,10,13,53,39,14,49
RZ Pellets W,1940,6,14,6,16,41,53,-12,48
Admira Wacke,1940,7,10,8,18,39,63,-24,38
St. Pölten,1940,8,9,8,19,43,61,-18,35
Mattersburg,1940,9,9,8,19,35,61,-26,35
SV Josko Rie,1940,10,9,5,22,32,60,-28,32
SC Rheindorf,1941,1,20,9,7,57,38,19,69
FC Salzburg,1941,2,18,11,7,69,38,31,65
SK Sturm Gra,1941,3,17,8,11,56,39,17,59
Vienna,1941,4,16,9,11,55,50,5,57
Rapid Vienna,1941,5,15,10,11,56,40,16,55
RZ Pellets W,1941,6,13,7,16,51,57,-6,46
Admira Wacke,1941,7,12,8,16,36,52,-16,44
St. Pölten,1941,8,10,9,17,41,63,-22,39
Mattersburg,1941,9,10,6,20,37,54,-17,36
SV Josko Rie,1941,10,7,7,22,31,58,-27,28
FC Salzburg,1942,1,21,9,6,65,25,40,72
SK Sturm Gra,1942,2,21,5,10,63,32,31,68
SC Rheindorf,1942,3,20,7,9,62,47,15,67
Vienna,1942,4,16,6,14,58,49,9,54
Rapid Vienna,1942,5,12,12,12,53,45,8,48
St. Pölten,1942,6,11,11,14,41,54,-13,44
SV Josko Rie,1942,7,12,7,17,36,52,-16,43
RZ Pellets W,1942,8,9,13,14,41,57,-16,40
Admira Wacke,1942,9,8,10,18,30,61,-31,34
Mattersburg,1942,10,6,8,22,33,60,-27,26
SC Rheindorf,1943,1,21,8,7,55,40,15,71
FC Salzburg,1943,2,21,6,9,67,37,30,69
Vienna,1943,3,19,5,12,64,52,12,62
SK Sturm Gra,1943,4,17,7,12,58,40,18,58
Rapid Vienna,1943,5,14,11,11,56,34,22,53
RZ Pellets W,1943,6,13,7,16,50,59,-9,46
SV Josko Rie,1943,7,10,8,18,33,51,-18,38
Mattersburg,1943,8,9,9,18,41,60,-19,36
St. Pölten,1943,9,8,10,18,43,67,-24,34
Admira Wacke,1943,10,9,7,20,32,59,-27,34
Vienna,1944,1,23,5,8,72,47,25,74
Rapid Vienna,1944,2,19,9,8,57,36,21,66
SK Sturm Gra,1944,3,19,3,14,58,34,24,60
SC Rheindorf,1944,4,18,6,12,53,44,9,60
FC Salzburg,1944,5,15,7,14,56,40,16,52
RZ Pellets W,1944,6,13,7,16,48,57,-9,46
St. Pölten,1944,7,12,7,17,46,62,-16,43
Admira Wacke,1944,8,12,5,19,38,65,-27,41
SV Josko Rie,1944,9,10,6,20,38,54,-16,36
Mattersburg,1944,10,8,7,21,34,61,-27,31
FC Salzburg,1945,1,20,7,9,63,38,25,67
SK Sturm Gra,1945,2,19,7,10,56,31,25,64
Vienna,1945,3,20,4,12,57,46,11,64
SC Rheindorf,1945,4,18,7,11,49,39,10,61
Rapid Vienna,1945,5,12,15,9,59,40,19,51
Admira Wacke,1945,6,12,7,17,40,54,-14,43
RZ Pellets W,1945,7,10,9,17,40,53,-13,39
St. Pölten,1945,8,8,13,15,45,65,-20,37
Mattersburg,1945,9,9,9,18,38,58,-20,36
SV Josko Rie,1945,10,10,6,20,33,56,-23,36
FC Salzburg,1946,1,22,7,7,66,27,39,73
SC Rheindorf,1946,2,20,7,9,53,40,13,67
SK Sturm Gra,1946,3,20,6,10,65,42,23,66
Vienna,1946,4,17,8,11,60,50,10,59
Rapid Vienna,1946,5,13,10,13,50,42,8,49
St. Pölten,1946,6,12,7,17,45,59,-14,43
Admira Wacke,1946,7,12,7,17,42,62,-20,43
SV Josko Rie,1946,8,11,5,20,34,51,-17,38
RZ Pellets W,1946,9,9,9,18,42,61,-19,36
Mattersburg,1946,10,7,8,21,35,58,-23,29
FC Salzburg,1947,1,20,6,10,64,33,31,66
SC Rheindorf,1947,2,20,5,11,59,52,7,65
Rapid Vienna,1947,3,16,11,9,53,30,23,59
SK Sturm Gra,1947,4,18,5,13,56,40,16,59
Vienna,1947,5,16,8,12,63,54,9,56
RZ Pellets W,1947,6,14,7,15,46,53,-7,49
Admira Wacke,1947,7,14,6,16,38,57,-19,48
Mattersburg,1947,8,9,9,18,39,56,-17,36
St. Pölten,1947,9,8,9,19,40,61,-21,33
SV Josko Rie,1947,10,9,6,21,34,56,-22,33
FC Salzburg,1948,1,22,9,5,66,29,37,75
SK Sturm Gra,1948,2,20,8,8,70,33,37,68
SC Rheindorf,1948,3,20,7,9,52,42,10,67
Vienna,1948,4,19,6,11,63,48,15,63
Rapid Vienna,1948,5,12,10,14,53,50,3,46
RZ Pellets W,1948,6,12,8,16,45,55,-10,44
St. Pölten,1948,7,10,9,17,43,60,-17,39
Mattersburg,1948,8,9,7,20,40,60,-20,34
SV Josko Rie,1948,9,10,4,22,35,59,-24,34
Admira Wacke,1948,10,10,4,22,27,58,-31,34
SC Rheindorf,1949,1,24,7,5,68,33,35,79
SK Sturm Gra,1949,2,20,7,9,60,31,29,67
FC Salzburg,1949,3,18,8,10,61,37,24,62
Vienna,1949,4,16,7,13,62,54,8,55
Rapid Vienna,1949,5,15,9,12,62,41,21,54
Admira Wacke,1949,6,12,7,17,36,60,-24,43
SV Josko Rie,1949,7,12,5,19,39,56,-17,41
St. Pölten,1949,8,10,9,17,46,65,-19,39
Mattersburg,1949,9,8,8,20,35,63,-28,32
RZ Pellets W,1949,10,7,9,20,37,66,-29,30
FC Salzburg,1950,1,21,9,6,62,25,37,72
SK Sturm Gra,1950,2,20,7,9,60,36,24,67
SC Rheindorf,1950,3,19,8,9,57,41,16,65
Vienna,1950,4,19,6,11,58,42,16,63
Rapid Vienna,1950,5,11,15,10,46,34,12,48
Admira Wacke,1950,6,10,12,14,33,51,-18,42
RZ Pellets W,1950,7,10,10,16,39,58,-19,40
Mattersburg,1950,8,9,9,18,38,49,-11,36
St. Pölten,1950,9,8,8,20,37,68,-31,32
SV Josko Rie,1950,10,8,6,22,26,52,-26,30
FC Salzburg,1951,1,21,6,9,67,36,31,69
SK Sturm Gra,1951,2,20,7,9,62,34,28,67
SC Rheindorf,1951,3,18,8,10,52,44,8,62
Vienna,1951,4,16,5,15,58,57,1,53
Rapid Vienna,1951,5,14,10,12,57,43,14,52
Admira Wacke,1951,6,12,10,14,36,49,-13,46
RZ Pellets W,1951,7,11,10,15,42,53,-11,43
SV Josko Rie,1951,8,12,7,17,38,50,-12,43
St. Pölten,1951,9,8,9,19,43,71,-28,33
Mattersburg,1951,10,6,12,18,34,52,-18,30
FC Salzburg,1952,1,19,7,10,59,31,28,64
SC Rheindorf,1952,2,19,7,10,58,40,18,64
Vienna,1952,3,19,6,11,71,49,22,63
SK Sturm Gra,1952,4,18,4,14,56,37,19,58
Rapid Vienna,1952,5,15,9,12,51,39,12,54
SV Josko Rie,1952,6,13,5,18,39,52,-13,44
Mattersburg,1952,7,10,11,15,36,51,-15,41
Admira Wacke,1952,8,11,8,17,33,60,-27,41
RZ Pellets W,1952,9,11,6,19,38,60,-22,39
St. Pölten,1952,10,9,9,18,39,61,-22,36
SK Sturm Gra,1953,1,19,8,9,58,32,26,65
FC Salzburg,1953,2,19,6,11,68,38,30,63
Vienna,1953,3,18,8,10,58,45,13,62
SC Rheindorf,1953,4,17,8,11,55,42,13,59
Admira Wacke,1953,5,13,9,14,40,50,-10,48
RZ Pellets W,1953,6,13,8,15,40,53,-13,47
Rapid Vienna,1953,7,10,15,11,43,36,7,45
SV Josko Rie,1953,8,10,8,18,31,48,-17,38
Mattersburg,1953,9,9,10,17,41,54,-13,37
St. Pölten,1953,10,8,8,20,34,70,-36,32
FC Salzburg,1954,1,22,6,8,72,32,40,72
SC Rheindorf,1954,2,21,7,8,53,39,14,70
SK Sturm Gra,1954,3,18,6,12,64,41,23,60
Vienna,1954,4,18,6,12,60,46,14,60
Rapid Vienna,1954,5,13,10,13,55,46,9,49
Admira Wacke,1954,6,14,5,17,38,60,-22,47
SV Josko Rie,1954,7,10,8,18,39,55,-16,38
Mattersburg,1954,8,9,10,17,47,69,-22,37
St. Pölten,1954,9,8,11,17,45,63,-18,35
RZ Pellets W,1954,10,10,5,21,44,66,-22,35
SK Sturm Gra,1955,1,21,8,7,68,35,33,71
FC Salzburg,1955,2,21,6,9,64,35,29,69
SC Rheindorf,1955,3,20,6,10,61,43,18,66
Vienna,1955,4,19,4,13,60,51,9,61
RZ Pellets W,1955,5,14,6,16,45,53,-8,48
Rapid Vienna,1955,6,12,10,14,53,51,2,46
Admira Wacke,1955,7,12,6,18,36,54,-18,42
St. Pölten,1955,8,9,10,17,41,61,-20,37
Mattersburg,1955,9,8,10,18,36,53,-17,34
SV Josko Rie,1955,10,8,6,22,29,57,-28,30
FC Salzburg,1956,1,20,9,7,68,28,40,69
Vienna,1956,2,21,5,10,67,50,17,68
SC Rheindorf,1956,3,19,9,8,57,47,10,66
SK Sturm Gra,1956,4,19,6,11,55,31,24,63
Rapid Vienna,1956,5,16,10,10,58,36,22,58
RZ Pellets W,1956,6,11,11,14,47,56,-9,44
Admira Wacke,1956,7,9,9,18,32,64,-32,36
SV Josko Rie,1956,8,9,6,21,31,53,-22,33
Mattersburg,1956,9,7,10,19,35,58,-23,31
St. Pölten,1956,10,7,9,20,39,66,-27,30
FC Salzburg,1957,1,22,8,6,71,35,36,74
SC Rheindorf,1957,2,22,7,7,66,36,30,73
SK Sturm Gra,1957,3,21,6,9,64,37,27,69
Vienna,1957,4,18,5,13,70,58,12,59
Rapid Vienna,1957,5,13,12,11,61,43,18,51
RZ Pellets W,1957,6,14,7,15,57,60,-3,49
SV Josko Rie,1957,7,9,7,20,33,55,-22,34
Admira Wacke,1957,8,10,4,22,36,75,-39,34
Mattersburg,1957,9,6,12,18,32,52,-20,30
St. Pölten,1957,10,8,6,22,34,73,-39,30
FC Salzburg,1958,1,22,8,6,72,32,40,74
SK Sturm Gra,1958,2,18,9,9,60,34,26,63
Rapid Vienna,1958,3,16,10,10,61,39,22,58
SC Rheindorf,1958,4,17,7,12,52,44,8,58
Vienna,1958,5,18,4,14,58,54,4,58
RZ Pellets W,1958,6,15,6,15,44,51,-7,51
Admira Wacke,1958,7,13,5,18,38,58,-20,44
SV Josko Rie,1958,8,12,3,21,35,55,-20,39
St. Pölten,1958,9,6,14,16,32,56,-24,32
Mattersburg,1958,10,6,8,22,25,54,-29,26
FC Salzburg,1959,1,19,9,8,66,34,32,66
SC Rheindorf,1959,2,20,6,10,61,39,22,66
Vienna,1959,3,20,4,12,64,49,15,64
Rapid Vienna,1959,4,18,9,9,57,37,20,63
SK Sturm Gra,1959,5,18,7,11,61,36,25,61
RZ Pellets W,1959,6,13,7,16,49,58,-9,46
Admira Wacke,1959,7,10,7,19,37,69,-32,37
Mattersburg,1959,8,8,11,17,33,51,-18,35
SV Josko Rie,1959,9,10,4,22,36,56,-20,34
St. Pölten,1959,10,8,8,20,40,75,-35,32
FC Salzburg,1960,1,20,9,7,57,30,27,69
SC Rheindorf,1960,2,21,6,9,47,35,12,69
SK Sturm Gra,1960,3,15,12,9,61,38,23,57
Vienna,1960,4,17,6,13,63,57,6,57
Rapid Vienna,1960,5,10,15,11,59,46,13,45
RZ Pellets W,1960,6,11,11,14,47,51,-4,44
Admira Wacke,1960,7,11,7,18,36,58,-22,40
SV Josko Rie,1960,8,10,8,18,41,61,-20,38
Mattersburg,1960,9,9,10,17,38,52,-14,37
St. Pölten,1960,10,8,12,16,41,62,-21,36
FC Salzburg,1961,1,22,6,8,66,30,36,72
Vienna,1961,2,22,5,9,72,47,25,71
SC Rheindorf,1961,3,22,5,9,58,42,16,71
SK Sturm Gra,1961,4,19,5,12,59,39,20,62
Rapid Vienna,1961,5,14,10,12,49,36,13,52
RZ Pellets W,1961,6,13,5,18,43,56,-13,44
SV Josko Rie,1961,7,12,4,20,34,52,-18,40
Admira Wacke,1961,8,9,8,19,37,66,-29,35
St. Pölten,1961,9,8,8,20,37,62,-25,32
Mattersburg,1961,10,8,6,22,33,58,-25,30
SC Rheindorf,1962,1,23,6,7,64,37,27,75
FC Salzburg,1962,2,20,10,6,64,31,33,70
Vienna,1962,3,20,5,11,67,46,21,65
SK Sturm Gra,1962,4,16,7,13,60,46,14,55
Rapid Vienna,1962,5,15,9,12,54,42,12,54
SV Josko Rie,1962,6,12,6,18,36,54,-18,42
RZ Pellets W,1962,7,10,8,18,41,54,-13,38
Admira Wacke,1962,8,9,8,19,37,68,-31,35
Mattersburg,1962,9,8,10,18,36,59,-23,34
St. Pölten,1962,10,7,11,18,36,58,-22,32
FC Salzburg,1963,1,21,9,6,65,26,39,72
SC Rheindorf,1963,2,19,9,8,60,47,13,66
Vienna,1963,3,19,6,11,65,49,16,63
SK Sturm Gra,1963,4,17,9,10,55,34,21,60
Rapid Vienna,1963,5,14,10,12,55,43,12,52
RZ Pellets W,1963,6,12,11,13,54,54,0,47
SV Josko Rie,1963,7,11,7,18,36,50,-14,40
Admira Wacke,1963,8,9,9,18,31,62,-31,36
St. Pölten,1963,9,8,10,18,46,71,-25,34
Mattersburg,1963,10,4,12,20,35,66,-31,24
FC Salzburg,1964,1,22,8,6,69,29,40,74
SK Sturm Gra,1964,2,20,6,10,61,34,27,66
SC Rheindorf,1964,3,16,10,10,54,47,7,58
Vienna,1964,4,18,4,14,58,54,4,58
RZ Pellets W,1964,5,14,9,13,51,56,-5,51
Rapid Vienna,1964,6,11,14,11,54,45,9,47
Admira Wacke,1964,7,11,7,18,33,56,-23,40
SV Josko Rie,1964,8,11,6,19,32,49,-17,39
St. Pölten,1964,9,8,10,18,41,60,-19,34
Mattersburg,1964,10,6,12,18,34,57,-23,30
FC Salzburg,1965,1,19,10,7,59,28,31,67
SK Sturm Gra,1965,2,20,7,9,63,34,29,67
SC Rheindorf,1965,3,19,10,7,54,42,12,67
Vienna,1965,4,18,6,12,65,61,4,60
Rapid Vienna,1965,5,11,14,11,53,44,9,47
RZ Pellets W,1965,6,12,9,15,49,56,-7,45
SV Josko Rie,1965,7,11,6,19,40,52,-12,39
Mattersburg,1965,8,9,9,18,40,52,-12,36
Admira Wacke,1965,9,9,8,19,38,67,-29,35
St. Pölten,1965,10,8,9,19,37,62,-25,33
SK Sturm Gra,1966,1,23,5,8,65,31,34,74
FC Salzburg,1966,2,21,7,8,67,31,36,70
SC Rheindorf,1966,3,20,6,10,58,41,17,66
Vienna,1966,4,19,5,12,58,48,10,62
Rapid Vienna,1966,5,13,12,11,56,38,18,51
RZ Pellets W,1966,6,14,7,15,42,51,-9,49
Admira Wacke,1966,7,11,6,19,36,68,-32,39
SV Josko Rie,1966,8,10,7,19,32,51,-19,37
St. Pölten,1966,9,7,10,19,49,69,-20,31
Mattersburg,1966,10,5,9,22,33,68,-35,24
FC Salzburg,1967,1,21,8,7,57,24,33,71
SK Sturm Gra,1967,2,22,5,9,61,31,30,71
SC Rheindorf,1967,3,19,9,8,56,39,17,66
Rapid Vienna,1967,4,14,11,11,62,42,20,53
Vienna,1967,5,15,4,17,50,52,-2,49
RZ Pellets W,1967,6,12,8,16,44,51,-7,44
SV Josko Rie,1967,7,12,8,16,38,49,-11,44
Admira Wacke,1967,8,10,6,20,33,67,-34,36
Mattersburg,1967,9,8,10,18,35,53,-18,34
St. Pölten,1967,10,7,11,18,36,64,-28,32
Vienna,1968,1,21,4,11,63,48,15,67
SK Sturm Gra,1968,2,18,9,9,61,37,24,63
FC Salzburg,1968,3,17,9,10,62,32,30,60
SC Rheindorf,1968,4,18,6,12,57,49,8,60
Rapid Vienna,1968,5,12,14,10,50,38,12,50
Admira Wacke,1968,6,13,7,16,41,53,-12,46
RZ Pellets W,1968,7,11,11,14,39,51,-12,44
SV Josko Rie,1968,8,12,5,19,36,55,-19,41
St. Pölten,1968,9,9,11,16,43,61,-18,38
Mattersburg,1968,10,7,8,21,38,66,-28,29
FC Salzburg,1969,1,24,7,5,79,27,52,79
SC Rheindorf,1969,2,19,6,11,57,47,10,63
SK Sturm Gra,1969,3,17,9,10,60,42,18,60
Vienna,1969,4,17,7,12,63,56,7,58
Rapid Vienna,1969,5,14,11,11,59,46,13,53
Admira Wacke,1969,6,10,9,17,43,63,-20,39
Mattersburg,1969,7,10,9,17,44,65,-21,39
St. Pölten,1969,8,9,10,17,44,63,-19,37
RZ Pellets W,1969,9,9,9,18,48,62,-14,36
SV Josko Rie,1969,10,10,5,21,34,60,-26,35
SC Rheindorf,1970,1,22,5,9,58,37,21,71
Vienna,1970,2,21,5,10,68,46,22,68
FC Salzburg,1970,3,18,10,8,58,30,28,64
SK Sturm Gra,1970,4,17,9,10,52,32,20,60
Rapid Vienna,1970,5,17,9,10,62,43,19,60
RZ Pellets W,1970,6,11,6,19,40,61,-21,39
St. Pölten,1970,7,9,9,18,40,62,-22,36
Admira Wacke,1970,8,10,6,20,31,59,-28,36
Mattersburg,1970,9,10,5,21,45,62,-17,35
SV Josko Rie,1970,10,9,8,19,33,55,-22,35
SC Rheindorf,1971,1,23,4,9,60,43,17,73
FC Salzburg,1971,2,22,6,8,74,29,45,72
Rapid Vienna,1971,3,17,10,9,60,37,23,61
SK Sturm Gra,1971,4,19,4,13,57,36,21,61
Vienna,1971,5,17,6,13,64,56,8,57
Admira Wacke,1971,6,13,8,15,39,55,-16,47
SV Josko Rie,1971,7,12,6,18,37,54,-17,42
St. Pölten,1971,8,11,7,18,42,65,-23,40
RZ Pellets W,1971,9,10,4,22,45,68,-23,34
Mattersburg,1971,10,5,7,24,33,68,-35,22
SC Rheindorf,1972,1,23,7,6,58,34,24,76
SK Sturm Gra,1972,2,20,5,11,61,34,27,65
FC Salzburg,1972,3,19,7,10,55,29,26,64
Vienna,1972,4,18,3,15,62,57,5,57
Rapid Vienna,1972,5,15,8,13,54,41,13,53
Admira Wacke,1972,6,12,9,15,41,55,-14,45
RZ Pellets W,1972,7,11,7,18,39,58,-19,40
St. Pölten,1972,8,10,7,19,36,56,-20,37
SV Josko Rie,1972,9,11,4,21,33,58,-25,37
Mattersburg,1972,10,8,9,19,43,60,-17,33
SC Rheindorf,1973,1,20,9,7,59,42,17,69
FC Salzburg,1973,2,21,5,10,75,36,39,68
Vienna,1973,3,19,6,11,56,45,11,63
SK Sturm Gra,1973,4,18,4,14,57,41,16,58
Rapid Vienna,1973,5,14,11,11,54,37,17,53
SV Josko Rie,1973,6,12,8,16,33,48,-15,44
St. Pölten,1973,7,10,10,16,43,56,-13,40
RZ Pellets W,1973,8,11,6,19,45,63,-18,39
Mattersburg,1973,9,9,9,18,37,56,-19,36
Admira Wacke,1973,10,9,6,21,30,65,-35,33
FC Salzburg,1974,1,20,10,6,64,32,32,70
SC Rheindorf,1974,2,19,9,8,53,37,16,66
SK Sturm Gra,1974,3,20,4,12,57,39,18,64
Vienna,1974,4,19,7,10,65,50,15,64
Rapid Vienna,1974,5,14,10,12,59,44,15,52
Admira Wacke,1974,6,13,5,18,42,59,-17,44
Mattersburg,1974,7,9,11,16,43,56,-13,38
RZ Pellets W,1974,8,9,10,17,44,56,-12,37
St. Pölten,1974,9,9,9,18,39,65,-26,36
SV Josko Rie,1974,10,8,5,23,33,61,-28,29
FC Salzburg,1975,1,22,6,8,70,37,33,72
SC Rheindorf,1975,2,21,8,7,61,38,23,71
Vienna,1975,3,20,7,9,60,49,11,67
SK Sturm Gra,1975,4,17,6,13,60,47,13,57
Rapid Vienna,1975,5,14,12,10,56,40,16,54
RZ Pellets W,1975,6,12,5,19,46,61,-15,41
Admira Wacke,1975,7,12,5,19,37,60,-23,41
St. Pölten,1975,8,8,11,17,41,59,-18,35
SV Josko Rie,1975,9,8,8,20,39,58,-19,32
Mattersburg,1975,10,8,8,20,34,55,-21,32
FC Salzburg,1976,1,23,4,9,65,28,37,73
SK Sturm Gra,1976,2,19,7,10,54,29,25,64
SC Rheindorf,1976,3,18,7,11,53,44,9,61
Vienna,1976,4,18,6,12,55,49,6,60
Admira Wacke,1976,5,14,6,16,39,53,-14,48
RZ Pellets W,1976,6,13,8,15,42,51,-9,47
Rapid Vienna,1976,7,11,10,15,47,41,6,43
Mattersburg,1976,8,11,6,19,38,54,-16,39
SV Josko Rie,1976,9,12,3,21,38,60,-22,39
St. Pölten,1976,10,8,9,19,39,61,-22,33
FC Salzburg,1977,1,22,6,8,67,29,38,72
SK Sturm Gra,1977,2,19,9,8,60,32,28,66
Vienna,1977,3,19,4,13,62,53,9,61
Rapid Vienna,1977,4,16,10,10,57,36,21,58
SC Rheindorf,1977,5,17,6,13,48,47,1,57
SV Josko Rie,1977,6,15,4,17,38,48,-10,49
Mattersburg,1977,7,11,8,17,41,56,-15,41
RZ Pellets W,1977,8,11,6,19,38,55,-17,39
Admira Wacke,1977,9,10,6,20,37,60,-23,36
St. Pölten,1977,10,7,7,22,39,71,-32,28
SK Sturm Gra,1978,1,22,7,7,61,27,34,73
FC Salzburg,1978,2,21,6,9,67,33,34,69
SC Rheindorf,1978,3,19,6,11,57,44,13,63
Vienna,1978,4,19,4,13,62,48,14,61
Admira Wacke,1978,5,14,7,15,49,57,-8,49
Rapid Vienna,1978,6,11,14,11,55,47,8,47
RZ Pellets W,1978,7,11,10,15,45,55,-10,43
SV Josko Rie,1978,8,10,6,20,41,70,-29,36
St. Pölten,1978,9,6,12,18,41,67,-26,30
Mattersburg,1978,10,6,10,20,36,66,-30,28
SC Rheindorf,1979,1,21,7,8,58,42,16,70
FC Salzburg,1979,2,20,8,8,65,35,30,68
Vienna,1979,3,21,3,12,63,45,18,66
SK Sturm Gra,1979,4,17,5,14,49,36,13,56
Admira Wacke,1979,5,15,6,15,37,52,-15,51
Rapid Vienna,1979,6,13,10,13,52,43,9,49
RZ Pellets W,1979,7,12,8,16,46,51,-5,44
SV Josko Rie,1979,8,9,9,18,30,49,-19,36
Mattersburg,1979,9,7,9,20,33,55,-22,30
St. Pölten,1979,10,5,15,16,34,59,-25,30
FC Salzburg,1980,1,22,6,8,63,29,34,72
SK Sturm Gra,1980,2,18,10,8,60,35,25,64
SC Rheindorf,1980,3,18,8,10,56,43,13,62
Vienna,1980,4,17,4,15,63,61,2,55
Rapid Vienna,1980,5,12,10,14,50,40,10,46
Admira Wacke,1980,6,12,10,14,38,58,-20,46
RZ Pellets W,1980,7,11,10,15,44,55,-11,43
St. Pölten,1980,8,9,12,15,44,57,-13,39
Mattersburg,1980,9,9,10,17,32,50,-18,37
SV Josko Rie,1980,10,9,6,21,36,58,-22,33
FC Salzburg,1981,1,22,9,5,65,29,36,75
SC Rheindorf,1981,2,21,7,8,54,43,11,70
SK Sturm Gra,1981,3,21,4,11,60,35,25,67
Vienna,1981,4,18,5,13,64,56,8,59
Rapid Vienna,1981,5,10,13,13,51,41,10,43
SV Josko Rie,1981,6,12,7,17,39,49,-10,43
RZ Pellets W,1981,7,10,9,17,41,56,-15,39
Admira Wacke,1981,8,10,9,17,34,54,-20,39
Mattersburg,1981,9,9,10,17,35,49,-14,37
St. Pölten,1981,10,5,11,20,33,64,-31,26
FC Salzburg,1982,1,23,8,5,66,25,41,77
SK Sturm Gra,1982,2,19,7,10,53,29,24,64
SC Rheindorf,1982,3,18,9,9,55,40,15,63
Vienna,1982,4,18,6,12,62,54,8,60
Rapid Vienna,1982,5,16,8,12,63,44,19,56
RZ Pellets W,1982,6,13,8,15,51,59,-8,47
Admira Wacke,1982,7,10,8,18,32,56,-24,38
SV Josko Rie,1982,8,10,6,20,39,56,-17,36
St. Pölten,1982,9,8,9,19,37,68,-31,33
Mattersburg,1982,10,6,9,21,35,62,-27,27
FC Salzburg,1983,1,20,7,9,62,33,29,67
SC Rheindorf,1983,2,19,8,9,53,43,10,65
SK Sturm Gra,1983,3,18,8,10,55,32,23,62
Rapid Vienna,1983,4,15,12,9,58,37,21,57
Vienna,1983,5,16,6,14,56,52,4,54
RZ Pellets W,1983,6,15,6,15,51,56,-5,51
Admira Wacke,1983,7,12,4,20,37,61,-24,40
Mattersburg,1983,8,9,9,18,39,57,-18,36
St. Pölten,1983,9,8,12,16,42,61,-19,36
SV Josko Rie,1983,10,9,6,21,35,56,-21,33
FC Salzburg,1984,1,22,7,7,69,29,40,73
Vienna,1984,2,21,5,10,73,48,25,68
SC Rheindorf,1984,3,19,6,11,55,43,12,63
SK Sturm Gra,1984,4,18,6,12,59,42,17,60
Rapid Vienna,1984,5,12,11,13,58,48,10,47
RZ Pellets W,1984,6,13,6,17,49,63,-14,45
Admira Wacke,1984,7,13,6,17,38,57,-19,45
St. Pölten,1984,8,10,9,17,42,61,-19,39
SV Josko Rie,1984,9,10,7,19,33,56,-23,37
Mattersburg,1984,10,6,9,21,32,61,-29,27
FC Salzburg,1985,1,22,6,8,68,33,35,72
SK Sturm Gra,1985,2,19,6,11,71,40,31,63
Vienna,1985,3,19,5,12,68,52,16,62
SC Rheindorf,1985,4,18,8,10,47,45,2,62
Rapid Vienna,1985,5,14,9,13,58,39,19,51
Mattersburg,1985,6,11,9,16,42,53,-11,42
Admira Wacke,1985,7,13,3,20,38,63,-25,42
RZ Pellets W,1985,8,11,8,17,39,53,-14,41
SV Josko Rie,1985,9,10,6,20,32,54,-22,36
St. Pölten,1985,10,9,8,19,37,68,-31,35
FC Salzburg,1986,1,24,8,4,76,29,47,80
SK Sturm Gra,1986,2,19,7,10,60,40,20,64
Vienna,1986,3,20,4,12,62,48,14,64
SC Rheindorf,1986,4,18,7,11,61,48,13,61
Rapid Vienna,1986,5,12,12,12,51,41,10,48
St. Pölten,1986,6,12,8,16,45,62,-17,44
Admira Wacke,1986,7,11,5,20,40,61,-21,38
SV Josko Rie,1986,8,11,4,21,35,55,-20,37
RZ Pellets W,1986,9,10,6,20,38,58,-20,36
Mattersburg,1986,10,9,7,20,38,64,-26,34
FC Salzburg,1987,1,19,12,5,65,31,34,69
SC Rheindorf,1987,2,19,9,8,57,43,14,66
SK Sturm Gra,1987,3,15,10,11,51,36,15,55
Rapid Vienna,1987,4,14,12,10,64,43,21,54
Vienna,1987,5,15,6,15,50,51,-1,51
RZ Pellets W,1987,6,14,8,14,54,59,-5,50
Admira Wacke,1987,7,13,7,16,45,53,-8,46
St. Pölten,1987,8,8,11,17,41,65,-24,35
SV Josko Rie,1987,9,9,8,19,35,63,-28,35
Mattersburg,1987,10,8,9,19,42,60,-18,33
FC Salzburg,1988,1,24,6,6,71,29,42,78
SC Rheindorf,1988,2,21,7,8,55,38,17,70
SK Sturm Gra,1988,3,16,11,9,50,31,19,59
Vienna,1988,4,18,4,14,64,58,6,58
Rapid Vienna,1988,5,13,12,11,51,36,15,51
RZ Pellets W,1988,6,13,8,15,43,52,-9,47
SV Josko Rie,1988,7,11,6,19,38,51,-13,39
Admira Wacke,1988,8,10,6,20,31,61,-30,36
St. Pölten,1988,9,8,10,18,40,63,-23,34
Mattersburg,1988,10,7,8,21,32,56,-24,29
FC Salzburg,1989,1,21,8,7,61,29,32,71
SC Rheindorf,1989,2,19,11,6,60,44,16,68
SK Sturm Gra,1989,3,20,6,10,68,36,32,66
Vienna,1989,4,17,6,13,60,55,5,57
Admira Wacke,1989,5,15,5,16,42,57,-15,50
Rapid Vienna,1989,6,12,12,12,52,40,12,48
RZ Pellets W,1989,7,11,8,17,42,57,-15,41
Mattersburg,1989,8,8,10,18,39,57,-18,34
St. Pölten,1989,9,8,10,18,47,72,-25,34
SV Josko Rie,1989,10,7,8,21,32,56,-24,29
FC Salzburg,1990,1,24,5,7,71,29,42,77
SC Rheindorf,1990,2,21,5,10,56,45,11,68
SK Sturm Gra,1990,3,21,4,11,64,39,25,67
Vienna,1990,4,17,6,13,63,51,12,57
Rapid Vienna,1990,5,13,11,12,56,43,13,50
Admira Wacke,1990,6,13,7,16,37,53,-16,46
RZ Pellets W,1990,7,9,11,16,42,59,-17,38
SV Josko Rie,1990,8,10,5,21,37,56,-19,35
St. Pölten,1990,9,8,9,19,48,72,-24,33
Mattersburg,1990,10,8,9,19,36,63,-27,33
SC Rheindorf,1991,1,20,9,7,56,34,22,69
FC Salzburg,1991,2,18,9,9,56,36,20,63
SK Sturm Gra,1991,3,17,8,11,56,38,18,59
Vienna,1991,4,18,4,14,65,57,8,58
Rapid Vienna,1991,5,15,10,11,64,42,22,55
Admira Wacke,1991,6,14,9,13,41,54,-13,51
RZ Pellets W,1991,7,11,9,16,45,57,-12,42
SV Josko Rie,1991,8,10,8,18,34,49,-15,38
Mattersburg,1991,9,10,7,19,39,52,-13,37
St. Pölten,1991,10,6,9,21,43,80,-37,27
SK Sturm Gra,1992,1,20,7,9,65,40,25,67
FC Salzburg,1992,2,19,9,8,66,34,32,66
SC Rheindorf,1992,3,19,7,10,51,39,12,64
Vienna,1992,4,19,6,11,66,48,18,63
Rapid Vienna,1992,5,13,10,13,54,45,9,49
RZ Pellets W,1992,6,13,8,15,51,57,-6,47
Admira Wacke,1992,7,13,5,18,40,57,-17,44
SV Josko Rie,1992,8,9,7,20,30,52,-22,34
St. Pölten,1992,9,8,10,18,45,68,-23,34
Mattersburg,1992,10,8,9,19,35,63,-28,33
FC Salzburg,1993,1,19,9,8,63,30,33,66
SK Sturm Gra,1993,2,20,6,10,58,33,25,66
SC Rheindorf,1993,3,19,4,13,54,46,8,61
Vienna,1993,4,19,3,14,70,53,17,60
Rapid Vienna,1993,5,14,10,12,49,34,15,52
RZ Pellets W,1993,6,13,8,15,42,49,-7,47
Admira Wacke,1993,7,13,7,16,38,57,-19,46
St. Pölten,1993,8,12,7,17,44,63,-19,43
SV Josko Rie,1993,9,10,6,20,34,65,-31,36
Mattersburg,1993,10,8,6,22,37,59,-22,30
FC Salzburg,1994,1,21,7,8,69,36,33,70
SK Sturm Gra,1994,2,20,7,9,62,32,30,67
SC Rheindorf,1994,3,19,8,9,58,46,12,65
Rapid Vienna,1994,4,15,8,13,61,44,17,53
Vienna,1994,5,16,4,16,58,60,-2,52
RZ Pellets W,1994,6,14,5,17,47,55,-8,47
Admira Wacke,1994,7,12,8,16,47,62,-15,44
SV Josko Rie,1994,8,12,4,20,44,59,-15,40
Mattersburg,1994,9,9,8,19,37,61,-24,35
St. Pölten,1994,10,8,9,19,45,73,-28,33
FC Salzburg,1995,1,22,5,9,63,27,36,71
SK Sturm Gra,1995,2,18,8,10,52,33,19,62
SC Rheindorf,1995,3,18,6,12,54,43,11,60
Vienna,1995,4,18,3,15,60,55,5,57
RZ Pellets W,1995,5,14,8,14,49,49,0,50
SV Josko Rie,1995,6,15,3,18,39,51,-12,48
St. Pölten,1995,7,13,8,15,43,56,-13,47
Admira Wacke,1995,8,11,6,19,36,57,-21,39
Rapid Vienna,1995,9,9,10,17,45,48,-3,37
Mattersburg,1995,10,9,9,18,38,60,-22,36
FC Salzburg,1996,1,21,8,7,60,24,36,71
SK Sturm Gra,1996,2,19,6,11,60,35,25,63
SC Rheindorf,1996,3,17,10,9,51,41,10,61
Vienna,1996,4,17,7,12,63,53,10,58
Rapid Vienna,1996,5,13,10,13,56,40,16,49
RZ Pellets W,1996,6,14,7,15,42,47,-5,49
Mattersburg,1996,7,10,10,16,39,52,-13,40
SV Josko Rie,1996,8,11,6,19,40,60,-20,39
Admira Wacke,1996,9,10,7,19,33,64,-31,37
St. Pölten,1996,10,8,9,19,42,70,-28,33
SC Rheindorf,1997,1,21,6,9,56,43,13,69
SK Sturm Gra,1997,2,19,7,10,53,35,18,64
Vienna,1997,3,19,5,12,69,56,13,62
FC Salzburg,1997,4,16,9,11,59,38,21,57
Rapid Vienna,1997,5,11,13,12,54,47,7,46
Mattersburg,1997,6,13,7,16,50,56,-6,46
SV Josko Rie,1997,7,13,5,18,43,52,-9,44
RZ Pellets W,1997,8,12,7,17,45,54,-9,43
Admira Wacke,1997,9,11,7,18,33,58,-25,40
St. Pölten,1997,10,6,12,18,45,68,-23,30
SC Rheindorf,1998,1,21,9,6,73,47,26,72
FC Salzburg,1998,2,19,10,7,65,30,35,67
SK Sturm Gra,1998,3,19,9,8,60,32,28,66
Vienna,1998,4,18,7,11,67,51,16,61
Rapid Vienna,1998,5,14,12,10,57,42,15,54
Admira Wacke,1998,6,12,8,16,42,60,-18,44
RZ Pellets W,1998,7,10,7,19,44,64,-20,37
SV Josko Rie,1998,8,9,8,19,32,55,-23,35
St. Pölten,1998,9,7,10,19,38,64,-26,31
Mattersburg,1998,10,8,6,22,31,64,-33,30
FC Salzburg,1999,1,22,6,8,73,28,45,72
SC Rheindorf,1999,2,17,10,9,49,47,2,61
Vienna,1999,3,17,7,12,59,53,6,58
SK Sturm Gra,1999,4,17,6,13,52,38,14,57
Rapid Vienna,1999,5,15,9,12,67,42,25,54
RZ Pellets W,1999,6,14,8,14,46,52,-6,50
Mattersburg,1999,7,12,9,15,43,49,-6,45
SV Josko Rie,1999,8,9,7,20,40,65,-25,34
Admira Wacke,1999,9,8,10,18,39,73,-34,34
St. Pölten,1999,10,7,12,17,43,64,-21,33
FC Salzburg,2000,1,21,8,7,69,35,34,71
SC Rheindorf,2000,2,20,10,6,58,38,20,70
SK Sturm Gra,2000,3,18,9,9,56,29,27,63
Vienna,2000,4,19,6,11,68,57,11,63
Rapid Vienna,2000,5,16,7,13,57,39,18,55
RZ Pellets W,2000,6,11,6,19,44,62,-18,39
SV Josko Rie,2000,7,10,8,18,37,56,-19,38
Admira Wacke,2000,8,10,6,20,32,61,-29,36
St. Pölten,2000,9,7,12,17,37,59,-22,33
Mattersburg,2000,10,7,10,19,40,62,-22,31
FC Salzburg,2001,1,22,6,8,74,34,40,72
SC Rheindorf,2001,2,19,7,10,55,41,14,64
Vienna,2001,3,20,4,12,65,54,11,64
SK Sturm Gra,2001,4,18,6,12,52,32,20,60
Rapid Vienna,2001,5,16,8,12,54,41,13,56
RZ Pellets W,2001,6,13,7,16,42,46,-4,46
Admira Wacke,2001,7,12,5,19,37,58,-21,41
SV Josko Rie,2001,8,12,4,20,34,56,-22,40
Mattersburg,2001,9,9,6,21,36,62,-26,33
St. Pölten,2001,10,7,11,18,36,61,-25,32
FC Salzburg,2002,1,22,10,4,69,26,43,76
SK Sturm Gra,2002,2,20,7,9,61,37,24,67
Vienna,2002,3,19,5,12,72,53,19,62
SC Rheindorf,2002,4,17,9,10,51,46,5,60
Rapid Vienna,2002,5,15,11,10,53,34,19,56
Admira Wacke,2002,6,10,11,15,45,58,-13,41
RZ Pellets W,2002,7,11,7,18,44,63,-19,40
SV Josko Rie,2002,8,9,7,20,32,53,-21,34
St. Pölten,2002,9,8,8,20,40,63,-23,32
Mattersburg,2002,10,7,9,20,31,65,-34,30
FC Salzburg,2003,1,23,6,7,75,33,42,75
SC Rheindorf,2003,2,21,9,6,61,34,27,72
SK Sturm Gra,2003,3,16,8,12,58,37,21,56
Vienna,2003,4,16,6,14,59,56,3,54
Rapid Vienna,2003,5,13,13,10,54,36,18,52
RZ Pellets W,2003,6,13,7,16,42,50,-8,46
Admira Wacke,2003,7,12,6,18,36,63,-27,42
Mattersburg,2003,8,10,8,18,37,54,-17,38
St. Pölten,2003,9,9,9,18,37,68,-31,36
SV Josko Rie,2003,10,7,8,21,27,55,-28,29
SC Rheindorf,2004,1,25,7,4,68,34,34,82
SK Sturm Gra,2004,2,22,4,10,61,33,28,70
FC Salzburg,2004,3,19,10,7,62,30,32,67
Rapid Vienna,2004,4,14,11,11,56,44,12,53
Vienna,2004,5,14,8,14,59,56,3,50
RZ Pellets W,2004,6,10,9,17,44,57,-13,39
SV Josko Rie,2004,7,11,6,19,40,54,-14,39
Admira Wacke,2004,8,9,8,19,36,69,-33,35
Mattersburg,2004,9,8,9,19,37,61,-24,33
St. Pölten,2004,10,7,10,19,37,62,-25,31
SK Sturm Gra,2005,1,20,6,10,66,35,31,66
FC Salzburg,2005,2,20,6,10,61,37,24,66
SC Rheindorf,2005,3,19,5,12,59,47,12,62
Vienna,2005,4,19,3,14,62,52,10,60
Rapid Vienna,2005,5,14,11,11,55,43,12,53
Admira Wacke,2005,6,12,8,16,39,58,-19,44
SV Josko Rie,2005,7,12,7,17,38,56,-18,43
RZ Pellets W,2005,8,12,6,18,45,55,-10,42
St. Pölten,2005,9,9,8,19,44,60,-16,35
Mattersburg,2005,10,8,10,18,33,59,-26,34
SK Sturm Gra,2006,1,22,7,7,63,30,33,73
FC Salzburg,2006,2,21,6,9,71,38,33,69
SC Rheindorf,2006,3,19,10,7,55,35,20,67
Vienna,2006,4,17,6,13,60,53,7,57
Rapid Vienna,2006,5,13,13,10,60,48,12,52
Admira Wacke,2006,6,13,7,16,40,50,-10,46
RZ Pellets W,2006,7,11,6,19,39,55,-16,39
SV Josko Rie,2006,8,9,8,19,34,56,-22,35
Mattersburg,2006,9,7,9,20,37,63,-26,30
St. Pölten,2006,10,6,12,18,34,65,-31,30
FC Salzburg,2007,1,21,7,8,72,40,32,70
SK Sturm Gra,2007,2,20,7,9,64,35,29,67
Vienna,2007,3,20,6,10,67,49,18,66
SC Rheindorf,2007,4,19,6,11,53,39,14,63
Rapid Vienna,2007,5,14,8,14,52,42,10,50
RZ Pellets W,2007,6,13,9,14,50,56,-6,48
Admira Wacke,2007,7,12,7,17,41,61,-20,43
Mattersburg,2007,8,9,7,20,33,52,-19,34
SV Josko Rie,2007,9,9,6,21,31,54,-23,33
St. Pölten,2007,10,8,7,21,35,70,-35,31
FC Salzburg,2008,1,21,9,6,69,31,38,72
SC Rheindorf,2008,2,18,7,11,52,43,9,61
Rapid Vienna,2008,3,16,11,9,58,36,22,59
SK Sturm Gra,2008,4,17,8,11,58,39,19,59
Vienna,2008,5,18,4,14,65,53,12,58
RZ Pellets W,2008,6,12,5,19,39,56,-17,41
SV Josko Rie,2008,7,11,6,19,37,49,-12,39
Admira Wacke,2008,8,11,6,19,35,60,-25,39
St. Pölten,2008,9,10,9,17,43,69,-26,39
Mattersburg,2008,10,9,9,18,34,54,-20,36
SK Sturm Gra,2009,1,22,4,10,64,31,33,70
FC Salzburg,2009,2,21,7,8,63,32,31,70
SC Rheindorf,2009,3,21,4,11,59,42,17,67
Vienna,2009,4,20,4,12,59,50,9,64
Rapid Vienna,2009,5,16,9,11,63,44,19,57
RZ Pellets W,2009,6,12,6,18,41,55,-14,42
St. Pölten,2009,7,10,11,15,53,67,-14,41
Admira Wacke,2009,8,11,7,18,33,54,-21,40
SV Josko Rie,2009,9,8,6,22,31,60,-29,30
Mattersburg,2009,10,6,8,22,31,62,-31,26
FC Salzburg,2010,1,21,7,8,70,33,37,70
SK Sturm Gra,2010,2,19,8,9,57,28,29,65
SC Rheindorf,2010,3,18,8,10,55,51,4,62
Vienna,2010,4,18,5,13,68,56,12,59
RZ Pellets W,2010,5,17,6,13,52,48,4,57
Rapid Vienna,2010,6,15,10,11,59,39,20,55
SV Josko Rie,2010,7,13,4,19,39,54,-15,43
Admira Wacke,2010,8,10,7,19,36,63,-27,37
Mattersburg,2010,9,6,10,20,39,69,-30,28
St. Pölten,2010,10,7,7,22,42,76,-34,28
SK Sturm Gra,2011,1,20,6,10,62,38,24,66
FC Salzburg,2011,2,19,6,11,63,38,25,63
SC Rheindorf,2011,3,18,9,9,50,42,8,63
Vienna,2011,4,18,7,11,63,49,14,61
Rapid Vienna,2011,5,14,10,12,61,45,16,52
RZ Pellets W,2011,6,14,8,14,46,53,-7,50
SV Josko Rie,2011,7,13,6,17,39,52,-13,45
Admira Wacke,2011,8,11,6,19,34,59,-25,39
St. Pölten,2011,9,8,9,19,40,61,-21,33
Mattersburg,2011,10,6,11,19,34,55,-21,29
SK Sturm Gra,2012,1,22,4,10,66,35,31,70
FC Salzburg,2012,2,20,8,8,64,29,35,68
Vienna,2012,3,21,4,11,68,51,17,67
SC Rheindorf,2012,4,20,6,10,59,47,12,66
Rapid Vienna,2012,5,16,9,11,56,36,20,57
RZ Pellets W,2012,6,12,6,18,44,61,-17,42
Admira Wacke,2012,7,12,5,19,40,61,-21,41
Mattersburg,2012,8,11,6,19,39,60,-21,39
SV Josko Rie,2012,9,10,6,20,39,58,-19,36
St. Pölten,2012,10,4,10,22,28,65,-37,22
FC Salzburg,2013,1,23,5,8,66,35,31,74
SC Rheindorf,2013,2,20,8,8,58,43,15,68
SK Sturm Gra,2013,3,19,5,12,63,40,23,62
Vienna,2013,4,18,7,11,61,50,11,61
Rapid Vienna,2013,5,16,10,10,71,44,27,58
RZ Pellets W,2013,6,12,7,17,40,51,-11,43
Mattersburg,2013,7,11,7,18,38,55,-17,40
Admira Wacke,2013,8,10,6,20,42,68,-26,36
SV Josko Rie,2013,9,11,2,23,34,55,-21,35
St. Pölten,2013,10,8,7,21,39,71,-32,31
FC Salzburg,2014,1,21,8,7,65,32,33,71
Rapid Vienna,2014,2,18,10,8,76,41,35,64
SC Rheindorf,2014,3,18,8,10,51,40,11,62
Vienna,2014,4,19,2,15,60,58,2,59
SK Sturm Gra,2014,5,17,6,13,55,45,10,57
Admira Wacke,2014,6,15,7,14,55,61,-6,52
RZ Pellets W,2014,7,13,7,16,53,57,-4,46
Mattersburg,2014,8,8,11,17,36,53,-17,35
SV Josko Rie,2014,9,9,4,23,29,56,-27,31
St. Pölten,2014,10,7,7,22,38,75,-37,28
FC Salzburg,2015,1,22,7,7,66,27,39,73
SK Sturm Gra,2015,2,21,6,9,61,31,30,69
Vienna,2015,3,20,5,11,62,47,15,65
SC Rheindorf,2015,4,18,8,10,57,47,10,62
Rapid Vienna,2015,5,15,10,11,51,37,14,55
RZ Pellets W,2015,6,11,7,18,40,55,-15,40
Admira Wacke,2015,7,11,7,18,36,58,-22,40
SV Josko Rie,2015,8,9,7,20,26,49,-23,34
Mattersburg,2015,9,7,10,19,32,55,-23,31
St. Pölten,2015,10,6,13,17,42,67,-25,31
FC Salzburg,2016,1,21,8,7,67,32,35,71
SK Sturm Gra,2016,2,19,9,8,53,31,22,66
SC Rheindorf,2016,3,17,9,10,49,38,11,60
Vienna,2016,4,18,4,14,63,58,5,58
RZ Pellets W,2016,5,14,8,14,55,62,-7,50
Rapid Vienna,2016,6,11,12,13,50,41,9,45
SV Josko Rie,2016,7,12,7,17,41,52,-11,43
Mattersburg,2016,8,10,9,17,46,54,-8,39
Admira Wacke,2016,9,10,7,19,37,64,-27,37
St. Pölten,2016,10,7,9,20,36,65,-29,30
FC Salzburg,2017,1,22,7,7,72,36,36,73
SC Rheindorf,2017,2,20,8,8,55,44,11,68
SK Sturm Gra,2017,3,18,10,8,62,38,24,64
Vienna,2017,4,18,6,12,65,52,13,60
Rapid Vienna,2017,5,14,9,13,56,41,15,51
Admira Wacke,2017,6,12,6,18,37,56,-19,42
RZ Pellets W,2017,7,11,7,18,39,54,-15,40
SV Josko Rie,2017,8,10,8,18,38,58,-20,38
St. Pölten,2017,9,8,12,16,46,65,-19,36
Mattersburg,2017,10,8,5,23,39,65,-26,29
FC Salzburg,2018,1,21,8,7,67,31,36,71
SK Sturm Gra,2018,2,22,4,10,57,29,28,70
SC Rheindorf,2018,3,21,6,9,59,41,18,69
Vienna,2018,4,18,6,12,64,59,5,60
RZ Pellets W,2018,5,14,8,14,49,53,-4,50
Admira Wacke,2018,6,13,8,15,41,50,-9,47
Rapid Vienna,2018,7,11,10,15,55,45,10,43
St. Pölten,2018,8,9,7,20,38,65,-27,34
SV Josko Rie,2018,9,9,5,22,30,55,-25,32
Mattersburg,2018,10,7,8,21,32,64,-32,29
SC Rheindorf,2019,1,21,8,7,57,34,23,71
FC Salzburg,2019,2,19,10,7,63,32,31,67
SK Sturm Gra,2019,3,19,7,10,56,30,26,64
Rapid Vienna,2019,4,16,10,10,52,30,22,58
Vienna,2019,5,17,7,12,61,51,10,58
RZ Pellets W,2019,6,12,10,14,43,50,-7,46
SV Josko Rie,2019,7,13,3,20,43,57,-14,42
Admira Wacke,2019,8,10,7,19,30,60,-30,37
Mattersburg,2019,9,7,9,20,35,60,-25,30
St. Pölten,2019,10,5,11,20,35,71,-36,26
FC Salzburg,2020,1,20,7,9,58,31,27,67
SC Rheindorf,2020,2,19,9,8,57,38,19,66
Vienna,2020,3,19,8,9,64,46,18,65
SK Sturm Gra,2020,4,18,6,12,63,37,26,60
Rapid Vienna,2020,5,16,11,9,56,38,18,59
St. Pölten,2020,6,11,10,15,50,57,-7,43
Admira Wacke,2020,7,12,4,20,34,63,-29,40
RZ Pellets W,2020,8,10,7,19,44,60,-16,37
SV Josko Rie,2020,9,11,4,21,30,54,-24,37
Mattersburg,2020,10,8,6,22,31,63,-32,30
FC Salzburg,2021,1,19,12,5,61,30,31,69
SC Rheindorf,2021,2,20,8,8,60,38,22,68
Vienna,2021,3,20,5,11,69,52,17,65
SK Sturm Gra,2021,4,19,5,12,58,34,24,62
Rapid Vienna,2021,5,16,12,8,57,32,25,60
SV Josko Rie,2021,6,12,6,18,36,51,-15,42
Admira Wacke,2021,7,10,8,18,39,61,-22,38
RZ Pellets W,2021,8,8,10,18,41,62,-21,34
St. Pölten,2021,9,7,9,20,36,70,-34,30
Mattersburg,2021,10,6,11,19,30,57,-27,29
FC Salzburg,2022,1,23,8,5,74,24,50,77
SC Rheindorf,2022,2,21,9,6,54,33,21,72
SK Sturm Gra,2022,3,15,12,9,57,35,22,57
Vienna,2022,4,16,6,14,53,57,-4,54
Rapid Vienna,2022,5,13,11,12,58,48,10,50
Admira Wacke,2022,6,12,9,15,38,58,-20,45
RZ Pellets W,2022,7,10,8,18,45,57,-12,38
SV Josko Rie,2022,8,10,6,20,29,49,-20,36
Mattersburg,2022,9,9,8,19,38,59,-21,35
St. Pölten,2022,10,8,9,19,38,64,-26,33
FC Salzburg,2023,1,22,4,10,61,33,28,70
SC Rheindorf,2023,2,20,9,7,54,35,19,69
Vienna,2023,3,19,7,10,60,42,18,64
SK Sturm Gra,2023,4,18,7,11,54,37,17,61
Rapid Vienna,2023,5,11,11,14,50,45,5,44
RZ Pellets W,2023,6,12,8,16,43,52,-9,44
St. Pölten,2023,7,11,10,15,48,57,-9,43
Admira Wacke,2023,8,11,6,19,37,62,-25,39
Mattersburg,2023,9,8,10,18,43,61,-18,34
SV Josko Rie,2023,10,9,6,21,34,60,-26,33
FC Salzburg,2024,1,21,8,7,65,36,29,71
SC Rheindorf,2024,2,21,7,8,64,42,22,70
SK Sturm Gra,2024,3,19,7,10,61,35,26,64
Vienna,2024,4,20,3,13,67,57,10,63
Rapid Vienna,2024,5,14,9,13,53,42,11,51
RZ Pellets W,2024,6,12,7,17,45,59,-14,43
St. Pölten,2024,7,10,10,16,41,58,-17,40
Admira Wacke,2024,8,10,8,18,38,60,-22,38
SV Josko Rie,2024,9,11,4,21,32,53,-21,37
Mattersburg,2024,10,7,7,22,37,61,-24,28
Vienna,2025,1,22,4,10,78,45,33,70
FC Salzburg,2025,2,21,7,8,62,31,31,70
SC Rheindorf,2025,3,20,8,8,62,43,19,68
SK Sturm Gra,2025,4,18,6,12,61,41,20,60
Rapid Vienna,2025,5,12,10,14,54,46,8,46
RZ Pellets W,2025,6,11,11,14,48,55,-7,44
Admira Wacke,2025,7,11,7,18,33,64,-31,40
SV Josko Rie,2025,8,11,5,20,35,58,-23,38
St. Pölten,2025,9,9,8,19,48,75,-27,35
Mattersburg,2025,10,8,8,20,36,59,-23,32
FC Salzburg,2026,1,22,8,6,63,23,40,74
Vienna,2026,2,21,5,10,64,48,16,68
SC Rheindorf,2026,3,20,6,10,58,50,8,66
SK Sturm Gra,2026,4,17,7,12,56,36,20,58
RZ Pellets W,2026,5,12,10,14,42,51,-9,46
Admira Wacke,2026,6,12,7,17,39,59,-20,43
Rapid Vienna,2026,7,11,9,16,50,43,7,42
Mattersburg,2026,8,10,8,18,41,55,-14,38
SV Josko Rie,2026,9,10,5,21,35,53,-18,35
St. Pölten,2026,10,8,9,19,40,70,-30,33
SC Rheindorf,2027,1,23,5,8,64,43,21,74
FC Salzburg,2027,2,19,9,8,61,32,29,66
SK Sturm Gra,2027,3,19,5,12,61,37,24,62
Vienna,2027,4,19,3,14,63,51,12,60
Rapid Vienna,2027,5,15,10,11,65,45,20,55
Admira Wacke,2027,6,14,6,16,46,63,-17,48
RZ Pellets W,2027,7,12,6,18,45,60,-15,42
Mattersburg,2027,8,9,8,19,38,56,-18,35
SV Josko Rie,2027,9,10,5,21,32,57,-25,35
St. Pölten,2027,10,7,9,20,36,67,-31,30
SC Rheindorf,2028,1,22,6,8,65,43,22,72
SK Sturm Gra,2028,2,21,6,9,67,36,31,69
Vienna,2028,3,21,5,10,73,50,23,68
FC Salzburg,2028,4,20,5,11,64,36,28,65
Rapid Vienna,2028,5,15,10,11,57,42,15,55
Mattersburg,2028,6,11,6,19,46,59,-13,39
RZ Pellets W,2028,7,11,5,20,46,61,-15,38
Admira Wacke,2028,8,11,5,20,40,67,-27,38
St. Pölten,2028,9,9,9,18,37,66,-29,36
SV Josko Rie,2028,10,9,3,24,27,62,-35,30
SC Rheindorf,2029,1,20,7,9,61,39,22,67
Vienna,2029,2,20,7,9,65,44,21,67
SK Sturm Gra,2029,3,19,6,11,61,37,24,63
FC Salzburg,2029,4,17,11,8,55,33,22,62
Rapid Vienna,2029,5,12,12,12,50,38,12,48
Mattersburg,2029,6,12,8,16,46,52,-6,44
RZ Pellets W,2029,7,12,8,16,42,52,-10,44
Admira Wacke,2029,8,10,7,19,30,62,-32,37
SV Josko Rie,2029,9,9,6,21,30,55,-25,33
St. Pölten,2029,10,7,12,17,39,67,-28,33
FC Salzburg,2030,1,22,5,9,64,31,33,71
SC Rheindorf,2030,2,22,5,9,62,42,20,71
Vienna,2030,3,18,6,12,63,53,10,60
SK Sturm Gra,2030,4,16,8,12,55,41,14,56
RZ Pellets W,2030,5,14,9,13,53,55,-2,51
Rapid Vienna,2030,6,12,13,11,50,42,8,49
Admira Wacke,2030,7,12,8,16,37,53,-16,44
Mattersburg,2030,8,8,9,19,41,56,-15,33
St. Pölten,2030,9,7,11,18,40,66,-26,32
SV Josko Rie,2030,10,8,8,20,35,61,-26,32
SK Sturm Gra,2031,1,21,6,9,58,30,28,69
FC Salzburg,2031,2,18,10,8,64,32,32,64
SC Rheindorf,2031,3,18,8,10,57,44,13,62
Vienna,2031,4,16,4,16,53,52,1,52
RZ Pellets W,2031,5,14,9,13,45,50,-5,51
Rapid Vienna,2031,6,13,10,13,59,49,10,49
Mattersburg,2031,7,11,9,16,41,51,-10,42
Admira Wacke,2031,8,11,7,18,35,61,-26,40
St. Pölten,2031,9,10,8,18,39,58,-19,38
SV Josko Rie,2031,10,10,5,21,30,54,-24,35
SK Sturm Gra,2032,1,20,8,8,64,33,31,68
FC Salzburg,2032,2,19,9,8,71,38,33,66
SC Rheindorf,2032,3,18,9,9,57,43,14,63
Vienna,2032,4,17,5,14,58,54,4,56
Rapid Vienna,2032,5,14,12,10,61,42,19,54
RZ Pellets W,2032,6,14,7,15,42,49,-7,49
Admira Wacke,2032,7,12,6,18,44,64,-20,42
SV Josko Rie,2032,8,12,6,18,36,57,-21,42
Mattersburg,2032,9,8,8,20,35,59,-24,32
St. Pölten,2032,10,5,12,19,40,69,-29,27
FC Salzburg,2033,1,22,6,8,66,31,35,72
SC Rheindorf,2033,2,19,11,6,59,42,17,68
Vienna,2033,3,18,4,14,65,58,7,58
Rapid Vienna,2033,4,15,12,9,62,33,29,57
SK Sturm Gra,2033,5,15,9,12,55,40,15,54
Admira Wacke,2033,6,15,4,17,43,62,-19,49
RZ Pellets W,2033,7,13,7,16,46,57,-11,46
St. Pölten,2033,8,8,12,16,46,63,-17,36
Mattersburg,2033,9,8,8,20,32,57,-25,32
SV Josko Rie,2033,10,7,7,22,33,64,-31,28
FC Salzburg,2034,1,23,8,5,71,29,42,77
Vienna,2034,2,18,9,9,61,47,14,63
SC Rheindorf,2034,3,18,7,11,52,40,12,61
SK Sturm Gra,2034,4,17,7,12,59,41,18,58
Rapid Vienna,2034,5,12,12,12,57,44,13,48
RZ Pellets W,2034,6,12,11,13,49,53,-4,47
SV Josko Rie,2034,7,12,4,20,32,49,-17,40
Admira Wacke,2034,8,10,9,17,35,59,-24,39
St. Pölten,2034,9,9,8,19,44,74,-30,35
Mattersburg,2034,10,7,9,20,35,59,-24,30
FC Salzburg,2035,1,22,8,6,66,28,38,74
SC Rheindorf,2035,2,19,7,10,56,39,17,64
Vienna,2035,3,17,5,14,56,52,4,56
Rapid Vienna,2035,4,14,12,10,58,40,18,54
SK Sturm Gra,2035,5,15,8,13,53,39,14,53
Admira Wacke,2035,6,13,7,16,41,59,-18,46
RZ Pellets W,2035,7,12,8,16,48,55,-7,44
SV Josko Rie,2035,8,13,5,18,44,58,-14,44
St. Pölten,2035,9,8,11,17,44,68,-24,35
Mattersburg,2035,10,7,9,20,33,61,-28,30
FC Salzburg,2036,1,21,6,9,66,35,31,69
SC Rheindorf,2036,2,19,11,6,63,43,20,68
Vienna,2036,3,20,5,11,68,49,19,65
SK Sturm Gra,2036,4,18,6,12,62,42,20,60
Rapid Vienna,2036,5,12,12,12,56,50,6,48
RZ Pellets W,2036,6,12,6,18,54,63,-9,42
Admira Wacke,2036,7,12,6,18,40,67,-27,42
SV Josko Rie,2036,8,12,5,19,37,48,-11,41
St. Pölten,2036,9,10,6,20,45,68,-23,36
Mattersburg,2036,10,8,9,19,37,63,-26,33
FC Salzburg,2037,1,21,8,7,65,32,33,71
SK Sturm Gra,2037,2,21,5,10,66,30,36,68
SC Rheindorf,2037,3,20,8,8,58,44,14,68
Vienna,2037,4,20,5,11,66,50,16,65
Admira Wacke,2037,5,15,5,16,36,55,-19,50
Rapid Vienna,2037,6,11,10,15,54,50,4,43
SV Josko Rie,2037,7,10,6,20,35,53,-18,36
St. Pölten,2037,8,9,9,18,41,63,-22,36
RZ Pellets W,2037,9,9,9,18,40,62,-22,36
Mattersburg,2037,10,6,11,19,34,56,-22,29
FC Salzburg,2038,1,24,6,6,76,31,45,78
SC Rheindorf,2038,2,19,9,8,51,42,9,66
SK Sturm Gra,2038,3,20,5,11,60,33,27,65
Vienna,2038,4,19,5,12,68,51,17,62
RZ Pellets W,2038,5,12,9,15,50,57,-7,45
Admira Wacke,2038,6,13,5,18,38,58,-20,44
SV Josko Rie,2038,7,11,7,18,37,54,-17,40
Rapid Vienna,2038,8,9,11,16,47,51,-4,38
Mattersburg,2038,9,7,11,18,33,56,-23,32
St. Pölten,2038,10,7,10,19,39,66,-27,31
SK Sturm Gra,2039,1,20,8,8,54,27,27,68
SC Rheindorf,2039,2,19,10,7,60,45,15,67
FC Salzburg,2039,3,18,9,9,62,29,33,63
Vienna,2039,4,18,5,13,60,48,12,59
Rapid Vienna,2039,5,14,10,12,56,41,15,52
RZ Pellets W,2039,6,15,6,15,45,49,-4,51
Admira Wacke,2039,7,11,7,18,30,57,-27,40
SV Josko Rie,2039,8,11,5,20,38,56,-18,38
St. Pölten,2039,9,9,9,18,38,65,-27,36
Mattersburg,2039,10,6,9,21,34,60,-26,27
FC Salzburg,2040,1,22,7,7,61,28,33,73
SC Rheindorf,2040,2,22,7,7,61,39,22,73
SK Sturm Gra,2040,3,21,6,9,64,33,31,69
Vienna,2040,4,17,5,14,67,60,7,56
Rapid Vienna,2040,5,14,10,12,55,40,15,52
RZ Pellets W,2040,6,13,5,18,48,58,-10,44
Admira Wacke,2040,7,12,7,17,37,56,-19,43
St. Pölten,2040,8,10,8,18,47,74,-27,38
SV Josko Rie,2040,9,9,4,23,28,56,-28,31
Mattersburg,2040,10,7,7,22,34,58,-24,28
SC Rheindorf,2041,1,22,6,8,70,46,24,72
FC Salzburg,2041,2,21,5,10,67,35,32,68
Vienna,2041,3,18,6,12,70,57,13,60
SK Sturm Gra,2041,4,18,5,13,55,39,16,59
Rapid Vienna,2041,5,16,10,10,60,36,24,58
RZ Pellets W,2041,6,14,6,16,55,60,-5,48
Admira Wacke,2041,7,12,4,20,42,73,-31,40
St. Pölten,2041,8,10,7,19,43,72,-29,37
Mattersburg,2041,9,8,9,19,38,57,-19,33
SV Josko Rie,2041,10,9,6,21,32,57,-25,33
SK Sturm Gra,2042,1,24,3,9,69,28,41,75
FC Salzburg,2042,2,22,7,7,67,28,39,73
SC Rheindorf,2042,3,20,7,9,53,43,10,67
Vienna,2042,4,17,5,14,59,52,7,56
Rapid Vienna,2042,5,15,9,12,58,39,19,54
RZ Pellets W,2042,6,15,6,15,50,52,-2,51
Mattersburg,2042,7,10,8,18,44,62,-18,38
SV Josko Rie,2042,8,11,5,20,35,59,-24,38
Admira Wacke,2042,9,9,5,22,33,69,-36,32
St. Pölten,2042,10,5,9,22,30,66,-36,24
SC Rheindorf,2043,1,21,7,8,57,41,16,70
Vienna,2043,2,19,8,9,67,51,16,65
SK Sturm Gra,2043,3,17,10,9,55,32,23,61
FC Salzburg,2043,4,17,9,10,59,33,26,60
Rapid Vienna,2043,5,14,10,12,56,40,16,52
RZ Pellets W,2043,6,12,7,17,44,55,-11,43
Admira Wacke,2043,7,11,7,18,35,54,-19,40
SV Josko Rie,2043,8,10,8,18,33,54,-21,38
St. Pölten,2043,9,9,10,17,38,61,-23,37
Mattersburg,2043,10,8,8,20,34,57,-23,32
FC Salzburg,2044,1,22,5,9,70,34,36,71
SK Sturm Gra,2044,2,21,7,8,63,30,33,70
SC Rheindorf,2044,3,19,7,10,57,44,13,64
Vienna,2044,4,17,7,12,61,50,11,58
RZ Pellets W,2044,5,13,8,15,53,59,-6,47
Rapid Vienna,2044,6,12,10,14,48,45,3,46
Admira Wacke,2044,7,11,8,17,33,55,-22,41
St. Pölten,2044,8,9,11,16,38,57,-19,38
Mattersburg,2044,9,8,10,18,32,57,-25,34
SV Josko Rie,2044,10,8,7,21,27,51,-24,31
FC Salzburg,2045,1,21,8,7,62,27,35,71
SC Rheindorf,2045,2,19,8,9,53,41,12,65
SK Sturm Gra,2045,3,17,10,9,59,35,24,61
Rapid Vienna,2045,4,17,10,9,59,42,17,61
Vienna,2045,5,18,6,12,62,48,14,60
Admira Wacke,2045,6,10,11,15,37,55,-18,41
RZ Pellets W,2045,7,11,7,18,42,54,-12,40
SV Josko Rie,2045,8,9,7,20,34,60,-26,34
St. Pölten,2045,9,8,9,19,44,66,-22,33
Mattersburg,2045,10,8,8,20,40,64,-24,32
SC Rheindorf,2046,1,20,7,9,60,43,17,67
SK Sturm Gra,2046,2,20,6,10,59,30,29,66
Vienna,2046,3,19,6,11,61,47,14,63
FC Salzburg,2046,4,18,8,10,65,39,26,62
Rapid Vienna,2046,5,12,12,12,58,47,11,48
RZ Pellets W,2046,6,13,9,14,49,58,-9,48
Admira Wacke,2046,7,12,6,18,42,61,-19,42
St. Pölten,2046,8,8,12,16,45,67,-22,36
SV Josko Rie,2046,9,9,8,19,37,57,-20,35
Mattersburg,2046,10,7,10,19,31,58,-27,31
FC Salzburg,2047,1,21,8,7,70,30,40,71
Vienna,2047,2,21,4,11,62,42,20,67
SC Rheindorf,2047,3,20,6,10,60,41,19,66
SK Sturm Gra,2047,4,16,8,12,56,38,18,56
Rapid Vienna,2047,5,15,9,12,58,47,11,54
RZ Pellets W,2047,6,11,11,14,45,51,-6,44
St. Pölten,2047,7,10,10,16,42,57,-15,40
Admira Wacke,2047,8,11,5,20,38,69,-31,38
SV Josko Rie,2047,9,10,7,19,35,52,-17,37
Mattersburg,2047,10,7,8,21,36,75,-39,29
SC Rheindorf,2048,1,21,6,9,58,39,19,69
FC Salzburg,2048,2,20,7,9,60,31,29,67
SK Sturm Gra,2048,3,20,4,12,60,41,19,64
Vienna,2048,4,18,6,12,59,49,10,60
Rapid Vienna,2048,5,15,9,12,56,34,22,54
RZ Pellets W,2048,6,13,8,15,48,55,-7,47
Mattersburg,2048,7,10,9,17,39,53,-14,39
Admira Wacke,2048,8,10,7,19,33,63,-30,37
SV Josko Rie,2048,9,10,4,22,29,51,-22,34
St. Pölten,2048,10,8,10,18,42,68,-26,34
FC Salzburg,2049,1,19,12,5,61,22,39,69
SC Rheindorf,2049,2,20,9,7,56,37,19,69
SK Sturm Gra,2049,3,20,8,8,60,28,32,68
Vienna,2049,4,18,7,11,59,49,10,61
Rapid Vienna,2049,5,12,12,12,53,39,14,48
RZ Pellets W,2049,6,10,10,16,44,56,-12,40
Admira Wacke,2049,7,10,10,16,37,62,-25,40
SV Josko Rie,2049,8,10,8,18,33,53,-20,38
Mattersburg,2049,9,8,8,20,35,59,-24,32
St. Pölten,2049,10,5,12,19,37,70,-33,27
FC Salzburg,2050,1,21,6,9,66,30,36,69
SK Sturm Gra,2050,2,18,9,9,61,35,26,63
SC Rheindorf,2050,3,18,9,9,60,50,10,63
Vienna,2050,4,15,8,13,52,51,1,53
Rapid Vienna,2050,5,12,11,13,52,50,2,47
RZ Pellets W,2050,6,13,7,16,47,53,-6,46
Admira Wacke,2050,7,12,6,18,37,55,-18,42
St. Pölten,2050,8,10,10,16,44,57,-13,40
Mattersburg,2050,9,10,9,17,44,55,-11,39
SV Josko Rie,2050,10,11,5,20,29,56,-27,38
FC Salzburg,2051,1,20,9,7,57,27,30,69
SC Rheindorf,2051,2,19,11,6,61,43,18,68
SK Sturm Gra,2051,3,19,9,8,61,30,31,66
Rapid Vienna,2051,4,15,12,9,53,34,19,57
Vienna,2051,5,17,5,14,58,57,1,56
RZ Pellets W,2051,6,13,5,18,42,55,-13,44
SV Josko Rie,2051,7,12,7,17,33,46,-13,43
St. Pölten,2051,8,7,12,17,47,73,-26,33
Mattersburg,2051,9,7,9,20,41,59,-18,30
Admira Wacke,2051,10,7,9,20,33,62,-29,30
Vienna,2052,1,21,4,11,65,45,20,67
SC Rheindorf,2052,2,20,7,9,59,46,13,67
FC Salzburg,2052,3,19,9,8,59,34,25,66
SK Sturm Gra,2052,4,20,5,11,54,32,22,65
Rapid Vienna,2052,5,16,10,10,57,42,15,58
Admira Wacke,2052,6,14,5,17,46,61,-15,47
RZ Pellets W,2052,7,10,9,17,42,61,-19,39
Mattersburg,2052,8,9,8,19,41,51,-10,35
St. Pölten,2052,9,7,11,18,42,62,-20,32
SV Josko Rie,2052,10,7,6,23,25,56,-31,27
SC Rheindorf,2053,1,20,9,7,67,47,20,69
SK Sturm Gra,2053,2,18,8,10,57,34,23,62
FC Salzburg,2053,3,17,7,12,61,42,19,58
Vienna,2053,4,16,8,12,61,54,7,56
Rapid Vienna,2053,5,15,10,11,57,41,16,55
RZ Pellets W,2053,6,14,9,13,51,53,-2,51
Admira Wacke,2053,7,12,5,19,40,68,-28,41
Mattersburg,2053,8,9,11,16,44,56,-12,38
SV Josko Rie,2053,9,10,6,20,42,57,-15,36
St. Pölten,2053,10,7,11,18,39,67,-28,32
SC Rheindorf,2054,1,21,9,6,58,35,23,72
FC Salzburg,2054,2,18,9,9,64,37,27,63
SK Sturm Gra,2054,3,19,6,11,58,34,24,63
Vienna,2054,4,18,8,10,68,47,21,62
Rapid Vienna,2054,5,14,12,10,57,44,13,54
Admira Wacke,2054,6,12,7,17,39,55,-16,43
RZ Pellets W,2054,7,10,10,16,39,56,-17,40
SV Josko Rie,2054,8,9,10,17,34,53,-19,37
St. Pölten,2054,9,7,11,18,45,72,-27,32
Mattersburg,2054,10,6,10,20,32,61,-29,28
SC Rheindorf,2055,1,22,7,7,61,40,21,73
FC Salzburg,2055,2,21,9,6,69,31,38,72
Rapid Vienna,2055,3,18,10,8,67,35,32,64
Vienna,2055,4,20,3,13,66,55,11,63
SK Sturm Gra,2055,5,17,6,13,63,45,18,57
RZ Pellets W,2055,6,14,4,18,50,64,-14,46
SV Josko Rie,2055,7,10,7,19,34,57,-23,37
Mattersburg,2055,8,9,9,18,39,57,-18,36
Admira Wacke,2055,9,10,6,20,38,62,-24,36
St. Pölten,2055,10,5,7,24,39,80,-41,22
FC Salzburg,2056,1,23,6,7,69,29,40,75
SK Sturm Gra,2056,2,20,5,11,59,34,25,65
SC Rheindorf,2056,3,19,7,10,54,44,10,64
Vienna,2056,4,18,8,10,70,50,20,62
RZ Pellets W,2056,5,17,8,11,50,45,5,59
Rapid Vienna,2056,6,12,12,12,60,43,17,48
Admira Wacke,2056,7,11,5,20,34,70,-36,38
Mattersburg,2056,8,8,9,19,32,54,-22,33
St. Pölten,2056,9,8,9,19,39,62,-23,33
SV Josko Rie,2056,10,7,5,24,26,62,-36,26
FC Salzburg,2057,1,21,10,5,68,29,39,73
SC Rheindorf,2057,2,18,9,9,55,48,7,63
SK Sturm Gra,2057,3,17,9,10,62,40,22,60
Vienna,2057,4,16,8,12,62,49,13,56
Rapid Vienna,2057,5,15,10,11,57,36,21,55
Admira Wacke,2057,6,12,7,17,43,62,-19,43
RZ Pellets W,2057,7,12,6,18,45,64,-19,42
Mattersburg,2057,8,10,11,15,41,53,-12,41
SV Josko Rie,2057,9,9,7,20,29,54,-25,34
St. Pölten,2057,10,8,7,21,38,65,-27,31
FC Salzburg,2058,1,22,6,8,70,35,35,72
SK Sturm Gra,2058,2,19,7,10,57,30,27,64
SC Rheindorf,2058,3,16,11,9,51,42,9,59
Admira Wacke,2058,4,16,7,13,43,51,-8,55
Vienna,2058,5,15,6,15,61,59,2,51
RZ Pellets W,2058,6,12,8,16,49,60,-11,44
Rapid Vienna,2058,7,11,10,15,51,51,0,43
Mattersburg,2058,8,10,9,17,37,52,-15,39
St. Pölten,2058,9,9,10,17,45,60,-15,37
SV Josko Rie,2058,10,10,6,20,36,60,-24,36
SK Sturm Gra,2059,1,23,5,8,67,27,40,74
FC Salzburg,2059,2,20,5,11,60,33,27,65
Vienna,2059,3,20,5,11,64,46,18,65
SC Rheindorf,2059,4,19,8,9,52,39,13,65
Rapid Vienna,2059,5,15,10,11,54,40,14,55
Admira Wacke,2059,6,13,6,17,37,53,-16,45
RZ Pellets W,2059,7,13,5,18,43,61,-18,44
SV Josko Rie,2059,8,11,3,22,33,58,-25,36
Mattersburg,2059,9,8,8,20,40,62,-22,32
St. Pölten,2059,10,7,7,22,40,71,-31,28
FC Salzburg,2060,1,22,7,7,66,30,36,73
Vienna,2060,2,20,6,10,60,45,15,66
SC Rheindorf,2060,3,19,7,10,55,42,13,64
SK Sturm Gra,2060,4,19,6,11,58,38,20,63
Rapid Vienna,2060,5,14,12,10,58,39,19,54
St. Pölten,2060,6,11,8,17,46,62,-16,41
RZ Pellets W,2060,7,9,9,18,40,59,-19,36
SV Josko Rie,2060,8,10,6,20,27,48,-21,36
Admira Wacke,2060,9,9,8,19,29,59,-30,35
Mattersburg,2060,10,7,11,18,34,51,-17,32
SK Sturm Gra,2061,1,22,5,9,60,28,32,71
SC Rheindorf,2061,2,22,5,9,73,44,29,71
FC Salzburg,2061,3,19,6,11,62,35,27,63
Rapid Vienna,2061,4,17,11,8,59,35,24,62
Vienna,2061,5,17,5,14,61,54,7,56
Admira Wacke,2061,6,12,5,19,37,62,-25,41
Mattersburg,2061,7,11,6,19,42,66,-24,39
St. Pölten,2061,8,9,10,17,42,65,-23,37
SV Josko Rie,2061,9,9,7,20,37,60,-23,34
RZ Pellets W,2061,10,9,6,21,43,67,-24,33
SC Rheindorf,2062,1,19,11,6,56,35,21,68
SK Sturm Gra,2062,2,20,7,9,63,31,32,67
FC Salzburg,2062,3,20,6,10,63,38,25,66
Vienna,2062,4,18,6,12,55,50,5,60
Rapid Vienna,2062,5,14,12,10,61,44,17,54
RZ Pellets W,2062,6,12,9,15,45,54,-9,45
Mattersburg,2062,7,11,8,17,45,59,-14,41
Admira Wacke,2062,8,11,7,18,34,58,-24,40
SV Josko Rie,2062,9,8,6,22,25,51,-26,30
St. Pölten,2062,10,5,12,19,34,61,-27,27
FC Salzburg,2063,1,22,7,7,68,24,44,73
SK Sturm Gra,2063,2,20,6,10,67,33,34,66
SC Rheindorf,2063,3,19,6,11,51,42,9,63
Vienna,2063,4,19,3,14,61,55,6,60
Rapid Vienna,2063,5,13,11,12,51,42,9,50
Admira Wacke,2063,6,12,6,18,36,60,-24,42
SV Josko Rie,2063,7,12,5,19,35,53,-18,41
Mattersburg,2063,8,10,8,18,39,55,-16,38
St. Pölten,2063,9,9,11,16,37,57,-20,38
RZ Pellets W,2063,10,9,7,20,39,63,-24,34
SK Sturm Gra,2064,1,20,7,9,64,39,25,67
SC Rheindorf,2064,2,18,7,11,56,46,10,61
Vienna,2064,3,19,4,13,59,53,6,61
FC Salzburg,2064,4,16,10,10,64,38,26,58
Rapid Vienna,2064,5,14,10,12,62,46,16,52
SV Josko Rie,2064,6,16,3,17,48,54,-6,51
RZ Pellets W,2064,7,13,9,14,44,49,-5,48
Admira Wacke,2064,8,10,7,19,35,65,-30,37
Mattersburg,2064,9,9,7,20,40,59,-19,34
St. Pölten,2064,10,8,10,18,42,65,-23,34
SK Sturm Gra,2065,1,20,6,10,61,30,31,66
SC Rheindorf,2065,2,19,8,9,59,44,15,65
FC Salzburg,2065,3,19,6,11,59,37,22,63
Vienna,2065,4,17,6,13,62,55,7,57
Rapid Vienna,2065,5,14,11,11,59,41,18,53
SV Josko Rie,2065,6,13,5,18,39,49,-10,44
RZ Pellets W,2065,7,11,10,15,48,59,-11,43
Admira Wacke,2065,8,10,7,19,37,70,-33,37
St. Pölten,2065,9,8,12,16,44,63,-19,36
Mattersburg,2065,10,9,9,18,40,60,-20,36
FC Salzburg,2066,1,20,11,5,61,27,34,71
SK Sturm Gra,2066,2,18,7,11,62,44,18,61
Vienna,2066,3,19,4,13,66,55,11,61
SC Rheindorf,2066,4,16,10,10,51,46,5,58
Rapid Vienna,2066,5,15,11,10,60,41,19,56
RZ Pellets W,2066,6,11,9,16,51,62,-11,42
Admira Wacke,2066,7,11,9,16,42,60,-18,42
Mattersburg,2066,8,10,9,17,42,56,-14,39
St. Pölten,2066,9,8,11,17,44,66,-22,35
SV Josko Rie,2066,10,7,9,20,35,57,-22,30
FC Salzburg,2067,1,24,7,5,69,25,44,79
SK Sturm Gra,2067,2,22,4,10,63,33,30,70
SC Rheindorf,2067,3,20,7,9,63,44,19,67
Vienna,2067,4,17,5,14,65,58,7,56
Rapid Vienna,2067,5,13,12,11,52,42,10,51
RZ Pellets W,2067,6,14,7,15,49,47,2,49
Admira Wacke,2067,7,10,8,18,30,54,-24,38
Mattersburg,2067,8,8,9,19,34,61,-27,33
SV Josko Rie,2067,9,8,6,22,31,57,-26,30
St. Pölten,2067,10,7,9,20,39,74,-35,30
FC Salzburg,2068,1,20,10,6,69,33,36,70
SK Sturm Gra,2068,2,19,6,11,57,35,22,63
SC Rheindorf,2068,3,18,9,9,57,43,14,63
Vienna,2068,4,19,4,13,63,56,7,61
Rapid Vienna,2068,5,15,10,11,64,40,24,55
RZ Pellets W,2068,6,12,8,16,50,53,-3,44
Admira Wacke,2068,7,12,5,19,34,56,-22,41
St. Pölten,2068,8,9,10,17,45,69,-24,37
Mattersburg,2068,9,9,8,19,32,57,-25,35
SV Josko Rie,2068,10,8,8,20,31,60,-29,32
FC Salzburg,2069,1,21,8,7,68,29,39,71
SC Rheindorf,2069,2,22,5,9,58,39,19,71
Vienna,2069,3,18,9,9,65,48,17,63
SK Sturm Gra,2069,4,19,5,12,57,33,24,62
Rapid Vienna,2069,5,15,9,12,54,39,15,54
RZ Pellets W,2069,6,14,6,16,44,52,-8,48
St. Pölten,2069,7,10,9,17,40,59,-19,39
Admira Wacke,2069,8,11,5,20,31,62,-31,38
Mattersburg,2069,9,8,7,21,32,56,-24,31
SV Josko Rie,2069,10,8,5,23,26,58,-32,29
FC Salzburg,2070,1,22,7,7,68,29,39,73
SK Sturm Gra,2070,2,19,9,8,54,31,23,66
SC Rheindorf,2070,3,19,9,8,52,41,11,66
Rapid Vienna,2070,4,17,9,10,58,36,22,60
RZ Pellets W,2070,5,14,8,14,50,49,1,50
Vienna,2070,6,15,4,17,56,54,2,49
SV Josko Rie,2070,7,13,5,18,32,47,-15,44
Admira Wacke,2070,8,12,5,19,35,59,-24,41
Mattersburg,2070,9,8,8,20,30,52,-22,32
St. Pölten,2070,10,5,8,23,30,67,-37,23
FC Salzburg,2071,1,22,8,6,64,28,36,74
SC Rheindorf,2071,2,21,7,8,59,41,18,70
SK Sturm Gra,2071,3,20,5,11,58,37,21,65
Vienna,2071,4,17,6,13,64,54,10,57
Rapid Vienna,2071,5,14,9,13,51,41,10,51
RZ Pellets W,2071,6,11,8,17,39,56,-17,41
St. Pölten,2071,7,11,7,18,44,61,-17,40
Admira Wacke,2071,8,12,4,20,34,57,-23,40
SV Josko Rie,2071,9,11,3,22,36,61,-25,36
Mattersburg,2071,10,7,11,18,42,55,-13,32
FC Salzburg,2072,1,24,5,7,73,29,44,77
SK Sturm Gra,2072,2,20,5,11,63,39,24,65
SC Rheindorf,2072,3,18,7,11,57,45,12,61
Vienna,2072,4,18,5,13,62,57,5,59
Rapid Vienna,2072,5,16,8,12,60,36,24,56
RZ Pellets W,2072,6,13,7,16,46,56,-10,46
St. Pölten,2072,7,11,9,16,49,62,-13,42
SV Josko Rie,2072,8,11,6,19,31,53,-22,39
Admira Wacke,2072,9,8,6,22,39,75,-36,30
Mattersburg,2072,10,5,14,17,30,58,-28,29
SK Sturm Gra,2073,1,19,9,8,58,31,27,66
Vienna,2073,2,19,7,10,60,44,16,64
FC Salzburg,2073,3,18,9,9,60,33,27,63
SC Rheindorf,2073,4,17,7,12,48,44,4,58
RZ Pellets W,2073,5,13,9,14,45,55,-10,48
Rapid Vienna,2073,6,12,11,13,51,41,10,47
Admira Wacke,2073,7,12,9,15,39,54,-15,45
SV Josko Rie,2073,8,11,7,18,37,52,-15,40
Mattersburg,2073,9,10,8,18,45,61,-16,38
St. Pölten,2073,10,6,10,20,37,65,-28,28
FC Salzburg,2074,1,24,6,6,65,27,38,78
SK Sturm Gra,2074,2,18,8,10,49,29,20,62
SC Rheindorf,2074,3,15,12,9,45,38,7,57
RZ Pellets W,2074,4,16,6,14,50,54,-4,54
Rapid Vienna,2074,5,14,10,12,54,39,15,52
Vienna,2074,6,15,6,15,58,51,7,51
Admira Wacke,2074,7,14,6,16,39,53,-14,48
SV Josko Rie,2074,8,10,10,16,35,52,-17,40
St. Pölten,2074,9,7,9,20,43,67,-24,30
Mattersburg,2074,10,6,9,21,33,61,-28,27
SK Sturm Gra,2075,1,21,6,9,57,30,27,69
FC Salzburg,2075,2,20,7,9,66,37,29,67
Vienna,2075,3,20,7,9,66,50,16,67
SC Rheindorf,2075,4,18,8,10,54,41,13,62
Rapid Vienna,2075,5,14,12,10,58,38,20,54
Admira Wacke,2075,6,13,6,17,42,55,-13,45
RZ Pellets W,2075,7,11,8,17,41,53,-12,41
SV Josko Rie,2075,8,9,6,21,29,57,-28,33
Mattersburg,2075,9,7,11,18,33,57,-24,32
St. Pölten,2075,10,6,11,19,34,62,-28,29
FC Salzburg,2076,1,22,7,7,66,27,39,73
SC Rheindorf,2076,2,21,9,6,59,43,16,72
SK Sturm Gra,2076,3,17,8,11,62,40,22,59
Vienna,2076,4,18,4,14,57,54,3,58
Rapid Vienna,2076,5,13,11,12,58,46,12,50
RZ Pellets W,2076,6,13,7,16,49,57,-8,46
Admira Wacke,2076,7,12,6,18,35,54,-19,42
SV Josko Rie,2076,8,10,6,20,34,55,-21,36
Mattersburg,2076,9,8,9,19,36,56,-20,33
St. Pölten,2076,10,8,9,19,45,69,-24,33
Vienna,2077,1,20,6,10,68,43,25,66
FC Salzburg,2077,2,18,9,9,58,27,31,63
SK Sturm Gra,2077,3,18,8,10,52,35,17,62
SC Rheindorf,2077,4,18,8,10,53,46,7,62
Rapid Vienna,2077,5,13,10,13,45,37,8,49
SV Josko Rie,2077,6,13,7,16,42,49,-7,46
RZ Pellets W,2077,7,11,7,18,41,59,-18,40
St. Pölten,2077,8,9,11,16,41,59,-18,38
Mattersburg,2077,9,8,12,16,36,51,-15,36
Admira Wacke,2077,10,9,8,19,30,60,-30,35
SC Rheindorf,2078,1,22,5,9,63,37,26,71
FC Salzburg,2078,2,20,9,7,62,26,36,69
Vienna,2078,3,21,3,12,58,54,4,66
SK Sturm Gra,2078,4,19,6,11,56,33,23,63
Rapid Vienna,2078,5,15,11,10,54,37,17,56
SV Josko Rie,2078,6,13,2,21,34,54,-20,41
RZ Pellets W,2078,7,10,8,18,42,55,-13,38
St. Pölten,2078,8,9,10,17,35,55,-20,37
Admira Wacke,2078,9,11,4,21,30,58,-28,37
Mattersburg,2078,10,7,8,21,31,56,-25,29
SC Rheindorf,2079,1,21,8,7,55,36,19,71
FC Salzburg,2079,2,20,7,9,66,30,36,67
Vienna,2079,3,20,5,11,68,56,12,65
Rapid Vienna,2079,4,17,10,9,63,42,21,61
SK Sturm Gra,2079,5,16,5,15,57,47,10,53
Admira Wacke,2079,6,15,6,15,42,54,-12,51
RZ Pellets W,2079,7,11,8,17,44,56,-12,41
Mattersburg,2079,8,9,6,21,31,52,-21,33
St. Pölten,2079,9,7,12,17,36,60,-24,33
SV Josko Rie,2079,10,7,7,22,29,58,-29,28
FC Salzburg,2080,1,22,7,7,68,29,39,73
SC Rheindorf,2080,2,22,6,8,61,40,21,72
SK Sturm Gra,2080,3,20,5,11,66,39,27,65
Vienna,2080,4,19,5,12,57,52,5,62
RZ Pellets W,2080,5,16,5,15,46,51,-5,53
Rapid Vienna,2080,6,12,12,12,53,41,12,48
Admira Wacke,2080,7,11,5,20,43,63,-20,38
SV Josko Rie,2080,8,10,5,21,29,54,-25,35
Mattersburg,2080,9,8,8,20,34,63,-29,32
St. Pölten,2080,10,6,10,20,39,64,-25,28
SC Rheindorf,2081,1,20,9,7,58,37,21,69
FC Salzburg,2081,2,20,8,8,72,37,35,68
SK Sturm Gra,2081,3,20,6,10,61,34,27,66
Vienna,2081,4,18,7,11,67,52,15,61
Rapid Vienna,2081,5,13,10,13,53,44,9,49
RZ Pellets W,2081,6,13,8,15,49,55,-6,47
SV Josko Rie,2081,7,13,4,19,41,55,-14,43
Admira Wacke,2081,8,10,8,18,37,61,-24,38
Mattersburg,2081,9,9,8,19,39,65,-26,35
St. Pölten,2081,10,5,10,21,33,70,-37,25
SK Sturm Gra,2082,1,25,4,7,70,32,38,79
SC Rheindorf,2082,2,20,8,8,58,38,20,68
FC Salzburg,2082,3,19,5,12,66,37,29,62
Rapid Vienna,2082,4,15,10,11,55,43,12,55
Vienna,2082,5,17,4,15,59,56,3,55
RZ Pellets W,2082,6,13,8,15,42,51,-9,47
St. Pölten,2082,7,10,9,17,44,57,-13,39
Admira Wacke,2082,8,10,5,21,35,70,-35,35
Mattersburg,2082,9,8,9,19,36,54,-18,33
SV Josko Rie,2082,10,9,6,21,26,53,-27,33
FC Salzburg,2083,1,24,7,5,77,27,50,79
SC Rheindorf,2083,2,19,9,8,52,39,13,66
SK Sturm Gra,2083,3,18,8,10,55,28,27,62
Vienna,2083,4,19,5,12,60,51,9,62
RZ Pellets W,2083,5,13,7,16,45,53,-8,46
Admira Wacke,2083,6,13,6,17,41,59,-18,45
Rapid Vienna,2083,7,11,11,14,53,51,2,44
St. Pölten,2083,8,9,7,20,41,66,-25,34
Mattersburg,2083,9,8,8,20,36,59,-23,32
SV Josko Rie,2083,10,8,8,20,29,56,-27,32
FC Salzburg,2084,1,20,8,8,56,29,27,68
SK Sturm Gra,2084,2,19,8,9,65,39,26,65
SC Rheindorf,2084,3,17,10,9,55,44,11,61
Vienna,2084,4,19,3,14,71,58,13,60
Rapid Vienna,2084,5,14,12,10,59,42,17,54
Mattersburg,2084,6,11,9,16,48,56,-8,42
SV Josko Rie,2084,7,12,5,19,44,57,-13,41
RZ Pellets W,2084,8,11,5,20,39,58,-19,38
Admira Wacke,2084,9,10,7,19,38,72,-34,37
St. Pölten,2084,10,9,9,18,42,62,-20,36
SC Rheindorf,2085,1,20,8,8,59,40,19,68
SK Sturm Gra,2085,2,20,5,11,54,37,17,65
Vienna,2085,3,19,5,12,64,51,13,62
FC Salzburg,2085,4,17,10,9,56,32,24,61
Rapid Vienna,2085,5,15,14,7,58,35,23,59
RZ Pellets W,2085,6,15,6,15,45,51,-6,51
SV Josko Rie,2085,7,11,6,19,36,52,-16,39
Admira Wacke,2085,8,9,9,18,34,58,-24,36
St. Pölten,2085,9,8,7,21,50,76,-26,31
Mattersburg,2085,10,8,6,22,32,56,-24,30
FC Salzburg,2086,1,23,7,6,70,33,37,76
SK Sturm Gra,2086,2,20,5,11,63,33,30,65
SC Rheindorf,2086,3,17,9,10,46,45,1,60
Vienna,2086,4,18,3,15,59,49,10,57
Rapid Vienna,2086,5,14,10,12,57,40,17,52
RZ Pellets W,2086,6,12,9,15,46,56,-10,45
SV Josko Rie,2086,7,11,8,17,38,50,-12,41
St. Pölten,2086,8,10,8,18,46,69,-23,38
Mattersburg,2086,9,9,8,19,35,58,-23,35
Admira Wacke,2086,10,10,5,21,37,64,-27,35
SC Rheindorf,2087,1,22,4,10,63,42,21,70
FC Salzburg,2087,2,20,6,10,62,38,24,66
Vienna,2087,3,20,5,11,64,52,12,65
SK Sturm Gra,2087,4,17,9,10,50,32,18,60
Rapid Vienna,2087,5,13,13,10,56,44,12,52
Admira Wacke,2087,6,12,6,18,44,60,-16,42
RZ Pellets W,2087,7,11,8,17,43,57,-14,41
Mattersburg,2087,8,11,7,18,37,48,-11,40
St. Pölten,2087,9,9,10,17,43,60,-17,37
SV Josko Rie,2087,10,9,4,23,31,60,-29,31
SC Rheindorf,2088,1,24,5,7,61,35,26,77
SK Sturm Gra,2088,2,23,6,7,61,30,31,75
FC Salzburg,2088,3,19,8,9,61,34,27,65
Vienna,2088,4,17,5,14,67,56,11,56
Rapid Vienna,2088,5,11,13,12,52,39,13,46
RZ Pellets W,2088,6,12,7,17,40,53,-13,43
SV Josko Rie,2088,7,12,4,20,36,55,-19,40
Admira Wacke,2088,8,11,6,19,41,66,-25,39
St. Pölten,2088,9,9,9,18,42,62,-20,36
Mattersburg,2088,10,7,7,22,32,63,-31,28
SC Rheindorf,2089,1,20,9,7,58,42,16,69
FC Salzburg,2089,2,19,7,10,57,32,25,64
SK Sturm Gra,2089,3,18,9,9,59,34,25,63
Vienna,2089,4,19,3,14,60,50,10,60
Rapid Vienna,2089,5,14,14,8,54,35,19,56
RZ Pellets W,2089,6,11,9,16,44,56,-12,42
Admira Wacke,2089,7,12,6,18,38,62,-24,42
SV Josko Rie,2089,8,11,4,21,36,56,-20,37
Mattersburg,2089,9,9,9,18,42,55,-13,36
St. Pölten,2089,10,7,10,19,42,68,-26,31
Vienna,2090,1,22,5,9,71,46,25,71
FC Salzburg,2090,2,20,7,9,61,31,30,67
SC Rheindorf,2090,3,18,5,13,49,45,4,59
SK Sturm Gra,2090,4,15,8,13,51,36,15,53
Rapid Vienna,2090,5,13,13,10,46,33,13,52
Admira Wacke,2090,6,12,8,16,43,59,-16,44
SV Josko Rie,2090,7,12,6,18,34,48,-14,42
St. Pölten,2090,8,11,9,16,39,56,-17,42
RZ Pellets W,2090,9,10,7,19,42,64,-22,37
Mattersburg,2090,10,9,8,19,34,52,-18,35
SK Sturm Gra,2091,1,23,4,9,64,29,35,73
FC Salzburg,2091,2,22,6,8,71,36,35,72
Vienna,2091,3,17,8,11,63,51,12,59
Rapid Vienna,2091,4,16,10,10,60,41,19,58
SC Rheindorf,2091,5,17,5,14,53,46,7,56
RZ Pellets W,2091,6,13,9,14,54,57,-3,48
Admira Wacke,2091,7,12,4,20,38,68,-30,40
Mattersburg,2091,8,9,10,17,38,52,-14,37
SV Josko Rie,2091,9,9,8,19,38,58,-20,35
St. Pölten,2091,10,6,8,22,34,75,-41,26
FC Salzburg,2092,1,24,7,5,67,24,43,79
SC Rheindorf,2092,2,19,10,7,61,38,23,67
SK Sturm Gra,2092,3,20,6,10,69,35,34,66
Vienna,2092,4,16,5,15,60,61,-1,53
Rapid Vienna,2092,5,13,10,13,56,48,8,49
RZ Pellets W,2092,6,12,9,15,46,62,-16,45
Admira Wacke,2092,7,12,6,18,43,58,-15,42
SV Josko Rie,2092,8,12,5,19,34,53,-19,41
St. Pölten,2092,9,9,9,18,41,64,-23,36
Mattersburg,2092,10,6,7,23,34,68,-34,25
Vienna,2093,1,21,5,10,77,51,26,68
FC Salzburg,2093,2,19,8,9,62,33,29,65
SK Sturm Gra,2093,3,20,5,11,66,41,25,65
SC Rheindorf,2093,4,16,7,13,55,53,2,55
Rapid Vienna,2093,5,13,13,10,51,40,11,52
Admira Wacke,2093,6,13,8,15,43,59,-16,47
RZ Pellets W,2093,7,12,9,15,49,54,-5,45
Mattersburg,2093,8,10,8,18,36,55,-19,38
SV Josko Rie,2093,9,11,5,20,38,58,-20,38
St. Pölten,2093,10,7,8,21,39,72,-33,29
SK Sturm Gra,2094,1,24,5,7,71,27,44,77
FC Salzburg,2094,2,22,8,6,76,32,44,74
Vienna,2094,3,19,5,12,58,52,6,62
SC Rheindorf,2094,4,19,5,12,55,49,6,62
Rapid Vienna,2094,5,13,13,10,53,41,12,52
RZ Pellets W,2094,6,11,9,16,46,58,-12,42
SV Josko Rie,2094,7,10,6,20,32,51,-19,36
Admira Wacke,2094,8,10,6,20,32,60,-28,36
Mattersburg,2094,9,8,8,20,39,68,-29,32
St. Pölten,2094,10,6,11,19,32,56,-24,29
FC Salzburg,2095,1,24,5,7,71,34,37,77
Vienna,2095,2,20,6,10,64,48,16,66
SK Sturm Gra,2095,3,20,5,11,56,35,21,65
Rapid Vienna,2095,4,15,10,11,58,36,22,55
SC Rheindorf,2095,5,14,11,11,50,47,3,53
RZ Pellets W,2095,6,15,7,14,50,49,1,52
SV Josko Rie,2095,7,10,5,21,39,60,-21,35
Admira Wacke,2095,8,10,5,21,32,64,-32,35
St. Pölten,2095,9,8,9,19,39,66,-27,33
Mattersburg,2095,10,7,11,18,42,62,-20,32
FC Salzburg,2096,1,23,6,7,73,28,45,75
SC Rheindorf,2096,2,20,8,8,57,40,17,68
SK Sturm Gra,2096,3,18,8,10,53,32,21,62
Rapid Vienna,2096,4,17,9,10,59,36,23,60
Vienna,2096,5,15,5,16,63,61,2,50
RZ Pellets W,2096,6,13,6,17,48,60,-12,45
Admira Wacke,2096,7,13,5,18,40,61,-21,44
SV Josko Rie,2096,8,10,7,19,31,49,-18,37
St. Pölten,2096,9,8,12,16,40,63,-23,36
Mattersburg,2096,10,5,10,21,36,70,-34,25
FC Salzburg,2097,1,23,7,6,76,35,41,76
SC Rheindorf,2097,2,20,9,7,54,36,18,69
SK Sturm Gra,2097,3,19,8,9,64,31,33,65
Vienna,2097,4,15,10,11,59,51,8,55
Rapid Vienna,2097,5,13,12,11,52,42,10,51
SV Josko Rie,2097,6,13,4,19,37,54,-17,43
RZ Pellets W,2097,7,10,10,16,43,55,-12,40
Mattersburg,2097,8,8,9,19,40,59,-19,33
St. Pölten,2097,9,8,9,19,42,71,-29,33
Admira Wacke,2097,10,8,8,20,36,69,-33,32
FC Salzburg,2098,1,24,7,5,73,24,49,79
SK Sturm Gra,2098,2,21,5,10,60,32,28,68
SC Rheindorf,2098,3,20,8,8,50,36,14,68
Rapid Vienna,2098,4,16,10,10,59,38,21,58
Vienna,2098,5,16,4,16,61,61,0,52
RZ Pellets W,2098,6,13,6,17,44,59,-15,45
Admira Wacke,2098,7,12,6,18,39,58,-19,42
Mattersburg,2098,8,9,8,19,31,56,-25,35
St. Pölten,2098,9,8,7,21,38,64,-26,31
SV Josko Rie,2098,10,8,5,23,31,58,-27,29
SC Rheindorf,2099,1,22,7,7,59,41,18,73
FC Salzburg,2099,2,22,5,9,67,31,36,71
Vienna,2099,3,18,8,10,62,47,15,62
SK Sturm Gra,2099,4,18,7,11,53,33,20,61
Rapid Vienna,2099,5,14,10,12,53,39,14,52
RZ Pellets W,2099,6,11,7,18,43,63,-20,40
SV Josko Rie,2099,7,10,8,18,35,54,-19,38
St. Pölten,2099,8,9,10,17,41,61,-20,37
Mattersburg,2099,9,10,6,20,41,54,-13,36
Admira Wacke,2099,10,9,6,21,32,63,-31,33
FC Salzburg,2100,1,24,7,5,75,30,45,79
SC Rheindorf,2100,2,19,10,7,55,37,18,67
SK Sturm Gra,2100,3,17,7,12,47,31,16,58
Vienna,2100,4,18,4,14,56,53,3,58
Mattersburg,2100,5,12,7,17,44,55,-11,43
Rapid Vienna,2100,6,10,12,14,49,46,3,42
RZ Pellets W,2100,7,11,8,17,51,64,-13,41
St. Pölten,2100,8,9,13,14,42,59,-17,40
SV Josko Rie,2100,9,8,11,17,31,52,-21,35
Admira Wacke,2100,10,9,7,20,33,56,-23,34
FC Salzburg,2101,1,23,7,6,68,26,42,76
SC Rheindorf,2101,2,23,5,8,58,38,20,74
Vienna,2101,3,19,5,12,57,44,13,62
SK Sturm Gra,2101,4,17,6,13,51,35,16,57
Rapid Vienna,2101,5,14,9,13,52,43,9,51
RZ Pellets W,2101,6,13,9,14,44,49,-5,48
Admira Wacke,2101,7,13,4,19,32,51,-19,43
SV Josko Rie,2101,8,10,4,22,33,55,-22,34
St. Pölten,2101,9,8,9,19,37,63,-26,33
Mattersburg,2101,10,5,12,19,36,64,-28,27
FC Salzburg,2102,1,23,8,5,70,27,43,77
SK Sturm Gra,2102,2,20,6,10,55,30,25,66
SC Rheindorf,2102,3,19,7,10,53,42,11,64
Vienna,2102,4,19,5,12,60,50,10,62
Rapid Vienna,2102,5,13,11,12,55,39,16,50
RZ Pellets W,2102,6,13,8,15,46,55,-9,47
SV Josko Rie,2102,7,11,6,19,35,52,-17,39
St. Pölten,2102,8,10,9,17,46,68,-22,39
Admira Wacke,2102,9,9,6,21,36,64,-28,33
Mattersburg,2102,10,6,8,22,32,61,-29,26
SK Sturm Gra,2103,1,22,8,6,66,29,37,74
FC Salzburg,2103,2,21,9,6,64,28,36,72
Rapid Vienna,2103,3,15,10,11,51,39,12,55
SC Rheindorf,2103,4,16,7,13,44,40,4,55
Vienna,2103,5,13,7,16,47,56,-9,46
RZ Pellets W,2103,6,12,8,16,42,55,-13,44
Admira Wacke,2103,7,10,11,15,36,52,-16,41
SV Josko Rie,2103,8,11,7,18,33,50,-17,40
Mattersburg,2103,9,10,8,18,38,49,-11,38
St. Pölten,2103,10,9,7,20,39,62,-23,34
FC Salzburg,2104,1,21,7,8,61,26,35,70
SK Sturm Gra,2104,2,20,7,9,56,31,25,67
SC Rheindorf,2104,3,20,7,9,59,41,18,67
Rapid Vienna,2104,4,15,10,11,57,45,12,55
Vienna,2104,5,15,7,14,56,55,1,52
RZ Pellets W,2104,6,11,9,16,39,56,-17,42
Admira Wacke,2104,7,12,5,19,40,60,-20,41
St. Pölten,2104,8,10,9,17,46,61,-15,39
Mattersburg,2104,9,9,9,18,40,61,-21,36
SV Josko Rie,2104,10,9,6,21,34,52,-18,33
SK Sturm Gra,2105,1,24,6,6,69,31,38,78
FC Salzburg,2105,2,21,7,8,67,28,39,70
SC Rheindorf,2105,3,18,6,12,51,45,6,60
Vienna,2105,4,17,5,14,56,58,-2,56
Rapid Vienna,2105,5,14,8,14,54,45,9,50
RZ Pellets W,2105,6,13,5,18,48,62,-14,44
Admira Wacke,2105,7,12,5,19,41,58,-17,41
St. Pölten,2105,8,10,9,17,43,60,-17,39
SV Josko Rie,2105,9,10,7,19,31,50,-19,37
Mattersburg,2105,10,8,8,20,37,60,-23,32
FC Salzburg,2106,1,24,4,8,75,32,43,76
SC Rheindorf,2106,2,19,9,8,57,42,15,66
Vienna,2106,3,19,4,13,62,54,8,61
SK Sturm Gra,2106,4,16,8,12,58,41,17,56
RZ Pellets W,2106,5,13,8,15,46,53,-7,47
Admira Wacke,2106,6,12,8,16,46,60,-14,44
Rapid Vienna,2106,7,11,10,15,51,48,3,43
SV Josko Rie,2106,8,12,6,18,33,52,-19,42
Mattersburg,2106,9,9,9,18,40,55,-15,36
St. Pölten,2106,10,7,10,19,39,70,-31,31
SC Rheindorf,2107,1,22,6,8,54,40,14,72
FC Salzburg,2107,2,21,8,7,63,32,31,71
SK Sturm Gra,2107,3,20,5,11,55,37,18,65
Vienna,2107,4,17,7,12,65,52,13,58
Admira Wacke,2107,5,14,7,15,44,51,-7,49
Rapid Vienna,2107,6,12,9,15,46,39,7,45
RZ Pellets W,2107,7,11,9,16,48,57,-9,42
St. Pölten,2107,8,8,11,17,42,66,-24,35
Mattersburg,2107,9,7,11,18,32,51,-19,32
SV Josko Rie,2107,10,8,7,21,31,55,-24,31
SC Rheindorf,2108,1,24,8,4,62,33,29,80
FC Salzburg,2108,2,23,8,5,71,31,40,77
SK Sturm Gra,2108,3,21,7,8,61,34,27,70
Vienna,2108,4,16,5,15,61,60,1,53
Rapid Vienna,2108,5,12,11,13,51,45,6,47
RZ Pellets W,2108,6,12,8,16,48,54,-6,44
SV Josko Rie,2108,7,10,5,21,42,62,-20,35
Admira Wacke,2108,8,9,7,20,41,71,-30,34
St. Pölten,2108,9,7,10,19,44,65,-21,31
Mattersburg,2108,10,8,7,21,37,63,-26,31
SC Rheindorf,2109,1,22,5,9,63,45,18,71
SK Sturm Gra,2109,2,21,5,10,62,33,29,68
FC Salzburg,2109,3,18,10,8,60,31,29,64
Vienna,2109,4,18,7,11,57,46,11,61
Rapid Vienna,2109,5,14,10,12,54,40,14,52
RZ Pellets W,2109,6,13,7,16,44,54,-10,46
Admira Wacke,2109,7,12,7,17,38,57,-19,43
SV Josko Rie,2109,8,9,8,19,33,52,-19,35
Mattersburg,2109,9,7,10,19,36,61,-25,31
St. Pölten,2109,10,8,7,21,42,70,-28,31
FC Salzburg,2110,1,20,9,7,67,30,37,69
SC Rheindorf,2110,2,21,6,9,58,38,20,69
SK Sturm Gra,2110,3,18,9,9,56,34,22,63
Vienna,2110,4,18,4,14,55,49,6,58
Rapid Vienna,2110,5,15,9,12,54,41,13,54
RZ Pellets W,2110,6,14,5,17,45,55,-10,47
Mattersburg,2110,7,12,8,16,44,50,-6,44
SV Josko Rie,2110,8,10,5,21,30,54,-24,35
St. Pölten,2110,9,7,11,18,33,60,-27,32
Admira Wacke,2110,10,8,8,20,27,58,-31,32
FC Salzburg,2111,1,21,8,7,64,29,35,71
Vienna,2111,2,22,4,10,63,44,19,70
SC Rheindorf,2111,3,20,6,10,60,46,14,66
SK Sturm Gra,2111,4,17,7,12,55,43,12,58
Rapid Vienna,2111,5,14,11,11,58,42,16,53
RZ Pellets W,2111,6,12,7,17,46,56,-10,43
Admira Wacke,2111,7,12,5,19,36,61,-25,41
SV Josko Rie,2111,8,11,4,21,36,56,-20,37
St. Pölten,2111,9,7,12,17,39,58,-19,33
Mattersburg,2111,10,7,10,19,40,62,-22,31
FC Salzburg,2112,1,24,7,5,76,29,47,79
SK Sturm Gra,2112,2,22,7,7,60,28,32,73
Vienna,2112,3,18,7,11,60,48,12,61
SC Rheindorf,2112,4,17,10,9,59,50,9,61
Rapid Vienna,2112,5,11,11,14,54,46,8,44
Admira Wacke,2112,6,11,7,18,38,60,-22,40
St. Pölten,2112,7,8,14,14,43,61,-18,38
RZ Pellets W,2112,8,8,10,18,39,59,-20,34
SV Josko Rie,2112,9,9,7,20,34,60,-26,34
Mattersburg,2112,10,7,10,19,40,62,-22,31
FC Salzburg,2113,1,22,8,6,66,31,35,74
Vienna,2113,2,20,4,12,65,51,14,64
SC Rheindorf,2113,3,19,6,11,50,40,10,63
SK Sturm Gra,2113,4,18,6,12,57,39,18,60
Rapid Vienna,2113,5,14,12,10,54,40,14,54
Admira Wacke,2113,6,13,6,17,38,58,-20,45
RZ Pellets W,2113,7,12,7,17,53,60,-7,43
St. Pölten,2113,8,9,8,19,46,66,-20,35
SV Josko Rie,2113,9,10,4,22,32,54,-22,34
Mattersburg,2113,10,8,9,19,34,56,-22,33
FC Salzburg,2114,1,23,8,5,75,25,50,77
SC Rheindorf,2114,2,20,7,9,55,42,13,67
SK Sturm Gra,2114,3,19,5,12,60,38,22,62
Vienna,2114,4,16,7,13,64,62,2,55
SV Josko Rie,2114,5,16,2,18,45,55,-10,50
RZ Pellets W,2114,6,14,7,15,45,51,-6,49
Rapid Vienna,2114,7,11,12,13,52,43,9,45
St. Pölten,2114,8,10,9,17,48,69,-21,39
Mattersburg,2114,9,7,9,20,43,69,-26,30
Admira Wacke,2114,10,8,6,22,33,66,-33,30
FC Salzburg,2115,1,22,8,6,64,28,36,74
SC Rheindorf,2115,2,20,6,10,53,34,19,66
SK Sturm Gra,2115,3,19,6,11,56,37,19,63
Vienna,2115,4,18,7,11,55,48,7,61
Rapid Vienna,2115,5,11,13,12,52,43,9,46
Admira Wacke,2115,6,13,6,17,43,63,-20,45
RZ Pellets W,2115,7,10,9,17,47,59,-12,39
St. Pölten,2115,8,9,11,16,45,60,-15,38
Mattersburg,2115,9,10,6,20,38,55,-17,36
SV Josko Rie,2115,10,9,6,21,28,54,-26,33
SC Rheindorf,2116,1,21,8,7,56,39,17,71
FC Salzburg,2116,2,20,7,9,61,34,27,67
Vienna,2116,3,21,3,12,68,49,19,66
SK Sturm Gra,2116,4,18,9,9,59,32,27,63
Rapid Vienna,2116,5,13,12,11,50,39,11,51
RZ Pellets W,2116,6,14,7,15,43,50,-7,49
SV Josko Rie,2116,7,10,6,20,32,53,-21,36
St. Pölten,2116,8,8,11,17,43,61,-18,35
Admira Wacke,2116,9,9,7,20,33,64,-31,34
Mattersburg,2116,10,8,6,22,38,62,-24,30
FC Salzburg,2117,1,21,8,7,61,30,31,71
SK Sturm Gra,2117,2,20,7,9,61,37,24,67
Vienna,2117,3,19,6,11,64,48,16,63
SC Rheindorf,2117,4,19,6,11,52,45,7,63
Rapid Vienna,2117,5,13,10,13,53,41,12,49
RZ Pellets W,2117,6,14,7,15,47,53,-6,49
SV Josko Rie,2117,7,13,4,19,37,51,-14,43
Admira Wacke,2117,8,10,5,21,38,67,-29,35
St. Pölten,2117,9,8,10,18,43,60,-17,34
Mattersburg,2117,10,6,11,19,30,54,-24,29
FC Salzburg,2118,1,24,4,8,70,30,40,76
SK Sturm Gra,2118,2,21,6,9,62,32,30,69
Vienna,2118,3,20,5,11,73,55,18,65
SC Rheindorf,2118,4,19,8,9,49,38,11,65
Rapid Vienna,2118,5,12,11,13,56,48,8,47
Admira Wacke,2118,6,13,6,17,34,54,-20,45
RZ Pellets W,2118,7,10,9,17,43,57,-14,39
Mattersburg,2118,8,9,9,18,37,58,-21,36
St. Pölten,2118,9,9,9,18,39,61,-22,36
SV Josko Rie,2118,10,6,7,23,33,63,-30,25
SC Rheindorf,2119,1,21,6,9,55,39,16,69
FC Salzburg,2119,2,20,6,10,62,34,28,66
SK Sturm Gra,2119,3,18,6,12,58,41,17,60
Vienna,2119,4,18,5,13,67,56,11,59
Rapid Vienna,2119,5,13,12,11,51,40,11,51
Admira Wacke,2119,6,15,6,15,41,55,-14,51
RZ Pellets W,2119,7,12,11,13,49,51,-2,47
SV Josko Rie,2119,8,11,5,20,38,58,-20,38
Mattersburg,2119,9,9,7,20,29,51,-22,34
St. Pölten,2119,10,7,8,21,40,65,-25,29
FC Salzburg,2120,1,21,9,6,72,26,46,72
SC Rheindorf,2120,2,21,5,10,62,41,21,68
SK Sturm Gra,2120,3,19,6,11,60,40,20,63
Vienna,2120,4,19,3,14,63,52,11,60
Rapid Vienna,2120,5,15,9,12,54,38,16,54
RZ Pellets W,2120,6,14,6,16,45,58,-13,48
St. Pölten,2120,7,10,10,16,41,66,-25,40
SV Josko Rie,2120,8,10,5,21,32,52,-20,35
Mattersburg,2120,9,8,9,19,38,62,-24,33
Admira Wacke,2120,10,9,6,21,34,66,-32,33
FC Salzburg,2121,1,23,8,5,66,23,43,77
SC Rheindorf,2121,2,21,9,6,60,38,22,72
SK Sturm Gra,2121,3,19,5,12,57,43,14,62
Rapid Vienna,2121,4,15,9,12,57,45,12,54
Vienna,2121,5,16,5,15,56,50,6,53
Admira Wacke,2121,6,12,8,16,38,55,-17,44
RZ Pellets W,2121,7,11,7,18,53,59,-6,40
SV Josko Rie,2121,8,10,8,18,36,56,-20,38
St. Pölten,2121,9,8,11,17,40,67,-27,35
Mattersburg,2121,10,5,10,21,35,62,-27,25
SK Sturm Gra,2122,1,21,5,10,62,34,28,68
FC Salzburg,2122,2,17,12,7,64,35,29,63
SC Rheindorf,2122,3,18,7,11,57,48,9,61
Rapid Vienna,2122,4,14,12,10,59,34,25,54
Vienna,2122,5,16,6,14,59,56,3,54
RZ Pellets W,2122,6,13,9,14,47,58,-11,48
Admira Wacke,2122,7,12,6,18,40,55,-15,42
St. Pölten,2122,8,11,8,17,45,64,-19,41
SV Josko Rie,2122,9,10,6,20,31,58,-27,36
Mattersburg,2122,10,9,7,20,37,59,-22,34
FC Salzburg,2123,1,24,6,6,65,26,39,78
SK Sturm Gra,2123,2,19,4,13,61,39,22,61
SC Rheindorf,2123,3,17,9,10,54,46,8,60
Vienna,2123,4,17,6,13,58,51,7,57
Rapid Vienna,2123,5,14,10,12,54,40,14,52
RZ Pellets W,2123,6,13,7,16,40,50,-10,46
St. Pölten,2123,7,11,8,17,52,65,-13,41
Admira Wacke,2123,8,10,8,18,34,56,-22,38
SV Josko Rie,2123,9,10,7,19,32,54,-22,37
Mattersburg,2123,10,8,9,19,35,58,-23,33
FC Salzburg,2124,1,20,10,6,65,29,36,70
Vienna,2124,2,19,6,11,69,51,18,63
SC Rheindorf,2124,3,18,9,9,51,42,9,63
SK Sturm Gra,2124,4,16,7,13,54,41,13,55
RZ Pellets W,2124,5,13,9,14,45,50,-5,48
Rapid Vienna,2124,6,10,12,14,47,43,4,42
Mattersburg,2124,7,10,12,14,37,47,-10,42
Admira Wacke,2124,8,10,10,16,36,55,-19,40
St. Pölten,2124,9,9,12,15,46,60,-14,39
SV Josko Rie,2124,10,9,5,22,35,67,-32,32
FC Salzburg,2125,1,23,7,6,75,31,44,76
SC Rheindorf,2125,2,21,7,8,62,43,19,70
SK Sturm Gra,2125,3,19,6,11,63,42,21,63
Vienna,2125,4,17,6,13,73,66,7,57
Rapid Vienna,2125,5,12,12,12,55,41,14,48
Admira Wacke,2125,6,12,7,17,42,60,-18,43
St. Pölten,2125,7,11,9,16,47,62,-15,42
RZ Pellets W,2125,8,10,6,20,42,71,-29,36
SV Josko Rie,2125,9,10,5,21,40,60,-20,35
Mattersburg,2125,10,9,7,20,42,65,-23,34
SC Rheindorf,2126,1,25,6,5,64,37,27,81
SK Sturm Gra,2126,2,21,5,10,58,32,26,68
FC Salzburg,2126,3,18,10,8,66,33,33,64
Vienna,2126,4,18,6,12,63,50,13,60
Rapid Vienna,2126,5,14,8,14,54,43,11,50
RZ Pellets W,2126,6,12,8,16,44,55,-11,44
SV Josko Rie,2126,7,11,8,17,37,50,-13,41
Admira Wacke,2126,8,11,5,20,33,60,-27,38
St. Pölten,2126,9,7,9,20,35,65,-30,30
Mattersburg,2126,10,6,9,21,35,64,-29,27
FC Salzburg,2127,1,21,8,7,69,33,36,71
Vienna,2127,2,20,6,10,70,49,21,66
SK Sturm Gra,2127,3,19,6,11,60,39,21,63
SC Rheindorf,2127,4,18,7,11,56,45,11,61
RZ Pellets W,2127,5,16,6,14,51,50,1,54
Rapid Vienna,2127,6,12,10,14,55,47,8,46
SV Josko Rie,2127,7,13,7,16,36,51,-15,46
Admira Wacke,2127,8,11,8,17,39,59,-20,41
Mattersburg,2127,9,8,10,18,41,57,-16,34
St. Pölten,2127,10,5,6,25,38,85,-47,21
FC Salzburg,2128,1,22,7,7,69,25,44,73
SK Sturm Gra,2128,2,22,4,10,66,35,31,70
Vienna,2128,3,19,6,11,58,49,9,63
SC Rheindorf,2128,4,17,8,11,47,39,8,59
Rapid Vienna,2128,5,15,8,13,62,47,15,53
RZ Pellets W,2128,6,14,6,16,47,51,-4,48
SV Josko Rie,2128,7,12,4,20,37,54,-17,40
Admira Wacke,2128,8,10,5,21,31,63,-32,35
St. Pölten,2128,9,9,7,20,39,63,-24,34
Mattersburg,2128,10,9,7,20,32,62,-30,34
SC Rheindorf,2129,1,24,7,5,61,32,29,79
FC Salzburg,2129,2,21,5,10,65,31,34,68
Vienna,2129,3,18,6,12,66,52,14,60
SK Sturm Gra,2129,4,16,8,12,54,39,15,56
Rapid Vienna,2129,5,14,12,10,60,42,18,54
RZ Pellets W,2129,6,13,9,14,54,63,-9,48
St. Pölten,2129,7,11,9,16,39,58,-19,42
Admira Wacke,2129,8,10,7,19,36,62,-26,37
SV Josko Rie,2129,9,8,9,19,32,56,-24,33
Mattersburg,2129,10,5,8,23,35,67,-32,23
SK Sturm Gra,2130,1,22,7,7,60,28,32,73
FC Salzburg,2130,2,21,5,10,64,34,30,68
SC Rheindorf,2130,3,18,9,9,55,42,13,63
Vienna,2130,4,17,6,13,60,53,7,57
Rapid Vienna,2130,5,13,9,14,51,44,7,48
RZ Pellets W,2130,6,13,6,17,47,61,-14,45
Mattersburg,2130,7,11,8,17,48,55,-7,41
St. Pölten,2130,8,10,8,18,46,67,-21,38
SV Josko Rie,2130,9,11,5,20,32,53,-21,38
Admira Wacke,2130,10,10,5,21,30,56,-26,35
FC Salzburg,2131,1,22,8,6,64,29,35,74
Vienna,2131,2,21,5,10,67,47,20,68
SK Sturm Gra,2131,3,20,6,10,65,38,27,66
SC Rheindorf,2131,4,19,9,8,59,47,12,66
RZ Pellets W,2131,5,11,12,13,48,55,-7,45
Rapid Vienna,2131,6,10,12,14,48,44,4,42
Admira Wacke,2131,7,10,9,17,39,60,-21,39
SV Josko Rie,2131,8,8,8,20,29,56,-27,32
Mattersburg,2131,9,7,10,19,38,55,-17,31
St. Pölten,2131,10,6,13,17,39,65,-26,31
FC Salzburg,2132,1,20,8,8,72,33,39,68
Vienna,2132,2,20,7,9,63,44,19,67
SK Sturm Gra,2132,3,18,9,9,54,36,18,63
SC Rheindorf,2132,4,18,8,10,55,45,10,62
Rapid Vienna,2132,5,14,11,11,56,36,20,53
RZ Pellets W,2132,6,12,7,17,48,63,-15,43
SV Josko Rie,2132,7,12,3,21,33,56,-23,39
Mattersburg,2132,8,10,8,18,41,60,-19,38
St. Pölten,2132,9,8,11,17,43,63,-20,35
Admira Wacke,2132,10,10,4,22,31,60,-29,34
SK Sturm Gra,2133,1,21,8,7,64,28,36,71
FC Salzburg,2133,2,19,8,9,60,34,26,65
SC Rheindorf,2133,3,19,7,10,56,42,14,64
Vienna,2133,4,17,8,11,60,51,9,59
Rapid Vienna,2133,5,16,7,13,59,43,16,55
SV Josko Rie,2133,6,14,6,16,46,50,-4,48
RZ Pellets W,2133,7,11,7,18,38,56,-18,40
St. Pölten,2133,8,9,9,18,36,61,-25,36
Mattersburg,2133,9,7,11,18,39,58,-19,32
Admira Wacke,2133,10,8,7,21,30,65,-35,31
SC Rheindorf,2134,1,21,9,6,58,37,21,72
FC Salzburg,2134,2,20,9,7,62,31,31,69
SK Sturm Gra,2134,3,19,6,11,67,36,31,63
Vienna,2134,4,18,6,12,64,54,10,60
Rapid Vienna,2134,5,16,8,12,56,42,14,56
RZ Pellets W,2134,6,11,6,19,42,58,-16,39
SV Josko Rie,2134,7,11,5,20,32,49,-17,38
Mattersburg,2134,8,10,7,19,35,55,-20,37
St. Pölten,2134,9,9,9,18,38,60,-22,36
Admira Wacke,2134,10,10,5,21,36,68,-32,35
SC Rheindorf,2135,1,23,8,5,59,36,23,77
SK Sturm Gra,2135,2,19,7,10,59,31,28,64
FC Salzburg,2135,3,17,11,8,60,36,24,62
Vienna,2135,4,18,5,13,60,53,7,59
Rapid Vienna,2135,5,13,11,12,50,41,9,50
Admira Wacke,2135,6,12,7,17,33,53,-20,43
RZ Pellets W,2135,7,10,11,15,43,55,-12,41
St. Pölten,2135,8,10,8,18,40,56,-16,38
Mattersburg,2135,9,9,7,20,33,50,-17,34
SV Josko Rie,2135,10,9,5,22,32,58,-26,32
FC Salzburg,2136,1,20,9,7,62,31,31,69
Vienna,2136,2,20,3,13,66,49,17,63
SK Sturm Gra,2136,3,18,8,10,59,35,24,62
SC Rheindorf,2136,4,17,8,11,54,47,7,59
Rapid Vienna,2136,5,15,9,12,57,39,18,54
Mattersburg,2136,6,15,8,13,47,45,2,53
RZ Pellets W,2136,7,10,10,16,44,55,-11,40
SV Josko Rie,2136,8,11,7,18,32,51,-19,40
Admira Wacke,2136,9,9,6,21,31,66,-35,33
St. Pölten,2136,10,7,8,21,35,69,-34,29
FC Salzburg,2137,1,24,6,6,69,28,41,78
SC Rheindorf,2137,2,18,11,7,57,40,17,65
Vienna,2137,3,20,4,12,59,48,11,64
SK Sturm Gra,2137,4,18,7,11,53,33,20,61
Rapid Vienna,2137,5,13,11,12,60,46,14,50
RZ Pellets W,2137,6,11,9,16,41,53,-12,42
Admira Wacke,2137,7,12,6,18,34,53,-19,42
SV Josko Rie,2137,8,9,7,20,29,51,-22,34
Mattersburg,2137,9,8,8,20,39,64,-25,32
St. Pölten,2137,9,7,11,18,39,64,-25,32
FC Salzburg,2138,1,22,5,9,72,37,35,71
SK Sturm Gra,2138,2,20,7,9,59,31,28,67
SC Rheindorf,2138,3,18,6,12,52,50,2,60
Rapid Vienna,2138,4,17,8,11,73,49,24,59
Vienna,2138,5,17,6,13,62,57,5,57
RZ Pellets W,2138,6,13,7,16,49,57,-8,46
Admira Wacke,2138,7,13,5,18,43,63,-20,44
SV Josko Rie,2138,8,10,8,18,34,50,-16,38
Mattersburg,2138,9,9,9,18,40,60,-20,36
St. Pölten,2138,10,6,9,21,43,73,-30,27
FC Salzburg,2139,1,21,7,8,61,32,29,70
Vienna,2139,2,22,3,11,73,50,23,69
SK Sturm Gra,2139,3,21,5,10,65,35,30,68
SC Rheindorf,2139,4,19,5,12,50,44,6,62
Rapid Vienna,2139,5,15,8,13,58,39,19,53
RZ Pellets W,2139,6,15,6,15,45,51,-6,51
Admira Wacke,2139,7,12,4,20,38,61,-23,40
SV Josko Rie,2139,8,11,6,19,30,49,-19,39
St. Pölten,2139,9,8,7,21,38,66,-28,31
Mattersburg,2139,10,7,7,22,31,62,-31,28
SK Sturm Gra,2140,1,20,8,8,64,34,30,68
SC Rheindorf,2140,2,20,8,8,59,41,18,68
FC Salzburg,2140,3,19,9,8,63,34,29,66
Vienna,2140,4,18,5,13,58,56,2,59
Rapid Vienna,2140,5,13,13,10,51,38,13,52
SV Josko Rie,2140,6,14,6,16,36,43,-7,48
RZ Pellets W,2140,7,12,8,16,48,59,-11,44
Mattersburg,2140,8,9,11,16,38,51,-13,38
Admira Wacke,2140,9,10,6,20,37,61,-24,36
St. Pölten,2140,10,4,8,24,33,70,-37,20
Vienna,2141,1,20,7,9,62,41,21,67
FC Salzburg,2141,2,18,10,8,62,32,30,64
SC Rheindorf,2141,3,17,10,9,50,47,3,61
SK Sturm Gra,2141,4,17,9,10,63,36,27,60
RZ Pellets W,2141,5,16,7,13,51,52,-1,55
Rapid Vienna,2141,6,11,12,13,53,47,6,45
Admira Wacke,2141,7,10,8,18,37,58,-21,38
SV Josko Rie,2141,8,10,6,20,32,53,-21,36
Mattersburg,2141,9,8,11,17,37,57,-20,35
St. Pölten,2141,10,8,10,18,46,70,-24,34
FC Salzburg,2142,1,26,6,4,77,24,53,84
SK Sturm Gra,2142,2,21,6,9,62,26,36,69
SC Rheindorf,2142,3,19,7,10,57,47,10,64
Vienna,2142,4,17,3,16,54,55,-1,54
Rapid Vienna,2142,5,12,11,13,48,43,5,47
RZ Pellets W,2142,6,12,7,17,40,52,-12,43
Admira Wacke,2142,7,10,8,18,32,60,-28,38
SV Josko Rie,2142,8,11,4,21,38,59,-21,37
Mattersburg,2142,9,9,8,19,38,58,-20,35
St. Pölten,2142,10,8,10,18,40,62,-22,34
SC Rheindorf,2143,1,21,8,7,59,38,21,71
FC Salzburg,2143,2,20,8,8,69,34,35,68
Vienna,2143,3,20,5,11,62,48,14,65
SK Sturm Gra,2143,4,19,5,12,64,40,24,62
Rapid Vienna,2143,5,17,7,12,63,44,19,58
Admira Wacke,2143,6,13,4,19,36,57,-21,43
RZ Pellets W,2143,7,11,5,20,41,57,-16,38
SV Josko Rie,2143,8,12,2,22,36,58,-22,38
St. Pölten,2143,9,10,6,20,40,63,-23,36
Mattersburg,2143,10,8,8,20,38,69,-31,32
SC Rheindorf,2144,1,20,9,7,53,35,18,69
SK Sturm Gra,2144,2,20,5,11,63,36,27,65
FC Salzburg,2144,3,18,9,9,63,35,28,63
Vienna,2144,4,19,4,13,64,56,8,61
Rapid Vienna,2144,5,13,12,11,54,43,11,51
Admira Wacke,2144,6,13,6,17,45,65,-20,45
SV Josko Rie,2144,7,12,7,17,41,48,-7,43
RZ Pellets W,2144,8,11,9,16,46,60,-14,42
St. Pölten,2144,9,7,10,19,37,64,-27,31
Mattersburg,2144,10,7,9,20,34,58,-24,30
FC Salzburg,2145,1,23,5,8,67,28,39,74
SC Rheindorf,2145,2,20,5,11,52,45,7,65
SK Sturm Gra,2145,3,19,6,11,59,39,20,63
Vienna,2145,4,18,7,11,55,43,12,61
RZ Pellets W,2145,5,18,6,12,57,50,7,60
Rapid Vienna,2145,6,13,12,11,56,40,16,51
Admira Wacke,2145,7,11,5,20,30,55,-25,38
St. Pölten,2145,8,10,6,20,37,59,-22,36
SV Josko Rie,2145,9,8,7,21,31,55,-24,31
Mattersburg,2145,10,6,9,21,28,58,-30,27
FC Salzburg,2146,1,23,8,5,67,27,40,77
SC Rheindorf,2146,2,19,7,10,58,42,16,64
Vienna,2146,3,19,6,11,72,59,13,63
SK Sturm Gra,2146,4,18,8,10,57,31,26,62
Rapid Vienna,2146,5,16,11,9,61,37,24,59
RZ Pellets W,2146,6,11,8,17,42,54,-12,41
SV Josko Rie,2146,7,11,5,20,35,51,-16,38
Admira Wacke,2146,8,10,8,18,36,71,-35,38
Mattersburg,2146,9,8,6,22,41,66,-25,30
St. Pölten,2146,10,6,11,19,41,72,-31,29
FC Salzburg,2147,1,21,10,5,66,30,36,73
SC Rheindorf,2147,2,19,9,8,51,38,13,66
SK Sturm Gra,2147,3,19,8,9,59,32,27,65
Vienna,2147,4,18,6,12,69,54,15,60
Rapid Vienna,2147,5,14,9,13,53,39,14,51
SV Josko Rie,2147,6,13,4,19,41,60,-19,43
RZ Pellets W,2147,7,11,8,17,45,58,-13,41
Admira Wacke,2147,8,11,7,18,34,60,-26,40
Mattersburg,2147,9,8,9,19,44,62,-18,33
St. Pölten,2147,10,6,10,20,38,67,-29,28
FC Salzburg,2148,1,26,4,6,69,23,46,82
SK Sturm Gra,2148,2,21,5,10,63,36,27,68
Vienna,2148,3,21,5,10,66,54,12,68
SC Rheindorf,2148,4,19,8,9,57,39,18,65
Rapid Vienna,2148,5,11,11,14,54,46,8,44
SV Josko Rie,2148,6,13,4,19,37,51,-14,43
RZ Pellets W,2148,7,12,6,18,49,61,-12,42
Admira Wacke,2148,8,10,6,20,38,66,-28,36
St. Pölten,2148,9,8,8,20,41,71,-30,32
Mattersburg,2148,10,7,7,22,33,60,-27,28
SC Rheindorf,2149,1,21,8,7,59,39,20,71
SK Sturm Gra,2149,2,21,5,10,71,33,38,68
FC Salzburg,2149,3,19,6,11,61,34,27,63
Vienna,2149,4,19,3,14,74,57,17,60
Rapid Vienna,2149,5,16,9,11,55,40,15,57
SV Josko Rie,2149,6,16,3,17,37,48,-11,51
Admira Wacke,2149,7,12,5,19,41,65,-24,41
RZ Pellets W,2149,8,11,6,19,46,66,-20,39
St. Pölten,2149,9,8,7,21,39,70,-31,31
Mattersburg,2149,10,7,8,21,34,65,-31,29
SC Rheindorf,2150,1,21,6,9,57,39,18,69
FC Salzburg,2150,2,20,8,8,60,27,33,68
SK Sturm Gra,2150,3,20,8,8,61,31,30,68
Vienna,2150,4,17,6,13,65,61,4,57
RZ Pellets W,2150,5,15,7,14,53,53,0,52
Rapid Vienna,2150,6,11,11,14,47,43,4,44
Mattersburg,2150,7,10,11,15,40,50,-10,41
SV Josko Rie,2150,8,11,8,17,39,55,-16,41
Admira Wacke,2150,9,8,8,20,28,60,-32,32
St. Pölten,2150,10,6,9,21,36,67,-31,27
SK Sturm Gra,2151,1,22,7,7,69,34,35,73
FC Salzburg,2151,2,19,10,7,69,37,32,67
SC Rheindorf,2151,3,17,12,7,53,40,13,63
Vienna,2151,4,19,4,13,64,55,9,61
Rapid Vienna,2151,5,14,11,11,61,43,18,53
Admira Wacke,2151,6,13,6,17,43,61,-18,45
SV Josko Rie,2151,7,11,6,19,33,52,-19,39
Mattersburg,2151,8,9,9,18,43,59,-16,36
RZ Pellets W,2151,9,9,7,20,41,64,-23,34
St. Pölten,2151,10,6,10,20,36,67,-31,28
SC Rheindorf,2152,1,22,6,8,61,38,23,72
SK Sturm Gra,2152,2,20,6,10,60,31,29,66
FC Salzburg,2152,3,19,6,11,66,41,25,63
Vienna,2152,4,17,7,12,62,60,2,58
Rapid Vienna,2152,5,13,12,11,56,40,16,51
Admira Wacke,2152,6,15,6,15,56,57,-1,51
Mattersburg,2152,7,10,8,18,39,56,-17,38
RZ Pellets W,2152,8,9,9,18,42,65,-23,36
St. Pölten,2152,9,9,9,18,43,73,-30,36
SV Josko Rie,2152,10,9,5,22,38,62,-24,32
FC Salzburg,2153,1,23,8,5,71,31,40,77
SK Sturm Gra,2153,2,19,8,9,58,29,29,65
SC Rheindorf,2153,3,17,12,7,66,47,19,63
Vienna,2153,4,18,7,11,62,52,10,61
Rapid Vienna,2153,5,15,11,10,59,43,16,56
Admira Wacke,2153,6,11,8,17,41,56,-15,41
RZ Pellets W,2153,7,11,7,18,45,60,-15,40
SV Josko Rie,2153,8,11,3,22,29,57,-28,36
St. Pölten,2153,9,8,8,20,42,67,-25,32
Mattersburg,2153,10,5,12,19,28,59,-31,27
FC Salzburg,2154,1,23,6,7,67,32,35,75
SK Sturm Gra,2154,2,21,7,8,64,28,36,70
SC Rheindorf,2154,3,19,9,8,55,43,12,66
Vienna,2154,4,19,4,13,66,57,9,61
Rapid Vienna,2154,5,12,15,9,56,40,16,51
RZ Pellets W,2154,6,13,8,15,50,60,-10,47
Admira Wacke,2154,7,10,8,18,35,61,-26,38
St. Pölten,2154,8,8,9,19,43,64,-21,33
SV Josko Rie,2154,9,8,7,21,32,60,-28,31
Mattersburg,2154,10,5,11,20,32,55,-23,26
Vienna,2155,1,22,4,10,75,46,29,70
SK Sturm Gra,2155,2,20,6,10,61,35,26,66
SC Rheindorf,2155,3,19,9,8,54,39,15,66
FC Salzburg,2155,4,18,11,7,63,38,25,65
Rapid Vienna,2155,5,14,10,12,54,38,16,52
RZ Pellets W,2155,6,13,5,18,47,62,-15,44
Admira Wacke,2155,7,11,5,20,34,58,-24,38
St. Pölten,2155,8,10,6,20,44,70,-26,36
SV Josko Rie,2155,9,9,8,19,32,56,-24,35
Mattersburg,2155,10,9,6,21,35,57,-22,33
FC Salzburg,2156,1,22,7,7,73,35,38,73
SC Rheindorf,2156,2,20,6,10,57,44,13,66
Vienna,2156,3,19,3,14,70,60,10,60
SK Sturm Gra,2156,4,17,7,12,59,40,19,58
Rapid Vienna,2156,5,12,12,12,52,40,12,48
Admira Wacke,2156,6,13,5,18,40,62,-22,44
Mattersburg,2156,7,10,9,17,44,59,-15,39
RZ Pellets W,2156,8,9,11,16,40,58,-18,38
SV Josko Rie,2156,9,11,5,20,33,51,-18,38
St. Pölten,2156,10,8,13,15,39,58,-19,37
FC Salzburg,2157,1,20,9,7,65,32,33,69
SC Rheindorf,2157,2,20,8,8,54,37,17,68
Vienna,2157,3,21,5,10,70,55,15,68
SK Sturm Gra,2157,4,20,5,11,66,36,30,65
RZ Pellets W,2157,5,13,6,17,47,60,-13,45
Rapid Vienna,2157,6,11,11,14,53,47,6,44
Admira Wacke,2157,7,12,6,18,44,59,-15,42
Mattersburg,2157,8,10,7,19,41,60,-19,37
SV Josko Rie,2157,9,10,5,21,33,56,-23,35
St. Pölten,2157,10,7,10,19,40,71,-31,31
FC Salzburg,2158,1,20,8,8,68,39,29,68
Vienna,2158,2,21,5,10,69,48,21,68
SC Rheindorf,2158,3,20,7,9,52,35,17,67
SK Sturm Gra,2158,4,17,6,13,51,39,12,57
Rapid Vienna,2158,5,15,8,13,58,46,12,53
Admira Wacke,2158,6,14,5,17,47,66,-19,47
RZ Pellets W,2158,7,10,11,15,50,61,-11,41
St. Pölten,2158,8,9,11,16,47,60,-13,38
Mattersburg,2158,9,9,7,20,36,58,-22,34
SV Josko Rie,2158,10,9,4,23,33,59,-26,31
FC Salzburg,2159,1,22,7,7,67,30,37,73
SC Rheindorf,2159,2,18,9,9,55,40,15,63
SK Sturm Gra,2159,3,18,6,12,55,33,22,60
Vienna,2159,4,18,6,12,62,52,10,60
Rapid Vienna,2159,5,15,11,10,60,40,20,56
Mattersburg,2159,6,13,6,17,41,54,-13,45
RZ Pellets W,2159,7,12,6,18,37,63,-26,42
Admira Wacke,2159,8,11,8,17,39,55,-16,41
SV Josko Rie,2159,9,9,5,22,28,53,-25,32
St. Pölten,2159,10,7,10,19,39,63,-24,31
FC Salzburg,2160,1,22,8,6,68,28,40,74
Rapid Vienna,2160,2,18,9,9,62,39,23,63
SK Sturm Gra,2160,3,19,5,12,60,39,21,62
SC Rheindorf,2160,4,16,13,7,43,32,11,61
Vienna,2160,5,16,5,15,55,50,5,53
SV Josko Rie,2160,6,12,8,16,37,46,-9,44
RZ Pellets W,2160,7,11,7,18,41,58,-17,40
Admira Wacke,2160,8,10,7,19,30,54,-24,37
Mattersburg,2160,9,7,12,17,38,58,-20,33
St. Pölten,2160,10,7,10,19,42,72,-30,31
FC Salzburg,2161,1,21,8,7,72,32,40,71
SK Sturm Gra,2161,2,21,6,9,59,31,28,69
SC Rheindorf,2161,3,18,8,10,57,43,14,62
Vienna,2161,4,18,5,13,55,53,2,59
Rapid Vienna,2161,5,14,10,12,53,43,10,52
RZ Pellets W,2161,6,14,9,13,49,52,-3,51
Mattersburg,2161,7,9,11,16,37,54,-17,38
Admira Wacke,2161,8,11,4,21,39,66,-27,37
SV Josko Rie,2161,9,8,9,19,30,52,-22,33
St. Pölten,2161,10,6,10,20,46,71,-25,28
FC Salzburg,2162,1,23,5,8,71,41,30,74
SC Rheindorf,2162,2,22,6,8,60,38,22,72
Vienna,2162,3,21,5,10,66,48,18,68
SK Sturm Gra,2162,4,19,7,10,58,33,25,64
Rapid Vienna,2162,5,17,7,12,61,44,17,58
RZ Pellets W,2162,6,10,7,19,44,60,-16,37
Admira Wacke,2162,7,10,7,19,34,58,-24,37
St. Pölten,2162,8,9,9,18,39,58,-19,36
Mattersburg,2162,9,9,6,21,37,58,-21,33
SV Josko Rie,2162,10,8,5,23,35,67,-32,29
FC Salzburg,2163,1,22,7,7,71,35,36,73
SK Sturm Gra,2163,2,20,7,9,60,30,30,67
SC Rheindorf,2163,3,19,7,10,60,53,7,64
Vienna,2163,4,19,6,11,66,56,10,63
Rapid Vienna,2163,5,11,14,11,52,43,9,47
RZ Pellets W,2163,6,12,10,14,50,56,-6,46
Admira Wacke,2163,7,12,4,20,41,66,-25,40
SV Josko Rie,2163,8,11,4,21,32,54,-22,37
St. Pölten,2163,9,8,9,19,43,59,-16,33
Mattersburg,2163,10,8,8,20,41,64,-23,32
FC Salzburg,2164,1,22,6,8,69,34,35,72
SC Rheindorf,2164,2,22,4,10,63,42,21,70
SK Sturm Gra,2164,3,21,6,9,54,30,24,69
Vienna,2164,4,17,5,14,51,45,6,56
Rapid Vienna,2164,5,14,9,13,56,46,10,51
RZ Pellets W,2164,6,14,5,17,41,51,-10,47
Admira Wacke,2164,7,11,6,19,41,60,-19,39
SV Josko Rie,2164,8,11,5,20,36,57,-21,38
St. Pölten,2164,9,8,11,17,39,61,-22,35
Mattersburg,2164,10,8,7,21,36,60,-24,31
FC Salzburg,2165,1,25,4,7,72,32,40,79
SC Rheindorf,2165,2,19,8,9,59,47,12,65
SK Sturm Gra,2165,3,18,9,9,54,31,23,63
RZ Pellets W,2165,4,16,6,14,50,52,-2,54
Rapid Vienna,2165,5,15,8,13,55,42,13,53
Vienna,2165,6,16,5,15,68,59,9,53
SV Josko Rie,2165,7,13,5,18,42,58,-16,44
Admira Wacke,2165,8,10,7,19,30,54,-24,37
Mattersburg,2165,9,8,7,21,35,55,-20,31
St. Pölten,2165,10,6,9,21,42,77,-35,27
FC Salzburg,2166,1,18,9,9,59,34,25,63
SC Rheindorf,2166,2,19,5,12,55,46,9,62
SK Sturm Gra,2166,3,18,7,11,56,36,20,61
Vienna,2166,4,18,7,11,56,45,11,61
RZ Pellets W,2166,5,16,6,14,52,51,1,54
Rapid Vienna,2166,6,12,10,14,55,44,11,46
Admira Wacke,2166,7,12,9,15,36,51,-15,45
Mattersburg,2166,8,12,7,17,43,53,-10,43
SV Josko Rie,2166,9,9,8,19,34,58,-24,35
St. Pölten,2166,10,6,12,18,31,59,-28,30
FC Salzburg,2167,1,22,6,8,71,34,37,72
SK Sturm Gra,2167,2,21,7,8,62,35,27,70
SC Rheindorf,2167,3,21,7,8,65,48,17,70
Vienna,2167,4,18,6,12,65,51,14,60
Rapid Vienna,2167,5,13,8,15,55,45,10,47
Admira Wacke,2167,6,13,6,17,36,57,-21,45
SV Josko Rie,2167,7,11,6,19,37,53,-16,39
Mattersburg,2167,8,10,7,19,36,57,-21,37
RZ Pellets W,2167,9,10,5,21,44,63,-19,35
St. Pölten,2167,10,8,8,20,40,68,-28,32
FC Salzburg,2168,1,21,9,6,68,32,36,72
SK Sturm Gra,2168,2,21,6,9,59,34,25,69
SC Rheindorf,2168,3,19,9,8,51,38,13,66
Vienna,2168,4,19,7,10,60,44,16,64
Rapid Vienna,2168,5,13,10,13,60,39,21,49
Admira Wacke,2168,6,13,6,17,32,53,-21,45
RZ Pellets W,2168,7,11,7,18,42,53,-11,40
St. Pölten,2168,8,8,10,18,37,64,-27,34
SV Josko Rie,2168,9,9,5,22,33,59,-26,32
Mattersburg,2168,10,6,11,19,32,58,-26,29
SK Sturm Gra,2169,1,20,6,10,60,32,28,66
FC Salzburg,2169,2,19,8,9,62,34,28,65
SC Rheindorf,2169,3,18,5,13,51,48,3,59
Rapid Vienna,2169,4,15,10,11,56,37,19,55
Vienna,2169,5,16,5,15,53,52,1,53
Admira Wacke,2169,6,14,8,14,44,53,-9,50
SV Josko Rie,2169,7,14,5,17,39,51,-12,47
RZ Pellets W,2169,8,10,8,18,43,62,-19,38
St. Pölten,2169,9,9,10,17,36,53,-17,37
Mattersburg,2169,10,8,9,19,38,60,-22,33
FC Salzburg,2170,1,23,6,7,70,30,40,75
SC Rheindorf,2170,2,20,6,10,58,43,15,66
SK Sturm Gra,2170,3,19,6,11,55,34,21,63
Vienna,2170,4,19,4,13,61,54,7,61
Rapid Vienna,2170,5,15,11,10,55,38,17,56
Admira Wacke,2170,6,13,4,19,36,55,-19,43
Mattersburg,2170,7,10,8,18,38,55,-17,38
SV Josko Rie,2170,8,10,7,19,33,50,-17,37
St. Pölten,2170,9,9,8,19,42,65,-23,35
RZ Pellets W,2170,10,9,6,21,36,60,-24,33
SK Sturm Gra,2171,1,20,9,7,62,31,31,69
FC Salzburg,2171,2,20,7,9,64,30,34,67
SC Rheindorf,2171,3,18,7,11,50,47,3,61
Vienna,2171,4,18,6,12,62,50,12,60
Rapid Vienna,2171,5,14,12,10,66,48,18,54
RZ Pellets W,2171,6,14,7,15,50,54,-4,49
Admira Wacke,2171,7,11,5,20,39,59,-20,38
Mattersburg,2171,8,10,7,19,39,59,-20,37
St. Pölten,2171,9,8,11,17,39,62,-23,35
SV Josko Rie,2171,10,10,3,23,35,66,-31,33
FC Salzburg,2172,1,23,5,8,71,31,40,74
SC Rheindorf,2172,2,21,7,8,53,38,15,70
SK Sturm Gra,2172,3,19,7,10,58,32,26,64
Vienna,2172,4,15,7,14,57,53,4,52
St. Pölten,2172,5,13,8,15,42,54,-12,47
Rapid Vienna,2172,6,12,10,14,53,49,4,46
SV Josko Rie,2172,7,13,5,18,41,50,-9,44
Admira Wacke,2172,8,13,5,18,37,58,-21,44
RZ Pellets W,2172,9,9,11,16,45,61,-16,38
Mattersburg,2172,10,6,7,23,35,66,-31,25
SC Rheindorf,2173,1,23,8,5,66,35,31,77
FC Salzburg,2173,2,23,6,7,69,31,38,75
SK Sturm Gra,2173,3,18,6,12,59,37,22,60
Rapid Vienna,2173,4,17,9,10,60,40,20,60
Vienna,2173,5,18,5,13,64,56,8,59
RZ Pellets W,2173,6,12,5,19,43,59,-16,41
Admira Wacke,2173,7,11,7,18,40,59,-19,40
Mattersburg,2173,8,10,6,20,36,57,-21,36
SV Josko Rie,2173,9,8,7,21,31,62,-31,31
St. Pölten,2173,10,7,7,22,35,67,-32,28
SC Rheindorf,2174,1,21,9,6,58,37,21,72
SK Sturm Gra,2174,2,21,6,9,64,33,31,69
FC Salzburg,2174,3,19,9,8,58,26,32,66
Vienna,2174,4,20,5,11,58,49,9,65
Rapid Vienna,2174,5,14,10,12,53,39,14,52
Mattersburg,2174,6,11,8,17,41,53,-12,41
Admira Wacke,2174,7,10,7,19,32,56,-24,37
RZ Pellets W,2174,8,10,6,20,44,63,-19,36
SV Josko Rie,2174,9,9,7,20,34,60,-26,34
St. Pölten,2174,10,7,9,20,43,69,-26,30
SK Sturm Gra,2175,1,21,7,8,63,30,33,70
SC Rheindorf,2175,2,19,7,10,52,42,10,64
Vienna,2175,3,19,5,12,62,51,11,62
FC Salzburg,2175,4,17,9,10,64,38,26,60
Rapid Vienna,2175,5,14,12,10,59,42,17,54
SV Josko Rie,2175,6,14,4,18,32,44,-12,46
Admira Wacke,2175,7,12,6,18,41,57,-16,42
Mattersburg,2175,8,11,7,18,33,48,-15,40
RZ Pellets W,2175,9,10,5,21,38,60,-22,35
St. Pölten,2175,10,8,8,20,37,69,-32,32
FC Salzburg,2176,1,22,7,7,66,25,41,73
SK Sturm Gra,2176,2,20,6,10,66,31,35,66
SC Rheindorf,2176,3,18,10,8,54,41,13,64
Vienna,2176,4,18,5,13,63,53,10,59
Admira Wacke,2176,5,13,7,16,39,54,-15,46
Rapid Vienna,2176,6,12,8,16,47,54,-7,44
SV Josko Rie,2176,7,11,7,18,34,52,-18,40
RZ Pellets W,2176,8,10,8,18,44,57,-13,38
Mattersburg,2176,9,10,8,18,36,54,-18,38
St. Pölten,2176,10,7,12,17,36,64,-28,33
FC Salzburg,2177,1,22,6,8,68,31,37,72
SK Sturm Gra,2177,2,22,6,8,63,34,29,72
Vienna,2177,3,20,2,14,67,54,13,62
SC Rheindorf,2177,4,17,8,11,51,45,6,59
RZ Pellets W,2177,5,13,8,15,46,54,-8,47
Admira Wacke,2177,6,14,5,17,38,57,-19,47
Rapid Vienna,2177,7,10,16,10,51,39,12,46
Mattersburg,2177,8,8,10,18,41,60,-19,34
SV Josko Rie,2177,9,10,4,22,35,62,-27,34
St. Pölten,2177,10,7,9,20,43,67,-24,30
FC Salzburg,2178,1,21,8,7,69,32,37,71
SK Sturm Gra,2178,2,18,8,10,59,36,23,62
Vienna,2178,3,17,8,11,61,56,5,59
SC Rheindorf,2178,4,16,6,14,49,44,5,54
Rapid Vienna,2178,5,11,15,10,53,36,17,48
RZ Pellets W,2178,6,12,9,15,48,55,-7,45
Admira Wacke,2178,7,12,7,17,36,57,-21,43
SV Josko Rie,2178,8,12,6,18,37,51,-14,42
St. Pölten,2178,9,10,11,15,44,62,-18,41
Mattersburg,2178,10,8,8,20,40,67,-27,32
FC Salzburg,2179,1,20,10,6,70,34,36,70
Vienna,2179,2,20,6,10,69,56,13,66
SK Sturm Gra,2179,3,19,6,11,60,33,27,63
Rapid Vienna,2179,4,16,10,10,59,43,16,58
SC Rheindorf,2179,5,15,10,11,48,43,5,55
RZ Pellets W,2179,6,11,9,16,49,62,-13,42
SV Josko Rie,2179,7,12,4,20,47,61,-14,40
Admira Wacke,2179,8,11,6,19,36,58,-22,39
St. Pölten,2179,9,10,8,18,44,66,-22,38
Mattersburg,2179,10,7,9,20,33,59,-26,30
FC Salzburg,2180,1,23,7,6,74,30,44,76
SC Rheindorf,2180,2,19,7,10,60,48,12,64
SK Sturm Gra,2180,3,17,7,12,50,37,13,58
Rapid Vienna,2180,4,15,9,12,60,45,15,54
Vienna,2180,5,15,7,14,54,54,0,52
Admira Wacke,2180,6,14,7,15,44,57,-13,49
SV Josko Rie,2180,7,11,8,17,40,56,-16,41
Mattersburg,2180,8,10,8,18,39,57,-18,38
RZ Pellets W,2180,9,10,6,20,45,66,-21,36
St. Pölten,2180,10,8,10,18,44,60,-16,34
FC Salzburg,2181,1,22,5,9,64,38,26,71
Vienna,2181,2,22,5,9,72,48,24,71
SC Rheindorf,2181,3,19,9,8,56,41,15,66
Rapid Vienna,2181,4,17,11,8,65,34,31,62
SK Sturm Gra,2181,5,15,6,15,48,45,3,51
RZ Pellets W,2181,6,12,9,15,45,58,-13,45
St. Pölten,2181,7,11,8,17,45,58,-13,41
Admira Wacke,2181,8,10,8,18,37,59,-22,38
Mattersburg,2181,9,8,8,20,37,56,-19,32
SV Josko Rie,2181,10,6,7,23,28,60,-32,25
FC Salzburg,2182,1,23,5,8,66,28,38,74
SK Sturm Gra,2182,2,21,7,8,60,35,25,70
SC Rheindorf,2182,3,20,6,10,64,46,18,66
Rapid Vienna,2182,4,14,10,12,53,42,11,52
SV Josko Rie,2182,5,13,7,16,35,44,-9,46
Vienna,2182,6,13,5,18,52,60,-8,44
St. Pölten,2182,7,11,9,16,51,65,-14,42
RZ Pellets W,2182,8,10,9,17,42,57,-15,39
Admira Wacke,2182,9,10,9,17,38,61,-23,39
Mattersburg,2182,10,8,7,21,39,62,-23,31
SC Rheindorf,2183,1,23,8,5,64,37,27,77
FC Salzburg,2183,2,20,9,7,67,32,35,69
Vienna,2183,3,20,4,12,63,49,14,64
SK Sturm Gra,2183,4,18,8,10,58,38,20,62
Rapid Vienna,2183,5,12,12,12,59,46,13,48
Admira Wacke,2183,6,12,5,19,42,62,-20,41
RZ Pellets W,2183,7,11,6,19,44,58,-14,39
SV Josko Rie,2183,8,9,9,18,27,50,-23,36
Mattersburg,2183,9,8,8,20,35,59,-24,32
St. Pölten,2183,10,7,11,18,39,67,-28,32
FC Salzburg,2184,1,21,8,7,70,27,43,71
SK Sturm Gra,2184,2,21,6,9,54,27,27,69
SC Rheindorf,2184,3,20,8,8,55,37,18,68
Vienna,2184,4,18,5,13,56,52,4,59
Rapid Vienna,2184,5,12,13,11,61,42,19,49
RZ Pellets W,2184,6,12,7,17,45,60,-15,43
SV Josko Rie,2184,7,13,3,20,30,51,-21,42
Admira Wacke,2184,8,9,10,17,36,59,-23,37
Mattersburg,2184,9,8,8,20,32,57,-25,32
St. Pölten,2184,10,7,10,19,38,65,-27,31
FC Salzburg,2185,1,20,9,7,68,35,33,69
SC Rheindorf,2185,2,19,9,8,63,48,15,66
SK Sturm Gra,2185,3,18,11,7,60,30,30,65
Vienna,2185,4,16,6,14,58,54,4,54
Rapid Vienna,2185,5,14,11,11,58,45,13,53
RZ Pellets W,2185,6,15,6,15,50,52,-2,51
Mattersburg,2185,7,10,8,18,42,57,-15,38
Admira Wacke,2185,8,10,7,19,29,57,-28,37
SV Josko Rie,2185,9,10,5,21,34,59,-25,35
St. Pölten,2185,10,7,10,19,38,63,-25,31
FC Salzburg,2186,1,22,5,9,68,38,30,71
Vienna,2186,2,19,5,12,65,52,13,62
Rapid Vienna,2186,3,16,12,8,57,38,19,60
SC Rheindorf,2186,4,18,6,12,54,43,11,60
SK Sturm Gra,2186,5,17,8,11,57,40,17,59
SV Josko Rie,2186,6,13,4,19,44,62,-18,43
Mattersburg,2186,7,10,8,18,39,50,-11,38
Admira Wacke,2186,8,10,7,19,40,68,-28,37
St. Pölten,2186,9,8,12,16,45,62,-17,36
RZ Pellets W,2186,10,8,11,17,48,64,-16,35
FC Salzburg,2187,1,24,6,6,72,30,42,78
SC Rheindorf,2187,2,20,7,9,55,37,18,67
SK Sturm Gra,2187,3,19,6,11,70,39,31,63
Vienna,2187,4,16,4,16,57,58,-1,52
Admira Wacke,2187,5,12,10,14,40,52,-12,46
Rapid Vienna,2187,6,10,15,11,56,51,5,45
RZ Pellets W,2187,7,13,6,17,48,63,-15,45
St. Pölten,2187,8,11,10,15,50,66,-16,43
SV Josko Rie,2187,9,8,7,21,32,58,-26,31
Mattersburg,2187,10,7,9,20,37,63,-26,30
FC Salzburg,2188,1,22,6,8,70,33,37,72
SC Rheindorf,2188,2,18,8,10,55,42,13,62
Vienna,2188,3,18,5,13,66,58,8,59
SK Sturm Gra,2188,4,14,11,11,52,38,14,53
Rapid Vienna,2188,5,13,10,13,56,46,10,49
RZ Pellets W,2188,6,12,11,13,48,52,-4,47
Admira Wacke,2188,7,12,9,15,42,60,-18,45
St. Pölten,2188,8,12,8,16,45,60,-15,44
SV Josko Rie,2188,9,12,7,17,32,48,-16,43
Mattersburg,2188,10,6,7,23,34,63,-29,25
FC Salzburg,2189,1,23,7,6,69,26,43,76
SK Sturm Gra,2189,2,18,9,9,57,34,23,63
SC Rheindorf,2189,3,18,8,10,54,43,11,62
Vienna,2189,4,17,5,14,62,60,2,56
Rapid Vienna,2189,5,13,13,10,56,39,17,52
SV Josko Rie,2189,6,13,6,17,38,50,-12,45
Admira Wacke,2189,7,11,8,17,43,63,-20,41
RZ Pellets W,2189,8,10,10,16,43,57,-14,40
St. Pölten,2189,9,8,10,18,37,57,-20,34
Mattersburg,2189,10,6,10,20,36,66,-30,28
FC Salzburg,2190,1,22,8,6,78,33,45,74
Vienna,2190,2,20,4,12,66,51,15,64
SC Rheindorf,2190,3,18,9,9,55,46,9,63
SK Sturm Gra,2190,4,17,7,12,56,40,16,58
Rapid Vienna,2190,5,11,12,13,51,43,8,45
Admira Wacke,2190,6,12,8,16,44,61,-17,44
RZ Pellets W,2190,7,11,8,17,39,56,-17,41
St. Pölten,2190,8,9,11,16,40,55,-15,38
SV Josko Rie,2190,9,11,5,20,30,53,-23,38
Mattersburg,2190,10,8,10,18,36,57,-21,34
FC Salzburg,2191,1,19,9,8,66,30,36,66
SK Sturm Gra,2191,2,20,6,10,64,34,30,66
SC Rheindorf,2191,3,19,8,9,60,49,11,65
Rapid Vienna,2191,4,15,10,11,55,38,17,55
Vienna,2191,5,15,9,12,62,55,7,54
SV Josko Rie,2191,6,15,5,16,46,53,-7,50
RZ Pellets W,2191,7,13,6,17,45,56,-11,45
St. Pölten,2191,8,9,9,18,43,68,-25,36
Admira Wacke,2191,9,10,5,21,33,62,-29,35
Mattersburg,2191,10,8,7,21,34,63,-29,31
SK Sturm Gra,2192,1,24,4,8,62,28,34,76
SC Rheindorf,2192,2,22,8,6,65,38,27,74
FC Salzburg,2192,3,19,7,10,61,32,29,64
Vienna,2192,4,18,6,12,55,48,7,60
Rapid Vienna,2192,5,13,10,13,56,48,8,49
Admira Wacke,2192,6,12,6,18,37,53,-16,42
Mattersburg,2192,7,10,7,19,39,53,-14,37
SV Josko Rie,2192,8,10,6,20,33,55,-22,36
St. Pölten,2192,9,9,9,18,40,64,-24,36
RZ Pellets W,2192,10,7,9,20,36,65,-29,30
FC Salzburg,2193,1,20,7,9,63,33,30,67
SK Sturm Gra,2193,2,19,9,8,55,31,24,66
SC Rheindorf,2193,3,18,9,9,56,41,15,63
Vienna,2193,4,19,5,12,64,50,14,62
Rapid Vienna,2193,5,11,15,10,50,40,10,48
Admira Wacke,2193,6,13,7,16,36,49,-13,46
RZ Pellets W,2193,7,11,9,16,42,50,-8,42
SV Josko Rie,2193,8,11,7,18,32,50,-18,40
Mattersburg,2193,9,6,12,18,29,50,-21,30
St. Pölten,2193,10,6,12,18,32,65,-33,30
SK Sturm Gra,2194,1,22,8,6,63,25,38,74
FC Salzburg,2194,2,21,9,6,62,25,37,72
SC Rheindorf,2194,3,21,6,9,54,35,19,69
Vienna,2194,4,18,4,14,61,59,2,58
Rapid Vienna,2194,5,15,11,10,55,33,22,56
RZ Pellets W,2194,6,12,6,18,44,55,-11,42
Admira Wacke,2194,7,11,8,17,37,56,-19,41
SV Josko Rie,2194,8,11,5,20,33,60,-27,38
Mattersburg,2194,9,7,9,20,40,60,-20,30
St. Pölten,2194,10,4,10,22,27,68,-41,22
SK Sturm Gra,2195,1,21,6,9,64,35,29,69
FC Salzburg,2195,2,19,8,9,67,32,35,65
Vienna,2195,3,20,4,12,63,49,14,64
SC Rheindorf,2195,4,17,8,11,54,52,2,59
Rapid Vienna,2195,5,13,11,12,51,44,7,50
Admira Wacke,2195,6,12,9,15,40,54,-14,45
RZ Pellets W,2195,7,13,6,17,44,59,-15,45
SV Josko Rie,2195,8,10,7,19,39,58,-19,37
St. Pölten,2195,9,9,9,18,49,65,-16,36
Mattersburg,2195,10,9,6,21,37,60,-23,33
FC Salzburg,2196,1,22,8,6,66,25,41,74
SC Rheindorf,2196,2,17,12,7,58,47,11,63
SK Sturm Gra,2196,3,18,8,10,58,31,27,62
Vienna,2196,4,17,11,8,72,50,22,62
SV Josko Rie,2196,5,13,6,17,39,55,-16,45
Rapid Vienna,2196,6,10,14,12,50,47,3,44
RZ Pellets W,2196,7,11,8,17,42,52,-10,41
Mattersburg,2196,8,8,12,16,35,50,-15,36
Admira Wacke,2196,9,10,5,21,35,66,-31,35
St. Pölten,2196,10,6,12,18,38,70,-32,30
FC Salzburg,2197,1,24,5,7,66,26,40,77
SC Rheindorf,2197,2,17,10,9,54,42,12,61
SK Sturm Gra,2197,3,16,7,13,52,40,12,55
Vienna,2197,4,16,5,15,55,57,-2,53
Rapid Vienna,2197,5,14,9,13,52,44,8,51
Admira Wacke,2197,6,15,5,16,52,62,-10,50
RZ Pellets W,2197,7,13,7,16,52,53,-1,46
St. Pölten,2197,8,12,9,15,51,65,-14,45
Mattersburg,2197,9,11,7,18,47,60,-13,40
SV Josko Rie,2197,10,8,4,24,27,59,-32,28
FC Salzburg,2198,1,20,10,6,72,31,41,70
SK Sturm Gra,2198,2,20,7,9,67,38,29,67
Vienna,2198,3,20,7,9,58,42,16,67
Rapid Vienna,2198,4,14,11,11,58,40,18,53
SC Rheindorf,2198,5,14,9,13,48,52,-4,51
RZ Pellets W,2198,6,13,10,13,48,53,-5,49
SV Josko Rie,2198,7,11,8,17,34,50,-16,41
Mattersburg,2198,8,9,10,17,38,58,-20,37
Admira Wacke,2198,9,8,7,21,30,64,-34,31
St. Pölten,2198,10,5,13,18,39,64,-25,28
SC Rheindorf,2199,1,21,6,9,64,47,17,69
SK Sturm Gra,2199,2,20,7,9,56,29,27,67
Vienna,2199,3,20,6,10,63,42,21,66
FC Salzburg,2199,4,19,7,10,63,36,27,64
Rapid Vienna,2199,5,12,11,13,45,34,11,47
St. Pölten,2199,6,13,7,16,47,58,-11,46
Admira Wacke,2199,7,12,8,16,36,54,-18,44
RZ Pellets W,2199,8,11,7,18,45,64,-19,40
SV Josko Rie,2199,9,12,3,21,37,56,-19,39
Mattersburg,2199,10,6,6,24,34,70,-36,24
SK Sturm Gra,2200,1,20,5,11,59,44,15,65
SC Rheindorf,2200,2,19,8,9,52,39,13,65
Vienna,2200,3,19,4,13,68,57,11,61
FC Salzburg,2200,4,16,11,9,62,36,26,59
RZ Pellets W,2200,5,17,5,14,66,61,5,56
Rapid Vienna,2200,6,15,10,11,62,48,14,55
SV Josko Rie,2200,7,13,6,17,40,50,-10,45
St. Pölten,2200,8,8,9,19,41,63,-22,33
Admira Wacke,2200,9,9,6,21,38,71,-33,33
Mattersburg,2200,10,7,10,19,36,55,-19,31
SC Rheindorf,2201,1,21,8,7,66,43,23,71
SK Sturm Gra,2201,2,19,7,10,62,38,24,64
FC Salzburg,2201,3,17,10,9,57,36,21,61
Rapid Vienna,2201,4,13,14,9,52,37,15,53
Vienna,2201,5,16,4,16,63,61,2,52
Admira Wacke,2201,6,15,4,17,46,59,-13,49
St. Pölten,2201,7,11,8,17,48,69,-21,41
Mattersburg,2201,8,11,6,19,38,54,-16,39
SV Josko Rie,2201,9,11,4,21,31,48,-17,37
RZ Pellets W,2201,10,10,7,19,42,60,-18,37
FC Salzburg,2202,1,23,7,6,67,25,42,76
SK Sturm Gra,2202,2,20,7,9,62,35,27,67
SC Rheindorf,2202,3,19,9,8,52,41,11,66
Vienna,2202,4,18,9,9,59,48,11,63
Rapid Vienna,2202,5,15,11,10,53,37,16,56
RZ Pellets W,2202,6,12,10,14,41,49,-8,46
Admira Wacke,2202,7,11,6,19,35,51,-16,39
St. Pölten,2202,8,9,7,20,42,65,-23,34
SV Josko Rie,2202,9,7,6,23,26,57,-31,27
Mattersburg,2202,10,6,8,22,27,56,-29,26
FC Salzburg,2203,1,21,7,8,67,32,35,70
Vienna,2203,2,21,5,10,64,53,11,68
SC Rheindorf,2203,3,20,7,9,61,43,18,67
SK Sturm Gra,2203,4,18,4,14,53,33,20,58
Rapid Vienna,2203,5,14,10,12,54,40,14,52
RZ Pellets W,2203,6,13,5,18,50,62,-12,44
Admira Wacke,2203,7,12,4,20,36,62,-26,40
St. Pölten,2203,8,10,9,17,43,63,-20,39
Mattersburg,2203,9,10,7,19,37,53,-16,37
SV Josko Rie,2203,10,7,10,19,37,61,-24,31
SK Sturm Gra,2204,1,22,5,9,66,35,31,71
FC Salzburg,2204,2,18,12,6,58,23,35,66
SC Rheindorf,2204,3,17,7,12,50,43,7,58
RZ Pellets W,2204,4,15,10,11,57,56,1,55
Vienna,2204,5,17,4,15,61,63,-2,55
Rapid Vienna,2204,6,14,11,11,61,46,15,53
Admira Wacke,2204,7,12,7,17,41,59,-18,43
Mattersburg,2204,8,7,12,17,36,53,-17,33
SV Josko Rie,2204,9,8,8,20,36,59,-23,32
St. Pölten,2204,10,6,12,18,41,70,-29,30
FC Salzburg,2205,1,24,6,6,63,23,40,78
SC Rheindorf,2205,2,20,6,10,56,47,9,66
SK Sturm Gra,2205,3,18,10,8,65,35,30,64
Vienna,2205,4,18,4,14,63,53,10,58
Rapid Vienna,2205,5,13,11,12,58,49,9,50
Admira Wacke,2205,6,12,8,16,42,58,-16,44
SV Josko Rie,2205,7,12,5,19,37,53,-16,41
RZ Pellets W,2205,8,10,9,17,42,57,-15,39
St. Pölten,2205,9,9,7,20,38,63,-25,34
Mattersburg,2205,10,6,10,20,38,64,-26,28
FC Salzburg,2206,1,22,7,7,75,34,41,73
SC Rheindorf,2206,2,20,8,8,57,41,16,68
Vienna,2206,3,19,7,10,61,50,11,64
SK Sturm Gra,2206,4,17,11,8,51,29,22,62
Rapid Vienna,2206,5,12,15,9,60,46,14,51
SV Josko Rie,2206,6,11,6,19,34,51,-17,39
Admira Wacke,2206,7,10,9,17,40,64,-24,39
RZ Pellets W,2206,8,10,8,18,43,57,-14,38
Mattersburg,2206,9,8,8,20,41,64,-23,32
St. Pölten,2206,10,5,13,18,37,63,-26,28
FC Salzburg,2207,1,22,7,7,69,30,39,73
SC Rheindorf,2207,2,21,8,7,61,41,20,71
SK Sturm Gra,2207,3,19,7,10,55,31,24,64
Vienna,2207,4,19,7,10,64,46,18,64
Rapid Vienna,2207,5,12,14,10,51,39,12,50
RZ Pellets W,2207,6,12,5,19,40,58,-18,41
Admira Wacke,2207,7,10,8,18,34,60,-26,38
SV Josko Rie,2207,8,9,7,20,32,54,-22,34
St. Pölten,2207,9,7,11,18,41,67,-26,32
Mattersburg,2207,10,7,10,19,35,56,-21,31
FC Salzburg,2208,1,20,11,5,76,34,42,71
Vienna,2208,2,18,8,10,64,54,10,62
SC Rheindorf,2208,3,18,7,11,53,47,6,61
SK Sturm Gra,2208,4,17,7,12,55,37,18,58
Rapid Vienna,2208,5,15,12,9,61,39,22,57
SV Josko Rie,2208,6,12,6,18,41,56,-15,42
Admira Wacke,2208,7,10,8,18,37,62,-25,38
RZ Pellets W,2208,8,9,9,18,40,60,-20,36
St. Pölten,2208,9,8,11,17,42,64,-22,35
Mattersburg,2208,10,7,13,16,37,53,-16,34
FC Salzburg,2209,1,22,8,6,67,32,35,74
SC Rheindorf,2209,2,20,7,9,59,37,22,67
Vienna,2209,3,18,8,10,65,56,9,62
SK Sturm Gra,2209,4,18,6,12,59,40,19,60
Rapid Vienna,2209,5,14,7,15,59,51,8,49
Admira Wacke,2209,6,12,6,18,38,61,-23,42
RZ Pellets W,2209,7,9,11,16,46,60,-14,38
SV Josko Rie,2209,8,10,7,19,36,55,-19,37
Mattersburg,2209,9,9,9,18,44,58,-14,36
St. Pölten,2209,10,8,11,17,35,58,-23,35
FC Salzburg,2210,1,21,9,6,71,30,41,72
SC Rheindorf,2210,2,19,8,9,58,43,15,65
SK Sturm Gra,2210,3,16,8,12,61,46,15,56
Vienna,2210,4,17,5,14,57,56,1,56
Rapid Vienna,2210,5,14,13,9,52,36,16,55
SV Josko Rie,2210,6,14,3,19,33,47,-14,45
RZ Pellets W,2210,7,12,6,18,46,60,-14,42
Admira Wacke,2210,8,10,9,17,41,61,-20,39
Mattersburg,2210,9,9,9,18,43,57,-14,36
St. Pölten,2210,10,8,10,18,39,65,-26,34
FC Salzburg,2211,1,21,8,7,63,31,32,71
SK Sturm Gra,2211,2,20,8,8,60,29,31,68
SC Rheindorf,2211,3,18,8,10,56,46,10,62
Vienna,2211,4,18,6,12,64,52,12,60
Rapid Vienna,2211,5,13,13,10,56,44,12,52
Admira Wacke,2211,6,13,7,16,35,53,-18,46
SV Josko Rie,2211,7,11,6,19,38,54,-16,39
RZ Pellets W,2211,8,10,8,18,47,62,-15,38
Mattersburg,2211,9,8,10,18,40,58,-18,34
St. Pölten,2211,10,6,10,20,38,68,-30,28
SC Rheindorf,2212,1,23,6,7,61,43,18,75
SK Sturm Gra,2212,2,19,7,10,64,33,31,64
FC Salzburg,2212,3,18,8,10,62,35,27,62
Vienna,2212,4,17,7,12,68,59,9,58
Rapid Vienna,2212,5,12,12,12,47,41,6,48
Admira Wacke,2212,6,13,5,18,38,59,-21,44
RZ Pellets W,2212,7,11,6,19,43,61,-18,39
St. Pölten,2212,8,9,11,16,48,67,-19,38
SV Josko Rie,2212,9,11,5,20,29,52,-23,38
Mattersburg,2212,10,9,9,18,42,52,-10,36
FC Salzburg,2213,1,22,7,7,66,31,35,73
SK Sturm Gra,2213,2,21,4,11,60,43,17,67
SC Rheindorf,2213,3,20,6,10,60,45,15,66
Vienna,2213,4,19,4,13,66,47,19,61
Rapid Vienna,2213,5,15,8,13,55,38,17,53
RZ Pellets W,2213,6,11,9,16,47,60,-13,42
St. Pölten,2213,7,10,10,16,39,57,-18,40
SV Josko Rie,2213,8,11,5,20,41,60,-19,38
Admira Wacke,2213,9,9,6,21,30,64,-34,33
Mattersburg,2213,10,7,11,18,36,55,-19,32
FC Salzburg,2214,1,21,9,6,66,31,35,72
SC Rheindorf,2214,2,21,8,7,61,44,17,71
SK Sturm Gra,2214,3,19,7,10,59,35,24,64
Vienna,2214,4,16,5,15,60,57,3,53
Admira Wacke,2214,5,13,8,15,45,56,-11,47
Rapid Vienna,2214,6,11,10,15,47,47,0,43
RZ Pellets W,2214,7,11,9,16,42,52,-10,42
St. Pölten,2214,8,9,11,16,45,60,-15,38
SV Josko Rie,2214,9,10,7,19,44,66,-22,37
Mattersburg,2214,10,8,8,20,39,60,-21,32
SC Rheindorf,2215,1,20,7,9,57,37,20,67
FC Salzburg,2215,2,20,6,10,61,32,29,66
SK Sturm Gra,2215,3,19,9,8,64,37,27,66
Vienna,2215,4,19,6,11,65,50,15,63
Rapid Vienna,2215,5,13,11,12,54,45,9,50
RZ Pellets W,2215,6,12,8,16,46,56,-10,44
Admira Wacke,2215,7,12,8,16,41,53,-12,44
Mattersburg,2215,8,8,10,18,33,57,-24,34
SV Josko Rie,2215,9,8,8,20,33,57,-24,32
St. Pölten,2215,10,7,11,18,37,67,-30,32
SC Rheindorf,2216,1,23,7,6,64,34,30,76
FC Salzburg,2216,2,21,7,8,65,32,33,70
SK Sturm Gra,2216,3,20,7,9,65,37,28,67
Vienna,2216,4,17,5,14,52,51,1,56
Rapid Vienna,2216,5,14,10,12,59,39,20,52
RZ Pellets W,2216,6,11,9,16,42,59,-17,42
Admira Wacke,2216,7,10,9,17,31,53,-22,39
SV Josko Rie,2216,8,11,3,22,31,56,-25,36
Mattersburg,2216,9,9,8,19,37,56,-19,35
St. Pölten,2216,10,8,7,21,41,70,-29,31
FC Salzburg,2217,1,22,8,6,67,29,38,74
SC Rheindorf,2217,2,20,5,11,58,49,9,65
Vienna,2217,3,18,7,11,66,50,16,61
SK Sturm Gra,2217,4,18,5,13,56,40,16,59
Rapid Vienna,2217,5,14,12,10,60,42,18,54
SV Josko Rie,2217,6,13,7,16,39,48,-9,46
RZ Pellets W,2217,7,11,11,14,45,56,-11,44
Admira Wacke,2217,8,9,8,19,37,59,-22,35
St. Pölten,2217,9,7,10,19,35,67,-32,31
Mattersburg,2217,10,7,9,20,38,61,-23,30
FC Salzburg,2218,1,22,8,6,65,29,36,74
SK Sturm Gra,2218,2,20,5,11,59,37,22,65
Vienna,2218,3,19,7,10,67,47,20,64
Rapid Vienna,2218,4,13,12,11,58,42,16,51
SC Rheindorf,2218,5,14,8,14,46,49,-3,50
Admira Wacke,2218,6,13,6,17,39,57,-18,45
RZ Pellets W,2218,7,12,8,16,37,48,-11,44
SV Josko Rie,2218,8,11,4,21,34,56,-22,37
St. Pölten,2218,9,9,10,17,41,65,-24,37
Mattersburg,2218,10,8,10,18,40,56,-16,34
FC Salzburg,2219,1,19,8,9,67,36,31,65
SK Sturm Gra,2219,2,17,10,9,54,34,20,61
Rapid Vienna,2219,3,17,9,10,64,40,24,60
SC Rheindorf,2219,4,17,8,11,55,45,10,59
Vienna,2219,5,16,4,16,58,58,0,52
Admira Wacke,2219,6,15,6,15,48,54,-6,51
RZ Pellets W,2219,7,14,8,14,54,59,-5,50
St. Pölten,2219,8,12,8,16,44,58,-14,44
SV Josko Rie,2219,9,10,4,22,33,62,-29,34
Mattersburg,2219,10,7,7,22,34,65,-31,28
FC Salzburg,2220,1,21,8,7,66,32,34,71
SC Rheindorf,2220,2,19,7,10,54,43,11,64
SK Sturm Gra,2220,3,19,6,11,59,37,22,63
Vienna,2220,4,18,5,13,66,62,4,59
Rapid Vienna,2220,5,14,12,10,58,41,17,54
RZ Pellets W,2220,6,14,6,16,56,62,-6,48
St. Pölten,2220,7,12,8,16,46,60,-14,44
Admira Wacke,2220,8,9,9,18,38,62,-24,36
Mattersburg,2220,9,7,11,18,34,52,-18,32
SV Josko Rie,2220,10,7,8,21,36,62,-26,29
FC Salzburg,2221,1,20,9,7,64,27,37,69
SC Rheindorf,2221,2,20,7,9,56,41,15,67
SK Sturm Gra,2221,3,18,8,10,57,36,21,62
Vienna,2221,4,19,5,12,61,45,16,62
Rapid Vienna,2221,5,14,13,9,53,37,16,55
RZ Pellets W,2221,6,12,8,16,44,54,-10,44
SV Josko Rie,2221,7,12,6,18,36,55,-19,42
Admira Wacke,2221,8,11,5,20,34,58,-24,38
St. Pölten,2221,9,8,10,18,41,63,-22,34
Mattersburg,2221,10,6,9,21,27,57,-30,27
FC Salzburg,2222,1,23,5,8,67,26,41,74
SC Rheindorf,2222,2,19,9,8,60,39,21,66
Vienna,2222,3,20,5,11,67,52,15,65
SK Sturm Gra,2222,4,18,8,10,57,37,20,62
Rapid Vienna,2222,5,13,8,15,47,41,6,47
SV Josko Rie,2222,6,14,5,17,38,55,-17,47
RZ Pellets W,2222,7,12,10,14,46,50,-4,46
Admira Wacke,2222,8,10,5,21,39,71,-32,35
Mattersburg,2222,9,7,10,19,36,53,-17,31
St. Pölten,2222,10,6,11,19,30,63,-33,29
FC Salzburg,2223,1,22,6,8,72,32,40,72
SC Rheindorf,2223,2,19,8,9,60,45,15,65
SK Sturm Gra,2223,3,19,6,11,59,35,24,63
Vienna,2223,4,17,7,12,62,55,7,58
Rapid Vienna,2223,5,15,9,12,58,44,14,54
RZ Pellets W,2223,6,12,6,18,53,67,-14,42
Admira Wacke,2223,7,11,9,16,40,59,-19,42
St. Pölten,2223,8,11,8,17,44,62,-18,41
SV Josko Rie,2223,9,11,5,20,39,55,-16,38
Mattersburg,2223,10,7,8,21,34,67,-33,29
SK Sturm Gra,2224,1,22,5,9,67,29,38,71
FC Salzburg,2224,2,20,7,9,59,29,30,67
SC Rheindorf,2224,3,20,7,9,54,38,16,67
Vienna,2224,4,19,4,13,57,50,7,61
Rapid Vienna,2224,5,14,13,9,57,38,19,55
RZ Pellets W,2224,6,13,8,15,42,52,-10,47
Mattersburg,2224,7,9,11,16,36,55,-19,38
Admira Wacke,2224,8,9,7,20,27,59,-32,34
St. Pölten,2224,9,8,8,20,43,66,-23,32
SV Josko Rie,2224,10,6,10,20,27,53,-26,28
FC Salzburg,2225,1,21,7,8,67,32,35,70
SC Rheindorf,2225,2,20,8,8,58,37,21,68
Rapid Vienna,2225,3,17,11,8,60,35,25,62
SK Sturm Gra,2225,4,18,6,12,61,34,27,60
Vienna,2225,5,18,5,13,58,58,0,59
RZ Pellets W,2225,6,11,10,15,46,55,-9,43
Admira Wacke,2225,7,12,6,18,38,64,-26,42
Mattersburg,2225,8,10,9,17,38,51,-13,39
SV Josko Rie,2225,9,8,5,23,36,64,-28,29
St. Pölten,2225,10,6,11,19,36,68,-32,29
SC Rheindorf,2226,1,19,10,7,59,43,16,67
SK Sturm Gra,2226,2,18,7,11,67,37,30,61
FC Salzburg,2226,3,18,7,11,56,31,25,61
Vienna,2226,4,17,4,15,58,61,-3,55
Rapid Vienna,2226,5,14,11,11,57,37,20,53
RZ Pellets W,2226,6,14,10,12,49,44,5,52
Admira Wacke,2226,7,13,8,15,36,59,-23,47
Mattersburg,2226,8,9,9,18,31,51,-20,36
St. Pölten,2226,9,9,8,19,42,68,-26,35
SV Josko Rie,2226,10,10,4,22,30,54,-24,34
SK Sturm Gra,2227,1,22,7,7,63,32,31,73
FC Salzburg,2227,2,21,9,6,63,29,34,72
SC Rheindorf,2227,3,20,5,11,50,37,13,65
Vienna,2227,4,19,3,14,58,54,4,60
Rapid Vienna,2227,5,14,9,13,54,38,16,51
RZ Pellets W,2227,6,12,7,17,45,56,-11,43
SV Josko Rie,2227,7,11,5,20,37,53,-16,38
St. Pölten,2227,8,10,8,18,40,61,-21,38
Admira Wacke,2227,9,11,5,20,36,59,-23,38
Mattersburg,2227,10,6,10,20,31,58,-27,28
FC Salzburg,2228,1,23,7,6,69,26,43,76
SC Rheindorf,2228,2,21,7,8,55,37,18,70
SK Sturm Gra,2228,3,20,7,9,62,37,25,67
Vienna,2228,4,17,4,15,57,52,5,55
Rapid Vienna,2228,5,13,13,10,54,41,13,52
Admira Wacke,2228,6,12,8,16,42,61,-19,44
St. Pölten,2228,7,8,11,17,39,61,-22,35
Mattersburg,2228,8,8,10,18,39,56,-17,34
SV Josko Rie,2228,9,8,9,19,38,61,-23,33
RZ Pellets W,2228,10,9,6,21,33,56,-23,33
FC Salzburg,2229,1,19,10,7,62,29,33,67
SK Sturm Gra,2229,2,19,8,9,64,36,28,65
Rapid Vienna,2229,3,14,12,10,60,41,19,54
Vienna,2229,4,16,6,14,66,61,5,54
RZ Pellets W,2229,5,15,9,12,52,48,4,54
SC Rheindorf,2229,6,14,9,13,40,44,-4,51
SV Josko Rie,2229,7,13,7,16,38,49,-11,46
Mattersburg,2229,8,11,8,17,36,52,-16,41
Admira Wacke,2229,9,9,8,19,31,64,-33,35
St. Pölten,2229,10,6,11,19,35,60,-25,29
SC Rheindorf,2230,1,21,7,8,54,36,18,70
SK Sturm Gra,2230,2,19,9,8,58,28,30,66
FC Salzburg,2230,3,19,7,10,56,32,24,64
Vienna,2230,4,19,6,11,66,53,13,63
Rapid Vienna,2230,5,10,15,11,49,43,6,45
RZ Pellets W,2230,6,11,8,17,45,55,-10,41
Admira Wacke,2230,7,11,7,18,37,58,-21,40
Mattersburg,2230,8,10,8,18,38,54,-16,38
St. Pölten,2230,9,9,9,18,41,67,-26,36
SV Josko Rie,2230,10,9,8,19,34,52,-18,35
SK Sturm Gra,2231,1,19,8,9,68,37,31,65
FC Salzburg,2231,2,19,8,9,58,33,25,65
SC Rheindorf,2231,3,19,7,10,60,45,15,64
Vienna,2231,4,18,6,12,57,47,10,60
Rapid Vienna,2231,5,12,12,12,57,43,14,48
Admira Wacke,2231,6,14,5,17,38,61,-23,47
Mattersburg,2231,7,10,10,16,45,57,-12,40
St. Pölten,2231,8,10,10,16,46,59,-13,40
SV Josko Rie,2231,9,10,7,19,31,52,-21,37
RZ Pellets W,2231,10,9,7,20,42,68,-26,34
FC Salzburg,2232,1,21,9,6,74,32,42,72
SK Sturm Gra,2232,2,20,6,10,63,37,26,66
SC Rheindorf,2232,3,18,9,9,57,46,11,63
Vienna,2232,4,18,3,15,64,66,-2,57
Rapid Vienna,2232,5,12,13,11,53,41,12,49
RZ Pellets W,2232,6,13,7,16,47,56,-9,46
Admira Wacke,2232,7,12,6,18,46,63,-17,42
Mattersburg,2232,8,11,7,18,45,60,-15,40
SV Josko Rie,2232,9,11,5,20,35,58,-23,38
St. Pölten,2232,10,6,11,19,37,62,-25,29
SK Sturm Gra,2233,1,22,6,8,58,31,27,72
FC Salzburg,2233,2,20,8,8,65,34,31,68
SC Rheindorf,2233,3,19,8,9,55,42,13,65
Vienna,2233,4,19,7,10,67,52,15,64
Rapid Vienna,2233,5,13,10,13,57,41,16,49
SV Josko Rie,2233,6,13,5,18,38,48,-10,44
RZ Pellets W,2233,7,11,9,16,48,60,-12,42
St. Pölten,2233,8,9,10,17,41,66,-25,37
Admira Wacke,2233,9,8,9,19,28,57,-29,33
Mattersburg,2233,10,6,8,22,33,59,-26,26
FC Salzburg,2234,1,19,9,8,58,29,29,66
SC Rheindorf,2234,2,19,8,9,56,44,12,65
Vienna,2234,3,19,7,10,68,49,19,64
SK Sturm Gra,2234,4,19,5,12,61,36,25,62
Rapid Vienna,2234,5,15,12,9,58,38,20,57
RZ Pellets W,2234,6,12,9,15,46,53,-7,45
SV Josko Rie,2234,7,11,6,19,34,49,-15,39
Admira Wacke,2234,8,11,6,19,34,61,-27,39
Mattersburg,2234,9,9,7,20,37,59,-22,34
St. Pölten,2234,10,8,7,21,36,70,-34,31
FC Salzburg,2235,1,21,9,6,62,32,30,72
SC Rheindorf,2235,2,22,6,8,67,44,23,72
Vienna,2235,3,20,5,11,71,58,13,65
Rapid Vienna,2235,4,14,13,9,59,37,22,55
SK Sturm Gra,2235,5,16,7,13,55,39,16,55
St. Pölten,2235,6,10,10,16,38,54,-16,40
RZ Pellets W,2235,7,10,10,16,45,64,-19,40
Admira Wacke,2235,8,10,7,19,41,62,-21,37
Mattersburg,2235,9,7,10,19,38,60,-22,31
SV Josko Rie,2235,10,7,9,20,30,56,-26,30
FC Salzburg,2236,1,23,7,6,72,28,44,76
Vienna,2236,2,20,5,11,69,51,18,65
SK Sturm Gra,2236,3,18,8,10,62,41,21,62
SC Rheindorf,2236,4,17,9,10,52,45,7,60
St. Pölten,2236,5,14,10,12,52,53,-1,52
Admira Wacke,2236,6,13,5,18,34,61,-27,44
Rapid Vienna,2236,7,10,11,15,48,43,5,41
RZ Pellets W,2236,8,11,8,17,46,63,-17,41
SV Josko Rie,2236,9,8,6,22,26,51,-25,30
Mattersburg,2236,10,6,11,19,35,60,-25,29
SK Sturm Gra,2237,1,20,7,9,66,37,29,67
FC Salzburg,2237,2,18,12,6,69,38,31,66
Vienna,2237,3,18,6,12,59,48,11,60
SC Rheindorf,2237,4,17,9,10,52,44,8,60
RZ Pellets W,2237,5,16,6,14,57,58,-1,54
Rapid Vienna,2237,6,12,14,10,54,38,16,50
Admira Wacke,2237,7,11,5,20,37,64,-27,38
St. Pölten,2237,8,9,10,17,34,55,-21,37
Mattersburg,2237,9,8,9,19,34,58,-24,33
SV Josko Rie,2237,10,8,8,20,31,53,-22,32
SC Rheindorf,2238,1,25,5,6,63,36,27,80
FC Salzburg,2238,2,21,8,7,68,29,39,71
SK Sturm Gra,2238,3,21,4,11,59,36,23,67
Rapid Vienna,2238,4,16,11,9,63,39,24,59
Vienna,2238,5,15,7,14,51,55,-4,52
RZ Pellets W,2238,6,13,7,16,49,54,-5,46
Admira Wacke,2238,7,11,7,18,41,63,-22,40
SV Josko Rie,2238,8,10,6,20,37,53,-16,36
St. Pölten,2238,9,7,7,22,39,74,-35,28
Mattersburg,2238,10,7,6,23,31,62,-31,27
FC Salzburg,2239,1,21,7,8,66,33,33,70
SC Rheindorf,2239,2,19,10,7,59,39,20,67
Vienna,2239,3,19,5,12,66,52,14,62
SK Sturm Gra,2239,4,19,4,13,59,33,26,61
Rapid Vienna,2239,5,18,7,11,58,37,21,61
RZ Pellets W,2239,6,13,9,14,45,53,-8,48
SV Josko Rie,2239,7,12,4,20,40,60,-20,40
Admira Wacke,2239,8,11,7,18,39,59,-20,40
Mattersburg,2239,9,7,9,20,35,60,-25,30
St. Pölten,2239,10,6,8,22,36,77,-41,26
FC Salzburg,2240,1,22,7,7,59,24,35,73
SK Sturm Gra,2240,2,20,6,10,60,36,24,66
Vienna,2240,3,19,5,12,68,52,16,62
SC Rheindorf,2240,4,18,7,11,48,49,-1,61
Rapid Vienna,2240,5,15,12,9,57,37,20,57
Mattersburg,2240,6,11,11,14,44,50,-6,44
Admira Wacke,2240,7,10,9,17,37,58,-21,39
RZ Pellets W,2240,8,9,9,18,39,57,-18,36
St. Pölten,2240,9,8,8,20,36,60,-24,32
SV Josko Rie,2240,10,8,6,22,29,54,-25,30
FC Salzburg,2241,1,21,8,7,65,28,37,71
SC Rheindorf,2241,2,20,8,8,59,47,12,68
SK Sturm Gra,2241,3,20,7,9,65,36,29,67
Vienna,2241,4,21,4,11,72,51,21,67
Rapid Vienna,2241,5,11,12,13,48,42,6,45
RZ Pellets W,2241,6,13,4,19,42,57,-15,43
SV Josko Rie,2241,7,13,3,20,34,54,-20,42
Admira Wacke,2241,8,10,8,18,35,63,-28,38
St. Pölten,2241,9,9,8,19,38,59,-21,35
Mattersburg,2241,10,7,8,21,36,57,-21,29
FC Salzburg,2242,1,22,5,9,65,34,31,71
SC Rheindorf,2242,2,19,9,8,54,39,15,66
SK Sturm Gra,2242,3,19,8,9,55,30,25,65
Vienna,2242,4,17,3,16,64,60,4,54
RZ Pellets W,2242,5,15,6,15,44,48,-4,51
Rapid Vienna,2242,6,12,11,13,52,41,11,47
St. Pölten,2242,7,11,10,15,41,55,-14,43
Admira Wacke,2242,8,12,7,17,39,57,-18,43
SV Josko Rie,2242,9,9,7,20,33,59,-26,34
Mattersburg,2242,10,6,10,20,32,56,-24,28
FC Salzburg,2243,1,22,8,6,73,29,44,74
SK Sturm Gra,2243,2,18,10,8,64,37,27,64
SC Rheindorf,2243,3,17,9,10,55,46,9,60
Vienna,2243,4,16,5,15,58,61,-3,53
Rapid Vienna,2243,5,14,9,13,59,43,16,51
RZ Pellets W,2243,6,13,7,16,51,64,-13,46
Admira Wacke,2243,7,13,5,18,41,59,-18,44
Mattersburg,2243,8,12,7,17,43,58,-15,43
SV Josko Rie,2243,9,10,5,21,32,53,-21,35
St. Pölten,2243,10,7,11,18,39,65,-26,32
FC Salzburg,2244,1,21,7,8,62,31,31,70
SK Sturm Gra,2244,2,21,5,10,62,35,27,68
Vienna,2244,3,21,4,11,74,49,25,67
SC Rheindorf,2244,4,17,7,12,52,41,11,58
Rapid Vienna,2244,5,12,10,14,60,48,12,46
RZ Pellets W,2244,6,12,8,16,49,58,-9,44
SV Josko Rie,2244,7,13,4,19,37,52,-15,43
Admira Wacke,2244,8,11,9,16,36,62,-26,42
Mattersburg,2244,9,9,10,17,38,57,-19,37
St. Pölten,2244,10,8,6,22,33,70,-37,30
FC Salzburg,2245,1,21,9,6,63,24,39,72
Vienna,2245,2,20,7,9,60,42,18,67
SC Rheindorf,2245,3,19,9,8,50,40,10,66
SK Sturm Gra,2245,4,17,6,13,58,40,18,57
Rapid Vienna,2245,5,12,14,10,57,41,16,50
Mattersburg,2245,6,11,9,16,41,52,-11,42
RZ Pellets W,2245,7,11,7,18,38,55,-17,40
SV Josko Rie,2245,8,10,6,20,36,59,-23,36
Admira Wacke,2245,9,8,10,18,38,66,-28,34
St. Pölten,2245,10,8,9,19,38,60,-22,33
SC Rheindorf,2246,1,22,7,7,61,39,22,73
FC Salzburg,2246,2,20,10,6,64,31,33,70
Vienna,2246,3,20,3,13,64,54,10,63
SK Sturm Gra,2246,4,18,8,10,57,34,23,62
Rapid Vienna,2246,5,14,10,12,51,40,11,52
RZ Pellets W,2246,6,13,8,15,46,52,-6,47
Admira Wacke,2246,7,10,6,20,34,63,-29,36
Mattersburg,2246,8,8,10,18,40,57,-17,34
St. Pölten,2246,9,8,10,18,36,61,-25,34
SV Josko Rie,2246,10,9,4,23,38,60,-22,31
FC Salzburg,2247,1,22,6,8,61,26,35,72
SC Rheindorf,2247,2,20,8,8,59,42,17,68
SK Sturm Gra,2247,3,21,4,11,59,34,25,67
Rapid Vienna,2247,4,15,10,11,60,41,19,55
Vienna,2247,5,15,4,17,51,59,-8,49
RZ Pellets W,2247,6,13,7,16,46,53,-7,46
Admira Wacke,2247,7,13,4,19,38,64,-26,43
SV Josko Rie,2247,8,12,3,21,37,55,-18,39
Mattersburg,2247,9,9,10,17,39,52,-13,37
St. Pölten,2247,10,8,8,20,39,63,-24,32
FC Salzburg,2248,1,24,7,5,75,31,44,79
SC Rheindorf,2248,2,19,8,9,53,41,12,65
SK Sturm Gra,2248,3,15,11,10,54,36,18,56
Vienna,2248,4,15,7,14,60,59,1,52
Rapid Vienna,2248,5,13,12,11,54,38,16,51
St. Pölten,2248,6,12,8,16,41,58,-17,44
RZ Pellets W,2248,7,11,9,16,45,55,-10,42
Admira Wacke,2248,8,11,5,20,37,61,-24,38
Mattersburg,2248,9,9,10,17,42,55,-13,37
SV Josko Rie,2248,10,9,7,20,32,59,-27,34
FC Salzburg,2249,1,23,5,8,72,30,42,74
SK Sturm Gra,2249,2,21,6,9,59,31,28,69
SC Rheindorf,2249,3,18,9,9,49,40,9,63
Vienna,2249,4,18,5,13,60,47,13,59
Rapid Vienna,2249,5,12,12,12,55,44,11,48
RZ Pellets W,2249,6,13,8,15,44,52,-8,47
Mattersburg,2249,7,12,7,17,36,57,-21,43
St. Pölten,2249,8,10,9,17,42,61,-19,39
SV Josko Rie,2249,9,9,5,22,31,52,-21,32
Admira Wacke,2249,10,8,6,22,31,65,-34,30
FC Salzburg,2250,1,23,8,5,72,30,42,77
SC Rheindorf,2250,2,21,8,7,52,38,14,71
SK Sturm Gra,2250,3,17,7,12,56,39,17,58
Vienna,2250,4,18,3,15,61,54,7,57
Rapid Vienna,2250,5,12,12,12,56,46,10,48
RZ Pellets W,2250,6,12,11,13,46,55,-9,47
Mattersburg,2250,7,11,8,17,44,60,-16,41
St. Pölten,2250,8,8,11,17,46,63,-17,35
SV Josko Rie,2250,9,10,4,22,36,55,-19,34
Admira Wacke,2250,10,8,8,20,27,56,-29,32
SC Rheindorf,2251,1,22,8,6,57,32,25,74
FC Salzburg,2251,2,22,4,10,62,36,26,70
SK Sturm Gra,2251,3,20,8,8,58,32,26,68
Vienna,2251,4,16,6,14,59,60,-1,54
Rapid Vienna,2251,5,14,10,12,51,35,16,52
RZ Pellets W,2251,6,12,6,18,49,60,-11,42
Admira Wacke,2251,7,11,6,19,40,58,-18,39
St. Pölten,2251,8,9,11,16,39,60,-21,38
SV Josko Rie,2251,9,10,6,20,32,53,-21,36
Mattersburg,2251,10,8,7,21,41,62,-21,31
SC Rheindorf,2252,1,21,7,8,53,38,15,70
FC Salzburg,2252,2,21,6,9,64,31,33,69
Vienna,2252,3,20,5,11,58,46,12,65
SK Sturm Gra,2252,4,18,9,9,56,32,24,63
Rapid Vienna,2252,5,14,9,13,55,39,16,51
RZ Pellets W,2252,6,13,9,14,42,50,-8,48
Admira Wacke,2252,7,10,6,20,35,64,-29,36
St. Pölten,2252,8,8,11,17,48,66,-18,35
Mattersburg,2252,9,7,11,18,34,55,-21,32
SV Josko Rie,2252,10,9,5,22,37,61,-24,32
SC Rheindorf,2253,1,20,8,8,60,45,15,68
SK Sturm Gra,2253,2,19,8,9,58,37,21,65
FC Salzburg,2253,3,19,5,12,64,41,23,62
Rapid Vienna,2253,4,17,9,10,69,43,26,60
Vienna,2253,5,16,7,13,60,58,2,55
RZ Pellets W,2253,6,15,7,14,48,50,-2,52
Admira Wacke,2253,7,12,7,17,42,58,-16,43
SV Josko Rie,2253,8,10,7,19,39,54,-15,37
Mattersburg,2253,9,7,9,20,34,58,-24,30
St. Pölten,2253,10,7,9,20,36,66,-30,30
FC Salzburg,2254,1,19,8,9,61,31,30,65
Rapid Vienna,2254,2,19,8,9,68,39,29,65
SK Sturm Gra,2254,3,19,8,9,53,30,23,65
SC Rheindorf,2254,4,16,8,12,50,45,5,56
Vienna,2254,5,17,4,15,59,57,2,55
Admira Wacke,2254,6,12,7,17,38,57,-19,43
SV Josko Rie,2254,7,11,9,16,39,51,-12,42
RZ Pellets W,2254,8,11,9,16,41,56,-15,42
St. Pölten,2254,9,10,8,18,43,59,-16,38
Mattersburg,2254,10,8,7,21,37,64,-27,31
FC Salzburg,2255,1,23,7,6,63,25,38,76
SK Sturm Gra,2255,2,21,5,10,65,31,34,68
SC Rheindorf,2255,3,19,9,8,51,36,15,66
Vienna,2255,4,18,7,11,56,50,6,61
Rapid Vienna,2255,5,13,12,11,55,41,14,51
RZ Pellets W,2255,6,10,9,17,46,63,-17,39
Admira Wacke,2255,7,10,8,18,34,58,-24,38
SV Josko Rie,2255,8,11,4,21,35,53,-18,37
St. Pölten,2255,9,8,10,18,35,60,-25,34
Mattersburg,2255,10,8,7,21,48,71,-23,31
FC Salzburg,2256,1,20,9,7,68,33,35,69
SK Sturm Gra,2256,2,18,9,9,52,32,20,63
SC Rheindorf,2256,3,17,11,8,57,49,8,62
Rapid Vienna,2256,4,16,9,11,59,38,21,57
Vienna,2256,5,16,7,13,60,53,7,55
SV Josko Rie,2256,6,13,7,16,38,45,-7,46
Admira Wacke,2256,7,10,8,18,41,62,-21,38
St. Pölten,2256,8,8,12,16,40,63,-23,36
RZ Pellets W,2256,9,9,8,19,40,63,-23,35
Mattersburg,2256,10,7,12,17,36,53,-17,33
SC Rheindorf,2257,1,24,5,7,64,40,24,77
FC Salzburg,2257,2,20,11,5,68,28,40,71
Vienna,2257,3,20,4,12,69,54,15,64
SK Sturm Gra,2257,4,18,6,12,59,43,16,60
Rapid Vienna,2257,5,12,11,13,52,43,9,47
St. Pölten,2257,6,10,10,16,49,65,-16,40
Admira Wacke,2257,7,11,7,18,43,66,-23,40
Mattersburg,2257,8,9,10,17,41,55,-14,37
RZ Pellets W,2257,9,8,10,18,41,58,-17,34
SV Josko Rie,2257,10,9,4,23,28,62,-34,31
SK Sturm Gra,2258,1,22,7,7,69,29,40,73
FC Salzburg,2258,2,20,9,7,68,36,32,69
SC Rheindorf,2258,3,19,6,11,56,49,7,63
Vienna,2258,4,19,5,12,65,54,11,62
Rapid Vienna,2258,5,16,10,10,59,38,21,58
RZ Pellets W,2258,6,12,6,18,47,59,-12,42
Admira Wacke,2258,7,11,7,18,35,57,-22,40
St. Pölten,2258,8,9,8,19,37,66,-29,35
SV Josko Rie,2258,9,9,6,21,35,59,-24,33
Mattersburg,2258,10,6,10,20,35,59,-24,28
SK Sturm Gra,2259,1,23,5,8,70,30,40,74
SC Rheindorf,2259,2,19,9,8,56,48,8,66
FC Salzburg,2259,3,19,6,11,64,38,26,63
Vienna,2259,4,17,5,14,53,51,2,56
Rapid Vienna,2259,5,14,9,13,51,45,6,51
Mattersburg,2259,6,12,10,14,45,51,-6,46
RZ Pellets W,2259,7,11,6,19,37,57,-20,39
Admira Wacke,2259,8,11,5,20,39,57,-18,38
St. Pölten,2259,9,7,14,15,43,60,-17,35
SV Josko Rie,2259,10,9,7,20,33,54,-21,34
FC Salzburg,2260,1,21,7,8,69,36,33,70
SC Rheindorf,2260,2,19,8,9,52,41,11,65
Vienna,2260,3,19,4,13,64,54,10,61
SK Sturm Gra,2260,4,17,7,12,51,34,17,58
Rapid Vienna,2260,5,15,11,10,58,39,19,56
Admira Wacke,2260,6,13,11,12,40,50,-10,50
RZ Pellets W,2260,7,13,9,14,50,51,-1,48
St. Pölten,2260,8,8,10,18,34,62,-28,34
SV Josko Rie,2260,9,9,5,22,29,51,-22,32
Mattersburg,2260,10,7,6,23,33,62,-29,27
SC Rheindorf,2261,1,20,7,9,49,36,13,67
SK Sturm Gra,2261,2,20,6,10,58,34,24,66
FC Salzburg,2261,3,20,5,11,60,32,28,65
Vienna,2261,4,19,6,11,60,45,15,63
Rapid Vienna,2261,5,13,10,13,51,42,9,49
RZ Pellets W,2261,6,12,7,17,47,63,-16,43
Mattersburg,2261,7,12,5,19,42,57,-15,41
SV Josko Rie,2261,8,12,4,20,31,48,-17,40
Admira Wacke,2261,9,10,9,17,33,53,-20,39
St. Pölten,2261,10,9,7,20,38,59,-21,34
SC Rheindorf,2262,1,21,7,8,60,40,20,70
FC Salzburg,2262,2,19,9,8,62,31,31,66
SK Sturm Gra,2262,3,19,8,9,62,33,29,65
Vienna,2262,4,18,5,13,65,60,5,59
RZ Pellets W,2262,5,14,7,15,49,56,-7,49
Rapid Vienna,2262,6,13,8,15,57,49,8,47
SV Josko Rie,2262,7,10,9,17,39,57,-18,39
Admira Wacke,2262,8,10,9,17,39,59,-20,39
St. Pölten,2262,9,9,9,18,39,61,-22,36
Mattersburg,2262,10,6,11,19,33,59,-26,29
SC Rheindorf,2263,1,18,10,8,49,37,12,64
SK Sturm Gra,2263,2,18,8,10,61,37,24,62
FC Salzburg,2263,3,18,7,11,68,42,26,61
Rapid Vienna,2263,4,14,13,9,66,40,26,55
Vienna,2263,5,16,7,13,52,51,1,55
RZ Pellets W,2263,6,12,10,14,45,58,-13,46
Admira Wacke,2263,7,12,8,16,38,57,-19,44
SV Josko Rie,2263,8,12,7,17,36,48,-12,43
Mattersburg,2263,9,7,11,18,39,56,-17,32
St. Pölten,2263,10,7,11,18,35,63,-28,32
FC Salzburg,2264,1,21,9,6,64,27,37,72
SC Rheindorf,2264,2,20,8,8,61,39,22,68
Vienna,2264,3,21,3,12,65,49,16,66
SK Sturm Gra,2264,4,17,7,12,57,42,15,58
Rapid Vienna,2264,5,14,12,10,58,45,13,54
RZ Pellets W,2264,6,13,6,17,42,55,-13,45
Admira Wacke,2264,7,12,7,17,34,57,-23,43
St. Pölten,2264,8,8,10,18,44,66,-22,34
SV Josko Rie,2264,9,10,4,22,31,54,-23,34
Mattersburg,2264,10,7,8,21,35,57,-22,29
FC Salzburg,2265,1,22,8,6,71,26,45,74
Rapid Vienna,2265,2,18,7,11,64,39,25,61
SC Rheindorf,2265,3,18,7,11,51,45,6,61
Vienna,2265,4,19,3,14,67,57,10,60
SK Sturm Gra,2265,5,17,6,13,53,44,9,57
Admira Wacke,2265,6,12,7,17,37,51,-14,43
Mattersburg,2265,7,10,10,16,42,54,-12,40
RZ Pellets W,2265,8,11,7,18,44,61,-17,40
SV Josko Rie,2265,9,10,5,21,33,55,-22,35
St. Pölten,2265,10,9,8,19,39,69,-30,35
FC Salzburg,2266,1,21,9,6,67,31,36,72
SC Rheindorf,2266,2,21,8,7,61,41,20,71
SK Sturm Gra,2266,3,19,6,11,64,39,25,63
Vienna,2266,4,17,7,12,63,55,8,58
RZ Pellets W,2266,5,14,7,15,53,60,-7,49
Rapid Vienna,2266,6,11,10,15,48,45,3,43
Mattersburg,2266,7,9,11,16,45,57,-12,38
Admira Wacke,2266,8,10,6,20,36,62,-26,36
SV Josko Rie,2266,9,9,8,19,28,51,-23,35
St. Pölten,2266,10,8,10,18,50,74,-24,34
SK Sturm Gra,2267,1,20,6,10,58,39,19,66
FC Salzburg,2267,2,20,5,11,61,30,31,65
SC Rheindorf,2267,3,20,5,11,52,43,9,65
Vienna,2267,4,19,6,11,64,48,16,63
Rapid Vienna,2267,5,15,11,10,58,38,20,56
RZ Pellets W,2267,6,12,8,16,47,56,-9,44
SV Josko Rie,2267,7,12,5,19,36,55,-19,41
Admira Wacke,2267,8,11,8,17,39,60,-21,41
St. Pölten,2267,9,9,9,18,42,65,-23,36
Mattersburg,2267,10,7,7,22,38,61,-23,28
SK Sturm Gra,2268,1,22,5,9,68,36,32,71
Vienna,2268,2,22,3,11,69,47,22,69
SC Rheindorf,2268,3,21,6,9,65,47,18,69
FC Salzburg,2268,4,17,9,10,59,35,24,60
Rapid Vienna,2268,5,14,11,11,55,37,18,53
Admira Wacke,2268,6,13,7,16,42,60,-18,46
RZ Pellets W,2268,7,10,9,17,47,64,-17,39
Mattersburg,2268,8,9,9,18,37,60,-23,36
SV Josko Rie,2268,9,9,7,20,33,57,-24,34
St. Pölten,2268,10,4,12,20,32,64,-32,24
SC Rheindorf,2269,1,23,5,8,66,36,30,74
Vienna,2269,2,20,5,11,66,48,18,65
FC Salzburg,2269,3,19,6,11,61,39,22,63
SK Sturm Gra,2269,4,18,7,11,54,34,20,61
Rapid Vienna,2269,5,13,14,9,54,34,20,53
RZ Pellets W,2269,6,11,9,16,42,53,-11,42
Mattersburg,2269,7,11,8,17,36,50,-14,41
SV Josko Rie,2269,8,10,7,19,34,52,-18,37
Admira Wacke,2269,9,10,4,22,31,68,-37,34
St. Pölten,2269,10,8,9,19,33,63,-30,33
FC Salzburg,2270,1,22,7,7,64,29,35,73
Vienna,2270,2,22,4,10,70,47,23,70
SC Rheindorf,2270,3,21,7,8,53,35,18,70
SK Sturm Gra,2270,4,17,10,9,60,37,23,61
Rapid Vienna,2270,5,15,11,10,55,38,17,56
Admira Wacke,2270,6,10,10,16,29,57,-28,40
RZ Pellets W,2270,7,10,9,17,47,58,-11,39
Mattersburg,2270,8,9,7,20,36,54,-18,34
SV Josko Rie,2270,9,10,4,22,38,57,-19,34
St. Pölten,2270,10,5,9,22,33,73,-40,24
SC Rheindorf,2271,1,21,5,10,61,46,15,68
SK Sturm Gra,2271,2,20,7,9,60,33,27,67
FC Salzburg,2271,3,20,5,11,65,43,22,65
Vienna,2271,4,19,6,11,66,54,12,63
Rapid Vienna,2271,5,17,10,9,58,31,27,61
Admira Wacke,2271,6,13,4,19,42,61,-19,43
Mattersburg,2271,7,11,7,18,39,51,-12,40
RZ Pellets W,2271,8,10,7,19,43,60,-17,37
SV Josko Rie,2271,9,9,6,21,37,62,-25,33
St. Pölten,2271,10,8,7,21,40,70,-30,31
Vienna,2272,1,21,5,10,69,45,24,68
SK Sturm Gra,2272,2,20,7,9,60,37,23,67
SC Rheindorf,2272,3,20,6,10,60,43,17,66
FC Salzburg,2272,4,20,5,11,63,34,29,65
Rapid Vienna,2272,5,15,9,12,56,40,16,54
Admira Wacke,2272,6,14,6,16,40,57,-17,48
RZ Pellets W,2272,7,12,6,18,41,59,-18,42
St. Pölten,2272,8,10,7,19,41,65,-24,37
Mattersburg,2272,9,9,6,21,42,59,-17,33
SV Josko Rie,2272,10,8,5,23,31,64,-33,29
FC Salzburg,2273,1,24,4,8,69,27,42,76
SC Rheindorf,2273,2,21,6,9,59,41,18,69
Vienna,2273,3,19,7,10,64,52,12,64
SK Sturm Gra,2273,4,15,8,13,55,39,16,53
RZ Pellets W,2273,5,15,7,14,53,50,3,52
Rapid Vienna,2273,6,13,9,14,53,47,6,48
Admira Wacke,2273,7,12,7,17,37,57,-20,43
Mattersburg,2273,8,10,6,20,38,59,-21,36
St. Pölten,2273,9,8,9,19,39,62,-23,33
SV Josko Rie,2273,10,8,7,21,34,67,-33,31
SK Sturm Gra,2274,1,21,6,9,68,35,33,69
SC Rheindorf,2274,2,19,8,9,53,40,13,65
FC Salzburg,2274,3,18,9,9,61,38,23,63
Vienna,2274,4,17,6,13,61,58,3,57
Rapid Vienna,2274,5,12,8,16,45,45,0,44
RZ Pellets W,2274,6,11,9,16,49,55,-6,42
Admira Wacke,2274,7,11,9,16,34,56,-22,42
SV Josko Rie,2274,8,12,5,19,39,55,-16,41
Mattersburg,2274,9,10,10,16,37,47,-10,40
St. Pölten,2274,10,10,8,18,45,63,-18,38
FC Salzburg,2275,1,20,8,8,70,34,36,68
SK Sturm Gra,2275,2,20,7,9,58,32,26,67
SC Rheindorf,2275,3,20,7,9,54,40,14,67
Vienna,2275,4,18,4,14,64,57,7,58
RZ Pellets W,2275,5,14,7,15,47,51,-4,49
Rapid Vienna,2275,6,11,14,11,57,44,13,47
St. Pölten,2275,7,10,10,16,43,68,-25,40
SV Josko Rie,2275,8,10,7,19,30,54,-24,37
Admira Wacke,2275,9,9,9,18,32,52,-20,36
Mattersburg,2275,10,8,7,21,41,64,-23,31
FC Salzburg,2276,1,20,8,8,68,35,33,68
SC Rheindorf,2276,2,20,8,8,59,42,17,68
SK Sturm Gra,2276,3,19,6,11,65,39,26,63
Vienna,2276,4,19,5,12,65,53,12,62
Rapid Vienna,2276,5,13,13,10,66,48,18,52
Admira Wacke,2276,6,10,11,15,37,59,-22,41
RZ Pellets W,2276,7,11,6,19,44,66,-22,39
SV Josko Rie,2276,8,10,7,19,35,54,-19,37
Mattersburg,2276,9,9,9,18,38,54,-16,36
St. Pölten,2276,10,9,7,20,39,66,-27,34
SC Rheindorf,2277,1,24,6,6,64,35,29,78
FC Salzburg,2277,2,21,9,6,63,30,33,72
Vienna,2277,3,20,4,12,66,50,16,64
SK Sturm Gra,2277,4,19,4,13,58,34,24,61
Rapid Vienna,2277,5,12,9,15,53,43,10,45
Admira Wacke,2277,6,12,6,18,38,61,-23,42
SV Josko Rie,2277,7,10,8,18,37,51,-14,38
RZ Pellets W,2277,8,10,8,18,39,63,-24,38
St. Pölten,2277,9,8,9,19,37,62,-25,33
Mattersburg,2277,10,8,9,19,35,61,-26,33
SK Sturm Gra,2278,1,22,7,7,64,31,33,73
FC Salzburg,2278,2,20,6,10,62,35,27,66
SC Rheindorf,2278,3,17,9,10,55,48,7,60
Vienna,2278,4,17,5,14,59,51,8,56
RZ Pellets W,2278,5,14,10,12,45,48,-3,52
Rapid Vienna,2278,6,13,11,12,59,44,15,50
Admira Wacke,2278,7,13,5,18,40,58,-18,44
St. Pölten,2278,8,9,12,15,43,62,-19,39
Mattersburg,2278,9,9,8,19,41,57,-16,35
SV Josko Rie,2278,10,7,5,24,36,70,-34,26
FC Salzburg,2279,1,20,9,7,64,30,34,69
SC Rheindorf,2279,2,20,8,8,57,36,21,68
Vienna,2279,3,20,5,11,67,48,19,65
SK Sturm Gra,2279,4,16,11,9,53,34,19,59
Rapid Vienna,2279,5,11,15,10,51,43,8,48
RZ Pellets W,2279,6,11,10,15,40,51,-11,43
SV Josko Rie,2279,7,10,8,18,31,49,-18,38
Admira Wacke,2279,8,8,13,15,44,62,-18,37
St. Pölten,2279,9,9,9,18,44,69,-25,36
Mattersburg,2279,10,7,8,21,33,62,-29,29
SK Sturm Gra,2280,1,23,6,7,64,25,39,75
SC Rheindorf,2280,2,22,9,5,59,34,25,75
FC Salzburg,2280,3,22,5,9,71,35,36,71
Rapid Vienna,2280,4,17,9,10,54,33,21,60
Vienna,2280,5,16,3,17,53,51,2,51
RZ Pellets W,2280,6,11,8,17,40,55,-15,41
SV Josko Rie,2280,7,11,6,19,32,52,-20,39
Admira Wacke,2280,8,10,6,20,37,59,-22,36
Mattersburg,2280,9,7,8,21,35,64,-29,29
St. Pölten,2280,10,7,8,21,34,71,-37,29
FC Salzburg,2281,1,21,7,8,71,29,42,70
SK Sturm Gra,2281,2,20,6,10,65,38,27,66
SC Rheindorf,2281,3,20,5,11,50,46,4,65
Rapid Vienna,2281,4,15,8,13,60,43,17,53
Vienna,2281,5,16,4,16,58,59,-1,52
Admira Wacke,2281,6,13,4,19,43,61,-18,43
SV Josko Rie,2281,7,12,6,18,37,54,-17,42
RZ Pellets W,2281,8,11,8,17,37,53,-16,41
Mattersburg,2281,9,10,8,18,38,55,-17,38
St. Pölten,2281,10,8,12,16,44,65,-21,36
FC Salzburg,2282,1,22,8,6,69,29,40,74
Vienna,2282,2,21,7,8,69,42,27,70
SC Rheindorf,2282,3,18,7,11,57,42,15,61
Rapid Vienna,2282,4,15,9,12,53,37,16,54
SK Sturm Gra,2282,5,14,7,15,49,45,4,49
Admira Wacke,2282,6,13,5,18,43,63,-20,44
SV Josko Rie,2282,7,13,5,18,39,59,-20,44
RZ Pellets W,2282,8,10,9,17,44,60,-16,39
St. Pölten,2282,9,11,6,19,42,69,-27,39
Mattersburg,2282,10,8,7,21,38,57,-19,31
FC Salzburg,2283,1,21,7,8,66,26,40,70
SK Sturm Gra,2283,2,18,7,11,54,38,16,61
SC Rheindorf,2283,3,18,7,11,52,44,8,61
Vienna,2283,4,18,5,13,58,46,12,59
Rapid Vienna,2283,5,14,12,10,57,43,14,54
Admira Wacke,2283,6,15,5,16,47,51,-4,50
RZ Pellets W,2283,7,14,4,18,44,58,-14,46
Mattersburg,2283,8,9,10,17,35,53,-18,37
St. Pölten,2283,9,9,10,17,38,60,-22,37
SV Josko Rie,2283,10,8,5,23,25,57,-32,29
FC Salzburg,2284,1,21,6,9,66,31,35,69
SC Rheindorf,2284,2,20,9,7,56,40,16,69
SK Sturm Gra,2284,3,19,5,12,56,38,18,62
Vienna,2284,4,19,4,13,61,51,10,61
Rapid Vienna,2284,5,15,10,11,54,34,20,55
SV Josko Rie,2284,6,14,4,18,39,55,-16,46
Admira Wacke,2284,7,14,4,18,45,63,-18,46
RZ Pellets W,2284,8,13,6,17,45,57,-12,45
St. Pölten,2284,9,8,9,19,44,67,-23,33
Mattersburg,2284,10,4,9,23,32,62,-30,21
FC Salzburg,2285,1,23,5,8,67,24,43,74
SC Rheindorf,2285,2,19,7,10,58,50,8,64
Vienna,2285,3,18,6,12,62,48,14,60
SK Sturm Gra,2285,4,16,10,10,55,37,18,58
Rapid Vienna,2285,5,15,9,12,51,38,13,54
RZ Pellets W,2285,6,14,6,16,55,55,0,48
Admira Wacke,2285,7,12,6,18,39,59,-20,42
St. Pölten,2285,8,10,7,19,45,66,-21,37
SV Josko Rie,2285,9,11,4,21,31,58,-27,37
Mattersburg,2285,10,9,6,21,32,60,-28,33
FC Salzburg,2286,1,21,9,6,64,28,36,72
SK Sturm Gra,2286,2,19,7,10,58,35,23,64
SC Rheindorf,2286,3,19,6,11,52,48,4,63
Vienna,2286,4,16,8,12,66,60,6,56
Rapid Vienna,2286,5,14,13,9,56,38,18,55
Admira Wacke,2286,6,12,8,16,40,59,-19,44
RZ Pellets W,2286,7,10,11,15,46,53,-7,41
Mattersburg,2286,8,10,8,18,42,55,-13,38
St. Pölten,2286,9,8,10,18,40,66,-26,34
SV Josko Rie,2286,10,7,8,21,37,59,-22,29
Vienna,2287,1,23,4,9,70,46,24,73
SK Sturm Gra,2287,2,22,5,9,66,35,31,71
SC Rheindorf,2287,3,20,7,9,59,40,19,67
FC Salzburg,2287,4,19,8,9,58,30,28,65
Rapid Vienna,2287,5,15,10,11,56,39,17,55
RZ Pellets W,2287,6,12,7,17,44,60,-16,43
Admira Wacke,2287,7,10,6,20,35,59,-24,36
Mattersburg,2287,8,8,10,18,39,56,-17,34
SV Josko Rie,2287,9,9,7,20,35,63,-28,34
St. Pölten,2287,10,5,10,21,32,66,-34,25
SC Rheindorf,2288,1,22,6,8,60,40,20,72
FC Salzburg,2288,2,20,8,8,63,35,28,68
SK Sturm Gra,2288,3,20,7,9,64,34,30,67
Rapid Vienna,2288,4,15,11,10,58,32,26,56
Vienna,2288,5,17,4,15,60,60,0,55
RZ Pellets W,2288,6,13,10,13,45,46,-1,49
Admira Wacke,2288,7,10,7,19,35,60,-25,37
SV Josko Rie,2288,8,11,3,22,35,57,-22,36
St. Pölten,2288,9,8,10,18,36,62,-26,34
Mattersburg,2288,10,7,8,21,30,60,-30,29
FC Salzburg,2289,1,24,6,6,77,35,42,78
SK Sturm Gra,2289,2,21,5,10,65,41,24,68
SC Rheindorf,2289,3,20,8,8,57,44,13,68
Rapid Vienna,2289,4,16,10,10,69,42,27,58
Vienna,2289,5,16,6,14,59,57,2,54
RZ Pellets W,2289,6,11,7,18,43,58,-15,40
St. Pölten,2289,7,10,10,16,45,66,-21,40
SV Josko Rie,2289,8,10,7,19,39,55,-16,37
Admira Wacke,2289,9,10,6,20,35,66,-31,36
Mattersburg,2289,10,4,11,21,28,53,-25,23
FC Salzburg,2290,1,21,8,7,68,31,37,71
SK Sturm Gra,2290,2,19,5,12,65,39,26,62
SC Rheindorf,2290,3,18,8,10,54,43,11,62
Vienna,2290,4,18,5,13,65,64,1,59
Rapid Vienna,2290,5,14,11,11,58,47,11,53
RZ Pellets W,2290,6,14,6,16,56,57,-1,48
Admira Wacke,2290,7,12,6,18,39,60,-21,42
St. Pölten,2290,8,10,9,17,42,56,-14,39
Mattersburg,2290,9,9,9,18,39,57,-18,36
SV Josko Rie,2290,10,9,5,22,31,63,-32,32
FC Salzburg,2291,1,23,8,5,72,29,43,77
SC Rheindorf,2291,2,19,9,8,54,37,17,66
SK Sturm Gra,2291,3,19,8,9,49,27,22,65
Vienna,2291,4,20,5,11,63,47,16,65
Rapid Vienna,2291,5,12,10,14,50,41,9,46
RZ Pellets W,2291,6,13,7,16,44,57,-13,46
Admira Wacke,2291,7,10,10,16,32,50,-18,40
Mattersburg,2291,8,10,8,18,38,55,-17,38
SV Josko Rie,2291,9,8,6,22,30,54,-24,30
St. Pölten,2291,10,6,9,21,35,70,-35,27
FC Salzburg,2292,1,21,7,8,64,31,33,70
Vienna,2292,2,20,6,10,65,50,15,66
Rapid Vienna,2292,3,16,11,9,58,35,23,59
SC Rheindorf,2292,4,16,9,11,45,39,6,57
SK Sturm Gra,2292,5,17,5,14,51,41,10,56
SV Josko Rie,2292,6,12,9,15,36,44,-8,45
RZ Pellets W,2292,7,10,12,14,46,51,-5,42
Admira Wacke,2292,8,10,8,18,33,56,-23,38
St. Pölten,2292,9,8,9,19,43,70,-27,33
Mattersburg,2292,10,7,10,19,31,55,-24,31
FC Salzburg,2293,1,20,7,9,67,39,28,67
Vienna,2293,2,20,7,9,71,47,24,67
SC Rheindorf,2293,3,19,7,10,48,38,10,64
Rapid Vienna,2293,4,15,11,10,59,42,17,56
SK Sturm Gra,2293,5,17,4,15,57,41,16,55
RZ Pellets W,2293,6,13,8,15,41,47,-6,47
St. Pölten,2293,7,9,12,15,41,58,-17,39
Admira Wacke,2293,8,11,6,19,36,63,-27,39
SV Josko Rie,2293,9,9,7,20,29,52,-23,34
Mattersburg,2293,10,8,9,19,33,55,-22,33
FC Salzburg,2294,1,20,8,8,66,32,34,68
SC Rheindorf,2294,2,18,8,10,50,41,9,62
SK Sturm Gra,2294,3,17,9,10,55,37,18,60
Vienna,2294,4,17,6,13,67,56,11,57
RZ Pellets W,2294,5,16,5,15,47,56,-9,53
Rapid Vienna,2294,6,14,10,12,50,38,12,52
SV Josko Rie,2294,7,12,6,18,37,52,-15,42
Admira Wacke,2294,8,11,7,18,36,55,-19,40
St. Pölten,2294,9,9,8,19,43,63,-20,35
Mattersburg,2294,10,9,7,20,37,58,-21,34
SC Rheindorf,2295,1,23,6,7,68,40,28,75
FC Salzburg,2295,2,21,11,4,62,25,37,74
SK Sturm Gra,2295,3,18,7,11,57,41,16,61
Rapid Vienna,2295,4,17,9,10,57,39,18,60
RZ Pellets W,2295,5,15,8,13,55,53,2,53
Vienna,2295,6,15,7,14,60,59,1,52
SV Josko Rie,2295,7,12,2,22,37,61,-24,38
Admira Wacke,2295,8,9,8,19,35,58,-23,35
St. Pölten,2295,9,7,9,20,37,64,-27,30
Mattersburg,2295,10,5,9,22,34,62,-28,24
FC Salzburg,2296,1,21,7,8,76,38,38,70
Vienna,2296,2,20,6,10,72,48,24,66
SC Rheindorf,2296,3,19,8,9,65,45,20,65
SK Sturm Gra,2296,4,19,5,12,56,36,20,62
Rapid Vienna,2296,5,15,11,10,55,41,14,56
RZ Pellets W,2296,6,14,8,14,52,57,-5,50
Admira Wacke,2296,7,12,4,20,40,70,-30,40
St. Pölten,2296,8,10,9,17,42,58,-16,39
Mattersburg,2296,9,9,7,20,34,63,-29,34
SV Josko Rie,2296,10,7,3,26,28,64,-36,24
FC Salzburg,2297,1,19,6,11,62,37,25,63
SK Sturm Gra,2297,2,17,11,8,56,32,24,62
Vienna,2297,3,18,8,10,60,44,16,62
SC Rheindorf,2297,4,18,7,11,54,44,10,61
Rapid Vienna,2297,5,15,11,10,58,39,19,56
Admira Wacke,2297,6,16,4,16,46,55,-9,52
RZ Pellets W,2297,7,13,7,16,44,57,-13,46
SV Josko Rie,2297,8,11,5,20,35,61,-26,38
Mattersburg,2297,9,9,6,21,37,59,-22,33
St. Pölten,2297,10,7,9,20,42,66,-24,30
FC Salzburg,2298,1,20,10,6,68,32,36,70
SK Sturm Gra,2298,2,21,6,9,66,35,31,69
SC Rheindorf,2298,3,19,7,10,58,45,13,64
Vienna,2298,4,18,4,14,56,45,11,58
Rapid Vienna,2298,5,13,12,11,54,46,8,51
RZ Pellets W,2298,6,14,7,15,48,59,-11,49
SV Josko Rie,2298,7,11,7,18,41,53,-12,40
Mattersburg,2298,8,10,6,20,40,61,-21,36
Admira Wacke,2298,9,8,9,19,28,58,-30,33
St. Pölten,2298,10,7,10,19,38,63,-25,31
SK Sturm Gra,2299,1,21,6,9,60,30,30,69
FC Salzburg,2299,2,20,9,7,63,37,26,69
Vienna,2299,3,19,7,10,60,44,16,64
Rapid Vienna,2299,4,17,11,8,64,33,31,62
SC Rheindorf,2299,5,19,5,12,50,43,7,62
RZ Pellets W,2299,6,13,6,17,46,53,-7,45
SV Josko Rie,2299,7,12,3,21,37,60,-23,39
St. Pölten,2299,8,9,9,18,43,66,-23,36
Admira Wacke,2299,9,10,5,21,34,61,-27,35
Mattersburg,2299,10,6,7,23,37,67,-30,25
SC Rheindorf,2300,1,21,6,9,61,44,17,69
FC Salzburg,2300,2,20,5,11,61,35,26,65
Vienna,2300,3,19,6,11,65,52,13,63
SK Sturm Gra,2300,4,19,5,12,60,38,22,62
Rapid Vienna,2300,5,13,11,12,50,39,11,50
SV Josko Rie,2300,6,14,4,18,38,49,-11,46
Admira Wacke,2300,7,13,7,16,39,55,-16,46
RZ Pellets W,2300,8,12,8,16,48,57,-9,44
Mattersburg,2300,9,9,7,20,39,59,-20,34
St. Pölten,2300,10,6,9,21,32,65,-33,27
FC Salzburg,2301,1,19,10,7,61,30,31,67
Rapid Vienna,2301,1,19,10,7,61,30,31,67
SC Rheindorf,2301,3,20,7,9,55,42,13,67
SK Sturm Gra,2301,4,18,7,11,56,37,19,61
Vienna,2301,5,18,6,12,68,54,14,60
RZ Pellets W,2301,6,13,6,17,50,57,-7,45
Admira Wacke,2301,7,10,8,18,34,59,-25,38
SV Josko Rie,2301,8,10,4,22,36,61,-25,34
St. Pölten,2301,9,8,9,19,36,59,-23,33
Mattersburg,2301,10,8,7,21,31,59,-28,31
FC Salzburg,2302,1,22,7,7,62,26,36,73
SK Sturm Gra,2302,2,19,6,11,55,32,23,63
Vienna,2302,3,19,6,11,72,50,22,63
SC Rheindorf,2302,4,16,10,10,59,48,11,58
Rapid Vienna,2302,5,14,12,10,54,37,17,54
RZ Pellets W,2302,6,14,7,15,48,55,-7,49
SV Josko Rie,2302,7,11,6,19,40,55,-15,39
St. Pölten,2302,8,8,10,18,46,70,-24,34
Mattersburg,2302,9,8,10,18,38,64,-26,34
Admira Wacke,2302,10,8,8,20,34,71,-37,32
FC Salzburg,2303,1,20,10,6,67,33,34,70
SC Rheindorf,2303,2,20,8,8,57,40,17,68
SK Sturm Gra,2303,3,19,6,11,58,34,24,63
Vienna,2303,4,17,8,11,57,49,8,59
Rapid Vienna,2303,5,12,10,14,59,45,14,46
Admira Wacke,2303,6,11,10,15,38,55,-17,43
SV Josko Rie,2303,7,10,8,18,36,53,-17,38
RZ Pellets W,2303,8,10,8,18,42,60,-18,38
St. Pölten,2303,9,9,10,17,46,69,-23,37
Mattersburg,2303,10,9,8,19,34,56,-22,35
SC Rheindorf,2304,1,21,6,9,62,50,12,69
FC Salzburg,2304,2,19,10,7,66,33,33,67
SK Sturm Gra,2304,3,19,5,12,57,35,22,62
Vienna,2304,4,18,5,13,68,58,10,59
Rapid Vienna,2304,5,12,10,14,53,46,7,46
SV Josko Rie,2304,6,14,3,19,40,50,-10,45
RZ Pellets W,2304,7,11,9,16,45,59,-14,42
St. Pölten,2304,8,10,9,17,47,59,-12,39
Admira Wacke,2304,9,10,8,18,34,64,-30,38
Mattersburg,2304,10,10,7,19,38,56,-18,37
SC Rheindorf,2305,1,20,6,10,66,50,16,66
FC Salzburg,2305,2,20,5,11,70,41,29,65
SK Sturm Gra,2305,3,18,10,8,63,33,30,64
Vienna,2305,4,18,6,12,65,54,11,60
Rapid Vienna,2305,5,13,11,12,57,46,11,50
RZ Pellets W,2305,6,11,10,15,45,58,-13,43
St. Pölten,2305,7,9,13,14,44,61,-17,40
SV Josko Rie,2305,8,9,9,18,40,61,-21,36
Admira Wacke,2305,9,9,9,18,33,62,-29,36
Mattersburg,2305,10,7,13,16,36,53,-17,34
SC Rheindorf,2306,1,22,7,7,55,33,22,73
SK Sturm Gra,2306,2,20,5,11,53,29,24,65
FC Salzburg,2306,3,17,9,10,58,36,22,60
Rapid Vienna,2306,4,15,9,12,60,36,24,54
Vienna,2306,5,16,6,14,59,59,0,54
RZ Pellets W,2306,6,15,7,14,53,57,-4,52
Admira Wacke,2306,7,11,9,16,32,52,-20,42
St. Pölten,2306,8,11,8,17,47,63,-16,41
SV Josko Rie,2306,9,8,8,20,28,53,-25,32
Mattersburg,2306,10,6,10,20,30,57,-27,28
SC Rheindorf,2307,1,24,8,4,60,32,28,80
FC Salzburg,2307,2,20,8,8,67,35,32,68
Vienna,2307,3,18,5,13,66,54,12,59
SK Sturm Gra,2307,4,17,7,12,59,38,21,58
Rapid Vienna,2307,5,12,13,11,53,44,9,49
RZ Pellets W,2307,6,13,8,15,47,53,-6,47
SV Josko Rie,2307,7,10,7,19,33,57,-24,37
Admira Wacke,2307,8,8,12,16,35,57,-22,36
Mattersburg,2307,9,8,10,18,40,61,-21,34
St. Pölten,2307,10,7,8,21,41,70,-29,29
SC Rheindorf,2308,1,20,8,8,56,38,18,68
SK Sturm Gra,2308,2,20,7,9,60,32,28,67
FC Salzburg,2308,3,19,9,8,73,45,28,66
Vienna,2308,4,19,5,12,60,51,9,62
Admira Wacke,2308,5,13,7,16,42,61,-19,46
Rapid Vienna,2308,6,11,12,13,55,48,7,45
RZ Pellets W,2308,7,11,8,17,41,54,-13,41
St. Pölten,2308,8,10,9,17,45,64,-19,39
SV Josko Rie,2308,9,11,4,21,44,59,-15,37
Mattersburg,2308,10,7,9,20,38,62,-24,30
FC Salzburg,2309,1,21,7,8,61,24,37,70
SK Sturm Gra,2309,2,20,7,9,69,35,34,67
SC Rheindorf,2309,3,18,9,9,53,41,12,63
Vienna,2309,4,17,4,15,59,58,1,55
RZ Pellets W,2309,5,14,8,14,51,51,0,50
Rapid Vienna,2309,6,13,10,13,49,40,9,49
SV Josko Rie,2309,7,11,6,19,30,47,-17,39
Admira Wacke,2309,8,11,6,19,33,60,-27,39
St. Pölten,2309,9,8,12,16,40,65,-25,36
Mattersburg,2309,10,7,11,18,30,54,-24,32
SK Sturm Gra,2310,1,21,6,9,61,34,27,69
FC Salzburg,2310,2,19,9,8,67,38,29,66
SC Rheindorf,2310,3,20,6,10,54,39,15,66
Vienna,2310,4,18,4,14,70,57,13,58
Rapid Vienna,2310,5,13,8,15,58,51,7,47
SV Josko Rie,2310,6,14,4,18,42,55,-13,46
RZ Pellets W,2310,7,11,7,18,43,57,-14,40
Mattersburg,2310,8,9,11,16,41,57,-16,38
Admira Wacke,2310,9,11,5,20,37,63,-26,38
St. Pölten,2310,10,9,10,17,39,61,-22,37
SK Sturm Gra,2311,1,22,6,8,64,34,30,72
FC Salzburg,2311,2,20,9,7,66,34,32,69
SC Rheindorf,2311,3,17,9,10,53,45,8,60
Vienna,2311,4,16,7,13,55,49,6,55
Rapid Vienna,2311,5,12,11,13,51,44,7,47
SV Josko Rie,2311,6,13,7,16,42,48,-6,46
RZ Pellets W,2311,7,13,7,16,43,53,-10,46
St. Pölten,2311,8,10,8,18,43,67,-24,38
Mattersburg,2311,9,8,9,19,40,54,-14,33
Admira Wacke,2311,10,8,9,19,27,56,-29,33
FC Salzburg,2312,1,23,6,7,71,28,43,75
SC Rheindorf,2312,2,23,5,8,64,48,16,74
Vienna,2312,3,20,5,11,70,46,24,65
RZ Pellets W,2312,4,17,5,14,53,55,-2,56
SK Sturm Gra,2312,5,14,11,11,48,36,12,53
Rapid Vienna,2312,6,13,12,11,50,40,10,51
SV Josko Rie,2312,7,10,5,21,39,60,-21,35
Mattersburg,2312,8,9,7,20,40,59,-19,34
St. Pölten,2312,9,7,13,16,39,63,-24,34
Admira Wacke,2312,10,8,3,25,32,71,-39,27
FC Salzburg,2313,1,23,7,6,77,28,49,76
SC Rheindorf,2313,2,19,9,8,57,45,12,66
SK Sturm Gra,2313,3,20,5,11,59,38,21,65
Vienna,2313,4,18,4,14,64,53,11,58
Rapid Vienna,2313,5,13,13,10,53,40,13,52
RZ Pellets W,2313,6,13,9,14,54,59,-5,48
St. Pölten,2313,7,9,9,18,40,65,-25,36
Admira Wacke,2313,8,9,8,19,31,61,-30,35
SV Josko Rie,2313,9,9,7,20,35,58,-23,34
Mattersburg,2313,10,6,11,19,39,62,-23,29
FC Salzburg,2314,1,19,10,7,62,35,27,67
SC Rheindorf,2314,2,20,6,10,57,37,20,66
Vienna,2314,3,20,6,10,58,48,10,66
SK Sturm Gra,2314,4,18,7,11,61,38,23,61
Rapid Vienna,2314,5,14,9,13,60,48,12,51
SV Josko Rie,2314,6,11,8,17,34,46,-12,41
RZ Pellets W,2314,7,11,8,17,44,58,-14,41
St. Pölten,2314,8,10,10,16,42,59,-17,40
Admira Wacke,2314,9,10,6,20,37,63,-26,36
Mattersburg,2314,10,6,12,18,37,60,-23,30
FC Salzburg,2315,1,24,8,4,65,23,42,80
SK Sturm Gra,2315,2,21,7,8,58,28,30,70
SC Rheindorf,2315,3,21,6,9,59,40,19,69
Vienna,2315,4,17,5,14,58,51,7,56
Rapid Vienna,2315,5,13,11,12,58,45,13,50
Admira Wacke,2315,6,11,9,16,36,54,-18,42
SV Josko Rie,2315,7,12,5,19,34,50,-16,41
RZ Pellets W,2315,8,12,5,19,42,64,-22,41
St. Pölten,2315,9,6,10,20,37,62,-25,28
Mattersburg,2315,10,6,8,22,35,65,-30,26
FC Salzburg,2316,1,20,9,7,64,31,33,69
SK Sturm Gra,2316,2,19,6,11,53,38,15,63
Vienna,2316,3,17,10,9,67,52,15,61
SC Rheindorf,2316,4,14,12,10,44,40,4,54
Rapid Vienna,2316,5,13,11,12,57,38,19,50
Admira Wacke,2316,6,13,5,18,41,61,-20,44
Mattersburg,2316,7,10,10,16,43,54,-11,40
RZ Pellets W,2316,8,10,10,16,42,56,-14,40
St. Pölten,2316,9,9,10,17,45,66,-21,37
SV Josko Rie,2316,10,9,9,18,28,48,-20,36
FC Salzburg,2317,1,22,7,7,70,26,44,73
SC Rheindorf,2317,2,20,7,9,64,44,20,67
SK Sturm Gra,2317,3,19,7,10,55,31,24,64
Vienna,2317,4,18,7,11,58,44,14,61
Rapid Vienna,2317,5,14,11,11,59,46,13,53
Admira Wacke,2317,6,12,6,18,39,61,-22,42
SV Josko Rie,2317,7,12,5,19,33,57,-24,41
RZ Pellets W,2317,8,9,11,16,39,58,-19,38
St. Pölten,2317,9,7,10,19,34,64,-30,31
Mattersburg,2317,10,7,9,20,41,61,-20,30
FC Salzburg,2318,1,25,6,5,71,26,45,81
SK Sturm Gra,2318,2,20,8,8,60,29,31,68
SC Rheindorf,2318,3,17,9,10,54,45,9,60
Vienna,2318,4,17,4,15,57,52,5,55
Rapid Vienna,2318,5,13,11,12,53,44,9,50
RZ Pellets W,2318,6,13,7,16,45,53,-8,46
SV Josko Rie,2318,7,13,4,19,34,52,-18,43
St. Pölten,2318,8,9,9,18,43,65,-22,36
Mattersburg,2318,9,8,9,19,34,55,-21,33
Admira Wacke,2318,10,9,5,22,29,59,-30,32
Vienna,2319,1,20,4,12,63,50,13,64
SK Sturm Gra,2319,2,18,9,9,58,37,21,63
FC Salzburg,2319,3,18,8,10,67,40,27,62
SC Rheindorf,2319,4,18,8,10,55,45,10,62
Rapid Vienna,2319,5,16,9,11,54,42,12,57
RZ Pellets W,2319,6,13,6,17,48,57,-9,45
Mattersburg,2319,7,11,8,17,42,52,-10,41
Admira Wacke,2319,8,10,8,18,36,59,-23,38
SV Josko Rie,2319,9,10,5,21,39,58,-19,35
St. Pölten,2319,10,8,11,17,47,69,-22,35
FC Salzburg,2320,1,21,7,8,67,32,35,70
SC Rheindorf,2320,2,18,10,8,51,41,10,64
SK Sturm Gra,2320,3,19,6,11,60,38,22,63
Vienna,2320,4,16,8,12,64,58,6,56
Admira Wacke,2320,5,16,5,15,43,53,-10,53
RZ Pellets W,2320,6,14,9,13,52,51,1,51
Rapid Vienna,2320,7,11,10,15,49,42,7,43
SV Josko Rie,2320,8,12,7,17,37,47,-10,43
St. Pölten,2320,9,8,8,20,49,78,-29,32
Mattersburg,2320,10,7,6,23,32,64,-32,27
FC Salzburg,2321,1,22,8,6,71,29,42,74
SK Sturm Gra,2321,2,21,6,9,64,33,31,69
Vienna,2321,3,21,5,10,73,49,24,68
SC Rheindorf,2321,4,20,6,10,56,48,8,66
Rapid Vienna,2321,5,13,11,12,56,40,16,50
RZ Pellets W,2321,6,11,7,18,43,59,-16,40
Admira Wacke,2321,7,11,4,21,36,68,-32,37
St. Pölten,2321,8,9,8,19,39,64,-25,35
Mattersburg,2321,9,8,10,18,38,56,-18,34
SV Josko Rie,2321,10,9,5,22,35,65,-30,32
FC Salzburg,2322,1,20,7,9,62,34,28,67
SC Rheindorf,2322,2,20,7,9,56,37,19,67
Vienna,2322,3,20,6,10,60,44,16,66
Rapid Vienna,2322,4,17,8,11,60,40,20,59
SK Sturm Gra,2322,5,18,3,15,62,40,22,57
RZ Pellets W,2322,6,11,9,16,44,58,-14,42
SV Josko Rie,2322,7,12,5,19,37,53,-16,41
St. Pölten,2322,8,10,10,16,41,61,-20,40
Admira Wacke,2322,9,11,3,22,33,65,-32,36
Mattersburg,2322,10,7,10,19,32,55,-23,31
FC Salzburg,2323,1,22,6,8,66,32,34,72
SC Rheindorf,2323,2,19,11,6,59,41,18,68
SK Sturm Gra,2323,3,19,7,10,61,36,25,64
Vienna,2323,4,19,2,15,64,52,12,59
Rapid Vienna,2323,5,16,9,11,58,39,19,57
Admira Wacke,2323,6,13,6,17,41,55,-14,45
RZ Pellets W,2323,7,11,6,19,41,61,-20,39
Mattersburg,2323,8,10,7,19,38,58,-20,37
St. Pölten,2323,9,8,9,19,41,69,-28,33
SV Josko Rie,2323,10,9,5,22,34,60,-26,32
Vienna,2324,1,22,4,10,65,44,21,70
SC Rheindorf,2324,2,20,7,9,58,41,17,67
SK Sturm Gra,2324,3,20,6,10,56,29,27,66
FC Salzburg,2324,4,18,9,9,59,34,25,63
Rapid Vienna,2324,5,16,9,11,57,39,18,57
RZ Pellets W,2324,6,12,7,17,50,61,-11,43
Admira Wacke,2324,7,12,5,19,36,62,-26,41
SV Josko Rie,2324,8,12,4,20,43,57,-14,40
St. Pölten,2324,9,8,8,20,46,76,-30,32
Mattersburg,2324,10,6,9,21,37,64,-27,27
FC Salzburg,2325,1,23,6,7,70,34,36,75
SC Rheindorf,2325,2,21,9,6,60,36,24,72
SK Sturm Gra,2325,3,16,10,10,54,34,20,58
Vienna,2325,4,17,6,13,68,59,9,57
Rapid Vienna,2325,5,13,10,13,54,40,14,49
RZ Pellets W,2325,6,13,10,13,52,56,-4,49
Admira Wacke,2325,7,11,6,19,36,61,-25,39
Mattersburg,2325,8,7,13,16,36,56,-20,34
St. Pölten,2325,9,8,9,19,39,66,-27,33
SV Josko Rie,2325,10,10,3,23,34,61,-27,33
FC Salzburg,2326,1,24,4,8,73,38,35,76
SK Sturm Gra,2326,2,19,7,10,58,36,22,64
SC Rheindorf,2326,3,18,6,12,48,43,5,60
Vienna,2326,4,18,5,13,60,50,10,59
Rapid Vienna,2326,5,16,9,11,61,40,21,57
Admira Wacke,2326,6,15,5,16,51,56,-5,50
St. Pölten,2326,7,10,11,15,36,57,-21,41
SV Josko Rie,2326,8,10,4,22,35,54,-19,34
RZ Pellets W,2326,9,9,7,20,38,60,-22,34
Mattersburg,2326,10,8,8,20,33,59,-26,32
SC Rheindorf,2327,1,21,9,6,63,37,26,72
FC Salzburg,2327,2,19,10,7,62,31,31,67
SK Sturm Gra,2327,3,19,6,11,69,40,29,63
Vienna,2327,4,18,5,13,67,54,13,59
Rapid Vienna,2327,5,14,8,14,52,46,6,50
St. Pölten,2327,6,11,12,13,49,65,-16,45
Admira Wacke,2327,7,11,7,18,38,65,-27,40
RZ Pellets W,2327,8,9,9,18,41,55,-14,36
Mattersburg,2327,9,9,8,19,40,59,-19,35
SV Josko Rie,2327,10,9,6,21,31,60,-29,33
FC Salzburg,2328,1,21,8,7,65,26,39,71
SK Sturm Gra,2328,2,20,5,11,58,33,25,65
SC Rheindorf,2328,3,17,11,8,59,46,13,62
Rapid Vienna,2328,4,13,13,10,56,37,19,52
Vienna,2328,5,15,6,15,53,50,3,51
Admira Wacke,2328,6,14,5,17,43,57,-14,47
RZ Pellets W,2328,7,11,12,13,45,51,-6,45
SV Josko Rie,2328,8,10,6,20,34,53,-19,36
St. Pölten,2328,9,8,12,16,37,69,-32,36
Mattersburg,2328,10,6,12,18,37,65,-28,30
FC Salzburg,2329,1,20,9,7,71,36,35,69
SK Sturm Gra,2329,2,20,9,7,58,25,33,69
SC Rheindorf,2329,3,20,8,8,50,33,17,68
Vienna,2329,4,18,4,14,64,56,8,58
Rapid Vienna,2329,5,14,13,9,52,36,16,55
Admira Wacke,2329,6,10,13,13,38,53,-15,43
RZ Pellets W,2329,7,9,10,17,41,60,-19,37
Mattersburg,2329,8,9,9,18,34,53,-19,36
SV Josko Rie,2329,9,9,7,20,33,55,-22,34
St. Pölten,2329,10,5,10,21,29,63,-34,25
FC Salzburg,2330,1,21,6,9,61,34,27,69
SC Rheindorf,2330,2,20,7,9,62,44,18,67
SK Sturm Gra,2330,3,20,6,10,60,35,25,66
Vienna,2330,4,20,3,13,70,52,18,63
Admira Wacke,2330,5,14,5,17,40,59,-19,47
Rapid Vienna,2330,6,11,11,14,52,42,10,44
RZ Pellets W,2330,7,11,11,14,52,57,-5,44
Mattersburg,2330,8,10,8,18,40,62,-22,38
SV Josko Rie,2330,9,9,7,20,36,58,-22,34
St. Pölten,2330,10,7,10,19,36,66,-30,31
FC Salzburg,2331,1,20,9,7,69,36,33,69
SC Rheindorf,2331,2,20,9,7,62,48,14,69
SK Sturm Gra,2331,3,19,7,10,68,39,29,64
Vienna,2331,4,18,3,15,68,60,8,57
Rapid Vienna,2331,5,14,10,12,56,45,11,52
RZ Pellets W,2331,6,13,8,15,55,56,-1,47
Admira Wacke,2331,7,13,7,16,44,58,-14,46
SV Josko Rie,2331,8,12,5,19,41,57,-16,41
Mattersburg,2331,9,8,7,21,33,58,-25,31
St. Pölten,2331,10,6,9,21,37,76,-39,27
FC Salzburg,2332,1,21,9,6,71,32,39,72
SK Sturm Gra,2332,2,20,5,11,59,33,26,65
SC Rheindorf,2332,3,19,5,12,62,49,13,62
Rapid Vienna,2332,4,15,13,8,55,37,18,58
Vienna,2332,5,17,7,12,62,52,10,58
RZ Pellets W,2332,6,12,8,16,44,52,-8,44
Admira Wacke,2332,7,12,6,18,35,55,-20,42
Mattersburg,2332,8,8,10,18,40,60,-20,34
SV Josko Rie,2332,9,9,7,20,33,63,-30,34
St. Pölten,2332,10,6,12,18,41,69,-28,30
FC Salzburg,2333,1,23,6,7,71,28,43,75
SC Rheindorf,2333,2,19,10,7,57,43,14,67
Rapid Vienna,2333,3,17,10,9,68,37,31,61
SK Sturm Gra,2333,4,15,10,11,63,51,12,55
Vienna,2333,5,16,7,13,63,52,11,55
RZ Pellets W,2333,6,11,6,19,42,62,-20,39
Mattersburg,2333,7,10,9,17,43,67,-24,39
Admira Wacke,2333,8,11,5,20,37,58,-21,38
SV Josko Rie,2333,9,9,9,18,40,58,-18,36
St. Pölten,2333,10,7,12,17,44,72,-28,33
FC Salzburg,2334,1,22,8,6,71,35,36,74
SC Rheindorf,2334,2,22,5,9,60,44,16,71
SK Sturm Gra,2334,3,18,7,11,56,32,24,61
Vienna,2334,4,18,3,15,57,54,3,57
RZ Pellets W,2334,5,16,5,15,47,56,-9,53
Admira Wacke,2334,6,14,6,16,45,58,-13,48
Rapid Vienna,2334,7,12,11,13,57,44,13,47
SV Josko Rie,2334,8,11,5,20,38,53,-15,38
St. Pölten,2334,9,6,11,19,36,64,-28,29
Mattersburg,2334,10,7,7,22,29,56,-27,28
FC Salzburg,2335,1,22,8,6,64,30,34,74
SC Rheindorf,2335,2,21,6,9,61,42,19,69
SK Sturm Gra,2335,3,20,6,10,67,38,29,66
Vienna,2335,4,18,5,13,65,52,13,59
Rapid Vienna,2335,5,14,10,12,50,39,11,52
Admira Wacke,2335,6,11,8,17,38,59,-21,41
RZ Pellets W,2335,7,11,6,19,43,61,-18,39
St. Pölten,2335,8,9,10,17,44,63,-19,37
Mattersburg,2335,9,9,9,18,34,54,-20,36
SV Josko Rie,2335,10,9,4,23,35,63,-28,31
FC Salzburg,2336,1,25,5,6,74,29,45,80
SK Sturm Gra,2336,2,19,7,10,56,30,26,64
Vienna,2336,3,17,4,15,59,55,4,55
SC Rheindorf,2336,4,15,8,13,50,48,2,53
Rapid Vienna,2336,5,12,12,12,51,44,7,48
RZ Pellets W,2336,6,12,10,14,52,58,-6,46
SV Josko Rie,2336,7,13,2,21,39,59,-20,41
Admira Wacke,2336,8,11,8,17,37,59,-22,41
Mattersburg,2336,9,11,7,18,42,56,-14,40
St. Pölten,2336,10,7,13,16,40,62,-22,34
SC Rheindorf,2337,1,21,8,7,59,36,23,71
FC Salzburg,2337,2,19,10,7,61,30,31,67
SK Sturm Gra,2337,3,16,8,12,58,44,14,56
Rapid Vienna,2337,4,14,11,11,55,37,18,53
Vienna,2337,5,16,5,15,62,63,-1,53
Admira Wacke,2337,6,15,7,14,43,52,-9,52
RZ Pellets W,2337,7,10,12,14,43,53,-10,42
SV Josko Rie,2337,8,10,7,19,35,54,-19,37
Mattersburg,2337,9,7,11,18,31,53,-22,32
St. Pölten,2337,10,7,11,18,35,60,-25,32
FC Salzburg,2338,1,21,7,8,66,32,34,70
SK Sturm Gra,2338,2,20,7,9,58,31,27,67
Vienna,2338,3,20,7,9,67,49,18,67
SC Rheindorf,2338,4,16,12,8,48,39,9,60
Rapid Vienna,2338,5,16,10,10,59,42,17,58
RZ Pellets W,2338,6,13,7,16,41,51,-10,46
Mattersburg,2338,7,9,10,17,39,56,-17,37
Admira Wacke,2338,8,10,7,19,30,57,-27,37
St. Pölten,2338,9,7,10,19,45,69,-24,31
SV Josko Rie,2338,10,8,3,25,27,54,-27,27
FC Salzburg,2339,1,20,8,8,61,31,30,68
Vienna,2339,2,18,8,10,60,52,8,62
SC Rheindorf,2339,3,18,8,10,53,48,5,62
Rapid Vienna,2339,4,16,11,9,65,39,26,59
SK Sturm Gra,2339,5,16,5,15,55,38,17,53
SV Josko Rie,2339,6,14,5,17,44,49,-5,47
RZ Pellets W,2339,7,11,11,14,38,49,-11,44
Admira Wacke,2339,8,11,8,17,42,58,-16,41
Mattersburg,2339,9,9,9,18,38,61,-23,36
St. Pölten,2339,10,6,9,21,34,65,-31,27
Vienna,2340,1,23,4,9,73,47,26,73
FC Salzburg,2340,2,20,9,7,66,30,36,69
SC Rheindorf,2340,3,20,8,8,60,40,20,68
SK Sturm Gra,2340,4,19,7,10,57,34,23,64
Rapid Vienna,2340,5,12,13,11,60,46,14,49
Admira Wacke,2340,6,13,7,16,38,53,-15,46
SV Josko Rie,2340,7,11,6,19,35,52,-17,39
RZ Pellets W,2340,8,10,6,20,45,61,-16,36
Mattersburg,2340,9,8,6,22,37,70,-33,30
St. Pölten,2340,10,6,10,20,40,78,-38,28
FC Salzburg,2341,1,20,7,9,66,33,33,67
SK Sturm Gra,2341,2,19,8,9,59,32,27,65
Rapid Vienna,2341,3,17,10,9,60,38,22,61
Vienna,2341,4,19,3,14,63,54,9,60
SC Rheindorf,2341,5,18,6,12,59,53,6,60
RZ Pellets W,2341,6,12,7,17,43,57,-14,43
Admira Wacke,2341,7,12,6,18,42,63,-21,42
SV Josko Rie,2341,8,11,6,19,32,52,-20,39
St. Pölten,2341,9,9,8,19,39,64,-25,35
Mattersburg,2341,10,8,9,19,38,55,-17,33
FC Salzburg,2342,1,19,10,7,64,33,31,67
Vienna,2342,2,20,6,10,69,49,20,66
SC Rheindorf,2342,3,19,8,9,50,39,11,65
SK Sturm Gra,2342,4,18,6,12,56,32,24,60
Rapid Vienna,2342,5,14,11,11,54,39,15,53
Admira Wacke,2342,6,14,6,16,43,53,-10,48
RZ Pellets W,2342,7,12,8,16,43,57,-14,44
St. Pölten,2342,8,10,6,20,43,63,-20,36
Mattersburg,2342,9,7,11,18,34,57,-23,32
SV Josko Rie,2342,10,9,4,23,31,65,-34,31
FC Salzburg,2343,1,20,9,7,60,30,30,69
SK Sturm Gra,2343,2,19,6,11,59,37,22,63
SC Rheindorf,2343,3,17,8,11,49,43,6,59
Vienna,2343,4,17,6,13,57,51,6,57
Rapid Vienna,2343,5,13,11,12,55,41,14,50
RZ Pellets W,2343,6,13,10,13,46,47,-1,49
Admira Wacke,2343,7,14,6,16,39,54,-15,48
Mattersburg,2343,8,13,8,15,40,45,-5,47
SV Josko Rie,2343,9,7,7,22,26,53,-27,28
St. Pölten,2343,10,4,15,17,32,62,-30,27
SK Sturm Gra,2344,1,21,6,9,66,39,27,69
SC Rheindorf,2344,2,20,7,9,57,43,14,67
FC Salzburg,2344,3,18,10,8,66,36,30,64
Vienna,2344,4,18,5,13,56,49,7,59
Rapid Vienna,2344,5,15,8,13,58,41,17,53
RZ Pellets W,2344,6,12,9,15,44,53,-9,45
Admira Wacke,2344,7,13,5,18,40,59,-19,44
SV Josko Rie,2344,8,9,9,18,31,52,-21,36
St. Pölten,2344,9,9,8,19,43,61,-18,35
Mattersburg,2344,10,6,11,19,33,61,-28,29
SC Rheindorf,2345,1,21,8,7,58,39,19,71
FC Salzburg,2345,2,19,7,10,62,35,27,64
SK Sturm Gra,2345,3,19,4,13,55,35,20,61
Vienna,2345,4,18,5,13,62,53,9,59
Rapid Vienna,2345,5,16,10,10,60,42,18,58
RZ Pellets W,2345,6,11,9,16,40,57,-17,42
Mattersburg,2345,7,11,8,17,44,53,-9,41
Admira Wacke,2345,8,11,5,20,40,62,-22,38
SV Josko Rie,2345,9,11,5,20,31,53,-22,38
St. Pölten,2345,10,8,9,19,38,61,-23,33
FC Salzburg,2346,1,23,6,7,69,28,41,75
SK Sturm Gra,2346,2,20,5,11,61,37,24,65
Vienna,2346,3,19,7,10,73,47,26,64
SC Rheindorf,2346,4,17,7,12,55,50,5,58
Rapid Vienna,2346,5,13,8,15,47,41,6,47
Admira Wacke,2346,6,13,7,16,38,58,-20,46
St. Pölten,2346,7,10,10,16,40,61,-21,40
SV Josko Rie,2346,8,11,6,19,39,59,-20,39
RZ Pellets W,2346,9,10,7,19,39,66,-27,37
Mattersburg,2346,10,9,7,20,39,53,-14,34
FC Salzburg,2347,1,22,6,8,69,31,38,72
SC Rheindorf,2347,2,20,6,10,54,43,11,66
Vienna,2347,3,19,6,11,64,50,14,63
SK Sturm Gra,2347,4,18,6,12,56,42,14,60
RZ Pellets W,2347,5,13,7,16,50,56,-6,46
Rapid Vienna,2347,6,12,9,15,55,50,5,45
Admira Wacke,2347,7,12,5,19,40,63,-23,41
St. Pölten,2347,8,9,12,15,46,60,-14,39
Mattersburg,2347,9,10,8,18,40,56,-16,38
SV Josko Rie,2347,10,10,5,21,33,56,-23,35
FC Salzburg,2348,1,21,8,7,72,36,36,71
SK Sturm Gra,2348,2,19,9,8,64,35,29,66
SC Rheindorf,2348,3,18,6,12,62,53,9,60
Vienna,2348,4,18,5,13,67,58,9,59
Rapid Vienna,2348,5,15,10,11,63,38,25,55
RZ Pellets W,2348,6,12,10,14,46,53,-7,46
SV Josko Rie,2348,7,12,6,18,39,60,-21,42
Mattersburg,2348,8,9,9,18,44,60,-16,36
Admira Wacke,2348,9,9,7,20,32,62,-30,34
St. Pölten,2348,10,6,12,18,38,72,-34,30
FC Salzburg,2349,1,22,7,7,67,31,36,73
SK Sturm Gra,2349,2,21,7,8,58,27,31,70
SC Rheindorf,2349,3,18,7,11,58,47,11,61
Vienna,2349,4,16,8,12,64,50,14,56
RZ Pellets W,2349,5,14,9,13,50,54,-4,51
Rapid Vienna,2349,6,11,12,13,52,43,9,45
Mattersburg,2349,7,11,7,18,36,58,-22,40
SV Josko Rie,2349,8,11,5,20,36,56,-20,38
Admira Wacke,2349,9,10,6,20,38,66,-28,36
St. Pölten,2349,10,7,10,19,42,69,-27,31
FC Salzburg,2350,1,22,7,7,67,31,36,73
SC Rheindorf,2350,2,22,4,10,60,39,21,70
Vienna,2350,3,22,3,11,72,47,25,69
SK Sturm Gra,2350,4,17,10,9,56,34,22,61
RZ Pellets W,2350,5,13,8,15,49,52,-3,47
Rapid Vienna,2350,6,11,13,12,49,41,8,46
Admira Wacke,2350,7,11,8,17,33,54,-21,41
SV Josko Rie,2350,8,9,7,20,31,52,-21,34
St. Pölten,2350,9,8,8,20,35,74,-39,32
Mattersburg,2350,10,6,10,20,32,60,-28,28
FC Salzburg,2351,1,21,6,9,67,30,37,69
SC Rheindorf,2351,2,18,9,9,59,48,11,63
Vienna,2351,3,19,5,12,64,54,10,62
SK Sturm Gra,2351,4,17,9,10,52,29,23,60
Rapid Vienna,2351,5,15,10,11,56,39,17,55
Mattersburg,2351,6,12,7,17,44,55,-11,43
SV Josko Rie,2351,7,12,6,18,33,47,-14,42
RZ Pellets W,2351,8,11,7,18,42,59,-17,40
Admira Wacke,2351,9,10,6,20,32,60,-28,36
St. Pölten,2351,10,6,13,17,40,68,-28,31
FC Salzburg,2352,1,21,7,8,59,26,33,70
Vienna,2352,2,19,5,12,62,49,13,62
SK Sturm Gra,2352,3,17,10,9,56,30,26,61
SC Rheindorf,2352,4,17,9,10,49,45,4,60
Rapid Vienna,2352,5,12,14,10,51,38,13,50
Admira Wacke,2352,6,14,5,17,36,53,-17,47
SV Josko Rie,2352,7,14,4,18,39,47,-8,46
RZ Pellets W,2352,8,12,10,14,37,46,-9,46
St. Pölten,2352,9,7,10,19,36,61,-25,31
Mattersburg,2352,10,6,8,22,31,61,-30,26
FC Salzburg,2353,1,25,6,5,72,25,47,81
SC Rheindorf,2353,2,21,4,11,64,46,18,67
SK Sturm Gra,2353,3,20,6,10,62,38,24,66
Vienna,2353,4,19,5,12,67,58,9,62
Rapid Vienna,2353,5,12,10,14,52,42,10,46
RZ Pellets W,2353,6,11,9,16,42,57,-15,42
Mattersburg,2353,7,9,11,16,35,49,-14,38
SV Josko Rie,2353,8,11,5,20,33,56,-23,38
Admira Wacke,2353,9,9,7,20,35,64,-29,34
St. Pölten,2353,10,8,7,21,40,67,-27,31
SC Rheindorf,2354,1,22,7,7,62,41,21,73
FC Salzburg,2354,2,20,7,9,62,33,29,67
SK Sturm Gra,2354,3,19,8,9,60,32,28,65
Vienna,2354,4,19,6,11,55,46,9,63
Rapid Vienna,2354,5,13,10,13,52,37,15,49
RZ Pellets W,2354,6,13,5,18,44,56,-12,44
Admira Wacke,2354,7,12,7,17,39,55,-16,43
Mattersburg,2354,8,11,8,17,37,51,-14,41
SV Josko Rie,2354,9,11,3,22,36,64,-28,36
St. Pölten,2354,10,6,7,23,34,66,-32,25
SK Sturm Gra,2355,1,21,6,9,63,32,31,69
SC Rheindorf,2355,2,19,5,12,56,43,13,62
Vienna,2355,3,19,4,13,61,52,9,61
FC Salzburg,2355,4,16,12,8,56,38,18,60
Rapid Vienna,2355,5,15,11,10,66,39,27,56
RZ Pellets W,2355,6,16,6,14,48,48,0,54
Admira Wacke,2355,7,11,8,17,34,57,-23,41
SV Josko Rie,2355,8,11,6,19,30,47,-17,39
Mattersburg,2355,9,7,12,17,35,55,-20,33
St. Pölten,2355,10,5,10,21,32,70,-38,25
SC Rheindorf,2356,1,20,6,10,58,45,13,66
FC Salzburg,2356,2,18,9,9,63,36,27,63
Vienna,2356,3,19,4,13,60,50,10,61
SK Sturm Gra,2356,4,18,6,12,59,38,21,60
Rapid Vienna,2356,5,13,10,13,56,44,12,49
RZ Pellets W,2356,6,14,5,17,47,56,-9,47
St. Pölten,2356,7,13,6,17,52,69,-17,45
Admira Wacke,2356,8,13,6,17,42,60,-18,45
Mattersburg,2356,9,10,8,18,37,56,-19,38
SV Josko Rie,2356,10,10,4,22,40,60,-20,34
SK Sturm Gra,2357,1,23,5,8,68,33,35,74
FC Salzburg,2357,2,21,9,6,68,27,41,72
SC Rheindorf,2357,3,17,11,8,54,42,12,62
Vienna,2357,4,17,6,13,69,56,13,57
RZ Pellets W,2357,5,14,6,16,56,60,-4,48
Rapid Vienna,2357,6,11,11,14,47,46,1,44
Admira Wacke,2357,7,12,5,19,36,66,-30,41
St. Pölten,2357,8,9,11,16,44,65,-21,38
Mattersburg,2357,9,8,8,20,36,59,-23,32
SV Josko Rie,2357,10,8,8,20,33,57,-24,32
SC Rheindorf,2358,1,23,6,7,64,41,23,75
FC Salzburg,2358,2,19,9,8,60,31,29,66
SK Sturm Gra,2358,3,19,9,8,57,32,25,66
Vienna,2358,4,18,8,10,64,41,23,62
Rapid Vienna,2358,5,15,11,10,56,38,18,56
St. Pölten,2358,6,12,7,17,45,59,-14,43
Admira Wacke,2358,7,11,8,17,39,64,-25,41
Mattersburg,2358,8,8,10,18,33,55,-22,34
RZ Pellets W,2358,9,8,7,21,41,66,-25,31
SV Josko Rie,2358,10,7,5,24,30,62,-32,26
FC Salzburg,2359,1,21,9,6,60,26,34,72
SK Sturm Gra,2359,2,20,8,8,69,37,32,68
SC Rheindorf,2359,3,17,10,9,53,41,12,61
Vienna,2359,4,15,3,18,53,58,-5,48
Admira Wacke,2359,5,13,9,14,41,54,-13,48
RZ Pellets W,2359,6,13,8,15,47,53,-6,47
Rapid Vienna,2359,7,11,11,14,59,51,8,44
St. Pölten,2359,8,11,10,15,55,69,-14,43
SV Josko Rie,2359,9,11,6,19,35,55,-20,39
Mattersburg,2359,10,7,8,21,33,61,-28,29
FC Salzburg,2360,1,23,7,6,69,28,41,76
SC Rheindorf,2360,2,21,8,7,53,39,14,71
Vienna,2360,3,17,5,14,57,52,5,56
Rapid Vienna,2360,4,15,10,11,55,41,14,55
SK Sturm Gra,2360,5,15,8,13,56,42,14,53
SV Josko Rie,2360,6,13,4,19,39,55,-16,43
RZ Pellets W,2360,7,12,6,18,45,58,-13,42
Admira Wacke,2360,8,11,5,20,37,61,-24,38
St. Pölten,2360,9,8,11,17,47,64,-17,35
Mattersburg,2360,10,9,8,19,37,55,-18,35
FC Salzburg,2361,1,22,7,7,61,25,36,73
SC Rheindorf,2361,2,20,5,11,55,42,13,65
Vienna,2361,3,19,7,10,61,49,12,64
Rapid Vienna,2361,4,16,10,10,64,42,22,58
SK Sturm Gra,2361,5,16,7,13,57,40,17,55
RZ Pellets W,2361,6,13,7,16,48,57,-9,46
Admira Wacke,2361,7,11,6,19,39,64,-25,39
SV Josko Rie,2361,8,11,5,20,39,60,-21,38
Mattersburg,2361,9,9,7,20,35,55,-20,34
St. Pölten,2361,10,8,9,19,34,59,-25,33
FC Salzburg,2362,1,20,9,7,65,32,33,69
SC Rheindorf,2362,2,20,9,7,57,37,20,69
SK Sturm Gra,2362,3,19,5,12,58,36,22,62
Rapid Vienna,2362,4,16,9,11,60,41,19,57
Vienna,2362,5,15,7,14,61,59,2,52
RZ Pellets W,2362,6,14,7,15,46,52,-6,49
SV Josko Rie,2362,7,11,8,17,33,48,-15,41
Mattersburg,2362,8,10,7,19,38,55,-17,37
Admira Wacke,2362,9,9,7,20,33,68,-35,34
St. Pölten,2362,10,6,12,18,37,60,-23,30
Vienna,2363,1,22,5,9,64,42,22,71
SK Sturm Gra,2363,2,21,3,12,61,36,25,66
SC Rheindorf,2363,3,18,12,6,58,39,19,66
FC Salzburg,2363,4,17,10,9,56,35,21,61
Rapid Vienna,2363,5,15,12,9,56,37,19,57
RZ Pellets W,2363,6,11,9,16,43,51,-8,42
St. Pölten,2363,7,10,11,15,47,61,-14,41
SV Josko Rie,2363,8,10,8,18,37,56,-19,38
Admira Wacke,2363,9,8,6,22,32,66,-34,30
Mattersburg,2363,10,5,10,21,30,61,-31,25
FC Salzburg,2364,1,23,7,6,77,30,47,76
SK Sturm Gra,2364,2,19,8,9,62,31,31,65
SC Rheindorf,2364,3,18,9,9,52,44,8,63
Vienna,2364,4,19,5,12,68,54,14,62
Rapid Vienna,2364,5,13,10,13,55,42,13,49
Admira Wacke,2364,6,12,5,19,37,63,-26,41
RZ Pellets W,2364,7,11,7,18,44,59,-15,40
SV Josko Rie,2364,8,10,9,17,33,49,-16,39
St. Pölten,2364,9,8,11,17,34,60,-26,35
Mattersburg,2364,10,7,9,20,31,61,-30,30
FC Salzburg,2365,1,20,9,7,66,32,34,69
SK Sturm Gra,2365,2,20,6,10,66,40,26,66
Vienna,2365,3,20,3,13,67,57,10,63
SC Rheindorf,2365,4,19,6,11,55,46,9,63
Rapid Vienna,2365,5,15,10,11,61,42,19,55
RZ Pellets W,2365,6,12,7,17,49,60,-11,43
Admira Wacke,2365,7,13,3,20,38,60,-22,42
SV Josko Rie,2365,8,12,4,20,43,52,-9,40
Mattersburg,2365,9,10,6,20,39,64,-25,36
St. Pölten,2365,10,8,8,20,41,72,-31,32
SK Sturm Gra,2366,1,18,10,8,60,35,25,64
SC Rheindorf,2366,2,18,9,9,53,43,10,63
Rapid Vienna,2366,3,16,11,9,57,36,21,59
FC Salzburg,2366,4,15,12,9,54,32,22,57
Vienna,2366,5,16,7,13,57,50,7,55
RZ Pellets W,2366,6,14,8,14,47,52,-5,50
SV Josko Rie,2366,7,11,5,20,37,53,-16,38
Admira Wacke,2366,8,9,10,17,37,64,-27,37
Mattersburg,2366,9,7,14,15,36,50,-14,35
St. Pölten,2366,10,8,10,18,42,65,-23,34
SC Rheindorf,2367,1,25,5,6,68,39,29,80
FC Salzburg,2367,2,22,9,5,72,29,43,75
SK Sturm Gra,2367,3,18,6,12,59,35,24,60
Vienna,2367,4,17,3,16,62,56,6,54
Rapid Vienna,2367,5,13,11,12,54,43,11,50
Admira Wacke,2367,6,12,8,16,40,56,-16,44
St. Pölten,2367,7,10,10,16,41,60,-19,40
RZ Pellets W,2367,8,11,7,18,45,65,-20,40
SV Josko Rie,2367,9,10,4,22,30,58,-28,34
Mattersburg,2367,10,7,7,22,33,63,-30,28
SC Rheindorf,2368,1,21,7,8,52,37,15,70
SK Sturm Gra,2368,2,21,5,10,62,33,29,68
Vienna,2368,3,20,5,11,63,48,15,65
Rapid Vienna,2368,4,17,9,10,62,41,21,60
FC Salzburg,2368,5,17,8,11,60,38,22,59
RZ Pellets W,2368,6,13,5,18,42,59,-17,44
Admira Wacke,2368,7,11,6,19,39,54,-15,39
SV Josko Rie,2368,8,11,5,20,34,56,-22,38
St. Pölten,2368,9,8,9,19,39,62,-23,33
Mattersburg,2368,10,7,9,20,32,57,-25,30
FC Salzburg,2369,1,22,6,8,61,28,33,72
SC Rheindorf,2369,2,18,10,8,51,41,10,64
SK Sturm Gra,2369,3,19,6,11,60,34,26,63
Vienna,2369,4,19,6,11,61,43,18,63
Rapid Vienna,2369,5,13,10,13,51,39,12,49
RZ Pellets W,2369,6,14,5,17,47,58,-11,47
Mattersburg,2369,7,12,9,15,44,52,-8,45
Admira Wacke,2369,8,10,8,18,33,57,-24,38
SV Josko Rie,2369,9,8,7,21,23,49,-26,31
St. Pölten,2369,10,7,9,20,31,61,-30,30
FC Salzburg,2370,1,21,10,5,70,29,41,73
SC Rheindorf,2370,2,21,9,6,57,31,26,72
SK Sturm Gra,2370,3,17,7,12,56,37,19,58
Vienna,2370,4,17,4,15,57,56,1,55
Rapid Vienna,2370,5,12,13,11,53,38,15,49
SV Josko Rie,2370,6,13,6,17,35,53,-18,45
RZ Pellets W,2370,7,11,8,17,49,59,-10,41
Mattersburg,2370,8,9,9,18,43,59,-16,36
Admira Wacke,2370,9,9,8,19,34,63,-29,35
St. Pölten,2370,10,8,10,18,37,66,-29,34
FC Salzburg,2371,1,22,7,7,67,31,36,73
SC Rheindorf,2371,2,22,6,8,62,40,22,72
SK Sturm Gra,2371,3,17,9,10,57,38,19,60
Vienna,2371,4,16,6,14,58,59,-1,54
Rapid Vienna,2371,5,14,10,12,57,46,11,52
Mattersburg,2371,6,12,8,16,45,47,-2,44
RZ Pellets W,2371,7,12,8,16,48,52,-4,44
SV Josko Rie,2371,8,11,6,19,36,52,-16,39
Admira Wacke,2371,9,10,5,21,31,62,-31,35
St. Pölten,2371,10,6,11,19,38,72,-34,29
FC Salzburg,2372,1,24,7,5,69,27,42,79
SC Rheindorf,2372,2,20,9,7,59,40,19,69
SK Sturm Gra,2372,3,17,8,11,57,40,17,59
Vienna,2372,4,15,9,12,56,49,7,54
Rapid Vienna,2372,5,12,12,12,49,38,11,48
Admira Wacke,2372,6,12,9,15,48,65,-17,45
RZ Pellets W,2372,7,11,8,17,45,57,-12,41
SV Josko Rie,2372,8,11,6,19,35,57,-22,39
St. Pölten,2372,9,8,10,18,44,65,-21,34
Mattersburg,2372,10,6,10,20,34,58,-24,28
FC Salzburg,2373,1,19,7,10,62,35,27,64
Vienna,2373,2,19,7,10,65,45,20,64
SK Sturm Gra,2373,3,18,9,9,55,34,21,63
SC Rheindorf,2373,4,17,6,13,51,45,6,57
Rapid Vienna,2373,5,15,11,10,58,39,19,56
RZ Pellets W,2373,6,12,10,14,43,55,-12,46
SV Josko Rie,2373,7,13,3,20,44,54,-10,42
Admira Wacke,2373,8,12,4,20,41,60,-19,40
St. Pölten,2373,9,10,9,17,40,63,-23,39
Mattersburg,2373,10,8,8,20,35,64,-29,32
FC Salzburg,2374,1,20,10,6,65,26,39,70
SK Sturm Gra,2374,2,19,8,9,59,34,25,65
SC Rheindorf,2374,3,19,8,9,52,45,7,65
Vienna,2374,4,17,7,12,63,54,9,58
Rapid Vienna,2374,5,16,9,11,57,36,21,57
RZ Pellets W,2374,6,14,8,14,51,55,-4,50
Admira Wacke,2374,7,11,8,17,37,56,-19,41
SV Josko Rie,2374,8,9,7,20,35,54,-19,34
Mattersburg,2374,9,7,11,18,35,58,-23,32
St. Pölten,2374,10,6,8,22,35,71,-36,26
FC Salzburg,2375,1,23,7,6,70,28,42,76
SK Sturm Gra,2375,2,20,6,10,59,36,23,66
Vienna,2375,3,20,5,11,68,50,18,65
Rapid Vienna,2375,4,15,11,10,56,37,19,56
SC Rheindorf,2375,5,17,5,14,51,47,4,56
Admira Wacke,2375,6,11,7,18,29,49,-20,40
RZ Pellets W,2375,7,10,9,17,42,60,-18,39
Mattersburg,2375,8,9,8,19,34,58,-24,35
St. Pölten,2375,9,8,11,17,40,65,-25,35
SV Josko Rie,2375,10,7,11,18,30,49,-19,32
Vienna,2376,1,22,6,8,72,48,24,72
FC Salzburg,2376,2,21,7,8,62,31,31,70
SK Sturm Gra,2376,3,18,7,11,60,38,22,61
SC Rheindorf,2376,4,17,8,11,52,46,6,59
Rapid Vienna,2376,5,13,13,10,58,41,17,52
RZ Pellets W,2376,6,12,7,17,49,63,-14,43
Admira Wacke,2376,7,11,9,16,39,56,-17,42
SV Josko Rie,2376,8,10,7,19,29,52,-23,37
Mattersburg,2376,9,9,6,21,35,54,-19,33
St. Pölten,2376,10,7,10,19,37,64,-27,31
SC Rheindorf,2377,1,20,8,8,57,40,17,68
FC Salzburg,2377,2,18,9,9,64,35,29,63
Vienna,2377,3,19,5,12,53,45,8,62
SK Sturm Gra,2377,4,17,7,12,55,45,10,58
Mattersburg,2377,5,14,7,15,43,47,-4,49
Rapid Vienna,2377,6,11,15,10,58,46,12,48
Admira Wacke,2377,7,12,8,16,47,54,-7,44
RZ Pellets W,2377,8,11,8,17,44,59,-15,41
SV Josko Rie,2377,9,9,8,19,30,54,-24,35
St. Pölten,2377,10,6,11,19,40,66,-26,29
FC Salzburg,2378,1,23,7,6,64,29,35,76
SK Sturm Gra,2378,2,20,4,12,67,33,34,64
Vienna,2378,3,19,6,11,66,49,17,63
SC Rheindorf,2378,4,17,9,10,56,45,11,60
Rapid Vienna,2378,5,15,8,13,52,45,7,53
RZ Pellets W,2378,6,12,9,15,41,53,-12,45
Admira Wacke,2378,7,11,6,19,35,60,-25,39
SV Josko Rie,2378,8,11,5,20,32,52,-20,38
St. Pölten,2378,9,9,10,17,41,61,-20,37
Mattersburg,2378,10,6,10,20,34,61,-27,28
SC Rheindorf,2379,1,20,10,6,60,40,20,70
FC Salzburg,2379,2,19,9,8,80,43,37,66
SK Sturm Gra,2379,3,19,5,12,56,36,20,62
Vienna,2379,4,17,6,13,65,57,8,57
RZ Pellets W,2379,5,15,8,13,47,47,0,53
Rapid Vienna,2379,6,12,13,11,61,48,13,49
Admira Wacke,2379,7,11,7,18,33,57,-24,40
Mattersburg,2379,8,10,9,17,42,59,-17,39
St. Pölten,2379,9,7,10,19,41,65,-24,31
SV Josko Rie,2379,10,8,7,21,34,67,-33,31
FC Salzburg,2380,1,23,8,5,73,23,50,77
SC Rheindorf,2380,2,20,8,8,56,37,19,68
SK Sturm Gra,2380,3,19,8,9,54,28,26,65
Vienna,2380,4,15,7,14,59,57,2,52
RZ Pellets W,2380,5,14,8,14,50,52,-2,50
Admira Wacke,2380,6,13,8,15,37,53,-16,47
Rapid Vienna,2380,7,11,13,12,50,41,9,46
St. Pölten,2380,8,7,12,17,43,68,-25,33
SV Josko Rie,2380,9,8,6,22,30,61,-31,30
Mattersburg,2380,10,7,8,21,34,66,-32,29
SC Rheindorf,2381,1,23,6,7,66,37,29,75
FC Salzburg,2381,2,21,6,9,69,33,36,69
SK Sturm Gra,2381,3,20,6,10,64,39,25,66
Rapid Vienna,2381,4,14,13,9,56,38,18,55
RZ Pellets W,2381,5,13,9,14,52,54,-2,48
Vienna,2381,6,14,6,16,56,67,-11,48
Admira Wacke,2381,7,12,7,17,39,60,-21,43
St. Pölten,2381,8,10,8,18,47,69,-22,38
SV Josko Rie,2381,9,10,4,22,33,57,-24,34
Mattersburg,2381,10,6,9,21,34,62,-28,27
SK Sturm Gra,2382,1,21,5,10,58,31,27,68
FC Salzburg,2382,2,17,13,6,57,26,31,64
SC Rheindorf,2382,3,18,9,9,56,47,9,63
Vienna,2382,4,18,5,13,60,52,8,59
Rapid Vienna,2382,5,13,15,8,53,33,20,54
St. Pölten,2382,6,9,12,15,37,57,-20,39
Admira Wacke,2382,7,9,11,16,35,59,-24,38
SV Josko Rie,2382,8,9,10,17,37,54,-17,37
RZ Pellets W,2382,9,9,9,18,38,54,-16,36
Mattersburg,2382,10,5,15,16,34,52,-18,30
FC Salzburg,2383,1,21,8,7,67,31,36,71
SC Rheindorf,2383,2,19,9,8,51,36,15,66
SK Sturm Gra,2383,3,19,8,9,58,27,31,65
Vienna,2383,4,18,5,13,62,48,14,59
Mattersburg,2383,5,14,6,16,42,50,-8,48
RZ Pellets W,2383,6,12,8,16,43,54,-11,44
Rapid Vienna,2383,7,10,12,14,51,46,5,42
St. Pölten,2383,8,9,11,16,41,62,-21,38
SV Josko Rie,2383,9,10,5,21,33,58,-25,35
Admira Wacke,2383,10,9,6,21,29,65,-36,33
FC Salzburg,2384,1,22,8,6,72,31,41,74
SC Rheindorf,2384,2,17,8,11,53,49,4,59
SK Sturm Gra,2384,3,17,6,13,58,41,17,57
Vienna,2384,4,16,7,13,59,52,7,55
Rapid Vienna,2384,5,14,11,11,61,38,23,53
RZ Pellets W,2384,6,12,8,16,49,60,-11,44
St. Pölten,2384,7,10,10,16,44,64,-20,40
Admira Wacke,2384,8,11,7,18,36,64,-28,40
SV Josko Rie,2384,9,10,9,17,44,55,-11,39
Mattersburg,2384,10,9,10,17,40,62,-22,37
SK Sturm Gra,2385,1,21,7,8,62,33,29,70
Vienna,2385,2,20,7,9,72,47,25,67
FC Salzburg,2385,3,18,12,6,65,34,31,66
SC Rheindorf,2385,4,16,9,11,58,47,11,57
Rapid Vienna,2385,5,14,8,14,60,47,13,50
Admira Wacke,2385,6,12,8,16,38,60,-22,44
RZ Pellets W,2385,7,12,7,17,46,62,-16,43
SV Josko Rie,2385,8,11,7,18,33,51,-18,40
Mattersburg,2385,9,10,8,18,38,52,-14,38
St. Pölten,2385,10,5,9,22,39,78,-39,24
FC Salzburg,2386,1,24,6,6,83,37,46,78
SK Sturm Gra,2386,2,17,9,10,62,44,18,60
SC Rheindorf,2386,3,17,8,11,52,48,4,59
Rapid Vienna,2386,4,15,10,11,63,42,21,55
Vienna,2386,5,15,8,13,65,60,5,53
SV Josko Rie,2386,6,14,7,15,49,50,-1,49
RZ Pellets W,2386,7,12,8,16,44,60,-16,44
Admira Wacke,2386,8,9,8,19,39,62,-23,35
St. Pölten,2386,9,8,10,18,37,65,-28,34
Mattersburg,2386,10,7,10,19,37,63,-26,31
FC Salzburg,2387,1,22,7,7,66,31,35,73
SK Sturm Gra,2387,2,19,8,9,57,30,27,65
SC Rheindorf,2387,3,19,7,10,58,49,9,64
Vienna,2387,4,19,4,13,63,50,13,61
Rapid Vienna,2387,5,12,12,12,53,44,9,48
RZ Pellets W,2387,6,13,7,16,46,60,-14,46
Admira Wacke,2387,7,12,5,19,38,63,-25,41
St. Pölten,2387,8,9,10,17,43,62,-19,37
SV Josko Rie,2387,9,10,5,21,37,58,-21,35
Mattersburg,2387,10,9,7,20,40,54,-14,34
FC Salzburg,2388,1,19,11,6,61,32,29,68
SC Rheindorf,2388,2,19,10,7,56,38,18,67
Vienna,2388,3,18,7,11,58,48,10,61
SK Sturm Gra,2388,4,16,8,12,52,37,15,56
Rapid Vienna,2388,5,12,12,12,54,41,13,48
Admira Wacke,2388,6,12,7,17,35,53,-18,43
St. Pölten,2388,7,10,10,16,41,55,-14,40
RZ Pellets W,2388,8,11,7,18,40,59,-19,40
SV Josko Rie,2388,9,9,9,18,32,46,-14,36
Mattersburg,2388,10,9,9,18,38,58,-20,36
FC Salzburg,2389,1,21,9,6,67,29,38,72
SK Sturm Gra,2389,2,21,6,9,61,31,30,69
Vienna,2389,3,21,2,13,70,53,17,65
SC Rheindorf,2389,4,18,7,11,54,49,5,61
Rapid Vienna,2389,5,16,10,10,63,44,19,58
Admira Wacke,2389,6,14,5,17,47,58,-11,47
RZ Pellets W,2389,7,12,5,19,42,60,-18,41
St. Pölten,2389,8,10,7,19,47,63,-16,37
Mattersburg,2389,9,8,6,22,36,64,-28,30
SV Josko Rie,2389,10,7,7,22,27,63,-36,28
FC Salzburg,2390,1,25,5,6,75,29,46,80
SC Rheindorf,2390,2,19,8,9,55,44,11,65
SK Sturm Gra,2390,3,19,7,10,57,36,21,64
Vienna,2390,4,17,6,13,63,57,6,57
Rapid Vienna,2390,5,14,11,11,49,36,13,53
Admira Wacke,2390,6,11,9,16,40,57,-17,42
RZ Pellets W,2390,7,11,7,18,48,59,-11,40
SV Josko Rie,2390,8,10,7,19,35,56,-21,37
Mattersburg,2390,9,8,10,18,36,54,-18,34
St. Pölten,2390,10,6,10,20,41,71,-30,28
Vienna,2391,1,21,3,12,69,46,23,66
FC Salzburg,2391,2,19,5,12,57,32,25,62
SC Rheindorf,2391,3,18,8,10,50,38,12,62
SK Sturm Gra,2391,4,18,6,12,55,35,20,60
Rapid Vienna,2391,5,17,8,11,61,42,19,59
RZ Pellets W,2391,6,13,8,15,44,54,-10,47
SV Josko Rie,2391,7,12,7,17,37,52,-15,43
Admira Wacke,2391,8,12,5,19,39,63,-24,41
St. Pölten,2391,9,9,7,20,38,66,-28,34
Mattersburg,2391,10,8,9,19,37,59,-22,33
FC Salzburg,2392,1,21,9,6,62,28,34,72
SK Sturm Gra,2392,2,21,5,10,65,34,31,68
SC Rheindorf,2392,3,18,8,10,52,46,6,62
Vienna,2392,4,19,3,14,62,48,14,60
Rapid Vienna,2392,5,13,10,13,54,42,12,49
Mattersburg,2392,6,12,6,18,39,55,-16,42
Admira Wacke,2392,7,12,5,19,35,57,-22,41
RZ Pellets W,2392,8,11,7,18,40,59,-19,40
SV Josko Rie,2392,9,11,6,19,35,52,-17,39
St. Pölten,2392,10,9,7,20,39,62,-23,34
FC Salzburg,2393,1,24,6,6,71,28,43,78
SC Rheindorf,2393,2,21,6,9,55,44,11,69
Vienna,2393,3,19,3,14,71,60,11,60
SK Sturm Gra,2393,4,18,4,14,58,46,12,58
RZ Pellets W,2393,5,15,7,14,52,53,-1,52
Rapid Vienna,2393,6,13,9,14,53,37,16,48
Admira Wacke,2393,7,12,5,19,33,58,-25,41
SV Josko Rie,2393,8,11,4,21,35,59,-24,37
St. Pölten,2393,9,10,6,20,41,64,-23,36
Mattersburg,2393,10,8,8,20,35,55,-20,32
FC Salzburg,2394,1,20,9,7,70,33,37,69
SC Rheindorf,2394,2,20,7,9,60,46,14,67
Vienna,2394,3,20,4,12,67,51,16,64
SK Sturm Gra,2394,4,18,6,12,60,46,14,60
Rapid Vienna,2394,5,16,10,10,63,43,20,58
Mattersburg,2394,6,10,9,17,46,57,-11,39
RZ Pellets W,2394,7,10,8,18,38,55,-17,38
St. Pölten,2394,8,10,8,18,48,68,-20,38
Admira Wacke,2394,9,10,7,19,33,62,-29,37
SV Josko Rie,2394,10,10,4,22,36,60,-24,34
FC Salzburg,2395,1,22,8,6,68,29,39,74
SC Rheindorf,2395,2,20,9,7,57,38,19,69
SK Sturm Gra,2395,3,20,6,10,65,34,31,66
Vienna,2395,4,19,7,10,62,48,14,64
Rapid Vienna,2395,5,13,12,11,55,45,10,51
RZ Pellets W,2395,6,10,9,17,42,54,-12,39
St. Pölten,2395,7,10,8,18,43,63,-20,38
SV Josko Rie,2395,8,10,5,21,30,51,-21,35
Admira Wacke,2395,9,9,8,19,35,63,-28,35
Mattersburg,2395,10,6,10,20,32,64,-32,28
SC Rheindorf,2396,1,23,6,7,62,35,27,75
FC Salzburg,2396,2,21,7,8,67,30,37,70
SK Sturm Gra,2396,3,19,10,7,56,31,25,67
Vienna,2396,4,19,4,13,69,52,17,61
Rapid Vienna,2396,5,13,10,13,51,43,8,49
RZ Pellets W,2396,6,12,6,18,47,60,-13,42
SV Josko Rie,2396,7,10,8,18,37,55,-18,38
Mattersburg,2396,8,10,6,20,34,58,-24,36
Admira Wacke,2396,9,9,6,21,34,66,-32,33
St. Pölten,2396,10,7,11,18,35,62,-27,32
FC Salzburg,2397,1,21,7,8,67,29,38,70
SC Rheindorf,2397,2,20,6,10,56,43,13,66
Vienna,2397,3,19,7,10,73,52,21,64
SK Sturm Gra,2397,4,19,7,10,58,42,16,64
Rapid Vienna,2397,5,14,8,14,59,40,19,50
Admira Wacke,2397,6,13,5,18,39,66,-27,44
RZ Pellets W,2397,7,12,6,18,42,57,-15,42
SV Josko Rie,2397,8,10,7,19,33,52,-19,37
St. Pölten,2397,9,10,7,19,37,63,-26,37
Mattersburg,2397,10,8,8,20,38,58,-20,32
SK Sturm Gra,2398,1,23,5,8,67,30,37,74
FC Salzburg,2398,2,18,9,9,57,28,29,63
SC Rheindorf,2398,3,18,9,9,52,41,11,63
Vienna,2398,4,18,5,13,66,53,13,59
Rapid Vienna,2398,5,12,13,11,51,45,6,49
Admira Wacke,2398,6,14,4,18,47,65,-18,46
RZ Pellets W,2398,7,12,8,16,53,65,-12,44
SV Josko Rie,2398,8,11,5,20,34,59,-25,38
Mattersburg,2398,9,9,8,19,34,50,-16,35
St. Pölten,2398,10,7,10,19,45,70,-25,31
FC Salzburg,2399,1,24,6,6,67,23,44,78
SC Rheindorf,2399,2,24,6,6,64,37,27,78
SK Sturm Gra,2399,3,21,7,8,63,32,31,70
Vienna,2399,4,16,5,15,53,53,0,53
Rapid Vienna,2399,5,12,12,12,46,40,6,48
Admira Wacke,2399,6,13,7,16,40,56,-16,46
St. Pölten,2399,7,11,8,17,46,59,-13,41
SV Josko Rie,2399,8,11,3,22,33,56,-23,36
RZ Pellets W,2399,9,9,6,21,41,64,-23,33
Mattersburg,2399,10,5,8,23,37,70,-33,23
FC Salzburg,2400,1,26,6,4,72,26,46,84
SC Rheindorf,2400,2,19,9,8,56,42,14,66
SK Sturm Gra,2400,3,19,6,11,58,36,22,63
Vienna,2400,4,17,3,16,59,57,2,54
Rapid Vienna,2400,5,14,11,11,55,42,13,53
RZ Pellets W,2400,6,13,5,18,49,54,-5,44
Admira Wacke,2400,7,12,4,20,36,61,-25,40
St. Pölten,2400,8,10,8,18,43,58,-15,38
Mattersburg,2400,9,9,7,20,36,61,-25,34
SV Josko Rie,2400,10,9,5,22,30,57,-27,32
SK Sturm Gra,2401,1,21,6,9,69,37,32,69
SC Rheindorf,2401,2,21,6,9,67,51,16,69
FC Salzburg,2401,3,19,8,9,63,32,31,65
Vienna,2401,4,20,3,13,69,55,14,63
Rapid Vienna,2401,5,12,12,12,49,41,8,48
RZ Pellets W,2401,6,12,7,17,51,66,-15,43
St. Pölten,2401,7,11,8,17,47,67,-20,41
Admira Wacke,2401,8,11,6,19,36,61,-25,39
SV Josko Rie,2401,9,9,7,20,36,57,-21,34
Mattersburg,2401,10,8,9,19,35,55,-20,33
SC Rheindorf,2402,1,23,6,7,67,35,32,75
SK Sturm Gra,2402,2,20,7,9,56,30,26,67
FC Salzburg,2402,3,18,9,9,62,33,29,63
Vienna,2402,4,18,7,11,66,60,6,61
Rapid Vienna,2402,5,12,15,9,52,35,17,51
RZ Pellets W,2402,6,10,10,16,44,58,-14,40
Admira Wacke,2402,7,11,5,20,38,65,-27,38
SV Josko Rie,2402,8,9,8,19,34,54,-20,35
Mattersburg,2402,9,8,11,17,38,60,-22,35
St. Pölten,2402,10,8,8,20,40,67,-27,32
FC Salzburg,2403,1,21,7,8,76,37,39,70
SK Sturm Gra,2403,2,20,7,9,62,34,28,67
SC Rheindorf,2403,3,20,7,9,54,43,11,67
Vienna,2403,4,17,4,15,63,55,8,55
Admira Wacke,2403,5,14,6,16,39,56,-17,48
Rapid Vienna,2403,6,12,11,13,55,47,8,47
RZ Pellets W,2403,7,11,9,16,42,52,-10,42
St. Pölten,2403,8,10,7,19,42,60,-18,37
Mattersburg,2403,9,9,9,18,36,58,-22,36
SV Josko Rie,2403,10,10,5,21,28,55,-27,35
Vienna,2404,1,20,6,10,64,47,17,66
FC Salzburg,2404,2,18,11,7,66,34,32,65
SC Rheindorf,2404,3,19,8,9,56,41,15,65
SK Sturm Gra,2404,4,18,7,11,57,42,15,61
Rapid Vienna,2404,5,11,12,13,53,46,7,45
Admira Wacke,2404,6,12,8,16,41,59,-18,44
RZ Pellets W,2404,7,9,13,14,40,51,-11,40
Mattersburg,2404,8,9,11,16,40,54,-14,38
SV Josko Rie,2404,9,10,7,19,38,51,-13,37
St. Pölten,2404,10,7,11,18,40,70,-30,32
FC Salzburg,2405,1,20,11,5,64,29,35,71
SK Sturm Gra,2405,2,21,6,9,62,33,29,69
SC Rheindorf,2405,3,18,7,11,53,47,6,61
Rapid Vienna,2405,4,16,9,11,57,38,19,57
Vienna,2405,5,17,6,13,59,60,-1,57
RZ Pellets W,2405,6,13,7,16,49,57,-8,46
Admira Wacke,2405,7,13,6,17,40,55,-15,45
SV Josko Rie,2405,8,11,3,22,43,60,-17,36
Mattersburg,2405,9,9,8,19,35,54,-19,35
St. Pölten,2405,10,7,7,22,37,66,-29,28
SC Rheindorf,2406,1,24,6,6,63,36,27,78
Vienna,2406,2,21,5,10,70,51,19,68
SK Sturm Gra,2406,3,19,7,10,62,40,22,64
FC Salzburg,2406,4,17,10,9,59,31,28,61
Rapid Vienna,2406,5,12,11,13,46,34,12,47
RZ Pellets W,2406,6,11,8,17,39,55,-16,41
Mattersburg,2406,7,10,8,18,37,56,-19,38
Admira Wacke,2406,8,10,8,18,36,58,-22,38
St. Pölten,2406,9,8,10,18,37,62,-25,34
SV Josko Rie,2406,10,9,5,22,29,55,-26,32
FC Salzburg,2407,1,24,6,6,65,25,40,78
SC Rheindorf,2407,2,20,10,6,60,41,19,70
SK Sturm Gra,2407,3,20,6,10,63,36,27,66
Vienna,2407,4,17,6,13,59,46,13,57
Rapid Vienna,2407,5,13,13,10,55,40,15,52
RZ Pellets W,2407,6,11,8,17,44,63,-19,41
SV Josko Rie,2407,7,12,3,21,34,53,-19,39
St. Pölten,2407,8,8,9,19,40,63,-23,33
Mattersburg,2407,9,7,11,18,39,60,-21,32
Admira Wacke,2407,10,8,8,20,34,66,-32,32
SK Sturm Gra,2408,1,21,5,10,67,39,28,68
SC Rheindorf,2408,2,20,6,10,60,45,15,66
FC Salzburg,2408,3,19,5,12,65,40,25,62
Rapid Vienna,2408,4,17,10,9,61,32,29,61
Vienna,2408,5,19,4,13,58,48,10,61
Admira Wacke,2408,6,13,7,16,36,56,-20,46
RZ Pellets W,2408,7,11,8,17,49,63,-14,41
St. Pölten,2408,8,9,10,17,40,59,-19,37
SV Josko Rie,2408,9,10,6,20,36,55,-19,36
Mattersburg,2408,10,6,9,21,29,64,-35,27
FC Salzburg,2409,1,22,5,9,66,41,25,71
SC Rheindorf,2409,2,19,7,10,63,49,14,64
Vienna,2409,3,20,3,13,68,54,14,63
SK Sturm Gra,2409,4,19,4,13,65,46,19,61
Rapid Vienna,2409,5,14,12,10,58,43,15,54
RZ Pellets W,2409,6,14,7,15,53,56,-3,49
SV Josko Rie,2409,7,14,3,19,41,53,-12,45
St. Pölten,2409,8,9,10,17,45,60,-15,37
Admira Wacke,2409,9,11,3,22,38,65,-27,36
Mattersburg,2409,10,7,8,21,37,67,-30,29
SK Sturm Gra,2410,1,23,6,7,68,29,39,75
FC Salzburg,2410,2,17,9,10,58,36,22,60
SC Rheindorf,2410,3,18,6,12,59,51,8,60
Vienna,2410,4,17,7,12,60,52,8,58
Rapid Vienna,2410,5,13,12,11,52,39,13,51
Mattersburg,2410,6,12,7,17,46,55,-9,43
RZ Pellets W,2410,7,12,7,17,43,54,-11,43
SV Josko Rie,2410,8,11,9,16,41,53,-12,42
Admira Wacke,2410,9,10,6,20,31,59,-28,36
St. Pölten,2410,10,8,9,19,42,72,-30,33
FC Salzburg,2411,1,23,5,8,63,31,32,74
SK Sturm Gra,2411,2,21,8,7,58,28,30,71
SC Rheindorf,2411,3,20,6,10,56,43,13,66
Vienna,2411,4,16,6,14,58,52,6,54
Rapid Vienna,2411,5,13,8,15,45,38,7,47
RZ Pellets W,2411,6,11,13,12,46,50,-4,46
SV Josko Rie,2411,7,13,4,19,45,51,-6,43
Mattersburg,2411,8,12,7,17,36,53,-17,43
Admira Wacke,2411,9,10,6,20,32,62,-30,36
St. Pölten,2411,10,5,9,22,34,65,-31,24
FC Salzburg,2412,1,22,7,7,65,31,34,73
SC Rheindorf,2412,2,20,7,9,55,42,13,67
SK Sturm Gra,2412,3,19,8,9,57,30,27,65
Vienna,2412,4,20,4,12,60,51,9,64
Rapid Vienna,2412,5,15,10,11,56,39,17,55
Mattersburg,2412,6,12,7,17,49,54,-5,43
RZ Pellets W,2412,7,11,9,16,45,56,-11,42
Admira Wacke,2412,8,9,8,19,31,58,-27,35
SV Josko Rie,2412,9,8,5,23,33,60,-27,29
St. Pölten,2412,10,5,13,18,36,66,-30,28
FC Salzburg,2413,1,21,9,6,65,33,32,72
SK Sturm Gra,2413,2,18,8,10,61,37,24,62
Vienna,2413,3,17,8,11,63,53,10,59
SC Rheindorf,2413,4,17,8,11,51,44,7,59
Rapid Vienna,2413,5,15,9,12,58,43,15,54
Admira Wacke,2413,6,12,8,16,37,54,-17,44
RZ Pellets W,2413,7,12,7,17,44,58,-14,43
SV Josko Rie,2413,8,13,3,20,39,49,-10,42
St. Pölten,2413,9,10,9,17,43,63,-20,39
Mattersburg,2413,10,7,7,22,28,55,-27,28
SC Rheindorf,2414,1,21,8,7,55,38,17,71
FC Salzburg,2414,2,20,8,8,59,30,29,68
SK Sturm Gra,2414,3,18,6,12,54,38,16,60
Vienna,2414,4,17,6,13,63,51,12,57
Rapid Vienna,2414,5,15,11,10,59,40,19,56
RZ Pellets W,2414,6,15,4,17,51,56,-5,49
SV Josko Rie,2414,7,14,3,19,40,53,-13,45
Admira Wacke,2414,8,12,6,18,39,63,-24,42
Mattersburg,2414,9,6,10,20,36,60,-24,28
St. Pölten,2414,10,6,10,20,33,60,-27,28
FC Salzburg,2415,1,22,8,6,62,28,34,74
SK Sturm Gra,2415,2,18,8,10,60,33,27,62
Vienna,2415,3,19,3,14,70,57,13,60
SC Rheindorf,2415,4,17,8,11,51,52,-1,59
Rapid Vienna,2415,5,12,15,9,58,39,19,51
RZ Pellets W,2415,6,13,6,17,51,66,-15,45
Mattersburg,2415,7,12,8,16,41,55,-14,44
Admira Wacke,2415,8,11,9,16,39,57,-18,42
SV Josko Rie,2415,9,9,8,19,37,53,-16,35
St. Pölten,2415,10,6,9,21,42,71,-29,27
SC Rheindorf,2416,1,20,8,8,58,37,21,68
FC Salzburg,2416,2,19,5,12,60,39,21,62
Vienna,2416,3,18,5,13,69,54,15,59
SK Sturm Gra,2416,4,16,9,11,54,40,14,57
Rapid Vienna,2416,5,14,12,10,61,42,19,54
RZ Pellets W,2416,6,14,7,15,52,57,-5,49
SV Josko Rie,2416,7,11,7,18,38,52,-14,40
Admira Wacke,2416,8,11,7,18,35,59,-24,40
Mattersburg,2416,9,9,10,17,38,57,-19,37
St. Pölten,2416,10,6,14,16,38,66,-28,32
FC Salzburg,2417,1,21,8,7,72,30,42,71
SC Rheindorf,2417,2,21,6,9,62,39,23,69
SK Sturm Gra,2417,3,20,4,12,61,44,17,64
Vienna,2417,4,18,6,12,69,59,10,60
Rapid Vienna,2417,5,13,12,11,55,41,14,51
St. Pölten,2417,6,11,9,16,40,56,-16,42
Admira Wacke,2417,7,11,7,18,40,61,-21,40
SV Josko Rie,2417,8,10,9,17,31,54,-23,39
RZ Pellets W,2417,9,8,9,19,42,63,-21,33
Mattersburg,2417,10,7,10,19,38,63,-25,31
SC Rheindorf,2418,1,20,8,8,54,44,10,68
Vienna,2418,2,19,6,11,73,56,17,63
FC Salzburg,2418,3,18,8,10,67,41,26,62
SK Sturm Gra,2418,4,18,6,12,59,37,22,60
Rapid Vienna,2418,5,14,12,10,60,39,21,54
RZ Pellets W,2418,6,11,11,14,42,54,-12,44
SV Josko Rie,2418,7,13,5,18,41,55,-14,44
Admira Wacke,2418,8,11,4,21,46,72,-26,37
Mattersburg,2418,9,8,10,18,43,64,-21,34
St. Pölten,2418,10,8,10,18,39,62,-23,34
SK Sturm Gra,2419,1,20,9,7,66,36,30,69
FC Salzburg,2419,2,21,5,10,65,31,34,68
Rapid Vienna,2419,3,20,8,8,65,32,33,68
SC Rheindorf,2419,4,19,7,10,53,35,18,64
Vienna,2419,5,18,5,13,62,53,9,59
Admira Wacke,2419,6,10,9,17,35,60,-25,39
RZ Pellets W,2419,7,9,11,16,47,61,-14,38
SV Josko Rie,2419,8,8,8,20,37,64,-27,32
St. Pölten,2419,9,6,13,17,37,63,-26,31
Mattersburg,2419,10,7,9,20,35,67,-32,30
FC Salzburg,2420,1,20,8,8,66,31,35,68
SC Rheindorf,2420,2,19,6,11,49,43,6,63
Vienna,2420,3,18,5,13,63,56,7,59
SK Sturm Gra,2420,4,17,5,14,55,45,10,56
Rapid Vienna,2420,5,14,13,9,59,39,20,55
RZ Pellets W,2420,6,14,9,13,48,48,0,51
SV Josko Rie,2420,7,12,7,17,36,47,-11,43
Mattersburg,2420,8,11,7,18,40,55,-15,40
Admira Wacke,2420,9,10,6,20,35,63,-28,36
St. Pölten,2420,10,8,8,20,40,64,-24,32
FC Salzburg,2421,1,24,7,5,77,28,49,79
SK Sturm Gra,2421,2,23,5,8,69,27,42,74
SC Rheindorf,2421,3,18,10,8,56,41,15,64
Vienna,2421,4,19,4,13,63,54,9,61
SV Josko Rie,2421,5,13,6,17,43,55,-12,45
RZ Pellets W,2421,6,12,7,17,47,55,-8,43
Rapid Vienna,2421,7,9,11,16,44,50,-6,38
Admira Wacke,2421,8,11,5,20,33,63,-30,38
Mattersburg,2421,9,8,7,21,30,64,-34,31
St. Pölten,2421,10,6,12,18,39,64,-25,30
SK Sturm Gra,2422,1,21,7,8,63,26,37,70
FC Salzburg,2422,2,19,7,10,61,32,29,64
SC Rheindorf,2422,3,19,7,10,45,36,9,64
Vienna,2422,4,17,9,10,58,48,10,60
Rapid Vienna,2422,5,14,12,10,49,36,13,54
Admira Wacke,2422,6,12,7,17,33,56,-23,43
RZ Pellets W,2422,7,10,10,16,39,51,-12,40
St. Pölten,2422,8,9,10,17,37,55,-18,37
SV Josko Rie,2422,9,11,4,21,33,53,-20,37
Mattersburg,2422,10,7,9,20,33,58,-25,30
SK Sturm Gra,2423,1,22,5,9,68,33,35,71
FC Salzburg,2423,2,18,11,7,63,30,33,65
SC Rheindorf,2423,3,19,7,10,58,46,12,64
Vienna,2423,4,18,7,11,60,50,10,61
Rapid Vienna,2423,5,15,10,11,61,45,16,55
RZ Pellets W,2423,6,11,7,18,37,55,-18,40
Mattersburg,2423,7,11,6,19,38,57,-19,39
St. Pölten,2423,8,10,8,18,43,67,-24,38
SV Josko Rie,2423,9,11,4,21,38,52,-14,37
Admira Wacke,2423,10,8,9,19,29,60,-31,33
FC Salzburg,2424,1,22,7,7,66,31,35,73
SC Rheindorf,2424,2,19,10,7,55,39,16,67
SK Sturm Gra,2424,3,18,7,11,51,34,17,61
Vienna,2424,4,15,7,14,57,48,9,52
RZ Pellets W,2424,5,15,7,14,50,57,-7,52
Rapid Vienna,2424,6,13,10,13,58,44,14,49
Admira Wacke,2424,7,13,5,18,37,55,-18,44
SV Josko Rie,2424,8,10,6,20,33,51,-18,36
St. Pölten,2424,9,9,9,18,39,64,-25,36
Mattersburg,2424,10,6,12,18,27,50,-23,30
FC Salzburg,2425,1,22,8,6,69,26,43,74
Vienna,2425,2,17,8,11,54,47,7,59
SK Sturm Gra,2425,3,17,6,13,52,35,17,57
SC Rheindorf,2425,4,15,11,10,50,45,5,56
RZ Pellets W,2425,5,14,7,15,43,51,-8,49
Rapid Vienna,2425,6,12,11,13,52,39,13,47
SV Josko Rie,2425,7,13,6,17,37,48,-11,45
Admira Wacke,2425,8,13,5,18,35,59,-24,44
Mattersburg,2425,9,9,8,19,34,57,-23,35
St. Pölten,2425,10,7,12,17,37,56,-19,33
Vienna,2426,1,21,3,12,59,44,15,66
SK Sturm Gra,2426,2,19,6,11,56,34,22,63
SC Rheindorf,2426,3,18,9,9,51,44,7,63
FC Salzburg,2426,4,18,8,10,56,32,24,62
Rapid Vienna,2426,5,14,13,9,54,39,15,55
Admira Wacke,2426,6,12,7,17,40,52,-12,43
RZ Pellets W,2426,7,10,10,16,37,52,-15,40
Mattersburg,2426,8,10,9,17,40,55,-15,39
St. Pölten,2426,9,7,13,16,43,63,-20,34
SV Josko Rie,2426,10,9,6,21,37,58,-21,33
FC Salzburg,2427,1,21,8,7,63,29,34,71
SC Rheindorf,2427,2,21,8,7,56,39,17,71
SK Sturm Gra,2427,3,17,8,11,62,42,20,59
Vienna,2427,4,18,4,14,64,53,11,58
RZ Pellets W,2427,5,14,7,15,50,53,-3,49
Rapid Vienna,2427,6,10,13,13,54,48,6,43
Admira Wacke,2427,7,12,6,18,41,64,-23,42
SV Josko Rie,2427,8,12,4,20,30,50,-20,40
Mattersburg,2427,9,9,10,17,42,57,-15,37
St. Pölten,2427,10,6,12,18,35,62,-27,30
SC Rheindorf,2428,1,22,5,9,57,35,22,71
Vienna,2428,2,22,2,12,77,47,30,68
SK Sturm Gra,2428,3,19,9,8,58,35,23,66
FC Salzburg,2428,4,19,8,9,56,37,19,65
Rapid Vienna,2428,5,14,11,11,58,41,17,53
Admira Wacke,2428,6,13,8,15,39,52,-13,47
RZ Pellets W,2428,7,11,6,19,45,67,-22,39
SV Josko Rie,2428,8,9,6,21,33,56,-23,33
Mattersburg,2428,9,8,8,20,37,63,-26,32
St. Pölten,2428,10,7,9,20,50,77,-27,30
FC Salzburg,2429,1,23,8,5,69,23,46,77
SK Sturm Gra,2429,2,22,6,8,62,30,32,72
SC Rheindorf,2429,3,16,9,11,47,41,6,57
Vienna,2429,4,16,7,13,55,50,5,55
Rapid Vienna,2429,5,14,9,13,51,42,9,51
RZ Pellets W,2429,6,12,8,16,52,54,-2,44
SV Josko Rie,2429,7,10,9,17,30,55,-25,39
Admira Wacke,2429,8,10,7,19,35,59,-24,37
Mattersburg,2429,9,8,11,17,37,57,-20,35
St. Pölten,2429,10,8,8,20,35,62,-27,32
FC Salzburg,2430,1,22,7,7,69,28,41,73
SK Sturm Gra,2430,2,21,7,8,63,31,32,70
Vienna,2430,3,20,5,11,63,48,15,65
SC Rheindorf,2430,4,19,7,10,57,46,11,64
RZ Pellets W,2430,5,13,8,15,47,56,-9,47
Rapid Vienna,2430,6,11,13,12,55,45,10,46
SV Josko Rie,2430,7,11,5,20,37,52,-15,38
Admira Wacke,2430,8,11,5,20,38,69,-31,38
St. Pölten,2430,9,8,11,17,41,64,-23,35
Mattersburg,2430,10,6,8,22,34,65,-31,26
FC Salzburg,2431,1,19,11,6,62,30,32,68
SK Sturm Gra,2431,2,20,7,9,65,34,31,67
SC Rheindorf,2431,3,18,8,10,66,53,13,62
Vienna,2431,4,18,7,11,66,46,20,61
Rapid Vienna,2431,5,15,10,11,56,42,14,55
SV Josko Rie,2431,6,12,7,17,41,57,-16,43
RZ Pellets W,2431,7,10,9,17,42,56,-14,39
St. Pölten,2431,8,9,10,17,43,66,-23,37
Admira Wacke,2431,9,9,8,19,38,69,-31,35
Mattersburg,2431,10,7,9,20,32,58,-26,30
FC Salzburg,2432,1,21,7,8,69,38,31,70
SK Sturm Gra,2432,2,21,6,9,71,34,37,69
SC Rheindorf,2432,3,18,8,10,52,44,8,62
Vienna,2432,4,17,7,12,58,50,8,58
Rapid Vienna,2432,5,13,14,9,60,46,14,53
Admira Wacke,2432,6,12,8,16,42,60,-18,44
Mattersburg,2432,7,11,7,18,45,55,-10,40
RZ Pellets W,2432,8,11,7,18,43,60,-17,40
St. Pölten,2432,9,8,12,16,44,65,-21,36
SV Josko Rie,2432,10,7,6,23,31,63,-32,27
Vienna,2433,1,22,6,8,73,49,24,72
FC Salzburg,2433,2,20,7,9,65,36,29,67
SK Sturm Gra,2433,3,21,4,11,58,35,23,67
SC Rheindorf,2433,4,20,4,12,52,43,9,64
Rapid Vienna,2433,5,14,11,11,54,42,12,53
RZ Pellets W,2433,6,12,10,14,44,48,-4,46
Admira Wacke,2433,7,11,5,20,37,66,-29,38
Mattersburg,2433,8,9,8,19,41,57,-16,35
St. Pölten,2433,9,9,8,19,43,63,-20,35
SV Josko Rie,2433,10,7,7,22,28,56,-28,28
FC Salzburg,2434,1,22,9,5,68,30,38,75
SK Sturm Gra,2434,2,18,8,10,55,33,22,62
SC Rheindorf,2434,3,16,11,9,50,46,4,59
Rapid Vienna,2434,4,16,10,10,68,40,28,58
Vienna,2434,5,16,5,15,52,48,4,53
Admira Wacke,2434,6,13,7,16,36,51,-15,46
RZ Pellets W,2434,7,9,11,16,42,59,-17,38
Mattersburg,2434,8,8,12,16,43,58,-15,36
St. Pölten,2434,9,8,11,17,45,68,-23,35
SV Josko Rie,2434,10,9,6,21,28,54,-26,33
SK Sturm Gra,2435,1,21,7,8,58,34,24,70
SC Rheindorf,2435,2,21,6,9,58,35,23,69
FC Salzburg,2435,3,19,9,8,58,30,28,66
Vienna,2435,4,17,6,13,54,42,12,57
Rapid Vienna,2435,5,14,11,11,48,35,13,53
RZ Pellets W,2435,6,10,11,15,45,58,-13,41
SV Josko Rie,2435,7,11,7,18,33,53,-20,40
Admira Wacke,2435,8,11,6,19,33,55,-22,39
St. Pölten,2435,9,8,9,19,39,62,-23,33
Mattersburg,2435,10,8,8,20,41,63,-22,32
FC Salzburg,2436,1,21,8,7,61,29,32,71
SK Sturm Gra,2436,2,21,6,9,55,27,28,69
SC Rheindorf,2436,3,19,9,8,52,36,16,66
Rapid Vienna,2436,4,15,10,11,59,40,19,55
Vienna,2436,5,16,7,13,59,53,6,55
RZ Pellets W,2436,6,13,6,17,46,53,-7,45
Admira Wacke,2436,7,12,6,18,35,58,-23,42
SV Josko Rie,2436,8,11,6,19,39,54,-15,39
Mattersburg,2436,9,8,7,21,34,58,-24,31
St. Pölten,2436,10,7,9,20,36,68,-32,30
FC Salzburg,2437,1,25,4,7,75,32,43,79
SC Rheindorf,2437,2,19,11,6,53,35,18,68
SK Sturm Gra,2437,3,19,8,9,55,30,25,65
Vienna,2437,4,19,4,13,64,54,10,61
Rapid Vienna,2437,5,15,10,11,54,37,17,55
RZ Pellets W,2437,6,13,4,19,49,60,-11,43
Admira Wacke,2437,7,10,6,20,37,59,-22,36
SV Josko Rie,2437,8,10,3,23,37,60,-23,33
St. Pölten,2437,9,7,11,18,40,66,-26,32
Mattersburg,2437,10,7,11,18,34,65,-31,32
FC Salzburg,2438,1,21,7,8,67,27,40,70
SC Rheindorf,2438,2,21,6,9,62,45,17,69
SK Sturm Gra,2438,3,20,6,10,57,36,21,66
Vienna,2438,4,19,5,12,61,47,14,62
Rapid Vienna,2438,5,13,11,12,55,45,10,50
St. Pölten,2438,6,10,9,17,53,69,-16,39
RZ Pellets W,2438,7,10,8,18,40,60,-20,38
Admira Wacke,2438,8,10,8,18,37,64,-27,38
Mattersburg,2438,9,10,7,19,43,57,-14,37
SV Josko Rie,2438,10,10,5,21,32,57,-25,35
FC Salzburg,2439,1,23,6,7,68,29,39,75
SC Rheindorf,2439,2,21,5,10,55,38,17,68
Vienna,2439,3,20,5,11,66,53,13,65
SK Sturm Gra,2439,4,17,7,12,51,35,16,58
Rapid Vienna,2439,5,14,9,13,60,47,13,51
St. Pölten,2439,6,11,10,15,41,51,-10,43
Mattersburg,2439,7,11,8,17,40,52,-12,41
RZ Pellets W,2439,8,10,10,16,38,54,-16,40
Admira Wacke,2439,9,10,5,21,33,59,-26,35
SV Josko Rie,2439,10,9,3,24,30,64,-34,30
FC Salzburg,2440,1,22,6,8,68,30,38,72
SK Sturm Gra,2440,2,22,6,8,66,30,36,72
SC Rheindorf,2440,3,21,7,8,56,40,16,70
Vienna,2440,4,19,5,12,68,47,21,62
Rapid Vienna,2440,5,13,13,10,52,41,11,52
RZ Pellets W,2440,6,13,7,16,47,55,-8,46
Admira Wacke,2440,7,11,8,17,31,56,-25,41
SV Josko Rie,2440,8,10,7,19,34,56,-22,37
St. Pölten,2440,9,6,8,22,34,66,-32,26
Mattersburg,2440,10,5,9,22,33,68,-35,24
FC Salzburg,2441,1,21,7,8,72,38,34,70
SC Rheindorf,2441,2,21,6,9,53,39,14,69
Vienna,2441,3,18,7,11,57,46,11,61
SK Sturm Gra,2441,4,17,6,13,52,38,14,57
Rapid Vienna,2441,5,15,11,10,68,49,19,56
Admira Wacke,2441,6,12,9,15,42,56,-14,45
Mattersburg,2441,7,11,8,17,43,52,-9,41
RZ Pellets W,2441,8,9,10,17,38,57,-19,37
St. Pölten,2441,9,8,10,18,36,62,-26,34
SV Josko Rie,2441,10,8,6,22,33,57,-24,30
SK Sturm Gra,2442,1,22,5,9,64,33,31,71
FC Salzburg,2442,2,21,6,9,65,32,33,69
Vienna,2442,3,21,5,10,66,50,16,68
SC Rheindorf,2442,4,18,6,12,50,44,6,60
Rapid Vienna,2442,5,14,9,13,61,50,11,51
RZ Pellets W,2442,6,13,7,16,54,61,-7,46
Admira Wacke,2442,7,13,5,18,39,56,-17,44
SV Josko Rie,2442,8,11,4,21,35,60,-25,37
Mattersburg,2442,9,9,7,20,35,55,-20,34
St. Pölten,2442,10,7,8,21,39,67,-28,29
SK Sturm Gra,2443,1,22,6,8,59,28,31,72
FC Salzburg,2443,2,19,9,8,65,35,30,66
SC Rheindorf,2443,3,19,9,8,61,41,20,66
Vienna,2443,4,18,4,14,59,53,6,58
Rapid Vienna,2443,5,15,9,12,55,38,17,54
Admira Wacke,2443,6,11,9,16,31,52,-21,42
St. Pölten,2443,7,11,8,17,44,64,-20,41
RZ Pellets W,2443,8,10,9,17,39,54,-15,39
SV Josko Rie,2443,9,8,8,20,33,55,-22,32
Mattersburg,2443,10,8,7,21,36,62,-26,31
SC Rheindorf,2444,1,24,6,6,73,44,29,78
FC Salzburg,2444,2,22,6,8,71,38,33,72
SK Sturm Gra,2444,3,21,5,10,70,38,32,68
Vienna,2444,4,19,6,11,67,54,13,63
Rapid Vienna,2444,5,11,12,13,53,48,5,45
RZ Pellets W,2444,6,11,9,16,44,56,-12,42
Mattersburg,2444,7,10,8,18,42,54,-12,38
Admira Wacke,2444,8,11,5,20,39,61,-22,38
SV Josko Rie,2444,9,9,4,23,33,62,-29,31
St. Pölten,2444,10,6,11,19,39,76,-37,29
FC Salzburg,2445,1,22,6,8,72,31,41,72
Vienna,2445,2,19,5,12,61,48,13,62
SC Rheindorf,2445,3,18,8,10,48,40,8,62
SK Sturm Gra,2445,4,17,9,10,66,40,26,60
Rapid Vienna,2445,5,14,10,12,52,39,13,52
Admira Wacke,2445,6,14,8,14,42,50,-8,50
RZ Pellets W,2445,7,12,8,16,49,61,-12,44
St. Pölten,2445,8,11,8,17,47,70,-23,41
SV Josko Rie,2445,9,11,6,19,35,57,-22,39
Mattersburg,2445,10,4,8,24,31,67,-36,20
SC Rheindorf,2446,1,21,7,8,58,37,21,70
FC Salzburg,2446,2,20,8,8,60,31,29,68
Vienna,2446,3,19,5,12,60,54,6,62
SK Sturm Gra,2446,4,18,6,12,51,30,21,60
Rapid Vienna,2446,5,12,12,12,49,39,10,48
RZ Pellets W,2446,6,12,9,15,48,52,-4,45
Admira Wacke,2446,7,12,5,19,33,59,-26,41
St. Pölten,2446,8,11,6,19,40,66,-26,39
SV Josko Rie,2446,9,10,6,20,32,48,-16,36
Mattersburg,2446,10,9,8,19,33,48,-15,35
FC Salzburg,2447,1,20,7,9,74,38,36,67
SC Rheindorf,2447,2,19,9,8,55,39,16,66
SK Sturm Gra,2447,3,20,5,11,59,32,27,65
Vienna,2447,4,18,3,15,54,54,0,57
Rapid Vienna,2447,5,12,13,11,48,40,8,49
Admira Wacke,2447,6,13,7,16,35,50,-15,46
Mattersburg,2447,7,11,9,16,40,52,-12,42
RZ Pellets W,2447,8,11,5,20,39,50,-11,38
SV Josko Rie,2447,9,11,5,20,35,56,-21,38
St. Pölten,2447,10,9,9,18,39,67,-28,36
SK Sturm Gra,2448,1,21,7,8,66,30,36,70
Vienna,2448,2,19,6,11,64,52,12,63
SC Rheindorf,2448,3,18,7,11,53,47,6,61
FC Salzburg,2448,4,17,9,10,52,31,21,60
Rapid Vienna,2448,5,12,12,12,51,44,7,48
SV Josko Rie,2448,6,13,5,18,35,47,-12,44
Mattersburg,2448,7,11,7,18,45,50,-5,40
RZ Pellets W,2448,8,11,7,18,43,58,-15,40
Admira Wacke,2448,9,11,7,18,30,58,-28,40
St. Pölten,2448,10,9,9,18,45,67,-22,36
SC Rheindorf,2449,1,22,6,8,63,46,17,72
FC Salzburg,2449,2,21,8,7,68,31,37,71
Rapid Vienna,2449,3,18,9,9,65,36,29,63
SK Sturm Gra,2449,4,17,10,9,59,36,23,61
Vienna,2449,5,17,6,13,63,58,5,57
RZ Pellets W,2449,6,12,7,17,52,62,-10,43
Admira Wacke,2449,7,11,6,19,37,62,-25,39
SV Josko Rie,2449,8,11,4,21,37,59,-22,37
Mattersburg,2449,9,8,8,20,42,66,-24,32
St. Pölten,2449,10,7,8,21,39,69,-30,29
FC Salzburg,2450,1,20,11,5,71,31,40,71
SK Sturm Gra,2450,2,20,5,11,62,36,26,65
Rapid Vienna,2450,3,17,9,10,59,40,19,60
SC Rheindorf,2450,4,17,9,10,52,44,8,60
Vienna,2450,5,17,5,14,65,60,5,56
RZ Pellets W,2450,6,14,6,16,44,53,-9,48
Admira Wacke,2450,7,13,7,16,44,55,-11,46
SV Josko Rie,2450,8,12,4,20,35,58,-23,40
Mattersburg,2450,9,8,9,19,36,55,-19,33
St. Pölten,2450,10,5,9,22,35,71,-36,24
SC Rheindorf,2451,1,21,7,8,56,40,16,70
SK Sturm Gra,2451,2,21,4,11,67,35,32,67
FC Salzburg,2451,3,19,9,8,58,30,28,66
Vienna,2451,4,20,3,13,61,53,8,63
Rapid Vienna,2451,5,12,12,12,52,43,9,48
Admira Wacke,2451,6,12,7,17,39,58,-19,43
RZ Pellets W,2451,7,11,9,16,38,49,-11,42
SV Josko Rie,2451,8,11,5,20,37,51,-14,38
St. Pölten,2451,9,9,10,17,40,64,-24,37
Mattersburg,2451,10,7,8,21,35,60,-25,29
FC Salzburg,2452,1,21,8,7,71,27,44,71
SK Sturm Gra,2452,2,19,7,10,58,37,21,64
Vienna,2452,3,17,8,11,60,52,8,59
SC Rheindorf,2452,4,16,9,11,54,54,0,57
Rapid Vienna,2452,5,14,11,11,54,39,15,53
RZ Pellets W,2452,6,12,7,17,42,55,-13,43
Admira Wacke,2452,7,12,6,18,39,58,-19,42
SV Josko Rie,2452,8,12,5,19,40,57,-17,41
Mattersburg,2452,9,10,8,18,36,55,-19,38
St. Pölten,2452,10,8,9,19,45,65,-20,33
FC Salzburg,2453,1,20,8,8,65,30,35,68
Vienna,2453,2,21,5,10,64,46,18,68
SC Rheindorf,2453,3,18,8,10,54,49,5,62
SK Sturm Gra,2453,4,16,8,12,55,38,17,56
Rapid Vienna,2453,5,16,8,12,59,45,14,56
St. Pölten,2453,6,11,10,15,49,61,-12,43
Admira Wacke,2453,7,11,6,19,35,62,-27,39
RZ Pellets W,2453,8,11,5,20,42,62,-20,38
Mattersburg,2453,9,9,10,17,40,53,-13,37
SV Josko Rie,2453,10,11,4,21,39,56,-17,37
FC Salzburg,2454,1,21,7,8,68,33,35,70
Vienna,2454,2,19,8,9,62,43,19,65
SC Rheindorf,2454,3,18,7,11,60,48,12,61
SK Sturm Gra,2454,4,18,6,12,57,41,16,60
Rapid Vienna,2454,5,15,13,8,61,39,22,58
RZ Pellets W,2454,6,11,8,17,39,55,-16,41
Admira Wacke,2454,7,12,5,19,39,62,-23,41
St. Pölten,2454,8,10,8,18,46,68,-22,38
SV Josko Rie,2454,9,10,5,21,36,60,-24,35
Mattersburg,2454,10,9,7,20,38,57,-19,34
FC Salzburg,2455,1,18,11,7,62,32,30,65
Vienna,2455,2,19,6,11,68,53,15,63
SC Rheindorf,2455,3,17,9,10,56,45,11,60
Rapid Vienna,2455,4,16,10,10,56,38,18,58
SK Sturm Gra,2455,5,16,8,12,54,37,17,56
RZ Pellets W,2455,6,13,9,14,43,53,-10,48
St. Pölten,2455,7,10,10,16,40,55,-15,40
Admira Wacke,2455,8,12,4,20,36,56,-20,40
Mattersburg,2455,9,9,10,17,35,55,-20,37
SV Josko Rie,2455,10,8,7,21,31,57,-26,31
SC Rheindorf,2456,1,21,7,8,62,45,17,70
FC Salzburg,2456,2,20,7,9,64,32,32,67
SK Sturm Gra,2456,3,19,7,10,59,36,23,64
Vienna,2456,4,19,5,12,65,56,9,62
Rapid Vienna,2456,5,12,11,13,54,43,11,47
RZ Pellets W,2456,6,12,6,18,41,54,-13,42
Admira Wacke,2456,7,11,8,17,38,55,-17,41
SV Josko Rie,2456,8,11,5,20,33,58,-25,38
Mattersburg,2456,9,10,7,19,41,57,-16,37
St. Pölten,2456,10,8,11,17,42,63,-21,35
FC Salzburg,2457,1,21,10,5,66,29,37,73
Vienna,2457,2,21,6,9,65,47,18,69
SK Sturm Gra,2457,3,18,8,10,61,32,29,62
SC Rheindorf,2457,4,17,8,11,59,49,10,59
RZ Pellets W,2457,5,15,9,12,50,54,-4,54
Rapid Vienna,2457,6,12,11,13,50,43,7,47
Admira Wacke,2457,7,11,7,18,44,64,-20,40
St. Pölten,2457,8,8,11,17,42,65,-23,35
Mattersburg,2457,9,7,11,18,36,53,-17,32
SV Josko Rie,2457,10,7,5,24,24,61,-37,26
FC Salzburg,2458,1,22,8,6,59,25,34,74
Vienna,2458,2,22,5,9,68,42,26,71
SK Sturm Gra,2458,3,19,6,11,56,36,20,63
Rapid Vienna,2458,4,15,10,11,47,35,12,55
SC Rheindorf,2458,5,16,7,13,51,51,0,55
RZ Pellets W,2458,6,14,7,15,50,53,-3,49
Mattersburg,2458,7,9,11,16,39,52,-13,38
Admira Wacke,2458,8,11,5,20,35,61,-26,38
SV Josko Rie,2458,9,8,6,22,33,55,-22,30
St. Pölten,2458,10,7,9,20,40,68,-28,30
FC Salzburg,2459,1,20,7,9,63,30,33,67
SK Sturm Gra,2459,2,20,7,9,69,38,31,67
Vienna,2459,3,19,6,11,68,53,15,63
SC Rheindorf,2459,4,16,7,13,52,49,3,55
Admira Wacke,2459,5,13,8,15,41,54,-13,47
SV Josko Rie,2459,6,14,5,17,34,47,-13,47
Rapid Vienna,2459,7,10,15,11,49,42,7,45
RZ Pellets W,2459,8,11,8,17,41,57,-16,41
St. Pölten,2459,9,8,11,17,38,60,-22,35
Mattersburg,2459,10,9,6,21,34,59,-25,33
FC Salzburg,2460,1,20,8,8,60,35,25,68
SC Rheindorf,2460,2,20,7,9,59,43,16,67
SK Sturm Gra,2460,3,19,6,11,65,42,23,63
Vienna,2460,4,19,6,11,66,47,19,63
Rapid Vienna,2460,5,15,13,8,57,37,20,58
Mattersburg,2460,6,10,11,15,40,52,-12,41
RZ Pellets W,2460,7,9,10,17,41,54,-13,37
Admira Wacke,2460,8,9,8,19,31,56,-25,35
SV Josko Rie,2460,9,9,6,21,30,55,-25,33
St. Pölten,2460,10,7,11,18,36,64,-28,32
FC Salzburg,2461,1,20,7,9,61,31,30,67
Vienna,2461,2,20,5,11,65,48,17,65
SK Sturm Gra,2461,3,19,6,11,61,37,24,63
Rapid Vienna,2461,4,16,9,11,62,43,19,57
SC Rheindorf,2461,5,16,7,13,52,48,4,55
RZ Pellets W,2461,6,13,9,14,53,55,-2,48
SV Josko Rie,2461,7,12,6,18,40,59,-19,42
Admira Wacke,2461,8,12,6,18,43,67,-24,42
Mattersburg,2461,9,8,9,19,32,56,-24,33
St. Pölten,2461,10,8,8,20,42,67,-25,32
FC Salzburg,2462,1,23,6,7,69,24,45,75
SC Rheindorf,2462,2,21,4,11,57,46,11,67
SK Sturm Gra,2462,3,19,6,11,52,34,18,63
Rapid Vienna,2462,4,15,11,10,57,39,18,56
Vienna,2462,5,17,5,14,56,54,2,56
RZ Pellets W,2462,6,14,10,12,48,48,0,52
Admira Wacke,2462,7,15,5,16,42,48,-6,50
SV Josko Rie,2462,8,11,2,23,32,57,-25,35
Mattersburg,2462,9,7,8,21,31,61,-30,29
St. Pölten,2462,10,5,9,22,36,69,-33,24
FC Salzburg,2463,1,24,6,6,70,30,40,78
SC Rheindorf,2463,2,23,6,7,64,39,25,75
Vienna,2463,3,21,5,10,63,44,19,68
Rapid Vienna,2463,4,16,8,12,61,41,20,56
SK Sturm Gra,2463,5,16,7,13,60,49,11,55
Admira Wacke,2463,6,13,6,17,36,54,-18,45
RZ Pellets W,2463,7,10,9,17,44,56,-12,39
St. Pölten,2463,8,8,9,19,38,71,-33,33
SV Josko Rie,2463,9,8,5,23,31,59,-28,29
Mattersburg,2463,10,6,9,21,35,59,-24,27
FC Salzburg,2464,1,22,6,8,72,37,35,72
SC Rheindorf,2464,2,20,9,7,64,45,19,69
SK Sturm Gra,2464,3,18,8,10,56,37,19,62
Vienna,2464,4,17,4,15,67,63,4,55
Rapid Vienna,2464,5,14,12,10,65,49,16,54
RZ Pellets W,2464,6,11,12,13,53,56,-3,45
SV Josko Rie,2464,7,13,5,18,36,46,-10,44
Admira Wacke,2464,8,12,5,19,48,65,-17,41
Mattersburg,2464,9,7,11,18,43,68,-25,32
St. Pölten,2464,10,5,10,21,38,76,-38,25
FC Salzburg,2465,1,22,6,8,66,33,33,72
SC Rheindorf,2465,2,19,9,8,57,42,15,66
Vienna,2465,3,21,3,12,64,50,14,66
Rapid Vienna,2465,4,17,10,9,65,38,27,61
SK Sturm Gra,2465,5,17,7,12,53,35,18,58
RZ Pellets W,2465,6,11,7,18,42,60,-18,40
Admira Wacke,2465,7,10,8,18,34,59,-25,38
St. Pölten,2465,8,9,9,18,41,60,-19,36
SV Josko Rie,2465,9,8,10,18,34,56,-22,34
Mattersburg,2465,10,7,9,20,36,59,-23,30
SK Sturm Gra,2466,1,20,7,9,57,32,25,67
Vienna,2466,2,20,5,11,64,48,16,65
FC Salzburg,2466,3,18,10,8,65,33,32,64
SC Rheindorf,2466,4,19,7,10,54,40,14,64
Rapid Vienna,2466,5,14,10,12,52,37,15,52
RZ Pellets W,2466,6,12,8,16,42,56,-14,44
Mattersburg,2466,7,11,7,18,45,59,-14,40
SV Josko Rie,2466,8,11,7,18,37,54,-17,40
St. Pölten,2466,9,9,7,20,40,63,-23,34
Admira Wacke,2466,10,9,6,21,31,65,-34,33
FC Salzburg,2467,1,21,10,5,72,30,42,73
SK Sturm Gra,2467,2,20,5,11,59,35,24,65
SC Rheindorf,2467,3,18,9,9,56,49,7,63
Vienna,2467,4,15,10,11,57,51,6,55
RZ Pellets W,2467,5,15,7,14,48,52,-4,52
Rapid Vienna,2467,6,12,11,13,54,43,11,47
St. Pölten,2467,7,11,11,14,46,58,-12,44
Admira Wacke,2467,8,9,8,19,34,63,-29,35
SV Josko Rie,2467,9,8,9,19,34,56,-22,33
Mattersburg,2467,10,7,8,21,38,61,-23,29
FC Salzburg,2468,1,19,7,10,58,35,23,64
Vienna,2468,2,20,4,12,63,51,12,64
SK Sturm Gra,2468,3,17,11,8,61,35,26,62
SC Rheindorf,2468,4,18,8,10,53,45,8,62
Rapid Vienna,2468,5,13,11,12,58,43,15,50
Admira Wacke,2468,6,12,9,15,38,53,-15,45
RZ Pellets W,2468,7,12,8,16,47,56,-9,44
St. Pölten,2468,8,8,14,14,40,54,-14,38
Mattersburg,2468,9,10,7,19,37,56,-19,37
SV Josko Rie,2468,10,9,5,22,27,54,-27,32
FC Salzburg,2469,1,21,7,8,71,32,39,70
SK Sturm Gra,2469,2,20,6,10,57,33,24,66
SC Rheindorf,2469,3,20,6,10,52,44,8,66
Vienna,2469,4,18,7,11,73,61,12,61
Admira Wacke,2469,5,15,5,16,45,52,-7,50
Rapid Vienna,2469,6,13,8,15,51,47,4,47
RZ Pellets W,2469,7,12,7,17,42,58,-16,43
SV Josko Rie,2469,8,11,5,20,33,53,-20,38
Mattersburg,2469,9,9,7,20,33,54,-21,34
St. Pölten,2469,10,7,10,19,42,65,-23,31
SK Sturm Gra,2470,1,20,10,6,62,28,34,70
SC Rheindorf,2470,2,19,9,8,54,38,16,66
FC Salzburg,2470,3,17,12,7,60,29,31,63
Vienna,2470,4,19,5,12,65,56,9,62
Rapid Vienna,2470,5,14,11,11,58,40,18,53
Admira Wacke,2470,6,13,6,17,38,60,-22,45
RZ Pellets W,2470,7,10,11,15,46,62,-16,41
St. Pölten,2470,8,8,10,18,42,68,-26,34
SV Josko Rie,2470,9,8,8,20,30,50,-20,32
Mattersburg,2470,10,7,8,21,38,62,-24,29
FC Salzburg,2471,1,20,8,8,63,32,31,68
Vienna,2471,2,20,6,10,70,47,23,66
SC Rheindorf,2471,3,17,12,7,51,41,10,63
SK Sturm Gra,2471,4,17,8,11,55,33,22,59
Rapid Vienna,2471,5,13,10,13,53,41,12,49
Admira Wacke,2471,6,14,7,15,40,52,-12,49
RZ Pellets W,2471,7,13,9,14,51,51,0,48
St. Pölten,2471,8,11,6,19,43,66,-23,39
SV Josko Rie,2471,9,9,7,20,32,60,-28,34
Mattersburg,2471,10,4,11,21,30,65,-35,23
FC Salzburg,2472,1,26,4,6,74,27,47,82
Vienna,2472,2,21,6,9,64,47,17,69
SK Sturm Gra,2472,3,19,7,10,61,34,27,64
SC Rheindorf,2472,4,19,6,11,51,42,9,63
Rapid Vienna,2472,5,14,9,13,54,47,7,51
RZ Pellets W,2472,6,12,8,16,45,53,-8,44
Admira Wacke,2472,7,11,4,21,36,67,-31,37
St. Pölten,2472,8,8,9,19,45,66,-21,33
SV Josko Rie,2472,9,10,3,23,35,65,-30,33
Mattersburg,2472,10,8,8,20,41,58,-17,32
FC Salzburg,2473,1,18,10,8,60,28,32,64
Vienna,2473,2,18,9,9,62,49,13,63
SC Rheindorf,2473,3,18,9,9,60,48,12,63
SK Sturm Gra,2473,4,17,11,8,58,34,24,62
Rapid Vienna,2473,5,16,13,7,63,38,25,61
RZ Pellets W,2473,6,11,11,14,43,54,-11,44
Admira Wacke,2473,7,12,7,17,34,50,-16,43
Mattersburg,2473,8,8,9,19,41,62,-21,33
SV Josko Rie,2473,9,8,7,21,30,61,-31,31
St. Pölten,2473,10,6,10,20,42,69,-27,28
FC Salzburg,2474,1,21,9,6,69,32,37,72
SC Rheindorf,2474,2,19,8,9,60,45,15,65
SK Sturm Gra,2474,3,17,11,8,59,36,23,62
Vienna,2474,4,17,8,11,61,52,9,59
Rapid Vienna,2474,5,12,15,9,56,39,17,51
RZ Pellets W,2474,6,10,9,17,42,54,-12,39
SV Josko Rie,2474,7,11,5,20,38,61,-23,38
Admira Wacke,2474,8,9,10,17,39,63,-24,37
St. Pölten,2474,9,9,9,18,40,65,-25,36
Mattersburg,2474,10,9,8,19,33,50,-17,35
FC Salzburg,2475,1,20,9,7,69,31,38,69
SK Sturm Gra,2475,2,21,6,9,64,30,34,69
Vienna,2475,3,20,6,10,65,47,18,66
SC Rheindorf,2475,4,18,7,11,51,45,6,61
RZ Pellets W,2475,5,13,10,13,45,51,-6,49
Rapid Vienna,2475,6,12,12,12,50,41,9,48
Admira Wacke,2475,7,10,9,17,35,60,-25,39
St. Pölten,2475,8,8,12,16,46,67,-21,36
SV Josko Rie,2475,9,8,8,20,29,53,-24,32
Mattersburg,2475,10,6,9,21,33,62,-29,27
FC Salzburg,2476,1,20,10,6,75,34,41,70
Vienna,2476,2,19,9,8,63,42,21,66
SC Rheindorf,2476,3,17,9,10,47,43,4,60
SK Sturm Gra,2476,4,15,9,12,49,36,13,54
Rapid Vienna,2476,5,13,12,11,57,42,15,51
RZ Pellets W,2476,6,11,13,12,41,46,-5,46
SV Josko Rie,2476,7,9,9,18,32,51,-19,36
St. Pölten,2476,8,8,12,16,44,67,-23,36
Mattersburg,2476,9,9,9,18,33,56,-23,36
Admira Wacke,2476,10,9,8,19,39,63,-24,35
FC Salzburg,2477,1,19,11,6,64,32,32,68
Vienna,2477,2,20,8,8,76,55,21,68
SC Rheindorf,2477,3,20,7,9,63,49,14,67
SK Sturm Gra,2477,4,20,5,11,61,27,34,65
Rapid Vienna,2477,5,15,10,11,57,39,18,55
Admira Wacke,2477,6,12,6,18,39,65,-26,42
RZ Pellets W,2477,7,11,8,17,47,64,-17,41
Mattersburg,2477,8,8,8,20,42,62,-20,32
SV Josko Rie,2477,9,8,7,21,32,59,-27,31
St. Pölten,2477,10,7,10,19,37,66,-29,31
FC Salzburg,2478,1,20,8,8,64,29,35,68
SC Rheindorf,2478,2,21,5,10,57,42,15,68
SK Sturm Gra,2478,3,20,5,11,54,32,22,65
Vienna,2478,4,18,3,15,56,49,7,57
RZ Pellets W,2478,5,16,6,14,50,52,-2,54
Rapid Vienna,2478,6,13,10,13,58,45,13,49
Admira Wacke,2478,7,14,5,17,34,53,-19,47
Mattersburg,2478,8,12,6,18,43,54,-11,42
SV Josko Rie,2478,9,11,2,23,36,59,-23,35
St. Pölten,2478,10,7,6,23,40,77,-37,27
SK Sturm Gra,2479,1,21,7,8,57,28,29,70
FC Salzburg,2479,2,19,9,8,71,33,38,66
Vienna,2479,3,19,8,9,67,50,17,65
SC Rheindorf,2479,4,17,7,12,50,52,-2,58
Rapid Vienna,2479,5,12,12,12,52,43,9,48
Admira Wacke,2479,6,14,6,16,40,54,-14,48
St. Pölten,2479,7,11,8,17,41,53,-12,41
SV Josko Rie,2479,8,11,6,19,29,45,-16,39
RZ Pellets W,2479,9,11,5,20,37,58,-21,38
Mattersburg,2479,10,7,8,21,38,66,-28,29
FC Salzburg,2480,1,22,7,7,63,28,35,73
SK Sturm Gra,2480,2,20,6,10,65,36,29,66
SC Rheindorf,2480,3,19,9,8,53,41,12,66
Vienna,2480,4,17,8,11,55,50,5,59
Rapid Vienna,2480,5,16,10,10,54,35,19,58
RZ Pellets W,2480,6,11,8,17,43,58,-15,41
Mattersburg,2480,7,9,10,17,34,50,-16,37
Admira Wacke,2480,8,9,8,19,31,59,-28,35
SV Josko Rie,2480,9,9,7,20,37,56,-19,34
St. Pölten,2480,10,7,9,20,39,61,-22,30
FC Salzburg,2481,1,22,8,6,64,31,33,74
SK Sturm Gra,2481,2,19,10,7,57,27,30,67
SC Rheindorf,2481,3,18,10,8,50,36,14,64
Vienna,2481,4,16,6,14,61,62,-1,54
Rapid Vienna,2481,5,12,13,11,53,42,11,49
Admira Wacke,2481,6,12,6,18,35,55,-20,42
RZ Pellets W,2481,7,9,11,16,49,59,-10,38
SV Josko Rie,2481,8,11,5,20,37,53,-16,38
Mattersburg,2481,9,8,10,18,40,59,-19,34
St. Pölten,2481,10,7,13,16,40,62,-22,34
FC Salzburg,2482,1,20,8,8,68,34,34,68
SC Rheindorf,2482,2,20,7,9,61,46,15,67
Rapid Vienna,2482,3,17,11,8,63,36,27,62
SK Sturm Gra,2482,4,19,5,12,56,37,19,62
Vienna,2482,5,16,5,15,55,56,-1,53
RZ Pellets W,2482,6,14,9,13,56,49,7,51
Admira Wacke,2482,7,11,9,16,34,54,-20,42
SV Josko Rie,2482,8,11,7,18,37,53,-16,40
St. Pölten,2482,9,7,8,21,38,72,-34,29
Mattersburg,2482,10,6,9,21,37,68,-31,27
FC Salzburg,2483,1,22,8,6,66,31,35,74
SC Rheindorf,2483,2,22,7,7,64,36,28,73
SK Sturm Gra,2483,3,18,7,11,58,35,23,61
Vienna,2483,4,17,7,12,63,55,8,58
Rapid Vienna,2483,5,14,10,12,59,45,14,52
RZ Pellets W,2483,6,12,10,14,48,56,-8,46
Admira Wacke,2483,7,13,5,18,39,58,-19,44
St. Pölten,2483,8,9,8,19,40,64,-24,35
Mattersburg,2483,9,8,7,21,43,68,-25,31
SV Josko Rie,2483,10,8,5,23,29,61,-32,29
SK Sturm Gra,2484,1,20,9,7,68,34,34,69
FC Salzburg,2484,2,20,9,7,62,31,31,69
SC Rheindorf,2484,3,20,6,10,60,45,15,66
Vienna,2484,4,17,7,12,58,53,5,58
Rapid Vienna,2484,5,14,9,13,53,40,13,51
RZ Pellets W,2484,6,12,7,17,44,55,-11,43
SV Josko Rie,2484,7,12,6,18,40,53,-13,42
Mattersburg,2484,8,10,8,18,43,53,-10,38
St. Pölten,2484,9,8,9,19,45,73,-28,33
Admira Wacke,2484,10,9,6,21,35,71,-36,33
FC Salzburg,2485,1,21,7,8,71,33,38,70
SK Sturm Gra,2485,2,21,3,12,64,42,22,66
SC Rheindorf,2485,3,18,11,7,54,41,13,65
Vienna,2485,4,19,3,14,63,55,8,60
Rapid Vienna,2485,5,15,11,10,61,39,22,56
Admira Wacke,2485,6,14,5,17,39,63,-24,47
SV Josko Rie,2485,7,10,8,18,36,50,-14,38
RZ Pellets W,2485,8,10,6,20,47,63,-16,36
St. Pölten,2485,9,8,10,18,40,62,-22,34
Mattersburg,2485,10,9,6,21,37,64,-27,33
SC Rheindorf,2486,1,21,7,8,58,37,21,70
FC Salzburg,2486,2,19,9,8,61,29,32,66
SK Sturm Gra,2486,3,19,7,10,60,36,24,64
Vienna,2486,4,17,8,11,61,55,6,59
RZ Pellets W,2486,5,15,8,13,50,51,-1,53
Rapid Vienna,2486,6,12,11,13,46,40,6,47
Admira Wacke,2486,7,12,7,17,48,59,-11,43
St. Pölten,2486,8,10,10,16,47,61,-14,40
SV Josko Rie,2486,9,8,7,21,32,62,-30,31
Mattersburg,2486,10,6,8,22,34,67,-33,26
FC Salzburg,2487,1,20,8,8,68,37,31,68
SC Rheindorf,2487,2,19,8,9,60,44,16,65
Vienna,2487,3,20,4,12,64,55,9,64
SK Sturm Gra,2487,4,17,10,9,60,36,24,61
Rapid Vienna,2487,5,12,11,13,52,45,7,47
RZ Pellets W,2487,6,12,10,14,52,57,-5,46
Admira Wacke,2487,7,11,9,16,40,60,-20,42
SV Josko Rie,2487,8,11,6,19,39,55,-16,39
Mattersburg,2487,9,9,8,19,43,60,-17,35
St. Pölten,2487,10,6,12,18,37,66,-29,30
FC Salzburg,2488,1,23,6,7,61,32,29,75
SC Rheindorf,2488,2,21,8,7,58,37,21,71
Vienna,2488,3,18,5,13,63,50,13,59
SK Sturm Gra,2488,4,16,5,15,50,40,10,53
RZ Pellets W,2488,5,15,8,13,52,49,3,53
Rapid Vienna,2488,6,13,9,14,51,43,8,48
Admira Wacke,2488,7,11,7,18,34,58,-24,40
SV Josko Rie,2488,8,12,3,21,33,52,-19,39
Mattersburg,2488,9,9,8,19,35,52,-17,35
St. Pölten,2488,10,7,11,18,38,62,-24,32
SC Rheindorf,2489,1,22,5,9,59,40,19,71
FC Salzburg,2489,2,21,7,8,61,27,34,70
SK Sturm Gra,2489,3,19,6,11,61,36,25,63
Vienna,2489,4,18,6,12,64,52,12,60
Rapid Vienna,2489,5,14,9,13,55,42,13,51
RZ Pellets W,2489,6,14,8,14,44,48,-4,50
St. Pölten,2489,7,9,9,18,36,66,-30,36
Mattersburg,2489,8,8,10,18,37,54,-17,34
SV Josko Rie,2489,9,9,7,20,32,55,-23,34
Admira Wacke,2489,10,9,7,20,35,64,-29,34
SC Rheindorf,2490,1,20,7,9,67,47,20,67
FC Salzburg,2490,2,19,9,8,66,36,30,66
SK Sturm Gra,2490,3,18,7,11,57,36,21,61
Vienna,2490,4,19,3,14,60,49,11,60
Rapid Vienna,2490,5,15,8,13,60,48,12,53
Admira Wacke,2490,6,14,5,17,39,58,-19,47
St. Pölten,2490,7,11,9,16,46,62,-16,42
RZ Pellets W,2490,8,11,6,19,42,62,-20,39
SV Josko Rie,2490,9,11,5,20,36,52,-16,38
Mattersburg,2490,10,8,9,19,39,62,-23,33
SK Sturm Gra,2491,1,22,5,9,61,33,28,71
FC Salzburg,2491,2,19,10,7,63,30,33,67
Rapid Vienna,2491,3,19,8,9,65,34,31,65
SC Rheindorf,2491,4,16,9,11,44,43,1,57
RZ Pellets W,2491,5,15,7,14,51,49,2,52
Vienna,2491,6,16,4,16,53,54,-1,52
Admira Wacke,2491,7,11,8,17,33,54,-21,41
Mattersburg,2491,8,9,9,18,38,57,-19,36
St. Pölten,2491,9,8,8,20,36,63,-27,32
SV Josko Rie,2491,10,8,6,22,28,55,-27,30
SK Sturm Gra,2492,1,22,5,9,67,35,32,71
FC Salzburg,2492,2,20,7,9,63,36,27,67
Vienna,2492,3,20,6,10,64,51,13,66
SC Rheindorf,2492,4,18,9,9,53,40,13,63
Rapid Vienna,2492,5,14,10,12,57,40,17,52
RZ Pellets W,2492,6,11,8,17,41,58,-17,41
Admira Wacke,2492,7,11,7,18,34,55,-21,40
St. Pölten,2492,8,10,9,17,43,61,-18,39
SV Josko Rie,2492,9,10,6,20,38,60,-22,36
Mattersburg,2492,10,7,7,22,33,57,-24,28
SC Rheindorf,2493,1,21,9,6,54,31,23,72
FC Salzburg,2493,2,21,7,8,60,29,31,70
Vienna,2493,3,18,6,12,61,50,11,60
Rapid Vienna,2493,4,16,10,10,61,32,29,58
SK Sturm Gra,2493,5,17,6,13,53,38,15,57
St. Pölten,2493,6,11,8,17,42,57,-15,41
Admira Wacke,2493,7,11,6,19,36,63,-27,39
RZ Pellets W,2493,8,9,9,18,38,59,-21,36
SV Josko Rie,2493,9,10,5,21,33,59,-26,35
Mattersburg,2493,10,8,10,18,34,54,-20,34
SC Rheindorf,2494,1,22,8,6,62,43,19,74
Vienna,2494,2,20,7,9,73,50,23,67
SK Sturm Gra,2494,3,18,9,9,53,31,22,63
Rapid Vienna,2494,4,16,11,9,61,34,27,59
FC Salzburg,2494,5,17,8,11,57,35,22,59
RZ Pellets W,2494,6,12,9,15,47,53,-6,45
Admira Wacke,2494,7,11,6,19,35,59,-24,39
SV Josko Rie,2494,8,10,3,23,33,57,-24,33
Mattersburg,2494,9,8,8,20,38,61,-23,32
St. Pölten,2494,10,6,11,19,33,69,-36,29
FC Salzburg,2495,1,23,6,7,72,28,44,75
SK Sturm Gra,2495,2,22,4,10,62,40,22,70
Vienna,2495,3,19,5,12,67,52,15,62
SC Rheindorf,2495,4,18,5,13,47,48,-1,59
Rapid Vienna,2495,5,15,11,10,56,40,16,56
SV Josko Rie,2495,6,14,4,18,41,51,-10,46
RZ Pellets W,2495,7,11,7,18,48,59,-11,40
St. Pölten,2495,8,10,9,17,42,62,-20,39
Admira Wacke,2495,9,11,4,21,35,63,-28,37
Mattersburg,2495,10,6,7,23,29,56,-27,25
SK Sturm Gra,2496,1,22,6,8,69,35,34,72
FC Salzburg,2496,2,20,9,7,68,32,36,69
SC Rheindorf,2496,3,21,6,9,56,38,18,69
Vienna,2496,4,17,6,13,59,48,11,57
Rapid Vienna,2496,5,14,10,12,50,40,10,52
Admira Wacke,2496,6,13,6,17,42,62,-20,45
RZ Pellets W,2496,7,12,7,17,47,55,-8,43
SV Josko Rie,2496,8,11,5,20,37,58,-21,38
Mattersburg,2496,9,9,5,22,32,64,-32,32
St. Pölten,2496,10,7,8,21,39,67,-28,29
FC Salzburg,2497,1,20,9,7,68,32,36,69
SC Rheindorf,2497,2,21,6,9,61,45,16,69
Vienna,2497,3,20,6,10,65,51,14,66
SK Sturm Gra,2497,4,18,7,11,58,35,23,61
Rapid Vienna,2497,5,14,13,9,58,40,18,55
SV Josko Rie,2497,6,13,6,17,42,59,-17,45
Mattersburg,2497,7,9,8,19,34,58,-24,35
Admira Wacke,2497,8,9,7,20,44,66,-22,34
RZ Pellets W,2497,9,8,9,19,43,65,-22,33
St. Pölten,2497,10,8,9,19,42,64,-22,33
SK Sturm Gra,2498,1,25,3,8,65,29,36,78
FC Salzburg,2498,2,21,9,6,61,31,30,72
SC Rheindorf,2498,3,22,6,8,61,41,20,72
Vienna,2498,4,21,5,10,70,47,23,68
Rapid Vienna,2498,5,12,8,16,47,45,2,44
Admira Wacke,2498,6,11,9,16,42,54,-12,42
RZ Pellets W,2498,7,12,6,18,40,57,-17,42
Mattersburg,2498,8,9,7,20,39,57,-18,34
SV Josko Rie,2498,9,9,4,23,33,57,-24,31
St. Pölten,2498,10,5,9,22,37,77,-40,24
FC Salzburg,2499,1,19,10,7,61,31,30,67
SC Rheindorf,2499,2,18,11,7,54,40,14,65
Vienna,2499,3,19,4,13,59,57,2,61
SK Sturm Gra,2499,4,16,8,12,50,37,13,56
Rapid Vienna,2499,5,14,11,11,57,37,20,53
RZ Pellets W,2499,6,14,8,14,53,49,4,50
Admira Wacke,2499,7,12,7,17,37,54,-17,43
Mattersburg,2499,8,9,8,19,36,57,-21,35
SV Josko Rie,2499,9,10,5,21,33,54,-21,35
St. Pölten,2499,10,8,10,18,47,71,-24,34
FC Salzburg,2500,1,21,7,8,75,31,44,70
SC Rheindorf,2500,2,18,7,11,56,50,6,61
SK Sturm Gra,2500,3,18,6,12,52,37,15,60
Vienna,2500,4,18,5,13,63,57,6,59
Rapid Vienna,2500,5,13,11,12,59,44,15,50
Admira Wacke,2500,6,12,11,13,43,53,-10,47
RZ Pellets W,2500,7,12,7,17,43,51,-8,43
SV Josko Rie,2500,8,12,6,18,43,59,-16,42
Mattersburg,2500,9,9,9,18,37,63,-26,36
St. Pölten,2500,10,9,7,20,46,72,-26,34
FC Salzburg,2501,1,22,7,7,63,26,37,73
Vienna,2501,2,22,2,12,66,48,18,68
SK Sturm Gra,2501,3,21,4,11,61,34,27,67
SC Rheindorf,2501,4,19,5,12,53,47,6,62
Rapid Vienna,2501,5,16,9,11,66,44,22,57
RZ Pellets W,2501,6,12,8,16,45,59,-14,44
SV Josko Rie,2501,7,11,7,18,31,48,-17,40
Admira Wacke,2501,8,10,5,21,31,56,-25,35
St. Pölten,2501,9,8,8,20,39,68,-29,32
Mattersburg,2501,10,8,7,21,38,63,-25,31
FC Salzburg,2502,1,21,8,7,66,31,35,71
SC Rheindorf,2502,2,21,8,7,51,34,17,71
SK Sturm Gra,2502,3,18,7,11,55,37,18,61
Rapid Vienna,2502,4,16,9,11,51,37,14,57
Vienna,2502,5,16,6,14,57,53,4,54
Admira Wacke,2502,6,12,10,14,39,52,-13,46
RZ Pellets W,2502,7,11,10,15,44,54,-10,43
Mattersburg,2502,8,8,10,18,35,52,-17,34
SV Josko Rie,2502,9,10,3,23,32,56,-24,33
St. Pölten,2502,10,7,9,20,38,62,-24,30
FC Salzburg,2503,1,23,7,6,69,24,45,76
SK Sturm Gra,2503,2,22,5,9,66,37,29,71
SC Rheindorf,2503,3,18,7,11,49,45,4,61
Vienna,2503,4,17,4,15,64,61,3,55
Rapid Vienna,2503,5,14,9,13,56,42,14,51
RZ Pellets W,2503,6,12,10,14,54,55,-1,46
Admira Wacke,2503,7,11,6,19,39,66,-27,39
SV Josko Rie,2503,8,11,4,21,34,61,-27,37
St. Pölten,2503,9,10,6,20,44,68,-24,36
Mattersburg,2503,10,9,8,19,40,56,-16,35
FC Salzburg,2504,1,20,8,8,64,32,32,68
SC Rheindorf,2504,2,19,11,6,63,40,23,68
SK Sturm Gra,2504,3,20,5,11,71,38,33,65
Vienna,2504,4,20,5,11,64,50,14,65
Rapid Vienna,2504,5,16,11,9,61,36,25,59
SV Josko Rie,2504,6,11,6,19,35,60,-25,39
Mattersburg,2504,7,9,10,17,39,59,-20,37
Admira Wacke,2504,8,9,9,18,35,62,-27,36
RZ Pellets W,2504,9,9,8,19,39,61,-22,35
St. Pölten,2504,10,6,9,21,36,69,-33,27
FC Salzburg,2505,1,21,7,8,66,34,32,70
Vienna,2505,2,21,5,10,68,52,16,68
SK Sturm Gra,2505,3,20,7,9,65,38,27,67
SC Rheindorf,2505,4,17,10,9,52,43,9,61
Rapid Vienna,2505,5,14,10,12,56,41,15,52
Admira Wacke,2505,6,13,5,18,42,61,-19,44
RZ Pellets W,2505,7,12,7,17,50,62,-12,43
SV Josko Rie,2505,8,12,5,19,42,56,-14,41
St. Pölten,2505,9,7,11,18,42,65,-23,32
Mattersburg,2505,10,5,9,22,34,65,-31,24
FC Salzburg,2506,1,24,5,7,71,30,41,77
SK Sturm Gra,2506,2,22,7,7,62,31,31,73
SC Rheindorf,2506,3,20,8,8,63,42,21,68
Vienna,2506,4,17,7,12,62,57,5,58
Rapid Vienna,2506,5,14,10,12,61,42,19,52
RZ Pellets W,2506,6,10,11,15,45,56,-11,41
Admira Wacke,2506,7,10,9,17,36,59,-23,39
SV Josko Rie,2506,8,9,9,18,38,54,-16,36
St. Pölten,2506,9,7,10,19,40,74,-34,31
Mattersburg,2506,10,6,6,24,34,67,-33,24
SC Rheindorf,2507,1,22,5,9,57,44,13,71
SK Sturm Gra,2507,2,21,5,10,68,39,29,68
FC Salzburg,2507,3,18,11,7,63,34,29,65
Vienna,2507,4,18,6,12,61,54,7,60
Rapid Vienna,2507,5,13,11,12,55,39,16,50
RZ Pellets W,2507,6,13,6,17,46,58,-12,45
Admira Wacke,2507,7,13,5,18,40,57,-17,44
St. Pölten,2507,8,10,8,18,43,61,-18,38
Mattersburg,2507,9,8,8,20,40,61,-21,32
SV Josko Rie,2507,10,9,5,22,31,57,-26,32
SK Sturm Gra,2508,1,21,5,10,61,36,25,68
FC Salzburg,2508,2,20,5,11,59,35,24,65
Vienna,2508,3,20,3,13,65,52,13,63
Rapid Vienna,2508,4,16,8,12,63,40,23,56
SC Rheindorf,2508,5,15,6,15,49,48,1,51
RZ Pellets W,2508,6,13,8,15,48,52,-4,47
Admira Wacke,2508,7,13,5,18,36,54,-18,44
SV Josko Rie,2508,8,12,6,18,37,53,-16,42
Mattersburg,2508,9,10,8,18,35,55,-20,38
St. Pölten,2508,10,9,8,19,45,73,-28,35
FC Salzburg,2509,1,23,6,7,68,30,38,75
SK Sturm Gra,2509,2,20,7,9,63,35,28,67
Vienna,2509,3,20,5,11,65,48,17,65
SC Rheindorf,2509,4,17,7,12,51,43,8,58
RZ Pellets W,2509,5,11,10,15,46,57,-11,43
SV Josko Rie,2509,6,12,6,18,41,56,-15,42
Admira Wacke,2509,7,11,7,18,39,67,-28,40
Mattersburg,2509,8,11,6,19,41,51,-10,39
St. Pölten,2509,9,10,9,17,46,69,-23,39
Rapid Vienna,2509,10,8,11,17,44,48,-4,35
SC Rheindorf,2510,1,24,7,5,67,38,29,79
FC Salzburg,2510,2,20,7,9,65,36,29,67
SK Sturm Gra,2510,3,18,6,12,56,37,19,60
Vienna,2510,4,17,8,11,70,59,11,59
RZ Pellets W,2510,5,14,7,15,45,57,-12,49
SV Josko Rie,2510,6,12,7,17,45,50,-5,43
Rapid Vienna,2510,7,11,9,16,48,45,3,42
Admira Wacke,2510,8,11,9,16,44,60,-16,42
St. Pölten,2510,9,9,7,20,36,70,-34,34
Mattersburg,2510,10,7,7,22,37,61,-24,28
FC Salzburg,2511,1,24,4,8,71,28,43,76
SK Sturm Gra,2511,2,19,9,8,59,29,30,66
Vienna,2511,3,20,5,11,63,45,18,65
SC Rheindorf,2511,4,18,7,11,54,44,10,61
Rapid Vienna,2511,5,12,12,12,50,45,5,48
Mattersburg,2511,6,12,8,16,40,56,-16,44
RZ Pellets W,2511,7,12,6,18,44,60,-16,42
Admira Wacke,2511,8,11,8,17,40,58,-18,41
SV Josko Rie,2511,9,9,6,21,31,59,-28,33
St. Pölten,2511,10,5,11,20,35,63,-28,26
SK Sturm Gra,2512,1,21,7,8,70,31,39,70
FC Salzburg,2512,2,20,9,7,65,30,35,69
SC Rheindorf,2512,3,18,8,10,51,44,7,62
Vienna,2512,4,17,6,13,57,54,3,57
Rapid Vienna,2512,5,12,12,12,51,44,7,48
Admira Wacke,2512,6,12,8,16,40,57,-17,44
RZ Pellets W,2512,7,10,13,13,46,54,-8,43
SV Josko Rie,2512,8,11,8,17,35,47,-12,41
St. Pölten,2512,9,6,12,18,38,66,-28,30
Mattersburg,2512,10,6,11,19,31,57,-26,29
FC Salzburg,2513,1,19,12,5,65,28,37,69
SC Rheindorf,2513,2,19,8,9,61,46,15,65
Vienna,2513,3,18,6,12,69,59,10,60
RZ Pellets W,2513,4,16,7,13,55,54,1,55
SK Sturm Gra,2513,5,16,5,15,50,40,10,53
Admira Wacke,2513,6,14,7,15,46,53,-7,49
Rapid Vienna,2513,7,10,14,12,48,43,5,44
SV Josko Rie,2513,8,10,7,19,36,57,-21,37
Mattersburg,2513,9,8,10,18,37,56,-19,34
St. Pölten,2513,10,7,10,19,35,66,-31,31
FC Salzburg,2514,1,23,8,5,77,31,46,77
SC Rheindorf,2514,2,20,6,10,53,47,6,66
Vienna,2514,3,19,6,11,68,56,12,63
SK Sturm Gra,2514,4,17,8,11,57,44,13,59
RZ Pellets W,2514,5,14,8,14,48,47,1,50
Rapid Vienna,2514,6,10,15,11,57,49,8,45
SV Josko Rie,2514,7,13,2,21,42,57,-15,41
Admira Wacke,2514,8,11,5,20,42,69,-27,38
St. Pölten,2514,9,8,10,18,50,68,-18,34
Mattersburg,2514,10,7,8,21,34,60,-26,29
FC Salzburg,2515,1,22,8,6,61,27,34,74
SC Rheindorf,2515,2,22,7,7,64,36,28,73
SK Sturm Gra,2515,3,17,8,11,59,37,22,59
Vienna,2515,4,16,7,13,53,51,2,55
Rapid Vienna,2515,5,13,13,10,49,35,14,52
RZ Pellets W,2515,6,14,7,15,51,52,-1,49
SV Josko Rie,2515,7,9,10,17,33,51,-18,37
St. Pölten,2515,8,8,11,17,41,67,-26,35
Admira Wacke,2515,9,9,7,20,29,61,-32,34
Mattersburg,2515,10,7,8,21,36,59,-23,29
FC Salzburg,2516,1,21,7,8,69,39,30,70
SK Sturm Gra,2516,2,21,5,10,62,37,25,68
Rapid Vienna,2516,3,15,14,7,57,33,24,59
SC Rheindorf,2516,4,17,5,14,47,40,7,56
Vienna,2516,5,16,7,13,59,52,7,55
RZ Pellets W,2516,6,11,11,14,45,52,-7,44
Admira Wacke,2516,7,11,7,18,37,58,-21,40
St. Pölten,2516,8,9,12,15,37,56,-19,39
SV Josko Rie,2516,9,10,7,19,31,52,-21,37
Mattersburg,2516,10,7,9,20,35,60,-25,30
SC Rheindorf,2517,1,23,5,8,57,35,22,74
FC Salzburg,2517,2,20,6,10,72,36,36,66
Vienna,2517,3,18,5,13,60,58,2,59
SK Sturm Gra,2517,4,16,8,12,60,43,17,56
Rapid Vienna,2517,5,13,14,9,56,38,18,53
Admira Wacke,2517,6,13,9,14,42,54,-12,48
SV Josko Rie,2517,7,13,3,20,33,55,-22,42
RZ Pellets W,2517,8,8,11,17,43,59,-16,35
Mattersburg,2517,9,9,7,20,34,57,-23,34
St. Pölten,2517,10,7,12,17,46,68,-22,33
FC Salzburg,2518,1,24,5,7,72,35,37,77
SK Sturm Gra,2518,2,20,7,9,59,31,28,67
SC Rheindorf,2518,3,20,6,10,57,46,11,66
Vienna,2518,4,20,3,13,63,47,16,63
Admira Wacke,2518,5,13,6,17,38,53,-15,45
Rapid Vienna,2518,6,11,10,15,49,45,4,43
RZ Pellets W,2518,7,11,5,20,41,61,-20,38
St. Pölten,2518,8,9,10,17,46,66,-20,37
SV Josko Rie,2518,9,10,6,20,33,62,-29,36
Mattersburg,2518,10,8,10,18,40,52,-12,34
FC Salzburg,2519,1,19,9,8,68,31,37,66
SC Rheindorf,2519,2,19,7,10,54,40,14,64
Vienna,2519,3,18,9,9,55,44,11,63
SK Sturm Gra,2519,4,17,7,12,54,35,19,58
Rapid Vienna,2519,5,15,10,11,55,41,14,55
Mattersburg,2519,6,13,8,15,48,55,-7,47
Admira Wacke,2519,7,13,7,16,40,53,-13,46
RZ Pellets W,2519,8,11,8,17,42,60,-18,41
SV Josko Rie,2519,9,8,6,22,31,60,-29,30
St. Pölten,2519,10,6,11,19,34,62,-28,29
Vienna,2520,1,22,6,8,67,42,25,72
FC Salzburg,2520,2,19,11,6,66,35,31,68
SC Rheindorf,2520,3,18,9,9,56,43,13,63
SK Sturm Gra,2520,4,18,7,11,51,34,17,61
Rapid Vienna,2520,5,13,13,10,59,39,20,52
RZ Pellets W,2520,6,11,9,16,43,56,-13,42
Mattersburg,2520,7,10,9,17,36,50,-14,39
Admira Wacke,2520,8,10,8,18,31,60,-29,38
SV Josko Rie,2520,9,10,5,21,29,50,-21,35
St. Pölten,2520,10,7,7,22,39,68,-29,28
SK Sturm Gra,2521,1,21,6,9,63,32,31,69
FC Salzburg,2521,2,19,9,8,66,34,32,66
SC Rheindorf,2521,3,18,8,10,54,45,9,62
Vienna,2521,4,18,6,12,66,54,12,60
Rapid Vienna,2521,5,13,9,14,54,46,8,48
RZ Pellets W,2521,6,12,10,14,47,54,-7,46
SV Josko Rie,2521,7,12,7,17,38,53,-15,43
Admira Wacke,2521,8,10,9,17,33,59,-26,39
Mattersburg,2521,9,9,8,19,32,53,-21,35
St. Pölten,2521,10,7,10,19,36,59,-23,31
SC Rheindorf,2522,1,22,7,7,55,36,19,73
FC Salzburg,2522,2,22,6,8,72,40,32,72
SK Sturm Gra,2522,3,22,5,9,64,29,35,71
Rapid Vienna,2522,4,17,10,9,66,40,26,61
Vienna,2522,5,17,6,13,64,52,12,57
RZ Pellets W,2522,6,10,10,16,45,58,-13,40
Admira Wacke,2522,7,10,7,19,34,60,-26,37
St. Pölten,2522,8,9,8,19,40,67,-27,35
SV Josko Rie,2522,9,9,5,22,28,56,-28,32
Mattersburg,2522,10,6,8,22,31,61,-30,26
SC Rheindorf,2523,1,21,7,8,61,43,18,70
SK Sturm Gra,2523,2,19,6,11,58,31,27,63
FC Salzburg,2523,3,18,8,10,58,34,24,62
Vienna,2523,4,18,6,12,64,55,9,60
Rapid Vienna,2523,5,15,9,12,54,37,17,54
RZ Pellets W,2523,6,16,5,15,54,55,-1,53
SV Josko Rie,2523,7,13,6,17,44,51,-7,45
Admira Wacke,2523,8,10,9,17,43,65,-22,39
Mattersburg,2523,9,7,8,21,33,63,-30,29
St. Pölten,2523,10,7,8,21,42,77,-35,29
FC Salzburg,2524,1,23,7,6,66,29,37,76
SK Sturm Gra,2524,2,20,6,10,62,33,29,66
Vienna,2524,3,19,4,13,63,55,8,61
SC Rheindorf,2524,4,18,4,14,51,47,4,58
Rapid Vienna,2524,5,12,14,10,50,37,13,50
RZ Pellets W,2524,6,13,8,15,49,49,0,47
Admira Wacke,2524,7,13,6,17,37,53,-16,45
Mattersburg,2524,8,9,9,18,42,60,-18,36
SV Josko Rie,2524,9,10,4,22,37,59,-22,34
St. Pölten,2524,10,8,8,20,39,74,-35,32
FC Salzburg,2525,1,23,7,6,74,28,46,76
SC Rheindorf,2525,2,21,8,7,61,45,16,71
SK Sturm Gra,2525,3,19,7,10,58,32,26,64
Rapid Vienna,2525,4,15,10,11,55,35,20,55
Vienna,2525,5,17,4,15,61,58,3,55
Admira Wacke,2525,6,14,5,17,47,55,-8,47
RZ Pellets W,2525,7,13,6,17,41,61,-20,45
SV Josko Rie,2525,8,8,7,21,33,58,-25,31
Mattersburg,2525,9,7,10,19,32,58,-26,31
St. Pölten,2525,10,7,8,21,36,68,-32,29
SK Sturm Gra,2526,1,25,3,8,80,30,50,78
FC Salzburg,2526,2,19,12,5,62,31,31,69
SC Rheindorf,2526,3,20,7,9,59,41,18,67
Vienna,2526,4,18,5,13,60,50,10,59
Rapid Vienna,2526,5,11,11,14,49,46,3,44
Admira Wacke,2526,6,12,7,17,40,63,-23,43
SV Josko Rie,2526,7,12,5,19,47,61,-14,41
RZ Pellets W,2526,8,11,6,19,43,65,-22,39
Mattersburg,2526,9,8,8,20,41,66,-25,32
St. Pölten,2526,10,8,8,20,37,65,-28,32
FC Salzburg,2527,1,21,8,7,66,35,31,71
SC Rheindorf,2527,2,19,10,7,54,37,17,67
SK Sturm Gra,2527,3,20,5,11,58,33,25,65
Vienna,2527,4,17,3,16,56,55,1,54
Rapid Vienna,2527,5,14,10,12,51,41,10,52
Admira Wacke,2527,6,14,7,15,47,57,-10,49
RZ Pellets W,2527,7,11,7,18,42,53,-11,40
Mattersburg,2527,8,10,7,19,41,62,-21,37
St. Pölten,2527,9,9,8,19,47,64,-17,35
SV Josko Rie,2527,10,10,5,21,32,57,-25,35
SC Rheindorf,2528,1,21,7,8,62,45,17,70
FC Salzburg,2528,2,20,8,8,66,32,34,68
SK Sturm Gra,2528,3,19,7,10,54,34,20,64
Vienna,2528,4,18,8,10,71,47,24,62
Rapid Vienna,2528,5,12,13,11,55,40,15,49
RZ Pellets W,2528,6,13,8,15,53,57,-4,47
Admira Wacke,2528,7,12,8,16,40,59,-19,44
SV Josko Rie,2528,8,9,7,20,31,57,-26,34
St. Pölten,2528,9,9,7,20,42,72,-30,34
Mattersburg,2528,10,7,7,22,32,63,-31,28
FC Salzburg,2529,1,21,6,9,63,32,31,69
Vienna,2529,2,20,5,11,67,51,16,65
SC Rheindorf,2529,3,18,10,8,52,35,17,64
SK Sturm Gra,2529,4,18,9,9,56,34,22,63
Rapid Vienna,2529,5,14,10,12,57,40,17,52
RZ Pellets W,2529,6,12,6,18,46,52,-6,42
St. Pölten,2529,7,11,9,16,45,62,-17,42
Admira Wacke,2529,8,11,5,20,38,66,-28,38
SV Josko Rie,2529,9,11,4,21,35,57,-22,37
Mattersburg,2529,10,8,8,20,33,63,-30,32
FC Salzburg,2530,1,23,7,6,67,27,40,76
Vienna,2530,2,19,8,9,60,44,16,65
SK Sturm Gra,2530,3,18,8,10,58,37,21,62
SC Rheindorf,2530,4,15,10,11,43,38,5,55
Rapid Vienna,2530,5,12,13,11,53,38,15,49
RZ Pellets W,2530,6,13,7,16,47,56,-9,46
SV Josko Rie,2530,7,13,6,17,44,54,-10,45
Admira Wacke,2530,8,9,8,19,33,62,-29,35
St. Pölten,2530,9,8,10,18,42,65,-23,34
Mattersburg,2530,10,7,9,20,36,62,-26,30
SC Rheindorf,2531,1,20,8,8,60,43,17,68
FC Salzburg,2531,2,20,7,9,60,34,26,67
SK Sturm Gra,2531,3,20,6,10,64,32,32,66
Vienna,2531,4,16,7,13,59,59,0,55
Rapid Vienna,2531,5,14,9,13,54,37,17,51
RZ Pellets W,2531,6,13,10,13,51,52,-1,49
Admira Wacke,2531,7,14,6,16,38,55,-17,48
SV Josko Rie,2531,8,10,6,20,38,58,-20,36
St. Pölten,2531,9,8,12,16,39,63,-24,36
Mattersburg,2531,10,5,9,22,34,64,-30,24
FC Salzburg,2532,1,23,5,8,76,38,38,74
Vienna,2532,2,22,5,9,72,50,22,71
SC Rheindorf,2532,3,22,5,9,57,37,20,71
SK Sturm Gra,2532,4,19,6,11,57,36,21,63
Rapid Vienna,2532,5,12,13,11,59,45,14,49
RZ Pellets W,2532,6,11,5,20,50,62,-12,38
Admira Wacke,2532,7,10,8,18,37,64,-27,38
SV Josko Rie,2532,8,10,6,20,35,59,-24,36
Mattersburg,2532,9,9,7,20,37,63,-26,34
St. Pölten,2532,10,8,8,20,40,66,-26,32
SC Rheindorf,2533,1,22,8,6,61,36,25,74
SK Sturm Gra,2533,2,19,6,11,58,38,20,63
FC Salzburg,2533,3,18,7,11,66,34,32,61
Vienna,2533,4,17,5,14,60,62,-2,56
Rapid Vienna,2533,5,12,10,14,53,46,7,46
Admira Wacke,2533,6,13,7,16,41,58,-17,46
SV Josko Rie,2533,7,13,4,19,42,60,-18,43
Mattersburg,2533,8,11,6,19,36,55,-19,39
RZ Pellets W,2533,9,10,8,18,47,59,-12,38
St. Pölten,2533,10,9,11,16,44,60,-16,38
FC Salzburg,2534,1,21,9,6,66,30,36,72
SC Rheindorf,2534,2,20,9,7,60,46,14,69
SK Sturm Gra,2534,3,18,9,9,65,37,28,63
Vienna,2534,4,18,5,13,65,52,13,59
Rapid Vienna,2534,5,15,13,8,58,39,19,58
RZ Pellets W,2534,6,11,10,15,44,57,-13,43
Admira Wacke,2534,7,10,7,19,31,58,-27,37
SV Josko Rie,2534,8,9,7,20,30,51,-21,34
St. Pölten,2534,9,8,9,19,45,67,-22,33
Mattersburg,2534,10,5,12,19,32,59,-27,27
FC Salzburg,2535,1,23,6,7,70,30,40,75
SC Rheindorf,2535,2,21,8,7,60,39,21,71
SK Sturm Gra,2535,3,19,5,12,66,38,28,62
Vienna,2535,4,17,6,13,61,55,6,57
RZ Pellets W,2535,5,14,10,12,49,48,1,52
Rapid Vienna,2535,6,13,11,12,56,41,15,50
Admira Wacke,2535,7,12,6,18,32,58,-26,42
St. Pölten,2535,8,9,9,18,41,65,-24,36
SV Josko Rie,2535,9,7,8,21,27,57,-30,29
Mattersburg,2535,10,5,11,20,28,59,-31,26
FC Salzburg,2536,1,24,4,8,67,32,35,76
SC Rheindorf,2536,2,21,7,8,61,43,18,70
SK Sturm Gra,2536,3,18,6,12,60,40,20,60
Vienna,2536,4,17,9,10,69,53,16,60
Rapid Vienna,2536,5,15,10,11,54,41,13,55
Admira Wacke,2536,6,12,7,17,35,56,-21,43
RZ Pellets W,2536,7,11,9,16,41,52,-11,42
SV Josko Rie,2536,8,10,6,20,40,59,-19,36
St. Pölten,2536,9,8,11,17,38,60,-22,35
Mattersburg,2536,10,6,7,23,28,57,-29,25
FC Salzburg,2537,1,21,9,6,66,29,37,72
SC Rheindorf,2537,2,16,14,6,49,37,12,62
SK Sturm Gra,2537,3,17,7,12,54,40,14,58
Vienna,2537,4,16,6,14,59,52,7,54
RZ Pellets W,2537,5,13,8,15,50,57,-7,47
SV Josko Rie,2537,6,13,4,19,38,49,-11,43
St. Pölten,2537,7,11,10,15,41,57,-16,43
Rapid Vienna,2537,8,10,11,15,50,43,7,41
Mattersburg,2537,9,9,11,16,31,50,-19,38
Admira Wacke,2537,10,10,8,18,36,60,-24,38
FC Salzburg,2538,1,25,5,6,69,29,40,80
Vienna,2538,2,19,6,11,59,46,13,63
SC Rheindorf,2538,3,17,11,8,55,41,14,62
Rapid Vienna,2538,4,15,13,8,56,37,19,58
SK Sturm Gra,2538,5,17,6,13,53,37,16,57
RZ Pellets W,2538,6,12,9,15,48,51,-3,45
Admira Wacke,2538,7,11,5,20,37,57,-20,38
SV Josko Rie,2538,8,10,6,20,30,54,-24,36
St. Pölten,2538,9,7,10,19,40,68,-28,31
Mattersburg,2538,10,6,11,19,36,63,-27,29
FC Salzburg,2539,1,22,7,7,69,27,42,73
SC Rheindorf,2539,2,20,10,6,53,35,18,70
Vienna,2539,3,19,4,13,57,52,5,61
SK Sturm Gra,2539,4,18,6,12,56,37,19,60
Rapid Vienna,2539,5,14,10,12,62,43,19,52
RZ Pellets W,2539,6,12,8,16,46,56,-10,44
Admira Wacke,2539,7,10,7,19,34,60,-26,37
Mattersburg,2539,8,9,8,19,39,57,-18,35
St. Pölten,2539,9,8,11,17,41,65,-24,35
SV Josko Rie,2539,10,9,7,20,28,53,-25,34
FC Salzburg,2540,1,20,10,6,69,35,34,70
Vienna,2540,2,20,5,11,62,48,14,65
SK Sturm Gra,2540,3,19,7,10,59,34,25,64
SC Rheindorf,2540,4,18,8,10,54,41,13,62
Rapid Vienna,2540,5,13,12,11,61,48,13,51
St. Pölten,2540,6,11,9,16,45,57,-12,42
Admira Wacke,2540,7,10,8,18,31,56,-25,38
RZ Pellets W,2540,8,9,10,17,41,59,-18,37
SV Josko Rie,2540,9,11,3,22,33,56,-23,36
Mattersburg,2540,10,9,8,19,40,61,-21,35
FC Salzburg,2541,1,22,7,7,71,32,39,73
SK Sturm Gra,2541,2,20,6,10,66,33,33,66
Vienna,2541,3,19,7,10,63,48,15,64
SC Rheindorf,2541,4,19,7,10,50,40,10,64
RZ Pellets W,2541,5,14,6,16,45,58,-13,48
Rapid Vienna,2541,6,11,12,13,50,40,10,45
Admira Wacke,2541,7,12,5,19,42,62,-20,41
St. Pölten,2541,8,10,8,18,41,63,-22,38
Mattersburg,2541,9,9,8,19,38,62,-24,35
SV Josko Rie,2541,10,8,6,22,31,59,-28,30
SC Rheindorf,2542,1,22,8,6,60,38,22,74
Vienna,2542,2,18,9,9,63,47,16,63
SK Sturm Gra,2542,3,18,6,12,57,41,16,60
Rapid Vienna,2542,4,16,10,10,63,40,23,58
FC Salzburg,2542,5,16,7,13,57,38,19,55
St. Pölten,2542,6,10,11,15,45,62,-17,41
RZ Pellets W,2542,7,11,8,17,38,56,-18,41
SV Josko Rie,2542,8,11,6,19,38,53,-15,39
Mattersburg,2542,9,10,7,19,38,55,-17,37
Admira Wacke,2542,10,10,4,22,37,66,-29,34
FC Salzburg,2543,1,23,6,7,68,31,37,75
SK Sturm Gra,2543,2,19,7,10,61,38,23,64
Vienna,2543,3,18,4,14,62,56,6,58
SC Rheindorf,2543,4,16,7,13,53,49,4,55
Rapid Vienna,2543,5,14,11,11,57,42,15,53
SV Josko Rie,2543,6,13,6,17,45,48,-3,45
RZ Pellets W,2543,7,11,9,16,44,57,-13,42
Admira Wacke,2543,8,11,8,17,40,61,-21,41
St. Pölten,2543,9,9,8,19,43,68,-25,35
Mattersburg,2543,10,8,10,18,36,59,-23,34
SK Sturm Gra,2544,1,23,5,8,65,27,38,74
SC Rheindorf,2544,2,21,6,9,51,39,12,69
FC Salzburg,2544,3,20,8,8,61,27,34,68
Vienna,2544,4,18,4,14,59,56,3,58
Rapid Vienna,2544,5,15,8,13,53,40,13,53
RZ Pellets W,2544,6,15,5,16,48,52,-4,50
St. Pölten,2544,7,10,8,18,42,64,-22,38
Admira Wacke,2544,8,10,7,19,34,61,-27,37
Mattersburg,2544,9,9,9,18,35,53,-18,36
SV Josko Rie,2544,10,7,4,25,25,54,-29,25
SK Sturm Gra,2545,1,21,5,10,63,37,26,68
SC Rheindorf,2545,2,20,6,10,58,38,20,66
FC Salzburg,2545,3,18,11,7,66,38,28,65
Vienna,2545,4,18,4,14,58,58,0,58
Rapid Vienna,2545,5,15,9,12,59,37,22,54
RZ Pellets W,2545,6,15,6,15,54,57,-3,51
Admira Wacke,2545,7,11,7,18,38,63,-25,40
SV Josko Rie,2545,8,10,7,19,36,55,-19,37
Mattersburg,2545,9,8,9,19,32,53,-21,33
St. Pölten,2545,10,8,8,20,41,69,-28,32
FC Salzburg,2546,1,22,7,7,59,25,34,73
SK Sturm Gra,2546,2,19,10,7,56,29,27,67
Vienna,2546,3,17,8,11,58,51,7,59
SC Rheindorf,2546,4,16,9,11,57,48,9,57
Rapid Vienna,2546,5,15,11,10,51,37,14,56
RZ Pellets W,2546,6,11,8,17,47,60,-13,41
Mattersburg,2546,7,10,9,17,38,51,-13,39
St. Pölten,2546,8,8,13,15,40,61,-21,37
SV Josko Rie,2546,9,9,8,19,31,49,-18,35
Admira Wacke,2546,10,8,7,21,35,61,-26,31
SC Rheindorf,2547,1,23,5,8,63,39,24,74
FC Salzburg,2547,2,19,9,8,65,34,31,66
SK Sturm Gra,2547,3,19,6,11,57,35,22,63
Vienna,2547,4,18,4,14,58,56,2,58
Admira Wacke,2547,5,14,8,14,38,52,-14,50
Rapid Vienna,2547,6,12,11,13,55,51,4,47
RZ Pellets W,2547,7,11,8,17,48,56,-8,41
SV Josko Rie,2547,8,11,7,18,36,55,-19,40
St. Pölten,2547,9,9,8,19,48,68,-20,35
Mattersburg,2547,10,6,10,20,35,57,-22,28
SC Rheindorf,2548,1,23,4,9,56,38,18,73
FC Salzburg,2548,2,19,11,6,62,28,34,68
Rapid Vienna,2548,3,17,9,10,63,40,23,60
Vienna,2548,4,18,6,12,61,48,13,60
SK Sturm Gra,2548,5,16,7,13,52,39,13,55
RZ Pellets W,2548,6,11,9,16,47,60,-13,42
SV Josko Rie,2548,7,11,5,20,39,55,-16,38
Admira Wacke,2548,8,10,7,19,38,64,-26,37
Mattersburg,2548,9,10,6,20,33,52,-19,36
St. Pölten,2548,10,9,8,19,39,66,-27,35
FC Salzburg,2549,1,22,7,7,66,26,40,73
SC Rheindorf,2549,2,20,8,8,64,43,21,68
SK Sturm Gra,2549,3,20,7,9,56,32,24,67
Vienna,2549,4,19,8,9,62,43,19,65
Rapid Vienna,2549,5,13,10,13,49,41,8,49
Admira Wacke,2549,6,11,9,16,40,59,-19,42
RZ Pellets W,2549,7,10,10,16,45,59,-14,40
St. Pölten,2549,8,10,8,18,48,65,-17,38
SV Josko Rie,2549,9,10,3,23,28,61,-33,33
Mattersburg,2549,10,6,8,22,34,63,-29,26
FC Salzburg,2550,1,21,7,8,67,35,32,70
Vienna,2550,2,20,5,11,60,49,11,65
SC Rheindorf,2550,3,19,6,11,52,43,9,63
SK Sturm Gra,2550,4,19,4,13,61,38,23,61
Rapid Vienna,2550,5,17,8,11,64,39,25,59
SV Josko Rie,2550,6,12,7,17,36,49,-13,43
RZ Pellets W,2550,7,11,10,15,47,63,-16,43
Admira Wacke,2550,8,11,6,19,45,63,-18,39
Mattersburg,2550,9,8,9,19,36,52,-16,33
St. Pölten,2550,10,7,8,21,37,74,-37,29
SC Rheindorf,2551,1,22,8,6,61,38,23,74
SK Sturm Gra,2551,2,22,6,8,63,30,33,72
FC Salzburg,2551,3,20,7,9,70,32,38,67
Vienna,2551,4,19,4,13,64,54,10,61
Rapid Vienna,2551,5,16,10,10,59,42,17,58
Admira Wacke,2551,6,11,8,17,41,62,-21,41
RZ Pellets W,2551,7,11,6,19,41,57,-16,39
SV Josko Rie,2551,8,10,5,21,33,56,-23,35
St. Pölten,2551,9,8,7,21,45,77,-32,31
Mattersburg,2551,10,7,7,22,36,65,-29,28
FC Salzburg,2552,1,22,9,5,66,29,37,75
SK Sturm Gra,2552,2,20,5,11,63,34,29,65
Vienna,2552,3,19,6,11,67,50,17,63
SC Rheindorf,2552,4,17,8,11,56,47,9,59
Rapid Vienna,2552,5,13,12,11,55,43,12,51
St. Pölten,2552,6,12,11,13,56,63,-7,47
RZ Pellets W,2552,7,13,6,17,48,65,-17,45
Admira Wacke,2552,8,11,3,22,36,63,-27,36
SV Josko Rie,2552,9,9,5,22,33,56,-23,32
Mattersburg,2552,10,7,9,20,33,63,-30,30
SK Sturm Gra,2553,1,20,6,10,63,35,28,66
SC Rheindorf,2553,2,20,5,11,58,42,16,65
FC Salzburg,2553,3,18,10,8,59,33,26,64
Vienna,2553,4,19,5,12,62,47,15,62
Rapid Vienna,2553,5,12,9,15,53,48,5,45
RZ Pellets W,2553,6,13,6,17,50,68,-18,45
Admira Wacke,2553,7,12,7,17,43,58,-15,43
St. Pölten,2553,8,12,6,18,45,61,-16,42
Mattersburg,2553,9,10,8,18,37,59,-22,38
SV Josko Rie,2553,10,11,4,21,36,55,-19,37
FC Salzburg,2554,1,20,7,9,66,33,33,67
SC Rheindorf,2554,2,20,5,11,60,43,17,65
Rapid Vienna,2554,3,18,9,9,60,38,22,63
Vienna,2554,4,18,6,12,69,57,12,60
SK Sturm Gra,2554,5,18,4,14,52,41,11,58
RZ Pellets W,2554,6,13,7,16,49,59,-10,46
SV Josko Rie,2554,7,13,5,18,42,55,-13,44
Admira Wacke,2554,8,11,5,20,34,58,-24,38
St. Pölten,2554,9,8,10,18,43,69,-26,34
Mattersburg,2554,10,8,8,20,35,57,-22,32
FC Salzburg,2555,1,24,6,6,69,22,47,78
SC Rheindorf,2555,2,23,6,7,65,39,26,75
SK Sturm Gra,2555,3,20,6,10,60,37,23,66
Vienna,2555,4,18,4,14,65,54,11,58
Rapid Vienna,2555,5,14,11,11,53,38,15,53
RZ Pellets W,2555,6,12,7,17,47,61,-14,43
SV Josko Rie,2555,7,10,7,19,36,55,-19,37
Admira Wacke,2555,8,9,9,18,38,69,-31,36
St. Pölten,2555,9,6,11,19,39,68,-29,29
Mattersburg,2555,10,5,11,20,33,62,-29,26
SC Rheindorf,2556,1,23,6,7,65,45,20,75
FC Salzburg,2556,2,21,8,7,60,27,33,71
SK Sturm Gra,2556,3,17,5,14,53,35,18,56
Rapid Vienna,2556,4,13,10,13,59,39,20,49
Vienna,2556,5,15,4,17,54,58,-4,49
RZ Pellets W,2556,6,13,8,15,43,51,-8,47
Mattersburg,2556,7,10,11,15,37,49,-12,41
SV Josko Rie,2556,8,10,9,17,35,53,-18,39
Admira Wacke,2556,9,10,8,18,35,60,-25,38
St. Pölten,2556,10,9,9,18,41,65,-24,36
Vienna,2557,1,22,4,10,69,51,18,70
SK Sturm Gra,2557,2,21,6,9,66,39,27,69
FC Salzburg,2557,3,19,8,9,64,35,29,65
SC Rheindorf,2557,4,17,10,9,55,43,12,61
Rapid Vienna,2557,5,11,13,12,52,45,7,46
RZ Pellets W,2557,6,11,10,15,50,58,-8,43
Admira Wacke,2557,7,10,10,16,38,54,-16,40
SV Josko Rie,2557,8,11,5,20,34,54,-20,38
St. Pölten,2557,9,8,12,16,41,62,-21,36
Mattersburg,2557,10,7,8,21,35,63,-28,29
FC Salzburg,2558,1,23,8,5,77,27,50,77
Vienna,2558,2,19,5,12,67,54,13,62
SK Sturm Gra,2558,3,18,6,12,55,40,15,60
SC Rheindorf,2558,4,17,9,10,49,40,9,60
Rapid Vienna,2558,5,16,10,10,55,35,20,58
Admira Wacke,2558,6,14,5,17,36,56,-20,47
RZ Pellets W,2558,7,13,7,16,50,53,-3,46
SV Josko Rie,2558,8,11,4,21,34,59,-25,37
St. Pölten,2558,9,9,9,18,40,58,-18,36
Mattersburg,2558,10,4,9,23,29,70,-41,21
SC Rheindorf,2559,1,22,7,7,65,40,25,73
FC Salzburg,2559,2,22,4,10,60,37,23,70
SK Sturm Gra,2559,3,19,5,12,56,35,21,62
Rapid Vienna,2559,4,17,9,10,62,36,26,60
Vienna,2559,5,19,3,14,58,51,7,60
Admira Wacke,2559,6,13,5,18,37,56,-19,44
RZ Pellets W,2559,7,12,4,20,42,56,-14,40
SV Josko Rie,2559,8,11,6,19,35,51,-16,39
St. Pölten,2559,9,7,10,19,40,71,-31,31
Mattersburg,2559,10,7,9,20,37,59,-22,30
FC Salzburg,2560,1,23,5,8,66,30,36,74
SK Sturm Gra,2560,2,20,7,9,60,33,27,67
SC Rheindorf,2560,3,20,6,10,56,38,18,66
Rapid Vienna,2560,4,16,10,10,57,38,19,58
Vienna,2560,5,17,6,13,60,50,10,57
RZ Pellets W,2560,6,13,9,14,53,56,-3,48
Admira Wacke,2560,7,10,7,19,35,62,-27,37
SV Josko Rie,2560,8,10,6,20,34,54,-20,36
St. Pölten,2560,9,9,9,18,43,68,-25,36
Mattersburg,2560,10,5,9,22,36,71,-35,24
SC Rheindorf,2561,1,21,7,8,54,36,18,70
SK Sturm Gra,2561,2,20,6,10,64,37,27,66
FC Salzburg,2561,3,19,7,10,59,34,25,64
Vienna,2561,4,17,7,12,67,56,11,58
Rapid Vienna,2561,5,13,13,10,53,36,17,52
RZ Pellets W,2561,6,12,10,14,47,57,-10,46
SV Josko Rie,2561,7,13,7,16,40,52,-12,46
Admira Wacke,2561,8,8,11,17,38,60,-22,35
St. Pölten,2561,9,8,10,18,34,61,-27,34
Mattersburg,2561,10,6,8,22,31,58,-27,26
SC Rheindorf,2562,1,22,7,7,63,40,23,73
FC Salzburg,2562,2,20,9,7,64,30,34,69
SK Sturm Gra,2562,3,17,10,9,51,29,22,61
Vienna,2562,4,18,6,12,65,50,15,60
Rapid Vienna,2562,5,11,15,10,51,41,10,48
Admira Wacke,2562,6,11,8,17,34,60,-26,41
RZ Pellets W,2562,7,11,7,18,44,60,-16,40
St. Pölten,2562,8,9,12,15,44,60,-16,39
SV Josko Rie,2562,9,9,6,21,34,59,-25,33
Mattersburg,2562,10,8,8,20,36,57,-21,32
FC Salzburg,2563,1,23,4,9,66,26,40,73
SC Rheindorf,2563,2,18,9,9,54,43,11,63
SK Sturm Gra,2563,3,17,10,9,59,39,20,61
Vienna,2563,4,17,8,11,63,51,12,59
Rapid Vienna,2563,5,14,12,10,59,46,13,54
RZ Pellets W,2563,6,12,12,12,48,49,-1,48
Mattersburg,2563,7,9,10,17,44,59,-15,37
Admira Wacke,2563,8,10,7,19,32,65,-33,37
SV Josko Rie,2563,9,9,7,20,34,54,-20,34
St. Pölten,2563,10,6,11,19,41,68,-27,29
SK Sturm Gra,2564,1,23,6,7,73,31,42,75
SC Rheindorf,2564,2,20,7,9,57,42,15,67
FC Salzburg,2564,3,16,9,11,58,34,24,57
Vienna,2564,4,16,8,12,60,59,1,56
Rapid Vienna,2564,5,11,12,13,54,50,4,45
SV Josko Rie,2564,6,12,6,18,40,50,-10,42
RZ Pellets W,2564,7,11,8,17,49,64,-15,41
Mattersburg,2564,8,10,10,16,41,57,-16,40
Admira Wacke,2564,9,10,8,18,35,60,-25,38
St. Pölten,2564,10,9,10,17,41,61,-20,37
FC Salzburg,2565,1,24,6,6,72,27,45,78
SK Sturm Gra,2565,2,19,7,10,57,29,28,64
Vienna,2565,3,19,4,13,64,47,17,61
SC Rheindorf,2565,4,18,5,13,51,45,6,59
Rapid Vienna,2565,5,15,11,10,55,38,17,56
Admira Wacke,2565,6,11,8,17,36,63,-27,41
RZ Pellets W,2565,7,11,7,18,45,62,-17,40
St. Pölten,2565,8,9,12,15,43,62,-19,39
SV Josko Rie,2565,9,10,4,22,37,65,-28,34
Mattersburg,2565,10,9,6,21,37,59,-22,33
SK Sturm Gra,2566,1,20,7,9,68,36,32,67
FC Salzburg,2566,2,19,9,8,59,32,27,66
SC Rheindorf,2566,3,19,9,8,59,37,22,66
Vienna,2566,4,17,7,12,63,58,5,58
Rapid Vienna,2566,5,13,13,10,61,43,18,52
RZ Pellets W,2566,6,11,8,17,43,58,-15,41
Admira Wacke,2566,7,12,5,19,35,57,-22,41
St. Pölten,2566,8,10,9,17,40,66,-26,39
SV Josko Rie,2566,9,9,7,20,33,53,-20,34
Mattersburg,2566,10,6,14,16,38,59,-21,32
FC Salzburg,2567,1,21,10,5,68,31,37,73
Vienna,2567,2,21,5,10,68,49,19,68
SC Rheindorf,2567,3,18,9,9,55,38,17,63
SK Sturm Gra,2567,4,18,7,11,62,41,21,61
Rapid Vienna,2567,5,14,11,11,59,39,20,53
Admira Wacke,2567,6,13,5,18,41,60,-19,44
SV Josko Rie,2567,7,11,5,20,34,57,-23,38
St. Pölten,2567,8,9,9,18,40,65,-25,36
Mattersburg,2567,9,8,10,18,37,55,-18,34
RZ Pellets W,2567,10,7,9,20,41,70,-29,30
FC Salzburg,2568,1,23,5,8,60,28,32,74
SC Rheindorf,2568,2,21,7,8,57,42,15,70
Vienna,2568,3,19,6,11,65,52,13,63
SK Sturm Gra,2568,4,18,6,12,60,35,25,60
Rapid Vienna,2568,5,11,13,12,53,43,10,46
RZ Pellets W,2568,6,11,10,15,48,57,-9,43
St. Pölten,2568,7,10,11,15,49,64,-15,41
Mattersburg,2568,8,10,7,19,38,58,-20,37
Admira Wacke,2568,9,10,5,21,34,63,-29,35
SV Josko Rie,2568,10,9,6,21,33,55,-22,33
FC Salzburg,2569,1,24,6,6,72,31,41,78
SC Rheindorf,2569,2,23,6,7,55,33,22,75
SK Sturm Gra,2569,3,19,7,10,57,32,25,64
Vienna,2569,4,18,4,14,59,53,6,58
Rapid Vienna,2569,5,10,12,14,46,39,7,42
SV Josko Rie,2569,6,11,6,19,32,52,-20,39
Admira Wacke,2569,7,11,5,20,35,61,-26,38
RZ Pellets W,2569,8,9,10,17,37,52,-15,37
Mattersburg,2569,9,9,9,18,34,50,-16,36
St. Pölten,2569,10,7,13,16,30,54,-24,34
FC Salzburg,2570,1,19,10,7,62,29,33,67
SK Sturm Gra,2570,2,20,6,10,67,36,31,66
Vienna,2570,3,20,3,13,67,54,13,63
SC Rheindorf,2570,4,17,8,11,54,43,11,59
Rapid Vienna,2570,5,13,12,11,47,36,11,51
SV Josko Rie,2570,6,13,7,16,41,52,-11,46
RZ Pellets W,2570,7,12,8,16,43,59,-16,44
Admira Wacke,2570,8,11,9,16,42,62,-20,42
St. Pölten,2570,9,8,11,17,45,66,-21,35
Mattersburg,2570,10,7,6,23,32,63,-31,27
Vienna,2571,1,21,5,10,64,42,22,68
SC Rheindorf,2571,2,20,7,9,50,39,11,67
FC Salzburg,2571,3,18,9,9,62,30,32,63
SK Sturm Gra,2571,4,18,5,13,56,37,19,59
Rapid Vienna,2571,5,14,12,10,54,39,15,54
RZ Pellets W,2571,6,12,7,17,46,57,-11,43
Admira Wacke,2571,7,11,8,17,38,55,-17,41
St. Pölten,2571,8,10,10,16,50,66,-16,40
SV Josko Rie,2571,9,11,6,19,35,54,-19,39
Mattersburg,2571,10,7,7,22,27,63,-36,28
SK Sturm Gra,2572,1,23,4,9,64,33,31,73
FC Salzburg,2572,2,21,7,8,67,32,35,70
SC Rheindorf,2572,3,20,6,10,56,46,10,66
Rapid Vienna,2572,4,17,9,10,66,45,21,60
Vienna,2572,5,18,5,13,61,47,14,59
SV Josko Rie,2572,6,12,6,18,41,52,-11,42
RZ Pellets W,2572,7,11,7,18,43,58,-15,40
Admira Wacke,2572,8,10,6,20,34,66,-32,36
Mattersburg,2572,9,8,8,20,40,64,-24,32
St. Pölten,2572,10,6,10,20,40,69,-29,28
FC Salzburg,2573,1,20,9,7,70,31,39,69
SC Rheindorf,2573,2,20,9,7,62,37,25,69
Vienna,2573,3,20,5,11,64,54,10,65
SK Sturm Gra,2573,4,18,6,12,60,39,21,60
Rapid Vienna,2573,5,12,12,12,53,44,9,48
RZ Pellets W,2573,6,12,7,17,42,54,-12,43
Admira Wacke,2573,7,10,10,16,36,62,-26,40
St. Pölten,2573,8,9,11,16,44,67,-23,38
Mattersburg,2573,9,7,12,17,36,50,-14,33
SV Josko Rie,2573,10,9,5,22,28,57,-29,32
FC Salzburg,2574,1,24,6,6,66,24,42,78
SK Sturm Gra,2574,2,20,6,10,58,33,25,66
Vienna,2574,3,20,5,11,57,49,8,65
SC Rheindorf,2574,4,17,8,11,51,42,9,59
Rapid Vienna,2574,5,14,10,12,60,44,16,52
Admira Wacke,2574,6,12,7,17,37,53,-16,43
RZ Pellets W,2574,7,11,7,18,40,58,-18,40
Mattersburg,2574,8,10,6,20,35,57,-22,36
SV Josko Rie,2574,9,9,7,20,30,52,-22,34
St. Pölten,2574,10,8,8,20,37,59,-22,32
FC Salzburg,2575,1,21,10,5,68,27,41,73
SC Rheindorf,2575,2,21,7,8,62,39,23,70
SK Sturm Gra,2575,3,17,10,9,53,31,22,61
Rapid Vienna,2575,4,15,11,10,60,40,20,56
Vienna,2575,5,15,7,14,59,60,-1,52
RZ Pellets W,2575,6,13,8,15,49,57,-8,47
Mattersburg,2575,7,11,8,17,41,56,-15,41
SV Josko Rie,2575,8,10,6,20,32,51,-19,36
St. Pölten,2575,9,8,8,20,36,63,-27,32
Admira Wacke,2575,10,9,5,22,29,65,-36,32
SK Sturm Gra,2576,1,21,8,7,72,38,34,71
FC Salzburg,2576,2,19,8,9,66,42,24,65
SC Rheindorf,2576,3,19,8,9,62,45,17,65
Rapid Vienna,2576,4,15,12,9,62,43,19,57
Vienna,2576,5,17,5,14,69,65,4,56
SV Josko Rie,2576,6,14,4,18,38,51,-13,46
RZ Pellets W,2576,7,13,6,17,47,57,-10,45
Admira Wacke,2576,8,10,6,20,34,62,-28,36
Mattersburg,2576,9,8,8,20,37,60,-23,32
St. Pölten,2576,10,8,7,21,37,61,-24,31
FC Salzburg,2577,1,23,5,8,71,30,41,74
SC Rheindorf,2577,2,21,5,10,51,40,11,68
SK Sturm Gra,2577,3,19,7,10,52,29,23,64
Vienna,2577,4,18,9,9,60,46,14,63
Rapid Vienna,2577,5,11,13,12,52,43,9,46
Admira Wacke,2577,6,12,8,16,42,61,-19,44
RZ Pellets W,2577,7,12,7,17,42,53,-11,43
SV Josko Rie,2577,8,11,3,22,34,54,-20,36
St. Pölten,2577,9,9,8,19,37,63,-26,35
Mattersburg,2577,10,8,7,21,37,59,-22,31
SC Rheindorf,2578,1,21,8,7,53,31,22,71
FC Salzburg,2578,2,20,8,8,57,25,32,68
SK Sturm Gra,2578,3,21,4,11,57,33,24,67
Rapid Vienna,2578,4,16,8,12,58,34,24,56
Vienna,2578,5,16,8,12,59,50,9,56
RZ Pellets W,2578,6,12,7,17,47,61,-14,43
SV Josko Rie,2578,7,13,4,19,34,55,-21,43
Mattersburg,2578,8,9,8,19,37,58,-21,35
Admira Wacke,2578,9,9,8,19,34,62,-28,35
St. Pölten,2578,10,7,9,20,37,64,-27,30
FC Salzburg,2579,1,21,7,8,64,28,36,70
SK Sturm Gra,2579,2,21,6,9,59,30,29,69
SC Rheindorf,2579,3,19,7,10,52,39,13,64
Vienna,2579,4,20,4,12,61,56,5,64
Rapid Vienna,2579,5,12,11,13,53,45,8,47
RZ Pellets W,2579,6,13,8,15,44,52,-8,47
Admira Wacke,2579,7,12,6,18,39,56,-17,42
SV Josko Rie,2579,8,10,5,21,30,54,-24,35
St. Pölten,2579,9,8,10,18,37,61,-24,34
Mattersburg,2579,10,8,8,20,34,52,-18,32
FC Salzburg,2580,1,21,6,9,62,32,30,69
SC Rheindorf,2580,2,20,7,9,56,39,17,67
SK Sturm Gra,2580,3,20,5,11,59,31,28,65
Vienna,2580,4,17,4,15,59,57,2,55
Rapid Vienna,2580,5,14,9,13,55,46,9,51
SV Josko Rie,2580,6,15,4,17,38,47,-9,49
RZ Pellets W,2580,7,14,6,16,49,51,-2,48
Admira Wacke,2580,8,11,9,16,38,64,-26,42
St. Pölten,2580,9,8,8,20,34,60,-26,32
Mattersburg,2580,10,8,6,22,34,57,-23,30
FC Salzburg,2581,1,21,7,8,67,30,37,70
SK Sturm Gra,2581,2,20,5,11,60,33,27,65
SC Rheindorf,2581,3,18,9,9,56,44,12,63
Rapid Vienna,2581,4,15,11,10,53,33,20,56
Vienna,2581,5,16,8,12,60,56,4,56
RZ Pellets W,2581,6,14,7,15,42,47,-5,49
SV Josko Rie,2581,7,14,4,18,36,55,-19,46
Admira Wacke,2581,8,8,9,19,39,69,-30,33
St. Pölten,2581,9,7,10,19,38,64,-26,31
Mattersburg,2581,10,6,12,18,33,53,-20,30
SK Sturm Gra,2582,1,25,3,8,68,29,39,78
FC Salzburg,2582,2,20,11,5,70,29,41,71
SC Rheindorf,2582,3,19,8,9,53,39,14,65
Rapid Vienna,2582,4,14,13,9,58,38,20,55
Vienna,2582,5,16,5,15,52,55,-3,53
RZ Pellets W,2582,6,10,9,17,43,59,-16,39
Admira Wacke,2582,7,10,8,18,36,62,-26,38
SV Josko Rie,2582,8,10,7,19,39,58,-19,37
Mattersburg,2582,9,7,10,19,39,62,-23,31
St. Pölten,2582,10,7,10,19,38,65,-27,31
FC Salzburg,2583,1,24,8,4,73,26,47,80
SK Sturm Gra,2583,2,20,5,11,67,41,26,65
SC Rheindorf,2583,3,19,5,12,55,43,12,62
Vienna,2583,4,19,4,13,66,53,13,61
Rapid Vienna,2583,5,12,12,12,54,48,6,48
RZ Pellets W,2583,6,13,6,17,50,62,-12,45
Mattersburg,2583,7,11,9,16,42,54,-12,42
Admira Wacke,2583,8,10,7,19,33,60,-27,37
SV Josko Rie,2583,9,9,6,21,30,54,-24,33
St. Pölten,2583,10,8,8,20,41,70,-29,32
FC Salzburg,2584,1,21,8,7,65,33,32,71
SC Rheindorf,2584,2,22,5,9,60,43,17,71
Vienna,2584,3,20,3,13,68,50,18,63
Rapid Vienna,2584,4,17,10,9,69,40,29,61
SK Sturm Gra,2584,5,18,7,11,61,39,22,61
Admira Wacke,2584,6,13,7,16,44,57,-13,46
Mattersburg,2584,7,11,10,15,42,57,-15,43
RZ Pellets W,2584,8,11,7,18,45,60,-15,40
SV Josko Rie,2584,9,7,6,23,30,66,-36,27
St. Pölten,2584,10,4,9,23,32,71,-39,21
Vienna,2585,1,20,7,9,65,43,22,67
FC Salzburg,2585,2,19,9,8,58,32,26,66
SK Sturm Gra,2585,3,19,8,9,56,29,27,65
SC Rheindorf,2585,4,18,8,10,51,40,11,62
RZ Pellets W,2585,5,12,10,14,43,53,-10,46
Mattersburg,2585,6,12,7,17,34,53,-19,43
St. Pölten,2585,7,11,9,16,50,59,-9,42
Rapid Vienna,2585,8,10,11,15,47,45,2,41
Admira Wacke,2585,9,10,6,20,35,57,-22,36
SV Josko Rie,2585,10,8,7,21,32,60,-28,31
FC Salzburg,2586,1,17,11,8,57,32,25,62
SC Rheindorf,2586,2,17,10,9,50,43,7,61
Rapid Vienna,2586,3,17,9,10,63,39,24,60
Vienna,2586,4,18,6,12,61,53,8,60
SK Sturm Gra,2586,5,17,7,12,57,34,23,58
Admira Wacke,2586,6,13,6,17,44,62,-18,45
St. Pölten,2586,7,11,10,15,45,55,-10,43
RZ Pellets W,2586,8,11,8,17,42,56,-14,41
SV Josko Rie,2586,9,10,6,20,31,50,-19,36
Mattersburg,2586,10,8,9,19,31,57,-26,33
FC Salzburg,2587,1,21,7,8,66,30,36,70
SK Sturm Gra,2587,2,20,5,11,59,30,29,65
SC Rheindorf,2587,3,18,9,9,49,42,7,63
Vienna,2587,4,17,5,14,58,54,4,56
RZ Pellets W,2587,5,12,11,13,49,53,-4,47
Rapid Vienna,2587,6,11,12,13,49,42,7,45
SV Josko Rie,2587,7,12,7,17,39,48,-9,43
St. Pölten,2587,8,10,10,16,41,57,-16,40
Mattersburg,2587,9,8,11,17,34,51,-17,35
Admira Wacke,2587,10,9,7,20,28,65,-37,34
FC Salzburg,2588,1,23,6,7,67,24,43,75
SC Rheindorf,2588,2,20,9,7,59,40,19,69
SK Sturm Gra,2588,3,20,5,11,58,34,24,65
Vienna,2588,4,19,5,12,63,53,10,62
Rapid Vienna,2588,5,17,10,9,60,37,23,61
RZ Pellets W,2588,6,10,8,18,40,59,-19,38
Admira Wacke,2588,7,11,3,22,40,69,-29,36
St. Pölten,2588,8,9,8,19,39,65,-26,35
Mattersburg,2588,9,8,9,19,32,53,-21,33
SV Josko Rie,2588,10,7,9,20,31,55,-24,30
FC Salzburg,2589,1,21,6,9,69,36,33,69
Vienna,2589,2,21,2,13,74,62,12,65
SC Rheindorf,2589,3,20,5,11,52,40,12,65
SK Sturm Gra,2589,4,19,4,13,63,41,22,61
Rapid Vienna,2589,5,16,10,10,61,44,17,58
RZ Pellets W,2589,6,13,6,17,47,59,-12,45
SV Josko Rie,2589,7,11,6,19,37,55,-18,39
St. Pölten,2589,8,10,7,19,41,64,-23,37
Admira Wacke,2589,9,10,6,20,35,62,-27,36
Mattersburg,2589,10,9,8,19,44,60,-16,35
FC Salzburg,2590,1,19,8,9,62,41,21,65
SC Rheindorf,2590,2,18,11,7,63,47,16,65
Vienna,2590,3,18,8,10,62,47,15,62
SK Sturm Gra,2590,4,18,4,14,51,41,10,58
Rapid Vienna,2590,5,15,10,11,60,41,19,55
SV Josko Rie,2590,6,13,7,16,53,54,-1,46
RZ Pellets W,2590,7,12,7,17,40,54,-14,43
Admira Wacke,2590,8,11,7,18,35,54,-19,40
Mattersburg,2590,9,9,9,18,37,59,-22,36
St. Pölten,2590,10,7,9,20,37,62,-25,30
SK Sturm Gra,2591,1,22,5,9,58,31,27,71
FC Salzburg,2591,2,19,7,10,58,35,23,64
SC Rheindorf,2591,3,18,8,10,58,50,8,62
Vienna,2591,4,19,4,13,65,48,17,61
Rapid Vienna,2591,5,14,11,11,53,38,15,53
RZ Pellets W,2591,6,13,6,17,46,57,-11,45
St. Pölten,2591,7,10,11,15,43,57,-14,41
Admira Wacke,2591,8,10,7,19,39,60,-21,37
Mattersburg,2591,9,9,8,19,35,57,-22,35
SV Josko Rie,2591,10,9,7,20,33,55,-22,34
FC Salzburg,2592,1,23,5,8,71,39,32,74
SC Rheindorf,2592,2,19,10,7,51,37,14,67
SK Sturm Gra,2592,3,18,9,9,57,32,25,63
Rapid Vienna,2592,4,15,11,10,59,37,22,56
Vienna,2592,5,16,7,13,56,51,5,55
RZ Pellets W,2592,6,13,8,15,50,56,-6,47
Admira Wacke,2592,7,12,9,15,46,56,-10,45
SV Josko Rie,2592,8,12,3,21,39,62,-23,39
Mattersburg,2592,9,6,11,19,34,61,-27,29
St. Pölten,2592,10,5,9,22,33,65,-32,24
Vienna,2593,1,20,6,10,69,47,22,66
SK Sturm Gra,2593,2,19,8,9,58,35,23,65
SC Rheindorf,2593,3,18,8,10,52,42,10,62
FC Salzburg,2593,4,16,10,10,60,32,28,58
Rapid Vienna,2593,5,14,12,10,58,38,20,54
RZ Pellets W,2593,6,14,7,15,50,61,-11,49
Admira Wacke,2593,7,13,7,16,41,62,-21,46
Mattersburg,2593,8,9,8,19,36,53,-17,35
SV Josko Rie,2593,9,9,8,19,38,60,-22,35
St. Pölten,2593,10,6,10,20,39,71,-32,28
FC Salzburg,2594,1,24,7,5,68,27,41,79
SC Rheindorf,2594,2,20,10,6,57,31,26,70
SK Sturm Gra,2594,3,17,6,13,63,45,18,57
Vienna,2594,4,16,7,13,66,56,10,55
Admira Wacke,2594,5,16,5,15,46,60,-14,53
RZ Pellets W,2594,6,13,7,16,46,57,-11,46
Rapid Vienna,2594,7,9,12,15,46,44,2,39
Mattersburg,2594,8,8,11,17,37,53,-16,35
SV Josko Rie,2594,9,9,6,21,33,60,-27,33
St. Pölten,2594,10,8,9,19,43,72,-29,33
FC Salzburg,2595,1,22,8,6,68,26,42,74
SC Rheindorf,2595,2,21,9,6,65,44,21,72
SK Sturm Gra,2595,3,20,8,8,60,31,29,68
Vienna,2595,4,17,6,13,61,53,8,57
Rapid Vienna,2595,5,13,11,12,55,36,19,50
RZ Pellets W,2595,6,12,9,15,50,55,-5,45
St. Pölten,2595,7,10,8,18,45,68,-23,38
Admira Wacke,2595,8,10,6,20,31,64,-33,36
Mattersburg,2595,9,8,8,20,32,57,-25,32
SV Josko Rie,2595,10,8,5,23,32,65,-33,29
FC Salzburg,2596,1,21,10,5,61,25,36,73
SK Sturm Gra,2596,2,21,8,7,63,30,33,71
Vienna,2596,3,20,4,12,58,41,17,64
SC Rheindorf,2596,4,16,10,10,48,41,7,58
Rapid Vienna,2596,5,13,11,12,54,43,11,50
RZ Pellets W,2596,6,11,10,15,42,50,-8,43
Admira Wacke,2596,7,12,6,18,34,56,-22,42
SV Josko Rie,2596,8,9,6,21,25,52,-27,33
St. Pölten,2596,9,7,11,18,34,61,-27,32
Mattersburg,2596,10,7,10,19,39,59,-20,31
FC Salzburg,2597,1,24,6,6,81,31,50,78
SK Sturm Gra,2597,2,20,6,10,61,33,28,66
SC Rheindorf,2597,3,18,7,11,63,47,16,61
Vienna,2597,4,17,6,13,53,52,1,57
Rapid Vienna,2597,5,15,9,12,65,47,18,54
RZ Pellets W,2597,6,11,10,15,43,56,-13,43
SV Josko Rie,2597,7,13,4,19,40,55,-15,43
Admira Wacke,2597,8,12,7,17,42,60,-18,43
St. Pölten,2597,9,7,9,20,38,71,-33,30
Mattersburg,2597,10,7,8,21,35,69,-34,29
SK Sturm Gra,2598,1,23,5,8,67,31,36,74
FC Salzburg,2598,2,21,8,7,65,23,42,71
SC Rheindorf,2598,3,20,5,11,56,42,14,65
Vienna,2598,4,19,6,11,67,46,21,63
Rapid Vienna,2598,5,14,10,12,55,45,10,52
Admira Wacke,2598,6,12,7,17,38,60,-22,43
RZ Pellets W,2598,7,11,9,16,47,53,-6,42
St. Pölten,2598,8,8,10,18,41,67,-26,34
SV Josko Rie,2598,9,9,5,22,28,61,-33,32
Mattersburg,2598,10,7,7,22,35,71,-36,28
Vienna,2599,1,22,5,9,74,50,24,71
SC Rheindorf,2599,2,21,4,11,53,46,7,67
FC Salzburg,2599,3,18,8,10,60,38,22,62
SK Sturm Gra,2599,4,18,6,12,62,43,19,60
Rapid Vienna,2599,5,13,11,12,50,40,10,50
RZ Pellets W,2599,6,14,6,16,46,52,-6,48
SV Josko Rie,2599,7,11,8,17,33,47,-14,41
Admira Wacke,2599,8,12,4,20,37,54,-17,40
Mattersburg,2599,9,9,9,18,41,57,-16,36
St. Pölten,2599,10,8,7,21,38,67,-29,31
FC Salzburg,2600,1,19,9,8,69,36,33,66
SC Rheindorf,2600,2,19,8,9,58,43,15,65
SK Sturm Gra,2600,3,18,8,10,55,34,21,62
Vienna,2600,4,17,9,10,60,48,12,60
Admira Wacke,2600,5,13,6,17,47,72,-25,45
Rapid Vienna,2600,6,9,17,10,53,48,5,44
Mattersburg,2600,7,12,7,17,41,54,-13,43
RZ Pellets W,2600,8,9,11,16,46,60,-14,38
SV Josko Rie,2600,9,10,6,20,40,56,-16,36
St. Pölten,2600,10,8,11,17,48,66,-18,35
FC Salzburg,2601,1,21,7,8,71,35,36,70
SC Rheindorf,2601,2,20,10,6,65,39,26,70
SK Sturm Gra,2601,3,20,4,12,63,40,23,64
Vienna,2601,4,18,6,12,65,60,5,60
Rapid Vienna,2601,5,16,8,12,60,43,17,56
RZ Pellets W,2601,6,14,6,16,55,62,-7,48
Admira Wacke,2601,7,14,4,18,42,58,-16,46
SV Josko Rie,2601,8,10,6,20,29,51,-22,36
St. Pölten,2601,9,7,8,21,37,68,-31,29
Mattersburg,2601,10,7,7,22,39,70,-31,28
SC Rheindorf,2602,1,20,6,10,56,50,6,66
SK Sturm Gra,2602,2,19,6,11,65,39,26,63
FC Salzburg,2602,3,18,9,9,63,38,25,63
Vienna,2602,4,16,6,14,69,63,6,54
Rapid Vienna,2602,5,13,13,10,60,39,21,52
RZ Pellets W,2602,6,15,5,16,49,62,-13,50
Admira Wacke,2602,7,12,9,15,43,57,-14,45
St. Pölten,2602,8,12,7,17,53,62,-9,43
Mattersburg,2602,9,9,7,20,39,65,-26,34
SV Josko Rie,2602,10,9,6,21,34,56,-22,33
FC Salzburg,2603,1,19,10,7,63,36,27,67
SK Sturm Gra,2603,2,20,6,10,51,28,23,66
SC Rheindorf,2603,3,19,6,11,56,46,10,63
Vienna,2603,4,19,4,13,62,54,8,61
Rapid Vienna,2603,5,16,8,12,58,36,22,56
RZ Pellets W,2603,6,11,10,15,42,52,-10,43
SV Josko Rie,2603,7,12,4,20,40,58,-18,40
Admira Wacke,2603,8,10,8,18,37,62,-25,38
St. Pölten,2603,9,9,9,18,43,62,-19,36
Mattersburg,2603,10,8,9,19,36,54,-18,33
FC Salzburg,2604,1,17,11,8,59,32,27,62
Vienna,2604,2,18,7,11,62,52,10,61
SC Rheindorf,2604,3,18,7,11,54,48,6,61
SK Sturm Gra,2604,4,17,6,13,57,40,17,57
RZ Pellets W,2604,5,14,6,16,47,54,-7,48
Mattersburg,2604,6,13,7,16,39,47,-8,46
Admira Wacke,2604,7,13,7,16,38,55,-17,46
Rapid Vienna,2604,8,11,12,13,51,39,12,45
St. Pölten,2604,9,10,9,17,44,64,-20,39
SV Josko Rie,2604,10,10,6,20,33,53,-20,36
FC Salzburg,2605,1,21,9,6,64,28,36,72
SK Sturm Gra,2605,2,22,5,9,62,33,29,71
SC Rheindorf,2605,3,18,8,10,44,31,13,62
Vienna,2605,4,17,6,13,61,53,8,57
Rapid Vienna,2605,5,15,10,11,56,42,14,55
SV Josko Rie,2605,6,13,7,16,37,47,-10,46
RZ Pellets W,2605,7,10,6,20,42,63,-21,36
St. Pölten,2605,8,9,9,18,41,63,-22,36
Admira Wacke,2605,9,9,7,20,28,56,-28,34
Mattersburg,2605,10,7,11,18,37,56,-19,32
FC Salzburg,2606,1,23,7,6,78,27,51,76
Vienna,2606,2,21,5,10,68,48,20,68
SK Sturm Gra,2606,3,18,8,10,64,38,26,62
SC Rheindorf,2606,4,17,9,10,49,44,5,60
Rapid Vienna,2606,5,14,9,13,63,46,17,51
RZ Pellets W,2606,6,13,7,16,48,57,-9,46
SV Josko Rie,2606,7,11,5,20,32,56,-24,38
St. Pölten,2606,8,9,10,17,38,62,-24,37
Admira Wacke,2606,9,11,4,21,34,64,-30,37
Mattersburg,2606,10,6,10,20,32,64,-32,28
SK Sturm Gra,2607,1,20,7,9,68,32,36,67
FC Salzburg,2607,2,19,9,8,60,32,28,66
Vienna,2607,3,20,4,12,65,51,14,64
SC Rheindorf,2607,4,19,7,10,52,42,10,64
Rapid Vienna,2607,5,16,10,10,58,36,22,58
Admira Wacke,2607,6,13,9,14,47,55,-8,48
RZ Pellets W,2607,7,11,7,18,46,63,-17,40
SV Josko Rie,2607,8,11,4,21,33,57,-24,37
Mattersburg,2607,9,8,8,20,38,60,-22,32
St. Pölten,2607,10,7,7,22,37,76,-39,28
FC Salzburg,2608,1,21,6,9,69,34,35,69
SK Sturm Gra,2608,2,18,9,9,56,30,26,63
SC Rheindorf,2608,3,17,10,9,54,47,7,61
Rapid Vienna,2608,4,14,13,9,52,39,13,55
Vienna,2608,5,17,3,16,62,60,2,54
SV Josko Rie,2608,6,13,7,16,44,53,-9,46
RZ Pellets W,2608,7,12,5,19,47,62,-15,41
St. Pölten,2608,8,10,10,16,42,59,-17,40
Admira Wacke,2608,9,11,5,20,44,67,-23,38
Mattersburg,2608,10,8,10,18,37,56,-19,34
SK Sturm Gra,2609,1,19,10,7,55,29,26,67
SC Rheindorf,2609,2,17,11,8,53,36,17,62
FC Salzburg,2609,3,16,12,8,56,31,25,60
Vienna,2609,4,17,7,12,64,51,13,58
RZ Pellets W,2609,5,14,10,12,47,47,0,52
Rapid Vienna,2609,6,13,12,11,52,40,12,51
SV Josko Rie,2609,7,11,6,19,36,54,-18,39
Admira Wacke,2609,8,10,8,18,34,61,-27,38
Mattersburg,2609,9,8,11,17,33,50,-17,35
St. Pölten,2609,10,6,11,19,32,63,-31,29
FC Salzburg,2610,1,23,6,7,66,26,40,75
SK Sturm Gra,2610,2,21,6,9,63,30,33,69
Vienna,2610,3,19,3,14,62,53,9,60
SC Rheindorf,2610,4,17,8,11,52,50,2,59
Rapid Vienna,2610,5,14,13,9,55,39,16,55
SV Josko Rie,2610,6,12,5,19,34,48,-14,41
RZ Pellets W,2610,7,11,7,18,47,63,-16,40
Mattersburg,2610,8,11,7,18,39,57,-18,40
Admira Wacke,2610,9,10,6,20,34,61,-27,36
St. Pölten,2610,10,7,9,20,38,63,-25,30
FC Salzburg,2611,1,21,7,8,64,32,32,70
SK Sturm Gra,2611,2,20,6,10,67,37,30,66
SC Rheindorf,2611,3,18,7,11,51,45,6,61
Rapid Vienna,2611,4,16,11,9,56,36,20,59
Vienna,2611,5,16,7,13,61,50,11,55
Admira Wacke,2611,6,15,6,15,41,52,-11,51
RZ Pellets W,2611,7,13,6,17,41,54,-13,45
SV Josko Rie,2611,8,12,3,21,35,55,-20,39
Mattersburg,2611,9,7,9,20,31,55,-24,30
St. Pölten,2611,10,7,8,21,33,64,-31,29
FC Salzburg,2612,1,21,7,8,68,28,40,70
SK Sturm Gra,2612,2,21,5,10,56,34,22,68
Vienna,2612,3,21,5,10,71,54,17,68
SC Rheindorf,2612,4,17,10,9,51,43,8,61
Rapid Vienna,2612,5,16,11,9,63,33,30,59
RZ Pellets W,2612,6,14,7,15,49,49,0,49
Mattersburg,2612,7,10,7,19,35,57,-22,37
St. Pölten,2612,8,9,8,19,44,72,-28,35
SV Josko Rie,2612,9,9,4,23,33,58,-25,31
Admira Wacke,2612,10,7,6,23,30,72,-42,27
FC Salzburg,2613,1,21,8,7,60,28,32,71
SK Sturm Gra,2613,2,20,6,10,55,29,26,66
SC Rheindorf,2613,3,19,7,10,45,33,12,64
Rapid Vienna,2613,4,16,9,11,53,43,10,57
Vienna,2613,5,16,7,13,62,54,8,55
RZ Pellets W,2613,6,13,6,17,44,52,-8,45
SV Josko Rie,2613,7,12,6,18,43,56,-13,42
St. Pölten,2613,8,9,11,16,42,62,-20,38
Admira Wacke,2613,9,9,6,21,32,60,-28,33
Mattersburg,2613,10,8,8,20,43,62,-19,32
FC Salzburg,2614,1,22,6,8,65,30,35,72
SK Sturm Gra,2614,2,18,9,9,64,37,27,63
Vienna,2614,3,19,4,13,55,50,5,61
SC Rheindorf,2614,4,18,4,14,51,48,3,58
Rapid Vienna,2614,5,15,9,12,61,42,19,54
RZ Pellets W,2614,6,15,5,16,50,54,-4,50
Admira Wacke,2614,7,13,6,17,37,57,-20,45
St. Pölten,2614,8,10,9,17,49,66,-17,39
Mattersburg,2614,9,8,10,18,32,51,-19,34
SV Josko Rie,2614,10,8,6,22,27,56,-29,30
FC Salzburg,2615,1,24,6,6,72,28,44,78
SC Rheindorf,2615,2,19,9,8,58,38,20,66
Rapid Vienna,2615,3,16,9,11,56,37,19,57
SK Sturm Gra,2615,4,16,8,12,48,33,15,56
Vienna,2615,5,17,4,15,57,55,2,55
RZ Pellets W,2615,6,16,7,13,53,53,0,55
Mattersburg,2615,7,9,11,16,45,57,-12,38
SV Josko Rie,2615,8,9,8,19,28,53,-25,35
Admira Wacke,2615,9,8,7,21,30,62,-32,31
St. Pölten,2615,10,7,9,20,37,68,-31,30
FC Salzburg,2616,1,23,8,5,63,21,42,77
SK Sturm Gra,2616,2,19,7,10,58,35,23,64
Vienna,2616,3,18,3,15,63,55,8,57
SC Rheindorf,2616,4,16,8,12,51,47,4,56
Rapid Vienna,2616,5,14,10,12,56,39,17,52
RZ Pellets W,2616,6,13,7,16,45,55,-10,46
Admira Wacke,2616,7,13,7,16,39,59,-20,46
SV Josko Rie,2616,8,12,4,20,37,52,-15,40
Mattersburg,2616,9,8,12,16,34,49,-15,36
St. Pölten,2616,10,7,8,21,39,73,-34,29
SK Sturm Gra,2617,1,18,8,10,70,39,31,62
Vienna,2617,2,19,4,13,64,62,2,61
SC Rheindorf,2617,3,17,9,10,50,41,9,60
FC Salzburg,2617,4,15,10,11,55,39,16,55
Admira Wacke,2617,5,15,6,15,43,54,-11,51
Rapid Vienna,2617,6,13,9,14,53,43,10,48
St. Pölten,2617,7,13,9,14,44,52,-8,48
Mattersburg,2617,8,12,8,16,40,50,-10,44
SV Josko Rie,2617,9,11,5,20,40,59,-19,38
RZ Pellets W,2617,10,9,8,19,45,65,-20,35
SK Sturm Gra,2618,1,23,5,8,69,35,34,74
FC Salzburg,2618,2,19,8,9,56,28,28,65
SC Rheindorf,2618,3,18,7,11,51,48,3,61
Vienna,2618,4,18,4,14,60,51,9,58
Rapid Vienna,2618,5,12,12,12,53,45,8,48
RZ Pellets W,2618,6,13,7,16,43,53,-10,46
St. Pölten,2618,7,11,10,15,52,66,-14,43
SV Josko Rie,2618,8,11,7,18,36,51,-15,40
Admira Wacke,2618,9,8,9,19,35,61,-26,33
Mattersburg,2618,10,7,11,18,40,57,-17,32
FC Salzburg,2619,1,22,6,8,70,31,39,72
SK Sturm Gra,2619,2,21,6,9,69,42,27,69
Vienna,2619,3,21,5,10,70,49,21,68
SC Rheindorf,2619,4,20,5,11,53,44,9,65
Rapid Vienna,2619,5,14,11,11,61,46,15,53
RZ Pellets W,2619,6,11,8,17,44,56,-12,41
Admira Wacke,2619,7,11,7,18,42,66,-24,40
St. Pölten,2619,8,8,12,16,41,63,-22,36
Mattersburg,2619,9,8,6,22,37,61,-24,30
SV Josko Rie,2619,10,8,6,22,34,63,-29,30
SC Rheindorf,2620,1,19,10,7,64,38,26,67
FC Salzburg,2620,2,20,5,11,62,32,30,65
Vienna,2620,3,19,6,11,59,51,8,63
SK Sturm Gra,2620,4,18,5,13,55,40,15,59
Rapid Vienna,2620,5,14,9,13,57,43,14,51
Admira Wacke,2620,6,14,7,15,44,56,-12,49
RZ Pellets W,2620,7,13,9,14,46,53,-7,48
Mattersburg,2620,8,10,7,19,41,61,-20,37
SV Josko Rie,2620,9,10,5,21,31,54,-23,35
St. Pölten,2620,10,6,11,19,38,69,-31,29
FC Salzburg,2621,1,22,6,8,57,28,29,72
SC Rheindorf,2621,2,20,10,6,64,39,25,70
SK Sturm Gra,2621,3,18,9,9,60,37,23,63
Rapid Vienna,2621,4,15,10,11,60,40,20,55
RZ Pellets W,2621,5,15,8,13,49,49,0,53
Vienna,2621,6,15,3,18,52,57,-5,48
SV Josko Rie,2621,7,12,6,18,30,49,-19,42
Admira Wacke,2621,8,12,4,20,36,61,-25,40
Mattersburg,2621,9,8,7,21,35,58,-23,31
St. Pölten,2621,10,7,9,20,38,63,-25,30
FC Salzburg,2622,1,21,10,5,64,27,37,73
SC Rheindorf,2622,2,19,8,9,54,42,12,65
SK Sturm Gra,2622,3,18,6,12,59,39,20,60
Vienna,2622,4,18,6,12,70,56,14,60
Rapid Vienna,2622,5,14,11,11,60,42,18,53
RZ Pellets W,2622,6,12,7,17,44,58,-14,43
St. Pölten,2622,7,11,8,17,42,68,-26,41
Mattersburg,2622,8,10,9,17,38,51,-13,39
Admira Wacke,2622,9,10,5,21,41,69,-28,35
SV Josko Rie,2622,10,8,8,20,36,56,-20,32
FC Salzburg,2623,1,20,7,9,64,30,34,67
SK Sturm Gra,2623,2,20,7,9,63,31,32,67
SC Rheindorf,2623,3,20,7,9,60,43,17,67
Vienna,2623,4,20,4,12,58,47,11,64
RZ Pellets W,2623,5,13,9,14,51,59,-8,48
Rapid Vienna,2623,6,11,13,12,52,47,5,46
SV Josko Rie,2623,7,11,6,19,33,52,-19,39
Admira Wacke,2623,8,11,6,19,41,64,-23,39
Mattersburg,2623,9,8,9,19,37,58,-21,33
St. Pölten,2623,10,6,12,18,35,63,-28,30
SK Sturm Gra,2624,1,22,6,8,58,29,29,72
SC Rheindorf,2624,2,22,6,8,58,37,21,72
FC Salzburg,2624,3,19,5,12,51,32,19,62
Vienna,2624,4,19,4,13,63,50,13,61
Rapid Vienna,2624,5,15,11,10,57,38,19,56
SV Josko Rie,2624,6,12,7,17,33,44,-11,43
RZ Pellets W,2624,7,11,6,19,42,52,-10,39
Mattersburg,2624,8,10,6,20,41,63,-22,36
Admira Wacke,2624,9,10,6,20,34,63,-29,36
St. Pölten,2624,10,7,9,20,34,63,-29,30
FC Salzburg,2625,1,23,7,6,66,26,40,76
SK Sturm Gra,2625,2,21,4,11,60,33,27,67
Vienna,2625,3,21,4,11,64,43,21,67
SC Rheindorf,2625,4,18,8,10,53,41,12,62
Rapid Vienna,2625,5,12,13,11,48,38,10,49
RZ Pellets W,2625,6,13,7,16,43,46,-3,46
St. Pölten,2625,7,10,6,20,39,64,-25,36
SV Josko Rie,2625,8,9,9,18,33,59,-26,36
Mattersburg,2625,9,7,11,18,44,67,-23,32
Admira Wacke,2625,10,8,7,21,30,63,-33,31
FC Salzburg,2626,1,23,7,6,72,29,43,76
SC Rheindorf,2626,2,20,8,8,56,43,13,68
SK Sturm Gra,2626,3,19,8,9,58,32,26,65
Rapid Vienna,2626,4,13,11,12,52,45,7,50
Vienna,2626,5,15,4,17,61,58,3,49
St. Pölten,2626,6,11,11,14,45,55,-10,44
RZ Pellets W,2626,7,12,5,19,44,61,-17,41
Admira Wacke,2626,8,11,8,17,33,54,-21,41
SV Josko Rie,2626,9,9,9,18,36,62,-26,36
Mattersburg,2626,10,7,9,20,38,56,-18,30
SC Rheindorf,2627,1,20,9,7,57,41,16,69
FC Salzburg,2627,2,20,7,9,66,39,27,67
Vienna,2627,3,21,4,11,71,52,19,67
SK Sturm Gra,2627,4,18,7,11,57,40,17,61
Rapid Vienna,2627,5,13,12,11,53,39,14,51
SV Josko Rie,2627,6,11,9,16,39,50,-11,42
RZ Pellets W,2627,7,11,7,18,46,63,-17,40
Admira Wacke,2627,8,11,7,18,38,60,-22,40
St. Pölten,2627,9,8,10,18,42,62,-20,34
Mattersburg,2627,10,6,10,20,36,59,-23,28
FC Salzburg,2628,1,23,6,7,69,27,42,75
SC Rheindorf,2628,2,21,6,9,58,43,15,69
SK Sturm Gra,2628,3,20,5,11,62,34,28,65
Vienna,2628,4,20,4,12,65,51,14,64
Rapid Vienna,2628,5,16,8,12,59,41,18,56
RZ Pellets W,2628,6,13,8,15,48,52,-4,47
SV Josko Rie,2628,7,12,2,22,32,65,-33,38
St. Pölten,2628,8,10,7,19,46,67,-21,37
Admira Wacke,2628,9,8,9,19,33,61,-28,33
Mattersburg,2628,10,7,5,24,29,60,-31,26
SC Rheindorf,2629,1,24,5,7,59,35,24,77
Rapid Vienna,2629,2,18,9,9,69,41,28,63
Vienna,2629,3,19,4,13,73,62,11,61
FC Salzburg,2629,4,17,8,11,56,32,24,59
SK Sturm Gra,2629,5,17,7,12,57,47,10,58
SV Josko Rie,2629,6,14,3,19,46,52,-6,45
Admira Wacke,2629,7,12,8,16,39,54,-15,44
St. Pölten,2629,8,10,9,17,48,68,-20,39
RZ Pellets W,2629,9,10,6,20,46,65,-19,36
Mattersburg,2629,10,6,7,23,29,66,-37,25
FC Salzburg,2630,1,24,7,5,72,29,43,79
SK Sturm Gra,2630,2,22,6,8,65,32,33,72
Vienna,2630,3,18,6,12,65,47,18,60
SC Rheindorf,2630,4,18,6,12,51,47,4,60
Rapid Vienna,2630,5,14,11,11,55,39,16,53
RZ Pellets W,2630,6,12,7,17,46,63,-17,43
Admira Wacke,2630,7,10,7,19,35,61,-26,37
SV Josko Rie,2630,8,9,9,18,29,47,-18,36
Mattersburg,2630,9,8,10,18,35,55,-20,34
St. Pölten,2630,10,6,9,21,38,71,-33,27
SC Rheindorf,2631,1,21,7,8,68,42,26,70
FC Salzburg,2631,2,21,5,10,63,32,31,68
SK Sturm Gra,2631,3,20,6,10,61,39,22,66
Vienna,2631,4,16,6,14,56,56,0,54
RZ Pellets W,2631,5,15,6,15,51,52,-1,51
SV Josko Rie,2631,6,14,7,15,44,48,-4,49
Rapid Vienna,2631,7,13,9,14,50,45,5,48
Admira Wacke,2631,8,10,5,21,37,67,-30,35
St. Pölten,2631,9,7,12,17,42,66,-24,33
Mattersburg,2631,10,6,11,19,33,58,-25,29
FC Salzburg,2632,1,23,7,6,69,34,35,76
SK Sturm Gra,2632,2,22,5,9,68,33,35,71
Vienna,2632,3,20,3,13,73,64,9,63
Rapid Vienna,2632,4,16,9,11,51,36,15,57
SC Rheindorf,2632,5,16,8,12,49,47,2,56
RZ Pellets W,2632,6,15,6,15,51,49,2,51
SV Josko Rie,2632,7,12,3,21,34,56,-22,39
Admira Wacke,2632,8,11,6,19,40,64,-24,39
Mattersburg,2632,9,7,9,20,30,56,-26,30
St. Pölten,2632,10,7,6,23,40,66,-26,27
FC Salzburg,2633,1,20,8,8,65,32,33,68
Vienna,2633,2,20,5,11,72,55,17,65
SC Rheindorf,2633,3,18,6,12,51,45,6,60
SK Sturm Gra,2633,4,14,13,9,57,40,17,55
Rapid Vienna,2633,5,14,10,12,54,44,10,52
RZ Pellets W,2633,6,14,6,16,49,58,-9,48
St. Pölten,2633,7,10,12,14,50,59,-9,42
Admira Wacke,2633,8,10,9,17,38,61,-23,39
SV Josko Rie,2633,9,10,6,20,43,63,-20,36
Mattersburg,2633,10,9,7,20,33,55,-22,34
SC Rheindorf,2634,1,21,10,5,64,39,25,73
FC Salzburg,2634,2,20,8,8,63,32,31,68
Vienna,2634,3,18,9,9,67,54,13,63
Rapid Vienna,2634,4,16,12,8,60,33,27,60
SK Sturm Gra,2634,5,16,6,14,54,40,14,54
RZ Pellets W,2634,6,11,7,18,42,58,-16,40
St. Pölten,2634,7,9,11,16,36,54,-18,38
Admira Wacke,2634,8,10,7,19,40,70,-30,37
SV Josko Rie,2634,9,10,5,21,35,57,-22,35
Mattersburg,2634,10,6,11,19,30,54,-24,29
FC Salzburg,2635,1,21,9,6,67,28,39,72
SK Sturm Gra,2635,2,20,8,8,61,32,29,68
SC Rheindorf,2635,3,20,7,9,51,42,9,67
Vienna,2635,4,19,4,13,63,60,3,61
Rapid Vienna,2635,5,14,12,10,55,36,19,54
RZ Pellets W,2635,6,13,7,16,43,49,-6,46
Mattersburg,2635,7,11,8,17,45,53,-8,41
SV Josko Rie,2635,8,10,5,21,33,54,-21,35
Admira Wacke,2635,9,9,5,22,29,60,-31,32
St. Pölten,2635,10,7,7,22,36,69,-33,28
SC Rheindorf,2636,1,21,5,10,53,41,12,68
FC Salzburg,2636,2,20,7,9,63,33,30,67
SK Sturm Gra,2636,3,20,7,9,58,28,30,67
Vienna,2636,4,18,4,14,61,55,6,58
SV Josko Rie,2636,5,15,4,17,37,47,-10,49
Rapid Vienna,2636,6,11,13,12,47,38,9,46
RZ Pellets W,2636,7,12,10,14,45,50,-5,46
Admira Wacke,2636,8,11,9,16,41,57,-16,42
Mattersburg,2636,9,7,10,19,33,61,-28,31
St. Pölten,2636,10,6,9,21,36,64,-28,27
FC Salzburg,2637,1,24,5,7,76,36,40,77
SC Rheindorf,2637,2,19,10,7,64,44,20,67
SK Sturm Gra,2637,3,17,9,10,56,38,18,60
Vienna,2637,4,18,5,13,62,55,7,59
Rapid Vienna,2637,5,13,12,11,56,40,16,51
RZ Pellets W,2637,6,14,9,13,51,52,-1,51
Admira Wacke,2637,7,10,7,19,34,63,-29,37
St. Pölten,2637,8,8,11,17,37,60,-23,35
Mattersburg,2637,9,7,10,19,38,60,-22,31
SV Josko Rie,2637,10,8,6,22,34,60,-26,30
FC Salzburg,2638,1,23,6,7,64,30,34,75
SC Rheindorf,2638,2,21,6,9,58,43,15,69
Vienna,2638,3,21,5,10,66,49,17,68
SK Sturm Gra,2638,4,21,4,11,58,33,25,67
Rapid Vienna,2638,5,13,9,14,52,41,11,48
RZ Pellets W,2638,6,11,9,16,41,52,-11,42
Admira Wacke,2638,7,10,6,20,34,60,-26,36
SV Josko Rie,2638,8,10,5,21,33,54,-21,35
St. Pölten,2638,9,8,10,18,39,62,-23,34
Mattersburg,2638,10,8,8,20,34,55,-21,32
FC Salzburg,2639,1,22,7,7,61,27,34,73
Vienna,2639,2,22,5,9,73,43,30,71
SC Rheindorf,2639,3,20,6,10,57,40,17,66
SK Sturm Gra,2639,4,19,7,10,60,38,22,64
Rapid Vienna,2639,5,12,11,13,53,47,6,47
St. Pölten,2639,6,11,9,16,44,61,-17,42
RZ Pellets W,2639,7,11,8,17,45,61,-16,41
SV Josko Rie,2639,8,10,7,19,41,49,-8,37
Admira Wacke,2639,9,9,5,22,29,70,-41,32
Mattersburg,2639,10,7,9,20,35,62,-27,30
FC Salzburg,2640,1,23,6,7,64,29,35,75
Vienna,2640,2,20,4,12,65,48,17,64
SK Sturm Gra,2640,3,19,6,11,55,31,24,63
SC Rheindorf,2640,4,18,7,11,51,42,9,61
Rapid Vienna,2640,5,12,11,13,45,40,5,47
Admira Wacke,2640,6,12,8,16,33,53,-20,44
RZ Pellets W,2640,7,11,10,15,41,52,-11,43
St. Pölten,2640,8,9,10,17,40,63,-23,37
Mattersburg,2640,9,8,12,16,35,53,-18,36
SV Josko Rie,2640,10,9,4,23,32,50,-18,31
FC Salzburg,2641,1,23,7,6,69,29,40,76
SC Rheindorf,2641,2,21,5,10,54,41,13,68
SK Sturm Gra,2641,3,18,11,7,59,31,28,65
Rapid Vienna,2641,4,16,11,9,56,37,19,59
Vienna,2641,5,15,5,16,56,56,0,50
RZ Pellets W,2641,6,14,8,14,50,50,0,50
Admira Wacke,2641,7,12,5,19,40,61,-21,41
SV Josko Rie,2641,8,11,4,21,35,56,-21,37
St. Pölten,2641,9,8,9,19,43,69,-26,33
Mattersburg,2641,10,7,5,24,32,64,-32,26
FC Salzburg,2642,1,23,8,5,76,28,48,77
SK Sturm Gra,2642,2,20,7,9,64,33,31,67
SC Rheindorf,2642,3,19,9,8,54,38,16,66
Vienna,2642,4,16,7,13,62,60,2,55
Rapid Vienna,2642,5,13,11,12,52,39,13,50
RZ Pellets W,2642,6,12,8,16,43,56,-13,44
Admira Wacke,2642,7,10,7,19,30,52,-22,37
St. Pölten,2642,8,9,9,18,37,56,-19,36
SV Josko Rie,2642,9,10,6,20,32,54,-22,36
Mattersburg,2642,10,8,8,20,34,68,-34,32
FC Salzburg,2643,1,24,4,8,71,31,40,76
SK Sturm Gra,2643,2,20,7,9,65,34,31,67
SC Rheindorf,2643,3,20,7,9,52,45,7,67
Vienna,2643,4,19,7,10,63,47,16,64
Rapid Vienna,2643,5,15,11,10,61,44,17,56
Admira Wacke,2643,6,11,7,18,38,60,-22,40
St. Pölten,2643,7,10,8,18,43,60,-17,38
RZ Pellets W,2643,8,10,7,19,41,59,-18,37
SV Josko Rie,2643,9,9,4,23,37,64,-27,31
Mattersburg,2643,10,7,8,21,42,69,-27,29
FC Salzburg,2644,1,22,5,9,69,29,40,71
SK Sturm Gra,2644,2,21,5,10,63,35,28,68
Vienna,2644,3,18,6,12,66,52,14,60
SC Rheindorf,2644,4,16,9,11,50,49,1,57
Rapid Vienna,2644,5,13,11,12,55,36,19,50
RZ Pellets W,2644,6,12,8,16,43,57,-14,44
Admira Wacke,2644,7,13,4,19,40,67,-27,43
SV Josko Rie,2644,8,12,5,19,38,52,-14,41
Mattersburg,2644,9,9,10,17,43,65,-22,37
St. Pölten,2644,10,8,9,19,42,67,-25,33
FC Salzburg,2645,1,20,7,9,60,29,31,67
SK Sturm Gra,2645,2,19,8,9,61,35,26,65
SC Rheindorf,2645,3,18,8,10,60,44,16,62
Vienna,2645,4,17,6,13,60,48,12,57
Admira Wacke,2645,5,16,5,15,46,57,-11,53
Rapid Vienna,2645,6,13,9,14,52,43,9,48
RZ Pellets W,2645,7,13,9,14,49,57,-8,48
Mattersburg,2645,8,10,7,19,37,56,-19,37
SV Josko Rie,2645,9,9,7,20,33,54,-21,34
St. Pölten,2645,10,6,12,18,33,68,-35,30
FC Salzburg,2646,1,22,7,7,69,28,41,73
SC Rheindorf,2646,2,22,5,9,59,40,19,71
SK Sturm Gra,2646,3,19,7,10,65,36,29,64
Vienna,2646,4,16,5,15,55,56,-1,53
Rapid Vienna,2646,5,14,9,13,56,40,16,51
RZ Pellets W,2646,6,14,8,14,47,51,-4,50
Mattersburg,2646,7,12,7,17,45,55,-10,43
Admira Wacke,2646,8,11,5,20,33,67,-34,38
St. Pölten,2646,9,8,10,18,35,60,-25,34
SV Josko Rie,2646,10,8,5,23,30,61,-31,29
FC Salzburg,2647,1,22,7,7,62,26,36,73
SK Sturm Gra,2647,2,20,5,11,61,38,23,65
Vienna,2647,3,17,9,10,62,48,14,60
SC Rheindorf,2647,4,17,7,12,53,48,5,58
Rapid Vienna,2647,5,13,10,13,54,41,13,49
RZ Pellets W,2647,6,14,6,16,45,57,-12,48
SV Josko Rie,2647,7,13,5,18,46,57,-11,44
Admira Wacke,2647,8,11,5,20,37,60,-23,38
St. Pölten,2647,9,7,13,16,42,64,-22,34
Mattersburg,2647,10,7,11,18,36,59,-23,32
SK Sturm Gra,2648,1,24,4,8,66,28,38,76
SC Rheindorf,2648,2,20,8,8,51,36,15,68
FC Salzburg,2648,3,17,12,7,63,30,33,63
Vienna,2648,4,16,7,13,57,56,1,55
Rapid Vienna,2648,5,13,11,12,54,39,15,50
Admira Wacke,2648,6,12,7,17,37,54,-17,43
SV Josko Rie,2648,7,12,6,18,39,53,-14,42
RZ Pellets W,2648,8,11,6,19,39,58,-19,39
Mattersburg,2648,9,9,10,17,44,57,-13,37
St. Pölten,2648,10,7,7,22,34,73,-39,28
FC Salzburg,2649,1,22,10,4,70,32,38,76
SC Rheindorf,2649,2,22,6,8,63,44,19,72
SK Sturm Gra,2649,3,18,6,12,58,40,18,60
Vienna,2649,4,17,6,13,63,59,4,57
Rapid Vienna,2649,5,15,9,12,58,40,18,54
SV Josko Rie,2649,6,13,5,18,40,54,-14,44
Admira Wacke,2649,7,12,7,17,36,52,-16,43
Mattersburg,2649,8,9,9,18,44,57,-13,36
RZ Pellets W,2649,9,10,5,21,43,63,-20,35
St. Pölten,2649,10,6,9,21,40,74,-34,27
SK Sturm Gra,2650,1,20,8,8,60,31,29,68
FC Salzburg,2650,2,17,10,9,62,35,27,61
Vienna,2650,3,18,6,12,64,54,10,60
SC Rheindorf,2650,4,15,11,10,48,45,3,56
Rapid Vienna,2650,5,13,11,12,58,41,17,50
RZ Pellets W,2650,6,14,7,15,51,54,-3,49
Mattersburg,2650,7,10,11,15,40,52,-12,41
Admira Wacke,2650,8,11,6,19,38,62,-24,39
SV Josko Rie,2650,9,10,7,19,38,60,-22,37
St. Pölten,2650,10,8,11,17,40,65,-25,35
SK Sturm Gra,2651,1,20,7,9,59,34,25,67
SC Rheindorf,2651,2,19,6,11,64,47,17,63
Vienna,2651,3,19,4,13,58,52,6,61
FC Salzburg,2651,4,17,9,10,57,37,20,60
Rapid Vienna,2651,5,14,12,10,53,42,11,54
RZ Pellets W,2651,6,13,9,14,49,49,0,48
SV Josko Rie,2651,7,14,5,17,44,53,-9,47
Mattersburg,2651,8,9,10,17,42,61,-19,37
Admira Wacke,2651,9,9,6,21,33,63,-30,33
St. Pölten,2651,10,7,10,19,45,66,-21,31
SC Rheindorf,2652,1,22,8,6,60,33,27,74
FC Salzburg,2652,2,20,9,7,65,33,32,69
Vienna,2652,3,19,6,11,64,54,10,63
SK Sturm Gra,2652,4,18,7,11,51,31,20,61
Rapid Vienna,2652,5,13,11,12,57,46,11,50
RZ Pellets W,2652,6,12,9,15,52,58,-6,45
SV Josko Rie,2652,7,10,8,18,32,52,-20,38
St. Pölten,2652,8,8,11,17,47,66,-19,35
Admira Wacke,2652,9,9,5,22,28,58,-30,32
Mattersburg,2652,10,7,10,19,33,58,-25,31
FC Salzburg,2653,1,22,8,6,70,30,40,74
SC Rheindorf,2653,2,19,7,10,55,42,13,64
Vienna,2653,3,19,6,11,66,56,10,63
SK Sturm Gra,2653,4,19,5,12,63,40,23,62
Rapid Vienna,2653,5,13,12,11,58,42,16,51
Admira Wacke,2653,6,12,9,15,38,58,-20,45
RZ Pellets W,2653,7,12,7,17,46,61,-15,43
SV Josko Rie,2653,8,10,5,21,39,56,-17,35
St. Pölten,2653,9,8,11,17,40,60,-20,35
Mattersburg,2653,10,7,8,21,34,64,-30,29
FC Salzburg,2654,1,23,8,5,74,30,44,77
SK Sturm Gra,2654,2,21,6,9,58,32,26,69
SC Rheindorf,2654,3,18,12,6,58,39,19,66
Rapid Vienna,2654,4,14,13,9,63,41,22,55
Vienna,2654,5,16,5,15,59,56,3,53
RZ Pellets W,2654,6,12,8,16,47,54,-7,44
Admira Wacke,2654,7,12,8,16,37,56,-19,44
SV Josko Rie,2654,8,9,7,20,33,58,-25,34
Mattersburg,2654,9,7,10,19,40,61,-21,31
St. Pölten,2654,10,5,9,22,31,73,-42,24
FC Salzburg,2655,1,20,10,6,69,32,37,70
SC Rheindorf,2655,2,20,9,7,60,45,15,69
RZ Pellets W,2655,3,19,5,12,57,47,10,62
SK Sturm Gra,2655,4,18,5,13,52,39,13,59
Vienna,2655,5,18,5,13,64,53,11,59
Rapid Vienna,2655,6,13,10,13,51,45,6,49
Mattersburg,2655,7,9,9,18,32,48,-16,36
Admira Wacke,2655,8,10,6,20,44,68,-24,36
SV Josko Rie,2655,9,9,8,19,42,60,-18,35
St. Pölten,2655,10,6,9,21,37,71,-34,27
FC Salzburg,2656,1,21,9,6,66,29,37,72
SC Rheindorf,2656,2,21,5,10,54,45,9,68
Vienna,2656,3,18,7,11,63,49,14,61
SK Sturm Gra,2656,4,18,6,12,58,33,25,60
Rapid Vienna,2656,5,16,8,12,54,39,15,56
Admira Wacke,2656,6,13,6,17,42,58,-16,45
SV Josko Rie,2656,7,13,4,19,39,54,-15,43
RZ Pellets W,2656,8,12,6,18,41,58,-17,42
St. Pölten,2656,9,9,7,20,39,65,-26,34
Mattersburg,2656,10,5,10,21,31,57,-26,25
FC Salzburg,2657,1,21,8,7,70,34,36,71
Vienna,2657,2,22,4,10,62,45,17,70
SK Sturm Gra,2657,3,21,5,10,60,32,28,68
SC Rheindorf,2657,4,20,7,9,56,41,15,67
Rapid Vienna,2657,5,12,12,12,54,43,11,48
RZ Pellets W,2657,6,14,6,16,53,57,-4,48
Admira Wacke,2657,7,11,7,18,42,66,-24,40
SV Josko Rie,2657,8,11,5,20,36,61,-25,38
Mattersburg,2657,9,8,8,20,36,57,-21,32
St. Pölten,2657,10,5,8,23,32,65,-33,23
SC Rheindorf,2658,1,20,5,11,51,42,9,65
SK Sturm Gra,2658,2,19,5,12,56,35,21,62
FC Salzburg,2658,3,18,7,11,60,39,21,61
Vienna,2658,4,19,4,13,66,49,17,61
Rapid Vienna,2658,5,14,13,9,60,42,18,55
RZ Pellets W,2658,6,12,9,15,42,51,-9,45
Admira Wacke,2658,7,13,4,19,39,64,-25,43
SV Josko Rie,2658,8,12,6,18,33,47,-14,42
Mattersburg,2658,9,10,7,19,41,57,-16,37
St. Pölten,2658,10,7,12,17,40,62,-22,33
SC Rheindorf,2659,1,19,9,8,52,38,14,66
Vienna,2659,2,20,5,11,69,50,19,65
FC Salzburg,2659,3,19,7,10,65,32,33,64
SK Sturm Gra,2659,4,17,9,10,56,34,22,60
Rapid Vienna,2659,5,15,10,11,60,38,22,55
RZ Pellets W,2659,6,14,7,15,43,55,-12,49
St. Pölten,2659,7,9,10,17,43,59,-16,37
SV Josko Rie,2659,8,10,6,20,33,55,-22,36
Mattersburg,2659,9,8,11,17,34,54,-20,35
Admira Wacke,2659,10,9,6,21,29,69,-40,33
FC Salzburg,2660,1,22,6,8,63,30,33,72
SK Sturm Gra,2660,2,20,8,8,60,35,25,68
SC Rheindorf,2660,3,19,9,8,52,39,13,66
Vienna,2660,4,19,4,13,72,55,17,61
Rapid Vienna,2660,5,13,12,11,54,39,15,51
RZ Pellets W,2660,6,11,7,18,43,55,-12,40
Admira Wacke,2660,7,10,9,17,38,59,-21,39
Mattersburg,2660,8,9,8,19,40,59,-19,35
SV Josko Rie,2660,9,9,8,19,34,58,-24,35
St. Pölten,2660,10,8,9,19,36,63,-27,33
FC Salzburg,2661,1,23,8,5,82,31,51,77
SC Rheindorf,2661,2,19,8,9,52,45,7,65
SK Sturm Gra,2661,3,18,5,13,60,39,21,59
Vienna,2661,4,16,7,13,61,55,6,55
Rapid Vienna,2661,5,13,13,10,52,44,8,52
RZ Pellets W,2661,6,15,6,15,56,57,-1,51
Admira Wacke,2661,7,12,5,19,45,63,-18,41
Mattersburg,2661,8,9,8,19,34,53,-19,35
St. Pölten,2661,9,8,10,18,44,68,-24,34
SV Josko Rie,2661,10,8,8,20,30,61,-31,32
Vienna,2662,1,21,4,11,69,47,22,67
FC Salzburg,2662,2,18,9,9,59,31,28,63
SK Sturm Gra,2662,3,18,8,10,53,32,21,62
Rapid Vienna,2662,4,15,10,11,52,38,14,55
SC Rheindorf,2662,5,16,7,13,42,42,0,55
RZ Pellets W,2662,6,12,8,16,49,54,-5,44
Mattersburg,2662,7,11,9,16,40,53,-13,42
Admira Wacke,2662,8,12,5,19,39,67,-28,41
SV Josko Rie,2662,9,10,7,19,35,55,-20,37
St. Pölten,2662,10,9,9,18,38,57,-19,36
FC Salzburg,2663,1,22,5,9,62,29,33,71
SC Rheindorf,2663,2,22,5,9,57,37,20,71
SK Sturm Gra,2663,3,18,7,11,54,32,22,61
Vienna,2663,4,18,4,14,65,57,8,58
Rapid Vienna,2663,5,16,8,12,59,43,16,56
St. Pölten,2663,6,11,11,14,53,65,-12,44
RZ Pellets W,2663,7,12,6,18,44,58,-14,42
Admira Wacke,2663,8,12,4,20,41,65,-24,40
SV Josko Rie,2663,9,12,3,21,33,57,-24,39
Mattersburg,2663,10,7,7,22,32,57,-25,28
FC Salzburg,2664,1,22,7,7,71,30,41,73
SC Rheindorf,2664,2,20,10,6,53,37,16,70
Rapid Vienna,2664,3,17,11,8,62,38,24,62
Vienna,2664,4,18,7,11,63,55,8,61
SK Sturm Gra,2664,5,16,7,13,60,42,18,55
RZ Pellets W,2664,6,14,7,15,56,59,-3,49
Admira Wacke,2664,7,9,9,18,33,60,-27,36
SV Josko Rie,2664,8,9,7,20,32,52,-20,34
Mattersburg,2664,9,8,7,21,35,62,-27,31
St. Pölten,2664,10,7,8,21,35,65,-30,29
SC Rheindorf,2665,1,23,5,8,66,45,21,74
SK Sturm Gra,2665,2,21,4,11,57,30,27,67
FC Salzburg,2665,3,19,7,10,64,31,33,64
Vienna,2665,4,19,7,10,63,47,16,64
Rapid Vienna,2665,5,16,8,12,52,40,12,56
RZ Pellets W,2665,6,11,9,16,43,58,-15,42
Admira Wacke,2665,7,12,4,20,35,58,-23,40
SV Josko Rie,2665,8,11,4,21,32,56,-24,37
St. Pölten,2665,9,9,8,19,42,70,-28,35
Mattersburg,2665,10,6,10,20,36,55,-19,28
FC Salzburg,2666,1,23,7,6,72,33,39,76
SC Rheindorf,2666,2,21,6,9,62,41,21,69
Vienna,2666,3,19,6,11,60,48,12,63
SK Sturm Gra,2666,4,17,9,10,57,39,18,60
Rapid Vienna,2666,5,13,12,11,53,41,12,51
RZ Pellets W,2666,6,12,9,15,49,54,-5,45
Admira Wacke,2666,7,12,6,18,32,55,-23,42
SV Josko Rie,2666,8,10,4,22,33,57,-24,34
St. Pölten,2666,9,8,8,20,41,67,-26,32
Mattersburg,2666,10,7,9,20,41,65,-24,30
SC Rheindorf,2667,1,22,4,10,57,43,14,70
FC Salzburg,2667,2,21,6,9,65,34,31,69
Vienna,2667,3,19,7,10,68,50,18,64
SK Sturm Gra,2667,4,16,7,13,53,41,12,55
Rapid Vienna,2667,5,12,12,12,51,43,8,48
RZ Pellets W,2667,6,14,6,16,41,49,-8,48
Mattersburg,2667,7,10,9,17,42,55,-13,39
St. Pölten,2667,8,10,9,17,43,59,-16,39
SV Josko Rie,2667,9,11,4,21,32,55,-23,37
Admira Wacke,2667,10,9,8,19,35,58,-23,35
FC Salzburg,2668,1,20,8,8,60,29,31,68
Vienna,2668,2,21,4,11,63,40,23,67
SK Sturm Gra,2668,3,19,8,9,60,36,24,65
SC Rheindorf,2668,4,18,8,10,53,42,11,62
Rapid Vienna,2668,5,13,13,10,52,37,15,52
RZ Pellets W,2668,6,13,7,16,43,56,-13,46
Admira Wacke,2668,7,13,6,17,33,54,-21,45
SV Josko Rie,2668,8,11,4,21,35,52,-17,37
Mattersburg,2668,9,7,9,20,36,61,-25,30
St. Pölten,2668,10,6,11,19,39,67,-28,29
FC Salzburg,2669,1,22,6,8,64,29,35,72
SK Sturm Gra,2669,2,21,5,10,63,41,22,68
SC Rheindorf,2669,3,18,8,10,52,44,8,62
Vienna,2669,4,16,5,15,61,56,5,53
Admira Wacke,2669,5,14,7,15,37,48,-11,49
Rapid Vienna,2669,6,11,14,11,54,40,14,47
SV Josko Rie,2669,7,11,6,19,35,53,-18,39
RZ Pellets W,2669,8,11,6,19,36,55,-19,39
St. Pölten,2669,9,8,13,15,41,58,-17,37
Mattersburg,2669,10,8,10,18,36,55,-19,34
FC Salzburg,2670,1,24,4,8,65,32,33,76
SC Rheindorf,2670,2,19,9,8,53,41,12,66
Vienna,2670,3,19,5,12,65,48,17,62
SK Sturm Gra,2670,4,17,6,13,57,35,22,57
RZ Pellets W,2670,5,15,6,15,45,48,-3,51
Rapid Vienna,2670,6,13,9,14,52,42,10,48
Admira Wacke,2670,7,11,6,19,32,61,-29,39
St. Pölten,2670,8,9,10,17,46,67,-21,37
SV Josko Rie,2670,9,10,6,20,32,51,-19,36
Mattersburg,2670,10,8,9,19,36,58,-22,33
FC Salzburg,2671,1,23,6,7,75,28,47,75
SK Sturm Gra,2671,2,20,6,10,58,32,26,66
Vienna,2671,3,18,7,11,69,52,17,61
SC Rheindorf,2671,4,17,10,9,55,46,9,61
Rapid Vienna,2671,5,12,10,14,52,48,4,46
Admira Wacke,2671,6,12,7,17,36,61,-25,43
Mattersburg,2671,7,10,10,16,36,55,-19,40
RZ Pellets W,2671,8,9,10,17,42,61,-19,37
SV Josko Rie,2671,9,10,6,20,35,55,-20,36
St. Pölten,2671,10,8,10,18,35,55,-20,34
FC Salzburg,2672,1,21,9,6,73,27,46,72
SC Rheindorf,2672,2,20,8,8,59,41,18,68
SK Sturm Gra,2672,3,20,5,11,62,38,24,65
Vienna,2672,4,20,4,12,67,59,8,64
Rapid Vienna,2672,5,14,7,15,56,50,6,49
RZ Pellets W,2672,6,13,7,16,48,56,-8,46
SV Josko Rie,2672,7,11,6,19,40,56,-16,39
Admira Wacke,2672,8,11,6,19,37,67,-30,39
St. Pölten,2672,9,8,8,20,46,66,-20,32
Mattersburg,2672,10,8,8,20,32,60,-28,32
SK Sturm Gra,2673,1,22,4,10,69,42,27,70
FC Salzburg,2673,2,20,8,8,67,33,34,68
SC Rheindorf,2673,3,20,6,10,57,43,14,66
Rapid Vienna,2673,4,16,9,11,57,40,17,57
RZ Pellets W,2673,5,16,8,12,46,44,2,56
Vienna,2673,6,17,2,17,67,57,10,53
Admira Wacke,2673,7,12,6,18,34,57,-23,42
SV Josko Rie,2673,8,11,6,19,35,52,-17,39
St. Pölten,2673,9,7,8,21,38,78,-40,29
Mattersburg,2673,10,7,7,22,38,62,-24,28
FC Salzburg,2674,1,21,6,9,64,33,31,69
SC Rheindorf,2674,2,21,6,9,58,42,16,69
Vienna,2674,3,21,4,11,68,50,18,67
SK Sturm Gra,2674,4,17,6,13,55,40,15,57
Rapid Vienna,2674,5,16,8,12,58,42,16,56
RZ Pellets W,2674,6,12,6,18,44,61,-17,42
St. Pölten,2674,7,10,9,17,39,57,-18,39
Admira Wacke,2674,8,11,6,19,34,52,-18,39
SV Josko Rie,2674,9,11,4,21,34,55,-21,37
Mattersburg,2674,10,7,11,18,37,59,-22,32
SC Rheindorf,2675,1,21,6,9,62,43,19,69
FC Salzburg,2675,2,19,10,7,64,35,29,67
Vienna,2675,3,18,8,10,61,41,20,62
SK Sturm Gra,2675,4,18,5,13,57,41,16,59
RZ Pellets W,2675,5,13,9,14,49,55,-6,48
Rapid Vienna,2675,6,12,11,13,55,47,8,47
Admira Wacke,2675,7,12,7,17,41,57,-16,43
St. Pölten,2675,8,8,12,16,38,64,-26,36
SV Josko Rie,2675,9,9,7,20,30,52,-22,34
Mattersburg,2675,10,8,9,19,34,56,-22,33
FC Salzburg,2676,1,21,5,10,70,32,38,68
SK Sturm Gra,2676,2,21,5,10,65,38,27,68
Vienna,2676,3,19,5,12,70,48,22,62
SC Rheindorf,2676,4,18,8,10,51,49,2,62
Rapid Vienna,2676,5,11,13,12,55,50,5,46
RZ Pellets W,2676,6,11,9,16,44,54,-10,42
Mattersburg,2676,7,10,11,15,43,55,-12,41
St. Pölten,2676,8,9,11,16,43,62,-19,38
SV Josko Rie,2676,9,10,7,19,31,53,-22,37
Admira Wacke,2676,10,10,6,20,38,69,-31,36
SC Rheindorf,2677,1,20,9,7,56,38,18,69
FC Salzburg,2677,2,20,7,9,66,32,34,67
Vienna,2677,3,20,3,13,62,50,12,63
SK Sturm Gra,2677,4,18,6,12,51,35,16,60
Rapid Vienna,2677,5,14,13,9,55,40,15,55
Admira Wacke,2677,6,15,6,15,44,55,-11,51
Mattersburg,2677,7,9,11,16,35,51,-16,38
St. Pölten,2677,8,8,9,19,37,59,-22,33
RZ Pellets W,2677,9,8,9,19,36,58,-22,33
SV Josko Rie,2677,10,9,5,22,30,54,-24,32
SK Sturm Gra,2678,1,23,3,10,65,33,32,72
FC Salzburg,2678,2,20,8,8,65,32,33,68
SC Rheindorf,2678,3,21,4,11,53,40,13,67
Rapid Vienna,2678,4,18,9,9,62,36,26,63
Vienna,2678,5,19,5,12,62,52,10,62
RZ Pellets W,2678,6,11,5,20,42,58,-16,38
Admira Wacke,2678,7,10,7,19,33,63,-30,37
Mattersburg,2678,8,9,9,18,41,59,-18,36
St. Pölten,2678,9,6,13,17,42,67,-25,31
SV Josko Rie,2678,10,8,7,21,29,54,-25,31
SC Rheindorf,2679,1,20,8,8,60,42,18,68
FC Salzburg,2679,2,18,11,7,62,32,30,65
Vienna,2679,3,19,5,12,72,55,17,62
SK Sturm Gra,2679,4,18,6,12,54,35,19,60
Rapid Vienna,2679,5,16,10,10,60,34,26,58
Admira Wacke,2679,6,13,5,18,39,56,-17,44
RZ Pellets W,2679,7,12,6,18,38,61,-23,42
St. Pölten,2679,8,9,11,16,45,64,-19,38
SV Josko Rie,2679,9,9,6,21,30,52,-22,33
Mattersburg,2679,10,7,10,19,32,61,-29,31
FC Salzburg,2680,1,22,9,5,62,26,36,75
SC Rheindorf,2680,2,18,10,8,53,42,11,64
Vienna,2680,3,19,4,13,64,51,13,61
SK Sturm Gra,2680,4,17,5,14,54,41,13,56
Rapid Vienna,2680,5,13,12,11,55,35,20,51
RZ Pellets W,2680,6,12,10,14,43,50,-7,46
Admira Wacke,2680,7,11,8,17,36,56,-20,41
SV Josko Rie,2680,8,10,8,18,26,43,-17,38
Mattersburg,2680,9,7,12,17,31,54,-23,33
St. Pölten,2680,10,7,10,19,47,73,-26,31
FC Salzburg,2681,1,23,8,5,75,31,44,77
SC Rheindorf,2681,2,19,9,8,56,43,13,66
SK Sturm Gra,2681,3,18,8,10,61,38,23,62
Rapid Vienna,2681,4,16,11,9,68,43,25,59
Vienna,2681,5,17,8,11,62,52,10,59
RZ Pellets W,2681,6,12,8,16,48,59,-11,44
SV Josko Rie,2681,7,10,5,21,36,59,-23,35
Admira Wacke,2681,8,10,5,21,31,63,-32,35
St. Pölten,2681,9,7,11,18,42,65,-23,32
Mattersburg,2681,10,7,9,20,39,65,-26,30
FC Salzburg,2682,1,20,9,7,64,32,32,69
SK Sturm Gra,2682,2,19,9,8,60,31,29,66
SC Rheindorf,2682,3,18,5,13,51,43,8,59
Vienna,2682,4,16,7,13,54,50,4,55
Rapid Vienna,2682,5,13,14,9,56,42,14,53
Admira Wacke,2682,6,13,7,16,39,57,-18,46
SV Josko Rie,2682,7,12,7,17,36,50,-14,43
RZ Pellets W,2682,8,12,5,19,49,60,-11,41
Mattersburg,2682,9,9,9,18,39,55,-16,36
St. Pölten,2682,10,7,10,19,37,65,-28,31
FC Salzburg,2683,1,23,7,6,72,25,47,76
SC Rheindorf,2683,2,19,6,11,56,48,8,63
Rapid Vienna,2683,3,16,11,9,59,35,24,59
SK Sturm Gra,2683,4,18,5,13,57,36,21,59
Vienna,2683,5,17,5,14,57,58,-1,56
RZ Pellets W,2683,6,12,8,16,41,54,-13,44
St. Pölten,2683,7,11,8,17,48,61,-13,41
Mattersburg,2683,8,11,7,18,38,56,-18,40
SV Josko Rie,2683,9,10,6,20,36,59,-23,36
Admira Wacke,2683,10,8,7,21,36,68,-32,31
FC Salzburg,2684,1,22,6,8,66,31,35,72
SC Rheindorf,2684,2,20,8,8,54,36,18,68
Vienna,2684,3,19,6,11,61,46,15,63
SK Sturm Gra,2684,4,17,6,13,53,36,17,57
Admira Wacke,2684,5,15,6,15,46,56,-10,51
Rapid Vienna,2684,6,12,14,10,58,43,15,50
RZ Pellets W,2684,7,11,7,18,49,68,-19,40
SV Josko Rie,2684,8,10,5,21,33,57,-24,35
Mattersburg,2684,9,8,10,18,37,59,-22,34
St. Pölten,2684,10,6,12,18,36,61,-25,30
FC Salzburg,2685,1,20,10,6,74,36,38,70
SC Rheindorf,2685,2,21,6,9,58,39,19,69
SK Sturm Gra,2685,3,20,5,11,59,34,25,65
Vienna,2685,4,17,6,13,60,56,4,57
Rapid Vienna,2685,5,14,13,9,65,45,20,55
RZ Pellets W,2685,6,15,7,14,53,54,-1,52
Mattersburg,2685,7,10,6,20,37,62,-25,36
SV Josko Rie,2685,8,10,4,22,39,60,-21,34
St. Pölten,2685,9,8,10,18,37,63,-26,34
Admira Wacke,2685,10,8,7,21,30,63,-33,31
Vienna,2686,1,22,4,10,69,46,23,70
FC Salzburg,2686,2,21,5,10,66,35,31,68
SK Sturm Gra,2686,3,20,5,11,60,26,34,65
SC Rheindorf,2686,4,19,7,10,53,46,7,64
Rapid Vienna,2686,5,16,7,13,57,42,15,55
RZ Pellets W,2686,6,12,9,15,48,52,-4,45
Admira Wacke,2686,7,11,6,19,36,60,-24,39
St. Pölten,2686,8,9,9,18,38,67,-29,36
Mattersburg,2686,9,9,7,20,35,61,-26,34
SV Josko Rie,2686,10,10,3,23,32,59,-27,33
SC Rheindorf,2687,1,21,9,6,69,45,24,72
Vienna,2687,2,20,5,11,68,51,17,65
FC Salzburg,2687,3,18,9,9,61,38,23,63
Rapid Vienna,2687,4,13,12,11,55,46,9,51
SK Sturm Gra,2687,5,14,9,13,53,47,6,51
RZ Pellets W,2687,6,13,9,14,53,55,-2,48
Mattersburg,2687,7,12,7,17,45,53,-8,43
Admira Wacke,2687,8,11,7,18,41,62,-21,40
St. Pölten,2687,9,9,10,17,48,69,-21,37
SV Josko Rie,2687,10,9,3,24,35,62,-27,30
FC Salzburg,2688,1,22,8,6,68,32,36,74
SC Rheindorf,2688,2,20,7,9,54,36,18,67
SK Sturm Gra,2688,3,18,9,9,61,30,31,63
Vienna,2688,4,18,4,14,57,51,6,58
Rapid Vienna,2688,5,14,11,11,60,47,13,53
RZ Pellets W,2688,6,12,7,17,44,59,-15,43
SV Josko Rie,2688,7,11,6,19,36,53,-17,39
Admira Wacke,2688,8,11,6,19,40,62,-22,39
Mattersburg,2688,9,8,12,16,39,54,-15,36
St. Pölten,2688,10,6,10,20,37,72,-35,28
FC Salzburg,2689,1,21,8,7,66,32,34,71
SK Sturm Gra,2689,2,21,5,10,69,38,31,68
SC Rheindorf,2689,3,19,9,8,55,41,14,66
Vienna,2689,4,17,5,14,65,59,6,56
Rapid Vienna,2689,5,14,12,10,71,47,24,54
Admira Wacke,2689,6,13,6,17,43,59,-16,45
RZ Pellets W,2689,7,11,6,19,46,60,-14,39
SV Josko Rie,2689,8,11,5,20,43,62,-19,38
St. Pölten,2689,9,8,10,18,46,81,-35,34
Mattersburg,2689,10,7,10,19,39,64,-25,31
FC Salzburg,2690,1,22,7,7,72,33,39,73
SC Rheindorf,2690,2,20,7,9,58,38,20,67
Vienna,2690,3,21,4,11,69,53,16,67
SK Sturm Gra,2690,4,19,7,10,59,36,23,64
Rapid Vienna,2690,5,13,13,10,61,42,19,52
RZ Pellets W,2690,6,12,7,17,44,61,-17,43
Admira Wacke,2690,7,11,6,19,39,58,-19,39
Mattersburg,2690,8,9,7,20,43,58,-15,34
St. Pölten,2690,9,9,7,20,36,69,-33,34
SV Josko Rie,2690,10,10,3,23,31,64,-33,33
SC Rheindorf,2691,1,23,7,6,68,41,27,76
FC Salzburg,2691,2,20,10,6,62,27,35,70
SK Sturm Gra,2691,3,21,5,10,60,30,30,68
Vienna,2691,4,19,5,12,62,51,11,62
Rapid Vienna,2691,5,14,10,12,52,39,13,52
Admira Wacke,2691,6,11,8,17,35,55,-20,41
RZ Pellets W,2691,7,11,7,18,37,58,-21,40
SV Josko Rie,2691,8,9,7,20,27,48,-21,34
St. Pölten,2691,9,9,7,20,43,66,-23,34
Mattersburg,2691,10,5,10,21,33,64,-31,25
FC Salzburg,2692,1,21,5,10,65,38,27,68
SC Rheindorf,2692,2,19,8,9,54,42,12,65
Vienna,2692,3,19,5,12,61,52,9,62
SK Sturm Gra,2692,4,19,4,13,61,43,18,61
Rapid Vienna,2692,5,14,11,11,55,39,16,53
RZ Pellets W,2692,6,14,5,17,47,53,-6,47
Admira Wacke,2692,7,13,6,17,46,62,-16,45
Mattersburg,2692,8,10,9,17,41,51,-10,39
SV Josko Rie,2692,9,10,4,22,33,55,-22,34
St. Pölten,2692,10,8,9,19,38,66,-28,33
SC Rheindorf,2693,1,25,6,5,64,34,30,81
FC Salzburg,2693,2,19,8,9,63,32,31,65
SK Sturm Gra,2693,3,18,7,11,55,32,23,61
Vienna,2693,4,18,7,11,60,46,14,61
RZ Pellets W,2693,5,13,8,15,42,48,-6,47
Rapid Vienna,2693,6,12,10,14,52,41,11,46
SV Josko Rie,2693,7,13,5,18,41,53,-12,44
Mattersburg,2693,8,9,7,20,40,60,-20,34
Admira Wacke,2693,9,9,7,20,30,67,-37,34
St. Pölten,2693,10,7,9,20,34,68,-34,30
FC Salzburg,2694,1,22,9,5,68,31,37,75
SK Sturm Gra,2694,2,21,5,10,65,37,28,68
Vienna,2694,3,19,5,12,64,51,13,62
SC Rheindorf,2694,4,16,9,11,46,41,5,57
Rapid Vienna,2694,5,14,11,11,58,37,21,53
RZ Pellets W,2694,6,13,8,15,47,55,-8,47
St. Pölten,2694,7,8,13,15,39,59,-20,37
Admira Wacke,2694,8,10,6,20,36,67,-31,36
SV Josko Rie,2694,9,9,7,20,34,54,-20,34
Mattersburg,2694,10,8,7,21,33,58,-25,31
FC Salzburg,2695,1,24,6,6,70,32,38,78
SC Rheindorf,2695,2,20,7,9,61,47,14,67
SK Sturm Gra,2695,3,19,5,12,62,40,22,62
Vienna,2695,4,18,5,13,73,56,17,59
Rapid Vienna,2695,5,14,8,14,49,37,12,50
RZ Pellets W,2695,6,13,7,16,46,56,-10,46
SV Josko Rie,2695,7,12,5,19,42,57,-15,41
Mattersburg,2695,8,8,11,17,39,55,-16,35
St. Pölten,2695,9,9,8,19,33,66,-33,35
Admira Wacke,2695,10,9,6,21,38,67,-29,33
FC Salzburg,2696,1,23,5,8,73,30,43,74
SC Rheindorf,2696,2,20,8,8,65,42,23,68
Vienna,2696,3,19,5,12,59,47,12,62
Rapid Vienna,2696,4,17,10,9,57,35,22,61
SK Sturm Gra,2696,5,18,6,12,52,33,19,60
RZ Pellets W,2696,6,14,8,14,44,50,-6,50
Admira Wacke,2696,7,12,3,21,37,61,-24,39
Mattersburg,2696,8,9,8,19,33,51,-18,35
St. Pölten,2696,9,8,7,21,36,75,-39,31
SV Josko Rie,2696,10,8,4,24,29,61,-32,28
SK Sturm Gra,2697,1,24,4,8,65,33,32,76
FC Salzburg,2697,2,21,9,6,63,27,36,72
SC Rheindorf,2697,3,17,7,12,48,41,7,58
Vienna,2697,4,17,5,14,58,52,6,56
Rapid Vienna,2697,5,13,11,12,52,45,7,50
SV Josko Rie,2697,6,13,6,17,37,47,-10,45
RZ Pellets W,2697,7,12,6,18,47,56,-9,42
Admira Wacke,2697,8,10,9,17,40,61,-21,39
St. Pölten,2697,9,8,9,19,40,67,-27,33
Mattersburg,2697,10,8,8,20,35,56,-21,32
FC Salzburg,2698,1,22,6,8,62,32,30,72
SK Sturm Gra,2698,2,20,5,11,62,42,20,65
Rapid Vienna,2698,3,17,9,10,69,41,28,60
SC Rheindorf,2698,4,18,6,12,58,47,11,60
Vienna,2698,5,18,4,14,59,51,8,58
RZ Pellets W,2698,6,15,6,15,46,50,-4,51
Admira Wacke,2698,7,14,4,18,36,59,-23,46
SV Josko Rie,2698,8,12,5,19,39,53,-14,41
St. Pölten,2698,9,8,8,20,41,67,-26,32
Mattersburg,2698,10,5,9,22,30,60,-30,24
SK Sturm Gra,2699,1,20,8,8,68,35,33,68
FC Salzburg,2699,2,20,7,9,60,28,32,67
Rapid Vienna,2699,3,19,8,9,61,36,25,65
Vienna,2699,4,19,5,12,71,56,15,62
SC Rheindorf,2699,5,16,9,11,50,46,4,57
RZ Pellets W,2699,6,12,8,16,49,60,-11,44
Mattersburg,2699,7,10,9,17,40,57,-17,39
SV Josko Rie,2699,8,10,7,19,37,61,-24,37
Admira Wacke,2699,9,10,7,19,32,57,-25,37
St. Pölten,2699,10,6,8,22,39,71,-32,26
FC Salzburg,2700,1,22,7,7,74,34,40,73
SC Rheindorf,2700,2,22,6,8,62,41,21,72
SK Sturm Gra,2700,3,21,5,10,61,32,29,68
Vienna,2700,4,19,3,14,65,51,14,60
Rapid Vienna,2700,5,14,8,14,54,46,8,50
RZ Pellets W,2700,6,13,4,19,52,63,-11,43
Admira Wacke,2700,7,13,4,19,37,58,-21,43
St. Pölten,2700,8,10,7,19,44,78,-34,37
Mattersburg,2700,9,10,5,21,38,56,-18,35
SV Josko Rie,2700,10,9,5,22,37,65,-28,32
FC Salzburg,2701,1,23,6,7,67,25,42,75
SC Rheindorf,2701,2,19,8,9,53,37,16,65
SK Sturm Gra,2701,3,18,8,10,56,37,19,62
Vienna,2701,4,18,7,11,61,46,15,61
Rapid Vienna,2701,5,15,11,10,57,36,21,56
SV Josko Rie,2701,6,12,4,20,33,56,-23,40
Mattersburg,2701,7,9,12,15,32,45,-13,39
Admira Wacke,2701,8,10,6,20,32,64,-32,36
St. Pölten,2701,9,9,7,20,42,65,-23,34
RZ Pellets W,2701,10,8,9,19,40,62,-22,33
FC Salzburg,2702,1,23,6,7,65,29,36,75
SK Sturm Gra,2702,2,17,11,8,56,36,20,62
Vienna,2702,3,17,6,13,61,59,2,57
SC Rheindorf,2702,4,16,8,12,47,43,4,56
Rapid Vienna,2702,5,13,12,11,56,39,17,51
RZ Pellets W,2702,6,12,9,15,52,61,-9,45
Admira Wacke,2702,7,11,9,16,38,54,-16,42
Mattersburg,2702,8,8,14,14,36,51,-15,38
St. Pölten,2702,9,7,13,16,43,60,-17,34
SV Josko Rie,2702,10,8,8,20,36,58,-22,32
FC Salzburg,2703,1,21,10,5,66,26,40,73
SK Sturm Gra,2703,2,22,6,8,61,31,30,72
SC Rheindorf,2703,3,18,7,11,55,41,14,61
Vienna,2703,4,17,5,14,55,48,7,56
Rapid Vienna,2703,5,13,11,12,58,41,17,50
RZ Pellets W,2703,6,14,7,15,45,50,-5,49
SV Josko Rie,2703,7,11,4,21,33,52,-19,37
St. Pölten,2703,8,8,12,16,37,62,-25,36
Admira Wacke,2703,9,9,8,19,29,66,-37,35
Mattersburg,2703,10,6,12,18,36,58,-22,30
FC Salzburg,2704,1,23,6,7,73,29,44,75
SC Rheindorf,2704,2,18,7,11,52,46,6,61
SK Sturm Gra,2704,3,17,9,10,54,31,23,60
Vienna,2704,4,17,7,12,57,47,10,58
Rapid Vienna,2704,5,15,10,11,49,36,13,55
SV Josko Rie,2704,6,14,8,14,42,46,-4,50
RZ Pellets W,2704,7,12,8,16,44,53,-9,44
Admira Wacke,2704,8,10,9,17,34,57,-23,39
St. Pölten,2704,9,8,8,20,36,62,-26,32
Mattersburg,2704,10,7,6,23,25,59,-34,27
SC Rheindorf,2705,1,21,9,6,63,40,23,72
FC Salzburg,2705,2,21,7,8,67,34,33,70
SK Sturm Gra,2705,3,19,7,10,59,37,22,64
Rapid Vienna,2705,4,16,10,10,63,41,22,58
Vienna,2705,5,17,7,12,64,52,12,58
Admira Wacke,2705,6,11,7,18,39,62,-23,40
St. Pölten,2705,7,8,15,13,44,56,-12,39
SV Josko Rie,2705,8,10,7,19,37,55,-18,37
Mattersburg,2705,9,8,7,21,37,67,-30,31
RZ Pellets W,2705,10,7,8,21,37,66,-29,29
SC Rheindorf,2706,1,21,8,7,57,38,19,71
Vienna,2706,2,21,5,10,66,49,17,68
SK Sturm Gra,2706,3,20,3,13,54,34,20,63
Rapid Vienna,2706,4,16,10,10,60,43,17,58
FC Salzburg,2706,5,16,8,12,57,34,23,56
RZ Pellets W,2706,6,12,7,17,40,54,-14,43
SV Josko Rie,2706,7,13,3,20,43,55,-12,42
Admira Wacke,2706,8,11,7,18,33,54,-21,40
Mattersburg,2706,9,8,9,19,34,59,-25,33
St. Pölten,2706,10,7,10,19,40,64,-24,31
FC Salzburg,2707,1,22,8,6,64,28,36,74
SC Rheindorf,2707,2,22,7,7,61,39,22,73
SK Sturm Gra,2707,3,19,5,12,58,32,26,62
Vienna,2707,4,18,3,15,63,53,10,57
Rapid Vienna,2707,5,12,11,13,53,41,12,47
Admira Wacke,2707,6,14,5,17,40,56,-16,47
RZ Pellets W,2707,7,13,5,18,46,65,-19,44
St. Pölten,2707,8,9,10,17,42,60,-18,37
SV Josko Rie,2707,9,10,5,21,36,60,-24,35
Mattersburg,2707,10,8,7,21,31,60,-29,31
SC Rheindorf,2708,1,22,6,8,64,40,24,72
FC Salzburg,2708,2,19,6,11,57,34,23,63
Rapid Vienna,2708,3,17,8,11,69,48,21,59
SK Sturm Gra,2708,4,17,7,12,57,40,17,58
Vienna,2708,5,17,5,14,60,58,2,56
RZ Pellets W,2708,6,14,5,17,54,67,-13,47
Admira Wacke,2708,7,13,6,17,41,54,-13,45
St. Pölten,2708,8,9,10,17,48,70,-22,37
SV Josko Rie,2708,9,10,6,20,31,53,-22,36
Mattersburg,2708,10,8,9,19,39,56,-17,33
SK Sturm Gra,2709,1,22,4,10,65,35,30,70
SC Rheindorf,2709,2,21,7,8,56,36,20,70
Rapid Vienna,2709,3,17,9,10,57,37,20,60
FC Salzburg,2709,4,17,8,11,56,38,18,59
Vienna,2709,5,18,3,15,66,52,14,57
Admira Wacke,2709,6,13,4,19,39,60,-21,43
SV Josko Rie,2709,7,13,3,20,38,57,-19,42
RZ Pellets W,2709,8,12,5,19,47,63,-16,41
St. Pölten,2709,9,8,11,17,42,69,-27,35
Mattersburg,2709,10,7,10,19,41,60,-19,31
SK Sturm Gra,2710,1,21,5,10,65,33,32,68
SC Rheindorf,2710,2,19,8,9,59,48,11,65
FC Salzburg,2710,3,19,7,10,68,36,32,64
Vienna,2710,4,19,5,12,64,51,13,62
Admira Wacke,2710,5,16,6,14,41,50,-9,54
Rapid Vienna,2710,6,14,9,13,50,39,11,51
St. Pölten,2710,7,10,10,16,43,60,-17,40
Mattersburg,2710,8,9,9,18,39,63,-24,36
RZ Pellets W,2710,9,9,8,19,36,55,-19,35
SV Josko Rie,2710,10,9,3,24,38,68,-30,30
FC Salzburg,2711,1,21,9,6,64,27,37,72
SK Sturm Gra,2711,2,22,5,9,57,30,27,71
SC Rheindorf,2711,3,20,8,8,56,39,17,68
Rapid Vienna,2711,4,16,10,10,58,37,21,58
Vienna,2711,5,15,8,13,62,60,2,53
RZ Pellets W,2711,6,11,9,16,48,56,-8,42
Admira Wacke,2711,7,11,7,18,43,59,-16,40
SV Josko Rie,2711,8,11,5,20,39,59,-20,38
Mattersburg,2711,9,9,8,19,36,60,-24,35
St. Pölten,2711,10,5,9,22,34,70,-36,24
FC Salzburg,2712,1,24,6,6,68,28,40,78
SK Sturm Gra,2712,2,21,4,11,61,35,26,67
Vienna,2712,3,21,3,12,69,49,20,66
SC Rheindorf,2712,4,19,6,11,54,47,7,63
Rapid Vienna,2712,5,13,9,14,54,44,10,48
St. Pölten,2712,6,11,8,17,48,65,-17,41
SV Josko Rie,2712,7,12,3,21,36,54,-18,39
RZ Pellets W,2712,8,10,8,18,38,55,-17,38
Admira Wacke,2712,9,10,6,20,35,62,-27,36
Mattersburg,2712,10,8,9,19,36,60,-24,33
FC Salzburg,2713,1,20,7,9,59,32,27,67
SK Sturm Gra,2713,2,18,8,10,60,34,26,62
SC Rheindorf,2713,3,18,7,11,54,43,11,61
Vienna,2713,4,18,4,14,62,59,3,58
Rapid Vienna,2713,5,15,10,11,51,39,12,55
RZ Pellets W,2713,6,13,8,15,49,51,-2,47
St. Pölten,2713,7,12,10,14,46,55,-9,46
Admira Wacke,2713,8,12,4,20,38,61,-23,40
SV Josko Rie,2713,9,11,6,19,41,55,-14,39
Mattersburg,2713,10,7,8,21,35,66,-31,29
SK Sturm Gra,2714,1,20,7,9,63,34,29,67
FC Salzburg,2714,2,18,10,8,69,35,34,64
SC Rheindorf,2714,3,19,6,11,54,40,14,63
Vienna,2714,4,18,7,11,59,46,13,61
Rapid Vienna,2714,5,14,10,12,54,37,17,52
RZ Pellets W,2714,6,14,8,14,51,57,-6,50
Mattersburg,2714,7,12,7,17,40,51,-11,43
Admira Wacke,2714,8,12,5,19,44,74,-30,41
SV Josko Rie,2714,9,10,5,21,28,53,-25,35
St. Pölten,2714,10,5,11,20,35,70,-35,26
FC Salzburg,2715,1,22,6,8,67,27,40,72
SK Sturm Gra,2715,2,23,3,10,67,34,33,72
Vienna,2715,3,21,4,11,72,50,22,67
SC Rheindorf,2715,4,18,8,10,54,46,8,62
Rapid Vienna,2715,5,12,10,14,45,43,2,46
SV Josko Rie,2715,6,12,6,18,39,57,-18,42
Mattersburg,2715,7,11,8,17,50,56,-6,41
St. Pölten,2715,8,10,8,18,38,59,-21,38
RZ Pellets W,2715,9,9,7,20,37,59,-22,34
Admira Wacke,2715,10,9,6,21,31,69,-38,33
FC Salzburg,2716,1,20,7,9,59,30,29,67
SK Sturm Gra,2716,2,20,5,11,60,31,29,65
SC Rheindorf,2716,3,18,11,7,52,39,13,65
Vienna,2716,4,19,6,11,66,56,10,63
RZ Pellets W,2716,5,15,8,13,54,52,2,53
Rapid Vienna,2716,6,12,10,14,47,45,2,46
Admira Wacke,2716,7,12,7,17,33,51,-18,43
St. Pölten,2716,8,9,9,18,48,65,-17,36
SV Josko Rie,2716,9,9,7,20,35,56,-21,34
Mattersburg,2716,10,6,10,20,34,63,-29,28
FC Salzburg,2717,1,20,11,5,64,30,34,71
SC Rheindorf,2717,2,20,9,7,62,40,22,69
SK Sturm Gra,2717,3,19,5,12,62,37,25,62
Rapid Vienna,2717,4,17,10,9,59,38,21,61
Vienna,2717,5,18,7,11,59,50,9,61
RZ Pellets W,2717,6,10,8,18,43,64,-21,38
SV Josko Rie,2717,7,10,6,20,36,56,-20,36
Mattersburg,2717,8,9,9,18,35,56,-21,36
Admira Wacke,2717,9,10,6,20,39,62,-23,36
St. Pölten,2717,10,6,11,19,43,69,-26,29
SC Rheindorf,2718,1,20,9,7,56,41,15,69
SK Sturm Gra,2718,2,17,9,10,59,33,26,60
Vienna,2718,3,18,5,13,59,51,8,59
Admira Wacke,2718,4,18,4,14,48,51,-3,58
FC Salzburg,2718,5,17,5,14,60,38,22,56
Rapid Vienna,2718,6,13,12,11,51,38,13,51
Mattersburg,2718,7,11,9,16,40,54,-14,42
RZ Pellets W,2718,8,9,10,17,40,57,-17,37
SV Josko Rie,2718,9,10,7,19,31,53,-22,37
St. Pölten,2718,10,7,10,19,42,70,-28,31
SC Rheindorf,2719,1,21,6,9,53,40,13,69
FC Salzburg,2719,2,20,5,11,65,29,36,65
Rapid Vienna,2719,3,18,9,9,61,34,27,63
SK Sturm Gra,2719,4,18,8,10,56,34,22,62
Vienna,2719,5,15,8,13,55,60,-5,53
St. Pölten,2719,6,11,8,17,45,60,-15,41
Admira Wacke,2719,7,10,9,17,37,55,-18,39
RZ Pellets W,2719,8,10,7,19,41,60,-19,37
SV Josko Rie,2719,9,10,7,19,31,55,-24,37
Mattersburg,2719,10,9,9,18,40,57,-17,36
FC Salzburg,2720,1,23,7,6,62,28,34,76
SC Rheindorf,2720,2,21,6,9,54,41,13,69
Vienna,2720,3,19,9,8,62,45,17,66
SK Sturm Gra,2720,4,18,5,13,55,41,14,59
Rapid Vienna,2720,5,15,10,11,55,35,20,55
Admira Wacke,2720,6,13,6,17,42,57,-15,45
RZ Pellets W,2720,7,12,8,16,49,53,-4,44
SV Josko Rie,2720,8,8,10,18,31,48,-17,34
Mattersburg,2720,9,7,9,20,41,63,-22,30
St. Pölten,2720,10,5,8,23,33,73,-40,23
FC Salzburg,2721,1,25,7,4,80,35,45,82
SK Sturm Gra,2721,2,20,7,9,61,30,31,67
SC Rheindorf,2721,3,19,8,9,56,44,12,65
Vienna,2721,4,18,7,11,62,51,11,61
Rapid Vienna,2721,5,11,13,12,57,43,14,46
RZ Pellets W,2721,6,10,9,17,41,55,-14,39
Admira Wacke,2721,7,11,6,19,45,65,-20,39
SV Josko Rie,2721,8,11,4,21,32,57,-25,37
Mattersburg,2721,9,8,9,19,37,62,-25,33
St. Pölten,2721,10,8,8,20,35,64,-29,32
SK Sturm Gra,2722,1,22,6,8,71,36,35,72
FC Salzburg,2722,2,20,8,8,68,33,35,68
SC Rheindorf,2722,3,19,7,10,52,44,8,64
Vienna,2722,4,16,3,17,58,63,-5,51
Admira Wacke,2722,5,15,6,15,44,58,-14,51
Rapid Vienna,2722,6,12,10,14,60,50,10,46
Mattersburg,2722,7,11,9,16,46,54,-8,42
SV Josko Rie,2722,8,10,9,17,39,57,-18,39
RZ Pellets W,2722,9,10,6,20,42,61,-19,36
St. Pölten,2722,10,7,12,17,43,67,-24,33
SK Sturm Gra,2723,1,21,5,10,60,34,26,68
FC Salzburg,2723,2,20,7,9,65,38,27,67
SC Rheindorf,2723,3,20,5,11,52,42,10,65
Vienna,2723,4,19,4,13,57,46,11,61
Rapid Vienna,2723,5,14,9,13,54,40,14,51
SV Josko Rie,2723,6,14,4,18,39,47,-8,46
St. Pölten,2723,7,11,8,17,44,62,-18,41
RZ Pellets W,2723,8,10,9,17,52,68,-16,39
Admira Wacke,2723,9,10,8,18,40,62,-22,38
Mattersburg,2723,10,8,7,21,31,55,-24,31
SC Rheindorf,2724,1,23,7,6,58,34,24,76
FC Salzburg,2724,2,21,10,5,62,24,38,73
SK Sturm Gra,2724,3,19,8,9,53,32,21,65
Vienna,2724,4,15,7,14,60,55,5,52
Rapid Vienna,2724,5,12,11,13,53,45,8,47
RZ Pellets W,2724,6,13,7,16,46,55,-9,46
Admira Wacke,2724,7,13,5,18,41,63,-22,44
SV Josko Rie,2724,8,12,3,21,31,51,-20,39
Mattersburg,2724,9,8,8,20,30,50,-20,32
St. Pölten,2724,10,6,10,20,38,63,-25,28
SK Sturm Gra,2725,1,21,7,8,73,29,44,70
SC Rheindorf,2725,2,21,7,8,57,40,17,70
FC Salzburg,2725,3,20,5,11,63,34,29,65
Vienna,2725,4,18,4,14,59,55,4,58
Rapid Vienna,2725,5,16,9,11,57,39,18,57
RZ Pellets W,2725,6,15,6,15,47,54,-7,51
Admira Wacke,2725,7,12,7,17,37,57,-20,43
St. Pölten,2725,8,9,9,18,41,69,-28,36
SV Josko Rie,2725,9,11,2,23,37,61,-24,35
Mattersburg,2725,10,6,6,24,31,64,-33,24
SC Rheindorf,2726,1,18,10,8,52,42,10,64
FC Salzburg,2726,2,18,9,9,59,29,30,63
Vienna,2726,3,20,3,13,61,49,12,63
Rapid Vienna,2726,4,18,8,10,58,34,24,62
SK Sturm Gra,2726,5,17,9,10,60,40,20,60
RZ Pellets W,2726,6,12,9,15,43,56,-13,45
SV Josko Rie,2726,7,11,6,19,36,53,-17,39
Admira Wacke,2726,8,9,10,17,40,61,-21,37
Mattersburg,2726,9,8,10,18,41,60,-19,34
St. Pölten,2726,10,7,10,19,35,61,-26,31
FC Salzburg,2727,1,22,8,6,64,28,36,74
SK Sturm Gra,2727,2,20,7,9,64,33,31,67
SC Rheindorf,2727,3,20,6,10,60,47,13,66
Vienna,2727,4,16,4,16,58,59,-1,52
Rapid Vienna,2727,5,14,9,13,52,42,10,51
RZ Pellets W,2727,6,13,8,15,57,59,-2,47
Mattersburg,2727,7,13,7,16,44,49,-5,46
Admira Wacke,2727,8,12,7,17,39,62,-23,43
SV Josko Rie,2727,9,12,3,21,37,56,-19,39
St. Pölten,2727,10,4,9,23,31,71,-40,21
FC Salzburg,2728,1,20,11,5,61,28,33,71
Vienna,2728,2,22,4,10,67,47,20,70
SC Rheindorf,2728,3,19,9,8,54,39,15,66
SK Sturm Gra,2728,4,17,6,13,52,33,19,57
Rapid Vienna,2728,5,13,14,9,53,41,12,53
Admira Wacke,2728,6,14,7,15,40,53,-13,49
RZ Pellets W,2728,7,9,8,19,41,56,-15,35
St. Pölten,2728,8,6,15,15,39,63,-24,33
SV Josko Rie,2728,9,8,8,20,30,53,-23,32
Mattersburg,2728,10,6,10,20,35,59,-24,28
SK Sturm Gra,2729,1,22,6,8,59,31,28,72
FC Salzburg,2729,2,19,9,8,64,35,29,66
SC Rheindorf,2729,3,19,7,10,58,45,13,64
Vienna,2729,4,19,6,11,66,51,15,63
Rapid Vienna,2729,5,13,8,15,56,47,9,47
RZ Pellets W,2729,6,13,5,18,48,59,-11,44
Admira Wacke,2729,7,11,8,17,38,61,-23,41
SV Josko Rie,2729,8,11,7,18,35,49,-14,40
Mattersburg,2729,9,9,8,19,40,61,-21,35
St. Pölten,2729,10,8,8,20,37,62,-25,32
SC Rheindorf,2730,1,19,8,9,56,41,15,65
Vienna,2730,2,20,5,11,59,46,13,65
FC Salzburg,2730,3,18,8,10,62,34,28,62
SK Sturm Gra,2730,4,18,6,12,52,36,16,60
Rapid Vienna,2730,5,15,11,10,59,42,17,56
RZ Pellets W,2730,6,14,8,14,47,51,-4,50
St. Pölten,2730,7,12,9,15,49,55,-6,45
SV Josko Rie,2730,8,12,6,18,33,50,-17,42
Admira Wacke,2730,9,10,7,19,34,60,-26,37
Mattersburg,2730,10,5,6,25,32,68,-36,21
SK Sturm Gra,2731,1,23,6,7,67,28,39,75
FC Salzburg,2731,2,20,8,8,64,31,33,68
SC Rheindorf,2731,3,16,10,10,47,39,8,58
Rapid Vienna,2731,4,15,11,10,58,39,19,56
Vienna,2731,5,15,5,16,55,59,-4,50
Admira Wacke,2731,6,15,4,17,40,62,-22,49
RZ Pellets W,2731,7,11,10,15,46,53,-7,43
SV Josko Rie,2731,8,12,4,20,37,58,-21,40
St. Pölten,2731,9,7,11,18,45,66,-21,32
Mattersburg,2731,10,5,13,18,32,56,-24,28
SC Rheindorf,2732,1,20,9,7,53,36,17,69
FC Salzburg,2732,2,19,10,7,61,30,31,67
Rapid Vienna,2732,3,16,12,8,57,32,25,60
SK Sturm Gra,2732,4,17,8,11,58,34,24,59
Vienna,2732,5,16,8,12,56,54,2,56
Admira Wacke,2732,6,12,6,18,39,56,-17,42
RZ Pellets W,2732,7,11,8,17,42,58,-16,41
SV Josko Rie,2732,8,10,7,19,29,57,-28,37
St. Pölten,2732,9,7,12,17,40,59,-19,33
Mattersburg,2732,10,7,10,19,38,57,-19,31
SC Rheindorf,2733,1,22,6,8,59,34,25,72
FC Salzburg,2733,2,20,6,10,59,28,31,66
SK Sturm Gra,2733,3,17,7,12,54,39,15,58
Vienna,2733,4,18,4,14,62,57,5,58
Rapid Vienna,2733,5,14,11,11,59,40,19,53
RZ Pellets W,2733,6,13,8,15,48,57,-9,47
SV Josko Rie,2733,7,12,6,18,36,46,-10,42
Admira Wacke,2733,8,12,5,19,36,63,-27,41
Mattersburg,2733,9,10,8,18,41,61,-20,38
St. Pölten,2733,10,6,11,19,38,67,-29,29
SK Sturm Gra,2734,1,20,7,9,60,28,32,67
SC Rheindorf,2734,2,19,7,10,52,44,8,64
Vienna,2734,3,18,6,12,59,47,12,60
FC Salzburg,2734,4,16,11,9,58,35,23,59
Rapid Vienna,2734,5,14,11,11,52,40,12,53
Admira Wacke,2734,6,13,8,15,38,53,-15,47
RZ Pellets W,2734,7,13,7,16,49,54,-5,46
St. Pölten,2734,8,9,9,18,37,61,-24,36
Mattersburg,2734,9,8,10,18,35,54,-19,34
SV Josko Rie,2734,10,10,4,22,31,55,-24,34
SC Rheindorf,2735,1,19,8,9,54,42,12,65
FC Salzburg,2735,2,17,12,7,64,35,29,63
SK Sturm Gra,2735,3,18,7,11,55,31,24,61
Vienna,2735,4,18,6,12,56,51,5,60
Rapid Vienna,2735,5,14,9,13,59,50,9,51
RZ Pellets W,2735,6,15,5,16,52,50,2,50
Admira Wacke,2735,7,13,5,18,38,54,-16,44
SV Josko Rie,2735,8,12,4,20,35,55,-20,40
Mattersburg,2735,9,9,9,18,38,56,-18,36
St. Pölten,2735,10,8,9,19,41,68,-27,33
FC Salzburg,2736,1,20,9,7,63,37,26,69
SK Sturm Gra,2736,2,19,8,9,61,33,28,65
SC Rheindorf,2736,3,18,9,9,54,41,13,63
Vienna,2736,4,18,4,14,67,54,13,58
Rapid Vienna,2736,5,13,12,11,59,41,18,51
RZ Pellets W,2736,6,11,9,16,43,57,-14,42
SV Josko Rie,2736,7,12,6,18,40,62,-22,42
Admira Wacke,2736,8,11,7,18,39,60,-21,40
Mattersburg,2736,9,8,10,18,38,56,-18,34
St. Pölten,2736,10,7,12,17,43,66,-23,33
FC Salzburg,2737,1,25,6,5,75,32,43,81
SK Sturm Gra,2737,2,21,5,10,67,37,30,68
SC Rheindorf,2737,3,17,9,10,56,48,8,60
Vienna,2737,4,18,5,13,61,50,11,59
Rapid Vienna,2737,5,13,13,10,56,39,17,52
RZ Pellets W,2737,6,14,7,15,45,52,-7,49
Admira Wacke,2737,7,12,6,18,38,59,-21,42
SV Josko Rie,2737,8,8,9,19,31,52,-21,33
St. Pölten,2737,9,8,9,19,40,68,-28,33
Mattersburg,2737,10,7,5,24,33,65,-32,26
FC Salzburg,2738,1,20,8,8,69,33,36,68
Vienna,2738,2,21,3,12,64,51,13,66
SC Rheindorf,2738,3,17,10,9,58,46,12,61
SK Sturm Gra,2738,4,16,10,10,63,42,21,58
Rapid Vienna,2738,5,15,11,10,55,40,15,56
RZ Pellets W,2738,6,13,9,14,52,54,-2,48
St. Pölten,2738,7,10,10,16,43,61,-18,40
Admira Wacke,2738,8,11,5,20,39,63,-24,38
Mattersburg,2738,9,9,8,19,40,61,-21,35
SV Josko Rie,2738,10,8,6,22,27,59,-32,30
FC Salzburg,2739,1,20,9,7,65,29,36,69
SC Rheindorf,2739,2,21,6,9,56,37,19,69
SK Sturm Gra,2739,3,20,7,9,58,34,24,67
Rapid Vienna,2739,4,15,11,10,55,38,17,56
RZ Pellets W,2739,5,16,7,13,52,54,-2,55
Vienna,2739,6,16,3,17,62,62,0,51
SV Josko Rie,2739,7,13,3,20,41,57,-16,42
Admira Wacke,2739,8,12,5,19,40,62,-22,41
St. Pölten,2739,9,7,9,20,39,68,-29,30
Mattersburg,2739,10,6,8,22,34,61,-27,26
FC Salzburg,2740,1,23,6,7,74,32,42,75
Vienna,2740,2,21,5,10,63,44,19,68
SK Sturm Gra,2740,3,20,5,11,56,29,27,65
SC Rheindorf,2740,4,20,5,11,49,41,8,65
Rapid Vienna,2740,5,13,12,11,52,42,10,51
St. Pölten,2740,6,11,10,15,46,61,-15,43
RZ Pellets W,2740,7,11,7,18,43,67,-24,40
SV Josko Rie,2740,8,10,4,22,31,53,-22,34
Admira Wacke,2740,9,9,6,21,33,64,-31,33
Mattersburg,2740,10,8,8,20,42,56,-14,32
SC Rheindorf,2741,1,21,7,8,60,41,19,70
Vienna,2741,2,20,6,10,69,46,23,66
FC Salzburg,2741,3,17,12,7,54,30,24,63
SK Sturm Gra,2741,4,19,5,12,53,30,23,62
Rapid Vienna,2741,5,14,9,13,62,40,22,51
RZ Pellets W,2741,6,11,7,18,43,56,-13,40
Mattersburg,2741,7,10,10,16,36,62,-26,40
SV Josko Rie,2741,8,11,5,20,34,50,-16,38
Admira Wacke,2741,9,10,7,19,31,62,-31,37
St. Pölten,2741,10,9,8,19,36,61,-25,35
FC Salzburg,2742,1,20,10,6,66,34,32,70
SC Rheindorf,2742,2,20,10,6,62,40,22,70
SK Sturm Gra,2742,3,19,5,12,59,35,24,62
Rapid Vienna,2742,4,14,11,11,61,41,20,53
Vienna,2742,5,16,5,15,59,54,5,53
RZ Pellets W,2742,6,12,10,14,51,58,-7,46
SV Josko Rie,2742,7,10,9,17,34,53,-19,39
Mattersburg,2742,8,9,10,17,37,56,-19,37
St. Pölten,2742,9,9,10,17,42,66,-24,37
Admira Wacke,2742,10,9,4,23,27,61,-34,31
FC Salzburg,2743,1,21,11,4,64,24,40,74
SK Sturm Gra,2743,2,20,5,11,63,34,29,65
SC Rheindorf,2743,3,18,8,10,53,41,12,62
Vienna,2743,4,17,4,15,62,58,4,55
Rapid Vienna,2743,5,12,14,10,58,45,13,50
Admira Wacke,2743,6,13,9,14,39,55,-16,48
RZ Pellets W,2743,7,11,10,15,51,58,-7,43
St. Pölten,2743,8,8,12,16,38,61,-23,36
Mattersburg,2743,9,8,8,20,38,64,-26,32
SV Josko Rie,2743,10,9,5,22,30,56,-26,32
SC Rheindorf,2744,1,22,7,7,58,33,25,73
FC Salzburg,2744,2,20,8,8,65,38,27,68
Vienna,2744,3,19,6,11,61,47,14,63
Rapid Vienna,2744,4,18,8,10,65,38,27,62
SK Sturm Gra,2744,5,17,7,12,54,36,18,58
RZ Pellets W,2744,6,13,6,17,45,52,-7,45
Admira Wacke,2744,7,10,7,19,33,60,-27,37
SV Josko Rie,2744,8,10,5,21,33,52,-19,35
Mattersburg,2744,9,8,8,20,34,63,-29,32
St. Pölten,2744,10,7,10,19,43,72,-29,31
SC Rheindorf,2745,1,21,8,7,58,39,19,71
Vienna,2745,2,21,5,10,65,47,18,68
SK Sturm Gra,2745,3,20,7,9,68,33,35,67
FC Salzburg,2745,4,20,7,9,65,34,31,67
Rapid Vienna,2745,5,10,13,13,46,41,5,43
RZ Pellets W,2745,6,11,9,16,42,52,-10,42
Mattersburg,2745,7,11,9,16,41,56,-15,42
SV Josko Rie,2745,8,11,4,21,34,53,-19,37
Admira Wacke,2745,9,10,5,21,34,67,-33,35
St. Pölten,2745,10,7,9,20,37,68,-31,30
FC Salzburg,2746,1,21,9,6,71,30,41,72
SK Sturm Gra,2746,2,22,6,8,63,30,33,72
SC Rheindorf,2746,3,19,11,6,51,36,15,68
Vienna,2746,4,17,8,11,60,51,9,59
Rapid Vienna,2746,5,13,10,13,55,44,11,49
Admira Wacke,2746,6,12,5,19,39,65,-26,41
RZ Pellets W,2746,7,11,6,19,45,57,-12,39
Mattersburg,2746,8,7,14,15,39,55,-16,35
SV Josko Rie,2746,9,9,5,22,31,55,-24,32
St. Pölten,2746,10,6,12,18,36,67,-31,30
SK Sturm Gra,2747,1,23,6,7,81,33,48,75
FC Salzburg,2747,2,21,9,6,71,28,43,72
Vienna,2747,3,21,5,10,63,46,17,68
SC Rheindorf,2747,4,20,7,9,56,36,20,67
Rapid Vienna,2747,5,11,10,15,55,53,2,43
RZ Pellets W,2747,6,11,8,17,43,59,-16,41
Admira Wacke,2747,7,11,6,19,36,77,-41,39
Mattersburg,2747,8,11,5,20,40,58,-18,38
St. Pölten,2747,9,8,9,19,44,71,-27,33
SV Josko Rie,2747,10,8,5,23,29,57,-28,29
SC Rheindorf,2748,1,21,7,8,62,38,24,70
FC Salzburg,2748,2,17,10,9,62,36,26,61
Vienna,2748,3,19,3,14,60,53,7,60
SK Sturm Gra,2748,4,16,11,9,58,37,21,59
Rapid Vienna,2748,5,14,13,9,49,36,13,55
RZ Pellets W,2748,6,12,8,16,47,54,-7,44
St. Pölten,2748,7,12,8,16,47,59,-12,44
SV Josko Rie,2748,8,12,5,19,34,50,-16,41
Admira Wacke,2748,9,11,6,19,35,61,-26,39
Mattersburg,2748,10,5,11,20,28,58,-30,26
SC Rheindorf,2749,1,21,7,8,56,40,16,70
FC Salzburg,2749,2,20,7,9,64,31,33,67
Vienna,2749,3,19,7,10,70,51,19,64
SK Sturm Gra,2749,4,18,5,13,51,36,15,59
Rapid Vienna,2749,5,15,11,10,60,41,19,56
RZ Pellets W,2749,6,12,9,15,42,51,-9,45
Admira Wacke,2749,7,11,10,15,30,47,-17,43
SV Josko Rie,2749,8,9,6,21,33,55,-22,33
Mattersburg,2749,9,7,10,19,39,63,-24,31
St. Pölten,2749,10,7,10,19,37,67,-30,31
FC Salzburg,2750,1,22,6,8,70,34,36,72
SC Rheindorf,2750,2,21,8,7,58,35,23,71
SK Sturm Gra,2750,3,21,5,10,68,41,27,68
Rapid Vienna,2750,4,17,9,10,57,38,19,60
Vienna,2750,5,17,5,14,65,57,8,56
Admira Wacke,2750,6,12,6,18,37,60,-23,42
RZ Pellets W,2750,7,11,8,17,44,56,-12,41
Mattersburg,2750,8,9,9,18,38,59,-21,36
St. Pölten,2750,9,7,10,19,46,72,-26,31
SV Josko Rie,2750,10,8,4,24,25,56,-31,28
FC Salzburg,2751,1,21,7,8,60,29,31,70
SK Sturm Gra,2751,2,21,5,10,62,35,27,68
SC Rheindorf,2751,3,19,8,9,51,41,10,65
Vienna,2751,4,17,7,12,63,50,13,58
Rapid Vienna,2751,5,14,11,11,61,41,20,53
Admira Wacke,2751,6,14,6,16,39,55,-16,48
RZ Pellets W,2751,7,10,11,15,45,57,-12,41
SV Josko Rie,2751,8,11,6,19,31,51,-20,39
Mattersburg,2751,9,9,9,18,36,51,-15,36
St. Pölten,2751,10,5,8,23,34,72,-38,23
FC Salzburg,2752,1,21,8,7,64,30,34,71
SC Rheindorf,2752,2,20,8,8,52,39,13,68
Vienna,2752,3,20,3,13,63,57,6,63
SK Sturm Gra,2752,4,19,5,12,58,32,26,62
Rapid Vienna,2752,5,13,10,13,58,44,14,49
RZ Pellets W,2752,6,14,6,16,44,49,-5,48
Admira Wacke,2752,7,12,4,20,36,58,-22,40
St. Pölten,2752,8,10,8,18,45,65,-20,38
SV Josko Rie,2752,9,11,4,21,35,51,-16,37
Mattersburg,2752,10,8,8,20,34,64,-30,32
SK Sturm Gra,2753,1,22,6,8,57,32,25,72
FC Salzburg,2753,2,20,7,9,61,31,30,67
SC Rheindorf,2753,3,18,7,11,56,50,6,61
Vienna,2753,4,17,3,16,53,49,4,54
RZ Pellets W,2753,5,15,6,15,59,55,4,51
St. Pölten,2753,6,14,8,14,54,58,-4,50
Rapid Vienna,2753,7,11,12,13,45,39,6,45
Admira Wacke,2753,8,12,6,18,37,59,-22,42
SV Josko Rie,2753,9,10,5,21,38,63,-25,35
Mattersburg,2753,10,8,6,22,44,68,-24,30
SC Rheindorf,2754,1,21,8,7,60,40,20,71
FC Salzburg,2754,2,18,9,9,59,33,26,63
SK Sturm Gra,2754,3,17,9,10,54,32,22,60
Vienna,2754,4,17,8,11,62,52,10,59
Rapid Vienna,2754,5,15,10,11,64,46,18,55
RZ Pellets W,2754,6,11,9,16,41,52,-11,42
Admira Wacke,2754,7,11,7,18,35,61,-26,40
St. Pölten,2754,8,9,10,17,42,60,-18,37
Mattersburg,2754,9,9,9,18,34,52,-18,36
SV Josko Rie,2754,10,8,9,19,29,52,-23,33
FC Salzburg,2755,1,20,7,9,64,32,32,67
SC Rheindorf,2755,2,19,7,10,63,45,18,64
Rapid Vienna,2755,3,17,9,10,58,39,19,60
Vienna,2755,4,17,7,12,60,55,5,58
SK Sturm Gra,2755,5,17,6,13,54,41,13,57
SV Josko Rie,2755,6,14,5,17,40,47,-7,47
St. Pölten,2755,7,13,6,17,52,64,-12,45
Admira Wacke,2755,8,11,8,17,42,61,-19,41
RZ Pellets W,2755,9,10,10,16,47,61,-14,40
Mattersburg,2755,10,6,7,23,34,69,-35,25
SC Rheindorf,2756,1,20,8,8,61,37,24,68
SK Sturm Gra,2756,2,21,3,12,62,37,25,66
FC Salzburg,2756,3,19,7,10,69,39,30,64
Vienna,2756,4,18,8,10,67,52,15,62
Rapid Vienna,2756,5,12,11,13,52,42,10,47
RZ Pellets W,2756,6,12,10,14,49,59,-10,46
Admira Wacke,2756,7,13,4,19,30,65,-35,43
Mattersburg,2756,8,10,8,18,37,54,-17,38
St. Pölten,2756,9,7,13,16,45,63,-18,34
SV Josko Rie,2756,10,10,4,22,30,54,-24,34
FC Salzburg,2757,1,22,8,6,68,32,36,74
SK Sturm Gra,2757,2,22,5,9,65,35,30,71
SC Rheindorf,2757,3,19,6,11,54,37,17,63
Vienna,2757,4,16,9,11,58,48,10,57
Rapid Vienna,2757,5,15,11,10,57,39,18,56
RZ Pellets W,2757,6,13,7,16,48,56,-8,46
Admira Wacke,2757,7,13,6,17,37,58,-21,45
SV Josko Rie,2757,8,10,6,20,37,57,-20,36
St. Pölten,2757,9,7,8,21,39,72,-33,29
Mattersburg,2757,10,7,6,23,37,66,-29,27
SC Rheindorf,2758,1,22,8,6,59,38,21,74
FC Salzburg,2758,2,21,7,8,63,29,34,70
Vienna,2758,3,19,4,13,59,46,13,61
Rapid Vienna,2758,4,17,9,10,51,35,16,60
SK Sturm Gra,2758,5,17,5,14,47,36,11,56
RZ Pellets W,2758,6,12,10,14,54,57,-3,46
SV Josko Rie,2758,7,11,5,20,37,52,-15,38
Mattersburg,2758,8,8,10,18,33,51,-18,34
Admira Wacke,2758,9,10,4,22,30,60,-30,34
St. Pölten,2758,10,7,10,19,33,62,-29,31
FC Salzburg,2759,1,23,5,8,72,27,45,74
SK Sturm Gra,2759,2,20,6,10,61,33,28,66
SC Rheindorf,2759,3,19,8,9,52,38,14,65
Vienna,2759,4,18,6,12,57,55,2,60
Rapid Vienna,2759,5,12,9,15,50,50,0,45
RZ Pellets W,2759,6,11,10,15,44,52,-8,43
St. Pölten,2759,7,11,10,15,42,57,-15,43
Admira Wacke,2759,8,12,6,18,33,57,-24,42
Mattersburg,2759,9,8,10,18,37,55,-18,34
SV Josko Rie,2759,10,8,6,22,29,53,-24,30
FC Salzburg,2760,1,24,7,5,69,30,39,79
SK Sturm Gra,2760,2,21,4,11,67,40,27,67
SC Rheindorf,2760,3,20,7,9,61,46,15,67
Rapid Vienna,2760,4,16,10,10,66,41,25,58
Vienna,2760,5,15,5,16,57,61,-4,50
SV Josko Rie,2760,6,13,5,18,48,53,-5,44
RZ Pellets W,2760,7,10,8,18,51,61,-10,38
Admira Wacke,2760,8,10,7,19,38,63,-25,37
Mattersburg,2760,9,9,7,20,43,68,-25,34
St. Pölten,2760,10,8,8,20,41,78,-37,32
FC Salzburg,2761,1,24,5,7,72,24,48,77
SC Rheindorf,2761,2,21,5,10,54,35,19,68
Vienna,2761,3,19,3,14,62,51,11,60
SK Sturm Gra,2761,4,16,5,15,50,43,7,53
RZ Pellets W,2761,5,16,5,15,51,53,-2,53
Rapid Vienna,2761,6,14,8,14,51,40,11,50
Admira Wacke,2761,7,13,4,19,35,60,-25,43
SV Josko Rie,2761,8,12,5,19,35,53,-18,41
St. Pölten,2761,9,9,8,19,38,71,-33,35
Mattersburg,2761,10,8,8,20,35,53,-18,32
FC Salzburg,2762,1,21,7,8,62,33,29,70
SC Rheindorf,2762,2,18,8,10,54,40,14,62
SK Sturm Gra,2762,3,18,6,12,60,39,21,60
SV Josko Rie,2762,4,16,6,14,43,45,-2,54
Rapid Vienna,2762,5,14,11,11,56,42,14,53
Vienna,2762,6,15,6,15,58,61,-3,51
Admira Wacke,2762,7,12,7,17,36,55,-19,43
RZ Pellets W,2762,8,12,6,18,46,54,-8,42
St. Pölten,2762,9,8,11,17,39,60,-21,35
Mattersburg,2762,10,9,6,21,32,57,-25,33
FC Salzburg,2763,1,23,8,5,74,29,45,77
SK Sturm Gra,2763,2,19,6,11,57,36,21,63
SC Rheindorf,2763,3,17,11,8,52,42,10,62
Vienna,2763,4,18,5,13,58,53,5,59
Rapid Vienna,2763,5,12,12,12,47,40,7,48
RZ Pellets W,2763,6,13,6,17,51,59,-8,45
SV Josko Rie,2763,7,11,7,18,38,52,-14,40
Admira Wacke,2763,8,11,7,18,40,63,-23,40
St. Pölten,2763,9,9,10,17,40,59,-19,37
Mattersburg,2763,10,7,8,21,40,64,-24,29
FC Salzburg,2764,1,22,7,7,64,27,37,73
SC Rheindorf,2764,2,20,7,9,57,42,15,67
SK Sturm Gra,2764,3,17,7,12,61,37,24,58
Rapid Vienna,2764,4,16,8,12,55,42,13,56
Vienna,2764,5,16,6,14,54,53,1,54
RZ Pellets W,2764,6,13,6,17,41,53,-12,45
Mattersburg,2764,7,12,7,17,43,56,-13,43
Admira Wacke,2764,8,10,8,18,34,57,-23,38
St. Pölten,2764,9,9,9,18,37,57,-20,36
SV Josko Rie,2764,10,9,7,20,30,52,-22,34
FC Salzburg,2765,1,20,10,6,66,31,35,70
SK Sturm Gra,2765,2,18,9,9,63,40,23,63
SC Rheindorf,2765,3,16,11,9,52,40,12,59
Vienna,2765,4,17,8,11,68,57,11,59
RZ Pellets W,2765,5,15,8,13,50,54,-4,53
Rapid Vienna,2765,6,14,9,13,59,45,14,51
SV Josko Rie,2765,7,11,7,18,29,45,-16,40
St. Pölten,2765,8,9,9,18,39,66,-27,36
Admira Wacke,2765,9,9,8,19,39,63,-24,35
Mattersburg,2765,10,5,13,18,31,55,-24,28
FC Salzburg,2766,1,21,7,8,63,32,31,70
Vienna,2766,2,21,7,8,69,47,22,70
SC Rheindorf,2766,3,21,7,8,61,48,13,70
SK Sturm Gra,2766,4,18,8,10,59,31,28,62
Rapid Vienna,2766,5,14,8,14,49,43,6,50
RZ Pellets W,2766,6,13,9,14,49,54,-5,48
Admira Wacke,2766,7,13,6,17,41,58,-17,45
St. Pölten,2766,8,8,12,16,37,56,-19,36
SV Josko Rie,2766,9,7,5,24,27,57,-30,26
Mattersburg,2766,10,5,9,22,34,63,-29,24
SK Sturm Gra,2767,1,20,7,9,64,35,29,67
Vienna,2767,2,19,5,12,68,54,14,62
FC Salzburg,2767,3,17,8,11,59,37,22,59
SC Rheindorf,2767,4,16,8,12,49,45,4,56
Rapid Vienna,2767,5,12,12,12,60,45,15,48
Admira Wacke,2767,6,14,6,16,43,59,-16,48
RZ Pellets W,2767,7,12,9,15,43,57,-14,45
St. Pölten,2767,8,11,10,15,47,58,-11,43
Mattersburg,2767,9,9,10,17,39,59,-20,37
SV Josko Rie,2767,10,9,7,20,35,58,-23,34
SC Rheindorf,2768,1,24,5,7,62,36,26,77
FC Salzburg,2768,2,21,8,7,70,29,41,71
Vienna,2768,3,20,5,11,65,55,10,65
SK Sturm Gra,2768,4,18,8,10,62,34,28,62
RZ Pellets W,2768,5,13,5,18,47,62,-15,44
Rapid Vienna,2768,6,10,12,14,49,46,3,42
Mattersburg,2768,7,10,8,18,40,57,-17,38
SV Josko Rie,2768,8,10,7,19,35,52,-17,37
Admira Wacke,2768,9,10,6,20,32,61,-29,36
St. Pölten,2768,10,6,12,18,39,69,-30,30
FC Salzburg,2769,1,20,11,5,70,29,41,71
SC Rheindorf,2769,2,21,7,8,57,40,17,70
Vienna,2769,3,19,5,12,62,53,9,62
SK Sturm Gra,2769,4,18,7,11,53,34,19,61
RZ Pellets W,2769,5,14,8,14,47,49,-2,50
Admira Wacke,2769,6,15,4,17,38,52,-14,49
Rapid Vienna,2769,7,12,11,13,47,39,8,47
SV Josko Rie,2769,8,9,6,21,33,57,-24,33
St. Pölten,2769,9,6,14,16,33,56,-23,32
Mattersburg,2769,10,4,11,21,30,61,-31,23
FC Salzburg,2770,1,22,8,6,62,24,38,74
SC Rheindorf,2770,2,20,6,10,53,42,11,66
SK Sturm Gra,2770,3,18,6,12,53,32,21,60
Vienna,2770,4,17,5,14,57,51,6,56
Rapid Vienna,2770,5,13,11,12,57,41,16,50
RZ Pellets W,2770,6,14,7,15,47,55,-8,49
Admira Wacke,2770,7,11,9,16,40,60,-20,42
Mattersburg,2770,8,11,8,17,42,53,-11,41
SV Josko Rie,2770,9,10,5,21,31,57,-26,35
St. Pölten,2770,10,7,9,20,42,69,-27,30
SC Rheindorf,2771,1,23,8,5,63,36,27,77
FC Salzburg,2771,2,19,7,10,63,36,27,64
SK Sturm Gra,2771,3,18,9,9,53,30,23,63
Vienna,2771,4,17,5,14,57,47,10,56
Rapid Vienna,2771,5,13,10,13,51,40,11,49
Admira Wacke,2771,6,12,9,15,39,54,-15,45
SV Josko Rie,2771,7,11,8,17,38,52,-14,41
Mattersburg,2771,8,11,7,18,39,52,-13,40
RZ Pellets W,2771,9,9,7,20,38,65,-27,34
St. Pölten,2771,10,7,10,19,37,66,-29,31
FC Salzburg,2772,1,20,9,7,62,34,28,69
SK Sturm Gra,2772,2,19,9,8,56,28,28,66
Vienna,2772,3,19,6,11,64,47,17,63
SC Rheindorf,2772,4,18,8,10,56,43,13,62
Rapid Vienna,2772,5,15,12,9,54,36,18,57
RZ Pellets W,2772,6,13,12,11,45,47,-2,51
Admira Wacke,2772,7,11,7,18,29,52,-23,40
SV Josko Rie,2772,8,10,3,23,33,59,-26,33
Mattersburg,2772,9,6,10,20,36,61,-25,28
St. Pölten,2772,10,5,12,19,33,61,-28,27
SC Rheindorf,2773,1,21,6,9,62,38,24,69
FC Salzburg,2773,2,20,8,8,64,34,30,68
SK Sturm Gra,2773,3,19,4,13,54,35,19,61
Rapid Vienna,2773,4,16,10,10,59,36,23,58
Vienna,2773,5,17,6,13,63,57,6,57
RZ Pellets W,2773,6,11,8,17,38,56,-18,41
SV Josko Rie,2773,7,11,7,18,35,55,-20,40
Admira Wacke,2773,8,10,9,17,38,62,-24,39
Mattersburg,2773,9,9,9,18,41,55,-14,36
St. Pölten,2773,10,9,7,20,38,64,-26,34
FC Salzburg,2774,1,22,9,5,72,25,47,75
SC Rheindorf,2774,2,20,6,10,64,43,21,66
SK Sturm Gra,2774,3,18,9,9,60,32,28,63
Vienna,2774,4,18,5,13,61,53,8,59
Rapid Vienna,2774,5,17,7,12,58,38,20,58
RZ Pellets W,2774,6,12,9,15,41,51,-10,45
SV Josko Rie,2774,7,12,2,22,34,62,-28,38
Admira Wacke,2774,8,11,5,20,35,65,-30,38
Mattersburg,2774,9,9,8,19,37,61,-24,35
St. Pölten,2774,10,5,12,19,37,69,-32,27
FC Salzburg,2775,1,25,4,7,77,29,48,79
Vienna,2775,2,20,6,10,67,51,16,66
SC Rheindorf,2775,3,19,6,11,50,44,6,63
SK Sturm Gra,2775,4,16,7,13,54,36,18,55
St. Pölten,2775,5,14,7,15,48,53,-5,49
Rapid Vienna,2775,6,12,10,14,48,48,0,46
SV Josko Rie,2775,7,13,3,20,36,51,-15,42
Admira Wacke,2775,8,11,8,17,35,57,-22,41
RZ Pellets W,2775,9,10,5,21,37,63,-26,35
Mattersburg,2775,10,7,10,19,32,52,-20,31
FC Salzburg,2776,1,23,7,6,66,31,35,76
SC Rheindorf,2776,2,21,5,10,54,43,11,68
Vienna,2776,3,19,6,11,62,47,15,63
SK Sturm Gra,2776,4,17,6,13,58,42,16,57
Rapid Vienna,2776,5,15,11,10,52,33,19,56
RZ Pellets W,2776,6,12,7,17,46,52,-6,43
Admira Wacke,2776,7,12,4,20,44,65,-21,40
St. Pölten,2776,8,9,9,18,39,59,-20,36
Mattersburg,2776,9,9,7,20,36,60,-24,34
SV Josko Rie,2776,10,10,4,22,32,57,-25,34
SK Sturm Gra,2777,1,22,5,9,60,30,30,71
FC Salzburg,2777,2,21,5,10,56,26,30,68
Vienna,2777,3,19,4,13,60,50,10,61
SC Rheindorf,2777,4,17,7,12,51,42,9,58
Rapid Vienna,2777,5,14,10,12,50,38,12,52
RZ Pellets W,2777,6,11,9,16,44,57,-13,42
Admira Wacke,2777,7,12,5,19,38,57,-19,41
Mattersburg,2777,8,10,9,17,37,54,-17,39
SV Josko Rie,2777,9,9,9,18,32,51,-19,36
St. Pölten,2777,10,8,11,17,35,58,-23,35
SC Rheindorf,2778,1,23,6,7,66,40,26,75
FC Salzburg,2778,2,22,7,7,65,29,36,73
SK Sturm Gra,2778,3,19,5,12,56,35,21,62
Vienna,2778,4,19,5,12,61,51,10,62
Rapid Vienna,2778,5,15,9,12,61,47,14,54
St. Pölten,2778,6,11,8,17,47,67,-20,41
Admira Wacke,2778,7,10,9,17,38,61,-23,39
SV Josko Rie,2778,8,11,4,21,32,50,-18,37
RZ Pellets W,2778,9,10,7,19,41,60,-19,37
Mattersburg,2778,10,7,6,23,34,61,-27,27
FC Salzburg,2779,1,22,6,8,66,26,40,72
SC Rheindorf,2779,2,21,6,9,64,42,22,69
SK Sturm Gra,2779,3,21,5,10,57,35,22,68
Vienna,2779,4,18,5,13,59,53,6,59
Rapid Vienna,2779,5,14,8,14,65,43,22,50
Admira Wacke,2779,6,15,3,18,33,58,-25,48
RZ Pellets W,2779,7,12,8,16,39,50,-11,44
St. Pölten,2779,8,11,8,17,43,61,-18,41
SV Josko Rie,2779,9,9,4,23,28,56,-28,31
Mattersburg,2779,10,6,9,21,33,63,-30,27
SK Sturm Gra,2780,1,21,6,9,64,34,30,69
SC Rheindorf,2780,2,19,9,8,57,44,13,66
FC Salzburg,2780,3,18,11,7,55,28,27,65
Vienna,2780,4,17,7,12,61,54,7,58
Rapid Vienna,2780,5,11,14,11,50,44,6,47
RZ Pellets W,2780,6,11,11,14,46,56,-10,44
Mattersburg,2780,7,10,10,16,46,55,-9,40
St. Pölten,2780,8,9,10,17,42,62,-20,37
Admira Wacke,2780,9,9,8,19,32,55,-23,35
SV Josko Rie,2780,10,9,6,21,37,58,-21,33
FC Salzburg,2781,1,21,8,7,67,37,30,71
SC Rheindorf,2781,2,20,9,7,58,34,24,69
SK Sturm Gra,2781,3,20,5,11,59,31,28,65
Vienna,2781,4,19,6,11,63,58,5,63
Rapid Vienna,2781,5,11,14,11,54,43,11,47
Mattersburg,2781,6,10,10,16,37,49,-12,40
RZ Pellets W,2781,7,9,12,15,35,52,-17,39
Admira Wacke,2781,8,10,6,20,32,59,-27,36
St. Pölten,2781,9,8,11,17,37,59,-22,35
SV Josko Rie,2781,10,9,5,22,26,46,-20,32
Vienna,2782,1,22,5,9,69,43,26,71
FC Salzburg,2782,2,21,5,10,64,34,30,68
SK Sturm Gra,2782,3,21,4,11,65,35,30,67
SC Rheindorf,2782,4,17,7,12,46,44,2,58
Rapid Vienna,2782,5,12,11,13,46,39,7,47
RZ Pellets W,2782,6,13,8,15,45,52,-7,47
Admira Wacke,2782,7,12,8,16,37,58,-21,44
SV Josko Rie,2782,8,13,4,19,34,46,-12,43
Mattersburg,2782,9,9,9,18,38,59,-21,36
St. Pölten,2782,10,6,7,23,31,65,-34,25
FC Salzburg,2783,1,21,7,8,68,34,34,70
SC Rheindorf,2783,2,20,10,6,63,42,21,70
SK Sturm Gra,2783,3,19,6,11,66,44,22,63
Vienna,2783,4,16,9,11,64,55,9,57
Rapid Vienna,2783,5,14,12,10,57,43,14,54
Admira Wacke,2783,6,13,8,15,42,59,-17,47
RZ Pellets W,2783,7,10,10,16,45,60,-15,40
Mattersburg,2783,8,9,8,19,42,62,-20,35
SV Josko Rie,2783,9,9,5,22,32,56,-24,32
St. Pölten,2783,10,6,11,19,43,67,-24,29
FC Salzburg,2784,1,21,10,5,69,33,36,73
SC Rheindorf,2784,2,21,9,6,66,38,28,72
Vienna,2784,3,18,5,13,63,54,9,59
SK Sturm Gra,2784,4,16,10,10,61,37,24,58
Rapid Vienna,2784,5,14,14,8,58,37,21,56
SV Josko Rie,2784,6,12,5,19,35,51,-16,41
RZ Pellets W,2784,7,10,8,18,41,61,-20,38
Admira Wacke,2784,8,9,10,17,35,66,-31,37
St. Pölten,2784,9,6,13,17,39,65,-26,31
Mattersburg,2784,10,5,12,19,36,61,-25,27
FC Salzburg,2785,1,21,7,8,65,32,33,70
SC Rheindorf,2785,2,18,7,11,49,43,6,61
Vienna,2785,3,16,6,14,53,49,4,54
Rapid Vienna,2785,4,13,13,10,60,42,18,52
SK Sturm Gra,2785,5,14,10,12,51,36,15,52
Mattersburg,2785,6,13,8,15,37,45,-8,47
SV Josko Rie,2785,7,13,7,16,34,42,-8,46
Admira Wacke,2785,8,12,8,16,34,53,-19,44
RZ Pellets W,2785,9,11,7,18,45,63,-18,40
St. Pölten,2785,10,8,9,19,35,58,-23,33
FC Salzburg,2786,1,22,6,8,65,29,36,72
SC Rheindorf,2786,2,21,7,8,51,40,11,70
Vienna,2786,3,21,5,10,68,44,24,68
SK Sturm Gra,2786,4,19,7,10,57,30,27,64
Rapid Vienna,2786,5,17,10,9,66,35,31,61
RZ Pellets W,2786,6,11,9,16,46,63,-17,42
SV Josko Rie,2786,7,10,5,21,32,52,-20,35
Admira Wacke,2786,8,10,5,21,30,61,-31,35
Mattersburg,2786,9,8,8,20,35,66,-31,32
St. Pölten,2786,10,5,10,21,32,62,-30,25
SK Sturm Gra,2787,1,20,6,10,62,37,25,66
SC Rheindorf,2787,2,19,8,9,52,41,11,65
FC Salzburg,2787,3,19,5,12,63,35,28,62
Vienna,2787,4,18,5,13,57,48,9,59
Rapid Vienna,2787,5,13,13,10,49,37,12,52
Admira Wacke,2787,6,14,5,17,38,55,-17,47
RZ Pellets W,2787,7,12,5,19,48,57,-9,41
SV Josko Rie,2787,8,12,5,19,41,60,-19,41
Mattersburg,2787,9,11,7,18,40,56,-16,40
St. Pölten,2787,10,8,9,19,41,65,-24,33
FC Salzburg,2788,1,22,6,8,65,31,34,72
SC Rheindorf,2788,2,21,9,6,60,37,23,72
SK Sturm Gra,2788,3,19,7,10,60,32,28,64
Vienna,2788,4,17,5,14,61,52,9,56
SV Josko Rie,2788,5,14,7,15,44,43,1,49
Admira Wacke,2788,6,14,7,15,32,49,-17,49
Rapid Vienna,2788,7,12,9,15,48,45,3,45
RZ Pellets W,2788,8,10,9,17,45,66,-21,39
St. Pölten,2788,9,7,9,20,41,71,-30,30
Mattersburg,2788,10,7,6,23,38,68,-30,27
FC Salzburg,2789,1,21,8,7,59,24,35,71
Vienna,2789,2,19,5,12,64,48,16,62
SC Rheindorf,2789,3,18,8,10,51,40,11,62
Rapid Vienna,2789,4,16,11,9,54,32,22,59
SK Sturm Gra,2789,5,16,6,14,51,39,12,54
RZ Pellets W,2789,6,13,7,16,44,52,-8,46
Admira Wacke,2789,7,10,8,18,35,56,-21,38
St. Pölten,2789,8,7,15,14,37,60,-23,36
SV Josko Rie,2789,9,9,8,19,32,54,-22,35
Mattersburg,2789,10,8,10,18,33,55,-22,34
Vienna,2790,1,22,3,11,60,42,18,69
FC Salzburg,2790,2,20,8,8,63,32,31,68
SC Rheindorf,2790,3,20,5,11,58,50,8,65
SK Sturm Gra,2790,4,17,6,13,53,39,14,57
Rapid Vienna,2790,5,13,14,9,52,39,13,53
RZ Pellets W,2790,6,14,6,16,53,55,-2,48
Admira Wacke,2790,7,13,6,17,34,54,-20,45
Mattersburg,2790,8,10,8,18,46,60,-14,38
St. Pölten,2790,9,9,8,19,44,63,-19,35
SV Josko Rie,2790,10,8,4,24,28,57,-29,28
FC Salzburg,2791,1,22,6,8,74,33,41,72
SC Rheindorf,2791,2,18,9,9,49,42,7,63
Rapid Vienna,2791,3,15,12,9,58,39,19,57
Vienna,2791,4,17,6,13,58,47,11,57
SK Sturm Gra,2791,5,16,8,12,52,36,16,56
RZ Pellets W,2791,6,12,9,15,45,54,-9,45
SV Josko Rie,2791,7,11,9,16,35,47,-12,42
Admira Wacke,2791,8,11,8,17,39,66,-27,41
Mattersburg,2791,9,6,13,17,37,55,-18,31
St. Pölten,2791,10,7,10,19,35,63,-28,31
FC Salzburg,2792,1,22,6,8,73,33,40,72
SK Sturm Gra,2792,2,21,6,9,65,34,31,69
SC Rheindorf,2792,3,20,9,7,56,39,17,69
Vienna,2792,4,18,2,16,58,59,-1,56
SV Josko Rie,2792,5,14,6,16,36,45,-9,48
Mattersburg,2792,6,13,6,17,36,49,-13,45
RZ Pellets W,2792,7,12,8,16,52,60,-8,44
Admira Wacke,2792,8,12,6,18,38,58,-20,42
Rapid Vienna,2792,9,10,10,16,44,47,-3,40
St. Pölten,2792,10,5,7,24,33,67,-34,22
SC Rheindorf,2793,1,21,8,7,58,45,13,71
FC Salzburg,2793,2,21,7,8,68,31,37,70
SK Sturm Gra,2793,3,18,7,11,54,32,22,61
Rapid Vienna,2793,4,16,10,10,60,35,25,58
Vienna,2793,5,16,4,16,54,58,-4,52
RZ Pellets W,2793,6,13,8,15,45,53,-8,47
SV Josko Rie,2793,7,11,6,19,36,53,-17,39
Mattersburg,2793,8,9,10,17,35,48,-13,37
Admira Wacke,2793,9,10,7,19,36,65,-29,37
St. Pölten,2793,10,7,9,20,37,63,-26,30
SC Rheindorf,2794,1,21,9,6,55,33,22,72
FC Salzburg,2794,2,19,10,7,67,32,35,67
Vienna,2794,3,19,4,13,56,49,7,61
SK Sturm Gra,2794,4,16,8,12,60,42,18,56
RZ Pellets W,2794,5,13,11,12,53,52,1,50
Rapid Vienna,2794,6,10,14,12,54,47,7,44
St. Pölten,2794,7,11,9,16,53,67,-14,42
Admira Wacke,2794,8,11,8,17,38,60,-22,41
SV Josko Rie,2794,9,9,7,20,31,58,-27,34
Mattersburg,2794,10,6,10,20,37,64,-27,28
Vienna,2795,1,23,3,10,66,41,25,72
SK Sturm Gra,2795,2,21,5,10,64,33,31,68
SC Rheindorf,2795,3,20,7,9,55,41,14,67
FC Salzburg,2795,4,20,5,11,60,34,26,65
RZ Pellets W,2795,5,13,7,16,44,52,-8,46
Admira Wacke,2795,6,13,5,18,34,56,-22,44
Rapid Vienna,2795,7,10,11,15,49,52,-3,41
St. Pölten,2795,8,9,9,18,47,66,-19,36
Mattersburg,2795,9,8,10,18,31,53,-22,34
SV Josko Rie,2795,10,9,6,21,32,54,-22,33
FC Salzburg,2796,1,22,8,6,70,32,38,74
SC Rheindorf,2796,2,19,8,9,50,43,7,65
SK Sturm Gra,2796,3,18,6,12,61,41,20,60
Vienna,2796,4,18,5,13,70,53,17,59
Rapid Vienna,2796,5,14,12,10,65,49,16,54
Mattersburg,2796,6,12,8,16,44,54,-10,44
RZ Pellets W,2796,7,11,8,17,47,57,-10,41
SV Josko Rie,2796,8,11,5,20,36,57,-21,38
Admira Wacke,2796,9,11,4,21,39,67,-28,37
St. Pölten,2796,10,6,12,18,35,64,-29,30
FC Salzburg,2797,1,23,6,7,65,27,38,75
SC Rheindorf,2797,2,21,7,8,63,42,21,70
SK Sturm Gra,2797,3,18,6,12,61,38,23,60
Rapid Vienna,2797,4,16,10,10,58,34,24,58
Vienna,2797,5,18,4,14,62,51,11,58
RZ Pellets W,2797,6,13,7,16,49,57,-8,46
Admira Wacke,2797,7,13,3,20,41,69,-28,42
SV Josko Rie,2797,8,11,3,22,36,60,-24,36
Mattersburg,2797,9,9,7,20,37,61,-24,34
St. Pölten,2797,10,7,9,20,40,73,-33,30
FC Salzburg,2798,1,22,8,6,71,31,40,74
SK Sturm Gra,2798,2,21,6,9,59,33,26,69
SC Rheindorf,2798,3,18,7,11,53,42,11,61
Vienna,2798,4,16,6,14,59,54,5,54
Rapid Vienna,2798,5,14,11,11,55,38,17,53
SV Josko Rie,2798,6,15,4,17,45,50,-5,49
Admira Wacke,2798,7,12,7,17,40,62,-22,43
RZ Pellets W,2798,8,12,6,18,42,59,-17,42
Mattersburg,2798,9,7,9,20,32,58,-26,30
St. Pölten,2798,10,7,8,21,35,64,-29,29
FC Salzburg,2799,1,17,13,6,61,30,31,64
SK Sturm Gra,2799,2,18,8,10,56,33,23,62
SC Rheindorf,2799,3,17,11,8,50,37,13,62
Vienna,2799,4,16,7,13,66,57,9,55
Rapid Vienna,2799,5,12,14,10,51,37,14,50
Mattersburg,2799,6,11,11,14,42,51,-9,44
Admira Wacke,2799,7,11,9,16,42,63,-21,42
RZ Pellets W,2799,8,10,9,17,44,63,-19,39
St. Pölten,2799,9,9,10,17,46,64,-18,37
SV Josko Rie,2799,10,10,6,20,33,56,-23,36
SK Sturm Gra,2800,1,21,4,11,59,38,21,67
Vienna,2800,2,20,5,11,70,52,18,65
FC Salzburg,2800,3,18,10,8,64,36,28,64
SC Rheindorf,2800,4,18,7,11,54,44,10,61
SV Josko Rie,2800,5,13,6,17,37,48,-11,45
RZ Pellets W,2800,6,13,6,17,43,56,-13,45
Rapid Vienna,2800,7,10,13,13,58,49,9,43
St. Pölten,2800,8,11,8,17,41,56,-15,41
Admira Wacke,2800,9,10,7,19,38,61,-23,37
Mattersburg,2800,10,9,8,19,35,59,-24,35
FC Salzburg,2801,1,23,7,6,66,29,37,76
SC Rheindorf,2801,2,20,9,7,54,40,14,69
SK Sturm Gra,2801,3,21,4,11,60,38,22,67
Vienna,2801,4,20,5,11,75,47,28,65
RZ Pellets W,2801,5,15,6,15,51,54,-3,51
Rapid Vienna,2801,6,12,9,15,53,51,2,45
Admira Wacke,2801,7,12,8,16,37,56,-19,44
St. Pölten,2801,8,8,9,19,37,63,-26,33
Mattersburg,2801,9,7,7,22,29,53,-24,28
SV Josko Rie,2801,10,8,4,24,31,62,-31,28
SC Rheindorf,2802,1,22,6,8,64,35,29,72
SK Sturm Gra,2802,2,21,5,10,60,33,27,68
Vienna,2802,3,21,5,10,67,47,20,68
FC Salzburg,2802,4,20,6,10,58,32,26,66
Rapid Vienna,2802,5,13,11,12,50,35,15,50
Admira Wacke,2802,6,13,7,16,40,53,-13,46
SV Josko Rie,2802,7,12,4,20,33,58,-25,40
RZ Pellets W,2802,8,9,8,19,41,64,-23,35
Mattersburg,2802,9,7,10,19,35,59,-24,31
St. Pölten,2802,10,6,10,20,36,68,-32,28
Vienna,2803,1,22,6,8,72,45,27,72
SC Rheindorf,2803,2,21,6,9,62,47,15,69
FC Salzburg,2803,3,20,8,8,62,31,31,68
SK Sturm Gra,2803,4,18,7,11,60,35,25,61
RZ Pellets W,2803,5,14,10,12,51,48,3,52
Rapid Vienna,2803,6,12,13,11,52,40,12,49
SV Josko Rie,2803,7,11,2,23,34,59,-25,35
Admira Wacke,2803,8,9,6,21,33,65,-32,33
St. Pölten,2803,9,7,11,18,39,65,-26,32
Mattersburg,2803,10,7,9,20,33,63,-30,30
FC Salzburg,2804,1,20,11,5,61,29,32,71
SC Rheindorf,2804,2,19,8,9,61,45,16,65
SK Sturm Gra,2804,3,19,7,10,64,40,24,64
Vienna,2804,4,17,4,15,66,55,11,55
Rapid Vienna,2804,5,12,10,14,56,46,10,46
RZ Pellets W,2804,6,13,6,17,45,62,-17,45
Admira Wacke,2804,7,12,8,16,37,57,-20,44
St. Pölten,2804,8,10,9,17,48,63,-15,39
Mattersburg,2804,9,8,11,17,37,56,-19,35
SV Josko Rie,2804,10,9,8,19,29,51,-22,35
FC Salzburg,2805,1,23,7,6,76,34,42,76
SC Rheindorf,2805,2,20,11,5,58,36,22,71
SK Sturm Gra,2805,3,19,6,11,52,33,19,63
Vienna,2805,4,18,5,13,55,52,3,59
Admira Wacke,2805,5,14,6,16,41,55,-14,48
St. Pölten,2805,6,10,10,16,40,55,-15,40
Rapid Vienna,2805,7,9,12,15,44,44,0,39
SV Josko Rie,2805,8,10,7,19,35,50,-15,37
RZ Pellets W,2805,9,9,9,18,37,56,-19,36
Mattersburg,2805,10,6,11,19,33,56,-23,29
FC Salzburg,2806,1,25,5,6,70,30,40,80
Vienna,2806,2,21,4,11,68,47,21,67
SC Rheindorf,2806,3,20,5,11,59,42,17,65
SK Sturm Gra,2806,4,19,6,11,58,39,19,63
Rapid Vienna,2806,5,15,8,13,47,37,10,53
RZ Pellets W,2806,6,13,8,15,48,53,-5,47
Admira Wacke,2806,7,12,7,17,36,53,-17,43
St. Pölten,2806,8,9,9,18,40,61,-21,36
SV Josko Rie,2806,9,8,5,23,29,59,-30,29
Mattersburg,2806,10,6,7,23,30,64,-34,25
SC Rheindorf,2807,1,23,7,6,61,33,28,76
FC Salzburg,2807,2,22,7,7,78,31,47,73
SK Sturm Gra,2807,3,17,6,13,51,39,12,57
Vienna,2807,4,18,3,15,63,54,9,57
Rapid Vienna,2807,5,12,12,12,51,39,12,48
RZ Pellets W,2807,6,12,8,16,47,60,-13,44
Admira Wacke,2807,7,11,9,16,39,58,-19,42
SV Josko Rie,2807,8,10,6,20,37,58,-21,36
Mattersburg,2807,9,8,12,16,33,54,-21,36
St. Pölten,2807,10,8,8,20,41,75,-34,32
SC Rheindorf,2808,1,20,10,6,55,42,13,70
FC Salzburg,2808,2,19,10,7,65,38,27,67
Vienna,2808,3,20,3,13,69,52,17,63
SK Sturm Gra,2808,4,17,9,10,57,33,24,60
Rapid Vienna,2808,5,16,10,10,59,38,21,58
RZ Pellets W,2808,6,13,7,16,44,54,-10,46
SV Josko Rie,2808,7,11,4,21,32,53,-21,37
Admira Wacke,2808,8,9,7,20,36,63,-27,34
Mattersburg,2808,9,7,11,18,33,56,-23,32
St. Pölten,2808,10,6,13,17,38,59,-21,31
FC Salzburg,2809,1,25,5,6,67,25,42,80
Vienna,2809,2,21,6,9,68,46,22,69
SC Rheindorf,2809,3,19,7,10,52,47,5,64
SK Sturm Gra,2809,4,18,3,15,62,35,27,57
Rapid Vienna,2809,5,15,9,12,56,36,20,54
Admira Wacke,2809,6,13,5,18,39,63,-24,44
St. Pölten,2809,7,11,10,15,50,66,-16,43
RZ Pellets W,2809,8,11,6,19,46,67,-21,39
SV Josko Rie,2809,9,9,7,20,34,54,-20,34
Mattersburg,2809,10,6,6,24,30,65,-35,24
FC Salzburg,2810,1,20,10,6,66,30,36,70
SK Sturm Gra,2810,2,19,6,11,60,38,22,63
SC Rheindorf,2810,3,19,5,12,55,44,11,62
Vienna,2810,4,19,2,15,60,52,8,59
Rapid Vienna,2810,5,14,12,10,52,37,15,54
RZ Pellets W,2810,6,14,5,17,48,57,-9,47
Mattersburg,2810,7,12,6,18,46,55,-9,42
Admira Wacke,2810,8,11,6,19,39,67,-28,39
SV Josko Rie,2810,9,10,6,20,39,58,-19,36
St. Pölten,2810,10,9,8,19,42,69,-27,35
SC Rheindorf,2811,1,21,7,8,50,38,12,70
FC Salzburg,2811,2,20,8,8,68,31,37,68
SK Sturm Gra,2811,3,19,8,9,62,34,28,65
RZ Pellets W,2811,4,16,6,14,52,54,-2,54
Rapid Vienna,2811,5,14,11,11,63,47,16,53
Vienna,2811,6,16,4,16,61,58,3,52
SV Josko Rie,2811,7,12,3,21,35,56,-21,39
Admira Wacke,2811,8,10,7,19,36,57,-21,37
St. Pölten,2811,9,8,10,18,37,66,-29,34
Mattersburg,2811,10,9,6,21,36,59,-23,33
SK Sturm Gra,2812,1,20,7,9,65,35,30,67
FC Salzburg,2812,2,20,6,10,58,34,24,66
SC Rheindorf,2812,3,17,8,11,53,40,13,59
Vienna,2812,4,18,4,14,57,50,7,58
Admira Wacke,2812,5,16,5,15,43,50,-7,53
Rapid Vienna,2812,6,14,9,13,53,45,8,51
RZ Pellets W,2812,7,12,8,16,38,48,-10,44
SV Josko Rie,2812,8,12,5,19,38,54,-16,41
St. Pölten,2812,9,9,8,19,42,67,-25,35
Mattersburg,2812,10,9,6,21,36,60,-24,33
FC Salzburg,2813,1,19,10,7,56,26,30,67
Vienna,2813,2,19,6,11,54,43,11,63
SC Rheindorf,2813,3,16,10,10,43,37,6,58
SK Sturm Gra,2813,4,16,8,12,53,31,22,56
Rapid Vienna,2813,5,15,10,11,60,37,23,55
RZ Pellets W,2813,6,15,7,14,44,49,-5,52
St. Pölten,2813,7,11,8,17,39,64,-25,41
SV Josko Rie,2813,8,11,7,18,31,45,-14,40
Admira Wacke,2813,9,9,9,18,31,57,-26,36
Mattersburg,2813,10,8,7,21,33,55,-22,31
FC Salzburg,2814,1,25,4,7,69,23,46,79
SK Sturm Gra,2814,2,18,7,11,61,40,21,61
Vienna,2814,3,18,6,12,69,57,12,60
SC Rheindorf,2814,4,17,9,10,50,41,9,60
Rapid Vienna,2814,5,14,10,12,50,40,10,52
RZ Pellets W,2814,6,13,7,16,48,59,-11,46
Mattersburg,2814,7,11,7,18,39,56,-17,40
Admira Wacke,2814,8,10,8,18,36,59,-23,38
SV Josko Rie,2814,9,10,6,20,29,52,-23,36
St. Pölten,2814,10,7,10,19,39,63,-24,31
FC Salzburg,2815,1,21,8,7,64,30,34,71
SK Sturm Gra,2815,2,18,9,9,68,42,26,63
Rapid Vienna,2815,3,18,7,11,61,39,22,61
SC Rheindorf,2815,4,17,9,10,56,47,9,60
Vienna,2815,5,17,6,13,66,54,12,57
Admira Wacke,2815,6,12,8,16,43,55,-12,44
RZ Pellets W,2815,7,10,12,14,47,61,-14,42
SV Josko Rie,2815,8,11,4,21,31,60,-29,37
St. Pölten,2815,9,8,9,19,40,68,-28,33
Mattersburg,2815,10,7,10,19,38,58,-20,31
FC Salzburg,2816,1,21,5,10,68,42,26,68
SK Sturm Gra,2816,2,20,5,11,61,42,19,65
SC Rheindorf,2816,3,18,10,8,60,45,15,64
Vienna,2816,4,19,4,13,61,53,8,61
Rapid Vienna,2816,5,14,10,12,55,40,15,52
RZ Pellets W,2816,6,14,7,15,45,47,-2,49
Admira Wacke,2816,7,14,4,18,44,54,-10,46
SV Josko Rie,2816,8,10,8,18,38,52,-14,38
St. Pölten,2816,9,8,8,20,43,75,-32,32
Mattersburg,2816,10,8,7,21,37,62,-25,31
SK Sturm Gra,2817,1,23,4,9,73,33,40,73
SC Rheindorf,2817,2,20,9,7,55,42,13,69
FC Salzburg,2817,3,19,9,8,74,37,37,66
Vienna,2817,4,19,6,11,67,57,10,63
Rapid Vienna,2817,5,13,11,12,52,45,7,50
RZ Pellets W,2817,6,13,5,18,42,57,-15,44
Admira Wacke,2817,7,11,6,19,37,59,-22,39
Mattersburg,2817,8,9,9,18,41,59,-18,36
SV Josko Rie,2817,9,9,5,22,31,59,-28,32
St. Pölten,2817,10,7,10,19,39,63,-24,31
SC Rheindorf,2818,1,21,10,5,55,29,26,73
SK Sturm Gra,2818,2,19,9,8,55,29,26,66
Vienna,2818,3,20,6,10,60,42,18,66
FC Salzburg,2818,4,19,8,9,58,34,24,65
Rapid Vienna,2818,5,13,11,12,48,34,14,50
Admira Wacke,2818,6,10,10,16,31,53,-22,40
SV Josko Rie,2818,7,9,8,19,31,49,-18,35
RZ Pellets W,2818,8,10,5,21,34,56,-22,35
Mattersburg,2818,9,8,10,18,34,55,-21,34
St. Pölten,2818,10,9,7,20,38,63,-25,34
FC Salzburg,2819,1,19,10,7,70,37,33,67
SC Rheindorf,2819,2,19,9,8,52,39,13,66
SK Sturm Gra,2819,3,18,7,11,55,38,17,61
Vienna,2819,4,19,3,14,63,53,10,60
Rapid Vienna,2819,5,14,10,12,61,45,16,52
Admira Wacke,2819,6,13,6,17,37,52,-15,45
RZ Pellets W,2819,7,11,8,17,44,61,-17,41
St. Pölten,2819,8,9,11,16,44,64,-20,38
Mattersburg,2819,9,9,9,18,38,55,-17,36
SV Josko Rie,2819,10,9,7,20,34,54,-20,34
FC Salzburg,2820,1,21,8,7,65,28,37,71
SC Rheindorf,2820,2,19,8,9,52,42,10,65
SK Sturm Gra,2820,3,19,7,10,58,30,28,64
Vienna,2820,4,18,5,13,58,46,12,59
Admira Wacke,2820,5,14,7,15,47,56,-9,49
Rapid Vienna,2820,6,12,11,13,49,43,6,47
RZ Pellets W,2820,7,12,8,16,41,53,-12,44
SV Josko Rie,2820,8,12,4,20,36,61,-25,40
St. Pölten,2820,9,10,7,19,41,61,-20,37
Mattersburg,2820,10,6,9,21,30,57,-27,27
SC Rheindorf,2821,1,21,8,7,55,35,20,71
FC Salzburg,2821,2,19,9,8,61,37,24,66
SK Sturm Gra,2821,3,18,10,8,57,28,29,64
Vienna,2821,4,17,5,14,60,56,4,56
Rapid Vienna,2821,5,13,12,11,56,37,19,51
RZ Pellets W,2821,6,12,13,11,44,44,0,49
Admira Wacke,2821,7,13,5,18,39,63,-24,44
Mattersburg,2821,8,9,10,17,37,52,-15,37
St. Pölten,2821,9,6,11,19,35,64,-29,29
SV Josko Rie,2821,10,7,7,22,31,59,-28,28
FC Salzburg,2822,1,21,9,6,67,31,36,72
SC Rheindorf,2822,2,19,8,9,63,46,17,65
Vienna,2822,3,20,5,11,64,51,13,65
SK Sturm Gra,2822,4,19,5,12,58,41,17,62
Rapid Vienna,2822,5,13,10,13,58,49,9,49
RZ Pellets W,2822,6,11,11,14,39,46,-7,44
Admira Wacke,2822,7,10,8,18,35,61,-26,38
St. Pölten,2822,8,9,9,18,40,63,-23,36
SV Josko Rie,2822,9,10,5,21,27,47,-20,35
Mattersburg,2822,10,7,12,17,40,56,-16,33
SC Rheindorf,2823,1,20,7,9,52,42,10,67
FC Salzburg,2823,2,19,9,8,62,33,29,66
SK Sturm Gra,2823,3,20,4,12,55,37,18,64
Vienna,2823,4,19,4,13,71,52,19,61
Rapid Vienna,2823,5,15,8,13,58,44,14,53
Mattersburg,2823,6,11,8,17,43,53,-10,41
RZ Pellets W,2823,7,11,7,18,44,59,-15,40
SV Josko Rie,2823,8,11,6,19,36,55,-19,39
Admira Wacke,2823,9,11,6,19,38,58,-20,39
St. Pölten,2823,10,9,9,18,44,70,-26,36
FC Salzburg,2824,1,23,5,8,64,30,34,74
Vienna,2824,2,20,5,11,61,49,12,65
SC Rheindorf,2824,3,19,5,12,56,45,11,62
SK Sturm Gra,2824,4,16,7,13,52,37,15,55
Rapid Vienna,2824,5,15,8,13,57,43,14,53
Admira Wacke,2824,6,14,7,15,42,53,-11,49
RZ Pellets W,2824,7,13,5,18,49,60,-11,44
SV Josko Rie,2824,8,12,4,20,39,55,-16,40
Mattersburg,2824,9,10,8,18,36,53,-17,38
St. Pölten,2824,10,6,10,20,34,65,-31,28
FC Salzburg,2825,1,22,6,8,72,32,40,72
SC Rheindorf,2825,2,20,5,11,54,45,9,65
SK Sturm Gra,2825,3,17,10,9,55,36,19,61
Vienna,2825,4,16,5,15,61,56,5,53
Rapid Vienna,2825,5,13,12,11,61,45,16,51
SV Josko Rie,2825,6,15,4,17,40,47,-7,49
Admira Wacke,2825,7,12,8,16,40,60,-20,44
RZ Pellets W,2825,8,11,9,16,45,56,-11,42
Mattersburg,2825,9,8,7,21,38,63,-25,31
St. Pölten,2825,10,5,16,15,40,66,-26,31
FC Salzburg,2826,1,21,8,7,72,32,40,71
SK Sturm Gra,2826,2,21,6,9,61,35,26,69
SC Rheindorf,2826,3,20,6,10,53,38,15,66
Vienna,2826,4,19,6,11,67,47,20,63
Rapid Vienna,2826,5,13,10,13,54,47,7,49
RZ Pellets W,2826,6,12,8,16,44,50,-6,44
Admira Wacke,2826,7,12,7,17,39,61,-22,43
SV Josko Rie,2826,8,11,4,21,34,60,-26,37
St. Pölten,2826,9,7,10,19,40,66,-26,31
Mattersburg,2826,10,7,9,20,31,59,-28,30
SC Rheindorf,2827,1,23,5,8,60,37,23,74
FC Salzburg,2827,2,20,7,9,66,25,41,67
SK Sturm Gra,2827,3,19,8,9,60,30,30,65
Vienna,2827,4,17,7,12,57,52,5,58
RZ Pellets W,2827,5,14,7,15,44,50,-6,49
Rapid Vienna,2827,6,12,11,13,50,42,8,47
Admira Wacke,2827,7,13,6,17,35,54,-19,45
SV Josko Rie,2827,8,12,4,20,39,60,-21,40
St. Pölten,2827,9,7,9,20,36,66,-30,30
Mattersburg,2827,10,7,8,21,37,68,-31,29
FC Salzburg,2828,1,23,8,5,61,25,36,77
SC Rheindorf,2828,2,19,8,9,54,43,11,65
SK Sturm Gra,2828,3,19,6,11,55,33,22,63
Rapid Vienna,2828,4,14,10,12,66,46,20,52
Vienna,2828,5,15,4,17,62,65,-3,49
RZ Pellets W,2828,6,14,7,15,50,55,-5,49
Mattersburg,2828,7,11,7,18,42,61,-19,40
Admira Wacke,2828,8,10,10,16,35,54,-19,40
SV Josko Rie,2828,9,9,9,18,35,51,-16,36
St. Pölten,2828,10,6,11,19,38,65,-27,29
FC Salzburg,2829,1,23,4,9,63,30,33,73
SC Rheindorf,2829,2,22,7,7,58,34,24,73
SK Sturm Gra,2829,3,21,5,10,63,34,29,68
Vienna,2829,4,20,4,12,67,49,18,64
RZ Pellets W,2829,5,14,4,18,42,54,-12,46
Rapid Vienna,2829,6,11,10,15,52,44,8,43
Admira Wacke,2829,7,12,5,19,37,59,-22,41
SV Josko Rie,2829,8,11,3,22,27,50,-23,36
St. Pölten,2829,9,9,8,19,35,67,-32,35
Mattersburg,2829,10,9,6,21,35,58,-23,33
SC Rheindorf,2830,1,20,8,8,55,44,11,68
FC Salzburg,2830,2,20,6,10,65,31,34,66
SK Sturm Gra,2830,3,20,5,11,61,39,22,65
Vienna,2830,4,20,3,13,66,51,15,63
Rapid Vienna,2830,5,18,8,10,66,34,32,62
RZ Pellets W,2830,6,14,6,16,45,53,-8,48
St. Pölten,2830,7,10,10,16,44,63,-19,40
Admira Wacke,2830,8,10,4,22,41,72,-31,34
Mattersburg,2830,9,8,8,20,31,57,-26,32
SV Josko Rie,2830,10,8,6,22,35,65,-30,30
FC Salzburg,2831,1,22,6,8,67,32,35,72
SC Rheindorf,2831,2,19,9,8,56,39,17,66
SK Sturm Gra,2831,3,19,6,11,55,30,25,63
Vienna,2831,4,18,3,15,55,57,-2,57
Rapid Vienna,2831,5,14,13,9,55,38,17,55
RZ Pellets W,2831,6,10,11,15,46,57,-11,41
SV Josko Rie,2831,7,11,7,18,41,57,-16,40
Admira Wacke,2831,8,10,8,18,35,58,-23,38
St. Pölten,2831,9,8,9,19,41,62,-21,33
Mattersburg,2831,10,7,12,17,36,57,-21,33
FC Salzburg,2832,1,22,8,6,66,22,44,74
SK Sturm Gra,2832,2,19,5,12,59,33,26,62
SC Rheindorf,2832,3,17,10,9,53,46,7,61
Vienna,2832,4,16,8,12,59,52,7,56
RZ Pellets W,2832,5,16,5,15,48,50,-2,53
Rapid Vienna,2832,6,12,10,14,51,46,5,46
St. Pölten,2832,7,10,10,16,42,59,-17,40
SV Josko Rie,2832,8,11,7,18,36,54,-18,40
Admira Wacke,2832,9,10,8,18,39,64,-25,38
Mattersburg,2832,10,7,9,20,31,58,-27,30
FC Salzburg,2833,1,23,8,5,73,29,44,77
SC Rheindorf,2833,2,21,7,8,66,39,27,70
SK Sturm Gra,2833,3,18,6,12,53,39,14,60
Vienna,2833,4,17,6,13,60,52,8,57
Rapid Vienna,2833,5,15,8,13,58,42,16,53
SV Josko Rie,2833,6,13,7,16,39,48,-9,46
RZ Pellets W,2833,7,13,7,16,39,51,-12,46
Admira Wacke,2833,8,13,5,18,47,63,-16,44
St. Pölten,2833,9,9,7,20,39,72,-33,34
Mattersburg,2833,10,4,7,25,34,73,-39,19
SC Rheindorf,2834,1,22,6,8,63,45,18,72
FC Salzburg,2834,2,21,5,10,64,32,32,68
Vienna,2834,3,21,4,11,66,51,15,67
Rapid Vienna,2834,4,16,10,10,53,33,20,58
SK Sturm Gra,2834,5,16,7,13,54,44,10,55
RZ Pellets W,2834,6,14,7,15,46,51,-5,49
SV Josko Rie,2834,7,11,5,20,34,52,-18,38
Admira Wacke,2834,8,9,10,17,35,58,-23,37
St. Pölten,2834,9,7,9,20,43,69,-26,30
Mattersburg,2834,10,6,11,19,34,57,-23,29
FC Salzburg,2835,1,22,7,7,68,30,38,73
SC Rheindorf,2835,2,19,8,9,56,42,14,65
Vienna,2835,3,20,2,14,74,57,17,62
SK Sturm Gra,2835,4,17,5,14,60,40,20,56
Rapid Vienna,2835,5,14,13,9,53,37,16,55
RZ Pellets W,2835,6,14,8,14,46,52,-6,50
St. Pölten,2835,7,8,12,16,40,58,-18,36
Admira Wacke,2835,8,10,6,20,32,64,-32,36
Mattersburg,2835,9,8,11,17,39,57,-18,35
SV Josko Rie,2835,10,10,4,22,30,61,-31,34
Vienna,2836,1,23,3,10,70,42,28,72
FC Salzburg,2836,2,21,7,8,67,36,31,70
SK Sturm Gra,2836,3,20,6,10,58,32,26,66
SC Rheindorf,2836,4,16,9,11,55,51,4,57
Rapid Vienna,2836,5,16,7,13,61,48,13,55
RZ Pellets W,2836,6,14,6,16,54,56,-2,48
Mattersburg,2836,7,11,7,18,43,57,-14,40
Admira Wacke,2836,8,10,6,20,39,67,-28,36
SV Josko Rie,2836,9,9,5,22,37,66,-29,32
St. Pölten,2836,10,8,8,20,36,65,-29,32
FC Salzburg,2837,1,22,6,8,73,33,40,72
SK Sturm Gra,2837,2,19,9,8,63,33,30,66
SC Rheindorf,2837,3,19,8,9,54,38,16,65
Vienna,2837,4,17,8,11,63,54,9,59
Rapid Vienna,2837,5,14,10,12,54,40,14,52
RZ Pellets W,2837,6,12,9,15,47,57,-10,45
St. Pölten,2837,7,10,9,17,41,62,-21,39
SV Josko Rie,2837,8,10,7,19,34,56,-22,37
Mattersburg,2837,9,9,7,20,35,59,-24,34
Admira Wacke,2837,10,8,7,21,28,60,-32,31
FC Salzburg,2838,1,22,4,10,60,26,34,70
SC Rheindorf,2838,2,19,10,7,52,38,14,67
SK Sturm Gra,2838,3,18,9,9,53,29,24,63
Vienna,2838,4,18,5,13,59,50,9,59
Rapid Vienna,2838,5,12,12,12,50,37,13,48
Admira Wacke,2838,6,11,7,18,40,65,-25,40
RZ Pellets W,2838,7,9,12,15,44,57,-13,39
Mattersburg,2838,8,10,8,18,36,55,-19,38
SV Josko Rie,2838,9,10,7,19,32,53,-21,37
St. Pölten,2838,10,8,12,16,46,62,-16,36
SK Sturm Gra,2839,1,20,7,9,70,33,37,67
Vienna,2839,2,20,7,9,72,51,21,67
FC Salzburg,2839,3,19,9,8,70,38,32,66
SC Rheindorf,2839,4,19,9,8,55,40,15,66
Rapid Vienna,2839,5,17,8,11,55,41,14,59
St. Pölten,2839,6,14,7,15,46,53,-7,49
RZ Pellets W,2839,7,11,6,19,38,61,-23,39
Admira Wacke,2839,8,10,4,22,36,73,-37,34
SV Josko Rie,2839,9,9,4,23,34,59,-25,31
Mattersburg,2839,10,7,7,22,37,64,-27,28
SC Rheindorf,2840,1,19,10,7,64,42,22,67
FC Salzburg,2840,2,16,10,10,59,34,25,58
SK Sturm Gra,2840,3,17,6,13,60,41,19,57
Vienna,2840,4,16,8,12,63,57,6,56
Admira Wacke,2840,5,14,7,15,44,52,-8,49
Rapid Vienna,2840,6,12,11,13,52,43,9,47
St. Pölten,2840,7,13,7,16,45,69,-24,46
RZ Pellets W,2840,8,12,8,16,44,55,-11,44
SV Josko Rie,2840,9,13,3,20,36,58,-22,42
Mattersburg,2840,10,9,8,19,41,57,-16,35
FC Salzburg,2841,1,22,9,5,64,24,40,75
SK Sturm Gra,2841,2,21,4,11,64,39,25,67
SC Rheindorf,2841,3,17,11,8,60,43,17,62
Vienna,2841,4,18,7,11,67,49,18,61
Rapid Vienna,2841,5,16,11,9,58,38,20,59
St. Pölten,2841,6,10,9,17,42,59,-17,39
Admira Wacke,2841,7,11,5,20,41,68,-27,38
SV Josko Rie,2841,8,10,6,20,31,55,-24,36
RZ Pellets W,2841,9,8,8,20,37,65,-28,32
Mattersburg,2841,10,7,10,19,34,58,-24,31
FC Salzburg,2842,1,22,6,8,64,29,35,72
SK Sturm Gra,2842,2,22,4,10,67,35,32,70
SC Rheindorf,2842,3,21,7,8,62,45,17,70
Vienna,2842,4,19,3,14,63,52,11,60
Rapid Vienna,2842,5,14,11,11,60,44,16,53
Admira Wacke,2842,6,14,6,16,41,55,-14,48
RZ Pellets W,2842,7,11,7,18,40,61,-21,40
St. Pölten,2842,8,9,7,20,44,66,-22,34
Mattersburg,2842,9,9,5,22,33,60,-27,32
SV Josko Rie,2842,10,8,6,22,27,54,-27,30
FC Salzburg,2843,1,21,8,7,59,29,30,71
SK Sturm Gra,2843,2,20,7,9,60,33,27,67
Vienna,2843,3,16,8,12,60,51,9,56
SC Rheindorf,2843,4,16,8,12,46,42,4,56
Rapid Vienna,2843,5,14,12,10,56,39,17,54
RZ Pellets W,2843,6,12,11,13,47,51,-4,47
Admira Wacke,2843,7,11,10,15,41,58,-17,43
SV Josko Rie,2843,8,10,7,19,34,56,-22,37
St. Pölten,2843,9,7,11,18,41,63,-22,32
Mattersburg,2843,10,7,10,19,34,56,-22,31
FC Salzburg,2844,1,22,6,8,64,28,36,72
SC Rheindorf,2844,2,19,7,10,54,41,13,64
Vienna,2844,3,17,7,12,55,46,9,58
Rapid Vienna,2844,4,14,11,11,52,36,16,53
SK Sturm Gra,2844,5,15,7,14,50,38,12,52
SV Josko Rie,2844,6,15,5,16,42,50,-8,50
Admira Wacke,2844,7,13,7,16,33,51,-18,46
RZ Pellets W,2844,8,10,10,16,38,52,-14,40
St. Pölten,2844,9,9,8,19,41,63,-22,35
Mattersburg,2844,10,8,8,20,31,55,-24,32
SC Rheindorf,2845,1,22,6,8,59,39,20,72
FC Salzburg,2845,2,20,7,9,64,36,28,67
SK Sturm Gra,2845,3,18,9,9,58,33,25,63
Vienna,2845,4,18,7,11,68,55,13,61
Rapid Vienna,2845,5,14,11,11,61,45,16,53
RZ Pellets W,2845,6,15,7,14,54,56,-2,52
Admira Wacke,2845,7,10,6,20,33,69,-36,36
Mattersburg,2845,8,9,8,19,41,54,-13,35
St. Pölten,2845,9,7,11,18,44,68,-24,32
SV Josko Rie,2845,10,7,8,21,28,55,-27,29
SK Sturm Gra,2846,1,23,4,9,54,28,26,73
FC Salzburg,2846,2,21,8,7,61,25,36,71
SC Rheindorf,2846,3,21,5,10,55,46,9,68
Vienna,2846,4,18,7,11,70,54,16,61
RZ Pellets W,2846,5,14,9,13,54,54,0,51
Rapid Vienna,2846,6,10,12,14,51,39,12,42
SV Josko Rie,2846,7,11,5,20,44,58,-14,38
Admira Wacke,2846,8,9,8,19,33,61,-28,35
St. Pölten,2846,9,8,9,19,36,68,-32,33
Mattersburg,2846,10,6,11,19,33,58,-25,29
FC Salzburg,2847,1,20,7,9,65,34,31,67
SK Sturm Gra,2847,2,20,5,11,57,36,21,65
Vienna,2847,3,19,4,13,64,55,9,61
SC Rheindorf,2847,4,16,10,10,51,45,6,58
Rapid Vienna,2847,5,14,8,14,54,39,15,50
Mattersburg,2847,6,14,7,15,47,52,-5,49
RZ Pellets W,2847,7,14,5,17,51,59,-8,47
Admira Wacke,2847,8,13,6,17,35,54,-19,45
St. Pölten,2847,9,9,8,19,39,61,-22,35
SV Josko Rie,2847,10,8,6,22,27,55,-28,30
SK Sturm Gra,2848,1,21,6,9,62,36,26,69
SC Rheindorf,2848,2,19,10,7,57,40,17,67
FC Salzburg,2848,3,17,12,7,64,36,28,63
Vienna,2848,4,19,6,11,68,54,14,63
Rapid Vienna,2848,5,13,12,11,56,44,12,51
RZ Pellets W,2848,6,11,8,17,44,67,-23,41
St. Pölten,2848,7,9,11,16,47,62,-15,38
Admira Wacke,2848,8,10,8,18,41,59,-18,38
Mattersburg,2848,9,8,9,19,39,57,-18,33
SV Josko Rie,2848,10,9,6,21,43,66,-23,33
FC Salzburg,2849,1,21,7,8,65,34,31,70
SC Rheindorf,2849,2,20,7,9,59,45,14,67
Vienna,2849,3,19,4,13,63,49,14,61
Rapid Vienna,2849,4,15,12,9,58,37,21,57
SK Sturm Gra,2849,5,16,9,11,53,38,15,57
RZ Pellets W,2849,6,13,8,15,47,51,-4,47
Admira Wacke,2849,7,11,5,20,33,57,-24,38
Mattersburg,2849,8,9,9,18,42,61,-19,36
St. Pölten,2849,9,10,6,20,43,63,-20,36
SV Josko Rie,2849,10,9,7,20,38,66,-28,34
SC Rheindorf,2850,1,22,6,8,58,43,15,72
Vienna,2850,2,21,7,8,69,43,26,70
SK Sturm Gra,2850,3,18,8,10,61,36,25,62
FC Salzburg,2850,4,17,8,11,53,32,21,59
Rapid Vienna,2850,5,13,10,13,45,41,4,49
RZ Pellets W,2850,6,11,8,17,48,58,-10,41
SV Josko Rie,2850,7,11,7,18,34,47,-13,40
Mattersburg,2850,8,9,11,16,33,47,-14,38
St. Pölten,2850,9,9,8,19,41,65,-24,35
Admira Wacke,2850,10,10,5,21,32,62,-30,35
SC Rheindorf,2851,1,21,8,7,56,43,13,71
FC Salzburg,2851,2,19,11,6,64,29,35,68
SK Sturm Gra,2851,3,20,8,8,60,28,32,68
Vienna,2851,4,17,5,14,62,57,5,56
RZ Pellets W,2851,5,14,7,15,48,48,0,49
Rapid Vienna,2851,6,11,12,13,53,42,11,45
St. Pölten,2851,7,8,13,15,44,63,-19,37
Mattersburg,2851,8,9,10,17,38,60,-22,37
SV Josko Rie,2851,9,9,6,21,32,54,-22,33
Admira Wacke,2851,10,8,8,20,30,63,-33,32
FC Salzburg,2852,1,23,6,7,65,27,38,75
SC Rheindorf,2852,2,20,6,10,56,43,13,66
SK Sturm Gra,2852,3,17,9,10,60,37,23,60
Vienna,2852,4,17,8,11,63,53,10,59
Rapid Vienna,2852,5,15,10,11,54,38,16,55
RZ Pellets W,2852,6,11,9,16,45,56,-11,42
Mattersburg,2852,7,9,11,16,39,56,-17,38
Admira Wacke,2852,8,9,10,17,39,64,-25,37
St. Pölten,2852,9,7,12,17,40,63,-23,33
SV Josko Rie,2852,10,8,7,21,40,64,-24,31
FC Salzburg,2853,1,21,8,7,62,26,36,71
SC Rheindorf,2853,2,20,6,10,49,39,10,66
SK Sturm Gra,2853,3,20,3,13,66,38,28,63
Vienna,2853,4,18,4,14,58,50,8,58
Rapid Vienna,2853,5,14,9,13,53,45,8,51
RZ Pellets W,2853,6,14,8,14,50,54,-4,50
Admira Wacke,2853,7,12,5,19,39,58,-19,41
Mattersburg,2853,8,10,7,19,34,56,-22,37
SV Josko Rie,2853,9,9,8,19,33,53,-20,35
St. Pölten,2853,10,9,8,19,36,61,-25,35
SC Rheindorf,2854,1,21,10,5,62,37,25,73
FC Salzburg,2854,2,20,6,10,67,36,31,66
Vienna,2854,3,19,4,13,66,61,5,61
SK Sturm Gra,2854,4,17,8,11,53,36,17,59
Rapid Vienna,2854,5,14,11,11,61,38,23,53
Admira Wacke,2854,6,13,6,17,46,63,-17,45
RZ Pellets W,2854,7,11,8,17,46,62,-16,41
SV Josko Rie,2854,8,11,5,20,38,56,-18,38
St. Pölten,2854,9,8,11,17,48,69,-21,35
Mattersburg,2854,10,6,11,19,39,68,-29,29
Vienna,2855,1,21,4,11,58,47,11,67
SC Rheindorf,2855,2,20,6,10,57,43,14,66
SK Sturm Gra,2855,3,19,7,10,60,37,23,64
FC Salzburg,2855,4,17,7,12,57,37,20,58
RZ Pellets W,2855,5,15,8,13,51,46,5,53
Rapid Vienna,2855,6,15,7,14,62,49,13,52
SV Josko Rie,2855,7,11,6,19,35,47,-12,39
St. Pölten,2855,8,10,8,18,43,67,-24,38
Admira Wacke,2855,9,10,7,19,35,66,-31,37
Mattersburg,2855,10,7,10,19,37,56,-19,31
FC Salzburg,2856,1,23,7,6,64,29,35,76
SK Sturm Gra,2856,2,19,7,10,57,35,22,64
Vienna,2856,3,17,4,15,59,50,9,55
RZ Pellets W,2856,4,16,6,14,52,50,2,54
SC Rheindorf,2856,5,15,8,13,44,47,-3,53
Rapid Vienna,2856,6,12,11,13,53,48,5,47
SV Josko Rie,2856,7,12,6,18,42,52,-10,42
Admira Wacke,2856,8,12,5,19,39,58,-19,41
St. Pölten,2856,9,10,9,17,40,59,-19,39
Mattersburg,2856,10,9,7,20,39,61,-22,34
FC Salzburg,2857,1,22,7,7,62,26,36,73
SK Sturm Gra,2857,2,20,7,9,62,31,31,67
SC Rheindorf,2857,3,20,6,10,59,41,18,66
Vienna,2857,4,18,5,13,64,53,11,59
Rapid Vienna,2857,5,14,11,11,54,43,11,53
Admira Wacke,2857,6,11,9,16,33,56,-23,42
RZ Pellets W,2857,7,11,7,18,48,56,-8,40
SV Josko Rie,2857,8,11,5,20,38,55,-17,38
Mattersburg,2857,9,7,11,18,34,63,-29,32
St. Pölten,2857,10,8,8,20,42,72,-30,32
FC Salzburg,2858,1,18,12,6,63,34,29,66
Vienna,2858,2,20,5,11,65,52,13,65
SK Sturm Gra,2858,3,18,7,11,55,39,16,61
SC Rheindorf,2858,4,17,8,11,58,47,11,59
Rapid Vienna,2858,5,13,12,11,57,41,16,51
Admira Wacke,2858,6,12,9,15,34,54,-20,45
RZ Pellets W,2858,7,12,7,17,49,58,-9,43
Mattersburg,2858,8,10,8,18,39,50,-11,38
St. Pölten,2858,9,9,11,16,42,63,-21,38
SV Josko Rie,2858,10,8,7,21,35,59,-24,31
SC Rheindorf,2859,1,23,6,7,65,35,30,75
FC Salzburg,2859,2,19,6,11,62,36,26,63
SK Sturm Gra,2859,3,18,6,12,51,35,16,60
Rapid Vienna,2859,4,15,10,11,57,40,17,55
Vienna,2859,5,16,7,13,53,44,9,55
RZ Pellets W,2859,6,15,6,15,53,55,-2,51
Admira Wacke,2859,7,11,6,19,39,61,-22,39
SV Josko Rie,2859,8,10,7,19,34,56,-22,37
Mattersburg,2859,9,9,8,19,35,62,-27,35
St. Pölten,2859,10,8,10,18,40,65,-25,34
FC Salzburg,2860,1,19,9,8,58,28,30,66
SC Rheindorf,2860,2,19,9,8,63,39,24,66
SK Sturm Gra,2860,3,19,7,10,58,36,22,64
Vienna,2860,4,18,6,12,61,51,10,60
Rapid Vienna,2860,5,11,13,12,51,42,9,46
St. Pölten,2860,6,10,10,16,41,59,-18,40
SV Josko Rie,2860,7,11,6,19,37,52,-15,39
RZ Pellets W,2860,8,10,9,17,45,65,-20,39
Mattersburg,2860,9,9,11,16,35,50,-15,38
Admira Wacke,2860,10,10,8,18,34,61,-27,38
SC Rheindorf,2861,1,21,6,9,59,38,21,69
FC Salzburg,2861,2,20,8,8,66,28,38,68
Vienna,2861,3,21,5,10,68,45,23,68
SK Sturm Gra,2861,4,18,8,10,61,36,25,62
Rapid Vienna,2861,5,15,8,13,53,45,8,53
SV Josko Rie,2861,6,14,4,18,42,52,-10,46
RZ Pellets W,2861,7,13,6,17,43,62,-19,45
Admira Wacke,2861,8,10,4,22,31,66,-35,34
St. Pölten,2861,9,8,9,19,41,65,-24,33
Mattersburg,2861,10,7,8,21,32,59,-27,29
Vienna,2862,1,23,3,10,63,46,17,72
SC Rheindorf,2862,2,20,9,7,57,34,23,69
FC Salzburg,2862,3,19,5,12,60,38,22,62
SK Sturm Gra,2862,4,16,9,11,49,31,18,57
Rapid Vienna,2862,5,12,11,13,53,43,10,47
RZ Pellets W,2862,6,13,6,17,44,56,-12,45
Admira Wacke,2862,7,12,7,17,43,60,-17,43
St. Pölten,2862,8,11,7,18,40,59,-19,40
Mattersburg,2862,9,10,7,19,33,51,-18,37
SV Josko Rie,2862,10,10,4,22,33,57,-24,34
FC Salzburg,2863,1,21,7,8,65,30,35,70
SC Rheindorf,2863,2,21,6,9,57,44,13,69
Vienna,2863,3,20,6,10,72,52,20,66
SK Sturm Gra,2863,4,20,3,13,65,39,26,63
RZ Pellets W,2863,5,16,6,14,48,51,-3,54
Rapid Vienna,2863,6,12,10,14,49,40,9,46
Admira Wacke,2863,7,12,4,20,39,66,-27,40
SV Josko Rie,2863,8,11,5,20,34,53,-19,38
Mattersburg,2863,9,9,9,18,35,55,-20,36
St. Pölten,2863,10,6,8,22,33,67,-34,26
FC Salzburg,2864,1,22,6,8,67,31,36,72
SK Sturm Gra,2864,2,19,7,10,67,33,34,64
SC Rheindorf,2864,3,20,4,12,51,47,4,64
Vienna,2864,4,18,5,13,56,48,8,59
RZ Pellets W,2864,5,16,5,15,43,46,-3,53
Rapid Vienna,2864,6,12,10,14,53,45,8,46
Admira Wacke,2864,7,13,5,18,37,55,-18,44
St. Pölten,2864,8,11,7,18,42,59,-17,40
SV Josko Rie,2864,9,11,4,21,39,63,-24,37
Mattersburg,2864,10,8,7,21,40,68,-28,31
FC Salzburg,2865,1,22,8,6,67,27,40,74
Vienna,2865,2,21,5,10,63,41,22,68
SC Rheindorf,2865,3,19,5,12,54,49,5,62
SK Sturm Gra,2865,4,17,7,12,51,35,16,58
Rapid Vienna,2865,5,16,8,12,51,34,17,56
Admira Wacke,2865,6,13,5,18,38,59,-21,44
RZ Pellets W,2865,7,10,8,18,41,58,-17,38
Mattersburg,2865,8,9,9,18,39,53,-14,36
St. Pölten,2865,9,9,8,19,38,66,-28,35
SV Josko Rie,2865,10,9,7,20,36,56,-20,34
SC Rheindorf,2866,1,21,7,8,59,39,20,70
FC Salzburg,2866,2,18,11,7,68,34,34,65
Vienna,2866,3,20,3,13,62,47,15,63
SK Sturm Gra,2866,4,18,6,12,60,36,24,60
Rapid Vienna,2866,5,14,10,12,56,39,17,52
RZ Pellets W,2866,6,14,6,16,46,59,-13,48
Admira Wacke,2866,7,10,10,16,39,61,-22,40
Mattersburg,2866,8,9,8,19,38,63,-25,35
SV Josko Rie,2866,9,9,7,20,32,52,-20,34
St. Pölten,2866,10,8,10,18,40,70,-30,34
SK Sturm Gra,2867,1,21,4,11,65,38,27,67
SC Rheindorf,2867,2,20,6,10,55,40,15,66
FC Salzburg,2867,3,19,8,9,63,33,30,65
Vienna,2867,4,19,5,12,67,53,14,62
Rapid Vienna,2867,5,16,10,10,57,39,18,58
Admira Wacke,2867,6,13,5,18,36,54,-18,44
St. Pölten,2867,7,11,8,17,41,62,-21,41
RZ Pellets W,2867,8,9,9,18,36,53,-17,36
Mattersburg,2867,9,9,8,19,35,58,-23,35
SV Josko Rie,2867,10,7,9,20,28,53,-25,30
FC Salzburg,2868,1,23,8,5,68,26,42,77
Vienna,2868,2,22,4,10,59,43,16,70
SK Sturm Gra,2868,3,20,6,10,53,29,24,66
SC Rheindorf,2868,4,19,6,11,55,42,13,63
Rapid Vienna,2868,5,14,9,13,54,41,13,51
RZ Pellets W,2868,6,12,7,17,47,63,-16,43
St. Pölten,2868,7,10,10,16,50,62,-12,40
SV Josko Rie,2868,8,11,6,19,34,55,-21,39
Admira Wacke,2868,9,8,7,21,34,66,-32,31
Mattersburg,2868,10,5,9,22,32,59,-27,24
SK Sturm Gra,2869,1,21,5,10,63,32,31,68
FC Salzburg,2869,2,20,6,10,65,35,30,66
SC Rheindorf,2869,3,18,6,12,50,47,3,60
Vienna,2869,4,17,6,13,66,55,11,57
Rapid Vienna,2869,5,14,12,10,62,43,19,54
Mattersburg,2869,6,11,11,14,39,49,-10,44
Admira Wacke,2869,7,13,5,18,34,55,-21,44
SV Josko Rie,2869,8,12,4,20,42,61,-19,40
RZ Pellets W,2869,9,9,9,18,38,61,-23,36
St. Pölten,2869,10,8,10,18,40,61,-21,34
FC Salzburg,2870,1,22,6,8,67,32,35,72
Vienna,2870,2,20,5,11,67,45,22,65
SK Sturm Gra,2870,3,19,7,10,55,34,21,64
SC Rheindorf,2870,4,18,10,8,60,48,12,64
RZ Pellets W,2870,5,13,7,16,47,54,-7,46
Admira Wacke,2870,6,13,7,16,45,62,-17,46
Rapid Vienna,2870,7,11,12,13,47,41,6,45
Mattersburg,2870,8,8,9,19,34,56,-22,33
St. Pölten,2870,9,7,12,17,42,67,-25,33
SV Josko Rie,2870,10,8,7,21,38,63,-25,31
FC Salzburg,2871,1,21,8,7,67,32,35,71
SK Sturm Gra,2871,2,19,7,10,63,38,25,64
SC Rheindorf,2871,3,17,9,10,55,49,6,60
Vienna,2871,4,18,3,15,66,55,11,57
RZ Pellets W,2871,5,16,9,11,56,47,9,57
Rapid Vienna,2871,6,11,11,14,54,51,3,44
St. Pölten,2871,7,9,13,14,41,56,-15,40
Admira Wacke,2871,8,10,8,18,37,61,-24,38
SV Josko Rie,2871,9,11,4,21,35,61,-26,37
Mattersburg,2871,10,8,8,20,34,58,-24,32
FC Salzburg,2872,1,23,7,6,70,31,39,76
Vienna,2872,2,20,7,9,64,47,17,67
SK Sturm Gra,2872,3,19,5,12,57,36,21,62
SC Rheindorf,2872,4,18,7,11,53,43,10,61
Rapid Vienna,2872,5,13,10,13,53,47,6,49
RZ Pellets W,2872,6,14,7,15,47,48,-1,49
SV Josko Rie,2872,7,11,6,19,30,50,-20,39
Admira Wacke,2872,8,11,6,19,40,62,-22,39
Mattersburg,2872,9,8,8,20,40,62,-22,32
St. Pölten,2872,10,7,9,20,34,62,-28,30
SK Sturm Gra,2873,1,22,4,10,67,38,29,70
FC Salzburg,2873,2,20,7,9,72,34,38,67
SC Rheindorf,2873,3,20,6,10,60,51,9,66
Vienna,2873,4,19,5,12,70,55,15,62
Rapid Vienna,2873,5,14,9,13,59,44,15,51
RZ Pellets W,2873,6,13,8,15,45,56,-11,47
Mattersburg,2873,7,9,10,17,38,55,-17,37
SV Josko Rie,2873,8,10,7,19,33,54,-21,37
Admira Wacke,2873,9,9,7,20,33,66,-33,34
St. Pölten,2873,10,8,9,19,42,66,-24,33
FC Salzburg,2874,1,22,7,7,65,30,35,73
SK Sturm Gra,2874,2,19,6,11,64,35,29,63
SC Rheindorf,2874,3,18,8,10,53,43,10,62
Vienna,2874,4,17,4,15,58,52,6,55
Rapid Vienna,2874,5,14,8,14,58,48,10,50
Admira Wacke,2874,6,14,8,14,45,55,-10,50
SV Josko Rie,2874,7,11,7,18,35,54,-19,40
RZ Pellets W,2874,8,9,10,17,42,58,-16,37
Mattersburg,2874,9,9,10,17,39,56,-17,37
St. Pölten,2874,10,7,12,17,39,67,-28,33
FC Salzburg,2875,1,22,7,7,65,32,33,73
SC Rheindorf,2875,2,20,9,7,60,40,20,69
SK Sturm Gra,2875,3,19,9,8,60,31,29,66
Vienna,2875,4,16,5,15,59,59,0,53
Rapid Vienna,2875,5,10,14,12,50,44,6,44
RZ Pellets W,2875,6,12,8,16,51,61,-10,44
Admira Wacke,2875,7,10,9,17,41,57,-16,39
St. Pölten,2875,8,9,11,16,47,72,-25,38
Mattersburg,2875,9,9,9,18,38,56,-18,36
SV Josko Rie,2875,10,10,5,21,38,57,-19,35
FC Salzburg,2876,1,20,8,8,61,33,28,68
Vienna,2876,2,20,6,10,75,53,22,66
SK Sturm Gra,2876,3,19,5,12,58,38,20,62
Rapid Vienna,2876,4,16,11,9,60,38,22,59
SC Rheindorf,2876,5,15,4,17,49,54,-5,49
SV Josko Rie,2876,6,14,5,17,35,45,-10,47
St. Pölten,2876,7,11,9,16,43,58,-15,42
Admira Wacke,2876,8,12,6,18,39,64,-25,42
RZ Pellets W,2876,9,11,6,19,40,56,-16,39
Mattersburg,2876,10,9,6,21,41,62,-21,33
SK Sturm Gra,2877,1,21,6,9,58,34,24,69
SC Rheindorf,2877,2,21,6,9,59,37,22,69
FC Salzburg,2877,3,20,8,8,64,31,33,68
Vienna,2877,4,17,7,12,66,59,7,58
Rapid Vienna,2877,5,13,11,12,52,39,13,50
RZ Pellets W,2877,6,11,9,16,44,55,-11,42
Mattersburg,2877,7,10,8,18,32,50,-18,38
SV Josko Rie,2877,8,11,5,20,31,51,-20,38
Admira Wacke,2877,9,10,7,19,37,62,-25,37
St. Pölten,2877,10,7,11,18,39,64,-25,32
SK Sturm Gra,2878,1,23,4,9,61,33,28,73
FC Salzburg,2878,2,22,6,8,68,31,37,72
SC Rheindorf,2878,3,18,8,10,53,49,4,62
Rapid Vienna,2878,4,17,8,11,63,40,23,59
Vienna,2878,5,17,3,16,62,56,6,54
St. Pölten,2878,6,10,10,16,40,54,-14,40
SV Josko Rie,2878,7,12,4,20,34,54,-20,40
RZ Pellets W,2878,8,10,8,18,43,58,-15,38
Admira Wacke,2878,9,11,4,21,36,64,-28,37
Mattersburg,2878,10,9,7,20,37,58,-21,34
FC Salzburg,2879,1,23,7,6,73,29,44,76
SK Sturm Gra,2879,2,21,6,9,66,29,37,69
Vienna,2879,3,19,7,10,67,51,16,64
SC Rheindorf,2879,4,17,9,10,48,45,3,60
Rapid Vienna,2879,5,13,13,10,56,39,17,52
SV Josko Rie,2879,6,12,5,19,32,50,-18,41
RZ Pellets W,2879,7,10,6,20,41,63,-22,36
Admira Wacke,2879,8,9,9,18,30,58,-28,36
St. Pölten,2879,9,9,8,19,41,68,-27,35
Mattersburg,2879,10,7,10,19,33,55,-22,31
FC Salzburg,2880,1,23,6,7,62,29,33,75
SK Sturm Gra,2880,2,20,7,9,57,34,23,67
Vienna,2880,3,21,4,11,64,49,15,67
SC Rheindorf,2880,4,20,6,10,54,43,11,66
Rapid Vienna,2880,5,13,10,13,48,38,10,49
SV Josko Rie,2880,6,13,5,18,39,49,-10,44
RZ Pellets W,2880,7,12,7,17,45,52,-7,43
Mattersburg,2880,8,9,7,20,39,63,-24,34
Admira Wacke,2880,9,9,7,20,37,63,-26,34
St. Pölten,2880,10,7,7,22,36,61,-25,28
SC Rheindorf,2881,1,19,7,10,53,41,12,64
FC Salzburg,2881,2,19,6,11,60,33,27,63
SK Sturm Gra,2881,3,19,6,11,59,39,20,63
Vienna,2881,4,19,5,12,63,50,13,62
Rapid Vienna,2881,5,17,8,11,59,36,23,59
St. Pölten,2881,6,12,8,16,47,58,-11,44
SV Josko Rie,2881,7,13,5,18,41,54,-13,44
Admira Wacke,2881,8,13,4,19,39,60,-21,43
RZ Pellets W,2881,9,11,7,18,46,59,-13,40
Mattersburg,2881,10,6,8,22,30,67,-37,26
FC Salzburg,2882,1,21,9,6,66,32,34,72
SC Rheindorf,2882,2,20,8,8,68,46,22,68
SK Sturm Gra,2882,3,17,10,9,58,34,24,61
Vienna,2882,4,18,5,13,56,49,7,59
St. Pölten,2882,5,12,10,14,45,58,-13,46
Admira Wacke,2882,6,11,9,16,42,60,-18,42
Rapid Vienna,2882,7,10,11,15,54,57,-3,41
RZ Pellets W,2882,8,11,7,18,47,60,-13,40
Mattersburg,2882,9,10,8,18,38,54,-16,38
SV Josko Rie,2882,10,8,7,21,33,57,-24,31
FC Salzburg,2883,1,24,6,6,76,31,45,78
SC Rheindorf,2883,2,21,7,8,58,41,17,70
SK Sturm Gra,2883,3,17,9,10,56,37,19,60
Vienna,2883,4,17,4,15,60,58,2,55
Rapid Vienna,2883,5,14,9,13,56,45,11,51
RZ Pellets W,2883,6,14,7,15,51,53,-2,49
SV Josko Rie,2883,7,13,5,18,40,60,-20,44
Admira Wacke,2883,8,10,8,18,38,65,-27,38
Mattersburg,2883,9,9,7,20,46,63,-17,34
St. Pölten,2883,10,5,10,21,38,66,-28,25
FC Salzburg,2884,1,22,8,6,69,34,35,74
Vienna,2884,2,21,5,10,64,44,20,68
SK Sturm Gra,2884,3,20,6,10,55,33,22,66
SC Rheindorf,2884,4,18,8,10,58,48,10,62
Rapid Vienna,2884,5,17,8,11,62,42,20,59
Admira Wacke,2884,6,11,6,19,39,60,-21,39
St. Pölten,2884,7,9,9,18,46,62,-16,36
RZ Pellets W,2884,8,9,9,18,44,66,-22,36
SV Josko Rie,2884,9,10,4,22,32,60,-28,34
Mattersburg,2884,10,7,9,20,39,59,-20,30
FC Salzburg,2885,1,22,7,7,67,31,36,73
Vienna,2885,2,20,5,11,63,51,12,65
SC Rheindorf,2885,3,19,7,10,50,41,9,64
SK Sturm Gra,2885,4,18,8,10,53,31,22,62
Rapid Vienna,2885,5,15,10,11,55,41,14,55
RZ Pellets W,2885,6,9,11,16,42,55,-13,38
SV Josko Rie,2885,7,11,4,21,32,51,-19,37
Admira Wacke,2885,8,9,10,17,30,53,-23,37
Mattersburg,2885,9,9,8,19,34,53,-19,35
St. Pölten,2885,10,8,10,18,42,61,-19,34
FC Salzburg,2886,1,20,9,7,64,28,36,69
SK Sturm Gra,2886,2,20,7,9,59,29,30,67
Vienna,2886,3,20,5,11,68,47,21,65
Rapid Vienna,2886,4,19,7,10,59,33,26,64
SC Rheindorf,2886,5,19,7,10,60,49,11,64
Admira Wacke,2886,6,14,6,16,43,58,-15,48
RZ Pellets W,2886,7,13,5,18,47,57,-10,44
SV Josko Rie,2886,8,7,9,20,25,58,-33,30
St. Pölten,2886,9,6,9,21,32,64,-32,27
Mattersburg,2886,10,7,6,23,33,67,-34,27
SK Sturm Gra,2887,1,22,6,8,69,36,33,72
Vienna,2887,2,20,6,10,65,45,20,66
FC Salzburg,2887,3,18,9,9,60,33,27,63
SC Rheindorf,2887,4,19,6,11,61,52,9,63
Rapid Vienna,2887,5,15,10,11,55,36,19,55
RZ Pellets W,2887,6,13,7,16,45,55,-10,46
Admira Wacke,2887,7,12,5,19,36,61,-25,41
Mattersburg,2887,8,9,9,18,40,61,-21,36
SV Josko Rie,2887,9,9,8,19,31,52,-21,35
St. Pölten,2887,10,6,8,22,35,66,-31,26
SC Rheindorf,2888,1,22,4,10,57,40,17,70
FC Salzburg,2888,2,19,7,10,67,34,33,64
Vienna,2888,3,19,5,12,65,55,10,62
SK Sturm Gra,2888,4,18,7,11,58,43,15,61
Rapid Vienna,2888,5,13,12,11,51,37,14,51
RZ Pellets W,2888,6,12,9,15,50,61,-11,45
Mattersburg,2888,7,12,7,17,40,54,-14,43
SV Josko Rie,2888,8,12,6,18,34,49,-15,42
Admira Wacke,2888,9,10,8,18,36,55,-19,38
St. Pölten,2888,10,5,11,20,35,65,-30,26
FC Salzburg,2889,1,22,7,7,70,36,34,73
SC Rheindorf,2889,2,18,8,10,58,40,18,62
SK Sturm Gra,2889,3,17,8,11,55,35,20,59
Vienna,2889,4,18,5,13,57,50,7,59
Rapid Vienna,2889,5,13,15,8,49,33,16,54
SV Josko Rie,2889,6,14,5,17,38,49,-11,47
RZ Pellets W,2889,7,11,8,17,43,60,-17,41
Mattersburg,2889,8,10,10,16,44,56,-12,40
St. Pölten,2889,9,9,9,18,47,71,-24,36
Admira Wacke,2889,10,7,7,22,33,64,-31,28
SC Rheindorf,2890,1,19,10,7,55,40,15,67
FC Salzburg,2890,2,19,6,11,63,32,31,63
SK Sturm Gra,2890,3,19,6,11,57,34,23,63
Rapid Vienna,2890,4,18,7,11,64,36,28,61
Vienna,2890,5,18,5,13,57,46,11,59
SV Josko Rie,2890,6,14,5,17,41,52,-11,47
RZ Pellets W,2890,7,13,7,16,45,56,-11,46
Admira Wacke,2890,8,11,6,19,32,60,-28,39
St. Pölten,2890,9,9,9,18,46,68,-22,36
Mattersburg,2890,10,5,9,22,28,64,-36,24
FC Salzburg,2891,1,19,9,8,60,35,25,66
SK Sturm Gra,2891,2,19,8,9,63,31,32,65
SC Rheindorf,2891,3,19,5,12,51,45,6,62
Vienna,2891,4,19,4,13,65,50,15,61
Rapid Vienna,2891,5,15,9,12,54,42,12,54
RZ Pellets W,2891,6,13,7,16,43,49,-6,46
SV Josko Rie,2891,7,13,5,18,40,51,-11,44
Admira Wacke,2891,8,11,6,19,39,62,-23,39
Mattersburg,2891,9,10,6,20,35,61,-26,36
St. Pölten,2891,10,9,7,20,41,65,-24,34
FC Salzburg,2892,1,23,6,7,72,26,46,75
SC Rheindorf,2892,2,20,8,8,60,43,17,68
SK Sturm Gra,2892,3,19,6,11,55,34,21,63
Vienna,2892,4,18,5,13,67,67,0,59
Rapid Vienna,2892,5,13,12,11,63,42,21,51
SV Josko Rie,2892,6,12,7,17,40,55,-15,43
RZ Pellets W,2892,7,12,6,18,40,57,-17,42
Admira Wacke,2892,8,11,8,17,39,66,-27,41
St. Pölten,2892,9,8,9,19,44,63,-19,33
Mattersburg,2892,10,6,9,21,29,56,-27,27
FC Salzburg,2893,1,22,4,10,70,37,33,70
SC Rheindorf,2893,2,21,7,8,63,46,17,70
SK Sturm Gra,2893,3,18,7,11,56,35,21,61
Rapid Vienna,2893,4,15,10,11,57,40,17,55
Vienna,2893,5,16,6,14,57,49,8,54
Admira Wacke,2893,6,13,7,16,44,63,-19,46
RZ Pellets W,2893,7,13,5,18,44,55,-11,44
SV Josko Rie,2893,8,12,6,18,40,53,-13,42
Mattersburg,2893,9,8,9,19,34,60,-26,33
St. Pölten,2893,10,7,9,20,38,65,-27,30
SC Rheindorf,2894,1,20,9,7,56,42,14,69
FC Salzburg,2894,2,21,5,10,72,38,34,68
SK Sturm Gra,2894,3,18,10,8,63,34,29,64
Vienna,2894,4,18,7,11,60,48,12,61
Rapid Vienna,2894,5,14,9,13,56,43,13,51
St. Pölten,2894,6,9,12,15,44,65,-21,39
RZ Pellets W,2894,7,9,11,16,38,50,-12,38
Admira Wacke,2894,8,11,5,20,34,59,-25,38
Mattersburg,2894,9,9,9,18,32,55,-23,36
SV Josko Rie,2894,10,10,5,21,34,55,-21,35
FC Salzburg,2895,1,20,8,8,66,31,35,68
SK Sturm Gra,2895,2,20,6,10,60,31,29,66
SC Rheindorf,2895,3,19,9,8,49,36,13,66
Vienna,2895,4,20,5,11,65,54,11,65
Rapid Vienna,2895,5,14,11,11,52,40,12,53
RZ Pellets W,2895,6,14,5,17,47,54,-7,47
Admira Wacke,2895,7,10,8,18,33,58,-25,38
SV Josko Rie,2895,8,10,7,19,35,50,-15,37
St. Pölten,2895,9,8,9,19,44,71,-27,33
Mattersburg,2895,10,6,10,20,33,59,-26,28
FC Salzburg,2896,1,20,7,9,58,28,30,67
Vienna,2896,2,20,5,11,80,52,28,65
SK Sturm Gra,2896,3,20,5,11,60,38,22,65
SC Rheindorf,2896,4,18,7,11,58,51,7,61
Rapid Vienna,2896,5,17,8,11,65,41,24,59
RZ Pellets W,2896,6,13,9,14,47,56,-9,48
Admira Wacke,2896,7,13,4,19,40,63,-23,43
SV Josko Rie,2896,8,11,5,20,32,58,-26,38
Mattersburg,2896,9,8,8,20,34,60,-26,32
St. Pölten,2896,10,7,8,21,45,72,-27,29
SC Rheindorf,2897,1,24,5,7,61,35,26,77
FC Salzburg,2897,2,24,4,8,65,31,34,76
SK Sturm Gra,2897,3,20,4,12,58,38,20,64
Vienna,2897,4,18,5,13,59,46,13,59
Rapid Vienna,2897,5,15,10,11,56,38,18,55
SV Josko Rie,2897,6,13,5,18,35,44,-9,44
Admira Wacke,2897,7,11,6,19,38,63,-25,39
RZ Pellets W,2897,8,11,5,20,46,68,-22,38
Mattersburg,2897,9,8,7,21,30,56,-26,31
St. Pölten,2897,10,6,9,21,31,60,-29,27
FC Salzburg,2898,1,20,9,7,65,35,30,69
Vienna,2898,2,21,3,12,67,55,12,66
SK Sturm Gra,2898,3,18,6,12,60,38,22,60
RZ Pellets W,2898,4,16,8,12,60,56,4,56
SC Rheindorf,2898,5,15,8,13,52,53,-1,53
Admira Wacke,2898,6,15,5,16,39,48,-9,50
Rapid Vienna,2898,7,12,11,13,55,44,11,47
Mattersburg,2898,8,8,12,16,39,52,-13,36
St. Pölten,2898,9,8,9,19,40,72,-32,33
SV Josko Rie,2898,10,9,5,22,32,56,-24,32
Vienna,2899,1,21,5,10,67,46,21,68
FC Salzburg,2899,2,20,6,10,67,35,32,66
SK Sturm Gra,2899,3,17,10,9,51,30,21,61
SC Rheindorf,2899,4,16,11,9,54,52,2,59
Rapid Vienna,2899,5,15,12,9,63,38,25,57
Admira Wacke,2899,6,12,9,15,33,50,-17,45
RZ Pellets W,2899,7,9,10,17,37,51,-14,37
St. Pölten,2899,8,8,13,15,49,69,-20,37
SV Josko Rie,2899,9,10,3,23,29,54,-25,33
Mattersburg,2899,10,7,11,18,36,61,-25,32
FC Salzburg,2900,1,21,6,9,58,30,28,69
SC Rheindorf,2900,2,21,5,10,55,42,13,68
SK Sturm Gra,2900,3,20,5,11,63,35,28,65
Vienna,2900,4,19,4,13,64,54,10,61
Rapid Vienna,2900,5,15,10,11,61,40,21,55
Admira Wacke,2900,6,16,3,17,38,51,-13,51
RZ Pellets W,2900,7,12,7,17,47,61,-14,43
St. Pölten,2900,8,9,10,17,46,71,-25,37
SV Josko Rie,2900,9,9,5,22,34,57,-23,32
Mattersburg,2900,10,6,9,21,33,58,-25,27
SK Sturm Gra,2901,1,22,5,9,67,34,33,71
Vienna,2901,2,22,3,11,63,49,14,69
FC Salzburg,2901,3,20,5,11,63,35,28,65
Rapid Vienna,2901,4,16,10,10,53,34,19,58
SC Rheindorf,2901,5,17,7,12,54,55,-1,58
RZ Pellets W,2901,6,11,10,15,51,52,-1,43
Mattersburg,2901,7,11,6,19,37,57,-20,39
SV Josko Rie,2901,8,10,7,19,30,53,-23,37
Admira Wacke,2901,9,10,6,20,33,57,-24,36
St. Pölten,2901,10,6,11,19,36,61,-25,29
FC Salzburg,2902,1,24,6,6,76,30,46,78
SC Rheindorf,2902,2,22,7,7,61,37,24,73
SK Sturm Gra,2902,3,21,6,9,64,37,27,69
Vienna,2902,4,19,5,12,63,52,11,62
Rapid Vienna,2902,5,12,9,15,47,44,3,45
Admira Wacke,2902,6,12,6,18,35,53,-18,42
RZ Pellets W,2902,7,11,5,20,46,65,-19,38
Mattersburg,2902,8,11,5,20,41,63,-22,38
SV Josko Rie,2902,9,10,5,21,38,59,-21,35
St. Pölten,2902,10,7,8,21,38,69,-31,29
FC Salzburg,2903,1,24,6,6,79,33,46,78
SC Rheindorf,2903,2,21,8,7,56,44,12,71
SK Sturm Gra,2903,3,19,8,9,54,27,27,65
Vienna,2903,4,17,3,16,58,56,2,54
RZ Pellets W,2903,5,14,8,14,50,53,-3,50
Rapid Vienna,2903,6,11,11,14,54,48,6,44
Admira Wacke,2903,7,11,5,20,40,64,-24,38
SV Josko Rie,2903,8,10,6,20,34,53,-19,36
St. Pölten,2903,9,7,12,17,44,67,-23,33
Mattersburg,2903,10,7,11,18,38,62,-24,32
FC Salzburg,2904,1,24,8,4,71,27,44,80
SC Rheindorf,2904,2,17,8,11,51,45,6,59
SK Sturm Gra,2904,3,16,9,11,57,40,17,57
Rapid Vienna,2904,4,15,11,10,55,34,21,56
Vienna,2904,5,14,9,13,59,58,1,51
RZ Pellets W,2904,6,14,6,16,45,57,-12,48
Admira Wacke,2904,7,11,7,18,39,61,-22,40
SV Josko Rie,2904,8,11,6,19,34,50,-16,39
Mattersburg,2904,9,9,8,19,39,56,-17,35
St. Pölten,2904,10,8,10,18,39,61,-22,34
FC Salzburg,2905,1,21,9,6,67,29,38,72
SC Rheindorf,2905,2,21,7,8,66,41,25,70
Vienna,2905,3,22,3,11,71,49,22,69
SK Sturm Gra,2905,4,17,6,13,55,41,14,57
Rapid Vienna,2905,5,15,10,11,56,45,11,55
RZ Pellets W,2905,6,13,6,17,54,62,-8,45
Admira Wacke,2905,7,11,7,18,39,63,-24,40
St. Pölten,2905,8,10,8,18,44,68,-24,38
Mattersburg,2905,9,8,7,21,39,62,-23,31
SV Josko Rie,2905,10,9,3,24,32,63,-31,30
FC Salzburg,2906,1,20,9,7,62,27,35,69
SK Sturm Gra,2906,2,18,9,9,60,33,27,63
Rapid Vienna,2906,3,16,10,10,59,39,20,58
Vienna,2906,4,16,6,14,59,55,4,54
SC Rheindorf,2906,5,15,9,12,41,48,-7,54
RZ Pellets W,2906,6,13,8,15,48,52,-4,47
Admira Wacke,2906,7,12,7,17,33,49,-16,43
SV Josko Rie,2906,8,11,8,17,39,52,-13,41
St. Pölten,2906,9,9,9,18,42,64,-22,36
Mattersburg,2906,10,9,7,20,32,56,-24,34
FC Salzburg,2907,1,23,6,7,66,32,34,75
Vienna,2907,2,19,6,11,62,47,15,63
SC Rheindorf,2907,3,19,6,11,51,44,7,63
SK Sturm Gra,2907,4,18,8,10,64,41,23,62
Rapid Vienna,2907,5,15,8,13,57,43,14,53
RZ Pellets W,2907,6,15,6,15,54,53,1,51
SV Josko Rie,2907,7,11,6,19,33,53,-20,39
Admira Wacke,2907,8,11,6,19,39,60,-21,39
Mattersburg,2907,9,10,5,21,37,58,-21,35
St. Pölten,2907,10,7,7,22,40,72,-32,28
FC Salzburg,2908,1,22,7,7,64,30,34,73
SC Rheindorf,2908,2,19,7,10,57,46,11,64
Vienna,2908,3,19,4,13,64,48,16,61
SK Sturm Gra,2908,4,17,9,10,55,34,21,60
Rapid Vienna,2908,5,15,11,10,65,40,25,56
St. Pölten,2908,6,12,8,16,57,66,-9,44
SV Josko Rie,2908,7,11,7,18,35,55,-20,40
Admira Wacke,2908,8,11,7,18,31,52,-21,40
RZ Pellets W,2908,9,11,6,19,47,67,-20,39
Mattersburg,2908,10,6,8,22,37,74,-37,26
SK Sturm Gra,2909,1,23,5,8,61,30,31,74
FC Salzburg,2909,2,22,5,9,67,29,38,71
SC Rheindorf,2909,3,22,5,9,58,40,18,71
Vienna,2909,4,18,3,15,57,53,4,57
Rapid Vienna,2909,5,15,9,12,58,41,17,54
RZ Pellets W,2909,6,13,5,18,44,55,-11,44
Admira Wacke,2909,7,11,6,19,35,66,-31,39
SV Josko Rie,2909,8,11,4,21,37,55,-18,37
St. Pölten,2909,9,10,7,19,45,65,-20,37
Mattersburg,2909,10,7,7,22,33,61,-28,28
FC Salzburg,2910,1,20,9,7,66,35,31,69
SK Sturm Gra,2910,2,18,11,7,58,28,30,65
SC Rheindorf,2910,3,18,9,9,45,39,6,63
Vienna,2910,4,17,8,11,61,49,12,59
RZ Pellets W,2910,5,12,9,15,45,57,-12,45
Rapid Vienna,2910,6,9,16,11,49,41,8,43
SV Josko Rie,2910,7,10,8,18,32,53,-21,38
Admira Wacke,2910,8,9,11,16,39,61,-22,38
Mattersburg,2910,9,8,11,17,39,54,-15,35
St. Pölten,2910,10,7,12,17,44,61,-17,33
FC Salzburg,2911,1,23,6,7,70,24,46,75
Vienna,2911,2,21,3,12,65,52,13,66
SK Sturm Gra,2911,3,19,8,9,61,33,28,65
SC Rheindorf,2911,4,18,6,12,53,48,5,60
Rapid Vienna,2911,5,13,12,11,53,40,13,51
St. Pölten,2911,6,11,9,16,48,63,-15,42
RZ Pellets W,2911,7,11,7,18,49,67,-18,40
SV Josko Rie,2911,8,12,4,20,34,56,-22,40
Admira Wacke,2911,9,10,6,20,40,66,-26,36
Mattersburg,2911,10,8,7,21,34,58,-24,31
SC Rheindorf,2912,1,23,6,7,60,36,24,75
FC Salzburg,2912,2,20,5,11,60,28,32,65
SK Sturm Gra,2912,3,18,5,13,54,42,12,59
Vienna,2912,4,17,6,13,66,53,13,57
Rapid Vienna,2912,5,15,11,10,55,36,19,56
RZ Pellets W,2912,6,12,9,15,49,57,-8,45
Admira Wacke,2912,7,12,7,17,35,55,-20,43
St. Pölten,2912,8,9,10,17,41,62,-21,37
SV Josko Rie,2912,9,10,5,21,35,61,-26,35
Mattersburg,2912,10,8,8,20,37,62,-25,32
FC Salzburg,2913,1,22,5,9,65,35,30,71
SK Sturm Gra,2913,2,21,7,8,63,28,35,70
SC Rheindorf,2913,3,19,4,13,47,51,-4,61
Vienna,2913,4,17,8,11,61,50,11,59
Rapid Vienna,2913,5,15,10,11,63,39,24,55
RZ Pellets W,2913,6,15,6,15,51,57,-6,51
Admira Wacke,2913,7,14,5,17,45,56,-11,47
St. Pölten,2913,8,8,10,18,43,67,-24,34
SV Josko Rie,2913,9,8,8,20,32,55,-23,32
Mattersburg,2913,10,5,9,22,35,67,-32,24
FC Salzburg,2914,1,22,8,6,65,32,33,74
SC Rheindorf,2914,2,18,9,9,50,42,8,63
SK Sturm Gra,2914,3,18,8,10,55,37,18,62
Vienna,2914,4,18,5,13,65,51,14,59
Rapid Vienna,2914,5,14,12,10,65,39,26,54
RZ Pellets W,2914,6,11,8,17,47,58,-11,41
SV Josko Rie,2914,7,12,4,20,39,51,-12,40
Mattersburg,2914,8,10,10,16,43,59,-16,40
Admira Wacke,2914,9,9,7,20,31,63,-32,34
St. Pölten,2914,10,7,11,18,37,65,-28,32
FC Salzburg,2915,1,22,6,8,68,33,35,72
SK Sturm Gra,2915,2,21,4,11,57,31,26,67
SC Rheindorf,2915,3,20,7,9,54,40,14,67
Vienna,2915,4,19,3,14,62,56,6,60
Rapid Vienna,2915,5,15,10,11,57,41,16,55
Admira Wacke,2915,6,12,8,16,42,53,-11,44
RZ Pellets W,2915,7,9,9,18,39,54,-15,36
SV Josko Rie,2915,8,10,6,20,33,57,-24,36
St. Pölten,2915,9,8,10,18,44,67,-23,34
Mattersburg,2915,10,8,9,19,33,57,-24,33
FC Salzburg,2916,1,22,6,8,69,32,37,72
SK Sturm Gra,2916,2,20,6,10,60,37,23,66
SC Rheindorf,2916,3,18,8,10,50,40,10,62
Rapid Vienna,2916,4,15,11,10,59,43,16,56
Vienna,2916,5,17,5,14,70,66,4,56
RZ Pellets W,2916,6,12,6,18,47,60,-13,42
Mattersburg,2916,7,11,6,19,40,58,-18,39
SV Josko Rie,2916,8,12,3,21,35,55,-20,39
St. Pölten,2916,9,10,8,18,50,65,-15,38
Admira Wacke,2916,10,10,7,19,37,61,-24,37
Vienna,2917,1,21,6,9,73,45,28,69
SC Rheindorf,2917,2,19,7,10,54,41,13,64
FC Salzburg,2917,3,18,9,9,68,38,30,63
SK Sturm Gra,2917,4,19,3,14,53,42,11,60
Rapid Vienna,2917,5,13,10,13,56,42,14,49
RZ Pellets W,2917,6,13,9,14,44,55,-11,48
Mattersburg,2917,7,11,11,14,41,52,-11,44
Admira Wacke,2917,8,9,9,18,29,58,-29,36
St. Pölten,2917,9,9,8,19,42,58,-16,35
SV Josko Rie,2917,10,9,6,21,31,60,-29,33
SK Sturm Gra,2918,1,21,6,9,66,30,36,69
FC Salzburg,2918,2,19,12,5,62,26,36,69
SC Rheindorf,2918,3,16,11,9,48,38,10,59
Vienna,2918,4,17,6,13,55,56,-1,57
Rapid Vienna,2918,5,15,9,12,52,38,14,54
SV Josko Rie,2918,6,15,5,16,38,47,-9,50
RZ Pellets W,2918,7,12,10,14,45,52,-7,46
St. Pölten,2918,8,9,9,18,41,62,-21,36
Admira Wacke,2918,9,9,6,21,31,61,-30,33
Mattersburg,2918,10,4,12,20,28,56,-28,24
FC Salzburg,2919,1,21,6,9,71,38,33,69
Vienna,2919,2,20,5,11,63,50,13,65
SK Sturm Gra,2919,3,18,6,12,53,35,18,60
SC Rheindorf,2919,4,16,8,12,48,46,2,56
Rapid Vienna,2919,5,15,9,12,58,43,15,54
SV Josko Rie,2919,6,14,5,17,43,54,-11,47
RZ Pellets W,2919,7,13,7,16,43,47,-4,46
Admira Wacke,2919,8,12,6,18,39,61,-22,42
Mattersburg,2919,9,8,9,19,37,57,-20,33
St. Pölten,2919,10,8,9,19,38,62,-24,33
FC Salzburg,2920,1,19,9,8,61,33,28,66
SC Rheindorf,2920,2,19,8,9,50,40,10,65
Vienna,2920,3,20,4,12,68,55,13,64
SK Sturm Gra,2920,4,18,6,12,59,36,23,60
Rapid Vienna,2920,5,13,11,12,55,42,13,50
RZ Pellets W,2920,6,14,6,16,51,55,-4,48
St. Pölten,2920,7,10,9,17,46,63,-17,39
Admira Wacke,2920,8,11,6,19,36,62,-26,39
SV Josko Rie,2920,9,11,5,20,41,57,-16,38
Mattersburg,2920,10,7,12,17,34,58,-24,33
SC Rheindorf,2921,1,21,8,7,56,39,17,71
SK Sturm Gra,2921,2,20,8,8,63,34,29,68
FC Salzburg,2921,3,19,8,9,59,29,30,65
Vienna,2921,4,19,5,12,62,52,10,62
Rapid Vienna,2921,5,14,11,11,56,41,15,53
SV Josko Rie,2921,6,13,5,18,37,47,-10,44
RZ Pellets W,2921,7,12,7,17,40,50,-10,43
Admira Wacke,2921,8,9,9,18,31,57,-26,36
Mattersburg,2921,9,7,9,20,37,60,-23,30
St. Pölten,2921,10,5,12,19,33,65,-32,27
FC Salzburg,2922,1,22,6,8,64,32,32,72
SC Rheindorf,2922,2,22,4,10,66,41,25,70
Vienna,2922,3,20,6,10,68,51,17,66
Rapid Vienna,2922,4,17,9,10,55,36,19,60
SK Sturm Gra,2922,5,17,6,13,54,40,14,57
Mattersburg,2922,6,12,5,19,38,58,-20,41
RZ Pellets W,2922,7,11,7,18,44,52,-8,40
St. Pölten,2922,8,8,11,17,34,58,-24,35
Admira Wacke,2922,9,9,7,20,35,61,-26,34
SV Josko Rie,2922,10,8,7,21,26,55,-29,31
FC Salzburg,2923,1,20,9,7,61,32,29,69
SC Rheindorf,2923,2,19,8,9,52,43,9,65
Rapid Vienna,2923,3,16,13,7,58,33,25,61
SK Sturm Gra,2923,4,18,7,11,49,29,20,61
Vienna,2923,5,19,2,15,61,49,12,59
Admira Wacke,2923,6,13,5,18,39,56,-17,44
RZ Pellets W,2923,7,11,7,18,41,57,-16,40
St. Pölten,2923,8,9,10,17,40,57,-17,37
SV Josko Rie,2923,9,10,5,21,33,56,-23,35
Mattersburg,2923,10,8,8,20,35,57,-22,32
SC Rheindorf,2924,1,21,6,9,57,43,14,69
FC Salzburg,2924,2,20,6,10,68,36,32,66
SK Sturm Gra,2924,3,17,7,12,58,40,18,58
Vienna,2924,4,17,7,12,63,56,7,58
Rapid Vienna,2924,5,13,13,10,61,45,16,52
SV Josko Rie,2924,6,15,5,16,45,53,-8,50
Admira Wacke,2924,7,12,7,17,39,60,-21,43
RZ Pellets W,2924,8,11,7,18,40,58,-18,40
Mattersburg,2924,9,8,10,18,42,61,-19,34
St. Pölten,2924,10,8,8,20,46,67,-21,32
FC Salzburg,2925,1,22,6,8,62,30,32,72
SC Rheindorf,2925,2,21,6,9,56,39,17,69
SK Sturm Gra,2925,3,20,6,10,57,29,28,66
Vienna,2925,4,19,4,13,64,51,13,61
Rapid Vienna,2925,5,14,12,10,52,37,15,54
SV Josko Rie,2925,6,12,5,19,39,52,-13,41
RZ Pellets W,2925,7,11,7,18,44,62,-18,40
St. Pölten,2925,8,10,7,19,45,64,-19,37
Mattersburg,2925,9,8,11,17,35,56,-21,35
Admira Wacke,2925,10,7,8,21,29,63,-34,29
SC Rheindorf,2926,1,22,6,8,69,44,25,72
SK Sturm Gra,2926,2,21,5,10,61,36,25,68
FC Salzburg,2926,3,20,6,10,60,32,28,66
Vienna,2926,4,18,5,13,65,55,10,59
Rapid Vienna,2926,5,15,10,11,66,49,17,55
SV Josko Rie,2926,6,13,4,19,41,56,-15,43
RZ Pellets W,2926,7,10,9,17,49,69,-20,39
Admira Wacke,2926,8,10,8,18,34,56,-22,38
St. Pölten,2926,9,10,7,19,38,61,-23,37
Mattersburg,2926,10,8,6,22,40,65,-25,30
FC Salzburg,2927,1,24,8,4,77,33,44,80
SK Sturm Gra,2927,2,20,7,9,61,33,28,67
SC Rheindorf,2927,3,20,7,9,54,41,13,67
Vienna,2927,4,18,5,13,59,50,9,59
RZ Pellets W,2927,5,14,6,16,47,58,-11,48
Rapid Vienna,2927,6,12,11,13,45,38,7,47
SV Josko Rie,2927,7,14,4,18,35,44,-9,46
Admira Wacke,2927,8,9,10,17,30,47,-17,37
St. Pölten,2927,9,6,10,20,39,71,-32,28
Mattersburg,2927,10,5,8,23,27,59,-32,23
FC Salzburg,2928,1,21,9,6,68,29,39,72
SK Sturm Gra,2928,2,20,6,10,57,33,24,66
SC Rheindorf,2928,3,19,9,8,56,40,16,66
Rapid Vienna,2928,4,15,11,10,55,37,18,56
Vienna,2928,5,15,9,12,57,55,2,54
RZ Pellets W,2928,6,13,7,16,43,51,-8,46
Admira Wacke,2928,7,10,6,20,41,66,-25,36
SV Josko Rie,2928,8,8,10,18,32,48,-16,34
Mattersburg,2928,9,9,7,20,33,63,-30,34
St. Pölten,2928,10,7,12,17,40,60,-20,33
FC Salzburg,2929,1,20,10,6,61,27,34,70
SK Sturm Gra,2929,2,19,7,10,65,34,31,64
Vienna,2929,3,18,8,10,63,47,16,62
SC Rheindorf,2929,4,17,7,12,46,45,1,58
Rapid Vienna,2929,5,16,9,11,58,43,15,57
RZ Pellets W,2929,6,14,8,14,50,54,-4,50
Admira Wacke,2929,7,11,5,20,36,58,-22,38
Mattersburg,2929,8,9,9,18,39,55,-16,36
St. Pölten,2929,9,8,10,18,37,68,-31,34
SV Josko Rie,2929,10,8,7,21,31,55,-24,31
SC Rheindorf,2930,1,22,6,8,55,37,18,72
FC Salzburg,2930,2,21,7,8,64,29,35,70
SK Sturm Gra,2930,3,19,8,9,57,29,28,65
Vienna,2930,4,20,2,14,60,52,8,62
RZ Pellets W,2930,5,14,9,13,49,53,-4,51
Rapid Vienna,2930,6,10,12,14,50,50,0,42
Mattersburg,2930,7,11,6,19,43,54,-11,39
Admira Wacke,2930,8,10,8,18,38,65,-27,38
St. Pölten,2930,9,8,9,19,39,62,-23,33
SV Josko Rie,2930,10,10,3,23,26,50,-24,33
SC Rheindorf,2931,1,24,7,5,63,34,29,79
FC Salzburg,2931,2,21,5,10,59,29,30,68
SK Sturm Gra,2931,3,21,5,10,64,40,24,68
Vienna,2931,4,19,6,11,65,48,17,63
RZ Pellets W,2931,5,14,7,15,52,57,-5,49
Rapid Vienna,2931,6,12,10,14,53,45,8,46
Mattersburg,2931,7,11,8,17,47,59,-12,41
SV Josko Rie,2931,8,9,8,19,33,54,-21,35
Admira Wacke,2931,9,9,5,22,31,62,-31,32
St. Pölten,2931,10,4,11,21,33,72,-39,23
FC Salzburg,2932,1,25,5,6,71,24,47,80
SC Rheindorf,2932,2,22,7,7,58,40,18,73
SK Sturm Gra,2932,3,19,7,10,62,37,25,64
Vienna,2932,4,18,6,12,61,51,10,60
Rapid Vienna,2932,5,12,12,12,52,43,9,48
RZ Pellets W,2932,6,12,8,16,44,57,-13,44
Admira Wacke,2932,7,12,5,19,40,60,-20,41
St. Pölten,2932,8,9,7,20,40,61,-21,34
SV Josko Rie,2932,9,9,5,22,33,65,-32,32
Mattersburg,2932,10,6,10,20,35,58,-23,28
Vienna,2933,1,21,6,9,71,47,24,69
FC Salzburg,2933,2,20,7,9,63,28,35,67
SC Rheindorf,2933,3,20,7,9,54,39,15,67
Rapid Vienna,2933,4,16,10,10,52,37,15,58
SK Sturm Gra,2933,5,16,7,13,53,36,17,55
SV Josko Rie,2933,6,12,7,17,35,52,-17,43
RZ Pellets W,2933,7,11,8,17,42,53,-11,41
Admira Wacke,2933,8,11,4,21,37,72,-35,37
St. Pölten,2933,9,9,9,18,45,63,-18,36
Mattersburg,2933,10,7,9,20,31,56,-25,30
FC Salzburg,2934,1,20,7,9,64,32,32,67
SK Sturm Gra,2934,2,20,6,10,60,31,29,66
SC Rheindorf,2934,3,19,8,9,57,47,10,65
Vienna,2934,4,19,7,10,63,44,19,64
Rapid Vienna,2934,5,15,9,12,53,42,11,54
St. Pölten,2934,6,11,9,16,43,57,-14,42
Mattersburg,2934,7,11,8,17,35,49,-14,41
RZ Pellets W,2934,8,11,4,21,43,61,-18,37
Admira Wacke,2934,9,10,6,20,39,67,-28,36
SV Josko Rie,2934,10,9,6,21,33,60,-27,33
FC Salzburg,2935,1,23,5,8,65,32,33,74
Vienna,2935,2,23,4,9,73,45,28,73
SK Sturm Gra,2935,3,21,4,11,62,37,25,67
SC Rheindorf,2935,4,20,6,10,58,45,13,66
Rapid Vienna,2935,5,16,9,11,53,38,15,57
RZ Pellets W,2935,6,12,6,18,50,64,-14,42
St. Pölten,2935,7,8,10,18,39,62,-23,34
SV Josko Rie,2935,8,9,7,20,35,59,-24,34
Admira Wacke,2935,9,10,4,22,34,61,-27,34
Mattersburg,2935,10,5,11,20,37,63,-26,26
FC Salzburg,2936,1,22,6,8,67,35,32,72
SC Rheindorf,2936,2,19,7,10,53,43,10,64
SK Sturm Gra,2936,3,17,9,10,55,32,23,60
Vienna,2936,4,17,5,14,57,50,7,56
Rapid Vienna,2936,5,13,12,11,51,38,13,51
Admira Wacke,2936,6,12,7,17,38,58,-20,43
RZ Pellets W,2936,7,11,9,16,40,51,-11,42
Mattersburg,2936,8,11,7,18,42,53,-11,40
St. Pölten,2936,9,9,10,17,42,62,-20,37
SV Josko Rie,2936,10,10,6,20,36,59,-23,36
FC Salzburg,2937,1,20,7,9,73,37,36,67
SK Sturm Gra,2937,2,19,8,9,61,34,27,65
Vienna,2937,3,19,7,10,70,51,19,64
Rapid Vienna,2937,4,17,9,10,55,38,17,60
SC Rheindorf,2937,5,16,8,12,50,49,1,56
Admira Wacke,2937,6,13,5,18,39,60,-21,44
SV Josko Rie,2937,7,12,4,20,40,53,-13,40
Mattersburg,2937,8,10,8,18,42,56,-14,38
St. Pölten,2937,9,9,9,18,46,68,-22,36
RZ Pellets W,2937,10,9,7,20,42,72,-30,34
FC Salzburg,2938,1,22,8,6,64,25,39,74
SC Rheindorf,2938,2,20,7,9,52,35,17,67
SK Sturm Gra,2938,3,17,8,11,54,37,17,59
Vienna,2938,4,18,5,13,61,57,4,59
Rapid Vienna,2938,5,15,10,11,54,40,14,55
Admira Wacke,2938,6,12,7,17,45,57,-12,43
SV Josko Rie,2938,7,11,9,16,40,50,-10,42
St. Pölten,2938,8,10,10,16,38,57,-19,40
RZ Pellets W,2938,9,9,9,18,38,57,-19,36
Mattersburg,2938,10,5,9,22,30,61,-31,24
Vienna,2939,1,21,7,8,69,45,24,70
FC Salzburg,2939,2,20,7,9,57,31,26,67
SC Rheindorf,2939,3,19,9,8,57,42,15,66
SK Sturm Gra,2939,4,19,6,11,58,36,22,63
Rapid Vienna,2939,5,16,11,9,65,39,26,59
RZ Pellets W,2939,6,10,8,18,46,66,-20,38
Mattersburg,2939,7,8,11,17,42,58,-16,35
SV Josko Rie,2939,8,10,5,21,40,61,-21,35
Admira Wacke,2939,9,9,8,19,40,71,-31,35
St. Pölten,2939,10,7,10,19,43,68,-25,31
FC Salzburg,2940,1,22,7,7,71,35,36,73
Vienna,2940,2,22,5,9,74,43,31,71
SC Rheindorf,2940,3,19,6,11,52,46,6,63
SK Sturm Gra,2940,4,18,8,10,64,39,25,62
Rapid Vienna,2940,5,12,12,12,58,48,10,48
RZ Pellets W,2940,6,12,8,16,46,58,-12,44
Admira Wacke,2940,7,11,7,18,42,62,-20,40
SV Josko Rie,2940,8,9,7,20,35,56,-21,34
St. Pölten,2940,9,9,7,20,39,69,-30,34
Mattersburg,2940,10,8,9,19,37,62,-25,33
FC Salzburg,2941,1,24,5,7,67,26,41,77
SK Sturm Gra,2941,2,19,5,12,59,37,22,62
SC Rheindorf,2941,3,18,8,10,53,42,11,62
Rapid Vienna,2941,4,17,9,10,49,37,12,60
Vienna,2941,5,15,5,16,55,53,2,50
RZ Pellets W,2941,6,13,7,16,40,56,-16,46
Admira Wacke,2941,7,13,5,18,41,57,-16,44
SV Josko Rie,2941,8,11,5,20,30,49,-19,38
St. Pölten,2941,9,8,10,18,44,62,-18,34
Mattersburg,2941,10,9,7,20,36,55,-19,34
FC Salzburg,2942,1,23,5,8,61,29,32,74
Rapid Vienna,2942,2,17,10,9,62,34,28,61
SC Rheindorf,2942,3,18,7,11,52,40,12,61
Vienna,2942,4,18,3,15,63,54,9,57
SK Sturm Gra,2942,5,16,7,13,56,39,17,55
RZ Pellets W,2942,6,14,5,17,47,58,-11,47
Admira Wacke,2942,7,13,7,16,36,52,-16,46
SV Josko Rie,2942,8,13,4,19,41,59,-18,43
Mattersburg,2942,9,9,7,20,37,62,-25,34
St. Pölten,2942,10,7,9,20,38,66,-28,30
SC Rheindorf,2943,1,21,9,6,57,33,24,72
FC Salzburg,2943,2,17,11,8,61,34,27,62
Vienna,2943,3,17,6,13,60,49,11,57
SK Sturm Gra,2943,4,15,7,14,46,37,9,52
Rapid Vienna,2943,5,12,15,9,58,38,20,51
RZ Pellets W,2943,6,12,10,14,52,57,-5,46
SV Josko Rie,2943,7,11,6,19,33,54,-21,39
St. Pölten,2943,8,9,11,16,39,60,-21,38
Admira Wacke,2943,9,10,8,18,34,61,-27,38
Mattersburg,2943,10,8,13,15,37,54,-17,37
FC Salzburg,2944,1,23,6,7,70,33,37,75
SC Rheindorf,2944,2,21,7,8,59,38,21,70
SK Sturm Gra,2944,3,20,6,10,56,36,20,66
Vienna,2944,4,20,5,11,70,52,18,65
Rapid Vienna,2944,5,12,10,14,62,49,13,46
RZ Pellets W,2944,6,10,10,16,46,61,-15,40
Admira Wacke,2944,7,11,6,19,44,70,-26,39
SV Josko Rie,2944,8,11,4,21,36,58,-22,37
St. Pölten,2944,9,8,11,17,43,65,-22,35
Mattersburg,2944,10,7,9,20,38,62,-24,30
FC Salzburg,2945,1,23,8,5,71,29,42,77
SC Rheindorf,2945,2,21,9,6,58,36,22,72
SK Sturm Gra,2945,3,19,6,11,60,36,24,63
Vienna,2945,4,18,5,13,56,54,2,59
Rapid Vienna,2945,5,16,9,11,61,42,19,57
Admira Wacke,2945,6,12,6,18,42,61,-19,42
SV Josko Rie,2945,7,12,3,21,39,54,-15,39
RZ Pellets W,2945,8,10,6,20,49,68,-19,36
Mattersburg,2945,9,9,8,19,41,62,-21,35
St. Pölten,2945,10,5,10,21,35,70,-35,25
FC Salzburg,2946,1,23,7,6,74,28,46,76
SK Sturm Gra,2946,2,21,6,9,69,38,31,69
SC Rheindorf,2946,3,19,8,9,56,44,12,65
Vienna,2946,4,17,7,12,65,58,7,58
Rapid Vienna,2946,5,15,11,10,54,35,19,56
RZ Pellets W,2946,6,11,9,16,46,60,-14,42
St. Pölten,2946,7,10,10,16,47,64,-17,40
Admira Wacke,2946,8,12,4,20,38,63,-25,40
SV Josko Rie,2946,9,8,6,22,33,59,-26,30
Mattersburg,2946,10,5,10,21,33,66,-33,25
SK Sturm Gra,2947,1,22,5,9,63,30,33,71
FC Salzburg,2947,2,19,11,6,60,31,29,68
Vienna,2947,3,20,7,9,66,49,17,67
Rapid Vienna,2947,4,15,11,10,60,40,20,56
SC Rheindorf,2947,5,15,10,11,50,42,8,55
RZ Pellets W,2947,6,12,9,15,42,51,-9,45
SV Josko Rie,2947,7,10,7,19,33,54,-21,37
Admira Wacke,2947,8,9,8,19,31,59,-28,35
St. Pölten,2947,9,8,9,19,43,71,-28,33
Mattersburg,2947,10,7,9,20,31,52,-21,30
SC Rheindorf,2948,1,21,8,7,57,39,18,71
FC Salzburg,2948,2,20,9,7,60,26,34,69
SK Sturm Gra,2948,3,20,6,10,61,33,28,66
Vienna,2948,4,19,5,12,58,44,14,62
RZ Pellets W,2948,5,14,6,16,51,61,-10,48
Admira Wacke,2948,6,12,7,17,42,61,-19,43
Rapid Vienna,2948,7,10,12,14,44,41,3,42
SV Josko Rie,2948,8,11,7,18,36,55,-19,40
Mattersburg,2948,9,9,7,20,37,54,-17,34
St. Pölten,2948,10,6,9,21,39,71,-32,27
FC Salzburg,2949,1,22,7,7,69,28,41,73
SC Rheindorf,2949,2,20,7,9,55,42,13,67
RZ Pellets W,2949,3,18,5,13,54,47,7,59
SK Sturm Gra,2949,4,17,7,12,61,33,28,58
Rapid Vienna,2949,5,14,10,12,59,45,14,52
Vienna,2949,6,15,5,16,52,53,-1,50
SV Josko Rie,2949,7,12,4,20,40,62,-22,40
St. Pölten,2949,8,11,7,18,48,74,-26,40
Mattersburg,2949,9,10,8,18,40,57,-17,38
Admira Wacke,2949,10,9,4,23,30,67,-37,31
SK Sturm Gra,2950,1,22,4,10,64,32,32,70
SC Rheindorf,2950,2,20,6,10,57,38,19,66
FC Salzburg,2950,3,17,8,11,67,45,22,59
RZ Pellets W,2950,4,17,8,11,62,49,13,59
Rapid Vienna,2950,5,16,10,10,66,44,22,58
Vienna,2950,6,17,5,14,63,59,4,56
SV Josko Rie,2950,7,10,6,20,33,55,-22,36
Admira Wacke,2950,8,10,6,20,39,68,-29,36
Mattersburg,2950,9,9,8,19,35,62,-27,35
St. Pölten,2950,10,8,7,21,38,72,-34,31
FC Salzburg,2951,1,21,6,9,65,31,34,69
SK Sturm Gra,2951,2,19,8,9,61,35,26,65
SC Rheindorf,2951,3,17,11,8,52,39,13,62
Vienna,2951,4,19,5,12,61,50,11,62
Rapid Vienna,2951,5,16,11,9,63,43,20,59
RZ Pellets W,2951,6,13,7,16,44,56,-12,46
Admira Wacke,2951,7,11,8,17,35,55,-20,41
SV Josko Rie,2951,8,11,6,19,36,53,-17,39
St. Pölten,2951,9,7,8,21,42,70,-28,29
Mattersburg,2951,10,6,10,20,32,59,-27,28
FC Salzburg,2952,1,23,6,7,68,28,40,75
SK Sturm Gra,2952,2,21,6,9,63,33,30,69
SC Rheindorf,2952,3,20,8,8,58,42,16,68
Vienna,2952,4,19,6,11,67,46,21,63
Rapid Vienna,2952,5,14,8,14,48,40,8,50
RZ Pellets W,2952,6,12,4,20,37,53,-16,40
Admira Wacke,2952,7,10,7,19,31,57,-26,37
SV Josko Rie,2952,8,11,3,22,33,60,-27,36
Mattersburg,2952,9,9,8,19,38,53,-15,35
St. Pölten,2952,10,9,8,19,44,75,-31,35
SC Rheindorf,2953,1,20,7,9,57,42,15,67
FC Salzburg,2953,2,20,5,11,64,34,30,65
Vienna,2953,3,20,3,13,68,58,10,63
Rapid Vienna,2953,4,16,9,11,56,40,16,57
SK Sturm Gra,2953,5,15,7,14,51,37,14,52
RZ Pellets W,2953,6,14,6,16,46,52,-6,48
Admira Wacke,2953,7,12,6,18,37,63,-26,42
Mattersburg,2953,8,11,7,18,39,55,-16,40
SV Josko Rie,2953,9,12,3,21,37,50,-13,39
St. Pölten,2953,10,10,7,19,39,63,-24,37
FC Salzburg,2954,1,23,7,6,66,24,42,76
Vienna,2954,2,20,5,11,71,59,12,65
SC Rheindorf,2954,3,19,5,12,50,40,10,62
SK Sturm Gra,2954,4,17,8,11,56,37,19,59
Rapid Vienna,2954,5,14,10,12,53,38,15,52
Admira Wacke,2954,6,12,6,18,36,56,-20,42
Mattersburg,2954,7,12,5,19,41,61,-20,41
RZ Pellets W,2954,8,11,6,19,43,59,-16,39
St. Pölten,2954,9,10,8,18,45,65,-20,38
SV Josko Rie,2954,10,9,6,21,35,57,-22,33
FC Salzburg,2955,1,22,5,9,67,25,42,71
SK Sturm Gra,2955,2,22,5,9,64,31,33,71
Vienna,2955,3,19,5,12,60,50,10,62
SC Rheindorf,2955,4,17,8,11,49,46,3,59
RZ Pellets W,2955,5,15,7,14,43,45,-2,52
Rapid Vienna,2955,6,12,10,14,49,48,1,46
Admira Wacke,2955,7,12,5,19,33,59,-26,41
St. Pölten,2955,8,10,9,17,40,57,-17,39
Mattersburg,2955,9,8,8,20,35,54,-19,32
SV Josko Rie,2955,10,8,8,20,25,50,-25,32
FC Salzburg,2956,1,24,5,7,77,32,45,77
SC Rheindorf,2956,2,22,7,7,60,41,19,73
Vienna,2956,3,20,4,12,59,45,14,64
SK Sturm Gra,2956,4,19,5,12,56,37,19,62
Rapid Vienna,2956,5,13,10,13,61,46,15,49
RZ Pellets W,2956,6,14,6,16,45,53,-8,48
SV Josko Rie,2956,7,11,7,18,42,51,-9,40
Admira Wacke,2956,8,10,5,21,40,69,-29,35
St. Pölten,2956,9,7,9,20,38,71,-33,30
Mattersburg,2956,10,7,8,21,37,70,-33,29
FC Salzburg,2957,1,19,12,5,60,23,37,69
SC Rheindorf,2957,2,19,6,11,59,49,10,63
SK Sturm Gra,2957,3,18,7,11,57,38,19,61
Vienna,2957,4,18,7,11,66,56,10,61
Admira Wacke,2957,5,16,7,13,39,46,-7,55
Rapid Vienna,2957,6,12,14,10,58,38,20,50
RZ Pellets W,2957,7,11,7,18,45,57,-12,40
Mattersburg,2957,8,9,9,18,40,55,-15,36
SV Josko Rie,2957,9,8,7,21,31,59,-28,31
St. Pölten,2957,10,7,10,19,33,67,-34,31
SK Sturm Gra,2958,1,21,4,11,67,34,33,67
FC Salzburg,2958,2,19,9,8,61,33,28,66
SC Rheindorf,2958,3,18,11,7,55,38,17,65
Rapid Vienna,2958,4,15,10,11,58,43,15,55
Vienna,2958,5,16,7,13,62,56,6,55
RZ Pellets W,2958,6,13,10,13,53,59,-6,49
St. Pölten,2958,7,8,13,15,39,56,-17,37
Admira Wacke,2958,8,9,9,18,37,62,-25,36
Mattersburg,2958,9,8,10,18,38,56,-18,34
SV Josko Rie,2958,10,8,7,21,31,64,-33,31
SC Rheindorf,2959,1,23,6,7,61,37,24,75
FC Salzburg,2959,2,20,8,8,66,30,36,68
Vienna,2959,3,20,4,12,60,46,14,64
SK Sturm Gra,2959,4,16,8,12,55,42,13,56
RZ Pellets W,2959,5,15,6,15,43,52,-9,51
Rapid Vienna,2959,6,12,9,15,46,41,5,45
SV Josko Rie,2959,7,11,6,19,39,55,-16,39
St. Pölten,2959,8,10,9,17,44,62,-18,39
Admira Wacke,2959,9,11,6,19,37,64,-27,39
Mattersburg,2959,10,7,8,21,37,59,-22,29
SK Sturm Gra,2960,1,21,7,8,56,27,29,70
FC Salzburg,2960,2,19,8,9,63,35,28,65
SC Rheindorf,2960,3,17,9,10,52,44,8,60
Vienna,2960,4,17,6,13,61,48,13,57
Admira Wacke,2960,5,16,6,14,41,49,-8,54
Rapid Vienna,2960,6,11,12,13,51,42,9,45
SV Josko Rie,2960,7,12,5,19,36,52,-16,41
Mattersburg,2960,8,9,9,18,38,55,-17,36
RZ Pellets W,2960,9,9,8,19,41,65,-24,35
St. Pölten,2960,10,6,16,14,39,61,-22,34
SC Rheindorf,2961,1,22,5,9,64,40,24,71
FC Salzburg,2961,2,19,9,8,58,27,31,66
SK Sturm Gra,2961,3,19,8,9,55,25,30,65
RZ Pellets W,2961,4,15,9,12,58,56,2,54
Vienna,2961,5,16,6,14,56,57,-1,54
Rapid Vienna,2961,6,14,10,12,54,35,19,52
Admira Wacke,2961,7,12,6,18,35,65,-30,42
St. Pölten,2961,8,8,10,18,39,62,-23,34
Mattersburg,2961,9,9,6,21,34,59,-25,33
SV Josko Rie,2961,10,10,3,23,34,61,-27,33
FC Salzburg,2962,1,21,8,7,58,25,33,71
SC Rheindorf,2962,2,20,7,9,54,39,15,67
SK Sturm Gra,2962,3,18,7,11,57,37,20,61
Rapid Vienna,2962,4,15,12,9,51,33,18,57
Vienna,2962,5,17,2,17,57,52,5,53
RZ Pellets W,2962,6,15,8,13,44,42,2,53
Admira Wacke,2962,7,10,10,16,35,55,-20,40
SV Josko Rie,2962,8,10,5,21,29,55,-26,35
Mattersburg,2962,9,7,12,17,33,49,-16,33
St. Pölten,2962,10,6,11,19,40,71,-31,29
FC Salzburg,2963,1,23,7,6,77,32,45,76
Vienna,2963,2,21,3,12,74,50,24,66
SC Rheindorf,2963,3,18,6,12,55,44,11,60
SK Sturm Gra,2963,4,18,4,14,48,38,10,58
Rapid Vienna,2963,5,15,12,9,59,42,17,57
Admira Wacke,2963,6,14,5,17,45,60,-15,47
SV Josko Rie,2963,7,12,4,20,37,52,-15,40
RZ Pellets W,2963,8,11,7,18,47,68,-21,40
Mattersburg,2963,9,8,9,19,39,65,-26,33
St. Pölten,2963,10,5,13,18,35,65,-30,28
FC Salzburg,2964,1,22,6,8,67,31,36,72
SK Sturm Gra,2964,2,20,8,8,54,26,28,68
Vienna,2964,3,19,4,13,65,56,9,61
SC Rheindorf,2964,4,17,8,11,51,46,5,59
Rapid Vienna,2964,5,16,9,11,58,37,21,57
RZ Pellets W,2964,6,13,7,16,44,53,-9,46
Mattersburg,2964,7,11,8,17,42,51,-9,41
Admira Wacke,2964,8,9,8,19,33,58,-25,35
SV Josko Rie,2964,9,8,8,20,30,56,-26,32
St. Pölten,2964,10,7,10,19,36,66,-30,31
FC Salzburg,2965,1,23,6,7,70,34,36,75
SC Rheindorf,2965,2,20,11,5,68,46,22,71
Vienna,2965,3,19,6,11,67,51,16,63
SK Sturm Gra,2965,4,17,7,12,58,42,16,58
RZ Pellets W,2965,5,15,6,15,51,58,-7,51
Admira Wacke,2965,6,14,7,15,47,60,-13,49
Rapid Vienna,2965,7,10,12,14,49,49,0,42
Mattersburg,2965,8,9,8,19,45,60,-15,35
SV Josko Rie,2965,9,9,3,24,33,58,-25,30
St. Pölten,2965,10,7,8,21,42,72,-30,29
SC Rheindorf,2966,1,22,5,9,62,40,22,71
SK Sturm Gra,2966,2,21,4,11,66,39,27,67
FC Salzburg,2966,3,19,8,9,68,37,31,65
Vienna,2966,4,19,6,11,68,54,14,63
Admira Wacke,2966,5,12,10,14,40,53,-13,46
Rapid Vienna,2966,6,11,12,13,52,43,9,45
RZ Pellets W,2966,7,11,7,18,44,61,-17,40
St. Pölten,2966,8,10,10,16,43,68,-25,40
Mattersburg,2966,9,10,7,19,49,64,-15,37
SV Josko Rie,2966,10,8,5,23,35,68,-33,29
Vienna,2967,1,21,7,8,63,43,20,70
FC Salzburg,2967,2,20,8,8,63,29,34,68
SC Rheindorf,2967,3,20,7,9,54,40,14,67
SK Sturm Gra,2967,4,16,8,12,57,40,17,56
RZ Pellets W,2967,5,15,5,16,56,58,-2,50
Rapid Vienna,2967,6,13,9,14,49,42,7,48
Admira Wacke,2967,7,13,7,16,40,55,-15,46
SV Josko Rie,2967,8,11,4,21,33,56,-23,37
St. Pölten,2967,9,9,9,18,45,66,-21,36
Mattersburg,2967,10,7,6,23,33,64,-31,27
FC Salzburg,2968,1,21,9,6,65,30,35,72
SK Sturm Gra,2968,2,18,7,11,60,39,21,61
Vienna,2968,3,18,6,12,61,51,10,60
SC Rheindorf,2968,4,16,7,13,50,49,1,55
Rapid Vienna,2968,5,13,12,11,63,43,20,51
St. Pölten,2968,6,11,10,15,50,65,-15,43
SV Josko Rie,2968,7,12,6,18,38,54,-16,42
RZ Pellets W,2968,8,10,11,15,43,54,-11,41
Admira Wacke,2968,9,10,7,19,32,58,-26,37
Mattersburg,2968,10,8,11,17,35,54,-19,35
SC Rheindorf,2969,1,23,7,6,57,34,23,76
Vienna,2969,2,21,5,10,68,47,21,68
FC Salzburg,2969,3,20,7,9,63,31,32,67
SK Sturm Gra,2969,4,20,7,9,65,36,29,67
Rapid Vienna,2969,5,13,9,14,52,46,6,48
RZ Pellets W,2969,6,11,10,15,37,46,-9,43
Admira Wacke,2969,7,11,7,18,41,66,-25,40
SV Josko Rie,2969,8,11,5,20,33,52,-19,38
Mattersburg,2969,9,7,7,22,34,66,-32,28
St. Pölten,2969,10,5,12,19,38,64,-26,27
FC Salzburg,2970,1,21,7,8,68,31,37,70
SK Sturm Gra,2970,2,20,6,10,58,33,25,66
Vienna,2970,3,20,5,11,67,50,17,65
SC Rheindorf,2970,4,17,12,7,55,43,12,63
Rapid Vienna,2970,5,12,10,14,52,44,8,46
RZ Pellets W,2970,6,12,8,16,49,56,-7,44
SV Josko Rie,2970,7,11,6,19,35,58,-23,39
Admira Wacke,2970,8,10,8,18,34,59,-25,38
St. Pölten,2970,9,9,10,17,50,67,-17,37
Mattersburg,2970,10,9,6,21,36,63,-27,33
SC Rheindorf,2971,1,18,10,8,57,46,11,64
FC Salzburg,2971,2,18,8,10,60,41,19,62
Rapid Vienna,2971,3,15,12,9,57,39,18,57
SK Sturm Gra,2971,4,17,6,13,56,41,15,57
Vienna,2971,5,16,9,11,62,51,11,57
Admira Wacke,2971,6,16,5,15,45,52,-7,53
RZ Pellets W,2971,7,13,8,15,47,54,-7,47
Mattersburg,2971,8,9,10,17,43,60,-17,37
St. Pölten,2971,9,7,12,17,50,63,-13,33
SV Josko Rie,2971,10,8,6,22,31,61,-30,30
FC Salzburg,2972,1,24,6,6,64,23,41,78
SC Rheindorf,2972,2,22,8,6,56,33,23,74
SK Sturm Gra,2972,3,20,7,9,57,31,26,67
Rapid Vienna,2972,4,16,11,9,60,36,24,59
Vienna,2972,5,16,5,15,53,59,-6,53
RZ Pellets W,2972,6,12,9,15,46,53,-7,45
Admira Wacke,2972,7,12,6,18,39,61,-22,42
SV Josko Rie,2972,8,11,4,21,33,51,-18,37
St. Pölten,2972,9,6,7,23,38,68,-30,25
Mattersburg,2972,10,6,7,23,30,61,-31,25
SC Rheindorf,2973,1,20,9,7,63,41,22,69
FC Salzburg,2973,2,18,12,6,65,32,33,66
Vienna,2973,3,20,5,11,66,44,22,65
SK Sturm Gra,2973,4,17,10,9,47,30,17,61
Rapid Vienna,2973,5,15,9,12,54,42,12,54
Admira Wacke,2973,6,13,6,17,40,62,-22,45
RZ Pellets W,2973,7,11,8,17,43,60,-17,41
SV Josko Rie,2973,8,10,6,20,35,57,-22,36
Mattersburg,2973,9,8,9,19,37,58,-21,33
St. Pölten,2973,10,6,10,20,44,68,-24,28
FC Salzburg,2974,1,22,6,8,64,33,31,72
SC Rheindorf,2974,2,22,6,8,55,39,16,72
Vienna,2974,3,22,3,11,69,50,19,69
SK Sturm Gra,2974,4,18,5,13,62,40,22,59
Rapid Vienna,2974,5,14,10,12,49,39,10,52
Admira Wacke,2974,6,12,6,18,40,60,-20,42
St. Pölten,2974,7,10,10,16,42,63,-21,40
RZ Pellets W,2974,8,10,8,18,49,59,-10,38
Mattersburg,2974,9,6,12,18,38,59,-21,30
SV Josko Rie,2974,10,8,6,22,26,52,-26,30
FC Salzburg,2975,1,22,7,7,65,29,36,73
SC Rheindorf,2975,2,20,7,9,52,39,13,67
Vienna,2975,3,20,5,11,71,49,22,65
SK Sturm Gra,2975,4,16,8,12,54,36,18,56
Rapid Vienna,2975,5,13,12,11,55,39,16,51
SV Josko Rie,2975,6,13,4,19,37,53,-16,43
Admira Wacke,2975,7,11,8,17,39,62,-23,41
RZ Pellets W,2975,8,10,8,18,43,63,-20,38
Mattersburg,2975,9,8,10,18,29,49,-20,34
St. Pölten,2975,10,9,7,20,41,67,-26,34
FC Salzburg,2976,1,23,4,9,68,29,39,73
SC Rheindorf,2976,2,19,8,9,63,48,15,65
Rapid Vienna,2976,3,18,9,9,64,33,31,63
SK Sturm Gra,2976,4,17,8,11,54,38,16,59
Vienna,2976,5,18,4,14,65,57,8,58
Admira Wacke,2976,6,12,7,17,40,67,-27,43
RZ Pellets W,2976,7,12,6,18,46,56,-10,42
SV Josko Rie,2976,8,10,7,19,33,53,-20,37
Mattersburg,2976,9,8,10,18,40,58,-18,34
St. Pölten,2976,10,8,7,21,37,71,-34,31
SC Rheindorf,2977,1,24,5,7,64,39,25,77
FC Salzburg,2977,2,20,9,7,64,31,33,69
SK Sturm Gra,2977,3,19,5,12,61,41,20,62
Vienna,2977,4,16,6,14,60,56,4,54
Rapid Vienna,2977,5,13,14,9,62,44,18,53
RZ Pellets W,2977,6,13,8,15,50,56,-6,47
Admira Wacke,2977,7,11,7,18,41,59,-18,40
SV Josko Rie,2977,8,9,8,19,34,56,-22,35
Mattersburg,2977,9,6,13,17,35,59,-24,31
St. Pölten,2977,10,7,9,20,37,67,-30,30
SC Rheindorf,2978,1,22,5,9,59,38,21,71
FC Salzburg,2978,2,19,8,9,58,29,29,65
Vienna,2978,3,18,7,11,61,47,14,61
SK Sturm Gra,2978,4,17,8,11,57,38,19,59
Rapid Vienna,2978,5,15,11,10,58,39,19,56
RZ Pellets W,2978,6,10,9,17,38,57,-19,39
Admira Wacke,2978,7,11,6,19,37,61,-24,39
Mattersburg,2978,8,9,11,16,40,54,-14,38
SV Josko Rie,2978,9,10,8,18,31,49,-18,38
St. Pölten,2978,10,7,11,18,39,66,-27,32
FC Salzburg,2979,1,22,6,8,72,41,31,72
SC Rheindorf,2979,2,21,7,8,63,44,19,70
SK Sturm Gra,2979,3,18,8,10,59,36,23,62
Vienna,2979,4,17,6,13,67,62,5,57
Rapid Vienna,2979,5,14,9,13,56,45,11,51
RZ Pellets W,2979,6,14,6,16,53,59,-6,48
Admira Wacke,2979,7,13,6,17,45,63,-18,45
St. Pölten,2979,8,10,9,17,51,67,-16,39
SV Josko Rie,2979,9,9,6,21,40,67,-27,33
Mattersburg,2979,10,7,7,22,43,65,-22,28
SK Sturm Gra,2980,1,19,6,11,62,37,25,63
SC Rheindorf,2980,2,18,8,10,52,42,10,62
FC Salzburg,2980,3,18,7,11,60,34,26,61
Rapid Vienna,2980,4,17,9,10,60,40,20,60
Vienna,2980,5,18,5,13,59,56,3,59
RZ Pellets W,2980,6,16,6,14,54,51,3,54
SV Josko Rie,2980,7,15,4,17,43,47,-4,49
Admira Wacke,2980,8,11,5,20,32,59,-27,38
Mattersburg,2980,9,7,10,19,33,61,-28,31
St. Pölten,2980,10,7,8,21,37,65,-28,29
FC Salzburg,2981,1,24,5,7,71,27,44,77
SC Rheindorf,2981,2,19,7,10,51,42,9,64
SK Sturm Gra,2981,3,19,6,11,51,32,19,63
Vienna,2981,4,17,9,10,62,49,13,60
Rapid Vienna,2981,5,14,7,15,54,43,11,49
RZ Pellets W,2981,6,12,6,18,45,58,-13,42
SV Josko Rie,2981,7,11,5,20,33,50,-17,38
Admira Wacke,2981,8,10,8,18,35,60,-25,38
St. Pölten,2981,9,9,10,17,48,70,-22,37
Mattersburg,2981,10,8,11,17,33,52,-19,35
FC Salzburg,2982,1,22,6,8,67,32,35,72
SC Rheindorf,2982,2,20,6,10,54,40,14,66
Rapid Vienna,2982,3,18,9,9,71,38,33,63
Vienna,2982,4,19,4,13,63,52,11,61
SK Sturm Gra,2982,5,18,5,13,55,34,21,59
RZ Pellets W,2982,6,13,6,17,47,57,-10,45
Admira Wacke,2982,7,13,6,17,33,51,-18,45
St. Pölten,2982,8,11,7,18,36,58,-22,40
SV Josko Rie,2982,9,9,4,23,24,58,-34,31
Mattersburg,2982,10,6,9,21,27,57,-30,27
Vienna,2983,1,24,3,9,78,43,35,75
FC Salzburg,2983,2,21,7,8,65,30,35,70
SC Rheindorf,2983,3,20,7,9,58,38,20,67
SK Sturm Gra,2983,4,16,8,12,60,39,21,56
Rapid Vienna,2983,5,11,13,12,51,43,8,46
Admira Wacke,2983,6,13,7,16,39,59,-20,46
SV Josko Rie,2983,7,12,5,19,37,50,-13,41
St. Pölten,2983,8,10,7,19,39,67,-28,37
RZ Pellets W,2983,9,9,6,21,39,73,-34,33
Mattersburg,2983,10,7,11,18,33,57,-24,32
SC Rheindorf,2984,1,20,9,7,61,41,20,69
FC Salzburg,2984,2,20,8,8,66,31,35,68
SK Sturm Gra,2984,3,18,8,10,59,40,19,62
Rapid Vienna,2984,4,17,9,10,63,37,26,60
Vienna,2984,5,17,5,14,59,54,5,56
RZ Pellets W,2984,6,16,4,16,53,60,-7,52
Admira Wacke,2984,7,13,6,17,40,57,-17,45
SV Josko Rie,2984,8,9,5,22,29,54,-25,32
Mattersburg,2984,9,8,7,21,36,63,-27,31
St. Pölten,2984,10,6,11,19,35,64,-29,29
FC Salzburg,2985,1,23,5,8,70,27,43,74
SC Rheindorf,2985,2,21,6,9,67,39,28,69
SK Sturm Gra,2985,3,19,8,9,59,33,26,65
Vienna,2985,4,20,2,14,57,46,11,62
Admira Wacke,2985,5,14,6,16,37,60,-23,48
Rapid Vienna,2985,6,12,11,13,56,44,12,47
RZ Pellets W,2985,7,13,6,17,47,66,-19,45
Mattersburg,2985,8,10,7,19,36,49,-13,37
St. Pölten,2985,9,8,9,19,37,67,-30,33
SV Josko Rie,2985,10,8,4,24,25,60,-35,28
FC Salzburg,2986,1,23,6,7,70,30,40,75
SC Rheindorf,2986,2,22,7,7,61,38,23,73
Vienna,2986,3,18,5,13,66,53,13,59
SK Sturm Gra,2986,4,17,7,12,51,34,17,58
Rapid Vienna,2986,5,16,8,12,67,43,24,56
RZ Pellets W,2986,6,13,7,16,47,55,-8,46
Admira Wacke,2986,7,13,4,19,36,67,-31,43
St. Pölten,2986,8,10,8,18,43,65,-22,38
SV Josko Rie,2986,9,10,5,21,34,60,-26,35
Mattersburg,2986,10,7,5,24,35,65,-30,26
FC Salzburg,2987,1,23,7,6,70,27,43,76
SK Sturm Gra,2987,2,19,8,9,60,31,29,65
SC Rheindorf,2987,3,17,8,11,53,45,8,59
Vienna,2987,4,18,5,13,53,47,6,59
Rapid Vienna,2987,5,13,12,11,52,37,15,51
RZ Pellets W,2987,6,13,7,16,45,54,-9,46
SV Josko Rie,2987,7,12,4,20,38,51,-13,40
Admira Wacke,2987,8,12,4,20,29,56,-27,40
St. Pölten,2987,9,9,10,17,40,62,-22,37
Mattersburg,2987,10,8,7,21,36,66,-30,31
SC Rheindorf,2988,1,21,8,7,61,39,22,71
Vienna,2988,2,21,6,9,69,50,19,69
FC Salzburg,2988,3,19,8,9,66,35,31,65
SK Sturm Gra,2988,4,17,5,14,56,43,13,56
Rapid Vienna,2988,5,14,9,13,55,44,11,51
Admira Wacke,2988,6,15,5,16,40,54,-14,50
St. Pölten,2988,7,10,10,16,43,58,-15,40
RZ Pellets W,2988,8,10,6,20,40,59,-19,36
SV Josko Rie,2988,9,11,2,23,33,58,-25,35
Mattersburg,2988,10,9,7,20,40,63,-23,34
FC Salzburg,2989,1,24,8,4,78,28,50,80
Vienna,2989,2,20,4,12,67,50,17,64
SC Rheindorf,2989,3,17,9,10,52,44,8,60
SK Sturm Gra,2989,4,17,8,11,51,38,13,59
Rapid Vienna,2989,5,12,15,9,51,37,14,51
RZ Pellets W,2989,6,13,7,16,43,53,-10,46
Admira Wacke,2989,7,13,7,16,44,56,-12,46
SV Josko Rie,2989,8,12,2,22,35,59,-24,38
St. Pölten,2989,9,7,9,20,39,67,-28,30
Mattersburg,2989,10,7,7,22,30,58,-28,28
FC Salzburg,2990,1,21,8,7,65,31,34,71
SC Rheindorf,2990,2,18,10,8,53,46,7,64
Vienna,2990,3,19,4,13,65,53,12,61
SK Sturm Gra,2990,4,18,6,12,60,37,23,60
Rapid Vienna,2990,5,14,11,11,59,43,16,53
RZ Pellets W,2990,6,13,5,18,50,62,-12,44
Admira Wacke,2990,7,12,8,16,35,59,-24,44
Mattersburg,2990,8,10,7,19,41,58,-17,37
SV Josko Rie,2990,9,9,7,20,29,47,-18,34
St. Pölten,2990,10,8,10,18,40,61,-21,34
FC Salzburg,2991,1,20,8,8,64,32,32,68
SC Rheindorf,2991,2,19,9,8,57,41,16,66
SK Sturm Gra,2991,3,18,6,12,60,42,18,60
Rapid Vienna,2991,4,17,8,11,63,38,25,59
Vienna,2991,5,17,4,15,57,58,-1,55
Admira Wacke,2991,6,12,10,14,41,53,-12,46
RZ Pellets W,2991,7,11,8,17,44,58,-14,41
Mattersburg,2991,8,11,7,18,43,54,-11,40
St. Pölten,2991,9,9,10,17,40,66,-26,37
SV Josko Rie,2991,10,9,4,23,32,59,-27,31
SC Rheindorf,2992,1,20,7,9,56,39,17,67
FC Salzburg,2992,2,19,8,9,65,30,35,65
SK Sturm Gra,2992,3,19,5,12,58,38,20,62
Rapid Vienna,2992,4,14,12,10,57,42,15,54
Vienna,2992,5,16,6,14,59,59,0,54
Admira Wacke,2992,6,14,3,19,42,61,-19,45
RZ Pellets W,2992,7,12,7,17,44,54,-10,43
Mattersburg,2992,8,11,9,16,40,54,-14,42
St. Pölten,2992,9,9,10,17,39,58,-19,37
SV Josko Rie,2992,10,10,5,21,33,58,-25,35
SC Rheindorf,2993,1,23,5,8,56,38,18,74
FC Salzburg,2993,2,19,6,11,57,33,24,63
SK Sturm Gra,2993,3,19,6,11,58,36,22,63
Vienna,2993,4,18,8,10,64,49,15,62
Rapid Vienna,2993,5,16,7,13,61,43,18,55
SV Josko Rie,2993,6,13,6,17,36,51,-15,45
RZ Pellets W,2993,7,10,9,17,41,58,-17,39
Admira Wacke,2993,8,11,6,19,36,54,-18,39
Mattersburg,2993,9,9,7,20,32,57,-25,34
St. Pölten,2993,10,7,10,19,41,63,-22,31
SK Sturm Gra,2994,1,23,4,9,80,35,45,73
FC Salzburg,2994,2,19,9,8,68,35,33,66
Vienna,2994,3,18,8,10,64,50,14,62
SC Rheindorf,2994,4,17,10,9,54,50,4,61
Rapid Vienna,2994,5,14,11,11,51,39,12,53
Admira Wacke,2994,6,12,7,17,40,60,-20,43
Mattersburg,2994,7,11,9,16,46,57,-11,42
RZ Pellets W,2994,8,11,7,18,45,63,-18,40
SV Josko Rie,2994,9,9,7,20,35,56,-21,34
St. Pölten,2994,10,6,8,22,34,72,-38,26
FC Salzburg,2995,1,21,6,9,67,37,30,69
SC Rheindorf,2995,2,21,6,9,58,37,21,69
Vienna,2995,3,21,5,10,68,47,21,68
SK Sturm Gra,2995,4,18,7,11,57,35,22,61
Rapid Vienna,2995,5,13,11,12,51,40,11,50
Mattersburg,2995,6,11,9,16,41,49,-8,42
RZ Pellets W,2995,7,12,5,19,40,54,-14,41
SV Josko Rie,2995,8,13,2,21,37,57,-20,41
Admira Wacke,2995,9,11,5,20,38,68,-30,38
St. Pölten,2995,10,6,10,20,34,67,-33,28
Vienna,2996,1,22,3,11,72,49,23,69
SC Rheindorf,2996,2,20,8,8,55,41,14,68
FC Salzburg,2996,3,18,7,11,62,43,19,61
SK Sturm Gra,2996,4,18,5,13,56,39,17,59
Rapid Vienna,2996,5,16,7,13,68,44,24,55
RZ Pellets W,2996,6,15,5,16,52,58,-6,50
Admira Wacke,2996,7,13,6,17,44,64,-20,45
St. Pölten,2996,8,9,9,18,44,66,-22,36
Mattersburg,2996,9,8,8,20,35,59,-24,32
SV Josko Rie,2996,10,8,8,20,33,58,-25,32
FC Salzburg,2997,1,24,4,8,66,29,37,76
SK Sturm Gra,2997,2,23,6,7,65,28,37,75
Vienna,2997,3,23,3,10,73,47,26,72
SC Rheindorf,2997,4,21,5,10,58,44,14,68
Rapid Vienna,2997,5,12,9,15,48,41,7,45
Admira Wacke,2997,6,13,5,18,39,59,-20,44
SV Josko Rie,2997,7,10,5,21,36,56,-20,35
RZ Pellets W,2997,8,9,7,20,40,64,-24,34
St. Pölten,2997,9,8,10,18,35,67,-32,34
Mattersburg,2997,10,6,8,22,36,61,-25,26
Vienna,2998,1,22,5,9,72,45,27,71
SC Rheindorf,2998,2,21,6,9,62,41,21,69
FC Salzburg,2998,3,18,8,10,61,36,25,62
SK Sturm Gra,2998,4,17,5,14,55,38,17,56
Rapid Vienna,2998,5,13,9,14,50,43,7,48
RZ Pellets W,2998,6,11,12,13,46,56,-10,45
SV Josko Rie,2998,7,13,5,18,47,59,-12,44
St. Pölten,2998,8,10,10,16,43,62,-19,40
Admira Wacke,2998,9,10,7,19,37,65,-28,37
Mattersburg,2998,10,8,7,21,36,64,-28,31
SK Sturm Gra,2999,1,20,8,8,54,25,29,68
Vienna,2999,2,19,8,9,61,43,18,65
FC Salzburg,2999,3,18,10,8,58,32,26,64
SC Rheindorf,2999,4,19,7,10,57,44,13,64
Rapid Vienna,2999,5,16,8,12,62,39,23,56
Admira Wacke,2999,6,13,6,17,41,56,-15,45
RZ Pellets W,2999,7,9,11,16,41,59,-18,38
Mattersburg,2999,8,8,10,18,37,57,-20,34
SV Josko Rie,2999,9,8,8,20,28,54,-26,32
St. Pölten,2999,10,6,12,18,43,73,-30,30
FC Salzburg,3000,1,22,7,7,68,30,38,73
Vienna,3000,2,21,7,8,67,42,25,70
SC Rheindorf,3000,3,20,9,7,53,39,14,69
SK Sturm Gra,3000,4,19,6,11,58,32,26,63
Rapid Vienna,3000,5,14,11,11,55,44,11,53
SV Josko Rie,3000,6,13,5,18,33,48,-15,44
RZ Pellets W,3000,7,10,9,17,50,64,-14,39
Admira Wacke,3000,8,10,6,20,39,68,-29,36
St. Pölten,3000,9,5,12,19,35,63,-28,27
Mattersburg,3000,10,6,8,22,35,63,-28,26
FC Salzburg,3001,1,21,8,7,68,30,38,71
SK Sturm Gra,3001,2,21,4,11,61,33,28,67
Vienna,3001,3,20,4,12,60,46,14,64
SC Rheindorf,3001,4,18,10,8,58,45,13,64
Rapid Vienna,3001,5,14,11,11,58,42,16,53
RZ Pellets W,3001,6,12,7,17,47,55,-8,43
SV Josko Rie,3001,7,10,8,18,38,55,-17,38
St. Pölten,3001,8,9,10,17,44,68,-24,37
Mattersburg,3001,9,7,12,17,36,56,-20,33
Admira Wacke,3001,10,9,4,23,29,69,-40,31
SC Rheindorf,3002,1,22,7,7,61,41,20,73
FC Salzburg,3002,2,20,8,8,64,32,32,68
SK Sturm Gra,3002,3,18,9,9,54,30,24,63
Vienna,3002,4,17,6,13,60,52,8,57
Rapid Vienna,3002,5,15,9,12,59,43,16,54
Mattersburg,3002,6,10,10,16,49,61,-12,40
RZ Pellets W,3002,7,10,10,16,43,56,-13,40
SV Josko Rie,3002,8,12,2,22,34,58,-24,38
Admira Wacke,3002,9,10,6,20,33,59,-26,36
St. Pölten,3002,10,8,9,19,39,64,-25,33
FC Salzburg,3003,1,21,6,9,61,31,30,69
Vienna,3003,2,20,5,11,68,52,16,65
SC Rheindorf,3003,3,18,6,12,57,50,7,60
Rapid Vienna,3003,4,15,10,11,60,38,22,55
SK Sturm Gra,3003,5,16,6,14,61,49,12,54
SV Josko Rie,3003,6,13,5,18,39,53,-14,44
RZ Pellets W,3003,7,12,6,18,48,64,-16,42
St. Pölten,3003,8,11,8,17,48,68,-20,41
Admira Wacke,3003,9,11,8,17,34,55,-21,41
Mattersburg,3003,10,9,8,19,45,61,-16,35
FC Salzburg,3004,1,22,5,9,69,37,32,71
SC Rheindorf,3004,2,20,8,8,58,37,21,68
SK Sturm Gra,3004,3,16,8,12,50,35,15,56
Vienna,3004,4,17,5,14,61,55,6,56
SV Josko Rie,3004,5,13,10,13,44,49,-5,49
Rapid Vienna,3004,6,13,9,14,59,45,14,48
Admira Wacke,3004,7,13,7,16,42,60,-18,46
RZ Pellets W,3004,8,12,5,19,42,59,-17,41
Mattersburg,3004,9,8,10,18,38,57,-19,34
St. Pölten,3004,10,7,11,18,42,71,-29,32
FC Salzburg,3005,1,19,10,7,63,33,30,67
SK Sturm Gra,3005,2,16,11,9,57,35,22,59
Vienna,3005,3,16,9,11,61,51,10,57
SC Rheindorf,3005,4,16,9,11,50,46,4,57
Rapid Vienna,3005,5,14,9,13,57,42,15,51
Admira Wacke,3005,6,13,8,15,40,58,-18,47
RZ Pellets W,3005,7,12,10,14,45,50,-5,46
SV Josko Rie,3005,8,12,6,18,41,54,-13,42
St. Pölten,3005,9,8,11,17,43,62,-19,35
Mattersburg,3005,10,8,9,19,38,64,-26,33
FC Salzburg,3006,1,22,9,5,76,30,46,75
SC Rheindorf,3006,2,21,7,8,59,42,17,70
SK Sturm Gra,3006,3,19,5,12,57,37,20,62
Vienna,3006,4,18,5,13,69,61,8,59
Rapid Vienna,3006,5,14,12,10,58,37,21,54
RZ Pellets W,3006,6,13,6,17,44,56,-12,45
SV Josko Rie,3006,7,11,8,17,38,57,-19,41
Admira Wacke,3006,8,11,5,20,43,70,-27,38
St. Pölten,3006,9,8,9,19,46,67,-21,33
Mattersburg,3006,10,6,8,22,36,69,-33,26
FC Salzburg,3007,1,22,7,7,62,30,32,73
SC Rheindorf,3007,2,21,7,8,56,38,18,70
Vienna,3007,3,20,3,13,64,52,12,63
SK Sturm Gra,3007,4,17,7,12,56,36,20,58
Rapid Vienna,3007,5,14,9,13,56,40,16,51
Admira Wacke,3007,6,13,7,16,40,58,-18,46
SV Josko Rie,3007,7,12,6,18,46,56,-10,42
RZ Pellets W,3007,8,11,7,18,38,60,-22,40
St. Pölten,3007,9,9,8,19,41,63,-22,35
Mattersburg,3007,10,7,7,22,36,62,-26,28
SC Rheindorf,3008,1,21,8,7,70,44,26,71
FC Salzburg,3008,2,19,10,7,69,33,36,67
SK Sturm Gra,3008,3,19,9,8,67,33,34,66
Rapid Vienna,3008,4,15,9,12,59,43,16,54
Vienna,3008,5,16,4,16,62,66,-4,52
RZ Pellets W,3008,6,13,7,16,50,64,-14,46
Mattersburg,3008,7,8,13,15,42,50,-8,37
SV Josko Rie,3008,8,9,9,18,33,54,-21,36
St. Pölten,3008,9,8,11,17,37,65,-28,35
Admira Wacke,3008,10,9,6,21,31,68,-37,33
FC Salzburg,3009,1,20,10,6,68,30,38,70
SK Sturm Gra,3009,2,22,4,10,61,34,27,70
Vienna,3009,3,20,4,12,65,49,16,64
SC Rheindorf,3009,4,16,7,13,58,54,4,55
Rapid Vienna,3009,5,13,14,9,63,41,22,53
RZ Pellets W,3009,6,13,9,14,45,54,-9,48
SV Josko Rie,3009,7,12,5,19,37,56,-19,41
Admira Wacke,3009,8,9,8,19,34,64,-30,35
Mattersburg,3009,9,8,10,18,38,56,-18,34
St. Pölten,3009,10,7,9,20,39,70,-31,30
FC Salzburg,3010,1,24,7,5,80,30,50,79
SK Sturm Gra,3010,2,20,5,11,63,37,26,65
SC Rheindorf,3010,3,17,9,10,58,49,9,60
Vienna,3010,4,16,8,12,63,54,9,56
Rapid Vienna,3010,5,13,10,13,57,45,12,49
RZ Pellets W,3010,6,14,7,15,48,63,-15,49
SV Josko Rie,3010,7,13,5,18,39,57,-18,44
Mattersburg,3010,8,9,9,18,47,58,-11,36
St. Pölten,3010,9,9,9,18,41,65,-24,36
Admira Wacke,3010,10,8,5,23,34,72,-38,29
FC Salzburg,3011,1,23,6,7,71,31,40,75
SK Sturm Gra,3011,2,20,7,9,68,39,29,67
Vienna,3011,3,20,2,14,70,55,15,62
SC Rheindorf,3011,4,19,4,13,54,47,7,61
RZ Pellets W,3011,5,15,8,13,47,51,-4,53
Rapid Vienna,3011,6,12,11,13,48,45,3,47
Admira Wacke,3011,7,11,7,18,43,66,-23,40
St. Pölten,3011,8,10,9,17,44,60,-16,39
Mattersburg,3011,9,8,8,20,36,60,-24,32
SV Josko Rie,3011,10,9,4,23,35,62,-27,31
FC Salzburg,3012,1,19,8,9,61,33,28,65
SK Sturm Gra,3012,2,18,8,10,59,32,27,62
SC Rheindorf,3012,3,19,5,12,48,45,3,62
Vienna,3012,4,19,4,13,66,58,8,61
Rapid Vienna,3012,5,12,12,12,55,44,11,48
St. Pölten,3012,6,12,10,14,50,53,-3,46
Admira Wacke,3012,7,13,7,16,41,54,-13,46
RZ Pellets W,3012,8,12,7,17,38,55,-17,43
Mattersburg,3012,9,9,12,15,38,51,-13,39
SV Josko Rie,3012,10,7,7,22,30,61,-31,28
FC Salzburg,3013,1,20,8,8,62,32,30,68
SK Sturm Gra,3013,2,18,7,11,57,32,25,61
Vienna,3013,3,18,7,11,61,49,12,61
SC Rheindorf,3013,4,18,6,12,48,46,2,60
Rapid Vienna,3013,5,14,10,12,53,40,13,52
RZ Pellets W,3013,6,13,8,15,45,50,-5,47
SV Josko Rie,3013,7,14,3,19,42,58,-16,45
Mattersburg,3013,8,9,11,16,37,49,-12,38
Admira Wacke,3013,9,9,8,19,31,56,-25,35
St. Pölten,3013,10,7,12,17,43,67,-24,33
SK Sturm Gra,3014,1,24,4,8,71,30,41,76
FC Salzburg,3014,2,19,11,6,64,32,32,68
Vienna,3014,3,19,5,12,71,56,15,62
SC Rheindorf,3014,4,16,8,12,49,43,6,56
Rapid Vienna,3014,5,13,11,12,57,51,6,50
RZ Pellets W,3014,6,13,6,17,48,60,-12,45
St. Pölten,3014,7,10,9,17,49,68,-19,39
Admira Wacke,3014,8,10,8,18,37,63,-26,38
Mattersburg,3014,9,9,9,18,39,55,-16,36
SV Josko Rie,3014,10,9,5,22,32,59,-27,32
FC Salzburg,3015,1,21,6,9,64,37,27,69
SC Rheindorf,3015,2,20,8,8,60,36,24,68
SK Sturm Gra,3015,3,20,7,9,60,33,27,67
Vienna,3015,4,18,7,11,60,52,8,61
Admira Wacke,3015,5,14,7,15,42,54,-12,49
Rapid Vienna,3015,6,10,13,13,50,43,7,43
RZ Pellets W,3015,7,10,8,18,40,57,-17,38
St. Pölten,3015,8,9,10,17,41,62,-21,37
Mattersburg,3015,9,8,10,18,37,56,-19,34
SV Josko Rie,3015,10,8,8,20,34,58,-24,32
FC Salzburg,3016,1,20,10,6,62,33,29,70
SC Rheindorf,3016,2,18,11,7,55,37,18,65
Vienna,3016,3,18,7,11,63,50,13,61
Rapid Vienna,3016,4,12,15,9,51,35,16,51
SK Sturm Gra,3016,5,14,8,14,46,35,11,50
RZ Pellets W,3016,6,12,10,14,44,53,-9,46
Admira Wacke,3016,7,13,5,18,34,52,-18,44
SV Josko Rie,3016,8,11,8,17,35,50,-15,41
Mattersburg,3016,9,10,8,18,44,58,-14,38
St. Pölten,3016,10,6,10,20,34,65,-31,28
FC Salzburg,3017,1,21,8,7,65,33,32,71
SC Rheindorf,3017,2,20,7,9,61,44,17,67
Vienna,3017,3,20,4,12,65,49,16,64
SK Sturm Gra,3017,4,19,5,12,58,38,20,62
Rapid Vienna,3017,5,12,11,13,50,40,10,47
SV Josko Rie,3017,6,13,4,19,40,53,-13,43
RZ Pellets W,3017,7,12,5,19,42,61,-19,41
St. Pölten,3017,8,10,8,18,37,59,-22,38
Admira Wacke,3017,9,11,5,20,32,56,-24,38
Mattersburg,3017,10,9,9,18,37,54,-17,36
FC Salzburg,3018,1,21,9,6,57,23,34,72
SC Rheindorf,3018,2,20,8,8,57,39,18,68
SK Sturm Gra,3018,3,19,6,11,63,34,29,63
Vienna,3018,4,17,8,11,59,49,10,59
Rapid Vienna,3018,5,14,9,13,52,43,9,51
Admira Wacke,3018,6,14,6,16,38,58,-20,48
RZ Pellets W,3018,7,10,10,16,40,51,-11,40
SV Josko Rie,3018,8,10,5,21,31,49,-18,35
Mattersburg,3018,9,8,10,18,35,54,-19,34
St. Pölten,3018,10,6,11,19,34,66,-32,29
FC Salzburg,3019,1,23,7,6,73,30,43,76
SK Sturm Gra,3019,2,20,5,11,54,31,23,65
Vienna,3019,3,19,4,13,63,50,13,61
SC Rheindorf,3019,4,17,6,13,53,49,4,57
Rapid Vienna,3019,5,15,10,11,58,42,16,55
RZ Pellets W,3019,6,12,6,18,39,52,-13,42
SV Josko Rie,3019,7,12,6,18,37,53,-16,42
Admira Wacke,3019,8,9,11,16,32,54,-22,38
Mattersburg,3019,9,10,7,19,42,65,-23,37
St. Pölten,3019,10,7,10,19,41,66,-25,31
Vienna,3020,1,21,6,9,70,50,20,69
FC Salzburg,3020,2,19,10,7,62,29,33,67
SK Sturm Gra,3020,3,18,9,9,55,32,23,63
Rapid Vienna,3020,4,16,12,8,60,36,24,60
SC Rheindorf,3020,5,16,6,14,51,48,3,54
Mattersburg,3020,6,10,11,15,44,56,-12,41
RZ Pellets W,3020,7,11,6,19,50,60,-10,39
St. Pölten,3020,8,9,9,18,41,70,-29,36
Admira Wacke,3020,9,8,11,17,38,63,-25,35
SV Josko Rie,3020,10,9,6,21,35,62,-27,33
FC Salzburg,3021,1,22,6,8,71,31,40,72
SC Rheindorf,3021,2,19,8,9,58,43,15,65
SK Sturm Gra,3021,3,19,7,10,57,32,25,64
Vienna,3021,4,17,6,13,56,55,1,57
Admira Wacke,3021,5,15,6,15,37,45,-8,51
RZ Pellets W,3021,6,12,9,15,42,51,-9,45
Rapid Vienna,3021,7,11,10,15,51,49,2,43
SV Josko Rie,3021,8,11,7,18,33,46,-13,40
St. Pölten,3021,9,8,10,18,40,63,-23,34
Mattersburg,3021,10,7,9,20,36,66,-30,30
FC Salzburg,3022,1,20,9,7,61,33,28,69
SK Sturm Gra,3022,2,20,7,9,54,30,24,67
Vienna,3022,3,18,7,11,60,48,12,61
SC Rheindorf,3022,4,17,8,11,51,41,10,59
Rapid Vienna,3022,5,12,12,12,50,40,10,48
RZ Pellets W,3022,6,13,6,17,45,51,-6,45
SV Josko Rie,3022,7,11,9,16,37,52,-15,42
St. Pölten,3022,8,11,8,17,45,57,-12,41
Admira Wacke,3022,9,10,7,19,40,64,-24,37
Mattersburg,3022,10,7,9,20,34,61,-27,30
SK Sturm Gra,3023,1,20,7,9,60,27,33,67
Vienna,3023,2,21,4,11,67,52,15,67
SC Rheindorf,3023,3,20,7,9,51,37,14,67
FC Salzburg,3023,4,19,8,9,63,34,29,65
Rapid Vienna,3023,5,15,9,12,57,42,15,54
Admira Wacke,3023,6,13,4,19,41,60,-19,43
SV Josko Rie,3023,7,10,6,20,35,56,-21,36
RZ Pellets W,3023,8,9,9,18,40,62,-22,36
St. Pölten,3023,9,7,13,16,40,62,-22,34
Mattersburg,3023,10,7,11,18,34,56,-22,32
SC Rheindorf,3024,1,21,5,10,61,40,21,68
FC Salzburg,3024,2,19,10,7,62,31,31,67
Rapid Vienna,3024,3,18,11,7,65,37,28,65
SK Sturm Gra,3024,4,17,6,13,51,43,8,57
Vienna,3024,5,16,5,15,61,59,2,53
RZ Pellets W,3024,6,12,8,16,47,56,-9,44
SV Josko Rie,3024,7,11,6,19,36,49,-13,39
Admira Wacke,3024,8,11,6,19,39,62,-23,39
St. Pölten,3024,9,9,9,18,39,66,-27,36
Mattersburg,3024,10,8,10,18,34,52,-18,34
Vienna,3025,1,22,4,10,62,43,19,70
SK Sturm Gra,3025,2,20,5,11,59,34,25,65
FC Salzburg,3025,3,17,12,7,56,26,30,63
SC Rheindorf,3025,4,16,9,11,52,45,7,57
Rapid Vienna,3025,5,15,11,10,53,40,13,56
RZ Pellets W,3025,6,12,6,18,46,55,-9,42
Admira Wacke,3025,7,12,4,20,33,60,-27,40
SV Josko Rie,3025,8,11,6,19,30,53,-23,39
St. Pölten,3025,9,8,11,17,46,63,-17,35
Mattersburg,3025,10,8,10,18,38,56,-18,34
FC Salzburg,3026,1,20,11,5,70,31,39,71
SK Sturm Gra,3026,2,21,6,9,63,32,31,69
SC Rheindorf,3026,3,18,9,9,55,47,8,63
Vienna,3026,4,18,3,15,63,58,5,57
Rapid Vienna,3026,5,11,12,13,48,45,3,45
St. Pölten,3026,6,12,7,17,47,59,-12,43
RZ Pellets W,3026,7,12,6,18,43,54,-11,42
SV Josko Rie,3026,8,12,6,18,42,55,-13,42
Admira Wacke,3026,9,11,6,19,34,58,-24,39
Mattersburg,3026,10,8,8,20,32,58,-26,32
FC Salzburg,3027,1,22,8,6,68,34,34,74
SC Rheindorf,3027,2,20,7,9,54,41,13,67
SK Sturm Gra,3027,3,19,6,11,61,40,21,63
Vienna,3027,4,18,6,12,63,54,9,60
Rapid Vienna,3027,5,14,12,10,56,41,15,54
Admira Wacke,3027,6,12,8,16,42,57,-15,44
RZ Pellets W,3027,7,10,8,18,48,62,-14,38
Mattersburg,3027,8,10,7,19,39,62,-23,37
SV Josko Rie,3027,9,11,3,22,37,54,-17,36
St. Pölten,3027,10,8,7,21,46,69,-23,31
FC Salzburg,3028,1,22,7,7,65,32,33,73
SK Sturm Gra,3028,2,22,6,8,62,28,34,72
Vienna,3028,3,18,5,13,58,53,5,59
SC Rheindorf,3028,4,17,7,12,55,45,10,58
Rapid Vienna,3028,5,13,10,13,50,41,9,49
Admira Wacke,3028,6,13,6,17,40,56,-16,45
RZ Pellets W,3028,7,12,7,17,39,52,-13,43
SV Josko Rie,3028,8,13,2,21,35,52,-17,41
Mattersburg,3028,9,8,10,18,38,57,-19,34
St. Pölten,3028,10,5,14,17,36,62,-26,29
FC Salzburg,3029,1,19,8,9,65,36,29,65
SC Rheindorf,3029,2,18,10,8,51,38,13,64
SK Sturm Gra,3029,3,18,8,10,52,31,21,62
Vienna,3029,4,17,4,15,55,50,5,55
Rapid Vienna,3029,5,13,10,13,53,41,12,49
SV Josko Rie,3029,6,12,9,15,39,48,-9,45
Admira Wacke,3029,7,12,9,15,39,55,-16,45
RZ Pellets W,3029,8,10,12,14,47,51,-4,42
St. Pölten,3029,9,8,11,17,36,64,-28,35
Mattersburg,3029,10,6,13,17,40,63,-23,31
SC Rheindorf,3030,1,21,7,8,60,44,16,70
Vienna,3030,2,21,6,9,66,48,18,69
SK Sturm Gra,3030,3,20,7,9,58,32,26,67
FC Salzburg,3030,4,18,5,13,58,37,21,59
Rapid Vienna,3030,5,14,13,9,54,36,18,55
St. Pölten,3030,6,11,8,17,42,60,-18,41
RZ Pellets W,3030,7,11,6,19,40,52,-12,39
SV Josko Rie,3030,8,11,6,19,29,46,-17,39
Admira Wacke,3030,9,10,4,22,33,62,-29,34
Mattersburg,3030,10,8,8,20,36,59,-23,32
FC Salzburg,3031,1,20,8,8,65,34,31,68
Vienna,3031,2,21,5,10,73,53,20,68
SC Rheindorf,3031,3,18,8,10,51,40,11,62
SK Sturm Gra,3031,4,16,7,13,47,38,9,55
Rapid Vienna,3031,5,14,12,10,56,37,19,54
RZ Pellets W,3031,6,15,8,13,47,47,0,53
Admira Wacke,3031,7,11,9,16,43,57,-14,42
SV Josko Rie,3031,8,9,7,20,27,55,-28,34
Mattersburg,3031,9,9,6,21,38,57,-19,33
St. Pölten,3031,10,6,12,18,30,59,-29,30
FC Salzburg,3032,1,19,11,6,58,28,30,68
SC Rheindorf,3032,2,18,8,10,56,41,15,62
Vienna,3032,3,19,5,12,60,60,0,62
SK Sturm Gra,3032,4,18,7,11,55,35,20,61
Rapid Vienna,3032,5,15,10,11,56,41,15,55
RZ Pellets W,3032,6,12,9,15,46,50,-4,45
SV Josko Rie,3032,7,12,9,15,40,46,-6,45
Admira Wacke,3032,8,8,11,17,35,59,-24,35
Mattersburg,3032,9,7,11,18,39,58,-19,32
St. Pölten,3032,10,7,9,20,35,62,-27,30
FC Salzburg,3033,1,21,6,9,64,31,33,69
SK Sturm Gra,3033,2,19,8,9,65,36,29,65
SC Rheindorf,3033,3,19,8,9,56,42,14,65
Vienna,3033,4,17,7,12,59,50,9,58
Admira Wacke,3033,5,14,7,15,43,53,-10,49
Rapid Vienna,3033,6,11,10,15,50,49,1,43
RZ Pellets W,3033,7,11,9,16,44,60,-16,42
St. Pölten,3033,8,10,10,16,48,61,-13,40
Mattersburg,3033,9,8,11,17,29,48,-19,35
SV Josko Rie,3033,10,11,2,23,30,58,-28,35
FC Salzburg,3034,1,20,9,7,68,29,39,69
SK Sturm Gra,3034,2,19,9,8,50,26,24,66
SC Rheindorf,3034,3,18,9,9,51,37,14,63
Vienna,3034,4,17,6,13,59,61,-2,57
Rapid Vienna,3034,5,12,11,13,55,42,13,47
RZ Pellets W,3034,6,12,10,14,50,53,-3,46
Admira Wacke,3034,7,12,9,15,40,53,-13,45
Mattersburg,3034,8,8,11,17,39,57,-18,35
SV Josko Rie,3034,9,9,8,19,31,52,-21,35
St. Pölten,3034,10,7,10,19,37,70,-33,31
FC Salzburg,3035,1,23,9,4,68,26,42,78
SC Rheindorf,3035,2,20,7,9,64,47,17,67
SK Sturm Gra,3035,3,19,6,11,56,34,22,63
Rapid Vienna,3035,4,14,12,10,55,38,17,54
Vienna,3035,5,17,3,16,55,50,5,54
SV Josko Rie,3035,6,13,5,18,38,53,-15,44
Admira Wacke,3035,7,12,6,18,34,57,-23,42
RZ Pellets W,3035,8,11,7,18,42,57,-15,40
St. Pölten,3035,9,8,10,18,42,62,-20,34
Mattersburg,3035,10,7,7,22,29,59,-30,28
SK Sturm Gra,3036,1,20,8,8,65,33,32,68
SC Rheindorf,3036,2,20,8,8,62,42,20,68
FC Salzburg,3036,3,17,11,8,56,30,26,62
Vienna,3036,4,17,6,13,60,54,6,57
Rapid Vienna,3036,5,13,12,11,60,39,21,51
RZ Pellets W,3036,6,14,8,14,48,55,-7,50
Mattersburg,3036,7,10,9,17,36,53,-17,39
St. Pölten,3036,8,9,10,17,41,62,-21,37
SV Josko Rie,3036,9,9,7,20,31,55,-24,34
Admira Wacke,3036,10,8,7,21,33,69,-36,31
FC Salzburg,3037,1,20,9,7,62,27,35,69
SK Sturm Gra,3037,2,20,6,10,55,30,25,66
Vienna,3037,3,19,5,12,65,55,10,62
SC Rheindorf,3037,4,17,7,12,50,47,3,58
Rapid Vienna,3037,5,13,10,13,55,48,7,49
Admira Wacke,3037,6,13,8,15,39,54,-15,47
RZ Pellets W,3037,7,12,9,15,41,53,-12,45
SV Josko Rie,3037,8,10,6,20,38,52,-14,36
Mattersburg,3037,9,9,9,18,45,62,-17,36
St. Pölten,3037,10,9,7,20,38,60,-22,34
FC Salzburg,3038,1,23,6,7,72,35,37,75
SK Sturm Gra,3038,2,23,6,7,67,32,35,75
SC Rheindorf,3038,3,19,7,10,56,39,17,64
Vienna,3038,4,19,4,13,65,57,8,61
Rapid Vienna,3038,5,11,12,13,51,42,9,45
Admira Wacke,3038,6,13,6,17,40,59,-19,45
SV Josko Rie,3038,7,12,5,19,38,53,-15,41
RZ Pellets W,3038,8,11,6,19,41,62,-21,39
Mattersburg,3038,9,8,8,20,37,58,-21,32
St. Pölten,3038,10,6,10,20,37,67,-30,28
FC Salzburg,3039,1,22,6,8,74,35,39,72
SC Rheindorf,3039,2,17,11,8,55,43,12,62
Rapid Vienna,3039,3,17,9,10,61,38,23,60
Vienna,3039,4,16,11,9,62,52,10,59
SK Sturm Gra,3039,5,16,7,13,54,44,10,55
RZ Pellets W,3039,6,12,9,15,45,52,-7,45
Mattersburg,3039,7,10,9,17,40,55,-15,39
Admira Wacke,3039,8,9,9,18,43,67,-24,36
St. Pölten,3039,9,8,11,17,39,63,-24,35
SV Josko Rie,3039,10,10,4,22,36,60,-24,34
FC Salzburg,3040,1,18,9,9,60,34,26,63
SK Sturm Gra,3040,2,18,7,11,49,30,19,61
Vienna,3040,3,18,7,11,60,48,12,61
SC Rheindorf,3040,4,16,9,11,53,49,4,57
Rapid Vienna,3040,5,12,13,11,52,36,16,49
Admira Wacke,3040,6,14,5,17,39,58,-19,47
RZ Pellets W,3040,7,13,7,16,45,55,-10,46
St. Pölten,3040,8,10,10,16,37,57,-20,40
Mattersburg,3040,9,10,9,17,38,49,-11,39
SV Josko Rie,3040,10,11,4,21,34,51,-17,37
SK Sturm Gra,3041,1,23,6,7,71,33,38,75
FC Salzburg,3041,2,20,9,7,63,27,36,69
SC Rheindorf,3041,3,20,9,7,57,34,23,69
Vienna,3041,4,16,5,15,66,60,6,53
Rapid Vienna,3041,5,13,11,12,55,48,7,50
Admira Wacke,3041,6,13,4,19,38,66,-28,43
RZ Pellets W,3041,7,12,6,18,45,61,-16,42
Mattersburg,3041,8,9,9,18,43,60,-17,36
SV Josko Rie,3041,9,10,5,21,37,57,-20,35
St. Pölten,3041,10,8,8,20,38,67,-29,32
FC Salzburg,3042,1,22,7,7,74,35,39,73
SK Sturm Gra,3042,2,19,7,10,59,36,23,64
Vienna,3042,3,20,4,12,70,54,16,64
SC Rheindorf,3042,4,18,8,10,53,48,5,62
Rapid Vienna,3042,5,15,10,11,62,43,19,55
RZ Pellets W,3042,6,12,9,15,48,53,-5,45
SV Josko Rie,3042,7,13,3,20,38,53,-15,42
Admira Wacke,3042,8,10,8,18,36,63,-27,38
Mattersburg,3042,9,8,8,20,37,63,-26,32
St. Pölten,3042,10,5,12,19,38,67,-29,27
FC Salzburg,3043,1,21,8,7,65,33,32,71
SK Sturm Gra,3043,2,20,7,9,58,37,21,67
SC Rheindorf,3043,3,19,5,12,48,46,2,62
Vienna,3043,4,19,4,13,64,53,11,61
Mattersburg,3043,5,13,8,15,55,55,0,47
RZ Pellets W,3043,6,13,8,15,44,56,-12,47
Rapid Vienna,3043,7,11,9,16,54,47,7,42
SV Josko Rie,3043,8,12,3,21,39,55,-16,39
Admira Wacke,3043,9,11,5,20,38,57,-19,38
St. Pölten,3043,10,8,9,19,45,71,-26,33
FC Salzburg,3044,1,20,9,7,69,34,35,69
SC Rheindorf,3044,2,21,6,9,58,38,20,69
SK Sturm Gra,3044,3,19,6,11,57,30,27,63
Vienna,3044,4,19,6,11,63,48,15,63
Rapid Vienna,3044,5,14,12,10,51,36,15,54
RZ Pellets W,3044,6,11,9,16,45,59,-14,42
St. Pölten,3044,7,11,9,16,41,59,-18,42
Admira Wacke,3044,8,11,5,20,36,66,-30,38
SV Josko Rie,3044,9,9,7,20,26,51,-25,34
Mattersburg,3044,10,6,9,21,32,57,-25,27
FC Salzburg,3045,1,23,6,7,70,32,38,75
SC Rheindorf,3045,2,19,8,9,59,41,18,65
SK Sturm Gra,3045,3,18,5,13,53,43,10,59
Vienna,3045,4,18,5,13,58,52,6,59
Rapid Vienna,3045,5,13,12,11,56,41,15,51
RZ Pellets W,3045,6,14,8,14,46,48,-2,50
Mattersburg,3045,7,11,7,18,41,57,-16,40
SV Josko Rie,3045,8,10,7,19,38,56,-18,37
Admira Wacke,3045,9,10,6,20,35,62,-27,36
St. Pölten,3045,10,8,8,20,34,58,-24,32
FC Salzburg,3046,1,21,10,5,63,24,39,73
Vienna,3046,2,21,6,9,68,44,24,69
SC Rheindorf,3046,3,19,7,10,55,48,7,64
SK Sturm Gra,3046,4,17,9,10,60,38,22,60
Rapid Vienna,3046,5,11,14,11,53,46,7,47
RZ Pellets W,3046,6,12,7,17,51,58,-7,43
Admira Wacke,3046,7,10,10,16,35,55,-20,40
St. Pölten,3046,8,9,11,16,49,67,-18,38
Mattersburg,3046,9,7,10,19,31,56,-25,31
SV Josko Rie,3046,10,8,6,22,25,54,-29,30
SK Sturm Gra,3047,1,23,6,7,71,29,42,75
FC Salzburg,3047,2,20,8,8,62,32,30,68
Vienna,3047,3,20,4,12,62,51,11,64
SC Rheindorf,3047,4,17,10,9,52,46,6,61
Rapid Vienna,3047,5,12,12,12,53,41,12,48
RZ Pellets W,3047,6,12,8,16,45,52,-7,44
Admira Wacke,3047,7,10,7,19,36,64,-28,37
SV Josko Rie,3047,8,9,7,20,34,53,-19,34
St. Pölten,3047,9,8,10,18,35,64,-29,34
Mattersburg,3047,10,7,12,17,40,58,-18,33
FC Salzburg,3048,1,20,8,8,60,32,28,68
SK Sturm Gra,3048,2,19,9,8,60,34,26,66
Vienna,3048,3,20,4,12,70,54,16,64
SC Rheindorf,3048,4,18,10,8,54,40,14,64
Rapid Vienna,3048,5,15,11,10,58,35,23,56
SV Josko Rie,3048,6,13,4,19,40,59,-19,43
RZ Pellets W,3048,7,10,8,18,42,58,-16,38
St. Pölten,3048,8,9,11,16,41,57,-16,38
Admira Wacke,3048,9,10,5,21,35,67,-32,35
Mattersburg,3048,10,6,10,20,32,56,-24,28
FC Salzburg,3049,1,22,5,9,64,31,33,71
SC Rheindorf,3049,2,19,7,10,49,38,11,64
SK Sturm Gra,3049,3,18,8,10,63,36,27,62
Vienna,3049,4,18,4,14,53,50,3,58
RZ Pellets W,3049,5,14,7,15,42,52,-10,49
Rapid Vienna,3049,6,12,11,13,48,39,9,47
Admira Wacke,3049,7,11,7,18,35,57,-22,40
Mattersburg,3049,8,11,6,19,38,49,-11,39
St. Pölten,3049,9,10,8,18,39,62,-23,38
SV Josko Rie,3049,10,10,7,19,35,52,-17,37
FC Salzburg,3050,1,24,7,5,80,28,52,79
SK Sturm Gra,3050,2,19,7,10,66,40,26,64
SC Rheindorf,3050,3,18,10,8,50,38,12,64
Vienna,3050,4,16,6,14,57,57,0,54
Admira Wacke,3050,5,13,7,16,42,55,-13,46
Rapid Vienna,3050,6,11,10,15,49,49,0,43
RZ Pellets W,3050,7,10,10,16,50,62,-12,40
St. Pölten,3050,8,10,10,16,39,59,-20,40
SV Josko Rie,3050,9,10,7,19,40,62,-22,37
Mattersburg,3050,10,7,10,19,34,57,-23,31
Vienna,3051,1,21,4,11,74,56,18,67
SC Rheindorf,3051,2,20,7,9,58,40,18,67
Rapid Vienna,3051,3,17,9,10,55,32,23,60
SK Sturm Gra,3051,4,18,6,12,55,35,20,60
FC Salzburg,3051,5,16,11,9,58,34,24,59
RZ Pellets W,3051,6,16,4,16,53,57,-4,52
Admira Wacke,3051,7,11,5,20,41,64,-23,38
SV Josko Rie,3051,8,11,4,21,29,55,-26,37
St. Pölten,3051,9,9,8,19,42,67,-25,35
Mattersburg,3051,10,8,8,20,31,56,-25,32
FC Salzburg,3052,1,20,7,9,62,32,30,67
SC Rheindorf,3052,2,20,5,11,57,46,11,65
SK Sturm Gra,3052,3,20,4,12,59,37,22,64
Rapid Vienna,3052,4,18,9,9,58,40,18,63
Vienna,3052,5,17,6,13,66,57,9,57
RZ Pellets W,3052,6,12,7,17,46,58,-12,43
Admira Wacke,3052,7,12,5,19,38,59,-21,41
St. Pölten,3052,8,10,9,17,48,60,-12,39
SV Josko Rie,3052,9,11,6,19,33,51,-18,39
Mattersburg,3052,10,7,8,21,32,59,-27,29
FC Salzburg,3053,1,24,6,6,70,28,42,78
Vienna,3053,2,21,4,11,66,48,18,67
SK Sturm Gra,3053,3,19,8,9,54,27,27,65
SC Rheindorf,3053,4,17,6,13,54,47,7,57
Rapid Vienna,3053,5,13,15,8,59,38,21,54
Admira Wacke,3053,6,11,8,17,39,59,-20,41
SV Josko Rie,3053,7,12,4,20,41,61,-20,40
RZ Pellets W,3053,8,9,10,17,40,59,-19,37
St. Pölten,3053,9,8,8,20,42,73,-31,32
Mattersburg,3053,10,7,9,20,36,61,-25,30
FC Salzburg,3054,1,19,9,8,62,28,34,66
SC Rheindorf,3054,2,19,8,9,49,40,9,65
SK Sturm Gra,3054,3,19,7,10,57,32,25,64
Vienna,3054,4,18,6,12,56,42,14,60
Rapid Vienna,3054,5,16,9,11,61,44,17,57
RZ Pellets W,3054,6,13,7,16,39,53,-14,46
Admira Wacke,3054,7,11,6,19,36,60,-24,39
St. Pölten,3054,8,9,10,17,46,60,-14,37
SV Josko Rie,3054,9,11,3,22,31,55,-24,36
Mattersburg,3054,10,7,11,18,39,62,-23,32
FC Salzburg,3055,1,23,8,5,80,29,51,77
Vienna,3055,2,19,6,11,70,55,15,63
SC Rheindorf,3055,3,18,8,10,58,52,6,62
SK Sturm Gra,3055,4,17,8,11,57,43,14,59
Rapid Vienna,3055,5,13,9,14,53,44,9,48
RZ Pellets W,3055,6,12,6,18,50,67,-17,42
St. Pölten,3055,7,11,8,17,47,62,-15,41
Admira Wacke,3055,8,12,5,19,43,64,-21,41
SV Josko Rie,3055,9,10,7,19,42,62,-20,37
Mattersburg,3055,10,9,7,20,46,68,-22,34
FC Salzburg,3056,1,22,8,6,70,29,41,74
SK Sturm Gra,3056,2,21,5,10,58,33,25,68
Vienna,3056,3,19,4,13,65,56,9,61
SC Rheindorf,3056,4,18,6,12,52,50,2,60
Rapid Vienna,3056,5,14,12,10,62,43,19,54
RZ Pellets W,3056,6,13,6,17,49,58,-9,45
Admira Wacke,3056,7,12,7,17,35,56,-21,43
Mattersburg,3056,8,10,8,18,40,55,-15,38
St. Pölten,3056,9,8,8,20,40,66,-26,32
SV Josko Rie,3056,10,9,4,23,29,54,-25,31
FC Salzburg,3057,1,21,6,9,65,38,27,69
SC Rheindorf,3057,2,19,10,7,62,41,21,67
SK Sturm Gra,3057,3,18,9,9,59,36,23,63
Rapid Vienna,3057,4,15,9,12,58,44,14,54
Vienna,3057,5,15,7,14,56,55,1,52
RZ Pellets W,3057,6,12,10,14,44,51,-7,46
SV Josko Rie,3057,7,11,8,17,33,49,-16,41
Admira Wacke,3057,8,10,9,17,37,58,-21,39
Mattersburg,3057,9,7,12,17,36,49,-13,33
St. Pölten,3057,10,9,6,21,40,69,-29,33
SC Rheindorf,3058,1,22,8,6,56,33,23,74
FC Salzburg,3058,2,18,12,6,58,31,27,66
SK Sturm Gra,3058,3,20,5,11,64,33,31,65
Rapid Vienna,3058,4,16,9,11,62,41,21,57
Vienna,3058,5,15,7,14,55,54,1,52
RZ Pellets W,3058,6,13,7,16,45,57,-12,46
Admira Wacke,3058,7,12,6,18,34,55,-21,42
St. Pölten,3058,8,8,11,17,43,67,-24,35
SV Josko Rie,3058,9,7,10,19,35,55,-20,31
Mattersburg,3058,10,7,9,20,32,58,-26,30
FC Salzburg,3059,1,20,9,7,63,30,33,69
SC Rheindorf,3059,2,20,9,7,63,45,18,69
SK Sturm Gra,3059,3,19,8,9,58,33,25,65
Vienna,3059,4,18,7,11,63,51,12,61
Rapid Vienna,3059,5,12,12,12,54,45,9,48
RZ Pellets W,3059,6,12,8,16,45,50,-5,44
Admira Wacke,3059,7,10,10,16,40,60,-20,40
SV Josko Rie,3059,8,10,5,21,34,59,-25,35
St. Pölten,3059,9,9,7,20,40,63,-23,34
Mattersburg,3059,10,8,9,19,30,54,-24,33
FC Salzburg,3060,1,20,6,10,57,31,26,66
SK Sturm Gra,3060,2,20,6,10,61,38,23,66
Vienna,3060,3,20,5,11,71,51,20,65
SC Rheindorf,3060,4,19,8,9,55,43,12,65
Rapid Vienna,3060,5,14,9,13,54,39,15,51
RZ Pellets W,3060,6,13,8,15,52,53,-1,47
Mattersburg,3060,7,10,11,15,41,50,-9,41
SV Josko Rie,3060,8,11,3,22,36,61,-25,36
St. Pölten,3060,9,8,11,17,38,59,-21,35
Admira Wacke,3060,10,9,5,22,32,72,-40,32
SC Rheindorf,3061,1,22,7,7,68,43,25,73
SK Sturm Gra,3061,2,21,5,10,60,32,28,68
FC Salzburg,3061,3,19,10,7,60,33,27,67
Vienna,3061,4,18,4,14,67,57,10,58
Rapid Vienna,3061,5,16,9,11,58,40,18,57
Admira Wacke,3061,6,13,7,16,41,53,-12,46
RZ Pellets W,3061,7,12,7,17,48,62,-14,43
Mattersburg,3061,8,9,8,19,33,57,-24,35
St. Pölten,3061,9,6,11,19,39,70,-31,29
SV Josko Rie,3061,10,8,4,24,31,58,-27,28
FC Salzburg,3062,1,24,5,7,69,28,41,77
SC Rheindorf,3062,2,19,10,7,56,42,14,67
SK Sturm Gra,3062,3,19,8,9,57,29,28,65
Vienna,3062,4,16,7,13,64,54,10,55
Rapid Vienna,3062,5,14,11,11,55,40,15,53
RZ Pellets W,3062,6,15,7,14,50,53,-3,52
St. Pölten,3062,7,9,9,18,49,67,-18,36
Mattersburg,3062,8,9,9,18,37,60,-23,36
Admira Wacke,3062,9,9,4,23,27,61,-34,31
SV Josko Rie,3062,10,8,6,22,27,57,-30,30
SK Sturm Gra,3063,1,23,3,10,65,30,35,72
SC Rheindorf,3063,2,20,10,6,51,34,17,70
FC Salzburg,3063,3,19,6,11,64,36,28,63
Vienna,3063,4,17,6,13,59,55,4,57
Rapid Vienna,3063,5,14,9,13,53,41,12,51
RZ Pellets W,3063,6,12,10,14,45,53,-8,46
Mattersburg,3063,7,11,7,18,37,50,-13,40
Admira Wacke,3063,8,10,7,19,33,58,-25,37
St. Pölten,3063,9,9,8,19,41,65,-24,35
SV Josko Rie,3063,10,10,4,22,41,67,-26,34
SC Rheindorf,3064,1,21,8,7,58,37,21,71
FC Salzburg,3064,2,21,7,8,65,32,33,70
SK Sturm Gra,3064,3,19,6,11,60,33,27,63
Vienna,3064,4,19,4,13,60,50,10,61
RZ Pellets W,3064,5,15,5,16,45,50,-5,50
Mattersburg,3064,6,12,8,16,40,51,-11,44
Rapid Vienna,3064,7,10,12,14,47,45,2,42
SV Josko Rie,3064,8,11,6,19,30,51,-21,39
Admira Wacke,3064,9,9,8,19,34,66,-32,35
St. Pölten,3064,10,7,8,21,41,65,-24,29
FC Salzburg,3065,1,21,8,7,63,31,32,71
SC Rheindorf,3065,2,20,6,10,57,39,18,66
SK Sturm Gra,3065,3,17,8,11,54,36,18,59
Rapid Vienna,3065,4,15,12,9,57,36,21,57
Vienna,3065,5,15,9,12,53,49,4,54
RZ Pellets W,3065,6,14,9,13,54,55,-1,51
Mattersburg,3065,7,10,9,17,41,55,-14,39
St. Pölten,3065,8,8,12,16,42,65,-23,36
SV Josko Rie,3065,9,9,6,21,30,57,-27,33
Admira Wacke,3065,10,8,7,21,27,55,-28,31
SK Sturm Gra,3066,1,23,5,8,64,30,34,74
FC Salzburg,3066,2,18,10,8,59,33,26,64
SC Rheindorf,3066,3,19,7,10,58,42,16,64
Vienna,3066,4,19,5,12,62,50,12,62
Admira Wacke,3066,5,14,5,17,38,52,-14,47
Rapid Vienna,3066,6,10,11,15,52,48,4,41
RZ Pellets W,3066,7,10,10,16,37,58,-21,40
Mattersburg,3066,8,9,10,17,39,51,-12,37
St. Pölten,3066,9,8,13,15,46,64,-18,37
SV Josko Rie,3066,10,9,6,21,29,56,-27,33
FC Salzburg,3067,1,23,7,6,70,29,41,76
SC Rheindorf,3067,2,20,9,7,71,40,31,69
SK Sturm Gra,3067,3,16,8,12,51,36,15,56
Vienna,3067,4,16,7,13,57,60,-3,55
Rapid Vienna,3067,5,14,9,13,57,42,15,51
RZ Pellets W,3067,6,14,8,14,46,55,-9,50
Admira Wacke,3067,7,12,5,19,35,64,-29,41
Mattersburg,3067,8,9,10,17,36,49,-13,37
SV Josko Rie,3067,9,8,8,20,34,54,-20,32
St. Pölten,3067,10,7,11,18,43,71,-28,32
FC Salzburg,3068,1,22,7,7,68,31,37,73
SC Rheindorf,3068,2,22,6,8,54,36,18,72
SK Sturm Gra,3068,3,19,7,10,56,31,25,64
Vienna,3068,4,17,8,11,62,50,12,59
Rapid Vienna,3068,5,14,10,12,53,39,14,52
Admira Wacke,3068,6,11,7,18,39,63,-24,40
RZ Pellets W,3068,7,10,9,17,39,58,-19,39
Mattersburg,3068,8,9,9,18,34,50,-16,36
St. Pölten,3068,9,8,10,18,47,67,-20,34
SV Josko Rie,3068,10,9,5,22,31,58,-27,32
FC Salzburg,3069,1,23,6,7,73,34,39,75
SK Sturm Gra,3069,2,23,5,8,71,35,36,74
Vienna,3069,3,20,5,11,66,52,14,65
SC Rheindorf,3069,4,19,5,12,52,44,8,62
Rapid Vienna,3069,5,12,10,14,51,45,6,46
Admira Wacke,3069,6,12,6,18,41,59,-18,42
St. Pölten,3069,7,10,10,16,38,62,-24,40
RZ Pellets W,3069,8,10,6,20,49,67,-18,36
SV Josko Rie,3069,9,11,3,22,37,58,-21,36
Mattersburg,3069,10,9,6,21,38,60,-22,33
SK Sturm Gra,3070,1,20,7,9,65,31,34,67
Vienna,3070,2,20,6,10,64,50,14,66
FC Salzburg,3070,3,19,8,9,60,31,29,65
SC Rheindorf,3070,4,18,7,11,53,45,8,61
Rapid Vienna,3070,5,14,11,11,54,39,15,53
RZ Pellets W,3070,6,11,10,15,48,57,-9,43
Admira Wacke,3070,7,12,6,18,40,59,-19,42
SV Josko Rie,3070,8,11,6,19,34,56,-22,39
Mattersburg,3070,9,8,11,17,36,56,-20,35
St. Pölten,3070,10,8,6,22,40,70,-30,30
FC Salzburg,3071,1,20,7,9,64,34,30,67
SK Sturm Gra,3071,2,19,8,9,57,29,28,65
SC Rheindorf,3071,3,16,8,12,52,50,2,56
Rapid Vienna,3071,4,15,10,11,58,41,17,55
Vienna,3071,5,16,7,13,59,59,0,55
SV Josko Rie,3071,6,16,6,14,38,39,-1,54
RZ Pellets W,3071,7,14,7,15,53,59,-6,49
Admira Wacke,3071,8,11,5,20,38,61,-23,38
St. Pölten,3071,9,8,8,20,40,66,-26,32
Mattersburg,3071,10,7,10,19,35,56,-21,31
FC Salzburg,3072,1,22,8,6,64,22,42,74
SK Sturm Gra,3072,2,20,5,11,58,31,27,65
SC Rheindorf,3072,3,19,6,11,56,44,12,63
Vienna,3072,4,19,4,13,59,46,13,61
Rapid Vienna,3072,5,15,11,10,60,43,17,56
RZ Pellets W,3072,6,15,7,14,49,58,-9,52
Mattersburg,3072,7,10,6,20,36,56,-20,36
Admira Wacke,3072,8,9,8,19,33,64,-31,35
SV Josko Rie,3072,9,9,6,21,30,57,-27,33
St. Pölten,3072,10,8,7,21,45,69,-24,31
SK Sturm Gra,3073,1,21,6,9,53,29,24,69
SC Rheindorf,3073,2,20,9,7,59,37,22,69
FC Salzburg,3073,3,20,7,9,66,29,37,67
Vienna,3073,4,18,8,10,57,44,13,62
Rapid Vienna,3073,5,11,11,14,53,43,10,44
Admira Wacke,3073,6,11,9,16,45,66,-21,42
SV Josko Rie,3073,7,10,8,18,39,57,-18,38
RZ Pellets W,3073,8,10,8,18,46,66,-20,38
St. Pölten,3073,9,8,11,17,42,67,-25,35
Mattersburg,3073,10,8,9,19,35,57,-22,33
SK Sturm Gra,3074,1,20,8,8,64,33,31,68
SC Rheindorf,3074,2,20,7,9,56,46,10,67
FC Salzburg,3074,3,19,7,10,61,30,31,64
Vienna,3074,4,19,4,13,55,51,4,61
Rapid Vienna,3074,5,13,12,11,56,40,16,51
RZ Pellets W,3074,6,12,8,16,51,58,-7,44
SV Josko Rie,3074,7,12,6,18,40,51,-11,42
Admira Wacke,3074,8,10,7,19,32,59,-27,37
Mattersburg,3074,9,8,9,19,34,57,-23,33
St. Pölten,3074,10,7,12,17,35,59,-24,33
FC Salzburg,3075,1,21,7,8,59,28,31,70
SC Rheindorf,3075,2,20,9,7,53,35,18,69
SK Sturm Gra,3075,3,21,5,10,59,32,27,68
Rapid Vienna,3075,4,14,12,10,51,35,16,54
Vienna,3075,5,15,7,14,62,58,4,52
Admira Wacke,3075,6,12,8,16,40,54,-14,44
RZ Pellets W,3075,7,11,9,16,47,56,-9,42
SV Josko Rie,3075,8,11,5,20,31,50,-19,38
St. Pölten,3075,9,8,9,19,40,70,-30,33
Mattersburg,3075,10,5,13,18,29,53,-24,28
FC Salzburg,3076,1,23,6,7,76,32,44,75
SC Rheindorf,3076,2,20,6,10,51,41,10,66
SK Sturm Gra,3076,3,19,7,10,60,31,29,64
Vienna,3076,4,19,6,11,62,50,12,63
Rapid Vienna,3076,5,12,14,10,53,40,13,50
Admira Wacke,3076,6,13,9,14,35,50,-15,48
RZ Pellets W,3076,7,11,8,17,42,56,-14,41
St. Pölten,3076,8,9,10,17,40,64,-24,37
SV Josko Rie,3076,9,9,3,24,32,64,-32,30
Mattersburg,3076,10,7,7,22,33,56,-23,28
FC Salzburg,3077,1,19,10,7,64,34,30,67
SK Sturm Gra,3077,2,19,8,9,63,32,31,65
SC Rheindorf,3077,3,19,8,9,50,37,13,65
Vienna,3077,4,18,3,15,59,52,7,57
RZ Pellets W,3077,5,14,9,13,46,49,-3,51
Rapid Vienna,3077,6,12,11,13,52,49,3,47
Admira Wacke,3077,7,13,6,17,37,56,-19,45
SV Josko Rie,3077,8,12,8,16,38,50,-12,44
St. Pölten,3077,9,7,10,19,34,61,-27,31
Mattersburg,3077,10,7,7,22,36,59,-23,28
FC Salzburg,3078,1,22,8,6,74,31,43,74
Vienna,3078,2,19,8,9,68,49,19,65
SK Sturm Gra,3078,3,18,7,11,52,34,18,61
SC Rheindorf,3078,4,18,7,11,47,43,4,61
Rapid Vienna,3078,5,16,12,8,61,39,22,60
RZ Pellets W,3078,6,14,7,15,51,55,-4,49
Admira Wacke,3078,7,10,7,19,39,61,-22,37
Mattersburg,3078,8,8,10,18,40,61,-21,34
St. Pölten,3078,9,6,11,19,35,64,-29,29
SV Josko Rie,3078,10,7,7,22,30,60,-30,28
FC Salzburg,3079,1,20,9,7,63,29,34,69
SK Sturm Gra,3079,2,19,6,11,59,35,24,63
Vienna,3079,3,18,9,9,64,47,17,63
SC Rheindorf,3079,4,18,9,9,53,44,9,63
Rapid Vienna,3079,5,15,11,10,63,42,21,56
Admira Wacke,3079,6,14,6,16,51,57,-6,48
RZ Pellets W,3079,7,11,8,17,42,57,-15,41
Mattersburg,3079,8,11,7,18,44,62,-18,40
SV Josko Rie,3079,9,7,9,20,30,59,-29,30
St. Pölten,3079,10,5,10,21,32,69,-37,25
FC Salzburg,3080,1,23,5,8,70,33,37,74
SK Sturm Gra,3080,2,18,8,10,61,38,23,62
Vienna,3080,3,19,5,12,68,56,12,62
SC Rheindorf,3080,4,18,8,10,54,44,10,62
Rapid Vienna,3080,5,16,9,11,67,37,30,57
RZ Pellets W,3080,6,12,9,15,46,60,-14,45
St. Pölten,3080,7,9,11,16,42,61,-19,38
Admira Wacke,3080,8,11,5,20,37,70,-33,38
Mattersburg,3080,9,8,9,19,39,56,-17,33
SV Josko Rie,3080,10,8,7,21,30,59,-29,31
FC Salzburg,3081,1,21,8,7,66,28,38,71
SC Rheindorf,3081,2,21,6,9,56,42,14,69
SK Sturm Gra,3081,3,20,6,10,63,33,30,66
Vienna,3081,4,18,5,13,58,50,8,59
Admira Wacke,3081,5,15,7,14,38,53,-15,52
Rapid Vienna,3081,6,13,10,13,56,45,11,49
RZ Pellets W,3081,7,11,7,18,41,56,-15,40
SV Josko Rie,3081,8,11,5,20,35,54,-19,38
Mattersburg,3081,9,7,9,20,33,59,-26,30
St. Pölten,3081,10,6,11,19,37,63,-26,29
FC Salzburg,3082,1,21,6,9,67,30,37,69
SK Sturm Gra,3082,2,20,7,9,68,33,35,67
Vienna,3082,3,20,7,9,62,46,16,67
SC Rheindorf,3082,4,19,9,8,56,45,11,66
RZ Pellets W,3082,5,13,8,15,46,61,-15,47
Rapid Vienna,3082,6,10,13,13,50,45,5,43
St. Pölten,3082,7,11,10,15,45,60,-15,43
Admira Wacke,3082,8,10,7,19,36,62,-26,37
SV Josko Rie,3082,9,10,6,20,34,52,-18,36
Mattersburg,3082,10,4,11,21,32,62,-30,23
FC Salzburg,3083,1,22,6,8,59,29,30,72
Vienna,3083,2,20,5,11,64,46,18,65
SC Rheindorf,3083,3,18,9,9,54,40,14,63
SK Sturm Gra,3083,4,19,5,12,59,41,18,62
Rapid Vienna,3083,5,16,8,12,61,41,20,56
RZ Pellets W,3083,6,12,7,17,45,54,-9,43
Admira Wacke,3083,7,12,5,19,42,70,-28,41
St. Pölten,3083,8,9,11,16,43,65,-22,38
Mattersburg,3083,9,8,10,18,37,51,-14,34
SV Josko Rie,3083,10,7,8,21,31,58,-27,29
FC Salzburg,3084,1,22,6,8,65,33,32,72
Vienna,3084,2,19,6,11,64,46,18,63
SC Rheindorf,3084,3,18,9,9,52,41,11,63
SK Sturm Gra,3084,4,16,9,11,55,41,14,57
Rapid Vienna,3084,5,14,11,11,60,40,20,53
SV Josko Rie,3084,6,11,8,17,39,54,-15,41
Admira Wacke,3084,7,11,7,18,36,56,-20,40
Mattersburg,3084,8,10,9,17,43,60,-17,39
RZ Pellets W,3084,9,10,7,19,51,66,-15,37
St. Pölten,3084,10,8,10,18,37,65,-28,34
FC Salzburg,3085,1,20,8,8,64,34,30,68
SK Sturm Gra,3085,2,19,8,9,59,38,21,65
Vienna,3085,3,20,5,11,66,50,16,65
SC Rheindorf,3085,4,19,8,9,61,45,16,65
Rapid Vienna,3085,5,13,13,10,57,43,14,52
RZ Pellets W,3085,6,12,8,16,48,56,-8,44
SV Josko Rie,3085,7,11,6,19,37,55,-18,39
Admira Wacke,3085,8,9,8,19,37,66,-29,35
St. Pölten,3085,9,7,12,17,36,56,-20,33
Mattersburg,3085,10,7,10,19,34,56,-22,31
FC Salzburg,3086,1,20,9,7,61,31,30,69
Vienna,3086,2,19,7,10,68,48,20,64
SC Rheindorf,3086,3,17,10,9,51,42,9,61
SK Sturm Gra,3086,4,18,6,12,54,37,17,60
Rapid Vienna,3086,5,14,10,12,63,44,19,52
Admira Wacke,3086,6,11,9,16,35,59,-24,42
St. Pölten,3086,7,10,10,16,50,63,-13,40
SV Josko Rie,3086,8,10,8,18,30,50,-20,38
RZ Pellets W,3086,9,9,9,18,44,63,-19,36
Mattersburg,3086,10,8,10,18,36,55,-19,34
FC Salzburg,3087,1,20,6,10,63,32,31,66
SK Sturm Gra,3087,2,19,7,10,64,38,26,64
Vienna,3087,3,19,5,12,69,55,14,62
SC Rheindorf,3087,4,16,12,8,55,47,8,60
Rapid Vienna,3087,5,13,13,10,58,41,17,52
RZ Pellets W,3087,6,13,7,16,51,62,-11,46
SV Josko Rie,3087,7,14,3,19,40,56,-16,45
Admira Wacke,3087,8,13,5,18,43,62,-19,44
Mattersburg,3087,9,8,8,20,41,58,-17,32
St. Pölten,3087,10,8,8,20,38,71,-33,32
FC Salzburg,3088,1,22,9,5,71,27,44,75
SC Rheindorf,3088,2,21,7,8,54,42,12,70
SK Sturm Gra,3088,3,19,6,11,70,40,30,63
Vienna,3088,4,17,7,12,68,57,11,58
Rapid Vienna,3088,5,12,11,13,59,53,6,47
RZ Pellets W,3088,6,10,9,17,49,66,-17,39
SV Josko Rie,3088,7,10,9,17,41,59,-18,39
Admira Wacke,3088,8,10,9,17,41,61,-20,39
Mattersburg,3088,9,9,8,19,36,56,-20,35
St. Pölten,3088,10,8,9,19,44,72,-28,33
Vienna,3089,1,21,4,11,61,43,18,67
FC Salzburg,3089,2,20,6,10,61,33,28,66
SC Rheindorf,3089,3,18,11,7,55,39,16,65
SK Sturm Gra,3089,4,19,6,11,61,36,25,63
Rapid Vienna,3089,5,14,10,12,55,44,11,52
RZ Pellets W,3089,6,13,5,18,49,58,-9,44
SV Josko Rie,3089,7,13,5,18,40,53,-13,44
St. Pölten,3089,8,10,8,18,38,59,-21,38
Admira Wacke,3089,9,9,7,20,30,62,-32,34
Mattersburg,3089,10,8,8,20,36,59,-23,32
FC Salzburg,3090,1,23,5,8,66,30,36,74
SK Sturm Gra,3090,2,18,9,9,55,31,24,63
Vienna,3090,3,19,5,12,59,52,7,62
SC Rheindorf,3090,4,16,11,9,48,39,9,59
Rapid Vienna,3090,5,11,13,12,46,39,7,46
RZ Pellets W,3090,6,11,11,14,42,51,-9,44
Admira Wacke,3090,7,11,8,17,36,50,-14,41
SV Josko Rie,3090,8,11,7,18,32,53,-21,40
St. Pölten,3090,9,8,12,16,37,55,-18,36
Mattersburg,3090,10,6,11,19,34,55,-21,29
FC Salzburg,3091,1,24,5,7,66,29,37,77
SC Rheindorf,3091,2,18,10,8,51,40,11,64
Vienna,3091,3,19,5,12,61,52,9,62
SK Sturm Gra,3091,4,18,6,12,59,41,18,60
Rapid Vienna,3091,5,12,12,12,53,39,14,48
Admira Wacke,3091,6,12,10,14,39,49,-10,46
RZ Pellets W,3091,7,13,7,16,45,57,-12,46
St. Pölten,3091,8,7,12,17,40,61,-21,33
SV Josko Rie,3091,9,7,11,18,28,47,-19,32
Mattersburg,3091,10,6,10,20,35,62,-27,28
FC Salzburg,3092,1,21,9,6,67,30,37,72
Vienna,3092,2,22,4,10,66,49,17,70
SC Rheindorf,3092,3,20,6,10,55,39,16,66
SK Sturm Gra,3092,4,18,7,11,60,32,28,61
Admira Wacke,3092,5,17,5,14,40,51,-11,56
Rapid Vienna,3092,6,13,12,11,63,40,23,51
RZ Pellets W,3092,7,9,8,19,39,61,-22,35
Mattersburg,3092,8,8,9,19,38,66,-28,33
SV Josko Rie,3092,9,9,3,24,26,55,-29,30
St. Pölten,3092,10,7,9,20,39,70,-31,30
SC Rheindorf,3093,1,21,6,9,68,52,16,69
FC Salzburg,3093,2,20,8,8,66,36,30,68
SK Sturm Gra,3093,3,20,5,11,63,33,30,65
Vienna,3093,4,19,3,14,64,57,7,60
Rapid Vienna,3093,5,13,12,11,58,39,19,51
RZ Pellets W,3093,6,13,8,15,43,50,-7,47
Admira Wacke,3093,7,13,6,17,45,65,-20,45
SV Josko Rie,3093,8,10,7,19,36,57,-21,37
St. Pölten,3093,9,8,9,19,38,68,-30,33
Mattersburg,3093,10,7,8,21,38,62,-24,29
FC Salzburg,3094,1,21,7,8,70,38,32,70
SC Rheindorf,3094,2,18,11,7,51,37,14,65
Vienna,3094,3,19,3,14,67,51,16,60
SK Sturm Gra,3094,4,17,8,11,57,37,20,59
Rapid Vienna,3094,5,14,10,12,57,42,15,52
RZ Pellets W,3094,6,14,8,14,46,49,-3,50
Admira Wacke,3094,7,12,6,18,36,61,-25,42
St. Pölten,3094,8,10,10,16,39,60,-21,40
Mattersburg,3094,9,8,9,19,40,63,-23,33
SV Josko Rie,3094,10,8,6,22,28,53,-25,30
SK Sturm Gra,3095,1,21,6,9,62,31,31,69
FC Salzburg,3095,2,20,6,10,66,35,31,66
Vienna,3095,3,18,7,11,63,53,10,61
SC Rheindorf,3095,4,17,9,10,48,40,8,60
Admira Wacke,3095,5,15,7,14,41,52,-11,52
Rapid Vienna,3095,6,11,12,13,54,47,7,45
Mattersburg,3095,7,10,9,17,36,54,-18,39
St. Pölten,3095,8,9,11,16,46,62,-16,38
RZ Pellets W,3095,9,9,8,19,39,57,-18,35
SV Josko Rie,3095,10,10,5,21,32,56,-24,35
FC Salzburg,3096,1,21,5,10,62,32,30,68
Rapid Vienna,3096,2,19,8,9,66,40,26,65
Vienna,3096,3,20,5,11,71,49,22,65
SC Rheindorf,3096,4,19,7,10,55,46,9,64
SK Sturm Gra,3096,5,17,9,10,56,35,21,60
RZ Pellets W,3096,6,12,5,19,47,62,-15,41
Admira Wacke,3096,7,10,8,18,38,61,-23,38
SV Josko Rie,3096,8,10,7,19,34,57,-23,37
Mattersburg,3096,9,9,9,18,34,52,-18,36
St. Pölten,3096,10,7,9,20,37,66,-29,30
FC Salzburg,3097,1,24,6,6,71,28,43,78
SK Sturm Gra,3097,2,19,7,10,61,35,26,64
SC Rheindorf,3097,3,18,4,14,54,49,5,58
Rapid Vienna,3097,4,15,11,10,67,43,24,56
Vienna,3097,5,16,5,15,57,57,0,53
RZ Pellets W,3097,6,13,9,14,55,58,-3,48
SV Josko Rie,3097,7,14,3,19,35,48,-13,45
Admira Wacke,3097,8,12,6,18,39,64,-25,42
St. Pölten,3097,9,9,7,20,40,63,-23,34
Mattersburg,3097,10,8,6,22,33,67,-34,30
SK Sturm Gra,3098,1,20,7,9,61,38,23,67
FC Salzburg,3098,2,19,8,9,63,37,26,65
Vienna,3098,3,19,6,11,63,48,15,63
SC Rheindorf,3098,4,18,9,9,59,48,11,63
Rapid Vienna,3098,5,13,12,11,61,48,13,51
RZ Pellets W,3098,6,12,9,15,47,56,-9,45
SV Josko Rie,3098,7,11,9,16,48,54,-6,42
Admira Wacke,3098,8,12,5,19,42,62,-20,41
St. Pölten,3098,9,7,10,19,45,69,-24,31
Mattersburg,3098,10,7,9,20,36,65,-29,30
FC Salzburg,3099,1,20,9,7,67,35,32,69
SC Rheindorf,3099,2,20,8,8,58,42,16,68
Vienna,3099,3,20,6,10,64,42,22,66
SK Sturm Gra,3099,4,18,9,9,57,36,21,63
Rapid Vienna,3099,5,15,8,13,58,43,15,53
Admira Wacke,3099,6,13,7,16,40,61,-21,46
SV Josko Rie,3099,7,10,6,20,33,52,-19,36
St. Pölten,3099,8,8,10,18,43,62,-19,34
RZ Pellets W,3099,9,9,7,20,41,65,-24,34
Mattersburg,3099,10,8,8,20,38,61,-23,32
SK Sturm Gra,3100,1,21,7,8,56,30,26,70
SC Rheindorf,3100,2,20,7,9,55,42,13,67
FC Salzburg,3100,3,19,8,9,61,32,29,65
Vienna,3100,4,19,4,13,63,56,7,61
Rapid Vienna,3100,5,13,13,10,57,39,18,52
SV Josko Rie,3100,6,11,6,19,44,60,-16,39
RZ Pellets W,3100,7,10,9,17,40,56,-16,39
Admira Wacke,3100,8,10,8,18,34,56,-22,38
Mattersburg,3100,9,7,13,16,31,47,-16,34
St. Pölten,3100,10,6,13,17,39,62,-23,31
SC Rheindorf,3101,1,22,6,8,56,35,21,72
FC Salzburg,3101,2,21,7,8,67,32,35,70
SK Sturm Gra,3101,3,21,6,9,61,31,30,69
Vienna,3101,4,17,5,14,63,54,9,56
Rapid Vienna,3101,5,13,11,12,53,43,10,50
Admira Wacke,3101,6,13,8,15,38,58,-20,47
RZ Pellets W,3101,7,9,11,16,45,61,-16,38
Mattersburg,3101,8,9,8,19,42,57,-15,35
SV Josko Rie,3101,9,7,11,18,33,55,-22,32
St. Pölten,3101,10,7,9,20,36,68,-32,30
FC Salzburg,3102,1,22,6,8,78,37,41,72
SC Rheindorf,3102,2,21,6,9,59,47,12,69
SK Sturm Gra,3102,3,20,7,9,59,31,28,67
Rapid Vienna,3102,4,13,13,10,59,46,13,52
Vienna,3102,5,16,4,16,60,57,3,52
SV Josko Rie,3102,6,13,4,19,36,53,-17,43
RZ Pellets W,3102,7,10,10,16,50,63,-13,40
Admira Wacke,3102,8,10,9,17,35,58,-23,39
Mattersburg,3102,9,10,8,18,48,62,-14,38
St. Pölten,3102,10,7,9,20,37,67,-30,30
SC Rheindorf,3103,1,21,4,11,61,43,18,67
SK Sturm Gra,3103,2,20,5,11,62,32,30,65
FC Salzburg,3103,3,18,10,8,57,30,27,64
Vienna,3103,4,17,5,14,58,56,2,56
Rapid Vienna,3103,5,15,9,12,54,47,7,54
RZ Pellets W,3103,6,14,6,16,48,56,-8,48
Mattersburg,3103,7,11,8,17,40,51,-11,41
Admira Wacke,3103,8,11,8,17,42,58,-16,41
St. Pölten,3103,9,9,10,17,39,60,-21,37
SV Josko Rie,3103,10,8,7,21,27,55,-28,31
FC Salzburg,3104,1,20,8,8,64,27,37,68
SK Sturm Gra,3104,2,20,4,12,63,31,32,64
Vienna,3104,3,20,4,12,54,47,7,64
Rapid Vienna,3104,4,17,9,10,54,33,21,60
SC Rheindorf,3104,5,17,8,11,47,44,3,59
Admira Wacke,3104,6,14,7,15,43,53,-10,49
RZ Pellets W,3104,7,10,8,18,38,58,-20,38
SV Josko Rie,3104,8,11,4,21,38,57,-19,37
Mattersburg,3104,9,8,9,19,36,59,-23,33
St. Pölten,3104,10,8,9,19,43,71,-28,33
FC Salzburg,3105,1,22,6,8,69,30,39,72
Vienna,3105,2,20,4,12,60,49,11,64
SC Rheindorf,3105,3,19,7,10,53,45,8,64
SK Sturm Gra,3105,4,19,6,11,52,31,21,63
Rapid Vienna,3105,5,15,10,11,64,40,24,55
RZ Pellets W,3105,6,13,7,16,42,48,-6,46
Admira Wacke,3105,7,9,10,17,36,61,-25,37
SV Josko Rie,3105,8,9,9,18,33,53,-20,36
Mattersburg,3105,9,8,10,18,35,59,-24,34
St. Pölten,3105,10,8,7,21,43,71,-28,31
FC Salzburg,3106,1,22,7,7,75,29,46,73
SC Rheindorf,3106,2,19,10,7,51,41,10,67
SK Sturm Gra,3106,3,17,8,11,57,41,16,59
Rapid Vienna,3106,4,15,13,8,62,38,24,58
Vienna,3106,5,18,3,15,69,61,8,57
Admira Wacke,3106,6,12,6,18,35,61,-26,42
RZ Pellets W,3106,7,10,9,17,44,57,-13,39
St. Pölten,3106,8,8,13,15,40,59,-19,37
SV Josko Rie,3106,9,10,5,21,34,57,-23,35
Mattersburg,3106,10,7,10,19,38,61,-23,31
Vienna,3107,1,21,5,10,69,47,22,68
FC Salzburg,3107,2,19,8,9,63,31,32,65
SC Rheindorf,3107,3,19,7,10,57,48,9,64
SK Sturm Gra,3107,4,18,8,10,58,35,23,62
Rapid Vienna,3107,5,16,12,8,58,34,24,60
SV Josko Rie,3107,6,12,6,18,36,48,-12,42
RZ Pellets W,3107,7,12,5,19,43,60,-17,41
St. Pölten,3107,8,11,8,17,46,69,-23,41
Admira Wacke,3107,9,10,5,21,36,64,-28,35
Mattersburg,3107,10,7,6,23,31,61,-30,27
FC Salzburg,3108,1,22,8,6,71,35,36,74
SC Rheindorf,3108,2,19,8,9,59,43,16,65
SK Sturm Gra,3108,3,19,7,10,65,35,30,64
Vienna,3108,4,18,2,16,63,59,4,56
Rapid Vienna,3108,5,14,11,11,53,36,17,53
Admira Wacke,3108,6,14,6,16,40,57,-17,48
RZ Pellets W,3108,7,13,6,17,42,55,-13,45
Mattersburg,3108,8,11,8,17,41,55,-14,41
St. Pölten,3108,9,9,7,20,38,64,-26,34
SV Josko Rie,3108,10,7,5,24,27,60,-33,26
FC Salzburg,3109,1,20,8,8,68,32,36,68
SK Sturm Gra,3109,2,18,9,9,57,35,22,63
SC Rheindorf,3109,3,18,6,12,50,45,5,60
RZ Pellets W,3109,4,15,7,14,53,54,-1,52
Rapid Vienna,3109,5,12,14,10,54,39,15,50
Vienna,3109,6,16,2,18,58,71,-13,50
Admira Wacke,3109,7,14,7,15,44,52,-8,49
Mattersburg,3109,8,12,7,17,50,59,-9,43
SV Josko Rie,3109,9,10,5,21,36,59,-23,35
St. Pölten,3109,10,8,9,19,40,64,-24,33
FC Salzburg,3110,1,22,7,7,69,29,40,73
SC Rheindorf,3110,2,19,10,7,58,38,20,67
SK Sturm Gra,3110,3,19,7,10,63,35,28,64
Vienna,3110,4,18,5,13,61,55,6,59
Rapid Vienna,3110,5,16,8,12,57,42,15,56
RZ Pellets W,3110,6,14,6,16,47,52,-5,48
Admira Wacke,3110,7,14,6,16,37,49,-12,48
Mattersburg,3110,8,7,9,20,31,59,-28,30
SV Josko Rie,3110,9,7,8,21,26,53,-27,29
St. Pölten,3110,10,5,12,19,33,70,-37,27
SC Rheindorf,3111,1,20,7,9,56,42,14,67
FC Salzburg,3111,2,19,9,8,65,33,32,66
SK Sturm Gra,3111,3,19,9,8,68,37,31,66
Rapid Vienna,3111,4,17,9,10,57,34,23,60
Vienna,3111,5,17,7,12,61,55,6,58
Admira Wacke,3111,6,12,9,15,40,59,-19,45
RZ Pellets W,3111,7,10,9,17,45,56,-11,39
Mattersburg,3111,8,7,11,18,34,59,-25,32
SV Josko Rie,3111,9,8,8,20,33,60,-27,32
St. Pölten,3111,10,7,10,19,41,65,-24,31
FC Salzburg,3112,1,20,8,8,61,36,25,68
SC Rheindorf,3112,2,19,9,8,56,40,16,66
SK Sturm Gra,3112,3,17,7,12,60,41,19,58
Vienna,3112,4,16,9,11,63,52,11,57
Rapid Vienna,3112,5,15,11,10,53,37,16,56
RZ Pellets W,3112,6,11,11,14,43,52,-9,44
SV Josko Rie,3112,7,12,4,20,40,53,-13,40
Admira Wacke,3112,8,10,9,17,36,59,-23,39
St. Pölten,3112,9,8,11,17,44,67,-23,35
Mattersburg,3112,10,8,9,19,44,63,-19,33
FC Salzburg,3113,1,20,8,8,70,36,34,68
SC Rheindorf,3113,2,19,6,11,49,42,7,63
Vienna,3113,3,18,5,13,60,51,9,59
SK Sturm Gra,3113,4,17,7,12,57,38,19,58
Rapid Vienna,3113,5,14,12,10,58,41,17,54
RZ Pellets W,3113,6,14,7,15,48,52,-4,49
St. Pölten,3113,7,11,10,15,49,64,-15,43
SV Josko Rie,3113,8,12,2,22,34,54,-20,38
Admira Wacke,3113,9,10,7,19,36,63,-27,37
Mattersburg,3113,10,9,8,19,34,54,-20,35
SK Sturm Gra,3114,1,22,6,8,63,33,30,72
FC Salzburg,3114,2,21,7,8,67,34,33,70
SC Rheindorf,3114,3,20,9,7,63,45,18,69
Vienna,3114,4,18,5,13,62,53,9,59
Rapid Vienna,3114,5,12,14,10,65,44,21,50
Mattersburg,3114,6,10,8,18,42,61,-19,38
Admira Wacke,3114,7,9,10,17,38,60,-22,37
RZ Pellets W,3114,8,10,6,20,39,62,-23,36
St. Pölten,3114,9,8,10,18,41,61,-20,34
SV Josko Rie,3114,10,9,7,20,26,53,-27,34
FC Salzburg,3115,1,21,9,6,64,32,32,72
Vienna,3115,2,19,7,10,64,47,17,64
SK Sturm Gra,3115,3,18,7,11,56,37,19,61
SC Rheindorf,3115,4,18,6,12,56,47,9,60
Rapid Vienna,3115,5,13,12,11,56,39,17,51
SV Josko Rie,3115,6,14,5,17,36,45,-9,47
Admira Wacke,3115,7,12,5,19,34,54,-20,41
St. Pölten,3115,8,9,10,17,46,64,-18,37
RZ Pellets W,3115,9,9,8,19,39,65,-26,35
Mattersburg,3115,10,7,11,18,38,59,-21,32
FC Salzburg,3116,1,22,8,6,71,26,45,74
SK Sturm Gra,3116,2,22,6,8,62,33,29,72
SC Rheindorf,3116,3,19,7,10,57,46,11,64
Vienna,3116,4,19,5,12,64,47,17,62
Rapid Vienna,3116,5,13,10,13,47,40,7,49
RZ Pellets W,3116,6,13,7,16,47,54,-7,46
Admira Wacke,3116,7,10,11,15,34,53,-19,41
St. Pölten,3116,8,9,8,19,42,69,-27,35
SV Josko Rie,3116,9,9,6,21,34,60,-26,33
Mattersburg,3116,10,6,8,22,43,73,-30,26
FC Salzburg,3117,1,22,6,8,67,29,38,72
SC Rheindorf,3117,2,20,6,10,57,43,14,66
SK Sturm Gra,3117,3,20,4,12,58,40,18,64
Vienna,3117,4,20,4,12,65,53,12,64
Rapid Vienna,3117,5,14,9,13,59,45,14,51
Admira Wacke,3117,6,14,6,16,36,50,-14,48
RZ Pellets W,3117,7,13,8,15,54,62,-8,47
SV Josko Rie,3117,8,11,3,22,41,62,-21,36
Mattersburg,3117,9,8,9,19,37,56,-19,33
St. Pölten,3117,10,7,7,22,43,77,-34,28
FC Salzburg,3118,1,23,7,6,70,31,39,76
SC Rheindorf,3118,2,21,8,7,60,41,19,71
Vienna,3118,3,19,6,11,68,51,17,63
SK Sturm Gra,3118,4,18,4,14,52,40,12,58
Rapid Vienna,3118,5,12,10,14,49,46,3,46
SV Josko Rie,3118,6,12,8,16,35,44,-9,44
RZ Pellets W,3118,7,12,7,17,51,61,-10,43
Admira Wacke,3118,8,12,6,18,38,57,-19,42
St. Pölten,3118,9,8,9,19,35,63,-28,33
Mattersburg,3118,10,7,7,22,39,63,-24,28
FC Salzburg,3119,1,20,9,7,66,30,36,69
SK Sturm Gra,3119,2,20,7,9,58,30,28,67
SC Rheindorf,3119,3,18,10,8,54,38,16,64
Vienna,3119,4,18,4,14,66,60,6,58
Rapid Vienna,3119,5,14,11,11,58,36,22,53
RZ Pellets W,3119,6,15,5,16,47,54,-7,50
St. Pölten,3119,7,10,9,17,37,61,-24,39
Admira Wacke,3119,8,10,7,19,36,64,-28,37
SV Josko Rie,3119,9,9,7,20,31,52,-21,34
Mattersburg,3119,10,7,9,20,34,62,-28,30
FC Salzburg,3120,1,20,7,9,65,35,30,67
SK Sturm Gra,3120,2,19,7,10,53,31,22,64
SC Rheindorf,3120,3,19,7,10,57,46,11,64
Vienna,3120,4,18,5,13,62,54,8,59
Rapid Vienna,3120,5,15,11,10,61,45,16,56
Admira Wacke,3120,6,11,10,15,40,55,-15,43
SV Josko Rie,3120,7,12,5,19,34,47,-13,41
RZ Pellets W,3120,8,11,8,17,41,57,-16,41
Mattersburg,3120,9,9,8,19,33,52,-19,35
St. Pölten,3120,10,8,8,20,39,63,-24,32
SC Rheindorf,3121,1,22,6,8,58,40,18,72
FC Salzburg,3121,2,20,7,9,59,33,26,67
Vienna,3121,3,19,6,11,70,52,18,63
SK Sturm Gra,3121,4,18,7,11,62,37,25,61
Rapid Vienna,3121,5,16,11,9,65,42,23,59
Admira Wacke,3121,6,13,5,18,45,65,-20,44
SV Josko Rie,3121,7,11,8,17,35,46,-11,41
RZ Pellets W,3121,8,11,8,17,47,66,-19,41
Mattersburg,3121,9,9,8,19,35,56,-21,35
St. Pölten,3121,10,4,8,24,36,75,-39,20
FC Salzburg,3122,1,22,4,10,62,32,30,70
SK Sturm Gra,3122,2,20,7,9,71,37,34,67
SC Rheindorf,3122,3,20,6,10,57,42,15,66
Vienna,3122,4,20,3,13,59,51,8,63
Rapid Vienna,3122,5,15,11,10,54,42,12,56
RZ Pellets W,3122,6,12,8,16,46,56,-10,44
Admira Wacke,3122,7,12,6,18,38,53,-15,42
St. Pölten,3122,8,10,7,19,44,67,-23,37
SV Josko Rie,3122,9,10,5,21,35,62,-27,35
Mattersburg,3122,10,7,7,22,33,57,-24,28
FC Salzburg,3123,1,24,6,6,71,31,40,78
SC Rheindorf,3123,2,21,8,7,56,37,19,71
Vienna,3123,3,20,6,10,65,50,15,66
SK Sturm Gra,3123,4,18,8,10,57,33,24,62
Rapid Vienna,3123,5,15,9,12,63,46,17,54
RZ Pellets W,3123,6,12,6,18,46,59,-13,42
Admira Wacke,3123,7,11,6,19,32,60,-28,39
SV Josko Rie,3123,8,9,6,21,27,51,-24,33
St. Pölten,3123,9,7,9,20,36,64,-28,30
Mattersburg,3123,10,7,8,21,40,62,-22,29
SC Rheindorf,3124,1,20,7,9,56,42,14,67
SK Sturm Gra,3124,2,19,8,9,59,37,22,65
FC Salzburg,3124,3,18,9,9,61,35,26,63
Vienna,3124,4,16,6,14,57,51,6,54
Rapid Vienna,3124,5,12,12,12,59,44,15,48
RZ Pellets W,3124,6,11,10,15,39,47,-8,43
Mattersburg,3124,7,11,10,15,40,54,-14,43
Admira Wacke,3124,8,11,8,17,33,54,-21,41
SV Josko Rie,3124,9,11,7,18,35,53,-18,40
St. Pölten,3124,10,8,9,19,41,63,-22,33
SK Sturm Gra,3125,1,19,8,9,62,36,26,65
SC Rheindorf,3125,2,19,8,9,59,42,17,65
FC Salzburg,3125,3,18,7,11,61,32,29,61
Rapid Vienna,3125,4,16,9,11,60,43,17,57
Vienna,3125,5,16,3,17,62,63,-1,51
Mattersburg,3125,6,14,7,15,45,52,-7,49
SV Josko Rie,3125,7,12,8,16,38,48,-10,44
Admira Wacke,3125,8,11,7,18,37,60,-23,40
RZ Pellets W,3125,9,9,9,18,40,58,-18,36
St. Pölten,3125,10,8,10,18,37,67,-30,34
FC Salzburg,3126,1,19,9,8,70,40,30,66
SK Sturm Gra,3126,2,18,8,10,59,32,27,62
Vienna,3126,3,18,5,13,60,50,10,59
SC Rheindorf,3126,4,16,11,9,56,47,9,59
Rapid Vienna,3126,5,15,9,12,59,41,18,54
Admira Wacke,3126,6,13,9,14,43,56,-13,48
RZ Pellets W,3126,7,11,9,16,43,51,-8,42
Mattersburg,3126,8,11,9,16,42,58,-16,42
St. Pölten,3126,9,8,10,18,39,65,-26,34
SV Josko Rie,3126,10,9,5,22,32,63,-31,32
SC Rheindorf,3127,1,21,8,7,56,41,15,71
SK Sturm Gra,3127,2,21,6,9,70,36,34,69
FC Salzburg,3127,3,20,7,9,70,38,32,67
Vienna,3127,4,19,4,13,66,55,11,61
Rapid Vienna,3127,5,12,13,11,48,37,11,49
RZ Pellets W,3127,6,13,9,14,55,63,-8,48
Admira Wacke,3127,7,11,8,17,38,58,-20,41
SV Josko Rie,3127,8,9,6,21,34,59,-25,33
St. Pölten,3127,9,7,10,19,41,65,-24,31
Mattersburg,3127,10,8,7,21,32,58,-26,31
FC Salzburg,3128,1,25,6,5,67,24,43,81
Vienna,3128,2,19,6,11,64,48,16,63
SK Sturm Gra,3128,3,18,7,11,52,33,19,61
SC Rheindorf,3128,4,16,12,8,51,40,11,60
Rapid Vienna,3128,5,14,12,10,58,43,15,54
RZ Pellets W,3128,6,13,6,17,48,55,-7,45
Admira Wacke,3128,7,12,5,19,36,60,-24,41
Mattersburg,3128,8,8,11,17,38,58,-20,35
St. Pölten,3128,9,8,9,19,35,60,-25,33
SV Josko Rie,3128,10,7,6,23,26,54,-28,27
SC Rheindorf,3129,1,22,6,8,65,40,25,72
FC Salzburg,3129,2,21,6,9,70,36,34,69
SK Sturm Gra,3129,3,20,6,10,63,38,25,66
Vienna,3129,4,19,6,11,66,53,13,63
Rapid Vienna,3129,5,11,11,14,54,52,2,44
Admira Wacke,3129,6,11,7,18,41,64,-23,40
St. Pölten,3129,7,10,9,17,42,62,-20,39
Mattersburg,3129,8,10,8,18,35,56,-21,38
RZ Pellets W,3129,9,10,7,19,40,60,-20,37
SV Josko Rie,3129,10,9,8,19,35,50,-15,35
Vienna,3130,1,22,3,11,71,47,24,69
SC Rheindorf,3130,2,21,5,10,57,49,8,68
SK Sturm Gra,3130,3,21,4,11,68,31,37,67
FC Salzburg,3130,4,17,8,11,64,42,22,59
Rapid Vienna,3130,5,15,9,12,56,40,16,54
RZ Pellets W,3130,6,13,6,17,47,55,-8,45
Admira Wacke,3130,7,12,5,19,35,66,-31,41
SV Josko Rie,3130,8,11,4,21,35,57,-22,37
St. Pölten,3130,9,9,8,19,42,60,-18,35
Mattersburg,3130,10,9,8,19,35,63,-28,35
FC Salzburg,3131,1,23,6,7,69,28,41,75
SK Sturm Gra,3131,2,22,5,9,68,37,31,71
SC Rheindorf,3131,3,17,7,12,53,51,2,58
Vienna,3131,4,17,4,15,65,61,4,55
RZ Pellets W,3131,5,16,6,14,56,60,-4,54
Rapid Vienna,3131,6,12,11,13,57,45,12,47
Admira Wacke,3131,7,12,8,16,45,64,-19,44
St. Pölten,3131,8,9,9,18,47,71,-24,36
SV Josko Rie,3131,9,10,5,21,33,53,-20,35
Mattersburg,3131,10,7,9,20,38,61,-23,30
SC Rheindorf,3132,1,21,7,8,58,37,21,70
Rapid Vienna,3132,2,19,7,10,64,41,23,64
FC Salzburg,3132,3,19,6,11,64,37,27,63
SK Sturm Gra,3132,4,18,5,13,56,33,23,59
Vienna,3132,5,18,5,13,62,51,11,59
Admira Wacke,3132,6,14,6,16,44,59,-15,48
RZ Pellets W,3132,7,12,7,17,46,58,-12,43
St. Pölten,3132,8,10,8,18,41,61,-20,38
SV Josko Rie,3132,9,10,4,22,30,67,-37,34
Mattersburg,3132,10,8,7,21,38,59,-21,31
FC Salzburg,3133,1,21,7,8,66,26,40,70
SK Sturm Gra,3133,2,21,7,8,63,29,34,70
Vienna,3133,3,20,2,14,60,55,5,62
SC Rheindorf,3133,4,17,9,10,48,37,11,60
RZ Pellets W,3133,5,13,6,17,44,54,-10,45
SV Josko Rie,3133,6,14,3,19,40,53,-13,45
Admira Wacke,3133,7,12,7,17,39,61,-22,43
Rapid Vienna,3133,8,11,9,16,47,46,1,42
St. Pölten,3133,9,11,9,16,42,59,-17,42
Mattersburg,3133,10,6,9,21,33,62,-29,27
FC Salzburg,3134,1,24,6,6,70,25,45,78
SK Sturm Gra,3134,2,21,6,9,58,33,25,69
SC Rheindorf,3134,3,21,6,9,56,41,15,69
Vienna,3134,4,18,7,11,61,48,13,61
Rapid Vienna,3134,5,10,12,14,49,43,6,42
Admira Wacke,3134,6,12,5,19,33,55,-22,41
Mattersburg,3134,7,11,7,18,41,55,-14,40
RZ Pellets W,3134,8,10,9,17,41,56,-15,39
SV Josko Rie,3134,9,9,7,20,30,55,-25,34
St. Pölten,3134,10,5,13,18,35,63,-28,28
Vienna,3135,1,22,5,9,69,48,21,71
FC Salzburg,3135,2,21,7,8,68,34,34,70
SC Rheindorf,3135,3,21,5,10,62,51,11,68
SK Sturm Gra,3135,4,16,9,11,58,41,17,57
Rapid Vienna,3135,5,15,10,11,56,41,15,55
RZ Pellets W,3135,6,12,9,15,44,55,-11,45
Admira Wacke,3135,7,12,5,19,36,58,-22,41
SV Josko Rie,3135,8,12,3,21,39,52,-13,39
St. Pölten,3135,9,8,12,16,39,59,-20,36
Mattersburg,3135,10,5,7,24,31,63,-32,22
FC Salzburg,3136,1,22,8,6,75,30,45,74
SK Sturm Gra,3136,2,20,6,10,57,30,27,66
SC Rheindorf,3136,3,19,8,9,53,45,8,65
Vienna,3136,4,18,5,13,61,58,3,59
RZ Pellets W,3136,5,18,5,13,49,48,1,59
Rapid Vienna,3136,6,13,9,14,60,44,16,48
SV Josko Rie,3136,7,11,5,20,41,52,-11,38
Admira Wacke,3136,8,9,7,20,35,61,-26,34
St. Pölten,3136,9,8,8,20,34,70,-36,32
Mattersburg,3136,10,8,7,21,37,64,-27,31
FC Salzburg,3137,1,24,6,6,61,23,38,78
SK Sturm Gra,3137,2,19,8,9,62,32,30,65
SC Rheindorf,3137,3,19,8,9,53,40,13,65
Vienna,3137,4,18,4,14,60,57,3,58
RZ Pellets W,3137,5,15,7,14,48,49,-1,52
Rapid Vienna,3137,6,12,12,12,55,42,13,48
SV Josko Rie,3137,7,11,6,19,37,50,-13,39
Admira Wacke,3137,8,11,6,19,36,59,-23,39
St. Pölten,3137,9,8,9,19,42,70,-28,33
Mattersburg,3137,10,5,10,21,31,63,-32,25
FC Salzburg,3138,1,23,6,7,63,27,36,75
SC Rheindorf,3138,2,20,7,9,61,38,23,67
Rapid Vienna,3138,3,17,11,8,60,37,23,62
SK Sturm Gra,3138,4,18,7,11,63,37,26,61
Vienna,3138,5,17,8,11,58,46,12,59
RZ Pellets W,3138,6,12,6,18,44,60,-16,42
SV Josko Rie,3138,7,13,2,21,38,58,-20,41
St. Pölten,3138,8,8,11,17,43,67,-24,35
Admira Wacke,3138,9,9,5,22,34,73,-39,32
Mattersburg,3138,10,7,9,20,41,62,-21,30
Vienna,3139,1,23,5,8,69,44,25,74
FC Salzburg,3139,2,21,8,7,61,30,31,71
SK Sturm Gra,3139,3,21,5,10,60,33,27,68
SC Rheindorf,3139,4,18,6,12,52,47,5,60
Rapid Vienna,3139,5,13,10,13,51,42,9,49
Admira Wacke,3139,6,11,5,20,41,59,-18,38
Mattersburg,3139,7,9,10,17,42,57,-15,37
RZ Pellets W,3139,8,10,6,20,42,61,-19,36
SV Josko Rie,3139,9,9,8,19,33,54,-21,35
St. Pölten,3139,10,8,11,17,42,66,-24,35
FC Salzburg,3140,1,21,6,9,71,37,34,69
SK Sturm Gra,3140,2,21,6,9,63,35,28,69
SC Rheindorf,3140,3,19,7,10,52,41,11,64
Vienna,3140,4,18,5,13,67,57,10,59
Rapid Vienna,3140,5,14,13,9,61,38,23,55
RZ Pellets W,3140,6,12,7,17,45,59,-14,43
SV Josko Rie,3140,7,10,8,18,33,48,-15,38
Mattersburg,3140,8,10,8,18,39,57,-18,38
Admira Wacke,3140,9,10,7,19,36,63,-27,37
St. Pölten,3140,10,8,7,21,35,67,-32,31
FC Salzburg,3141,1,22,7,7,74,28,46,73
SK Sturm Gra,3141,2,22,4,10,65,38,27,70
SC Rheindorf,3141,3,21,6,9,65,51,14,69
Vienna,3141,4,19,5,12,60,47,13,62
Rapid Vienna,3141,5,14,11,11,68,46,22,53
SV Josko Rie,3141,6,13,4,19,37,51,-14,43
Admira Wacke,3141,7,10,6,20,36,68,-32,36
St. Pölten,3141,8,8,11,17,40,66,-26,35
RZ Pellets W,3141,9,9,7,20,39,61,-22,34
Mattersburg,3141,10,8,7,21,34,62,-28,31
SC Rheindorf,3142,1,20,11,5,61,34,27,71
FC Salzburg,3142,2,20,9,7,67,32,35,69
SK Sturm Gra,3142,3,21,6,9,64,37,27,69
Vienna,3142,4,21,4,11,76,50,26,67
Rapid Vienna,3142,5,14,8,14,57,47,10,50
RZ Pellets W,3142,6,12,6,18,39,54,-15,42
Admira Wacke,3142,7,10,7,19,34,56,-22,37
Mattersburg,3142,8,9,8,19,36,58,-22,35
St. Pölten,3142,9,8,9,19,41,74,-33,33
SV Josko Rie,3142,10,8,6,22,28,61,-33,30
FC Salzburg,3143,1,20,9,7,57,27,30,69
SC Rheindorf,3143,2,20,8,8,62,44,18,68
SK Sturm Gra,3143,3,18,9,9,64,35,29,63
Vienna,3143,4,18,5,13,59,51,8,59
Rapid Vienna,3143,5,15,9,12,59,41,18,54
Admira Wacke,3143,6,15,5,16,36,50,-14,50
RZ Pellets W,3143,7,13,7,16,46,58,-12,46
SV Josko Rie,3143,8,11,4,21,34,55,-21,37
Mattersburg,3143,9,7,10,19,40,61,-21,31
St. Pölten,3143,10,6,8,22,40,75,-35,26
Vienna,3144,1,23,3,10,70,46,24,72
SK Sturm Gra,3144,2,19,8,9,62,38,24,65
FC Salzburg,3144,3,19,7,10,61,36,25,64
SC Rheindorf,3144,4,19,6,11,60,47,13,63
Rapid Vienna,3144,5,12,12,12,55,44,11,48
St. Pölten,3144,6,10,10,16,40,55,-15,40
SV Josko Rie,3144,7,11,7,18,37,54,-17,40
Admira Wacke,3144,8,11,6,19,36,63,-27,39
RZ Pellets W,3144,9,10,7,19,42,62,-20,37
Mattersburg,3144,10,7,12,17,38,56,-18,33
FC Salzburg,3145,1,24,6,6,70,26,44,78
SC Rheindorf,3145,2,21,5,10,57,40,17,68
Rapid Vienna,3145,3,17,9,10,73,48,25,60
SK Sturm Gra,3145,4,17,8,11,62,44,18,59
Vienna,3145,5,16,4,16,56,56,0,52
SV Josko Rie,3145,6,14,4,18,42,54,-12,46
RZ Pellets W,3145,7,12,8,16,45,57,-12,44
Admira Wacke,3145,8,12,5,19,37,65,-28,41
St. Pölten,3145,9,8,7,21,42,63,-21,31
Mattersburg,3145,10,7,8,21,36,67,-31,29
SK Sturm Gra,3146,1,19,8,9,69,38,31,65
Vienna,3146,2,19,4,13,65,61,4,61
FC Salzburg,3146,3,17,8,11,64,40,24,59
Rapid Vienna,3146,4,16,10,10,64,47,17,58
SC Rheindorf,3146,5,15,12,9,51,45,6,57
SV Josko Rie,3146,6,13,7,16,40,48,-8,46
St. Pölten,3146,7,11,10,15,52,66,-14,43
Admira Wacke,3146,8,10,9,17,40,62,-22,39
RZ Pellets W,3146,9,8,12,16,44,62,-18,36
Mattersburg,3146,10,5,14,17,36,56,-20,29
FC Salzburg,3147,1,21,8,7,74,33,41,71
SK Sturm Gra,3147,2,21,7,8,62,30,32,70
SC Rheindorf,3147,3,20,4,12,53,48,5,64
Rapid Vienna,3147,4,17,11,8,61,39,22,62
Vienna,3147,5,18,6,12,59,55,4,60
RZ Pellets W,3147,6,11,8,17,43,52,-9,41
SV Josko Rie,3147,7,11,6,19,33,47,-14,39
Admira Wacke,3147,8,10,8,18,34,55,-21,38
Mattersburg,3147,9,8,8,20,33,54,-21,32
St. Pölten,3147,10,6,8,22,36,75,-39,26
SK Sturm Gra,3148,1,21,7,8,62,32,30,70
FC Salzburg,3148,2,21,6,9,65,29,36,69
SC Rheindorf,3148,3,18,9,9,54,44,10,63
Vienna,3148,4,18,5,13,66,54,12,59
Rapid Vienna,3148,5,12,10,14,56,49,7,46
RZ Pellets W,3148,6,11,10,15,52,60,-8,43
SV Josko Rie,3148,7,12,5,19,36,54,-18,41
St. Pölten,3148,8,10,8,18,39,63,-24,38
Admira Wacke,3148,9,10,7,19,31,58,-27,37
Mattersburg,3148,10,9,9,18,43,61,-18,36
FC Salzburg,3149,1,20,6,10,59,34,25,66
Vienna,3149,2,20,4,12,70,56,14,64
SC Rheindorf,3149,3,18,8,10,57,46,11,62
Rapid Vienna,3149,4,17,10,9,64,39,25,61
SK Sturm Gra,3149,5,18,6,12,53,38,15,60
RZ Pellets W,3149,6,13,9,14,44,45,-1,48
St. Pölten,3149,7,9,10,17,43,63,-20,37
Admira Wacke,3149,8,10,6,20,32,58,-26,36
SV Josko Rie,3149,9,10,5,21,32,57,-25,35
Mattersburg,3149,10,8,10,18,42,60,-18,34
FC Salzburg,3150,1,23,7,6,70,32,38,76
SK Sturm Gra,3150,2,18,9,9,63,36,27,63
SC Rheindorf,3150,3,18,9,9,63,48,15,63
Vienna,3150,4,18,5,13,63,56,7,59
Rapid Vienna,3150,5,14,11,11,61,45,16,53
RZ Pellets W,3150,6,12,9,15,49,59,-10,45
Admira Wacke,3150,7,12,7,17,43,57,-14,43
Mattersburg,3150,8,11,8,17,45,61,-16,41
SV Josko Rie,3150,9,9,4,23,34,64,-30,31
St. Pölten,3150,10,6,9,21,41,74,-33,27
SC Rheindorf,3151,1,22,5,9,62,42,20,71
Vienna,3151,2,21,5,10,67,49,18,68
FC Salzburg,3151,3,20,7,9,68,37,31,67
SK Sturm Gra,3151,4,19,6,11,62,38,24,63
Rapid Vienna,3151,5,14,10,12,54,38,16,52
RZ Pellets W,3151,6,12,8,16,52,64,-12,44
Admira Wacke,3151,7,10,9,17,40,62,-22,39
SV Josko Rie,3151,8,11,5,20,36,57,-21,38
Mattersburg,3151,9,9,8,19,38,62,-24,35
St. Pölten,3151,10,6,9,21,36,66,-30,27
SC Rheindorf,3152,1,22,7,7,63,36,27,73
FC Salzburg,3152,2,22,6,8,64,34,30,72
SK Sturm Gra,3152,3,21,7,8,63,33,30,70
Vienna,3152,4,16,7,13,55,48,7,55
RZ Pellets W,3152,5,13,9,14,51,54,-3,48
Admira Wacke,3152,6,14,6,16,44,54,-10,48
Rapid Vienna,3152,7,12,9,15,53,43,10,45
SV Josko Rie,3152,8,9,6,21,29,54,-25,33
Mattersburg,3152,9,8,6,22,33,65,-32,30
St. Pölten,3152,10,7,9,20,37,71,-34,30
SC Rheindorf,3153,1,21,7,8,58,40,18,70
FC Salzburg,3153,2,19,9,8,60,27,33,66
SK Sturm Gra,3153,3,19,7,10,63,42,21,64
Vienna,3153,4,18,5,13,65,55,10,59
Rapid Vienna,3153,5,14,10,12,50,40,10,52
SV Josko Rie,3153,6,13,7,16,38,47,-9,46
Admira Wacke,3153,7,11,8,17,39,55,-16,41
RZ Pellets W,3153,8,11,7,18,48,63,-15,40
Mattersburg,3153,9,8,11,17,32,54,-22,35
St. Pölten,3153,10,6,9,21,36,66,-30,27
FC Salzburg,3154,1,20,7,9,61,31,30,67
Vienna,3154,2,20,6,10,58,43,15,66
SC Rheindorf,3154,3,19,8,9,57,42,15,65
SK Sturm Gra,3154,4,18,7,11,60,35,25,61
Rapid Vienna,3154,5,13,12,11,61,43,18,51
RZ Pellets W,3154,6,11,9,16,37,51,-14,42
Admira Wacke,3154,7,12,5,19,39,60,-21,41
SV Josko Rie,3154,8,10,9,17,34,52,-18,39
St. Pölten,3154,9,8,10,18,38,63,-25,34
Mattersburg,3154,10,7,11,18,35,60,-25,32
SK Sturm Gra,3155,1,20,8,8,62,33,29,68
FC Salzburg,3155,2,20,7,9,63,37,26,67
Vienna,3155,3,19,8,9,63,47,16,65
SC Rheindorf,3155,4,19,5,12,48,38,10,62
Rapid Vienna,3155,5,14,13,9,64,40,24,55
RZ Pellets W,3155,6,11,8,17,49,57,-8,41
Mattersburg,3155,7,10,10,16,36,49,-13,40
Admira Wacke,3155,8,11,6,19,39,65,-26,39
SV Josko Rie,3155,9,8,9,19,31,52,-21,33
St. Pölten,3155,10,6,10,20,34,71,-37,28
FC Salzburg,3156,1,21,8,7,65,30,35,71
SC Rheindorf,3156,2,19,10,7,54,39,15,67
SK Sturm Gra,3156,3,18,7,11,60,39,21,61
Vienna,3156,4,17,6,13,56,47,9,57
Rapid Vienna,3156,5,14,11,11,58,42,16,53
RZ Pellets W,3156,6,11,12,13,43,51,-8,45
Admira Wacke,3156,7,13,5,18,35,58,-23,44
Mattersburg,3156,8,9,8,19,38,59,-21,35
SV Josko Rie,3156,9,8,10,18,31,50,-19,34
St. Pölten,3156,10,7,9,20,38,63,-25,30
Vienna,3157,1,21,3,12,62,47,15,66
FC Salzburg,3157,2,19,8,9,71,41,30,65
SC Rheindorf,3157,3,19,6,11,57,43,14,63
SK Sturm Gra,3157,4,19,5,12,54,38,16,62
Rapid Vienna,3157,5,16,9,11,59,41,18,57
Admira Wacke,3157,6,15,5,16,43,57,-14,50
SV Josko Rie,3157,7,13,5,18,38,50,-12,44
RZ Pellets W,3157,8,11,5,20,47,58,-11,38
Mattersburg,3157,9,9,9,18,34,58,-24,36
St. Pölten,3157,10,6,9,21,37,69,-32,27
FC Salzburg,3158,1,20,9,7,66,33,33,69
SK Sturm Gra,3158,2,20,6,10,64,36,28,66
Vienna,3158,3,20,5,11,58,46,12,65
SC Rheindorf,3158,4,18,9,9,54,43,11,63
Rapid Vienna,3158,5,16,9,11,74,44,30,57
RZ Pellets W,3158,6,12,8,16,44,55,-11,44
Admira Wacke,3158,7,13,4,19,39,60,-21,43
St. Pölten,3158,8,8,12,16,39,60,-21,36
Mattersburg,3158,9,6,11,19,34,61,-27,29
SV Josko Rie,3158,10,8,5,23,29,63,-34,29
FC Salzburg,3159,1,20,9,7,68,32,36,69
SK Sturm Gra,3159,2,20,5,11,63,35,28,65
SC Rheindorf,3159,3,19,8,9,57,45,12,65
Vienna,3159,4,19,6,11,69,52,17,63
Rapid Vienna,3159,5,14,11,11,56,43,13,53
SV Josko Rie,3159,6,11,7,18,44,55,-11,40
Mattersburg,3159,7,10,8,18,44,58,-14,38
St. Pölten,3159,8,10,8,18,46,77,-31,38
RZ Pellets W,3159,9,10,6,20,45,70,-25,36
Admira Wacke,3159,10,9,8,19,43,68,-25,35
FC Salzburg,3160,1,24,7,5,77,33,44,79
SK Sturm Gra,3160,2,22,5,9,62,33,29,71
SC Rheindorf,3160,3,21,4,11,54,40,14,67
Vienna,3160,4,19,5,12,66,55,11,62
Rapid Vienna,3160,5,14,11,11,57,43,14,53
RZ Pellets W,3160,6,11,6,19,44,55,-11,39
SV Josko Rie,3160,7,10,9,17,32,53,-21,39
St. Pölten,3160,8,9,8,19,42,67,-25,35
Admira Wacke,3160,9,9,5,22,31,62,-31,32
Mattersburg,3160,10,8,6,22,39,63,-24,30
FC Salzburg,3161,1,22,7,7,78,36,42,73
Vienna,3161,2,20,4,12,68,48,20,64
SK Sturm Gra,3161,3,19,5,12,60,39,21,62
SC Rheindorf,3161,4,15,12,9,48,43,5,57
Rapid Vienna,3161,5,15,10,11,59,42,17,55
RZ Pellets W,3161,6,13,7,16,46,53,-7,46
Admira Wacke,3161,7,12,7,17,36,59,-23,43
St. Pölten,3161,8,8,11,17,41,67,-26,35
Mattersburg,3161,9,7,12,17,36,60,-24,33
SV Josko Rie,3161,10,8,7,21,27,52,-25,31
SK Sturm Gra,3162,1,22,7,7,66,30,36,73
FC Salzburg,3162,2,20,9,7,59,30,29,69
SC Rheindorf,3162,3,19,8,9,51,45,6,65
Vienna,3162,4,17,3,16,53,50,3,54
RZ Pellets W,3162,5,13,9,14,44,47,-3,48
Admira Wacke,3162,6,12,9,15,40,52,-12,45
Rapid Vienna,3162,7,10,13,13,52,49,3,43
Mattersburg,3162,8,8,10,18,36,52,-16,34
St. Pölten,3162,9,8,10,18,42,66,-24,34
SV Josko Rie,3162,10,9,6,21,30,52,-22,33
FC Salzburg,3163,1,20,9,7,61,32,29,69
Vienna,3163,2,21,6,9,71,45,26,69
SK Sturm Gra,3163,3,17,9,10,64,38,26,60
SC Rheindorf,3163,4,17,8,11,49,47,2,59
Rapid Vienna,3163,5,13,11,12,52,47,5,50
RZ Pellets W,3163,6,11,8,17,49,61,-12,41
SV Josko Rie,3163,7,12,5,19,43,62,-19,41
Admira Wacke,3163,8,11,7,18,39,61,-22,40
Mattersburg,3163,9,10,9,17,45,55,-10,39
St. Pölten,3163,10,5,14,17,40,65,-25,29
SC Rheindorf,3164,1,23,6,7,63,44,19,75
FC Salzburg,3164,2,21,9,6,64,29,35,72
Vienna,3164,3,19,6,11,66,54,12,63
SK Sturm Gra,3164,4,17,7,12,57,36,21,58
Rapid Vienna,3164,5,12,13,11,49,37,12,49
RZ Pellets W,3164,6,13,7,16,50,59,-9,46
Admira Wacke,3164,7,13,5,18,36,58,-22,44
SV Josko Rie,3164,8,10,6,20,34,50,-16,36
Mattersburg,3164,9,9,5,22,38,60,-22,32
St. Pölten,3164,10,6,10,20,35,65,-30,28
SK Sturm Gra,3165,1,21,7,8,57,29,28,70
SC Rheindorf,3165,2,19,9,8,52,39,13,66
FC Salzburg,3165,3,19,7,10,65,32,33,64
Rapid Vienna,3165,4,17,10,9,62,38,24,61
Vienna,3165,5,16,8,12,58,52,6,56
RZ Pellets W,3165,6,11,6,19,45,61,-16,39
Admira Wacke,3165,7,11,5,20,35,63,-28,38
SV Josko Rie,3165,8,11,4,21,36,57,-21,37
St. Pölten,3165,9,9,10,17,39,61,-22,37
Mattersburg,3165,10,9,8,19,41,58,-17,35
FC Salzburg,3166,1,22,7,7,71,31,40,73
Vienna,3166,2,19,7,10,64,52,12,64
SC Rheindorf,3166,3,19,7,10,56,46,10,64
Rapid Vienna,3166,4,14,14,8,57,35,22,56
SK Sturm Gra,3166,5,15,8,13,52,43,9,53
RZ Pellets W,3166,6,13,7,16,43,48,-5,46
Admira Wacke,3166,7,12,7,17,41,59,-18,43
St. Pölten,3166,8,9,10,17,47,68,-21,37
Mattersburg,3166,9,9,9,18,39,59,-20,36
SV Josko Rie,3166,10,7,6,23,31,60,-29,27
SK Sturm Gra,3167,1,23,4,9,67,33,34,73
FC Salzburg,3167,2,22,6,8,64,32,32,72
SC Rheindorf,3167,3,19,9,8,58,46,12,66
Vienna,3167,4,17,5,14,65,57,8,56
Rapid Vienna,3167,5,12,11,13,49,37,12,47
RZ Pellets W,3167,6,14,5,17,44,53,-9,47
SV Josko Rie,3167,7,10,8,18,40,55,-15,38
St. Pölten,3167,8,10,8,18,46,67,-21,38
Admira Wacke,3167,9,10,6,20,39,65,-26,36
Mattersburg,3167,10,8,8,20,31,58,-27,32
SC Rheindorf,3168,1,22,6,8,66,52,14,72
FC Salzburg,3168,2,21,7,8,68,37,31,70
Vienna,3168,3,19,7,10,69,51,18,64
SK Sturm Gra,3168,4,16,8,12,57,41,16,56
Rapid Vienna,3168,5,15,10,11,59,40,19,55
RZ Pellets W,3168,6,16,5,15,58,50,8,53
Admira Wacke,3168,7,10,8,18,35,60,-25,38
St. Pölten,3168,8,7,11,18,39,65,-26,32
SV Josko Rie,3168,9,9,5,22,37,64,-27,32
Mattersburg,3168,10,7,9,20,40,68,-28,30
SK Sturm Gra,3169,1,24,3,9,66,31,35,75
FC Salzburg,3169,2,22,8,6,69,32,37,74
SC Rheindorf,3169,3,19,6,11,58,45,13,63
Vienna,3169,4,18,5,13,57,50,7,59
Admira Wacke,3169,5,15,4,17,44,56,-12,49
Rapid Vienna,3169,6,12,10,14,56,45,11,46
RZ Pellets W,3169,7,12,6,18,47,65,-18,42
St. Pölten,3169,8,9,12,15,45,58,-13,39
SV Josko Rie,3169,9,10,3,23,35,60,-25,33
Mattersburg,3169,10,6,9,21,34,69,-35,27
SC Rheindorf,3170,1,20,6,10,54,39,15,66
Vienna,3170,2,20,5,11,57,44,13,65
FC Salzburg,3170,3,19,6,11,60,34,26,63
Rapid Vienna,3170,4,16,7,13,54,40,14,55
SK Sturm Gra,3170,5,17,4,15,51,37,14,55
SV Josko Rie,3170,6,15,3,18,37,47,-10,48
St. Pölten,3170,7,11,10,15,44,56,-12,43
RZ Pellets W,3170,8,12,6,18,44,59,-15,42
Mattersburg,3170,9,10,7,19,34,54,-20,37
Admira Wacke,3170,10,10,6,20,34,59,-25,36
SK Sturm Gra,3171,1,22,7,7,57,25,32,73
FC Salzburg,3171,2,21,6,9,61,29,32,69
Vienna,3171,3,19,6,11,62,51,11,63
SC Rheindorf,3171,4,18,8,10,49,39,10,62
RZ Pellets W,3171,5,14,6,16,46,50,-4,48
Rapid Vienna,3171,6,12,11,13,47,41,6,47
Mattersburg,3171,7,11,8,17,39,49,-10,41
Admira Wacke,3171,8,10,6,20,34,59,-25,36
SV Josko Rie,3171,9,10,4,22,30,53,-23,34
St. Pölten,3171,10,8,8,20,35,64,-29,32
FC Salzburg,3172,1,22,8,6,66,28,38,74
SK Sturm Gra,3172,2,20,8,8,65,37,28,68
SC Rheindorf,3172,3,18,9,9,53,43,10,63
Vienna,3172,4,18,5,13,60,49,11,59
Rapid Vienna,3172,5,12,13,11,49,39,10,49
RZ Pellets W,3172,6,13,9,14,46,52,-6,48
SV Josko Rie,3172,7,10,6,20,38,55,-17,36
Admira Wacke,3172,8,9,9,18,38,59,-21,36
Mattersburg,3172,9,9,8,19,36,62,-26,35
St. Pölten,3172,10,7,9,20,37,64,-27,30
SC Rheindorf,3173,1,20,7,9,58,47,11,67
FC Salzburg,3173,2,19,8,9,58,31,27,65
SK Sturm Gra,3173,3,19,6,11,61,38,23,63
Vienna,3173,4,17,8,11,60,44,16,59
Rapid Vienna,3173,5,14,11,11,60,41,19,53
RZ Pellets W,3173,6,12,9,15,41,48,-7,45
Admira Wacke,3173,7,11,8,17,31,56,-25,41
SV Josko Rie,3173,8,11,6,19,38,57,-19,39
St. Pölten,3173,9,9,10,17,42,64,-22,37
Mattersburg,3173,10,7,9,20,39,62,-23,30
FC Salzburg,3174,1,23,7,6,65,28,37,76
SK Sturm Gra,3174,2,21,7,8,65,30,35,70
Vienna,3174,3,20,5,11,62,46,16,65
SC Rheindorf,3174,4,16,10,10,52,41,11,58
RZ Pellets W,3174,5,15,5,16,52,52,0,50
Rapid Vienna,3174,6,12,12,12,46,38,8,48
Admira Wacke,3174,7,13,7,16,42,62,-20,46
Mattersburg,3174,8,9,6,21,35,54,-19,33
SV Josko Rie,3174,9,10,3,23,32,59,-27,33
St. Pölten,3174,10,5,10,21,36,77,-41,25
SC Rheindorf,3175,1,22,6,8,58,41,17,72
FC Salzburg,3175,2,20,8,8,63,33,30,68
SK Sturm Gra,3175,3,21,4,11,55,35,20,67
Vienna,3175,4,17,6,13,60,54,6,57
Admira Wacke,3175,5,15,6,15,42,52,-10,51
Rapid Vienna,3175,6,12,12,12,50,43,7,48
RZ Pellets W,3175,7,12,7,17,46,58,-12,43
SV Josko Rie,3175,8,10,7,19,36,52,-16,37
St. Pölten,3175,9,8,10,18,43,59,-16,34
Mattersburg,3175,10,7,6,23,37,63,-26,27
FC Salzburg,3176,1,20,8,8,63,37,26,68
SK Sturm Gra,3176,2,20,6,10,60,37,23,66
Vienna,3176,3,20,5,11,66,48,18,65
SC Rheindorf,3176,4,18,8,10,58,47,11,62
Rapid Vienna,3176,5,11,14,11,59,52,7,47
Mattersburg,3176,6,12,8,16,40,45,-5,44
Admira Wacke,3176,7,12,7,17,40,57,-17,43
RZ Pellets W,3176,8,11,8,17,44,59,-15,41
SV Josko Rie,3176,9,12,2,22,38,56,-18,38
St. Pölten,3176,10,7,8,21,37,67,-30,29
SC Rheindorf,3177,1,22,5,9,58,40,18,71
FC Salzburg,3177,2,21,7,8,68,30,38,70
SK Sturm Gra,3177,3,20,6,10,63,34,29,66
Vienna,3177,4,16,8,12,63,55,8,56
Rapid Vienna,3177,5,13,7,16,50,54,-4,46
Admira Wacke,3177,6,12,10,14,45,56,-11,46
RZ Pellets W,3177,7,12,8,16,47,67,-20,44
St. Pölten,3177,8,10,9,17,40,56,-16,39
SV Josko Rie,3177,9,10,4,22,36,57,-21,34
Mattersburg,3177,10,8,8,20,32,53,-21,32
FC Salzburg,3178,1,22,7,7,63,26,37,73
Vienna,3178,2,19,5,12,61,51,10,62
SK Sturm Gra,3178,3,17,10,9,60,31,29,61
SC Rheindorf,3178,4,17,9,10,55,47,8,60
Rapid Vienna,3178,5,16,9,11,55,34,21,57
RZ Pellets W,3178,6,13,6,17,47,62,-15,45
Admira Wacke,3178,7,13,5,18,39,60,-21,44
SV Josko Rie,3178,8,12,5,19,39,55,-16,41
St. Pölten,3178,9,10,7,19,44,65,-21,37
Mattersburg,3178,10,6,7,23,29,61,-32,25
SK Sturm Gra,3179,1,23,5,8,68,29,39,74
SC Rheindorf,3179,2,20,7,9,57,42,15,67
Vienna,3179,3,18,6,12,63,54,9,60
FC Salzburg,3179,4,16,10,10,55,34,21,58
Rapid Vienna,3179,5,13,12,11,51,37,14,51
Admira Wacke,3179,6,14,6,16,36,50,-14,48
St. Pölten,3179,7,10,10,16,46,61,-15,40
SV Josko Rie,3179,8,10,7,19,37,59,-22,37
RZ Pellets W,3179,9,9,9,18,39,59,-20,36
Mattersburg,3179,10,6,10,20,35,62,-27,28
FC Salzburg,3180,1,22,4,10,69,38,31,70
SK Sturm Gra,3180,2,21,5,10,66,34,32,68
SC Rheindorf,3180,3,19,6,11,57,47,10,63
Vienna,3180,4,20,2,14,67,53,14,62
Rapid Vienna,3180,5,14,10,12,55,43,12,52
Mattersburg,3180,6,11,9,16,43,57,-14,42
RZ Pellets W,3180,7,11,7,18,43,56,-13,40
SV Josko Rie,3180,8,11,7,18,38,54,-16,40
Admira Wacke,3180,9,11,4,21,40,73,-33,37
St. Pölten,3180,10,8,10,18,40,63,-23,34
SK Sturm Gra,3181,1,22,5,9,70,30,40,71
FC Salzburg,3181,2,20,9,7,68,33,35,69
Vienna,3181,3,19,5,12,66,51,15,62
SC Rheindorf,3181,4,17,7,12,55,45,10,58
Rapid Vienna,3181,5,13,11,12,56,47,9,50
RZ Pellets W,3181,6,14,8,14,45,58,-13,50
Admira Wacke,3181,7,12,6,18,40,61,-21,42
SV Josko Rie,3181,8,9,8,19,31,57,-26,35
St. Pölten,3181,9,8,9,19,39,68,-29,33
Mattersburg,3181,10,6,12,18,32,52,-20,30
SK Sturm Gra,3182,1,19,7,10,65,44,21,64
SC Rheindorf,3182,2,19,7,10,54,43,11,64
FC Salzburg,3182,3,17,11,8,49,27,22,62
Vienna,3182,4,18,8,10,58,48,10,62
Rapid Vienna,3182,5,13,10,13,53,40,13,49
Admira Wacke,3182,6,11,9,16,38,55,-17,42
St. Pölten,3182,7,10,11,15,53,63,-10,41
RZ Pellets W,3182,8,10,8,18,46,59,-13,38
Mattersburg,3182,9,8,12,16,34,52,-18,36
SV Josko Rie,3182,10,9,9,18,27,46,-19,36
FC Salzburg,3183,1,20,8,8,65,32,33,68
SC Rheindorf,3183,2,19,8,9,53,44,9,65
SK Sturm Gra,3183,3,19,7,10,60,39,21,64
Vienna,3183,4,19,6,11,69,51,18,63
RZ Pellets W,3183,5,13,9,14,47,48,-1,48
Rapid Vienna,3183,6,12,9,15,49,49,0,45
Mattersburg,3183,7,10,13,13,37,45,-8,43
Admira Wacke,3183,8,11,8,17,42,62,-20,41
St. Pölten,3183,9,8,12,16,41,62,-21,36
SV Josko Rie,3183,10,6,6,24,28,59,-31,24
SK Sturm Gra,3184,1,21,6,9,56,28,28,69
FC Salzburg,3184,2,19,11,6,60,31,29,68
Vienna,3184,3,21,4,11,61,45,16,67
Rapid Vienna,3184,4,17,8,11,57,35,22,59
SC Rheindorf,3184,5,15,8,13,49,47,2,53
RZ Pellets W,3184,6,15,6,15,55,50,5,51
Mattersburg,3184,7,11,7,18,39,60,-21,40
Admira Wacke,3184,8,10,6,20,39,64,-25,36
SV Josko Rie,3184,9,9,5,22,30,60,-30,32
St. Pölten,3184,10,7,9,20,41,67,-26,30
SC Rheindorf,3185,1,21,9,6,66,42,24,72
FC Salzburg,3185,2,20,8,8,64,33,31,68
SK Sturm Gra,3185,3,20,6,10,63,42,21,66
Vienna,3185,4,19,6,11,61,46,15,63
Rapid Vienna,3185,5,16,8,12,58,44,14,56
Admira Wacke,3185,6,15,3,18,37,55,-18,48
RZ Pellets W,3185,7,9,9,18,38,55,-17,36
SV Josko Rie,3185,7,10,6,20,38,55,-17,36
Mattersburg,3185,9,7,10,19,34,57,-23,31
St. Pölten,3185,10,7,7,22,37,67,-30,28
FC Salzburg,3186,1,22,7,7,71,30,41,73
SK Sturm Gra,3186,2,21,4,11,62,35,27,67
SC Rheindorf,3186,3,19,6,11,57,43,14,63
Vienna,3186,4,18,5,13,62,60,2,59
RZ Pellets W,3186,5,17,5,14,46,50,-4,56
St. Pölten,3186,6,12,7,17,40,59,-19,43
Mattersburg,3186,7,12,6,18,45,50,-5,42
Rapid Vienna,3186,8,9,12,15,48,49,-1,39
Admira Wacke,3186,9,11,5,20,37,62,-25,38
SV Josko Rie,3186,10,9,3,24,29,59,-30,30
SC Rheindorf,3187,1,21,6,9,58,36,22,69
FC Salzburg,3187,2,20,8,8,66,32,34,68
SK Sturm Gra,3187,3,19,7,10,62,36,26,64
Vienna,3187,4,17,5,14,58,56,2,56
Rapid Vienna,3187,5,15,10,11,49,36,13,55
Admira Wacke,3187,6,15,5,16,43,55,-12,50
SV Josko Rie,3187,7,12,5,19,39,52,-13,41
Mattersburg,3187,8,11,6,19,42,61,-19,39
RZ Pellets W,3187,9,11,4,21,39,65,-26,37
St. Pölten,3187,10,7,8,21,41,68,-27,29
FC Salzburg,3188,1,19,9,8,64,32,32,66
SK Sturm Gra,3188,2,20,6,10,61,37,24,66
SC Rheindorf,3188,3,18,9,9,57,46,11,63
Vienna,3188,4,14,10,12,56,51,5,52
Rapid Vienna,3188,5,14,9,13,53,39,14,51
SV Josko Rie,3188,6,12,7,17,39,50,-11,43
RZ Pellets W,3188,7,12,7,17,50,65,-15,43
St. Pölten,3188,8,11,9,16,46,63,-17,42
Admira Wacke,3188,9,11,6,19,35,59,-24,39
Mattersburg,3188,10,8,10,18,37,56,-19,34
SC Rheindorf,3189,1,21,6,9,61,44,17,69
FC Salzburg,3189,2,19,11,6,61,26,35,68
Vienna,3189,3,18,7,11,60,49,11,61
SK Sturm Gra,3189,4,17,8,11,56,40,16,59
RZ Pellets W,3189,5,12,10,14,44,52,-8,46
Rapid Vienna,3189,6,11,12,13,47,39,8,45
Admira Wacke,3189,7,13,6,17,37,53,-16,45
SV Josko Rie,3189,8,12,4,20,39,53,-14,40
Mattersburg,3189,9,8,9,19,29,52,-23,33
St. Pölten,3189,10,7,11,18,40,66,-26,32
FC Salzburg,3190,1,21,7,8,62,32,30,70
SK Sturm Gra,3190,2,19,6,11,57,35,22,63
SC Rheindorf,3190,3,17,11,8,49,38,11,62
Vienna,3190,4,18,5,13,64,55,9,59
Rapid Vienna,3190,5,13,10,13,51,39,12,49
Admira Wacke,3190,6,13,8,15,40,53,-13,47
RZ Pellets W,3190,7,13,6,17,46,55,-9,45
SV Josko Rie,3190,8,12,7,17,33,47,-14,43
St. Pölten,3190,9,8,10,18,40,64,-24,34
Mattersburg,3190,10,8,6,22,29,53,-24,30
FC Salzburg,3191,1,21,10,5,74,30,44,73
Vienna,3191,2,21,5,10,66,43,23,68
SK Sturm Gra,3191,3,20,4,12,52,30,22,64
SC Rheindorf,3191,4,17,12,7,47,37,10,63
Rapid Vienna,3191,5,11,10,15,46,43,3,43
SV Josko Rie,3191,6,12,6,18,39,53,-14,42
RZ Pellets W,3191,7,11,8,17,37,56,-19,41
Mattersburg,3191,8,10,8,18,39,55,-16,38
Admira Wacke,3191,9,10,7,19,34,56,-22,37
St. Pölten,3191,10,8,8,20,35,66,-31,32
FC Salzburg,3192,1,20,8,8,62,34,28,68
Vienna,3192,2,20,7,9,65,47,18,67
SC Rheindorf,3192,3,19,8,9,54,43,11,65
SK Sturm Gra,3192,4,16,8,12,54,38,16,56
Rapid Vienna,3192,5,14,9,13,58,45,13,51
RZ Pellets W,3192,6,13,6,17,50,58,-8,45
SV Josko Rie,3192,7,12,6,18,35,47,-12,42
Admira Wacke,3192,8,12,4,20,37,62,-25,40
St. Pölten,3192,9,9,9,18,44,66,-22,36
Mattersburg,3192,10,7,11,18,43,62,-19,32
FC Salzburg,3193,1,25,6,5,71,28,43,81
SC Rheindorf,3193,2,20,7,9,54,40,14,67
SK Sturm Gra,3193,3,18,7,11,62,37,25,61
Vienna,3193,4,17,5,14,55,48,7,56
Rapid Vienna,3193,5,15,10,11,53,38,15,55
RZ Pellets W,3193,6,11,6,19,39,59,-20,39
SV Josko Rie,3193,7,11,6,19,32,53,-21,39
St. Pölten,3193,8,9,10,17,38,55,-17,37
Admira Wacke,3193,9,11,4,21,36,61,-25,37
Mattersburg,3193,10,9,7,20,35,56,-21,34
FC Salzburg,3194,1,22,5,9,71,35,36,71
Vienna,3194,2,20,6,10,61,43,18,66
SK Sturm Gra,3194,3,18,7,11,55,34,21,61
SC Rheindorf,3194,4,17,10,9,54,48,6,61
Rapid Vienna,3194,5,12,15,9,47,36,11,51
SV Josko Rie,3194,6,12,6,18,33,45,-12,42
RZ Pellets W,3194,7,10,9,17,42,55,-13,39
St. Pölten,3194,8,9,11,16,40,59,-19,38
Admira Wacke,3194,9,9,10,17,36,56,-20,37
Mattersburg,3194,10,7,9,20,34,62,-28,30
FC Salzburg,3195,1,20,7,9,69,35,34,67
SK Sturm Gra,3195,2,20,5,11,60,34,26,65
SC Rheindorf,3195,3,17,9,10,52,44,8,60
Rapid Vienna,3195,4,16,11,9,68,39,29,59
Vienna,3195,5,17,7,12,60,53,7,58
Admira Wacke,3195,6,14,7,15,42,52,-10,49
Mattersburg,3195,7,9,10,17,38,56,-18,37
SV Josko Rie,3195,8,10,7,19,35,59,-24,37
RZ Pellets W,3195,9,10,6,20,39,63,-24,36
St. Pölten,3195,10,8,9,19,36,64,-28,33
SC Rheindorf,3196,1,22,6,8,67,42,25,72
SK Sturm Gra,3196,2,20,5,11,61,36,25,65
Vienna,3196,3,19,6,11,69,50,19,63
FC Salzburg,3196,4,18,7,11,62,38,24,61
Rapid Vienna,3196,5,14,10,12,51,43,8,52
Admira Wacke,3196,6,13,6,17,40,58,-18,45
RZ Pellets W,3196,7,12,8,16,47,62,-15,44
Mattersburg,3196,8,9,9,18,35,56,-21,36
SV Josko Rie,3196,9,9,6,21,32,58,-26,33
St. Pölten,3196,10,7,11,18,39,60,-21,32
FC Salzburg,3197,1,22,9,5,70,28,42,75
SK Sturm Gra,3197,2,21,5,10,64,38,26,68
Vienna,3197,3,21,4,11,68,53,15,67
SC Rheindorf,3197,4,17,7,12,54,51,3,58
RZ Pellets W,3197,5,15,6,15,50,52,-2,51
Admira Wacke,3197,6,12,6,18,36,58,-22,42
Rapid Vienna,3197,7,10,10,16,53,47,6,40
St. Pölten,3197,8,10,8,18,39,61,-22,38
SV Josko Rie,3197,9,10,4,22,33,57,-24,34
Mattersburg,3197,10,8,9,19,41,63,-22,33
FC Salzburg,3198,1,23,5,8,70,33,37,74
Vienna,3198,2,21,6,9,64,47,17,69
SK Sturm Gra,3198,3,18,8,10,62,44,18,62
SC Rheindorf,3198,4,17,8,11,50,44,6,59
Rapid Vienna,3198,5,13,13,10,58,39,19,52
RZ Pellets W,3198,6,12,7,17,50,59,-9,43
SV Josko Rie,3198,7,12,7,17,39,52,-13,43
Admira Wacke,3198,8,11,5,20,44,66,-22,38
Mattersburg,3198,9,7,11,18,34,54,-20,32
St. Pölten,3198,10,5,12,19,39,72,-33,27
Vienna,3199,1,21,7,8,70,44,26,70
SC Rheindorf,3199,2,20,8,8,54,37,17,68
FC Salzburg,3199,3,18,9,9,64,37,27,63
SK Sturm Gra,3199,4,16,7,13,53,41,12,55
Rapid Vienna,3199,5,14,9,13,69,56,13,51
RZ Pellets W,3199,6,14,7,15,49,57,-8,49
St. Pölten,3199,7,10,11,15,43,56,-13,41
SV Josko Rie,3199,8,10,6,20,34,55,-21,36
Admira Wacke,3199,9,9,7,20,35,65,-30,34
Mattersburg,3199,10,7,11,18,37,60,-23,32
SC Rheindorf,3200,1,19,11,6,58,38,20,68
Vienna,3200,2,20,7,9,64,47,17,67
FC Salzburg,3200,3,19,9,8,57,26,31,66
SK Sturm Gra,3200,4,17,7,12,59,42,17,58
Rapid Vienna,3200,5,14,11,11,51,40,11,53
RZ Pellets W,3200,6,10,10,16,45,59,-14,40
SV Josko Rie,3200,7,12,3,21,35,53,-18,39
Admira Wacke,3200,8,10,7,19,34,60,-26,37
Mattersburg,3200,9,9,9,18,47,59,-12,36
St. Pölten,3200,10,8,10,18,40,66,-26,34
FC Salzburg,3201,1,21,8,7,59,24,35,71
SC Rheindorf,3201,2,20,9,7,54,29,25,69
SK Sturm Gra,3201,3,19,8,9,63,37,26,65
Vienna,3201,4,19,6,11,57,48,9,63
Rapid Vienna,3201,5,12,13,11,50,37,13,49
RZ Pellets W,3201,6,12,8,16,45,56,-11,44
Admira Wacke,3201,7,13,5,18,41,62,-21,44
St. Pölten,3201,8,8,10,18,39,63,-24,34
SV Josko Rie,3201,9,10,4,22,35,61,-26,34
Mattersburg,3201,10,6,9,21,30,56,-26,27
FC Salzburg,3202,1,22,6,8,74,35,39,72
SK Sturm Gra,3202,2,20,7,9,52,29,23,67
SC Rheindorf,3202,3,17,8,11,47,41,6,59
Vienna,3202,4,18,4,14,66,57,9,58
Rapid Vienna,3202,5,14,12,10,53,38,15,54
Admira Wacke,3202,6,14,7,15,44,56,-12,49
RZ Pellets W,3202,7,9,9,18,42,55,-13,36
Mattersburg,3202,8,9,9,18,39,57,-18,36
SV Josko Rie,3202,9,10,5,21,34,56,-22,35
St. Pölten,3202,10,8,11,17,41,68,-27,35
FC Salzburg,3203,1,22,9,5,72,28,44,75
Vienna,3203,2,20,5,11,64,52,12,65
SC Rheindorf,3203,3,18,10,8,53,42,11,64
SK Sturm Gra,3203,4,18,5,13,54,34,20,59
Rapid Vienna,3203,5,14,14,8,54,37,17,56
RZ Pellets W,3203,6,14,8,14,51,49,2,50
Admira Wacke,3203,7,11,9,16,38,57,-19,42
Mattersburg,3203,8,8,9,19,39,63,-24,33
SV Josko Rie,3203,9,7,7,22,27,56,-29,28
St. Pölten,3203,10,4,12,20,31,65,-34,24
FC Salzburg,3204,1,22,7,7,71,32,39,73
SK Sturm Gra,3204,2,22,5,9,61,31,30,71
SC Rheindorf,3204,3,19,7,10,55,46,9,64
Vienna,3204,4,17,8,11,68,56,12,59
Rapid Vienna,3204,5,15,8,13,50,38,12,53
RZ Pellets W,3204,6,11,9,16,40,55,-15,42
Admira Wacke,3204,7,11,8,17,38,57,-19,41
SV Josko Rie,3204,8,9,10,17,35,53,-18,37
St. Pölten,3204,9,9,8,19,45,63,-18,35
Mattersburg,3204,10,6,8,22,30,62,-32,26
FC Salzburg,3205,1,20,10,6,59,26,33,70
Vienna,3205,2,20,4,12,60,47,13,64
Rapid Vienna,3205,3,15,10,11,59,39,20,55
SK Sturm Gra,3205,4,15,9,12,48,36,12,54
SC Rheindorf,3205,5,15,9,12,54,52,2,54
RZ Pellets W,3205,6,14,5,17,49,53,-4,47
Mattersburg,3205,7,12,9,15,41,51,-10,45
SV Josko Rie,3205,8,12,5,19,43,56,-13,41
Admira Wacke,3205,9,9,11,16,33,56,-23,38
St. Pölten,3205,10,7,10,19,38,68,-30,31
FC Salzburg,3206,1,23,6,7,62,26,36,75
SK Sturm Gra,3206,2,22,5,9,66,31,35,71
SC Rheindorf,3206,3,18,8,10,57,40,17,62
Vienna,3206,4,17,5,14,53,49,4,56
Rapid Vienna,3206,5,14,10,12,53,39,14,52
RZ Pellets W,3206,6,12,8,16,45,57,-12,44
Mattersburg,3206,7,10,10,16,42,56,-14,40
SV Josko Rie,3206,8,11,5,20,31,52,-21,38
Admira Wacke,3206,9,11,5,20,40,64,-24,38
St. Pölten,3206,10,6,10,20,38,73,-35,28
Vienna,3207,1,23,5,8,67,41,26,74
FC Salzburg,3207,2,21,8,7,70,31,39,71
SC Rheindorf,3207,3,20,8,8,54,40,14,68
SK Sturm Gra,3207,4,18,8,10,61,40,21,62
Rapid Vienna,3207,5,13,11,12,54,41,13,50
RZ Pellets W,3207,6,12,7,17,51,64,-13,43
SV Josko Rie,3207,7,10,6,20,34,54,-20,36
Admira Wacke,3207,8,9,9,18,44,67,-23,36
St. Pölten,3207,9,6,12,18,34,63,-29,30
Mattersburg,3207,10,7,8,21,38,66,-28,29
FC Salzburg,3208,1,21,8,7,63,27,36,71
SC Rheindorf,3208,2,21,8,7,61,44,17,71
Vienna,3208,3,19,6,11,72,50,22,63
SK Sturm Gra,3208,4,17,8,11,59,41,18,59
Rapid Vienna,3208,5,13,13,10,58,43,15,52
RZ Pellets W,3208,6,11,9,16,48,55,-7,42
Admira Wacke,3208,7,11,7,18,40,66,-26,40
Mattersburg,3208,8,10,6,20,38,60,-22,36
St. Pölten,3208,9,8,10,18,41,71,-30,34
SV Josko Rie,3208,10,9,5,22,30,53,-23,32
FC Salzburg,3209,1,22,8,6,75,36,39,74
SK Sturm Gra,3209,2,20,6,10,60,37,23,66
SC Rheindorf,3209,3,19,7,10,67,46,21,64
Vienna,3209,4,16,6,14,58,64,-6,54
Rapid Vienna,3209,5,14,10,12,61,51,10,52
RZ Pellets W,3209,6,14,7,15,55,54,1,49
St. Pölten,3209,7,9,10,17,49,65,-16,37
Admira Wacke,3209,8,10,7,19,36,61,-25,37
SV Josko Rie,3209,9,10,6,20,34,60,-26,36
Mattersburg,3209,10,7,11,18,37,58,-21,32
FC Salzburg,3210,1,22,8,6,68,26,42,74
SC Rheindorf,3210,2,20,7,9,59,43,16,67
SK Sturm Gra,3210,3,17,9,10,62,42,20,60
Vienna,3210,4,16,9,11,55,47,8,57
Rapid Vienna,3210,5,15,9,12,56,45,11,54
Admira Wacke,3210,6,12,9,15,38,53,-15,45
RZ Pellets W,3210,7,10,10,16,47,58,-11,40
SV Josko Rie,3210,8,11,6,19,37,51,-14,39
St. Pölten,3210,9,6,13,17,42,66,-24,31
Mattersburg,3210,10,6,10,20,37,70,-33,28
FC Salzburg,3211,1,20,9,7,65,34,31,69
SK Sturm Gra,3211,2,21,5,10,65,38,27,68
SC Rheindorf,3211,3,20,7,9,59,46,13,67
Vienna,3211,4,19,7,10,75,53,22,64
RZ Pellets W,3211,5,13,8,15,54,58,-4,47
Rapid Vienna,3211,6,12,10,14,51,47,4,46
Admira Wacke,3211,7,10,8,18,37,58,-21,38
SV Josko Rie,3211,8,11,5,20,36,61,-25,38
Mattersburg,3211,9,8,8,20,37,60,-23,32
St. Pölten,3211,10,7,11,18,42,66,-24,32
SK Sturm Gra,3212,1,25,5,6,68,25,43,80
FC Salzburg,3212,2,21,7,8,62,27,35,70
Vienna,3212,3,19,7,10,61,49,12,64
SC Rheindorf,3212,4,19,7,10,52,45,7,64
Admira Wacke,3212,5,12,8,16,38,59,-21,44
RZ Pellets W,3212,6,12,6,18,37,54,-17,42
Rapid Vienna,3212,7,10,10,16,48,47,1,40
St. Pölten,3212,8,11,7,18,43,55,-12,40
SV Josko Rie,3212,9,9,6,21,36,54,-18,33
Mattersburg,3212,10,6,9,21,39,69,-30,27
FC Salzburg,3213,1,19,9,8,62,28,34,66
SK Sturm Gra,3213,2,19,6,11,65,37,28,63
SC Rheindorf,3213,3,18,7,11,51,44,7,61
Vienna,3213,4,18,6,12,60,49,11,60
RZ Pellets W,3213,5,14,10,12,47,46,1,52
Rapid Vienna,3213,6,13,11,12,54,46,8,50
Admira Wacke,3213,7,11,7,18,36,64,-28,40
St. Pölten,3213,8,10,8,18,38,60,-22,38
Mattersburg,3213,9,7,14,15,41,54,-13,35
SV Josko Rie,3213,10,8,8,20,28,54,-26,32
SC Rheindorf,3214,1,22,8,6,58,35,23,74
Vienna,3214,2,22,2,12,64,50,14,68
SK Sturm Gra,3214,3,17,10,9,53,30,23,61
FC Salzburg,3214,4,17,7,12,54,33,21,58
Rapid Vienna,3214,5,12,9,15,49,43,6,45
RZ Pellets W,3214,6,11,9,16,42,50,-8,42
SV Josko Rie,3214,7,12,6,18,36,51,-15,42
Mattersburg,3214,8,10,8,18,44,59,-15,38
Admira Wacke,3214,9,10,8,18,33,56,-23,38
St. Pölten,3214,10,9,9,18,39,65,-26,36
FC Salzburg,3215,1,22,5,9,64,32,32,71
SK Sturm Gra,3215,2,19,6,11,55,37,18,63
Vienna,3215,3,19,3,14,63,53,10,60
SC Rheindorf,3215,4,17,8,11,50,41,9,59
Rapid Vienna,3215,5,15,10,11,51,37,14,55
RZ Pellets W,3215,6,14,5,17,47,55,-8,47
Admira Wacke,3215,7,13,6,17,40,51,-11,45
Mattersburg,3215,8,11,7,18,39,54,-15,40
SV Josko Rie,3215,9,10,8,18,30,49,-19,38
St. Pölten,3215,10,6,10,20,39,69,-30,28
FC Salzburg,3216,1,22,6,8,73,34,39,72
SK Sturm Gra,3216,2,21,7,8,58,27,31,70
SC Rheindorf,3216,3,20,8,8,59,44,15,68
Vienna,3216,4,18,4,14,60,60,0,58
RZ Pellets W,3216,5,16,6,14,52,52,0,54
Rapid Vienna,3216,6,14,9,13,58,39,19,51
Admira Wacke,3216,7,12,5,19,40,61,-21,41
SV Josko Rie,3216,8,10,2,24,37,60,-23,32
St. Pölten,3216,9,8,8,20,36,68,-32,32
Mattersburg,3216,10,8,7,21,40,68,-28,31
SC Rheindorf,3217,1,20,9,7,56,39,17,69
FC Salzburg,3217,2,19,10,7,63,30,33,67
Vienna,3217,3,20,5,11,62,47,15,65
SK Sturm Gra,3217,4,17,7,12,54,38,16,58
Rapid Vienna,3217,5,14,12,10,61,41,20,54
Mattersburg,3217,6,11,10,15,43,54,-11,43
RZ Pellets W,3217,7,12,6,18,49,59,-10,42
Admira Wacke,3217,8,11,8,17,32,58,-26,41
St. Pölten,3217,9,9,6,21,45,70,-25,33
SV Josko Rie,3217,10,8,5,23,26,55,-29,29
FC Salzburg,3218,1,22,6,8,66,33,33,72
SC Rheindorf,3218,2,18,10,8,55,39,16,64
SK Sturm Gra,3218,3,19,5,12,64,42,22,62
Rapid Vienna,3218,4,16,11,9,59,40,19,59
Vienna,3218,5,18,5,13,63,49,14,59
RZ Pellets W,3218,6,12,8,16,45,57,-12,44
SV Josko Rie,3218,7,13,5,18,38,52,-14,44
St. Pölten,3218,8,12,7,17,43,56,-13,43
Admira Wacke,3218,9,10,4,22,30,61,-31,34
Mattersburg,3218,10,6,7,23,34,68,-34,25
SK Sturm Gra,3219,1,22,6,8,65,32,33,72
Vienna,3219,2,20,6,10,61,45,16,66
SC Rheindorf,3219,3,18,11,7,54,40,14,65
FC Salzburg,3219,4,19,7,10,59,33,26,64
Rapid Vienna,3219,5,14,10,12,51,40,11,52
RZ Pellets W,3219,6,12,11,13,49,48,1,47
Admira Wacke,3219,7,9,9,18,32,59,-27,36
SV Josko Rie,3219,8,9,7,20,28,55,-27,34
St. Pölten,3219,9,7,12,17,41,57,-16,33
Mattersburg,3219,10,6,9,21,31,62,-31,27
SK Sturm Gra,3220,1,22,5,9,68,29,39,71
SC Rheindorf,3220,2,20,7,9,55,40,15,67
FC Salzburg,3220,3,19,8,9,65,33,32,65
Vienna,3220,4,21,2,13,65,54,11,65
Rapid Vienna,3220,5,16,9,11,58,40,18,57
RZ Pellets W,3220,6,12,4,20,47,63,-16,40
SV Josko Rie,3220,7,11,7,18,39,55,-16,40
Admira Wacke,3220,8,10,7,19,34,66,-32,37
St. Pölten,3220,9,8,12,16,43,63,-20,36
Mattersburg,3220,10,7,7,22,36,67,-31,28
FC Salzburg,3221,1,23,8,5,75,34,41,77
SK Sturm Gra,3221,2,19,5,12,57,36,21,62
Vienna,3221,3,19,5,12,58,49,9,62
SC Rheindorf,3221,4,18,7,11,51,41,10,61
Rapid Vienna,3221,5,12,10,14,52,46,6,46
RZ Pellets W,3221,6,12,8,16,44,55,-11,44
Admira Wacke,3221,7,11,9,16,38,54,-16,42
SV Josko Rie,3221,8,12,5,19,37,52,-15,41
St. Pölten,3221,9,9,9,18,44,63,-19,36
Mattersburg,3221,10,7,10,19,31,57,-26,31
SC Rheindorf,3222,1,23,6,7,58,36,22,75
FC Salzburg,3222,2,21,6,9,67,35,32,69
SK Sturm Gra,3222,3,19,6,11,55,28,27,63
Vienna,3222,4,18,5,13,63,52,11,59
Rapid Vienna,3222,5,15,11,10,58,42,16,56
Admira Wacke,3222,6,13,6,17,35,57,-22,45
RZ Pellets W,3222,7,12,7,17,42,54,-12,43
St. Pölten,3222,8,9,7,20,39,62,-23,34
Mattersburg,3222,9,8,9,19,33,52,-19,33
SV Josko Rie,3222,10,8,5,23,29,61,-32,29
SC Rheindorf,3223,1,21,7,8,64,43,21,70
FC Salzburg,3223,2,21,6,9,70,35,35,69
SK Sturm Gra,3223,3,21,5,10,62,34,28,68
Rapid Vienna,3223,4,15,8,13,60,44,16,53
Vienna,3223,5,15,6,15,61,70,-9,51
RZ Pellets W,3223,6,14,8,14,49,55,-6,50
SV Josko Rie,3223,7,12,6,18,45,61,-16,42
Mattersburg,3223,8,9,8,19,42,62,-20,35
St. Pölten,3223,9,8,10,18,44,65,-21,34
Admira Wacke,3223,10,9,6,21,36,64,-28,33
Vienna,3224,1,21,6,9,71,49,22,69
FC Salzburg,3224,2,20,8,8,67,34,33,68
SK Sturm Gra,3224,3,19,8,9,67,38,29,65
SC Rheindorf,3224,4,18,8,10,57,48,9,62
Rapid Vienna,3224,5,16,8,12,59,42,17,56
St. Pölten,3224,6,11,9,16,42,57,-15,42
RZ Pellets W,3224,7,10,8,18,42,64,-22,38
SV Josko Rie,3224,8,11,5,20,38,62,-24,38
Mattersburg,3224,9,8,9,19,36,53,-17,33
Admira Wacke,3224,10,8,7,21,31,63,-32,31
FC Salzburg,3225,1,20,9,7,75,31,44,69
SK Sturm Gra,3225,2,21,5,10,58,37,21,68
SC Rheindorf,3225,3,20,7,9,58,45,13,67
Vienna,3225,4,20,5,11,72,46,26,65
Rapid Vienna,3225,5,15,8,13,56,41,15,53
RZ Pellets W,3225,6,11,7,18,41,60,-19,40
SV Josko Rie,3225,7,12,4,20,33,55,-22,40
Admira Wacke,3225,8,10,8,18,36,60,-24,38
St. Pölten,3225,9,9,9,18,41,66,-25,36
Mattersburg,3225,10,7,8,21,31,60,-29,29
FC Salzburg,3226,1,23,8,5,78,32,46,77
SC Rheindorf,3226,2,21,7,8,60,41,19,70
Vienna,3226,3,20,6,10,65,49,16,66
SK Sturm Gra,3226,4,17,6,13,56,43,13,57
Rapid Vienna,3226,5,14,9,13,59,43,16,51
Admira Wacke,3226,6,13,4,19,35,66,-31,43
RZ Pellets W,3226,7,10,11,15,50,58,-8,41
SV Josko Rie,3226,8,12,2,22,34,57,-23,38
St. Pölten,3226,9,7,10,19,49,72,-23,31
Mattersburg,3226,10,7,9,20,38,63,-25,30
SC Rheindorf,3227,1,21,8,7,59,42,17,71
FC Salzburg,3227,2,20,8,8,62,35,27,68
Rapid Vienna,3227,3,17,10,9,62,35,27,61
Vienna,3227,4,19,3,14,62,50,12,60
SK Sturm Gra,3227,5,17,5,14,59,41,18,56
Admira Wacke,3227,6,13,10,13,38,48,-10,49
RZ Pellets W,3227,7,10,9,17,45,59,-14,39
SV Josko Rie,3227,8,10,6,20,33,59,-26,36
St. Pölten,3227,9,8,9,19,40,66,-26,33
Mattersburg,3227,10,7,8,21,35,60,-25,29
SC Rheindorf,3228,1,22,7,7,62,41,21,73
SK Sturm Gra,3228,2,19,8,9,65,37,28,65
FC Salzburg,3228,3,15,11,10,61,36,25,56
Rapid Vienna,3228,4,14,13,9,54,39,15,55
Vienna,3228,5,15,8,13,59,59,0,53
RZ Pellets W,3228,6,13,9,14,49,53,-4,48
St. Pölten,3228,7,12,9,15,46,57,-11,45
Admira Wacke,3228,8,11,7,18,39,60,-21,40
Mattersburg,3228,9,9,7,20,38,59,-21,34
SV Josko Rie,3228,10,6,9,21,24,56,-32,27
SC Rheindorf,3229,1,22,7,7,63,37,26,73
SK Sturm Gra,3229,2,20,5,11,58,38,20,65
FC Salzburg,3229,3,18,8,10,60,37,23,62
RZ Pellets W,3229,4,15,10,11,45,44,1,55
Admira Wacke,3229,5,16,6,14,46,51,-5,54
Vienna,3229,6,16,5,15,56,52,4,53
Rapid Vienna,3229,7,12,13,11,49,41,8,49
SV Josko Rie,3229,8,11,4,21,36,54,-18,37
St. Pölten,3229,9,6,10,20,36,66,-30,28
Mattersburg,3229,10,7,6,23,33,62,-29,27
FC Salzburg,3230,1,20,9,7,66,33,33,69
SC Rheindorf,3230,2,19,8,9,59,41,18,65
Vienna,3230,3,19,7,10,67,52,15,64
SK Sturm Gra,3230,4,19,5,12,54,35,19,62
Rapid Vienna,3230,5,10,16,10,49,41,8,46
St. Pölten,3230,6,11,10,15,37,54,-17,43
Admira Wacke,3230,7,11,7,18,45,63,-18,40
SV Josko Rie,3230,8,11,5,20,36,55,-19,38
RZ Pellets W,3230,9,8,11,17,43,61,-18,35
Mattersburg,3230,10,9,8,19,36,57,-21,35
FC Salzburg,3231,1,21,6,9,65,31,34,69
SC Rheindorf,3231,2,18,11,7,54,41,13,65
Rapid Vienna,3231,3,17,11,8,67,35,32,62
SK Sturm Gra,3231,4,18,6,12,60,41,19,60
Admira Wacke,3231,5,15,5,16,45,51,-6,50
RZ Pellets W,3231,6,13,7,16,43,55,-12,46
SV Josko Rie,3231,7,13,5,18,42,51,-9,44
Vienna,3231,8,13,5,18,48,63,-15,44
Mattersburg,3231,9,11,7,18,42,57,-15,40
St. Pölten,3231,10,5,9,22,34,75,-41,24
FC Salzburg,3232,1,19,7,10,62,34,28,64
Vienna,3232,2,20,4,12,65,51,14,64
SC Rheindorf,3232,3,18,10,8,56,48,8,64
Rapid Vienna,3232,4,17,9,10,62,40,22,60
SK Sturm Gra,3232,5,17,7,12,57,38,19,58
Admira Wacke,3232,6,14,7,15,40,52,-12,49
RZ Pellets W,3232,7,12,7,17,41,55,-14,43
SV Josko Rie,3232,8,11,8,17,35,52,-17,41
St. Pölten,3232,9,8,10,18,38,60,-22,34
Mattersburg,3232,10,6,7,23,39,65,-26,25
FC Salzburg,3233,1,23,5,8,68,31,37,74
SK Sturm Gra,3233,2,19,7,10,64,36,28,64
Vienna,3233,3,19,7,10,62,41,21,64
SC Rheindorf,3233,4,18,8,10,52,44,8,62
Rapid Vienna,3233,5,15,10,11,59,42,17,55
Admira Wacke,3233,6,14,8,14,39,54,-15,50
RZ Pellets W,3233,7,13,9,14,40,49,-9,48
Mattersburg,3233,8,8,7,21,37,58,-21,31
St. Pölten,3233,9,7,9,20,37,68,-31,30
SV Josko Rie,3233,10,7,4,25,30,65,-35,25
FC Salzburg,3234,1,20,6,10,61,32,29,66
Vienna,3234,2,19,6,11,69,56,13,63
SC Rheindorf,3234,3,18,8,10,50,40,10,62
SK Sturm Gra,3234,4,16,10,10,55,37,18,58
Rapid Vienna,3234,5,15,10,11,56,42,14,55
Admira Wacke,3234,6,14,6,16,40,52,-12,48
RZ Pellets W,3234,7,11,8,17,46,58,-12,41
SV Josko Rie,3234,8,12,4,20,41,56,-15,40
St. Pölten,3234,9,9,10,17,38,56,-18,37
Mattersburg,3234,10,7,10,19,40,67,-27,31
SC Rheindorf,3235,1,21,8,7,53,33,20,71
FC Salzburg,3235,2,21,7,8,69,35,34,70
SK Sturm Gra,3235,3,16,8,12,53,41,12,56
Vienna,3235,4,16,8,12,61,56,5,56
RZ Pellets W,3235,5,14,7,15,51,57,-6,49
Rapid Vienna,3235,6,12,11,13,60,44,16,47
St. Pölten,3235,7,10,10,16,41,56,-15,40
SV Josko Rie,3235,8,12,3,21,35,59,-24,39
Admira Wacke,3235,9,10,8,18,32,59,-27,38
Mattersburg,3235,10,9,8,19,38,53,-15,35
FC Salzburg,3236,1,21,8,7,64,30,34,71
SC Rheindorf,3236,2,21,8,7,59,36,23,71
SK Sturm Gra,3236,3,19,6,11,60,41,19,63
Vienna,3236,4,19,3,14,64,54,10,60
Rapid Vienna,3236,5,16,11,9,57,36,21,59
St. Pölten,3236,6,10,11,15,45,63,-18,41
RZ Pellets W,3236,7,10,6,20,39,57,-18,36
Admira Wacke,3236,8,10,5,21,36,64,-28,35
SV Josko Rie,3236,9,9,7,20,34,55,-21,34
Mattersburg,3236,10,8,9,19,32,54,-22,33
FC Salzburg,3237,1,21,8,7,63,28,35,71
SC Rheindorf,3237,2,20,9,7,60,37,23,69
Vienna,3237,3,20,5,11,71,52,19,65
SK Sturm Gra,3237,4,19,5,12,58,36,22,62
Rapid Vienna,3237,5,15,12,9,60,39,21,57
Admira Wacke,3237,6,12,5,19,39,60,-21,41
RZ Pellets W,3237,7,10,10,16,44,63,-19,40
St. Pölten,3237,8,8,10,18,40,60,-20,34
SV Josko Rie,3237,9,9,7,20,33,59,-26,34
Mattersburg,3237,10,6,9,21,33,67,-34,27
SK Sturm Gra,3238,1,21,6,9,62,32,30,69
FC Salzburg,3238,2,20,8,8,63,29,34,68
Vienna,3238,3,17,9,10,70,51,19,60
SC Rheindorf,3238,4,15,11,10,48,42,6,56
Rapid Vienna,3238,5,14,12,10,54,37,17,54
RZ Pellets W,3238,6,14,5,17,52,63,-11,47
SV Josko Rie,3238,7,10,7,19,31,52,-21,37
St. Pölten,3238,8,9,10,17,46,72,-26,37
Admira Wacke,3238,9,9,9,18,37,63,-26,36
Mattersburg,3238,10,7,11,18,36,58,-22,32
FC Salzburg,3239,1,26,5,5,68,25,43,83
SC Rheindorf,3239,2,19,7,10,53,38,15,64
SK Sturm Gra,3239,3,19,6,11,66,34,32,63
Rapid Vienna,3239,4,14,10,12,52,38,14,52
Vienna,3239,5,16,4,16,60,65,-5,52
SV Josko Rie,3239,6,13,4,19,46,59,-13,43
RZ Pellets W,3239,7,11,7,18,43,60,-17,40
Admira Wacke,3239,8,12,4,20,38,64,-26,40
Mattersburg,3239,9,10,6,20,40,59,-19,36
St. Pölten,3239,10,9,9,18,39,63,-24,36
SC Rheindorf,3240,1,23,6,7,59,34,25,75
FC Salzburg,3240,2,21,8,7,64,27,37,71
Vienna,3240,3,18,5,13,58,54,4,59
SK Sturm Gra,3240,4,17,7,12,56,36,20,58
Rapid Vienna,3240,5,13,12,11,54,39,15,51
RZ Pellets W,3240,6,12,9,15,44,49,-5,45
Admira Wacke,3240,7,11,8,17,43,69,-26,41
Mattersburg,3240,8,8,10,18,35,51,-16,34
SV Josko Rie,3240,9,10,4,22,30,62,-32,34
St. Pölten,3240,10,7,11,18,39,61,-22,32
FC Salzburg,3241,1,22,8,6,71,29,42,74
SC Rheindorf,3241,2,20,8,8,56,37,19,68
SK Sturm Gra,3241,3,18,7,11,58,38,20,61
Rapid Vienna,3241,4,16,9,11,57,39,18,57
Vienna,3241,5,15,8,13,63,56,7,53
RZ Pellets W,3241,6,13,8,15,46,50,-4,47
Mattersburg,3241,7,11,8,17,41,59,-18,41
Admira Wacke,3241,8,11,6,19,33,59,-26,39
SV Josko Rie,3241,9,10,6,20,32,55,-23,36
St. Pölten,3241,10,5,10,21,34,69,-35,25
SK Sturm Gra,3242,1,24,5,7,72,27,45,77
FC Salzburg,3242,2,22,6,8,68,34,34,72
Vienna,3242,3,18,3,15,60,63,-3,57
SC Rheindorf,3242,4,16,6,14,54,51,3,54
Rapid Vienna,3242,5,12,11,13,51,41,10,47
Admira Wacke,3242,6,13,8,15,37,54,-17,47
RZ Pellets W,3242,7,11,10,15,47,57,-10,43
Mattersburg,3242,8,11,9,16,48,59,-11,42
St. Pölten,3242,9,8,11,17,46,72,-26,35
SV Josko Rie,3242,10,9,3,24,33,58,-25,30
FC Salzburg,3243,1,21,9,6,70,29,41,72
SK Sturm Gra,3243,2,20,5,11,64,38,26,65
SC Rheindorf,3243,3,18,8,10,53,48,5,62
Vienna,3243,4,19,3,14,59,50,9,60
Rapid Vienna,3243,5,15,11,10,66,45,21,56
Admira Wacke,3243,6,14,5,17,40,63,-23,47
RZ Pellets W,3243,7,11,9,16,41,53,-12,42
SV Josko Rie,3243,8,11,4,21,32,51,-19,37
Mattersburg,3243,9,9,8,19,41,58,-17,35
St. Pölten,3243,10,7,8,21,35,66,-31,29
FC Salzburg,3244,1,20,9,7,65,30,35,69
SK Sturm Gra,3244,2,21,5,10,64,35,29,68
SC Rheindorf,3244,3,20,7,9,58,44,14,67
Vienna,3244,4,19,4,13,62,51,11,61
Rapid Vienna,3244,5,15,10,11,66,44,22,55
RZ Pellets W,3244,6,13,6,17,48,53,-5,45
Admira Wacke,3244,7,12,5,19,35,57,-22,41
Mattersburg,3244,8,9,8,19,37,62,-25,35
St. Pölten,3244,9,8,9,19,43,67,-24,33
SV Josko Rie,3244,10,7,9,20,31,66,-35,30
SC Rheindorf,3245,1,19,10,7,49,37,12,67
Vienna,3245,2,19,6,11,62,45,17,63
SK Sturm Gra,3245,3,18,8,10,56,32,24,62
FC Salzburg,3245,4,17,10,9,63,37,26,61
Rapid Vienna,3245,5,15,12,9,55,38,17,57
RZ Pellets W,3245,6,14,8,14,45,55,-10,50
Admira Wacke,3245,7,13,5,18,38,53,-15,44
SV Josko Rie,3245,8,11,6,19,36,56,-20,39
St. Pölten,3245,9,8,9,19,39,58,-19,33
Mattersburg,3245,10,6,6,24,33,65,-32,24
FC Salzburg,3246,1,23,6,7,78,40,38,75
SK Sturm Gra,3246,2,20,7,9,66,37,29,67
Vienna,3246,3,20,3,13,68,58,10,63
SC Rheindorf,3246,4,18,8,10,66,50,16,62
Rapid Vienna,3246,5,15,10,11,61,41,20,55
RZ Pellets W,3246,6,13,7,16,46,52,-6,46
Admira Wacke,3246,7,10,8,18,41,59,-18,38
Mattersburg,3246,8,9,9,18,44,62,-18,36
SV Josko Rie,3246,9,10,5,21,35,64,-29,35
St. Pölten,3246,10,7,7,22,37,79,-42,28
SC Rheindorf,3247,1,22,6,8,60,42,18,72
SK Sturm Gra,3247,2,20,5,11,61,35,26,65
FC Salzburg,3247,3,18,10,8,64,34,30,64
Vienna,3247,4,18,6,12,67,52,15,60
Rapid Vienna,3247,5,15,9,12,54,39,15,54
RZ Pellets W,3247,6,12,7,17,42,52,-10,43
Admira Wacke,3247,7,12,7,17,39,59,-20,43
SV Josko Rie,3247,8,11,7,18,37,58,-21,40
Mattersburg,3247,9,8,9,19,40,59,-19,33
St. Pölten,3247,10,7,8,21,43,77,-34,29
FC Salzburg,3248,1,21,9,6,74,34,40,72
SC Rheindorf,3248,2,20,8,8,59,49,10,68
SK Sturm Gra,3248,3,18,7,11,59,38,21,61
Rapid Vienna,3248,4,15,10,11,60,43,17,55
Vienna,3248,5,16,5,15,61,58,3,53
RZ Pellets W,3248,6,14,9,13,49,46,3,51
Admira Wacke,3248,7,12,8,16,37,55,-18,44
SV Josko Rie,3248,8,11,8,17,36,54,-18,41
Mattersburg,3248,9,7,10,19,34,56,-22,31
St. Pölten,3248,10,4,10,22,35,71,-36,22
SC Rheindorf,3249,1,23,6,7,57,35,22,75
SK Sturm Gra,3249,2,21,4,11,64,36,28,67
Vienna,3249,3,20,6,10,75,52,23,66
FC Salzburg,3249,4,17,9,10,63,37,26,60
Rapid Vienna,3249,5,16,11,9,58,40,18,59
RZ Pellets W,3249,6,10,8,18,46,58,-12,38
St. Pölten,3249,7,10,7,19,39,61,-22,37
Admira Wacke,3249,8,9,8,19,34,61,-27,35
SV Josko Rie,3249,9,10,5,21,32,63,-31,35
Mattersburg,3249,10,9,6,21,38,63,-25,33
FC Salzburg,3250,1,22,6,8,68,28,40,72
SC Rheindorf,3250,2,19,8,9,57,43,14,65
SK Sturm Gra,3250,3,18,8,10,65,36,29,62
Vienna,3250,4,18,5,13,61,53,8,59
RZ Pellets W,3250,5,15,7,14,44,47,-3,52
Rapid Vienna,3250,6,14,8,14,54,45,9,50
St. Pölten,3250,7,12,10,14,52,59,-7,46
SV Josko Rie,3250,8,11,4,21,31,55,-24,37
Admira Wacke,3250,9,10,5,21,36,67,-31,35
Mattersburg,3250,10,8,5,23,30,65,-35,29
FC Salzburg,3251,1,23,8,5,73,27,46,77
Vienna,3251,2,20,6,10,65,50,15,66
SC Rheindorf,3251,3,20,5,11,54,41,13,65
SK Sturm Gra,3251,4,19,6,11,65,41,24,63
RZ Pellets W,3251,5,13,8,15,54,54,0,47
Rapid Vienna,3251,6,11,11,14,47,45,2,44
Admira Wacke,3251,7,12,7,17,39,59,-20,43
St. Pölten,3251,8,11,8,17,41,63,-22,41
Mattersburg,3251,9,7,9,20,31,58,-27,30
SV Josko Rie,3251,10,8,4,24,27,58,-31,28
SC Rheindorf,3252,1,21,8,7,58,36,22,71
FC Salzburg,3252,2,21,6,9,65,28,37,69
Vienna,3252,3,20,6,10,63,45,18,66
SK Sturm Gra,3252,4,19,7,10,57,30,27,64
Rapid Vienna,3252,5,15,9,12,51,38,13,54
RZ Pellets W,3252,6,11,8,17,40,59,-19,41
St. Pölten,3252,7,9,12,15,43,63,-20,39
Admira Wacke,3252,8,11,6,19,36,61,-25,39
Mattersburg,3252,9,7,9,20,29,54,-25,30
SV Josko Rie,3252,10,7,7,22,29,57,-28,28
FC Salzburg,3253,1,23,7,6,70,28,42,76
SK Sturm Gra,3253,2,19,7,10,60,38,22,64
Vienna,3253,3,20,3,13,73,54,19,63
SC Rheindorf,3253,4,18,7,11,52,45,7,61
Rapid Vienna,3253,5,13,13,10,54,39,15,52
SV Josko Rie,3253,6,13,3,20,35,54,-19,42
Admira Wacke,3253,7,11,8,17,36,57,-21,41
RZ Pellets W,3253,8,10,10,16,43,51,-8,40
St. Pölten,3253,9,8,9,19,37,72,-35,33
Mattersburg,3253,10,7,9,20,34,56,-22,30
Vienna,3254,1,21,6,9,71,48,23,69
SK Sturm Gra,3254,2,19,7,10,56,32,24,64
SC Rheindorf,3254,3,17,12,7,50,41,9,63
FC Salzburg,3254,4,17,8,11,60,38,22,59
Admira Wacke,3254,5,14,6,16,41,54,-13,48
Mattersburg,3254,6,13,8,15,40,47,-7,47
Rapid Vienna,3254,7,11,13,12,52,44,8,46
RZ Pellets W,3254,8,11,8,17,46,59,-13,41
SV Josko Rie,3254,9,9,5,22,29,57,-28,32
St. Pölten,3254,10,6,11,19,39,64,-25,29
SK Sturm Gra,3255,1,23,5,8,57,23,34,74
FC Salzburg,3255,2,22,5,9,64,31,33,71
SC Rheindorf,3255,3,18,8,10,54,46,8,62
Vienna,3255,4,16,8,12,61,54,7,56
Rapid Vienna,3255,5,13,12,11,54,34,20,51
Admira Wacke,3255,6,12,8,16,37,55,-18,44
RZ Pellets W,3255,7,10,10,16,41,54,-13,40
St. Pölten,3255,8,9,10,17,38,60,-22,37
SV Josko Rie,3255,9,10,6,20,36,55,-19,36
Mattersburg,3255,10,8,6,22,28,58,-30,30
SC Rheindorf,3256,1,23,4,9,62,44,18,73
FC Salzburg,3256,2,21,8,7,64,27,37,71
SK Sturm Gra,3256,3,18,5,13,61,40,21,59
Vienna,3256,4,17,8,11,56,47,9,59
Rapid Vienna,3256,5,15,10,11,57,36,21,55
St. Pölten,3256,6,13,7,16,45,60,-15,46
SV Josko Rie,3256,7,12,6,18,34,48,-14,42
RZ Pellets W,3256,8,11,6,19,45,61,-16,39
Admira Wacke,3256,9,9,6,21,38,66,-28,33
Mattersburg,3256,10,8,6,22,31,64,-33,30
FC Salzburg,3257,1,21,9,6,60,28,32,72
SK Sturm Gra,3257,2,20,6,10,63,32,31,66
SC Rheindorf,3257,3,20,6,10,54,45,9,66
Vienna,3257,4,17,7,12,55,47,8,58
Rapid Vienna,3257,5,13,13,10,56,40,16,52
Admira Wacke,3257,6,12,8,16,36,50,-14,44
RZ Pellets W,3257,7,11,9,16,42,62,-20,42
SV Josko Rie,3257,8,10,7,19,30,49,-19,37
Mattersburg,3257,9,10,6,20,36,52,-16,36
St. Pölten,3257,10,5,11,20,38,65,-27,26
FC Salzburg,3258,1,22,7,7,73,33,40,73
SC Rheindorf,3258,2,19,8,9,57,44,13,65
SK Sturm Gra,3258,3,19,6,11,57,36,21,63
Vienna,3258,4,18,8,10,63,53,10,62
Rapid Vienna,3258,5,14,10,12,51,41,10,52
SV Josko Rie,3258,6,13,5,18,40,49,-9,44
RZ Pellets W,3258,7,10,9,17,45,59,-14,39
Admira Wacke,3258,8,10,7,19,37,61,-24,37
Mattersburg,3258,9,8,11,17,40,61,-21,35
St. Pölten,3258,10,6,11,19,42,68,-26,29
FC Salzburg,3259,1,23,7,6,67,23,44,76
SK Sturm Gra,3259,2,19,7,10,62,34,28,64
SC Rheindorf,3259,3,18,9,9,50,41,9,63
Vienna,3259,4,17,3,16,58,58,0,54
Rapid Vienna,3259,5,14,11,11,55,42,13,53
Admira Wacke,3259,6,12,9,15,35,51,-16,45
RZ Pellets W,3259,7,11,11,14,42,50,-8,44
Mattersburg,3259,8,8,11,17,37,54,-17,35
SV Josko Rie,3259,9,9,8,19,28,49,-21,35
St. Pölten,3259,10,7,8,21,39,71,-32,29
FC Salzburg,3260,1,21,8,7,70,32,38,71
SC Rheindorf,3260,2,19,7,10,62,42,20,64
SK Sturm Gra,3260,3,18,5,13,59,40,19,59
Vienna,3260,4,18,4,14,54,52,2,58
Rapid Vienna,3260,5,13,12,11,51,44,7,51
RZ Pellets W,3260,6,14,5,17,51,59,-8,47
Admira Wacke,3260,7,13,5,18,40,59,-19,44
St. Pölten,3260,8,10,9,17,43,63,-20,39
Mattersburg,3260,9,9,10,17,41,55,-14,37
SV Josko Rie,3260,10,9,7,20,30,55,-25,34
FC Salzburg,3261,1,24,6,6,72,26,46,78
SK Sturm Gra,3261,2,20,6,10,60,36,24,66
SC Rheindorf,3261,3,17,11,8,50,42,8,62
Rapid Vienna,3261,4,16,8,12,53,35,18,56
Vienna,3261,5,16,6,14,64,60,4,54
RZ Pellets W,3261,6,13,7,16,51,57,-6,46
Admira Wacke,3261,7,12,6,18,35,60,-25,42
St. Pölten,3261,8,9,8,19,37,61,-24,35
Mattersburg,3261,9,8,8,20,41,62,-21,32
SV Josko Rie,3261,10,8,8,20,33,57,-24,32
FC Salzburg,3262,1,21,9,6,62,32,30,72
SK Sturm Gra,3262,2,21,6,9,63,37,26,69
Vienna,3262,3,20,4,12,64,58,6,64
SC Rheindorf,3262,4,17,5,14,54,49,5,56
Rapid Vienna,3262,5,14,11,11,58,39,19,53
SV Josko Rie,3262,6,13,4,19,42,51,-9,43
Mattersburg,3262,7,10,10,16,41,55,-14,40
RZ Pellets W,3262,8,11,6,19,39,52,-13,39
Admira Wacke,3262,9,11,6,19,43,60,-17,39
St. Pölten,3262,10,7,9,20,36,69,-33,30
FC Salzburg,3263,1,22,8,6,61,27,34,74
SK Sturm Gra,3263,2,20,6,10,65,40,25,66
SC Rheindorf,3263,3,19,5,12,56,45,11,62
Vienna,3263,4,18,4,14,55,51,4,58
Rapid Vienna,3263,5,13,9,14,52,43,9,48
SV Josko Rie,3263,6,14,5,17,38,46,-8,47
RZ Pellets W,3263,7,13,6,17,46,58,-12,45
Admira Wacke,3263,8,12,6,18,37,56,-19,42
St. Pölten,3263,9,7,11,18,42,69,-27,32
Mattersburg,3263,10,7,10,19,41,58,-17,31
FC Salzburg,3264,1,20,9,7,62,32,30,69
SC Rheindorf,3264,2,20,8,8,53,37,16,68
SK Sturm Gra,3264,3,20,7,9,61,33,28,67
Vienna,3264,4,18,7,11,57,49,8,61
Rapid Vienna,3264,5,13,11,12,59,39,20,50
RZ Pellets W,3264,6,12,10,14,50,53,-3,46
St. Pölten,3264,7,9,11,16,41,59,-18,38
Admira Wacke,3264,8,10,7,19,35,71,-36,37
SV Josko Rie,3264,9,9,8,19,35,54,-19,35
Mattersburg,3264,10,5,10,21,36,62,-26,25
SK Sturm Gra,3265,1,22,5,9,74,31,43,71
FC Salzburg,3265,2,20,9,7,66,33,33,69
Vienna,3265,3,19,5,12,64,57,7,62
SC Rheindorf,3265,4,17,9,10,59,45,14,60
Rapid Vienna,3265,5,15,10,11,52,38,14,55
St. Pölten,3265,6,10,9,17,46,69,-23,39
Admira Wacke,3265,7,11,6,19,34,62,-28,39
SV Josko Rie,3265,8,11,5,20,30,51,-21,38
Mattersburg,3265,9,9,8,19,40,59,-19,35
RZ Pellets W,3265,10,9,8,19,42,62,-20,35
FC Salzburg,3266,1,20,9,7,63,29,34,69
SC Rheindorf,3266,2,20,9,7,64,46,18,69
SK Sturm Gra,3266,3,19,4,13,56,34,22,61
Vienna,3266,4,18,5,13,70,57,13,59
Rapid Vienna,3266,5,13,15,8,56,41,15,54
RZ Pellets W,3266,6,13,8,15,46,53,-7,47
Admira Wacke,3266,7,11,9,16,38,55,-17,42
SV Josko Rie,3266,8,12,4,20,41,59,-18,40
Mattersburg,3266,9,7,10,19,30,60,-30,31
St. Pölten,3266,10,6,9,21,40,70,-30,27
SC Rheindorf,3267,1,22,5,9,60,43,17,71
FC Salzburg,3267,2,20,7,9,60,30,30,67
SK Sturm Gra,3267,3,19,8,9,63,36,27,65
Vienna,3267,4,19,3,14,62,54,8,60
Rapid Vienna,3267,5,14,11,11,60,40,20,53
RZ Pellets W,3267,6,14,7,15,45,53,-8,49
Mattersburg,3267,7,13,6,17,43,55,-12,45
SV Josko Rie,3267,8,8,10,18,31,52,-21,34
Admira Wacke,3267,9,9,7,20,34,60,-26,34
St. Pölten,3267,10,6,8,22,31,66,-35,26
SC Rheindorf,3268,1,20,8,8,62,43,19,68
FC Salzburg,3268,2,19,9,8,65,33,32,66
Vienna,3268,3,20,5,11,62,49,13,65
SK Sturm Gra,3268,4,18,7,11,53,34,19,61
Rapid Vienna,3268,5,15,8,13,54,40,14,53
RZ Pellets W,3268,6,12,9,15,48,57,-9,45
St. Pölten,3268,7,9,10,17,37,59,-22,37
Admira Wacke,3268,8,9,9,18,35,57,-22,36
Mattersburg,3268,9,8,10,18,41,58,-17,34
SV Josko Rie,3268,10,9,7,20,32,59,-27,34
FC Salzburg,3269,1,21,9,6,69,25,44,72
Vienna,3269,2,20,5,11,67,49,18,65
SC Rheindorf,3269,3,18,9,9,55,42,13,63
Rapid Vienna,3269,4,15,12,9,58,36,22,57
SK Sturm Gra,3269,5,16,9,11,56,43,13,57
Admira Wacke,3269,6,11,7,18,37,63,-26,40
RZ Pellets W,3269,7,10,9,17,41,57,-16,39
Mattersburg,3269,8,9,11,16,34,46,-12,38
SV Josko Rie,3269,9,9,7,20,33,57,-24,34
St. Pölten,3269,10,8,8,20,43,75,-32,32
FC Salzburg,3270,1,22,7,7,65,27,38,73
SC Rheindorf,3270,2,19,8,9,50,33,17,65
SK Sturm Gra,3270,3,18,6,12,53,39,14,60
Vienna,3270,4,15,9,12,55,52,3,54
Rapid Vienna,3270,5,15,8,13,52,48,4,53
Admira Wacke,3270,6,14,6,16,41,57,-16,48
SV Josko Rie,3270,7,13,7,16,38,46,-8,46
RZ Pellets W,3270,8,12,9,15,49,53,-4,45
Mattersburg,3270,9,7,10,19,39,59,-20,31
St. Pölten,3270,10,5,10,21,36,64,-28,25
FC Salzburg,3271,1,21,9,6,69,26,43,72
SK Sturm Gra,3271,2,19,5,12,56,34,22,62
SC Rheindorf,3271,3,18,8,10,55,46,9,62
Vienna,3271,4,17,7,12,70,58,12,58
Rapid Vienna,3271,5,12,12,12,45,41,4,48
RZ Pellets W,3271,6,12,10,14,51,62,-11,46
Admira Wacke,3271,7,10,9,17,41,61,-20,39
SV Josko Rie,3271,8,10,8,18,32,49,-17,38
Mattersburg,3271,9,9,10,17,33,53,-20,37
St. Pölten,3271,10,9,8,19,42,64,-22,35
FC Salzburg,3272,1,21,7,8,62,28,34,70
SC Rheindorf,3272,2,19,9,8,58,45,13,66
Vienna,3272,3,20,4,12,66,51,15,64
SK Sturm Gra,3272,4,14,11,11,48,35,13,53
Rapid Vienna,3272,5,14,10,12,54,39,15,52
Admira Wacke,3272,6,13,8,15,41,58,-17,47
St. Pölten,3272,7,11,8,17,48,68,-20,41
RZ Pellets W,3272,8,10,10,16,45,57,-12,40
Mattersburg,3272,9,8,9,19,39,54,-15,33
SV Josko Rie,3272,10,9,6,21,32,58,-26,33
FC Salzburg,3273,1,23,6,7,70,32,38,75
SK Sturm Gra,3273,2,21,6,9,65,32,33,69
Vienna,3273,3,20,6,10,66,51,15,66
SC Rheindorf,3273,4,17,10,9,52,43,9,61
Rapid Vienna,3273,5,16,11,9,56,36,20,59
Admira Wacke,3273,6,11,5,20,38,64,-26,38
SV Josko Rie,3273,7,11,3,22,39,61,-22,36
Mattersburg,3273,8,9,8,19,35,55,-20,35
St. Pölten,3273,9,8,10,18,38,58,-20,34
RZ Pellets W,3273,10,9,5,22,42,69,-27,32
SC Rheindorf,3274,1,21,4,11,56,41,15,67
FC Salzburg,3274,2,19,9,8,63,32,31,66
SK Sturm Gra,3274,3,19,7,10,61,31,30,64
Vienna,3274,4,18,5,13,59,54,5,59
Rapid Vienna,3274,5,15,12,9,65,38,27,57
RZ Pellets W,3274,6,12,11,13,47,55,-8,47
Admira Wacke,3274,7,12,6,18,40,60,-20,42
SV Josko Rie,3274,8,11,4,21,32,54,-22,37
St. Pölten,3274,9,9,9,18,43,70,-27,36
Mattersburg,3274,10,7,7,22,35,66,-31,28
FC Salzburg,3275,1,22,9,5,70,29,41,75
SK Sturm Gra,3275,2,19,4,13,73,44,29,61
SC Rheindorf,3275,3,17,10,9,49,44,5,61
Vienna,3275,4,18,6,12,58,50,8,60
Rapid Vienna,3275,5,13,8,15,54,43,11,47
SV Josko Rie,3275,6,13,4,19,43,54,-11,43
RZ Pellets W,3275,7,11,8,17,46,67,-21,41
Mattersburg,3275,8,10,9,17,44,58,-14,39
Admira Wacke,3275,9,10,9,17,37,60,-23,39
St. Pölten,3275,10,8,11,17,46,71,-25,35
FC Salzburg,3276,1,23,7,6,79,32,47,76
Vienna,3276,2,21,5,10,65,48,17,68
SK Sturm Gra,3276,3,20,5,11,62,37,25,65
SC Rheindorf,3276,4,18,8,10,52,49,3,62
Rapid Vienna,3276,5,13,11,12,57,41,16,50
Admira Wacke,3276,6,12,6,18,36,62,-26,42
SV Josko Rie,3276,7,10,7,19,31,47,-16,37
St. Pölten,3276,8,8,11,17,39,62,-23,35
RZ Pellets W,3276,9,9,7,20,41,64,-23,34
Mattersburg,3276,10,8,9,19,39,59,-20,33
FC Salzburg,3277,1,24,6,6,73,24,49,78
SK Sturm Gra,3277,2,22,5,9,62,29,33,71
SC Rheindorf,3277,3,20,4,12,55,44,11,64
Vienna,3277,4,19,4,13,57,49,8,61
RZ Pellets W,3277,5,16,6,14,45,50,-5,54
Rapid Vienna,3277,6,12,13,11,50,42,8,49
Mattersburg,3277,7,10,10,16,44,54,-10,40
Admira Wacke,3277,8,10,7,19,32,55,-23,37
SV Josko Rie,3277,9,8,5,23,37,69,-32,29
St. Pölten,3277,10,6,6,24,35,74,-39,24
FC Salzburg,3278,1,20,6,10,61,29,32,66
SC Rheindorf,3278,2,17,12,7,53,41,12,63
Vienna,3278,3,17,4,15,55,53,2,55
SK Sturm Gra,3278,4,15,9,12,56,40,16,54
Rapid Vienna,3278,5,13,15,8,54,38,16,54
RZ Pellets W,3278,6,14,7,15,51,51,0,49
Admira Wacke,3278,7,12,8,16,41,58,-17,44
St. Pölten,3278,8,10,9,17,44,58,-14,39
Mattersburg,3278,9,11,6,19,35,59,-24,39
SV Josko Rie,3278,10,9,8,19,27,50,-23,35
FC Salzburg,3279,1,22,7,7,69,29,40,73
SC Rheindorf,3279,2,18,8,10,55,47,8,62
SK Sturm Gra,3279,3,18,6,12,56,42,14,60
Vienna,3279,4,19,3,14,56,50,6,60
RZ Pellets W,3279,5,14,9,13,49,49,0,51
Rapid Vienna,3279,6,13,10,13,51,44,7,49
Admira Wacke,3279,7,12,4,20,39,62,-23,40
Mattersburg,3279,8,10,9,17,39,52,-13,39
St. Pölten,3279,9,9,10,17,45,59,-14,37
SV Josko Rie,3279,10,9,6,21,34,59,-25,33
SK Sturm Gra,3280,1,22,7,7,66,28,38,73
SC Rheindorf,3280,2,23,4,9,56,40,16,73
FC Salzburg,3280,3,20,9,7,64,28,36,69
Vienna,3280,4,18,3,15,63,58,5,57
Rapid Vienna,3280,5,11,11,14,50,47,3,44
RZ Pellets W,3280,6,11,8,17,47,59,-12,41
Admira Wacke,3280,7,11,8,17,36,59,-23,41
Mattersburg,3280,8,10,9,17,35,52,-17,39
SV Josko Rie,3280,9,10,5,21,30,52,-22,35
St. Pölten,3280,10,8,8,20,36,60,-24,32
SC Rheindorf,3281,1,20,7,9,61,42,19,67
Vienna,3281,2,19,7,10,71,51,20,64
FC Salzburg,3281,3,19,5,12,65,44,21,62
Rapid Vienna,3281,4,15,12,9,57,41,16,57
SK Sturm Gra,3281,5,15,9,12,55,38,17,54
RZ Pellets W,3281,6,12,11,13,45,56,-11,47
Admira Wacke,3281,7,13,6,17,36,53,-17,45
Mattersburg,3281,8,10,9,17,42,54,-12,39
SV Josko Rie,3281,9,10,3,23,33,62,-29,33
St. Pölten,3281,10,7,11,18,40,64,-24,32
FC Salzburg,3282,1,23,6,7,65,26,39,75
SC Rheindorf,3282,2,23,5,8,60,37,23,74
SK Sturm Gra,3282,3,20,7,9,59,31,28,67
Vienna,3282,4,20,2,14,63,56,7,62
Rapid Vienna,3282,5,14,10,12,64,53,11,52
RZ Pellets W,3282,6,12,5,19,50,64,-14,41
Admira Wacke,3282,7,11,5,20,40,67,-27,38
St. Pölten,3282,8,10,7,19,52,68,-16,37
SV Josko Rie,3282,9,10,4,22,32,60,-28,34
Mattersburg,3282,10,7,9,20,36,59,-23,30
FC Salzburg,3283,1,23,7,6,72,32,40,76
SC Rheindorf,3283,2,20,5,11,60,46,14,65
Vienna,3283,3,19,7,10,61,52,9,64
Rapid Vienna,3283,4,15,10,11,60,45,15,55
SK Sturm Gra,3283,5,16,4,16,56,50,6,52
Admira Wacke,3283,6,13,6,17,43,52,-9,45
RZ Pellets W,3283,7,10,9,17,46,57,-11,39
St. Pölten,3283,8,10,8,18,44,60,-16,38
Mattersburg,3283,9,10,8,18,43,63,-20,38
SV Josko Rie,3283,10,10,4,22,34,62,-28,34
FC Salzburg,3284,1,22,8,6,65,28,37,74
SC Rheindorf,3284,2,20,8,8,55,39,16,68
Vienna,3284,3,18,7,11,66,48,18,61
SK Sturm Gra,3284,4,17,7,12,54,36,18,58
RZ Pellets W,3284,5,12,11,13,44,50,-6,47
Rapid Vienna,3284,6,10,15,11,50,44,6,45
Admira Wacke,3284,7,11,7,18,34,60,-26,40
SV Josko Rie,3284,8,11,5,20,38,52,-14,38
Mattersburg,3284,9,10,7,19,42,64,-22,37
St. Pölten,3284,10,7,9,20,39,66,-27,30
FC Salzburg,3285,1,21,8,7,61,25,36,71
SK Sturm Gra,3285,2,19,7,10,55,33,22,64
Vienna,3285,3,19,5,12,69,54,15,62
Rapid Vienna,3285,4,15,8,13,56,41,15,53
SC Rheindorf,3285,5,15,8,13,46,44,2,53
Admira Wacke,3285,6,16,5,15,45,51,-6,53
St. Pölten,3285,7,8,13,15,40,60,-20,37
Mattersburg,3285,8,9,9,18,35,52,-17,36
SV Josko Rie,3285,9,9,8,19,34,54,-20,35
RZ Pellets W,3285,10,8,11,17,41,68,-27,35
FC Salzburg,3286,1,19,10,7,65,33,32,67
SC Rheindorf,3286,2,20,7,9,61,41,20,67
Vienna,3286,3,20,5,11,66,51,15,65
Rapid Vienna,3286,4,15,10,11,60,42,18,55
SK Sturm Gra,3286,5,14,9,13,47,36,11,51
RZ Pellets W,3286,6,12,9,15,50,59,-9,45
Mattersburg,3286,7,10,9,17,41,56,-15,39
Admira Wacke,3286,8,10,9,17,36,58,-22,39
SV Josko Rie,3286,9,10,6,20,32,55,-23,36
St. Pölten,3286,10,9,8,19,46,73,-27,35
FC Salzburg,3287,1,23,5,8,66,32,34,74
SC Rheindorf,3287,2,20,6,10,54,45,9,66
SK Sturm Gra,3287,3,20,4,12,61,33,28,64
Vienna,3287,4,17,4,15,62,52,10,55
Rapid Vienna,3287,5,14,11,11,58,47,11,53
RZ Pellets W,3287,6,13,8,15,44,56,-12,47
St. Pölten,3287,7,11,9,16,50,66,-16,42
Admira Wacke,3287,8,11,7,18,38,57,-19,40
SV Josko Rie,3287,9,9,8,19,35,53,-18,35
Mattersburg,3287,10,7,8,21,32,59,-27,29
FC Salzburg,3288,1,22,7,7,63,26,37,73
SK Sturm Gra,3288,2,20,6,10,71,38,33,66
SC Rheindorf,3288,3,18,7,11,49,43,6,61
Rapid Vienna,3288,4,15,13,8,52,34,18,58
Vienna,3288,5,18,4,14,62,55,7,58
RZ Pellets W,3288,6,16,7,13,47,49,-2,55
Admira Wacke,3288,7,12,4,20,33,62,-29,40
Mattersburg,3288,8,9,6,21,35,55,-20,33
St. Pölten,3288,9,7,11,18,39,66,-27,32
SV Josko Rie,3288,10,8,5,23,36,59,-23,29
FC Salzburg,3289,1,21,9,6,66,28,38,72
SC Rheindorf,3289,2,19,7,10,50,40,10,64
SK Sturm Gra,3289,3,18,6,12,56,38,18,60
Vienna,3289,4,17,7,12,62,55,7,58
RZ Pellets W,3289,5,13,9,14,51,54,-3,48
Rapid Vienna,3289,6,13,8,15,55,46,9,47
Admira Wacke,3289,7,11,9,16,46,61,-15,42
Mattersburg,3289,8,10,9,17,43,59,-16,39
SV Josko Rie,3289,9,10,6,20,39,64,-25,36
St. Pölten,3289,10,8,10,18,39,62,-23,34
SK Sturm Gra,3290,1,23,3,10,70,36,34,72
FC Salzburg,3290,2,21,8,7,60,26,34,71
SC Rheindorf,3290,3,22,5,9,64,40,24,71
Vienna,3290,4,18,5,13,69,57,12,59
RZ Pellets W,3290,5,14,8,14,48,59,-11,50
Rapid Vienna,3290,6,13,10,13,47,35,12,49
Mattersburg,3290,7,10,9,17,37,52,-15,39
St. Pölten,3290,8,9,9,18,38,63,-25,36
Admira Wacke,3290,9,10,4,22,39,72,-33,34
SV Josko Rie,3290,10,8,3,25,29,61,-32,27
FC Salzburg,3291,1,20,6,10,66,36,30,66
SK Sturm Gra,3291,2,19,9,8,55,26,29,66
Vienna,3291,3,19,7,10,70,54,16,64
SC Rheindorf,3291,4,15,9,12,49,49,0,54
Rapid Vienna,3291,5,14,9,13,52,44,8,51
Admira Wacke,3291,6,14,5,17,42,57,-15,47
RZ Pellets W,3291,7,11,8,17,41,51,-10,41
SV Josko Rie,3291,8,11,7,18,38,55,-17,40
Mattersburg,3291,9,9,9,18,40,55,-15,36
St. Pölten,3291,10,9,9,18,43,69,-26,36
SK Sturm Gra,3292,1,24,4,8,69,30,39,76
SC Rheindorf,3292,2,23,6,7,67,40,27,75
FC Salzburg,3292,3,18,8,10,57,32,25,62
Vienna,3292,4,19,4,13,55,49,6,61
Rapid Vienna,3292,5,12,11,13,53,46,7,47
SV Josko Rie,3292,6,12,7,17,34,50,-16,43
RZ Pellets W,3292,7,11,7,18,46,58,-12,40
Admira Wacke,3292,8,10,7,19,35,61,-26,37
St. Pölten,3292,9,7,11,18,37,67,-30,32
Mattersburg,3292,10,6,11,19,38,58,-20,29
SK Sturm Gra,3293,1,21,6,9,63,34,29,69
SC Rheindorf,3293,2,19,9,8,59,42,17,66
FC Salzburg,3293,3,19,8,9,60,37,23,65
Vienna,3293,4,19,4,13,67,53,14,61
Rapid Vienna,3293,5,14,10,12,57,40,17,52
RZ Pellets W,3293,6,13,8,15,43,52,-9,47
SV Josko Rie,3293,7,13,5,18,38,55,-17,44
Admira Wacke,3293,8,10,10,16,43,56,-13,40
St. Pölten,3293,9,8,8,20,39,70,-31,32
Mattersburg,3293,10,6,8,22,34,64,-30,26
FC Salzburg,3294,1,21,6,9,60,28,32,69
SK Sturm Gra,3294,2,21,5,10,61,31,30,68
SC Rheindorf,3294,3,20,6,10,59,40,19,66
Vienna,3294,4,21,3,12,66,49,17,66
Rapid Vienna,3294,5,15,12,9,62,38,24,57
St. Pölten,3294,6,8,13,15,37,65,-28,37
RZ Pellets W,3294,7,9,9,18,43,64,-21,36
Mattersburg,3294,8,9,8,19,38,53,-15,35
Admira Wacke,3294,9,9,8,19,31,64,-33,35
SV Josko Rie,3294,10,9,6,21,32,57,-25,33
FC Salzburg,3295,1,20,8,8,60,34,26,68
SC Rheindorf,3295,2,20,7,9,61,43,18,67
Vienna,3295,3,20,5,11,64,48,16,65
SK Sturm Gra,3295,4,18,6,12,57,39,18,60
Rapid Vienna,3295,5,15,12,9,60,37,23,57
SV Josko Rie,3295,6,13,5,18,39,53,-14,44
RZ Pellets W,3295,7,11,8,17,47,59,-12,41
Admira Wacke,3295,8,10,9,17,37,57,-20,39
St. Pölten,3295,9,8,9,19,39,66,-27,33
Mattersburg,3295,10,6,9,21,32,60,-28,27
FC Salzburg,3296,1,19,12,5,58,25,33,69
SC Rheindorf,3296,2,17,11,8,48,39,9,62
Rapid Vienna,3296,3,16,11,9,61,34,27,59
Vienna,3296,4,18,5,13,66,54,12,59
SK Sturm Gra,3296,5,16,9,11,51,33,18,57
RZ Pellets W,3296,6,12,8,16,44,53,-9,44
Admira Wacke,3296,7,11,7,18,37,55,-18,40
St. Pölten,3296,8,10,10,16,45,65,-20,40
SV Josko Rie,3296,9,10,9,17,34,52,-18,39
Mattersburg,3296,10,6,8,22,29,63,-34,26
FC Salzburg,3297,1,23,6,7,70,27,43,75
SK Sturm Gra,3297,2,20,6,10,63,32,31,66
SC Rheindorf,3297,3,20,6,10,56,40,16,66
Vienna,3297,4,21,3,12,61,48,13,66
Rapid Vienna,3297,5,16,8,12,57,41,16,56
Admira Wacke,3297,6,12,6,18,30,51,-21,42
SV Josko Rie,3297,7,11,6,19,30,52,-22,39
RZ Pellets W,3297,8,10,6,20,37,54,-17,36
St. Pölten,3297,9,8,8,20,41,69,-28,32
Mattersburg,3297,10,8,7,21,31,62,-31,31
FC Salzburg,3298,1,23,6,7,71,35,36,75
SK Sturm Gra,3298,2,20,6,10,60,36,24,66
SC Rheindorf,3298,3,19,8,9,60,45,15,65
Vienna,3298,4,18,6,12,64,59,5,60
Rapid Vienna,3298,5,11,12,13,57,44,13,45
RZ Pellets W,3298,6,10,11,15,47,59,-12,41
Admira Wacke,3298,7,12,5,19,38,60,-22,41
SV Josko Rie,3298,8,10,7,19,32,51,-19,37
Mattersburg,3298,9,9,9,18,41,63,-22,36
St. Pölten,3298,10,9,8,19,47,65,-18,35
FC Salzburg,3299,1,20,9,7,59,30,29,69
Vienna,3299,2,21,6,9,61,39,22,69
SK Sturm Gra,3299,3,21,5,10,58,32,26,68
SC Rheindorf,3299,4,18,9,9,59,45,14,63
RZ Pellets W,3299,5,13,6,17,44,49,-5,45
Rapid Vienna,3299,6,11,11,14,46,39,7,44
Admira Wacke,3299,7,12,6,18,38,59,-21,42
St. Pölten,3299,8,10,8,18,43,59,-16,38
SV Josko Rie,3299,9,10,5,21,29,56,-27,35
Mattersburg,3299,10,8,7,21,29,58,-29,31
SC Rheindorf,3300,1,24,5,7,62,35,27,77
FC Salzburg,3300,2,20,7,9,69,36,33,67
Vienna,3300,3,21,3,12,74,48,26,66
SK Sturm Gra,3300,4,19,5,12,57,35,22,62
Rapid Vienna,3300,5,15,13,8,55,37,18,58
RZ Pellets W,3300,6,13,6,17,42,58,-16,45
Mattersburg,3300,7,10,9,17,40,54,-14,39
Admira Wacke,3300,8,10,7,19,33,56,-23,37
SV Josko Rie,3300,9,7,8,21,29,62,-33,29
St. Pölten,3300,10,4,11,21,31,71,-40,23
SC Rheindorf,3301,1,20,8,8,55,38,17,68
FC Salzburg,3301,2,19,9,8,68,42,26,66
Vienna,3301,3,20,6,10,68,57,11,66
SK Sturm Gra,3301,4,19,7,10,67,38,29,64
Rapid Vienna,3301,5,14,11,11,67,47,20,53
RZ Pellets W,3301,6,12,10,14,45,54,-9,46
Admira Wacke,3301,7,11,6,19,45,65,-20,39
St. Pölten,3301,8,9,9,18,40,62,-22,36
SV Josko Rie,3301,9,8,8,20,34,60,-26,32
Mattersburg,3301,10,5,12,19,34,60,-26,27
FC Salzburg,3302,1,22,7,7,72,33,39,73
SC Rheindorf,3302,2,21,7,8,63,41,22,70
SK Sturm Gra,3302,3,21,5,10,62,33,29,68
Vienna,3302,4,18,3,15,62,52,10,57
RZ Pellets W,3302,5,15,7,14,51,54,-3,52
Rapid Vienna,3302,6,13,10,13,52,47,5,49
Admira Wacke,3302,7,9,9,18,36,65,-29,36
St. Pölten,3302,8,8,9,19,43,66,-23,33
SV Josko Rie,3302,9,8,9,19,30,55,-25,33
Mattersburg,3302,10,7,10,19,39,64,-25,31
FC Salzburg,3303,1,23,6,7,74,37,37,75
SC Rheindorf,3303,2,20,8,8,62,41,21,68
SK Sturm Gra,3303,3,19,7,10,56,36,20,64
Vienna,3303,4,18,5,13,60,51,9,59
Admira Wacke,3303,5,15,4,17,45,62,-17,49
RZ Pellets W,3303,6,14,6,16,51,54,-3,48
Rapid Vienna,3303,7,11,10,15,45,42,3,43
Mattersburg,3303,8,9,8,19,33,55,-22,35
St. Pölten,3303,9,9,8,19,42,65,-23,35
SV Josko Rie,3303,10,7,8,21,31,56,-25,29
SK Sturm Gra,3304,1,22,6,8,65,33,32,72
FC Salzburg,3304,2,18,10,8,65,38,27,64
SC Rheindorf,3304,3,19,6,11,51,47,4,63
Rapid Vienna,3304,4,16,9,11,71,48,23,57
Vienna,3304,5,16,8,12,56,50,6,56
Admira Wacke,3304,6,12,6,18,40,56,-16,42
SV Josko Rie,3304,7,11,8,17,37,51,-14,41
RZ Pellets W,3304,8,11,5,20,43,64,-21,38
St. Pölten,3304,9,8,11,17,47,67,-20,35
Mattersburg,3304,10,7,11,18,41,62,-21,32
FC Salzburg,3305,1,19,9,8,67,37,30,66
SC Rheindorf,3305,2,18,8,10,51,46,5,62
Vienna,3305,3,17,8,11,61,54,7,59
SK Sturm Gra,3305,4,17,6,13,53,38,15,57
Rapid Vienna,3305,5,13,15,8,59,36,23,54
Admira Wacke,3305,6,12,9,15,40,57,-17,45
RZ Pellets W,3305,7,12,8,16,41,51,-10,44
St. Pölten,3305,8,10,11,15,44,60,-16,41
Mattersburg,3305,9,10,10,16,38,44,-6,40
SV Josko Rie,3305,10,8,4,24,33,64,-31,28
Vienna,3306,1,23,3,10,70,46,24,72
FC Salzburg,3306,2,19,10,7,62,32,30,67
SC Rheindorf,3306,3,20,6,10,63,43,20,66
SK Sturm Gra,3306,4,17,8,11,56,43,13,59
Rapid Vienna,3306,5,15,12,9,63,41,22,57
RZ Pellets W,3306,6,12,7,17,42,50,-8,43
Mattersburg,3306,7,10,8,18,39,58,-19,38
SV Josko Rie,3306,8,9,7,20,27,50,-23,34
St. Pölten,3306,9,7,11,18,37,63,-26,32
Admira Wacke,3306,10,8,8,20,29,62,-33,32
FC Salzburg,3307,1,19,10,7,62,27,35,67
SC Rheindorf,3307,2,20,6,10,59,51,8,66
SK Sturm Gra,3307,3,19,8,9,62,39,23,65
Vienna,3307,4,19,4,13,65,52,13,61
Rapid Vienna,3307,5,15,12,9,66,43,23,57
RZ Pellets W,3307,6,12,7,17,47,56,-9,43
Mattersburg,3307,7,11,8,17,37,55,-18,41
Admira Wacke,3307,8,11,6,19,28,56,-28,39
SV Josko Rie,3307,9,11,5,20,36,53,-17,38
St. Pölten,3307,10,5,10,21,35,65,-30,25
SK Sturm Gra,3308,1,21,8,7,56,27,29,71
FC Salzburg,3308,2,18,11,7,64,31,33,65
Vienna,3308,3,19,8,9,67,47,20,65
SC Rheindorf,3308,4,18,11,7,53,41,12,65
Rapid Vienna,3308,5,15,12,9,60,42,18,57
Admira Wacke,3308,6,11,6,19,37,60,-23,39
RZ Pellets W,3308,7,10,8,18,41,59,-18,38
SV Josko Rie,3308,8,10,5,21,34,59,-25,35
St. Pölten,3308,9,7,10,19,36,62,-26,31
Mattersburg,3308,10,6,11,19,36,56,-20,29
FC Salzburg,3309,1,23,5,8,72,38,34,74
SC Rheindorf,3309,2,18,9,9,54,40,14,63
SK Sturm Gra,3309,3,18,7,11,59,38,21,61
Rapid Vienna,3309,4,15,12,9,58,37,21,57
Vienna,3309,5,17,4,15,62,61,1,55
St. Pölten,3309,6,11,11,14,48,60,-12,44
RZ Pellets W,3309,7,11,7,18,40,54,-14,40
Admira Wacke,3309,8,12,4,20,39,61,-22,40
Mattersburg,3309,9,10,9,17,37,53,-16,39
SV Josko Rie,3309,10,9,4,23,30,57,-27,31
FC Salzburg,3310,1,24,6,6,69,25,44,78
Vienna,3310,2,22,4,10,69,44,25,70
SC Rheindorf,3310,3,17,8,11,54,46,8,59
SK Sturm Gra,3310,4,15,10,11,56,36,20,55
RZ Pellets W,3310,5,15,5,16,47,59,-12,50
Rapid Vienna,3310,6,12,12,12,47,40,7,48
Admira Wacke,3310,7,11,9,16,35,59,-24,42
Mattersburg,3310,8,10,8,18,37,52,-15,38
SV Josko Rie,3310,9,9,6,21,27,55,-28,33
St. Pölten,3310,10,7,8,21,37,62,-25,29
FC Salzburg,3311,1,19,9,8,71,41,30,66
SK Sturm Gra,3311,2,19,8,9,55,32,23,65
SC Rheindorf,3311,3,17,8,11,54,48,6,59
Vienna,3311,4,17,5,14,56,56,0,56
Rapid Vienna,3311,5,14,13,9,58,38,20,55
Admira Wacke,3311,6,13,6,17,40,56,-16,45
RZ Pellets W,3311,7,12,8,16,44,53,-9,44
Mattersburg,3311,8,10,10,16,41,55,-14,40
SV Josko Rie,3311,9,10,6,20,37,52,-15,36
St. Pölten,3311,10,7,11,18,41,66,-25,32
FC Salzburg,3312,1,22,8,6,65,27,38,74
SC Rheindorf,3312,2,19,7,10,56,42,14,64
SK Sturm Gra,3312,3,18,7,11,56,36,20,61
Vienna,3312,4,17,5,14,61,54,7,56
Rapid Vienna,3312,5,13,9,14,53,44,9,48
Admira Wacke,3312,6,14,5,17,49,67,-18,47
RZ Pellets W,3312,7,12,8,16,46,54,-8,44
Mattersburg,3312,8,9,9,18,37,55,-18,36
St. Pölten,3312,9,8,12,16,43,64,-21,36
SV Josko Rie,3312,10,9,8,19,37,60,-23,35
SC Rheindorf,3313,1,20,8,8,51,36,15,68
FC Salzburg,3313,2,19,8,9,71,36,35,65
Vienna,3313,3,19,8,9,67,47,20,65
SK Sturm Gra,3313,4,18,5,13,56,34,22,59
Rapid Vienna,3313,5,13,11,12,52,42,10,50
Admira Wacke,3313,6,14,5,17,44,58,-14,47
RZ Pellets W,3313,7,13,5,18,49,62,-13,44
SV Josko Rie,3313,8,12,5,19,38,61,-23,41
Mattersburg,3313,9,9,10,17,36,53,-17,37
St. Pölten,3313,10,7,7,22,37,72,-35,28
FC Salzburg,3314,1,25,6,5,72,29,43,81
SK Sturm Gra,3314,2,19,6,11,56,33,23,63
Vienna,3314,3,19,5,12,71,53,18,62
SC Rheindorf,3314,4,17,7,12,48,47,1,58
Rapid Vienna,3314,5,13,13,10,57,42,15,52
Mattersburg,3314,6,12,9,15,47,59,-12,45
Admira Wacke,3314,7,12,5,19,40,59,-19,41
RZ Pellets W,3314,8,9,9,18,38,59,-21,36
St. Pölten,3314,9,7,11,18,37,58,-21,32
SV Josko Rie,3314,10,9,5,22,31,58,-27,32
SC Rheindorf,3315,1,20,9,7,56,35,21,69
FC Salzburg,3315,2,20,8,8,61,31,30,68
SK Sturm Gra,3315,3,20,5,11,60,37,23,65
Vienna,3315,4,19,6,11,65,50,15,63
Rapid Vienna,3315,5,16,11,9,53,35,18,59
RZ Pellets W,3315,6,14,6,16,46,49,-3,48
Admira Wacke,3315,7,11,6,19,35,59,-24,39
SV Josko Rie,3315,8,9,6,21,35,62,-27,33
Mattersburg,3315,9,8,8,20,36,55,-19,32
St. Pölten,3315,10,6,9,21,37,71,-34,27
FC Salzburg,3316,1,23,7,6,66,25,41,76
SK Sturm Gra,3316,2,19,8,9,65,41,24,65
SC Rheindorf,3316,3,19,6,11,53,42,11,63
Vienna,3316,4,18,4,14,58,57,1,58
Rapid Vienna,3316,5,14,10,12,57,43,14,52
Admira Wacke,3316,6,12,8,16,40,55,-15,44
RZ Pellets W,3316,7,12,7,17,48,58,-10,43
Mattersburg,3316,8,12,6,18,42,55,-13,42
SV Josko Rie,3316,9,9,5,22,36,61,-25,32
St. Pölten,3316,10,6,11,19,45,73,-28,29
SC Rheindorf,3317,1,22,7,7,61,41,20,73
SK Sturm Gra,3317,2,21,7,8,62,29,33,70
FC Salzburg,3317,3,20,9,7,68,28,40,69
Rapid Vienna,3317,4,13,12,11,55,41,14,51
Vienna,3317,5,14,5,17,55,59,-4,47
SV Josko Rie,3317,6,13,5,18,34,51,-17,44
Admira Wacke,3317,7,12,7,17,38,58,-20,43
RZ Pellets W,3317,8,11,7,18,39,56,-17,40
Mattersburg,3317,9,10,6,20,41,63,-22,36
St. Pölten,3317,10,8,7,21,46,73,-27,31
FC Salzburg,3318,1,23,7,6,67,30,37,76
SC Rheindorf,3318,2,20,8,8,56,37,19,68
SK Sturm Gra,3318,3,20,6,10,58,36,22,66
Vienna,3318,4,18,6,12,66,53,13,60
Rapid Vienna,3318,5,11,14,11,55,40,15,47
RZ Pellets W,3318,6,12,7,17,44,55,-11,43
SV Josko Rie,3318,7,10,6,20,34,55,-21,36
St. Pölten,3318,8,9,9,18,35,60,-25,36
Admira Wacke,3318,9,10,6,20,32,59,-27,36
Mattersburg,3318,10,8,9,19,33,55,-22,33
SC Rheindorf,3319,1,21,7,8,53,36,17,70
FC Salzburg,3319,2,20,6,10,60,31,29,66
SK Sturm Gra,3319,3,20,4,12,55,36,19,64
Vienna,3319,4,18,4,14,65,58,7,58
Rapid Vienna,3319,5,12,11,13,54,46,8,47
SV Josko Rie,3319,6,14,4,18,34,47,-13,46
RZ Pellets W,3319,7,12,8,16,44,53,-9,44
Admira Wacke,3319,8,11,9,16,41,60,-19,42
St. Pölten,3319,9,10,8,18,46,65,-19,38
Mattersburg,3319,10,7,9,20,35,55,-20,30
FC Salzburg,3320,1,21,7,8,70,33,37,70
SC Rheindorf,3320,2,20,6,10,55,43,12,66
SK Sturm Gra,3320,3,19,6,11,60,38,22,63
Vienna,3320,4,19,6,11,61,49,12,63
Rapid Vienna,3320,5,14,10,12,49,41,8,52
RZ Pellets W,3320,6,11,12,13,42,44,-2,45
St. Pölten,3320,7,10,10,16,40,55,-15,40
Admira Wacke,3320,8,10,10,16,35,56,-21,40
SV Josko Rie,3320,9,9,4,23,27,54,-27,31
Mattersburg,3320,10,7,9,20,35,61,-26,30
SK Sturm Gra,3321,1,23,7,6,68,29,39,76
SC Rheindorf,3321,2,22,6,8,60,40,20,72
FC Salzburg,3321,3,18,7,11,65,37,28,61
Vienna,3321,4,18,3,15,59,56,3,57
Rapid Vienna,3321,5,16,8,12,56,42,14,56
Admira Wacke,3321,6,15,6,15,50,56,-6,51
SV Josko Rie,3321,7,12,3,21,36,57,-21,39
RZ Pellets W,3321,8,9,7,20,41,62,-21,34
St. Pölten,3321,9,8,8,20,42,71,-29,32
Mattersburg,3321,10,8,7,21,39,66,-27,31
FC Salzburg,3322,1,20,8,8,71,38,33,68
SC Rheindorf,3322,2,20,7,9,57,50,7,67
Vienna,3322,3,20,5,11,62,51,11,65
Rapid Vienna,3322,4,16,9,11,64,42,22,57
SK Sturm Gra,3322,5,17,6,13,55,37,18,57
RZ Pellets W,3322,6,15,7,14,53,49,4,52
SV Josko Rie,3322,7,10,6,20,38,59,-21,36
St. Pölten,3322,8,8,11,17,45,69,-24,35
Admira Wacke,3322,9,9,8,19,38,66,-28,35
Mattersburg,3322,10,8,7,21,41,63,-22,31
SK Sturm Gra,3323,1,21,5,10,69,40,29,68
SC Rheindorf,3323,2,20,7,9,58,46,12,67
FC Salzburg,3323,3,18,9,9,58,35,23,63
Vienna,3323,4,18,6,12,63,50,13,60
Rapid Vienna,3323,5,13,11,12,60,49,11,50
RZ Pellets W,3323,6,11,10,15,53,59,-6,43
St. Pölten,3323,7,10,12,14,43,52,-9,42
Admira Wacke,3323,8,12,6,18,34,61,-27,42
Mattersburg,3323,9,7,11,18,43,61,-18,32
SV Josko Rie,3323,10,9,5,22,34,62,-28,32
FC Salzburg,3324,1,22,8,6,65,28,37,74
Vienna,3324,2,20,8,8,70,46,24,68
SC Rheindorf,3324,3,19,9,8,61,39,22,66
SK Sturm Gra,3324,4,17,10,9,58,36,22,61
Rapid Vienna,3324,5,12,11,13,55,50,5,47
RZ Pellets W,3324,6,10,13,13,46,53,-7,43
Admira Wacke,3324,7,11,7,18,33,57,-24,40
St. Pölten,3324,8,9,9,18,44,65,-21,36
Mattersburg,3324,9,6,11,19,39,63,-24,29
SV Josko Rie,3324,10,7,8,21,30,64,-34,29
FC Salzburg,3325,1,22,8,6,66,29,37,74
Vienna,3325,2,23,4,9,72,47,25,73
SC Rheindorf,3325,3,19,8,9,60,43,17,65
SK Sturm Gra,3325,4,18,6,12,59,37,22,60
RZ Pellets W,3325,5,13,7,16,57,64,-7,46
SV Josko Rie,3325,6,11,8,17,41,52,-11,41
Rapid Vienna,3325,7,9,13,14,48,43,5,40
Admira Wacke,3325,8,11,6,19,38,65,-27,39
Mattersburg,3325,9,8,10,18,35,56,-21,34
St. Pölten,3325,10,6,10,20,37,77,-40,28
SC Rheindorf,3326,1,21,7,8,54,36,18,70
FC Salzburg,3326,2,20,8,8,62,30,32,68
SK Sturm Gra,3326,3,20,6,10,61,37,24,66
Vienna,3326,4,19,4,13,62,56,6,61
RZ Pellets W,3326,5,14,6,16,50,50,0,48
Rapid Vienna,3326,6,12,10,14,60,54,6,46
Admira Wacke,3326,7,12,5,19,35,58,-23,41
SV Josko Rie,3326,8,11,7,18,33,48,-15,40
Mattersburg,3326,9,9,8,19,39,60,-21,35
St. Pölten,3326,10,7,9,20,43,70,-27,30
FC Salzburg,3327,1,22,5,9,68,39,29,71
SK Sturm Gra,3327,2,19,8,9,55,27,28,65
Vienna,3327,3,20,5,11,72,48,24,65
SC Rheindorf,3327,4,20,5,11,57,47,10,65
Rapid Vienna,3327,5,16,8,12,60,39,21,56
Admira Wacke,3327,6,12,7,17,40,62,-22,43
RZ Pellets W,3327,7,11,6,19,47,69,-22,39
Mattersburg,3327,8,10,7,19,42,59,-17,37
St. Pölten,3327,9,8,9,19,44,69,-25,33
SV Josko Rie,3327,10,8,8,20,31,57,-26,32
FC Salzburg,3328,1,21,9,6,64,28,36,72
Vienna,3328,2,21,3,12,66,46,20,66
SC Rheindorf,3328,3,19,8,9,53,38,15,65
SK Sturm Gra,3328,4,18,6,12,55,36,19,60
Admira Wacke,3328,5,13,6,17,43,68,-25,45
Rapid Vienna,3328,6,11,11,14,53,46,7,44
SV Josko Rie,3328,7,12,7,17,41,54,-13,43
RZ Pellets W,3328,8,11,7,18,49,61,-12,40
Mattersburg,3328,9,8,10,18,38,55,-17,34
St. Pölten,3328,10,8,9,19,40,70,-30,33
FC Salzburg,3329,1,24,8,4,73,24,49,80
SK Sturm Gra,3329,2,18,9,9,65,35,30,63
SC Rheindorf,3329,3,18,6,12,57,50,7,60
Vienna,3329,4,17,7,12,62,55,7,58
Rapid Vienna,3329,5,14,12,10,58,43,15,54
RZ Pellets W,3329,6,13,6,17,48,53,-5,45
Admira Wacke,3329,7,10,8,18,35,61,-26,38
SV Josko Rie,3329,8,11,3,22,34,62,-28,36
St. Pölten,3329,9,9,8,19,37,64,-27,35
Mattersburg,3329,10,8,9,19,39,61,-22,33
FC Salzburg,3330,1,21,8,7,69,37,32,71
SC Rheindorf,3330,2,20,8,8,57,43,14,68
SK Sturm Gra,3330,3,18,8,10,55,36,19,62
Vienna,3330,4,17,7,12,62,50,12,58
Rapid Vienna,3330,5,13,12,11,57,40,17,51
RZ Pellets W,3330,6,13,7,16,50,57,-7,46
SV Josko Rie,3330,7,12,6,18,41,57,-16,42
Admira Wacke,3330,8,10,8,18,42,62,-20,38
Mattersburg,3330,9,8,9,19,39,59,-20,33
St. Pölten,3330,10,6,11,19,34,65,-31,29
SC Rheindorf,3331,1,20,7,9,55,39,16,67
FC Salzburg,3331,2,18,11,7,60,33,27,65
SK Sturm Gra,3331,3,17,8,11,53,30,23,59
RZ Pellets W,3331,4,16,8,12,55,47,8,56
Rapid Vienna,3331,5,13,11,12,46,38,8,50
Vienna,3331,6,15,5,16,48,51,-3,50
Admira Wacke,3331,7,13,5,18,35,57,-22,44
SV Josko Rie,3331,8,11,7,18,32,48,-16,40
Mattersburg,3331,9,9,8,19,31,51,-20,35
St. Pölten,3331,10,8,10,18,41,62,-21,34
FC Salzburg,3332,1,21,9,6,66,32,34,72
SC Rheindorf,3332,2,19,8,9,57,47,10,65
SK Sturm Gra,3332,3,19,5,12,59,40,19,62
Vienna,3332,4,19,5,12,65,52,13,62
Rapid Vienna,3332,5,13,11,12,56,45,11,50
SV Josko Rie,3332,6,11,9,16,35,46,-11,42
RZ Pellets W,3332,7,12,6,18,48,61,-13,42
Mattersburg,3332,8,11,9,16,38,56,-18,42
Admira Wacke,3332,9,10,8,18,36,56,-20,38
St. Pölten,3332,10,5,10,21,41,66,-25,25
FC Salzburg,3333,1,21,9,6,63,34,29,72
Rapid Vienna,3333,2,19,9,8,66,34,32,66
Vienna,3333,3,18,7,11,62,49,13,61
SC Rheindorf,3333,4,16,9,11,50,46,4,57
SK Sturm Gra,3333,5,16,8,12,52,39,13,56
Mattersburg,3333,6,11,8,17,41,52,-11,41
RZ Pellets W,3333,7,11,7,18,48,65,-17,40
Admira Wacke,3333,8,11,5,20,39,62,-23,38
SV Josko Rie,3333,9,10,6,20,35,55,-20,36
St. Pölten,3333,10,7,12,17,41,61,-20,33
FC Salzburg,3334,1,20,7,9,61,31,30,67
SK Sturm Gra,3334,2,19,6,11,57,33,24,63
SC Rheindorf,3334,3,17,8,11,56,50,6,59
Vienna,3334,4,18,3,15,60,54,6,57
Rapid Vienna,3334,5,15,10,11,59,34,25,55
RZ Pellets W,3334,6,13,8,15,48,57,-9,47
Admira Wacke,3334,7,14,5,17,46,57,-11,47
SV Josko Rie,3334,8,12,7,17,40,56,-16,43
Mattersburg,3334,9,9,10,17,42,56,-14,37
St. Pölten,3334,10,8,6,22,34,75,-41,30
FC Salzburg,3335,1,22,7,7,71,33,38,73
SK Sturm Gra,3335,2,22,4,10,57,30,27,70
SC Rheindorf,3335,3,21,5,10,49,38,11,68
Vienna,3335,4,16,8,12,57,47,10,56
Admira Wacke,3335,5,14,5,17,39,57,-18,47
Rapid Vienna,3335,6,12,9,15,55,47,8,45
RZ Pellets W,3335,7,12,8,16,47,55,-8,44
SV Josko Rie,3335,8,12,6,18,34,50,-16,42
Mattersburg,3335,9,8,9,19,32,52,-20,33
St. Pölten,3335,10,6,9,21,36,68,-32,27
SC Rheindorf,3336,1,24,5,7,69,38,31,77
FC Salzburg,3336,2,19,9,8,60,35,25,66
Vienna,3336,3,20,3,13,64,60,4,63
Rapid Vienna,3336,4,17,8,11,54,39,15,59
SK Sturm Gra,3336,5,17,5,14,55,37,18,56
RZ Pellets W,3336,6,13,8,15,49,56,-7,47
St. Pölten,3336,7,11,10,15,47,57,-10,43
Admira Wacke,3336,8,10,5,21,40,69,-29,35
Mattersburg,3336,9,8,7,21,40,60,-20,31
SV Josko Rie,3336,10,9,4,23,36,63,-27,31
FC Salzburg,3337,1,23,7,6,65,27,38,76
SC Rheindorf,3337,2,18,11,7,54,37,17,65
Vienna,3337,3,19,6,11,57,50,7,63
SK Sturm Gra,3337,4,17,9,10,58,36,22,60
Rapid Vienna,3337,5,14,10,12,57,45,12,52
RZ Pellets W,3337,6,11,10,15,52,57,-5,43
St. Pölten,3337,7,8,12,16,38,56,-18,36
SV Josko Rie,3337,8,10,6,20,33,58,-25,36
Admira Wacke,3337,9,10,6,20,34,62,-28,36
Mattersburg,3337,10,8,7,21,40,60,-20,31
SK Sturm Gra,3338,1,21,7,8,65,32,33,70
FC Salzburg,3338,2,20,5,11,67,35,32,65
Vienna,3338,3,19,4,13,63,53,10,61
SC Rheindorf,3338,4,17,6,13,47,44,3,57
RZ Pellets W,3338,5,15,8,13,47,46,1,53
Admira Wacke,3338,6,15,7,14,42,55,-13,52
Rapid Vienna,3338,7,12,12,12,52,45,7,48
St. Pölten,3338,8,10,7,19,40,66,-26,37
SV Josko Rie,3338,9,11,3,22,32,55,-23,36
Mattersburg,3338,10,5,11,20,36,60,-24,26
SK Sturm Gra,3339,1,23,7,6,61,24,37,76
SC Rheindorf,3339,2,19,5,12,56,45,11,62
Vienna,3339,3,18,7,11,56,43,13,61
FC Salzburg,3339,4,18,6,12,64,35,29,60
Rapid Vienna,3339,5,14,11,11,54,42,12,53
RZ Pellets W,3339,6,12,7,17,42,52,-10,43
Mattersburg,3339,7,12,6,18,34,59,-25,42
Admira Wacke,3339,8,11,7,18,35,57,-22,40
St. Pölten,3339,9,10,7,19,44,67,-23,37
SV Josko Rie,3339,10,10,3,23,32,54,-22,33
SC Rheindorf,3340,1,21,9,6,70,39,31,72
FC Salzburg,3340,2,20,7,9,64,31,33,67
SK Sturm Gra,3340,3,15,12,9,57,37,20,57
Vienna,3340,4,18,3,15,62,63,-1,57
Rapid Vienna,3340,5,12,13,11,61,42,19,49
RZ Pellets W,3340,6,14,7,15,42,52,-10,49
Admira Wacke,3340,7,12,7,17,38,56,-18,43
St. Pölten,3340,8,9,9,18,40,63,-23,36
SV Josko Rie,3340,9,10,5,21,33,62,-29,35
Mattersburg,3340,10,8,10,18,48,70,-22,34
FC Salzburg,3341,1,20,9,7,69,34,35,69
SK Sturm Gra,3341,2,21,4,11,59,33,26,67
Vienna,3341,3,17,5,14,57,51,6,56
SC Rheindorf,3341,4,16,7,13,58,59,-1,55
Rapid Vienna,3341,5,15,9,12,57,38,19,54
SV Josko Rie,3341,6,14,4,18,37,53,-16,46
RZ Pellets W,3341,7,12,9,15,49,58,-9,45
St. Pölten,3341,8,12,9,15,51,64,-13,45
Mattersburg,3341,9,9,9,18,42,57,-15,36
Admira Wacke,3341,10,8,7,21,30,62,-32,31
Vienna,3342,1,22,4,10,62,40,22,70
FC Salzburg,3342,2,21,5,10,59,30,29,68
SK Sturm Gra,3342,3,20,7,9,62,28,34,67
SC Rheindorf,3342,4,18,8,10,50,42,8,62
Rapid Vienna,3342,5,13,12,11,54,41,13,51
Admira Wacke,3342,6,15,4,17,39,53,-14,49
RZ Pellets W,3342,7,13,6,17,49,58,-9,45
St. Pölten,3342,8,8,10,18,38,64,-26,34
SV Josko Rie,3342,9,9,4,23,31,63,-32,31
Mattersburg,3342,10,7,8,21,34,59,-25,29
SC Rheindorf,3343,1,21,8,7,59,38,21,71
FC Salzburg,3343,2,20,6,10,67,34,33,66
SK Sturm Gra,3343,3,19,6,11,60,37,23,63
Vienna,3343,4,19,6,11,64,51,13,63
Rapid Vienna,3343,5,13,9,14,51,42,9,48
Admira Wacke,3343,6,13,7,16,38,52,-14,46
Mattersburg,3343,7,12,5,19,42,53,-11,41
RZ Pellets W,3343,8,11,6,19,47,66,-19,39
SV Josko Rie,3343,9,11,5,20,35,65,-30,38
St. Pölten,3343,10,7,10,19,39,64,-25,31
SC Rheindorf,3344,1,22,5,9,56,43,13,71
FC Salzburg,3344,2,20,9,7,70,33,37,69
Rapid Vienna,3344,3,14,13,9,55,38,17,55
SK Sturm Gra,3344,4,15,9,12,57,41,16,54
Vienna,3344,5,14,9,13,60,58,2,51
Mattersburg,3344,6,13,7,16,47,51,-4,46
RZ Pellets W,3344,7,12,9,15,45,58,-13,45
Admira Wacke,3344,8,10,9,17,40,61,-21,39
St. Pölten,3344,9,8,11,17,47,67,-20,35
SV Josko Rie,3344,10,8,7,21,31,58,-27,31
FC Salzburg,3345,1,20,6,10,65,33,32,66
SC Rheindorf,3345,2,20,6,10,57,43,14,66
Rapid Vienna,3345,3,15,13,8,67,39,28,58
SK Sturm Gra,3345,4,17,6,13,57,43,14,57
Vienna,3345,5,16,6,14,57,56,1,54
Admira Wacke,3345,6,14,7,15,40,55,-15,49
SV Josko Rie,3345,7,13,7,16,38,46,-8,46
RZ Pellets W,3345,8,10,10,16,39,59,-20,40
St. Pölten,3345,9,9,8,19,41,64,-23,35
Mattersburg,3345,10,7,9,20,36,59,-23,30
FC Salzburg,3346,1,22,7,7,63,31,32,73
SK Sturm Gra,3346,2,19,8,9,55,31,24,65
SC Rheindorf,3346,3,18,9,9,51,38,13,63
Vienna,3346,4,19,4,13,64,48,16,61
Rapid Vienna,3346,5,15,9,12,54,41,13,54
Admira Wacke,3346,6,13,5,18,39,56,-17,44
RZ Pellets W,3346,7,11,7,18,45,62,-17,40
St. Pölten,3346,8,10,9,17,49,61,-12,39
SV Josko Rie,3346,9,10,5,21,28,53,-25,35
Mattersburg,3346,10,7,9,20,35,62,-27,30
FC Salzburg,3347,1,21,8,7,63,31,32,71
Vienna,3347,2,21,6,9,71,52,19,69
SK Sturm Gra,3347,3,21,5,10,67,36,31,68
SC Rheindorf,3347,4,16,7,13,56,51,5,55
Rapid Vienna,3347,5,14,12,10,61,44,17,54
SV Josko Rie,3347,6,13,6,17,37,53,-16,45
RZ Pellets W,3347,7,11,8,17,48,62,-14,41
Admira Wacke,3347,8,10,6,20,38,66,-28,36
St. Pölten,3347,9,8,9,19,46,69,-23,33
Mattersburg,3347,10,7,9,20,37,60,-23,30
SK Sturm Gra,3348,1,23,4,9,64,31,33,73
Vienna,3348,2,20,4,12,66,51,15,64
FC Salzburg,3348,3,18,7,11,59,42,17,61
SC Rheindorf,3348,4,18,7,11,58,47,11,61
Rapid Vienna,3348,5,15,10,11,56,39,17,55
Admira Wacke,3348,6,13,7,16,43,53,-10,46
SV Josko Rie,3348,7,11,7,18,36,50,-14,40
RZ Pellets W,3348,8,10,9,17,40,55,-15,39
Mattersburg,3348,9,10,8,18,34,55,-21,38
St. Pölten,3348,10,7,7,22,39,72,-33,28
Vienna,3349,1,21,6,9,65,46,19,69
SK Sturm Gra,3349,2,20,6,10,63,39,24,66
FC Salzburg,3349,3,19,8,9,70,34,36,65
Rapid Vienna,3349,4,16,9,11,62,44,18,57
SC Rheindorf,3349,5,15,11,10,46,46,0,56
RZ Pellets W,3349,6,13,6,17,44,58,-14,45
Admira Wacke,3349,7,13,6,17,41,57,-16,45
SV Josko Rie,3349,8,12,6,18,36,50,-14,42
Mattersburg,3349,9,8,7,21,37,59,-22,31
St. Pölten,3349,10,6,9,21,37,68,-31,27
FC Salzburg,3350,1,21,8,7,68,28,40,71
SC Rheindorf,3350,2,21,7,8,59,38,21,70
SK Sturm Gra,3350,3,19,8,9,59,31,28,65
Rapid Vienna,3350,4,18,8,10,60,41,19,62
Vienna,3350,5,18,4,14,57,54,3,58
Admira Wacke,3350,6,12,8,16,38,55,-17,44
RZ Pellets W,3350,7,10,9,17,42,57,-15,39
St. Pölten,3350,8,8,10,18,40,62,-22,34
SV Josko Rie,3350,9,9,5,22,32,53,-21,32
Mattersburg,3350,10,8,5,23,32,68,-36,29
FC Salzburg,3351,1,21,7,8,63,31,32,70
SC Rheindorf,3351,2,19,7,10,56,45,11,64
SK Sturm Gra,3351,3,18,9,9,61,36,25,63
Vienna,3351,4,19,6,11,67,54,13,63
Rapid Vienna,3351,5,14,10,12,54,43,11,52
RZ Pellets W,3351,6,12,6,18,44,57,-13,42
Admira Wacke,3351,7,12,6,18,41,61,-20,42
SV Josko Rie,3351,8,11,5,20,41,60,-19,38
St. Pölten,3351,9,9,10,17,41,62,-21,37
Mattersburg,3351,10,7,10,19,43,62,-19,31
SK Sturm Gra,3352,1,19,8,9,57,31,26,65
SC Rheindorf,3352,2,20,5,11,56,38,18,65
FC Salzburg,3352,3,19,7,10,55,30,25,64
Rapid Vienna,3352,4,15,13,8,59,36,23,58
Vienna,3352,5,17,7,12,68,56,12,58
Admira Wacke,3352,6,11,9,16,40,56,-16,42
RZ Pellets W,3352,7,11,8,17,39,57,-18,41
St. Pölten,3352,8,10,10,16,40,59,-19,40
Mattersburg,3352,9,9,7,20,34,58,-24,34
SV Josko Rie,3352,10,10,4,22,30,57,-27,34
FC Salzburg,3353,1,22,5,9,64,29,35,71
SK Sturm Gra,3353,2,18,9,9,56,34,22,63
Rapid Vienna,3353,3,16,10,10,57,38,19,58
SC Rheindorf,3353,4,17,7,12,54,46,8,58
Vienna,3353,5,15,10,11,57,52,5,55
RZ Pellets W,3353,6,15,7,14,46,49,-3,52
Admira Wacke,3353,7,13,5,18,41,55,-14,44
SV Josko Rie,3353,8,10,9,17,30,48,-18,39
Mattersburg,3353,9,7,9,20,32,53,-21,30
St. Pölten,3353,10,7,9,20,33,66,-33,30
FC Salzburg,3354,1,22,7,7,66,27,39,73
SK Sturm Gra,3354,2,23,4,9,67,32,35,73
SC Rheindorf,3354,3,22,5,9,63,45,18,71
Vienna,3354,4,20,2,14,65,50,15,62
Rapid Vienna,3354,5,15,8,13,63,46,17,53
RZ Pellets W,3354,6,12,7,17,47,60,-13,43
St. Pölten,3354,7,10,8,18,50,75,-25,38
Admira Wacke,3354,8,10,7,19,39,67,-28,37
SV Josko Rie,3354,9,10,4,22,33,59,-26,34
Mattersburg,3354,10,6,8,22,29,61,-32,26
FC Salzburg,3355,1,20,6,10,58,29,29,66
Vienna,3355,2,19,7,10,63,46,17,64
SK Sturm Gra,3355,3,18,9,9,59,36,23,63
SC Rheindorf,3355,4,17,9,10,51,44,7,60
Rapid Vienna,3355,5,15,12,9,56,35,21,57
Mattersburg,3355,6,14,7,15,38,45,-7,49
RZ Pellets W,3355,7,11,7,18,44,58,-14,40
SV Josko Rie,3355,8,11,4,21,31,52,-21,37
Admira Wacke,3355,9,9,9,18,33,58,-25,36
St. Pölten,3355,10,6,10,20,34,64,-30,28
SC Rheindorf,3356,1,20,7,9,63,45,18,67
FC Salzburg,3356,2,19,8,9,60,36,24,65
Vienna,3356,3,19,6,11,65,52,13,63
SK Sturm Gra,3356,4,18,6,12,59,38,21,60
Rapid Vienna,3356,5,15,10,11,57,40,17,55
Admira Wacke,3356,6,16,4,16,47,57,-10,52
RZ Pellets W,3356,7,11,7,18,44,60,-16,40
St. Pölten,3356,8,9,10,17,43,60,-17,37
Mattersburg,3356,9,9,10,17,37,57,-20,37
SV Josko Rie,3356,10,8,4,24,35,65,-30,28
FC Salzburg,3357,1,19,9,8,63,34,29,66
SC Rheindorf,3357,2,19,7,10,59,41,18,64
SK Sturm Gra,3357,3,18,8,10,62,34,28,62
Vienna,3357,4,18,6,12,57,50,7,60
RZ Pellets W,3357,5,15,5,16,51,55,-4,50
Admira Wacke,3357,6,11,8,17,37,57,-20,41
SV Josko Rie,3357,7,12,5,19,33,56,-23,41
Rapid Vienna,3357,8,9,13,14,45,46,-1,40
St. Pölten,3357,9,10,9,17,44,61,-17,39
Mattersburg,3357,10,11,6,19,43,60,-17,39
FC Salzburg,3358,1,23,7,6,68,28,40,76
SC Rheindorf,3358,2,20,7,9,57,42,15,67
Vienna,3358,3,21,3,12,66,51,15,66
SK Sturm Gra,3358,4,20,5,11,61,39,22,65
Rapid Vienna,3358,5,16,9,11,58,37,21,57
St. Pölten,3358,6,11,6,19,45,62,-17,39
SV Josko Rie,3358,7,11,5,20,34,55,-21,38
Admira Wacke,3358,8,11,4,21,37,66,-29,37
RZ Pellets W,3358,9,9,6,21,40,65,-25,33
Mattersburg,3358,10,8,8,20,34,55,-21,32
SC Rheindorf,3359,1,23,5,8,60,40,20,74
SK Sturm Gra,3359,2,22,4,10,64,32,32,70
FC Salzburg,3359,3,20,8,8,65,35,30,68
Vienna,3359,4,19,2,15,64,52,12,59
Rapid Vienna,3359,5,11,13,12,52,48,4,46
St. Pölten,3359,6,10,11,15,41,55,-14,41
RZ Pellets W,3359,7,12,5,19,45,62,-17,41
Admira Wacke,3359,8,10,8,18,34,68,-34,38
Mattersburg,3359,9,9,8,19,48,57,-9,35
SV Josko Rie,3359,10,9,6,21,32,56,-24,33
FC Salzburg,3360,1,21,6,9,66,32,34,69
Vienna,3360,2,21,6,9,71,49,22,69
SC Rheindorf,3360,3,18,11,7,58,39,19,65
SK Sturm Gra,3360,4,17,7,12,57,37,20,58
Rapid Vienna,3360,5,14,11,11,54,42,12,53
SV Josko Rie,3360,6,12,7,17,45,59,-14,43
Admira Wacke,3360,7,12,5,19,36,69,-33,41
RZ Pellets W,3360,8,10,10,16,46,58,-12,40
Mattersburg,3360,9,10,7,19,41,58,-17,37
St. Pölten,3360,10,7,6,23,39,70,-31,27
FC Salzburg,3361,1,21,8,7,67,30,37,71
SC Rheindorf,3361,2,21,7,8,57,38,19,70
SK Sturm Gra,3361,3,18,7,11,57,39,18,61
Vienna,3361,4,19,4,13,69,55,14,61
Rapid Vienna,3361,5,14,13,9,51,32,19,55
RZ Pellets W,3361,6,13,6,17,44,60,-16,45
Admira Wacke,3361,7,12,8,16,42,52,-10,44
St. Pölten,3361,8,10,8,18,40,64,-24,38
Mattersburg,3361,9,8,8,20,31,55,-24,32
SV Josko Rie,3361,10,8,3,25,23,56,-33,27
FC Salzburg,3362,1,20,7,9,65,35,30,67
Vienna,3362,2,20,5,11,66,48,18,65
SC Rheindorf,3362,3,19,6,11,53,44,9,63
SK Sturm Gra,3362,4,18,8,10,58,31,27,62
Rapid Vienna,3362,5,14,13,9,59,35,24,55
RZ Pellets W,3362,6,13,9,14,41,52,-11,48
SV Josko Rie,3362,7,12,6,18,33,52,-19,42
Admira Wacke,3362,8,11,5,20,40,68,-28,38
Mattersburg,3362,9,9,7,20,40,61,-21,34
St. Pölten,3362,10,5,12,19,36,65,-29,27
SC Rheindorf,3363,1,20,8,8,58,40,18,68
SK Sturm Gra,3363,2,19,9,8,64,33,31,66
FC Salzburg,3363,3,16,12,8,60,36,24,60
Vienna,3363,4,17,6,13,62,55,7,57
Rapid Vienna,3363,5,13,14,9,53,41,12,53
RZ Pellets W,3363,6,14,8,14,53,56,-3,50
SV Josko Rie,3363,7,13,7,16,42,51,-9,46
Admira Wacke,3363,8,10,6,20,31,60,-29,36
Mattersburg,3363,9,6,12,18,40,61,-21,30
St. Pölten,3363,10,7,8,21,40,70,-30,29
FC Salzburg,3364,1,21,7,8,66,31,35,70
SC Rheindorf,3364,2,20,10,6,59,39,20,70
SK Sturm Gra,3364,3,19,8,9,60,30,30,65
Vienna,3364,4,17,5,14,53,50,3,56
Rapid Vienna,3364,5,14,12,10,52,39,13,54
RZ Pellets W,3364,6,13,5,18,45,58,-13,44
Admira Wacke,3364,7,11,8,17,39,62,-23,41
Mattersburg,3364,8,9,10,17,40,57,-17,37
SV Josko Rie,3364,9,8,7,21,32,54,-22,31
St. Pölten,3364,10,7,10,19,41,67,-26,31
SC Rheindorf,3365,1,23,7,6,60,38,22,76
FC Salzburg,3365,2,23,6,7,70,31,39,75
Vienna,3365,3,20,4,12,67,53,14,64
SK Sturm Gra,3365,4,18,8,10,61,37,24,62
Rapid Vienna,3365,5,12,12,12,56,44,12,48
SV Josko Rie,3365,6,13,4,19,42,57,-15,43
RZ Pellets W,3365,7,10,10,16,47,64,-17,40
Mattersburg,3365,8,9,6,21,42,68,-26,33
Admira Wacke,3365,9,8,8,20,38,64,-26,32
St. Pölten,3365,10,7,9,20,39,66,-27,30
SK Sturm Gra,3366,1,23,4,9,75,29,46,73
FC Salzburg,3366,2,21,9,6,68,26,42,72
Vienna,3366,3,19,8,9,60,48,12,65
SC Rheindorf,3366,4,15,11,10,49,49,0,56
Rapid Vienna,3366,5,11,12,13,55,47,8,45
Admira Wacke,3366,6,12,9,15,42,66,-24,45
RZ Pellets W,3366,7,11,8,17,53,70,-17,41
SV Josko Rie,3366,8,9,8,19,33,53,-20,35
Mattersburg,3366,9,8,10,18,41,57,-16,34
St. Pölten,3366,10,6,11,19,46,77,-31,29
FC Salzburg,3367,1,20,8,8,64,27,37,68
SC Rheindorf,3367,2,19,8,9,54,41,13,65
Vienna,3367,3,18,5,13,59,56,3,59
Rapid Vienna,3367,4,16,10,10,56,35,21,58
SK Sturm Gra,3367,5,16,6,14,57,45,12,54
RZ Pellets W,3367,6,14,8,14,44,46,-2,50
Admira Wacke,3367,7,12,7,17,41,62,-21,43
St. Pölten,3367,8,8,13,15,37,60,-23,37
SV Josko Rie,3367,9,9,8,19,34,56,-22,35
Mattersburg,3367,10,8,7,21,40,58,-18,31
FC Salzburg,3368,1,20,10,6,74,30,44,70
SC Rheindorf,3368,2,19,9,8,56,41,15,66
SK Sturm Gra,3368,3,19,7,10,58,34,24,64
Rapid Vienna,3368,4,16,11,9,59,42,17,59
Vienna,3368,5,16,7,13,55,51,4,55
RZ Pellets W,3368,6,13,7,16,41,48,-7,46
Admira Wacke,3368,7,11,7,18,38,63,-25,40
SV Josko Rie,3368,8,11,4,21,35,55,-20,37
Mattersburg,3368,9,10,6,20,31,55,-24,36
St. Pölten,3368,10,6,10,20,43,71,-28,28
FC Salzburg,3369,1,22,10,4,64,24,40,76
SC Rheindorf,3369,2,20,9,7,50,35,15,69
SK Sturm Gra,3369,3,18,7,11,59,32,27,61
Vienna,3369,4,16,8,12,56,53,3,56
Rapid Vienna,3369,5,13,10,13,51,40,11,49
RZ Pellets W,3369,6,13,9,14,44,51,-7,48
SV Josko Rie,3369,7,10,7,19,35,52,-17,37
Admira Wacke,3369,8,10,6,20,36,63,-27,36
St. Pölten,3369,9,8,11,17,38,59,-21,35
Mattersburg,3369,10,7,9,20,35,59,-24,30
FC Salzburg,3370,1,25,7,4,87,29,58,82
SC Rheindorf,3370,2,19,9,8,58,44,14,66
Vienna,3370,3,19,7,10,66,56,10,64
SK Sturm Gra,3370,4,18,8,10,67,45,22,62
RZ Pellets W,3370,5,15,5,16,55,52,3,50
Rapid Vienna,3370,6,12,11,13,55,50,5,47
Admira Wacke,3370,7,11,5,20,42,65,-23,38
SV Josko Rie,3370,8,10,4,22,33,62,-29,34
St. Pölten,3370,9,8,8,20,43,72,-29,32
Mattersburg,3370,10,7,8,21,33,64,-31,29
SK Sturm Gra,3371,1,22,5,9,60,30,30,71
FC Salzburg,3371,2,21,6,9,62,30,32,69
Vienna,3371,3,21,4,11,58,45,13,67
SC Rheindorf,3371,4,18,9,9,55,41,14,63
Rapid Vienna,3371,5,13,8,15,52,47,5,47
SV Josko Rie,3371,6,12,5,19,35,49,-14,41
RZ Pellets W,3371,7,10,10,16,42,54,-12,40
Mattersburg,3371,8,9,9,18,39,58,-19,36
St. Pölten,3371,9,9,9,18,44,64,-20,36
Admira Wacke,3371,10,10,5,21,35,64,-29,35
FC Salzburg,3372,1,19,8,9,56,31,25,65
Vienna,3372,2,19,4,13,57,44,13,61
SC Rheindorf,3372,3,17,10,9,56,45,11,61
Rapid Vienna,3372,4,17,9,10,63,38,25,60
SK Sturm Gra,3372,5,18,5,13,59,37,22,59
RZ Pellets W,3372,6,13,7,16,45,57,-12,46
SV Josko Rie,3372,7,14,3,19,34,50,-16,45
St. Pölten,3372,8,9,12,15,51,66,-15,39
Admira Wacke,3372,9,11,5,20,39,64,-25,38
Mattersburg,3372,10,7,9,20,31,59,-28,30
SC Rheindorf,3373,1,21,8,7,51,35,16,71
FC Salzburg,3373,2,20,6,10,62,36,26,66
Vienna,3373,3,19,6,11,57,45,12,63
SK Sturm Gra,3373,4,19,5,12,66,37,29,62
Rapid Vienna,3373,5,14,10,12,60,41,19,52
RZ Pellets W,3373,6,13,9,14,46,52,-6,48
Admira Wacke,3373,7,12,7,17,39,60,-21,43
Mattersburg,3373,8,11,9,16,40,52,-12,42
SV Josko Rie,3373,9,8,5,23,27,62,-35,29
St. Pölten,3373,10,6,9,21,34,62,-28,27
FC Salzburg,3374,1,23,6,7,65,25,40,75
SC Rheindorf,3374,2,21,5,10,59,42,17,68
SK Sturm Gra,3374,3,17,10,9,52,31,21,61
Vienna,3374,4,18,5,13,74,54,20,59
Rapid Vienna,3374,5,13,10,13,53,42,11,49
RZ Pellets W,3374,6,12,8,16,41,56,-15,44
SV Josko Rie,3374,7,13,5,18,35,55,-20,44
Mattersburg,3374,8,10,10,16,37,52,-15,40
St. Pölten,3374,9,8,10,18,36,62,-26,34
Admira Wacke,3374,10,8,5,23,33,66,-33,29
SC Rheindorf,3375,1,22,6,8,56,39,17,72
Vienna,3375,2,22,5,9,71,47,24,71
FC Salzburg,3375,3,20,7,9,70,33,37,67
SK Sturm Gra,3375,4,20,5,11,66,43,23,65
Rapid Vienna,3375,5,14,9,13,56,41,15,51
RZ Pellets W,3375,6,13,5,18,40,57,-17,44
Admira Wacke,3375,7,11,5,20,35,65,-30,38
St. Pölten,3375,8,9,9,18,44,61,-17,36
Mattersburg,3375,9,9,7,20,37,62,-25,34
SV Josko Rie,3375,10,8,6,22,39,66,-27,30
FC Salzburg,3376,1,22,4,10,73,31,42,70
SK Sturm Gra,3376,2,20,7,9,61,31,30,67
Rapid Vienna,3376,3,17,9,10,61,39,22,60
SC Rheindorf,3376,4,18,6,12,46,45,1,60
Vienna,3376,5,16,7,13,54,49,5,55
Admira Wacke,3376,6,15,5,16,42,55,-13,50
RZ Pellets W,3376,7,11,8,17,43,57,-14,41
St. Pölten,3376,8,9,10,17,36,54,-18,37
Mattersburg,3376,9,9,7,20,41,62,-21,34
SV Josko Rie,3376,10,10,3,23,32,66,-34,33
FC Salzburg,3377,1,20,10,6,62,24,38,70
SC Rheindorf,3377,2,20,10,6,57,38,19,70
Vienna,3377,3,18,8,10,70,51,19,62
SK Sturm Gra,3377,4,18,6,12,60,36,24,60
Rapid Vienna,3377,5,13,12,11,55,41,14,51
RZ Pellets W,3377,6,11,11,14,41,50,-9,44
SV Josko Rie,3377,7,12,5,19,34,55,-21,41
Admira Wacke,3377,8,11,4,21,30,64,-34,37
Mattersburg,3377,9,7,11,18,31,52,-21,32
St. Pölten,3377,10,5,13,18,35,64,-29,28
SC Rheindorf,3378,1,21,7,8,62,38,24,70
FC Salzburg,3378,2,19,8,9,67,35,32,65
SK Sturm Gra,3378,3,20,4,12,56,37,19,64
Vienna,3378,4,19,6,11,67,55,12,63
RZ Pellets W,3378,5,15,5,16,55,57,-2,50
Rapid Vienna,3378,6,12,10,14,52,44,8,46
SV Josko Rie,3378,7,13,2,21,32,52,-20,41
Admira Wacke,3378,8,12,4,20,34,59,-25,40
St. Pölten,3378,9,9,8,19,40,67,-27,35
Mattersburg,3378,10,7,12,17,35,56,-21,33
FC Salzburg,3379,1,22,5,9,62,28,34,71
SK Sturm Gra,3379,2,20,7,9,60,30,30,67
SC Rheindorf,3379,3,18,8,10,50,42,8,62
Vienna,3379,4,18,5,13,63,55,8,59
RZ Pellets W,3379,5,15,6,15,47,55,-8,51
Rapid Vienna,3379,6,13,11,12,56,45,11,50
SV Josko Rie,3379,7,11,7,18,42,54,-12,40
St. Pölten,3379,8,9,8,19,41,61,-20,35
Mattersburg,3379,9,7,13,16,36,53,-17,34
Admira Wacke,3379,10,9,6,21,30,64,-34,33
SK Sturm Gra,3380,1,21,6,9,62,32,30,69
SC Rheindorf,3380,2,18,8,10,48,43,5,62
FC Salzburg,3380,3,17,9,10,57,34,23,60
Vienna,3380,4,18,5,13,52,47,5,59
Rapid Vienna,3380,5,14,9,13,54,43,11,51
SV Josko Rie,3380,6,15,3,18,46,49,-3,48
Admira Wacke,3380,7,13,7,16,41,55,-14,46
RZ Pellets W,3380,8,11,8,17,45,60,-15,41
Mattersburg,3380,9,9,12,15,40,56,-16,39
St. Pölten,3380,10,5,11,20,38,64,-26,26
SK Sturm Gra,3381,1,23,6,7,70,33,37,75
FC Salzburg,3381,2,20,8,8,65,39,26,68
SC Rheindorf,3381,3,19,9,8,58,41,17,66
Vienna,3381,4,19,5,12,68,52,16,62
Rapid Vienna,3381,5,14,13,9,60,46,14,55
RZ Pellets W,3381,6,11,6,19,40,58,-18,39
Admira Wacke,3381,7,11,5,20,47,72,-25,38
SV Josko Rie,3381,8,8,12,16,39,56,-17,36
Mattersburg,3381,9,7,9,20,40,60,-20,30
St. Pölten,3381,10,6,11,19,38,68,-30,29
SK Sturm Gra,3382,1,21,7,8,60,28,32,70
FC Salzburg,3382,2,20,8,8,66,32,34,68
SC Rheindorf,3382,3,19,7,10,55,42,13,64
Vienna,3382,4,17,3,16,56,55,1,54
Rapid Vienna,3382,5,14,10,12,57,42,15,52
Admira Wacke,3382,6,12,8,16,45,59,-14,44
SV Josko Rie,3382,7,12,5,19,34,51,-17,41
RZ Pellets W,3382,8,11,8,17,43,63,-20,41
Mattersburg,3382,9,11,6,19,44,61,-17,39
St. Pölten,3382,10,8,8,20,40,67,-27,32
FC Salzburg,3383,1,23,6,7,62,29,33,75
SC Rheindorf,3383,2,20,7,9,48,35,13,67
Vienna,3383,3,19,5,12,60,46,14,62
Rapid Vienna,3383,4,17,9,10,58,33,25,60
SK Sturm Gra,3383,5,16,9,11,50,33,17,57
RZ Pellets W,3383,6,11,6,19,38,52,-14,39
Admira Wacke,3383,7,11,5,20,32,60,-28,38
SV Josko Rie,3383,8,10,7,19,29,48,-19,37
Mattersburg,3383,9,9,8,19,32,53,-21,35
St. Pölten,3383,10,8,10,18,39,59,-20,34
SC Rheindorf,3384,1,20,7,9,62,43,19,67
SK Sturm Gra,3384,2,19,9,8,56,26,30,66
FC Salzburg,3384,3,18,8,10,58,35,23,62
Rapid Vienna,3384,4,15,11,10,51,35,16,56
Vienna,3384,5,15,8,13,60,60,0,53
Mattersburg,3384,6,11,10,15,42,53,-11,43
Admira Wacke,3384,7,12,7,17,38,54,-16,43
RZ Pellets W,3384,8,10,8,18,41,61,-20,38
SV Josko Rie,3384,9,9,9,18,32,50,-18,36
St. Pölten,3384,10,6,13,17,34,57,-23,31
FC Salzburg,3385,1,21,8,7,66,32,34,71
SC Rheindorf,3385,2,20,8,8,59,43,16,68
Vienna,3385,3,20,4,12,73,51,22,64
SK Sturm Gra,3385,4,17,6,13,52,39,13,57
Rapid Vienna,3385,5,13,8,15,59,46,13,47
Admira Wacke,3385,6,13,8,15,40,55,-15,47
SV Josko Rie,3385,7,12,6,18,34,57,-23,42
RZ Pellets W,3385,8,11,8,17,54,58,-4,41
St. Pölten,3385,9,8,11,17,43,66,-23,35
Mattersburg,3385,10,8,7,21,33,66,-33,31
FC Salzburg,3386,1,22,8,6,63,27,36,74
SC Rheindorf,3386,2,20,6,10,52,36,16,66
Vienna,3386,3,20,4,12,71,49,22,64
Rapid Vienna,3386,4,16,9,11,55,37,18,57
SK Sturm Gra,3386,5,16,6,14,50,41,9,54
SV Josko Rie,3386,6,14,4,18,42,51,-9,46
Admira Wacke,3386,7,11,7,18,36,57,-21,40
RZ Pellets W,3386,8,9,11,16,44,65,-21,38
Mattersburg,3386,9,8,11,17,33,52,-19,35
St. Pölten,3386,10,7,8,21,32,63,-31,29
FC Salzburg,3387,1,21,9,6,62,31,31,72
SC Rheindorf,3387,2,19,10,7,55,37,18,67
SK Sturm Gra,3387,3,18,10,8,67,43,24,64
Vienna,3387,4,19,4,13,61,50,11,61
Rapid Vienna,3387,5,13,13,10,56,37,19,52
Admira Wacke,3387,6,12,6,18,42,71,-29,42
RZ Pellets W,3387,7,11,5,20,40,54,-14,38
SV Josko Rie,3387,8,10,6,20,35,51,-16,36
Mattersburg,3387,9,7,13,16,33,48,-15,34
St. Pölten,3387,10,7,10,19,41,70,-29,31
FC Salzburg,3388,1,19,11,6,68,32,36,68
SC Rheindorf,3388,2,19,11,6,59,41,18,68
SK Sturm Gra,3388,3,17,12,7,62,35,27,63
Vienna,3388,4,17,6,13,54,47,7,57
Rapid Vienna,3388,5,11,14,11,56,48,8,47
RZ Pellets W,3388,6,13,6,17,49,63,-14,45
St. Pölten,3388,7,9,12,15,43,55,-12,39
Mattersburg,3388,8,7,14,15,39,55,-16,35
Admira Wacke,3388,9,9,8,19,35,65,-30,35
SV Josko Rie,3388,10,10,4,22,32,56,-24,34
FC Salzburg,3389,1,22,5,9,64,31,33,71
SK Sturm Gra,3389,2,21,5,10,62,27,35,68
SC Rheindorf,3389,3,20,6,10,54,43,11,66
Vienna,3389,4,19,5,12,67,56,11,62
Rapid Vienna,3389,5,15,10,11,58,40,18,55
Mattersburg,3389,6,11,7,18,44,59,-15,40
Admira Wacke,3389,7,11,5,20,33,65,-32,38
RZ Pellets W,3389,8,10,7,19,39,57,-18,37
St. Pölten,3389,9,9,10,17,40,59,-19,37
SV Josko Rie,3389,10,10,4,22,37,61,-24,34
SK Sturm Gra,3390,1,21,7,8,65,32,33,70
FC Salzburg,3390,2,21,6,9,63,30,33,69
SC Rheindorf,3390,3,19,9,8,57,37,20,66
Vienna,3390,4,17,7,12,61,51,10,58
Rapid Vienna,3390,5,12,14,10,53,44,9,50
Admira Wacke,3390,6,13,6,17,42,60,-18,45
RZ Pellets W,3390,7,9,9,18,39,60,-21,36
St. Pölten,3390,8,8,12,16,39,62,-23,36
Mattersburg,3390,9,7,13,16,36,54,-18,34
SV Josko Rie,3390,10,10,3,23,29,54,-25,33
FC Salzburg,3391,1,25,7,4,73,22,51,82
SC Rheindorf,3391,2,21,7,8,54,39,15,70
SK Sturm Gra,3391,3,18,9,9,61,33,28,63
Vienna,3391,4,18,6,12,63,58,5,60
Rapid Vienna,3391,5,11,12,13,48,47,1,45
Admira Wacke,3391,6,11,12,13,41,48,-7,45
RZ Pellets W,3391,7,10,9,17,45,60,-15,39
Mattersburg,3391,8,7,12,17,32,51,-19,33
SV Josko Rie,3391,9,8,6,22,25,53,-28,30
St. Pölten,3391,10,6,10,20,35,66,-31,28
FC Salzburg,3392,1,22,9,5,66,28,38,75
SK Sturm Gra,3392,2,21,6,9,61,35,26,69
SC Rheindorf,3392,3,21,6,9,68,49,19,69
Rapid Vienna,3392,4,15,12,9,60,41,19,57
Vienna,3392,5,15,10,11,64,52,12,55
St. Pölten,3392,6,10,9,17,44,65,-21,39
Admira Wacke,3392,7,10,8,18,44,62,-18,38
SV Josko Rie,3392,8,10,6,20,32,55,-23,36
Mattersburg,3392,9,8,9,19,36,60,-24,33
RZ Pellets W,3392,10,7,7,22,45,73,-28,28
FC Salzburg,3393,1,22,8,6,69,29,40,74
SC Rheindorf,3393,2,21,7,8,57,41,16,70
SK Sturm Gra,3393,3,18,10,8,56,33,23,64
Vienna,3393,4,20,4,12,60,48,12,64
Rapid Vienna,3393,5,12,11,13,51,42,9,47
RZ Pellets W,3393,6,11,8,17,44,56,-12,41
Admira Wacke,3393,7,11,8,17,40,59,-19,41
SV Josko Rie,3393,8,10,8,18,37,56,-19,38
St. Pölten,3393,9,7,9,20,39,64,-25,30
Mattersburg,3393,10,7,9,20,36,61,-25,30
FC Salzburg,3394,1,21,8,7,71,34,37,71
Vienna,3394,2,20,7,9,69,51,18,67
SC Rheindorf,3394,3,18,12,6,53,35,18,66
SK Sturm Gra,3394,4,20,5,11,65,33,32,65
Rapid Vienna,3394,5,14,10,12,56,43,13,52
RZ Pellets W,3394,6,12,5,19,47,62,-15,41
Mattersburg,3394,7,10,9,17,41,56,-15,39
Admira Wacke,3394,8,10,5,21,29,67,-38,35
St. Pölten,3394,9,9,7,20,41,68,-27,34
SV Josko Rie,3394,10,9,6,21,35,58,-23,33
FC Salzburg,3395,1,23,6,7,62,25,37,75
SK Sturm Gra,3395,2,22,5,9,63,31,32,71
SC Rheindorf,3395,3,19,9,8,55,41,14,66
Vienna,3395,4,17,4,15,62,58,4,55
Rapid Vienna,3395,5,14,10,12,57,38,19,52
RZ Pellets W,3395,6,15,7,14,55,52,3,52
Admira Wacke,3395,7,10,7,19,34,58,-24,37
SV Josko Rie,3395,8,11,4,21,33,58,-25,37
Mattersburg,3395,9,8,7,21,39,66,-27,31
St. Pölten,3395,10,8,7,21,33,66,-33,31
FC Salzburg,3396,1,23,8,5,70,30,40,77
SK Sturm Gra,3396,2,20,6,10,64,41,23,66
SC Rheindorf,3396,3,18,7,11,55,44,11,61
Vienna,3396,4,18,5,13,64,55,9,59
RZ Pellets W,3396,5,13,9,14,48,53,-5,48
Rapid Vienna,3396,6,11,12,13,53,43,10,45
Admira Wacke,3396,7,12,7,17,43,65,-22,43
Mattersburg,3396,8,10,9,17,40,58,-18,39
SV Josko Rie,3396,9,9,5,22,40,63,-23,32
St. Pölten,3396,10,8,8,20,42,67,-25,32
FC Salzburg,3397,1,23,6,7,70,32,38,75
SK Sturm Gra,3397,2,19,8,9,57,32,25,65
SC Rheindorf,3397,3,18,7,11,51,43,8,61
Rapid Vienna,3397,4,16,11,9,66,45,21,59
Vienna,3397,5,17,4,15,61,56,5,55
St. Pölten,3397,6,10,13,13,48,57,-9,43
Admira Wacke,3397,7,12,6,18,45,65,-20,42
RZ Pellets W,3397,8,10,8,18,39,58,-19,38
Mattersburg,3397,9,8,9,19,36,56,-20,33
SV Josko Rie,3397,10,9,4,23,30,59,-29,31
FC Salzburg,3398,1,20,6,10,68,40,28,66
SK Sturm Gra,3398,2,19,9,8,65,37,28,66
SC Rheindorf,3398,3,19,9,8,58,40,18,66
Vienna,3398,4,16,6,14,56,55,1,54
Rapid Vienna,3398,5,12,13,11,52,45,7,49
Admira Wacke,3398,6,12,8,16,40,60,-20,44
RZ Pellets W,3398,7,9,12,15,38,49,-11,39
SV Josko Rie,3398,8,10,7,19,34,54,-20,37
Mattersburg,3398,9,8,12,16,35,50,-15,36
St. Pölten,3398,10,6,16,14,41,57,-16,34
FC Salzburg,3399,1,20,8,8,64,30,34,68
Vienna,3399,2,21,5,10,70,52,18,68
SK Sturm Gra,3399,3,21,3,12,67,39,28,66
SC Rheindorf,3399,4,17,9,10,63,55,8,60
Rapid Vienna,3399,5,15,9,12,56,42,14,54
RZ Pellets W,3399,6,13,9,14,48,54,-6,48
SV Josko Rie,3399,7,11,5,20,37,53,-16,38
Admira Wacke,3399,8,10,5,21,34,69,-35,35
Mattersburg,3399,9,7,12,17,33,55,-22,33
St. Pölten,3399,10,6,13,17,40,63,-23,31
FC Salzburg,3400,1,21,8,7,57,25,32,71
SK Sturm Gra,3400,2,21,5,10,57,31,26,68
Vienna,3400,3,18,6,12,61,45,16,60
SC Rheindorf,3400,4,18,6,12,49,41,8,60
RZ Pellets W,3400,5,14,8,14,52,51,1,50
Rapid Vienna,3400,6,12,11,13,48,38,10,47
SV Josko Rie,3400,7,12,8,16,37,46,-9,44
St. Pölten,3400,8,9,11,16,38,56,-18,38
Admira Wacke,3400,9,10,8,18,37,66,-29,38
Mattersburg,3400,10,5,9,22,27,64,-37,24
FC Salzburg,3401,1,21,7,8,57,31,26,70
SC Rheindorf,3401,2,19,8,9,52,44,8,65
Rapid Vienna,3401,3,18,10,8,67,33,34,64
SK Sturm Gra,3401,4,19,7,10,55,30,25,64
Vienna,3401,5,17,5,14,63,60,3,56
Admira Wacke,3401,6,13,6,17,42,57,-15,45
RZ Pellets W,3401,7,10,7,19,49,69,-20,37
Mattersburg,3401,8,10,6,20,47,62,-15,36
St. Pölten,3401,9,9,8,19,43,70,-27,35
SV Josko Rie,3401,10,10,4,22,36,55,-19,34
FC Salzburg,3402,1,21,9,6,72,38,34,72
SC Rheindorf,3402,2,20,9,7,60,38,22,69
SK Sturm Gra,3402,3,19,8,9,63,35,28,65
Rapid Vienna,3402,4,15,10,11,55,40,15,55
Vienna,3402,5,17,3,16,59,55,4,54
RZ Pellets W,3402,6,15,7,14,52,51,1,52
Admira Wacke,3402,7,12,4,20,37,61,-24,40
Mattersburg,3402,8,8,10,18,34,53,-19,34
St. Pölten,3402,9,8,8,20,38,73,-35,32
SV Josko Rie,3402,10,9,4,23,38,64,-26,31
SK Sturm Gra,3403,1,22,4,10,65,37,28,70
FC Salzburg,3403,2,20,9,7,60,29,31,69
Vienna,3403,3,19,4,13,63,55,8,61
SC Rheindorf,3403,4,18,7,11,52,49,3,61
Rapid Vienna,3403,5,16,8,12,58,36,22,56
RZ Pellets W,3403,6,13,5,18,51,64,-13,44
St. Pölten,3403,7,12,7,17,49,63,-14,43
Admira Wacke,3403,8,11,6,19,35,56,-21,39
SV Josko Rie,3403,9,11,5,20,43,57,-14,38
Mattersburg,3403,10,6,9,21,28,58,-30,27
SK Sturm Gra,3404,1,23,5,8,69,31,38,74
FC Salzburg,3404,2,17,11,8,59,35,24,62
SC Rheindorf,3404,3,16,10,10,52,45,7,58
Vienna,3404,4,17,5,14,64,57,7,56
Rapid Vienna,3404,5,15,10,11,58,39,19,55
RZ Pellets W,3404,6,14,7,15,50,53,-3,49
Admira Wacke,3404,7,12,8,16,32,53,-21,44
Mattersburg,3404,8,9,9,18,35,51,-16,36
SV Josko Rie,3404,9,9,8,19,30,52,-22,35
St. Pölten,3404,10,7,9,20,36,69,-33,30
SC Rheindorf,3405,1,21,8,7,56,38,18,71
SK Sturm Gra,3405,2,20,7,9,63,31,32,67
Rapid Vienna,3405,3,18,11,7,65,33,32,65
FC Salzburg,3405,4,17,8,11,58,34,24,59
Vienna,3405,5,18,4,14,59,57,2,58
SV Josko Rie,3405,6,14,5,17,43,49,-6,47
RZ Pellets W,3405,7,12,8,16,50,52,-2,44
St. Pölten,3405,8,8,9,19,39,64,-25,33
Admira Wacke,3405,9,9,5,22,32,73,-41,32
Mattersburg,3405,10,8,5,23,33,67,-34,29
SC Rheindorf,3406,1,21,8,7,49,34,15,71
FC Salzburg,3406,2,20,9,7,63,31,32,69
SK Sturm Gra,3406,3,19,6,11,58,34,24,63
Vienna,3406,4,17,6,13,61,53,8,57
Rapid Vienna,3406,5,12,13,11,58,45,13,49
RZ Pellets W,3406,6,13,7,16,47,60,-13,46
Mattersburg,3406,7,9,10,17,41,55,-14,37
SV Josko Rie,3406,8,11,4,21,37,52,-15,37
Admira Wacke,3406,9,10,7,19,34,59,-25,37
St. Pölten,3406,10,9,8,19,44,69,-25,35
SC Rheindorf,3407,1,21,7,8,59,39,20,70
FC Salzburg,3407,2,20,8,8,65,34,31,68
SK Sturm Gra,3407,3,20,5,11,61,38,23,65
Vienna,3407,4,20,5,11,68,47,21,65
Rapid Vienna,3407,5,14,8,14,54,48,6,50
RZ Pellets W,3407,6,11,11,14,47,54,-7,44
Admira Wacke,3407,7,13,5,18,35,54,-19,44
Mattersburg,3407,8,9,9,18,37,52,-15,36
St. Pölten,3407,9,8,9,19,41,65,-24,33
SV Josko Rie,3407,10,8,5,23,31,67,-36,29
FC Salzburg,3408,1,24,6,6,66,27,39,78
Vienna,3408,2,20,6,10,69,50,19,66
SC Rheindorf,3408,3,16,12,8,46,40,6,60
SK Sturm Gra,3408,4,16,7,13,59,43,16,55
Rapid Vienna,3408,5,14,10,12,49,39,10,52
Admira Wacke,3408,6,14,4,18,42,60,-18,46
RZ Pellets W,3408,7,12,7,17,44,53,-9,43
Mattersburg,3408,8,10,8,18,40,51,-11,38
St. Pölten,3408,9,8,11,17,41,61,-20,35
SV Josko Rie,3408,10,8,5,23,31,63,-32,29
SC Rheindorf,3409,1,20,8,8,62,38,24,68
FC Salzburg,3409,2,20,7,9,62,36,26,67
Vienna,3409,3,20,5,11,65,47,18,65
SK Sturm Gra,3409,4,19,6,11,59,37,22,63
Rapid Vienna,3409,5,12,12,12,50,40,10,48
Mattersburg,3409,6,11,10,15,40,53,-13,43
RZ Pellets W,3409,7,11,8,17,49,65,-16,41
Admira Wacke,3409,8,12,5,19,34,60,-26,41
SV Josko Rie,3409,9,9,7,20,39,60,-21,34
St. Pölten,3409,10,8,8,20,41,65,-24,32
FC Salzburg,3410,1,18,11,7,58,30,28,65
SC Rheindorf,3410,2,19,7,10,61,46,15,64
SK Sturm Gra,3410,3,16,8,12,56,39,17,56
Vienna,3410,4,16,8,12,62,55,7,56
Rapid Vienna,3410,5,14,12,10,53,38,15,54
SV Josko Rie,3410,6,14,5,17,42,52,-10,47
St. Pölten,3410,7,11,8,17,45,62,-17,41
RZ Pellets W,3410,8,11,7,18,40,55,-15,40
Admira Wacke,3410,9,10,10,16,34,55,-21,40
Mattersburg,3410,10,8,10,18,36,55,-19,34
SK Sturm Gra,3411,1,20,7,9,58,34,24,67
Vienna,3411,2,20,6,10,64,45,19,66
FC Salzburg,3411,3,18,8,10,61,37,24,62
SC Rheindorf,3411,4,17,8,11,55,46,9,59
Rapid Vienna,3411,5,13,14,9,50,37,13,53
RZ Pellets W,3411,6,14,7,15,48,53,-5,49
Admira Wacke,3411,7,10,12,14,38,51,-13,42
Mattersburg,3411,8,9,8,19,38,56,-18,35
SV Josko Rie,3411,9,10,5,21,31,58,-27,35
St. Pölten,3411,10,6,11,19,39,65,-26,29
SC Rheindorf,3412,1,24,5,7,67,36,31,77
FC Salzburg,3412,2,21,9,6,67,29,38,72
SK Sturm Gra,3412,3,20,6,10,64,36,28,66
Vienna,3412,4,16,8,12,57,47,10,56
RZ Pellets W,3412,5,14,7,15,50,57,-7,49
Rapid Vienna,3412,6,13,8,15,54,49,5,47
Mattersburg,3412,7,11,7,18,38,53,-15,40
Admira Wacke,3412,8,10,8,18,40,67,-27,38
SV Josko Rie,3412,9,8,6,22,31,61,-30,30
St. Pölten,3412,10,7,8,21,41,74,-33,29
FC Salzburg,3413,1,20,8,8,68,28,40,68
SC Rheindorf,3413,2,19,6,11,57,47,10,63
SK Sturm Gra,3413,3,18,8,10,55,36,19,62
Vienna,3413,4,19,5,12,65,54,11,62
Rapid Vienna,3413,5,13,13,10,59,43,16,52
RZ Pellets W,3413,6,13,7,16,48,57,-9,46
Admira Wacke,3413,7,10,9,17,36,62,-26,39
Mattersburg,3413,8,10,8,18,42,61,-19,38
St. Pölten,3413,9,10,8,18,43,64,-21,38
SV Josko Rie,3413,10,9,6,21,31,52,-21,33
FC Salzburg,3414,1,23,8,5,76,27,49,77
SK Sturm Gra,3414,2,23,5,8,66,31,35,74
SC Rheindorf,3414,3,19,8,9,62,41,21,65
Vienna,3414,4,19,5,12,57,48,9,62
Rapid Vienna,3414,5,15,9,12,47,39,8,54
RZ Pellets W,3414,6,11,7,18,41,58,-17,40
Mattersburg,3414,7,9,8,19,37,54,-17,35
Admira Wacke,3414,8,10,4,22,32,61,-29,34
SV Josko Rie,3414,9,10,4,22,32,63,-31,34
St. Pölten,3414,10,8,8,20,40,68,-28,32
SK Sturm Gra,3415,1,23,3,10,68,34,34,72
SC Rheindorf,3415,2,21,5,10,65,49,16,68
FC Salzburg,3415,3,19,7,10,67,40,27,64
Rapid Vienna,3415,4,17,10,9,72,41,31,61
Vienna,3415,5,16,5,15,61,55,6,53
Admira Wacke,3415,6,13,5,18,38,64,-26,44
RZ Pellets W,3415,7,11,9,16,49,60,-11,42
SV Josko Rie,3415,8,10,5,21,35,57,-22,35
St. Pölten,3415,9,9,8,19,41,70,-29,35
Mattersburg,3415,10,9,7,20,39,65,-26,34
FC Salzburg,3416,1,20,9,7,74,38,36,69
SK Sturm Gra,3416,2,21,4,11,64,42,22,67
Vienna,3416,3,21,4,11,67,47,20,67
SC Rheindorf,3416,4,18,9,9,52,41,11,63
Rapid Vienna,3416,5,14,12,10,59,41,18,54
St. Pölten,3416,6,10,9,17,49,65,-16,39
Mattersburg,3416,7,9,10,17,44,58,-14,37
RZ Pellets W,3416,8,9,8,19,41,66,-25,35
Admira Wacke,3416,9,9,8,19,37,63,-26,35
SV Josko Rie,3416,10,9,7,20,31,57,-26,34
FC Salzburg,3417,1,23,7,6,66,31,35,76
SK Sturm Gra,3417,2,21,8,7,72,40,32,71
SC Rheindorf,3417,3,21,6,9,60,48,12,69
Vienna,3417,4,18,6,12,65,50,15,60
Rapid Vienna,3417,5,13,8,15,54,47,7,47
RZ Pellets W,3417,6,11,10,15,51,54,-3,43
Admira Wacke,3417,7,11,5,20,33,61,-28,38
Mattersburg,3417,8,8,11,17,39,58,-19,35
SV Josko Rie,3417,9,8,7,21,29,54,-25,31
St. Pölten,3417,10,7,10,19,42,68,-26,31
SK Sturm Gra,3418,1,21,7,8,63,34,29,70
SC Rheindorf,3418,2,20,9,7,58,41,17,69
FC Salzburg,3418,3,19,9,8,61,28,33,66
Vienna,3418,4,16,7,13,59,55,4,55
Rapid Vienna,3418,5,12,13,11,51,43,8,49
RZ Pellets W,3418,6,13,6,17,57,65,-8,45
Mattersburg,3418,7,9,11,16,35,51,-16,38
Admira Wacke,3418,8,11,5,20,37,57,-20,38
St. Pölten,3418,9,10,7,19,43,66,-23,37
SV Josko Rie,3418,10,10,4,22,36,60,-24,34
FC Salzburg,3419,1,22,7,7,66,33,33,73
SK Sturm Gra,3419,2,22,4,10,56,30,26,70
SC Rheindorf,3419,3,20,5,11,53,44,9,65
Vienna,3419,4,19,5,12,68,45,23,62
Admira Wacke,3419,5,13,3,20,37,54,-17,42
Rapid Vienna,3419,6,11,8,17,51,51,0,41
RZ Pellets W,3419,7,11,8,17,40,53,-13,41
SV Josko Rie,3419,8,11,7,18,39,55,-16,40
Mattersburg,3419,9,11,7,18,35,57,-22,40
St. Pölten,3419,10,8,10,18,34,57,-23,34
FC Salzburg,3420,1,20,8,8,63,30,33,68
SC Rheindorf,3420,2,19,8,9,53,39,14,65
SK Sturm Gra,3420,3,19,7,10,61,36,25,64
Vienna,3420,4,17,7,12,63,51,12,58
Rapid Vienna,3420,5,15,10,11,52,39,13,55
Admira Wacke,3420,6,13,8,15,38,49,-11,47
Mattersburg,3420,7,12,7,17,43,53,-10,43
RZ Pellets W,3420,8,10,7,19,39,57,-18,37
St. Pölten,3420,9,8,10,18,37,65,-28,34
SV Josko Rie,3420,10,8,6,22,27,57,-30,30
SC Rheindorf,3421,1,22,8,6,64,39,25,74
FC Salzburg,3421,2,21,10,5,74,32,42,73
SK Sturm Gra,3421,3,22,4,10,73,40,33,70
Vienna,3421,4,14,8,14,56,55,1,50
Rapid Vienna,3421,5,13,8,15,58,51,7,47
SV Josko Rie,3421,6,12,8,16,38,50,-12,44
RZ Pellets W,3421,7,11,10,15,40,52,-12,43
Admira Wacke,3421,8,10,6,20,36,70,-34,36
St. Pölten,3421,9,6,14,16,39,62,-23,32
Mattersburg,3421,10,6,10,20,35,62,-27,28
FC Salzburg,3422,1,24,7,5,67,25,42,79
SC Rheindorf,3422,2,19,9,8,60,41,19,66
SK Sturm Gra,3422,3,19,5,12,60,34,26,62
Vienna,3422,4,18,5,13,57,52,5,59
Rapid Vienna,3422,5,15,8,13,47,44,3,53
RZ Pellets W,3422,6,13,6,17,44,51,-7,45
Admira Wacke,3422,7,12,7,17,40,54,-14,43
Mattersburg,3422,8,10,8,18,35,50,-15,38
SV Josko Rie,3422,9,9,5,22,29,58,-29,32
St. Pölten,3422,10,6,10,20,33,63,-30,28
FC Salzburg,3423,1,22,7,7,67,28,39,73
SC Rheindorf,3423,2,17,11,8,53,41,12,62
SK Sturm Gra,3423,3,16,13,7,58,31,27,61
Rapid Vienna,3423,4,14,12,10,52,35,17,54
Vienna,3423,5,14,7,15,53,55,-2,49
Admira Wacke,3423,6,13,6,17,37,55,-18,45
RZ Pellets W,3423,7,12,8,16,53,72,-19,44
SV Josko Rie,3423,8,11,8,17,37,50,-13,41
St. Pölten,3423,9,8,10,18,40,60,-20,34
Mattersburg,3423,10,8,8,20,35,58,-23,32
FC Salzburg,3424,1,25,5,6,74,32,42,80
SC Rheindorf,3424,2,21,7,8,63,51,12,70
SK Sturm Gra,3424,3,18,8,10,58,38,20,62
Rapid Vienna,3424,4,14,8,14,55,46,9,50
Vienna,3424,5,14,7,15,55,53,2,49
Admira Wacke,3424,6,14,5,17,45,59,-14,47
RZ Pellets W,3424,7,12,9,15,53,57,-4,45
St. Pölten,3424,8,9,8,19,41,62,-21,35
SV Josko Rie,3424,9,10,5,21,31,54,-23,35
Mattersburg,3424,10,9,6,21,39,62,-23,33
SC Rheindorf,3425,1,24,4,8,63,34,29,76
FC Salzburg,3425,2,22,7,7,71,32,39,73
SK Sturm Gra,3425,3,18,10,8,53,29,24,64
Vienna,3425,4,20,4,12,66,52,14,64
RZ Pellets W,3425,5,12,11,13,46,53,-7,47
Rapid Vienna,3425,6,10,13,13,46,37,9,43
SV Josko Rie,3425,7,11,5,20,30,55,-25,38
Admira Wacke,3425,8,9,8,19,32,59,-27,35
Mattersburg,3425,9,8,9,19,37,61,-24,33
St. Pölten,3425,10,5,11,20,36,68,-32,26
SK Sturm Gra,3426,1,22,5,9,69,36,33,71
FC Salzburg,3426,2,20,7,9,64,33,31,67
SC Rheindorf,3426,3,20,7,9,60,44,16,67
Vienna,3426,4,20,2,14,62,61,1,62
Rapid Vienna,3426,5,16,11,9,65,47,18,59
RZ Pellets W,3426,6,13,4,19,50,64,-14,43
SV Josko Rie,3426,7,11,6,19,42,55,-13,39
Admira Wacke,3426,8,11,4,21,32,61,-29,37
St. Pölten,3426,9,8,10,18,40,58,-18,34
Mattersburg,3426,10,6,10,20,33,58,-25,28
SK Sturm Gra,3427,1,21,6,9,60,36,24,69
FC Salzburg,3427,2,20,5,11,64,38,26,65
Vienna,3427,3,19,6,11,68,51,17,63
SC Rheindorf,3427,4,18,7,11,50,43,7,61
Rapid Vienna,3427,5,14,12,10,57,38,19,54
RZ Pellets W,3427,6,11,9,16,44,59,-15,42
Mattersburg,3427,7,10,8,18,37,52,-15,38
Admira Wacke,3427,8,10,8,18,31,52,-21,38
SV Josko Rie,3427,9,10,7,19,32,53,-21,37
St. Pölten,3427,10,8,10,18,37,58,-21,34
FC Salzburg,3428,1,22,6,8,65,29,36,72
SK Sturm Gra,3428,2,21,6,9,66,35,31,69
Vienna,3428,3,19,6,11,63,54,9,63
SC Rheindorf,3428,4,17,9,10,49,42,7,60
Rapid Vienna,3428,5,14,10,12,58,44,14,52
RZ Pellets W,3428,6,13,9,14,46,48,-2,48
SV Josko Rie,3428,7,13,2,21,36,54,-18,41
Admira Wacke,3428,8,10,6,20,39,68,-29,36
St. Pölten,3428,9,8,10,18,38,63,-25,34
Mattersburg,3428,10,7,8,21,35,58,-23,29
FC Salzburg,3429,1,22,5,9,69,34,35,71
SC Rheindorf,3429,2,20,8,8,54,38,16,68
Vienna,3429,3,18,7,11,67,58,9,61
Rapid Vienna,3429,4,14,9,13,53,40,13,51
SK Sturm Gra,3429,5,14,8,14,51,44,7,50
RZ Pellets W,3429,6,13,6,17,49,56,-7,45
Admira Wacke,3429,7,13,6,17,41,54,-13,45
SV Josko Rie,3429,8,12,7,17,34,52,-18,43
St. Pölten,3429,9,9,9,18,39,59,-20,36
Mattersburg,3429,10,8,9,19,33,55,-22,33
SC Rheindorf,3430,1,19,8,9,60,46,14,65
SK Sturm Gra,3430,2,19,7,10,58,37,21,64
Vienna,3430,3,19,5,12,63,49,14,62
FC Salzburg,3430,4,18,7,11,59,34,25,61
Rapid Vienna,3430,5,14,10,12,59,46,13,52
St. Pölten,3430,6,11,10,15,54,70,-16,43
RZ Pellets W,3430,7,11,9,16,45,55,-10,42
Admira Wacke,3430,8,11,9,16,36,52,-16,42
SV Josko Rie,3430,9,12,5,19,38,53,-15,41
Mattersburg,3430,10,6,10,20,33,63,-30,28
SC Rheindorf,3431,1,24,6,6,59,34,25,78
FC Salzburg,3431,2,20,7,9,63,30,33,67
Vienna,3431,3,20,5,11,59,49,10,65
SK Sturm Gra,3431,4,17,6,13,57,39,18,57
Rapid Vienna,3431,5,14,13,9,51,35,16,55
RZ Pellets W,3431,6,14,5,17,49,58,-9,47
SV Josko Rie,3431,7,10,7,19,33,48,-15,37
St. Pölten,3431,8,9,9,18,39,62,-23,36
Admira Wacke,3431,9,9,6,21,33,64,-31,33
Mattersburg,3431,10,6,10,20,32,56,-24,28
FC Salzburg,3432,1,20,10,6,58,25,33,70
SC Rheindorf,3432,2,20,9,7,50,33,17,69
SK Sturm Gra,3432,3,20,6,10,64,30,34,66
Vienna,3432,4,18,3,15,63,60,3,57
Rapid Vienna,3432,5,12,15,9,56,40,16,51
Admira Wacke,3432,6,11,7,18,36,60,-24,40
RZ Pellets W,3432,7,10,9,17,41,57,-16,39
SV Josko Rie,3432,8,11,5,20,39,58,-19,38
St. Pölten,3432,9,10,8,18,43,66,-23,38
Mattersburg,3432,10,8,8,20,35,56,-21,32
FC Salzburg,3433,1,20,8,8,65,30,35,68
Vienna,3433,2,21,4,11,67,57,10,67
SC Rheindorf,3433,3,17,8,11,53,48,5,59
SK Sturm Gra,3433,4,17,7,12,58,40,18,58
Rapid Vienna,3433,5,13,12,11,55,39,16,51
RZ Pellets W,3433,6,14,8,14,55,49,6,50
Admira Wacke,3433,7,12,7,17,36,58,-22,43
St. Pölten,3433,8,10,9,17,42,66,-24,39
SV Josko Rie,3433,9,9,9,18,32,51,-19,36
Mattersburg,3433,10,7,8,21,36,61,-25,29
FC Salzburg,3434,1,24,8,4,72,31,41,80
SC Rheindorf,3434,2,20,7,9,66,46,20,67
SK Sturm Gra,3434,3,19,4,13,58,36,22,61
Vienna,3434,4,17,9,10,64,57,7,60
Rapid Vienna,3434,5,13,11,12,60,47,13,50
RZ Pellets W,3434,6,14,8,14,46,53,-7,50
Admira Wacke,3434,7,12,8,16,35,55,-20,44
SV Josko Rie,3434,8,10,6,20,38,54,-16,36
Mattersburg,3434,9,7,9,20,35,58,-23,30
St. Pölten,3434,10,5,8,23,34,71,-37,23
FC Salzburg,3435,1,22,6,8,63,28,35,72
SK Sturm Gra,3435,2,21,8,7,69,29,40,71
SC Rheindorf,3435,3,22,5,9,58,42,16,71
Vienna,3435,4,18,6,12,65,58,7,60
Rapid Vienna,3435,5,13,12,11,54,43,11,51
RZ Pellets W,3435,6,12,8,16,51,64,-13,44
SV Josko Rie,3435,7,11,5,20,36,61,-25,38
St. Pölten,3435,8,8,10,18,44,65,-21,34
Admira Wacke,3435,9,9,5,22,37,65,-28,32
Mattersburg,3435,10,7,9,20,36,58,-22,30
SK Sturm Gra,3436,1,23,6,7,62,30,32,75
SC Rheindorf,3436,2,22,5,9,63,43,20,71
FC Salzburg,3436,3,21,7,8,66,35,31,70
Vienna,3436,4,20,4,12,64,49,15,64
Rapid Vienna,3436,5,15,10,11,57,38,19,55
SV Josko Rie,3436,6,13,5,18,40,57,-17,44
RZ Pellets W,3436,7,11,9,16,43,56,-13,42
Admira Wacke,3436,8,9,3,24,33,62,-29,30
Mattersburg,3436,9,6,10,20,32,61,-29,28
St. Pölten,3436,10,5,11,20,35,64,-29,26
Vienna,3437,1,21,4,11,65,45,20,67
FC Salzburg,3437,2,19,8,9,58,32,26,65
SC Rheindorf,3437,3,19,5,12,53,44,9,62
SK Sturm Gra,3437,4,18,6,12,59,42,17,60
Rapid Vienna,3437,5,14,12,10,56,36,20,54
Admira Wacke,3437,6,12,9,15,34,50,-16,45
St. Pölten,3437,7,10,11,15,50,64,-14,41
RZ Pellets W,3437,8,11,8,17,44,62,-18,41
SV Josko Rie,3437,9,10,6,20,39,60,-21,36
Mattersburg,3437,10,7,9,20,36,59,-23,30
SC Rheindorf,3438,1,20,9,7,54,36,18,69
FC Salzburg,3438,2,20,7,9,66,34,32,67
SK Sturm Gra,3438,3,16,11,9,55,33,22,59
Vienna,3438,4,18,4,14,60,54,6,58
Rapid Vienna,3438,5,14,9,13,58,51,7,51
RZ Pellets W,3438,6,14,8,14,45,48,-3,50
Admira Wacke,3438,7,14,4,18,48,62,-14,46
St. Pölten,3438,8,9,10,17,43,63,-20,37
SV Josko Rie,3438,9,10,4,22,34,61,-27,34
Mattersburg,3438,10,9,6,21,38,59,-21,33
SC Rheindorf,3439,1,20,8,8,55,41,14,68
FC Salzburg,3439,2,19,8,9,64,33,31,65
SK Sturm Gra,3439,3,20,5,11,58,34,24,65
Rapid Vienna,3439,4,15,11,10,61,45,16,56
Vienna,3439,5,15,7,14,57,58,-1,52
RZ Pellets W,3439,6,13,7,16,52,55,-3,46
St. Pölten,3439,7,10,9,17,47,66,-19,39
SV Josko Rie,3439,8,11,5,20,35,54,-19,38
Mattersburg,3439,9,10,7,19,42,55,-13,37
Admira Wacke,3439,10,9,9,18,29,59,-30,36
FC Salzburg,3440,1,21,9,6,70,28,42,72
SC Rheindorf,3440,2,19,11,6,55,35,20,68
SK Sturm Gra,3440,3,20,5,11,64,41,23,65
Vienna,3440,4,17,7,12,58,52,6,58
Rapid Vienna,3440,5,11,12,13,50,44,6,45
Admira Wacke,3440,6,12,7,17,39,58,-19,43
SV Josko Rie,3440,7,10,10,16,35,52,-17,40
RZ Pellets W,3440,8,9,9,18,41,58,-17,36
Mattersburg,3440,9,8,11,17,38,50,-12,35
St. Pölten,3440,10,7,11,18,38,70,-32,32
FC Salzburg,3441,1,23,7,6,70,29,41,76
Vienna,3441,2,20,3,13,57,51,6,63
SC Rheindorf,3441,3,18,8,10,59,45,14,62
SK Sturm Gra,3441,4,16,7,13,59,42,17,55
Rapid Vienna,3441,5,15,10,11,58,41,17,55
St. Pölten,3441,6,11,8,17,47,67,-20,41
Admira Wacke,3441,7,12,5,19,41,65,-24,41
SV Josko Rie,3441,8,12,4,20,40,54,-14,40
Mattersburg,3441,9,10,9,17,41,55,-14,39
RZ Pellets W,3441,10,10,5,21,39,62,-23,35
SC Rheindorf,3442,1,22,6,8,62,39,23,72
FC Salzburg,3442,2,21,8,7,68,31,37,71
SK Sturm Gra,3442,3,21,5,10,65,38,27,68
Vienna,3442,4,18,6,12,65,53,12,60
Rapid Vienna,3442,5,15,12,9,57,34,23,57
SV Josko Rie,3442,6,10,8,18,41,53,-12,38
St. Pölten,3442,7,9,9,18,40,60,-20,36
RZ Pellets W,3442,8,9,8,19,38,61,-23,35
Admira Wacke,3442,9,9,8,19,35,65,-30,35
Mattersburg,3442,10,8,6,22,35,72,-37,30
FC Salzburg,3443,1,24,6,6,70,29,41,78
SC Rheindorf,3443,2,19,8,9,59,50,9,65
SK Sturm Gra,3443,3,17,8,11,52,34,18,59
Vienna,3443,4,18,4,14,58,50,8,58
Rapid Vienna,3443,5,15,10,11,55,37,18,55
RZ Pellets W,3443,6,11,8,17,45,55,-10,41
Admira Wacke,3443,7,10,10,16,38,56,-18,40
SV Josko Rie,3443,8,11,6,19,43,56,-13,39
St. Pölten,3443,9,9,10,17,39,62,-23,37
Mattersburg,3443,10,7,8,21,35,65,-30,29
FC Salzburg,3444,1,23,7,6,77,34,43,76
SC Rheindorf,3444,2,18,8,10,51,40,11,62
Vienna,3444,3,19,4,13,65,58,7,61
SK Sturm Gra,3444,4,17,9,10,59,39,20,60
Rapid Vienna,3444,5,17,8,11,67,44,23,59
RZ Pellets W,3444,6,12,8,16,48,58,-10,44
St. Pölten,3444,7,10,11,15,42,55,-13,41
SV Josko Rie,3444,8,10,9,17,35,58,-23,39
Mattersburg,3444,9,8,6,22,39,61,-22,30
Admira Wacke,3444,10,8,6,22,29,65,-36,30
FC Salzburg,3445,1,22,7,7,66,27,39,73
SC Rheindorf,3445,2,21,7,8,66,47,19,70
Vienna,3445,3,21,4,11,66,45,21,67
SK Sturm Gra,3445,4,19,6,11,64,37,27,63
Rapid Vienna,3445,5,12,11,13,50,44,6,47
RZ Pellets W,3445,6,13,7,16,48,58,-10,46
Admira Wacke,3445,7,12,6,18,37,57,-20,42
SV Josko Rie,3445,8,10,4,22,35,59,-24,34
St. Pölten,3445,9,7,11,18,34,67,-33,32
Mattersburg,3445,10,7,9,20,34,59,-25,30
FC Salzburg,3446,1,20,9,7,66,32,34,69
SK Sturm Gra,3446,2,20,6,10,60,30,30,66
SC Rheindorf,3446,3,17,9,10,54,46,8,60
Rapid Vienna,3446,4,15,11,10,56,41,15,56
Vienna,3446,5,15,9,12,53,55,-2,54
RZ Pellets W,3446,6,12,7,17,56,60,-4,43
St. Pölten,3446,7,10,11,15,47,59,-12,41
SV Josko Rie,3446,8,10,7,19,35,55,-20,37
Mattersburg,3446,9,8,12,16,35,54,-19,36
Admira Wacke,3446,10,8,9,19,35,65,-30,33
SK Sturm Gra,3447,1,19,10,7,67,33,34,67
FC Salzburg,3447,2,19,9,8,66,35,31,66
SC Rheindorf,3447,3,20,6,10,56,42,14,66
Vienna,3447,4,16,8,12,58,54,4,56
Rapid Vienna,3447,5,12,11,13,61,50,11,47
RZ Pellets W,3447,6,11,10,15,44,56,-12,43
St. Pölten,3447,7,9,13,14,41,55,-14,40
Mattersburg,3447,8,10,9,17,38,56,-18,39
Admira Wacke,3447,9,11,6,19,33,59,-26,39
SV Josko Rie,3447,10,9,6,21,32,56,-24,33
SC Rheindorf,3448,1,22,6,8,66,45,21,72
SK Sturm Gra,3448,2,21,6,9,65,34,31,69
Vienna,3448,3,21,4,11,69,51,18,67
FC Salzburg,3448,4,19,8,9,72,34,38,65
Rapid Vienna,3448,5,16,8,12,59,42,17,56
RZ Pellets W,3448,6,11,8,17,49,61,-12,41
Admira Wacke,3448,7,12,5,19,33,65,-32,41
SV Josko Rie,3448,8,10,5,21,34,55,-21,35
Mattersburg,3448,9,8,7,21,40,65,-25,31
St. Pölten,3448,10,8,7,21,38,73,-35,31
FC Salzburg,3449,1,21,6,9,70,33,37,69
Vienna,3449,2,20,7,9,69,48,21,67
SK Sturm Gra,3449,3,19,5,12,60,37,23,62
Rapid Vienna,3449,4,14,9,13,54,48,6,51
SC Rheindorf,3449,5,15,6,15,51,62,-11,51
St. Pölten,3449,6,13,9,14,53,57,-4,48
RZ Pellets W,3449,7,12,8,16,47,55,-8,44
Admira Wacke,3449,8,12,6,18,39,64,-25,42
SV Josko Rie,3449,9,9,8,19,34,53,-19,35
Mattersburg,3449,10,7,12,17,35,55,-20,33
FC Salzburg,3450,1,21,10,5,67,30,37,73
SC Rheindorf,3450,2,19,11,6,55,35,20,68
SK Sturm Gra,3450,3,17,6,13,53,38,15,57
Vienna,3450,4,15,7,14,55,52,3,52
Admira Wacke,3450,5,14,5,17,42,55,-13,47
RZ Pellets W,3450,6,12,8,16,45,57,-12,44
Mattersburg,3450,7,11,10,15,43,52,-9,43
Rapid Vienna,3450,8,9,14,13,48,48,0,41
St. Pölten,3450,9,8,13,15,43,57,-14,37
SV Josko Rie,3450,10,9,6,21,33,60,-27,33
FC Salzburg,3451,1,20,9,7,65,31,34,69
SK Sturm Gra,3451,2,20,6,10,65,38,27,66
Vienna,3451,3,18,6,12,68,56,12,60
SC Rheindorf,3451,4,17,7,12,47,47,0,58
RZ Pellets W,3451,5,15,4,17,52,56,-4,49
Rapid Vienna,3451,6,12,12,12,51,39,12,48
SV Josko Rie,3451,7,12,6,18,40,51,-11,42
Admira Wacke,3451,8,10,9,17,36,57,-21,39
St. Pölten,3451,9,8,12,16,35,59,-24,36
Mattersburg,3451,10,7,11,18,40,65,-25,32
FC Salzburg,3452,1,20,9,7,71,31,40,69
SC Rheindorf,3452,2,21,6,9,61,40,21,69
SK Sturm Gra,3452,3,20,6,10,61,33,28,66
Vienna,3452,4,18,4,14,58,51,7,58
RZ Pellets W,3452,5,14,6,16,47,52,-5,48
SV Josko Rie,3452,6,13,6,17,36,50,-14,45
Rapid Vienna,3452,7,11,11,14,49,47,2,44
Admira Wacke,3452,8,13,4,19,39,60,-21,43
Mattersburg,3452,9,9,8,19,40,62,-22,35
St. Pölten,3452,10,7,8,21,35,71,-36,29
FC Salzburg,3453,1,20,11,5,62,29,33,71
SC Rheindorf,3453,2,18,9,9,56,43,13,63
Vienna,3453,3,18,7,11,64,51,13,61
SK Sturm Gra,3453,4,18,6,12,56,38,18,60
RZ Pellets W,3453,5,14,9,13,51,47,4,51
Rapid Vienna,3453,6,11,15,10,47,36,11,48
Admira Wacke,3453,7,11,5,20,41,65,-24,38
St. Pölten,3453,8,9,10,17,38,59,-21,37
SV Josko Rie,3453,9,9,7,20,35,63,-28,34
Mattersburg,3453,10,7,11,18,37,56,-19,32
FC Salzburg,3454,1,22,5,9,64,32,32,71
SK Sturm Gra,3454,2,21,7,8,58,33,25,70
SC Rheindorf,3454,3,19,7,10,54,43,11,64
RZ Pellets W,3454,4,13,11,12,54,52,2,50
Rapid Vienna,3454,5,13,9,14,58,45,13,48
Vienna,3454,6,13,9,14,51,59,-8,48
Admira Wacke,3454,7,12,5,19,37,58,-21,41
Mattersburg,3454,8,8,12,16,36,53,-17,36
SV Josko Rie,3454,9,10,6,20,34,52,-18,36
St. Pölten,3454,10,9,9,18,39,58,-19,36
FC Salzburg,3455,1,21,6,9,61,31,30,69
SK Sturm Gra,3455,2,20,8,8,63,33,30,68
Vienna,3455,3,20,4,12,62,47,15,64
Rapid Vienna,3455,4,15,12,9,59,38,21,57
SC Rheindorf,3455,5,17,6,13,56,49,7,57
RZ Pellets W,3455,6,13,7,16,43,53,-10,46
Admira Wacke,3455,7,12,7,17,37,56,-19,43
Mattersburg,3455,8,8,10,18,30,53,-23,34
St. Pölten,3455,9,8,9,19,37,66,-29,33
SV Josko Rie,3455,10,9,5,22,35,57,-22,32
FC Salzburg,3456,1,23,6,7,68,32,36,75
SK Sturm Gra,3456,2,22,6,8,64,34,30,72
Vienna,3456,3,20,5,11,64,48,16,65
SC Rheindorf,3456,4,17,7,12,52,46,6,58
Admira Wacke,3456,5,15,5,16,42,58,-16,50
Rapid Vienna,3456,6,13,10,13,58,47,11,49
St. Pölten,3456,7,10,11,15,49,60,-11,41
RZ Pellets W,3456,8,10,6,20,42,59,-17,36
SV Josko Rie,3456,9,9,4,23,33,66,-33,31
Mattersburg,3456,10,7,8,21,42,64,-22,29
SC Rheindorf,3457,1,23,7,6,66,34,32,76
FC Salzburg,3457,2,22,6,8,68,28,40,72
SK Sturm Gra,3457,3,20,5,11,61,38,23,65
Vienna,3457,4,19,3,14,64,55,9,60
Rapid Vienna,3457,5,14,9,13,56,47,9,51
RZ Pellets W,3457,6,13,6,17,54,63,-9,45
SV Josko Rie,3457,7,11,4,21,35,60,-25,37
Admira Wacke,3457,8,10,6,20,37,71,-34,36
St. Pölten,3457,9,8,10,18,36,59,-23,34
Mattersburg,3457,10,7,10,19,38,60,-22,31
FC Salzburg,3458,1,22,6,8,66,35,31,72
SK Sturm Gra,3458,2,20,6,10,60,35,25,66
Vienna,3458,3,19,6,11,73,56,17,63
SC Rheindorf,3458,4,17,9,10,59,52,7,60
Rapid Vienna,3458,5,13,12,11,48,38,10,51
RZ Pellets W,3458,6,11,8,17,49,61,-12,41
Admira Wacke,3458,7,12,4,20,35,58,-23,40
SV Josko Rie,3458,8,10,7,19,36,55,-19,37
St. Pölten,3458,9,8,12,16,45,63,-18,36
Mattersburg,3458,10,7,12,17,36,54,-18,33
FC Salzburg,3459,1,24,4,8,71,33,38,76
Vienna,3459,2,22,4,10,74,48,26,70
SK Sturm Gra,3459,3,19,8,9,62,38,24,65
SC Rheindorf,3459,4,19,8,9,58,44,14,65
Rapid Vienna,3459,5,15,13,8,55,35,20,58
RZ Pellets W,3459,6,10,9,17,44,57,-13,39
Admira Wacke,3459,7,11,6,19,33,61,-28,39
St. Pölten,3459,8,6,14,16,42,66,-24,32
Mattersburg,3459,9,7,10,19,34,59,-25,31
SV Josko Rie,3459,10,6,6,24,30,62,-32,24
SC Rheindorf,3460,1,21,9,6,53,35,18,72
FC Salzburg,3460,2,17,10,9,58,34,24,61
Vienna,3460,3,17,7,12,61,58,3,58
Rapid Vienna,3460,4,16,9,11,55,39,16,57
SK Sturm Gra,3460,5,13,13,10,52,39,13,52
RZ Pellets W,3460,6,15,7,14,49,49,0,52
Admira Wacke,3460,7,10,7,19,35,60,-25,37
SV Josko Rie,3460,8,10,6,20,37,53,-16,36
St. Pölten,3460,9,8,11,17,42,57,-15,35
Mattersburg,3460,10,8,11,17,35,53,-18,35
FC Salzburg,3461,1,22,5,9,60,30,30,71
SK Sturm Gra,3461,2,19,8,9,62,37,25,65
SC Rheindorf,3461,3,17,9,10,49,39,10,60
Vienna,3461,4,16,7,13,61,54,7,55
Rapid Vienna,3461,5,13,11,12,57,44,13,50
RZ Pellets W,3461,6,13,8,15,51,54,-3,47
Admira Wacke,3461,7,13,6,17,40,60,-20,45
SV Josko Rie,3461,8,12,4,20,31,51,-20,40
Mattersburg,3461,9,9,11,16,38,57,-19,38
St. Pölten,3461,10,6,11,19,40,63,-23,29
FC Salzburg,3462,1,19,8,9,61,32,29,65
SK Sturm Gra,3462,2,20,5,11,65,42,23,65
SC Rheindorf,3462,3,18,8,10,48,44,4,62
Vienna,3462,4,19,3,14,67,58,9,60
Rapid Vienna,3462,5,16,8,12,56,37,19,56
Mattersburg,3462,6,12,8,16,39,52,-13,44
Admira Wacke,3462,7,13,4,19,36,54,-18,43
RZ Pellets W,3462,8,12,6,18,48,61,-13,42
SV Josko Rie,3462,9,10,7,19,42,54,-12,37
St. Pölten,3462,10,7,11,18,39,67,-28,32
SC Rheindorf,3463,1,20,9,7,62,42,20,69
FC Salzburg,3463,2,21,5,10,66,37,29,68
SK Sturm Gra,3463,3,21,4,11,60,36,24,67
Rapid Vienna,3463,4,17,10,9,65,45,20,61
Vienna,3463,5,18,5,13,66,58,8,59
Admira Wacke,3463,6,15,5,16,50,59,-9,50
RZ Pellets W,3463,7,10,6,20,44,63,-19,36
St. Pölten,3463,8,9,8,19,43,66,-23,35
SV Josko Rie,3463,9,9,5,22,32,58,-26,32
Mattersburg,3463,10,8,7,21,34,58,-24,31
SC Rheindorf,3464,1,21,8,7,61,42,19,71
FC Salzburg,3464,2,19,9,8,63,31,32,66
SK Sturm Gra,3464,3,16,10,10,57,39,18,58
Vienna,3464,4,16,10,10,66,51,15,58
Rapid Vienna,3464,5,13,12,11,54,40,14,51
RZ Pellets W,3464,6,12,9,15,46,57,-11,45
SV Josko Rie,3464,7,11,7,18,39,63,-24,40
St. Pölten,3464,8,9,11,16,50,66,-16,38
Admira Wacke,3464,9,11,5,20,33,58,-25,38
Mattersburg,3464,10,7,9,20,33,55,-22,30
FC Salzburg,3465,1,25,5,6,76,28,48,80
SK Sturm Gra,3465,2,18,8,10,63,38,25,62
SC Rheindorf,3465,3,16,10,10,49,43,6,58
Vienna,3465,4,16,7,13,63,61,2,55
RZ Pellets W,3465,5,13,8,15,42,51,-9,47
Rapid Vienna,3465,6,12,10,14,54,48,6,46
SV Josko Rie,3465,7,11,6,19,35,55,-20,39
St. Pölten,3465,8,10,9,17,41,62,-21,39
Mattersburg,3465,9,10,8,18,36,53,-17,38
Admira Wacke,3465,10,9,9,18,40,60,-20,36
FC Salzburg,3466,1,21,8,7,67,32,35,71
SK Sturm Gra,3466,2,20,5,11,64,39,25,65
SC Rheindorf,3466,3,19,7,10,57,44,13,64
Vienna,3466,4,17,5,14,49,46,3,56
RZ Pellets W,3466,5,14,7,15,52,60,-8,49
Rapid Vienna,3466,6,11,13,12,54,44,10,46
SV Josko Rie,3466,7,13,6,17,39,49,-10,45
Admira Wacke,3466,8,12,6,18,38,60,-22,42
St. Pölten,3466,9,9,9,18,50,70,-20,36
Mattersburg,3466,10,8,6,22,38,64,-26,30
SK Sturm Gra,3467,1,20,8,8,62,32,30,68
SC Rheindorf,3467,2,20,8,8,59,46,13,68
FC Salzburg,3467,3,18,10,8,60,29,31,64
Vienna,3467,4,20,2,14,59,52,7,62
Rapid Vienna,3467,5,13,14,9,59,37,22,53
RZ Pellets W,3467,6,11,9,16,40,52,-12,42
Admira Wacke,3467,7,11,8,17,32,56,-24,41
St. Pölten,3467,8,9,10,17,38,57,-19,37
Mattersburg,3467,9,7,12,17,34,54,-20,33
SV Josko Rie,3467,10,9,3,24,29,57,-28,30
FC Salzburg,3468,1,23,7,6,70,28,42,76
Rapid Vienna,3468,2,17,11,8,55,31,24,62
SC Rheindorf,3468,3,18,8,10,53,49,4,62
SK Sturm Gra,3468,4,17,6,13,51,36,15,57
Vienna,3468,5,18,3,15,60,56,4,57
Admira Wacke,3468,6,14,6,16,38,52,-14,48
RZ Pellets W,3468,7,12,5,19,43,57,-14,41
SV Josko Rie,3468,8,10,6,20,30,50,-20,36
Mattersburg,3468,9,9,8,19,35,55,-20,35
St. Pölten,3468,10,7,10,19,42,63,-21,31
SK Sturm Gra,3469,1,22,5,9,65,33,32,71
Vienna,3469,2,22,5,9,61,43,18,71
FC Salzburg,3469,3,19,9,8,63,30,33,66
SC Rheindorf,3469,4,19,6,11,51,42,9,63
Rapid Vienna,3469,5,13,9,14,52,46,6,48
RZ Pellets W,3469,6,12,6,18,41,53,-12,42
St. Pölten,3469,7,11,9,16,45,58,-13,42
Admira Wacke,3469,8,10,8,18,35,58,-23,38
SV Josko Rie,3469,9,10,3,23,27,53,-26,33
Mattersburg,3469,10,8,8,20,33,57,-24,32
FC Salzburg,3470,1,20,9,7,64,34,30,69
SC Rheindorf,3470,2,19,8,9,54,43,11,65
SK Sturm Gra,3470,3,18,8,10,60,36,24,62
Vienna,3470,4,15,6,15,57,53,4,51
Mattersburg,3470,5,12,10,14,40,45,-5,46
Rapid Vienna,3470,6,11,12,13,51,42,9,45
SV Josko Rie,3470,7,12,7,17,41,52,-11,43
Admira Wacke,3470,8,12,7,17,41,61,-20,43
RZ Pellets W,3470,9,11,8,17,42,60,-18,41
St. Pölten,3470,10,7,11,18,43,67,-24,32
FC Salzburg,3471,1,21,7,8,61,31,30,70
Vienna,3471,2,19,5,12,64,50,14,62
SK Sturm Gra,3471,3,17,7,12,54,36,18,58
SC Rheindorf,3471,4,17,7,12,51,43,8,58
Rapid Vienna,3471,5,16,9,11,50,33,17,57
St. Pölten,3471,6,11,10,15,46,61,-15,43
Admira Wacke,3471,7,12,6,18,41,63,-22,42
RZ Pellets W,3471,8,11,7,18,42,61,-19,40
SV Josko Rie,3471,9,11,5,20,34,51,-17,38
Mattersburg,3471,10,9,9,18,47,61,-14,36
FC Salzburg,3472,1,21,8,7,68,28,40,71
SK Sturm Gra,3472,2,19,7,10,60,33,27,64
SC Rheindorf,3472,3,19,6,11,56,47,9,63
Vienna,3472,4,18,6,12,64,56,8,60
Rapid Vienna,3472,5,15,11,10,59,37,22,56
SV Josko Rie,3472,6,14,6,16,45,53,-8,48
Admira Wacke,3472,7,10,9,17,37,63,-26,39
St. Pölten,3472,8,9,10,17,45,62,-17,37
RZ Pellets W,3472,9,9,7,20,39,63,-24,34
Mattersburg,3472,10,7,8,21,41,72,-31,29
FC Salzburg,3473,1,25,6,5,80,31,49,81
SC Rheindorf,3473,2,18,9,9,57,47,10,63
SK Sturm Gra,3473,3,18,6,12,59,33,26,60
Vienna,3473,4,17,5,14,56,57,-1,56
Rapid Vienna,3473,5,15,8,13,55,47,8,53
RZ Pellets W,3473,6,13,10,13,42,46,-4,49
SV Josko Rie,3473,7,11,4,21,38,50,-12,37
St. Pölten,3473,8,9,10,17,36,59,-23,37
Admira Wacke,3473,9,10,5,21,33,66,-33,35
Mattersburg,3473,10,6,13,17,30,50,-20,31
SC Rheindorf,3474,1,20,8,8,55,38,17,68
SK Sturm Gra,3474,2,21,4,11,58,38,20,67
FC Salzburg,3474,3,19,8,9,71,31,40,65
Vienna,3474,4,19,8,9,63,44,19,65
Rapid Vienna,3474,5,15,10,11,54,37,17,55
RZ Pellets W,3474,6,11,6,19,44,59,-15,39
SV Josko Rie,3474,7,10,8,18,32,53,-21,38
Mattersburg,3474,8,8,11,17,36,54,-18,35
Admira Wacke,3474,9,10,5,21,33,70,-37,35
St. Pölten,3474,10,8,10,18,39,61,-22,34
FC Salzburg,3475,1,25,5,6,71,26,45,80
SK Sturm Gra,3475,2,22,5,9,62,30,32,71
Vienna,3475,3,21,6,9,71,47,24,69
SC Rheindorf,3475,4,18,6,12,51,47,4,60
Rapid Vienna,3475,5,16,9,11,58,43,15,57
RZ Pellets W,3475,6,12,6,18,43,56,-13,42
Admira Wacke,3475,7,9,11,16,33,53,-20,38
SV Josko Rie,3475,8,10,5,21,33,54,-21,35
St. Pölten,3475,9,7,8,21,40,81,-41,29
Mattersburg,3475,10,6,7,23,38,63,-25,25
FC Salzburg,3476,1,22,8,6,69,33,36,74
Vienna,3476,2,20,4,12,70,53,17,64
SK Sturm Gra,3476,3,20,4,12,55,41,14,64
Rapid Vienna,3476,4,14,12,10,61,42,19,54
SC Rheindorf,3476,5,15,6,15,50,57,-7,51
RZ Pellets W,3476,6,14,8,14,45,47,-2,50
Admira Wacke,3476,7,11,6,19,44,69,-25,39
Mattersburg,3476,8,9,11,16,39,50,-11,38
St. Pölten,3476,9,9,9,18,48,66,-18,36
SV Josko Rie,3476,10,10,4,22,29,52,-23,34
SC Rheindorf,3477,1,20,7,9,59,44,15,67
FC Salzburg,3477,2,18,12,6,64,36,28,66
SK Sturm Gra,3477,3,19,5,12,61,35,26,62
Vienna,3477,4,19,4,13,65,53,12,61
Rapid Vienna,3477,5,16,11,9,64,40,24,59
SV Josko Rie,3477,6,12,7,17,37,52,-15,43
Admira Wacke,3477,7,12,7,17,42,61,-19,43
Mattersburg,3477,8,9,9,18,43,57,-14,36
RZ Pellets W,3477,9,8,9,19,44,71,-27,33
St. Pölten,3477,10,7,9,20,39,69,-30,30
FC Salzburg,3478,1,23,8,5,74,29,45,77
SK Sturm Gra,3478,2,19,8,9,65,40,25,65
Vienna,3478,3,18,7,11,68,53,15,61
SC Rheindorf,3478,4,17,8,11,56,45,11,59
RZ Pellets W,3478,5,15,8,13,53,53,0,53
Rapid Vienna,3478,6,13,10,13,50,43,7,49
Admira Wacke,3478,7,12,4,20,39,65,-26,40
SV Josko Rie,3478,8,10,5,21,32,54,-22,35
Mattersburg,3478,9,8,10,18,36,59,-23,34
St. Pölten,3478,10,5,12,19,35,67,-32,27
FC Salzburg,3479,1,25,6,5,70,25,45,81
SK Sturm Gra,3479,2,20,7,9,60,30,30,67
SC Rheindorf,3479,3,19,9,8,54,40,14,66
Vienna,3479,4,18,6,12,60,51,9,60
RZ Pellets W,3479,5,15,7,14,55,57,-2,52
Rapid Vienna,3479,6,11,13,12,52,44,8,46
SV Josko Rie,3479,7,11,3,22,31,55,-24,36
Admira Wacke,3479,8,9,7,20,34,61,-27,34
Mattersburg,3479,9,6,11,19,39,61,-22,29
St. Pölten,3479,10,6,11,19,41,72,-31,29
FC Salzburg,3480,1,23,8,5,73,29,44,77
SC Rheindorf,3480,2,21,6,9,66,42,24,69
SK Sturm Gra,3480,3,21,5,10,55,33,22,68
Rapid Vienna,3480,4,16,10,10,60,43,17,58
Vienna,3480,5,18,3,15,62,49,13,57
RZ Pellets W,3480,6,15,7,14,53,60,-7,52
SV Josko Rie,3480,7,11,6,19,36,50,-14,39
St. Pölten,3480,8,8,7,21,44,75,-31,31
Admira Wacke,3480,9,8,5,23,32,67,-35,29
Mattersburg,3480,10,6,9,21,35,68,-33,27
FC Salzburg,3481,1,21,8,7,69,32,37,71
SC Rheindorf,3481,2,20,8,8,56,41,15,68
SK Sturm Gra,3481,3,21,4,11,62,34,28,67
Vienna,3481,4,20,3,13,60,49,11,63
Rapid Vienna,3481,5,13,9,14,52,44,8,48
Admira Wacke,3481,6,13,8,15,34,48,-14,47
RZ Pellets W,3481,7,10,10,16,38,55,-17,40
St. Pölten,3481,8,9,9,18,44,64,-20,36
SV Josko Rie,3481,9,9,7,20,39,59,-20,34
Mattersburg,3481,10,7,8,21,33,61,-28,29
FC Salzburg,3482,1,21,7,8,63,29,34,70
SK Sturm Gra,3482,2,20,7,9,59,29,30,67
SC Rheindorf,3482,3,19,7,10,58,39,19,64
Vienna,3482,4,19,4,13,63,51,12,61
Rapid Vienna,3482,5,13,9,14,50,42,8,48
RZ Pellets W,3482,6,12,7,17,45,60,-15,43
Admira Wacke,3482,7,12,7,17,41,63,-22,43
SV Josko Rie,3482,8,10,8,18,34,52,-18,38
Mattersburg,3482,9,9,8,19,32,56,-24,35
St. Pölten,3482,10,7,12,17,39,63,-24,33
FC Salzburg,3483,1,23,5,8,68,28,40,74
SC Rheindorf,3483,2,19,7,10,55,48,7,64
SK Sturm Gra,3483,3,17,9,10,55,35,20,60
Vienna,3483,4,16,5,15,64,58,6,53
Rapid Vienna,3483,5,12,13,11,59,43,16,49
RZ Pellets W,3483,6,12,9,15,45,55,-10,45
Admira Wacke,3483,7,13,5,18,38,52,-14,44
SV Josko Rie,3483,8,13,5,18,41,56,-15,44
St. Pölten,3483,9,9,11,16,43,61,-18,38
Mattersburg,3483,10,8,7,21,33,65,-32,31
FC Salzburg,3484,1,23,8,5,71,27,44,77
SK Sturm Gra,3484,2,20,7,9,59,32,27,67
SC Rheindorf,3484,3,19,7,10,51,38,13,64
Vienna,3484,4,19,6,11,62,54,8,63
RZ Pellets W,3484,5,14,5,17,51,61,-10,47
Admira Wacke,3484,6,13,7,16,39,55,-16,46
Rapid Vienna,3484,7,11,11,14,53,47,6,44
SV Josko Rie,3484,8,11,3,22,31,55,-24,36
St. Pölten,3484,9,9,7,20,41,65,-24,34
Mattersburg,3484,10,7,7,22,34,58,-24,28
FC Salzburg,3485,1,23,6,7,67,26,41,75
Vienna,3485,2,19,8,9,64,46,18,65
SC Rheindorf,3485,3,20,5,11,52,41,11,65
SK Sturm Gra,3485,4,19,6,11,59,32,27,63
Rapid Vienna,3485,5,16,10,10,58,39,19,58
RZ Pellets W,3485,6,11,9,16,46,58,-12,42
Mattersburg,3485,7,11,7,18,36,54,-18,40
SV Josko Rie,3485,8,10,5,21,34,58,-24,35
Admira Wacke,3485,9,9,7,20,31,60,-29,34
St. Pölten,3485,10,6,9,21,36,69,-33,27
FC Salzburg,3486,1,23,7,6,70,30,40,76
Vienna,3486,2,19,6,11,71,58,13,63
Rapid Vienna,3486,3,18,8,10,68,39,29,62
SC Rheindorf,3486,4,18,5,13,54,46,8,59
SK Sturm Gra,3486,5,18,4,14,58,42,16,58
Admira Wacke,3486,6,15,6,15,53,57,-4,51
Mattersburg,3486,7,10,11,15,41,52,-11,41
RZ Pellets W,3486,8,10,6,20,45,71,-26,36
SV Josko Rie,3486,9,8,6,22,34,66,-32,30
St. Pölten,3486,10,7,9,20,44,77,-33,30
FC Salzburg,3487,1,20,10,6,72,32,40,70
SK Sturm Gra,3487,2,20,8,8,64,31,33,68
Vienna,3487,3,20,5,11,68,49,19,65
SC Rheindorf,3487,4,17,9,10,52,43,9,60
Rapid Vienna,3487,5,11,14,11,54,44,10,47
St. Pölten,3487,6,12,8,16,39,56,-17,44
Admira Wacke,3487,7,11,7,18,31,65,-34,40
SV Josko Rie,3487,8,11,6,19,36,54,-18,39
Mattersburg,3487,9,9,8,19,43,63,-20,35
RZ Pellets W,3487,10,9,5,22,41,63,-22,32
SK Sturm Gra,3488,1,20,7,9,58,34,24,67
FC Salzburg,3488,2,19,8,9,60,33,27,65
SC Rheindorf,3488,3,18,8,10,58,43,15,62
Vienna,3488,4,17,8,11,61,52,9,59
Rapid Vienna,3488,5,16,10,10,61,38,23,58
RZ Pellets W,3488,6,11,11,14,51,55,-4,44
Mattersburg,3488,7,10,10,16,33,52,-19,40
St. Pölten,3488,8,8,14,14,46,65,-19,38
Admira Wacke,3488,9,8,9,19,32,60,-28,33
SV Josko Rie,3488,10,7,7,22,27,55,-28,28
FC Salzburg,3489,1,25,7,4,75,26,49,82
SC Rheindorf,3489,2,21,6,9,54,37,17,69
SK Sturm Gra,3489,3,20,6,10,61,34,27,66
Vienna,3489,4,18,3,15,57,55,2,57
Rapid Vienna,3489,5,15,7,14,55,35,20,52
RZ Pellets W,3489,6,15,4,17,49,56,-7,49
SV Josko Rie,3489,7,14,4,18,41,56,-15,46
Mattersburg,3489,8,9,5,22,35,61,-26,32
St. Pölten,3489,9,7,10,19,36,66,-30,31
Admira Wacke,3489,10,8,4,24,26,63,-37,28
SC Rheindorf,3490,1,21,9,6,58,37,21,72
Vienna,3490,2,20,5,11,66,49,17,65
FC Salzburg,3490,3,17,12,7,66,38,28,63
SK Sturm Gra,3490,4,16,10,10,57,39,18,58
Rapid Vienna,3490,5,11,13,12,55,48,7,46
Admira Wacke,3490,6,12,8,16,40,55,-15,44
RZ Pellets W,3490,7,11,8,17,40,60,-20,41
SV Josko Rie,3490,8,12,4,20,40,58,-18,40
St. Pölten,3490,9,7,12,17,43,61,-18,33
Mattersburg,3490,10,7,11,18,39,59,-20,32
FC Salzburg,3491,1,22,7,7,68,32,36,73
SK Sturm Gra,3491,2,20,7,9,62,30,32,67
Vienna,3491,3,19,4,13,65,52,13,61
SC Rheindorf,3491,4,17,9,10,50,44,6,60
Rapid Vienna,3491,5,15,12,9,54,37,17,57
Mattersburg,3491,6,11,9,16,37,52,-15,42
SV Josko Rie,3491,7,10,7,19,36,53,-17,37
RZ Pellets W,3491,8,10,7,19,40,58,-18,37
Admira Wacke,3491,9,10,6,20,35,64,-29,36
St. Pölten,3491,10,7,10,19,32,57,-25,31
FC Salzburg,3492,1,22,7,7,70,27,43,73
SK Sturm Gra,3492,2,20,7,9,59,33,26,67
SC Rheindorf,3492,3,19,8,9,51,41,10,65
Vienna,3492,4,18,6,12,66,50,16,60
Rapid Vienna,3492,5,12,13,11,52,40,12,49
RZ Pellets W,3492,6,13,8,15,46,52,-6,47
SV Josko Rie,3492,7,11,7,18,35,50,-15,40
St. Pölten,3492,8,9,10,17,46,67,-21,37
Admira Wacke,3492,9,10,7,19,36,69,-33,37
Mattersburg,3492,10,6,7,23,23,55,-32,25
FC Salzburg,3493,1,22,8,6,69,25,44,74
SC Rheindorf,3493,2,19,9,8,50,40,10,66
SK Sturm Gra,3493,3,18,9,9,59,36,23,63
Vienna,3493,4,20,3,13,64,48,16,63
Rapid Vienna,3493,5,13,10,13,52,41,11,49
Admira Wacke,3493,6,14,6,16,41,57,-16,48
RZ Pellets W,3493,7,12,7,17,42,59,-17,43
St. Pölten,3493,8,9,9,18,40,60,-20,36
SV Josko Rie,3493,9,9,4,23,36,65,-29,31
Mattersburg,3493,10,7,9,20,37,59,-22,30
SK Sturm Gra,3494,1,21,6,9,62,30,32,69
SC Rheindorf,3494,2,19,10,7,57,41,16,67
FC Salzburg,3494,3,19,8,9,64,30,34,65
Vienna,3494,4,19,6,11,71,54,17,63
Rapid Vienna,3494,5,16,10,10,58,39,19,58
RZ Pellets W,3494,6,12,7,17,42,57,-15,43
Admira Wacke,3494,7,10,7,19,36,62,-26,37
Mattersburg,3494,8,9,9,18,46,55,-9,36
St. Pölten,3494,9,9,8,19,39,72,-33,35
SV Josko Rie,3494,10,9,3,24,31,66,-35,30
Vienna,3495,1,22,4,10,66,43,23,70
SK Sturm Gra,3495,2,19,7,10,61,37,24,64
SC Rheindorf,3495,3,19,7,10,58,45,13,64
FC Salzburg,3495,4,19,6,11,63,40,23,63
Rapid Vienna,3495,5,15,8,13,57,40,17,53
RZ Pellets W,3495,6,13,8,15,48,54,-6,47
SV Josko Rie,3495,7,12,4,20,37,53,-16,40
Admira Wacke,3495,8,10,8,18,32,56,-24,38
Mattersburg,3495,9,9,8,19,42,62,-20,35
St. Pölten,3495,10,8,8,20,39,73,-34,32
SC Rheindorf,3496,1,23,8,5,63,34,29,77
FC Salzburg,3496,2,23,5,8,68,33,35,74
SK Sturm Gra,3496,3,19,7,10,55,35,20,64
Rapid Vienna,3496,4,17,9,10,58,36,22,60
Vienna,3496,5,18,4,14,65,51,14,58
RZ Pellets W,3496,6,11,6,19,40,63,-23,39
St. Pölten,3496,7,9,9,18,42,59,-17,36
Admira Wacke,3496,8,9,7,20,35,63,-28,34
Mattersburg,3496,9,8,8,20,35,59,-24,32
SV Josko Rie,3496,10,9,5,22,31,59,-28,32
FC Salzburg,3497,1,22,7,7,69,31,38,73
SC Rheindorf,3497,2,19,9,8,61,47,14,66
SK Sturm Gra,3497,3,19,7,10,68,40,28,64
RZ Pellets W,3497,4,15,7,14,52,55,-3,52
Vienna,3497,5,16,4,16,56,65,-9,52
Rapid Vienna,3497,6,14,9,13,61,43,18,51
SV Josko Rie,3497,7,13,3,20,39,56,-17,42
Admira Wacke,3497,8,11,9,16,32,53,-21,42
Mattersburg,3497,9,9,7,20,41,58,-17,34
St. Pölten,3497,10,7,8,21,43,74,-31,29
FC Salzburg,3498,1,22,5,9,75,31,44,71
SC Rheindorf,3498,2,21,5,10,62,47,15,68
Vienna,3498,3,18,7,11,60,46,14,61
Rapid Vienna,3498,4,16,10,10,62,40,22,58
SK Sturm Gra,3498,5,16,9,11,61,42,19,57
RZ Pellets W,3498,6,13,8,15,47,53,-6,47
Admira Wacke,3498,7,12,7,17,40,69,-29,43
St. Pölten,3498,8,9,8,19,41,63,-22,35
SV Josko Rie,3498,9,10,5,21,42,66,-24,35
Mattersburg,3498,10,7,8,21,30,63,-33,29
FC Salzburg,3499,1,22,6,8,71,29,42,72
SC Rheindorf,3499,2,19,8,9,57,40,17,65
SK Sturm Gra,3499,3,19,6,11,60,36,24,63
Rapid Vienna,3499,4,13,13,10,53,40,13,52
Vienna,3499,5,15,5,16,50,56,-6,50
SV Josko Rie,3499,6,13,4,19,35,51,-16,43
Admira Wacke,3499,7,12,7,17,39,61,-22,43
Mattersburg,3499,8,11,7,18,41,56,-15,40
RZ Pellets W,3499,9,11,6,19,47,58,-11,39
St. Pölten,3499,10,10,8,18,40,66,-26,38
SC Rheindorf,3500,1,20,8,8,59,38,21,68
FC Salzburg,3500,2,20,7,9,57,29,28,67
Vienna,3500,3,20,4,12,60,49,11,64
SK Sturm Gra,3500,4,19,5,12,53,33,20,62
Rapid Vienna,3500,5,15,8,13,55,44,11,53
RZ Pellets W,3500,6,15,7,14,44,48,-4,52
Admira Wacke,3500,7,12,7,17,42,60,-18,43
St. Pölten,3500,8,11,8,17,43,58,-15,41
Mattersburg,3500,9,8,8,20,33,58,-25,32
SV Josko Rie,3500,10,7,4,25,38,67,-29,25
FC Salzburg,3501,1,23,6,7,67,29,38,75
SK Sturm Gra,3501,2,19,7,10,57,32,25,64
Vienna,3501,3,18,8,10,64,48,16,62
SC Rheindorf,3501,4,15,10,11,47,42,5,55
Rapid Vienna,3501,5,14,11,11,53,37,16,53
Admira Wacke,3501,6,15,4,17,36,55,-19,49
St. Pölten,3501,7,11,8,17,41,57,-16,41
RZ Pellets W,3501,8,11,7,18,42,63,-21,40
Mattersburg,3501,9,8,8,20,41,63,-22,32
SV Josko Rie,3501,10,9,5,22,35,57,-22,32
SC Rheindorf,3502,1,23,5,8,59,34,25,74
SK Sturm Gra,3502,2,20,7,9,56,32,24,67
Vienna,3502,3,20,4,12,62,48,14,64
FC Salzburg,3502,4,19,6,11,60,38,22,63
RZ Pellets W,3502,5,13,10,13,46,52,-6,49
Rapid Vienna,3502,6,13,8,15,52,45,7,47
St. Pölten,3502,7,10,10,16,43,59,-16,40
Admira Wacke,3502,8,11,7,18,38,56,-18,40
Mattersburg,3502,9,9,7,20,38,64,-26,34
SV Josko Rie,3502,10,8,4,24,30,56,-26,28
FC Salzburg,3503,1,25,5,6,71,29,42,80
SK Sturm Gra,3503,2,22,6,8,67,33,34,72
SC Rheindorf,3503,3,20,8,8,57,41,16,68
Vienna,3503,4,16,6,14,53,48,5,54
Rapid Vienna,3503,5,12,13,11,57,43,14,49
RZ Pellets W,3503,6,11,10,15,43,52,-9,43
Mattersburg,3503,7,8,11,17,36,56,-20,35
Admira Wacke,3503,8,9,7,20,34,66,-32,34
SV Josko Rie,3503,9,9,6,21,31,51,-20,33
St. Pölten,3503,10,7,10,19,37,67,-30,31
Vienna,3504,1,23,4,9,69,45,24,73
FC Salzburg,3504,2,21,6,9,66,28,38,69
SC Rheindorf,3504,3,19,7,10,55,44,11,64
SK Sturm Gra,3504,4,16,11,9,60,43,17,59
Rapid Vienna,3504,5,13,13,10,55,41,14,52
Admira Wacke,3504,6,12,8,16,38,59,-21,44
SV Josko Rie,3504,7,12,5,19,34,54,-20,41
St. Pölten,3504,8,9,9,18,45,59,-14,36
RZ Pellets W,3504,9,9,7,20,40,56,-16,34
Mattersburg,3504,10,7,8,21,31,64,-33,29
SC Rheindorf,3505,1,24,7,5,64,32,32,79
FC Salzburg,3505,2,21,8,7,69,31,38,71
SK Sturm Gra,3505,3,19,5,12,56,37,19,62
Vienna,3505,4,18,5,13,56,52,4,59
Rapid Vienna,3505,5,12,11,13,49,49,0,47
Admira Wacke,3505,6,13,7,16,36,53,-17,46
RZ Pellets W,3505,7,11,10,15,42,50,-8,43
SV Josko Rie,3505,8,9,7,20,32,58,-26,34
Mattersburg,3505,9,7,10,19,40,56,-16,31
St. Pölten,3505,10,7,8,21,40,66,-26,29
FC Salzburg,3506,1,19,8,9,58,32,26,65
SK Sturm Gra,3506,2,19,6,11,59,37,22,63
Vienna,3506,3,20,3,13,64,50,14,63
SC Rheindorf,3506,4,19,5,12,50,43,7,62
RZ Pellets W,3506,5,14,8,14,41,51,-10,50
Rapid Vienna,3506,6,12,13,11,55,40,15,49
St. Pölten,3506,7,11,9,16,45,64,-19,42
Admira Wacke,3506,8,12,4,20,41,56,-15,40
SV Josko Rie,3506,9,11,5,20,31,48,-17,38
Mattersburg,3506,10,9,7,20,31,54,-23,34
FC Salzburg,3507,1,22,6,8,69,23,46,72
SC Rheindorf,3507,2,18,10,8,52,36,16,64
SK Sturm Gra,3507,3,18,8,10,52,36,16,62
Vienna,3507,4,16,6,14,54,51,3,54
Rapid Vienna,3507,5,14,8,14,58,39,19,50
Admira Wacke,3507,6,13,6,17,40,54,-14,45
RZ Pellets W,3507,7,11,8,17,39,53,-14,41
St. Pölten,3507,8,11,8,17,39,60,-21,41
SV Josko Rie,3507,9,11,6,19,31,56,-25,39
Mattersburg,3507,10,8,10,18,36,62,-26,34
SK Sturm Gra,3508,1,22,7,7,62,33,29,73
FC Salzburg,3508,2,20,7,9,65,34,31,67
Vienna,3508,3,20,4,12,68,50,18,64
SC Rheindorf,3508,4,18,8,10,54,47,7,62
Rapid Vienna,3508,5,15,12,9,61,41,20,57
RZ Pellets W,3508,6,11,7,18,42,53,-11,40
SV Josko Rie,3508,7,9,9,18,35,53,-18,36
Admira Wacke,3508,8,9,8,19,33,61,-28,35
Mattersburg,3508,9,8,10,18,39,58,-19,34
St. Pölten,3508,10,7,10,19,43,72,-29,31
SC Rheindorf,3509,1,20,9,7,58,41,17,69
SK Sturm Gra,3509,2,19,6,11,55,38,17,63
Vienna,3509,3,17,9,10,64,49,15,60
FC Salzburg,3509,4,16,9,11,58,36,22,57
Rapid Vienna,3509,5,14,11,11,54,40,14,53
RZ Pellets W,3509,6,12,9,15,47,58,-11,45
Admira Wacke,3509,7,12,7,17,40,61,-21,43
SV Josko Rie,3509,8,11,7,18,41,52,-11,40
St. Pölten,3509,9,9,9,18,39,57,-18,36
Mattersburg,3509,10,7,10,19,34,58,-24,31
SC Rheindorf,3510,1,22,8,6,61,40,21,74
FC Salzburg,3510,2,22,5,9,68,33,35,71
SK Sturm Gra,3510,3,17,7,12,59,40,19,58
Rapid Vienna,3510,4,14,14,8,55,37,18,56
Vienna,3510,5,16,8,12,64,58,6,56
RZ Pellets W,3510,6,14,8,14,52,56,-4,50
SV Josko Rie,3510,7,11,5,20,34,54,-20,38
Admira Wacke,3510,8,9,8,19,30,57,-27,35
Mattersburg,3510,9,8,8,20,33,54,-21,32
St. Pölten,3510,10,7,9,20,39,66,-27,30
FC Salzburg,3511,1,23,5,8,67,32,35,74
Vienna,3511,2,21,4,11,77,54,23,67
SK Sturm Gra,3511,3,17,5,14,59,41,18,56
Rapid Vienna,3511,4,16,8,12,57,39,18,56
SC Rheindorf,3511,5,16,7,13,55,54,1,55
St. Pölten,3511,6,12,8,16,49,61,-12,44
RZ Pellets W,3511,7,12,7,17,48,59,-11,43
SV Josko Rie,3511,8,10,8,18,38,59,-21,38
Admira Wacke,3511,9,11,5,20,42,72,-30,38
Mattersburg,3511,10,8,11,17,35,56,-21,35
SK Sturm Gra,3512,1,22,6,8,66,30,36,72
FC Salzburg,3512,2,21,7,8,69,37,32,70
SC Rheindorf,3512,3,21,5,10,55,40,15,68
Vienna,3512,4,20,6,10,69,51,18,66
Rapid Vienna,3512,5,12,12,12,56,46,10,48
St. Pölten,3512,6,11,10,15,48,58,-10,43
RZ Pellets W,3512,7,12,6,18,40,57,-17,42
SV Josko Rie,3512,8,10,4,22,32,58,-26,34
Admira Wacke,3512,9,9,5,22,33,65,-32,32
Mattersburg,3512,10,8,7,21,30,56,-26,31
FC Salzburg,3513,1,20,6,10,61,33,28,66
SC Rheindorf,3513,2,18,11,7,57,41,16,65
SK Sturm Gra,3513,3,18,8,10,58,37,21,62
Vienna,3513,4,19,5,12,66,50,16,62
Admira Wacke,3513,5,16,7,13,41,47,-6,55
Rapid Vienna,3513,6,14,11,11,53,38,15,53
RZ Pellets W,3513,7,11,9,16,43,54,-11,42
SV Josko Rie,3513,8,10,4,22,37,58,-21,34
Mattersburg,3513,9,9,6,21,37,66,-29,33
St. Pölten,3513,10,7,9,20,39,68,-29,30
FC Salzburg,3514,1,25,6,5,74,31,43,81
SK Sturm Gra,3514,2,21,7,8,58,33,25,70
SC Rheindorf,3514,3,19,8,9,56,43,13,65
Vienna,3514,4,18,4,14,62,50,12,58
Rapid Vienna,3514,5,12,11,13,54,43,11,47
RZ Pellets W,3514,6,12,9,15,52,61,-9,45
Admira Wacke,3514,7,11,7,18,38,60,-22,40
Mattersburg,3514,8,11,5,20,48,57,-9,38
SV Josko Rie,3514,9,10,4,22,31,57,-26,34
St. Pölten,3514,10,6,9,21,40,78,-38,27
SC Rheindorf,3515,1,19,9,8,53,38,15,66
FC Salzburg,3515,2,19,8,9,59,35,24,65
Vienna,3515,3,18,7,11,63,51,12,61
SK Sturm Gra,3515,4,15,11,10,53,36,17,56
Rapid Vienna,3515,5,13,12,11,57,42,15,51
RZ Pellets W,3515,6,14,9,13,52,53,-1,51
SV Josko Rie,3515,7,13,4,19,42,49,-7,43
Admira Wacke,3515,8,12,7,17,35,57,-22,43
Mattersburg,3515,9,9,7,20,41,63,-22,34
St. Pölten,3515,10,6,10,20,38,69,-31,28
FC Salzburg,3516,1,20,8,8,61,32,29,68
Vienna,3516,2,20,6,10,68,47,21,66
SC Rheindorf,3516,3,19,7,10,54,40,14,64
SK Sturm Gra,3516,4,18,7,11,54,38,16,61
Rapid Vienna,3516,5,15,11,10,64,45,19,56
RZ Pellets W,3516,6,16,6,14,53,53,0,54
Admira Wacke,3516,7,11,8,17,37,55,-18,41
SV Josko Rie,3516,8,10,5,21,34,53,-19,35
Mattersburg,3516,9,7,10,19,35,62,-27,31
St. Pölten,3516,10,5,10,21,37,72,-35,25
FC Salzburg,3517,1,21,7,8,62,27,35,70
SC Rheindorf,3517,2,18,11,7,58,39,19,65
Rapid Vienna,3517,3,18,9,9,54,30,24,63
Vienna,3517,4,18,7,11,64,49,15,61
SK Sturm Gra,3517,5,16,6,14,56,44,12,54
RZ Pellets W,3517,6,14,7,15,45,52,-7,49
Admira Wacke,3517,7,11,7,18,32,57,-25,40
Mattersburg,3517,8,8,11,17,38,57,-19,35
SV Josko Rie,3517,9,9,5,22,34,59,-25,32
St. Pölten,3517,10,6,12,18,40,69,-29,30
SC Rheindorf,3518,1,18,7,11,49,39,10,61
FC Salzburg,3518,2,15,13,8,57,32,25,58
Vienna,3518,3,17,7,12,61,55,6,58
Rapid Vienna,3518,4,14,14,8,56,36,20,56
SK Sturm Gra,3518,5,16,8,12,49,33,16,56
SV Josko Rie,3518,6,14,6,16,43,53,-10,48
Admira Wacke,3518,7,10,12,14,41,58,-17,42
Mattersburg,3518,8,11,8,17,43,52,-9,41
RZ Pellets W,3518,9,11,8,17,46,62,-16,41
St. Pölten,3518,10,6,13,17,43,68,-25,31
FC Salzburg,3519,1,21,8,7,70,32,38,71
SK Sturm Gra,3519,2,19,8,9,56,29,27,65
SC Rheindorf,3519,3,19,7,10,55,39,16,64
Vienna,3519,4,19,6,11,65,49,16,63
Rapid Vienna,3519,5,12,12,12,59,43,16,48
RZ Pellets W,3519,6,14,4,18,47,56,-9,46
SV Josko Rie,3519,7,13,7,16,38,54,-16,46
Admira Wacke,3519,8,10,7,19,36,67,-31,37
Mattersburg,3519,9,9,8,19,37,59,-22,35
St. Pölten,3519,10,5,11,20,35,70,-35,26
SC Rheindorf,3520,1,23,6,7,57,37,20,75
FC Salzburg,3520,2,21,8,7,64,28,36,71
Vienna,3520,3,20,4,12,69,58,11,64
SK Sturm Gra,3520,4,18,9,9,61,32,29,63
Rapid Vienna,3520,5,13,13,10,62,44,18,52
Admira Wacke,3520,6,11,7,18,34,59,-25,40
RZ Pellets W,3520,7,10,8,18,45,63,-18,38
SV Josko Rie,3520,8,10,7,19,35,48,-13,37
St. Pölten,3520,9,6,12,18,39,72,-33,30
Mattersburg,3520,10,7,8,21,36,61,-25,29
SC Rheindorf,3521,1,23,6,7,58,35,23,75
FC Salzburg,3521,2,20,9,7,63,32,31,69
SK Sturm Gra,3521,3,19,8,9,56,32,24,65
Rapid Vienna,3521,4,18,8,10,58,34,24,62
Vienna,3521,5,15,8,13,57,52,5,53
Mattersburg,3521,6,11,10,15,38,47,-9,43
Admira Wacke,3521,7,10,8,18,37,63,-26,38
RZ Pellets W,3521,8,8,11,17,40,57,-17,35
SV Josko Rie,3521,9,8,6,22,30,55,-25,30
St. Pölten,3521,10,8,6,22,39,69,-30,30
FC Salzburg,3522,1,21,6,9,70,33,37,69
SC Rheindorf,3522,2,18,9,9,55,44,11,63
SK Sturm Gra,3522,3,18,7,11,57,35,22,61
Vienna,3522,4,18,4,14,65,54,11,58
Rapid Vienna,3522,5,15,10,11,56,39,17,55
Mattersburg,3522,6,13,8,15,43,55,-12,47
RZ Pellets W,3522,7,12,6,18,42,55,-13,42
Admira Wacke,3522,8,12,6,18,38,62,-24,42
SV Josko Rie,3522,9,11,5,20,34,54,-20,38
St. Pölten,3522,10,7,9,20,41,70,-29,30
SC Rheindorf,3523,1,21,8,7,62,41,21,71
FC Salzburg,3523,2,21,6,9,65,32,33,69
SK Sturm Gra,3523,3,19,7,10,56,34,22,64
Rapid Vienna,3523,4,14,13,9,58,39,19,55
Vienna,3523,5,17,4,15,58,58,0,55
RZ Pellets W,3523,6,14,7,15,49,53,-4,49
SV Josko Rie,3523,7,12,5,19,35,47,-12,41
St. Pölten,3523,8,10,7,19,41,59,-18,37
Admira Wacke,3523,9,10,5,21,31,61,-30,35
Mattersburg,3523,10,7,8,21,37,68,-31,29
SK Sturm Gra,3524,1,20,8,8,69,40,29,68
SC Rheindorf,3524,2,19,9,8,60,47,13,66
Vienna,3524,3,18,7,11,63,54,9,61
FC Salzburg,3524,4,17,9,10,60,39,21,60
Rapid Vienna,3524,5,14,11,11,65,43,22,53
Admira Wacke,3524,6,15,5,16,46,57,-11,50
SV Josko Rie,3524,7,11,5,20,35,53,-18,38
St. Pölten,3524,8,9,10,17,42,66,-24,37
RZ Pellets W,3524,9,9,8,19,43,64,-21,35
Mattersburg,3524,10,8,8,20,32,52,-20,32
SC Rheindorf,3525,1,21,6,9,57,44,13,69
FC Salzburg,3525,2,19,10,7,60,31,29,67
SK Sturm Gra,3525,3,18,8,10,61,36,25,62
Rapid Vienna,3525,4,16,11,9,63,38,25,59
Vienna,3525,5,17,8,11,62,46,16,59
St. Pölten,3525,6,12,7,17,43,69,-26,43
SV Josko Rie,3525,7,12,6,18,41,50,-9,42
Admira Wacke,3525,8,9,10,17,38,63,-25,37
RZ Pellets W,3525,9,8,9,19,39,62,-23,33
Mattersburg,3525,10,6,9,21,38,63,-25,27
FC Salzburg,3526,1,22,6,8,73,32,41,72
SK Sturm Gra,3526,2,21,6,9,58,30,28,69
SC Rheindorf,3526,3,18,9,9,57,40,17,63
Vienna,3526,4,16,7,13,51,48,3,55
Rapid Vienna,3526,5,13,12,11,54,41,13,51
RZ Pellets W,3526,6,14,7,15,52,54,-2,49
Admira Wacke,3526,7,10,9,17,33,55,-22,39
St. Pölten,3526,8,9,9,18,40,63,-23,36
SV Josko Rie,3526,9,9,9,18,30,56,-26,36
Mattersburg,3526,10,6,10,20,29,58,-29,28
FC Salzburg,3527,1,21,9,6,63,26,37,72
SK Sturm Gra,3527,2,19,7,10,65,38,27,64
SC Rheindorf,3527,3,18,8,10,56,47,9,62
Vienna,3527,4,19,3,14,62,48,14,60
Rapid Vienna,3527,5,13,13,10,59,41,18,52
Admira Wacke,3527,6,13,5,18,43,61,-18,44
RZ Pellets W,3527,7,12,5,19,39,56,-17,41
Mattersburg,3527,8,10,11,15,35,52,-17,41
St. Pölten,3527,9,8,9,19,38,64,-26,33
SV Josko Rie,3527,10,8,8,20,37,64,-27,32
SK Sturm Gra,3528,1,24,5,7,72,31,41,77
FC Salzburg,3528,2,22,5,9,73,35,38,71
Vienna,3528,3,20,3,13,76,53,23,63
SC Rheindorf,3528,4,17,7,12,54,49,5,58
Rapid Vienna,3528,5,16,8,12,60,43,17,56
RZ Pellets W,3528,6,12,5,19,44,62,-18,41
SV Josko Rie,3528,7,12,4,20,39,58,-19,40
Mattersburg,3528,8,10,7,19,40,58,-18,37
Admira Wacke,3528,9,10,7,19,33,69,-36,37
St. Pölten,3528,10,8,7,21,39,72,-33,31
SK Sturm Gra,3529,1,21,8,7,57,28,29,71
SC Rheindorf,3529,2,19,9,8,59,44,15,66
FC Salzburg,3529,3,19,7,10,64,33,31,64
Vienna,3529,4,19,4,13,67,54,13,61
Rapid Vienna,3529,5,14,11,11,56,40,16,53
RZ Pellets W,3529,6,14,8,14,55,54,1,50
Admira Wacke,3529,7,11,8,17,39,60,-21,41
SV Josko Rie,3529,8,10,5,21,32,57,-25,35
Mattersburg,3529,9,8,8,20,36,58,-22,32
St. Pölten,3529,10,6,10,20,36,73,-37,28
FC Salzburg,3530,1,20,9,7,73,35,38,69
SK Sturm Gra,3530,2,19,8,9,64,37,27,65
SC Rheindorf,3530,3,17,8,11,58,48,10,59
Vienna,3530,4,17,8,11,59,50,9,59
Rapid Vienna,3530,5,12,13,11,57,45,12,49
Admira Wacke,3530,6,12,8,16,35,55,-20,44
RZ Pellets W,3530,7,11,8,17,47,58,-11,41
St. Pölten,3530,8,10,10,16,42,58,-16,40
Mattersburg,3530,9,10,9,17,38,57,-19,39
SV Josko Rie,3530,10,9,5,22,27,57,-30,32
FC Salzburg,3531,1,23,4,9,67,37,30,73
SK Sturm Gra,3531,2,20,6,10,67,33,34,66
SC Rheindorf,3531,3,17,8,11,52,46,6,59
Rapid Vienna,3531,4,15,10,11,55,37,18,55
Vienna,3531,5,15,7,14,55,51,4,52
RZ Pellets W,3531,6,15,6,15,50,55,-5,51
Admira Wacke,3531,7,12,7,17,36,55,-19,43
Mattersburg,3531,8,10,7,19,38,56,-18,37
St. Pölten,3531,9,8,11,17,44,68,-24,35
SV Josko Rie,3531,10,9,6,21,39,65,-26,33
FC Salzburg,3532,1,20,6,10,62,36,26,66
SC Rheindorf,3532,2,18,11,7,51,34,17,65
SK Sturm Gra,3532,3,19,7,10,59,37,22,64
Vienna,3532,4,20,4,12,64,48,16,64
Rapid Vienna,3532,5,11,13,12,52,43,9,46
Admira Wacke,3532,6,14,4,18,43,61,-18,46
RZ Pellets W,3532,7,12,7,17,45,52,-7,43
SV Josko Rie,3532,8,12,3,21,39,62,-23,39
St. Pölten,3532,9,9,9,18,44,68,-24,36
Mattersburg,3532,10,9,8,19,41,59,-18,35
Vienna,3533,1,22,4,10,63,47,16,70
FC Salzburg,3533,2,19,8,9,60,32,28,65
SC Rheindorf,3533,3,19,8,9,58,43,15,65
Rapid Vienna,3533,4,15,10,11,61,39,22,55
SK Sturm Gra,3533,5,15,7,14,53,37,16,52
RZ Pellets W,3533,6,15,6,15,47,54,-7,51
Admira Wacke,3533,7,12,6,18,42,66,-24,42
SV Josko Rie,3533,8,11,6,19,35,59,-24,39
Mattersburg,3533,9,7,11,18,36,54,-18,32
St. Pölten,3533,10,8,8,20,43,67,-24,32
FC Salzburg,3534,1,23,6,7,74,32,42,75
SC Rheindorf,3534,2,18,10,8,54,41,13,64
Vienna,3534,3,18,4,14,71,57,14,58
Rapid Vienna,3534,4,15,11,10,55,38,17,56
SK Sturm Gra,3534,5,16,8,12,52,36,16,56
RZ Pellets W,3534,6,12,8,16,46,59,-13,44
Admira Wacke,3534,7,12,6,18,38,56,-18,42
Mattersburg,3534,8,10,11,15,41,52,-11,41
St. Pölten,3534,9,9,7,20,38,68,-30,34
SV Josko Rie,3534,10,8,7,21,35,65,-30,31
SK Sturm Gra,3535,1,20,6,10,55,35,20,66
SC Rheindorf,3535,2,19,8,9,49,39,10,65
FC Salzburg,3535,3,17,11,8,57,31,26,62
Rapid Vienna,3535,4,15,10,11,58,42,16,55
Vienna,3535,5,17,4,15,56,52,4,55
RZ Pellets W,3535,6,13,9,14,47,49,-2,48
Admira Wacke,3535,7,12,6,18,37,56,-19,42
SV Josko Rie,3535,8,10,7,19,34,48,-14,37
Mattersburg,3535,9,9,8,19,35,55,-20,35
St. Pölten,3535,10,8,11,17,39,60,-21,35
FC Salzburg,3536,1,24,6,6,77,31,46,78
SC Rheindorf,3536,2,20,9,7,59,44,15,69
Vienna,3536,3,20,3,13,65,49,16,63
SK Sturm Gra,3536,4,15,10,11,54,37,17,55
Rapid Vienna,3536,5,15,9,12,54,35,19,54
Admira Wacke,3536,6,15,4,17,41,55,-14,49
RZ Pellets W,3536,7,12,7,17,48,63,-15,43
SV Josko Rie,3536,8,12,3,21,37,63,-26,39
Mattersburg,3536,9,8,7,21,37,57,-20,31
St. Pölten,3536,10,6,8,22,41,79,-38,26
FC Salzburg,3537,1,19,9,8,54,25,29,66
SK Sturm Gra,3537,2,20,6,10,60,38,22,66
SC Rheindorf,3537,3,19,9,8,52,39,13,66
Vienna,3537,4,19,5,12,65,49,16,62
RZ Pellets W,3537,5,15,7,14,52,52,0,52
Rapid Vienna,3537,6,11,12,13,50,44,6,45
SV Josko Rie,3537,7,10,7,19,37,54,-17,37
Admira Wacke,3537,8,10,7,19,33,59,-26,37
Mattersburg,3537,9,8,11,17,40,58,-18,35
St. Pölten,3537,10,8,9,19,49,74,-25,33
FC Salzburg,3538,1,23,7,6,67,27,40,76
Vienna,3538,2,19,6,11,64,51,13,63
SK Sturm Gra,3538,3,17,8,11,56,36,20,59
SC Rheindorf,3538,4,17,8,11,55,45,10,59
Rapid Vienna,3538,5,14,9,13,51,40,11,51
RZ Pellets W,3538,6,15,5,16,45,52,-7,50
Admira Wacke,3538,7,11,7,18,34,53,-19,40
SV Josko Rie,3538,8,11,5,20,35,58,-23,38
Mattersburg,3538,9,9,8,19,39,54,-15,35
St. Pölten,3538,10,8,9,19,39,69,-30,33
FC Salzburg,3539,1,23,6,7,67,30,37,75
Vienna,3539,2,21,6,9,64,45,19,69
SK Sturm Gra,3539,3,21,5,10,56,29,27,68
SC Rheindorf,3539,4,18,10,8,48,38,10,64
Rapid Vienna,3539,5,15,11,10,57,36,21,56
Admira Wacke,3539,6,12,8,16,45,58,-13,44
RZ Pellets W,3539,7,11,7,18,47,63,-16,40
St. Pölten,3539,8,7,10,19,38,64,-26,31
SV Josko Rie,3539,9,9,3,24,25,55,-30,30
Mattersburg,3539,10,6,8,22,35,64,-29,26
SK Sturm Gra,3540,1,22,5,9,64,28,36,71
FC Salzburg,3540,2,21,5,10,73,33,40,68
SC Rheindorf,3540,3,18,7,11,55,45,10,61
Vienna,3540,4,17,5,14,55,53,2,56
Rapid Vienna,3540,5,11,15,10,46,35,11,48
RZ Pellets W,3540,6,13,8,15,45,52,-7,47
Admira Wacke,3540,7,12,9,15,44,60,-16,45
SV Josko Rie,3540,8,12,6,18,34,52,-18,42
St. Pölten,3540,9,7,12,17,42,68,-26,33
Mattersburg,3540,10,7,8,21,30,62,-32,29
SK Sturm Gra,3541,1,19,8,9,58,30,28,65
Vienna,3541,2,19,7,10,60,43,17,64
FC Salzburg,3541,3,18,9,9,57,30,27,63
SC Rheindorf,3541,4,17,10,9,52,45,7,61
Rapid Vienna,3541,5,12,9,15,53,44,9,45
SV Josko Rie,3541,6,13,6,17,34,46,-12,45
Admira Wacke,3541,7,11,10,15,36,54,-18,43
St. Pölten,3541,8,10,11,15,40,60,-20,41
RZ Pellets W,3541,9,11,7,18,48,61,-13,40
Mattersburg,3541,10,7,9,20,31,56,-25,30
FC Salzburg,3542,1,22,8,6,64,26,38,74
SC Rheindorf,3542,2,20,7,9,54,42,12,67
SK Sturm Gra,3542,3,20,5,11,61,35,26,65
Vienna,3542,4,18,5,13,61,52,9,59
RZ Pellets W,3542,5,14,7,15,46,48,-2,49
Rapid Vienna,3542,6,10,16,10,47,37,10,46
SV Josko Rie,3542,7,10,7,19,32,50,-18,37
Admira Wacke,3542,8,9,8,19,32,60,-28,35
Mattersburg,3542,9,8,10,18,35,54,-19,34
St. Pölten,3542,10,8,9,19,31,59,-28,33
FC Salzburg,3543,1,20,7,9,68,35,33,67
SC Rheindorf,3543,2,20,6,10,52,41,11,66
Vienna,3543,3,19,4,13,59,48,11,61
SK Sturm Gra,3543,4,17,8,11,52,32,20,59
Rapid Vienna,3543,5,15,11,10,65,42,23,56
RZ Pellets W,3543,6,13,9,14,48,55,-7,48
SV Josko Rie,3543,7,12,6,18,33,47,-14,42
Admira Wacke,3543,8,10,7,19,36,66,-30,37
St. Pölten,3543,9,8,10,18,42,67,-25,34
Mattersburg,3543,10,7,10,19,31,53,-22,31
FC Salzburg,3544,1,19,11,6,65,32,33,68
SC Rheindorf,3544,2,19,7,10,53,39,14,64
Rapid Vienna,3544,3,15,11,10,59,41,18,56
SK Sturm Gra,3544,4,16,7,13,52,36,16,55
Vienna,3544,5,15,6,15,54,57,-3,51
RZ Pellets W,3544,6,14,8,14,46,48,-2,50
Mattersburg,3544,7,11,7,18,42,55,-13,40
SV Josko Rie,3544,8,11,6,19,34,53,-19,39
St. Pölten,3544,9,10,9,17,44,66,-22,39
Admira Wacke,3544,10,11,6,19,36,58,-22,39
FC Salzburg,3545,1,20,6,10,57,28,29,66
SK Sturm Gra,3545,2,19,8,9,56,32,24,65
SC Rheindorf,3545,3,19,8,9,58,42,16,65
Vienna,3545,4,19,6,11,62,47,15,63
Rapid Vienna,3545,5,18,7,11,58,34,24,61
RZ Pellets W,3545,6,12,6,18,42,56,-14,42
Admira Wacke,3545,7,12,5,19,37,60,-23,41
St. Pölten,3545,8,9,10,17,46,67,-21,37
Mattersburg,3545,9,8,8,20,34,56,-22,32
SV Josko Rie,3545,10,8,8,20,30,58,-28,32
FC Salzburg,3546,1,24,7,5,73,27,46,79
Vienna,3546,2,18,7,11,63,51,12,61
SK Sturm Gra,3546,3,16,9,11,58,42,16,57
SC Rheindorf,3546,4,17,5,14,61,55,6,56
Rapid Vienna,3546,5,13,11,12,56,41,15,50
RZ Pellets W,3546,6,12,10,14,49,57,-8,46
Mattersburg,3546,7,10,10,16,44,54,-10,40
SV Josko Rie,3546,8,10,8,18,40,61,-21,38
St. Pölten,3546,9,9,11,16,41,64,-23,38
Admira Wacke,3546,10,8,8,20,31,64,-33,32
FC Salzburg,3547,1,25,6,5,76,26,50,81
SC Rheindorf,3547,2,21,7,8,59,45,14,70
SK Sturm Gra,3547,3,21,5,10,56,31,25,68
Vienna,3547,4,18,5,13,60,45,15,59
Rapid Vienna,3547,5,14,11,11,54,38,16,53
RZ Pellets W,3547,6,12,5,19,44,59,-15,41
SV Josko Rie,3547,7,11,6,19,35,54,-19,39
Admira Wacke,3547,8,10,9,17,35,57,-22,39
Mattersburg,3547,9,7,7,22,34,61,-27,28
St. Pölten,3547,10,7,7,22,38,75,-37,28
SC Rheindorf,3548,1,20,7,9,58,39,19,67
SK Sturm Gra,3548,2,19,7,10,58,36,22,64
Vienna,3548,3,19,7,10,61,46,15,64
FC Salzburg,3548,4,18,7,11,63,40,23,61
RZ Pellets W,3548,5,14,8,14,44,50,-6,50
Rapid Vienna,3548,6,13,9,14,52,44,8,48
SV Josko Rie,3548,7,11,7,18,39,53,-14,40
Mattersburg,3548,8,10,8,18,34,52,-18,38
Admira Wacke,3548,9,11,4,21,34,64,-30,37
St. Pölten,3548,10,8,10,18,39,58,-19,34
FC Salzburg,3549,1,20,8,8,62,29,33,68
SC Rheindorf,3549,2,20,8,8,59,41,18,68
SK Sturm Gra,3549,3,20,6,10,60,32,28,66
Vienna,3549,4,16,8,12,53,52,1,56
Rapid Vienna,3549,5,14,10,12,52,38,14,52
SV Josko Rie,3549,6,14,4,18,32,48,-16,46
RZ Pellets W,3549,7,9,13,14,37,48,-11,40
Mattersburg,3549,8,9,10,17,39,52,-13,37
Admira Wacke,3549,9,9,8,19,33,60,-27,35
St. Pölten,3549,10,7,9,20,41,68,-27,30
FC Salzburg,3550,1,23,8,5,73,33,40,77
SK Sturm Gra,3550,2,18,7,11,61,37,24,61
SC Rheindorf,3550,3,16,10,10,58,45,13,58
Vienna,3550,4,16,3,17,55,55,0,51
Rapid Vienna,3550,5,13,10,13,56,42,14,49
St. Pölten,3550,6,11,12,13,44,58,-14,45
RZ Pellets W,3550,7,11,10,15,44,51,-7,43
Mattersburg,3550,8,12,6,18,47,64,-17,42
SV Josko Rie,3550,9,11,5,20,41,66,-25,38
Admira Wacke,3550,10,10,7,19,33,61,-28,37
FC Salzburg,3551,1,22,7,7,67,28,39,73
SC Rheindorf,3551,2,22,6,8,60,38,22,72
Vienna,3551,3,19,5,12,69,51,18,62
Rapid Vienna,3551,4,15,9,12,48,37,11,54
SK Sturm Gra,3551,5,16,4,16,55,44,11,52
RZ Pellets W,3551,6,13,9,14,47,51,-4,48
Admira Wacke,3551,7,14,5,17,39,55,-16,47
SV Josko Rie,3551,8,9,7,20,34,61,-27,34
Mattersburg,3551,9,7,11,18,31,55,-24,32
St. Pölten,3551,10,7,9,20,35,65,-30,30
Vienna,3552,1,21,5,10,70,49,21,68
SC Rheindorf,3552,2,19,10,7,54,42,12,67
FC Salzburg,3552,3,17,11,8,65,35,30,62
Rapid Vienna,3552,4,16,9,11,53,35,18,57
SK Sturm Gra,3552,5,15,7,14,52,41,11,52
RZ Pellets W,3552,6,13,9,14,43,58,-15,48
St. Pölten,3552,7,10,11,15,45,54,-9,41
SV Josko Rie,3552,8,10,7,19,38,57,-19,37
Admira Wacke,3552,9,10,6,20,36,63,-27,36
Mattersburg,3552,10,8,7,21,44,66,-22,31
Vienna,3553,1,20,8,8,68,50,18,68
FC Salzburg,3553,2,20,7,9,60,28,32,67
SC Rheindorf,3553,3,18,8,10,58,48,10,62
SK Sturm Gra,3553,4,17,9,10,55,38,17,60
Rapid Vienna,3553,5,13,13,10,57,42,15,52
RZ Pellets W,3553,6,13,8,15,55,60,-5,47
St. Pölten,3553,7,9,12,15,42,57,-15,39
Admira Wacke,3553,8,9,8,19,34,59,-25,35
SV Josko Rie,3553,9,10,5,21,30,60,-30,35
Mattersburg,3553,10,8,8,20,41,58,-17,32
SK Sturm Gra,3554,1,22,4,10,65,31,34,70
FC Salzburg,3554,2,19,9,8,67,36,31,66
SC Rheindorf,3554,3,19,7,10,62,46,16,64
Vienna,3554,4,19,3,14,67,60,7,60
RZ Pellets W,3554,5,13,8,15,55,59,-4,47
Admira Wacke,3554,6,13,6,17,41,63,-22,45
Rapid Vienna,3554,7,10,14,12,53,46,7,44
SV Josko Rie,3554,8,12,4,20,36,61,-25,40
Mattersburg,3554,9,11,6,19,44,62,-18,39
St. Pölten,3554,10,7,9,20,40,66,-26,30
FC Salzburg,3555,1,20,7,9,62,28,34,67
SK Sturm Gra,3555,2,19,7,10,65,38,27,64
SC Rheindorf,3555,3,19,5,12,54,42,12,62
Rapid Vienna,3555,4,16,9,11,61,37,24,57
Vienna,3555,5,16,6,14,55,58,-3,54
SV Josko Rie,3555,6,14,5,17,38,49,-11,47
RZ Pellets W,3555,7,13,7,16,50,56,-6,46
Admira Wacke,3555,8,10,10,16,35,57,-22,40
Mattersburg,3555,9,10,7,19,37,60,-23,37
St. Pölten,3555,10,8,7,21,39,71,-32,31
FC Salzburg,3556,1,21,11,4,68,29,39,74
SC Rheindorf,3556,2,20,7,9,60,42,18,67
SK Sturm Gra,3556,3,19,4,13,59,39,20,61
Rapid Vienna,3556,4,17,9,10,60,41,19,60
Vienna,3556,5,18,5,13,60,52,8,59
RZ Pellets W,3556,6,15,7,14,56,54,2,52
SV Josko Rie,3556,7,10,6,20,34,58,-24,36
St. Pölten,3556,8,9,8,19,37,63,-26,35
Mattersburg,3556,9,7,10,19,37,57,-20,31
Admira Wacke,3556,10,8,5,23,33,69,-36,29
FC Salzburg,3557,1,22,8,6,64,27,37,74
SC Rheindorf,3557,2,20,6,10,57,43,14,66
SK Sturm Gra,3557,3,19,7,10,55,31,24,64
Vienna,3557,4,19,6,11,63,49,14,63
RZ Pellets W,3557,5,17,6,13,60,47,13,57
Rapid Vienna,3557,6,13,12,11,52,41,11,51
SV Josko Rie,3557,7,10,5,21,37,57,-20,35
Mattersburg,3557,8,8,11,17,38,59,-21,35
Admira Wacke,3557,9,8,6,22,33,67,-34,30
St. Pölten,3557,10,6,9,21,34,72,-38,27
FC Salzburg,3558,1,22,7,7,74,27,47,73
SK Sturm Gra,3558,2,21,6,9,56,31,25,69
SC Rheindorf,3558,3,18,7,11,53,47,6,61
Vienna,3558,4,17,7,12,61,48,13,58
Rapid Vienna,3558,5,15,11,10,57,41,16,56
RZ Pellets W,3558,6,13,7,16,46,54,-8,46
Admira Wacke,3558,7,12,7,17,40,61,-21,43
SV Josko Rie,3558,8,9,10,17,29,46,-17,37
St. Pölten,3558,9,8,9,19,34,61,-27,33
Mattersburg,3558,10,5,9,22,28,62,-34,24
FC Salzburg,3559,1,22,8,6,61,25,36,74
SC Rheindorf,3559,2,20,8,8,59,44,15,68
Vienna,3559,3,19,6,11,65,47,18,63
SK Sturm Gra,3559,4,18,7,11,61,39,22,61
Rapid Vienna,3559,5,11,12,13,52,43,9,45
RZ Pellets W,3559,6,12,9,15,45,54,-9,45
SV Josko Rie,3559,7,12,5,19,33,48,-15,41
Admira Wacke,3559,8,10,7,19,36,64,-28,37
St. Pölten,3559,9,9,9,18,37,59,-22,36
Mattersburg,3559,10,7,9,20,31,57,-26,30
FC Salzburg,3560,1,21,6,9,69,30,39,69
SK Sturm Gra,3560,2,20,5,11,57,27,30,65
SC Rheindorf,3560,3,18,9,9,55,45,10,63
Vienna,3560,4,18,4,14,60,53,7,58
Rapid Vienna,3560,5,14,11,11,53,40,13,53
St. Pölten,3560,6,11,8,17,44,59,-15,41
SV Josko Rie,3560,7,12,5,19,37,57,-20,41
RZ Pellets W,3560,8,12,5,19,45,66,-21,41
Mattersburg,3560,9,9,10,17,47,66,-19,37
Admira Wacke,3560,10,10,7,19,37,61,-24,37
FC Salzburg,3561,1,22,8,6,73,29,44,74
SC Rheindorf,3561,2,20,6,10,54,40,14,66
SK Sturm Gra,3561,3,19,7,10,62,44,18,64
Vienna,3561,4,15,6,15,52,48,4,51
Admira Wacke,3561,5,13,8,15,45,57,-12,47
RZ Pellets W,3561,6,12,9,15,42,49,-7,45
SV Josko Rie,3561,7,13,6,17,36,48,-12,45
Rapid Vienna,3561,8,11,11,14,50,46,4,44
Mattersburg,3561,9,7,12,17,36,63,-27,33
St. Pölten,3561,10,7,9,20,39,65,-26,30
SK Sturm Gra,3562,1,20,7,9,59,33,26,67
SC Rheindorf,3562,2,20,7,9,57,39,18,67
Vienna,3562,3,20,4,12,66,55,11,64
FC Salzburg,3562,4,17,9,10,56,34,22,60
Rapid Vienna,3562,5,13,11,12,56,45,11,50
Admira Wacke,3562,6,14,8,14,53,52,1,50
SV Josko Rie,3562,7,13,4,19,41,60,-19,43
RZ Pellets W,3562,8,10,8,18,40,57,-17,38
Mattersburg,3562,9,9,8,19,39,59,-20,35
St. Pölten,3562,10,6,10,20,36,69,-33,28
SC Rheindorf,3563,1,20,7,9,58,46,12,67
FC Salzburg,3563,2,19,9,8,63,33,30,66
SK Sturm Gra,3563,3,19,8,9,61,35,26,65
Vienna,3563,4,19,5,12,65,48,17,62
RZ Pellets W,3563,5,16,5,15,47,54,-7,53
Rapid Vienna,3563,6,13,11,12,52,43,9,50
Mattersburg,3563,7,11,7,18,46,57,-11,40
Admira Wacke,3563,8,10,8,18,37,61,-24,38
St. Pölten,3563,9,9,8,19,43,64,-21,35
SV Josko Rie,3563,10,7,6,23,30,61,-31,27
SC Rheindorf,3564,1,18,9,9,49,41,8,63
FC Salzburg,3564,2,18,8,10,61,34,27,62
SK Sturm Gra,3564,3,17,8,11,58,38,20,59
Vienna,3564,4,17,8,11,64,53,11,59
RZ Pellets W,3564,5,17,6,13,55,51,4,57
Rapid Vienna,3564,6,14,13,9,60,37,23,55
SV Josko Rie,3564,7,11,9,16,37,54,-17,42
Admira Wacke,3564,8,10,8,18,36,63,-27,38
St. Pölten,3564,9,9,10,17,43,63,-20,37
Mattersburg,3564,10,6,7,23,31,60,-29,25
FC Salzburg,3565,1,22,7,7,70,35,35,73
SK Sturm Gra,3565,2,22,5,9,62,33,29,71
SC Rheindorf,3565,3,21,6,9,61,40,21,69
Rapid Vienna,3565,4,15,8,13,57,44,13,53
Vienna,3565,5,16,4,16,58,55,3,52
RZ Pellets W,3565,6,14,6,16,47,53,-6,48
Admira Wacke,3565,7,13,6,17,38,56,-18,45
SV Josko Rie,3565,8,10,7,19,35,54,-19,37
Mattersburg,3565,9,8,9,19,36,58,-22,33
St. Pölten,3565,10,5,10,21,34,70,-36,25
FC Salzburg,3566,1,21,9,6,66,32,34,72
Vienna,3566,2,21,5,10,72,48,24,68
SC Rheindorf,3566,3,17,8,11,64,57,7,59
SK Sturm Gra,3566,4,17,7,12,55,37,18,58
RZ Pellets W,3566,5,17,6,13,52,49,3,57
Rapid Vienna,3566,6,16,8,12,61,42,19,56
SV Josko Rie,3566,7,10,7,19,35,54,-19,37
St. Pölten,3566,8,8,13,15,51,73,-22,37
Admira Wacke,3566,9,8,6,22,36,66,-30,30
Mattersburg,3566,10,7,7,22,35,69,-34,28
SK Sturm Gra,3567,1,21,6,9,64,28,36,69
SC Rheindorf,3567,2,21,6,9,55,37,18,69
Vienna,3567,3,18,6,12,61,47,14,60
FC Salzburg,3567,4,16,11,9,64,41,23,59
Rapid Vienna,3567,5,12,11,13,51,40,11,47
RZ Pellets W,3567,6,14,5,17,42,55,-13,47
St. Pölten,3567,7,10,10,16,43,57,-14,40
Admira Wacke,3567,8,11,7,18,35,63,-28,40
SV Josko Rie,3567,9,10,7,19,32,53,-21,37
Mattersburg,3567,10,9,7,20,35,61,-26,34
FC Salzburg,3568,1,22,7,7,73,35,38,73
SC Rheindorf,3568,2,18,11,7,60,43,17,65
SK Sturm Gra,3568,3,19,6,11,60,37,23,63
Vienna,3568,4,17,7,12,61,49,12,58
Rapid Vienna,3568,5,11,16,9,54,39,15,49
Admira Wacke,3568,6,12,7,17,39,61,-22,43
SV Josko Rie,3568,7,12,6,18,34,47,-13,42
RZ Pellets W,3568,8,11,8,17,43,56,-13,41
St. Pölten,3568,9,9,8,19,39,67,-28,35
Mattersburg,3568,10,7,8,21,35,64,-29,29
SK Sturm Gra,3569,1,22,8,6,60,27,33,74
FC Salzburg,3569,2,21,7,8,66,29,37,70
Vienna,3569,3,20,7,9,72,47,25,67
SC Rheindorf,3569,4,17,12,7,58,44,14,63
Rapid Vienna,3569,5,12,14,10,56,41,15,50
Admira Wacke,3569,6,11,6,19,40,65,-25,39
St. Pölten,3569,7,9,8,19,38,61,-23,35
RZ Pellets W,3569,8,9,7,20,43,65,-22,34
SV Josko Rie,3569,9,10,4,22,34,66,-32,34
Mattersburg,3569,10,7,11,18,35,57,-22,32
SC Rheindorf,3570,1,21,8,7,61,41,20,71
FC Salzburg,3570,2,17,10,9,65,38,27,61
SK Sturm Gra,3570,3,16,10,10,63,44,19,58
Rapid Vienna,3570,4,14,12,10,57,40,17,54
Vienna,3570,5,15,9,12,59,56,3,54
Admira Wacke,3570,6,13,8,15,39,54,-15,47
RZ Pellets W,3570,7,12,8,16,42,54,-12,44
St. Pölten,3570,8,9,11,16,38,58,-20,38
SV Josko Rie,3570,9,10,7,19,31,49,-18,37
Mattersburg,3570,10,6,11,19,34,55,-21,29
SC Rheindorf,3571,1,21,6,9,57,39,18,69
FC Salzburg,3571,2,20,6,10,67,37,30,66
Vienna,3571,3,20,5,11,71,53,18,65
Rapid Vienna,3571,4,16,11,9,59,41,18,59
SK Sturm Gra,3571,5,16,10,10,60,40,20,58
Admira Wacke,3571,6,13,8,15,47,60,-13,47
RZ Pellets W,3571,7,10,8,18,48,60,-12,38
Mattersburg,3571,8,9,8,19,36,57,-21,35
St. Pölten,3571,9,8,9,19,41,66,-25,33
SV Josko Rie,3571,10,9,5,22,29,62,-33,32
FC Salzburg,3572,1,23,6,7,76,31,45,75
SC Rheindorf,3572,2,23,6,7,59,40,19,75
SK Sturm Gra,3572,3,20,4,12,62,38,24,64
Vienna,3572,4,19,4,13,65,53,12,61
Rapid Vienna,3572,5,13,11,12,52,41,11,50
Admira Wacke,3572,6,13,5,18,39,56,-17,44
RZ Pellets W,3572,7,11,5,20,45,66,-21,38
Mattersburg,3572,8,10,6,20,39,58,-19,36
St. Pölten,3572,9,9,7,20,44,66,-22,34
SV Josko Rie,3572,10,10,4,22,27,59,-32,34
FC Salzburg,3573,1,20,10,6,61,30,31,70
SC Rheindorf,3573,2,16,12,8,52,43,9,60
Vienna,3573,3,18,5,13,60,53,7,59
SK Sturm Gra,3573,4,16,8,12,54,34,20,56
RZ Pellets W,3573,5,15,9,12,44,43,1,54
Rapid Vienna,3573,6,12,13,11,51,37,14,49
SV Josko Rie,3573,7,11,8,17,36,49,-13,41
Admira Wacke,3573,8,11,8,17,37,56,-19,41
St. Pölten,3573,9,8,11,17,41,65,-24,35
Mattersburg,3573,10,5,12,19,26,52,-26,27
Rapid Vienna,3574,1,19,10,7,71,35,36,67
FC Salzburg,3574,2,19,10,7,60,29,31,67
Vienna,3574,3,17,9,10,59,53,6,60
SK Sturm Gra,3574,4,17,8,11,58,34,24,59
SC Rheindorf,3574,5,16,10,10,52,42,10,58
Mattersburg,3574,6,11,8,17,42,53,-11,41
SV Josko Rie,3574,7,11,6,19,35,53,-18,39
Admira Wacke,3574,8,11,6,19,31,63,-32,39
RZ Pellets W,3574,9,10,7,19,42,59,-17,37
St. Pölten,3574,10,8,8,20,36,65,-29,32
FC Salzburg,3575,1,20,9,7,71,38,33,69
Vienna,3575,2,19,5,12,64,49,15,62
SK Sturm Gra,3575,3,17,6,13,55,42,13,57
SC Rheindorf,3575,4,16,7,13,49,46,3,55
Rapid Vienna,3575,5,15,9,12,57,45,12,54
RZ Pellets W,3575,6,15,6,15,54,54,0,51
Admira Wacke,3575,7,12,8,16,41,58,-17,44
St. Pölten,3575,8,10,9,17,48,68,-20,39
Mattersburg,3575,9,10,7,19,38,57,-19,37
SV Josko Rie,3575,10,11,4,21,30,50,-20,37
FC Salzburg,3576,1,22,9,5,69,29,40,75
SC Rheindorf,3576,2,21,6,9,55,42,13,69
Vienna,3576,3,19,6,11,66,50,16,63
SK Sturm Gra,3576,4,18,6,12,58,38,20,60
Rapid Vienna,3576,5,13,12,11,50,40,10,51
RZ Pellets W,3576,6,12,9,15,46,55,-9,45
Admira Wacke,3576,7,12,6,18,36,59,-23,42
SV Josko Rie,3576,8,9,8,19,33,55,-22,35
Mattersburg,3576,9,7,10,19,38,55,-17,31
St. Pölten,3576,10,6,10,20,35,63,-28,28
FC Salzburg,3577,1,22,7,7,76,36,40,73
SK Sturm Gra,3577,2,19,8,9,60,35,25,65
Rapid Vienna,3577,3,18,8,10,67,38,29,62
SC Rheindorf,3577,4,17,10,9,59,48,11,61
Vienna,3577,5,18,6,12,62,52,10,60
RZ Pellets W,3577,6,13,6,17,46,57,-11,45
Mattersburg,3577,7,12,7,17,48,56,-8,43
St. Pölten,3577,8,9,10,17,40,62,-22,37
Admira Wacke,3577,9,8,6,22,35,71,-36,30
SV Josko Rie,3577,10,7,6,23,32,70,-38,27
SC Rheindorf,3578,1,19,9,8,54,39,15,66
SK Sturm Gra,3578,2,19,8,9,55,33,22,65
FC Salzburg,3578,3,18,10,8,60,36,24,64
Vienna,3578,4,17,4,15,61,57,4,55
Rapid Vienna,3578,5,14,11,11,55,40,15,53
SV Josko Rie,3578,6,14,5,17,48,56,-8,47
RZ Pellets W,3578,7,11,9,16,43,55,-12,42
Admira Wacke,3578,8,11,5,20,42,69,-27,38
St. Pölten,3578,9,8,11,17,43,60,-17,35
Mattersburg,3578,10,7,12,17,37,53,-16,33
SC Rheindorf,3579,1,22,8,6,63,41,22,74
SK Sturm Gra,3579,2,21,5,10,62,33,29,68
FC Salzburg,3579,3,20,7,9,57,33,24,67
Vienna,3579,4,20,6,10,70,52,18,66
Rapid Vienna,3579,5,11,12,13,55,38,17,45
RZ Pellets W,3579,6,11,10,15,46,59,-13,43
Admira Wacke,3579,7,12,4,20,34,63,-29,40
St. Pölten,3579,8,8,11,17,36,56,-20,35
SV Josko Rie,3579,9,11,2,23,32,56,-24,35
Mattersburg,3579,10,7,9,20,37,61,-24,30
FC Salzburg,3580,1,25,6,5,76,28,48,81
SC Rheindorf,3580,2,21,5,10,57,40,17,68
Vienna,3580,3,21,4,11,67,55,12,67
SK Sturm Gra,3580,4,18,7,11,65,44,21,61
Admira Wacke,3580,5,13,5,18,37,57,-20,44
Rapid Vienna,3580,6,11,9,16,51,45,6,42
Mattersburg,3580,7,12,5,19,42,60,-18,41
RZ Pellets W,3580,8,10,6,20,44,71,-27,36
SV Josko Rie,3580,9,10,5,21,36,55,-19,35
St. Pölten,3580,10,9,8,19,45,65,-20,35
FC Salzburg,3581,1,22,9,5,70,29,41,75
Vienna,3581,2,18,6,12,63,53,10,60
SK Sturm Gra,3581,3,18,5,13,57,39,18,59
SC Rheindorf,3581,4,15,12,9,46,41,5,57
RZ Pellets W,3581,5,15,8,13,48,48,0,53
Rapid Vienna,3581,6,14,8,14,55,46,9,50
St. Pölten,3581,7,11,9,16,45,59,-14,42
Mattersburg,3581,8,9,10,17,34,54,-20,37
SV Josko Rie,3581,9,9,7,20,33,53,-20,34
Admira Wacke,3581,10,9,6,21,35,64,-29,33
FC Salzburg,3582,1,20,8,8,65,34,31,68
SC Rheindorf,3582,2,20,7,9,61,43,18,67
SK Sturm Gra,3582,3,19,6,11,61,32,29,63
Vienna,3582,4,17,6,13,69,63,6,57
Rapid Vienna,3582,5,14,13,9,60,40,20,55
RZ Pellets W,3582,6,10,10,16,40,53,-13,40
Admira Wacke,3582,7,11,7,18,34,64,-30,40
SV Josko Rie,3582,8,11,6,19,41,57,-16,39
Mattersburg,3582,9,10,6,20,40,63,-23,36
St. Pölten,3582,10,8,11,17,38,60,-22,35
SC Rheindorf,3583,1,20,8,8,63,48,15,68
FC Salzburg,3583,2,18,13,5,64,29,35,67
SK Sturm Gra,3583,3,20,6,10,64,32,32,66
Vienna,3583,4,19,7,10,64,47,17,64
RZ Pellets W,3583,5,13,10,13,50,53,-3,49
Rapid Vienna,3583,6,11,12,13,52,46,6,45
SV Josko Rie,3583,7,12,8,16,41,48,-7,44
Admira Wacke,3583,8,11,8,17,33,53,-20,41
St. Pölten,3583,9,7,6,23,40,79,-39,27
Mattersburg,3583,10,5,10,21,33,69,-36,25
SK Sturm Gra,3584,1,21,5,10,67,35,32,68
FC Salzburg,3584,2,19,8,9,60,35,25,65
Vienna,3584,3,19,7,10,55,46,9,64
SC Rheindorf,3584,4,17,10,9,54,44,10,61
Rapid Vienna,3584,5,13,10,13,57,42,15,49
RZ Pellets W,3584,6,12,7,17,48,62,-14,43
Admira Wacke,3584,7,12,6,18,40,62,-22,42
St. Pölten,3584,8,9,10,17,39,57,-18,37
SV Josko Rie,3584,9,10,7,19,36,55,-19,37
Mattersburg,3584,10,8,10,18,34,52,-18,34
SC Rheindorf,3585,1,22,10,4,70,40,30,76
FC Salzburg,3585,2,18,11,7,65,36,29,65
Vienna,3585,3,21,2,13,56,46,10,65
SK Sturm Gra,3585,4,18,6,12,58,42,16,60
Rapid Vienna,3585,5,16,9,11,61,44,17,57
Admira Wacke,3585,6,12,9,15,47,56,-9,45
St. Pölten,3585,7,10,8,18,45,65,-20,38
SV Josko Rie,3585,8,10,7,19,39,59,-20,37
RZ Pellets W,3585,9,9,5,22,35,58,-23,32
Mattersburg,3585,10,6,9,21,32,62,-30,27
SK Sturm Gra,3586,1,20,7,9,63,32,31,67
SC Rheindorf,3586,2,19,8,9,52,39,13,65
FC Salzburg,3586,3,17,11,8,57,32,25,62
Rapid Vienna,3586,4,14,11,11,53,37,16,53
Vienna,3586,5,15,6,15,61,61,0,51
SV Josko Rie,3586,6,14,4,18,42,56,-14,46
Admira Wacke,3586,7,12,7,17,32,53,-21,43
RZ Pellets W,3586,8,10,10,16,45,56,-11,40
Mattersburg,3586,9,9,9,18,38,52,-14,36
St. Pölten,3586,10,8,11,17,43,68,-25,35
FC Salzburg,3587,1,21,8,7,67,29,38,71
Vienna,3587,2,20,5,11,69,51,18,65
SC Rheindorf,3587,3,19,8,9,54,46,8,65
SK Sturm Gra,3587,4,17,9,10,59,37,22,60
Rapid Vienna,3587,5,14,12,10,52,35,17,54
Admira Wacke,3587,6,13,6,17,45,66,-21,45
St. Pölten,3587,7,10,10,16,46,59,-13,40
RZ Pellets W,3587,8,11,6,19,42,64,-22,39
SV Josko Rie,3587,9,9,5,22,32,56,-24,32
Mattersburg,3587,10,7,9,20,32,55,-23,30
SK Sturm Gra,3588,1,23,3,10,71,32,39,72
Vienna,3588,2,21,6,9,67,44,23,69
FC Salzburg,3588,3,19,9,8,58,33,25,66
SC Rheindorf,3588,4,17,8,11,45,36,9,59
Rapid Vienna,3588,5,14,10,12,52,38,14,52
RZ Pellets W,3588,6,12,8,16,40,52,-12,44
SV Josko Rie,3588,7,13,5,18,34,48,-14,44
Admira Wacke,3588,8,9,6,21,28,67,-39,33
Mattersburg,3588,9,6,13,17,29,50,-21,31
St. Pölten,3588,10,7,10,19,35,59,-24,31
FC Salzburg,3589,1,21,8,7,64,30,34,71
SC Rheindorf,3589,2,20,9,7,60,43,17,69
SK Sturm Gra,3589,3,19,7,10,59,36,23,64
Vienna,3589,4,16,4,16,58,61,-3,52
Admira Wacke,3589,5,14,6,16,34,49,-15,48
Rapid Vienna,3589,6,12,10,14,52,40,12,46
RZ Pellets W,3589,7,13,6,17,41,52,-11,45
SV Josko Rie,3589,8,10,7,19,37,54,-17,37
St. Pölten,3589,9,9,9,18,41,64,-23,36
Mattersburg,3589,10,9,8,19,35,52,-17,35
FC Salzburg,3590,1,22,8,6,71,31,40,74
SK Sturm Gra,3590,2,23,5,8,61,29,32,74
SC Rheindorf,3590,3,19,5,12,53,45,8,62
Vienna,3590,4,16,7,13,61,53,8,55
Rapid Vienna,3590,5,15,9,12,53,42,11,54
Admira Wacke,3590,6,13,6,17,38,58,-20,45
Mattersburg,3590,7,9,9,18,39,54,-15,36
RZ Pellets W,3590,8,8,11,17,42,60,-18,35
St. Pölten,3590,9,9,8,19,46,68,-22,35
SV Josko Rie,3590,10,10,4,22,33,57,-24,34
FC Salzburg,3591,1,22,9,5,66,29,37,75
SC Rheindorf,3591,2,21,6,9,59,42,17,69
Vienna,3591,3,19,6,11,66,51,15,63
SK Sturm Gra,3591,4,17,7,12,55,37,18,58
RZ Pellets W,3591,5,14,7,15,48,52,-4,49
Rapid Vienna,3591,6,12,10,14,53,47,6,46
SV Josko Rie,3591,7,12,5,19,43,56,-13,41
Admira Wacke,3591,8,11,5,20,36,63,-27,38
Mattersburg,3591,9,9,8,19,30,49,-19,35
St. Pölten,3591,10,7,9,20,38,68,-30,30
FC Salzburg,3592,1,23,6,7,70,31,39,75
SC Rheindorf,3592,2,19,8,9,56,40,16,65
Vienna,3592,3,18,7,11,61,52,9,61
SK Sturm Gra,3592,4,18,4,14,58,47,11,58
Rapid Vienna,3592,5,12,14,10,58,44,14,50
Admira Wacke,3592,6,15,5,16,38,53,-15,50
RZ Pellets W,3592,7,11,11,14,50,56,-6,44
St. Pölten,3592,8,11,8,17,47,62,-15,41
SV Josko Rie,3592,9,9,5,22,31,53,-22,32
Mattersburg,3592,10,6,8,22,35,66,-31,26
FC Salzburg,3593,1,20,6,10,61,32,29,66
Vienna,3593,2,20,4,12,68,50,18,64
SK Sturm Gra,3593,3,19,5,12,56,33,23,62
SC Rheindorf,3593,4,17,10,9,49,44,5,61
Rapid Vienna,3593,5,15,12,9,60,38,22,57
RZ Pellets W,3593,6,15,5,16,46,55,-9,50
Admira Wacke,3593,7,12,5,19,36,60,-24,41
St. Pölten,3593,8,9,11,16,44,62,-18,38
SV Josko Rie,3593,9,11,4,21,31,55,-24,37
Mattersburg,3593,10,7,8,21,31,53,-22,29
FC Salzburg,3594,1,24,8,4,72,27,45,80
SC Rheindorf,3594,2,20,6,10,64,45,19,66
SK Sturm Gra,3594,3,18,7,11,60,41,19,61
Vienna,3594,4,18,5,13,60,56,4,59
Admira Wacke,3594,5,14,8,14,46,51,-5,50
Rapid Vienna,3594,6,11,11,14,53,53,0,44
RZ Pellets W,3594,7,12,6,18,49,62,-13,42
Mattersburg,3594,8,10,9,17,41,55,-14,39
SV Josko Rie,3594,9,10,4,22,31,53,-22,34
St. Pölten,3594,10,6,10,20,41,74,-33,28
FC Salzburg,3595,1,20,9,7,65,27,38,69
SK Sturm Gra,3595,2,21,5,10,59,37,22,68
SC Rheindorf,3595,3,21,5,10,54,42,12,68
Vienna,3595,4,21,2,13,61,46,15,65
Rapid Vienna,3595,5,15,11,10,51,35,16,56
Admira Wacke,3595,6,13,6,17,38,52,-14,45
RZ Pellets W,3595,7,11,7,18,46,57,-11,40
Mattersburg,3595,8,10,7,19,39,57,-18,37
SV Josko Rie,3595,9,9,5,22,29,53,-24,32
St. Pölten,3595,10,6,9,21,36,72,-36,27
FC Salzburg,3596,1,20,6,10,75,42,33,66
Vienna,3596,2,20,4,12,62,51,11,64
SK Sturm Gra,3596,3,18,9,9,54,31,23,63
SC Rheindorf,3596,4,18,5,13,52,48,4,59
Rapid Vienna,3596,5,15,9,12,52,39,13,54
Mattersburg,3596,6,13,7,16,43,48,-5,46
RZ Pellets W,3596,7,12,7,17,38,49,-11,43
Admira Wacke,3596,8,13,4,19,34,57,-23,43
St. Pölten,3596,9,10,8,18,44,62,-18,38
SV Josko Rie,3596,10,9,5,22,28,55,-27,32
FC Salzburg,3597,1,21,8,7,67,28,39,71
SK Sturm Gra,3597,2,21,6,9,67,33,34,69
Vienna,3597,3,17,7,12,59,50,9,58
SC Rheindorf,3597,4,16,9,11,55,44,11,57
Admira Wacke,3597,5,16,4,16,45,59,-14,52
Rapid Vienna,3597,6,13,10,13,57,45,12,49
RZ Pellets W,3597,7,13,8,15,50,63,-13,47
St. Pölten,3597,8,10,9,17,48,69,-21,39
SV Josko Rie,3597,9,9,5,22,31,61,-30,32
Mattersburg,3597,10,6,10,20,32,59,-27,28
FC Salzburg,3598,1,20,8,8,68,31,37,68
SK Sturm Gra,3598,2,19,6,11,62,39,23,63
SC Rheindorf,3598,3,18,7,11,55,45,10,61
Vienna,3598,4,17,6,13,59,48,11,57
Rapid Vienna,3598,5,13,12,11,61,48,13,51
Admira Wacke,3598,6,15,6,15,42,54,-12,51
RZ Pellets W,3598,7,14,6,16,53,58,-5,48
SV Josko Rie,3598,8,11,6,19,35,52,-17,39
Mattersburg,3598,9,9,8,19,39,63,-24,35
St. Pölten,3598,10,5,13,18,34,70,-36,28
FC Salzburg,3599,1,22,7,7,70,37,33,73
SC Rheindorf,3599,2,20,9,7,64,46,18,69
Vienna,3599,3,20,4,12,69,50,19,64
SK Sturm Gra,3599,4,17,8,11,52,38,14,59
Rapid Vienna,3599,5,13,13,10,57,40,17,52
SV Josko Rie,3599,6,10,9,17,36,54,-18,39
RZ Pellets W,3599,7,10,9,17,40,60,-20,39
Admira Wacke,3599,8,10,7,19,34,56,-22,37
Mattersburg,3599,9,9,9,18,35,50,-15,36
St. Pölten,3599,10,7,9,20,37,63,-26,30
SC Rheindorf,3600,1,21,9,6,58,38,20,72
FC Salzburg,3600,2,19,10,7,63,32,31,67
SK Sturm Gra,3600,3,19,6,11,60,36,24,63
Vienna,3600,4,18,4,14,59,51,8,58
Rapid Vienna,3600,5,14,11,11,56,41,15,53
RZ Pellets W,3600,6,14,7,15,46,53,-7,49
Admira Wacke,3600,7,13,5,18,35,54,-19,44
SV Josko Rie,3600,8,11,3,22,36,57,-21,36
St. Pölten,3600,9,9,7,20,40,66,-26,34
Mattersburg,3600,10,7,8,21,34,59,-25,29
FC Salzburg,3601,1,22,10,4,68,24,44,76
Vienna,3601,2,20,4,12,58,48,10,64
SK Sturm Gra,3601,3,19,5,12,62,43,19,62
SC Rheindorf,3601,4,17,11,8,50,40,10,62
Rapid Vienna,3601,5,12,11,13,52,41,11,47
RZ Pellets W,3601,6,12,6,18,43,56,-13,42
Admira Wacke,3601,7,12,6,18,40,61,-21,42
St. Pölten,3601,8,9,10,17,39,55,-16,37
Mattersburg,3601,9,9,10,17,34,50,-16,37
SV Josko Rie,3601,10,9,5,22,32,60,-28,32
FC Salzburg,3602,1,23,9,4,73,27,46,78
SK Sturm Gra,3602,2,19,6,11,62,34,28,63
SC Rheindorf,3602,3,17,9,10,55,53,2,60
Vienna,3602,4,13,10,13,59,57,2,49
RZ Pellets W,3602,5,13,10,13,53,55,-2,49
Admira Wacke,3602,6,13,9,14,42,55,-13,48
Rapid Vienna,3602,7,11,12,13,51,45,6,45
SV Josko Rie,3602,8,10,7,19,33,57,-24,37
St. Pölten,3602,9,9,7,20,41,65,-24,34
Mattersburg,3602,10,8,9,19,43,64,-21,33
FC Salzburg,3603,1,24,6,6,73,27,46,78
SK Sturm Gra,3603,2,19,7,10,61,37,24,64
SC Rheindorf,3603,3,19,7,10,56,42,14,64
Vienna,3603,4,18,5,13,63,62,1,59
Rapid Vienna,3603,5,13,10,13,52,43,9,49
SV Josko Rie,3603,6,12,5,19,38,56,-18,41
RZ Pellets W,3603,7,11,7,18,47,56,-9,40
Admira Wacke,3603,8,11,7,18,39,60,-21,40
Mattersburg,3603,9,9,9,18,40,59,-19,36
St. Pölten,3603,10,6,13,17,37,64,-27,31
SK Sturm Gra,3604,1,22,4,10,63,31,32,70
SC Rheindorf,3604,2,20,8,8,59,40,19,68
FC Salzburg,3604,3,19,8,9,59,32,27,65
Vienna,3604,4,17,7,12,60,53,7,58
Rapid Vienna,3604,5,12,10,14,52,43,9,46
RZ Pellets W,3604,6,12,8,16,44,55,-11,44
Admira Wacke,3604,7,11,8,17,36,56,-20,41
St. Pölten,3604,8,10,9,17,43,64,-21,39
SV Josko Rie,3604,9,9,11,16,30,47,-17,38
Mattersburg,3604,10,6,11,19,34,59,-25,29
FC Salzburg,3605,1,24,5,7,71,29,42,77
Vienna,3605,2,19,6,11,61,52,9,63
SK Sturm Gra,3605,3,16,10,10,55,35,20,58
SC Rheindorf,3605,4,17,7,12,51,43,8,58
Rapid Vienna,3605,5,13,9,14,54,44,10,48
Admira Wacke,3605,6,10,12,14,41,60,-19,42
RZ Pellets W,3605,7,11,8,17,42,53,-11,41
SV Josko Rie,3605,8,12,4,20,30,54,-24,40
St. Pölten,3605,9,10,9,17,42,61,-19,39
Mattersburg,3605,10,9,8,19,31,47,-16,35
FC Salzburg,3606,1,21,10,5,70,32,38,73
SK Sturm Gra,3606,2,20,6,10,60,32,28,66
SC Rheindorf,3606,3,18,9,9,57,48,9,63
Vienna,3606,4,19,5,12,61,52,9,62
Rapid Vienna,3606,5,14,11,11,58,43,15,53
RZ Pellets W,3606,6,11,9,16,43,57,-14,42
Admira Wacke,3606,7,12,5,19,41,60,-19,41
St. Pölten,3606,8,11,7,18,53,63,-10,40
SV Josko Rie,3606,9,8,7,21,31,57,-26,31
Mattersburg,3606,10,6,11,19,33,63,-30,29
FC Salzburg,3607,1,23,9,4,79,32,47,78
SC Rheindorf,3607,2,17,9,10,49,44,5,60
SK Sturm Gra,3607,3,17,7,12,52,37,15,58
Vienna,3607,4,17,7,12,59,47,12,58
Rapid Vienna,3607,5,13,12,11,60,43,17,51
RZ Pellets W,3607,6,12,9,15,48,55,-7,45
Admira Wacke,3607,7,12,8,16,40,59,-19,44
St. Pölten,3607,8,11,9,16,40,52,-12,42
SV Josko Rie,3607,9,9,7,20,33,56,-23,34
Mattersburg,3607,10,7,7,22,34,69,-35,28
FC Salzburg,3608,1,19,9,8,59,32,27,66
SC Rheindorf,3608,2,19,9,8,52,37,15,66
Vienna,3608,3,19,6,11,62,52,10,63
SK Sturm Gra,3608,4,18,5,13,59,41,18,59
RZ Pellets W,3608,5,15,10,11,49,43,6,55
Rapid Vienna,3608,6,12,10,14,48,42,6,46
St. Pölten,3608,7,11,9,16,50,66,-16,42
Admira Wacke,3608,8,9,8,19,34,59,-25,35
Mattersburg,3608,9,8,10,18,38,56,-18,34
SV Josko Rie,3608,10,9,6,21,30,53,-23,33
SC Rheindorf,3609,1,21,8,7,60,36,24,71
SK Sturm Gra,3609,2,20,5,11,61,35,26,65
Vienna,3609,3,19,6,11,69,56,13,63
FC Salzburg,3609,4,18,6,12,63,38,25,60
Mattersburg,3609,5,13,7,16,44,56,-12,46
Rapid Vienna,3609,6,11,12,13,53,46,7,45
RZ Pellets W,3609,7,11,7,18,47,61,-14,40
Admira Wacke,3609,8,11,7,18,33,60,-27,40
St. Pölten,3609,9,10,9,17,42,60,-18,39
SV Josko Rie,3609,10,10,5,21,38,62,-24,35
FC Salzburg,3610,1,23,6,7,75,33,42,75
SC Rheindorf,3610,2,20,8,8,55,36,19,68
SK Sturm Gra,3610,3,20,4,12,57,34,23,64
Vienna,3610,4,17,5,14,59,56,3,56
Rapid Vienna,3610,5,14,11,11,59,41,18,53
Admira Wacke,3610,6,14,3,19,44,61,-17,45
SV Josko Rie,3610,7,12,7,17,41,55,-14,43
RZ Pellets W,3610,8,11,4,21,38,66,-28,37
Mattersburg,3610,9,10,6,20,40,60,-20,36
St. Pölten,3610,10,7,10,19,38,64,-26,31
FC Salzburg,3611,1,23,5,8,67,31,36,74
SC Rheindorf,3611,2,21,6,9,53,37,16,69
SK Sturm Gra,3611,3,21,4,11,58,32,26,67
Vienna,3611,4,19,4,13,61,45,16,61
RZ Pellets W,3611,5,14,8,14,54,52,2,50
Rapid Vienna,3611,6,13,9,14,54,42,12,48
Admira Wacke,3611,7,13,5,18,34,60,-26,44
St. Pölten,3611,8,9,9,18,41,69,-28,36
SV Josko Rie,3611,9,9,6,21,27,51,-24,33
Mattersburg,3611,10,5,10,21,32,62,-30,25
FC Salzburg,3612,1,22,8,6,72,31,41,74
SK Sturm Gra,3612,2,20,6,10,65,40,25,66
SC Rheindorf,3612,3,19,6,11,53,44,9,63
Vienna,3612,4,18,3,15,63,55,8,57
Rapid Vienna,3612,5,14,9,13,62,46,16,51
RZ Pellets W,3612,6,14,6,16,47,56,-9,48
Admira Wacke,3612,7,13,6,17,43,63,-20,45
St. Pölten,3612,8,8,12,16,40,66,-26,36
SV Josko Rie,3612,9,9,6,21,37,64,-27,33
Mattersburg,3612,10,8,8,20,41,58,-17,32
FC Salzburg,3613,1,21,8,7,72,31,41,71
SC Rheindorf,3613,2,18,11,7,51,36,15,65
SK Sturm Gra,3613,3,18,9,9,52,32,20,63
Vienna,3613,4,19,4,13,57,52,5,61
RZ Pellets W,3613,5,13,9,14,43,52,-9,48
Admira Wacke,3613,6,12,8,16,41,53,-12,44
Rapid Vienna,3613,7,10,12,14,50,47,3,42
SV Josko Rie,3613,8,11,5,20,36,58,-22,38
Mattersburg,3613,9,9,9,18,40,58,-18,36
St. Pölten,3613,10,8,7,21,47,70,-23,31
FC Salzburg,3614,1,23,5,8,68,29,39,74
SK Sturm Gra,3614,2,22,5,9,59,35,24,71
SC Rheindorf,3614,3,19,5,12,57,53,4,62
Vienna,3614,4,18,5,13,64,53,11,59
RZ Pellets W,3614,5,15,7,14,48,52,-4,52
Rapid Vienna,3614,6,13,8,15,56,45,11,47
Admira Wacke,3614,7,11,6,19,40,66,-26,39
St. Pölten,3614,8,9,9,18,47,68,-21,36
Mattersburg,3614,9,8,10,18,42,55,-13,34
SV Josko Rie,3614,10,10,4,22,37,62,-25,34
FC Salzburg,3615,1,21,9,6,67,31,36,72
SC Rheindorf,3615,2,21,7,8,57,39,18,70
Vienna,3615,3,18,5,13,69,58,11,59
SK Sturm Gra,3615,4,17,6,13,62,44,18,57
RZ Pellets W,3615,5,12,8,16,50,56,-6,44
Rapid Vienna,3615,6,11,10,15,47,48,-1,43
SV Josko Rie,3615,7,13,3,20,38,53,-15,42
Admira Wacke,3615,8,12,6,18,39,59,-20,42
Mattersburg,3615,9,11,6,19,33,53,-20,39
St. Pölten,3615,10,8,12,16,42,63,-21,36
FC Salzburg,3616,1,20,11,5,69,33,36,71
SC Rheindorf,3616,2,20,10,6,57,38,19,70
Vienna,3616,3,19,7,10,65,48,17,64
SK Sturm Gra,3616,4,18,7,11,60,39,21,61
Rapid Vienna,3616,5,14,11,11,59,42,17,53
RZ Pellets W,3616,6,12,9,15,48,53,-5,45
St. Pölten,3616,7,8,10,18,38,63,-25,34
SV Josko Rie,3616,8,8,9,19,30,54,-24,33
Mattersburg,3616,9,7,11,18,36,64,-28,32
Admira Wacke,3616,10,8,7,21,31,59,-28,31
SC Rheindorf,3617,1,23,6,7,58,36,22,75
FC Salzburg,3617,2,20,7,9,64,31,33,67
Vienna,3617,3,20,5,11,58,42,16,65
SK Sturm Gra,3617,4,17,6,13,56,38,18,57
Rapid Vienna,3617,5,14,12,10,54,38,16,54
Admira Wacke,3617,6,13,6,17,36,57,-21,45
RZ Pellets W,3617,7,10,7,19,47,61,-14,37
St. Pölten,3617,8,9,9,18,40,59,-19,36
Mattersburg,3617,9,10,6,20,36,65,-29,36
SV Josko Rie,3617,10,10,4,22,36,58,-22,34
FC Salzburg,3618,1,22,8,6,65,28,37,74
SK Sturm Gra,3618,2,21,4,11,58,35,23,67
SC Rheindorf,3618,3,19,8,9,61,42,19,65
Vienna,3618,4,20,4,12,67,49,18,64
Rapid Vienna,3618,5,13,12,11,55,41,14,51
Mattersburg,3618,6,12,6,18,42,54,-12,42
SV Josko Rie,3618,7,13,2,21,35,52,-17,41
RZ Pellets W,3618,8,12,5,19,42,63,-21,41
Admira Wacke,3618,9,9,6,21,33,65,-32,33
St. Pölten,3618,10,7,9,20,40,69,-29,30
SK Sturm Gra,3619,1,23,4,9,68,28,40,73
FC Salzburg,3619,2,21,6,9,66,32,34,69
Vienna,3619,3,19,7,10,62,50,12,64
Rapid Vienna,3619,4,18,7,11,64,45,19,61
SC Rheindorf,3619,5,18,7,11,52,40,12,61
SV Josko Rie,3619,6,12,7,17,39,52,-13,43
Admira Wacke,3619,7,10,7,19,36,62,-26,37
Mattersburg,3619,8,9,8,19,36,58,-22,35
RZ Pellets W,3619,9,9,8,19,43,66,-23,35
St. Pölten,3619,10,6,9,21,40,73,-33,27
SK Sturm Gra,3620,1,21,6,9,57,27,30,69
FC Salzburg,3620,2,18,10,8,63,37,26,64
Vienna,3620,3,17,8,11,67,55,12,59
SC Rheindorf,3620,4,16,10,10,47,40,7,58
RZ Pellets W,3620,5,14,8,14,44,48,-4,50
Rapid Vienna,3620,6,10,15,11,53,46,7,45
St. Pölten,3620,7,11,9,16,41,55,-14,42
Admira Wacke,3620,8,10,7,19,34,59,-25,37
SV Josko Rie,3620,9,8,11,17,32,51,-19,35
Mattersburg,3620,10,9,8,19,39,59,-20,35
SK Sturm Gra,3621,1,21,4,11,64,36,28,67
Vienna,3621,2,20,4,12,67,52,15,64
FC Salzburg,3621,3,18,9,9,61,35,26,63
Rapid Vienna,3621,4,15,9,12,57,41,16,54
SC Rheindorf,3621,5,15,9,12,50,48,2,54
SV Josko Rie,3621,6,14,4,18,34,52,-18,46
Admira Wacke,3621,7,13,6,17,40,57,-17,45
RZ Pellets W,3621,8,12,7,17,50,60,-10,43
St. Pölten,3621,9,9,10,17,43,62,-19,37
Mattersburg,3621,10,7,10,19,30,53,-23,31
FC Salzburg,3622,1,19,10,7,63,33,30,67
SK Sturm Gra,3622,2,20,7,9,60,34,26,67
SC Rheindorf,3622,3,17,9,10,53,43,10,60
Vienna,3622,4,16,8,12,61,55,6,56
Rapid Vienna,3622,5,13,10,13,51,41,10,49
Admira Wacke,3622,6,14,7,15,42,53,-11,49
RZ Pellets W,3622,7,12,8,16,51,58,-7,44
SV Josko Rie,3622,8,10,8,18,39,54,-15,38
Mattersburg,3622,9,9,8,19,34,55,-21,35
St. Pölten,3622,10,9,7,20,38,66,-28,34
FC Salzburg,3623,1,22,7,7,66,30,36,73
Vienna,3623,2,22,5,9,70,52,18,71
SC Rheindorf,3623,3,16,11,9,54,44,10,59
SK Sturm Gra,3623,4,16,8,12,57,40,17,56
RZ Pellets W,3623,5,13,8,15,48,54,-6,47
Rapid Vienna,3623,6,11,13,12,54,49,5,46
Mattersburg,3623,7,11,8,17,40,55,-15,41
St. Pölten,3623,8,8,13,15,49,62,-13,37
SV Josko Rie,3623,9,9,7,20,30,49,-19,34
Admira Wacke,3623,10,10,4,22,33,66,-33,34
FC Salzburg,3624,1,21,7,8,62,31,31,70
Vienna,3624,2,20,5,11,77,47,30,65
SC Rheindorf,3624,3,16,9,11,56,48,8,57
Rapid Vienna,3624,4,14,10,12,51,37,14,52
SK Sturm Gra,3624,5,14,9,13,56,49,7,51
St. Pölten,3624,6,13,9,14,54,61,-7,48
RZ Pellets W,3624,7,12,9,15,50,63,-13,45
Mattersburg,3624,8,10,9,17,39,56,-17,39
Admira Wacke,3624,9,10,8,18,40,69,-29,38
SV Josko Rie,3624,10,9,7,20,36,60,-24,34
FC Salzburg,3625,1,23,6,7,66,27,39,75
SK Sturm Gra,3625,2,19,6,11,58,34,24,63
SC Rheindorf,3625,3,18,8,10,52,43,9,62
Rapid Vienna,3625,4,17,9,10,57,33,24,60
Vienna,3625,5,15,8,13,54,49,5,53
RZ Pellets W,3625,6,13,7,16,46,58,-12,46
SV Josko Rie,3625,7,10,8,18,34,55,-21,38
Admira Wacke,3625,8,10,8,18,32,54,-22,38
Mattersburg,3625,9,8,11,17,38,57,-19,35
St. Pölten,3625,10,6,11,19,42,69,-27,29
FC Salzburg,3626,1,23,5,8,72,29,43,74
Vienna,3626,2,20,6,10,65,49,16,66
SC Rheindorf,3626,3,20,5,11,56,45,11,65
Rapid Vienna,3626,4,16,10,10,53,36,17,58
SK Sturm Gra,3626,5,17,6,13,56,41,15,57
Admira Wacke,3626,6,11,7,18,33,59,-26,40
St. Pölten,3626,7,10,9,17,41,59,-18,39
RZ Pellets W,3626,8,10,7,19,38,54,-16,37
SV Josko Rie,3626,9,10,6,20,37,58,-21,36
Mattersburg,3626,10,9,7,20,37,58,-21,34
SC Rheindorf,3627,1,20,9,7,57,43,14,69
Vienna,3627,2,22,2,12,68,47,21,68
FC Salzburg,3627,3,18,9,9,64,36,28,63
SK Sturm Gra,3627,4,19,6,11,60,34,26,63
RZ Pellets W,3627,5,14,7,15,48,55,-7,49
Rapid Vienna,3627,6,11,14,11,49,39,10,47
Admira Wacke,3627,7,14,5,17,39,57,-18,47
Mattersburg,3627,8,12,9,15,45,51,-6,45
St. Pölten,3627,9,7,7,22,40,72,-32,28
SV Josko Rie,3627,10,7,4,25,25,61,-36,25
FC Salzburg,3628,1,24,6,6,68,27,41,78
SK Sturm Gra,3628,2,20,6,10,59,31,28,66
SC Rheindorf,3628,3,19,9,8,54,40,14,66
Vienna,3628,4,18,7,11,63,53,10,61
Rapid Vienna,3628,5,14,11,11,60,42,18,53
RZ Pellets W,3628,6,12,6,18,45,60,-15,42
SV Josko Rie,3628,7,11,6,19,34,52,-18,39
Admira Wacke,3628,8,10,7,19,39,63,-24,37
Mattersburg,3628,9,7,12,17,40,61,-21,33
St. Pölten,3628,10,6,8,22,32,65,-33,26
SC Rheindorf,3629,1,21,8,7,64,47,17,71
SK Sturm Gra,3629,2,20,5,11,56,32,24,65
FC Salzburg,3629,3,18,6,12,59,39,20,60
Rapid Vienna,3629,4,15,9,12,55,45,10,54
Vienna,3629,5,16,6,14,58,54,4,54
SV Josko Rie,3629,6,14,3,19,40,49,-9,45
St. Pölten,3629,7,11,9,16,50,59,-9,42
Admira Wacke,3629,8,12,5,19,35,62,-27,41
RZ Pellets W,3629,9,11,7,18,49,61,-12,40
Mattersburg,3629,10,6,14,16,39,57,-18,32
FC Salzburg,3630,1,20,8,8,65,35,30,68
Vienna,3630,2,21,5,10,66,46,20,68
SC Rheindorf,3630,3,19,10,7,49,35,14,67
SK Sturm Gra,3630,4,20,5,11,55,30,25,65
Rapid Vienna,3630,5,12,10,14,48,41,7,46
St. Pölten,3630,6,11,7,18,45,61,-16,40
Mattersburg,3630,7,11,6,19,40,57,-17,39
SV Josko Rie,3630,8,10,8,18,32,56,-24,38
Admira Wacke,3630,9,10,7,19,32,55,-23,37
RZ Pellets W,3630,10,10,6,20,46,62,-16,36
FC Salzburg,3631,1,20,7,9,58,36,22,67
Vienna,3631,2,21,3,12,69,49,20,66
SC Rheindorf,3631,3,20,6,10,52,40,12,66
Rapid Vienna,3631,4,17,9,10,62,37,25,60
SK Sturm Gra,3631,5,15,11,10,49,31,18,56
RZ Pellets W,3631,6,12,9,15,47,59,-12,45
Admira Wacke,3631,7,11,8,17,36,58,-22,41
SV Josko Rie,3631,8,10,6,20,32,50,-18,36
Mattersburg,3631,9,10,6,20,40,59,-19,36
St. Pölten,3631,10,8,7,21,44,70,-26,31
FC Salzburg,3632,1,22,5,9,63,30,33,71
SC Rheindorf,3632,2,21,5,10,59,45,14,68
Vienna,3632,3,20,4,12,57,46,11,64
SK Sturm Gra,3632,4,18,6,12,54,34,20,60
Rapid Vienna,3632,5,16,8,12,63,40,23,56
St. Pölten,3632,6,12,8,16,45,58,-13,44
RZ Pellets W,3632,7,13,5,18,40,55,-15,44
Admira Wacke,3632,8,11,7,18,37,60,-23,40
Mattersburg,3632,9,9,7,20,48,68,-20,34
SV Josko Rie,3632,10,8,5,23,31,61,-30,29
FC Salzburg,3633,1,21,7,8,70,30,40,70
SK Sturm Gra,3633,2,21,6,9,66,34,32,69
SC Rheindorf,3633,3,18,10,8,56,41,15,64
Rapid Vienna,3633,4,14,14,8,57,35,22,56
Vienna,3633,5,17,5,14,62,55,7,56
RZ Pellets W,3633,6,12,6,18,40,57,-17,42
Admira Wacke,3633,7,10,9,17,31,59,-28,39
Mattersburg,3633,8,10,8,18,40,56,-16,38
SV Josko Rie,3633,9,10,6,20,31,57,-26,36
St. Pölten,3633,10,6,11,19,35,64,-29,29
FC Salzburg,3634,1,24,5,7,73,31,42,77
SC Rheindorf,3634,2,21,5,10,61,37,24,68
Vienna,3634,3,18,5,13,63,63,0,59
SK Sturm Gra,3634,4,17,6,13,53,42,11,57
Rapid Vienna,3634,5,12,12,12,49,39,10,48
RZ Pellets W,3634,6,14,6,16,49,53,-4,48
St. Pölten,3634,7,10,11,15,47,63,-16,41
Admira Wacke,3634,8,12,4,20,39,57,-18,40
SV Josko Rie,3634,9,10,8,18,35,54,-19,38
Mattersburg,3634,10,6,10,20,32,62,-30,28
FC Salzburg,3635,1,23,4,9,70,35,35,73
SK Sturm Gra,3635,2,20,8,8,70,36,34,68
Vienna,3635,3,20,5,11,57,44,13,65
SC Rheindorf,3635,4,18,10,8,60,45,15,64
Rapid Vienna,3635,5,14,9,13,59,46,13,51
RZ Pellets W,3635,6,15,6,15,45,49,-4,51
St. Pölten,3635,7,10,8,18,51,73,-22,38
Admira Wacke,3635,8,10,6,20,37,61,-24,36
Mattersburg,3635,9,7,10,19,37,65,-28,31
SV Josko Rie,3635,10,7,6,23,29,61,-32,27
SK Sturm Gra,3636,1,21,5,10,63,36,27,68
Vienna,3636,2,21,4,11,64,42,22,67
FC Salzburg,3636,3,19,8,9,69,30,39,65
SC Rheindorf,3636,4,17,10,9,48,43,5,61
Rapid Vienna,3636,5,14,13,9,60,42,18,55
RZ Pellets W,3636,6,14,7,15,43,56,-13,49
Admira Wacke,3636,7,12,4,20,41,64,-23,40
SV Josko Rie,3636,8,11,6,19,36,51,-15,39
Mattersburg,3636,9,8,9,19,39,63,-24,33
St. Pölten,3636,10,6,8,22,37,73,-36,26
SC Rheindorf,3637,1,23,4,9,61,43,18,73
FC Salzburg,3637,2,22,5,9,64,30,34,71
SK Sturm Gra,3637,3,20,4,12,55,33,22,64
Vienna,3637,4,19,4,13,62,51,11,61
Rapid Vienna,3637,5,11,13,12,50,45,5,46
RZ Pellets W,3637,6,13,6,17,47,54,-7,45
Admira Wacke,3637,7,13,4,19,36,60,-24,43
St. Pölten,3637,8,10,9,17,44,57,-13,39
Mattersburg,3637,9,9,7,20,36,57,-21,34
SV Josko Rie,3637,10,9,6,21,34,59,-25,33
SC Rheindorf,3638,1,21,10,5,67,43,24,73
FC Salzburg,3638,2,21,6,9,67,30,37,69
Vienna,3638,3,20,4,12,64,50,14,64
SK Sturm Gra,3638,4,17,7,12,63,38,25,58
Rapid Vienna,3638,5,13,12,11,51,40,11,51
SV Josko Rie,3638,6,12,6,18,34,53,-19,42
RZ Pellets W,3638,7,10,8,18,40,56,-16,38
Admira Wacke,3638,8,10,7,19,36,65,-29,37
Mattersburg,3638,9,9,8,19,44,67,-23,35
St. Pölten,3638,10,9,8,19,43,67,-24,35
FC Salzburg,3639,1,21,7,8,69,34,35,70
Vienna,3639,2,20,6,10,68,51,17,66
SC Rheindorf,3639,3,19,9,8,59,45,14,66
SK Sturm Gra,3639,4,17,9,10,56,32,24,60
Rapid Vienna,3639,5,11,13,12,55,46,9,46
RZ Pellets W,3639,6,11,11,14,50,63,-13,44
Admira Wacke,3639,7,11,8,17,40,53,-13,41
Mattersburg,3639,8,10,9,17,42,56,-14,39
St. Pölten,3639,9,7,11,18,40,67,-27,32
SV Josko Rie,3639,10,9,5,22,34,66,-32,32
FC Salzburg,3640,1,20,7,9,64,31,33,67
SC Rheindorf,3640,2,18,7,11,56,47,9,61
Vienna,3640,3,18,3,15,65,61,4,57
Rapid Vienna,3640,4,15,11,10,54,38,16,56
SK Sturm Gra,3640,5,17,3,16,61,42,19,54
RZ Pellets W,3640,6,14,7,15,51,54,-3,49
SV Josko Rie,3640,7,13,7,16,44,49,-5,46
Admira Wacke,3640,8,11,8,17,39,67,-28,41
St. Pölten,3640,9,10,8,18,41,62,-21,38
Mattersburg,3640,10,10,7,19,39,63,-24,37
FC Salzburg,3641,1,21,10,5,70,31,39,73
SC Rheindorf,3641,2,21,6,9,60,45,15,69
SK Sturm Gra,3641,3,20,8,8,60,27,33,68
Vienna,3641,4,19,7,10,66,49,17,64
Rapid Vienna,3641,5,15,10,11,67,43,24,55
Admira Wacke,3641,6,13,5,18,43,67,-24,44
SV Josko Rie,3641,7,11,5,20,34,50,-16,38
Mattersburg,3641,8,9,6,21,32,62,-30,33
RZ Pellets W,3641,9,8,7,21,41,63,-22,31
St. Pölten,3641,10,5,12,19,37,73,-36,27
FC Salzburg,3642,1,24,7,5,68,29,39,79
SC Rheindorf,3642,2,20,10,6,59,39,20,70
SK Sturm Gra,3642,3,20,9,7,58,27,31,69
Vienna,3642,4,18,5,13,56,51,5,59
Rapid Vienna,3642,5,14,11,11,53,37,16,53
RZ Pellets W,3642,6,10,11,15,53,65,-12,41
Admira Wacke,3642,7,10,7,19,39,60,-21,37
SV Josko Rie,3642,8,10,5,21,39,64,-25,35
St. Pölten,3642,9,7,9,20,37,65,-28,30
Mattersburg,3642,10,6,8,22,40,65,-25,26
SC Rheindorf,3643,1,20,8,8,59,42,17,68
FC Salzburg,3643,2,21,4,11,66,37,29,67
SK Sturm Gra,3643,3,20,6,10,57,29,28,66
Vienna,3643,4,21,3,12,67,58,9,66
Rapid Vienna,3643,5,15,10,11,61,41,20,55
RZ Pellets W,3643,6,11,10,15,42,54,-12,43
SV Josko Rie,3643,7,12,5,19,37,51,-14,41
Admira Wacke,3643,8,11,5,20,31,57,-26,38
Mattersburg,3643,9,9,8,19,45,61,-16,35
St. Pölten,3643,10,7,7,22,35,70,-35,28
FC Salzburg,3644,1,19,8,9,62,34,28,65
SK Sturm Gra,3644,2,18,10,8,68,39,29,64
Vienna,3644,3,18,8,10,62,47,15,62
SC Rheindorf,3644,4,17,11,8,50,42,8,62
Rapid Vienna,3644,5,11,13,12,51,41,10,46
Admira Wacke,3644,6,12,7,17,39,60,-21,43
SV Josko Rie,3644,7,12,6,18,42,53,-11,42
RZ Pellets W,3644,8,12,5,19,48,57,-9,41
Mattersburg,3644,9,10,10,16,37,57,-20,40
St. Pölten,3644,10,7,10,19,39,68,-29,31
SC Rheindorf,3645,1,20,7,9,64,45,19,67
FC Salzburg,3645,2,20,6,10,61,31,30,66
SK Sturm Gra,3645,3,19,6,11,59,36,23,63
Vienna,3645,4,17,7,12,59,53,6,58
Rapid Vienna,3645,5,15,8,13,55,49,6,53
RZ Pellets W,3645,6,15,7,14,53,51,2,52
SV Josko Rie,3645,7,11,6,19,37,50,-13,39
Admira Wacke,3645,8,12,3,21,32,61,-29,39
Mattersburg,3645,9,10,6,20,39,57,-18,36
St. Pölten,3645,10,10,6,20,40,66,-26,36
FC Salzburg,3646,1,21,11,4,64,25,39,74
SC Rheindorf,3646,2,20,7,9,64,41,23,67
Vienna,3646,3,18,6,12,59,49,10,60
SK Sturm Gra,3646,4,17,7,12,56,38,18,58
Rapid Vienna,3646,5,15,10,11,63,41,22,55
Admira Wacke,3646,6,12,6,18,35,58,-23,42
RZ Pellets W,3646,7,10,11,15,42,52,-10,41
Mattersburg,3646,8,11,6,19,37,55,-18,39
SV Josko Rie,3646,9,10,5,21,34,60,-26,35
St. Pölten,3646,10,8,7,21,40,75,-35,31
Vienna,3647,1,22,6,8,72,52,20,72
FC Salzburg,3647,2,21,5,10,62,34,28,68
SC Rheindorf,3647,3,20,8,8,58,39,19,68
SK Sturm Gra,3647,4,20,4,12,60,34,26,64
Rapid Vienna,3647,5,15,9,12,55,41,14,54
RZ Pellets W,3647,6,12,7,17,42,55,-13,43
Admira Wacke,3647,7,12,6,18,40,61,-21,42
St. Pölten,3647,8,8,9,19,36,59,-23,33
Mattersburg,3647,9,8,8,20,35,58,-23,32
SV Josko Rie,3647,10,9,4,23,33,60,-27,31
FC Salzburg,3648,1,19,8,9,63,36,27,65
SK Sturm Gra,3648,2,19,8,9,62,35,27,65
SC Rheindorf,3648,3,18,11,7,60,42,18,65
Vienna,3648,4,18,8,10,63,51,12,62
Rapid Vienna,3648,5,15,10,11,64,47,17,55
RZ Pellets W,3648,6,13,9,14,50,61,-11,48
Mattersburg,3648,7,10,10,16,45,54,-9,40
Admira Wacke,3648,8,9,10,17,30,55,-25,37
SV Josko Rie,3648,9,9,4,23,34,59,-25,31
St. Pölten,3648,10,6,10,20,37,68,-31,28
SC Rheindorf,3649,1,22,8,6,63,39,24,74
FC Salzburg,3649,2,18,10,8,65,38,27,64
Vienna,3649,3,20,3,13,65,56,9,63
SK Sturm Gra,3649,4,18,6,12,56,42,14,60
Rapid Vienna,3649,5,13,11,12,59,44,15,50
RZ Pellets W,3649,6,13,9,14,43,52,-9,48
Admira Wacke,3649,7,11,8,17,38,59,-21,41
St. Pölten,3649,8,10,9,17,42,58,-16,39
SV Josko Rie,3649,9,10,5,21,41,60,-19,35
Mattersburg,3649,10,6,9,21,34,58,-24,27
SC Rheindorf,3650,1,22,7,7,65,43,22,73
FC Salzburg,3650,2,20,10,6,58,28,30,70
Vienna,3650,3,20,4,12,65,54,11,64
SK Sturm Gra,3650,4,18,9,9,60,36,24,63
Rapid Vienna,3650,5,12,11,13,49,40,9,47
RZ Pellets W,3650,6,13,5,18,47,55,-8,44
Mattersburg,3650,7,10,7,19,38,58,-20,37
SV Josko Rie,3650,8,8,10,18,38,54,-16,34
St. Pölten,3650,9,8,10,18,45,70,-25,34
Admira Wacke,3650,10,8,9,19,36,63,-27,33
FC Salzburg,3651,1,22,8,6,71,33,38,74
SK Sturm Gra,3651,2,21,8,7,62,33,29,71
SC Rheindorf,3651,3,18,8,10,52,41,11,62
Vienna,3651,4,18,4,14,61,54,7,58
Rapid Vienna,3651,5,12,13,11,52,42,10,49
RZ Pellets W,3651,6,12,7,17,42,59,-17,43
SV Josko Rie,3651,7,12,5,19,38,48,-10,41
Mattersburg,3651,8,10,8,18,38,56,-18,38
Admira Wacke,3651,9,10,5,21,37,61,-24,35
St. Pölten,3651,10,8,8,20,41,67,-26,32
FC Salzburg,3652,1,20,7,9,64,34,30,67
SC Rheindorf,3652,2,19,10,7,62,47,15,67
SK Sturm Gra,3652,3,19,8,9,58,31,27,65
Vienna,3652,4,17,4,15,67,58,9,55
Rapid Vienna,3652,5,11,16,9,51,39,12,49
RZ Pellets W,3652,6,14,7,15,47,58,-11,49
SV Josko Rie,3652,7,13,7,16,45,52,-7,46
Admira Wacke,3652,8,10,7,19,37,63,-26,37
Mattersburg,3652,9,8,8,20,31,54,-23,32
St. Pölten,3652,10,7,10,19,40,66,-26,31
FC Salzburg,3653,1,21,9,6,64,28,36,72
SK Sturm Gra,3653,2,22,4,10,64,33,31,70
Vienna,3653,3,20,5,11,67,54,13,65
SC Rheindorf,3653,4,17,8,11,53,43,10,59
Rapid Vienna,3653,5,15,11,10,60,41,19,56
RZ Pellets W,3653,6,12,11,13,48,56,-8,47
Admira Wacke,3653,7,12,5,19,31,58,-27,41
SV Josko Rie,3653,8,10,7,19,36,57,-21,37
Mattersburg,3653,9,7,10,19,35,55,-20,31
St. Pölten,3653,10,4,10,22,35,68,-33,22
FC Salzburg,3654,1,21,8,7,64,35,29,71
SK Sturm Gra,3654,2,19,7,10,55,32,23,64
SC Rheindorf,3654,3,17,8,11,49,42,7,59
Vienna,3654,4,16,9,11,62,55,7,57
Rapid Vienna,3654,5,13,14,9,60,43,17,53
RZ Pellets W,3654,6,12,8,16,54,60,-6,44
Admira Wacke,3654,7,11,7,18,38,59,-21,40
SV Josko Rie,3654,8,10,7,19,43,59,-16,37
St. Pölten,3654,9,9,10,17,40,62,-22,37
Mattersburg,3654,10,10,6,20,36,54,-18,36
FC Salzburg,3655,1,21,4,11,66,37,29,67
SC Rheindorf,3655,2,20,6,10,58,47,11,66
Vienna,3655,3,19,3,14,63,55,8,60
SK Sturm Gra,3655,4,18,4,14,56,38,18,58
Rapid Vienna,3655,5,15,11,10,55,36,19,56
RZ Pellets W,3655,6,15,5,16,47,52,-5,50
SV Josko Rie,3655,7,13,5,18,42,59,-17,44
Admira Wacke,3655,8,11,6,19,36,56,-20,39
St. Pölten,3655,9,10,8,18,45,64,-19,38
Mattersburg,3655,10,7,10,19,33,57,-24,31
FC Salzburg,3656,1,22,9,5,75,31,44,75
SC Rheindorf,3656,2,19,8,9,54,41,13,65
SK Sturm Gra,3656,3,18,8,10,62,37,25,62
Rapid Vienna,3656,4,16,9,11,61,40,21,57
Vienna,3656,5,16,7,13,54,53,1,55
RZ Pellets W,3656,6,12,6,18,46,55,-9,42
Mattersburg,3656,7,11,7,18,43,61,-18,40
Admira Wacke,3656,8,10,7,19,41,70,-29,37
St. Pölten,3656,9,8,12,16,39,60,-21,36
SV Josko Rie,3656,10,8,7,21,33,60,-27,31
FC Salzburg,3657,1,21,9,6,67,25,42,72
SC Rheindorf,3657,2,21,8,7,60,36,24,71
SK Sturm Gra,3657,3,21,4,11,66,34,32,67
Vienna,3657,4,15,5,16,55,57,-2,50
Admira Wacke,3657,5,12,10,14,36,55,-19,46
Rapid Vienna,3657,6,11,10,15,48,46,2,43
Mattersburg,3657,7,11,8,17,39,56,-17,41
RZ Pellets W,3657,8,11,7,18,43,58,-15,40
SV Josko Rie,3657,9,10,7,19,34,56,-22,37
St. Pölten,3657,10,7,12,17,40,65,-25,33
SC Rheindorf,3658,1,22,5,9,56,36,20,71
FC Salzburg,3658,2,21,5,10,62,32,30,68
Rapid Vienna,3658,3,18,8,10,62,43,19,62
SK Sturm Gra,3658,4,19,4,13,56,35,21,61
Vienna,3658,5,17,5,14,60,55,5,56
RZ Pellets W,3658,6,13,6,17,52,57,-5,45
SV Josko Rie,3658,7,13,5,18,37,53,-16,44
Admira Wacke,3658,8,13,4,19,41,62,-21,43
Mattersburg,3658,9,8,7,21,31,54,-23,31
St. Pölten,3658,10,8,7,21,36,66,-30,31
SC Rheindorf,3659,1,22,8,6,61,39,22,74
FC Salzburg,3659,2,22,7,7,71,29,42,73
Vienna,3659,3,19,5,12,65,50,15,62
SK Sturm Gra,3659,4,17,6,13,53,38,15,57
Rapid Vienna,3659,5,14,11,11,52,40,12,53
RZ Pellets W,3659,6,13,10,13,49,55,-6,49
Admira Wacke,3659,7,13,4,19,47,60,-13,43
SV Josko Rie,3659,8,9,6,21,34,59,-25,33
St. Pölten,3659,9,7,9,20,35,67,-32,30
Mattersburg,3659,10,7,8,21,33,63,-30,29
FC Salzburg,3660,1,20,7,9,68,39,29,67
Vienna,3660,2,20,6,10,70,51,19,66
SC Rheindorf,3660,3,19,9,8,55,41,14,66
SK Sturm Gra,3660,4,19,6,11,62,40,22,63
Rapid Vienna,3660,5,13,12,11,57,40,17,51
RZ Pellets W,3660,6,11,9,16,43,54,-11,42
Mattersburg,3660,7,11,9,16,42,57,-15,42
Admira Wacke,3660,8,12,5,19,38,57,-19,41
SV Josko Rie,3660,9,11,3,22,34,60,-26,36
St. Pölten,3660,10,7,8,21,38,68,-30,29
FC Salzburg,3661,1,21,8,7,73,32,41,71
SC Rheindorf,3661,2,20,9,7,60,43,17,69
Vienna,3661,3,19,6,11,61,53,8,63
SK Sturm Gra,3661,4,17,6,13,53,37,16,57
Rapid Vienna,3661,5,13,9,14,58,41,17,48
Admira Wacke,3661,6,13,8,15,40,52,-12,47
RZ Pellets W,3661,7,10,11,15,43,59,-16,41
Mattersburg,3661,8,9,9,18,44,57,-13,36
SV Josko Rie,3661,9,10,5,21,35,62,-27,35
St. Pölten,3661,10,8,9,19,42,73,-31,33
FC Salzburg,3662,1,23,7,6,67,31,36,76
SK Sturm Gra,3662,2,21,6,9,71,35,36,69
SC Rheindorf,3662,3,20,5,11,60,46,14,65
Rapid Vienna,3662,4,15,11,10,52,38,14,56
Vienna,3662,5,16,8,12,59,49,10,56
RZ Pellets W,3662,6,14,9,13,45,50,-5,51
St. Pölten,3662,7,9,10,17,43,66,-23,37
SV Josko Rie,3662,8,9,8,19,34,51,-17,35
Admira Wacke,3662,9,10,4,22,29,60,-31,34
Mattersburg,3662,10,5,8,23,34,68,-34,23
SK Sturm Gra,3663,1,22,6,8,60,29,31,72
Vienna,3663,2,21,5,10,64,47,17,68
FC Salzburg,3663,3,19,7,10,65,39,26,64
SC Rheindorf,3663,4,18,6,12,52,48,4,60
Rapid Vienna,3663,5,13,9,14,59,46,13,48
Admira Wacke,3663,6,11,7,18,38,57,-19,40
SV Josko Rie,3663,7,11,6,19,35,51,-16,39
RZ Pellets W,3663,8,11,6,19,44,64,-20,39
Mattersburg,3663,9,10,8,18,39,55,-16,38
St. Pölten,3663,10,8,12,16,40,60,-20,36
SK Sturm Gra,3664,1,22,5,9,61,31,30,71
FC Salzburg,3664,2,20,9,7,67,33,34,69
SC Rheindorf,3664,3,19,7,10,61,43,18,64
Vienna,3664,4,17,5,14,59,56,3,56
Admira Wacke,3664,5,15,5,16,41,64,-23,50
Rapid Vienna,3664,6,11,13,12,50,44,6,46
RZ Pellets W,3664,7,12,7,17,49,56,-7,43
St. Pölten,3664,8,9,11,16,43,60,-17,38
SV Josko Rie,3664,9,9,8,19,34,52,-18,35
Mattersburg,3664,10,7,8,21,35,61,-26,29
FC Salzburg,3665,1,24,5,7,77,31,46,77
SC Rheindorf,3665,2,21,7,8,65,43,22,70
SK Sturm Gra,3665,3,19,7,10,66,41,25,64
Rapid Vienna,3665,4,16,10,10,70,47,23,58
Vienna,3665,5,15,6,15,63,60,3,51
RZ Pellets W,3665,6,12,9,15,44,53,-9,45
SV Josko Rie,3665,7,12,6,18,37,58,-21,42
Admira Wacke,3665,8,10,8,18,40,59,-19,38
St. Pölten,3665,9,7,9,20,41,77,-36,30
Mattersburg,3665,10,7,7,22,35,69,-34,28
Vienna,3666,1,23,3,10,67,49,18,72
FC Salzburg,3666,2,19,9,8,63,35,28,66
SK Sturm Gra,3666,3,18,6,12,63,42,21,60
SC Rheindorf,3666,4,16,9,11,48,41,7,57
Rapid Vienna,3666,5,14,11,11,56,39,17,53
St. Pölten,3666,6,14,7,15,52,58,-6,49
Admira Wacke,3666,7,11,6,19,36,63,-27,39
RZ Pellets W,3666,8,9,10,17,46,59,-13,37
SV Josko Rie,3666,9,10,7,19,32,53,-21,37
Mattersburg,3666,10,7,10,19,38,62,-24,31
SK Sturm Gra,3667,1,21,6,9,60,33,27,69
FC Salzburg,3667,2,21,5,10,65,32,33,68
Vienna,3667,3,20,5,11,59,41,18,65
SC Rheindorf,3667,4,18,8,10,54,49,5,62
Rapid Vienna,3667,5,14,13,9,54,33,21,55
RZ Pellets W,3667,6,12,6,18,44,53,-9,42
Admira Wacke,3667,7,12,6,18,39,56,-17,42
St. Pölten,3667,8,9,8,19,41,60,-19,35
Mattersburg,3667,9,9,7,20,38,71,-33,34
SV Josko Rie,3667,10,9,6,21,35,61,-26,33
FC Salzburg,3668,1,22,7,7,72,33,39,73
SK Sturm Gra,3668,2,22,4,10,65,27,38,70
SC Rheindorf,3668,3,19,9,8,54,45,9,66
Vienna,3668,4,20,4,12,64,59,5,64
Rapid Vienna,3668,5,13,8,15,57,54,3,47
Admira Wacke,3668,6,12,8,16,44,58,-14,44
RZ Pellets W,3668,7,10,10,16,48,58,-10,40
St. Pölten,3668,8,8,11,17,43,62,-19,35
SV Josko Rie,3668,9,9,6,21,34,61,-27,33
Mattersburg,3668,10,6,11,19,37,61,-24,29
FC Salzburg,3669,1,20,8,8,60,30,30,68
SK Sturm Gra,3669,2,17,9,10,57,36,21,60
SC Rheindorf,3669,3,17,9,10,54,46,8,60
Rapid Vienna,3669,4,16,11,9,56,36,20,59
Vienna,3669,5,16,7,13,63,54,9,55
RZ Pellets W,3669,6,12,9,15,49,58,-9,45
Admira Wacke,3669,7,11,10,15,34,52,-18,43
SV Josko Rie,3669,8,11,9,16,37,48,-11,42
St. Pölten,3669,9,8,7,21,43,68,-25,31
Mattersburg,3669,10,6,13,17,35,60,-25,31
FC Salzburg,3670,1,23,5,8,77,36,41,74
SK Sturm Gra,3670,2,19,8,9,61,38,23,65
SC Rheindorf,3670,3,18,9,9,55,41,14,63
Vienna,3670,4,14,11,11,56,53,3,53
Rapid Vienna,3670,5,13,11,12,58,41,17,50
RZ Pellets W,3670,6,12,7,17,46,59,-13,43
Admira Wacke,3670,7,12,7,17,36,62,-26,43
SV Josko Rie,3670,8,10,7,19,33,51,-18,37
St. Pölten,3670,9,9,10,17,43,68,-25,37
Mattersburg,3670,10,9,7,20,37,53,-16,34
FC Salzburg,3671,1,23,6,7,69,31,38,75
SC Rheindorf,3671,2,20,7,9,52,39,13,67
SK Sturm Gra,3671,3,18,7,11,59,38,21,61
Vienna,3671,4,15,9,12,56,47,9,54
Rapid Vienna,3671,5,11,14,11,54,46,8,47
Admira Wacke,3671,6,12,7,17,34,60,-26,43
St. Pölten,3671,7,11,9,16,40,57,-17,42
RZ Pellets W,3671,8,11,7,18,42,53,-11,40
SV Josko Rie,3671,9,10,9,17,38,53,-15,39
Mattersburg,3671,10,8,7,21,38,58,-20,31
FC Salzburg,3672,1,22,9,5,65,23,42,75
SK Sturm Gra,3672,2,21,4,11,53,33,20,67
Vienna,3672,3,19,6,11,69,50,19,63
SC Rheindorf,3672,4,16,10,10,50,47,3,58
Rapid Vienna,3672,5,12,12,12,49,40,9,48
RZ Pellets W,3672,6,11,10,15,49,62,-13,43
Admira Wacke,3672,7,11,9,16,42,59,-17,42
SV Josko Rie,3672,8,10,7,19,36,57,-21,37
Mattersburg,3672,9,9,9,18,36,51,-15,36
St. Pölten,3672,10,6,10,20,36,63,-27,28
Vienna,3673,1,22,3,11,71,50,21,69
FC Salzburg,3673,2,21,4,11,67,36,31,67
SK Sturm Gra,3673,3,20,5,11,58,32,26,65
SC Rheindorf,3673,4,18,6,12,47,47,0,60
Rapid Vienna,3673,5,13,12,11,57,42,15,51
RZ Pellets W,3673,6,14,7,15,52,56,-4,49
SV Josko Rie,3673,7,10,8,18,35,53,-18,38
Admira Wacke,3673,8,11,4,21,35,65,-30,37
Mattersburg,3673,9,9,8,19,39,57,-18,35
St. Pölten,3673,10,8,11,17,43,66,-23,35
FC Salzburg,3674,1,21,7,8,57,27,30,70
SK Sturm Gra,3674,2,21,6,9,62,31,31,69
SC Rheindorf,3674,3,19,8,9,57,37,20,65
Vienna,3674,4,19,3,14,60,61,-1,60
Rapid Vienna,3674,5,14,11,11,58,40,18,53
RZ Pellets W,3674,6,14,9,13,51,58,-7,51
Mattersburg,3674,7,9,9,18,41,57,-16,36
St. Pölten,3674,8,8,10,18,41,63,-22,34
Admira Wacke,3674,9,9,7,20,39,68,-29,34
SV Josko Rie,3674,10,9,4,23,34,58,-24,31
SK Sturm Gra,3675,1,20,8,8,61,32,29,68
FC Salzburg,3675,2,20,6,10,68,35,33,66
Rapid Vienna,3675,3,17,10,9,56,36,20,61
SC Rheindorf,3675,4,17,8,11,49,46,3,59
Vienna,3675,5,17,5,14,62,55,7,56
RZ Pellets W,3675,6,13,8,15,45,55,-10,47
SV Josko Rie,3675,7,13,4,19,36,53,-17,43
Admira Wacke,3675,8,10,8,18,38,60,-22,38
St. Pölten,3675,9,8,9,19,38,61,-23,33
Mattersburg,3675,10,8,8,20,38,58,-20,32
SC Rheindorf,3676,1,20,7,9,60,47,13,67
SK Sturm Gra,3676,2,19,5,12,61,41,20,62
Vienna,3676,3,19,4,13,62,53,9,61
FC Salzburg,3676,4,17,7,12,60,37,23,58
Rapid Vienna,3676,5,13,10,13,53,42,11,49
SV Josko Rie,3676,6,14,6,16,40,48,-8,48
Admira Wacke,3676,7,13,5,18,34,52,-18,44
RZ Pellets W,3676,8,12,5,19,47,60,-13,41
St. Pölten,3676,9,9,12,15,45,61,-16,39
Mattersburg,3676,10,11,5,20,36,57,-21,38
FC Salzburg,3677,1,20,9,7,64,31,33,69
SC Rheindorf,3677,2,19,10,7,58,39,19,67
SK Sturm Gra,3677,3,19,6,11,57,34,23,63
Vienna,3677,4,15,8,13,58,50,8,53
Rapid Vienna,3677,5,14,10,12,63,43,20,52
SV Josko Rie,3677,6,13,6,17,35,48,-13,45
St. Pölten,3677,7,11,8,17,42,62,-20,41
Admira Wacke,3677,8,11,8,17,35,56,-21,41
RZ Pellets W,3677,9,10,6,20,41,64,-23,36
Mattersburg,3677,10,9,7,20,37,63,-26,34
SK Sturm Gra,3678,1,22,5,9,58,28,30,71
SC Rheindorf,3678,2,22,5,9,58,39,19,71
FC Salzburg,3678,3,20,8,8,65,29,36,68
Vienna,3678,4,18,5,13,58,51,7,59
Rapid Vienna,3678,5,12,13,11,52,37,15,49
RZ Pellets W,3678,6,14,6,16,46,50,-4,48
SV Josko Rie,3678,7,11,6,19,38,53,-15,39
Admira Wacke,3678,8,11,5,20,41,63,-22,38
Mattersburg,3678,9,8,8,20,33,67,-34,32
St. Pölten,3678,10,7,9,20,39,71,-32,30
FC Salzburg,3679,1,22,9,5,72,36,36,75
SC Rheindorf,3679,2,21,6,9,65,48,17,69
SK Sturm Gra,3679,3,18,8,10,60,35,25,62
Rapid Vienna,3679,4,12,13,11,58,46,12,49
Vienna,3679,5,15,4,17,51,55,-4,49
RZ Pellets W,3679,6,12,7,17,56,61,-5,43
Admira Wacke,3679,7,12,7,17,35,53,-18,43
SV Josko Rie,3679,8,12,5,19,43,56,-13,41
Mattersburg,3679,9,11,7,18,43,58,-15,40
St. Pölten,3679,10,7,10,19,41,76,-35,31
FC Salzburg,3680,1,20,9,7,69,37,32,69
SK Sturm Gra,3680,2,19,6,11,67,35,32,63
SC Rheindorf,3680,3,17,10,9,58,49,9,61
Rapid Vienna,3680,4,15,10,11,63,40,23,55
Vienna,3680,5,15,8,13,71,67,4,53
St. Pölten,3680,6,12,9,15,40,50,-10,45
RZ Pellets W,3680,7,11,10,15,42,60,-18,43
Mattersburg,3680,8,9,12,15,40,52,-12,39
SV Josko Rie,3680,9,11,3,22,35,60,-25,36
Admira Wacke,3680,10,9,7,20,29,64,-35,34
FC Salzburg,3681,1,22,7,7,69,33,36,73
SK Sturm Gra,3681,2,21,5,10,69,33,36,68
Vienna,3681,3,19,6,11,60,46,14,63
SC Rheindorf,3681,4,17,7,12,58,50,8,58
Admira Wacke,3681,5,15,5,16,39,55,-16,50
Rapid Vienna,3681,6,13,10,13,61,49,12,49
Mattersburg,3681,7,11,7,18,42,57,-15,40
SV Josko Rie,3681,8,12,4,20,40,55,-15,40
RZ Pellets W,3681,9,11,5,20,45,64,-19,38
St. Pölten,3681,10,7,8,21,34,75,-41,29
FC Salzburg,3682,1,20,9,7,65,32,33,69
SK Sturm Gra,3682,2,19,7,10,63,37,26,64
SC Rheindorf,3682,3,19,6,11,65,43,22,63
Vienna,3682,4,19,5,12,63,55,8,62
Rapid Vienna,3682,5,12,16,8,54,39,15,52
SV Josko Rie,3682,6,13,5,18,38,52,-14,44
Admira Wacke,3682,7,11,6,19,38,61,-23,39
St. Pölten,3682,8,9,11,16,45,71,-26,38
RZ Pellets W,3682,9,8,10,18,39,58,-19,34
Mattersburg,3682,10,8,9,19,41,63,-22,33
FC Salzburg,3683,1,22,9,5,68,25,43,75
SK Sturm Gra,3683,2,21,5,10,59,40,19,68
SC Rheindorf,3683,3,18,8,10,54,49,5,62
Vienna,3683,4,19,3,14,61,54,7,60
Rapid Vienna,3683,5,12,14,10,54,39,15,50
RZ Pellets W,3683,6,13,5,18,44,53,-9,44
St. Pölten,3683,7,9,12,15,41,57,-16,39
SV Josko Rie,3683,8,9,9,18,33,51,-18,36
Admira Wacke,3683,9,10,6,20,31,54,-23,36
Mattersburg,3683,10,8,7,21,38,61,-23,31
FC Salzburg,3684,1,20,8,8,65,33,32,68
SC Rheindorf,3684,2,19,9,8,55,39,16,66
SK Sturm Gra,3684,3,19,7,10,60,31,29,64
Vienna,3684,4,17,7,12,63,52,11,58
Rapid Vienna,3684,5,13,10,13,55,45,10,49
RZ Pellets W,3684,6,14,5,17,47,57,-10,47
Admira Wacke,3684,7,11,6,19,40,60,-20,39
SV Josko Rie,3684,8,10,8,18,40,57,-17,38
Mattersburg,3684,9,9,10,17,41,65,-24,37
St. Pölten,3684,10,8,10,18,38,65,-27,34
FC Salzburg,3685,1,21,9,6,71,34,37,72
SK Sturm Gra,3685,2,19,7,10,60,35,25,64
SC Rheindorf,3685,3,17,7,12,51,46,5,58
RZ Pellets W,3685,4,15,10,11,47,44,3,55
Vienna,3685,5,15,7,14,55,49,6,52
Rapid Vienna,3685,6,11,13,12,48,46,2,46
SV Josko Rie,3685,7,13,5,18,44,53,-9,44
Admira Wacke,3685,8,12,6,18,35,56,-21,42
St. Pölten,3685,9,8,9,19,40,64,-24,33
Mattersburg,3685,10,8,9,19,35,59,-24,33
FC Salzburg,3686,1,22,7,7,69,30,39,73
SC Rheindorf,3686,2,21,6,9,55,38,17,69
SK Sturm Gra,3686,3,19,6,11,57,33,24,63
Rapid Vienna,3686,4,15,11,10,54,36,18,56
Vienna,3686,5,17,5,14,63,53,10,56
RZ Pellets W,3686,6,12,8,16,44,53,-9,44
SV Josko Rie,3686,7,13,5,18,33,49,-16,44
Mattersburg,3686,8,8,11,17,33,50,-17,35
Admira Wacke,3686,9,9,7,20,34,64,-30,34
St. Pölten,3686,10,6,10,20,36,72,-36,28
FC Salzburg,3687,1,24,6,6,66,26,40,78
SK Sturm Gra,3687,2,21,6,9,68,39,29,69
SC Rheindorf,3687,3,20,7,9,60,44,16,67
Vienna,3687,4,18,6,12,63,49,14,60
Admira Wacke,3687,5,13,5,18,37,57,-20,44
Rapid Vienna,3687,6,10,13,13,56,52,4,43
SV Josko Rie,3687,7,13,3,20,36,58,-22,42
St. Pölten,3687,8,8,10,18,45,66,-21,34
Mattersburg,3687,9,7,12,17,40,57,-17,33
RZ Pellets W,3687,10,9,6,21,38,61,-23,33
FC Salzburg,3688,1,20,10,6,67,30,37,70
SC Rheindorf,3688,2,19,9,8,51,36,15,66
Vienna,3688,3,19,6,11,68,52,16,63
SK Sturm Gra,3688,4,18,8,10,54,31,23,62
Rapid Vienna,3688,5,13,11,12,55,39,16,50
RZ Pellets W,3688,6,12,10,14,43,48,-5,46
Mattersburg,3688,7,10,9,17,40,55,-15,39
Admira Wacke,3688,8,10,8,18,35,63,-28,38
SV Josko Rie,3688,9,9,5,22,34,62,-28,32
St. Pölten,3688,10,6,12,18,36,67,-31,30
FC Salzburg,3689,1,23,7,6,71,29,42,76
SK Sturm Gra,3689,2,21,8,7,61,31,30,71
Vienna,3689,3,18,5,13,63,53,10,59
SC Rheindorf,3689,4,16,9,11,55,50,5,57
Rapid Vienna,3689,5,13,8,15,55,48,7,47
Admira Wacke,3689,6,14,5,17,40,56,-16,47
RZ Pellets W,3689,7,13,6,17,40,56,-16,45
Mattersburg,3689,8,10,7,19,43,59,-16,37
St. Pölten,3689,9,8,10,18,39,63,-24,34
SV Josko Rie,3689,10,10,3,23,35,57,-22,33
SC Rheindorf,3690,1,21,7,8,52,37,15,70
FC Salzburg,3690,2,20,6,10,68,34,34,66
SK Sturm Gra,3690,3,19,6,11,61,34,27,63
RZ Pellets W,3690,4,16,6,14,50,54,-4,54
Vienna,3690,5,16,5,15,63,58,5,53
Rapid Vienna,3690,6,13,11,12,48,36,12,50
Admira Wacke,3690,7,15,4,17,42,60,-18,49
SV Josko Rie,3690,8,11,6,19,38,58,-20,39
Mattersburg,3690,9,8,7,21,42,67,-25,31
St. Pölten,3690,10,6,12,18,40,66,-26,30
FC Salzburg,3691,1,23,5,8,67,31,36,74
SC Rheindorf,3691,2,21,6,9,58,39,19,69
SK Sturm Gra,3691,3,20,6,10,60,32,28,66
Vienna,3691,4,20,6,10,66,46,20,66
Rapid Vienna,3691,5,12,9,15,51,48,3,45
RZ Pellets W,3691,6,9,14,13,41,52,-11,41
St. Pölten,3691,7,10,8,18,39,60,-21,38
Mattersburg,3691,8,9,10,17,38,54,-16,37
SV Josko Rie,3691,9,10,5,21,29,58,-29,35
Admira Wacke,3691,10,9,5,22,38,67,-29,32
FC Salzburg,3692,1,21,7,8,64,32,32,70
SK Sturm Gra,3692,2,20,5,11,55,33,22,65
SC Rheindorf,3692,3,19,8,9,61,48,13,65
Vienna,3692,4,20,5,11,62,53,9,65
RZ Pellets W,3692,5,14,6,16,53,58,-5,48
Rapid Vienna,3692,6,11,11,14,51,46,5,44
Admira Wacke,3692,7,13,5,18,37,50,-13,44
St. Pölten,3692,8,10,7,19,47,72,-25,37
SV Josko Rie,3692,9,10,5,21,37,58,-21,35
Mattersburg,3692,10,8,9,19,44,61,-17,33
FC Salzburg,3693,1,19,8,9,61,35,26,65
SC Rheindorf,3693,2,19,7,10,59,43,16,64
Vienna,3693,3,19,4,13,64,57,7,61
SK Sturm Gra,3693,4,17,9,10,60,44,16,60
Rapid Vienna,3693,5,14,11,11,56,43,13,53
Admira Wacke,3693,6,13,9,14,36,48,-12,48
RZ Pellets W,3693,7,11,9,16,47,52,-5,42
SV Josko Rie,3693,8,12,6,18,37,45,-8,42
Mattersburg,3693,9,10,6,20,35,58,-23,36
St. Pölten,3693,10,5,13,18,34,64,-30,28
SC Rheindorf,3694,1,23,6,7,60,46,14,75
FC Salzburg,3694,2,20,8,8,68,37,31,68
Vienna,3694,3,18,5,13,67,57,10,59
SK Sturm Gra,3694,4,18,4,14,54,40,14,58
Rapid Vienna,3694,5,14,9,13,57,38,19,51
RZ Pellets W,3694,6,13,6,17,40,56,-16,45
Admira Wacke,3694,7,13,4,19,49,65,-16,43
Mattersburg,3694,8,11,8,17,41,55,-14,41
SV Josko Rie,3694,9,11,4,21,35,56,-21,37
St. Pölten,3694,10,6,12,18,39,60,-21,30
FC Salzburg,3695,1,24,6,6,67,26,41,78
Vienna,3695,2,21,5,10,71,50,21,68
SK Sturm Gra,3695,3,20,5,11,64,32,32,65
SC Rheindorf,3695,4,18,8,10,53,50,3,62
Rapid Vienna,3695,5,13,10,13,53,42,11,49
RZ Pellets W,3695,6,11,10,15,40,51,-11,43
Admira Wacke,3695,7,12,6,18,31,54,-23,42
St. Pölten,3695,8,10,9,17,45,65,-20,39
SV Josko Rie,3695,9,9,5,22,32,58,-26,32
Mattersburg,3695,10,6,8,22,37,65,-28,26
FC Salzburg,3696,1,20,8,8,66,39,27,68
SK Sturm Gra,3696,2,20,7,9,61,33,28,67
SC Rheindorf,3696,3,18,8,10,52,43,9,62
Rapid Vienna,3696,4,16,10,10,63,44,19,58
Vienna,3696,5,16,4,16,60,59,1,52
Admira Wacke,3696,6,13,7,16,34,53,-19,46
RZ Pellets W,3696,7,12,5,19,51,62,-11,41
St. Pölten,3696,8,10,9,17,47,65,-18,39
SV Josko Rie,3696,9,10,7,19,30,51,-21,37
Mattersburg,3696,10,7,11,18,35,50,-15,32
FC Salzburg,3697,1,20,10,6,62,27,35,70
SK Sturm Gra,3697,2,21,6,9,60,29,31,69
Vienna,3697,3,19,3,14,62,55,7,60
SC Rheindorf,3697,4,17,8,11,53,51,2,59
Rapid Vienna,3697,5,13,11,12,53,43,10,50
Admira Wacke,3697,6,14,5,17,46,56,-10,47
RZ Pellets W,3697,6,13,8,15,46,56,-10,47
Mattersburg,3697,8,9,10,17,43,57,-14,37
SV Josko Rie,3697,9,11,4,21,40,59,-19,37
St. Pölten,3697,10,6,9,21,32,64,-32,27
SC Rheindorf,3698,1,22,6,8,59,38,21,72
FC Salzburg,3698,2,20,5,11,60,34,26,65
SK Sturm Gra,3698,3,20,5,11,59,42,17,65
Rapid Vienna,3698,4,16,11,9,63,40,23,59
Vienna,3698,5,17,7,12,63,55,8,58
RZ Pellets W,3698,6,13,8,15,52,56,-4,47
SV Josko Rie,3698,7,11,5,20,38,53,-15,38
St. Pölten,3698,8,9,9,18,40,61,-21,36
Mattersburg,3698,9,8,8,20,43,63,-20,32
Admira Wacke,3698,10,7,10,19,36,71,-35,31
SK Sturm Gra,3699,1,20,10,6,64,32,32,70
FC Salzburg,3699,2,20,9,7,64,34,30,69
SC Rheindorf,3699,3,19,7,10,59,45,14,64
Rapid Vienna,3699,4,15,11,10,63,43,20,56
Vienna,3699,5,17,3,16,68,65,3,54
SV Josko Rie,3699,6,12,7,17,37,48,-11,43
RZ Pellets W,3699,7,11,7,18,44,58,-14,40
Admira Wacke,3699,8,10,8,18,43,67,-24,38
St. Pölten,3699,9,9,7,20,35,62,-27,34
Mattersburg,3699,10,8,9,19,37,60,-23,33
SC Rheindorf,3700,1,23,5,8,63,39,24,74
Vienna,3700,2,21,4,11,61,46,15,67
FC Salzburg,3700,3,20,6,10,67,37,30,66
SK Sturm Gra,3700,4,19,4,13,61,41,20,61
Rapid Vienna,3700,5,13,14,9,53,38,15,53
RZ Pellets W,3700,6,14,5,17,46,55,-9,47
Admira Wacke,3700,7,13,4,19,43,62,-19,43
Mattersburg,3700,8,9,10,17,39,54,-15,37
SV Josko Rie,3700,9,10,6,20,33,55,-22,36
St. Pölten,3700,10,5,8,23,30,69,-39,23
SK Sturm Gra,3701,1,21,6,9,62,29,33,69
Vienna,3701,2,21,6,9,71,47,24,69
FC Salzburg,3701,3,18,8,10,59,35,24,62
SC Rheindorf,3701,4,19,5,12,50,46,4,62
Rapid Vienna,3701,5,13,12,11,53,38,15,51
RZ Pellets W,3701,6,13,8,15,57,64,-7,47
Admira Wacke,3701,7,9,10,17,34,62,-28,37
SV Josko Rie,3701,8,10,6,20,41,61,-20,36
St. Pölten,3701,9,8,11,17,43,69,-26,35
Mattersburg,3701,10,7,10,19,39,58,-19,31
FC Salzburg,3702,1,20,7,9,68,34,34,67
SC Rheindorf,3702,2,18,11,7,56,44,12,65
SK Sturm Gra,3702,3,16,9,11,57,36,21,57
Vienna,3702,4,16,7,13,54,44,10,55
Rapid Vienna,3702,5,14,12,10,57,40,17,54
RZ Pellets W,3702,6,12,10,14,44,55,-11,46
Admira Wacke,3702,7,11,8,17,40,59,-19,41
SV Josko Rie,3702,8,11,6,19,39,58,-19,39
Mattersburg,3702,9,8,13,15,35,55,-20,37
St. Pölten,3702,10,8,9,19,46,71,-25,33
SC Rheindorf,3703,1,23,6,7,58,33,25,75
FC Salzburg,3703,2,18,10,8,58,30,28,64
SK Sturm Gra,3703,3,17,9,10,55,37,18,60
Vienna,3703,4,18,6,12,60,49,11,60
RZ Pellets W,3703,5,14,6,16,48,61,-13,48
Rapid Vienna,3703,6,12,10,14,51,43,8,46
Mattersburg,3703,7,11,6,19,46,57,-11,39
St. Pölten,3703,8,10,9,17,45,62,-17,39
Admira Wacke,3703,9,11,6,19,34,60,-26,39
SV Josko Rie,3703,10,9,6,21,33,56,-23,33
FC Salzburg,3704,1,24,7,5,70,29,41,79
SK Sturm Gra,3704,2,21,5,10,63,29,34,68
SC Rheindorf,3704,3,19,7,10,58,48,10,64
Vienna,3704,4,18,7,11,58,47,11,61
Rapid Vienna,3704,5,11,14,11,49,44,5,47
St. Pölten,3704,6,11,9,16,44,57,-13,42
Admira Wacke,3704,7,12,4,20,39,63,-24,40
Mattersburg,3704,8,9,9,18,43,57,-14,36
SV Josko Rie,3704,9,10,5,21,37,62,-25,35
RZ Pellets W,3704,10,8,7,21,36,61,-25,31
FC Salzburg,3705,1,21,7,8,61,31,30,70
SC Rheindorf,3705,2,19,8,9,54,36,18,65
SK Sturm Gra,3705,3,19,7,10,55,32,23,64
Vienna,3705,4,20,4,12,63,49,14,64
Rapid Vienna,3705,5,14,13,9,60,39,21,55
RZ Pellets W,3705,6,12,7,17,50,61,-11,43
Admira Wacke,3705,7,13,4,19,36,60,-24,43
SV Josko Rie,3705,8,10,5,21,34,54,-20,35
St. Pölten,3705,9,8,11,17,38,61,-23,35
Mattersburg,3705,10,6,10,20,35,63,-28,28
FC Salzburg,3706,1,21,9,6,61,26,35,72
SK Sturm Gra,3706,2,19,8,9,60,37,23,65
Vienna,3706,3,19,6,11,63,43,20,63
SC Rheindorf,3706,4,18,8,10,55,42,13,62
Rapid Vienna,3706,5,13,13,10,56,42,14,52
RZ Pellets W,3706,6,12,8,16,55,65,-10,44
Admira Wacke,3706,7,12,5,19,37,64,-27,41
Mattersburg,3706,8,10,7,19,41,57,-16,37
SV Josko Rie,3706,9,11,4,21,37,60,-23,37
St. Pölten,3706,10,6,10,20,39,68,-29,28
FC Salzburg,3707,1,21,7,8,69,33,36,70
SK Sturm Gra,3707,2,19,6,11,58,37,21,63
Vienna,3707,3,17,5,14,67,60,7,56
SC Rheindorf,3707,4,16,8,12,54,49,5,56
Rapid Vienna,3707,5,14,9,13,53,41,12,51
Admira Wacke,3707,6,14,6,16,44,60,-16,48
RZ Pellets W,3707,7,12,8,16,49,57,-8,44
Mattersburg,3707,8,11,8,17,41,54,-13,41
SV Josko Rie,3707,9,12,5,19,41,58,-17,41
St. Pölten,3707,10,9,8,19,40,67,-27,35
FC Salzburg,3708,1,24,6,6,70,29,41,78
SK Sturm Gra,3708,2,24,4,8,70,29,41,76
SC Rheindorf,3708,3,20,5,11,55,45,10,65
Vienna,3708,4,15,6,15,53,55,-2,51
Rapid Vienna,3708,5,14,7,15,51,42,9,49
Admira Wacke,3708,6,14,6,16,41,58,-17,48
RZ Pellets W,3708,7,12,6,18,46,60,-14,42
Mattersburg,3708,8,10,8,18,41,55,-14,38
St. Pölten,3708,9,8,9,19,37,62,-25,33
SV Josko Rie,3708,10,8,5,23,28,57,-29,29
SC Rheindorf,3709,1,20,10,6,52,35,17,70
FC Salzburg,3709,2,19,11,6,61,26,35,68
SK Sturm Gra,3709,3,20,5,11,56,33,23,65
Vienna,3709,4,16,8,12,53,44,9,56
Rapid Vienna,3709,5,14,10,12,58,46,12,52
RZ Pellets W,3709,6,11,8,17,51,57,-6,41
SV Josko Rie,3709,7,11,7,18,41,54,-13,40
Admira Wacke,3709,8,11,7,18,33,61,-28,40
Mattersburg,3709,9,9,10,17,42,58,-16,37
St. Pölten,3709,10,7,8,21,45,78,-33,29
SK Sturm Gra,3710,1,21,5,10,59,33,26,68
Vienna,3710,2,19,9,8,63,40,23,66
FC Salzburg,3710,3,16,12,8,56,32,24,60
SC Rheindorf,3710,4,15,12,9,45,36,9,57
Admira Wacke,3710,5,16,4,16,41,53,-12,52
Rapid Vienna,3710,6,11,11,14,49,46,3,44
RZ Pellets W,3710,7,11,9,16,46,57,-11,42
Mattersburg,3710,8,10,11,15,40,51,-11,41
SV Josko Rie,3710,9,10,7,19,33,51,-18,37
St. Pölten,3710,10,7,8,21,34,67,-33,29
Vienna,3711,1,20,7,9,71,46,25,67
SC Rheindorf,3711,2,20,7,9,56,42,14,67
FC Salzburg,3711,3,19,8,9,59,32,27,65
SK Sturm Gra,3711,4,19,7,10,48,32,16,64
Rapid Vienna,3711,5,13,11,12,53,42,11,50
RZ Pellets W,3711,6,13,9,14,49,51,-2,48
SV Josko Rie,3711,7,12,5,19,35,55,-20,41
St. Pölten,3711,8,9,10,17,42,65,-23,37
Admira Wacke,3711,9,9,7,20,40,63,-23,34
Mattersburg,3711,10,6,9,21,35,60,-25,27
FC Salzburg,3712,1,21,7,8,65,31,34,70
SC Rheindorf,3712,2,20,7,9,53,41,12,67
SK Sturm Gra,3712,3,18,8,10,57,32,25,62
Vienna,3712,4,19,5,12,69,55,14,62
Rapid Vienna,3712,5,16,10,10,59,37,22,58
Admira Wacke,3712,6,12,5,19,34,61,-27,41
RZ Pellets W,3712,7,11,7,18,38,54,-16,40
Mattersburg,3712,8,10,9,17,44,56,-12,39
SV Josko Rie,3712,9,9,5,22,31,51,-20,32
St. Pölten,3712,10,7,11,18,35,67,-32,32
FC Salzburg,3713,1,22,8,6,65,27,38,74
SK Sturm Gra,3713,2,21,7,8,73,34,39,70
SC Rheindorf,3713,3,20,6,10,62,44,18,66
Vienna,3713,4,19,2,15,60,66,-6,59
Rapid Vienna,3713,5,15,9,12,59,46,13,54
RZ Pellets W,3713,6,11,8,17,44,55,-11,41
St. Pölten,3713,7,7,15,14,49,71,-22,36
Mattersburg,3713,8,9,8,19,36,55,-19,35
Admira Wacke,3713,9,9,8,19,39,66,-27,35
SV Josko Rie,3713,10,9,5,22,37,60,-23,32
FC Salzburg,3714,1,25,5,6,76,31,45,80
SK Sturm Gra,3714,2,20,4,12,56,35,21,64
SC Rheindorf,3714,3,19,7,10,58,46,12,64
Vienna,3714,4,19,2,15,63,56,7,59
Rapid Vienna,3714,5,15,11,10,55,34,21,56
RZ Pellets W,3714,6,13,6,17,48,55,-7,45
St. Pölten,3714,7,11,8,17,46,60,-14,41
Admira Wacke,3714,8,11,5,20,37,65,-28,38
SV Josko Rie,3714,9,10,4,22,35,57,-22,34
Mattersburg,3714,10,8,6,22,35,70,-35,30
SK Sturm Gra,3715,1,20,6,10,59,33,26,66
SC Rheindorf,3715,2,18,10,8,51,42,9,64
FC Salzburg,3715,3,18,8,10,60,35,25,62
Rapid Vienna,3715,4,16,13,7,61,39,22,61
Vienna,3715,5,17,5,14,63,57,6,56
RZ Pellets W,3715,6,13,9,14,52,56,-4,48
Mattersburg,3715,7,10,9,17,35,48,-13,39
SV Josko Rie,3715,8,9,8,19,39,57,-18,35
Admira Wacke,3715,9,8,10,18,29,54,-25,34
St. Pölten,3715,10,6,12,18,39,67,-28,30
FC Salzburg,3716,1,22,8,6,75,30,45,74
SC Rheindorf,3716,2,19,6,11,57,52,5,63
SK Sturm Gra,3716,3,16,9,11,55,36,19,57
Vienna,3716,4,17,4,15,60,52,8,55
Rapid Vienna,3716,5,12,12,12,53,38,15,48
RZ Pellets W,3716,6,13,8,15,35,49,-14,47
Admira Wacke,3716,7,12,8,16,42,60,-18,44
SV Josko Rie,3716,8,13,3,20,43,60,-17,42
St. Pölten,3716,9,10,10,16,40,61,-21,40
Mattersburg,3716,10,8,8,20,30,52,-22,32
SK Sturm Gra,3717,1,21,7,8,56,28,28,70
SC Rheindorf,3717,2,19,8,9,51,38,13,65
FC Salzburg,3717,3,18,10,8,61,26,35,64
Vienna,3717,4,19,4,13,65,51,14,61
Rapid Vienna,3717,5,15,11,10,54,39,15,56
Admira Wacke,3717,6,14,5,17,35,54,-19,47
St. Pölten,3717,7,11,8,17,45,69,-24,41
RZ Pellets W,3717,8,11,7,18,44,57,-13,40
SV Josko Rie,3717,9,9,6,21,33,53,-20,33
Mattersburg,3717,10,6,8,22,30,59,-29,26
SC Rheindorf,3718,1,22,6,8,60,41,19,72
FC Salzburg,3718,2,18,9,9,59,31,28,63
Vienna,3718,3,18,7,11,61,53,8,61
SK Sturm Gra,3718,4,17,6,13,58,42,16,57
Rapid Vienna,3718,5,15,10,11,61,40,21,55
SV Josko Rie,3718,6,13,5,18,37,54,-17,44
RZ Pellets W,3718,7,11,10,15,48,58,-10,43
Admira Wacke,3718,8,10,9,17,36,59,-23,39
St. Pölten,3718,9,9,8,19,39,60,-21,35
Mattersburg,3718,10,8,8,20,41,62,-21,32
Vienna,3719,1,22,5,9,67,45,22,71
FC Salzburg,3719,2,19,9,8,58,33,25,66
SK Sturm Gra,3719,3,18,10,8,56,29,27,64
SC Rheindorf,3719,4,18,7,11,53,49,4,61
Rapid Vienna,3719,5,14,10,12,53,41,12,52
Admira Wacke,3719,6,13,6,17,40,62,-22,45
RZ Pellets W,3719,7,13,5,18,45,57,-12,44
SV Josko Rie,3719,8,11,5,20,46,59,-13,38
Mattersburg,3719,9,8,8,20,37,60,-23,32
St. Pölten,3719,10,7,9,20,41,61,-20,30
Vienna,3720,1,22,3,11,64,49,15,69
FC Salzburg,3720,2,20,8,8,59,26,33,68
SC Rheindorf,3720,3,19,9,8,58,38,20,66
Rapid Vienna,3720,4,17,10,9,59,31,28,61
SK Sturm Gra,3720,5,18,6,12,58,32,26,60
RZ Pellets W,3720,6,13,6,17,43,58,-15,45
SV Josko Rie,3720,7,11,6,19,30,50,-20,39
St. Pölten,3720,8,9,8,19,37,62,-25,35
Admira Wacke,3720,9,9,6,21,34,66,-32,33
Mattersburg,3720,10,7,8,21,31,61,-30,29
SK Sturm Gra,3721,1,22,6,8,62,27,35,72
SC Rheindorf,3721,2,20,10,6,61,33,28,70
FC Salzburg,3721,3,19,10,7,66,32,34,67
Rapid Vienna,3721,4,15,10,11,61,43,18,55
Vienna,3721,5,15,9,12,59,58,1,54
RZ Pellets W,3721,6,12,7,17,49,60,-11,43
Admira Wacke,3721,7,12,5,19,46,69,-23,41
SV Josko Rie,3721,8,9,8,19,36,62,-26,35
St. Pölten,3721,9,6,12,18,40,63,-23,30
Mattersburg,3721,10,7,9,20,34,67,-33,30
FC Salzburg,3722,1,22,8,6,63,28,35,74
SK Sturm Gra,3722,2,20,4,12,60,38,22,64
SC Rheindorf,3722,3,17,9,10,47,39,8,60
Rapid Vienna,3722,4,14,12,10,62,48,14,54
Vienna,3722,5,16,4,16,62,55,7,52
Admira Wacke,3722,6,14,5,17,46,58,-12,47
RZ Pellets W,3722,7,11,9,16,45,56,-11,42
SV Josko Rie,3722,8,11,9,16,38,51,-13,42
St. Pölten,3722,9,8,11,17,42,68,-26,35
Mattersburg,3722,10,5,13,18,36,60,-24,28
FC Salzburg,3723,1,21,8,7,64,30,34,71
SC Rheindorf,3723,2,19,10,7,60,44,16,67
Vienna,3723,3,21,4,11,64,49,15,67
SK Sturm Gra,3723,4,19,7,10,53,27,26,64
Rapid Vienna,3723,5,13,12,11,55,41,14,51
RZ Pellets W,3723,6,15,6,15,46,49,-3,51
SV Josko Rie,3723,7,12,5,19,40,60,-20,41
Admira Wacke,3723,8,10,5,21,30,59,-29,35
Mattersburg,3723,9,7,9,20,38,62,-24,30
St. Pölten,3723,10,5,10,21,38,67,-29,25
FC Salzburg,3724,1,23,6,7,68,31,37,75
SC Rheindorf,3724,2,20,6,10,59,45,14,66
SK Sturm Gra,3724,3,18,8,10,55,36,19,62
Vienna,3724,4,19,4,13,66,49,17,61
RZ Pellets W,3724,5,14,7,15,55,57,-2,49
Rapid Vienna,3724,6,13,9,14,52,42,10,48
Admira Wacke,3724,7,13,5,18,39,62,-23,44
Mattersburg,3724,8,10,9,17,39,54,-15,39
SV Josko Rie,3724,9,11,2,23,39,70,-31,35
St. Pölten,3724,10,6,10,20,40,66,-26,28
SK Sturm Gra,3725,1,20,6,10,61,33,28,66
SC Rheindorf,3725,2,19,7,10,59,45,14,64
FC Salzburg,3725,3,18,8,10,62,36,26,62
Vienna,3725,4,18,5,13,62,52,10,59
Rapid Vienna,3725,5,14,10,12,52,41,11,52
RZ Pellets W,3725,6,14,9,13,52,49,3,51
Admira Wacke,3725,7,15,4,17,45,58,-13,49
Mattersburg,3725,8,9,9,18,41,58,-17,36
SV Josko Rie,3725,9,9,6,21,33,61,-28,33
St. Pölten,3725,10,8,8,20,35,69,-34,32
FC Salzburg,3726,1,22,6,8,65,28,37,72
SK Sturm Gra,3726,2,19,8,9,59,28,31,65
Vienna,3726,3,21,2,13,60,51,9,65
SC Rheindorf,3726,4,18,8,10,50,40,10,62
Rapid Vienna,3726,5,12,11,13,52,43,9,47
RZ Pellets W,3726,6,12,9,15,46,51,-5,45
Mattersburg,3726,7,11,7,18,43,53,-10,40
Admira Wacke,3726,8,9,10,17,29,55,-26,37
SV Josko Rie,3726,9,10,5,21,30,59,-29,35
St. Pölten,3726,10,7,12,17,39,65,-26,33
FC Salzburg,3727,1,22,7,7,70,29,41,73
SK Sturm Gra,3727,2,19,8,9,54,33,21,65
Vienna,3727,3,18,7,11,67,46,21,61
SC Rheindorf,3727,4,16,8,12,50,46,4,56
Rapid Vienna,3727,5,14,13,9,54,38,16,55
RZ Pellets W,3727,6,12,9,15,40,47,-7,45
Admira Wacke,3727,7,12,6,18,38,62,-24,42
St. Pölten,3727,8,11,8,17,46,68,-22,41
SV Josko Rie,3727,9,9,7,20,29,52,-23,34
Mattersburg,3727,10,6,9,21,33,60,-27,27
FC Salzburg,3728,1,21,7,8,65,33,32,70
SK Sturm Gra,3728,2,20,6,10,66,37,29,66
SC Rheindorf,3728,3,19,9,8,56,42,14,66
Vienna,3728,4,18,4,14,61,55,6,58
Rapid Vienna,3728,5,14,11,11,58,39,19,53
Admira Wacke,3728,6,13,6,17,42,57,-15,45
RZ Pellets W,3728,7,12,6,18,43,56,-13,42
SV Josko Rie,3728,8,11,6,19,32,53,-21,39
Mattersburg,3728,9,9,9,18,35,50,-15,36
St. Pölten,3728,10,6,10,20,34,70,-36,28
FC Salzburg,3729,1,19,11,6,76,34,42,68
SC Rheindorf,3729,2,19,11,6,54,41,13,68
Rapid Vienna,3729,3,17,11,8,70,42,28,62
SK Sturm Gra,3729,4,18,7,11,56,37,19,61
Vienna,3729,5,16,8,12,56,54,2,56
RZ Pellets W,3729,6,9,12,15,48,58,-10,39
Admira Wacke,3729,7,11,6,19,39,62,-23,39
Mattersburg,3729,8,10,8,18,42,63,-21,38
St. Pölten,3729,9,7,12,17,49,69,-20,33
SV Josko Rie,3729,10,8,6,22,35,65,-30,30
SK Sturm Gra,3730,1,23,5,8,63,26,37,74
Vienna,3730,2,21,3,12,66,48,18,66
Rapid Vienna,3730,3,18,8,10,58,32,26,62
FC Salzburg,3730,4,18,8,10,57,33,24,62
SC Rheindorf,3730,5,19,5,12,52,47,5,62
RZ Pellets W,3730,6,11,9,16,40,52,-12,42
Mattersburg,3730,7,9,8,19,37,55,-18,35
SV Josko Rie,3730,8,10,5,21,37,59,-22,35
St. Pölten,3730,9,8,11,17,36,60,-24,35
Admira Wacke,3730,10,9,6,21,30,64,-34,33
SK Sturm Gra,3731,1,21,7,8,69,38,31,70
FC Salzburg,3731,2,21,6,9,64,36,28,69
SC Rheindorf,3731,3,20,7,9,55,43,12,67
Rapid Vienna,3731,4,16,8,12,54,43,11,56
Vienna,3731,5,16,8,12,59,49,10,56
RZ Pellets W,3731,6,12,8,16,48,57,-9,44
Admira Wacke,3731,7,12,7,17,46,63,-17,43
Mattersburg,3731,8,7,13,16,39,54,-15,34
St. Pölten,3731,9,7,10,19,37,60,-23,31
SV Josko Rie,3731,10,8,6,22,34,62,-28,30
FC Salzburg,3732,1,22,6,8,65,31,34,72
SK Sturm Gra,3732,2,21,7,8,61,30,31,70
Vienna,3732,3,18,5,13,63,55,8,59
RZ Pellets W,3732,4,16,7,13,54,50,4,55
SC Rheindorf,3732,5,14,9,13,44,44,0,51
Rapid Vienna,3732,6,11,12,13,49,41,8,45
SV Josko Rie,3732,7,13,5,18,38,48,-10,44
Admira Wacke,3732,8,12,5,19,38,65,-27,41
St. Pölten,3732,9,9,8,19,42,65,-23,35
Mattersburg,3732,10,7,10,19,35,60,-25,31
FC Salzburg,3733,1,19,9,8,64,35,29,66
Vienna,3733,2,19,9,8,70,49,21,66
SK Sturm Gra,3733,3,18,9,9,54,33,21,63
SC Rheindorf,3733,4,17,8,11,56,46,10,59
Rapid Vienna,3733,5,12,12,12,54,46,8,48
RZ Pellets W,3733,6,12,9,15,50,59,-9,45
St. Pölten,3733,7,10,11,15,43,61,-18,41
SV Josko Rie,3733,8,10,8,18,36,55,-19,38
Admira Wacke,3733,9,11,4,21,34,58,-24,37
Mattersburg,3733,10,8,9,19,39,58,-19,33
FC Salzburg,3734,1,19,11,6,61,30,31,68
SC Rheindorf,3734,2,19,9,8,58,42,16,66
SK Sturm Gra,3734,3,18,8,10,56,31,25,62
Vienna,3734,4,19,5,12,66,50,16,62
RZ Pellets W,3734,5,12,10,14,50,58,-8,46
Rapid Vienna,3734,6,11,12,13,52,41,11,45
Admira Wacke,3734,7,13,5,18,41,56,-15,44
SV Josko Rie,3734,8,12,7,17,41,53,-12,43
Mattersburg,3734,9,8,10,18,40,65,-25,34
St. Pölten,3734,10,6,9,21,39,78,-39,27
FC Salzburg,3735,1,20,9,7,61,28,33,69
Vienna,3735,2,20,6,10,68,51,17,66
SC Rheindorf,3735,3,19,8,9,48,37,11,65
SK Sturm Gra,3735,4,17,6,13,53,37,16,57
Rapid Vienna,3735,5,11,14,11,51,42,9,47
Mattersburg,3735,6,13,6,17,38,49,-11,45
Admira Wacke,3735,7,13,6,17,37,51,-14,45
RZ Pellets W,3735,8,11,5,20,38,58,-20,38
SV Josko Rie,3735,9,10,6,20,31,53,-22,36
St. Pölten,3735,10,9,8,19,44,63,-19,35
FC Salzburg,3736,1,20,9,7,68,31,37,69
SK Sturm Gra,3736,2,19,7,10,63,35,28,64
SC Rheindorf,3736,3,17,8,11,60,45,15,59
Vienna,3736,4,17,7,12,61,55,6,58
Rapid Vienna,3736,5,14,12,10,53,38,15,54
RZ Pellets W,3736,6,14,9,13,46,52,-6,51
Admira Wacke,3736,7,10,10,16,32,61,-29,40
St. Pölten,3736,8,10,8,18,46,63,-17,38
SV Josko Rie,3736,9,11,4,21,35,57,-22,37
Mattersburg,3736,10,8,6,22,32,59,-27,30
FC Salzburg,3737,1,21,8,7,66,31,35,71
Vienna,3737,2,21,5,10,73,50,23,68
SC Rheindorf,3737,3,18,10,8,53,42,11,64
SK Sturm Gra,3737,4,17,6,13,56,38,18,57
Rapid Vienna,3737,5,14,9,13,50,45,5,51
Admira Wacke,3737,6,12,7,17,38,57,-19,43
RZ Pellets W,3737,7,10,11,15,39,53,-14,41
Mattersburg,3737,8,10,9,17,45,50,-5,39
SV Josko Rie,3737,9,10,6,20,32,57,-25,36
St. Pölten,3737,10,8,7,21,41,70,-29,31
SC Rheindorf,3738,1,21,6,9,59,40,19,69
SK Sturm Gra,3738,2,20,5,11,56,33,23,65
FC Salzburg,3738,3,19,6,11,55,28,27,63
Rapid Vienna,3738,4,17,10,9,65,40,25,61
Vienna,3738,5,18,7,11,66,52,14,61
Admira Wacke,3738,6,12,7,17,41,64,-23,43
RZ Pellets W,3738,7,11,9,16,45,58,-13,42
St. Pölten,3738,8,8,12,16,37,60,-23,36
SV Josko Rie,3738,9,9,5,22,35,64,-29,32
Mattersburg,3738,10,8,7,21,40,60,-20,31
Vienna,3739,1,21,5,10,68,47,21,68
SK Sturm Gra,3739,2,20,6,10,54,28,26,66
SC Rheindorf,3739,3,20,6,10,52,47,5,66
Rapid Vienna,3739,4,18,9,9,63,36,27,63
FC Salzburg,3739,5,18,8,10,63,36,27,62
RZ Pellets W,3739,6,11,7,18,41,62,-21,40
Admira Wacke,3739,7,10,8,18,33,57,-24,38
Mattersburg,3739,8,10,7,19,41,56,-15,37
St. Pölten,3739,9,7,11,18,39,61,-22,32
SV Josko Rie,3739,10,9,5,22,32,56,-24,32
FC Salzburg,3740,1,19,7,10,57,29,28,64
Vienna,3740,2,19,5,12,61,50,11,62
SK Sturm Gra,3740,3,17,9,10,64,43,21,60
SC Rheindorf,3740,4,17,8,11,57,49,8,59
Rapid Vienna,3740,5,15,9,12,54,37,17,54
Admira Wacke,3740,6,14,6,16,41,56,-15,48
RZ Pellets W,3740,7,12,6,18,41,57,-16,42
St. Pölten,3740,8,10,9,17,41,61,-20,39
Mattersburg,3740,9,9,11,16,34,51,-17,38
SV Josko Rie,3740,10,11,4,21,34,51,-17,37
Vienna,3741,1,24,4,8,72,45,27,76
FC Salzburg,3741,2,21,7,8,65,32,33,70
SC Rheindorf,3741,3,19,9,8,58,42,16,66
SK Sturm Gra,3741,4,16,8,12,55,42,13,56
Rapid Vienna,3741,5,12,14,10,56,41,15,50
RZ Pellets W,3741,6,13,6,17,45,58,-13,45
Admira Wacke,3741,7,11,7,18,34,54,-20,40
SV Josko Rie,3741,8,11,4,21,37,57,-20,37
St. Pölten,3741,9,9,8,19,40,63,-23,35
Mattersburg,3741,10,6,9,21,37,65,-28,27
SC Rheindorf,3742,1,21,8,7,65,37,28,71
SK Sturm Gra,3742,2,21,5,10,62,31,31,68
FC Salzburg,3742,3,19,7,10,61,32,29,64
Rapid Vienna,3742,4,17,8,11,59,40,19,59
Vienna,3742,5,18,3,15,56,56,0,57
RZ Pellets W,3742,6,12,6,18,42,59,-17,42
SV Josko Rie,3742,7,12,5,19,38,50,-12,41
Admira Wacke,3742,8,12,4,20,34,63,-29,40
Mattersburg,3742,9,8,10,18,33,54,-21,34
St. Pölten,3742,10,7,10,19,32,60,-28,31
FC Salzburg,3743,1,23,4,9,68,34,34,73
SC Rheindorf,3743,2,22,5,9,60,39,21,71
SK Sturm Gra,3743,3,21,7,8,63,32,31,70
Vienna,3743,4,17,6,13,62,51,11,57
Rapid Vienna,3743,5,12,10,14,50,43,7,46
SV Josko Rie,3743,6,13,4,19,40,54,-14,43
Admira Wacke,3743,7,12,7,17,36,56,-20,43
RZ Pellets W,3743,8,9,12,15,36,51,-15,39
Mattersburg,3743,9,8,8,20,37,62,-25,32
St. Pölten,3743,10,6,11,19,35,65,-30,29
FC Salzburg,3744,1,23,6,7,72,32,40,75
Vienna,3744,2,21,4,11,72,47,25,67
SK Sturm Gra,3744,3,21,4,11,58,37,21,67
SC Rheindorf,3744,4,19,8,9,62,43,19,65
Rapid Vienna,3744,5,13,10,13,57,46,11,49
Admira Wacke,3744,6,11,7,18,40,64,-24,40
SV Josko Rie,3744,7,10,7,19,37,64,-27,37
St. Pölten,3744,8,9,9,18,46,61,-15,36
RZ Pellets W,3744,9,9,8,19,38,62,-24,35
Mattersburg,3744,10,8,9,19,34,60,-26,33
FC Salzburg,3745,1,22,5,9,66,32,34,71
SC Rheindorf,3745,2,21,7,8,59,41,18,70
SK Sturm Gra,3745,3,20,5,11,57,36,21,65
Vienna,3745,4,16,7,13,53,51,2,55
Rapid Vienna,3745,5,14,11,11,60,43,17,53
RZ Pellets W,3745,6,15,7,14,50,51,-1,52
Admira Wacke,3745,7,14,6,16,49,61,-12,48
St. Pölten,3745,8,9,10,17,44,61,-17,37
Mattersburg,3745,9,7,7,22,37,65,-28,28
SV Josko Rie,3745,10,7,5,24,24,58,-34,26
FC Salzburg,3746,1,22,6,8,74,34,40,72
SC Rheindorf,3746,2,20,7,9,55,39,16,67
Vienna,3746,3,20,3,13,63,60,3,63
SK Sturm Gra,3746,4,19,5,12,62,37,25,62
Rapid Vienna,3746,5,15,10,11,57,39,18,55
Admira Wacke,3746,6,14,6,16,37,58,-21,48
SV Josko Rie,3746,7,11,5,20,37,51,-14,38
RZ Pellets W,3746,8,10,6,20,43,60,-17,36
Mattersburg,3746,9,8,11,17,39,58,-19,35
St. Pölten,3746,10,8,7,21,39,70,-31,31
FC Salzburg,3747,1,24,6,6,73,29,44,78
SK Sturm Gra,3747,2,21,5,10,58,32,26,68
SC Rheindorf,3747,3,20,8,8,56,40,16,68
Vienna,3747,4,20,4,12,73,55,18,64
Rapid Vienna,3747,5,13,13,10,51,39,12,52
Admira Wacke,3747,6,11,8,17,37,54,-17,41
SV Josko Rie,3747,7,10,7,19,35,56,-21,37
St. Pölten,3747,8,8,10,18,34,57,-23,34
RZ Pellets W,3747,9,7,11,18,33,62,-29,32
Mattersburg,3747,10,6,8,22,37,63,-26,26
SC Rheindorf,3748,1,22,6,8,58,43,15,72
Vienna,3748,2,19,6,11,63,53,10,63
Rapid Vienna,3748,3,17,9,10,61,35,26,60
FC Salzburg,3748,4,17,8,11,54,33,21,59
SK Sturm Gra,3748,5,15,8,13,48,35,13,53
SV Josko Rie,3748,6,12,8,16,38,47,-9,44
St. Pölten,3748,7,10,10,16,50,63,-13,40
RZ Pellets W,3748,8,11,7,18,42,61,-19,40
Admira Wacke,3748,9,10,7,19,30,56,-26,37
Mattersburg,3748,10,8,9,19,38,56,-18,33
FC Salzburg,3749,1,26,6,4,77,27,50,84
SK Sturm Gra,3749,2,20,6,10,60,36,24,66
SC Rheindorf,3749,3,16,10,10,55,51,4,58
Vienna,3749,4,17,5,14,61,57,4,56
Rapid Vienna,3749,5,14,12,10,58,41,17,54
RZ Pellets W,3749,6,11,10,15,42,49,-7,43
Admira Wacke,3749,7,12,7,17,37,56,-19,43
SV Josko Rie,3749,8,11,6,19,33,49,-16,39
Mattersburg,3749,9,9,8,19,40,57,-17,35
St. Pölten,3749,10,4,10,22,32,72,-40,22
FC Salzburg,3750,1,22,7,7,65,31,34,73
SK Sturm Gra,3750,2,23,4,9,60,33,27,73
SC Rheindorf,3750,3,19,7,10,51,45,6,64
Vienna,3750,4,16,8,12,64,51,13,56
Admira Wacke,3750,5,16,5,15,47,51,-4,53
SV Josko Rie,3750,6,12,6,18,35,50,-15,42
Rapid Vienna,3750,7,10,11,15,47,50,-3,41
Mattersburg,3750,8,10,9,17,36,44,-8,39
RZ Pellets W,3750,9,10,8,18,45,57,-12,38
St. Pölten,3750,10,4,11,21,33,71,-38,23
SC Rheindorf,3751,1,20,8,8,58,41,17,68
FC Salzburg,3751,2,19,8,9,56,23,33,65
SK Sturm Gra,3751,3,19,7,10,63,37,26,64
Vienna,3751,4,19,6,11,59,45,14,63
Rapid Vienna,3751,5,13,10,13,56,43,13,49
SV Josko Rie,3751,6,14,5,17,36,51,-15,47
RZ Pellets W,3751,7,11,10,15,38,50,-12,43
Mattersburg,3751,8,9,10,17,41,61,-20,37
Admira Wacke,3751,9,10,5,21,35,65,-30,35
St. Pölten,3751,10,6,11,19,40,66,-26,29
FC Salzburg,3752,1,22,9,5,60,23,37,75
SK Sturm Gra,3752,2,20,6,10,64,31,33,66
SC Rheindorf,3752,3,19,9,8,62,47,15,66
Vienna,3752,4,20,5,11,67,50,17,65
Rapid Vienna,3752,5,13,12,11,53,39,14,51
Admira Wacke,3752,6,12,4,20,34,62,-28,40
RZ Pellets W,3752,7,10,9,17,44,58,-14,39
Mattersburg,3752,8,9,8,19,43,62,-19,35
SV Josko Rie,3752,9,10,3,23,34,61,-27,33
St. Pölten,3752,10,7,11,18,46,74,-28,32
SC Rheindorf,3753,1,22,8,6,59,38,21,74
FC Salzburg,3753,2,22,6,8,65,28,37,72
SK Sturm Gra,3753,3,22,4,10,62,35,27,70
Vienna,3753,4,16,4,16,61,61,0,52
Rapid Vienna,3753,5,13,10,13,58,50,8,49
Admira Wacke,3753,6,14,4,18,45,59,-14,46
Mattersburg,3753,7,10,11,15,42,51,-9,41
RZ Pellets W,3753,8,9,9,18,41,59,-18,36
SV Josko Rie,3753,9,10,6,20,36,57,-21,36
St. Pölten,3753,10,6,10,20,34,65,-31,28
SK Sturm Gra,3754,1,22,5,9,66,33,33,71
SC Rheindorf,3754,2,20,8,8,63,44,19,68
FC Salzburg,3754,3,19,7,10,62,39,23,64
Vienna,3754,4,19,3,14,67,57,10,60
Rapid Vienna,3754,5,14,10,12,55,41,14,52
St. Pölten,3754,6,11,9,16,44,58,-14,42
Admira Wacke,3754,7,12,6,18,34,61,-27,42
Mattersburg,3754,8,11,6,19,42,55,-13,39
RZ Pellets W,3754,9,11,4,21,37,53,-16,37
SV Josko Rie,3754,10,10,4,22,32,61,-29,34
FC Salzburg,3755,1,19,8,9,62,35,27,65
Vienna,3755,2,20,5,11,62,48,14,65
SK Sturm Gra,3755,3,18,8,10,59,35,24,62
SC Rheindorf,3755,4,17,9,10,54,47,7,60
Rapid Vienna,3755,5,14,10,12,56,46,10,52
RZ Pellets W,3755,6,12,10,14,46,53,-7,46
Admira Wacke,3755,7,12,8,16,38,54,-16,44
SV Josko Rie,3755,8,9,9,18,36,54,-18,36
St. Pölten,3755,9,9,8,19,39,61,-22,35
Mattersburg,3755,10,8,9,19,30,49,-19,33
FC Salzburg,3756,1,21,7,8,74,33,41,70
Vienna,3756,2,22,4,10,75,55,20,70
SK Sturm Gra,3756,3,18,11,7,59,35,24,65
SC Rheindorf,3756,4,19,7,10,60,47,13,64
Rapid Vienna,3756,5,13,12,11,59,46,13,51
RZ Pellets W,3756,6,11,7,18,46,62,-16,40
Mattersburg,3756,7,10,7,19,35,56,-21,37
St. Pölten,3756,8,8,11,17,43,66,-23,35
Admira Wacke,3756,9,9,8,19,39,66,-27,35
SV Josko Rie,3756,10,10,4,22,36,60,-24,34
FC Salzburg,3757,1,20,10,6,59,29,30,70
SK Sturm Gra,3757,2,20,6,10,56,32,24,66
SC Rheindorf,3757,3,20,6,10,57,45,12,66
Vienna,3757,4,17,5,14,62,51,11,56
Rapid Vienna,3757,5,13,12,11,49,38,11,51
Admira Wacke,3757,6,13,7,16,38,49,-11,46
RZ Pellets W,3757,7,12,8,16,45,59,-14,44
Mattersburg,3757,8,9,8,19,36,53,-17,35
SV Josko Rie,3757,9,9,7,20,34,57,-23,34
St. Pölten,3757,10,7,11,18,36,59,-23,32
FC Salzburg,3758,1,20,8,8,67,35,32,68
SK Sturm Gra,3758,2,19,8,9,66,36,30,65
Vienna,3758,3,17,7,12,61,58,3,58
SC Rheindorf,3758,4,16,8,12,53,45,8,56
Rapid Vienna,3758,5,11,14,11,48,40,8,47
SV Josko Rie,3758,6,14,4,18,45,57,-12,46
RZ Pellets W,3758,7,12,9,15,43,52,-9,45
Admira Wacke,3758,8,12,5,19,35,56,-21,41
Mattersburg,3758,9,9,10,17,38,52,-14,37
St. Pölten,3758,10,8,11,17,43,68,-25,35
FC Salzburg,3759,1,22,8,6,66,28,38,74
SK Sturm Gra,3759,2,20,5,11,62,36,26,65
SC Rheindorf,3759,3,19,8,9,56,43,13,65
Vienna,3759,4,20,4,12,71,56,15,64
Rapid Vienna,3759,5,13,12,11,49,37,12,51
Admira Wacke,3759,6,13,8,15,46,59,-13,47
Mattersburg,3759,7,9,10,17,35,50,-15,37
RZ Pellets W,3759,8,10,7,19,37,60,-23,37
SV Josko Rie,3759,9,10,2,24,28,53,-25,32
St. Pölten,3759,10,7,10,19,34,62,-28,31
FC Salzburg,3760,1,21,8,7,65,32,33,71
SK Sturm Gra,3760,2,21,5,10,64,32,32,68
SC Rheindorf,3760,3,19,9,8,58,38,20,66
Vienna,3760,4,19,6,11,63,49,14,63
Rapid Vienna,3760,5,14,9,13,57,44,13,51
RZ Pellets W,3760,6,13,7,16,50,57,-7,46
St. Pölten,3760,7,10,9,17,41,60,-19,39
Admira Wacke,3760,8,10,8,18,36,62,-26,38
SV Josko Rie,3760,9,9,8,19,28,57,-29,35
Mattersburg,3760,10,5,9,22,29,60,-31,24
FC Salzburg,3761,1,20,8,8,63,31,32,68
SC Rheindorf,3761,2,19,9,8,61,40,21,66
SK Sturm Gra,3761,3,18,10,8,59,33,26,64
Vienna,3761,4,16,8,12,62,55,7,56
Rapid Vienna,3761,5,14,13,9,54,33,21,55
RZ Pellets W,3761,6,13,7,16,51,63,-12,46
Admira Wacke,3761,7,11,8,17,37,62,-25,41
St. Pölten,3761,8,8,11,17,44,62,-18,35
SV Josko Rie,3761,9,9,6,21,33,56,-23,33
Mattersburg,3761,10,8,8,20,36,65,-29,32
FC Salzburg,3762,1,21,9,6,70,32,38,72
SK Sturm Gra,3762,2,21,6,9,65,37,28,69
SC Rheindorf,3762,3,20,7,9,53,39,14,67
Vienna,3762,4,18,4,14,63,55,8,58
Rapid Vienna,3762,5,15,10,11,61,46,15,55
RZ Pellets W,3762,6,14,5,17,54,60,-6,47
Admira Wacke,3762,7,12,5,19,38,59,-21,41
St. Pölten,3762,8,9,10,17,38,54,-16,37
SV Josko Rie,3762,9,9,7,20,27,51,-24,34
Mattersburg,3762,10,4,11,21,29,65,-36,23
FC Salzburg,3763,1,21,8,7,65,33,32,71
SC Rheindorf,3763,2,21,8,7,56,39,17,71
Rapid Vienna,3763,3,16,10,10,62,38,24,58
Vienna,3763,4,17,7,12,62,59,3,58
SK Sturm Gra,3763,5,16,7,13,55,33,22,55
RZ Pellets W,3763,6,12,9,15,44,53,-9,45
SV Josko Rie,3763,7,10,7,19,38,55,-17,37
Mattersburg,3763,8,9,10,17,35,55,-20,37
St. Pölten,3763,9,9,9,18,45,63,-18,36
Admira Wacke,3763,10,9,5,22,31,65,-34,32
FC Salzburg,3764,1,25,5,6,75,24,51,80
SK Sturm Gra,3764,2,20,6,10,58,29,29,66
SC Rheindorf,3764,3,19,8,9,51,41,10,65
Rapid Vienna,3764,4,16,11,9,61,44,17,59
Vienna,3764,5,14,7,15,54,61,-7,49
RZ Pellets W,3764,6,11,8,17,40,53,-13,41
Admira Wacke,3764,7,11,8,17,37,59,-22,41
SV Josko Rie,3764,8,11,3,22,32,57,-25,36
Mattersburg,3764,9,9,7,20,33,52,-19,34
St. Pölten,3764,10,6,13,17,44,65,-21,31
FC Salzburg,3765,1,22,5,9,72,35,37,71
SK Sturm Gra,3765,2,21,5,10,60,32,28,68
SC Rheindorf,3765,3,18,9,9,57,48,9,63
Vienna,3765,4,18,4,14,64,53,11,58
Rapid Vienna,3765,5,15,10,11,52,38,14,55
Admira Wacke,3765,6,14,5,17,40,58,-18,47
Mattersburg,3765,7,10,9,17,43,57,-14,39
RZ Pellets W,3765,8,10,7,19,42,57,-15,37
SV Josko Rie,3765,9,10,5,21,35,60,-25,35
St. Pölten,3765,10,8,9,19,42,69,-27,33
FC Salzburg,3766,1,21,9,6,58,27,31,72
SC Rheindorf,3766,2,20,8,8,55,38,17,68
Vienna,3766,3,17,8,11,62,49,13,59
SK Sturm Gra,3766,4,17,8,11,52,40,12,59
Rapid Vienna,3766,5,16,9,11,57,33,24,57
RZ Pellets W,3766,6,13,10,13,52,50,2,49
Admira Wacke,3766,7,11,7,18,35,55,-20,40
SV Josko Rie,3766,8,10,5,21,32,57,-25,35
Mattersburg,3766,9,7,10,19,31,58,-27,31
St. Pölten,3766,10,6,10,20,41,68,-27,28
FC Salzburg,3767,1,22,8,6,68,29,39,74
Vienna,3767,2,19,4,13,65,52,13,61
SC Rheindorf,3767,3,18,7,11,48,43,5,61
SK Sturm Gra,3767,4,16,6,14,56,44,12,54
Admira Wacke,3767,5,15,8,13,46,55,-9,53
Rapid Vienna,3767,6,12,12,12,57,48,9,48
RZ Pellets W,3767,7,12,8,16,51,60,-9,44
SV Josko Rie,3767,8,12,5,19,37,53,-16,41
Mattersburg,3767,9,10,8,18,42,57,-15,38
St. Pölten,3767,10,7,8,21,35,64,-29,29
SC Rheindorf,3768,1,20,7,9,56,42,14,67
FC Salzburg,3768,2,18,8,10,58,36,22,62
Vienna,3768,3,17,8,11,59,46,13,59
SK Sturm Gra,3768,4,16,8,12,55,35,20,56
Rapid Vienna,3768,5,12,11,13,53,46,7,47
RZ Pellets W,3768,6,12,11,13,44,49,-5,47
Admira Wacke,3768,7,13,7,16,45,57,-12,46
Mattersburg,3768,8,11,10,15,38,45,-7,43
SV Josko Rie,3768,9,8,10,18,35,59,-24,34
St. Pölten,3768,10,8,10,18,46,74,-28,34
FC Salzburg,3769,1,21,9,6,61,29,32,72
SK Sturm Gra,3769,2,20,5,11,58,36,22,65
Vienna,3769,3,19,7,10,67,53,14,64
SC Rheindorf,3769,4,19,6,11,50,40,10,63
Rapid Vienna,3769,5,13,11,12,52,37,15,50
RZ Pellets W,3769,6,12,6,18,47,59,-12,42
Admira Wacke,3769,7,11,7,18,43,60,-17,40
SV Josko Rie,3769,8,11,5,20,38,61,-23,38
Mattersburg,3769,9,10,7,19,40,58,-18,37
St. Pölten,3769,10,7,11,18,39,62,-23,32
FC Salzburg,3770,1,20,7,9,65,34,31,67
SC Rheindorf,3770,2,19,10,7,58,42,16,67
SK Sturm Gra,3770,3,18,7,11,63,36,27,61
Vienna,3770,4,19,4,13,66,53,13,61
Rapid Vienna,3770,5,16,8,12,62,42,20,56
RZ Pellets W,3770,6,13,7,16,38,54,-16,46
Admira Wacke,3770,7,11,9,16,39,59,-20,42
SV Josko Rie,3770,8,12,5,19,36,55,-19,41
Mattersburg,3770,9,8,8,20,37,62,-25,32
St. Pölten,3770,10,8,7,21,32,59,-27,31
FC Salzburg,3771,1,21,9,6,68,30,38,72
SK Sturm Gra,3771,2,18,9,9,58,36,22,63
SC Rheindorf,3771,3,18,9,9,53,42,11,63
Vienna,3771,4,17,6,13,66,58,8,57
Rapid Vienna,3771,5,13,15,8,66,50,16,54
RZ Pellets W,3771,6,12,11,13,47,51,-4,47
SV Josko Rie,3771,7,11,8,17,33,47,-14,41
Admira Wacke,3771,8,10,6,20,38,67,-29,36
Mattersburg,3771,9,9,7,20,38,58,-20,34
St. Pölten,3771,10,6,10,20,38,66,-28,28
FC Salzburg,3772,1,23,8,5,71,25,46,77
SK Sturm Gra,3772,2,22,8,6,63,26,37,74
SC Rheindorf,3772,3,17,9,10,53,49,4,60
Vienna,3772,4,17,7,12,59,53,6,58
Rapid Vienna,3772,5,15,8,13,59,41,18,53
RZ Pellets W,3772,6,13,7,16,47,55,-8,46
Admira Wacke,3772,7,12,7,17,29,54,-25,43
Mattersburg,3772,8,7,10,19,31,57,-26,31
SV Josko Rie,3772,9,8,6,22,36,60,-24,30
St. Pölten,3772,10,7,8,21,41,69,-28,29
FC Salzburg,3773,1,19,9,8,66,32,34,66
SC Rheindorf,3773,2,20,6,10,56,41,15,66
Vienna,3773,3,19,7,10,60,48,12,64
SK Sturm Gra,3773,4,17,9,10,56,32,24,60
Rapid Vienna,3773,5,13,13,10,59,39,20,52
RZ Pellets W,3773,6,14,7,15,43,52,-9,49
Admira Wacke,3773,7,10,8,18,36,65,-29,38
SV Josko Rie,3773,8,11,4,21,32,54,-22,37
St. Pölten,3773,9,8,10,18,46,67,-21,34
Mattersburg,3773,10,8,9,19,35,59,-24,33
FC Salzburg,3774,1,24,6,6,72,29,43,78
SC Rheindorf,3774,2,20,5,11,57,48,9,65
SK Sturm Gra,3774,3,18,8,10,57,31,26,62
Vienna,3774,4,18,4,14,65,59,6,58
Rapid Vienna,3774,5,16,9,11,60,38,22,57
SV Josko Rie,3774,6,13,4,19,39,50,-11,43
RZ Pellets W,3774,7,10,8,18,40,59,-19,38
Admira Wacke,3774,8,10,8,18,40,63,-23,38
Mattersburg,3774,9,8,10,18,33,57,-24,34
St. Pölten,3774,10,7,10,19,36,65,-29,31
FC Salzburg,3775,1,21,7,8,74,37,37,70
SC Rheindorf,3775,2,20,9,7,61,44,17,69
Vienna,3775,3,19,7,10,72,54,18,64
SK Sturm Gra,3775,4,18,9,9,58,35,23,63
Rapid Vienna,3775,5,14,12,10,49,34,15,54
RZ Pellets W,3775,6,12,7,17,52,64,-12,43
Admira Wacke,3775,7,10,8,18,36,65,-29,38
SV Josko Rie,3775,8,10,5,21,33,55,-22,35
Mattersburg,3775,9,7,10,19,40,60,-20,31
St. Pölten,3775,10,7,10,19,38,65,-27,31
FC Salzburg,3776,1,18,11,7,65,34,31,65
Vienna,3776,2,19,8,9,62,46,16,65
SK Sturm Gra,3776,3,19,7,10,61,34,27,64
SC Rheindorf,3776,4,17,9,10,52,42,10,60
Rapid Vienna,3776,5,14,11,11,55,43,12,53
Admira Wacke,3776,6,11,8,17,35,55,-20,41
Mattersburg,3776,7,10,10,16,40,55,-15,40
RZ Pellets W,3776,8,11,6,19,40,56,-16,39
SV Josko Rie,3776,9,10,7,19,35,57,-22,37
St. Pölten,3776,10,6,13,17,38,61,-23,31
FC Salzburg,3777,1,20,8,8,68,32,36,68
SK Sturm Gra,3777,2,21,5,10,63,37,26,68
SC Rheindorf,3777,3,19,9,8,58,45,13,66
Vienna,3777,4,18,8,10,72,56,16,62
Rapid Vienna,3777,5,16,11,9,63,40,23,59
RZ Pellets W,3777,6,11,8,17,42,56,-14,41
Admira Wacke,3777,7,11,6,19,42,65,-23,39
Mattersburg,3777,8,8,10,18,42,67,-25,34
SV Josko Rie,3777,9,9,6,21,36,53,-17,33
St. Pölten,3777,10,6,11,19,38,73,-35,29
SC Rheindorf,3778,1,21,7,8,59,36,23,70
FC Salzburg,3778,2,18,6,12,61,41,20,60
Vienna,3778,3,18,6,12,57,46,11,60
SK Sturm Gra,3778,4,17,7,12,56,36,20,58
RZ Pellets W,3778,5,14,10,12,46,47,-1,52
Rapid Vienna,3778,6,13,11,12,54,39,15,50
SV Josko Rie,3778,7,11,9,16,33,45,-12,42
Admira Wacke,3778,8,11,7,18,37,63,-26,40
Mattersburg,3778,9,9,10,17,37,53,-16,37
St. Pölten,3778,10,7,9,20,39,73,-34,30
FC Salzburg,3779,1,21,11,4,70,22,48,74
SK Sturm Gra,3779,2,21,7,8,70,36,34,70
SC Rheindorf,3779,3,18,7,11,54,49,5,61
Vienna,3779,4,17,5,14,53,54,-1,56
Rapid Vienna,3779,5,13,10,13,53,41,12,49
RZ Pellets W,3779,6,12,7,17,50,53,-3,43
SV Josko Rie,3779,7,10,8,18,32,49,-17,38
St. Pölten,3779,8,9,11,16,44,64,-20,38
Admira Wacke,3779,9,10,6,20,37,65,-28,36
Mattersburg,3779,10,9,8,19,37,67,-30,35
FC Salzburg,3780,1,22,8,6,67,28,39,74
SC Rheindorf,3780,2,21,7,8,55,39,16,70
SK Sturm Gra,3780,3,19,5,12,62,36,26,62
Vienna,3780,4,17,6,13,61,55,6,57
Rapid Vienna,3780,5,12,12,12,52,48,4,48
RZ Pellets W,3780,6,12,9,15,44,55,-11,45
Admira Wacke,3780,7,12,7,17,39,54,-15,43
SV Josko Rie,3780,8,11,6,19,42,57,-15,39
St. Pölten,3780,9,7,12,17,34,58,-24,33
Mattersburg,3780,10,8,6,22,34,60,-26,30
FC Salzburg,3781,1,20,8,8,64,35,29,68
Vienna,3781,2,18,7,11,72,47,25,61
SC Rheindorf,3781,3,17,10,9,52,48,4,61
Rapid Vienna,3781,4,16,10,10,56,35,21,58
SK Sturm Gra,3781,5,16,10,10,54,34,20,58
Admira Wacke,3781,6,13,4,19,40,65,-25,43
Mattersburg,3781,7,10,11,15,41,55,-14,41
SV Josko Rie,3781,8,11,7,18,40,61,-21,40
RZ Pellets W,3781,9,8,9,19,39,57,-18,33
St. Pölten,3781,10,7,12,17,40,61,-21,33
FC Salzburg,3782,1,25,6,5,68,25,43,81
SK Sturm Gra,3782,2,20,5,11,52,32,20,65
SC Rheindorf,3782,3,19,7,10,52,46,6,64
Vienna,3782,4,19,5,12,62,46,16,62
Rapid Vienna,3782,5,13,9,14,47,36,11,48
Mattersburg,3782,6,11,8,17,39,50,-11,41
RZ Pellets W,3782,7,11,7,18,38,51,-13,40
Admira Wacke,3782,8,11,6,19,34,57,-23,39
St. Pölten,3782,9,8,9,19,40,67,-27,33
SV Josko Rie,3782,10,7,10,19,29,51,-22,31
SK Sturm Gra,3783,1,21,6,9,66,33,33,69
SC Rheindorf,3783,2,20,9,7,64,47,17,69
FC Salzburg,3783,3,19,9,8,61,29,32,66
Vienna,3783,4,17,7,12,57,50,7,58
Rapid Vienna,3783,5,13,13,10,56,48,8,52
RZ Pellets W,3783,6,13,10,13,48,54,-6,49
Mattersburg,3783,7,11,10,15,49,59,-10,43
SV Josko Rie,3783,8,10,5,21,35,55,-20,35
Admira Wacke,3783,9,10,5,21,35,62,-27,35
St. Pölten,3783,10,5,8,23,37,71,-34,23
SC Rheindorf,3784,1,20,9,7,63,46,17,69
SK Sturm Gra,3784,2,20,7,9,55,31,24,67
Vienna,3784,3,21,4,11,66,45,21,67
Rapid Vienna,3784,4,16,12,8,57,36,21,60
FC Salzburg,3784,5,17,6,13,61,38,23,57
RZ Pellets W,3784,6,13,8,15,42,49,-7,47
SV Josko Rie,3784,7,11,5,20,35,58,-23,38
St. Pölten,3784,8,8,9,19,37,62,-25,33
Admira Wacke,3784,9,9,6,21,29,59,-30,33
Mattersburg,3784,10,8,8,20,40,61,-21,32
FC Salzburg,3785,1,21,7,8,67,35,32,70
SK Sturm Gra,3785,2,20,8,8,58,30,28,68
SC Rheindorf,3785,3,18,11,7,53,38,15,65
Vienna,3785,4,17,6,13,57,56,1,57
Rapid Vienna,3785,5,14,10,12,56,44,12,52
Mattersburg,3785,6,12,7,17,43,52,-9,43
SV Josko Rie,3785,7,11,7,18,41,54,-13,40
Admira Wacke,3785,8,10,8,18,35,54,-19,38
RZ Pellets W,3785,9,9,9,18,39,57,-18,36
St. Pölten,3785,10,6,11,19,36,65,-29,29
FC Salzburg,3786,1,21,8,7,70,37,33,71
SK Sturm Gra,3786,2,21,5,10,60,32,28,68
SC Rheindorf,3786,3,18,8,10,50,45,5,62
Vienna,3786,4,18,5,13,65,51,14,59
Rapid Vienna,3786,5,15,11,10,56,36,20,56
RZ Pellets W,3786,6,14,7,15,51,54,-3,49
SV Josko Rie,3786,7,11,8,17,41,51,-10,41
Admira Wacke,3786,8,9,6,21,33,71,-38,33
Mattersburg,3786,9,8,8,20,34,56,-22,32
St. Pölten,3786,10,8,8,20,41,68,-27,32
SC Rheindorf,3787,1,22,9,5,61,35,26,75
FC Salzburg,3787,2,20,9,7,69,36,33,69
SK Sturm Gra,3787,3,18,6,12,56,36,20,60
Rapid Vienna,3787,4,14,12,10,63,44,19,54
Vienna,3787,5,16,5,15,57,55,2,53
Admira Wacke,3787,6,14,5,17,36,53,-17,47
RZ Pellets W,3787,7,12,10,14,52,53,-1,46
SV Josko Rie,3787,8,12,7,17,40,53,-13,43
St. Pölten,3787,9,7,8,21,37,73,-36,29
Mattersburg,3787,10,5,9,22,29,62,-33,24
FC Salzburg,3788,1,22,9,5,70,28,42,75
SC Rheindorf,3788,2,18,10,8,53,44,9,64
SK Sturm Gra,3788,3,18,6,12,55,38,17,60
Vienna,3788,4,18,5,13,64,54,10,59
Rapid Vienna,3788,5,14,12,10,60,40,20,54
Admira Wacke,3788,6,13,7,16,35,51,-16,46
RZ Pellets W,3788,7,11,8,17,45,61,-16,41
SV Josko Rie,3788,8,9,9,18,30,50,-20,36
St. Pölten,3788,9,7,10,19,40,63,-23,31
Mattersburg,3788,10,7,10,19,37,60,-23,31
FC Salzburg,3789,1,22,7,7,66,29,37,73
SK Sturm Gra,3789,2,17,9,10,58,37,21,60
Rapid Vienna,3789,3,16,10,10,68,44,24,58
Vienna,3789,4,18,4,14,59,57,2,58
SC Rheindorf,3789,5,16,7,13,57,52,5,55
RZ Pellets W,3789,6,14,8,14,50,52,-2,50
Admira Wacke,3789,7,13,5,18,40,60,-20,44
Mattersburg,3789,8,9,11,16,42,56,-14,38
SV Josko Rie,3789,9,10,5,21,37,58,-21,35
St. Pölten,3789,10,7,10,19,42,74,-32,31
FC Salzburg,3790,1,20,9,7,65,29,36,69
SK Sturm Gra,3790,2,20,9,7,66,34,32,69
SC Rheindorf,3790,3,19,8,9,50,37,13,65
Rapid Vienna,3790,4,17,9,10,60,42,18,60
Vienna,3790,5,18,5,13,60,49,11,59
RZ Pellets W,3790,6,11,10,15,42,57,-15,43
SV Josko Rie,3790,7,10,5,21,40,61,-21,35
St. Pölten,3790,8,9,8,19,41,67,-26,35
Admira Wacke,3790,9,9,7,20,34,63,-29,34
Mattersburg,3790,10,7,10,19,44,63,-19,31
FC Salzburg,3791,1,22,6,8,67,32,35,72
Vienna,3791,2,22,2,12,78,52,26,68
SC Rheindorf,3791,3,19,7,10,59,47,12,64
SK Sturm Gra,3791,4,18,5,13,56,46,10,59
Rapid Vienna,3791,5,16,9,11,59,44,15,57
RZ Pellets W,3791,6,14,5,17,49,58,-9,47
Admira Wacke,3791,7,12,5,19,35,55,-20,41
Mattersburg,3791,8,9,10,17,39,58,-19,37
SV Josko Rie,3791,9,8,7,21,32,57,-25,31
St. Pölten,3791,10,6,12,18,38,63,-25,30
SC Rheindorf,3792,1,22,6,8,65,42,23,72
Vienna,3792,2,19,7,10,64,54,10,64
FC Salzburg,3792,3,18,9,9,65,38,27,63
SK Sturm Gra,3792,4,18,7,11,54,32,22,61
Rapid Vienna,3792,5,14,13,9,57,38,19,55
Admira Wacke,3792,6,13,5,18,41,61,-20,44
St. Pölten,3792,7,11,8,17,45,62,-17,41
RZ Pellets W,3792,8,9,11,16,39,55,-16,38
Mattersburg,3792,9,7,11,18,34,54,-20,32
SV Josko Rie,3792,10,8,5,23,32,60,-28,29
FC Salzburg,3793,1,22,8,6,70,30,40,74
SK Sturm Gra,3793,2,20,8,8,64,35,29,68
SC Rheindorf,3793,3,19,6,11,53,46,7,63
Rapid Vienna,3793,4,15,12,9,61,42,19,57
Vienna,3793,5,16,8,12,68,61,7,56
RZ Pellets W,3793,6,14,7,15,48,52,-4,49
St. Pölten,3793,7,9,9,18,47,67,-20,36
Admira Wacke,3793,8,8,10,18,32,59,-27,34
SV Josko Rie,3793,9,9,6,21,37,64,-27,33
Mattersburg,3793,10,7,8,21,34,58,-24,29
FC Salzburg,3794,1,19,11,6,66,35,31,68
SK Sturm Gra,3794,2,19,6,11,59,36,23,63
SC Rheindorf,3794,3,17,7,12,50,44,6,58
Vienna,3794,4,17,4,15,57,56,1,55
Rapid Vienna,3794,5,15,9,12,58,40,18,54
RZ Pellets W,3794,6,11,10,15,43,54,-11,43
St. Pölten,3794,7,12,6,18,42,58,-16,42
Admira Wacke,3794,8,11,9,16,34,53,-19,42
SV Josko Rie,3794,9,11,7,18,33,49,-16,40
Mattersburg,3794,10,9,9,18,35,52,-17,36
FC Salzburg,3795,1,23,5,8,73,36,37,74
Vienna,3795,2,19,7,10,66,50,16,64
SC Rheindorf,3795,3,18,9,9,56,44,12,63
Rapid Vienna,3795,4,16,8,12,63,45,18,56
SK Sturm Gra,3795,5,16,6,14,52,39,13,54
Admira Wacke,3795,6,13,7,16,42,59,-17,46
RZ Pellets W,3795,7,12,7,17,47,56,-9,43
SV Josko Rie,3795,8,13,4,19,38,53,-15,43
St. Pölten,3795,9,8,11,17,43,65,-22,35
Mattersburg,3795,10,6,8,22,34,67,-33,26
FC Salzburg,3796,1,22,7,7,63,27,36,73
SK Sturm Gra,3796,2,19,6,11,63,40,23,63
SC Rheindorf,3796,3,17,10,9,58,43,15,61
Vienna,3796,4,19,3,14,62,53,9,60
Rapid Vienna,3796,5,16,9,11,48,37,11,57
RZ Pellets W,3796,6,13,6,17,51,55,-4,45
Admira Wacke,3796,7,11,6,19,35,62,-27,39
SV Josko Rie,3796,8,11,4,21,29,50,-21,37
St. Pölten,3796,9,9,9,18,38,58,-20,36
Mattersburg,3796,10,8,10,18,30,52,-22,34
SK Sturm Gra,3797,1,22,4,10,66,34,32,70
FC Salzburg,3797,2,20,8,8,68,35,33,68
SC Rheindorf,3797,3,20,7,9,52,40,12,67
Vienna,3797,4,20,5,11,68,49,19,65
Rapid Vienna,3797,5,11,14,11,55,39,16,47
RZ Pellets W,3797,6,12,8,16,42,55,-13,44
SV Josko Rie,3797,7,10,9,17,34,51,-17,39
St. Pölten,3797,8,9,9,18,39,66,-27,36
Admira Wacke,3797,9,9,8,19,31,60,-29,35
Mattersburg,3797,10,7,8,21,32,58,-26,29
FC Salzburg,3798,1,24,6,6,63,22,41,78
SK Sturm Gra,3798,2,20,6,10,59,31,28,66
SC Rheindorf,3798,3,19,8,9,68,47,21,65
Rapid Vienna,3798,4,16,10,10,59,39,20,58
Vienna,3798,5,17,7,12,57,46,11,58
RZ Pellets W,3798,6,14,6,16,46,52,-6,48
SV Josko Rie,3798,7,9,7,20,34,56,-22,34
Mattersburg,3798,8,9,7,20,39,63,-24,34
St. Pölten,3798,9,8,9,19,38,68,-30,33
Admira Wacke,3798,10,7,8,21,30,69,-39,29
FC Salzburg,3799,1,23,7,6,70,28,42,76
SK Sturm Gra,3799,2,22,4,10,59,33,26,70
SC Rheindorf,3799,3,18,7,11,60,48,12,61
Vienna,3799,4,17,7,12,56,48,8,58
Rapid Vienna,3799,5,14,10,12,58,43,15,52
St. Pölten,3799,6,11,8,17,49,64,-15,41
Admira Wacke,3799,7,11,7,18,37,58,-21,40
RZ Pellets W,3799,8,11,5,20,43,64,-21,38
Mattersburg,3799,9,9,8,19,38,61,-23,35
SV Josko Rie,3799,10,10,5,21,37,60,-23,35
SK Sturm Gra,3800,1,21,6,9,66,39,27,69
SC Rheindorf,3800,2,21,5,10,56,43,13,68
Vienna,3800,3,18,7,11,61,48,13,61
FC Salzburg,3800,4,17,9,10,58,35,23,60
Rapid Vienna,3800,5,12,14,10,55,40,15,50
RZ Pellets W,3800,6,14,8,14,49,48,1,50
SV Josko Rie,3800,7,11,6,19,34,53,-19,39
Admira Wacke,3800,8,11,5,20,42,64,-22,38
St. Pölten,3800,9,9,10,17,45,69,-24,37
Mattersburg,3800,10,6,10,20,34,61,-27,28
FC Salzburg,3801,1,21,9,6,72,33,39,72
SC Rheindorf,3801,2,18,11,7,50,38,12,65
Vienna,3801,3,18,4,14,62,57,5,58
SK Sturm Gra,3801,4,15,9,12,55,38,17,54
RZ Pellets W,3801,5,15,8,13,56,53,3,53
Rapid Vienna,3801,6,13,13,10,51,43,8,52
Admira Wacke,3801,7,11,5,20,38,63,-25,38
St. Pölten,3801,8,9,10,17,48,66,-18,37
SV Josko Rie,3801,9,10,6,20,38,56,-18,36
Mattersburg,3801,10,8,9,19,37,60,-23,33
Vienna,3802,1,23,5,8,69,46,23,74
FC Salzburg,3802,2,21,6,9,64,30,34,69
SK Sturm Gra,3802,3,19,4,13,59,43,16,61
SC Rheindorf,3802,4,17,8,11,52,44,8,59
Rapid Vienna,3802,5,14,11,11,63,42,21,53
RZ Pellets W,3802,6,11,7,18,43,63,-20,40
Admira Wacke,3802,7,11,7,18,35,59,-24,40
Mattersburg,3802,8,10,9,17,40,55,-15,39
SV Josko Rie,3802,9,11,5,20,40,60,-20,38
St. Pölten,3802,10,9,6,21,43,66,-23,33
FC Salzburg,3803,1,24,5,7,72,29,43,77
SK Sturm Gra,3803,2,21,7,8,65,32,33,70
SC Rheindorf,3803,3,21,7,8,52,38,14,70
Vienna,3803,4,19,4,13,64,54,10,61
RZ Pellets W,3803,5,13,8,15,41,56,-15,47
Admira Wacke,3803,6,12,6,18,37,54,-17,42
Rapid Vienna,3803,7,10,11,15,50,49,1,41
SV Josko Rie,3803,8,11,6,19,39,53,-14,39
Mattersburg,3803,9,8,7,21,40,64,-24,31
St. Pölten,3803,10,6,9,21,32,63,-31,27
FC Salzburg,3804,1,24,7,5,70,27,43,79
SC Rheindorf,3804,2,20,7,9,57,37,20,67
SK Sturm Gra,3804,3,19,4,13,56,36,20,61
Vienna,3804,4,18,6,12,62,57,5,60
Rapid Vienna,3804,5,14,9,13,53,37,16,51
RZ Pellets W,3804,6,14,7,15,45,56,-11,49
Admira Wacke,3804,7,12,7,17,41,56,-15,43
Mattersburg,3804,8,9,7,20,32,53,-21,34
SV Josko Rie,3804,9,9,5,22,31,57,-26,32
St. Pölten,3804,10,8,7,21,35,66,-31,31
FC Salzburg,3805,1,23,9,4,69,31,38,78
Vienna,3805,2,21,4,11,55,41,14,67
SC Rheindorf,3805,3,18,8,10,52,44,8,62
SK Sturm Gra,3805,4,17,8,11,56,32,24,59
Rapid Vienna,3805,5,12,11,13,52,45,7,47
RZ Pellets W,3805,6,11,9,16,45,59,-14,42
SV Josko Rie,3805,7,11,6,19,36,53,-17,39
Admira Wacke,3805,8,10,6,20,37,61,-24,36
Mattersburg,3805,9,9,8,19,37,54,-17,35
St. Pölten,3805,10,8,11,17,41,60,-19,35
FC Salzburg,3806,1,23,7,6,67,25,42,76
Vienna,3806,2,21,2,13,67,52,15,65
SK Sturm Gra,3806,3,19,7,10,55,34,21,64
SC Rheindorf,3806,4,17,11,8,53,41,12,62
Rapid Vienna,3806,5,13,11,12,54,42,12,50
RZ Pellets W,3806,6,13,4,19,46,58,-12,43
SV Josko Rie,3806,7,11,7,18,38,54,-16,40
St. Pölten,3806,8,9,10,17,44,67,-23,37
Mattersburg,3806,9,9,7,20,38,61,-23,34
Admira Wacke,3806,10,10,4,22,35,63,-28,34
FC Salzburg,3807,1,20,8,8,70,33,37,68
SK Sturm Gra,3807,2,20,7,9,55,35,20,67
Vienna,3807,3,20,5,11,63,49,14,65
SC Rheindorf,3807,4,14,11,11,50,49,1,53
Rapid Vienna,3807,5,14,10,12,53,43,10,52
RZ Pellets W,3807,6,15,7,14,55,51,4,52
SV Josko Rie,3807,7,13,6,17,37,50,-13,45
Admira Wacke,3807,8,11,7,18,42,62,-20,40
St. Pölten,3807,9,5,14,17,37,61,-24,29
Mattersburg,3807,10,6,9,21,27,56,-29,27
SC Rheindorf,3808,1,22,6,8,57,41,16,72
SK Sturm Gra,3808,2,22,5,9,59,31,28,71
FC Salzburg,3808,3,20,8,8,65,34,31,68
Vienna,3808,4,15,7,14,57,51,6,52
Rapid Vienna,3808,5,12,14,10,49,37,12,50
Admira Wacke,3808,6,13,5,18,39,61,-22,44
RZ Pellets W,3808,7,12,7,17,46,58,-12,43
Mattersburg,3808,8,10,8,18,39,52,-13,38
SV Josko Rie,3808,9,9,9,18,31,51,-20,36
St. Pölten,3808,10,7,7,22,39,65,-26,28
FC Salzburg,3809,1,20,9,7,64,33,31,69
SC Rheindorf,3809,2,21,6,9,64,48,16,69
SK Sturm Gra,3809,3,20,6,10,62,32,30,66
Rapid Vienna,3809,4,18,10,8,75,43,32,64
Vienna,3809,5,19,6,11,68,51,17,63
RZ Pellets W,3809,6,11,10,15,49,59,-10,43
SV Josko Rie,3809,7,11,7,18,39,54,-15,40
Admira Wacke,3809,8,11,5,20,34,58,-24,38
St. Pölten,3809,9,6,8,22,38,77,-39,26
Mattersburg,3809,10,6,7,23,35,73,-38,25
FC Salzburg,3810,1,21,8,7,61,27,34,71
SK Sturm Gra,3810,2,22,3,11,58,31,27,69
Vienna,3810,3,21,4,11,61,44,17,67
Rapid Vienna,3810,4,15,12,9,64,37,27,57
SC Rheindorf,3810,5,17,6,13,46,44,2,57
RZ Pellets W,3810,6,14,7,15,45,48,-3,49
Admira Wacke,3810,7,10,9,17,34,58,-24,39
SV Josko Rie,3810,8,10,5,21,28,53,-25,35
Mattersburg,3810,9,7,11,18,35,55,-20,32
St. Pölten,3810,10,7,7,22,37,72,-35,28
FC Salzburg,3811,1,23,6,7,72,29,43,75
SC Rheindorf,3811,2,22,7,7,65,39,26,73
Vienna,3811,3,18,3,15,61,55,6,57
Rapid Vienna,3811,4,15,10,11,57,39,18,55
SK Sturm Gra,3811,5,16,7,13,51,37,14,55
RZ Pellets W,3811,6,14,7,15,49,54,-5,49
Admira Wacke,3811,7,11,6,19,32,61,-29,39
St. Pölten,3811,8,9,9,18,44,70,-26,36
SV Josko Rie,3811,9,10,4,22,29,55,-26,34
Mattersburg,3811,10,7,11,18,33,54,-21,32
FC Salzburg,3812,1,19,9,8,59,30,29,66
SK Sturm Gra,3812,2,16,11,9,57,33,24,59
Vienna,3812,3,17,7,12,59,52,7,58
SC Rheindorf,3812,4,16,10,10,51,49,2,58
Rapid Vienna,3812,5,12,13,11,64,47,17,49
Admira Wacke,3812,6,13,7,16,42,56,-14,46
Mattersburg,3812,7,12,8,16,49,56,-7,44
RZ Pellets W,3812,8,11,9,16,43,54,-11,42
SV Josko Rie,3812,9,12,6,18,33,48,-15,42
St. Pölten,3812,10,5,14,17,44,76,-32,29
SK Sturm Gra,3813,1,21,6,9,62,34,28,69
FC Salzburg,3813,2,18,10,8,65,35,30,64
SC Rheindorf,3813,3,17,9,10,57,45,12,60
Vienna,3813,4,17,8,11,64,56,8,59
Rapid Vienna,3813,5,14,12,10,60,40,20,54
RZ Pellets W,3813,6,12,8,16,45,57,-12,44
Admira Wacke,3813,7,12,8,16,40,56,-16,44
Mattersburg,3813,8,11,8,17,43,58,-15,41
SV Josko Rie,3813,9,10,6,20,31,57,-26,36
St. Pölten,3813,10,6,9,21,37,66,-29,27
FC Salzburg,3814,1,20,8,8,65,34,31,68
SK Sturm Gra,3814,2,21,4,11,61,35,26,67
SC Rheindorf,3814,3,19,9,8,57,45,12,66
Vienna,3814,4,17,7,12,58,50,8,58
SV Josko Rie,3814,5,14,6,16,42,46,-4,48
Rapid Vienna,3814,6,11,11,14,46,38,8,44
Admira Wacke,3814,7,13,4,19,40,63,-23,43
RZ Pellets W,3814,8,12,6,18,47,59,-12,42
Mattersburg,3814,9,8,10,18,39,61,-22,34
St. Pölten,3814,10,8,9,19,41,65,-24,33
FC Salzburg,3815,1,20,8,8,61,33,28,68
SC Rheindorf,3815,2,19,9,8,53,39,14,66
SK Sturm Gra,3815,3,19,8,9,66,29,37,65
Vienna,3815,4,17,5,14,54,51,3,56
Rapid Vienna,3815,5,13,12,11,54,38,16,51
RZ Pellets W,3815,6,13,9,14,42,44,-2,48
SV Josko Rie,3815,7,11,7,18,35,47,-12,40
Admira Wacke,3815,8,10,7,19,35,65,-30,37
St. Pölten,3815,9,8,11,17,37,66,-29,35
Mattersburg,3815,10,7,10,19,32,57,-25,31
FC Salzburg,3816,1,21,7,8,64,34,30,70
SC Rheindorf,3816,2,18,10,8,52,38,14,64
Rapid Vienna,3816,3,17,9,10,65,40,25,60
SK Sturm Gra,3816,4,17,8,11,62,46,16,59
Vienna,3816,5,17,5,14,68,63,5,56
SV Josko Rie,3816,6,12,5,19,37,51,-14,41
RZ Pellets W,3816,7,10,10,16,47,65,-18,40
Admira Wacke,3816,8,10,8,18,40,62,-22,38
Mattersburg,3816,9,9,9,18,39,56,-17,36
St. Pölten,3816,10,9,9,18,41,60,-19,36
FC Salzburg,3817,1,22,7,7,69,30,39,73
SK Sturm Gra,3817,2,20,6,10,60,35,25,66
Vienna,3817,3,20,5,11,66,51,15,65
SC Rheindorf,3817,4,17,5,14,53,51,2,56
Admira Wacke,3817,5,15,6,15,41,53,-12,51
Rapid Vienna,3817,6,13,10,13,53,41,12,49
RZ Pellets W,3817,7,11,8,17,44,57,-13,41
St. Pölten,3817,8,10,8,18,44,66,-22,38
Mattersburg,3817,9,10,7,19,39,60,-21,37
SV Josko Rie,3817,10,9,4,23,33,58,-25,31
FC Salzburg,3818,1,23,8,5,73,29,44,77
SK Sturm Gra,3818,2,21,6,9,65,36,29,69
SC Rheindorf,3818,3,20,6,10,52,42,10,66
Vienna,3818,4,18,4,14,58,56,2,58
Rapid Vienna,3818,5,13,12,11,57,42,15,51
SV Josko Rie,3818,6,12,5,19,35,51,-16,41
Admira Wacke,3818,7,10,10,16,41,62,-21,40
St. Pölten,3818,8,8,11,17,41,60,-19,35
RZ Pellets W,3818,9,8,8,20,43,63,-20,32
Mattersburg,3818,10,8,8,20,33,57,-24,32
FC Salzburg,3819,1,20,9,7,69,34,35,69
Vienna,3819,2,19,9,8,63,46,17,66
SC Rheindorf,3819,3,19,8,9,52,38,14,65
SK Sturm Gra,3819,4,18,6,12,55,38,17,60
Rapid Vienna,3819,5,14,13,9,59,42,17,55
RZ Pellets W,3819,6,10,10,16,47,61,-14,40
SV Josko Rie,3819,7,11,6,19,32,46,-14,39
Admira Wacke,3819,8,10,5,21,38,66,-28,35
Mattersburg,3819,9,8,10,18,34,54,-20,34
St. Pölten,3819,10,8,10,18,45,69,-24,34
Vienna,3820,1,21,5,10,70,50,20,68
SC Rheindorf,3820,2,20,7,9,54,45,9,67
FC Salzburg,3820,3,19,9,8,65,33,32,66
SK Sturm Gra,3820,4,20,6,10,63,37,26,66
Rapid Vienna,3820,5,13,11,12,50,40,10,50
Admira Wacke,3820,6,15,4,17,43,58,-15,49
RZ Pellets W,3820,7,12,7,17,43,56,-13,43
St. Pölten,3820,8,9,9,18,42,61,-19,36
SV Josko Rie,3820,9,9,4,23,30,55,-25,31
Mattersburg,3820,10,7,8,21,38,63,-25,29
SC Rheindorf,3821,1,21,8,7,67,40,27,71
SK Sturm Gra,3821,2,20,6,10,62,35,27,66
FC Salzburg,3821,3,17,12,7,57,32,25,63
Vienna,3821,4,18,5,13,64,54,10,59
Rapid Vienna,3821,5,13,14,9,52,36,16,53
RZ Pellets W,3821,6,14,6,16,51,64,-13,48
St. Pölten,3821,7,9,11,16,44,65,-21,38
Admira Wacke,3821,8,10,7,19,39,63,-24,37
SV Josko Rie,3821,9,9,9,18,31,49,-18,36
Mattersburg,3821,10,5,10,21,34,63,-29,25
FC Salzburg,3822,1,21,6,9,67,33,34,69
Vienna,3822,2,20,4,12,68,51,17,64
SC Rheindorf,3822,3,19,7,10,57,45,12,64
Rapid Vienna,3822,4,17,11,8,56,31,25,62
SK Sturm Gra,3822,5,17,7,12,58,46,12,58
Admira Wacke,3822,6,14,5,17,51,62,-11,47
RZ Pellets W,3822,7,12,9,15,41,55,-14,45
SV Josko Rie,3822,8,12,6,18,36,53,-17,42
Mattersburg,3822,9,6,11,19,34,58,-24,29
St. Pölten,3822,10,5,8,23,31,65,-34,23
FC Salzburg,3823,1,21,5,10,65,36,29,68
SK Sturm Gra,3823,2,19,4,13,57,38,19,61
SC Rheindorf,3823,3,17,10,9,56,43,13,61
Rapid Vienna,3823,4,16,9,11,63,40,23,57
RZ Pellets W,3823,5,16,6,14,67,60,7,54
Vienna,3823,6,16,5,15,54,56,-2,53
Admira Wacke,3823,7,15,4,17,44,61,-17,49
Mattersburg,3823,8,10,9,17,36,55,-19,39
SV Josko Rie,3823,9,9,7,20,35,58,-23,34
St. Pölten,3823,10,7,9,20,37,67,-30,30
FC Salzburg,3824,1,21,10,5,65,26,39,73
SC Rheindorf,3824,2,21,8,7,59,39,20,71
SK Sturm Gra,3824,3,21,4,11,68,31,37,67
Rapid Vienna,3824,4,17,9,10,60,39,21,60
Vienna,3824,5,18,6,12,62,47,15,60
RZ Pellets W,3824,6,10,7,19,41,63,-22,37
St. Pölten,3824,7,10,7,19,37,64,-27,37
Admira Wacke,3824,8,10,6,20,38,73,-35,36
SV Josko Rie,3824,9,9,6,21,31,53,-22,33
Mattersburg,3824,10,8,7,21,32,58,-26,31
SC Rheindorf,3825,1,20,7,9,52,36,16,67
FC Salzburg,3825,2,19,9,8,68,32,36,66
Vienna,3825,3,19,4,13,61,53,8,61
Rapid Vienna,3825,4,16,12,8,63,40,23,60
SK Sturm Gra,3825,5,16,7,13,54,39,15,55
SV Josko Rie,3825,6,14,5,17,41,56,-15,47
St. Pölten,3825,7,11,10,15,41,55,-14,43
Admira Wacke,3825,8,12,6,18,39,60,-21,42
RZ Pellets W,3825,9,8,9,19,42,61,-19,33
Mattersburg,3825,10,7,7,22,33,62,-29,28
SC Rheindorf,3826,1,20,9,7,66,47,19,69
SK Sturm Gra,3826,2,21,5,10,61,34,27,68
FC Salzburg,3826,3,19,8,9,64,38,26,65
Vienna,3826,4,20,3,13,69,54,15,63
Rapid Vienna,3826,5,12,10,14,49,46,3,46
SV Josko Rie,3826,6,12,6,18,38,50,-12,42
Mattersburg,3826,7,10,9,17,34,50,-16,39
RZ Pellets W,3826,8,10,8,18,43,55,-12,38
Admira Wacke,3826,9,11,5,20,36,64,-28,38
St. Pölten,3826,10,7,13,16,37,59,-22,34
SC Rheindorf,3827,1,24,6,6,64,33,31,78
FC Salzburg,3827,2,20,10,6,64,31,33,70
Vienna,3827,3,20,5,11,72,58,14,65
SK Sturm Gra,3827,4,18,5,13,53,38,15,59
Rapid Vienna,3827,5,11,13,12,50,41,9,46
RZ Pellets W,3827,6,13,7,16,50,58,-8,46
SV Josko Rie,3827,7,11,3,22,35,54,-19,36
Admira Wacke,3827,8,10,6,20,34,61,-27,36
Mattersburg,3827,9,8,9,19,37,60,-23,33
St. Pölten,3827,10,7,12,17,40,65,-25,33
Vienna,3828,1,22,4,10,70,52,18,70
SC Rheindorf,3828,2,21,5,10,57,41,16,68
FC Salzburg,3828,3,20,6,10,64,36,28,66
Rapid Vienna,3828,4,16,12,8,57,36,21,60
SK Sturm Gra,3828,5,17,5,14,51,35,16,56
SV Josko Rie,3828,6,14,3,19,39,53,-14,45
RZ Pellets W,3828,7,10,9,17,44,55,-11,39
Admira Wacke,3828,8,11,6,19,34,56,-22,39
St. Pölten,3828,9,9,10,17,43,64,-21,37
Mattersburg,3828,10,5,10,21,24,55,-31,25
SK Sturm Gra,3829,1,21,6,9,60,37,23,69
SC Rheindorf,3829,2,19,6,11,54,46,8,63
Vienna,3829,3,19,5,12,69,49,20,62
FC Salzburg,3829,4,17,10,9,54,28,26,61
Rapid Vienna,3829,5,14,11,11,55,47,8,53
RZ Pellets W,3829,6,14,7,15,48,51,-3,49
Admira Wacke,3829,7,12,8,16,39,60,-21,44
Mattersburg,3829,8,10,7,19,38,55,-17,37
SV Josko Rie,3829,9,11,4,21,32,52,-20,37
St. Pölten,3829,10,7,8,21,39,63,-24,29
FC Salzburg,3830,1,21,7,8,71,32,39,70
SK Sturm Gra,3830,2,19,9,8,54,30,24,66
Vienna,3830,3,20,4,12,65,52,13,64
SC Rheindorf,3830,4,15,12,9,50,47,3,57
Rapid Vienna,3830,5,13,12,11,52,40,12,51
RZ Pellets W,3830,6,10,9,17,41,54,-13,39
SV Josko Rie,3830,7,10,8,18,31,48,-17,38
St. Pölten,3830,8,8,13,15,47,64,-17,37
Admira Wacke,3830,9,9,9,18,33,57,-24,36
Mattersburg,3830,10,8,11,17,44,64,-20,35
FC Salzburg,3831,1,23,5,8,71,37,34,74
SC Rheindorf,3831,2,22,6,8,53,31,22,72
SK Sturm Gra,3831,3,19,6,11,61,40,21,63
Vienna,3831,4,18,6,12,59,45,14,60
Rapid Vienna,3831,5,15,11,10,56,37,19,56
RZ Pellets W,3831,6,13,9,14,44,48,-4,48
SV Josko Rie,3831,7,11,5,20,36,54,-18,38
Admira Wacke,3831,8,10,7,19,36,67,-31,37
St. Pölten,3831,9,5,13,18,36,65,-29,28
Mattersburg,3831,10,6,8,22,30,58,-28,26
Vienna,3832,1,20,4,12,68,50,18,64
FC Salzburg,3832,2,18,9,9,63,35,28,63
SC Rheindorf,3832,3,19,6,11,52,42,10,63
SK Sturm Gra,3832,4,19,5,12,59,46,13,62
Rapid Vienna,3832,5,15,12,9,61,37,24,57
RZ Pellets W,3832,6,12,9,15,47,54,-7,45
Admira Wacke,3832,7,13,6,17,46,58,-12,45
SV Josko Rie,3832,8,12,5,19,38,51,-13,41
St. Pölten,3832,9,7,11,18,38,68,-30,32
Mattersburg,3832,10,7,9,20,29,60,-31,30
SK Sturm Gra,3833,1,22,6,8,64,33,31,72
FC Salzburg,3833,2,19,10,7,63,30,33,67
RZ Pellets W,3833,3,17,6,13,60,48,12,57
SC Rheindorf,3833,4,16,6,14,50,52,-2,54
Vienna,3833,5,15,6,15,60,60,0,51
Admira Wacke,3833,6,14,7,15,37,52,-15,49
Rapid Vienna,3833,7,11,11,14,54,54,0,44
SV Josko Rie,3833,8,11,8,17,40,51,-11,41
St. Pölten,3833,9,10,9,17,44,62,-18,39
Mattersburg,3833,10,6,9,21,33,63,-30,27
FC Salzburg,3834,1,20,9,7,64,27,37,69
Vienna,3834,2,20,6,10,58,42,16,66
SC Rheindorf,3834,3,18,11,7,52,35,17,65
SK Sturm Gra,3834,4,18,9,9,61,33,28,63
Rapid Vienna,3834,5,14,10,12,56,44,12,52
Mattersburg,3834,6,10,11,15,38,58,-20,41
RZ Pellets W,3834,7,9,11,16,41,56,-15,38
Admira Wacke,3834,8,11,5,20,35,62,-27,38
St. Pölten,3834,9,8,10,18,37,59,-22,34
SV Josko Rie,3834,10,6,10,20,27,53,-26,28
FC Salzburg,3835,1,20,11,5,61,31,30,71
Vienna,3835,2,21,5,10,71,45,26,68
SC Rheindorf,3835,3,18,8,10,48,37,11,62
SK Sturm Gra,3835,4,18,7,11,57,34,23,61
Rapid Vienna,3835,5,13,11,12,60,44,16,50
SV Josko Rie,3835,6,11,8,17,36,54,-18,41
RZ Pellets W,3835,7,11,7,18,42,61,-19,40
St. Pölten,3835,8,8,13,15,38,56,-18,37
Admira Wacke,3835,9,9,8,19,31,64,-33,35
Mattersburg,3835,10,9,6,21,38,56,-18,33
FC Salzburg,3836,1,22,6,8,62,28,34,72
SC Rheindorf,3836,2,20,8,8,60,41,19,68
SK Sturm Gra,3836,3,19,6,11,58,39,19,63
Vienna,3836,4,19,4,13,64,54,10,61
RZ Pellets W,3836,5,16,6,14,51,47,4,54
Rapid Vienna,3836,6,13,12,11,54,44,10,51
Admira Wacke,3836,7,12,6,18,37,56,-19,42
Mattersburg,3836,8,9,9,18,36,54,-18,36
SV Josko Rie,3836,9,9,6,21,34,51,-17,33
St. Pölten,3836,10,5,9,22,34,76,-42,24
SC Rheindorf,3837,1,23,8,5,60,32,28,77
SK Sturm Gra,3837,2,20,4,12,72,43,29,64
FC Salzburg,3837,3,18,10,8,62,33,29,64
Vienna,3837,4,17,9,10,64,48,16,60
RZ Pellets W,3837,5,14,8,14,50,54,-4,50
Rapid Vienna,3837,6,13,10,13,57,46,11,49
Admira Wacke,3837,7,11,7,18,37,64,-27,40
Mattersburg,3837,8,9,10,17,37,55,-18,37
SV Josko Rie,3837,9,9,4,23,34,59,-25,31
St. Pölten,3837,10,7,8,21,35,74,-39,29
FC Salzburg,3838,1,23,5,8,75,30,45,74
SK Sturm Gra,3838,2,19,6,11,63,41,22,63
SC Rheindorf,3838,3,18,9,9,57,53,4,63
Vienna,3838,4,19,4,13,57,54,3,61
Rapid Vienna,3838,5,13,10,13,55,41,14,49
RZ Pellets W,3838,6,12,8,16,44,55,-11,44
Mattersburg,3838,7,11,9,16,44,54,-10,42
SV Josko Rie,3838,8,12,4,20,39,51,-12,40
St. Pölten,3838,9,8,12,16,42,66,-24,36
Admira Wacke,3838,10,9,5,22,30,61,-31,32
FC Salzburg,3839,1,23,7,6,67,26,41,76
SK Sturm Gra,3839,2,18,7,11,59,39,20,61
Vienna,3839,3,18,5,13,57,52,5,59
SC Rheindorf,3839,4,17,6,13,52,47,5,57
RZ Pellets W,3839,5,13,10,13,46,51,-5,49
Rapid Vienna,3839,6,12,12,12,51,38,13,48
Admira Wacke,3839,7,12,8,16,40,55,-15,44
St. Pölten,3839,8,10,9,17,39,57,-18,39
Mattersburg,3839,9,9,10,17,37,56,-19,37
SV Josko Rie,3839,10,8,6,22,31,58,-27,30
FC Salzburg,3840,1,22,9,5,67,27,40,75
SC Rheindorf,3840,2,22,6,8,52,35,17,72
Vienna,3840,3,19,7,10,61,42,19,64
SK Sturm Gra,3840,4,19,5,12,57,38,19,62
Rapid Vienna,3840,5,14,12,10,53,40,13,54
RZ Pellets W,3840,6,10,8,18,40,54,-14,38
Admira Wacke,3840,7,9,9,18,32,60,-28,36
St. Pölten,3840,8,8,11,17,40,62,-22,35
SV Josko Rie,3840,9,9,5,22,30,52,-22,32
Mattersburg,3840,10,7,10,19,33,55,-22,31
SC Rheindorf,3841,1,21,9,6,60,38,22,72
FC Salzburg,3841,2,21,8,7,67,30,37,71
Vienna,3841,3,18,3,15,63,61,2,57
SK Sturm Gra,3841,4,17,4,15,52,42,10,55
RZ Pellets W,3841,5,15,7,14,51,56,-5,52
Rapid Vienna,3841,6,13,12,11,54,39,15,51
Admira Wacke,3841,7,13,5,18,40,57,-17,44
SV Josko Rie,3841,8,10,6,20,32,51,-19,36
Mattersburg,3841,9,9,8,19,37,52,-15,35
St. Pölten,3841,10,8,8,20,35,65,-30,32
SC Rheindorf,3842,1,22,7,7,63,41,22,73
FC Salzburg,3842,2,20,10,6,70,33,37,70
SK Sturm Gra,3842,3,19,5,12,61,38,23,62
Vienna,3842,4,15,8,13,58,58,0,53
RZ Pellets W,3842,5,14,8,14,50,53,-3,50
Rapid Vienna,3842,6,11,13,12,52,43,9,46
Admira Wacke,3842,7,12,7,17,39,59,-20,43
SV Josko Rie,3842,8,12,6,18,40,53,-13,42
St. Pölten,3842,9,7,10,19,46,73,-27,31
Mattersburg,3842,10,6,10,20,39,67,-28,28
FC Salzburg,3843,1,23,6,7,72,29,43,75
SC Rheindorf,3843,2,20,8,8,54,39,15,68
Vienna,3843,3,20,5,11,62,49,13,65
SK Sturm Gra,3843,4,18,8,10,56,34,22,62
Rapid Vienna,3843,5,15,9,12,58,41,17,54
RZ Pellets W,3843,6,13,6,17,40,52,-12,45
Admira Wacke,3843,7,10,6,20,32,63,-31,36
SV Josko Rie,3843,8,9,8,19,35,53,-18,35
Mattersburg,3843,9,8,8,20,34,61,-27,32
St. Pölten,3843,10,6,12,18,44,66,-22,30
FC Salzburg,3844,1,24,8,4,70,24,46,80
SC Rheindorf,3844,2,19,9,8,51,37,14,66
Vienna,3844,3,20,3,13,62,48,14,63
Rapid Vienna,3844,4,14,11,11,48,35,13,53
SK Sturm Gra,3844,5,15,7,14,52,42,10,52
Admira Wacke,3844,6,13,8,15,38,54,-16,47
Mattersburg,3844,7,10,10,16,38,52,-14,40
RZ Pellets W,3844,8,8,12,16,42,57,-15,36
St. Pölten,3844,9,9,9,18,43,63,-20,36
SV Josko Rie,3844,10,7,5,24,31,63,-32,26
FC Salzburg,3845,1,23,5,8,70,29,41,74
SC Rheindorf,3845,2,20,7,9,51,37,14,67
SK Sturm Gra,3845,3,19,7,10,58,35,23,64
Rapid Vienna,3845,4,16,9,11,53,37,16,57
Vienna,3845,5,16,8,12,60,59,1,56
Admira Wacke,3845,6,14,4,18,42,58,-16,46
St. Pölten,3845,7,12,6,18,43,62,-19,42
SV Josko Rie,3845,8,11,5,20,39,55,-16,38
RZ Pellets W,3845,9,10,5,21,44,66,-22,35
Mattersburg,3845,10,7,8,21,32,54,-22,29
FC Salzburg,3846,1,22,8,6,68,28,40,74
SK Sturm Gra,3846,2,20,7,9,63,36,27,67
Vienna,3846,3,21,3,12,66,49,17,66
SC Rheindorf,3846,4,19,8,9,59,42,17,65
Rapid Vienna,3846,5,15,10,11,60,40,20,55
RZ Pellets W,3846,6,14,4,18,49,57,-8,46
SV Josko Rie,3846,7,11,5,20,37,63,-26,38
Admira Wacke,3846,8,11,5,20,39,75,-36,38
St. Pölten,3846,9,7,9,20,41,71,-30,30
Mattersburg,3846,10,6,9,21,39,60,-21,27
Vienna,3847,1,19,7,10,68,49,19,64
FC Salzburg,3847,2,18,8,10,57,31,26,62
SC Rheindorf,3847,3,17,8,11,56,52,4,59
SK Sturm Gra,3847,4,17,5,14,49,35,14,56
Rapid Vienna,3847,5,13,13,10,56,41,15,52
RZ Pellets W,3847,6,13,5,18,45,59,-14,44
Admira Wacke,3847,7,13,5,18,40,58,-18,44
SV Josko Rie,3847,8,11,8,17,37,50,-13,41
St. Pölten,3847,9,10,10,16,37,55,-18,40
Mattersburg,3847,10,10,9,17,35,50,-15,39
FC Salzburg,3848,1,21,10,5,63,30,33,73
Vienna,3848,2,22,5,9,66,44,22,71
SC Rheindorf,3848,3,21,6,9,54,36,18,69
SK Sturm Gra,3848,4,18,9,9,58,35,23,63
RZ Pellets W,3848,5,12,7,17,45,54,-9,43
Rapid Vienna,3848,6,11,9,16,51,49,2,42
SV Josko Rie,3848,7,11,6,19,32,52,-20,39
Admira Wacke,3848,8,11,6,19,36,61,-25,39
St. Pölten,3848,9,8,8,20,41,61,-20,32
Mattersburg,3848,10,8,8,20,37,61,-24,32
FC Salzburg,3849,1,21,5,10,69,36,33,68
SC Rheindorf,3849,2,20,8,8,62,44,18,68
Vienna,3849,3,19,5,12,66,53,13,62
SK Sturm Gra,3849,4,17,7,12,58,40,18,58
Rapid Vienna,3849,5,16,8,12,57,42,15,56
Admira Wacke,3849,6,15,6,15,39,53,-14,51
St. Pölten,3849,7,10,9,17,41,65,-24,39
SV Josko Rie,3849,8,11,4,21,41,57,-16,37
RZ Pellets W,3849,9,9,7,20,43,64,-21,34
Mattersburg,3849,10,9,7,20,39,61,-22,34
SK Sturm Gra,3850,1,19,8,9,59,32,27,65
Vienna,3850,2,20,5,11,70,49,21,65
FC Salzburg,3850,3,20,4,12,64,40,24,64
SC Rheindorf,3850,4,18,9,9,55,41,14,63
RZ Pellets W,3850,5,16,6,14,58,57,1,54
Rapid Vienna,3850,6,14,10,12,58,42,16,52
St. Pölten,3850,7,11,8,17,42,62,-20,41
Mattersburg,3850,8,10,8,18,39,56,-17,38
SV Josko Rie,3850,9,8,7,21,29,58,-29,31
Admira Wacke,3850,10,8,7,21,29,66,-37,31
FC Salzburg,3851,1,21,8,7,60,28,32,71
Rapid Vienna,3851,2,19,8,9,69,39,30,65
Vienna,3851,3,19,6,11,68,52,16,63
SC Rheindorf,3851,4,17,9,10,56,45,11,60
SK Sturm Gra,3851,5,16,7,13,52,37,15,55
Admira Wacke,3851,6,14,4,18,36,52,-16,46
RZ Pellets W,3851,7,11,9,16,47,56,-9,42
SV Josko Rie,3851,8,10,9,17,31,51,-20,39
St. Pölten,3851,9,8,9,19,39,66,-27,33
Mattersburg,3851,10,7,7,22,31,63,-32,28
FC Salzburg,3852,1,23,7,6,65,30,35,76
SK Sturm Gra,3852,2,19,7,10,63,36,27,64
SC Rheindorf,3852,3,19,7,10,58,48,10,64
Vienna,3852,4,19,3,14,61,53,8,60
Rapid Vienna,3852,5,16,8,12,53,40,13,56
St. Pölten,3852,6,11,10,15,46,60,-14,43
Mattersburg,3852,7,9,11,16,36,49,-13,38
RZ Pellets W,3852,8,10,6,20,40,57,-17,36
Admira Wacke,3852,9,9,8,19,38,65,-27,35
SV Josko Rie,3852,10,10,3,23,35,57,-22,33
FC Salzburg,3853,1,18,11,7,58,29,29,65
SK Sturm Gra,3853,2,19,8,9,66,38,28,65
SC Rheindorf,3853,3,18,8,10,52,41,11,62
Vienna,3853,4,15,10,11,59,56,3,55
Rapid Vienna,3853,5,13,12,11,62,46,16,51
SV Josko Rie,3853,6,13,7,16,40,48,-8,46
RZ Pellets W,3853,7,12,8,16,45,54,-9,44
Admira Wacke,3853,8,12,6,18,38,65,-27,42
St. Pölten,3853,9,9,9,18,44,63,-19,36
Mattersburg,3853,10,6,11,19,29,53,-24,29
SK Sturm Gra,3854,1,22,5,9,65,32,33,71
SC Rheindorf,3854,2,22,5,9,59,44,15,71
FC Salzburg,3854,3,21,5,10,73,36,37,68
Rapid Vienna,3854,4,16,10,10,52,36,16,58
Vienna,3854,5,17,4,15,64,63,1,55
RZ Pellets W,3854,6,12,11,13,54,54,0,47
Admira Wacke,3854,7,12,7,17,39,62,-23,43
Mattersburg,3854,8,8,9,19,40,60,-20,33
St. Pölten,3854,9,8,8,20,42,68,-26,32
SV Josko Rie,3854,10,8,4,24,35,68,-33,28
SC Rheindorf,3855,1,23,5,8,60,37,23,74
FC Salzburg,3855,2,20,10,6,67,25,42,70
SK Sturm Gra,3855,3,21,6,9,67,34,33,69
Vienna,3855,4,17,7,12,56,48,8,58
Rapid Vienna,3855,5,12,11,13,53,47,6,47
Admira Wacke,3855,6,13,5,18,38,61,-23,44
RZ Pellets W,3855,7,11,7,18,44,61,-17,40
Mattersburg,3855,8,8,11,17,36,54,-18,35
SV Josko Rie,3855,9,9,6,21,30,57,-27,33
St. Pölten,3855,10,8,8,20,41,68,-27,32
FC Salzburg,3856,1,22,8,6,64,23,41,74
SC Rheindorf,3856,2,21,7,8,61,43,18,70
Vienna,3856,3,18,6,12,59,47,12,60
Rapid Vienna,3856,4,15,11,10,55,38,17,56
SK Sturm Gra,3856,5,16,7,13,52,38,14,55
Admira Wacke,3856,6,13,5,18,39,59,-20,44
RZ Pellets W,3856,7,11,8,17,47,62,-15,41
St. Pölten,3856,8,10,9,17,42,60,-18,39
SV Josko Rie,3856,9,10,5,21,31,55,-24,35
Mattersburg,3856,10,7,8,21,34,59,-25,29
FC Salzburg,3857,1,21,8,7,71,34,37,71
Vienna,3857,2,20,4,12,66,53,13,64
SK Sturm Gra,3857,3,18,7,11,67,39,28,61
SC Rheindorf,3857,4,17,10,9,46,43,3,61
Rapid Vienna,3857,5,12,14,10,52,43,9,50
RZ Pellets W,3857,6,14,6,16,54,52,2,48
Mattersburg,3857,7,10,9,17,40,54,-14,39
St. Pölten,3857,8,9,10,17,44,68,-24,37
Admira Wacke,3857,9,11,4,21,31,62,-31,37
SV Josko Rie,3857,10,7,10,19,29,52,-23,31
FC Salzburg,3858,1,20,8,8,63,29,34,68
SC Rheindorf,3858,2,19,7,10,55,40,15,64
Vienna,3858,3,18,7,11,71,55,16,61
SK Sturm Gra,3858,4,18,7,11,57,44,13,61
RZ Pellets W,3858,5,15,6,15,45,52,-7,51
Rapid Vienna,3858,6,12,10,14,52,43,9,46
SV Josko Rie,3858,7,12,6,18,38,52,-14,42
Admira Wacke,3858,8,11,7,18,35,63,-28,40
St. Pölten,3858,9,9,10,17,37,54,-17,37
Mattersburg,3858,10,7,10,19,30,51,-21,31
FC Salzburg,3859,1,20,9,7,71,36,35,69
Vienna,3859,2,20,6,10,69,46,23,66
SC Rheindorf,3859,3,19,9,8,55,42,13,66
SK Sturm Gra,3859,4,19,6,11,59,31,28,63
Rapid Vienna,3859,5,12,11,13,53,46,7,47
SV Josko Rie,3859,6,13,6,17,44,48,-4,45
RZ Pellets W,3859,7,10,10,16,38,57,-19,40
Admira Wacke,3859,8,10,8,18,32,68,-36,38
St. Pölten,3859,9,9,9,18,40,63,-23,36
Mattersburg,3859,10,7,8,21,33,57,-24,29
SK Sturm Gra,3860,1,21,5,10,62,32,30,68
SC Rheindorf,3860,2,20,8,8,51,38,13,68
FC Salzburg,3860,3,20,6,10,63,32,31,66
Vienna,3860,4,17,8,11,58,49,9,59
Admira Wacke,3860,5,16,5,15,48,50,-2,53
Rapid Vienna,3860,6,13,11,12,57,42,15,50
RZ Pellets W,3860,7,13,6,17,42,54,-12,45
SV Josko Rie,3860,8,13,5,18,35,54,-19,44
St. Pölten,3860,9,6,10,20,35,66,-31,28
Mattersburg,3860,10,6,6,24,32,66,-34,24
SC Rheindorf,3861,1,22,7,7,57,41,16,73
Vienna,3861,2,21,5,10,72,49,23,68
FC Salzburg,3861,3,20,7,9,65,30,35,67
SK Sturm Gra,3861,4,18,5,13,56,36,20,59
Rapid Vienna,3861,5,15,10,11,49,38,11,55
RZ Pellets W,3861,6,13,6,17,42,58,-16,45
St. Pölten,3861,7,10,8,18,44,64,-20,38
Admira Wacke,3861,8,9,9,18,36,58,-22,36
SV Josko Rie,3861,9,9,7,20,28,51,-23,34
Mattersburg,3861,10,6,10,20,34,58,-24,28
SC Rheindorf,3862,1,22,6,8,56,35,21,72
FC Salzburg,3862,2,20,8,8,66,31,35,68
SK Sturm Gra,3862,3,19,6,11,60,33,27,63
Vienna,3862,4,19,4,13,69,57,12,61
Rapid Vienna,3862,5,13,12,11,58,45,13,51
Admira Wacke,3862,6,14,7,15,36,51,-15,49
SV Josko Rie,3862,7,11,6,19,38,55,-17,39
RZ Pellets W,3862,8,10,8,18,41,57,-16,38
St. Pölten,3862,9,8,9,19,37,62,-25,33
Mattersburg,3862,10,7,8,21,30,65,-35,29
FC Salzburg,3863,1,19,10,7,65,35,30,67
SK Sturm Gra,3863,2,21,3,12,65,34,31,66
Vienna,3863,3,19,6,11,62,49,13,63
SC Rheindorf,3863,4,16,11,9,50,45,5,59
RZ Pellets W,3863,5,14,7,15,44,48,-4,49
Rapid Vienna,3863,6,12,11,13,48,41,7,47
Admira Wacke,3863,7,12,6,18,39,58,-19,42
SV Josko Rie,3863,8,11,7,18,37,54,-17,40
Mattersburg,3863,9,9,9,18,38,57,-19,36
St. Pölten,3863,10,7,10,19,39,66,-27,31
SK Sturm Gra,3864,1,22,6,8,63,27,36,72
FC Salzburg,3864,2,20,10,6,60,26,34,70
SC Rheindorf,3864,3,19,10,7,57,39,18,67
Vienna,3864,4,16,5,15,56,51,5,53
Rapid Vienna,3864,5,14,10,12,63,47,16,52
RZ Pellets W,3864,6,12,8,16,45,53,-8,44
Admira Wacke,3864,7,12,5,19,34,62,-28,41
Mattersburg,3864,8,10,7,19,34,53,-19,37
SV Josko Rie,3864,9,10,6,20,32,53,-21,36
St. Pölten,3864,10,7,9,20,34,67,-33,30
FC Salzburg,3865,1,23,5,8,81,33,48,74
Vienna,3865,2,20,7,9,60,46,14,67
SK Sturm Gra,3865,3,16,9,11,58,35,23,57
Rapid Vienna,3865,4,14,11,11,59,45,14,53
SC Rheindorf,3865,5,14,9,13,49,56,-7,51
RZ Pellets W,3865,6,14,7,15,45,50,-5,49
Admira Wacke,3865,7,12,5,19,35,62,-27,41
St. Pölten,3865,8,10,9,17,43,61,-18,39
Mattersburg,3865,9,9,10,17,37,54,-17,37
SV Josko Rie,3865,10,10,4,22,37,62,-25,34
FC Salzburg,3866,1,23,7,6,70,25,45,76
Vienna,3866,2,21,6,9,63,47,16,69
SC Rheindorf,3866,3,20,5,11,53,41,12,65
SK Sturm Gra,3866,4,18,5,13,53,35,18,59
Rapid Vienna,3866,5,16,10,10,64,45,19,58
RZ Pellets W,3866,6,14,5,17,51,57,-6,47
SV Josko Rie,3866,7,14,4,18,35,48,-13,46
Admira Wacke,3866,8,8,7,21,33,62,-29,31
St. Pölten,3866,9,7,8,21,35,67,-32,29
Mattersburg,3866,10,7,7,22,34,64,-30,28
FC Salzburg,3867,1,21,6,9,66,31,35,69
SC Rheindorf,3867,2,20,8,8,58,36,22,68
SK Sturm Gra,3867,3,20,7,9,61,32,29,67
Vienna,3867,4,19,8,9,63,46,17,65
Rapid Vienna,3867,5,13,11,12,51,41,10,50
RZ Pellets W,3867,6,14,8,14,53,56,-3,50
Admira Wacke,3867,7,12,7,17,42,60,-18,43
SV Josko Rie,3867,8,10,6,20,40,58,-18,36
Mattersburg,3867,9,6,11,19,32,64,-32,29
St. Pölten,3867,10,4,10,22,28,70,-42,22
FC Salzburg,3868,1,21,7,8,75,33,42,70
SC Rheindorf,3868,2,19,8,9,54,37,17,65
SK Sturm Gra,3868,3,20,4,12,62,41,21,64
Vienna,3868,4,18,5,13,59,50,9,59
Rapid Vienna,3868,5,14,11,11,55,45,10,53
RZ Pellets W,3868,6,13,8,15,46,50,-4,47
Admira Wacke,3868,7,11,9,16,41,62,-21,42
SV Josko Rie,3868,8,10,6,20,31,56,-25,36
St. Pölten,3868,9,7,11,18,43,68,-25,32
Mattersburg,3868,10,6,13,17,33,57,-24,31
FC Salzburg,3869,1,20,10,6,70,30,40,70
SK Sturm Gra,3869,2,19,5,12,55,39,16,62
Rapid Vienna,3869,3,16,12,8,63,37,26,60
SC Rheindorf,3869,4,18,6,12,51,44,7,60
Vienna,3869,5,15,5,16,53,63,-10,50
Mattersburg,3869,6,13,9,14,42,49,-7,48
RZ Pellets W,3869,7,11,9,16,44,54,-10,42
Admira Wacke,3869,8,10,9,17,39,61,-22,39
SV Josko Rie,3869,9,10,7,19,37,53,-16,37
St. Pölten,3869,10,7,10,19,41,65,-24,31
SC Rheindorf,3870,1,22,7,7,63,36,27,73
FC Salzburg,3870,2,20,9,7,60,29,31,69
Vienna,3870,3,20,5,11,67,51,16,65
SK Sturm Gra,3870,4,17,9,10,53,31,22,60
Rapid Vienna,3870,5,13,10,13,54,42,12,49
RZ Pellets W,3870,6,12,7,17,49,61,-12,43
Admira Wacke,3870,7,12,6,18,37,60,-23,42
St. Pölten,3870,8,9,10,17,36,57,-21,37
Mattersburg,3870,9,8,9,19,35,60,-25,33
SV Josko Rie,3870,10,9,4,23,26,53,-27,31
SK Sturm Gra,3871,1,20,8,8,61,30,31,68
FC Salzburg,3871,2,20,8,8,68,39,29,68
SC Rheindorf,3871,3,20,7,9,66,47,19,67
Rapid Vienna,3871,4,15,12,9,57,42,15,57
Vienna,3871,5,17,6,13,58,51,7,57
RZ Pellets W,3871,6,12,9,15,48,57,-9,45
Admira Wacke,3871,7,11,8,17,34,56,-22,41
SV Josko Rie,3871,8,10,7,19,35,55,-20,37
St. Pölten,3871,9,7,9,20,39,63,-24,30
Mattersburg,3871,10,8,6,22,42,68,-26,30
FC Salzburg,3872,1,22,8,6,70,30,40,74
SK Sturm Gra,3872,2,18,9,9,55,31,24,63
SC Rheindorf,3872,3,17,11,8,45,36,9,62
Vienna,3872,4,17,7,12,64,54,10,58
Rapid Vienna,3872,5,12,13,11,50,38,12,49
RZ Pellets W,3872,6,13,7,16,45,54,-9,46
Admira Wacke,3872,7,11,8,17,38,58,-20,41
St. Pölten,3872,8,8,13,15,37,58,-21,37
Mattersburg,3872,9,8,8,20,35,57,-22,32
SV Josko Rie,3872,10,7,10,19,32,55,-23,31
FC Salzburg,3873,1,22,6,8,64,34,30,72
SK Sturm Gra,3873,2,20,8,8,62,31,31,68
SC Rheindorf,3873,3,17,8,11,54,44,10,59
Vienna,3873,4,17,6,13,61,50,11,57
Rapid Vienna,3873,5,15,9,12,52,36,16,54
RZ Pellets W,3873,6,14,6,16,50,54,-4,48
SV Josko Rie,3873,7,14,4,18,39,51,-12,46
Mattersburg,3873,8,10,8,18,37,55,-18,38
Admira Wacke,3873,9,9,7,20,33,60,-27,34
St. Pölten,3873,10,6,10,20,38,75,-37,28
FC Salzburg,3874,1,19,8,9,62,34,28,65
SK Sturm Gra,3874,2,19,8,9,58,32,26,65
Vienna,3874,3,20,5,11,64,48,16,65
SC Rheindorf,3874,4,17,9,10,57,49,8,60
Rapid Vienna,3874,5,15,10,11,58,39,19,55
Mattersburg,3874,6,13,9,14,49,57,-8,48
SV Josko Rie,3874,7,11,7,18,41,56,-15,40
RZ Pellets W,3874,8,10,8,18,41,60,-19,38
Admira Wacke,3874,9,8,9,19,33,62,-29,33
St. Pölten,3874,10,7,9,20,39,65,-26,30
SK Sturm Gra,3875,1,20,7,9,68,37,31,67
SC Rheindorf,3875,2,20,7,9,56,43,13,67
FC Salzburg,3875,3,18,9,9,64,34,30,63
Vienna,3875,4,16,6,14,65,52,13,54
RZ Pellets W,3875,5,15,7,14,50,55,-5,52
Rapid Vienna,3875,6,12,11,13,61,57,4,47
Admira Wacke,3875,7,12,7,17,35,59,-24,43
St. Pölten,3875,8,9,10,17,41,62,-21,37
SV Josko Rie,3875,9,10,6,20,36,54,-18,36
Mattersburg,3875,10,9,8,19,36,59,-23,35
SC Rheindorf,3876,1,23,6,7,62,35,27,75
FC Salzburg,3876,2,22,6,8,65,32,33,72
Vienna,3876,3,21,4,11,68,55,13,67
Rapid Vienna,3876,4,16,8,12,52,40,12,56
SK Sturm Gra,3876,5,16,7,13,59,43,16,55
RZ Pellets W,3876,6,14,7,15,48,49,-1,49
Admira Wacke,3876,7,11,5,20,40,64,-24,38
SV Josko Rie,3876,8,9,7,20,37,57,-20,34
Mattersburg,3876,9,9,7,20,35,57,-22,34
St. Pölten,3876,10,6,9,21,36,70,-34,27
FC Salzburg,3877,1,21,8,7,66,33,33,71
SC Rheindorf,3877,2,21,7,8,60,40,20,70
SK Sturm Gra,3877,3,16,8,12,52,33,19,56
Rapid Vienna,3877,4,15,10,11,55,39,16,55
Vienna,3877,5,17,4,15,62,54,8,55
Admira Wacke,3877,6,15,5,16,44,54,-10,50
RZ Pellets W,3877,7,9,11,16,41,64,-23,38
Mattersburg,3877,8,9,9,18,35,53,-18,36
SV Josko Rie,3877,9,9,8,19,27,48,-21,35
St. Pölten,3877,10,8,10,18,35,59,-24,34
Vienna,3878,1,22,4,10,69,45,24,70
SK Sturm Gra,3878,2,20,8,8,59,30,29,68
FC Salzburg,3878,3,19,8,9,67,36,31,65
SC Rheindorf,3878,4,16,7,13,52,51,1,55
Rapid Vienna,3878,5,13,12,11,58,39,19,51
RZ Pellets W,3878,6,12,7,17,47,61,-14,43
Admira Wacke,3878,7,10,9,17,40,60,-20,39
SV Josko Rie,3878,8,11,6,19,35,57,-22,39
St. Pölten,3878,9,9,10,17,47,66,-19,37
Mattersburg,3878,10,7,11,18,33,62,-29,32
FC Salzburg,3879,1,21,8,7,67,32,35,71
SK Sturm Gra,3879,2,20,7,9,63,35,28,67
SC Rheindorf,3879,3,19,7,10,61,49,12,64
Rapid Vienna,3879,4,16,9,11,63,43,20,57
Vienna,3879,5,17,3,16,62,62,0,54
St. Pölten,3879,6,12,9,15,51,63,-12,45
RZ Pellets W,3879,7,10,10,16,42,56,-14,40
SV Josko Rie,3879,8,11,5,20,33,57,-24,38
Admira Wacke,3879,9,9,8,19,37,62,-25,35
Mattersburg,3879,10,6,12,18,35,55,-20,30
FC Salzburg,3880,1,22,6,8,66,34,32,72
SC Rheindorf,3880,2,21,7,8,58,40,18,70
Vienna,3880,3,20,3,13,60,50,10,63
SK Sturm Gra,3880,4,17,8,11,57,32,25,59
Rapid Vienna,3880,5,12,12,12,55,47,8,48
RZ Pellets W,3880,6,12,8,16,47,58,-11,44
Admira Wacke,3880,7,11,10,15,44,58,-14,43
SV Josko Rie,3880,8,10,5,21,32,51,-19,35
Mattersburg,3880,9,8,10,18,31,53,-22,34
St. Pölten,3880,10,8,9,19,40,67,-27,33
FC Salzburg,3881,1,22,7,7,67,29,38,73
SC Rheindorf,3881,2,21,8,7,64,44,20,71
Vienna,3881,3,20,5,11,58,46,12,65
SK Sturm Gra,3881,4,18,8,10,63,39,24,62
Rapid Vienna,3881,5,12,10,14,48,42,6,46
Admira Wacke,3881,6,11,9,16,33,60,-27,42
RZ Pellets W,3881,7,10,8,18,41,55,-14,38
St. Pölten,3881,8,10,8,18,40,58,-18,38
SV Josko Rie,3881,9,10,4,22,30,53,-23,34
Mattersburg,3881,10,7,11,18,36,54,-18,32
FC Salzburg,3882,1,24,5,7,70,35,35,77
SC Rheindorf,3882,2,21,6,9,63,43,20,69
Vienna,3882,3,20,4,12,67,53,14,64
SK Sturm Gra,3882,4,17,6,13,56,40,16,57
RZ Pellets W,3882,5,16,6,14,49,50,-1,54
Rapid Vienna,3882,6,13,9,14,57,44,13,48
SV Josko Rie,3882,7,11,6,19,32,47,-15,39
Mattersburg,3882,8,9,7,20,41,62,-21,34
Admira Wacke,3882,9,9,6,21,37,70,-33,33
St. Pölten,3882,10,7,11,18,41,69,-28,32
FC Salzburg,3883,1,20,11,5,67,30,37,71
SK Sturm Gra,3883,2,20,4,12,62,38,24,64
SC Rheindorf,3883,3,17,10,9,55,46,9,61
Rapid Vienna,3883,4,15,11,10,52,34,18,56
Vienna,3883,5,16,5,15,58,51,7,53
RZ Pellets W,3883,6,13,8,15,49,56,-7,47
SV Josko Rie,3883,7,14,4,18,42,55,-13,46
Admira Wacke,3883,8,12,5,19,36,60,-24,41
St. Pölten,3883,9,7,13,16,44,68,-24,34
Mattersburg,3883,10,6,9,21,35,62,-27,27
FC Salzburg,3884,1,21,8,7,71,32,39,71
SK Sturm Gra,3884,2,19,6,11,59,35,24,63
SC Rheindorf,3884,3,18,8,10,59,48,11,62
Vienna,3884,4,18,3,15,62,58,4,57
RZ Pellets W,3884,5,15,8,13,52,50,2,53
Rapid Vienna,3884,6,11,15,10,49,40,9,48
Mattersburg,3884,7,11,7,18,47,60,-13,40
Admira Wacke,3884,8,11,6,19,33,63,-30,39
SV Josko Rie,3884,9,10,7,19,35,58,-23,37
St. Pölten,3884,10,8,8,20,44,67,-23,32
FC Salzburg,3885,1,22,6,8,66,31,35,72
SC Rheindorf,3885,2,19,8,9,59,44,15,65
SK Sturm Gra,3885,3,17,9,10,62,39,23,60
Vienna,3885,4,18,5,13,60,49,11,59
Rapid Vienna,3885,5,15,11,10,59,39,20,56
RZ Pellets W,3885,6,12,10,14,40,49,-9,46
Admira Wacke,3885,7,13,7,16,39,56,-17,46
SV Josko Rie,3885,8,12,5,19,38,53,-15,41
St. Pölten,3885,9,8,7,21,40,77,-37,31
Mattersburg,3885,10,7,6,23,36,62,-26,27
FC Salzburg,3886,1,23,7,6,69,31,38,76
SK Sturm Gra,3886,2,21,7,8,63,32,31,70
SC Rheindorf,3886,3,18,8,10,51,39,12,62
Vienna,3886,4,17,6,13,61,54,7,57
Rapid Vienna,3886,5,12,10,14,47,42,5,46
RZ Pellets W,3886,6,12,8,16,50,57,-7,44
Mattersburg,3886,7,11,6,19,38,58,-20,39
SV Josko Rie,3886,8,11,5,20,38,55,-17,38
Admira Wacke,3886,9,10,8,18,35,60,-25,38
St. Pölten,3886,10,9,7,20,42,66,-24,34
Vienna,3887,1,21,7,8,73,49,24,70
FC Salzburg,3887,2,19,7,10,59,32,27,64
SK Sturm Gra,3887,3,18,6,12,53,41,12,60
SC Rheindorf,3887,4,15,11,10,49,44,5,56
Rapid Vienna,3887,5,12,15,9,56,43,13,51
Admira Wacke,3887,6,14,7,15,41,51,-10,49
RZ Pellets W,3887,7,11,9,16,44,57,-13,42
SV Josko Rie,3887,8,9,8,19,34,53,-19,35
Mattersburg,3887,9,7,12,17,42,61,-19,33
St. Pölten,3887,10,7,12,17,42,62,-20,33
FC Salzburg,3888,1,20,8,8,64,35,29,68
SC Rheindorf,3888,2,18,11,7,59,42,17,65
SK Sturm Gra,3888,3,19,5,12,57,37,20,62
Vienna,3888,4,18,6,12,64,49,15,60
Rapid Vienna,3888,5,15,12,9,54,35,19,57
Admira Wacke,3888,6,14,6,16,33,49,-16,48
RZ Pellets W,3888,7,13,7,16,41,59,-18,46
Mattersburg,3888,8,8,9,19,37,55,-18,33
SV Josko Rie,3888,9,9,6,21,33,54,-21,33
St. Pölten,3888,10,6,10,20,40,67,-27,28
FC Salzburg,3889,1,20,10,6,70,31,39,70
SK Sturm Gra,3889,2,20,5,11,60,37,23,65
Vienna,3889,3,19,7,10,65,44,21,64
Rapid Vienna,3889,4,16,11,9,64,40,24,59
SC Rheindorf,3889,5,16,9,11,53,53,0,57
Admira Wacke,3889,6,14,6,16,43,57,-14,48
St. Pölten,3889,7,12,9,15,46,59,-13,45
RZ Pellets W,3889,8,9,7,20,41,70,-29,34
SV Josko Rie,3889,9,8,9,19,31,53,-22,33
Mattersburg,3889,10,4,11,21,29,58,-29,23
FC Salzburg,3890,1,24,6,6,75,32,43,78
SC Rheindorf,3890,2,22,7,7,60,38,22,73
SK Sturm Gra,3890,3,18,11,7,62,31,31,65
Vienna,3890,4,15,7,14,63,56,7,52
Rapid Vienna,3890,5,13,11,12,56,48,8,50
RZ Pellets W,3890,6,14,8,14,44,50,-6,50
Mattersburg,3890,7,9,10,17,40,56,-16,37
Admira Wacke,3890,8,9,9,18,38,64,-26,36
St. Pölten,3890,9,8,8,20,46,75,-29,32
SV Josko Rie,3890,10,7,5,24,24,58,-34,26
FC Salzburg,3891,1,23,7,6,69,28,41,76
SK Sturm Gra,3891,2,22,4,10,62,34,28,70
SC Rheindorf,3891,3,19,7,10,60,50,10,64
Rapid Vienna,3891,4,14,11,11,61,49,12,53
Vienna,3891,5,16,5,15,59,54,5,53
RZ Pellets W,3891,6,14,9,13,54,55,-1,51
Admira Wacke,3891,7,11,7,18,36,60,-24,40
St. Pölten,3891,8,8,11,17,53,73,-20,35
SV Josko Rie,3891,9,9,5,22,34,60,-26,32
Mattersburg,3891,10,7,8,21,32,57,-25,29
FC Salzburg,3892,1,20,10,6,58,28,30,70
SC Rheindorf,3892,2,21,5,10,54,40,14,68
Vienna,3892,3,20,5,11,62,48,14,65
SK Sturm Gra,3892,4,18,7,11,60,35,25,61
Rapid Vienna,3892,5,13,10,13,47,39,8,49
RZ Pellets W,3892,6,14,6,16,50,55,-5,48
Admira Wacke,3892,7,13,5,18,40,61,-21,44
SV Josko Rie,3892,8,10,7,19,35,49,-14,37
St. Pölten,3892,9,7,11,18,40,66,-26,32
Mattersburg,3892,10,7,8,21,33,58,-25,29
FC Salzburg,3893,1,22,8,6,70,24,46,74
SK Sturm Gra,3893,2,21,6,9,58,31,27,69
SC Rheindorf,3893,3,20,8,8,62,42,20,68
Rapid Vienna,3893,4,14,10,12,56,42,14,52
Vienna,3893,5,14,9,13,51,54,-3,51
Admira Wacke,3893,6,12,9,15,42,55,-13,45
RZ Pellets W,3893,7,10,7,19,45,66,-21,37
St. Pölten,3893,8,9,10,17,37,60,-23,37
SV Josko Rie,3893,9,9,6,21,36,63,-27,33
Mattersburg,3893,10,7,11,18,33,53,-20,32
FC Salzburg,3894,1,23,6,7,67,34,33,75
Vienna,3894,2,21,4,11,70,54,16,67
SC Rheindorf,3894,3,19,8,9,53,35,18,65
SK Sturm Gra,3894,4,18,4,14,56,39,17,58
Rapid Vienna,3894,5,13,12,11,54,39,15,51
SV Josko Rie,3894,6,15,4,17,41,50,-9,49
RZ Pellets W,3894,7,12,7,17,46,59,-13,43
Admira Wacke,3894,8,9,8,19,37,63,-26,35
Mattersburg,3894,9,8,9,19,41,61,-20,33
St. Pölten,3894,10,8,6,22,45,76,-31,30
SC Rheindorf,3895,1,21,5,10,62,40,22,68
FC Salzburg,3895,2,20,6,10,66,39,27,66
SK Sturm Gra,3895,3,18,9,9,60,36,24,63
Rapid Vienna,3895,4,16,11,9,58,39,19,59
Vienna,3895,5,17,7,12,59,53,6,58
RZ Pellets W,3895,6,11,9,16,45,60,-15,42
Mattersburg,3895,7,11,7,18,37,51,-14,40
Admira Wacke,3895,8,10,8,18,34,55,-21,38
St. Pölten,3895,9,9,8,19,38,61,-23,35
SV Josko Rie,3895,10,10,4,22,33,58,-25,34
FC Salzburg,3896,1,22,5,9,65,31,34,71
SC Rheindorf,3896,2,21,7,8,54,39,15,70
SK Sturm Gra,3896,3,20,7,9,63,28,35,67
Vienna,3896,4,21,4,11,61,48,13,67
Rapid Vienna,3896,5,13,11,12,53,41,12,50
RZ Pellets W,3896,6,13,6,17,48,67,-19,45
St. Pölten,3896,7,9,11,16,41,60,-19,38
SV Josko Rie,3896,8,10,6,20,33,50,-17,36
Admira Wacke,3896,9,9,8,19,41,62,-21,35
Mattersburg,3896,10,6,7,23,36,69,-33,25
SC Rheindorf,3897,1,22,7,7,62,37,25,73
Vienna,3897,2,21,4,11,64,52,12,67
FC Salzburg,3897,3,19,9,8,60,30,30,66
SK Sturm Gra,3897,4,19,6,11,52,32,20,63
RZ Pellets W,3897,5,14,6,16,51,56,-5,48
Rapid Vienna,3897,6,11,11,14,49,41,8,44
Admira Wacke,3897,7,12,5,19,38,60,-22,41
Mattersburg,3897,8,11,7,18,47,57,-10,40
St. Pölten,3897,9,8,9,19,36,67,-31,33
SV Josko Rie,3897,10,8,6,22,30,57,-27,30
FC Salzburg,3898,1,21,6,9,66,34,32,69
SK Sturm Gra,3898,2,19,8,9,62,32,30,65
SC Rheindorf,3898,3,18,8,10,57,42,15,62
Vienna,3898,4,17,8,11,64,56,8,59
Rapid Vienna,3898,5,15,12,9,54,35,19,57
Admira Wacke,3898,6,13,5,18,38,57,-19,44
RZ Pellets W,3898,7,11,8,17,43,59,-16,41
St. Pölten,3898,8,8,12,16,44,67,-23,36
SV Josko Rie,3898,9,10,5,21,34,61,-27,35
Mattersburg,3898,10,7,10,19,42,61,-19,31
SC Rheindorf,3899,1,21,7,8,58,38,20,70
SK Sturm Gra,3899,2,20,4,12,52,35,17,64
Vienna,3899,3,19,6,11,64,51,13,63
FC Salzburg,3899,4,18,8,10,65,39,26,62
Rapid Vienna,3899,5,15,10,11,58,42,16,55
RZ Pellets W,3899,6,15,5,16,47,56,-9,50
Admira Wacke,3899,7,12,6,18,37,57,-20,42
St. Pölten,3899,8,9,9,18,47,64,-17,36
SV Josko Rie,3899,9,9,6,21,36,61,-25,33
Mattersburg,3899,10,7,9,20,43,64,-21,30
FC Salzburg,3900,1,20,8,8,72,33,39,68
SK Sturm Gra,3900,2,20,7,9,57,32,25,67
SC Rheindorf,3900,3,19,9,8,51,39,12,66
Vienna,3900,4,16,8,12,62,53,9,56
Rapid Vienna,3900,5,14,10,12,53,44,9,52
Admira Wacke,3900,6,14,6,16,42,61,-19,48
RZ Pellets W,3900,7,12,7,17,47,63,-16,43
SV Josko Rie,3900,8,10,6,20,34,54,-20,36
St. Pölten,3900,9,7,11,18,46,62,-16,32
Mattersburg,3900,10,8,8,20,38,61,-23,32
FC Salzburg,3901,1,23,5,8,72,31,41,74
SC Rheindorf,3901,2,19,8,9,56,43,13,65
SK Sturm Gra,3901,3,18,7,11,59,37,22,61
Vienna,3901,4,18,6,12,56,53,3,60
Rapid Vienna,3901,5,15,10,11,61,44,17,55
RZ Pellets W,3901,6,12,8,16,44,49,-5,44
Admira Wacke,3901,7,12,6,18,43,66,-23,42
SV Josko Rie,3901,8,12,3,21,43,56,-13,39
Mattersburg,3901,9,10,8,18,42,62,-20,38
St. Pölten,3901,10,6,9,21,41,76,-35,27
FC Salzburg,3902,1,20,8,8,64,32,32,68
SK Sturm Gra,3902,2,19,8,9,63,37,26,65
Vienna,3902,3,18,7,11,64,48,16,61
SC Rheindorf,3902,4,16,10,10,52,46,6,58
Rapid Vienna,3902,5,14,10,12,56,44,12,52
Admira Wacke,3902,6,13,9,14,42,54,-12,48
RZ Pellets W,3902,7,10,9,17,43,60,-17,39
St. Pölten,3902,8,8,13,15,43,62,-19,37
Mattersburg,3902,9,9,9,18,41,60,-19,36
SV Josko Rie,3902,10,8,7,21,32,57,-25,31
FC Salzburg,3903,1,22,8,6,66,27,39,74
SC Rheindorf,3903,2,22,6,8,59,37,22,72
SK Sturm Gra,3903,3,18,7,11,60,35,25,61
Vienna,3903,4,16,8,12,57,51,6,56
Rapid Vienna,3903,5,14,10,12,55,40,15,52
RZ Pellets W,3903,6,11,6,19,42,58,-16,39
Admira Wacke,3903,7,11,6,19,37,64,-27,39
Mattersburg,3903,8,9,10,17,44,62,-18,37
SV Josko Rie,3903,9,10,6,20,35,52,-17,36
St. Pölten,3903,10,9,9,18,42,71,-29,36
FC Salzburg,3904,1,22,7,7,69,33,36,73
SC Rheindorf,3904,2,19,7,10,55,43,12,64
SK Sturm Gra,3904,3,18,9,9,58,31,27,63
Vienna,3904,4,19,5,12,60,53,7,62
Rapid Vienna,3904,5,12,12,12,52,42,10,48
RZ Pellets W,3904,6,13,8,15,49,50,-1,47
Admira Wacke,3904,7,11,8,17,40,57,-17,41
SV Josko Rie,3904,8,10,6,20,29,56,-27,36
St. Pölten,3904,9,8,10,18,41,58,-17,34
Mattersburg,3904,10,8,8,20,30,60,-30,32
FC Salzburg,3905,1,21,6,9,69,35,34,69
SK Sturm Gra,3905,2,20,8,8,65,32,33,68
Vienna,3905,3,19,8,9,64,46,18,65
SC Rheindorf,3905,4,19,7,10,56,47,9,64
RZ Pellets W,3905,5,14,8,14,47,50,-3,50
Rapid Vienna,3905,6,10,16,10,56,43,13,46
SV Josko Rie,3905,7,11,6,19,32,52,-20,39
Admira Wacke,3905,8,10,7,19,39,63,-24,37
Mattersburg,3905,9,7,10,19,33,61,-28,31
St. Pölten,3905,10,7,8,21,35,67,-32,29
SK Sturm Gra,3906,1,21,5,10,59,34,25,68
Vienna,3906,2,21,3,12,64,48,16,66
FC Salzburg,3906,3,19,7,10,54,28,26,64
SC Rheindorf,3906,4,19,7,10,62,47,15,64
Rapid Vienna,3906,5,16,9,11,59,41,18,57
RZ Pellets W,3906,6,10,12,14,40,51,-11,42
Admira Wacke,3906,7,11,7,18,35,64,-29,40
SV Josko Rie,3906,8,11,5,20,39,57,-18,38
St. Pölten,3906,9,8,10,18,43,59,-16,34
Mattersburg,3906,10,7,9,20,34,60,-26,30
FC Salzburg,3907,1,21,7,8,68,27,41,70
SK Sturm Gra,3907,2,19,4,13,57,35,22,61
Vienna,3907,3,18,7,11,61,48,13,61
SC Rheindorf,3907,4,18,7,11,45,42,3,61
Rapid Vienna,3907,5,12,12,12,53,38,15,48
Admira Wacke,3907,6,12,8,16,34,51,-17,44
SV Josko Rie,3907,7,12,7,17,38,50,-12,43
St. Pölten,3907,8,11,8,17,40,69,-29,41
Mattersburg,3907,9,10,9,17,38,49,-11,39
RZ Pellets W,3907,10,8,9,19,37,62,-25,33
FC Salzburg,3908,1,22,5,9,73,38,35,71
SC Rheindorf,3908,2,20,5,11,56,45,11,65
Vienna,3908,3,20,4,12,68,51,17,64
Rapid Vienna,3908,4,15,11,10,58,39,19,56
SK Sturm Gra,3908,5,16,7,13,58,37,21,55
RZ Pellets W,3908,6,12,9,15,50,58,-8,45
St. Pölten,3908,7,11,9,16,44,61,-17,42
SV Josko Rie,3908,8,12,3,21,37,59,-22,39
Admira Wacke,3908,9,10,7,19,35,64,-29,37
Mattersburg,3908,10,8,8,20,33,60,-27,32
FC Salzburg,3909,1,21,9,6,72,36,36,72
SK Sturm Gra,3909,2,22,6,8,62,30,32,72
SC Rheindorf,3909,3,19,5,12,54,51,3,62
Vienna,3909,4,17,7,12,65,50,15,58
SV Josko Rie,3909,5,16,6,14,43,42,1,54
Rapid Vienna,3909,6,13,11,12,56,41,15,50
RZ Pellets W,3909,7,10,8,18,41,62,-21,38
Admira Wacke,3909,8,11,5,20,35,63,-28,38
Mattersburg,3909,9,8,8,20,38,60,-22,32
St. Pölten,3909,10,5,11,20,37,68,-31,26
FC Salzburg,3910,1,23,4,9,65,29,36,73
SK Sturm Gra,3910,2,22,5,9,67,31,36,71
SC Rheindorf,3910,3,19,5,12,50,43,7,62
Rapid Vienna,3910,4,16,10,10,57,36,21,58
Vienna,3910,5,17,5,14,57,54,3,56
RZ Pellets W,3910,6,13,7,16,42,53,-11,46
Admira Wacke,3910,7,12,6,18,39,58,-19,42
St. Pölten,3910,8,8,10,18,43,68,-25,34
Mattersburg,3910,9,8,9,19,40,61,-21,33
SV Josko Rie,3910,10,9,5,22,29,56,-27,32
SK Sturm Gra,3911,1,19,8,9,62,34,28,65
SC Rheindorf,3911,2,19,7,10,59,46,13,64
Vienna,3911,3,19,4,13,60,57,3,61
FC Salzburg,3911,4,17,9,10,55,36,19,60
Rapid Vienna,3911,5,15,8,13,55,41,14,53
RZ Pellets W,3911,6,14,7,15,51,54,-3,49
Admira Wacke,3911,7,11,9,16,39,53,-14,42
St. Pölten,3911,8,11,9,16,45,63,-18,42
SV Josko Rie,3911,9,8,10,18,31,54,-23,34
Mattersburg,3911,10,7,9,20,34,53,-19,30
FC Salzburg,3912,1,24,8,4,70,24,46,80
SK Sturm Gra,3912,2,20,7,9,56,32,24,67
SC Rheindorf,3912,3,18,6,12,50,41,9,60
Vienna,3912,4,18,3,15,59,53,6,57
Rapid Vienna,3912,5,14,9,13,57,46,11,51
Admira Wacke,3912,6,14,5,17,33,50,-17,47
SV Josko Rie,3912,7,12,5,19,36,49,-13,41
RZ Pellets W,3912,8,10,8,18,47,60,-13,38
St. Pölten,3912,9,9,9,18,41,66,-25,36
Mattersburg,3912,10,5,12,19,29,57,-28,27
FC Salzburg,3913,1,20,9,7,63,29,34,69
Vienna,3913,2,19,7,10,64,47,17,64
SK Sturm Gra,3913,3,19,6,11,49,29,20,63
SC Rheindorf,3913,4,18,7,11,55,45,10,61
Rapid Vienna,3913,5,16,10,10,56,36,20,58
Admira Wacke,3913,6,14,5,17,44,59,-15,47
RZ Pellets W,3913,7,11,9,16,41,54,-13,42
Mattersburg,3913,8,9,8,19,44,60,-16,35
SV Josko Rie,3913,9,10,5,21,35,60,-25,35
St. Pölten,3913,10,7,8,21,33,65,-32,29
SK Sturm Gra,3914,1,22,8,6,59,26,33,74
SC Rheindorf,3914,2,21,9,6,60,38,22,72
FC Salzburg,3914,3,19,10,7,65,35,30,67
Rapid Vienna,3914,4,14,11,11,59,42,17,53
Vienna,3914,5,15,5,16,54,54,0,50
RZ Pellets W,3914,6,11,9,16,49,56,-7,42
SV Josko Rie,3914,7,9,9,18,32,50,-18,36
Admira Wacke,3914,8,9,8,19,41,67,-26,35
Mattersburg,3914,9,7,12,17,35,55,-20,33
St. Pölten,3914,10,8,9,19,40,71,-31,33
SC Rheindorf,3915,1,21,8,7,62,39,23,71
FC Salzburg,3915,2,20,7,9,67,33,34,67
Rapid Vienna,3915,3,16,11,9,64,38,26,59
SK Sturm Gra,3915,4,17,8,11,55,33,22,59
Vienna,3915,5,18,4,14,60,55,5,58
SV Josko Rie,3915,6,13,5,18,36,50,-14,44
RZ Pellets W,3915,7,11,8,17,45,57,-12,41
St. Pölten,3915,8,9,10,17,51,72,-21,37
Admira Wacke,3915,9,11,3,22,34,68,-34,36
Mattersburg,3915,10,8,8,20,35,64,-29,32
FC Salzburg,3916,1,24,7,5,80,27,53,79
SC Rheindorf,3916,2,20,8,8,59,40,19,68
Vienna,3916,3,19,4,13,59,50,9,61
Rapid Vienna,3916,4,14,10,12,53,41,12,52
SK Sturm Gra,3916,5,14,9,13,53,41,12,51
RZ Pellets W,3916,6,12,10,14,42,44,-2,46
St. Pölten,3916,7,8,13,15,39,60,-21,37
SV Josko Rie,3916,8,10,6,20,31,53,-22,36
Admira Wacke,3916,9,9,9,18,34,68,-34,36
Mattersburg,3916,10,8,8,20,35,61,-26,32
FC Salzburg,3917,1,26,5,5,71,25,46,83
SC Rheindorf,3917,2,19,6,11,53,45,8,63
SK Sturm Gra,3917,3,17,8,11,60,40,20,59
Vienna,3917,4,15,7,14,61,62,-1,52
Rapid Vienna,3917,5,13,11,12,61,43,18,50
RZ Pellets W,3917,6,13,9,14,48,51,-3,48
St. Pölten,3917,7,11,10,15,50,60,-10,43
SV Josko Rie,3917,8,10,6,20,33,55,-22,36
Mattersburg,3917,9,9,7,20,30,56,-26,34
Admira Wacke,3917,10,9,7,20,31,61,-30,34
SC Rheindorf,3918,1,22,7,7,64,34,30,73
FC Salzburg,3918,2,21,7,8,60,27,33,70
SK Sturm Gra,3918,3,19,5,12,57,36,21,62
RZ Pellets W,3918,4,16,5,15,47,51,-4,53
Rapid Vienna,3918,5,13,10,13,53,47,6,49
Vienna,3918,6,14,7,15,51,57,-6,49
St. Pölten,3918,7,11,11,14,40,55,-15,44
SV Josko Rie,3918,8,11,5,20,37,52,-15,38
Mattersburg,3918,9,9,7,20,40,63,-23,34
Admira Wacke,3918,10,9,6,21,34,61,-27,33
SC Rheindorf,3919,1,21,8,7,59,38,21,71
FC Salzburg,3919,2,20,6,10,59,30,29,66
SK Sturm Gra,3919,3,17,7,12,57,36,21,58
Vienna,3919,4,18,4,14,61,52,9,58
Rapid Vienna,3919,5,14,10,12,52,40,12,52
SV Josko Rie,3919,6,13,5,18,36,50,-14,44
RZ Pellets W,3919,7,11,10,15,44,53,-9,43
Admira Wacke,3919,8,13,4,19,42,65,-23,43
Mattersburg,3919,9,10,7,19,35,55,-20,37
St. Pölten,3919,10,9,7,20,39,65,-26,34
SC Rheindorf,3920,1,19,9,8,51,41,10,66
SK Sturm Gra,3920,2,19,6,11,57,33,24,63
FC Salzburg,3920,3,18,9,9,59,36,23,63
Vienna,3920,4,17,8,11,53,43,10,59
Rapid Vienna,3920,5,14,12,10,53,37,16,54
RZ Pellets W,3920,6,15,7,14,41,45,-4,52
SV Josko Rie,3920,7,12,6,18,34,47,-13,42
Admira Wacke,3920,8,11,7,18,40,55,-15,40
St. Pölten,3920,9,10,10,16,39,57,-18,40
Mattersburg,3920,10,5,6,25,28,61,-33,21
FC Salzburg,3921,1,20,7,9,58,28,30,67
SK Sturm Gra,3921,2,19,7,10,59,33,26,64
SC Rheindorf,3921,3,18,10,8,46,34,12,64
Vienna,3921,4,19,3,14,62,51,11,60
RZ Pellets W,3921,5,15,7,14,45,53,-8,52
Rapid Vienna,3921,6,12,15,9,52,36,16,51
St. Pölten,3921,7,10,11,15,41,56,-15,41
Admira Wacke,3921,8,10,6,20,31,55,-24,36
SV Josko Rie,3921,9,10,5,21,32,52,-20,35
Mattersburg,3921,10,7,9,20,36,64,-28,30
FC Salzburg,3922,1,21,8,7,66,27,39,71
SC Rheindorf,3922,2,20,8,8,52,36,16,68
Vienna,3922,3,21,4,11,70,48,22,67
SK Sturm Gra,3922,4,18,8,10,61,36,25,62
Rapid Vienna,3922,5,11,10,15,49,43,6,43
RZ Pellets W,3922,6,12,7,17,45,55,-10,43
Mattersburg,3922,7,11,8,17,38,55,-17,41
St. Pölten,3922,8,9,11,16,42,62,-20,38
Admira Wacke,3922,9,10,7,19,28,61,-33,37
SV Josko Rie,3922,10,10,3,23,32,60,-28,33
SC Rheindorf,3923,1,20,8,8,59,37,22,68
FC Salzburg,3923,2,18,10,8,60,32,28,64
Vienna,3923,3,18,5,13,61,57,4,59
SK Sturm Gra,3923,4,15,10,11,51,35,16,55
RZ Pellets W,3923,5,16,6,14,53,54,-1,54
Rapid Vienna,3923,6,14,10,12,53,39,14,52
Admira Wacke,3923,7,11,8,17,38,58,-20,41
St. Pölten,3923,8,10,8,18,35,54,-19,38
SV Josko Rie,3923,9,10,6,20,31,53,-22,36
Mattersburg,3923,10,8,9,19,35,57,-22,33
Vienna,3924,1,20,6,10,67,47,20,66
FC Salzburg,3924,2,19,8,9,62,33,29,65
SK Sturm Gra,3924,2,19,8,9,62,33,29,65
SC Rheindorf,3924,4,17,10,9,55,46,9,61
Rapid Vienna,3924,5,13,11,12,56,42,14,50
RZ Pellets W,3924,6,13,8,15,48,61,-13,47
SV Josko Rie,3924,7,11,7,18,35,54,-19,40
Admira Wacke,3924,8,10,9,17,41,65,-24,39
St. Pölten,3924,9,8,9,19,40,61,-21,33
Mattersburg,3924,10,8,8,20,33,57,-24,32
FC Salzburg,3925,1,21,8,7,66,30,36,71
Vienna,3925,2,20,5,11,64,44,20,65
SC Rheindorf,3925,3,19,7,10,54,44,10,64
SK Sturm Gra,3925,4,18,7,11,55,33,22,61
RZ Pellets W,3925,5,12,9,15,44,58,-14,45
Mattersburg,3925,6,10,11,15,41,51,-10,41
Rapid Vienna,3925,7,9,13,14,45,43,2,40
St. Pölten,3925,8,10,10,16,41,62,-21,40
Admira Wacke,3925,9,9,11,16,37,57,-20,38
SV Josko Rie,3925,10,9,5,22,28,53,-25,32
FC Salzburg,3926,1,21,6,9,72,33,39,69
SC Rheindorf,3926,2,18,10,8,60,46,14,64
Vienna,3926,3,18,7,11,59,56,3,61
Rapid Vienna,3926,4,14,12,10,57,43,14,54
SK Sturm Gra,3926,5,14,9,13,53,40,13,51
RZ Pellets W,3926,6,13,9,14,51,51,0,48
SV Josko Rie,3926,7,13,5,18,41,52,-11,44
Admira Wacke,3926,8,11,7,18,34,59,-25,40
Mattersburg,3926,9,9,8,19,37,58,-21,35
St. Pölten,3926,10,9,7,20,45,71,-26,34
SK Sturm Gra,3927,1,19,9,8,57,29,28,66
SC Rheindorf,3927,2,19,8,9,54,41,13,65
FC Salzburg,3927,3,18,9,9,62,36,26,63
Vienna,3927,4,18,6,12,66,53,13,60
Rapid Vienna,3927,5,13,11,12,50,41,9,50
Admira Wacke,3927,6,14,6,16,41,59,-18,48
RZ Pellets W,3927,7,11,9,16,40,51,-11,42
SV Josko Rie,3927,8,12,4,20,37,56,-19,40
Mattersburg,3927,9,9,8,19,43,62,-19,35
St. Pölten,3927,10,7,10,19,35,57,-22,31
SK Sturm Gra,3928,1,22,5,9,61,33,28,71
SC Rheindorf,3928,2,19,4,13,56,52,4,61
Rapid Vienna,3928,3,15,12,9,57,35,22,57
FC Salzburg,3928,4,16,8,12,62,41,21,56
Vienna,3928,5,17,5,14,59,54,5,56
Admira Wacke,3928,6,14,7,15,42,49,-7,49
RZ Pellets W,3928,7,14,7,15,43,51,-8,49
SV Josko Rie,3928,8,13,3,20,41,57,-16,42
St. Pölten,3928,9,9,9,18,37,60,-23,36
Mattersburg,3928,10,8,6,22,35,61,-26,30
SC Rheindorf,3929,1,20,8,8,51,34,17,68
SK Sturm Gra,3929,2,19,9,8,63,33,30,66
FC Salzburg,3929,3,18,9,9,57,29,28,63
Vienna,3929,4,17,5,14,57,55,2,56
Rapid Vienna,3929,5,12,11,13,57,45,12,47
Admira Wacke,3929,6,12,10,14,36,50,-14,46
RZ Pellets W,3929,7,11,9,16,47,65,-18,42
Mattersburg,3929,8,9,10,17,42,57,-15,37
SV Josko Rie,3929,9,10,6,20,37,57,-20,36
St. Pölten,3929,10,7,13,16,38,60,-22,34
SC Rheindorf,3930,1,22,9,5,56,32,24,75
FC Salzburg,3930,2,22,8,6,64,24,40,74
SK Sturm Gra,3930,3,23,4,9,60,32,28,73
Vienna,3930,4,15,10,11,59,52,7,55
Rapid Vienna,3930,5,11,11,14,52,47,5,44
RZ Pellets W,3930,6,11,8,17,46,58,-12,41
Admira Wacke,3930,7,11,5,20,41,64,-23,38
SV Josko Rie,3930,8,11,4,21,32,51,-19,37
St. Pölten,3930,9,9,8,19,37,64,-27,35
Mattersburg,3930,10,7,9,20,32,55,-23,30
FC Salzburg,3931,1,22,7,7,72,32,40,73
SK Sturm Gra,3931,2,19,7,10,65,38,27,64
SC Rheindorf,3931,3,19,7,10,51,41,10,64
Vienna,3931,4,17,5,14,60,54,6,56
Rapid Vienna,3931,5,14,10,12,58,47,11,52
RZ Pellets W,3931,6,11,9,16,47,61,-14,42
SV Josko Rie,3931,7,11,7,18,29,45,-16,40
St. Pölten,3931,8,10,10,16,45,65,-20,40
Admira Wacke,3931,9,10,9,17,40,61,-21,39
Mattersburg,3931,10,7,9,20,35,58,-23,30
SC Rheindorf,3932,1,23,5,8,70,48,22,74
FC Salzburg,3932,2,21,6,9,67,39,28,69
SK Sturm Gra,3932,3,20,4,12,63,40,23,64
Vienna,3932,4,19,4,13,73,60,13,61
Rapid Vienna,3932,5,16,9,11,57,40,17,57
RZ Pellets W,3932,6,14,7,15,44,52,-8,49
SV Josko Rie,3932,7,13,4,19,41,51,-10,43
Admira Wacke,3932,8,10,6,20,41,63,-22,36
St. Pölten,3932,9,8,7,21,37,66,-29,31
Mattersburg,3932,10,5,10,21,34,68,-34,25
FC Salzburg,3933,1,21,8,7,71,31,40,71
SK Sturm Gra,3933,2,19,7,10,64,32,32,64
SC Rheindorf,3933,3,17,10,9,48,43,5,61
RZ Pellets W,3933,4,15,7,14,51,57,-6,52
Vienna,3933,5,15,6,15,58,60,-2,51
SV Josko Rie,3933,6,15,3,18,44,54,-10,48
Rapid Vienna,3933,7,11,11,14,47,45,2,44
Admira Wacke,3933,8,12,6,18,43,57,-14,42
St. Pölten,3933,9,11,9,16,42,64,-22,42
Mattersburg,3933,10,5,11,20,33,58,-25,26
SC Rheindorf,3934,1,25,4,7,65,38,27,79
FC Salzburg,3934,2,22,8,6,70,33,37,74
Vienna,3934,3,18,5,13,59,54,5,59
SK Sturm Gra,3934,4,16,8,12,48,34,14,56
Rapid Vienna,3934,5,13,12,11,55,37,18,51
RZ Pellets W,3934,6,12,6,18,47,63,-16,42
Admira Wacke,3934,7,11,9,16,45,61,-16,42
St. Pölten,3934,8,8,11,17,43,59,-16,35
Mattersburg,3934,9,7,10,19,36,60,-24,31
SV Josko Rie,3934,10,8,7,21,36,65,-29,31
FC Salzburg,3935,1,21,6,9,62,31,31,69
SK Sturm Gra,3935,2,21,6,9,60,33,27,69
Vienna,3935,3,21,5,10,67,48,19,68
SC Rheindorf,3935,4,20,5,11,55,39,16,65
Rapid Vienna,3935,5,15,11,10,57,38,19,56
SV Josko Rie,3935,6,13,3,20,45,59,-14,42
Admira Wacke,3935,7,11,7,18,40,64,-24,40
RZ Pellets W,3935,8,10,7,19,43,60,-17,37
Mattersburg,3935,9,8,7,21,38,65,-27,31
St. Pölten,3935,10,6,11,19,36,66,-30,29
SK Sturm Gra,3936,1,22,5,9,64,36,28,71
FC Salzburg,3936,2,18,9,9,64,28,36,63
SC Rheindorf,3936,3,17,10,9,50,39,11,61
Vienna,3936,4,16,8,12,60,55,5,56
Rapid Vienna,3936,5,14,10,12,59,45,14,52
RZ Pellets W,3936,6,12,10,14,47,52,-5,46
Admira Wacke,3936,7,11,11,14,37,54,-17,44
St. Pölten,3936,8,11,7,18,39,65,-26,40
SV Josko Rie,3936,9,9,6,21,32,58,-26,33
Mattersburg,3936,10,6,12,18,39,59,-20,30
SC Rheindorf,3937,1,22,6,8,66,39,27,72
FC Salzburg,3937,2,21,6,9,65,30,35,69
SK Sturm Gra,3937,3,21,4,11,66,38,28,67
Vienna,3937,4,21,4,11,62,50,12,67
Rapid Vienna,3937,5,16,9,11,59,43,16,57
RZ Pellets W,3937,6,12,6,18,48,61,-13,42
Admira Wacke,3937,7,12,5,19,35,64,-29,41
St. Pölten,3937,8,8,9,19,44,66,-22,33
Mattersburg,3937,9,9,5,22,35,60,-25,32
SV Josko Rie,3937,10,9,4,23,28,57,-29,31
FC Salzburg,3938,1,22,8,6,64,30,34,74
SK Sturm Gra,3938,2,20,6,10,58,36,22,66
SC Rheindorf,3938,3,20,6,10,55,45,10,66
Vienna,3938,4,20,3,13,66,52,14,63
Rapid Vienna,3938,5,16,10,10,55,37,18,58
RZ Pellets W,3938,6,15,6,15,49,49,0,51
Mattersburg,3938,7,11,6,19,42,56,-14,39
Admira Wacke,3938,8,9,6,21,33,63,-30,33
SV Josko Rie,3938,9,8,6,22,30,53,-23,30
St. Pölten,3938,10,6,9,21,34,65,-31,27
FC Salzburg,3939,1,20,7,9,64,34,30,67
Vienna,3939,2,19,6,11,65,53,12,63
SC Rheindorf,3939,3,18,9,9,49,40,9,63
SK Sturm Gra,3939,4,16,5,15,61,46,15,53
Rapid Vienna,3939,5,11,16,9,56,42,14,49
RZ Pellets W,3939,6,14,7,15,55,64,-9,49
Mattersburg,3939,7,11,8,17,42,60,-18,41
St. Pölten,3939,8,10,10,16,51,64,-13,40
SV Josko Rie,3939,9,11,4,21,36,51,-15,37
Admira Wacke,3939,10,8,12,16,33,58,-25,36
SC Rheindorf,3940,1,22,9,5,56,33,23,75
FC Salzburg,3940,2,20,8,8,61,31,30,68
Vienna,3940,3,20,3,13,63,52,11,63
SK Sturm Gra,3940,4,19,5,12,60,35,25,62
Rapid Vienna,3940,5,16,8,12,66,48,18,56
Admira Wacke,3940,6,13,8,15,43,54,-11,47
St. Pölten,3940,7,9,9,18,42,61,-19,36
RZ Pellets W,3940,8,9,9,18,38,60,-22,36
Mattersburg,3940,9,9,7,20,36,60,-24,34
SV Josko Rie,3940,10,8,4,24,25,56,-31,28
Vienna,3941,1,22,5,9,63,43,20,71
FC Salzburg,3941,2,21,7,8,65,33,32,70
SK Sturm Gra,3941,3,19,5,12,64,39,25,62
SC Rheindorf,3941,4,17,9,10,49,39,10,60
Rapid Vienna,3941,5,16,9,11,61,42,19,57
Admira Wacke,3941,6,13,6,17,39,57,-18,45
RZ Pellets W,3941,7,13,4,19,51,65,-14,43
St. Pölten,3941,8,10,7,19,48,71,-23,37
SV Josko Rie,3941,9,10,4,22,29,55,-26,34
Mattersburg,3941,10,7,8,21,31,56,-25,29
FC Salzburg,3942,1,23,6,7,72,26,46,75
SC Rheindorf,3942,2,19,8,9,56,44,12,65
SK Sturm Gra,3942,3,19,6,11,59,32,27,63
Rapid Vienna,3942,4,14,11,11,56,43,13,53
RZ Pellets W,3942,5,15,5,16,49,56,-7,50
Vienna,3942,6,14,7,15,61,62,-1,49
Admira Wacke,3942,7,13,4,19,35,60,-25,43
SV Josko Rie,3942,8,10,7,19,31,55,-24,37
St. Pölten,3942,9,8,11,17,45,65,-20,35
Mattersburg,3942,10,8,9,19,39,60,-21,33
FC Salzburg,3943,1,23,7,6,69,30,39,76
SK Sturm Gra,3943,2,22,5,9,61,30,31,71
SC Rheindorf,3943,3,18,7,11,58,48,10,61
Vienna,3943,4,18,5,13,56,54,2,59
Rapid Vienna,3943,5,14,10,12,62,40,22,52
RZ Pellets W,3943,6,11,7,18,43,55,-12,40
Admira Wacke,3943,7,11,6,19,38,67,-29,39
SV Josko Rie,3943,8,11,5,20,33,55,-22,38
Mattersburg,3943,9,10,7,19,43,60,-17,37
St. Pölten,3943,10,9,7,20,39,63,-24,34
FC Salzburg,3944,1,21,7,8,65,36,29,70
SK Sturm Gra,3944,2,20,6,10,58,32,26,66
SC Rheindorf,3944,3,19,8,9,62,44,18,65
Vienna,3944,4,19,6,11,67,54,13,63
Rapid Vienna,3944,5,12,11,13,49,40,9,47
RZ Pellets W,3944,6,12,9,15,48,51,-3,45
SV Josko Rie,3944,7,12,6,18,37,49,-12,42
Admira Wacke,3944,8,10,7,19,31,59,-28,37
Mattersburg,3944,9,8,10,18,41,63,-22,34
St. Pölten,3944,10,7,10,19,40,70,-30,31
Vienna,3945,1,23,5,8,73,47,26,74
FC Salzburg,3945,2,21,7,8,75,39,36,70
SK Sturm Gra,3945,3,20,7,9,62,33,29,67
SC Rheindorf,3945,4,17,6,13,51,47,4,57
Rapid Vienna,3945,5,12,8,16,51,48,3,44
St. Pölten,3945,6,11,9,16,50,64,-14,42
Mattersburg,3945,7,11,9,16,38,53,-15,42
Admira Wacke,3945,8,12,5,19,37,63,-26,41
RZ Pellets W,3945,9,11,7,18,47,58,-11,40
SV Josko Rie,3945,10,9,3,24,33,65,-32,30
SC Rheindorf,3946,1,21,8,7,53,37,16,71
FC Salzburg,3946,2,21,7,8,65,30,35,70
Rapid Vienna,3946,3,18,9,9,62,36,26,63
Vienna,3946,4,18,7,11,65,58,7,61
SK Sturm Gra,3946,5,15,9,12,56,41,15,54
Admira Wacke,3946,6,13,3,20,37,61,-24,42
SV Josko Rie,3946,7,12,5,19,38,52,-14,41
RZ Pellets W,3946,8,10,6,20,45,70,-25,36
Mattersburg,3946,9,9,8,19,39,53,-14,35
St. Pölten,3946,10,8,8,20,39,61,-22,32
Vienna,3947,1,21,4,11,62,47,15,67
FC Salzburg,3947,2,19,6,11,60,34,26,63
SC Rheindorf,3947,3,18,6,12,60,52,8,60
SK Sturm Gra,3947,4,17,7,12,57,33,24,58
Rapid Vienna,3947,5,12,12,12,53,45,8,48
SV Josko Rie,3947,6,14,6,16,45,52,-7,48
RZ Pellets W,3947,7,12,6,18,39,58,-19,42
St. Pölten,3947,8,10,10,16,46,63,-17,40
Admira Wacke,3947,9,11,7,18,37,60,-23,40
Mattersburg,3947,10,9,10,17,44,59,-15,37
FC Salzburg,3948,1,22,6,8,64,33,31,72
SK Sturm Gra,3948,2,21,6,9,59,30,29,69
SC Rheindorf,3948,3,17,7,12,55,51,4,58
Vienna,3948,4,17,4,15,62,56,6,55
Rapid Vienna,3948,5,15,9,12,56,38,18,54
RZ Pellets W,3948,6,13,9,14,48,53,-5,48
Admira Wacke,3948,7,13,4,19,36,56,-20,43
St. Pölten,3948,8,11,8,17,46,64,-18,41
Mattersburg,3948,9,8,10,18,37,56,-19,34
SV Josko Rie,3948,10,9,5,22,30,56,-26,32
Vienna,3949,1,23,3,10,73,52,21,72
SK Sturm Gra,3949,2,21,4,11,62,28,34,67
FC Salzburg,3949,3,19,7,10,64,41,23,64
SC Rheindorf,3949,4,18,8,10,50,40,10,62
Rapid Vienna,3949,5,14,9,13,56,42,14,51
RZ Pellets W,3949,6,13,6,17,49,60,-11,45
Mattersburg,3949,7,12,7,17,41,51,-10,43
SV Josko Rie,3949,8,10,8,18,37,53,-16,38
Admira Wacke,3949,9,11,4,21,35,69,-34,37
St. Pölten,3949,10,6,10,20,35,66,-31,28
Vienna,3950,1,21,6,9,68,47,21,69
FC Salzburg,3950,2,20,8,8,64,32,32,68
SC Rheindorf,3950,3,18,6,12,54,46,8,60
SK Sturm Gra,3950,4,17,5,14,57,38,19,56
Rapid Vienna,3950,5,14,11,11,54,36,18,53
Admira Wacke,3950,6,14,8,14,42,55,-13,50
RZ Pellets W,3950,7,10,9,17,46,62,-16,39
SV Josko Rie,3950,8,11,4,21,35,57,-22,37
St. Pölten,3950,9,10,7,19,41,69,-28,37
Mattersburg,3950,10,8,10,18,33,52,-19,34
FC Salzburg,3951,1,22,7,7,61,29,32,73
SC Rheindorf,3951,2,19,8,9,54,38,16,65
Rapid Vienna,3951,3,15,12,9,54,33,21,57
SK Sturm Gra,3951,4,16,8,12,52,34,18,56
Vienna,3951,5,17,5,14,52,49,3,56
RZ Pellets W,3951,6,16,7,13,52,44,8,55
SV Josko Rie,3951,7,12,6,18,36,52,-16,42
Admira Wacke,3951,8,11,8,17,40,58,-18,41
Mattersburg,3951,9,6,10,20,28,56,-28,28
St. Pölten,3951,10,5,11,20,35,71,-36,26
Vienna,3952,1,24,2,10,71,45,26,74
SK Sturm Gra,3952,2,21,5,10,66,32,34,68
FC Salzburg,3952,3,19,9,8,59,32,27,66
SC Rheindorf,3952,4,19,5,12,58,49,9,62
RZ Pellets W,3952,5,13,9,14,41,50,-9,48
Rapid Vienna,3952,6,12,11,13,48,43,5,47
Mattersburg,3952,7,10,9,17,41,58,-17,39
SV Josko Rie,3952,8,9,7,20,32,55,-23,34
St. Pölten,3952,9,8,9,19,44,65,-21,33
Admira Wacke,3952,10,8,8,20,25,56,-31,32
FC Salzburg,3953,1,21,8,7,67,33,34,71
SC Rheindorf,3953,2,18,8,10,53,45,8,62
SK Sturm Gra,3953,3,17,10,9,54,33,21,61
Vienna,3953,4,18,7,11,58,45,13,61
Rapid Vienna,3953,5,12,12,12,59,46,13,48
Admira Wacke,3953,6,13,8,15,39,47,-8,47
SV Josko Rie,3953,7,13,8,15,37,46,-9,47
RZ Pellets W,3953,8,10,8,18,39,59,-20,38
Mattersburg,3953,9,8,8,20,37,65,-28,32
St. Pölten,3953,10,6,11,19,36,60,-24,29
FC Salzburg,3954,1,22,6,8,68,34,34,72
SK Sturm Gra,3954,2,22,4,10,59,34,25,70
Vienna,3954,3,19,6,11,68,50,18,63
SC Rheindorf,3954,4,19,5,12,53,42,11,62
Rapid Vienna,3954,5,14,10,12,55,44,11,52
Admira Wacke,3954,6,12,7,17,44,58,-14,43
Mattersburg,3954,7,10,10,16,39,57,-18,40
RZ Pellets W,3954,8,9,9,18,48,67,-19,36
St. Pölten,3954,9,9,7,20,42,66,-24,34
SV Josko Rie,3954,10,10,4,22,32,56,-24,34
FC Salzburg,3955,1,22,6,8,64,31,33,72
SK Sturm Gra,3955,2,19,6,11,54,35,19,63
SC Rheindorf,3955,3,19,4,13,58,49,9,61
Vienna,3955,4,17,5,14,59,49,10,56
Rapid Vienna,3955,5,14,10,12,58,47,11,52
RZ Pellets W,3955,6,12,8,16,48,60,-12,44
Admira Wacke,3955,7,13,5,18,38,58,-20,44
SV Josko Rie,3955,8,12,6,18,40,55,-15,42
St. Pölten,3955,9,11,8,17,44,61,-17,41
Mattersburg,3955,10,9,6,21,43,61,-18,33
FC Salzburg,3956,1,25,6,5,77,23,54,81
Rapid Vienna,3956,2,19,7,10,59,38,21,64
SK Sturm Gra,3956,3,19,4,13,57,41,16,61
SC Rheindorf,3956,4,18,7,11,53,43,10,61
Vienna,3956,5,17,5,14,59,49,10,56
RZ Pellets W,3956,6,13,6,17,49,58,-9,45
SV Josko Rie,3956,7,12,6,18,34,55,-21,42
Admira Wacke,3956,8,11,5,20,37,68,-31,38
Mattersburg,3956,9,8,8,20,40,60,-20,32
St. Pölten,3956,10,6,10,20,39,69,-30,28
SC Rheindorf,3957,1,20,8,8,58,35,23,68
FC Salzburg,3957,2,19,10,7,62,28,34,67
SK Sturm Gra,3957,3,19,10,7,55,29,26,67
Vienna,3957,4,19,5,12,72,55,17,62
Rapid Vienna,3957,5,12,13,11,53,39,14,49
Admira Wacke,3957,6,14,4,18,44,56,-12,46
RZ Pellets W,3957,7,11,7,18,43,56,-13,40
SV Josko Rie,3957,8,11,4,21,37,59,-22,37
Mattersburg,3957,9,8,9,19,39,68,-29,33
St. Pölten,3957,10,8,8,20,36,74,-38,32
FC Salzburg,3958,1,22,7,7,66,31,35,73
SK Sturm Gra,3958,2,19,5,12,63,38,25,62
Vienna,3958,3,19,5,12,72,59,13,62
Rapid Vienna,3958,4,17,7,12,64,39,25,58
SC Rheindorf,3958,5,15,7,14,52,53,-1,52
RZ Pellets W,3958,6,14,8,14,51,51,0,50
Admira Wacke,3958,7,14,5,17,39,64,-25,47
SV Josko Rie,3958,8,12,3,21,44,62,-18,39
St. Pölten,3958,9,9,8,19,44,71,-27,35
Mattersburg,3958,10,7,9,20,36,63,-27,30
FC Salzburg,3959,1,22,7,7,66,28,38,73
SC Rheindorf,3959,2,19,9,8,55,40,15,66
SK Sturm Gra,3959,3,20,5,11,60,34,26,65
Vienna,3959,4,17,7,12,55,48,7,58
Rapid Vienna,3959,5,15,10,11,57,40,17,55
Admira Wacke,3959,6,12,6,18,34,56,-22,42
RZ Pellets W,3959,7,11,7,18,42,58,-16,40
SV Josko Rie,3959,8,12,4,20,35,52,-17,40
Mattersburg,3959,9,10,6,20,41,51,-10,36
St. Pölten,3959,10,6,11,19,35,73,-38,29
SC Rheindorf,3960,1,22,7,7,54,33,21,73
FC Salzburg,3960,2,20,7,9,63,31,32,67
SK Sturm Gra,3960,3,20,5,11,60,38,22,65
Vienna,3960,4,19,4,13,63,55,8,61
Rapid Vienna,3960,5,13,10,13,51,41,10,49
SV Josko Rie,3960,6,11,7,18,30,47,-17,40
Admira Wacke,3960,7,11,7,18,37,59,-22,40
RZ Pellets W,3960,8,10,8,18,47,64,-17,38
Mattersburg,3960,9,10,6,20,38,56,-18,36
St. Pölten,3960,10,9,9,18,40,59,-19,36
SK Sturm Gra,3961,1,20,9,7,66,36,30,69
FC Salzburg,3961,2,20,9,7,64,35,29,69
Vienna,3961,3,19,4,13,59,50,9,61
SC Rheindorf,3961,4,15,11,10,52,48,4,56
RZ Pellets W,3961,5,16,6,14,46,46,0,54
Admira Wacke,3961,6,16,5,15,49,55,-6,53
Rapid Vienna,3961,7,10,12,14,48,44,4,42
SV Josko Rie,3961,8,10,5,21,33,55,-22,35
Mattersburg,3961,9,8,8,20,39,62,-23,32
St. Pölten,3961,10,7,9,20,35,60,-25,30
FC Salzburg,3962,1,21,8,7,68,28,40,71
SC Rheindorf,3962,2,20,7,9,59,41,18,67
SK Sturm Gra,3962,3,20,4,12,57,37,20,64
Vienna,3962,4,16,8,12,54,48,6,56
Rapid Vienna,3962,5,12,12,12,49,43,6,48
RZ Pellets W,3962,6,11,11,14,43,50,-7,44
Admira Wacke,3962,7,10,11,15,36,54,-18,41
SV Josko Rie,3962,8,10,7,19,33,54,-21,37
St. Pölten,3962,9,9,9,18,47,63,-16,36
Mattersburg,3962,10,8,9,19,33,61,-28,33
FC Salzburg,3963,1,21,8,7,72,36,36,71
SC Rheindorf,3963,2,21,8,7,65,42,23,71
Vienna,3963,3,20,4,12,68,58,10,64
SK Sturm Gra,3963,4,17,8,11,54,35,19,59
Rapid Vienna,3963,5,12,12,12,58,45,13,48
RZ Pellets W,3963,6,12,7,17,46,55,-9,43
Admira Wacke,3963,7,12,6,18,34,55,-21,42
SV Josko Rie,3963,8,12,4,20,38,56,-18,40
St. Pölten,3963,9,10,8,18,46,67,-21,38
Mattersburg,3963,10,6,9,21,37,69,-32,27
SK Sturm Gra,3964,1,22,6,8,59,29,30,72
FC Salzburg,3964,2,21,7,8,63,30,33,70
SC Rheindorf,3964,3,21,7,8,52,33,19,70
Rapid Vienna,3964,4,18,9,9,59,37,22,63
Vienna,3964,5,19,3,14,59,53,6,60
RZ Pellets W,3964,6,13,9,14,56,55,1,48
Mattersburg,3964,7,10,6,20,45,62,-17,36
Admira Wacke,3964,8,10,5,21,36,67,-31,35
SV Josko Rie,3964,9,9,3,24,36,62,-26,30
St. Pölten,3964,10,6,7,23,34,71,-37,25
SC Rheindorf,3965,1,23,6,7,59,45,14,75
FC Salzburg,3965,2,19,10,7,64,30,34,67
SK Sturm Gra,3965,3,19,7,10,66,36,30,64
Vienna,3965,4,16,6,14,60,57,3,54
Rapid Vienna,3965,5,13,13,10,53,36,17,52
RZ Pellets W,3965,6,12,11,13,46,56,-10,47
Admira Wacke,3965,7,10,7,19,37,60,-23,37
Mattersburg,3965,8,8,11,17,38,55,-17,35
SV Josko Rie,3965,9,10,5,21,32,56,-24,35
St. Pölten,3965,10,7,10,19,41,65,-24,31
SC Rheindorf,3966,1,20,8,8,55,41,14,68
Vienna,3966,2,20,5,11,65,52,13,65
SK Sturm Gra,3966,3,20,4,12,59,41,18,64
FC Salzburg,3966,4,18,7,11,62,34,28,61
Rapid Vienna,3966,5,13,12,11,59,46,13,51
SV Josko Rie,3966,6,13,4,19,39,56,-17,43
RZ Pellets W,3966,7,12,6,18,49,59,-10,42
Admira Wacke,3966,8,12,4,20,41,64,-23,40
Mattersburg,3966,9,9,11,16,39,54,-15,38
St. Pölten,3966,10,8,9,19,45,66,-21,33
SK Sturm Gra,3967,1,23,5,8,69,36,33,74
SC Rheindorf,3967,2,19,8,9,58,42,16,65
Rapid Vienna,3967,3,17,8,11,58,37,21,59
FC Salzburg,3967,4,17,8,11,54,37,17,59
Vienna,3967,5,17,4,15,64,58,6,55
Admira Wacke,3967,6,14,6,16,42,52,-10,48
St. Pölten,3967,7,10,9,17,38,64,-26,39
Mattersburg,3967,8,10,8,18,40,53,-13,38
RZ Pellets W,3967,9,9,10,17,47,61,-14,37
SV Josko Rie,3967,10,8,6,22,29,59,-30,30
FC Salzburg,3968,1,22,8,6,74,33,41,74
SK Sturm Gra,3968,2,21,5,10,70,36,34,68
SC Rheindorf,3968,3,18,9,9,53,37,16,63
Vienna,3968,4,19,3,14,66,58,8,60
Rapid Vienna,3968,5,13,13,10,56,41,15,52
St. Pölten,3968,6,12,8,16,44,58,-14,44
RZ Pellets W,3968,7,11,8,17,47,68,-21,41
Admira Wacke,3968,8,10,9,17,35,54,-19,39
SV Josko Rie,3968,9,9,6,21,34,62,-28,33
Mattersburg,3968,10,7,7,22,40,72,-32,28
SK Sturm Gra,3969,1,20,7,9,60,35,25,67
FC Salzburg,3969,2,18,9,9,57,33,24,63
SC Rheindorf,3969,3,17,9,10,56,50,6,60
Vienna,3969,4,17,8,11,60,50,10,59
Rapid Vienna,3969,5,15,11,10,56,39,17,56
St. Pölten,3969,6,14,7,15,47,56,-9,49
RZ Pellets W,3969,7,12,7,17,49,59,-10,43
SV Josko Rie,3969,8,12,4,20,44,57,-13,40
Admira Wacke,3969,9,9,7,20,37,63,-26,34
Mattersburg,3969,10,7,9,20,35,59,-24,30
FC Salzburg,3970,1,23,7,6,66,25,41,76
SK Sturm Gra,3970,2,21,5,10,56,33,23,68
SC Rheindorf,3970,3,19,9,8,56,42,14,66
Vienna,3970,4,15,5,16,50,53,-3,50
Rapid Vienna,3970,5,13,10,13,50,39,11,49
SV Josko Rie,3970,6,13,5,18,39,51,-12,44
RZ Pellets W,3970,7,11,9,16,40,50,-10,42
St. Pölten,3970,8,9,12,15,46,61,-15,39
Admira Wacke,3970,9,10,6,20,34,62,-28,36
Mattersburg,3970,10,7,10,19,36,57,-21,31
FC Salzburg,3971,1,21,7,8,64,28,36,70
SK Sturm Gra,3971,2,21,6,9,71,37,34,69
Vienna,3971,3,20,5,11,68,49,19,65
SC Rheindorf,3971,4,20,5,11,53,44,9,65
Rapid Vienna,3971,5,17,10,9,64,37,27,61
Admira Wacke,3971,6,12,7,17,40,58,-18,43
RZ Pellets W,3971,7,9,9,18,42,63,-21,36
St. Pölten,3971,8,9,8,19,43,73,-30,35
SV Josko Rie,3971,9,9,5,22,37,64,-27,32
Mattersburg,3971,10,7,8,21,36,65,-29,29
SK Sturm Gra,3972,1,20,6,10,62,40,22,66
SC Rheindorf,3972,2,19,9,8,60,42,18,66
FC Salzburg,3972,3,19,8,9,64,32,32,65
Vienna,3972,4,18,5,13,56,48,8,59
Rapid Vienna,3972,5,13,8,15,52,47,5,47
Admira Wacke,3972,6,13,7,16,40,53,-13,46
St. Pölten,3972,7,12,8,16,45,59,-14,44
RZ Pellets W,3972,8,11,10,15,45,56,-11,43
SV Josko Rie,3972,9,11,5,20,32,52,-20,38
Mattersburg,3972,10,6,10,20,36,63,-27,28
SC Rheindorf,3973,1,21,8,7,67,42,25,71
FC Salzburg,3973,2,20,8,8,63,34,29,68
Vienna,3973,3,21,4,11,72,51,21,67
SK Sturm Gra,3973,4,18,8,10,59,41,18,62
Rapid Vienna,3973,5,12,12,12,53,45,8,48
RZ Pellets W,3973,6,11,9,16,45,54,-9,42
Admira Wacke,3973,7,11,8,17,41,61,-20,41
St. Pölten,3973,8,10,10,16,48,65,-17,40
SV Josko Rie,3973,9,9,6,21,34,60,-26,33
Mattersburg,3973,10,6,9,21,41,70,-29,27
FC Salzburg,3974,1,23,7,6,69,26,43,76
SK Sturm Gra,3974,2,20,5,11,60,39,21,65
SC Rheindorf,3974,3,19,7,10,55,41,14,64
Vienna,3974,4,18,6,12,64,48,16,60
RZ Pellets W,3974,5,15,6,15,47,52,-5,51
Rapid Vienna,3974,6,13,10,13,51,45,6,49
Admira Wacke,3974,7,12,7,17,36,51,-15,43
St. Pölten,3974,8,8,10,18,39,63,-24,34
Mattersburg,3974,9,9,6,21,38,65,-27,33
SV Josko Rie,3974,10,8,6,22,31,60,-29,30
FC Salzburg,3975,1,25,5,6,74,29,45,80
SC Rheindorf,3975,2,21,6,9,56,39,17,69
Vienna,3975,3,21,4,11,64,47,17,67
SK Sturm Gra,3975,4,17,10,9,54,33,21,61
RZ Pellets W,3975,5,14,7,15,48,53,-5,49
Rapid Vienna,3975,6,12,9,15,55,45,10,45
Admira Wacke,3975,7,11,4,21,37,67,-30,37
Mattersburg,3975,8,10,6,20,44,65,-21,36
St. Pölten,3975,9,9,8,19,49,73,-24,35
SV Josko Rie,3975,10,8,5,23,30,60,-30,29
FC Salzburg,3976,1,23,6,7,70,32,38,75
SK Sturm Gra,3976,2,21,7,8,60,29,31,70
SC Rheindorf,3976,3,19,6,11,49,41,8,63
Vienna,3976,4,17,6,13,59,52,7,57
Rapid Vienna,3976,5,13,9,14,53,41,12,48
SV Josko Rie,3976,6,12,6,18,41,52,-11,42
RZ Pellets W,3976,7,11,7,18,50,67,-17,40
Mattersburg,3976,8,11,7,18,47,64,-17,40
Admira Wacke,3976,9,10,7,19,35,63,-28,37
St. Pölten,3976,10,7,11,18,44,67,-23,32
FC Salzburg,3977,1,24,4,8,78,30,48,76
SC Rheindorf,3977,2,22,9,5,61,34,27,75
SK Sturm Gra,3977,3,19,6,11,64,40,24,63
Rapid Vienna,3977,4,17,9,10,55,38,17,60
Vienna,3977,5,15,7,14,53,55,-2,52
Mattersburg,3977,6,12,6,18,39,56,-17,42
RZ Pellets W,3977,7,11,5,20,39,61,-22,38
Admira Wacke,3977,8,10,6,20,37,64,-27,36
SV Josko Rie,3977,9,10,5,21,30,54,-24,35
St. Pölten,3977,10,8,7,21,37,61,-24,31
FC Salzburg,3978,1,21,6,9,67,30,37,69
SC Rheindorf,3978,2,21,6,9,59,42,17,69
SK Sturm Gra,3978,3,20,8,8,61,35,26,68
Vienna,3978,4,17,5,14,57,51,6,56
Rapid Vienna,3978,5,13,10,13,48,41,7,49
RZ Pellets W,3978,6,13,6,17,48,56,-8,45
Admira Wacke,3978,7,11,8,17,34,58,-24,41
Mattersburg,3978,8,11,7,18,43,57,-14,40
SV Josko Rie,3978,9,9,7,20,34,55,-21,34
St. Pölten,3978,10,7,11,18,37,63,-26,32
SK Sturm Gra,3979,1,22,5,9,60,33,27,71
FC Salzburg,3979,2,20,8,8,67,36,31,68
Vienna,3979,3,20,4,12,62,52,10,64
SC Rheindorf,3979,4,18,9,9,54,43,11,63
Rapid Vienna,3979,5,10,14,12,49,42,7,44
RZ Pellets W,3979,6,13,5,18,46,53,-7,44
Admira Wacke,3979,7,13,5,18,37,56,-19,44
SV Josko Rie,3979,8,11,6,19,39,53,-14,39
Mattersburg,3979,9,8,12,16,33,51,-18,36
St. Pölten,3979,10,6,10,20,35,63,-28,28
FC Salzburg,3980,1,20,9,7,65,34,31,69
SC Rheindorf,3980,2,19,9,8,60,37,23,66
SK Sturm Gra,3980,3,18,9,9,59,35,24,63
Vienna,3980,4,18,5,13,66,52,14,59
Rapid Vienna,3980,5,15,12,9,58,36,22,57
RZ Pellets W,3980,6,11,8,17,40,55,-15,41
St. Pölten,3980,7,10,10,16,43,62,-19,40
Admira Wacke,3980,8,10,7,19,31,61,-30,37
Mattersburg,3980,9,7,12,17,38,58,-20,33
SV Josko Rie,3980,10,8,7,21,29,59,-30,31
Vienna,3981,1,22,3,11,61,40,21,69
SC Rheindorf,3981,2,20,8,8,52,40,12,68
FC Salzburg,3981,3,20,7,9,64,34,30,67
SK Sturm Gra,3981,4,18,5,13,62,44,18,59
Rapid Vienna,3981,5,14,10,12,61,44,17,52
RZ Pellets W,3981,6,12,8,16,48,58,-10,44
SV Josko Rie,3981,7,12,6,18,35,49,-14,42
Admira Wacke,3981,8,10,7,19,32,55,-23,37
St. Pölten,3981,9,8,10,18,39,67,-28,34
Mattersburg,3981,10,7,10,19,39,62,-23,31
FC Salzburg,3982,1,23,6,7,63,28,35,75
SC Rheindorf,3982,2,19,8,9,56,41,15,65
SK Sturm Gra,3982,3,20,4,12,56,33,23,64
Vienna,3982,4,18,5,13,60,45,15,59
Rapid Vienna,3982,5,15,8,13,52,40,12,53
SV Josko Rie,3982,6,12,7,17,28,46,-18,43
RZ Pellets W,3982,7,11,6,19,46,60,-14,39
St. Pölten,3982,8,9,11,16,40,59,-19,38
Mattersburg,3982,9,9,8,19,38,52,-14,35
Admira Wacke,3982,10,9,7,20,28,63,-35,34
FC Salzburg,3983,1,23,6,7,75,31,44,75
Vienna,3983,2,19,5,12,64,51,13,62
Rapid Vienna,3983,3,17,9,10,54,38,16,60
SC Rheindorf,3983,4,18,5,13,54,44,10,59
SK Sturm Gra,3983,5,16,6,14,54,40,14,54
RZ Pellets W,3983,6,14,7,15,44,57,-13,49
Admira Wacke,3983,7,14,5,17,42,62,-20,47
SV Josko Rie,3983,8,11,4,21,34,53,-19,37
Mattersburg,3983,9,7,10,19,35,56,-21,31
St. Pölten,3983,10,6,13,17,39,63,-24,31
FC Salzburg,3984,1,21,8,7,69,37,32,71
SC Rheindorf,3984,2,21,7,8,59,44,15,70
SK Sturm Gra,3984,3,20,6,10,61,31,30,66
Vienna,3984,4,20,5,11,71,55,16,65
Rapid Vienna,3984,5,14,9,13,54,40,14,51
RZ Pellets W,3984,6,14,9,13,53,56,-3,51
SV Josko Rie,3984,7,11,5,20,35,52,-17,38
Mattersburg,3984,8,8,10,18,39,61,-22,34
Admira Wacke,3984,9,8,8,20,34,63,-29,32
St. Pölten,3984,10,6,7,23,35,71,-36,25
FC Salzburg,3985,1,20,7,9,67,32,35,67
SK Sturm Gra,3985,2,20,6,10,59,35,24,66
SC Rheindorf,3985,3,19,6,11,53,44,9,63
Vienna,3985,4,18,6,12,54,47,7,60
Rapid Vienna,3985,5,13,12,11,56,40,16,51
SV Josko Rie,3985,6,13,6,17,39,52,-13,45
RZ Pellets W,3985,7,10,9,17,47,63,-16,39
Mattersburg,3985,8,10,8,18,40,57,-17,38
Admira Wacke,3985,9,10,7,19,36,57,-21,37
St. Pölten,3985,10,9,9,18,40,64,-24,36
SC Rheindorf,3986,1,21,6,9,56,42,14,69
FC Salzburg,3986,2,20,7,9,66,33,33,67
SK Sturm Gra,3986,3,19,7,10,64,39,25,64
Vienna,3986,4,20,4,12,64,51,13,64
Rapid Vienna,3986,5,12,13,11,49,38,11,49
RZ Pellets W,3986,6,13,7,16,45,51,-6,46
SV Josko Rie,3986,7,14,3,19,45,53,-8,45
Mattersburg,3986,8,11,7,18,41,57,-16,40
Admira Wacke,3986,9,11,5,20,34,60,-26,38
St. Pölten,3986,10,6,7,23,28,68,-40,25
SC Rheindorf,3987,1,24,4,8,63,39,24,76
FC Salzburg,3987,2,22,4,10,65,38,27,70
SK Sturm Gra,3987,3,19,8,9,65,37,28,65
Vienna,3987,4,18,5,13,60,55,5,59
Rapid Vienna,3987,5,13,13,10,55,40,15,52
RZ Pellets W,3987,6,12,8,16,47,59,-12,44
Admira Wacke,3987,7,11,6,19,41,61,-20,39
St. Pölten,3987,8,7,13,16,45,67,-22,34
SV Josko Rie,3987,9,9,6,21,36,54,-18,33
Mattersburg,3987,10,8,7,21,36,63,-27,31
FC Salzburg,3988,1,22,7,7,67,31,36,73
SK Sturm Gra,3988,2,21,4,11,63,38,25,67
SC Rheindorf,3988,3,19,7,10,54,45,9,64
Vienna,3988,4,18,6,12,61,51,10,60
Rapid Vienna,3988,5,12,10,14,48,47,1,46
RZ Pellets W,3988,6,13,7,16,49,57,-8,46
Admira Wacke,3988,7,13,6,17,38,57,-19,45
Mattersburg,3988,8,11,8,17,46,49,-3,41
SV Josko Rie,3988,9,10,3,23,27,52,-25,33
St. Pölten,3988,10,8,8,20,39,65,-26,32
FC Salzburg,3989,1,20,9,7,62,27,35,69
Vienna,3989,2,21,4,11,72,53,19,67
SK Sturm Gra,3989,3,19,6,11,61,39,22,63
SC Rheindorf,3989,4,17,9,10,45,37,8,60
Rapid Vienna,3989,5,16,9,11,54,43,11,57
SV Josko Rie,3989,6,13,3,20,34,47,-13,42
RZ Pellets W,3989,7,11,7,18,40,57,-17,40
Admira Wacke,3989,8,10,8,18,39,60,-21,38
Mattersburg,3989,9,9,8,19,31,54,-23,35
St. Pölten,3989,10,9,7,20,36,57,-21,34
FC Salzburg,3990,1,21,8,7,65,31,34,71
SC Rheindorf,3990,2,21,6,9,65,45,20,69
SK Sturm Gra,3990,3,17,8,11,58,39,19,59
Rapid Vienna,3990,4,15,10,11,48,33,15,55
Vienna,3990,5,17,4,15,64,58,6,55
Admira Wacke,3990,6,11,8,17,37,60,-23,41
RZ Pellets W,3990,7,10,10,16,44,55,-11,40
Mattersburg,3990,8,10,8,18,37,56,-19,38
SV Josko Rie,3990,9,10,7,19,38,60,-22,37
St. Pölten,3990,10,8,11,17,38,57,-19,35
FC Salzburg,3991,1,23,8,5,70,29,41,77
SK Sturm Gra,3991,2,19,6,11,57,32,25,63
SC Rheindorf,3991,3,17,10,9,53,41,12,61
Vienna,3991,4,18,7,11,58,47,11,61
Rapid Vienna,3991,5,12,13,11,51,40,11,49
RZ Pellets W,3991,6,11,8,17,40,55,-15,41
Admira Wacke,3991,7,11,8,17,38,57,-19,41
SV Josko Rie,3991,8,10,7,19,36,55,-19,37
St. Pölten,3991,9,7,12,17,40,65,-25,33
Mattersburg,3991,10,7,11,18,34,56,-22,32
FC Salzburg,3992,1,20,12,4,64,29,35,72
SK Sturm Gra,3992,2,19,6,11,52,34,18,63
SC Rheindorf,3992,3,17,9,10,52,41,11,60
Vienna,3992,4,16,8,12,59,56,3,56
Rapid Vienna,3992,5,12,12,12,53,44,9,48
RZ Pellets W,3992,6,12,7,17,44,53,-9,43
SV Josko Rie,3992,7,11,9,16,36,48,-12,42
Admira Wacke,3992,8,12,6,18,35,54,-19,42
St. Pölten,3992,9,10,8,18,44,61,-17,38
Mattersburg,3992,10,8,9,19,38,57,-19,33
FC Salzburg,3993,1,23,8,5,73,28,45,77
SC Rheindorf,3993,2,21,8,7,62,41,21,71
SK Sturm Gra,3993,3,18,7,11,58,33,25,61
Vienna,3993,4,19,3,14,66,61,5,60
RZ Pellets W,3993,5,14,6,16,51,55,-4,48
Rapid Vienna,3993,6,11,12,13,53,47,6,45
SV Josko Rie,3993,7,11,5,20,41,61,-20,38
Mattersburg,3993,8,10,7,19,38,55,-17,37
St. Pölten,3993,9,10,7,19,42,66,-24,37
Admira Wacke,3993,10,8,7,21,33,70,-37,31
SC Rheindorf,3994,1,22,7,7,62,42,20,73
SK Sturm Gra,3994,2,22,6,8,61,35,26,72
FC Salzburg,3994,3,20,8,8,59,28,31,68
Vienna,3994,4,17,5,14,58,51,7,56
Rapid Vienna,3994,5,15,9,12,56,41,15,54
Admira Wacke,3994,6,13,6,17,40,61,-21,45
RZ Pellets W,3994,7,10,11,15,40,50,-10,41
SV Josko Rie,3994,8,9,7,20,35,56,-21,34
St. Pölten,3994,9,6,11,19,37,60,-23,29
Mattersburg,3994,10,7,8,21,36,60,-24,29
FC Salzburg,3995,1,20,9,7,67,32,35,69
SC Rheindorf,3995,2,19,9,8,50,38,12,66
SK Sturm Gra,3995,3,20,5,11,65,38,27,65
Vienna,3995,4,16,7,13,59,55,4,55
Rapid Vienna,3995,5,13,11,12,54,43,11,50
Admira Wacke,3995,6,13,7,16,39,57,-18,46
RZ Pellets W,3995,7,12,6,18,44,61,-17,42
Mattersburg,3995,8,11,8,17,44,54,-10,41
SV Josko Rie,3995,9,12,4,20,36,51,-15,40
St. Pölten,3995,10,7,8,21,40,69,-29,29
Vienna,3996,1,22,4,10,72,56,16,70
FC Salzburg,3996,2,21,5,10,67,36,31,68
SC Rheindorf,3996,3,18,11,7,57,42,15,65
SK Sturm Gra,3996,4,17,10,9,62,37,25,61
Rapid Vienna,3996,5,14,9,13,61,46,15,51
SV Josko Rie,3996,6,12,4,20,38,57,-19,40
RZ Pellets W,3996,7,10,9,17,47,64,-17,39
Mattersburg,3996,8,10,8,18,43,57,-14,38
Admira Wacke,3996,9,10,6,20,34,60,-26,36
St. Pölten,3996,10,8,10,18,45,71,-26,34
FC Salzburg,3997,1,23,6,7,70,32,38,75
SC Rheindorf,3997,2,19,9,8,54,41,13,66
Vienna,3997,3,19,4,13,70,59,11,61
SK Sturm Gra,3997,4,17,8,11,56,38,18,59
RZ Pellets W,3997,5,14,8,14,48,49,-1,50
Rapid Vienna,3997,6,12,12,12,53,43,10,48
SV Josko Rie,3997,7,11,6,19,31,48,-17,39
St. Pölten,3997,8,10,9,17,40,60,-20,39
Admira Wacke,3997,9,10,5,21,33,65,-32,35
Mattersburg,3997,10,7,9,20,34,54,-20,30
FC Salzburg,3998,1,19,8,9,59,29,30,65
SC Rheindorf,3998,2,18,10,8,60,45,15,64
SK Sturm Gra,3998,3,18,7,11,60,36,24,61
Vienna,3998,4,17,4,15,64,54,10,55
Rapid Vienna,3998,5,13,10,13,58,44,14,49
Admira Wacke,3998,6,12,9,15,32,59,-27,45
RZ Pellets W,3998,7,11,11,14,51,59,-8,44
SV Josko Rie,3998,8,12,7,17,33,47,-14,43
St. Pölten,3998,9,9,11,16,41,65,-24,38
Mattersburg,3998,10,7,11,18,34,54,-20,32
FC Salzburg,3999,1,23,7,6,70,31,39,76
SK Sturm Gra,3999,2,20,6,10,63,39,24,66
SC Rheindorf,3999,3,18,7,11,58,53,5,61
Vienna,3999,4,17,9,10,63,51,12,60
Rapid Vienna,3999,5,13,11,12,56,46,10,50
RZ Pellets W,3999,6,13,9,14,49,52,-3,48
Admira Wacke,3999,7,12,9,15,39,53,-14,45
SV Josko Rie,3999,8,10,6,20,33,55,-22,36
St. Pölten,3999,9,7,9,20,44,68,-24,30
Mattersburg,3999,10,6,9,21,31,58,-27,27
FC Salzburg,4000,1,21,8,7,67,33,34,71
SK Sturm Gra,4000,2,22,3,11,62,34,28,69
SC Rheindorf,4000,3,19,7,10,57,44,13,64
Vienna,4000,4,17,5,14,60,55,5,56
Rapid Vienna,4000,5,13,13,10,55,38,17,52
Admira Wacke,4000,6,12,7,17,43,59,-16,43
SV Josko Rie,4000,7,12,6,18,31,48,-17,42
RZ Pellets W,4000,8,11,5,20,40,55,-15,38
Mattersburg,4000,9,8,10,18,32,56,-24,34
St. Pölten,4000,10,7,12,17,36,61,-25,33
FC Salzburg,4001,1,19,10,7,64,30,34,67
SC Rheindorf,4001,2,19,9,8,59,44,15,66
SK Sturm Gra,4001,3,19,8,9,60,33,27,65
Vienna,4001,4,19,3,14,73,64,9,60
Rapid Vienna,4001,5,14,11,11,58,38,20,53
RZ Pellets W,4001,6,14,7,15,46,52,-6,49
SV Josko Rie,4001,7,10,7,19,35,51,-16,37
Mattersburg,4001,8,9,8,19,41,61,-20,35
St. Pölten,4001,9,8,11,17,39,65,-26,35
Admira Wacke,4001,10,10,4,22,33,70,-37,34
FC Salzburg,4002,1,24,6,6,68,29,39,78
SK Sturm Gra,4002,2,21,7,8,60,31,29,70
SC Rheindorf,4002,3,18,7,11,58,43,15,61
Vienna,4002,4,17,7,12,61,50,11,58
Rapid Vienna,4002,5,16,9,11,59,42,17,57
Admira Wacke,4002,6,11,7,18,37,56,-19,40
RZ Pellets W,4002,7,10,7,19,48,62,-14,37
SV Josko Rie,4002,8,11,4,21,32,59,-27,37
Mattersburg,4002,9,9,8,19,36,54,-18,35
St. Pölten,4002,10,7,10,19,38,71,-33,31
FC Salzburg,4003,1,20,9,7,69,30,39,69
SC Rheindorf,4003,2,20,7,9,52,38,14,67
SK Sturm Gra,4003,3,19,7,10,62,34,28,64
Vienna,4003,4,17,5,14,63,61,2,56
Rapid Vienna,4003,5,14,10,12,53,39,14,52
RZ Pellets W,4003,6,14,5,17,52,64,-12,47
SV Josko Rie,4003,7,12,5,19,35,53,-18,41
St. Pölten,4003,8,9,11,16,40,58,-18,38
Admira Wacke,4003,9,11,5,20,39,67,-28,38
Mattersburg,4003,10,8,8,20,38,59,-21,32
FC Salzburg,4004,1,20,7,9,69,33,36,67
SK Sturm Gra,4004,2,19,8,9,59,37,22,65
Vienna,4004,3,20,3,13,65,46,19,63
Rapid Vienna,4004,4,16,12,8,66,36,30,60
SC Rheindorf,4004,5,17,9,10,49,43,6,60
RZ Pellets W,4004,6,12,7,17,39,54,-15,43
SV Josko Rie,4004,7,11,6,19,32,49,-17,39
Admira Wacke,4004,8,11,6,19,32,63,-31,39
Mattersburg,4004,9,9,9,18,37,56,-19,36
St. Pölten,4004,10,6,11,19,29,60,-31,29
FC Salzburg,4005,1,22,7,7,76,36,40,73
SK Sturm Gra,4005,2,21,6,9,60,34,26,69
SC Rheindorf,4005,3,19,5,12,49,44,5,62
Vienna,4005,4,19,3,14,65,58,7,60
Rapid Vienna,4005,5,15,10,11,59,41,18,55
RZ Pellets W,4005,6,15,8,13,57,52,5,53
Mattersburg,4005,7,10,8,18,31,53,-22,38
Admira Wacke,4005,8,10,6,20,34,58,-24,36
SV Josko Rie,4005,9,8,6,22,29,56,-27,30
St. Pölten,4005,10,7,9,20,40,68,-28,30
FC Salzburg,4006,1,25,5,6,70,33,37,80
SK Sturm Gra,4006,2,19,5,12,59,39,20,62
Vienna,4006,3,19,4,13,67,55,12,61
SC Rheindorf,4006,4,16,11,9,53,41,12,59
Rapid Vienna,4006,5,14,9,13,62,47,15,51
Admira Wacke,4006,6,11,10,15,39,56,-17,43
St. Pölten,4006,7,9,12,15,49,66,-17,39
RZ Pellets W,4006,8,10,8,18,44,59,-15,38
Mattersburg,4006,9,9,11,16,40,59,-19,38
SV Josko Rie,4006,10,7,7,22,35,63,-28,28
SC Rheindorf,4007,1,20,10,6,54,37,17,70
FC Salzburg,4007,2,17,11,8,60,32,28,62
SK Sturm Gra,4007,3,18,8,10,54,37,17,62
Vienna,4007,4,16,6,14,66,50,16,54
Rapid Vienna,4007,5,14,11,11,54,38,16,53
Admira Wacke,4007,6,12,10,14,44,57,-13,46
RZ Pellets W,4007,7,11,10,15,44,56,-12,43
SV Josko Rie,4007,8,11,6,19,33,49,-16,39
St. Pölten,4007,9,8,12,16,33,57,-24,36
Mattersburg,4007,10,7,8,21,33,62,-29,29
FC Salzburg,4008,1,25,5,6,82,30,52,80
SK Sturm Gra,4008,2,23,3,10,72,37,35,72
SC Rheindorf,4008,3,20,10,6,59,38,21,70
Vienna,4008,4,16,4,16,55,67,-12,52
Rapid Vienna,4008,5,13,11,12,55,43,12,50
Admira Wacke,4008,6,11,7,18,37,60,-23,40
SV Josko Rie,4008,7,10,8,18,40,55,-15,38
RZ Pellets W,4008,8,9,9,18,41,58,-17,36
St. Pölten,4008,9,9,7,20,38,70,-32,34
Mattersburg,4008,10,8,8,20,37,58,-21,32
SC Rheindorf,4009,1,22,6,8,61,42,19,72
FC Salzburg,4009,2,20,8,8,61,29,32,68
SK Sturm Gra,4009,3,20,7,9,69,40,29,67
Vienna,4009,4,17,7,12,59,52,7,58
Rapid Vienna,4009,5,15,11,10,54,36,18,56
Admira Wacke,4009,6,11,8,17,35,54,-19,41
SV Josko Rie,4009,7,11,7,18,37,52,-15,40
Mattersburg,4009,8,8,11,17,38,55,-17,35
RZ Pellets W,4009,9,9,6,21,42,68,-26,33
St. Pölten,4009,10,7,9,20,34,62,-28,30
FC Salzburg,4010,1,23,5,8,67,32,35,74
SC Rheindorf,4010,2,18,10,8,57,44,13,64
SK Sturm Gra,4010,3,17,8,11,56,33,23,59
Rapid Vienna,4010,4,15,11,10,57,38,19,56
Vienna,4010,5,15,6,15,59,61,-2,51
RZ Pellets W,4010,6,13,6,17,46,58,-12,45
Admira Wacke,4010,7,12,8,16,42,56,-14,44
Mattersburg,4010,8,10,10,16,45,60,-15,40
SV Josko Rie,4010,9,10,7,19,37,57,-20,37
St. Pölten,4010,10,8,7,21,46,73,-27,31
FC Salzburg,4011,1,21,8,7,68,34,34,71
SC Rheindorf,4011,2,20,6,10,55,43,12,66
SK Sturm Gra,4011,3,19,7,10,57,34,23,64
Rapid Vienna,4011,4,18,7,11,61,39,22,61
Vienna,4011,5,18,7,11,57,47,10,61
SV Josko Rie,4011,6,13,6,17,44,58,-14,45
RZ Pellets W,4011,7,11,8,17,43,59,-16,41
St. Pölten,4011,8,7,13,16,40,59,-19,34
Admira Wacke,4011,9,9,6,21,35,63,-28,33
Mattersburg,4011,10,5,10,21,36,60,-24,25
FC Salzburg,4012,1,20,6,10,65,35,30,66
SK Sturm Gra,4012,2,19,8,9,68,36,32,65
SC Rheindorf,4012,3,18,10,8,56,42,14,64
Vienna,4012,4,16,6,14,60,58,2,54
Rapid Vienna,4012,5,11,13,12,58,48,10,46
SV Josko Rie,4012,6,13,7,16,41,54,-13,46
RZ Pellets W,4012,7,11,10,15,51,64,-13,43
St. Pölten,4012,8,11,10,15,50,66,-16,43
Admira Wacke,4012,9,10,9,17,33,57,-24,39
Mattersburg,4012,10,7,9,20,35,57,-22,30
SK Sturm Gra,4013,1,24,5,7,71,27,44,77
FC Salzburg,4013,2,24,5,7,70,29,41,77
SC Rheindorf,4013,3,18,7,11,51,45,6,61
Rapid Vienna,4013,4,14,13,9,51,38,13,55
Vienna,4013,5,17,4,15,66,57,9,55
RZ Pellets W,4013,6,13,7,16,43,55,-12,46
Mattersburg,4013,7,10,7,19,42,56,-14,37
St. Pölten,4013,8,9,8,19,42,66,-24,35
Admira Wacke,4013,9,9,8,19,33,63,-30,35
SV Josko Rie,4013,10,7,6,23,24,57,-33,27
SC Rheindorf,4014,1,22,7,7,63,40,23,73
FC Salzburg,4014,2,18,9,9,59,33,26,63
SK Sturm Gra,4014,3,19,5,12,55,34,21,62
Vienna,4014,4,16,6,14,57,56,1,54
Rapid Vienna,4014,5,13,11,12,50,37,13,50
St. Pölten,4014,6,12,9,15,56,68,-12,45
Admira Wacke,4014,7,13,5,18,40,59,-19,44
Mattersburg,4014,8,9,13,14,42,53,-11,40
RZ Pellets W,4014,9,9,8,19,38,58,-20,35
SV Josko Rie,4014,10,9,7,20,35,57,-22,34
FC Salzburg,4015,1,22,8,6,72,35,37,74
SK Sturm Gra,4015,2,19,8,9,57,30,27,65
SC Rheindorf,4015,3,19,8,9,57,42,15,65
Rapid Vienna,4015,4,14,12,10,55,39,16,54
Vienna,4015,5,15,9,12,61,59,2,54
RZ Pellets W,4015,6,12,9,15,44,54,-10,45
SV Josko Rie,4015,7,11,5,20,41,57,-16,38
St. Pölten,4015,8,8,11,17,43,63,-20,35
Mattersburg,4015,9,9,8,19,41,61,-20,35
Admira Wacke,4015,10,8,8,20,31,62,-31,32
SC Rheindorf,4016,1,20,9,7,56,40,16,69
SK Sturm Gra,4016,2,20,6,10,68,37,31,66
Vienna,4016,3,21,3,12,65,47,18,66
FC Salzburg,4016,4,17,10,9,59,33,26,61
RZ Pellets W,4016,5,16,7,13,56,47,9,55
Rapid Vienna,4016,6,11,11,14,56,53,3,44
Admira Wacke,4016,7,12,6,18,33,62,-29,42
Mattersburg,4016,8,8,10,18,34,56,-22,34
St. Pölten,4016,9,7,11,18,36,60,-24,32
SV Josko Rie,4016,10,7,9,20,28,56,-28,30
Vienna,4017,1,21,6,9,69,48,21,69
FC Salzburg,4017,2,19,6,11,63,37,26,63
Rapid Vienna,4017,3,17,10,9,62,37,25,61
SC Rheindorf,4017,4,17,7,12,53,43,10,58
SK Sturm Gra,4017,5,14,8,14,49,48,1,50
Mattersburg,4017,6,13,9,14,43,46,-3,48
RZ Pellets W,4017,7,13,9,14,46,54,-8,48
Admira Wacke,4017,8,10,8,18,35,60,-25,38
St. Pölten,4017,9,9,10,17,44,62,-18,37
SV Josko Rie,4017,10,7,7,22,28,57,-29,28
SK Sturm Gra,4018,1,21,6,9,61,33,28,69
FC Salzburg,4018,2,19,11,6,60,27,33,68
SC Rheindorf,4018,3,18,5,13,52,48,4,59
Vienna,4018,4,16,7,13,62,59,3,55
Rapid Vienna,4018,5,13,12,11,57,40,17,51
Admira Wacke,4018,6,15,6,15,45,55,-10,51
RZ Pellets W,4018,7,13,6,17,49,65,-16,45
SV Josko Rie,4018,8,12,5,19,39,53,-14,41
Mattersburg,4018,9,8,10,18,34,55,-21,34
St. Pölten,4018,10,8,6,22,39,63,-24,30
FC Salzburg,4019,1,21,10,5,67,28,39,73
SC Rheindorf,4019,2,18,12,6,59,44,15,66
SK Sturm Gra,4019,3,18,7,11,59,37,22,61
Vienna,4019,4,19,3,14,62,52,10,60
Rapid Vienna,4019,5,14,11,11,50,42,8,53
RZ Pellets W,4019,6,12,6,18,47,60,-13,42
Admira Wacke,4019,7,11,6,19,33,60,-27,39
SV Josko Rie,4019,8,10,7,19,37,49,-12,37
Mattersburg,4019,9,8,10,18,35,52,-17,34
St. Pölten,4019,10,8,10,18,39,64,-25,34
SK Sturm Gra,4020,1,24,3,9,65,28,37,75
FC Salzburg,4020,2,22,6,8,62,27,35,72
SC Rheindorf,4020,3,20,8,8,52,38,14,68
Vienna,4020,4,17,5,14,60,48,12,56
Rapid Vienna,4020,5,13,10,13,54,44,10,49
Admira Wacke,4020,6,12,7,17,40,61,-21,43
SV Josko Rie,4020,7,11,5,20,30,50,-20,38
St. Pölten,4020,8,10,7,19,38,65,-27,37
RZ Pellets W,4020,9,9,7,20,45,62,-17,34
Mattersburg,4020,10,8,10,18,34,57,-23,34
FC Salzburg,4021,1,24,7,5,71,28,43,79
SK Sturm Gra,4021,2,17,7,12,56,40,16,58
Vienna,4021,3,17,7,12,59,45,14,58
SC Rheindorf,4021,4,16,8,12,49,52,-3,56
Rapid Vienna,4021,5,14,11,11,55,37,18,53
Admira Wacke,4021,6,14,5,17,35,52,-17,47
RZ Pellets W,4021,7,12,7,17,46,50,-4,43
SV Josko Rie,4021,8,11,7,18,30,46,-16,40
St. Pölten,4021,9,9,8,19,49,70,-21,35
Mattersburg,4021,10,8,9,19,32,62,-30,33
FC Salzburg,4022,1,22,7,7,65,32,33,73
SK Sturm Gra,4022,2,22,5,9,65,35,30,71
SC Rheindorf,4022,3,18,6,12,54,46,8,60
Vienna,4022,4,17,4,15,55,48,7,55
Rapid Vienna,4022,5,14,10,12,57,39,18,52
RZ Pellets W,4022,6,12,11,13,50,52,-2,47
Admira Wacke,4022,7,12,8,16,41,58,-17,44
SV Josko Rie,4022,8,12,6,18,38,55,-17,42
Mattersburg,4022,9,7,10,19,33,58,-25,31
St. Pölten,4022,10,6,9,21,37,72,-35,27
SC Rheindorf,4023,1,20,10,6,61,38,23,70
SK Sturm Gra,4023,2,20,7,9,63,38,25,67
FC Salzburg,4023,3,19,9,8,62,33,29,66
Rapid Vienna,4023,4,15,10,11,62,41,21,55
Vienna,4023,5,15,7,14,61,65,-4,52
RZ Pellets W,4023,6,14,7,15,50,54,-4,49
Admira Wacke,4023,7,10,7,19,31,55,-24,37
SV Josko Rie,4023,8,9,9,18,42,62,-20,36
St. Pölten,4023,9,8,11,17,42,62,-20,35
Mattersburg,4023,10,6,11,19,36,62,-26,29
SK Sturm Gra,4024,1,20,7,9,58,31,27,67
FC Salzburg,4024,2,19,9,8,64,30,34,66
SC Rheindorf,4024,3,17,11,8,51,42,9,62
Vienna,4024,4,18,7,11,57,43,14,61
Rapid Vienna,4024,5,13,12,11,55,43,12,51
RZ Pellets W,4024,6,12,10,14,48,54,-6,46
SV Josko Rie,4024,7,11,8,17,36,49,-13,41
Admira Wacke,4024,8,10,7,19,32,60,-28,37
Mattersburg,4024,9,6,13,17,33,54,-21,31
St. Pölten,4024,10,5,14,17,38,66,-28,29
FC Salzburg,4025,1,20,8,8,62,31,31,68
SC Rheindorf,4025,2,19,10,7,54,36,18,67
Vienna,4025,3,20,6,10,68,58,10,66
SK Sturm Gra,4025,4,17,9,10,59,32,27,60
RZ Pellets W,4025,5,15,10,11,50,47,3,55
Rapid Vienna,4025,6,14,11,11,55,36,19,53
Admira Wacke,4025,7,11,5,20,35,64,-29,38
Mattersburg,4025,8,9,7,20,38,57,-19,34
St. Pölten,4025,9,8,9,19,38,66,-28,33
SV Josko Rie,4025,10,7,5,24,34,66,-32,26
FC Salzburg,4026,1,22,8,6,68,24,44,74
SK Sturm Gra,4026,2,21,3,12,61,35,26,66
SC Rheindorf,4026,3,17,8,11,56,46,10,59
Vienna,4026,4,19,2,15,63,54,9,59
Rapid Vienna,4026,5,15,11,10,54,37,17,56
RZ Pellets W,4026,6,11,9,16,44,62,-18,42
Admira Wacke,4026,7,12,3,21,38,64,-26,39
Mattersburg,4026,8,9,11,16,34,53,-19,38
SV Josko Rie,4026,9,11,4,21,38,57,-19,37
St. Pölten,4026,10,8,11,17,34,58,-24,35
SC Rheindorf,4027,1,20,6,10,55,43,12,66
Vienna,4027,2,20,5,11,66,53,13,65
FC Salzburg,4027,3,19,7,10,68,37,31,64
SK Sturm Gra,4027,4,19,7,10,61,36,25,64
Rapid Vienna,4027,5,17,11,8,68,40,28,62
Admira Wacke,4027,6,11,9,16,37,57,-20,42
RZ Pellets W,4027,7,12,5,19,47,61,-14,41
Mattersburg,4027,8,10,8,18,37,57,-20,38
St. Pölten,4027,9,9,8,19,43,71,-28,35
SV Josko Rie,4027,10,7,6,23,28,55,-27,27
SC Rheindorf,4028,1,23,6,7,58,38,20,75
FC Salzburg,4028,2,21,8,7,64,29,35,71
SK Sturm Gra,4028,3,18,8,10,51,28,23,62
Vienna,4028,4,17,5,14,54,51,3,56
Rapid Vienna,4028,5,13,13,10,56,42,14,52
Admira Wacke,4028,6,14,5,17,41,55,-14,47
RZ Pellets W,4028,7,9,10,17,35,50,-15,37
St. Pölten,4028,8,10,7,19,41,64,-23,37
Mattersburg,4028,9,7,12,17,33,56,-23,33
SV Josko Rie,4028,10,9,4,23,34,54,-20,31
SC Rheindorf,4029,1,21,7,8,57,37,20,70
FC Salzburg,4029,2,20,8,8,59,27,32,68
SK Sturm Gra,4029,3,19,7,10,51,30,21,64
Vienna,4029,4,18,5,13,64,55,9,59
Rapid Vienna,4029,5,14,9,13,55,45,10,51
RZ Pellets W,4029,6,14,7,15,52,51,1,49
Admira Wacke,4029,7,11,8,17,34,54,-20,41
St. Pölten,4029,8,10,10,16,46,63,-17,40
SV Josko Rie,4029,9,9,7,20,31,53,-22,34
Mattersburg,4029,10,6,8,22,33,67,-34,26
SC Rheindorf,4030,1,21,8,7,60,37,23,71
FC Salzburg,4030,2,20,7,9,61,28,33,67
SK Sturm Gra,4030,3,20,5,11,62,41,21,65
Rapid Vienna,4030,4,16,10,10,59,41,18,58
Vienna,4030,5,18,3,15,55,51,4,57
SV Josko Rie,4030,6,16,3,17,48,57,-9,51
Admira Wacke,4030,7,11,6,19,38,60,-22,39
RZ Pellets W,4030,8,10,7,19,40,60,-20,37
St. Pölten,4030,9,7,12,17,38,57,-19,33
Mattersburg,4030,10,5,11,20,31,60,-29,26
FC Salzburg,4031,1,21,7,8,60,30,30,70
SK Sturm Gra,4031,2,21,5,10,63,31,32,68
SC Rheindorf,4031,3,21,5,10,57,45,12,68
Vienna,4031,4,20,5,11,61,43,18,65
Rapid Vienna,4031,5,10,13,13,51,43,8,43
RZ Pellets W,4031,6,12,7,17,49,61,-12,43
Admira Wacke,4031,7,11,8,17,36,57,-21,41
SV Josko Rie,4031,8,11,5,20,35,57,-22,38
Mattersburg,4031,9,9,9,18,42,60,-18,36
St. Pölten,4031,10,8,8,20,36,63,-27,32
FC Salzburg,4032,1,22,5,9,74,31,43,71
SC Rheindorf,4032,2,20,8,8,52,40,12,68
SK Sturm Gra,4032,3,17,7,12,58,40,18,58
Rapid Vienna,4032,4,16,10,10,52,36,16,58
Vienna,4032,5,17,5,14,61,57,4,56
Admira Wacke,4032,6,15,5,16,36,50,-14,50
RZ Pellets W,4032,7,11,8,17,43,56,-13,41
St. Pölten,4032,8,10,9,17,43,57,-14,39
SV Josko Rie,4032,9,10,4,22,34,56,-22,34
Mattersburg,4032,10,7,9,20,34,64,-30,30
FC Salzburg,4033,1,19,9,8,64,35,29,66
Vienna,4033,2,18,7,11,61,49,12,61
SC Rheindorf,4033,3,18,6,12,53,46,7,60
SK Sturm Gra,4033,4,16,10,10,61,43,18,58
Rapid Vienna,4033,5,15,12,9,65,43,22,57
Admira Wacke,4033,6,13,7,16,44,56,-12,46
RZ Pellets W,4033,7,11,12,13,48,59,-11,45
Mattersburg,4033,8,8,11,17,38,56,-18,35
SV Josko Rie,4033,9,10,4,22,37,56,-19,34
St. Pölten,4033,10,8,10,18,37,65,-28,34
SC Rheindorf,4034,1,24,6,6,58,37,21,78
FC Salzburg,4034,2,21,7,8,67,33,34,70
Rapid Vienna,4034,3,17,10,9,64,43,21,61
SK Sturm Gra,4034,4,18,7,11,51,34,17,61
Vienna,4034,5,18,6,12,69,55,14,60
SV Josko Rie,4034,6,11,6,19,38,58,-20,39
RZ Pellets W,4034,7,10,7,19,39,58,-19,37
Admira Wacke,4034,8,9,8,19,39,65,-26,35
Mattersburg,4034,9,8,8,20,41,59,-18,32
St. Pölten,4034,10,8,7,21,41,65,-24,31
FC Salzburg,4035,1,21,8,7,69,31,38,71
Vienna,4035,2,20,7,9,66,51,15,67
SC Rheindorf,4035,3,19,9,8,59,50,9,66
SK Sturm Gra,4035,4,15,11,10,51,31,20,56
Rapid Vienna,4035,5,13,10,13,52,39,13,49
RZ Pellets W,4035,6,11,11,14,47,53,-6,44
Admira Wacke,4035,7,10,9,17,36,53,-17,39
St. Pölten,4035,8,6,18,12,42,57,-15,36
SV Josko Rie,4035,9,8,8,20,32,57,-25,32
Mattersburg,4035,10,8,7,21,36,68,-32,31
FC Salzburg,4036,1,22,8,6,70,30,40,74
SC Rheindorf,4036,2,21,6,9,54,38,16,69
SK Sturm Gra,4036,3,20,5,11,61,34,27,65
Vienna,4036,4,17,8,11,65,54,11,59
RZ Pellets W,4036,5,17,6,13,49,48,1,57
Rapid Vienna,4036,6,14,11,11,66,50,16,53
Mattersburg,4036,7,9,9,18,40,59,-19,36
Admira Wacke,4036,8,10,4,22,33,65,-32,34
SV Josko Rie,4036,9,8,7,21,34,56,-22,31
St. Pölten,4036,10,7,6,23,39,77,-38,27
SK Sturm Gra,4037,1,22,7,7,65,29,36,73
FC Salzburg,4037,2,20,6,10,65,36,29,66
SC Rheindorf,4037,3,18,9,9,55,40,15,63
Vienna,4037,4,17,7,12,58,52,6,58
Rapid Vienna,4037,5,14,12,10,58,39,19,54
SV Josko Rie,4037,6,13,5,18,39,53,-14,44
RZ Pellets W,4037,7,11,7,18,48,62,-14,40
Admira Wacke,4037,8,11,5,20,37,66,-29,38
Mattersburg,4037,9,9,8,19,34,56,-22,35
St. Pölten,4037,10,6,12,18,35,61,-26,30
FC Salzburg,4038,1,23,6,7,66,30,36,75
SC Rheindorf,4038,2,21,8,7,59,37,22,71
Vienna,4038,3,18,6,12,63,56,7,60
SK Sturm Gra,4038,4,17,4,15,58,43,15,55
RZ Pellets W,4038,5,14,9,13,48,53,-5,51
Rapid Vienna,4038,6,14,8,14,61,47,14,50
SV Josko Rie,4038,7,12,7,17,38,49,-11,43
St. Pölten,4038,8,10,8,18,44,67,-23,38
Admira Wacke,4038,9,9,5,22,31,62,-31,32
Mattersburg,4038,10,8,7,21,44,68,-24,31
SC Rheindorf,4039,1,20,8,8,57,40,17,68
FC Salzburg,4039,2,20,7,9,66,31,35,67
SK Sturm Gra,4039,3,19,8,9,61,37,24,65
Vienna,4039,4,18,8,10,62,46,16,62
Admira Wacke,4039,5,15,7,14,50,61,-11,52
Rapid Vienna,4039,6,13,11,12,56,40,16,50
RZ Pellets W,4039,7,12,6,18,52,60,-8,42
St. Pölten,4039,8,9,9,18,42,69,-27,36
SV Josko Rie,4039,9,9,6,21,34,62,-28,33
Mattersburg,4039,10,6,8,22,34,68,-34,26
SC Rheindorf,4040,1,20,11,5,53,31,22,71
FC Salzburg,4040,2,19,6,11,67,39,28,63
SK Sturm Gra,4040,3,18,9,9,59,36,23,63
Vienna,4040,4,18,6,12,62,48,14,60
Rapid Vienna,4040,5,15,11,10,59,45,14,56
RZ Pellets W,4040,6,10,10,16,47,60,-13,40
Mattersburg,4040,7,10,9,17,36,56,-20,39
Admira Wacke,4040,8,10,8,18,44,67,-23,38
SV Josko Rie,4040,9,9,8,19,32,55,-23,35
St. Pölten,4040,10,6,12,18,40,62,-22,30
SK Sturm Gra,4041,1,23,6,7,65,29,36,75
FC Salzburg,4041,2,19,10,7,61,30,31,67
SC Rheindorf,4041,3,19,6,11,53,45,8,63
Vienna,4041,4,18,5,13,62,55,7,59
Rapid Vienna,4041,5,13,10,13,52,40,12,49
RZ Pellets W,4041,6,11,9,16,45,58,-13,42
Mattersburg,4041,7,9,11,16,40,49,-9,38
St. Pölten,4041,8,9,10,17,40,60,-20,37
Admira Wacke,4041,9,10,7,19,32,54,-22,37
SV Josko Rie,4041,10,9,6,21,31,61,-30,33
FC Salzburg,4042,1,22,7,7,70,30,40,73
SC Rheindorf,4042,2,20,8,8,63,44,19,68
Vienna,4042,3,22,2,12,69,58,11,68
SK Sturm Gra,4042,4,19,5,12,64,38,26,62
Rapid Vienna,4042,5,14,11,11,60,41,19,53
RZ Pellets W,4042,6,13,8,15,48,58,-10,47
Admira Wacke,4042,7,12,7,17,38,63,-25,43
Mattersburg,4042,8,9,6,21,40,70,-30,33
SV Josko Rie,4042,9,9,4,23,35,62,-27,31
St. Pölten,4042,10,7,8,21,44,67,-23,29
Vienna,4043,1,23,3,10,67,49,18,72
FC Salzburg,4043,2,20,9,7,66,33,33,69
SK Sturm Gra,4043,3,20,7,9,64,36,28,67
SC Rheindorf,4043,4,18,7,11,50,40,10,61
Rapid Vienna,4043,5,16,8,12,64,42,22,56
RZ Pellets W,4043,6,13,10,13,54,57,-3,49
Admira Wacke,4043,7,10,5,21,41,68,-27,35
SV Josko Rie,4043,8,9,7,20,33,54,-21,34
St. Pölten,4043,9,7,12,17,35,63,-28,33
Mattersburg,4043,10,7,6,23,32,64,-32,27
FC Salzburg,4044,1,22,7,7,65,35,30,73
SK Sturm Gra,4044,2,20,8,8,66,34,32,68
SC Rheindorf,4044,3,19,7,10,61,44,17,64
Vienna,4044,4,15,8,13,60,56,4,53
Admira Wacke,4044,5,14,6,16,41,56,-15,48
Rapid Vienna,4044,6,12,11,13,60,49,11,47
RZ Pellets W,4044,7,10,12,14,41,51,-10,42
Mattersburg,4044,8,9,8,19,39,58,-19,35
SV Josko Rie,4044,9,10,5,21,37,64,-27,35
St. Pölten,4044,10,7,12,17,40,63,-23,33
FC Salzburg,4045,1,24,7,5,75,28,47,79
SC Rheindorf,4045,2,20,6,10,53,46,7,66
SK Sturm Gra,4045,3,19,8,9,58,36,22,65
Vienna,4045,4,19,5,12,70,53,17,62
Rapid Vienna,4045,5,12,12,12,54,45,9,48
RZ Pellets W,4045,6,11,11,14,48,55,-7,44
SV Josko Rie,4045,7,11,3,22,37,58,-21,36
Admira Wacke,4045,8,9,9,18,37,66,-29,36
Mattersburg,4045,9,9,8,19,48,64,-16,35
St. Pölten,4045,10,7,9,20,31,60,-29,30
FC Salzburg,4046,1,21,7,8,69,36,33,70
SK Sturm Gra,4046,2,21,6,9,57,29,28,69
Vienna,4046,3,21,3,12,69,49,20,66
SC Rheindorf,4046,4,16,9,11,49,42,7,57
RZ Pellets W,4046,5,15,7,14,51,54,-3,52
Admira Wacke,4046,6,15,6,15,42,53,-11,51
Rapid Vienna,4046,7,10,10,16,47,53,-6,40
SV Josko Rie,4046,8,12,4,20,33,51,-18,40
St. Pölten,4046,9,9,7,20,41,65,-24,34
Mattersburg,4046,10,6,9,21,34,60,-26,27
FC Salzburg,4047,1,18,9,9,62,33,29,63
SC Rheindorf,4047,2,18,9,9,53,36,17,63
SK Sturm Gra,4047,3,17,11,8,59,34,25,62
Vienna,4047,4,18,7,11,63,53,10,61
Rapid Vienna,4047,5,14,12,10,58,41,17,54
SV Josko Rie,4047,6,13,6,17,47,63,-16,45
RZ Pellets W,4047,7,11,8,17,39,55,-16,41
Admira Wacke,4047,8,10,9,17,40,63,-23,39
St. Pölten,4047,9,9,10,17,40,61,-21,37
Mattersburg,4047,10,7,9,20,35,57,-22,30
FC Salzburg,4048,1,22,5,9,69,32,37,71
Vienna,4048,2,22,4,10,66,51,15,70
SC Rheindorf,4048,3,18,9,9,48,40,8,63
SK Sturm Gra,4048,4,18,5,13,61,39,22,59
Rapid Vienna,4048,5,13,14,9,54,39,15,53
RZ Pellets W,4048,6,14,11,11,49,45,4,53
SV Josko Rie,4048,7,10,7,19,34,53,-19,37
Mattersburg,4048,8,8,10,18,31,47,-16,34
Admira Wacke,4048,9,8,8,20,27,61,-34,32
St. Pölten,4048,10,5,11,20,33,65,-32,26
FC Salzburg,4049,1,24,6,6,81,26,55,78
SC Rheindorf,4049,2,22,7,7,58,38,20,73
SK Sturm Gra,4049,3,22,5,9,63,32,31,71
Rapid Vienna,4049,4,15,9,12,58,41,17,54
Vienna,4049,5,17,3,16,56,58,-2,54
SV Josko Rie,4049,6,11,6,19,31,49,-18,39
Admira Wacke,4049,7,11,6,19,40,65,-25,39
RZ Pellets W,4049,8,10,6,20,38,60,-22,36
St. Pölten,4049,9,8,10,18,37,66,-29,34
Mattersburg,4049,10,6,10,20,34,61,-27,28
FC Salzburg,4050,1,21,9,6,64,27,37,72
SK Sturm Gra,4050,2,20,7,9,65,32,33,67
SC Rheindorf,4050,3,18,8,10,46,42,4,62
Vienna,4050,4,17,5,14,59,52,7,56
Rapid Vienna,4050,5,13,9,14,62,44,18,48
SV Josko Rie,4050,6,14,5,17,39,47,-8,47
RZ Pellets W,4050,7,12,7,17,45,63,-18,43
Admira Wacke,4050,8,11,9,16,38,59,-21,42
St. Pölten,4050,9,10,7,19,43,68,-25,37
Mattersburg,4050,10,5,12,19,32,59,-27,27
Vienna,4051,1,21,5,10,72,50,22,68
SK Sturm Gra,4051,2,19,6,11,57,34,23,63
FC Salzburg,4051,3,18,8,10,58,36,22,62
SC Rheindorf,4051,4,17,6,13,51,45,6,57
Rapid Vienna,4051,5,14,12,10,54,39,15,54
Admira Wacke,4051,6,12,9,15,44,57,-13,45
Mattersburg,4051,7,12,7,17,38,51,-13,43
RZ Pellets W,4051,8,11,8,17,37,58,-21,41
SV Josko Rie,4051,9,11,5,20,33,53,-20,38
St. Pölten,4051,10,8,8,20,41,62,-21,32
SK Sturm Gra,4052,1,23,4,9,64,32,32,73
FC Salzburg,4052,2,20,9,7,66,32,34,69
SC Rheindorf,4052,3,18,8,10,57,48,9,62
Vienna,4052,4,17,3,16,66,62,4,54
Rapid Vienna,4052,5,12,12,12,62,46,16,48
RZ Pellets W,4052,6,12,9,15,43,50,-7,45
SV Josko Rie,4052,7,12,4,20,39,58,-19,40
Mattersburg,4052,8,9,11,16,35,51,-16,38
Admira Wacke,4052,9,11,5,20,38,65,-27,38
St. Pölten,4052,10,9,9,18,41,67,-26,36
FC Salzburg,4053,1,22,7,7,65,29,36,73
SC Rheindorf,4053,2,20,7,9,64,43,21,67
SK Sturm Gra,4053,3,18,6,12,56,40,16,60
RZ Pellets W,4053,4,16,6,14,59,49,10,54
Vienna,4053,5,16,6,14,64,62,2,54
Rapid Vienna,4053,6,15,8,13,60,43,17,53
Admira Wacke,4053,7,12,7,17,45,67,-22,43
SV Josko Rie,4053,8,12,5,19,38,53,-15,41
Mattersburg,4053,9,8,10,18,34,61,-27,34
St. Pölten,4053,10,6,8,22,29,67,-38,26
FC Salzburg,4054,1,26,6,4,78,27,51,84
SC Rheindorf,4054,2,21,4,11,58,40,18,67
SK Sturm Gra,4054,3,20,6,10,57,33,24,66
Vienna,4054,4,19,4,13,62,50,12,61
Rapid Vienna,4054,5,14,9,13,58,46,12,51
RZ Pellets W,4054,6,11,6,19,47,62,-15,39
Admira Wacke,4054,7,10,8,18,34,61,-27,38
Mattersburg,4054,8,9,9,18,37,56,-19,36
St. Pölten,4054,9,8,9,19,44,67,-23,33
SV Josko Rie,4054,10,8,7,21,34,67,-33,31
FC Salzburg,4055,1,19,9,8,63,32,31,66
Vienna,4055,2,20,4,12,61,51,10,64
SC Rheindorf,4055,3,18,9,9,61,44,17,63
Rapid Vienna,4055,4,17,11,8,65,32,33,62
SK Sturm Gra,4055,5,18,7,11,60,37,23,61
SV Josko Rie,4055,6,12,6,18,34,50,-16,42
RZ Pellets W,4055,7,11,5,20,44,63,-19,38
St. Pölten,4055,8,9,11,16,38,59,-21,38
Mattersburg,4055,9,8,10,18,34,54,-20,34
Admira Wacke,4055,10,9,6,21,33,71,-38,33
FC Salzburg,4056,1,21,8,7,60,24,36,71
SC Rheindorf,4056,2,22,4,10,68,46,22,70
SK Sturm Gra,4056,3,17,10,9,56,33,23,61
Rapid Vienna,4056,4,14,12,10,64,45,19,54
Vienna,4056,5,15,6,15,64,61,3,51
St. Pölten,4056,6,11,9,16,52,69,-17,42
RZ Pellets W,4056,7,12,6,18,43,62,-19,42
Admira Wacke,4056,8,12,4,20,35,57,-22,40
SV Josko Rie,4056,9,11,4,21,41,67,-26,37
Mattersburg,4056,10,9,9,18,38,57,-19,36
FC Salzburg,4057,1,23,7,6,65,25,40,76
SC Rheindorf,4057,2,21,6,9,55,39,16,69
SK Sturm Gra,4057,3,19,9,8,57,33,24,66
Vienna,4057,4,20,4,12,56,42,14,64
Rapid Vienna,4057,5,17,10,9,58,37,21,61
RZ Pellets W,4057,6,11,8,17,44,54,-10,41
Admira Wacke,4057,7,10,6,20,34,65,-31,36
SV Josko Rie,4057,8,9,7,20,30,48,-18,34
Mattersburg,4057,9,8,6,22,33,61,-28,30
St. Pölten,4057,10,6,9,21,32,60,-28,27
FC Salzburg,4058,1,22,6,8,66,28,38,72
SC Rheindorf,4058,2,20,7,9,57,42,15,67
SK Sturm Gra,4058,3,19,7,10,57,36,21,64
Vienna,4058,4,19,5,12,64,54,10,62
Admira Wacke,4058,5,13,8,15,42,57,-15,47
Rapid Vienna,4058,6,11,12,13,55,44,11,45
St. Pölten,4058,7,11,10,15,51,60,-9,43
RZ Pellets W,4058,8,10,8,18,42,62,-20,38
SV Josko Rie,4058,9,9,6,21,34,57,-23,33
Mattersburg,4058,10,8,7,21,41,69,-28,31
FC Salzburg,4059,1,20,7,9,61,31,30,67
SK Sturm Gra,4059,2,19,5,12,57,39,18,62
SC Rheindorf,4059,3,17,9,10,51,46,5,60
Vienna,4059,4,17,7,12,63,48,15,58
Rapid Vienna,4059,5,15,10,11,54,41,13,55
Admira Wacke,4059,6,16,5,15,44,50,-6,53
RZ Pellets W,4059,7,14,6,16,43,48,-5,48
St. Pölten,4059,8,10,7,19,40,65,-25,37
Mattersburg,4059,9,9,8,19,39,57,-18,35
SV Josko Rie,4059,10,10,2,24,32,59,-27,32
FC Salzburg,4060,1,21,10,5,66,27,39,73
Vienna,4060,2,20,5,11,63,48,15,65
SC Rheindorf,4060,3,19,6,11,54,43,11,63
SK Sturm Gra,4060,4,18,7,11,60,45,15,61
Rapid Vienna,4060,5,15,12,9,60,35,25,57
RZ Pellets W,4060,6,10,12,14,43,52,-9,42
St. Pölten,4060,7,10,9,17,46,62,-16,39
Mattersburg,4060,8,9,11,16,42,59,-17,38
Admira Wacke,4060,9,10,7,19,33,60,-27,37
SV Josko Rie,4060,10,7,3,26,25,61,-36,24
FC Salzburg,4061,1,20,8,8,62,24,38,68
SK Sturm Gra,4061,2,20,5,11,59,33,26,65
Vienna,4061,3,19,8,9,69,48,21,65
SC Rheindorf,4061,4,18,7,11,51,49,2,61
Rapid Vienna,4061,5,17,9,10,56,33,23,60
RZ Pellets W,4061,6,13,6,17,50,61,-11,45
Mattersburg,4061,7,10,8,18,40,56,-16,38
St. Pölten,4061,8,8,11,17,38,67,-29,35
SV Josko Rie,4061,9,8,9,19,31,52,-21,33
Admira Wacke,4061,10,8,7,21,35,68,-33,31
FC Salzburg,4062,1,21,11,4,70,27,43,74
SC Rheindorf,4062,2,21,8,7,61,45,16,71
SK Sturm Gra,4062,3,19,8,9,70,42,28,65
Vienna,4062,4,19,4,13,64,51,13,61
Rapid Vienna,4062,5,13,10,13,57,46,11,49
RZ Pellets W,4062,6,14,6,16,47,62,-15,48
St. Pölten,4062,7,8,11,17,44,65,-21,35
Admira Wacke,4062,8,10,5,21,35,67,-32,35
Mattersburg,4062,9,7,10,19,38,57,-19,31
SV Josko Rie,4062,10,8,7,21,34,58,-24,31
FC Salzburg,4063,1,24,6,6,70,29,41,78
SC Rheindorf,4063,2,20,7,9,56,43,13,67
SK Sturm Gra,4063,3,20,6,10,62,40,22,66
Vienna,4063,4,19,6,11,65,45,20,63
RZ Pellets W,4063,5,12,10,14,44,53,-9,46
Admira Wacke,4063,6,11,8,17,37,56,-19,41
Rapid Vienna,4063,7,9,12,15,50,48,2,39
St. Pölten,4063,8,7,14,15,40,63,-23,35
SV Josko Rie,4063,9,9,7,20,34,53,-19,34
Mattersburg,4063,10,6,10,20,35,63,-28,28
FC Salzburg,4064,1,22,5,9,64,32,32,71
SK Sturm Gra,4064,2,19,6,11,58,35,23,63
Vienna,4064,3,19,6,11,58,49,9,63
SC Rheindorf,4064,4,17,10,9,49,40,9,61
Rapid Vienna,4064,5,13,10,13,59,43,16,49
SV Josko Rie,4064,6,13,5,18,38,53,-15,44
Admira Wacke,4064,7,11,9,16,36,50,-14,42
RZ Pellets W,4064,8,11,9,16,41,58,-17,42
St. Pölten,4064,9,9,10,17,45,57,-12,37
Mattersburg,4064,10,7,8,21,30,61,-31,29
SC Rheindorf,4065,1,21,7,8,61,41,20,70
FC Salzburg,4065,2,21,6,9,75,36,39,69
Vienna,4065,3,21,3,12,72,54,18,66
SK Sturm Gra,4065,4,20,4,12,57,36,21,64
Rapid Vienna,4065,5,12,10,14,49,44,5,46
St. Pölten,4065,6,13,6,17,47,61,-14,45
RZ Pellets W,4065,7,11,7,18,45,61,-16,40
Admira Wacke,4065,8,11,6,19,37,61,-24,39
SV Josko Rie,4065,9,10,6,20,32,58,-26,36
Mattersburg,4065,10,8,9,19,39,62,-23,33
FC Salzburg,4066,1,21,9,6,63,25,38,72
SC Rheindorf,4066,2,17,11,8,57,46,11,62
SK Sturm Gra,4066,3,16,9,11,56,41,15,57
Vienna,4066,4,16,7,13,56,55,1,55
Rapid Vienna,4066,5,13,14,9,59,39,20,53
RZ Pellets W,4066,6,12,6,18,51,62,-11,42
St. Pölten,4066,7,11,9,16,45,62,-17,42
SV Josko Rie,4066,8,12,5,19,36,50,-14,41
Mattersburg,4066,9,10,8,18,39,56,-17,38
Admira Wacke,4066,10,10,6,20,42,68,-26,36
FC Salzburg,4067,1,22,9,5,64,24,40,75
Vienna,4067,2,17,8,11,64,51,13,59
SK Sturm Gra,4067,3,16,8,12,52,39,13,56
SC Rheindorf,4067,4,16,6,14,48,46,2,54
RZ Pellets W,4067,5,15,7,14,45,50,-5,52
Rapid Vienna,4067,6,13,12,11,56,47,9,51
SV Josko Rie,4067,7,12,7,17,38,52,-14,43
Admira Wacke,4067,8,11,7,18,37,56,-19,40
Mattersburg,4067,9,9,9,18,45,58,-13,36
St. Pölten,4067,10,8,9,19,39,65,-26,33
FC Salzburg,4068,1,21,6,9,66,33,33,69
Vienna,4068,2,22,3,11,63,49,14,69
SC Rheindorf,4068,3,21,5,10,52,43,9,68
SK Sturm Gra,4068,4,19,6,11,55,33,22,63
Rapid Vienna,4068,5,14,10,12,55,35,20,52
Admira Wacke,4068,6,14,4,18,42,54,-12,46
RZ Pellets W,4068,7,11,8,17,47,59,-12,41
St. Pölten,4068,8,8,12,16,38,59,-21,36
SV Josko Rie,4068,9,8,9,19,34,57,-23,33
Mattersburg,4068,10,5,11,20,32,62,-30,26
FC Salzburg,4069,1,22,7,7,64,30,34,73
SC Rheindorf,4069,2,22,6,8,62,39,23,72
SK Sturm Gra,4069,3,20,4,12,55,35,20,64
Vienna,4069,4,18,4,14,59,48,11,58
Rapid Vienna,4069,5,16,9,11,62,39,23,57
St. Pölten,4069,6,11,8,17,43,59,-16,41
RZ Pellets W,4069,7,10,8,18,40,55,-15,38
Mattersburg,4069,8,9,9,18,39,61,-22,36
SV Josko Rie,4069,9,10,5,21,34,61,-27,35
Admira Wacke,4069,10,8,8,20,28,59,-31,32
SC Rheindorf,4070,1,20,7,9,58,44,14,67
FC Salzburg,4070,2,18,10,8,56,29,27,64
SK Sturm Gra,4070,3,18,9,9,59,39,20,63
Rapid Vienna,4070,4,16,11,9,62,37,25,59
Vienna,4070,5,17,3,16,58,55,3,54
Admira Wacke,4070,6,16,6,14,37,47,-10,54
RZ Pellets W,4070,7,12,6,18,44,59,-15,42
Mattersburg,4070,8,9,9,18,37,55,-18,36
SV Josko Rie,4070,9,10,4,22,32,56,-24,34
St. Pölten,4070,10,6,11,19,39,61,-22,29
Vienna,4071,1,22,5,9,66,48,18,71
FC Salzburg,4071,2,20,7,9,59,37,22,67
Rapid Vienna,4071,3,18,9,9,68,37,31,63
SC Rheindorf,4071,4,18,8,10,50,43,7,62
SK Sturm Gra,4071,5,17,9,10,57,36,21,60
RZ Pellets W,4071,6,13,8,15,50,53,-3,47
SV Josko Rie,4071,7,10,6,20,34,53,-19,36
St. Pölten,4071,8,8,10,18,43,64,-21,34
Mattersburg,4071,9,7,10,19,35,58,-23,31
Admira Wacke,4071,10,9,4,23,31,64,-33,31
FC Salzburg,4072,1,20,9,7,55,26,29,69
SK Sturm Gra,4072,2,21,5,10,58,29,29,68
Vienna,4072,3,18,6,12,64,55,9,60
Rapid Vienna,4072,4,15,11,10,52,34,18,56
SC Rheindorf,4072,5,17,5,14,52,44,8,56
Admira Wacke,4072,6,13,6,17,43,65,-22,45
RZ Pellets W,4072,7,11,9,16,47,58,-11,42
SV Josko Rie,4072,8,11,5,20,33,53,-20,38
Mattersburg,4072,9,10,7,19,39,56,-17,37
St. Pölten,4072,10,7,11,18,36,59,-23,32
FC Salzburg,4073,1,23,7,6,66,23,43,76
SC Rheindorf,4073,2,20,7,9,62,46,16,67
SK Sturm Gra,4073,3,20,5,11,64,35,29,65
Vienna,4073,4,17,5,14,61,52,9,56
Rapid Vienna,4073,5,13,12,11,57,40,17,51
RZ Pellets W,4073,6,13,5,18,45,60,-15,44
St. Pölten,4073,7,11,7,18,43,59,-16,40
SV Josko Rie,4073,8,12,4,20,37,59,-22,40
Admira Wacke,4073,9,10,7,19,34,66,-32,37
Mattersburg,4073,10,7,9,20,32,61,-29,30
SC Rheindorf,4074,1,20,9,7,56,38,18,69
FC Salzburg,4074,2,20,8,8,70,37,33,68
SK Sturm Gra,4074,3,19,6,11,57,38,19,63
Rapid Vienna,4074,4,14,12,10,54,36,18,54
Vienna,4074,5,16,6,14,55,54,1,54
SV Josko Rie,4074,6,12,7,17,45,56,-11,43
Admira Wacke,4074,7,11,9,16,41,57,-16,42
RZ Pellets W,4074,8,11,7,18,42,57,-15,40
St. Pölten,4074,9,8,10,18,41,67,-26,34
Mattersburg,4074,10,7,10,19,36,57,-21,31
SC Rheindorf,4075,1,24,6,6,55,33,22,78
FC Salzburg,4075,2,21,9,6,61,26,35,72
SK Sturm Gra,4075,3,18,5,13,54,37,17,59
Vienna,4075,4,18,5,13,63,51,12,59
Rapid Vienna,4075,5,14,12,10,54,40,14,54
RZ Pellets W,4075,6,13,7,16,47,55,-8,46
SV Josko Rie,4075,7,11,5,20,36,49,-13,38
Mattersburg,4075,8,9,9,18,36,50,-14,36
Admira Wacke,4075,9,10,5,21,34,61,-27,35
St. Pölten,4075,10,5,11,20,36,74,-38,26
SC Rheindorf,4076,1,21,8,7,52,32,20,71
FC Salzburg,4076,2,20,8,8,60,27,33,68
SK Sturm Gra,4076,3,18,6,12,62,36,26,60
Vienna,4076,4,18,5,13,63,55,8,59
Rapid Vienna,4076,5,16,9,11,54,40,14,57
RZ Pellets W,4076,6,10,12,14,44,54,-10,42
SV Josko Rie,4076,7,11,7,18,35,52,-17,40
Admira Wacke,4076,8,11,7,18,37,58,-21,40
Mattersburg,4076,9,7,11,18,34,57,-23,32
St. Pölten,4076,10,7,9,20,39,69,-30,30
FC Salzburg,4077,1,22,8,6,70,34,36,74
SC Rheindorf,4077,2,20,10,6,59,40,19,70
SK Sturm Gra,4077,3,18,5,13,68,45,23,59
Vienna,4077,4,17,8,11,59,49,10,59
RZ Pellets W,4077,5,14,8,14,55,54,1,50
Rapid Vienna,4077,6,11,12,13,55,51,4,45
Mattersburg,4077,7,11,8,17,39,48,-9,41
Admira Wacke,4077,8,12,4,20,44,69,-25,40
SV Josko Rie,4077,9,9,7,20,28,54,-26,34
St. Pölten,4077,10,7,8,21,34,67,-33,29
SC Rheindorf,4078,1,20,8,8,58,42,16,68
FC Salzburg,4078,2,21,4,11,67,34,33,67
SK Sturm Gra,4078,3,19,6,11,58,32,26,63
Vienna,4078,4,17,5,14,61,53,8,56
Rapid Vienna,4078,5,15,8,13,58,44,14,53
RZ Pellets W,4078,6,13,8,15,50,51,-1,47
Admira Wacke,4078,7,13,6,17,35,59,-24,45
SV Josko Rie,4078,8,12,3,21,33,55,-22,39
Mattersburg,4078,9,10,7,19,33,54,-21,37
St. Pölten,4078,10,9,7,20,41,70,-29,34
SK Sturm Gra,4079,1,22,6,8,62,32,30,72
Vienna,4079,2,22,4,10,74,50,24,70
FC Salzburg,4079,3,20,9,7,59,31,28,69
SC Rheindorf,4079,4,18,9,9,59,44,15,63
Rapid Vienna,4079,5,14,10,12,55,42,13,52
Admira Wacke,4079,6,11,7,18,44,62,-18,40
RZ Pellets W,4079,7,10,8,18,49,67,-18,38
Mattersburg,4079,8,9,10,17,41,57,-16,37
SV Josko Rie,4079,9,8,6,22,35,64,-29,30
St. Pölten,4079,10,6,11,19,32,61,-29,29
Vienna,4080,1,20,7,9,70,43,27,67
SC Rheindorf,4080,2,19,10,7,54,39,15,67
FC Salzburg,4080,3,20,6,10,57,29,28,66
SK Sturm Gra,4080,4,19,9,8,62,36,26,66
Rapid Vienna,4080,5,13,9,14,52,47,5,48
RZ Pellets W,4080,6,12,7,17,41,57,-16,43
Admira Wacke,4080,7,11,6,19,40,66,-26,39
Mattersburg,4080,8,9,10,17,39,56,-17,37
SV Josko Rie,4080,9,8,9,19,34,53,-19,33
St. Pölten,4080,10,7,11,18,38,61,-23,32
FC Salzburg,4081,1,23,6,7,66,26,40,75
SC Rheindorf,4081,2,19,7,10,58,44,14,64
Vienna,4081,3,19,6,11,59,52,7,63
SK Sturm Gra,4081,4,18,5,13,60,38,22,59
RZ Pellets W,4081,5,14,8,14,51,58,-7,50
Rapid Vienna,4081,6,11,11,14,59,49,10,44
SV Josko Rie,4081,7,13,4,19,38,51,-13,43
Mattersburg,4081,8,10,8,18,45,58,-13,38
St. Pölten,4081,9,8,10,18,40,70,-30,34
Admira Wacke,4081,10,9,7,20,33,63,-30,34
SK Sturm Gra,4082,1,21,6,9,57,34,23,69
FC Salzburg,4082,2,19,9,8,66,38,28,66
Vienna,4082,3,19,6,11,63,50,13,63
Rapid Vienna,4082,4,17,10,9,61,37,24,61
SC Rheindorf,4082,5,16,8,12,49,44,5,56
SV Josko Rie,4082,6,13,6,17,41,52,-11,45
Admira Wacke,4082,7,12,8,16,36,54,-18,44
RZ Pellets W,4082,8,11,10,15,51,56,-5,43
Mattersburg,4082,9,8,5,23,41,61,-20,29
St. Pölten,4082,10,6,8,22,30,69,-39,26
FC Salzburg,4083,1,23,7,6,70,31,39,76
SC Rheindorf,4083,2,18,8,10,54,42,12,62
Rapid Vienna,4083,3,15,12,9,58,38,20,57
SK Sturm Gra,4083,4,16,9,11,54,37,17,57
Vienna,4083,5,15,11,10,64,53,11,56
Admira Wacke,4083,6,12,6,18,40,63,-23,42
RZ Pellets W,4083,7,11,8,17,43,56,-13,41
SV Josko Rie,4083,8,10,9,17,36,50,-14,39
St. Pölten,4083,9,10,9,17,43,65,-22,39
Mattersburg,4083,10,6,9,21,34,61,-27,27
FC Salzburg,4084,1,23,6,7,61,27,34,75
Vienna,4084,2,20,7,9,67,50,17,67
SK Sturm Gra,4084,3,19,7,10,57,28,29,64
SC Rheindorf,4084,4,16,11,9,54,48,6,59
Rapid Vienna,4084,5,12,10,14,49,37,12,46
Admira Wacke,4084,6,14,4,18,46,60,-14,46
RZ Pellets W,4084,7,13,6,17,42,53,-11,45
Mattersburg,4084,8,9,9,18,35,57,-22,36
St. Pölten,4084,9,8,9,19,43,68,-25,33
SV Josko Rie,4084,10,8,7,21,29,55,-26,31
FC Salzburg,4085,1,23,8,5,72,27,45,77
Vienna,4085,2,20,5,11,68,51,17,65
SK Sturm Gra,4085,3,17,9,10,60,39,21,60
SC Rheindorf,4085,4,17,8,11,55,45,10,59
Rapid Vienna,4085,5,13,10,13,55,51,4,49
RZ Pellets W,4085,6,14,5,17,49,59,-10,47
Admira Wacke,4085,7,12,6,18,40,61,-21,42
SV Josko Rie,4085,8,10,7,19,32,57,-25,37
St. Pölten,4085,9,9,9,18,44,65,-21,36
Mattersburg,4085,10,6,11,19,33,53,-20,29
FC Salzburg,4086,1,22,6,8,68,31,37,72
Vienna,4086,2,19,7,10,67,48,19,64
SC Rheindorf,4086,3,18,8,10,50,40,10,62
SK Sturm Gra,4086,4,18,7,11,57,38,19,61
Rapid Vienna,4086,5,13,14,9,57,41,16,53
Admira Wacke,4086,6,15,5,16,42,56,-14,50
RZ Pellets W,4086,7,12,6,18,45,55,-10,42
St. Pölten,4086,8,8,11,17,43,68,-25,35
SV Josko Rie,4086,9,10,3,23,35,62,-27,33
Mattersburg,4086,10,7,9,20,38,63,-25,30
FC Salzburg,4087,1,25,4,7,78,35,43,79
SK Sturm Gra,4087,2,20,9,7,62,31,31,69
Vienna,4087,3,19,5,12,69,56,13,62
SC Rheindorf,4087,4,16,8,12,46,42,4,56
Rapid Vienna,4087,5,12,13,11,51,42,9,49
RZ Pellets W,4087,6,13,6,17,46,54,-8,45
Admira Wacke,4087,7,9,10,17,37,65,-28,37
SV Josko Rie,4087,8,10,6,20,32,55,-23,36
St. Pölten,4087,9,8,11,17,42,60,-18,35
Mattersburg,4087,10,7,10,19,37,60,-23,31
SC Rheindorf,4088,1,21,8,7,56,33,23,71
Vienna,4088,2,21,5,10,72,50,22,68
FC Salzburg,4088,3,18,10,8,60,32,28,64
SK Sturm Gra,4088,4,19,5,12,55,34,21,62
Rapid Vienna,4088,5,14,14,8,61,39,22,56
RZ Pellets W,4088,6,12,7,17,46,63,-17,43
Admira Wacke,4088,7,11,7,18,38,63,-25,40
SV Josko Rie,4088,8,9,8,19,35,52,-17,35
Mattersburg,4088,9,8,9,19,38,54,-16,33
St. Pölten,4088,10,6,9,21,33,74,-41,27
FC Salzburg,4089,1,20,8,8,62,30,32,68
SK Sturm Gra,4089,2,21,5,10,59,27,32,68
SC Rheindorf,4089,3,20,5,11,60,43,17,65
Rapid Vienna,4089,4,13,11,12,54,45,9,50
Vienna,4089,5,15,5,16,59,66,-7,50
RZ Pellets W,4089,6,14,7,15,48,53,-5,49
Admira Wacke,4089,7,14,4,18,36,55,-19,46
SV Josko Rie,4089,8,12,6,18,39,46,-7,42
Mattersburg,4089,9,8,10,18,34,54,-20,34
St. Pölten,4089,10,8,9,19,42,74,-32,33
SC Rheindorf,4090,1,22,5,9,56,37,19,71
FC Salzburg,4090,2,20,9,7,63,29,34,69
SK Sturm Gra,4090,3,21,6,9,64,33,31,69
Rapid Vienna,4090,4,18,10,8,66,30,36,64
Vienna,4090,5,16,5,15,55,55,0,53
RZ Pellets W,4090,6,12,7,17,41,60,-19,43
Admira Wacke,4090,7,12,5,19,45,66,-21,41
SV Josko Rie,4090,8,11,3,22,37,60,-23,36
St. Pölten,4090,9,8,8,20,41,73,-32,32
Mattersburg,4090,10,8,6,22,39,64,-25,30
SK Sturm Gra,4091,1,20,6,10,65,34,31,66
FC Salzburg,4091,2,18,11,7,61,33,28,65
Vienna,4091,3,19,5,12,60,44,16,62
SC Rheindorf,4091,4,17,8,11,52,46,6,59
Rapid Vienna,4091,5,13,10,13,52,46,6,49
Admira Wacke,4091,6,13,6,17,35,55,-20,45
RZ Pellets W,4091,7,10,10,16,41,55,-14,40
SV Josko Rie,4091,8,11,7,18,34,48,-14,40
St. Pölten,4091,9,10,10,16,41,61,-20,40
Mattersburg,4091,10,8,9,19,37,56,-19,33
FC Salzburg,4092,1,20,9,7,67,31,36,69
Vienna,4092,2,21,4,11,65,48,17,67
SK Sturm Gra,4092,3,20,6,10,62,32,30,66
SC Rheindorf,4092,4,16,10,10,49,47,2,58
Rapid Vienna,4092,5,11,12,13,51,44,7,45
RZ Pellets W,4092,6,13,6,17,42,53,-11,45
Admira Wacke,4092,7,13,6,17,39,58,-19,45
Mattersburg,4092,8,10,9,17,35,49,-14,39
St. Pölten,4092,9,9,10,17,44,63,-19,37
SV Josko Rie,4092,10,9,4,23,35,64,-29,31
FC Salzburg,4093,1,20,8,8,69,34,35,68
SC Rheindorf,4093,2,19,10,7,61,46,15,67
SK Sturm Gra,4093,3,19,7,10,62,30,32,64
Vienna,4093,4,17,8,11,59,51,8,59
Rapid Vienna,4093,5,14,12,10,55,39,16,54
RZ Pellets W,4093,6,13,9,14,48,53,-5,48
SV Josko Rie,4093,7,11,7,18,35,52,-17,40
Admira Wacke,4093,8,11,7,18,39,64,-25,40
Mattersburg,4093,9,8,7,21,37,68,-31,31
St. Pölten,4093,10,6,9,21,36,64,-28,27
FC Salzburg,4094,1,22,5,9,71,30,41,71
SC Rheindorf,4094,2,19,7,10,53,42,11,64
SK Sturm Gra,4094,3,18,9,9,60,29,31,63
Vienna,4094,4,18,7,11,61,56,5,61
Rapid Vienna,4094,5,14,11,11,54,40,14,53
Admira Wacke,4094,6,11,8,17,38,57,-19,41
SV Josko Rie,4094,7,12,4,20,40,59,-19,40
RZ Pellets W,4094,8,10,8,18,37,52,-15,38
Mattersburg,4094,9,10,7,19,33,58,-25,37
St. Pölten,4094,10,8,10,18,40,64,-24,34
FC Salzburg,4095,1,21,8,7,65,36,29,71
Vienna,4095,2,22,3,11,72,52,20,69
SK Sturm Gra,4095,3,20,5,11,62,36,26,65
SC Rheindorf,4095,4,18,7,11,47,42,5,61
Rapid Vienna,4095,5,14,8,14,51,48,3,50
RZ Pellets W,4095,6,12,7,17,47,59,-12,43
SV Josko Rie,4095,7,11,7,18,33,47,-14,40
St. Pölten,4095,8,10,8,18,44,61,-17,38
Admira Wacke,4095,9,10,5,21,34,60,-26,35
Mattersburg,4095,10,8,10,18,39,53,-14,34
SC Rheindorf,4096,1,22,6,8,59,40,19,72
FC Salzburg,4096,2,20,9,7,64,32,32,69
Vienna,4096,3,20,6,10,64,46,18,66
SK Sturm Gra,4096,4,14,12,10,46,32,14,54
Rapid Vienna,4096,5,13,10,13,52,39,13,49
Admira Wacke,4096,6,13,8,15,40,53,-13,47
RZ Pellets W,4096,7,11,10,15,47,53,-6,43
St. Pölten,4096,8,10,9,17,39,64,-25,39
SV Josko Rie,4096,9,10,4,22,32,54,-22,34
Mattersburg,4096,10,6,8,22,31,61,-30,26
SK Sturm Gra,4097,1,21,8,7,59,29,30,71
SC Rheindorf,4097,2,22,5,9,58,43,15,71
FC Salzburg,4097,3,19,6,11,60,35,25,63
Vienna,4097,4,17,5,14,58,51,7,56
Rapid Vienna,4097,5,14,8,14,56,48,8,50
RZ Pellets W,4097,6,13,9,14,49,52,-3,48
Mattersburg,4097,7,11,6,19,42,56,-14,39
Admira Wacke,4097,8,11,5,20,34,56,-22,38
SV Josko Rie,4097,9,11,4,21,37,58,-21,37
St. Pölten,4097,10,9,8,19,39,64,-25,35
SC Rheindorf,4098,1,22,6,8,62,41,21,72
FC Salzburg,4098,2,22,5,9,73,30,43,71
SK Sturm Gra,4098,3,20,5,11,63,36,27,65
Rapid Vienna,4098,4,16,8,12,57,44,13,56
Vienna,4098,5,15,4,17,56,63,-7,49
RZ Pellets W,4098,6,13,9,14,50,54,-4,48
SV Josko Rie,4098,7,15,3,18,42,47,-5,48
Admira Wacke,4098,8,13,5,18,38,58,-20,44
St. Pölten,4098,9,7,8,21,37,72,-35,29
Mattersburg,4098,10,6,9,21,32,65,-33,27
FC Salzburg,4099,1,20,8,8,73,42,31,68
SK Sturm Gra,4099,2,19,7,10,63,36,27,64
SC Rheindorf,4099,3,17,10,9,61,46,15,61
Vienna,4099,4,18,4,14,64,61,3,58
Rapid Vienna,4099,5,15,11,10,61,42,19,56
RZ Pellets W,4099,6,13,6,17,43,55,-12,45
Admira Wacke,4099,7,12,6,18,41,57,-16,42
Mattersburg,4099,8,11,8,17,43,56,-13,41
SV Josko Rie,4099,9,10,6,20,36,58,-22,36
St. Pölten,4099,10,7,10,19,42,74,-32,31
FC Salzburg,4100,1,23,7,6,67,21,46,76
SC Rheindorf,4100,2,19,8,9,49,40,9,65
SK Sturm Gra,4100,3,19,7,10,56,33,23,64
Vienna,4100,4,17,9,10,65,49,16,60
RZ Pellets W,4100,5,14,6,16,56,54,2,48
Admira Wacke,4100,6,14,6,16,48,60,-12,48
Rapid Vienna,4100,7,12,11,13,52,41,11,47
Mattersburg,4100,8,9,8,19,38,59,-21,35
St. Pölten,4100,9,8,7,21,35,75,-40,31
SV Josko Rie,4100,10,7,7,22,30,64,-34,28
FC Salzburg,4101,1,25,6,5,71,26,45,81
SC Rheindorf,4101,2,22,7,7,51,35,16,73
Vienna,4101,3,18,6,12,61,52,9,60
SK Sturm Gra,4101,4,17,7,12,57,44,13,58
Rapid Vienna,4101,5,14,12,10,53,38,15,54
RZ Pellets W,4101,6,12,9,15,49,52,-3,45
SV Josko Rie,4101,7,11,7,18,40,52,-12,40
Admira Wacke,4101,8,8,9,19,34,61,-27,33
St. Pölten,4101,9,8,7,21,36,67,-31,31
Mattersburg,4101,10,5,10,21,31,56,-25,25
SC Rheindorf,4102,1,21,9,6,61,34,27,72
FC Salzburg,4102,2,20,8,8,69,34,35,68
Vienna,4102,3,21,5,10,63,51,12,68
SK Sturm Gra,4102,4,18,6,12,52,37,15,60
Rapid Vienna,4102,5,14,11,11,55,40,15,53
RZ Pellets W,4102,6,11,9,16,46,53,-7,42
Admira Wacke,4102,7,11,7,18,34,58,-24,40
Mattersburg,4102,8,9,9,18,38,53,-15,36
SV Josko Rie,4102,9,10,4,22,39,64,-25,34
St. Pölten,4102,10,5,12,19,35,68,-33,27
FC Salzburg,4103,1,23,7,6,71,26,45,76
SC Rheindorf,4103,2,18,12,6,56,39,17,66
SK Sturm Gra,4103,3,20,5,11,58,38,20,65
Rapid Vienna,4103,4,13,11,12,56,45,11,50
Vienna,4103,5,14,7,15,54,62,-8,49
Admira Wacke,4103,6,11,9,16,40,52,-12,42
St. Pölten,4103,7,10,10,16,47,65,-18,40
SV Josko Rie,4103,8,10,8,18,32,49,-17,38
RZ Pellets W,4103,9,8,13,15,43,62,-19,37
Mattersburg,4103,10,6,12,18,41,60,-19,30
FC Salzburg,4104,1,21,7,8,67,29,38,70
SK Sturm Gra,4104,2,21,6,9,62,35,27,69
SC Rheindorf,4104,3,20,7,9,56,41,15,67
Rapid Vienna,4104,4,18,8,10,58,41,17,62
Vienna,4104,5,17,5,14,65,54,11,56
RZ Pellets W,4104,6,15,6,15,48,53,-5,51
SV Josko Rie,4104,7,12,4,20,34,57,-23,40
Admira Wacke,4104,8,9,6,21,32,61,-29,33
St. Pölten,4104,9,8,8,20,45,72,-27,32
Mattersburg,4104,10,6,9,21,34,58,-24,27
SK Sturm Gra,4105,1,21,9,6,68,33,35,72
SC Rheindorf,4105,2,17,13,6,62,44,18,64
FC Salzburg,4105,3,17,12,7,61,33,28,63
Vienna,4105,4,15,9,12,60,61,-1,54
Rapid Vienna,4105,5,12,13,11,54,42,12,49
RZ Pellets W,4105,6,11,10,15,45,52,-7,43
Admira Wacke,4105,7,11,6,19,37,60,-23,39
SV Josko Rie,4105,8,10,8,18,39,53,-14,38
St. Pölten,4105,9,9,9,18,44,65,-21,36
Mattersburg,4105,10,8,9,19,35,62,-27,33
FC Salzburg,4106,1,22,4,10,66,34,32,70
SC Rheindorf,4106,2,17,10,9,53,46,7,61
SK Sturm Gra,4106,3,17,8,11,56,35,21,59
Vienna,4106,4,17,7,12,56,49,7,58
RZ Pellets W,4106,5,16,6,14,48,45,3,54
Rapid Vienna,4106,6,13,11,12,58,41,17,50
Admira Wacke,4106,7,12,8,16,40,55,-15,44
SV Josko Rie,4106,8,11,7,18,36,52,-16,40
St. Pölten,4106,9,9,8,19,41,68,-27,35
Mattersburg,4106,10,7,9,20,34,63,-29,30
FC Salzburg,4107,1,21,8,7,71,32,39,71
SK Sturm Gra,4107,2,21,7,8,72,39,33,70
SC Rheindorf,4107,3,21,7,8,64,45,19,70
Vienna,4107,4,18,4,14,67,60,7,58
Rapid Vienna,4107,5,13,10,13,55,42,13,49
SV Josko Rie,4107,6,12,4,20,37,52,-15,40
RZ Pellets W,4107,7,11,7,18,47,68,-21,40
Admira Wacke,4107,8,11,6,19,39,65,-26,39
Mattersburg,4107,9,9,8,19,40,61,-21,35
St. Pölten,4107,10,7,11,18,38,66,-28,32
FC Salzburg,4108,1,21,9,6,65,34,31,72
SC Rheindorf,4108,2,22,6,8,63,38,25,72
SK Sturm Gra,4108,3,18,9,9,66,33,33,63
Vienna,4108,4,19,5,12,59,51,8,62
Rapid Vienna,4108,5,12,11,13,52,43,9,47
SV Josko Rie,4108,6,13,5,18,39,50,-11,44
Admira Wacke,4108,7,11,6,19,38,64,-26,39
RZ Pellets W,4108,8,9,8,19,40,64,-24,35
Mattersburg,4108,9,7,11,18,33,54,-21,32
St. Pölten,4108,10,6,14,16,35,59,-24,32
FC Salzburg,4109,1,22,8,6,71,32,39,74
Vienna,4109,2,20,5,11,69,51,18,65
SC Rheindorf,4109,3,17,11,8,59,49,10,62
Rapid Vienna,4109,4,16,11,9,60,38,22,59
SK Sturm Gra,4109,5,17,7,12,55,38,17,58
RZ Pellets W,4109,6,13,8,15,45,50,-5,47
Admira Wacke,4109,7,9,10,17,30,51,-21,37
St. Pölten,4109,8,9,9,18,42,68,-26,36
Mattersburg,4109,9,8,7,21,33,61,-28,31
SV Josko Rie,4109,10,8,6,22,31,57,-26,30
FC Salzburg,4110,1,22,5,9,68,29,39,71
SK Sturm Gra,4110,2,21,7,8,58,27,31,70
Vienna,4110,3,19,8,9,66,46,20,65
SC Rheindorf,4110,4,18,8,10,54,40,14,62
Rapid Vienna,4110,5,13,12,11,60,49,11,51
RZ Pellets W,4110,6,13,7,16,43,53,-10,46
Admira Wacke,4110,7,12,5,19,36,60,-24,41
St. Pölten,4110,8,10,10,16,40,55,-15,40
SV Josko Rie,4110,9,9,6,21,30,59,-29,33
Mattersburg,4110,10,5,8,23,30,67,-37,23
FC Salzburg,4111,1,19,10,7,70,31,39,67
SC Rheindorf,4111,2,20,7,9,57,43,14,67
Vienna,4111,3,20,4,12,64,50,14,64
SK Sturm Gra,4111,4,18,8,10,51,32,19,62
Rapid Vienna,4111,5,13,11,12,54,44,10,50
RZ Pellets W,4111,6,14,7,15,53,58,-5,49
St. Pölten,4111,7,9,13,14,48,60,-12,40
Admira Wacke,4111,8,10,9,17,41,61,-20,39
SV Josko Rie,4111,9,10,4,22,31,63,-32,34
Mattersburg,4111,10,7,7,22,32,59,-27,28
FC Salzburg,4112,1,21,7,8,68,31,37,70
SK Sturm Gra,4112,2,17,11,8,53,30,23,62
SC Rheindorf,4112,3,17,9,10,52,45,7,60
Vienna,4112,4,17,8,11,58,52,6,59
Rapid Vienna,4112,5,14,10,12,61,43,18,52
Admira Wacke,4112,6,14,6,16,34,52,-18,48
RZ Pellets W,4112,7,12,9,15,46,53,-7,45
SV Josko Rie,4112,8,11,5,20,34,52,-18,38
Mattersburg,4112,9,10,6,20,37,58,-21,36
St. Pölten,4112,10,6,11,19,37,64,-27,29
FC Salzburg,4113,1,23,6,7,68,24,44,75
SK Sturm Gra,4113,2,21,6,9,68,30,38,69
SC Rheindorf,4113,3,21,5,10,48,41,7,68
Vienna,4113,4,19,5,12,58,51,7,62
Rapid Vienna,4113,5,17,9,10,61,42,19,60
RZ Pellets W,4113,6,12,8,16,45,57,-12,44
Admira Wacke,4113,7,11,5,20,34,57,-23,38
SV Josko Rie,4113,8,10,4,22,31,60,-29,34
Mattersburg,4113,9,8,9,19,40,58,-18,33
St. Pölten,4113,10,6,7,23,32,65,-33,25
Vienna,4114,1,21,5,10,76,51,25,68
FC Salzburg,4114,2,18,7,11,62,40,22,61
SC Rheindorf,4114,3,17,10,9,54,46,8,61
SK Sturm Gra,4114,4,16,11,9,58,39,19,59
St. Pölten,4114,5,12,11,13,52,58,-6,47
Rapid Vienna,4114,6,11,11,14,52,50,2,44
SV Josko Rie,4114,7,11,11,14,36,44,-8,44
RZ Pellets W,4114,8,11,9,16,47,63,-16,42
Admira Wacke,4114,9,11,7,18,42,62,-20,40
Mattersburg,4114,10,7,8,21,42,68,-26,29
FC Salzburg,4115,1,22,6,8,71,29,42,72
SC Rheindorf,4115,2,21,6,9,58,50,8,69
SK Sturm Gra,4115,3,19,4,13,58,37,21,61
Vienna,4115,4,17,6,13,67,60,7,57
Rapid Vienna,4115,5,14,12,10,54,37,17,54
RZ Pellets W,4115,6,12,8,16,50,57,-7,44
Mattersburg,4115,7,12,6,18,42,55,-13,42
St. Pölten,4115,8,10,9,17,46,66,-20,39
SV Josko Rie,4115,9,9,7,20,35,53,-18,34
Admira Wacke,4115,10,10,4,22,34,71,-37,34
SC Rheindorf,4116,1,22,6,8,68,43,25,72
FC Salzburg,4116,2,19,8,9,62,36,26,65
SK Sturm Gra,4116,3,18,7,11,61,42,19,61
Vienna,4116,4,17,5,14,58,48,10,56
Rapid Vienna,4116,5,13,11,12,55,43,12,50
Mattersburg,4116,6,10,12,14,47,52,-5,42
SV Josko Rie,4116,7,12,6,18,38,55,-17,42
RZ Pellets W,4116,8,11,8,17,45,61,-16,41
Admira Wacke,4116,9,11,7,18,39,62,-23,40
St. Pölten,4116,10,7,10,19,33,64,-31,31
FC Salzburg,4117,1,22,4,10,67,34,33,70
SK Sturm Gra,4117,2,21,5,10,68,44,24,68
SC Rheindorf,4117,3,19,5,12,56,50,6,62
RZ Pellets W,4117,4,15,10,11,53,49,4,55
Rapid Vienna,4117,5,14,9,13,63,48,15,51
Vienna,4117,6,16,3,17,58,66,-8,51
Mattersburg,4117,7,11,11,14,47,54,-7,44
Admira Wacke,4117,8,13,4,19,41,59,-18,43
SV Josko Rie,4117,9,11,5,20,38,55,-17,38
St. Pölten,4117,10,6,8,22,38,70,-32,26
FC Salzburg,4118,1,23,5,8,63,26,37,74
SC Rheindorf,4118,2,20,6,10,62,45,17,66
SK Sturm Gra,4118,3,20,5,11,59,34,25,65
Vienna,4118,4,17,6,13,59,56,3,57
Rapid Vienna,4118,5,14,12,10,51,36,15,54
RZ Pellets W,4118,6,13,5,18,43,57,-14,44
St. Pölten,4118,7,11,8,17,41,58,-17,41
Admira Wacke,4118,8,12,4,20,34,58,-24,40
SV Josko Rie,4118,9,11,5,20,36,52,-16,38
Mattersburg,4118,10,7,8,21,35,61,-26,29
FC Salzburg,4119,1,23,6,7,64,26,38,75
SC Rheindorf,4119,2,22,8,6,56,32,24,74
SK Sturm Gra,4119,3,21,3,12,63,34,29,66
Vienna,4119,4,20,3,13,60,53,7,63
Admira Wacke,4119,5,13,5,18,41,57,-16,44
Rapid Vienna,4119,6,10,13,13,51,48,3,43
RZ Pellets W,4119,7,12,7,17,40,56,-16,43
St. Pölten,4119,8,9,10,17,40,60,-20,37
Mattersburg,4119,9,8,9,19,42,56,-14,33
SV Josko Rie,4119,10,7,6,23,26,61,-35,27
FC Salzburg,4120,1,22,8,6,64,27,37,74
SK Sturm Gra,4120,2,22,6,8,65,32,33,72
SC Rheindorf,4120,3,20,6,10,64,46,18,66
Rapid Vienna,4120,4,14,11,11,65,52,13,53
Vienna,4120,5,16,5,15,58,55,3,53
RZ Pellets W,4120,6,12,7,17,47,54,-7,43
Admira Wacke,4120,7,11,7,18,38,60,-22,40
St. Pölten,4120,8,10,8,18,44,66,-22,38
SV Josko Rie,4120,9,10,5,21,40,63,-23,35
Mattersburg,4120,10,8,7,21,31,61,-30,31
FC Salzburg,4121,1,20,9,7,63,30,33,69
Vienna,4121,2,20,5,11,66,44,22,65
SK Sturm Gra,4121,3,19,7,10,61,35,26,64
SC Rheindorf,4121,4,18,9,9,51,43,8,63
Rapid Vienna,4121,5,13,10,13,56,43,13,49
RZ Pellets W,4121,6,14,5,17,46,55,-9,47
Admira Wacke,4121,7,11,8,17,33,59,-26,41
Mattersburg,4121,8,11,7,18,42,54,-12,40
SV Josko Rie,4121,9,11,3,22,35,59,-24,36
St. Pölten,4121,10,7,9,20,39,70,-31,30
FC Salzburg,4122,1,20,8,8,66,35,31,68
SK Sturm Gra,4122,2,20,6,10,58,36,22,66
Vienna,4122,3,21,3,12,68,50,18,66
Rapid Vienna,4122,4,15,13,8,64,41,23,58
SC Rheindorf,4122,5,17,7,12,51,51,0,58
Mattersburg,4122,6,12,8,16,49,52,-3,44
Admira Wacke,4122,7,13,5,18,40,61,-21,44
RZ Pellets W,4122,8,10,8,18,44,60,-16,38
St. Pölten,4122,9,6,13,17,41,62,-21,31
SV Josko Rie,4122,10,8,5,23,31,64,-33,29
SC Rheindorf,4123,1,23,5,8,64,41,23,74
FC Salzburg,4123,2,20,8,8,64,32,32,68
Vienna,4123,3,20,3,13,65,59,6,63
SK Sturm Gra,4123,4,16,6,14,56,39,17,54
Rapid Vienna,4123,5,15,9,12,55,38,17,54
RZ Pellets W,4123,6,14,5,17,45,57,-12,47
Admira Wacke,4123,7,13,7,16,46,55,-9,46
SV Josko Rie,4123,8,11,4,21,32,50,-18,37
Mattersburg,4123,9,8,11,17,35,53,-18,35
St. Pölten,4123,10,7,8,21,40,78,-38,29
FC Salzburg,4124,1,24,4,8,81,32,49,76
SK Sturm Gra,4124,2,20,5,11,63,39,24,65
Vienna,4124,3,19,6,11,68,51,17,63
SC Rheindorf,4124,4,17,8,11,54,47,7,59
Rapid Vienna,4124,5,15,9,12,53,38,15,54
Admira Wacke,4124,6,15,4,17,43,63,-20,49
RZ Pellets W,4124,7,13,6,17,44,55,-11,45
Mattersburg,4124,8,10,8,18,41,57,-16,38
SV Josko Rie,4124,9,9,6,21,28,54,-26,33
St. Pölten,4124,10,6,8,22,34,73,-39,26
SK Sturm Gra,4125,1,23,5,8,69,33,36,74
FC Salzburg,4125,2,19,9,8,61,29,32,66
SC Rheindorf,4125,3,19,9,8,56,41,15,66
Vienna,4125,4,15,7,14,58,59,-1,52
Rapid Vienna,4125,5,13,10,13,49,41,8,49
RZ Pellets W,4125,6,11,11,14,49,55,-6,44
SV Josko Rie,4125,7,12,5,19,34,50,-16,41
St. Pölten,4125,8,10,8,18,40,60,-20,38
Admira Wacke,4125,9,11,4,21,34,64,-30,37
Mattersburg,4125,10,8,10,18,33,51,-18,34
FC Salzburg,4126,1,22,8,6,64,28,36,74
SC Rheindorf,4126,2,19,7,10,54,46,8,64
Vienna,4126,3,18,7,11,62,53,9,61
SK Sturm Gra,4126,4,18,4,14,55,44,11,58
Rapid Vienna,4126,5,12,10,14,59,45,14,46
SV Josko Rie,4126,6,12,7,17,41,49,-8,43
RZ Pellets W,4126,7,12,7,17,48,63,-15,43
Admira Wacke,4126,8,12,5,19,36,56,-20,41
St. Pölten,4126,9,10,9,17,43,61,-18,39
Mattersburg,4126,10,8,10,18,33,50,-17,34
SC Rheindorf,4127,1,20,9,7,59,40,19,69
FC Salzburg,4127,2,19,8,9,63,35,28,65
Vienna,4127,3,20,5,11,67,51,16,65
SK Sturm Gra,4127,4,16,7,13,55,39,16,55
Rapid Vienna,4127,5,13,10,13,60,47,13,49
Admira Wacke,4127,6,13,7,16,37,53,-16,46
RZ Pellets W,4127,7,12,9,15,49,54,-5,45
SV Josko Rie,4127,8,13,4,19,38,59,-21,43
Mattersburg,4127,9,10,7,19,35,55,-20,37
St. Pölten,4127,10,6,10,20,39,69,-30,28
FC Salzburg,4128,1,23,8,5,78,30,48,77
SC Rheindorf,4128,2,20,8,8,57,45,12,68
SK Sturm Gra,4128,3,18,10,8,58,32,26,64
Vienna,4128,4,15,8,13,65,62,3,53
Rapid Vienna,4128,5,14,10,12,49,37,12,52
RZ Pellets W,4128,6,12,7,17,46,54,-8,43
SV Josko Rie,4128,7,11,8,17,32,48,-16,41
St. Pölten,4128,8,10,8,18,42,57,-15,38
Admira Wacke,4128,9,11,5,20,29,58,-29,38
Mattersburg,4128,10,5,10,21,27,60,-33,25
FC Salzburg,4129,1,22,6,8,66,34,32,72
SK Sturm Gra,4129,2,22,5,9,65,39,26,71
SC Rheindorf,4129,3,21,6,9,63,40,23,69
Vienna,4129,4,17,5,14,60,55,5,56
Rapid Vienna,4129,5,15,9,12,59,40,19,54
RZ Pellets W,4129,6,13,6,17,43,48,-5,45
SV Josko Rie,4129,7,11,6,19,39,56,-17,39
Mattersburg,4129,8,8,11,17,35,56,-21,35
Admira Wacke,4129,9,7,11,18,37,69,-32,32
St. Pölten,4129,10,7,9,20,37,67,-30,30
SC Rheindorf,4130,1,22,6,8,63,39,24,72
FC Salzburg,4130,2,20,7,9,63,30,33,67
SK Sturm Gra,4130,3,17,10,9,54,34,20,61
Rapid Vienna,4130,4,16,10,10,61,34,27,58
Vienna,4130,5,15,8,13,53,51,2,53
SV Josko Rie,4130,6,14,4,18,44,51,-7,46
Mattersburg,4130,7,10,9,17,38,55,-17,39
Admira Wacke,4130,8,10,7,19,36,67,-31,37
RZ Pellets W,4130,9,9,7,20,35,58,-23,34
St. Pölten,4130,10,8,10,18,42,70,-28,34
FC Salzburg,4131,1,20,8,8,69,33,36,68
Vienna,4131,2,18,7,11,63,51,12,61
SC Rheindorf,4131,3,18,6,12,52,45,7,60
SK Sturm Gra,4131,4,17,8,11,60,42,18,59
Rapid Vienna,4131,5,14,11,11,62,38,24,53
Admira Wacke,4131,6,12,9,15,39,58,-19,45
St. Pölten,4131,7,11,10,15,42,55,-13,43
RZ Pellets W,4131,8,10,10,16,40,60,-20,40
SV Josko Rie,4131,9,10,5,21,28,45,-17,35
Mattersburg,4131,10,9,8,19,36,64,-28,35
FC Salzburg,4132,1,21,8,7,70,31,39,71
SC Rheindorf,4132,2,20,7,9,59,40,19,67
SK Sturm Gra,4132,3,19,8,9,60,32,28,65
Vienna,4132,4,18,6,12,61,46,15,60
Rapid Vienna,4132,5,17,8,11,65,40,25,59
St. Pölten,4132,6,11,8,17,43,68,-25,41
RZ Pellets W,4132,7,10,10,16,42,59,-17,40
SV Josko Rie,4132,8,11,5,20,33,55,-22,38
Admira Wacke,4132,9,10,8,18,33,58,-25,38
Mattersburg,4132,10,5,8,23,29,66,-37,23
Vienna,4133,1,21,6,9,72,53,19,69
SC Rheindorf,4133,2,20,8,8,62,39,23,68
FC Salzburg,4133,3,19,8,9,65,34,31,65
SK Sturm Gra,4133,4,19,7,10,64,37,27,64
Rapid Vienna,4133,5,13,14,9,57,40,17,53
RZ Pellets W,4133,6,10,13,13,46,58,-12,43
Admira Wacke,4133,7,12,7,17,42,59,-17,43
SV Josko Rie,4133,8,12,4,20,32,54,-22,40
St. Pölten,4133,9,7,9,20,44,76,-32,30
Mattersburg,4133,10,5,8,23,32,66,-34,23
SC Rheindorf,4134,1,21,7,8,56,39,17,70
FC Salzburg,4134,2,18,12,6,66,31,35,66
RZ Pellets W,4134,3,16,8,12,48,47,1,56
Vienna,4134,4,15,9,12,65,59,6,54
Rapid Vienna,4134,5,13,14,9,54,39,15,53
SK Sturm Gra,4134,6,14,7,15,54,45,9,49
Admira Wacke,4134,7,11,8,17,36,56,-20,41
Mattersburg,4134,8,9,12,15,40,51,-11,39
St. Pölten,4134,9,8,10,18,40,66,-26,34
SV Josko Rie,4134,10,8,7,21,37,63,-26,31
FC Salzburg,4135,1,19,11,6,66,33,33,68
SK Sturm Gra,4135,2,20,7,9,57,29,28,67
Vienna,4135,3,19,6,11,61,47,14,63
SC Rheindorf,4135,4,18,9,9,53,42,11,63
Rapid Vienna,4135,5,13,11,12,48,39,9,50
RZ Pellets W,4135,6,14,6,16,48,53,-5,48
Admira Wacke,4135,7,13,6,17,39,57,-18,45
Mattersburg,4135,8,10,7,19,40,55,-15,37
SV Josko Rie,4135,9,8,6,22,28,52,-24,30
St. Pölten,4135,10,7,9,20,33,66,-33,30
FC Salzburg,4136,1,24,8,4,71,27,44,80
SK Sturm Gra,4136,2,20,6,10,58,34,24,66
SC Rheindorf,4136,3,19,6,11,52,43,9,63
Vienna,4136,4,18,5,13,68,50,18,59
Rapid Vienna,4136,5,14,10,12,54,40,14,52
RZ Pellets W,4136,6,12,9,15,43,54,-11,45
Mattersburg,4136,7,9,11,16,35,54,-19,38
SV Josko Rie,4136,8,10,5,21,31,55,-24,35
Admira Wacke,4136,9,10,4,22,30,59,-29,34
St. Pölten,4136,10,6,12,18,38,64,-26,30
SC Rheindorf,4137,1,24,5,7,63,38,25,77
SK Sturm Gra,4137,2,22,6,8,59,26,33,72
Vienna,4137,3,17,9,10,58,45,13,60
FC Salzburg,4137,4,17,8,11,58,36,22,59
Admira Wacke,4137,5,13,6,17,49,54,-5,45
Rapid Vienna,4137,6,11,10,15,57,56,1,43
SV Josko Rie,4137,7,12,5,19,33,49,-16,41
RZ Pellets W,4137,8,11,6,19,41,65,-24,39
St. Pölten,4137,9,9,8,19,50,70,-20,35
Mattersburg,4137,10,9,7,20,36,65,-29,34
FC Salzburg,4138,1,21,6,9,69,33,36,69
Vienna,4138,2,21,3,12,74,53,21,66
SK Sturm Gra,4138,3,20,6,10,59,39,20,66
SC Rheindorf,4138,4,18,6,12,54,46,8,60
Rapid Vienna,4138,5,15,8,13,56,46,10,53
Admira Wacke,4138,6,15,4,17,42,61,-19,49
RZ Pellets W,4138,7,11,7,18,46,61,-15,40
Mattersburg,4138,8,10,8,18,44,59,-15,38
SV Josko Rie,4138,9,11,5,20,31,51,-20,38
St. Pölten,4138,10,7,9,20,40,66,-26,30
FC Salzburg,4139,1,21,9,6,61,30,31,72
SC Rheindorf,4139,2,20,6,10,48,36,12,66
Vienna,4139,3,19,4,13,71,54,17,61
SK Sturm Gra,4139,4,18,6,12,64,36,28,60
Rapid Vienna,4139,5,14,12,10,59,40,19,54
RZ Pellets W,4139,6,13,9,14,40,49,-9,48
Admira Wacke,4139,7,12,6,18,37,67,-30,42
SV Josko Rie,4139,8,11,5,20,36,57,-21,38
St. Pölten,4139,9,8,8,20,37,64,-27,32
Mattersburg,4139,10,7,9,20,36,56,-20,30
FC Salzburg,4140,1,21,9,6,68,32,36,72
SC Rheindorf,4140,2,22,6,8,62,43,19,72
SK Sturm Gra,4140,3,18,9,9,58,37,21,63
Vienna,4140,4,18,3,15,69,60,9,57
Rapid Vienna,4140,5,12,14,10,56,42,14,50
RZ Pellets W,4140,6,13,9,14,49,57,-8,48
Admira Wacke,4140,7,12,7,17,33,53,-20,43
St. Pölten,4140,8,9,7,20,43,68,-25,34
Mattersburg,4140,9,7,10,19,34,57,-23,31
SV Josko Rie,4140,10,8,6,22,31,54,-23,30
SK Sturm Gra,4141,1,21,7,8,57,25,32,70
Vienna,4141,2,22,4,10,64,46,18,70
SC Rheindorf,4141,3,20,6,10,54,43,11,66
FC Salzburg,4141,4,18,7,11,58,38,20,61
Rapid Vienna,4141,5,12,13,11,57,42,15,49
RZ Pellets W,4141,6,12,8,16,51,62,-11,44
Admira Wacke,4141,7,12,4,20,37,59,-22,40
Mattersburg,4141,8,9,9,18,42,60,-18,36
St. Pölten,4141,9,7,12,17,40,61,-21,33
SV Josko Rie,4141,10,8,8,20,28,52,-24,32
FC Salzburg,4142,1,20,9,7,65,29,36,69
SC Rheindorf,4142,2,20,8,8,57,44,13,68
SK Sturm Gra,4142,3,19,9,8,62,32,30,66
Vienna,4142,4,15,5,16,57,60,-3,50
Rapid Vienna,4142,5,12,12,12,49,42,7,48
RZ Pellets W,4142,6,13,9,14,44,51,-7,48
Admira Wacke,4142,7,13,9,14,36,49,-13,48
SV Josko Rie,4142,8,12,4,20,38,51,-13,40
Mattersburg,4142,9,6,12,18,29,48,-19,30
St. Pölten,4142,10,6,11,19,38,69,-31,29
Vienna,4143,1,22,4,10,66,45,21,70
FC Salzburg,4143,2,20,7,9,65,35,30,67
SC Rheindorf,4143,3,19,7,10,51,42,9,64
SK Sturm Gra,4143,4,19,5,12,61,34,27,62
Rapid Vienna,4143,5,12,14,10,56,46,10,50
Admira Wacke,4143,6,13,8,15,42,59,-17,47
RZ Pellets W,4143,7,10,11,15,40,55,-15,41
Mattersburg,4143,8,11,7,18,39,50,-11,40
SV Josko Rie,4143,9,10,6,20,37,57,-20,36
St. Pölten,4143,10,5,9,22,33,67,-34,24
FC Salzburg,4144,1,23,5,8,64,28,36,74
SC Rheindorf,4144,2,21,6,9,59,41,18,69
SK Sturm Gra,4144,3,18,5,13,59,33,26,59
Vienna,4144,4,16,6,14,57,55,2,54
Rapid Vienna,4144,5,15,7,14,62,48,14,52
St. Pölten,4144,6,13,8,15,50,62,-12,47
RZ Pellets W,4144,7,10,9,17,39,54,-15,39
Admira Wacke,4144,8,11,6,19,35,63,-28,39
Mattersburg,4144,9,10,8,18,38,53,-15,38
SV Josko Rie,4144,10,11,4,21,33,59,-26,37
Vienna,4145,1,21,6,9,71,47,24,69
SC Rheindorf,4145,2,20,8,8,63,46,17,68
FC Salzburg,4145,3,18,10,8,62,27,35,64
Rapid Vienna,4145,4,15,11,10,52,36,16,56
SK Sturm Gra,4145,5,16,6,14,53,42,11,54
Admira Wacke,4145,6,13,5,18,41,63,-22,44
RZ Pellets W,4145,7,11,8,17,46,62,-16,41
SV Josko Rie,4145,8,11,4,21,39,62,-23,37
St. Pölten,4145,9,9,9,18,39,61,-22,36
Mattersburg,4145,10,7,11,18,35,55,-20,32
FC Salzburg,4146,1,20,10,6,62,28,34,70
SK Sturm Gra,4146,2,20,6,10,58,30,28,66
Vienna,4146,3,19,6,11,61,50,11,63
SC Rheindorf,4146,4,18,7,11,57,44,13,61
RZ Pellets W,4146,5,14,10,12,44,44,0,52
Rapid Vienna,4146,6,13,12,11,53,41,12,51
SV Josko Rie,4146,7,10,8,18,30,46,-16,38
St. Pölten,4146,8,7,12,17,34,59,-25,33
Mattersburg,4146,9,7,10,19,30,56,-26,31
Admira Wacke,4146,10,7,9,20,31,62,-31,30
FC Salzburg,4147,1,21,10,5,68,32,36,73
SC Rheindorf,4147,2,20,5,11,58,49,9,65
SK Sturm Gra,4147,3,19,7,10,58,33,25,64
Rapid Vienna,4147,4,15,11,10,61,40,21,56
Vienna,4147,5,16,7,13,61,52,9,55
Admira Wacke,4147,6,15,6,15,48,59,-11,51
Mattersburg,4147,7,10,10,16,46,54,-8,40
RZ Pellets W,4147,8,10,9,17,45,61,-16,39
SV Josko Rie,4147,9,8,5,23,31,62,-31,29
St. Pölten,4147,10,6,10,20,37,71,-34,28
SK Sturm Gra,4148,1,20,6,10,56,31,25,66
FC Salzburg,4148,2,19,7,10,66,41,25,64
Vienna,4148,3,19,3,14,61,59,2,60
Rapid Vienna,4148,4,16,11,9,66,37,29,59
SC Rheindorf,4148,5,16,7,13,49,48,1,55
RZ Pellets W,4148,6,12,9,15,45,54,-9,45
Admira Wacke,4148,7,12,6,18,39,52,-13,42
SV Josko Rie,4148,8,11,8,17,34,47,-13,41
St. Pölten,4148,9,10,9,17,42,64,-22,39
Mattersburg,4148,10,8,8,20,35,60,-25,32
FC Salzburg,4149,1,23,8,5,63,27,36,77
SK Sturm Gra,4149,2,19,6,11,60,37,23,63
SC Rheindorf,4149,3,18,7,11,57,43,14,61
Vienna,4149,4,18,3,15,58,51,7,57
RZ Pellets W,4149,5,16,7,13,53,49,4,55
Admira Wacke,4149,6,16,6,14,39,48,-9,54
Rapid Vienna,4149,7,10,12,14,49,45,4,42
SV Josko Rie,4149,8,9,6,21,31,60,-29,33
St. Pölten,4149,9,7,11,18,38,60,-22,32
Mattersburg,4149,10,6,10,20,36,64,-28,28
FC Salzburg,4150,1,19,10,7,69,36,33,67
SK Sturm Gra,4150,2,19,9,8,54,26,28,66
SC Rheindorf,4150,3,19,6,11,54,42,12,63
Vienna,4150,4,19,4,13,63,50,13,61
Rapid Vienna,4150,5,17,9,10,59,42,17,60
RZ Pellets W,4150,6,11,10,15,43,53,-10,43
Admira Wacke,4150,7,12,7,17,37,58,-21,43
Mattersburg,4150,8,8,10,18,35,56,-21,34
SV Josko Rie,4150,9,8,8,20,37,58,-21,32
St. Pölten,4150,10,7,9,20,36,66,-30,30
FC Salzburg,4151,1,23,7,6,72,33,39,76
SK Sturm Gra,4151,2,21,6,9,61,28,33,69
SC Rheindorf,4151,3,19,8,9,55,41,14,65
Vienna,4151,4,15,9,12,61,51,10,54
Rapid Vienna,4151,5,12,13,11,55,46,9,49
Admira Wacke,4151,6,13,5,18,34,58,-24,44
RZ Pellets W,4151,7,10,10,16,50,58,-8,40
SV Josko Rie,4151,8,9,9,18,34,54,-20,36
St. Pölten,4151,9,8,10,18,36,64,-28,34
Mattersburg,4151,10,7,9,20,42,67,-25,30
SC Rheindorf,4152,1,22,6,8,60,42,18,72
FC Salzburg,4152,2,19,9,8,61,33,28,66
Vienna,4152,3,20,5,11,64,53,11,65
Rapid Vienna,4152,4,18,10,8,67,39,28,64
SK Sturm Gra,4152,5,19,4,13,57,40,17,61
RZ Pellets W,4152,6,12,8,16,44,50,-6,44
Admira Wacke,4152,7,10,7,19,32,60,-28,37
Mattersburg,4152,8,9,7,20,37,55,-18,34
St. Pölten,4152,9,9,6,21,44,67,-23,33
SV Josko Rie,4152,10,8,6,22,33,60,-27,30
SC Rheindorf,4153,1,25,6,5,63,35,28,81
FC Salzburg,4153,2,20,7,9,69,34,35,67
SK Sturm Gra,4153,3,18,7,11,61,42,19,61
Vienna,4153,4,18,5,13,72,59,13,59
Rapid Vienna,4153,5,13,10,13,54,41,13,49
SV Josko Rie,4153,6,14,4,18,36,47,-11,46
Admira Wacke,4153,7,12,6,18,39,59,-20,42
RZ Pellets W,4153,8,11,4,21,43,58,-15,37
St. Pölten,4153,9,9,7,20,39,71,-32,34
Mattersburg,4153,10,8,8,20,33,63,-30,32
SK Sturm Gra,4154,1,22,7,7,67,30,37,73
SC Rheindorf,4154,2,18,9,9,57,44,13,63
Vienna,4154,3,19,4,13,60,55,5,61
FC Salzburg,4154,4,18,5,13,58,36,22,59
RZ Pellets W,4154,5,15,6,15,50,57,-7,51
Rapid Vienna,4154,6,12,9,15,55,47,8,45
SV Josko Rie,4154,7,12,7,17,36,50,-14,43
Mattersburg,4154,8,11,8,17,40,51,-11,41
Admira Wacke,4154,9,12,5,19,34,60,-26,41
St. Pölten,4154,10,7,8,21,39,66,-27,29
FC Salzburg,4155,1,22,7,7,66,30,36,73
SK Sturm Gra,4155,2,22,6,8,58,24,34,72
Vienna,4155,3,18,7,11,60,45,15,61
SC Rheindorf,4155,4,17,10,9,50,46,4,61
Rapid Vienna,4155,5,12,14,10,54,42,12,50
RZ Pellets W,4155,6,9,11,16,41,56,-15,38
Mattersburg,4155,7,10,8,18,38,56,-18,38
Admira Wacke,4155,8,11,3,22,31,57,-26,36
St. Pölten,4155,9,8,11,17,41,62,-21,35
SV Josko Rie,4155,10,9,7,20,32,53,-21,34
FC Salzburg,4156,1,23,7,6,68,27,41,76
SC Rheindorf,4156,2,20,9,7,55,38,17,69
Vienna,4156,3,20,4,12,65,50,15,64
Rapid Vienna,4156,4,14,11,11,63,46,17,53
SK Sturm Gra,4156,5,15,8,13,56,42,14,53
RZ Pellets W,4156,6,11,9,16,44,60,-16,42
St. Pölten,4156,7,9,10,17,42,58,-16,37
Admira Wacke,4156,8,10,7,19,37,65,-28,37
SV Josko Rie,4156,9,9,7,20,33,57,-24,34
Mattersburg,4156,10,7,12,17,35,55,-20,33
FC Salzburg,4157,1,22,6,8,71,34,37,72
SK Sturm Gra,4157,2,19,7,10,60,35,25,64
Vienna,4157,3,20,2,14,63,58,5,62
SC Rheindorf,4157,4,15,11,10,48,46,2,56
Rapid Vienna,4157,5,15,9,12,60,42,18,54
SV Josko Rie,4157,6,13,4,19,43,57,-14,43
RZ Pellets W,4157,7,12,6,18,45,61,-16,42
Admira Wacke,4157,8,13,3,20,40,61,-21,42
Mattersburg,4157,9,10,8,18,40,54,-14,38
St. Pölten,4157,10,8,10,18,42,64,-22,34
FC Salzburg,4158,1,22,7,7,67,32,35,73
SK Sturm Gra,4158,2,21,4,11,63,35,28,67
SC Rheindorf,4158,3,20,6,10,55,41,14,66
Rapid Vienna,4158,4,17,9,10,63,40,23,60
Vienna,4158,5,16,6,14,59,56,3,54
RZ Pellets W,4158,6,12,10,14,42,53,-11,46
Admira Wacke,4158,7,12,6,18,36,59,-23,42
St. Pölten,4158,8,8,11,17,44,59,-15,35
Mattersburg,4158,9,8,7,21,40,65,-25,31
SV Josko Rie,4158,10,7,8,21,32,61,-29,29
FC Salzburg,4159,1,22,6,8,68,31,37,72
SC Rheindorf,4159,2,20,7,9,56,42,14,67
Vienna,4159,3,19,6,11,58,47,11,63
SK Sturm Gra,4159,4,17,7,12,56,37,19,58
Rapid Vienna,4159,5,12,11,13,51,39,12,47
SV Josko Rie,4159,6,12,8,16,34,43,-9,44
Mattersburg,4159,7,10,9,17,40,53,-13,39
RZ Pellets W,4159,8,10,9,17,40,58,-18,39
Admira Wacke,4159,9,11,5,20,37,61,-24,38
St. Pölten,4159,10,8,10,18,41,70,-29,34
FC Salzburg,4160,1,22,9,5,68,30,38,75
SC Rheindorf,4160,2,20,8,8,56,35,21,68
SK Sturm Gra,4160,3,18,9,9,60,33,27,63
Vienna,4160,4,18,7,11,63,52,11,61
Rapid Vienna,4160,5,13,10,13,59,50,9,49
Admira Wacke,4160,6,11,7,18,38,60,-22,40
Mattersburg,4160,7,10,8,18,37,57,-20,38
St. Pölten,4160,8,9,9,18,39,60,-21,36
SV Josko Rie,4160,9,9,8,19,35,56,-21,35
RZ Pellets W,4160,10,9,7,20,37,59,-22,34
Vienna,4161,1,23,4,9,67,40,27,73
FC Salzburg,4161,2,22,5,9,59,30,29,71
SC Rheindorf,4161,3,17,9,10,48,42,6,60
SK Sturm Gra,4161,4,17,7,12,55,37,18,58
Rapid Vienna,4161,5,14,9,13,58,46,12,51
Mattersburg,4161,6,12,7,17,36,50,-14,43
SV Josko Rie,4161,7,12,4,20,32,51,-19,40
RZ Pellets W,4161,8,11,6,19,43,60,-17,39
St. Pölten,4161,9,9,10,17,46,63,-17,37
Admira Wacke,4161,10,8,9,19,34,59,-25,33
SC Rheindorf,4162,1,23,5,8,67,44,23,74
FC Salzburg,4162,2,22,6,8,68,33,35,72
SK Sturm Gra,4162,3,22,5,9,63,33,30,71
Vienna,4162,4,18,4,14,56,51,5,58
Rapid Vienna,4162,5,15,9,12,66,40,26,54
SV Josko Rie,4162,6,12,5,19,41,54,-13,41
Admira Wacke,4162,7,12,5,19,35,59,-24,41
RZ Pellets W,4162,8,10,7,19,39,65,-26,37
St. Pölten,4162,9,7,10,19,38,62,-24,31
Mattersburg,4162,10,7,8,21,33,65,-32,29
SC Rheindorf,4163,1,21,7,8,59,38,21,70
Vienna,4163,2,20,6,10,68,50,18,66
FC Salzburg,4163,3,19,8,9,68,37,31,65
SK Sturm Gra,4163,4,19,6,11,57,32,25,63
RZ Pellets W,4163,5,14,7,15,44,49,-5,49
Rapid Vienna,4163,6,12,10,14,49,45,4,46
St. Pölten,4163,7,12,8,16,42,57,-15,44
SV Josko Rie,4163,8,11,4,21,35,54,-19,37
Mattersburg,4163,9,8,10,18,36,60,-24,34
Admira Wacke,4163,10,9,4,23,32,68,-36,31
FC Salzburg,4164,1,19,10,7,67,34,33,67
SC Rheindorf,4164,2,20,6,10,58,40,18,66
SK Sturm Gra,4164,3,19,8,9,61,34,27,65
Rapid Vienna,4164,4,16,10,10,58,38,20,58
Vienna,4164,5,16,7,13,57,54,3,55
SV Josko Rie,4164,6,12,7,17,35,49,-14,43
RZ Pellets W,4164,7,11,9,16,48,55,-7,42
Mattersburg,4164,8,10,9,17,42,56,-14,39
Admira Wacke,4164,9,9,9,18,38,66,-28,36
St. Pölten,4164,10,5,11,20,29,67,-38,26
FC Salzburg,4165,1,21,6,9,68,31,37,69
SC Rheindorf,4165,2,20,7,9,49,41,8,67
Rapid Vienna,4165,3,17,10,9,62,38,24,61
Vienna,4165,4,19,3,14,60,51,9,60
SK Sturm Gra,4165,5,17,6,13,53,37,16,57
RZ Pellets W,4165,6,12,8,16,41,55,-14,44
St. Pölten,4165,7,10,10,16,44,56,-12,40
SV Josko Rie,4165,8,12,3,21,33,53,-20,39
Admira Wacke,4165,9,11,6,19,38,63,-25,39
Mattersburg,4165,10,7,9,20,34,57,-23,30
FC Salzburg,4166,1,19,8,9,67,36,31,65
Vienna,4166,2,20,4,12,74,56,18,64
SC Rheindorf,4166,3,17,10,9,54,45,9,61
Rapid Vienna,4166,4,17,8,11,58,42,16,59
SK Sturm Gra,4166,5,17,7,12,55,36,19,58
RZ Pellets W,4166,6,12,9,15,47,54,-7,45
St. Pölten,4166,7,11,9,16,48,64,-16,42
SV Josko Rie,4166,8,11,5,20,31,55,-24,38
Mattersburg,4166,9,8,10,18,36,56,-20,34
Admira Wacke,4166,10,8,10,18,32,58,-26,34
SC Rheindorf,4167,1,23,5,8,61,41,20,74
FC Salzburg,4167,2,21,8,7,62,32,30,71
Vienna,4167,3,21,3,12,62,50,12,66
Rapid Vienna,4167,4,15,10,11,61,37,24,55
SK Sturm Gra,4167,5,15,8,13,50,37,13,53
RZ Pellets W,4167,6,12,8,16,46,57,-11,44
SV Josko Rie,4167,7,11,6,19,35,48,-13,39
Admira Wacke,4167,8,10,7,19,37,60,-23,37
St. Pölten,4167,9,7,13,16,39,64,-25,34
Mattersburg,4167,10,7,8,21,34,61,-27,29
SC Rheindorf,4168,1,20,9,7,54,36,18,69
FC Salzburg,4168,2,19,10,7,63,30,33,67
SK Sturm Gra,4168,3,20,7,9,68,36,32,67
Vienna,4168,4,19,5,12,64,54,10,62
Rapid Vienna,4168,5,14,13,9,56,35,21,55
SV Josko Rie,4168,6,11,7,18,36,61,-25,40
Admira Wacke,4168,7,10,8,18,40,62,-22,38
Mattersburg,4168,8,8,12,16,44,59,-15,36
RZ Pellets W,4168,9,9,7,20,44,66,-22,34
St. Pölten,4168,10,5,12,19,43,73,-30,27
FC Salzburg,4169,1,21,8,7,66,32,34,71
SK Sturm Gra,4169,2,18,8,10,55,32,23,62
Vienna,4169,3,18,6,12,59,46,13,60
SC Rheindorf,4169,4,16,9,11,56,57,-1,57
Rapid Vienna,4169,5,14,13,9,54,35,19,55
RZ Pellets W,4169,6,12,9,15,40,51,-11,45
SV Josko Rie,4169,7,9,11,16,29,45,-16,38
Admira Wacke,4169,8,10,8,18,34,54,-20,38
St. Pölten,4169,9,9,9,18,39,58,-19,36
Mattersburg,4169,10,8,9,19,32,54,-22,33
SK Sturm Gra,4170,1,22,5,9,58,29,29,71
Vienna,4170,2,22,4,10,71,49,22,70
FC Salzburg,4170,3,19,9,8,60,28,32,66
SC Rheindorf,4170,4,17,8,11,50,42,8,59
Rapid Vienna,4170,5,13,12,11,48,35,13,51
RZ Pellets W,4170,6,13,7,16,49,56,-7,46
Admira Wacke,4170,7,12,7,17,43,58,-15,43
St. Pölten,4170,8,9,9,18,37,62,-25,36
SV Josko Rie,4170,9,9,4,23,32,60,-28,31
Mattersburg,4170,10,7,9,20,33,62,-29,30
FC Salzburg,4171,1,22,6,8,73,30,43,72
SK Sturm Gra,4171,2,19,7,10,59,34,25,64
Rapid Vienna,4171,3,18,8,10,53,36,17,62
Vienna,4171,4,17,3,16,62,59,3,54
SC Rheindorf,4171,5,14,11,11,50,44,6,53
RZ Pellets W,4171,6,13,7,16,49,64,-15,46
SV Josko Rie,4171,7,12,6,18,43,58,-15,42
Admira Wacke,4171,8,11,8,17,45,63,-18,41
St. Pölten,4171,9,9,9,18,43,66,-23,36
Mattersburg,4171,10,8,9,19,37,60,-23,33
SK Sturm Gra,4172,1,22,5,9,56,28,28,71
Vienna,4172,2,20,4,12,64,51,13,64
SC Rheindorf,4172,3,18,9,9,53,42,11,63
FC Salzburg,4172,4,18,7,11,60,35,25,61
Rapid Vienna,4172,5,12,12,12,49,43,6,48
SV Josko Rie,4172,6,14,6,16,40,44,-4,48
RZ Pellets W,4172,7,11,6,19,40,57,-17,39
Admira Wacke,4172,8,10,9,17,39,60,-21,39
Mattersburg,4172,9,9,8,19,35,51,-16,35
St. Pölten,4172,10,8,10,18,34,59,-25,34
FC Salzburg,4173,1,21,9,6,72,32,40,72
SK Sturm Gra,4173,2,22,5,9,65,36,29,71
SC Rheindorf,4173,3,19,10,7,54,40,14,67
Vienna,4173,4,16,9,11,65,51,14,57
Rapid Vienna,4173,5,13,11,12,57,44,13,50
RZ Pellets W,4173,6,11,8,17,43,53,-10,41
SV Josko Rie,4173,7,10,8,18,34,54,-20,38
Admira Wacke,4173,8,10,6,20,36,68,-32,36
Mattersburg,4173,9,7,12,17,36,54,-18,33
St. Pölten,4173,10,7,10,19,36,66,-30,31
FC Salzburg,4174,1,20,8,8,68,31,37,68
SC Rheindorf,4174,2,19,10,7,55,41,14,67
SK Sturm Gra,4174,3,19,7,10,55,32,23,64
Vienna,4174,4,18,2,16,68,58,10,56
Rapid Vienna,4174,5,13,12,11,58,46,12,51
SV Josko Rie,4174,6,12,7,17,35,49,-14,43
Admira Wacke,4174,7,12,7,17,40,66,-26,43
St. Pölten,4174,8,9,11,16,44,66,-22,38
Mattersburg,4174,9,8,11,17,44,54,-10,35
RZ Pellets W,4174,10,9,7,20,43,67,-24,34
FC Salzburg,4175,1,23,9,4,62,20,42,78
SC Rheindorf,4175,2,21,6,9,56,41,15,69
SK Sturm Gra,4175,3,19,8,9,58,31,27,65
Vienna,4175,4,17,4,15,57,51,6,55
Rapid Vienna,4175,5,14,9,13,61,44,17,51
RZ Pellets W,4175,6,14,7,15,56,54,2,49
St. Pölten,4175,7,10,10,16,44,62,-18,40
Admira Wacke,4175,8,9,8,19,35,63,-28,35
Mattersburg,4175,9,8,7,21,35,69,-34,31
SV Josko Rie,4175,10,8,6,22,32,61,-29,30
FC Salzburg,4176,1,22,8,6,74,32,42,74
SK Sturm Gra,4176,2,20,7,9,53,29,24,67
Vienna,4176,3,19,7,10,62,50,12,64
Rapid Vienna,4176,4,15,10,11,65,41,24,55
SC Rheindorf,4176,5,15,10,11,51,45,6,55
Admira Wacke,4176,6,12,7,17,39,68,-29,43
RZ Pellets W,4176,7,11,7,18,44,58,-14,40
St. Pölten,4176,8,8,12,16,42,62,-20,36
SV Josko Rie,4176,9,11,3,22,34,56,-22,36
Mattersburg,4176,10,6,11,19,31,54,-23,29
FC Salzburg,4177,1,21,8,7,73,38,35,71
SK Sturm Gra,4177,2,20,6,10,61,33,28,66
Vienna,4177,3,19,6,11,73,53,20,63
SC Rheindorf,4177,4,17,10,9,50,41,9,61
Rapid Vienna,4177,5,15,8,13,61,48,13,53
SV Josko Rie,4177,6,16,4,16,34,45,-11,52
St. Pölten,4177,7,10,10,16,43,61,-18,40
RZ Pellets W,4177,8,10,6,20,43,65,-22,36
Admira Wacke,4177,9,9,7,20,31,60,-29,34
Mattersburg,4177,10,5,11,20,37,62,-25,26
Vienna,4178,1,23,3,10,65,41,24,72
FC Salzburg,4178,2,20,9,7,64,32,32,69
SC Rheindorf,4178,3,20,6,10,46,37,9,66
SK Sturm Gra,4178,4,19,7,10,58,35,23,64
Rapid Vienna,4178,5,11,16,9,60,39,21,49
RZ Pellets W,4178,6,12,10,14,44,55,-11,46
Admira Wacke,4178,7,12,7,17,31,58,-27,43
Mattersburg,4178,8,7,12,17,38,53,-15,33
St. Pölten,4178,9,8,8,20,37,63,-26,32
SV Josko Rie,4178,10,6,6,24,21,51,-30,24
FC Salzburg,4179,1,22,7,7,71,28,43,73
SC Rheindorf,4179,2,19,9,8,59,43,16,66
SK Sturm Gra,4179,3,19,7,10,56,32,24,64
Vienna,4179,4,19,4,13,71,56,15,61
RZ Pellets W,4179,5,14,7,15,50,54,-4,49
Rapid Vienna,4179,6,12,10,14,51,44,7,46
Admira Wacke,4179,7,12,7,17,42,62,-20,43
SV Josko Rie,4179,8,11,4,21,32,61,-29,37
Mattersburg,4179,9,8,11,17,43,58,-15,35
St. Pölten,4179,10,7,8,21,35,72,-37,29
FC Salzburg,4180,1,21,8,7,68,32,36,71
SC Rheindorf,4180,2,19,7,10,51,41,10,64
Vienna,4180,3,18,6,12,71,52,19,60
SK Sturm Gra,4180,4,17,9,10,53,34,19,60
Rapid Vienna,4180,5,13,10,13,59,48,11,49
SV Josko Rie,4180,6,13,6,17,39,55,-16,45
RZ Pellets W,4180,7,11,10,15,41,52,-11,43
Admira Wacke,4180,8,9,10,17,38,62,-24,37
St. Pölten,4180,9,9,8,19,43,69,-26,35
Mattersburg,4180,10,8,10,18,36,54,-18,34
SK Sturm Gra,4181,1,21,6,9,57,32,25,69
FC Salzburg,4181,2,18,11,7,62,34,28,65
SC Rheindorf,4181,3,18,9,9,54,43,11,63
Vienna,4181,4,19,4,13,61,50,11,61
Rapid Vienna,4181,5,15,10,11,59,46,13,55
RZ Pellets W,4181,6,12,9,15,49,58,-9,45
SV Josko Rie,4181,7,12,3,21,32,55,-23,39
Admira Wacke,4181,8,10,8,18,40,57,-17,38
Mattersburg,4181,9,10,6,20,40,55,-15,36
St. Pölten,4181,10,8,8,20,38,62,-24,32
FC Salzburg,4182,1,22,6,8,61,32,29,72
SC Rheindorf,4182,2,22,6,8,55,36,19,72
Vienna,4182,3,20,5,11,65,45,20,65
SK Sturm Gra,4182,4,18,8,10,55,34,21,62
Rapid Vienna,4182,5,13,9,14,48,43,5,48
SV Josko Rie,4182,6,13,5,18,37,49,-12,44
RZ Pellets W,4182,7,11,6,19,43,61,-18,39
Admira Wacke,4182,8,10,6,20,38,59,-21,36
Mattersburg,4182,9,8,10,18,39,53,-14,34
St. Pölten,4182,10,8,9,19,37,66,-29,33
FC Salzburg,4183,1,22,9,5,65,25,40,75
SK Sturm Gra,4183,2,18,7,11,56,37,19,61
SC Rheindorf,4183,3,17,9,10,47,40,7,60
Vienna,4183,4,15,10,11,58,50,8,55
Rapid Vienna,4183,5,13,11,12,56,43,13,50
RZ Pellets W,4183,6,12,10,14,45,52,-7,46
Admira Wacke,4183,7,12,7,17,42,64,-22,43
Mattersburg,4183,8,11,8,17,42,55,-13,41
SV Josko Rie,4183,9,9,8,19,35,55,-20,35
St. Pölten,4183,10,7,9,20,34,59,-25,30
FC Salzburg,4184,1,23,6,7,70,31,39,75
SK Sturm Gra,4184,2,22,5,9,65,35,30,71
Vienna,4184,3,22,3,11,76,56,20,69
SC Rheindorf,4184,4,18,6,12,53,48,5,60
Rapid Vienna,4184,5,15,9,12,57,45,12,54
RZ Pellets W,4184,6,12,7,17,45,54,-9,43
Admira Wacke,4184,7,12,5,19,37,60,-23,41
Mattersburg,4184,8,8,9,19,36,61,-25,33
SV Josko Rie,4184,9,8,8,20,29,52,-23,32
St. Pölten,4184,10,6,10,20,36,62,-26,28
SK Sturm Gra,4185,1,22,3,11,72,40,32,69
FC Salzburg,4185,2,19,10,7,61,26,35,67
Vienna,4185,3,19,6,11,59,51,8,63
SC Rheindorf,4185,4,18,7,11,53,39,14,61
Rapid Vienna,4185,5,17,9,10,62,41,21,60
St. Pölten,4185,6,12,8,16,39,54,-15,44
Admira Wacke,4185,7,13,4,19,32,58,-26,43
RZ Pellets W,4185,8,11,8,17,43,61,-18,41
SV Josko Rie,4185,9,7,8,21,31,58,-27,29
Mattersburg,4185,10,6,9,21,36,60,-24,27
FC Salzburg,4186,1,19,8,9,62,30,32,65
Vienna,4186,2,21,2,13,65,52,13,65
SC Rheindorf,4186,3,18,8,10,54,41,13,62
SK Sturm Gra,4186,4,18,7,11,58,38,20,61
Rapid Vienna,4186,5,16,11,9,53,35,18,59
RZ Pellets W,4186,6,14,5,17,54,63,-9,47
Admira Wacke,4186,7,12,7,17,38,59,-21,43
St. Pölten,4186,8,9,10,17,42,61,-19,37
Mattersburg,4186,9,9,8,19,39,56,-17,35
SV Josko Rie,4186,10,8,6,22,29,59,-30,30
SK Sturm Gra,4187,1,22,5,9,55,30,25,71
FC Salzburg,4187,2,20,8,8,58,29,29,68
SC Rheindorf,4187,3,20,7,9,56,41,15,67
Vienna,4187,4,18,4,14,62,54,8,58
Rapid Vienna,4187,5,14,11,11,61,40,21,53
RZ Pellets W,4187,6,13,5,18,47,56,-9,44
Admira Wacke,4187,7,12,7,17,36,54,-18,43
SV Josko Rie,4187,8,11,7,18,36,52,-16,40
St. Pölten,4187,9,8,8,20,41,68,-27,32
Mattersburg,4187,10,7,8,21,31,59,-28,29
SC Rheindorf,4188,1,22,5,9,63,43,20,71
FC Salzburg,4188,2,21,7,8,69,34,35,70
Vienna,4188,3,21,5,10,67,50,17,68
SK Sturm Gra,4188,4,15,9,12,53,40,13,54
Rapid Vienna,4188,5,12,13,11,52,45,7,49
SV Josko Rie,4188,6,12,6,18,42,55,-13,42
St. Pölten,4188,7,9,11,16,47,60,-13,38
Admira Wacke,4188,8,10,8,18,38,59,-21,38
RZ Pellets W,4188,9,10,6,20,47,65,-18,36
Mattersburg,4188,10,9,8,19,34,61,-27,35
FC Salzburg,4189,1,21,8,7,71,34,37,71
SC Rheindorf,4189,2,22,5,9,61,42,19,71
SK Sturm Gra,4189,3,18,8,10,65,34,31,62
Vienna,4189,4,17,6,13,60,55,5,57
RZ Pellets W,4189,5,12,9,15,45,53,-8,45
Rapid Vienna,4189,6,10,14,12,55,49,6,44
Admira Wacke,4189,7,13,5,18,37,56,-19,44
St. Pölten,4189,8,10,11,15,45,66,-21,41
SV Josko Rie,4189,9,9,8,19,37,62,-25,35
Mattersburg,4189,10,8,6,22,38,63,-25,30
FC Salzburg,4190,1,22,6,8,61,31,30,72
SK Sturm Gra,4190,2,20,4,12,62,37,25,64
SC Rheindorf,4190,3,19,6,11,59,45,14,63
Vienna,4190,4,18,7,11,57,46,11,61
Rapid Vienna,4190,5,16,11,9,60,35,25,59
St. Pölten,4190,6,12,9,15,46,58,-12,45
RZ Pellets W,4190,7,10,7,19,42,66,-24,37
Mattersburg,4190,8,10,6,20,39,62,-23,36
Admira Wacke,4190,9,10,6,20,33,60,-27,36
SV Josko Rie,4190,10,9,6,21,34,53,-19,33
FC Salzburg,4191,1,19,8,9,64,29,35,65
SK Sturm Gra,4191,2,19,8,9,64,33,31,65
Vienna,4191,3,20,5,11,60,51,9,65
SC Rheindorf,4191,4,18,8,10,53,43,10,62
Rapid Vienna,4191,5,13,11,12,50,44,6,50
RZ Pellets W,4191,6,11,9,16,47,59,-12,42
Admira Wacke,4191,7,10,10,16,39,58,-19,40
SV Josko Rie,4191,8,10,9,17,32,51,-19,39
Mattersburg,4191,9,8,11,17,36,52,-16,35
St. Pölten,4191,10,7,11,18,38,63,-25,32
SC Rheindorf,4192,1,23,5,8,53,35,18,74
FC Salzburg,4192,2,20,6,10,62,35,27,66
SK Sturm Gra,4192,3,20,5,11,64,34,30,65
Vienna,4192,4,20,2,14,66,56,10,62
Rapid Vienna,4192,5,12,13,11,56,44,12,49
RZ Pellets W,4192,6,13,10,13,47,52,-5,49
SV Josko Rie,4192,7,14,4,18,36,51,-15,46
St. Pölten,4192,8,8,12,16,41,60,-19,36
Mattersburg,4192,9,8,6,22,41,64,-23,30
Admira Wacke,4192,10,7,7,22,30,65,-35,28
FC Salzburg,4193,1,22,9,5,73,32,41,75
SK Sturm Gra,4193,2,20,6,10,64,33,31,66
SC Rheindorf,4193,3,17,9,10,53,41,12,60
Vienna,4193,4,17,4,15,54,56,-2,55
Rapid Vienna,4193,5,13,12,11,49,39,10,51
Admira Wacke,4193,6,12,8,16,35,54,-19,44
RZ Pellets W,4193,7,11,8,17,38,59,-21,41
SV Josko Rie,4193,8,9,11,16,34,47,-13,38
Mattersburg,4193,9,8,10,18,40,58,-18,34
St. Pölten,4193,10,7,11,18,42,63,-21,32
SK Sturm Gra,4194,1,25,4,7,69,32,37,79
FC Salzburg,4194,2,21,9,6,66,29,37,72
SC Rheindorf,4194,3,20,6,10,57,36,21,66
Rapid Vienna,4194,4,15,10,11,55,38,17,55
Vienna,4194,5,16,6,14,60,56,4,54
Mattersburg,4194,6,11,7,18,36,53,-17,40
SV Josko Rie,4194,7,11,6,19,37,55,-18,39
RZ Pellets W,4194,8,10,7,19,42,59,-17,37
Admira Wacke,4194,9,10,5,21,32,61,-29,35
St. Pölten,4194,10,5,12,19,34,69,-35,27
FC Salzburg,4195,1,19,8,9,62,31,31,65
SC Rheindorf,4195,2,19,7,10,54,39,15,64
SK Sturm Gra,4195,3,19,6,11,57,38,19,63
Vienna,4195,4,17,7,12,65,54,11,58
Rapid Vienna,4195,5,13,12,11,55,40,15,51
Admira Wacke,4195,6,13,5,18,35,55,-20,44
SV Josko Rie,4195,7,12,5,19,35,53,-18,41
St. Pölten,4195,8,10,10,16,39,59,-20,40
RZ Pellets W,4195,9,10,9,17,47,61,-14,39
Mattersburg,4195,10,9,9,18,39,58,-19,36
FC Salzburg,4196,1,19,8,9,63,34,29,65
SC Rheindorf,4196,2,18,10,8,60,52,8,64
Vienna,4196,3,19,5,12,64,53,11,62
Rapid Vienna,4196,4,17,10,9,60,38,22,61
SK Sturm Gra,4196,5,19,3,14,61,40,21,60
RZ Pellets W,4196,6,14,7,15,50,52,-2,49
Admira Wacke,4196,7,13,6,17,44,58,-14,45
SV Josko Rie,4196,8,11,6,19,34,51,-17,39
Mattersburg,4196,9,7,9,20,40,67,-27,30
St. Pölten,4196,10,6,10,20,39,70,-31,28
FC Salzburg,4197,1,23,7,6,60,25,35,76
SK Sturm Gra,4197,2,20,7,9,57,33,24,67
SC Rheindorf,4197,3,18,8,10,54,42,12,62
Vienna,4197,4,16,7,13,57,48,9,55
Rapid Vienna,4197,5,14,9,13,52,39,13,51
RZ Pellets W,4197,6,15,6,15,51,54,-3,51
Mattersburg,4197,7,10,9,17,39,54,-15,39
Admira Wacke,4197,8,9,11,16,42,64,-22,38
SV Josko Rie,4197,9,10,6,20,30,50,-20,36
St. Pölten,4197,10,5,10,21,38,71,-33,25
FC Salzburg,4198,1,20,9,7,66,32,34,69
SC Rheindorf,4198,2,20,8,8,52,38,14,68
SK Sturm Gra,4198,3,18,6,12,55,39,16,60
Vienna,4198,4,17,8,11,60,49,11,59
RZ Pellets W,4198,5,15,10,11,51,47,4,55
Rapid Vienna,4198,6,12,11,13,54,43,11,47
Admira Wacke,4198,7,10,8,18,35,57,-22,38
St. Pölten,4198,8,9,10,17,41,62,-21,37
SV Josko Rie,4198,9,10,5,21,32,54,-22,35
Mattersburg,4198,10,8,7,21,39,64,-25,31
FC Salzburg,4199,1,24,4,8,69,29,40,76
SC Rheindorf,4199,2,23,5,8,59,39,20,74
SK Sturm Gra,4199,3,18,6,12,53,31,22,60
RZ Pellets W,4199,4,16,7,13,44,45,-1,55
Vienna,4199,5,15,7,14,60,59,1,52
Rapid Vienna,4199,6,11,15,10,55,39,16,48
SV Josko Rie,4199,7,10,6,20,30,51,-21,36
Admira Wacke,4199,8,9,8,19,34,61,-27,35
Mattersburg,4199,9,9,7,20,30,61,-31,34
St. Pölten,4199,10,7,11,18,37,56,-19,32
FC Salzburg,4200,1,24,6,6,65,21,44,78
SC Rheindorf,4200,2,20,9,7,58,38,20,69
Vienna,4200,3,20,6,10,61,51,10,66
SK Sturm Gra,4200,4,20,5,11,67,39,28,65
Rapid Vienna,4200,5,15,10,11,57,43,14,55
RZ Pellets W,4200,6,11,9,16,42,57,-15,42
St. Pölten,4200,7,8,10,18,48,72,-24,34
Admira Wacke,4200,8,9,7,20,38,64,-26,34
SV Josko Rie,4200,9,9,4,23,32,59,-27,31
Mattersburg,4200,10,7,8,21,37,61,-24,29
FC Salzburg,4201,1,20,7,9,61,32,29,67
Vienna,4201,2,21,4,11,65,51,14,67
SC Rheindorf,4201,3,19,7,10,56,43,13,64
Rapid Vienna,4201,4,15,12,9,55,40,15,57
SK Sturm Gra,4201,5,15,8,13,53,38,15,53
Admira Wacke,4201,6,13,6,17,42,56,-14,45
SV Josko Rie,4201,7,11,8,17,36,49,-13,41
RZ Pellets W,4201,8,11,6,19,41,62,-21,39
St. Pölten,4201,9,9,9,18,42,61,-19,36
Mattersburg,4201,10,7,11,18,35,54,-19,32
Vienna,4202,1,19,7,10,58,44,14,64
SK Sturm Gra,4202,2,19,6,11,60,32,28,63
FC Salzburg,4202,3,17,11,8,59,29,30,62
SC Rheindorf,4202,4,18,8,10,52,41,11,62
RZ Pellets W,4202,5,15,6,15,47,55,-8,51
Rapid Vienna,4202,6,13,9,14,53,40,13,48
Admira Wacke,4202,7,14,5,17,34,54,-20,47
SV Josko Rie,4202,8,12,4,20,37,56,-19,40
Mattersburg,4202,9,10,7,19,36,56,-20,37
St. Pölten,4202,10,7,9,20,39,68,-29,30
FC Salzburg,4203,1,22,5,9,71,37,34,71
SK Sturm Gra,4203,2,21,6,9,64,37,27,69
Vienna,4203,3,19,4,13,59,51,8,61
SC Rheindorf,4203,4,16,8,12,53,47,6,56
Rapid Vienna,4203,5,14,11,11,55,40,15,53
RZ Pellets W,4203,6,14,5,17,42,53,-11,47
SV Josko Rie,4203,7,13,4,19,40,56,-16,43
Admira Wacke,4203,8,11,7,18,34,56,-22,40
St. Pölten,4203,9,8,11,17,34,55,-21,35
Mattersburg,4203,10,7,9,20,36,56,-20,30
FC Salzburg,4204,1,22,8,6,64,30,34,74
SK Sturm Gra,4204,2,20,7,9,64,34,30,67
SC Rheindorf,4204,3,19,7,10,54,45,9,64
Vienna,4204,4,18,4,14,60,53,7,58
Rapid Vienna,4204,5,11,15,10,57,44,13,48
RZ Pellets W,4204,6,12,9,15,42,48,-6,45
St. Pölten,4204,7,10,10,16,49,63,-14,40
SV Josko Rie,4204,8,10,8,18,40,59,-19,38
Admira Wacke,4204,9,10,7,19,38,62,-24,37
Mattersburg,4204,10,6,9,21,36,66,-30,27
FC Salzburg,4205,1,23,7,6,68,30,38,76
SC Rheindorf,4205,2,21,8,7,61,36,25,71
SK Sturm Gra,4205,3,19,8,9,58,34,24,65
Rapid Vienna,4205,4,14,10,12,53,38,15,52
Vienna,4205,5,16,4,16,64,61,3,52
RZ Pellets W,4205,6,12,8,16,50,60,-10,44
Admira Wacke,4205,7,11,6,19,37,62,-25,39
Mattersburg,4205,8,10,8,18,36,58,-22,38
SV Josko Rie,4205,9,10,7,19,38,55,-17,37
St. Pölten,4205,10,6,10,20,36,67,-31,28
FC Salzburg,4206,1,19,8,9,68,35,33,65
SK Sturm Gra,4206,2,19,5,12,58,32,26,62
Rapid Vienna,4206,3,17,9,10,61,37,24,60
Vienna,4206,4,19,3,14,60,52,8,60
SC Rheindorf,4206,5,18,6,12,50,47,3,60
SV Josko Rie,4206,6,14,4,18,40,55,-15,46
RZ Pellets W,4206,7,11,11,14,40,49,-9,44
St. Pölten,4206,8,9,10,17,39,61,-22,37
Admira Wacke,4206,9,10,7,19,32,58,-26,37
Mattersburg,4206,10,7,11,18,39,61,-22,32
FC Salzburg,4207,1,21,7,8,72,34,38,70
SK Sturm Gra,4207,2,20,7,9,63,32,31,67
SC Rheindorf,4207,3,18,9,9,58,45,13,63
Rapid Vienna,4207,4,16,10,10,57,39,18,58
Vienna,4207,5,17,6,13,58,56,2,57
RZ Pellets W,4207,6,11,7,18,39,56,-17,40
SV Josko Rie,4207,7,11,6,19,35,52,-17,39
Mattersburg,4207,8,10,8,18,45,65,-20,38
Admira Wacke,4207,9,9,8,19,34,62,-28,35
St. Pölten,4207,10,7,12,17,47,67,-20,33
FC Salzburg,4208,1,24,6,6,72,28,44,78
SK Sturm Gra,4208,2,19,8,9,63,39,24,65
SC Rheindorf,4208,3,18,8,10,48,44,4,62
Vienna,4208,4,16,7,13,55,49,6,55
Rapid Vienna,4208,5,13,12,11,50,38,12,51
RZ Pellets W,4208,6,12,10,14,49,54,-5,46
Mattersburg,4208,7,10,8,18,37,52,-15,38
Admira Wacke,4208,8,10,8,18,39,59,-20,38
SV Josko Rie,4208,9,11,3,22,36,58,-22,36
St. Pölten,4208,10,7,10,19,38,66,-28,31
SC Rheindorf,4209,1,21,8,7,49,35,14,71
SK Sturm Gra,4209,2,20,7,9,64,35,29,67
FC Salzburg,4209,3,18,10,8,63,33,30,64
Vienna,4209,4,17,8,11,64,52,12,59
Rapid Vienna,4209,5,12,11,13,51,42,9,47
RZ Pellets W,4209,6,13,6,17,45,55,-10,45
SV Josko Rie,4209,7,11,8,17,36,45,-9,41
St. Pölten,4209,8,9,9,18,44,69,-25,36
Admira Wacke,4209,9,10,5,21,35,66,-31,35
Mattersburg,4209,10,8,10,18,31,50,-19,34
FC Salzburg,4210,1,22,5,9,71,30,41,71
SK Sturm Gra,4210,2,20,6,10,64,31,33,66
SC Rheindorf,4210,3,19,7,10,50,42,8,64
Rapid Vienna,4210,4,15,11,10,58,40,18,56
Vienna,4210,5,16,5,15,57,53,4,53
RZ Pellets W,4210,6,13,8,15,42,55,-13,47
Admira Wacke,4210,7,12,6,18,37,60,-23,42
SV Josko Rie,4210,8,12,4,20,31,53,-22,40
St. Pölten,4210,9,9,8,19,43,68,-25,35
Mattersburg,4210,10,7,10,19,35,56,-21,31
SC Rheindorf,4211,1,21,8,7,55,36,19,71
FC Salzburg,4211,2,21,6,9,65,37,28,69
SK Sturm Gra,4211,3,20,7,9,62,27,35,67
Vienna,4211,4,19,6,11,61,47,14,63
Rapid Vienna,4211,5,15,12,9,59,38,21,57
RZ Pellets W,4211,6,11,8,17,39,49,-10,41
Admira Wacke,4211,7,11,6,19,33,60,-27,39
St. Pölten,4211,8,8,9,19,38,59,-21,33
SV Josko Rie,4211,9,9,6,21,25,55,-30,33
Mattersburg,4211,10,7,8,21,31,60,-29,29
FC Salzburg,4212,1,21,6,9,66,39,27,69
SC Rheindorf,4212,2,19,8,9,59,45,14,65
Vienna,4212,3,17,7,12,65,53,12,58
SK Sturm Gra,4212,4,17,5,14,57,38,19,56
Rapid Vienna,4212,5,14,11,11,56,39,17,53
RZ Pellets W,4212,6,13,8,15,48,52,-4,47
SV Josko Rie,4212,7,13,6,17,41,54,-13,45
Admira Wacke,4212,8,13,6,17,38,58,-20,45
St. Pölten,4212,9,9,10,17,41,63,-22,37
Mattersburg,4212,10,6,9,21,35,65,-30,27
FC Salzburg,4213,1,19,10,7,68,33,35,67
SC Rheindorf,4213,2,19,7,10,63,50,13,64
SK Sturm Gra,4213,3,17,8,11,58,43,15,59
Vienna,4213,4,17,5,14,59,53,6,56
Rapid Vienna,4213,5,14,10,12,60,41,19,52
RZ Pellets W,4213,6,13,8,15,47,54,-7,47
Admira Wacke,4213,7,11,11,14,39,60,-21,44
SV Josko Rie,4213,8,12,5,19,33,52,-19,41
Mattersburg,4213,9,10,7,19,45,60,-15,37
St. Pölten,4213,10,8,9,19,44,70,-26,33
FC Salzburg,4214,1,21,8,7,65,33,32,71
SC Rheindorf,4214,2,18,10,8,53,39,14,64
SK Sturm Gra,4214,3,18,9,9,53,28,25,63
Vienna,4214,4,19,3,14,61,53,8,60
Rapid Vienna,4214,5,14,11,11,52,37,15,53
RZ Pellets W,4214,6,14,7,15,47,48,-1,49
Mattersburg,4214,7,12,5,19,40,52,-12,41
Admira Wacke,4214,8,10,8,18,32,57,-25,38
St. Pölten,4214,9,8,10,18,39,66,-27,34
SV Josko Rie,4214,10,7,7,22,29,58,-29,28
FC Salzburg,4215,1,20,8,8,66,38,28,68
Vienna,4215,2,20,3,13,61,52,9,63
SK Sturm Gra,4215,3,18,8,10,56,39,17,62
SC Rheindorf,4215,4,18,7,11,51,45,6,61
Rapid Vienna,4215,5,13,10,13,56,48,8,49
RZ Pellets W,4215,6,14,7,15,48,49,-1,49
Mattersburg,4215,7,11,11,14,43,47,-4,44
St. Pölten,4215,8,10,9,17,46,59,-13,39
Admira Wacke,4215,9,10,6,20,45,70,-25,36
SV Josko Rie,4215,10,9,5,22,35,60,-25,32
SC Rheindorf,4216,1,18,9,9,51,39,12,63
SK Sturm Gra,4216,2,17,9,10,54,31,23,60
Rapid Vienna,4216,3,16,12,8,60,39,21,60
FC Salzburg,4216,4,17,8,11,55,34,21,59
Vienna,4216,5,17,5,14,64,55,9,56
RZ Pellets W,4216,6,13,8,15,49,55,-6,47
Admira Wacke,4216,7,13,8,15,39,57,-18,47
Mattersburg,4216,8,10,7,19,41,62,-21,37
SV Josko Rie,4216,9,10,6,20,33,50,-17,36
St. Pölten,4216,10,9,8,19,45,69,-24,35
SK Sturm Gra,4217,1,22,5,9,56,28,28,71
FC Salzburg,4217,2,20,5,11,57,31,26,65
Rapid Vienna,4217,3,16,9,11,53,39,14,57
SC Rheindorf,4217,4,17,6,13,46,40,6,57
Vienna,4217,5,17,4,15,50,50,0,55
RZ Pellets W,4217,6,13,7,16,45,52,-7,46
SV Josko Rie,4217,7,10,10,16,32,44,-12,40
Mattersburg,4217,8,11,7,18,42,55,-13,40
Admira Wacke,4217,9,10,9,17,36,54,-18,39
St. Pölten,4217,10,9,8,19,38,62,-24,35
FC Salzburg,4218,1,22,7,7,74,34,40,73
SC Rheindorf,4218,2,20,7,9,58,45,13,67
SK Sturm Gra,4218,3,19,7,10,63,44,19,64
Vienna,4218,4,19,5,12,65,56,9,62
Rapid Vienna,4218,5,14,9,13,56,46,10,51
SV Josko Rie,4218,6,12,7,17,35,49,-14,43
Admira Wacke,4218,7,12,7,17,46,61,-15,43
RZ Pellets W,4218,8,10,7,19,40,59,-19,37
Mattersburg,4218,9,8,11,17,40,54,-14,35
St. Pölten,4218,10,6,9,21,40,69,-29,27
Vienna,4219,1,24,2,10,69,40,29,74
SC Rheindorf,4219,2,22,5,9,66,47,19,71
SK Sturm Gra,4219,3,21,4,11,63,36,27,67
FC Salzburg,4219,4,19,9,8,63,32,31,66
Rapid Vienna,4219,5,11,12,13,61,54,7,45
RZ Pellets W,4219,6,13,6,17,42,63,-21,45
St. Pölten,4219,7,10,8,18,38,59,-21,38
SV Josko Rie,4219,8,10,5,21,38,62,-24,35
Mattersburg,4219,9,9,7,20,43,61,-18,34
Admira Wacke,4219,10,9,6,21,36,65,-29,33
SC Rheindorf,4220,1,21,6,9,59,39,20,69
SK Sturm Gra,4220,2,19,8,9,58,33,25,65
FC Salzburg,4220,3,18,10,8,68,36,32,64
Vienna,4220,4,15,8,13,55,49,6,53
Rapid Vienna,4220,5,13,10,13,53,45,8,49
RZ Pellets W,4220,6,13,9,14,45,54,-9,48
SV Josko Rie,4220,7,14,4,18,47,53,-6,46
Admira Wacke,4220,8,11,7,18,34,58,-24,40
Mattersburg,4220,9,10,7,19,37,60,-23,37
St. Pölten,4220,10,7,9,20,32,61,-29,30
FC Salzburg,4221,1,20,9,7,67,31,36,69
SK Sturm Gra,4221,2,20,7,9,64,31,33,67
Vienna,4221,3,18,5,13,62,56,6,59
SC Rheindorf,4221,4,17,8,11,55,50,5,59
Rapid Vienna,4221,5,11,14,11,52,42,10,47
Admira Wacke,4221,6,11,12,13,36,50,-14,45
RZ Pellets W,4221,7,11,10,15,48,57,-9,43
St. Pölten,4221,8,10,10,16,47,64,-17,40
Mattersburg,4221,9,8,10,18,32,52,-20,34
SV Josko Rie,4221,10,7,9,20,28,58,-30,30
FC Salzburg,4222,1,24,8,4,62,22,40,80
SC Rheindorf,4222,2,19,8,9,51,38,13,65
SK Sturm Gra,4222,3,19,7,10,57,34,23,64
Vienna,4222,4,15,7,14,59,59,0,52
Rapid Vienna,4222,5,13,10,13,58,45,13,49
RZ Pellets W,4222,6,12,9,15,52,61,-9,45
St. Pölten,4222,7,10,10,16,43,60,-17,40
Admira Wacke,4222,8,11,6,19,37,60,-23,39
SV Josko Rie,4222,9,9,8,19,37,57,-20,35
Mattersburg,4222,10,7,9,20,35,55,-20,30
SC Rheindorf,4223,1,21,6,9,59,43,16,69
FC Salzburg,4223,2,20,8,8,66,30,36,68
Vienna,4223,3,19,7,10,66,52,14,64
Rapid Vienna,4223,4,15,12,9,58,41,17,57
SK Sturm Gra,4223,5,16,7,13,56,39,17,55
RZ Pellets W,4223,6,12,5,19,45,59,-14,41
SV Josko Rie,4223,7,11,6,19,37,54,-17,39
Admira Wacke,4223,8,10,8,18,36,62,-26,38
Mattersburg,4223,9,9,9,18,35,52,-17,36
St. Pölten,4223,10,9,8,19,40,66,-26,35
SC Rheindorf,4224,1,22,8,6,58,40,18,74
FC Salzburg,4224,2,19,10,7,59,26,33,67
Vienna,4224,3,20,7,9,66,44,22,67
SK Sturm Gra,4224,4,16,10,10,56,34,22,58
Rapid Vienna,4224,5,11,11,14,50,46,4,44
RZ Pellets W,4224,6,12,8,16,44,57,-13,44
Admira Wacke,4224,7,11,7,18,38,56,-18,40
St. Pölten,4224,8,8,11,17,41,61,-20,35
Mattersburg,4224,9,9,8,19,34,58,-24,35
SV Josko Rie,4224,10,8,8,20,32,56,-24,32
SC Rheindorf,4225,1,22,6,8,57,36,21,72
FC Salzburg,4225,2,20,7,9,67,34,33,67
SK Sturm Gra,4225,3,16,10,10,52,32,20,58
Vienna,4225,4,17,6,13,55,49,6,57
Rapid Vienna,4225,5,13,12,11,48,39,9,51
Admira Wacke,4225,6,14,8,14,39,49,-10,50
St. Pölten,4225,7,10,11,15,42,55,-13,41
RZ Pellets W,4225,8,12,5,19,44,60,-16,41
SV Josko Rie,4225,9,8,7,21,35,62,-27,31
Mattersburg,4225,10,6,12,18,32,55,-23,30
SC Rheindorf,4226,1,22,5,9,62,46,16,71
FC Salzburg,4226,2,21,7,8,71,37,34,70
Vienna,4226,3,20,4,12,72,54,18,64
SK Sturm Gra,4226,4,17,6,13,60,44,16,57
Rapid Vienna,4226,5,14,11,11,57,46,11,53
RZ Pellets W,4226,6,13,8,15,48,56,-8,47
Admira Wacke,4226,7,12,6,18,43,59,-16,42
St. Pölten,4226,8,10,8,18,52,71,-19,38
Mattersburg,4226,9,9,10,17,38,54,-16,37
SV Josko Rie,4226,10,8,3,25,32,68,-36,27
SC Rheindorf,4227,1,21,7,8,53,34,19,70
FC Salzburg,4227,2,20,8,8,69,31,38,68
SK Sturm Gra,4227,3,19,5,12,60,33,27,62
Vienna,4227,4,19,5,12,62,51,11,62
Admira Wacke,4227,5,14,9,13,38,48,-10,51
Rapid Vienna,4227,6,11,12,13,55,47,8,45
RZ Pellets W,4227,7,11,10,15,43,55,-12,43
SV Josko Rie,4227,8,10,8,18,34,54,-20,38
St. Pölten,4227,9,7,10,19,36,64,-28,31
Mattersburg,4227,10,5,12,19,31,64,-33,27
FC Salzburg,4228,1,21,4,11,61,30,31,67
SC Rheindorf,4228,2,18,9,9,55,43,12,63
Vienna,4228,3,19,5,12,60,49,11,62
SK Sturm Gra,4228,4,16,8,12,51,34,17,56
Rapid Vienna,4228,5,13,12,11,48,38,10,51
Admira Wacke,4228,6,14,6,16,39,57,-18,48
SV Josko Rie,4228,7,14,4,18,34,43,-9,46
St. Pölten,4228,8,11,9,16,37,55,-18,42
RZ Pellets W,4228,9,11,7,18,46,57,-11,40
Mattersburg,4228,10,7,8,21,37,62,-25,29
SC Rheindorf,4229,1,22,6,8,61,41,20,72
Vienna,4229,2,21,5,10,72,50,22,68
FC Salzburg,4229,3,19,8,9,67,37,30,65
SK Sturm Gra,4229,4,17,10,9,62,35,27,61
Rapid Vienna,4229,5,13,11,12,52,41,11,50
RZ Pellets W,4229,6,13,8,15,50,55,-5,47
Admira Wacke,4229,7,11,6,19,36,63,-27,39
St. Pölten,4229,8,10,6,20,50,78,-28,36
Mattersburg,4229,9,8,9,19,37,62,-25,33
SV Josko Rie,4229,10,9,5,22,35,60,-25,32
FC Salzburg,4230,1,22,9,5,57,23,34,75
SC Rheindorf,4230,2,19,8,9,52,37,15,65
Vienna,4230,3,19,5,12,60,49,11,62
SK Sturm Gra,4230,4,18,6,12,68,39,29,60
Rapid Vienna,4230,5,14,12,10,56,38,18,54
RZ Pellets W,4230,6,14,6,16,47,53,-6,48
SV Josko Rie,4230,7,14,3,19,34,48,-14,45
Admira Wacke,4230,8,10,6,20,32,61,-29,36
St. Pölten,4230,9,8,7,21,35,64,-29,31
Mattersburg,4230,10,7,8,21,35,64,-29,29
FC Salzburg,4231,1,23,6,7,69,29,40,75
SC Rheindorf,4231,2,18,11,7,53,39,14,65
SK Sturm Gra,4231,3,20,4,12,63,32,31,64
Vienna,4231,4,18,5,13,63,50,13,59
Rapid Vienna,4231,5,15,10,11,53,42,11,55
RZ Pellets W,4231,6,13,8,15,47,53,-6,47
Admira Wacke,4231,7,9,13,14,37,65,-28,40
Mattersburg,4231,8,10,6,20,37,53,-16,36
SV Josko Rie,4231,9,8,7,21,38,62,-24,31
St. Pölten,4231,10,6,10,20,35,70,-35,28
FC Salzburg,4232,1,22,10,4,74,26,48,76
Vienna,4232,2,21,7,8,72,48,24,70
SC Rheindorf,4232,3,18,7,11,49,43,6,61
SK Sturm Gra,4232,4,16,8,12,53,37,16,56
Rapid Vienna,4232,5,13,13,10,56,43,13,52
RZ Pellets W,4232,6,11,9,16,47,55,-8,42
Mattersburg,4232,7,9,10,17,39,54,-15,37
Admira Wacke,4232,8,10,6,20,36,63,-27,36
St. Pölten,4232,9,9,7,20,44,72,-28,34
SV Josko Rie,4232,10,9,7,20,41,70,-29,34
SC Rheindorf,4233,1,22,6,8,62,40,22,72
FC Salzburg,4233,2,21,5,10,62,35,27,68
SK Sturm Gra,4233,3,19,8,9,60,36,24,65
Rapid Vienna,4233,4,16,12,8,65,36,29,60
Vienna,4233,5,18,3,15,61,55,6,57
RZ Pellets W,4233,6,14,7,15,54,54,0,49
Admira Wacke,4233,7,11,7,18,36,58,-22,40
SV Josko Rie,4233,8,11,5,20,30,52,-22,38
St. Pölten,4233,9,9,8,19,48,70,-22,35
Mattersburg,4233,10,5,7,24,36,78,-42,22
FC Salzburg,4234,1,22,8,6,69,33,36,74
SC Rheindorf,4234,2,19,9,8,50,37,13,66
Vienna,4234,3,18,4,14,55,50,5,58
SK Sturm Gra,4234,4,17,5,14,54,37,17,56
RZ Pellets W,4234,5,14,10,12,45,47,-2,52
Rapid Vienna,4234,6,13,11,12,55,41,14,50
Admira Wacke,4234,7,12,8,16,40,54,-14,44
SV Josko Rie,4234,8,9,8,19,29,51,-22,35
Mattersburg,4234,9,8,10,18,34,53,-19,34
St. Pölten,4234,10,6,11,19,44,72,-28,29
SK Sturm Gra,4235,1,23,5,8,65,32,33,74
FC Salzburg,4235,2,21,7,8,67,30,37,70
SC Rheindorf,4235,3,20,5,11,64,46,18,65
Vienna,4235,4,19,6,11,63,53,10,63
Rapid Vienna,4235,5,15,7,14,59,42,17,52
RZ Pellets W,4235,6,13,5,18,44,60,-16,44
SV Josko Rie,4235,7,13,4,19,35,54,-19,43
Admira Wacke,4235,8,13,4,19,38,59,-21,43
St. Pölten,4235,9,9,7,20,38,61,-23,34
Mattersburg,4235,10,6,6,24,33,69,-36,24
FC Salzburg,4236,1,24,5,7,68,33,35,77
SK Sturm Gra,4236,2,20,8,8,67,32,35,68
SC Rheindorf,4236,3,20,7,9,62,39,23,67
Vienna,4236,4,17,4,15,63,53,10,55
Rapid Vienna,4236,5,13,12,11,54,40,14,51
RZ Pellets W,4236,6,12,7,17,44,60,-16,43
Mattersburg,4236,7,10,8,18,37,53,-16,38
St. Pölten,4236,8,9,9,18,42,66,-24,36
SV Josko Rie,4236,9,10,6,20,35,63,-28,36
Admira Wacke,4236,10,8,8,20,34,67,-33,32
FC Salzburg,4237,1,23,7,6,78,28,50,76
SC Rheindorf,4237,2,22,9,5,66,40,26,75
Vienna,4237,3,19,4,13,59,54,5,61
SK Sturm Gra,4237,4,15,8,13,55,49,6,53
Rapid Vienna,4237,5,11,15,10,58,46,12,48
Mattersburg,4237,6,10,10,16,40,52,-12,40
Admira Wacke,4237,7,11,7,18,32,56,-24,40
RZ Pellets W,4237,8,9,9,18,37,53,-16,36
St. Pölten,4237,9,8,11,17,43,68,-25,35
SV Josko Rie,4237,10,9,6,21,32,54,-22,33
SC Rheindorf,4238,1,21,7,8,63,45,18,70
FC Salzburg,4238,2,20,5,11,65,36,29,65
Vienna,4238,3,20,3,13,58,48,10,63
SK Sturm Gra,4238,4,18,8,10,52,35,17,62
Rapid Vienna,4238,5,15,10,11,56,36,20,55
RZ Pellets W,4238,6,12,9,15,44,56,-12,45
SV Josko Rie,4238,7,12,6,18,42,49,-7,42
Admira Wacke,4238,8,12,5,19,37,60,-23,41
St. Pölten,4238,9,7,11,18,39,69,-30,32
Mattersburg,4238,10,8,6,22,31,53,-22,30
SC Rheindorf,4239,1,23,9,4,67,40,27,78
FC Salzburg,4239,2,18,10,8,56,30,26,64
Rapid Vienna,4239,3,18,9,9,61,31,30,63
SK Sturm Gra,4239,4,18,6,12,62,42,20,60
Vienna,4239,5,17,9,10,66,58,8,60
RZ Pellets W,4239,6,12,8,16,51,62,-11,44
Admira Wacke,4239,7,11,6,19,32,56,-24,39
SV Josko Rie,4239,8,10,4,22,33,60,-27,34
St. Pölten,4239,9,8,8,20,39,62,-23,32
Mattersburg,4239,10,6,9,21,37,63,-26,27
SC Rheindorf,4240,1,21,10,5,58,34,24,73
FC Salzburg,4240,2,21,6,9,65,31,34,69
Vienna,4240,3,19,9,8,66,47,19,66
SK Sturm Gra,4240,4,18,5,13,53,33,20,59
RZ Pellets W,4240,5,13,9,14,44,53,-9,48
Rapid Vienna,4240,6,11,10,15,53,50,3,43
Admira Wacke,4240,7,12,6,18,38,57,-19,42
SV Josko Rie,4240,8,11,6,19,33,51,-18,39
St. Pölten,4240,9,8,8,20,38,71,-33,32
Mattersburg,4240,10,6,11,19,38,59,-21,29
FC Salzburg,4241,1,22,7,7,69,34,35,73
SC Rheindorf,4241,2,21,6,9,60,40,20,69
SK Sturm Gra,4241,3,18,9,9,59,35,24,63
Vienna,4241,4,16,6,14,56,55,1,54
RZ Pellets W,4241,5,14,6,16,50,59,-9,48
Rapid Vienna,4241,6,11,12,13,51,42,9,45
SV Josko Rie,4241,7,13,4,19,33,47,-14,43
Admira Wacke,4241,8,12,6,18,33,58,-25,42
Mattersburg,4241,9,11,7,18,45,53,-8,40
St. Pölten,4241,10,6,9,21,39,72,-33,27
SK Sturm Gra,4242,1,20,6,10,51,29,22,66
Vienna,4242,2,20,6,10,67,55,12,66
SC Rheindorf,4242,3,20,5,11,53,42,11,65
FC Salzburg,4242,4,18,9,9,62,35,27,63
Rapid Vienna,4242,5,14,10,12,54,38,16,52
Admira Wacke,4242,6,13,5,18,40,55,-15,44
RZ Pellets W,4242,7,12,6,18,50,63,-13,42
Mattersburg,4242,8,11,7,18,40,57,-17,40
SV Josko Rie,4242,9,9,7,20,29,53,-24,34
St. Pölten,4242,10,8,9,19,43,62,-19,33
FC Salzburg,4243,1,23,6,7,77,30,47,75
SK Sturm Gra,4243,2,18,10,8,71,42,29,64
Vienna,4243,3,19,6,11,72,54,18,63
SC Rheindorf,4243,4,18,8,10,53,49,4,62
Rapid Vienna,4243,5,10,18,8,52,36,16,48
RZ Pellets W,4243,6,11,10,15,51,66,-15,43
SV Josko Rie,4243,7,10,8,18,35,50,-15,38
St. Pölten,4243,8,9,9,18,42,65,-23,36
Admira Wacke,4243,9,10,6,20,36,73,-37,36
Mattersburg,4243,10,7,9,20,35,59,-24,30
FC Salzburg,4244,1,22,7,7,67,29,38,73
SC Rheindorf,4244,2,19,7,10,56,42,14,64
SK Sturm Gra,4244,3,18,7,11,55,33,22,61
Vienna,4244,4,18,5,13,60,54,6,59
Rapid Vienna,4244,5,16,10,10,63,43,20,58
RZ Pellets W,4244,6,12,9,15,41,50,-9,45
St. Pölten,4244,7,9,11,16,42,65,-23,38
SV Josko Rie,4244,8,9,9,18,38,56,-18,36
Admira Wacke,4244,9,10,6,20,38,67,-29,36
Mattersburg,4244,10,7,9,20,35,56,-21,30
FC Salzburg,4245,1,23,6,7,71,33,38,75
SC Rheindorf,4245,2,23,5,8,60,36,24,74
SK Sturm Gra,4245,3,17,8,11,60,42,18,59
Vienna,4245,4,19,2,15,62,60,2,59
Rapid Vienna,4245,5,14,8,14,52,45,7,50
RZ Pellets W,4245,6,14,6,16,50,57,-7,48
Admira Wacke,4245,7,14,4,18,41,55,-14,46
Mattersburg,4245,8,10,7,19,39,54,-15,37
St. Pölten,4245,9,7,10,19,37,62,-25,31
SV Josko Rie,4245,10,8,6,22,31,59,-28,30
SC Rheindorf,4246,1,23,6,7,65,41,24,75
FC Salzburg,4246,2,21,6,9,64,36,28,69
Vienna,4246,3,20,5,11,67,44,23,65
SK Sturm Gra,4246,4,19,6,11,67,41,26,63
Rapid Vienna,4246,5,13,12,11,61,41,20,51
Admira Wacke,4246,6,13,4,19,40,67,-27,43
RZ Pellets W,4246,7,11,7,18,47,65,-18,40
Mattersburg,4246,8,11,6,19,45,63,-18,39
SV Josko Rie,4246,9,10,6,20,31,54,-23,36
St. Pölten,4246,10,6,8,22,37,72,-35,26
FC Salzburg,4247,1,23,6,7,73,27,46,75
SC Rheindorf,4247,2,20,9,7,59,37,22,69
Vienna,4247,3,20,4,12,66,52,14,64
SK Sturm Gra,4247,4,17,8,11,55,32,23,59
Rapid Vienna,4247,5,15,8,13,53,50,3,53
Admira Wacke,4247,6,15,3,18,40,53,-13,48
SV Josko Rie,4247,7,11,6,19,35,51,-16,39
RZ Pellets W,4247,8,9,8,19,40,62,-22,35
Mattersburg,4247,9,8,9,19,35,65,-30,33
St. Pölten,4247,10,7,9,20,41,68,-27,30
FC Salzburg,4248,1,19,8,9,59,35,24,65
SC Rheindorf,4248,2,19,8,9,55,39,16,65
Vienna,4248,3,18,4,14,61,53,8,58
Rapid Vienna,4248,4,15,12,9,61,37,24,57
SK Sturm Gra,4248,5,16,9,11,57,43,14,57
SV Josko Rie,4248,6,15,4,17,42,47,-5,49
Admira Wacke,4248,7,14,6,16,39,54,-15,48
St. Pölten,4248,8,12,7,17,47,61,-14,43
RZ Pellets W,4248,9,9,7,20,44,66,-22,34
Mattersburg,4248,10,7,7,22,36,66,-30,28
FC Salzburg,4249,1,20,10,6,70,29,41,70
SK Sturm Gra,4249,2,19,7,10,62,35,27,64
SC Rheindorf,4249,3,18,8,10,52,46,6,62
Rapid Vienna,4249,4,16,9,11,63,39,24,57
Vienna,4249,5,17,6,13,59,54,5,57
Admira Wacke,4249,6,12,7,17,37,54,-17,43
St. Pölten,4249,7,9,11,16,37,57,-20,38
SV Josko Rie,4249,8,10,7,19,34,58,-24,37
RZ Pellets W,4249,9,9,9,18,37,55,-18,36
Mattersburg,4249,10,8,10,18,37,61,-24,34
FC Salzburg,4250,1,24,6,6,71,28,43,78
SC Rheindorf,4250,2,19,7,10,60,44,16,64
SK Sturm Gra,4250,3,19,6,11,61,36,25,63
Vienna,4250,4,16,5,15,59,60,-1,53
Rapid Vienna,4250,5,12,12,12,53,46,7,48
RZ Pellets W,4250,6,11,10,15,47,60,-13,43
Admira Wacke,4250,7,13,4,19,42,62,-20,43
SV Josko Rie,4250,8,12,4,20,36,53,-17,40
Mattersburg,4250,9,10,7,19,39,56,-17,37
St. Pölten,4250,10,9,9,18,44,67,-23,36
SC Rheindorf,4251,1,23,7,6,63,35,28,76
FC Salzburg,4251,2,20,7,9,74,39,35,67
SK Sturm Gra,4251,3,17,10,9,55,33,22,61
Vienna,4251,4,18,3,15,63,53,10,57
Rapid Vienna,4251,5,13,10,13,53,43,10,49
RZ Pellets W,4251,6,12,7,17,50,56,-6,43
Admira Wacke,4251,7,11,9,16,41,63,-22,42
SV Josko Rie,4251,8,12,5,19,38,51,-13,41
St. Pölten,4251,9,9,8,19,38,68,-30,35
Mattersburg,4251,10,8,8,20,32,66,-34,32
FC Salzburg,4252,1,23,7,6,64,25,39,76
SC Rheindorf,4252,2,20,7,9,57,46,11,67
SK Sturm Gra,4252,3,19,6,11,53,33,20,63
Vienna,4252,4,19,3,14,59,46,13,60
Rapid Vienna,4252,5,14,12,10,53,34,19,54
RZ Pellets W,4252,6,13,5,18,43,57,-14,44
St. Pölten,4252,7,10,11,15,44,59,-15,41
Admira Wacke,4252,8,10,7,19,36,60,-24,37
SV Josko Rie,4252,9,10,5,21,37,61,-24,35
Mattersburg,4252,10,6,9,21,33,58,-25,27
FC Salzburg,4253,1,22,9,5,70,29,41,75
SC Rheindorf,4253,2,19,9,8,59,42,17,66
SK Sturm Gra,4253,3,19,6,11,54,37,17,63
Admira Wacke,4253,4,17,4,15,45,48,-3,55
Vienna,4253,5,15,7,14,54,57,-3,52
RZ Pellets W,4253,6,14,9,13,52,54,-2,51
Rapid Vienna,4253,7,13,9,14,50,42,8,48
St. Pölten,4253,8,8,8,20,33,58,-25,32
SV Josko Rie,4253,9,9,4,23,28,48,-20,31
Mattersburg,4253,10,7,9,20,31,61,-30,30
Vienna,4254,1,23,5,8,64,38,26,74
FC Salzburg,4254,2,21,5,10,61,33,28,68
SK Sturm Gra,4254,3,20,5,11,68,35,33,65
SC Rheindorf,4254,4,17,8,11,49,47,2,59
Rapid Vienna,4254,5,13,13,10,60,42,18,52
RZ Pellets W,4254,6,13,7,16,46,52,-6,46
Admira Wacke,4254,7,10,8,18,38,59,-21,38
SV Josko Rie,4254,8,11,3,22,36,61,-25,36
St. Pölten,4254,9,8,11,17,39,62,-23,35
Mattersburg,4254,10,7,9,20,38,70,-32,30
FC Salzburg,4255,1,21,8,7,75,36,39,71
SK Sturm Gra,4255,2,21,7,8,68,31,37,70
SC Rheindorf,4255,3,20,7,9,61,47,14,67
Vienna,4255,4,19,6,11,64,57,7,63
Rapid Vienna,4255,5,15,7,14,57,52,5,52
Admira Wacke,4255,6,13,8,15,50,60,-10,47
Mattersburg,4255,7,11,5,20,36,58,-22,38
RZ Pellets W,4255,8,10,7,19,41,56,-15,37
St. Pölten,4255,9,9,6,21,44,69,-25,33
SV Josko Rie,4255,10,9,3,24,33,63,-30,30
FC Salzburg,4256,1,20,9,7,64,31,33,69
Vienna,4256,2,21,4,11,64,51,13,67
SC Rheindorf,4256,3,19,9,8,57,40,17,66
SK Sturm Gra,4256,4,18,7,11,53,30,23,61
Rapid Vienna,4256,5,15,12,9,60,37,23,57
RZ Pellets W,4256,6,11,7,18,46,58,-12,40
Admira Wacke,4256,7,10,8,18,34,53,-19,38
SV Josko Rie,4256,8,11,5,20,37,59,-22,38
Mattersburg,4256,9,10,6,20,38,60,-22,36
St. Pölten,4256,10,7,9,20,40,74,-34,30
FC Salzburg,4257,1,20,6,10,63,34,29,66
SC Rheindorf,4257,2,20,6,10,52,39,13,66
Vienna,4257,3,19,6,11,57,43,14,63
SK Sturm Gra,4257,4,17,7,12,58,37,21,58
Rapid Vienna,4257,5,15,11,10,54,34,20,56
RZ Pellets W,4257,6,13,10,13,50,55,-5,49
SV Josko Rie,4257,7,11,5,20,37,53,-16,38
Admira Wacke,4257,8,11,5,20,36,66,-30,38
Mattersburg,4257,9,9,9,18,31,53,-22,36
St. Pölten,4257,10,8,9,19,42,66,-24,33
FC Salzburg,4258,1,21,8,7,67,32,35,71
SK Sturm Gra,4258,2,19,7,10,57,33,24,64
SC Rheindorf,4258,3,18,10,8,53,41,12,64
Vienna,4258,4,16,7,13,58,53,5,55
Admira Wacke,4258,5,15,5,16,48,54,-6,50
RZ Pellets W,4258,6,15,5,16,47,54,-7,50
Rapid Vienna,4258,7,12,13,11,56,47,9,49
SV Josko Rie,4258,8,10,6,20,38,51,-13,36
St. Pölten,4258,9,8,10,18,40,67,-27,34
Mattersburg,4258,10,6,9,21,36,68,-32,27
FC Salzburg,4259,1,21,7,8,59,29,30,70
SK Sturm Gra,4259,2,21,5,10,62,36,26,68
SC Rheindorf,4259,3,20,6,10,58,43,15,66
Vienna,4259,4,19,4,13,65,52,13,61
Rapid Vienna,4259,5,14,11,11,53,39,14,53
RZ Pellets W,4259,6,10,10,16,40,51,-11,40
SV Josko Rie,4259,7,12,3,21,38,60,-22,39
Mattersburg,4259,8,9,9,18,36,52,-16,36
St. Pölten,4259,9,9,9,18,46,69,-23,36
Admira Wacke,4259,10,9,8,19,31,57,-26,35
SC Rheindorf,4260,1,21,6,9,56,45,11,69
SK Sturm Gra,4260,2,20,6,10,61,33,28,66
Vienna,4260,3,21,3,12,64,52,12,66
FC Salzburg,4260,4,19,7,10,65,40,25,64
Rapid Vienna,4260,5,14,9,13,50,35,15,51
RZ Pellets W,4260,6,11,10,15,45,56,-11,43
Admira Wacke,4260,7,12,6,18,36,55,-19,42
St. Pölten,4260,8,9,10,17,43,63,-20,37
Mattersburg,4260,9,9,7,20,35,56,-21,34
SV Josko Rie,4260,10,9,6,21,34,54,-20,33
FC Salzburg,4261,1,23,6,7,72,30,42,75
SK Sturm Gra,4261,2,19,6,11,54,33,21,63
Vienna,4261,3,19,4,13,67,55,12,61
SC Rheindorf,4261,4,17,8,11,54,50,4,59
Rapid Vienna,4261,5,14,12,10,56,41,15,54
St. Pölten,4261,6,12,8,16,47,62,-15,44
Admira Wacke,4261,7,11,8,17,36,52,-16,41
SV Josko Rie,4261,8,11,3,22,38,63,-25,36
RZ Pellets W,4261,9,9,9,18,37,62,-25,36
Mattersburg,4261,10,8,10,18,43,56,-13,34
FC Salzburg,4262,1,18,11,7,61,30,31,65
SC Rheindorf,4262,2,19,8,9,64,46,18,65
Vienna,4262,3,19,6,11,56,46,10,63
SK Sturm Gra,4262,4,18,8,10,60,36,24,62
Rapid Vienna,4262,5,12,15,9,47,35,12,51
RZ Pellets W,4262,6,13,9,14,49,62,-13,48
Admira Wacke,4262,7,12,7,17,42,56,-14,43
St. Pölten,4262,8,8,10,18,36,57,-21,34
SV Josko Rie,4262,9,9,7,20,32,57,-25,34
Mattersburg,4262,10,8,7,21,36,58,-22,31
SC Rheindorf,4263,1,23,7,6,62,36,26,76
FC Salzburg,4263,2,21,8,7,65,30,35,71
SK Sturm Gra,4263,3,18,7,11,56,32,24,61
Vienna,4263,4,17,5,14,61,53,8,56
Rapid Vienna,4263,5,15,9,12,54,40,14,54
Admira Wacke,4263,6,13,7,16,35,52,-17,46
RZ Pellets W,4263,7,12,8,16,39,52,-13,44
St. Pölten,4263,8,9,8,19,47,70,-23,35
Mattersburg,4263,9,6,12,18,33,62,-29,30
SV Josko Rie,4263,10,8,5,23,28,53,-25,29
SC Rheindorf,4264,1,23,6,7,58,38,20,75
Vienna,4264,2,21,4,11,66,47,19,67
FC Salzburg,4264,3,19,7,10,58,32,26,64
SK Sturm Gra,4264,4,16,6,14,56,36,20,54
Rapid Vienna,4264,5,12,13,11,51,39,12,49
RZ Pellets W,4264,6,13,7,16,42,54,-12,46
SV Josko Rie,4264,7,12,6,18,33,49,-16,42
St. Pölten,4264,8,10,9,17,42,57,-15,39
Admira Wacke,4264,9,11,6,19,35,60,-25,39
Mattersburg,4264,10,7,8,21,33,62,-29,29
FC Salzburg,4265,1,23,8,5,70,31,39,77
SC Rheindorf,4265,2,19,7,10,53,37,16,64
SK Sturm Gra,4265,3,19,6,11,57,38,19,63
Rapid Vienna,4265,4,17,9,10,56,40,16,60
Vienna,4265,5,18,4,14,59,49,10,58
RZ Pellets W,4265,6,11,10,15,41,52,-11,43
Admira Wacke,4265,7,12,5,19,35,57,-22,41
SV Josko Rie,4265,8,11,7,18,36,52,-16,40
Mattersburg,4265,9,8,9,19,36,55,-19,33
St. Pölten,4265,10,6,7,23,34,66,-32,25
FC Salzburg,4266,1,21,8,7,73,35,38,71
SC Rheindorf,4266,2,20,5,11,59,44,15,65
Vienna,4266,3,19,5,12,63,49,14,62
SK Sturm Gra,4266,4,17,5,14,50,38,12,56
Rapid Vienna,4266,5,13,13,10,57,46,11,52
RZ Pellets W,4266,6,13,10,13,50,49,1,49
Admira Wacke,4266,7,12,5,19,39,60,-21,41
SV Josko Rie,4266,8,12,5,19,33,54,-21,41
St. Pölten,4266,9,6,13,17,38,62,-24,31
Mattersburg,4266,10,6,13,17,31,56,-25,31
FC Salzburg,4267,1,22,7,7,66,30,36,73
SC Rheindorf,4267,2,22,5,9,64,44,20,71
Vienna,4267,3,20,5,11,72,56,16,65
Rapid Vienna,4267,4,17,9,10,54,33,21,60
SK Sturm Gra,4267,5,18,5,13,54,35,19,59
Admira Wacke,4267,6,13,6,17,39,58,-19,45
RZ Pellets W,4267,7,11,7,18,45,57,-12,40
SV Josko Rie,4267,8,10,3,23,29,63,-34,33
Mattersburg,4267,9,8,8,20,36,57,-21,32
St. Pölten,4267,10,8,7,21,38,64,-26,31
SK Sturm Gra,4268,1,21,7,8,53,27,26,70
FC Salzburg,4268,2,18,8,10,57,32,25,62
SC Rheindorf,4268,3,17,9,10,55,45,10,60
Vienna,4268,4,18,6,12,58,50,8,60
Rapid Vienna,4268,5,15,11,10,65,44,21,56
RZ Pellets W,4268,6,14,8,14,49,50,-1,50
SV Josko Rie,4268,7,12,4,20,38,54,-16,40
St. Pölten,4268,8,11,6,19,42,60,-18,39
Admira Wacke,4268,9,11,6,19,34,61,-27,39
Mattersburg,4268,10,6,9,21,36,64,-28,27
FC Salzburg,4269,1,24,5,7,66,28,38,77
SC Rheindorf,4269,2,19,7,10,56,40,16,64
Vienna,4269,3,20,3,13,74,55,19,63
SK Sturm Gra,4269,4,18,5,13,60,38,22,59
Rapid Vienna,4269,5,15,12,9,62,41,21,57
Admira Wacke,4269,6,14,5,17,38,60,-22,47
St. Pölten,4269,7,10,10,16,46,59,-13,40
RZ Pellets W,4269,8,11,7,18,42,62,-20,40
Mattersburg,4269,9,8,8,20,33,59,-26,32
SV Josko Rie,4269,10,6,8,22,25,60,-35,26
SC Rheindorf,4270,1,21,7,8,53,38,15,70
FC Salzburg,4270,2,21,6,9,69,34,35,69
Vienna,4270,3,20,6,10,66,45,21,66
SK Sturm Gra,4270,4,18,8,10,59,36,23,62
Rapid Vienna,4270,5,16,11,9,55,32,23,59
RZ Pellets W,4270,6,12,7,17,44,54,-10,43
Admira Wacke,4270,7,11,6,19,33,61,-28,39
St. Pölten,4270,8,9,9,18,45,72,-27,36
Mattersburg,4270,9,7,9,20,27,52,-25,30
SV Josko Rie,4270,10,8,5,23,32,59,-27,29
FC Salzburg,4271,1,19,7,10,67,36,31,64
Vienna,4271,2,19,5,12,66,51,15,62
SC Rheindorf,4271,3,17,11,8,53,46,7,62
SK Sturm Gra,4271,4,17,10,9,52,33,19,61
Rapid Vienna,4271,5,14,12,10,50,38,12,54
RZ Pellets W,4271,6,13,8,15,43,54,-11,47
SV Josko Rie,4271,7,12,7,17,38,52,-14,43
Admira Wacke,4271,8,11,5,20,34,58,-24,38
St. Pölten,4271,9,8,11,17,42,59,-17,35
Mattersburg,4271,10,8,8,20,38,56,-18,32
FC Salzburg,4272,1,21,5,10,68,37,31,68
SC Rheindorf,4272,2,20,8,8,50,39,11,68
Vienna,4272,3,20,3,13,66,53,13,63
SK Sturm Gra,4272,4,16,8,12,60,44,16,56
Rapid Vienna,4272,5,10,14,12,56,43,13,44
RZ Pellets W,4272,6,12,8,16,52,67,-15,44
Admira Wacke,4272,7,12,8,16,42,58,-16,44
Mattersburg,4272,8,11,7,18,37,50,-13,40
St. Pölten,4272,9,10,10,16,47,61,-14,40
SV Josko Rie,4272,10,10,5,21,34,60,-26,35
FC Salzburg,4273,1,22,8,6,62,28,34,74
SK Sturm Gra,4273,2,21,6,9,68,33,35,69
SC Rheindorf,4273,3,20,7,9,54,43,11,67
Vienna,4273,4,17,6,13,61,50,11,57
Rapid Vienna,4273,5,15,9,12,58,38,20,54
St. Pölten,4273,6,11,9,16,40,57,-17,42
RZ Pellets W,4273,7,10,10,16,46,62,-16,40
Admira Wacke,4273,8,11,7,18,46,63,-17,40
SV Josko Rie,4273,9,9,5,22,34,62,-28,32
Mattersburg,4273,10,6,9,21,37,70,-33,27
FC Salzburg,4274,1,20,9,7,70,34,36,69
Vienna,4274,2,19,6,11,68,53,15,63
SC Rheindorf,4274,3,19,5,12,59,50,9,62
SK Sturm Gra,4274,4,18,7,11,60,38,22,61
Rapid Vienna,4274,5,13,10,13,50,40,10,49
RZ Pellets W,4274,6,14,6,16,48,57,-9,48
Admira Wacke,4274,7,12,5,19,35,63,-28,41
St. Pölten,4274,8,11,7,18,49,63,-14,40
SV Josko Rie,4274,9,12,4,20,39,58,-19,40
Mattersburg,4274,10,8,9,19,40,62,-22,33
Vienna,4275,1,21,6,9,62,43,19,69
SK Sturm Gra,4275,2,18,9,9,59,32,27,63
Rapid Vienna,4275,3,17,10,9,70,39,31,61
SC Rheindorf,4275,4,17,7,12,54,54,0,58
FC Salzburg,4275,5,16,8,12,62,42,20,56
RZ Pellets W,4275,6,13,7,16,47,56,-9,46
Admira Wacke,4275,7,12,6,18,35,60,-25,42
SV Josko Rie,4275,8,12,5,19,38,54,-16,41
Mattersburg,4275,9,7,11,18,39,58,-19,32
St. Pölten,4275,10,7,11,18,37,65,-28,32
FC Salzburg,4276,1,25,6,5,66,29,37,81
SC Rheindorf,4276,2,20,7,9,58,41,17,67
SK Sturm Gra,4276,3,19,6,11,64,37,27,63
Rapid Vienna,4276,4,16,9,11,65,47,18,57
Vienna,4276,5,16,6,14,57,55,2,54
SV Josko Rie,4276,6,13,3,20,41,53,-12,42
RZ Pellets W,4276,7,11,7,18,43,61,-18,40
Mattersburg,4276,8,9,9,18,39,56,-17,36
Admira Wacke,4276,9,9,7,20,32,60,-28,34
St. Pölten,4276,10,7,10,19,41,67,-26,31
FC Salzburg,4277,1,24,6,6,66,27,39,78
SK Sturm Gra,4277,2,21,4,11,57,27,30,67
SC Rheindorf,4277,3,18,8,10,62,49,13,62
Rapid Vienna,4277,4,17,8,11,56,40,16,59
Vienna,4277,5,17,4,15,57,56,1,55
RZ Pellets W,4277,6,13,6,17,47,55,-8,45
Admira Wacke,4277,7,12,7,17,42,58,-16,43
SV Josko Rie,4277,8,12,4,20,35,56,-21,40
St. Pölten,4277,9,8,10,18,40,64,-24,34
Mattersburg,4277,10,6,7,23,33,63,-30,25
FC Salzburg,4278,1,22,6,8,70,29,41,72
Vienna,4278,2,22,2,12,67,51,16,68
SC Rheindorf,4278,3,20,5,11,57,49,8,65
SK Sturm Gra,4278,4,16,10,10,57,36,21,58
RZ Pellets W,4278,5,16,6,14,53,52,1,54
Rapid Vienna,4278,6,10,13,13,52,46,6,43
St. Pölten,4278,7,11,7,18,43,59,-16,40
Admira Wacke,4278,8,11,7,18,36,63,-27,40
SV Josko Rie,4278,9,10,3,23,34,57,-23,33
Mattersburg,4278,10,8,9,19,30,57,-27,33
SK Sturm Gra,4279,1,21,7,8,63,34,29,70
SC Rheindorf,4279,2,18,8,10,54,42,12,62
FC Salzburg,4279,3,16,11,9,60,31,29,59
Vienna,4279,4,16,7,13,60,58,2,55
Rapid Vienna,4279,5,15,8,13,60,45,15,53
RZ Pellets W,4279,6,15,7,14,51,55,-4,52
Admira Wacke,4279,7,14,6,16,46,62,-16,48
St. Pölten,4279,8,10,8,18,46,64,-18,38
SV Josko Rie,4279,9,11,4,21,39,60,-21,37
Mattersburg,4279,10,6,10,20,30,58,-28,28
FC Salzburg,4280,1,21,10,5,74,29,45,73
Vienna,4280,2,22,4,10,66,49,17,70
SC Rheindorf,4280,3,19,7,10,60,51,9,64
SK Sturm Gra,4280,4,17,5,14,58,44,14,56
Rapid Vienna,4280,5,13,12,11,54,38,16,51
Admira Wacke,4280,6,12,7,17,34,59,-25,43
St. Pölten,4280,7,10,11,15,40,55,-15,41
SV Josko Rie,4280,8,10,8,18,31,45,-14,38
RZ Pellets W,4280,9,9,7,20,37,59,-22,34
Mattersburg,4280,10,9,5,22,36,61,-25,32
SK Sturm Gra,4281,1,21,8,7,61,29,32,71
SC Rheindorf,4281,2,20,7,9,56,39,17,67
FC Salzburg,4281,3,18,10,8,62,35,27,64
Vienna,4281,4,18,8,10,71,50,21,62
Rapid Vienna,4281,5,11,13,12,51,44,7,46
RZ Pellets W,4281,6,11,11,14,42,52,-10,44
Admira Wacke,4281,7,11,8,17,35,58,-23,41
SV Josko Rie,4281,8,10,10,16,34,52,-18,40
Mattersburg,4281,9,8,9,19,41,61,-20,33
St. Pölten,4281,10,5,10,21,33,66,-33,25
Vienna,4282,1,24,3,9,75,48,27,75
SC Rheindorf,4282,2,22,7,7,57,33,24,73
FC Salzburg,4282,3,21,6,9,64,34,30,69
Rapid Vienna,4282,4,13,12,11,56,43,13,51
SK Sturm Gra,4282,5,14,9,13,49,39,10,51
Admira Wacke,4282,6,12,5,19,35,55,-20,41
SV Josko Rie,4282,7,12,4,20,36,59,-23,40
RZ Pellets W,4282,8,10,8,18,44,58,-14,38
St. Pölten,4282,9,9,9,18,38,62,-24,36
Mattersburg,4282,10,9,5,22,32,55,-23,32
SK Sturm Gra,4283,1,22,5,9,66,30,36,71
SC Rheindorf,4283,2,20,6,10,57,44,13,66
FC Salzburg,4283,3,19,8,9,65,35,30,65
Vienna,4283,4,18,6,12,62,55,7,60
Rapid Vienna,4283,5,13,10,13,54,42,12,49
RZ Pellets W,4283,6,12,8,16,46,55,-9,44
Mattersburg,4283,7,11,8,17,39,53,-14,41
Admira Wacke,4283,8,12,4,20,39,67,-28,40
SV Josko Rie,4283,9,11,6,19,40,55,-15,39
St. Pölten,4283,10,8,7,21,35,67,-32,31
SK Sturm Gra,4284,1,21,6,9,64,31,33,69
Vienna,4284,2,20,4,12,64,46,18,64
SC Rheindorf,4284,3,18,9,9,55,45,10,63
FC Salzburg,4284,4,18,8,10,60,35,25,62
Rapid Vienna,4284,5,14,13,9,51,35,16,55
St. Pölten,4284,6,11,10,15,47,58,-11,43
Admira Wacke,4284,7,13,4,19,40,61,-21,43
RZ Pellets W,4284,8,11,7,18,38,57,-19,40
SV Josko Rie,4284,9,7,10,19,32,54,-22,31
Mattersburg,4284,10,8,7,21,36,65,-29,31
SK Sturm Gra,4285,1,23,5,8,64,28,36,74
SC Rheindorf,4285,2,20,8,8,60,44,16,68
FC Salzburg,4285,3,20,7,9,57,29,28,67
Vienna,4285,4,20,5,11,67,55,12,65
Rapid Vienna,4285,5,11,12,13,57,44,13,45
Admira Wacke,4285,6,11,8,17,36,57,-21,41
RZ Pellets W,4285,7,11,7,18,43,59,-16,40
SV Josko Rie,4285,8,11,4,21,37,55,-18,37
Mattersburg,4285,9,9,10,17,42,61,-19,37
St. Pölten,4285,10,7,8,21,36,67,-31,29
FC Salzburg,4286,1,22,7,7,70,30,40,73
SC Rheindorf,4286,2,17,10,9,54,43,11,61
SK Sturm Gra,4286,3,18,5,13,53,36,17,59
Vienna,4286,4,18,4,14,64,55,9,58
Rapid Vienna,4286,5,15,10,11,68,48,20,55
St. Pölten,4286,6,12,9,15,44,59,-15,45
RZ Pellets W,4286,7,12,7,17,46,56,-10,43
Admira Wacke,4286,8,12,5,19,40,61,-21,41
SV Josko Rie,4286,9,10,8,18,32,51,-19,38
Mattersburg,4286,10,7,9,20,35,67,-32,30
FC Salzburg,4287,1,22,8,6,65,25,40,74
SC Rheindorf,4287,2,20,10,6,62,46,16,70
SK Sturm Gra,4287,3,19,10,7,62,33,29,67
Vienna,4287,4,20,3,13,59,49,10,63
Rapid Vienna,4287,5,13,14,9,53,39,14,53
SV Josko Rie,4287,6,11,5,20,33,52,-19,38
Admira Wacke,4287,7,11,5,20,33,59,-26,38
RZ Pellets W,4287,8,10,5,21,41,62,-21,35
Mattersburg,4287,9,9,7,20,42,60,-18,34
St. Pölten,4287,10,6,11,19,41,66,-25,29
FC Salzburg,4288,1,23,6,7,80,37,43,75
Vienna,4288,2,20,5,11,64,51,13,65
SC Rheindorf,4288,3,18,7,11,59,53,6,61
RZ Pellets W,4288,4,17,6,13,60,55,5,57
Rapid Vienna,4288,5,13,11,12,62,43,19,50
Admira Wacke,4288,6,14,6,16,42,57,-15,48
SK Sturm Gra,4288,7,13,8,15,50,44,6,47
SV Josko Rie,4288,8,12,5,19,36,50,-14,41
St. Pölten,4288,9,7,11,18,35,64,-29,32
Mattersburg,4288,10,6,9,21,34,68,-34,27
FC Salzburg,4289,1,20,10,6,66,26,40,70
SC Rheindorf,4289,2,20,8,8,61,46,15,68
SK Sturm Gra,4289,3,20,6,10,61,37,24,66
Vienna,4289,4,18,8,10,65,48,17,62
Rapid Vienna,4289,5,12,13,11,52,40,12,49
RZ Pellets W,4289,6,11,9,16,44,58,-14,42
St. Pölten,4289,7,9,12,15,45,61,-16,39
Admira Wacke,4289,8,11,6,19,37,66,-29,39
Mattersburg,4289,9,8,8,20,37,60,-23,32
SV Josko Rie,4289,10,8,6,22,32,58,-26,30
FC Salzburg,4290,1,22,5,9,68,33,35,71
SC Rheindorf,4290,2,19,7,10,51,40,11,64
SK Sturm Gra,4290,3,20,3,13,60,38,22,63
Vienna,4290,4,18,4,14,63,56,7,58
RZ Pellets W,4290,5,16,7,13,45,48,-3,55
Rapid Vienna,4290,6,13,10,13,49,37,12,49
SV Josko Rie,4290,7,13,4,19,33,51,-18,43
St. Pölten,4290,8,9,10,17,40,56,-16,37
Admira Wacke,4290,9,10,6,20,39,64,-25,36
Mattersburg,4290,10,8,8,20,34,59,-25,32
SK Sturm Gra,4291,1,24,5,7,69,29,40,77
SC Rheindorf,4291,2,19,10,7,55,38,17,67
FC Salzburg,4291,3,18,9,9,55,33,22,63
Vienna,4291,4,18,3,15,59,56,3,57
RZ Pellets W,4291,5,14,7,15,44,50,-6,49
Rapid Vienna,4291,6,11,10,15,53,48,5,43
Admira Wacke,4291,7,12,7,17,42,58,-16,43
SV Josko Rie,4291,8,12,4,20,32,51,-19,40
Mattersburg,4291,9,9,7,20,33,54,-21,34
St. Pölten,4291,10,7,10,19,31,56,-25,31
FC Salzburg,4292,1,21,9,6,70,30,40,72
SK Sturm Gra,4292,2,19,8,9,65,40,25,65
Rapid Vienna,4292,3,18,9,9,61,38,23,63
Vienna,4292,4,17,7,12,61,54,7,58
SC Rheindorf,4292,5,16,9,11,52,48,4,57
SV Josko Rie,4292,6,13,6,17,40,49,-9,45
Admira Wacke,4292,7,10,8,18,33,56,-23,38
RZ Pellets W,4292,8,10,6,20,41,62,-21,36
Mattersburg,4292,9,9,7,20,35,56,-21,34
St. Pölten,4292,10,8,9,19,42,67,-25,33
FC Salzburg,4293,1,25,6,5,80,27,53,81
Vienna,4293,2,19,7,10,62,47,15,64
SC Rheindorf,4293,3,18,9,9,57,45,12,63
SK Sturm Gra,4293,4,19,5,12,57,33,24,62
Rapid Vienna,4293,5,13,14,9,52,40,12,53
RZ Pellets W,4293,6,11,8,17,48,62,-14,41
Mattersburg,4293,7,10,8,18,44,67,-23,38
SV Josko Rie,4293,8,10,5,21,32,58,-26,35
St. Pölten,4293,9,7,11,18,41,65,-24,32
Admira Wacke,4293,10,8,7,21,34,63,-29,31
FC Salzburg,4294,1,25,6,5,72,26,46,81
SC Rheindorf,4294,2,18,8,10,59,52,7,62
SK Sturm Gra,4294,3,15,11,10,54,36,18,56
Rapid Vienna,4294,4,15,10,11,55,40,15,55
Vienna,4294,5,15,5,16,58,60,-2,50
Admira Wacke,4294,6,13,7,16,41,53,-12,46
RZ Pellets W,4294,7,12,8,16,43,57,-14,44
SV Josko Rie,4294,8,12,7,17,37,48,-11,43
Mattersburg,4294,9,8,9,19,41,60,-19,33
St. Pölten,4294,10,6,11,19,41,69,-28,29
SK Sturm Gra,4295,1,22,7,7,64,32,32,73
SC Rheindorf,4295,2,20,7,9,55,38,17,67
FC Salzburg,4295,3,19,7,10,66,36,30,64
Vienna,4295,4,17,4,15,60,55,5,55
Rapid Vienna,4295,5,13,12,11,52,35,17,51
RZ Pellets W,4295,6,15,5,16,45,61,-16,50
SV Josko Rie,4295,7,11,9,16,36,51,-15,42
Admira Wacke,4295,8,10,10,16,39,59,-20,40
Mattersburg,4295,9,9,8,19,40,57,-17,35
St. Pölten,4295,10,5,9,22,31,64,-33,24
Vienna,4296,1,21,5,10,64,51,13,68
SK Sturm Gra,4296,2,19,9,8,58,32,26,66
FC Salzburg,4296,3,18,10,8,65,32,33,64
SC Rheindorf,4296,4,18,8,10,60,47,13,62
Rapid Vienna,4296,5,16,11,9,63,36,27,59
RZ Pellets W,4296,6,10,9,17,49,62,-13,39
Mattersburg,4296,7,10,9,17,46,62,-16,39
Admira Wacke,4296,8,10,7,19,37,62,-25,37
SV Josko Rie,4296,9,10,5,21,34,58,-24,35
St. Pölten,4296,10,6,11,19,38,72,-34,29
FC Salzburg,4297,1,20,10,6,60,28,32,70
SK Sturm Gra,4297,2,20,9,7,56,23,33,69
Vienna,4297,3,19,4,13,61,53,8,61
SC Rheindorf,4297,4,17,9,10,52,37,15,60
Rapid Vienna,4297,5,14,11,11,52,40,12,53
Admira Wacke,4297,6,11,7,18,36,60,-24,40
SV Josko Rie,4297,7,10,9,17,34,46,-12,39
Mattersburg,4297,8,10,9,17,40,59,-19,39
RZ Pellets W,4297,9,10,7,19,38,55,-17,37
St. Pölten,4297,10,6,11,19,35,63,-28,29
FC Salzburg,4298,1,21,8,7,69,33,36,71
SK Sturm Gra,4298,2,19,8,9,64,37,27,65
Vienna,4298,3,19,3,14,68,55,13,60
SC Rheindorf,4298,4,17,8,11,48,44,4,59
Rapid Vienna,4298,5,16,8,12,55,44,11,56
Admira Wacke,4298,6,14,4,18,39,57,-18,46
RZ Pellets W,4298,7,12,8,16,44,55,-11,44
St. Pölten,4298,8,9,9,18,46,67,-21,36
SV Josko Rie,4298,9,10,5,21,33,60,-27,35
Mattersburg,4298,10,8,9,19,42,56,-14,33
SC Rheindorf,4299,1,20,10,6,55,35,20,70
SK Sturm Gra,4299,2,21,6,9,59,29,30,69
FC Salzburg,4299,3,20,8,8,55,27,28,68
Vienna,4299,4,18,5,13,55,50,5,59
Rapid Vienna,4299,5,13,8,15,53,44,9,47
RZ Pellets W,4299,6,12,7,17,48,56,-8,43
Admira Wacke,4299,7,11,9,16,38,57,-19,42
SV Josko Rie,4299,8,9,7,20,33,52,-19,34
Mattersburg,4299,9,7,12,17,34,56,-22,33
St. Pölten,4299,10,7,12,17,46,70,-24,33
FC Salzburg,4300,1,23,4,9,66,32,34,73
SK Sturm Gra,4300,2,20,5,11,67,37,30,65
SC Rheindorf,4300,3,19,8,9,56,40,16,65
Vienna,4300,4,19,5,12,58,50,8,62
Rapid Vienna,4300,5,12,11,13,52,45,7,47
St. Pölten,4300,6,10,10,16,43,63,-20,40
SV Josko Rie,4300,7,11,6,19,38,50,-12,39
Admira Wacke,4300,8,11,6,19,43,66,-23,39
Mattersburg,4300,9,9,10,17,36,52,-16,37
RZ Pellets W,4300,10,9,9,18,35,59,-24,36
FC Salzburg,4301,1,22,7,7,81,34,47,73
SK Sturm Gra,4301,2,19,10,7,64,36,28,67
SC Rheindorf,4301,3,18,7,11,52,47,5,61
Vienna,4301,4,15,7,14,68,68,0,52
SV Josko Rie,4301,5,14,7,15,42,48,-6,49
Rapid Vienna,4301,6,12,11,13,54,42,12,47
RZ Pellets W,4301,7,11,9,16,46,61,-15,42
Admira Wacke,4301,8,11,7,18,40,61,-21,40
Mattersburg,4301,9,10,8,18,40,61,-21,38
St. Pölten,4301,10,7,9,20,38,67,-29,30
FC Salzburg,4302,1,23,7,6,68,29,39,76
SK Sturm Gra,4302,2,21,6,9,58,28,30,69
SC Rheindorf,4302,3,20,7,9,60,49,11,67
Vienna,4302,4,17,7,12,65,53,12,58
Rapid Vienna,4302,5,14,12,10,63,40,23,54
Admira Wacke,4302,6,12,6,18,31,55,-24,42
Mattersburg,4302,7,9,10,17,41,60,-19,37
RZ Pellets W,4302,8,8,10,18,44,62,-18,34
SV Josko Rie,4302,9,9,6,21,32,57,-25,33
St. Pölten,4302,10,7,9,20,36,65,-29,30
SK Sturm Gra,4303,1,22,5,9,68,34,34,71
FC Salzburg,4303,2,20,8,8,70,35,35,68
SC Rheindorf,4303,3,20,5,11,52,43,9,65
Vienna,4303,4,17,5,14,56,53,3,56
Rapid Vienna,4303,5,13,10,13,55,44,11,49
Admira Wacke,4303,6,13,6,17,41,59,-18,45
SV Josko Rie,4303,7,13,2,21,35,59,-24,41
St. Pölten,4303,8,10,9,17,44,61,-17,39
Mattersburg,4303,9,10,7,19,35,52,-17,37
RZ Pellets W,4303,10,9,9,18,41,57,-16,36
FC Salzburg,4304,1,22,8,6,65,28,37,74
SC Rheindorf,4304,2,21,7,8,56,39,17,70
SK Sturm Gra,4304,3,19,7,10,63,35,28,64
Vienna,4304,4,19,5,12,57,48,9,62
Rapid Vienna,4304,5,14,11,11,59,42,17,53
RZ Pellets W,4304,6,10,10,16,42,53,-11,40
Admira Wacke,4304,7,11,7,18,31,61,-30,40
SV Josko Rie,4304,8,11,5,20,36,53,-17,38
St. Pölten,4304,9,7,10,19,41,67,-26,31
Mattersburg,4304,10,7,8,21,33,57,-24,29
FC Salzburg,4305,1,21,7,8,63,29,34,70
SK Sturm Gra,4305,2,22,3,11,70,36,34,69
SC Rheindorf,4305,3,20,7,9,52,40,12,67
RZ Pellets W,4305,4,16,8,12,52,54,-2,56
Vienna,4305,5,16,5,15,57,62,-5,53
Rapid Vienna,4305,6,13,12,11,63,43,20,51
SV Josko Rie,4305,7,11,5,20,36,59,-23,38
St. Pölten,4305,8,8,11,17,39,60,-21,35
Mattersburg,4305,9,7,11,18,36,56,-20,32
Admira Wacke,4305,10,9,5,22,39,68,-29,32
FC Salzburg,4306,1,24,6,6,68,27,41,78
SK Sturm Gra,4306,2,21,5,10,64,37,27,68
SC Rheindorf,4306,3,21,5,10,65,45,20,68
Vienna,4306,4,18,6,12,58,45,13,60
Rapid Vienna,4306,5,12,12,12,54,48,6,48
RZ Pellets W,4306,6,12,8,16,40,54,-14,44
Admira Wacke,4306,7,11,5,20,33,63,-30,38
St. Pölten,4306,8,8,11,17,40,58,-18,35
Mattersburg,4306,9,9,8,19,34,55,-21,35
SV Josko Rie,4306,10,9,4,23,31,55,-24,31
SC Rheindorf,4307,1,21,7,8,58,44,14,70
FC Salzburg,4307,2,21,6,9,67,31,36,69
Vienna,4307,3,21,3,12,71,50,21,66
SK Sturm Gra,4307,4,19,6,11,59,39,20,63
Rapid Vienna,4307,5,11,15,10,48,43,5,48
Admira Wacke,4307,6,14,5,17,39,55,-16,47
RZ Pellets W,4307,7,12,8,16,44,47,-3,44
SV Josko Rie,4307,8,10,4,22,31,59,-28,34
St. Pölten,4307,9,7,11,18,36,61,-25,32
Mattersburg,4307,10,7,9,20,38,62,-24,30
SK Sturm Gra,4308,1,21,7,8,62,31,31,70
SC Rheindorf,4308,2,19,10,7,56,36,20,67
FC Salzburg,4308,3,18,10,8,58,34,24,64
Vienna,4308,4,16,5,15,56,53,3,53
Rapid Vienna,4308,5,10,15,11,50,42,8,45
RZ Pellets W,4308,6,12,9,15,51,56,-5,45
Admira Wacke,4308,7,11,9,16,35,56,-21,42
SV Josko Rie,4308,8,11,7,18,37,56,-19,40
Mattersburg,4308,9,10,9,17,45,58,-13,39
St. Pölten,4308,10,7,9,20,37,65,-28,30
FC Salzburg,4309,1,21,6,9,60,30,30,69
SK Sturm Gra,4309,2,20,5,11,56,34,22,65
Vienna,4309,3,20,4,12,61,49,12,64
Rapid Vienna,4309,4,15,9,12,58,39,19,54
SC Rheindorf,4309,5,15,8,13,49,43,6,53
SV Josko Rie,4309,6,14,7,15,40,49,-9,49
RZ Pellets W,4309,7,14,5,17,54,55,-1,47
Admira Wacke,4309,8,11,4,21,32,61,-29,37
Mattersburg,4309,9,9,8,19,40,63,-23,35
St. Pölten,4309,10,9,8,19,34,61,-27,35
SC Rheindorf,4310,1,21,7,8,61,41,20,70
FC Salzburg,4310,2,20,9,7,69,32,37,69
Vienna,4310,3,20,5,11,65,54,11,65
SK Sturm Gra,4310,4,18,7,11,58,33,25,61
Rapid Vienna,4310,5,15,10,11,54,39,15,55
RZ Pellets W,4310,6,11,9,16,46,57,-11,42
SV Josko Rie,4310,7,11,6,19,37,53,-16,39
Admira Wacke,4310,8,11,5,20,36,68,-32,38
Mattersburg,4310,9,8,8,20,34,58,-24,32
St. Pölten,4310,10,6,12,18,42,67,-25,30
FC Salzburg,4311,1,23,7,6,74,31,43,76
SK Sturm Gra,4311,2,21,4,11,63,38,25,67
Vienna,4311,3,20,5,11,71,50,21,65
SC Rheindorf,4311,4,16,8,12,49,49,0,56
Rapid Vienna,4311,5,14,11,11,57,39,18,53
RZ Pellets W,4311,6,13,8,15,46,58,-12,47
Admira Wacke,4311,7,13,4,19,46,68,-22,43
Mattersburg,4311,8,9,11,16,43,56,-13,38
St. Pölten,4311,9,7,10,19,37,70,-33,31
SV Josko Rie,4311,10,7,6,23,29,56,-27,27
SC Rheindorf,4312,1,20,9,7,53,36,17,69
SK Sturm Gra,4312,2,19,7,10,62,39,23,64
FC Salzburg,4312,3,17,11,8,60,30,30,62
Vienna,4312,4,19,5,12,57,44,13,62
Rapid Vienna,4312,5,14,10,12,60,47,13,52
RZ Pellets W,4312,6,14,7,15,55,56,-1,49
SV Josko Rie,4312,7,11,7,18,34,56,-22,40
Admira Wacke,4312,8,10,8,18,36,63,-27,38
Mattersburg,4312,9,9,9,18,34,50,-16,36
St. Pölten,4312,10,5,11,20,35,65,-30,26
FC Salzburg,4313,1,22,8,6,65,29,36,74
SC Rheindorf,4313,2,21,7,8,60,41,19,70
Vienna,4313,3,18,7,11,60,50,10,61
SK Sturm Gra,4313,4,18,4,14,60,37,23,58
Rapid Vienna,4313,5,16,10,10,52,37,15,58
RZ Pellets W,4313,6,13,7,16,45,60,-15,46
SV Josko Rie,4313,7,11,4,21,36,55,-19,37
Admira Wacke,4313,8,10,6,20,34,60,-26,36
St. Pölten,4313,9,9,8,19,40,62,-22,35
Mattersburg,4313,10,8,7,21,31,52,-21,31
SC Rheindorf,4314,1,20,8,8,61,44,17,68
FC Salzburg,4314,2,20,7,9,70,36,34,67
Vienna,4314,3,20,4,12,69,60,9,64
SK Sturm Gra,4314,4,18,7,11,58,39,19,61
St. Pölten,4314,5,13,9,14,51,62,-11,48
Rapid Vienna,4314,6,11,11,14,50,45,5,44
Admira Wacke,4314,7,12,8,16,41,55,-14,44
RZ Pellets W,4314,8,12,7,17,47,61,-14,43
Mattersburg,4314,9,7,10,19,33,55,-22,31
SV Josko Rie,4314,10,8,7,21,25,48,-23,31
FC Salzburg,4315,1,21,8,7,70,31,39,71
Vienna,4315,2,21,5,10,64,42,22,68
SK Sturm Gra,4315,3,21,4,11,60,33,27,67
SC Rheindorf,4315,4,17,9,10,49,42,7,60
Rapid Vienna,4315,5,13,11,12,53,44,9,50
SV Josko Rie,4315,6,15,3,18,33,50,-17,48
RZ Pellets W,4315,7,12,8,16,44,52,-8,44
Mattersburg,4315,8,9,8,19,38,56,-18,35
St. Pölten,4315,9,7,11,18,34,58,-24,32
Admira Wacke,4315,10,8,5,23,31,68,-37,29
SC Rheindorf,4316,1,21,7,8,56,39,17,70
FC Salzburg,4316,2,20,8,8,62,29,33,68
SK Sturm Gra,4316,3,18,9,9,57,34,23,63
Rapid Vienna,4316,4,14,14,8,59,39,20,56
Vienna,4316,5,16,7,13,64,59,5,55
St. Pölten,4316,6,10,12,14,44,56,-12,42
RZ Pellets W,4316,7,10,10,16,42,57,-15,40
Mattersburg,4316,8,9,7,20,34,53,-19,34
SV Josko Rie,4316,9,9,7,20,31,52,-21,34
Admira Wacke,4316,10,9,7,20,34,65,-31,34
Vienna,4317,1,20,4,12,58,52,6,64
FC Salzburg,4317,2,18,9,9,60,32,28,63
SK Sturm Gra,4317,3,19,6,11,55,33,22,63
SC Rheindorf,4317,4,18,6,12,49,43,6,60
Rapid Vienna,4317,5,14,10,12,57,37,20,52
Admira Wacke,4317,6,13,7,16,37,51,-14,46
SV Josko Rie,4317,7,13,4,19,32,45,-13,43
St. Pölten,4317,8,11,9,16,39,56,-17,42
RZ Pellets W,4317,9,10,10,16,41,54,-13,40
Mattersburg,4317,10,8,7,21,33,58,-25,31
SK Sturm Gra,4318,1,20,6,10,59,33,26,66
SC Rheindorf,4318,2,19,8,9,53,45,8,65
Vienna,4318,3,20,3,13,63,52,11,63
FC Salzburg,4318,4,17,10,9,63,37,26,61
Rapid Vienna,4318,5,12,12,12,46,38,8,48
SV Josko Rie,4318,6,15,3,18,42,55,-13,48
RZ Pellets W,4318,7,13,8,15,45,52,-7,47
Admira Wacke,4318,8,12,5,19,38,59,-21,41
Mattersburg,4318,9,9,11,16,47,58,-11,38
St. Pölten,4318,10,6,8,22,36,63,-27,26
SC Rheindorf,4319,1,23,6,7,67,46,21,75
Vienna,4319,2,23,4,9,65,46,19,73
FC Salzburg,4319,3,22,6,8,71,34,37,72
SK Sturm Gra,4319,4,18,8,10,53,31,22,62
Rapid Vienna,4319,5,15,10,11,61,45,16,55
Admira Wacke,4319,6,11,6,19,33,56,-23,39
St. Pölten,4319,7,10,7,19,49,67,-18,37
RZ Pellets W,4319,8,9,8,19,43,61,-18,35
Mattersburg,4319,9,8,7,21,42,66,-24,31
SV Josko Rie,4319,10,8,4,24,30,62,-32,28
SK Sturm Gra,4320,1,21,6,9,65,29,36,69
SC Rheindorf,4320,2,19,8,9,53,39,14,65
Vienna,4320,3,19,6,11,67,53,14,63
Rapid Vienna,4320,4,16,11,9,59,39,20,59
FC Salzburg,4320,5,17,6,13,64,47,17,57
Admira Wacke,4320,6,14,8,14,40,54,-14,50
RZ Pellets W,4320,7,12,8,16,44,56,-12,44
Mattersburg,4320,8,9,7,20,40,62,-22,34
SV Josko Rie,4320,9,9,5,22,31,57,-26,32
St. Pölten,4320,10,7,9,20,42,69,-27,30
FC Salzburg,4321,1,22,5,9,66,30,36,71
SK Sturm Gra,4321,2,19,7,10,53,32,21,64
SC Rheindorf,4321,3,16,10,10,54,54,0,58
Vienna,4321,4,18,3,15,61,50,11,57
Rapid Vienna,4321,5,12,13,11,58,44,14,49
RZ Pellets W,4321,6,12,11,13,51,52,-1,47
Admira Wacke,4321,7,11,9,16,43,61,-18,42
SV Josko Rie,4321,8,12,5,19,35,54,-19,41
Mattersburg,4321,9,11,7,18,49,62,-13,40
St. Pölten,4321,10,7,10,19,39,70,-31,31
FC Salzburg,4322,1,22,7,7,65,29,36,73
SC Rheindorf,4322,2,20,7,9,52,40,12,67
Vienna,4322,3,17,7,12,58,48,10,58
SK Sturm Gra,4322,4,17,6,13,52,37,15,57
Rapid Vienna,4322,5,13,10,13,58,44,14,49
RZ Pellets W,4322,6,14,6,16,49,58,-9,48
Admira Wacke,4322,7,12,6,18,36,54,-18,42
SV Josko Rie,4322,8,10,8,18,33,50,-17,38
St. Pölten,4322,9,9,10,17,41,56,-15,37
Mattersburg,4322,10,9,7,20,35,63,-28,34
SC Rheindorf,4323,1,20,5,11,57,45,12,65
FC Salzburg,4323,2,17,12,7,68,34,34,63
Rapid Vienna,4323,3,17,11,8,62,37,25,62
Vienna,4323,4,18,6,12,62,51,11,60
SK Sturm Gra,4323,5,13,9,14,49,41,8,48
RZ Pellets W,4323,6,12,10,14,50,55,-5,46
Mattersburg,4323,7,10,10,16,42,53,-11,40
St. Pölten,4323,8,10,10,16,44,64,-20,40
SV Josko Rie,4323,9,10,7,19,38,56,-18,37
Admira Wacke,4323,10,10,6,20,33,69,-36,36
FC Salzburg,4324,1,21,7,8,67,29,38,70
SK Sturm Gra,4324,2,21,4,11,60,34,26,67
SC Rheindorf,4324,3,19,7,10,58,45,13,64
Vienna,4324,4,17,3,16,58,53,5,54
Rapid Vienna,4324,5,13,9,14,54,48,6,48
Mattersburg,4324,6,12,9,15,44,50,-6,45
SV Josko Rie,4324,7,13,4,19,35,52,-17,43
RZ Pellets W,4324,8,11,8,17,40,54,-14,41
St. Pölten,4324,9,10,9,17,49,70,-21,39
Admira Wacke,4324,10,10,6,20,35,65,-30,36
FC Salzburg,4325,1,20,7,9,62,30,32,67
SC Rheindorf,4325,2,18,11,7,57,42,15,65
SK Sturm Gra,4325,3,17,7,12,55,36,19,58
Vienna,4325,4,16,8,12,60,49,11,56
Rapid Vienna,4325,5,13,14,9,60,44,16,53
RZ Pellets W,4325,6,13,11,12,47,53,-6,50
Admira Wacke,4325,7,12,8,16,45,64,-19,44
SV Josko Rie,4325,8,11,5,20,35,57,-22,38
St. Pölten,4325,9,9,9,18,36,60,-24,36
Mattersburg,4325,10,7,8,21,28,50,-22,29
FC Salzburg,4326,1,20,10,6,64,30,34,70
Vienna,4326,2,20,9,7,62,40,22,69
SC Rheindorf,4326,3,18,10,8,53,42,11,64
SK Sturm Gra,4326,4,19,6,11,55,36,19,63
Rapid Vienna,4326,5,12,17,7,55,34,21,53
RZ Pellets W,4326,6,11,7,18,45,60,-15,40
Admira Wacke,4326,7,10,7,19,35,57,-22,37
Mattersburg,4326,8,9,9,18,36,56,-20,36
SV Josko Rie,4326,9,8,7,21,30,54,-24,31
St. Pölten,4326,10,7,10,19,40,66,-26,31
FC Salzburg,4327,1,22,7,7,71,34,37,73
SC Rheindorf,4327,2,20,9,7,61,45,16,69
SK Sturm Gra,4327,3,17,10,9,60,34,26,61
Vienna,4327,4,18,6,12,56,53,3,60
Rapid Vienna,4327,5,14,13,9,64,47,17,55
RZ Pellets W,4327,6,13,9,14,55,56,-1,48
Admira Wacke,4327,7,8,10,18,38,65,-27,34
Mattersburg,4327,8,7,11,18,34,56,-22,32
St. Pölten,4327,9,7,10,19,45,68,-23,31
SV Josko Rie,4327,10,8,7,21,36,62,-26,31
FC Salzburg,4328,1,23,7,6,66,28,38,76
SK Sturm Gra,4328,2,21,9,6,58,29,29,72
SC Rheindorf,4328,3,18,9,9,50,36,14,63
Vienna,4328,4,18,3,15,57,47,10,57
RZ Pellets W,4328,5,15,7,14,46,51,-5,52
Admira Wacke,4328,6,12,6,18,38,56,-18,42
Rapid Vienna,4328,7,11,8,17,47,46,1,41
SV Josko Rie,4328,8,12,5,19,32,54,-22,41
St. Pölten,4328,9,8,10,18,42,66,-24,34
Mattersburg,4328,10,6,8,22,37,60,-23,26
Vienna,4329,1,21,5,10,67,49,18,68
FC Salzburg,4329,2,19,10,7,66,31,35,67
SC Rheindorf,4329,3,20,5,11,51,39,12,65
Rapid Vienna,4329,4,16,10,10,61,41,20,58
SK Sturm Gra,4329,5,16,7,13,55,39,16,55
RZ Pellets W,4329,6,13,6,17,48,58,-10,45
Admira Wacke,4329,7,12,5,19,42,64,-22,41
SV Josko Rie,4329,8,11,7,18,36,56,-20,40
St. Pölten,4329,9,8,10,18,42,71,-29,34
Mattersburg,4329,10,7,9,20,37,57,-20,30
FC Salzburg,4330,1,23,9,4,63,25,38,78
SK Sturm Gra,4330,2,18,6,12,59,41,18,60
Vienna,4330,3,17,7,12,58,48,10,58
SC Rheindorf,4330,4,17,7,12,52,45,7,58
Rapid Vienna,4330,5,14,12,10,55,41,14,54
Admira Wacke,4330,6,11,10,15,33,50,-17,43
RZ Pellets W,4330,7,10,10,16,45,56,-11,40
St. Pölten,4330,8,10,9,17,40,56,-16,39
SV Josko Rie,4330,9,10,7,19,35,53,-18,37
Mattersburg,4330,10,6,11,19,34,59,-25,29
FC Salzburg,4331,1,22,6,8,65,33,32,72
Vienna,4331,2,20,4,12,67,46,21,64
SC Rheindorf,4331,3,18,8,10,58,43,15,62
SK Sturm Gra,4331,4,17,5,14,57,46,11,56
Rapid Vienna,4331,5,13,13,10,53,39,14,52
RZ Pellets W,4331,6,13,10,13,48,51,-3,49
Admira Wacke,4331,7,12,6,18,46,58,-12,42
SV Josko Rie,4331,8,12,4,20,36,65,-29,40
St. Pölten,4331,9,8,11,17,37,63,-26,35
Mattersburg,4331,10,8,7,21,33,56,-23,31
FC Salzburg,4332,1,23,7,6,69,32,37,76
SC Rheindorf,4332,2,21,7,8,59,40,19,70
SK Sturm Gra,4332,3,19,7,10,65,39,26,64
Vienna,4332,4,18,6,12,60,54,6,60
Rapid Vienna,4332,5,12,12,12,57,46,11,48
RZ Pellets W,4332,6,11,9,16,48,51,-3,42
Admira Wacke,4332,7,12,6,18,46,63,-17,42
SV Josko Rie,4332,8,10,8,18,31,53,-22,38
Mattersburg,4332,9,8,8,20,36,57,-21,32
St. Pölten,4332,10,6,10,20,36,72,-36,28
SC Rheindorf,4333,1,21,8,7,64,35,29,71
FC Salzburg,4333,2,20,7,9,63,39,24,67
SK Sturm Gra,4333,3,20,5,11,59,40,19,65
Vienna,4333,4,19,5,12,67,53,14,62
Rapid Vienna,4333,5,14,10,12,61,44,17,52
RZ Pellets W,4333,6,12,9,15,41,48,-7,45
Admira Wacke,4333,7,12,4,20,38,66,-28,40
SV Josko Rie,4333,8,10,7,19,40,58,-18,37
Mattersburg,4333,9,7,12,17,36,57,-21,33
St. Pölten,4333,10,6,11,19,38,67,-29,29
FC Salzburg,4334,1,21,8,7,61,31,30,71
SC Rheindorf,4334,2,21,6,9,55,40,15,69
SK Sturm Gra,4334,3,20,7,9,65,34,31,67
Rapid Vienna,4334,4,16,12,8,58,32,26,60
Vienna,4334,5,17,7,12,59,53,6,58
Admira Wacke,4334,6,10,9,17,39,62,-23,39
RZ Pellets W,4334,7,10,6,20,42,60,-18,36
SV Josko Rie,4334,8,9,8,19,32,54,-22,35
Mattersburg,4334,9,8,9,19,34,54,-20,33
St. Pölten,4334,10,7,10,19,39,64,-25,31
FC Salzburg,4335,1,22,7,7,65,30,35,73
SK Sturm Gra,4335,2,19,6,11,58,39,19,63
Vienna,4335,3,18,6,12,55,45,10,60
SC Rheindorf,4335,4,18,6,12,54,45,9,60
Rapid Vienna,4335,5,15,10,11,57,42,15,55
RZ Pellets W,4335,6,14,7,15,47,54,-7,49
Admira Wacke,4335,7,13,5,18,36,55,-19,44
St. Pölten,4335,8,10,9,17,41,57,-16,39
SV Josko Rie,4335,9,10,4,22,32,54,-22,34
Mattersburg,4335,10,7,8,21,37,61,-24,29
SC Rheindorf,4336,1,22,6,8,56,39,17,72
FC Salzburg,4336,2,18,10,8,62,34,28,64
SK Sturm Gra,4336,3,20,4,12,61,40,21,64
Rapid Vienna,4336,4,16,12,8,57,34,23,60
Vienna,4336,5,18,4,14,61,51,10,58
Admira Wacke,4336,6,13,6,17,38,55,-17,45
RZ Pellets W,4336,7,10,10,16,40,57,-17,40
SV Josko Rie,4336,8,10,6,20,35,59,-24,36
Mattersburg,4336,9,8,10,18,38,53,-15,34
St. Pölten,4336,10,6,10,20,41,67,-26,28
SC Rheindorf,4337,1,23,6,7,63,35,28,75
FC Salzburg,4337,2,20,10,6,67,33,34,70
SK Sturm Gra,4337,3,19,5,12,61,41,20,62
Vienna,4337,4,19,5,12,61,53,8,62
Rapid Vienna,4337,5,14,11,11,59,49,10,53
RZ Pellets W,4337,6,12,6,18,44,55,-11,42
SV Josko Rie,4337,7,11,6,19,34,53,-19,39
St. Pölten,4337,8,9,8,19,47,67,-20,35
Admira Wacke,4337,9,10,5,21,31,62,-31,35
Mattersburg,4337,10,8,8,20,38,57,-19,32
FC Salzburg,4338,1,22,7,7,73,33,40,73
SK Sturm Gra,4338,2,21,4,11,63,32,31,67
Vienna,4338,3,19,5,12,65,51,14,62
SC Rheindorf,4338,4,18,5,13,54,48,6,59
Rapid Vienna,4338,5,15,12,9,62,38,24,57
RZ Pellets W,4338,6,12,8,16,42,55,-13,44
Admira Wacke,4338,7,12,6,18,33,55,-22,42
Mattersburg,4338,8,11,8,17,36,56,-20,41
St. Pölten,4338,9,8,9,19,33,67,-34,33
SV Josko Rie,4338,10,7,6,23,30,56,-26,27
FC Salzburg,4339,1,23,7,6,69,26,43,76
SC Rheindorf,4339,2,19,8,9,55,37,18,65
SK Sturm Gra,4339,3,17,8,11,61,41,20,59
Vienna,4339,4,14,9,13,53,51,2,51
Rapid Vienna,4339,5,11,13,12,57,48,9,46
Admira Wacke,4339,6,12,7,17,41,55,-14,43
RZ Pellets W,4339,7,12,7,17,44,61,-17,43
SV Josko Rie,4339,8,12,6,18,36,55,-19,42
Mattersburg,4339,9,9,11,16,42,54,-12,38
St. Pölten,4339,10,9,8,19,42,72,-30,35
SK Sturm Gra,4340,1,22,4,10,61,31,30,70
FC Salzburg,4340,2,20,6,10,60,33,27,66
SC Rheindorf,4340,3,17,8,11,51,41,10,59
Vienna,4340,4,17,6,13,59,55,4,57
Rapid Vienna,4340,5,14,10,12,48,40,8,52
Admira Wacke,4340,6,14,6,16,39,50,-11,48
SV Josko Rie,4340,7,14,4,18,41,48,-7,46
RZ Pellets W,4340,8,12,7,17,47,57,-10,43
St. Pölten,4340,9,8,9,19,42,72,-30,33
Mattersburg,4340,10,7,10,19,32,53,-21,31
FC Salzburg,4341,1,23,6,7,72,29,43,75
SC Rheindorf,4341,2,22,6,8,55,40,15,72
SK Sturm Gra,4341,3,17,8,11,52,38,14,59
Vienna,4341,4,17,4,15,59,57,2,55
Rapid Vienna,4341,5,11,15,10,61,47,14,48
SV Josko Rie,4341,6,13,4,19,39,54,-15,43
Mattersburg,4341,7,11,9,16,40,53,-13,42
Admira Wacke,4341,8,10,8,18,30,52,-22,38
RZ Pellets W,4341,9,10,6,20,44,59,-15,36
St. Pölten,4341,10,9,8,19,41,64,-23,35
FC Salzburg,4342,1,23,6,7,70,28,42,75
SC Rheindorf,4342,2,19,7,10,57,40,17,64
SK Sturm Gra,4342,3,18,7,11,54,33,21,61
Vienna,4342,4,18,3,15,61,54,7,57
Rapid Vienna,4342,5,14,12,10,54,40,14,54
RZ Pellets W,4342,6,14,7,15,48,58,-10,49
Admira Wacke,4342,7,13,5,18,41,58,-17,44
SV Josko Rie,4342,8,12,5,19,40,61,-21,41
St. Pölten,4342,9,9,8,19,41,68,-27,35
Mattersburg,4342,10,6,8,22,30,56,-26,26
FC Salzburg,4343,1,20,9,7,66,35,31,69
SK Sturm Gra,4343,2,19,8,9,58,32,26,65
SC Rheindorf,4343,3,17,11,8,52,41,11,62
Vienna,4343,4,18,7,11,65,50,15,61
Rapid Vienna,4343,5,13,13,10,55,41,14,52
SV Josko Rie,4343,6,14,6,16,36,43,-7,48
RZ Pellets W,4343,7,12,4,20,40,64,-24,40
St. Pölten,4343,8,9,10,17,44,63,-19,37
Admira Wacke,4343,9,11,4,21,39,61,-22,37
Mattersburg,4343,10,7,8,21,36,61,-25,29
FC Salzburg,4344,1,23,8,5,65,28,37,77
SK Sturm Gra,4344,2,23,6,7,65,30,35,75
SC Rheindorf,4344,3,22,6,8,64,40,24,72
Vienna,4344,4,19,4,13,65,48,17,61
Rapid Vienna,4344,5,12,11,13,51,40,11,47
RZ Pellets W,4344,6,11,7,18,49,66,-17,40
SV Josko Rie,4344,7,10,7,19,30,51,-21,37
Admira Wacke,4344,8,10,5,21,28,67,-39,35
St. Pölten,4344,9,8,8,20,38,61,-23,32
Mattersburg,4344,10,7,8,21,31,55,-24,29
FC Salzburg,4345,1,22,8,6,67,32,35,74
Vienna,4345,2,21,3,12,71,53,18,66
SK Sturm Gra,4345,3,18,7,11,63,43,20,61
SC Rheindorf,4345,4,18,6,12,59,50,9,60
Rapid Vienna,4345,5,13,8,15,54,48,6,47
RZ Pellets W,4345,6,13,8,15,47,55,-8,47
Admira Wacke,4345,7,13,5,18,48,62,-14,44
Mattersburg,4345,8,10,11,15,44,52,-8,41
St. Pölten,4345,9,7,11,18,39,68,-29,32
SV Josko Rie,4345,10,8,7,21,26,55,-29,31
Vienna,4346,1,23,4,9,68,45,23,73
FC Salzburg,4346,2,21,9,6,71,28,43,72
SC Rheindorf,4346,3,18,6,12,59,52,7,60
SK Sturm Gra,4346,4,16,8,12,58,43,15,56
Rapid Vienna,4346,5,12,16,8,56,40,16,52
SV Josko Rie,4346,6,14,4,18,46,58,-12,46
RZ Pellets W,4346,7,12,6,18,47,56,-9,42
Admira Wacke,4346,8,11,5,20,38,64,-26,38
St. Pölten,4346,9,9,9,18,43,69,-26,36
Mattersburg,4346,10,7,7,22,37,68,-31,28
FC Salzburg,4347,1,19,11,6,72,31,41,68
SK Sturm Gra,4347,2,19,6,11,61,32,29,63
Vienna,4347,3,17,7,12,60,50,10,58
SC Rheindorf,4347,4,16,9,11,53,52,1,57
Rapid Vienna,4347,5,13,15,8,51,32,19,54
RZ Pellets W,4347,6,14,6,16,48,55,-7,48
Mattersburg,4347,7,10,10,16,37,54,-17,40
Admira Wacke,4347,8,11,7,18,36,62,-26,40
St. Pölten,4347,9,8,11,17,40,63,-23,35
SV Josko Rie,4347,10,8,8,20,30,57,-27,32
FC Salzburg,4348,1,21,7,8,60,30,30,70
SC Rheindorf,4348,2,21,7,8,61,36,25,70
SK Sturm Gra,4348,3,19,7,10,61,38,23,64
Vienna,4348,4,17,6,13,58,48,10,57
Admira Wacke,4348,5,13,8,15,40,49,-9,47
Rapid Vienna,4348,6,10,14,12,55,48,7,44
RZ Pellets W,4348,7,11,9,16,42,55,-13,42
Mattersburg,4348,8,10,10,16,46,56,-10,40
SV Josko Rie,4348,9,10,6,20,31,55,-24,36
St. Pölten,4348,10,8,6,22,37,76,-39,30
FC Salzburg,4349,1,20,11,5,66,27,39,71
SK Sturm Gra,4349,2,20,9,7,56,30,26,69
SC Rheindorf,4349,3,19,7,10,55,40,15,64
Vienna,4349,4,15,5,16,61,61,0,50
Rapid Vienna,4349,5,12,12,12,50,42,8,48
St. Pölten,4349,6,12,9,15,49,57,-8,45
RZ Pellets W,4349,7,10,11,15,42,53,-11,41
Admira Wacke,4349,8,11,8,17,33,56,-23,41
SV Josko Rie,4349,9,11,6,19,37,52,-15,39
Mattersburg,4349,10,6,10,20,31,62,-31,28
SC Rheindorf,4350,1,21,6,9,57,48,9,69
FC Salzburg,4350,2,20,6,10,64,32,32,66
SK Sturm Gra,4350,3,17,9,10,54,33,21,60
Rapid Vienna,4350,4,14,12,10,58,41,17,54
RZ Pellets W,4350,5,14,9,13,47,47,0,51
Vienna,4350,6,15,6,15,54,58,-4,51
St. Pölten,4350,7,10,9,17,44,60,-16,39
Mattersburg,4350,8,10,7,19,42,54,-12,37
SV Josko Rie,4350,9,10,7,19,34,57,-23,37
Admira Wacke,4350,10,10,7,19,34,58,-24,37
Rapid Vienna,4351,1,19,9,8,68,39,29,66
SC Rheindorf,4351,2,18,10,8,60,41,19,64
SK Sturm Gra,4351,3,19,6,11,58,37,21,63
Vienna,4351,4,18,8,10,61,48,13,62
FC Salzburg,4351,5,17,10,9,61,35,26,61
RZ Pellets W,4351,6,10,9,17,41,58,-17,39
Admira Wacke,4351,7,10,9,17,36,63,-27,39
Mattersburg,4351,8,9,10,17,38,56,-18,37
SV Josko Rie,4351,9,10,4,22,32,55,-23,34
St. Pölten,4351,10,7,11,18,40,63,-23,32
SC Rheindorf,4352,1,19,12,5,53,34,19,69
FC Salzburg,4352,2,19,7,10,67,34,33,64
SK Sturm Gra,4352,3,19,6,11,60,38,22,63
Vienna,4352,4,18,6,12,52,46,6,60
Rapid Vienna,4352,5,11,14,11,55,47,8,47
RZ Pellets W,4352,6,12,7,17,44,55,-11,43
SV Josko Rie,4352,7,11,7,18,34,47,-13,40
Mattersburg,4352,8,9,10,17,36,53,-17,37
St. Pölten,4352,9,8,13,15,40,59,-19,37
Admira Wacke,4352,10,10,6,20,33,61,-28,36
FC Salzburg,4353,1,22,9,5,74,29,45,75
SC Rheindorf,4353,2,19,7,10,55,49,6,64
SK Sturm Gra,4353,3,19,6,11,68,38,30,63
Vienna,4353,4,18,7,11,64,55,9,61
Rapid Vienna,4353,5,15,11,10,63,41,22,56
RZ Pellets W,4353,6,13,8,15,46,55,-9,47
Admira Wacke,4353,7,10,7,19,29,62,-33,37
SV Josko Rie,4353,8,10,3,23,36,57,-21,33
St. Pölten,4353,9,8,9,19,36,66,-30,33
Mattersburg,4353,10,7,11,18,39,58,-19,32
FC Salzburg,4354,1,22,8,6,68,30,38,74
Vienna,4354,2,19,6,11,63,51,12,63
SK Sturm Gra,4354,3,18,7,11,55,35,20,61
SC Rheindorf,4354,4,17,6,13,57,46,11,57
Rapid Vienna,4354,5,15,11,10,53,37,16,56
RZ Pellets W,4354,6,10,11,15,45,55,-10,41
St. Pölten,4354,7,10,10,16,44,62,-18,40
SV Josko Rie,4354,8,12,4,20,34,54,-20,40
Mattersburg,4354,9,8,11,17,43,54,-11,35
Admira Wacke,4354,10,8,8,20,30,68,-38,32
FC Salzburg,4355,1,22,8,6,71,33,38,74
SK Sturm Gra,4355,2,19,6,11,67,42,25,63
SC Rheindorf,4355,3,18,9,9,54,46,8,63
Vienna,4355,4,19,3,14,67,55,12,60
Rapid Vienna,4355,5,16,9,11,61,38,23,57
RZ Pellets W,4355,6,15,6,15,49,51,-2,51
Admira Wacke,4355,7,11,6,19,43,65,-22,39
SV Josko Rie,4355,8,10,6,20,38,62,-24,36
Mattersburg,4355,9,7,9,20,33,59,-26,30
St. Pölten,4355,10,6,12,18,37,69,-32,30
SK Sturm Gra,4356,1,21,7,8,62,34,28,70
FC Salzburg,4356,2,19,7,10,59,29,30,64
Vienna,4356,3,19,5,12,66,56,10,62
SC Rheindorf,4356,4,18,5,13,55,46,9,59
SV Josko Rie,4356,5,14,6,16,38,45,-7,48
RZ Pellets W,4356,6,13,8,15,52,57,-5,47
Rapid Vienna,4356,7,12,10,14,51,43,8,46
Admira Wacke,4356,8,12,4,20,36,60,-24,40
Mattersburg,4356,9,9,9,18,36,56,-20,36
St. Pölten,4356,10,8,9,19,35,64,-29,33
SC Rheindorf,4357,1,21,6,9,52,38,14,69
SK Sturm Gra,4357,2,19,9,8,61,29,32,66
FC Salzburg,4357,3,18,10,8,57,31,26,64
Vienna,4357,4,17,5,14,59,61,-2,56
RZ Pellets W,4357,5,14,9,13,46,47,-1,51
Rapid Vienna,4357,6,13,11,12,57,46,11,50
Mattersburg,4357,7,11,9,16,35,48,-13,42
Admira Wacke,4357,8,11,5,20,33,55,-22,38
SV Josko Rie,4357,9,10,7,19,35,50,-15,37
St. Pölten,4357,10,6,9,21,43,73,-30,27
FC Salzburg,4358,1,21,8,7,64,30,34,71
SK Sturm Gra,4358,2,18,9,9,55,37,18,63
SC Rheindorf,4358,3,18,8,10,56,48,8,62
Vienna,4358,4,15,8,13,55,52,3,53
Admira Wacke,4358,5,16,5,15,42,51,-9,53
RZ Pellets W,4358,6,13,7,16,40,48,-8,46
SV Josko Rie,4358,7,11,8,17,41,50,-9,41
Rapid Vienna,4358,8,9,11,16,52,49,3,38
St. Pölten,4358,9,8,12,16,41,57,-16,36
Mattersburg,4358,10,8,10,18,38,62,-24,34
FC Salzburg,4359,1,19,10,7,57,27,30,67
Vienna,4359,2,20,5,11,59,46,13,65
SK Sturm Gra,4359,3,18,6,12,56,38,18,60
SC Rheindorf,4359,4,16,8,12,52,50,2,56
Rapid Vienna,4359,5,13,11,12,52,35,17,50
Admira Wacke,4359,6,12,8,16,35,53,-18,44
RZ Pellets W,4359,7,12,7,17,44,53,-9,43
SV Josko Rie,4359,8,13,4,19,35,49,-14,43
Mattersburg,4359,9,10,8,18,39,53,-14,38
St. Pölten,4359,10,10,7,19,41,66,-25,37
SC Rheindorf,4360,1,21,7,8,61,36,25,70
FC Salzburg,4360,2,20,8,8,67,31,36,68
Vienna,4360,3,19,4,13,62,59,3,61
SK Sturm Gra,4360,4,15,9,12,56,42,14,54
Rapid Vienna,4360,5,14,9,13,54,38,16,51
RZ Pellets W,4360,6,14,7,15,55,56,-1,49
SV Josko Rie,4360,7,13,5,18,32,49,-17,44
Admira Wacke,4360,8,12,6,18,33,60,-27,42
Mattersburg,4360,9,7,11,18,35,55,-20,32
St. Pölten,4360,10,7,10,19,36,65,-29,31
FC Salzburg,4361,1,20,11,5,71,31,40,71
SK Sturm Gra,4361,2,21,7,8,61,28,33,70
SC Rheindorf,4361,3,18,10,8,49,41,8,64
Vienna,4361,4,16,4,16,52,50,2,52
Rapid Vienna,4361,5,10,18,8,53,42,11,48
Mattersburg,4361,6,11,9,16,38,51,-13,42
St. Pölten,4361,7,11,8,17,41,57,-16,41
Admira Wacke,4361,8,11,7,18,34,56,-22,40
RZ Pellets W,4361,9,9,11,16,38,53,-15,38
SV Josko Rie,4361,10,8,5,23,28,56,-28,29
FC Salzburg,4362,1,23,7,6,71,31,40,76
SC Rheindorf,4362,2,20,6,10,50,40,10,66
SK Sturm Gra,4362,3,18,8,10,57,33,24,62
Vienna,4362,4,19,4,13,70,56,14,61
Rapid Vienna,4362,5,16,10,10,55,35,20,58
RZ Pellets W,4362,6,10,8,18,41,56,-15,38
Mattersburg,4362,7,10,8,18,39,57,-18,38
Admira Wacke,4362,8,10,7,19,32,54,-22,37
SV Josko Rie,4362,9,10,4,22,32,56,-24,34
St. Pölten,4362,10,8,10,18,35,64,-29,34
FC Salzburg,4363,1,22,7,7,60,25,35,73
Vienna,4363,2,22,3,11,68,47,21,69
SC Rheindorf,4363,3,20,7,9,56,39,17,67
SK Sturm Gra,4363,4,18,6,12,53,39,14,60
Rapid Vienna,4363,5,13,13,10,51,35,16,52
RZ Pellets W,4363,6,14,8,14,47,50,-3,50
Admira Wacke,4363,7,9,8,19,31,57,-26,35
St. Pölten,4363,8,8,9,19,38,63,-25,33
Mattersburg,4363,9,8,8,20,30,54,-24,32
SV Josko Rie,4363,10,9,5,22,29,54,-25,32
Vienna,4364,1,20,6,10,63,48,15,66
FC Salzburg,4364,2,19,7,10,60,35,25,64
SK Sturm Gra,4364,3,18,8,10,59,34,25,62
RZ Pellets W,4364,4,15,8,13,50,45,5,53
Rapid Vienna,4364,5,14,10,12,56,44,12,52
SC Rheindorf,4364,6,15,7,14,52,54,-2,52
Admira Wacke,4364,7,13,6,17,41,55,-14,45
SV Josko Rie,4364,8,13,5,18,38,53,-15,44
St. Pölten,4364,9,8,10,18,42,67,-25,34
Mattersburg,4364,10,8,7,21,37,63,-26,31
Vienna,4365,1,21,4,11,66,45,21,67
SC Rheindorf,4365,2,19,5,12,56,52,4,62
SK Sturm Gra,4365,3,18,7,11,63,38,25,61
FC Salzburg,4365,4,16,12,8,63,29,34,60
Rapid Vienna,4365,5,16,10,10,62,40,22,58
RZ Pellets W,4365,6,15,7,14,48,53,-5,52
Admira Wacke,4365,7,12,5,19,38,60,-22,41
St. Pölten,4365,8,10,9,17,39,66,-27,39
SV Josko Rie,4365,9,11,4,21,37,62,-25,37
Mattersburg,4365,10,6,9,21,35,62,-27,27
SC Rheindorf,4366,1,19,9,8,63,42,21,66
Vienna,4366,2,20,6,10,59,48,11,66
FC Salzburg,4366,3,18,8,10,65,32,33,62
SK Sturm Gra,4366,4,17,8,11,67,40,27,59
Rapid Vienna,4366,5,16,10,10,60,37,23,58
RZ Pellets W,4366,6,12,7,17,46,61,-15,43
Admira Wacke,4366,7,13,4,19,36,62,-26,43
Mattersburg,4366,8,10,8,18,40,63,-23,38
St. Pölten,4366,9,8,11,17,38,63,-25,35
SV Josko Rie,4366,10,9,5,22,31,57,-26,32
FC Salzburg,4367,1,21,6,9,65,38,27,69
SC Rheindorf,4367,2,20,7,9,65,46,19,67
SK Sturm Gra,4367,3,18,6,12,57,38,19,60
RZ Pellets W,4367,4,16,9,11,52,46,6,57
Vienna,4367,5,17,5,14,57,53,4,56
Rapid Vienna,4367,6,12,9,15,54,45,9,45
Admira Wacke,4367,7,13,5,18,47,67,-20,44
SV Josko Rie,4367,8,11,8,17,35,50,-15,41
St. Pölten,4367,9,8,9,19,45,65,-20,33
Mattersburg,4367,10,8,8,20,37,66,-29,32
SC Rheindorf,4368,1,20,10,6,56,37,19,70
SK Sturm Gra,4368,2,18,10,8,60,32,28,64
FC Salzburg,4368,3,19,7,10,58,32,26,64
Rapid Vienna,4368,4,15,13,8,64,37,27,58
Vienna,4368,5,17,7,12,61,54,7,58
RZ Pellets W,4368,6,13,7,16,44,55,-11,46
Mattersburg,4368,7,9,11,16,40,55,-15,38
SV Josko Rie,4368,8,11,5,20,38,56,-18,38
Admira Wacke,4368,9,10,6,20,34,58,-24,36
St. Pölten,4368,10,5,10,21,32,71,-39,25
FC Salzburg,4369,1,22,9,5,71,26,45,75
SC Rheindorf,4369,2,18,8,10,54,42,12,62
Vienna,4369,3,18,5,13,60,53,7,59
SK Sturm Gra,4369,4,17,6,13,57,42,15,57
Rapid Vienna,4369,5,14,8,14,62,48,14,50
RZ Pellets W,4369,6,12,9,15,48,60,-12,45
Mattersburg,4369,7,11,9,16,39,52,-13,42
St. Pölten,4369,8,9,12,15,44,60,-16,39
Admira Wacke,4369,9,11,4,21,36,67,-31,37
SV Josko Rie,4369,10,9,8,19,36,57,-21,35
SC Rheindorf,4370,1,21,6,9,62,43,19,69
FC Salzburg,4370,2,20,8,8,67,35,32,68
Rapid Vienna,4370,3,17,10,9,62,34,28,61
SK Sturm Gra,4370,4,17,8,11,55,38,17,59
Vienna,4370,5,18,4,14,61,56,5,58
RZ Pellets W,4370,6,14,10,12,50,47,3,52
Mattersburg,4370,7,9,12,15,41,58,-17,39
SV Josko Rie,4370,8,9,7,20,33,56,-23,34
Admira Wacke,4370,9,9,6,21,34,65,-31,33
St. Pölten,4370,10,6,9,21,36,69,-33,27
FC Salzburg,4371,1,20,10,6,60,30,30,70
SC Rheindorf,4371,2,21,7,8,57,35,22,70
Vienna,4371,3,19,5,12,62,53,9,62
SK Sturm Gra,4371,4,17,8,11,54,37,17,59
Rapid Vienna,4371,5,15,10,11,57,44,13,55
RZ Pellets W,4371,6,15,9,12,50,47,3,54
Admira Wacke,4371,7,9,9,18,39,63,-24,36
SV Josko Rie,4371,8,9,8,19,29,50,-21,35
Mattersburg,4371,9,7,8,21,33,55,-22,29
St. Pölten,4371,10,5,12,19,37,64,-27,27
SC Rheindorf,4372,1,22,5,9,58,41,17,71
FC Salzburg,4372,2,20,6,10,68,38,30,66
Vienna,4372,3,20,5,11,67,49,18,65
Rapid Vienna,4372,4,17,12,7,63,37,26,63
SK Sturm Gra,4372,5,19,4,13,57,37,20,61
RZ Pellets W,4372,6,11,10,15,41,56,-15,43
Admira Wacke,4372,7,11,6,19,34,55,-21,39
Mattersburg,4372,8,9,9,18,34,54,-20,36
SV Josko Rie,4372,9,10,4,22,31,57,-26,34
St. Pölten,4372,10,6,9,21,33,62,-29,27
SK Sturm Gra,4373,1,20,6,10,72,39,33,66
SC Rheindorf,4373,2,19,7,10,53,49,4,64
FC Salzburg,4373,3,18,9,9,59,31,28,63
Rapid Vienna,4373,4,15,13,8,65,44,21,58
Vienna,4373,5,17,6,13,65,51,14,57
Admira Wacke,4373,6,13,5,18,38,58,-20,44
RZ Pellets W,4373,7,11,8,17,40,52,-12,41
SV Josko Rie,4373,8,11,7,18,39,54,-15,40
St. Pölten,4373,9,8,11,17,43,64,-21,35
Mattersburg,4373,10,8,8,20,36,68,-32,32
FC Salzburg,4374,1,20,9,7,67,36,31,69
SC Rheindorf,4374,2,19,11,6,63,39,24,68
Vienna,4374,3,19,7,10,69,55,14,64
SK Sturm Gra,4374,4,19,5,12,58,39,19,62
Rapid Vienna,4374,5,15,8,13,54,40,14,53
RZ Pellets W,4374,6,14,6,16,55,61,-6,48
Admira Wacke,4374,7,12,6,18,40,59,-19,42
SV Josko Rie,4374,8,11,3,22,33,57,-24,36
Mattersburg,4374,9,8,7,21,34,59,-25,31
St. Pölten,4374,10,7,10,19,36,64,-28,31
FC Salzburg,4375,1,24,6,6,70,28,42,78
Vienna,4375,2,19,7,10,62,47,15,64
SC Rheindorf,4375,3,18,8,10,63,47,16,62
SK Sturm Gra,4375,4,16,6,14,54,40,14,54
Rapid Vienna,4375,5,13,13,10,54,37,17,52
RZ Pellets W,4375,6,14,6,16,45,57,-12,48
St. Pölten,4375,7,12,9,15,47,59,-12,45
Admira Wacke,4375,8,10,6,20,37,65,-28,36
SV Josko Rie,4375,9,10,5,21,42,68,-26,35
Mattersburg,4375,10,7,8,21,32,58,-26,29
FC Salzburg,4376,1,21,8,7,75,36,39,71
SC Rheindorf,4376,2,20,9,7,65,48,17,69
SK Sturm Gra,4376,3,20,6,10,64,39,25,66
Vienna,4376,4,14,10,12,58,62,-4,52
Rapid Vienna,4376,5,13,10,13,60,45,15,49
RZ Pellets W,4376,6,12,7,17,53,61,-8,43
Admira Wacke,4376,7,11,8,17,40,67,-27,41
St. Pölten,4376,8,10,10,16,45,62,-17,40
SV Josko Rie,4376,9,9,8,19,30,50,-20,35
Mattersburg,4376,10,7,10,19,35,55,-20,31
FC Salzburg,4377,1,22,8,6,65,27,38,74
Vienna,4377,2,21,5,10,67,44,23,68
SK Sturm Gra,4377,3,19,5,12,61,35,26,62
SC Rheindorf,4377,4,18,8,10,51,41,10,62
Rapid Vienna,4377,5,13,14,9,54,38,16,53
Mattersburg,4377,6,10,11,15,39,49,-10,41
RZ Pellets W,4377,7,11,7,18,41,57,-16,40
Admira Wacke,4377,8,11,7,18,35,59,-24,40
St. Pölten,4377,9,7,13,16,38,62,-24,34
SV Josko Rie,4377,10,7,4,25,29,68,-39,25
FC Salzburg,4378,1,21,6,9,66,35,31,69
SC Rheindorf,4378,2,20,7,9,56,46,10,67
SK Sturm Gra,4378,3,19,6,11,62,31,31,63
Vienna,4378,4,18,5,13,65,50,15,59
Rapid Vienna,4378,5,14,12,10,58,38,20,54
RZ Pellets W,4378,6,13,6,17,46,61,-15,45
SV Josko Rie,4378,7,12,4,20,42,53,-11,40
Admira Wacke,4378,8,10,8,18,31,63,-32,38
Mattersburg,4378,9,9,9,18,38,61,-23,36
St. Pölten,4378,10,9,7,20,39,65,-26,34
FC Salzburg,4379,1,22,9,5,66,24,42,75
SC Rheindorf,4379,2,19,12,5,57,38,19,69
SK Sturm Gra,4379,3,19,7,10,60,32,28,64
Vienna,4379,4,16,8,12,60,54,6,56
RZ Pellets W,4379,5,14,8,14,56,54,2,50
Rapid Vienna,4379,6,10,12,14,50,45,5,42
Admira Wacke,4379,7,10,11,15,42,66,-24,41
SV Josko Rie,4379,8,11,6,19,37,51,-14,39
Mattersburg,4379,9,7,9,20,38,65,-27,30
St. Pölten,4379,10,5,12,19,37,74,-37,27
SK Sturm Gra,4380,1,20,10,6,64,30,34,70
Vienna,4380,2,21,6,9,68,47,21,69
SC Rheindorf,4380,3,18,10,8,55,46,9,64
FC Salzburg,4380,4,19,6,11,61,29,32,63
Rapid Vienna,4380,5,12,12,12,52,40,12,48
St. Pölten,4380,6,11,7,18,44,65,-21,40
RZ Pellets W,4380,7,9,11,16,38,55,-17,38
Mattersburg,4380,8,9,10,17,36,48,-12,37
Admira Wacke,4380,9,9,9,18,33,65,-32,36
SV Josko Rie,4380,10,8,7,21,31,57,-26,31
SC Rheindorf,4381,1,23,5,8,63,39,24,74
FC Salzburg,4381,2,20,10,6,67,28,39,70
SK Sturm Gra,4381,3,18,8,10,59,38,21,62
Vienna,4381,4,19,4,13,63,59,4,61
Rapid Vienna,4381,5,11,12,13,47,39,8,45
Admira Wacke,4381,6,12,9,15,36,52,-16,45
RZ Pellets W,4381,7,12,7,17,42,52,-10,43
St. Pölten,4381,8,9,11,16,44,61,-17,38
SV Josko Rie,4381,9,9,6,21,35,66,-31,33
Mattersburg,4381,10,8,6,22,36,58,-22,30
SK Sturm Gra,4382,1,21,5,10,60,33,27,68
FC Salzburg,4382,2,20,5,11,62,34,28,65
Vienna,4382,3,19,5,12,58,45,13,62
SC Rheindorf,4382,4,16,9,11,43,40,3,57
Rapid Vienna,4382,5,15,11,10,56,38,18,56
RZ Pellets W,4382,6,13,8,15,48,55,-7,47
St. Pölten,4382,7,11,10,15,44,57,-13,43
Admira Wacke,4382,8,12,4,20,31,53,-22,40
Mattersburg,4382,9,8,9,19,35,53,-18,33
SV Josko Rie,4382,10,9,6,21,29,58,-29,33
FC Salzburg,4383,1,23,6,7,65,32,33,75
SK Sturm Gra,4383,2,20,9,7,63,31,32,69
Vienna,4383,3,17,8,11,62,54,8,59
SC Rheindorf,4383,4,16,8,12,54,45,9,56
Rapid Vienna,4383,5,11,13,12,45,42,3,46
RZ Pellets W,4383,6,13,7,16,49,50,-1,46
SV Josko Rie,4383,7,11,7,18,38,54,-16,40
St. Pölten,4383,8,9,10,17,37,59,-22,37
Admira Wacke,4383,9,9,9,18,36,61,-25,36
Mattersburg,4383,10,8,9,19,38,59,-21,33
FC Salzburg,4384,1,21,7,8,64,30,34,70
SC Rheindorf,4384,2,20,9,7,56,46,10,69
SK Sturm Gra,4384,3,20,7,9,63,28,35,67
Vienna,4384,4,16,8,12,60,57,3,56
Rapid Vienna,4384,5,13,10,13,61,49,12,49
Admira Wacke,4384,6,11,9,16,41,60,-19,42
SV Josko Rie,4384,7,11,6,19,33,51,-18,39
Mattersburg,4384,8,10,8,18,37,56,-19,38
RZ Pellets W,4384,9,8,10,18,38,53,-15,34
St. Pölten,4384,10,8,10,18,39,62,-23,34
SK Sturm Gra,4385,1,20,6,10,63,36,27,66
FC Salzburg,4385,2,19,8,9,66,37,29,65
Vienna,4385,3,20,4,12,67,48,19,64
SC Rheindorf,4385,4,18,8,10,57,45,12,62
Rapid Vienna,4385,5,15,8,13,52,42,10,53
RZ Pellets W,4385,6,14,8,14,52,59,-7,50
SV Josko Rie,4385,7,12,6,18,37,56,-19,42
Admira Wacke,4385,8,12,5,19,38,59,-21,41
Mattersburg,4385,9,8,8,20,37,62,-25,32
St. Pölten,4385,10,6,11,19,38,63,-25,29
FC Salzburg,4386,1,21,7,8,61,28,33,70
SK Sturm Gra,4386,2,20,8,8,56,31,25,68
SC Rheindorf,4386,3,20,8,8,54,39,15,68
Rapid Vienna,4386,4,17,9,10,53,36,17,60
Admira Wacke,4386,5,14,7,15,45,56,-11,49
Vienna,4386,6,13,5,18,59,65,-6,44
RZ Pellets W,4386,7,11,10,15,40,53,-13,43
St. Pölten,4386,8,9,9,18,39,55,-16,36
Mattersburg,4386,9,8,10,18,33,53,-20,34
SV Josko Rie,4386,10,9,3,24,32,56,-24,30
FC Salzburg,4387,1,23,7,6,70,31,39,76
SC Rheindorf,4387,2,22,8,6,62,35,27,74
SK Sturm Gra,4387,3,21,6,9,61,32,29,69
Vienna,4387,4,19,4,13,63,53,10,61
Rapid Vienna,4387,5,12,10,14,51,45,6,46
RZ Pellets W,4387,6,12,7,17,42,54,-12,43
Mattersburg,4387,7,9,8,19,43,58,-15,35
SV Josko Rie,4387,8,10,5,21,33,59,-26,35
Admira Wacke,4387,9,10,5,21,32,60,-28,35
St. Pölten,4387,10,7,10,19,41,71,-30,31
Vienna,4388,1,22,5,9,62,43,19,71
FC Salzburg,4388,2,20,7,9,59,33,26,67
Rapid Vienna,4388,3,18,9,9,65,39,26,63
SC Rheindorf,4388,4,18,9,9,54,41,13,63
SK Sturm Gra,4388,5,18,6,12,56,37,19,60
RZ Pellets W,4388,6,14,6,16,53,55,-2,48
SV Josko Rie,4388,7,11,6,19,36,55,-19,39
Mattersburg,4388,8,8,10,18,40,58,-18,34
Admira Wacke,4388,9,8,6,22,31,63,-32,30
St. Pölten,4388,10,6,10,20,37,69,-32,28
FC Salzburg,4389,1,21,7,8,64,31,33,70
Vienna,4389,2,21,5,10,64,46,18,68
SK Sturm Gra,4389,3,20,7,9,62,35,27,67
SC Rheindorf,4389,4,18,8,10,54,43,11,62
Rapid Vienna,4389,5,15,11,10,60,41,19,56
St. Pölten,4389,6,11,9,16,48,64,-16,42
RZ Pellets W,4389,7,12,6,18,44,61,-17,42
Admira Wacke,4389,8,11,7,18,38,57,-19,40
Mattersburg,4389,9,7,8,21,35,60,-25,29
SV Josko Rie,4389,10,7,6,23,30,61,-31,27
SC Rheindorf,4390,1,22,6,8,60,37,23,72
FC Salzburg,4390,2,19,9,8,64,34,30,66
Vienna,4390,3,19,9,8,69,48,21,66
SK Sturm Gra,4390,4,17,7,12,55,39,16,58
Rapid Vienna,4390,5,12,15,9,56,39,17,51
RZ Pellets W,4390,6,13,7,16,44,55,-11,46
Admira Wacke,4390,7,12,5,19,39,65,-26,41
SV Josko Rie,4390,8,11,5,20,36,54,-18,38
Mattersburg,4390,9,8,8,20,32,57,-25,32
St. Pölten,4390,10,7,9,20,38,65,-27,30
FC Salzburg,4391,1,21,9,6,68,28,40,72
SK Sturm Gra,4391,2,19,7,10,63,35,28,64
SC Rheindorf,4391,3,17,9,10,50,41,9,60
Vienna,4391,4,17,5,14,58,52,6,56
Rapid Vienna,4391,5,15,10,11,51,37,14,55
Mattersburg,4391,6,12,9,15,46,52,-6,45
Admira Wacke,4391,7,13,4,19,44,66,-22,43
SV Josko Rie,4391,8,11,6,19,38,57,-19,39
RZ Pellets W,4391,9,10,7,19,38,63,-25,37
St. Pölten,4391,10,7,10,19,40,65,-25,31
FC Salzburg,4392,1,20,10,6,66,28,38,70
SK Sturm Gra,4392,2,20,6,10,62,36,26,66
SC Rheindorf,4392,3,19,5,12,57,49,8,62
Vienna,4392,4,18,5,13,63,59,4,59
Rapid Vienna,4392,5,14,11,11,65,47,18,53
RZ Pellets W,4392,6,15,5,16,45,55,-10,50
St. Pölten,4392,7,11,8,17,47,62,-15,41
Admira Wacke,4392,8,11,7,18,45,63,-18,40
Mattersburg,4392,9,9,6,21,35,58,-23,33
SV Josko Rie,4392,10,8,7,21,29,57,-28,31
FC Salzburg,4393,1,21,8,7,69,29,40,71
SK Sturm Gra,4393,2,20,5,11,66,39,27,65
Rapid Vienna,4393,3,17,8,11,59,36,23,59
SC Rheindorf,4393,4,17,8,11,49,42,7,59
Vienna,4393,5,17,8,11,55,49,6,59
RZ Pellets W,4393,6,12,7,17,44,55,-11,43
Mattersburg,4393,7,11,9,16,37,51,-14,42
St. Pölten,4393,8,11,8,17,43,61,-18,41
SV Josko Rie,4393,9,10,7,19,31,54,-23,37
Admira Wacke,4393,10,7,6,23,32,69,-37,27
FC Salzburg,4394,1,22,7,7,68,24,44,73
SC Rheindorf,4394,2,20,7,9,53,41,12,67
SK Sturm Gra,4394,3,17,9,10,55,39,16,60
Vienna,4394,4,18,4,14,66,55,11,58
Rapid Vienna,4394,5,12,13,11,54,41,13,49
RZ Pellets W,4394,6,14,7,15,46,51,-5,49
SV Josko Rie,4394,7,14,5,17,47,54,-7,47
Admira Wacke,4394,8,10,5,21,30,66,-36,35
Mattersburg,4394,9,8,9,19,35,58,-23,33
St. Pölten,4394,10,8,8,20,45,70,-25,32
FC Salzburg,4395,1,21,10,5,73,30,43,73
Vienna,4395,2,19,7,10,62,46,16,64
SK Sturm Gra,4395,3,18,9,9,59,35,24,63
SC Rheindorf,4395,4,17,11,8,55,44,11,62
Rapid Vienna,4395,5,13,11,12,51,43,8,50
Admira Wacke,4395,6,12,8,16,39,55,-16,44
RZ Pellets W,4395,7,11,9,16,42,55,-13,42
Mattersburg,4395,8,8,12,16,33,52,-19,36
SV Josko Rie,4395,9,8,6,22,35,59,-24,30
St. Pölten,4395,10,6,11,19,36,66,-30,29
FC Salzburg,4396,1,18,10,8,61,33,28,64
SK Sturm Gra,4396,2,19,7,10,58,35,23,64
SC Rheindorf,4396,3,20,4,12,56,46,10,64
Rapid Vienna,4396,4,14,12,10,57,39,18,54
RZ Pellets W,4396,5,15,8,13,51,51,0,53
Vienna,4396,6,14,7,15,62,65,-3,49
SV Josko Rie,4396,7,11,9,16,37,47,-10,42
Admira Wacke,4396,8,12,6,18,42,68,-26,42
Mattersburg,4396,9,10,7,19,38,55,-17,37
St. Pölten,4396,10,8,8,20,41,64,-23,32
FC Salzburg,4397,1,22,7,7,69,30,39,73
SC Rheindorf,4397,2,20,7,9,53,39,14,67
Rapid Vienna,4397,3,17,9,10,64,36,28,60
Vienna,4397,4,17,7,12,64,57,7,58
SK Sturm Gra,4397,5,16,7,13,53,40,13,55
RZ Pellets W,4397,6,16,6,14,50,58,-8,54
Mattersburg,4397,7,10,9,17,45,55,-10,39
SV Josko Rie,4397,8,9,9,18,34,56,-22,36
St. Pölten,4397,9,7,9,20,42,68,-26,30
Admira Wacke,4397,10,8,6,22,30,65,-35,30
Vienna,4398,1,22,4,10,75,57,18,70
FC Salzburg,4398,2,18,11,7,64,35,29,65
SK Sturm Gra,4398,3,18,7,11,61,38,23,61
SC Rheindorf,4398,4,18,6,12,56,49,7,60
Rapid Vienna,4398,5,14,12,10,59,40,19,54
SV Josko Rie,4398,6,13,5,18,37,55,-18,44
Admira Wacke,4398,7,11,7,18,43,61,-18,40
RZ Pellets W,4398,8,11,6,19,49,65,-16,39
Mattersburg,4398,9,9,9,18,38,61,-23,36
St. Pölten,4398,10,7,11,18,40,61,-21,32
FC Salzburg,4399,1,20,8,8,63,32,31,68
SK Sturm Gra,4399,2,18,9,9,57,31,26,63
Vienna,4399,3,19,6,11,59,44,15,63
SC Rheindorf,4399,4,17,7,12,54,50,4,58
Rapid Vienna,4399,5,14,10,12,51,44,7,52
Admira Wacke,4399,6,15,6,15,41,55,-14,51
SV Josko Rie,4399,7,12,7,17,41,48,-7,43
RZ Pellets W,4399,8,11,9,16,43,52,-9,42
St. Pölten,4399,9,7,9,20,37,66,-29,30
Mattersburg,4399,10,6,11,19,35,59,-24,29
FC Salzburg,4400,1,22,7,7,64,31,33,73
SC Rheindorf,4400,2,20,9,7,54,43,11,69
Vienna,4400,3,20,5,11,73,61,12,65
SK Sturm Gra,4400,4,18,4,14,54,34,20,58
Rapid Vienna,4400,5,12,15,9,54,38,16,51
RZ Pellets W,4400,6,13,6,17,47,54,-7,45
St. Pölten,4400,7,9,10,17,41,60,-19,37
SV Josko Rie,4400,8,10,7,19,33,53,-20,37
Admira Wacke,4400,9,10,6,20,35,61,-26,36
Mattersburg,4400,10,8,7,21,33,53,-20,31
FC Salzburg,4401,1,21,7,8,64,33,31,70
Vienna,4401,2,22,3,11,70,45,25,69
SK Sturm Gra,4401,3,20,7,9,66,34,32,67
SC Rheindorf,4401,4,17,9,10,54,45,9,60
RZ Pellets W,4401,5,12,9,15,49,53,-4,45
Rapid Vienna,4401,6,10,14,12,49,43,6,44
Admira Wacke,4401,7,11,6,19,42,73,-31,39
St. Pölten,4401,8,10,8,18,37,58,-21,38
Mattersburg,4401,9,8,10,18,36,56,-20,34
SV Josko Rie,4401,10,9,7,20,36,63,-27,34
FC Salzburg,4402,1,20,9,7,64,31,33,69
SK Sturm Gra,4402,2,20,7,9,62,36,26,67
Vienna,4402,3,20,5,11,72,52,20,65
SC Rheindorf,4402,4,16,9,11,56,48,8,57
Rapid Vienna,4402,5,12,10,14,50,43,7,46
SV Josko Rie,4402,6,13,6,17,37,55,-18,45
St. Pölten,4402,7,11,8,17,46,61,-15,41
RZ Pellets W,4402,8,10,8,18,35,53,-18,38
Admira Wacke,4402,9,10,7,19,37,63,-26,37
Mattersburg,4402,10,8,11,17,33,50,-17,35
FC Salzburg,4403,1,21,8,7,66,29,37,71
SK Sturm Gra,4403,2,21,5,10,62,33,29,68
SC Rheindorf,4403,3,16,8,12,50,44,6,56
Vienna,4403,4,15,7,14,60,58,2,52
Rapid Vienna,4403,5,13,10,13,51,44,7,49
RZ Pellets W,4403,6,14,6,16,45,52,-7,48
Admira Wacke,4403,7,13,8,15,37,52,-15,47
St. Pölten,4403,8,10,10,16,47,62,-15,40
Mattersburg,4403,9,9,8,19,43,62,-19,35
SV Josko Rie,4403,10,9,8,19,35,60,-25,35
Vienna,4404,1,23,4,9,69,48,21,73
SC Rheindorf,4404,2,19,10,7,55,39,16,67
FC Salzburg,4404,3,20,6,10,60,32,28,66
SK Sturm Gra,4404,4,18,7,11,56,36,20,61
Rapid Vienna,4404,5,15,10,11,59,37,22,55
Admira Wacke,4404,6,14,7,15,41,59,-18,49
RZ Pellets W,4404,7,10,6,20,46,57,-11,36
St. Pölten,4404,8,9,8,19,42,64,-22,35
Mattersburg,4404,9,7,11,18,38,68,-30,32
SV Josko Rie,4404,10,8,5,23,31,57,-26,29
SK Sturm Gra,4405,1,22,4,10,58,25,33,70
FC Salzburg,4405,2,18,10,8,56,26,30,64
Vienna,4405,3,19,7,10,61,44,17,64
SC Rheindorf,4405,4,18,8,10,54,42,12,62
Rapid Vienna,4405,5,15,10,11,60,42,18,55
Admira Wacke,4405,6,12,7,17,33,58,-25,43
RZ Pellets W,4405,7,10,10,16,45,60,-15,40
Mattersburg,4405,8,9,8,19,33,57,-24,35
St. Pölten,4405,9,8,10,18,38,60,-22,34
SV Josko Rie,4405,10,10,4,22,29,53,-24,34
FC Salzburg,4406,1,21,10,5,63,25,38,73
SK Sturm Gra,4406,2,20,7,9,61,32,29,67
Vienna,4406,3,18,7,11,63,46,17,61
SC Rheindorf,4406,4,15,15,6,48,35,13,60
Rapid Vienna,4406,5,10,16,10,58,50,8,46
RZ Pellets W,4406,6,12,7,17,43,57,-14,43
Admira Wacke,4406,7,10,8,18,37,57,-20,38
Mattersburg,4406,8,9,10,17,35,55,-20,37
SV Josko Rie,4406,9,10,5,21,32,58,-26,35
St. Pölten,4406,10,6,13,17,40,65,-25,31
SK Sturm Gra,4407,1,20,5,11,65,43,22,65
Vienna,4407,2,18,8,10,68,51,17,62
SC Rheindorf,4407,3,17,11,8,62,46,16,62
FC Salzburg,4407,4,16,9,11,59,34,25,57
SV Josko Rie,4407,5,14,6,16,33,43,-10,48
Admira Wacke,4407,6,13,7,16,37,56,-19,46
Rapid Vienna,4407,7,11,10,15,47,45,2,43
RZ Pellets W,4407,8,11,9,16,45,56,-11,42
Mattersburg,4407,9,9,10,17,34,53,-19,37
St. Pölten,4407,10,7,13,16,42,65,-23,34
FC Salzburg,4408,1,22,8,6,62,28,34,74
SC Rheindorf,4408,2,22,6,8,55,39,16,72
SK Sturm Gra,4408,3,19,6,11,54,35,19,63
Vienna,4408,4,19,3,14,65,56,9,60
Rapid Vienna,4408,5,13,12,11,56,39,17,51
SV Josko Rie,4408,6,13,4,19,37,52,-15,43
RZ Pellets W,4408,7,12,6,18,37,53,-16,42
Admira Wacke,4408,8,11,6,19,43,60,-17,39
St. Pölten,4408,9,8,10,18,39,59,-20,34
Mattersburg,4408,10,7,7,22,37,64,-27,28
SK Sturm Gra,4409,1,22,6,8,62,28,34,72
SC Rheindorf,4409,2,19,8,9,54,42,12,65
FC Salzburg,4409,3,18,9,9,69,42,27,63
Vienna,4409,4,16,6,14,54,50,4,54
Rapid Vienna,4409,5,14,11,11,57,43,14,53
RZ Pellets W,4409,6,13,10,13,53,55,-2,49
SV Josko Rie,4409,7,13,4,19,44,55,-11,43
Admira Wacke,4409,8,12,7,17,40,66,-26,43
Mattersburg,4409,9,7,11,18,38,61,-23,32
St. Pölten,4409,10,5,10,21,36,65,-29,25
FC Salzburg,4410,1,21,8,7,67,28,39,71
SC Rheindorf,4410,2,18,10,8,50,43,7,64
SK Sturm Gra,4410,3,17,9,10,59,37,22,60
Vienna,4410,4,17,8,11,57,46,11,59
RZ Pellets W,4410,5,16,5,15,59,53,6,53
Rapid Vienna,4410,6,13,9,14,54,45,9,48
SV Josko Rie,4410,7,12,7,17,35,49,-14,43
Mattersburg,4410,8,10,10,16,39,50,-11,40
Admira Wacke,4410,9,10,5,21,33,65,-32,35
St. Pölten,4410,10,6,9,21,37,74,-37,27
SC Rheindorf,4411,1,20,10,6,56,34,22,70
SK Sturm Gra,4411,2,20,8,8,62,32,30,68
FC Salzburg,4411,3,19,7,10,62,38,24,64
Vienna,4411,4,19,5,12,61,49,12,62
Rapid Vienna,4411,5,12,12,12,52,41,11,48
SV Josko Rie,4411,6,12,7,17,35,47,-12,43
RZ Pellets W,4411,7,11,7,18,44,60,-16,40
St. Pölten,4411,8,10,9,17,39,63,-24,39
Mattersburg,4411,9,9,9,18,35,50,-15,36
Admira Wacke,4411,10,9,4,23,32,64,-32,31
FC Salzburg,4412,1,23,6,7,76,37,39,75
Vienna,4412,2,21,5,10,70,47,23,68
SK Sturm Gra,4412,3,19,8,9,61,35,26,65
Rapid Vienna,4412,4,17,11,8,70,41,29,62
SC Rheindorf,4412,5,16,7,13,47,49,-2,55
RZ Pellets W,4412,6,14,7,15,46,47,-1,49
SV Josko Rie,4412,7,11,5,20,37,56,-19,38
Admira Wacke,4412,8,10,7,19,35,65,-30,37
Mattersburg,4412,9,6,11,19,33,60,-27,29
St. Pölten,4412,10,6,7,23,36,74,-38,25
FC Salzburg,4413,1,22,6,8,70,31,39,72
Vienna,4413,2,17,8,11,56,50,6,59
SC Rheindorf,4413,3,16,11,9,54,48,6,59
SK Sturm Gra,4413,4,17,7,12,51,35,16,58
Rapid Vienna,4413,5,16,9,11,61,39,22,57
RZ Pellets W,4413,6,15,5,16,53,58,-5,50
Admira Wacke,4413,7,14,6,16,38,56,-18,48
Mattersburg,4413,8,10,9,17,40,49,-9,39
St. Pölten,4413,9,6,13,17,37,61,-24,31
SV Josko Rie,4413,10,7,6,23,27,60,-33,27
FC Salzburg,4414,1,24,7,5,70,27,43,79
SK Sturm Gra,4414,2,23,5,8,70,33,37,74
SC Rheindorf,4414,3,17,8,11,47,41,6,59
Vienna,4414,4,17,6,13,59,52,7,57
Rapid Vienna,4414,5,12,12,12,51,45,6,48
RZ Pellets W,4414,6,13,8,15,50,62,-12,47
SV Josko Rie,4414,7,13,5,18,43,52,-9,44
St. Pölten,4414,8,8,9,19,42,63,-21,33
Admira Wacke,4414,9,9,6,21,26,58,-32,33
Mattersburg,4414,10,6,10,20,30,55,-25,28
SC Rheindorf,4415,1,20,8,8,60,42,18,68
FC Salzburg,4415,2,20,7,9,61,37,24,67
SK Sturm Gra,4415,3,18,7,11,56,39,17,61
Vienna,4415,4,17,6,13,67,57,10,57
Admira Wacke,4415,5,15,6,15,45,54,-9,51
RZ Pellets W,4415,6,14,8,14,55,53,2,50
Rapid Vienna,4415,7,13,9,14,55,42,13,48
Mattersburg,4415,8,11,7,18,48,64,-16,40
SV Josko Rie,4415,9,8,8,20,31,59,-28,32
St. Pölten,4415,10,7,8,21,35,66,-31,29
FC Salzburg,4416,1,24,5,7,75,35,40,77
SC Rheindorf,4416,2,19,7,10,55,43,12,64
SK Sturm Gra,4416,3,19,6,11,63,38,25,63
Vienna,4416,4,18,4,14,60,54,6,58
Rapid Vienna,4416,5,15,11,10,63,42,21,56
SV Josko Rie,4416,6,12,6,18,40,58,-18,42
Mattersburg,4416,7,9,12,15,42,54,-12,39
RZ Pellets W,4416,8,10,7,19,41,61,-20,37
Admira Wacke,4416,9,9,10,17,36,59,-23,37
St. Pölten,4416,10,5,12,19,37,68,-31,27
FC Salzburg,4417,1,21,7,8,69,30,39,70
SC Rheindorf,4417,2,20,7,9,63,46,17,67
Vienna,4417,3,18,6,12,65,57,8,60
SK Sturm Gra,4417,4,16,9,11,53,36,17,57
RZ Pellets W,4417,5,15,7,14,58,56,2,52
Rapid Vienna,4417,6,13,10,13,52,41,11,49
SV Josko Rie,4417,7,14,4,18,40,54,-14,46
Admira Wacke,4417,8,11,6,19,37,60,-23,39
Mattersburg,4417,9,7,11,18,35,58,-23,32
St. Pölten,4417,10,6,11,19,38,72,-34,29
SK Sturm Gra,4418,1,19,10,7,63,34,29,67
SC Rheindorf,4418,2,18,11,7,57,42,15,65
Vienna,4418,3,18,6,12,63,52,11,60
FC Salzburg,4418,4,17,8,11,54,33,21,59
Rapid Vienna,4418,5,13,14,9,61,40,21,53
RZ Pellets W,4418,6,14,8,14,51,55,-4,50
Admira Wacke,4418,7,13,5,18,39,61,-22,44
SV Josko Rie,4418,8,10,7,19,34,54,-20,37
Mattersburg,4418,9,7,10,19,39,62,-23,31
St. Pölten,4418,10,7,9,20,45,73,-28,30
SC Rheindorf,4419,1,21,8,7,53,33,20,71
SK Sturm Gra,4419,2,20,7,9,62,35,27,67
FC Salzburg,4419,3,19,8,9,69,31,38,65
Vienna,4419,4,17,6,13,66,56,10,57
Rapid Vienna,4419,5,14,10,12,62,50,12,52
RZ Pellets W,4419,6,13,8,15,52,60,-8,47
SV Josko Rie,4419,7,13,5,18,37,54,-17,44
Admira Wacke,4419,8,11,5,20,35,63,-28,38
St. Pölten,4419,9,7,10,19,44,69,-25,31
Mattersburg,4419,10,6,11,19,32,61,-29,29
FC Salzburg,4420,1,24,5,7,69,30,39,77
SK Sturm Gra,4420,2,20,7,9,60,28,32,67
SC Rheindorf,4420,3,19,6,11,59,46,13,63
Rapid Vienna,4420,4,15,10,11,63,42,21,55
Vienna,4420,5,16,6,14,54,57,-3,54
SV Josko Rie,4420,6,13,5,18,35,50,-15,44
RZ Pellets W,4420,7,11,7,18,40,56,-16,40
Admira Wacke,4420,8,11,6,19,39,63,-24,39
Mattersburg,4420,9,9,6,21,38,63,-25,33
St. Pölten,4420,10,6,14,16,38,60,-22,32
FC Salzburg,4421,1,21,10,5,60,26,34,73
SK Sturm Gra,4421,2,21,6,9,64,32,32,69
SC Rheindorf,4421,3,17,11,8,52,46,6,62
Vienna,4421,4,17,8,11,58,45,13,59
Rapid Vienna,4421,5,15,11,10,56,35,21,56
RZ Pellets W,4421,6,11,9,16,43,54,-11,42
Admira Wacke,4421,7,12,4,20,34,59,-25,40
Mattersburg,4421,8,10,8,18,39,54,-15,38
SV Josko Rie,4421,9,11,5,20,30,47,-17,38
St. Pölten,4421,10,5,8,23,34,72,-38,23
FC Salzburg,4422,1,20,8,8,63,30,33,68
SK Sturm Gra,4422,2,19,9,8,57,31,26,66
Rapid Vienna,4422,3,18,8,10,62,37,25,62
SC Rheindorf,4422,4,18,7,11,52,46,6,61
Vienna,4422,5,16,7,13,54,52,2,55
St. Pölten,4422,6,10,11,15,40,58,-18,41
Admira Wacke,4422,7,12,5,19,34,57,-23,41
SV Josko Rie,4422,8,11,6,19,38,54,-16,39
RZ Pellets W,4422,9,10,7,19,42,58,-16,37
Mattersburg,4422,10,8,8,20,35,54,-19,32
FC Salzburg,4423,1,21,8,7,65,28,37,71
SK Sturm Gra,4423,2,20,5,11,61,38,23,65
SC Rheindorf,4423,3,18,9,9,54,46,8,63
Vienna,4423,4,16,9,11,60,51,9,57
Rapid Vienna,4423,5,14,11,11,52,36,16,53
RZ Pellets W,4423,6,11,9,16,42,54,-12,42
SV Josko Rie,4423,7,11,6,19,34,54,-20,39
Mattersburg,4423,8,9,11,16,34,49,-15,38
St. Pölten,4423,9,9,9,18,41,59,-18,36
Admira Wacke,4423,10,9,7,20,33,61,-28,34
FC Salzburg,4424,1,19,11,6,58,29,29,68
SK Sturm Gra,4424,2,19,7,10,68,38,30,64
Vienna,4424,3,19,6,11,65,49,16,63
SC Rheindorf,4424,4,18,7,11,53,45,8,61
Rapid Vienna,4424,5,14,13,9,55,35,20,55
RZ Pellets W,4424,6,13,8,15,46,54,-8,47
Mattersburg,4424,7,9,10,17,31,52,-21,37
St. Pölten,4424,8,8,12,16,46,60,-14,36
Admira Wacke,4424,9,10,5,21,36,63,-27,35
SV Josko Rie,4424,10,9,5,22,26,59,-33,32
FC Salzburg,4425,1,21,7,8,70,31,39,70
SK Sturm Gra,4425,2,21,6,9,58,32,26,69
Vienna,4425,3,20,4,12,64,50,14,64
SC Rheindorf,4425,4,18,6,12,52,47,5,60
Rapid Vienna,4425,5,14,13,9,61,42,19,55
RZ Pellets W,4425,6,12,6,18,45,62,-17,42
Admira Wacke,4425,7,12,6,18,42,63,-21,42
Mattersburg,4425,8,10,9,17,39,51,-12,39
St. Pölten,4425,9,9,7,20,39,63,-24,34
SV Josko Rie,4425,10,9,4,23,26,55,-29,31
SC Rheindorf,4426,1,21,9,6,58,38,20,72
SK Sturm Gra,4426,2,18,9,9,62,36,26,63
FC Salzburg,4426,3,18,7,11,59,32,27,61
Vienna,4426,4,16,10,10,64,57,7,58
Rapid Vienna,4426,5,15,10,11,57,41,16,55
RZ Pellets W,4426,6,11,10,15,40,53,-13,43
Admira Wacke,4426,7,11,5,20,33,55,-22,38
St. Pölten,4426,8,9,9,18,40,59,-19,36
Mattersburg,4426,9,9,9,18,34,54,-20,36
SV Josko Rie,4426,10,10,6,20,31,53,-22,36
FC Salzburg,4427,1,23,5,8,63,34,29,74
SC Rheindorf,4427,2,21,5,10,63,43,20,68
SK Sturm Gra,4427,3,21,4,11,57,30,27,67
Vienna,4427,4,19,5,12,67,47,20,62
Rapid Vienna,4427,5,13,10,13,53,50,3,49
RZ Pellets W,4427,6,11,9,16,44,53,-9,42
St. Pölten,4427,7,10,9,17,45,68,-23,39
SV Josko Rie,4427,8,11,5,20,32,48,-16,38
Admira Wacke,4427,9,11,5,20,35,61,-26,38
Mattersburg,4427,10,8,7,21,35,60,-25,31
FC Salzburg,4428,1,23,8,5,68,24,44,77
Vienna,4428,2,19,6,11,65,54,11,63
SC Rheindorf,4428,3,19,6,11,54,46,8,63
SK Sturm Gra,4428,4,17,7,12,62,41,21,58
Rapid Vienna,4428,5,15,11,10,61,39,22,56
RZ Pellets W,4428,6,12,8,16,54,62,-8,44
Mattersburg,4428,7,10,7,19,42,59,-17,37
SV Josko Rie,4428,8,9,8,19,36,57,-21,35
Admira Wacke,4428,9,8,10,18,35,66,-31,34
St. Pölten,4428,10,7,11,18,40,69,-29,32
FC Salzburg,4429,1,21,5,10,62,33,29,68
SK Sturm Gra,4429,2,19,9,8,53,31,22,66
SC Rheindorf,4429,3,19,6,11,57,45,12,63
Vienna,4429,4,18,8,10,61,49,12,62
Admira Wacke,4429,5,14,8,14,40,52,-12,50
RZ Pellets W,4429,6,12,11,13,47,53,-6,47
Rapid Vienna,4429,7,11,11,14,51,44,7,44
Mattersburg,4429,8,10,7,19,42,60,-18,37
St. Pölten,4429,9,8,8,20,42,62,-20,32
SV Josko Rie,4429,10,9,5,22,31,57,-26,32
FC Salzburg,4430,1,21,6,9,64,31,33,69
SC Rheindorf,4430,2,21,5,10,60,39,21,68
Vienna,4430,3,19,7,10,60,49,11,64
SK Sturm Gra,4430,4,19,5,12,59,37,22,62
Rapid Vienna,4430,5,13,10,13,52,42,10,49
RZ Pellets W,4430,6,13,6,17,44,53,-9,45
Admira Wacke,4430,7,12,6,18,37,59,-22,42
SV Josko Rie,4430,8,11,7,18,36,51,-15,40
St. Pölten,4430,9,10,10,16,39,62,-23,40
Mattersburg,4430,10,6,8,22,35,63,-28,26
FC Salzburg,4431,1,21,10,5,70,26,44,73
SC Rheindorf,4431,2,20,8,8,56,39,17,68
SK Sturm Gra,4431,3,19,6,11,55,33,22,63
Vienna,4431,4,17,5,14,60,56,4,56
Rapid Vienna,4431,5,14,9,13,62,46,16,51
Mattersburg,4431,6,12,6,18,48,59,-11,42
SV Josko Rie,4431,7,12,6,18,39,54,-15,42
RZ Pellets W,4431,8,11,7,18,42,61,-19,40
St. Pölten,4431,9,9,8,19,38,66,-28,35
Admira Wacke,4431,10,10,5,21,35,65,-30,35
FC Salzburg,4432,1,22,7,7,62,29,33,73
SK Sturm Gra,4432,2,19,9,8,62,30,32,66
Vienna,4432,3,20,4,12,69,57,12,64
SC Rheindorf,4432,4,17,8,11,47,39,8,59
RZ Pellets W,4432,5,14,9,13,43,48,-5,51
Rapid Vienna,4432,6,11,11,14,55,46,9,44
Mattersburg,4432,7,11,6,19,37,56,-19,39
Admira Wacke,4432,8,11,6,19,37,59,-22,39
St. Pölten,4432,9,9,8,19,37,64,-27,35
SV Josko Rie,4432,10,9,6,21,32,53,-21,33
FC Salzburg,4433,1,22,7,7,65,31,34,73
Vienna,4433,2,20,5,11,64,52,12,65
SC Rheindorf,4433,3,18,10,8,53,36,17,64
SK Sturm Gra,4433,4,16,11,9,61,35,26,59
RZ Pellets W,4433,5,13,9,14,55,54,1,48
Rapid Vienna,4433,6,11,12,13,59,52,7,45
Admira Wacke,4433,7,11,7,18,37,61,-24,40
SV Josko Rie,4433,8,11,4,21,33,57,-24,37
Mattersburg,4433,9,7,12,17,39,58,-19,33
St. Pölten,4433,10,6,13,17,34,64,-30,31
FC Salzburg,4434,1,22,8,6,68,28,40,74
SC Rheindorf,4434,2,19,9,8,53,41,12,66
SK Sturm Gra,4434,3,17,8,11,49,32,17,59
Vienna,4434,4,17,5,14,63,53,10,56
Rapid Vienna,4434,5,15,9,12,53,39,14,54
RZ Pellets W,4434,6,14,9,13,52,51,1,51
SV Josko Rie,4434,7,10,7,19,36,53,-17,37
Admira Wacke,4434,8,10,7,19,44,75,-31,37
Mattersburg,4434,9,8,10,18,37,58,-21,34
St. Pölten,4434,10,7,10,19,35,60,-25,31
SK Sturm Gra,4435,1,20,8,8,58,30,28,68
FC Salzburg,4435,2,20,6,10,59,33,26,66
SC Rheindorf,4435,3,16,8,12,47,43,4,56
Rapid Vienna,4435,4,14,12,10,61,47,14,54
Vienna,4435,5,15,8,13,50,53,-3,53
RZ Pellets W,4435,6,14,10,12,44,42,2,52
Admira Wacke,4435,7,12,8,16,39,53,-14,44
St. Pölten,4435,8,10,10,16,49,62,-13,40
SV Josko Rie,4435,9,8,9,19,34,54,-20,33
Mattersburg,4435,10,7,9,20,38,62,-24,30
FC Salzburg,4436,1,19,9,8,70,39,31,66
SC Rheindorf,4436,2,19,9,8,62,52,10,66
Rapid Vienna,4436,3,15,12,9,56,35,21,57
SK Sturm Gra,4436,4,16,9,11,57,40,17,57
Vienna,4436,5,16,6,14,60,59,1,54
SV Josko Rie,4436,6,16,3,17,44,52,-8,51
RZ Pellets W,4436,7,13,8,15,47,54,-7,47
Admira Wacke,4436,8,11,5,20,37,59,-22,38
St. Pölten,4436,9,10,7,19,43,59,-16,37
Mattersburg,4436,10,6,10,20,40,67,-27,28
FC Salzburg,4437,1,21,7,8,62,32,30,70
Vienna,4437,2,22,4,10,68,50,18,70
SC Rheindorf,4437,3,20,8,8,62,44,18,68
Rapid Vienna,4437,4,16,10,10,58,41,17,58
SK Sturm Gra,4437,5,15,7,14,48,40,8,52
St. Pölten,4437,6,10,11,15,47,59,-12,41
RZ Pellets W,4437,7,11,7,18,48,55,-7,40
Admira Wacke,4437,8,11,4,21,35,61,-26,37
SV Josko Rie,4437,9,10,4,22,38,61,-23,34
Mattersburg,4437,10,8,10,18,36,59,-23,34
FC Salzburg,4438,1,23,8,5,73,31,42,77
SC Rheindorf,4438,2,21,5,10,54,39,15,68
SK Sturm Gra,4438,3,19,7,10,55,34,21,64
Vienna,4438,4,17,8,11,58,47,11,59
Rapid Vienna,4438,5,16,8,12,60,42,18,56
RZ Pellets W,4438,6,11,8,17,41,61,-20,41
St. Pölten,4438,7,10,8,18,45,61,-16,38
SV Josko Rie,4438,8,9,7,20,39,61,-22,34
Admira Wacke,4438,9,9,7,20,29,56,-27,34
Mattersburg,4438,10,9,6,21,36,58,-22,33
FC Salzburg,4439,1,19,10,7,59,32,27,67
SC Rheindorf,4439,2,19,8,9,53,39,14,65
SK Sturm Gra,4439,3,19,6,11,62,36,26,63
Vienna,4439,4,17,7,12,55,46,9,58
Admira Wacke,4439,5,13,10,13,44,53,-9,49
Rapid Vienna,4439,6,11,10,15,44,41,3,43
SV Josko Rie,4439,7,12,7,17,36,50,-14,43
St. Pölten,4439,8,12,7,17,39,64,-25,43
RZ Pellets W,4439,9,10,8,18,41,51,-10,38
Mattersburg,4439,10,7,9,20,39,60,-21,30
Vienna,4440,1,21,4,11,70,53,17,67
FC Salzburg,4440,2,19,8,9,66,34,32,65
SC Rheindorf,4440,3,18,8,10,53,45,8,62
SK Sturm Gra,4440,4,18,7,11,60,40,20,61
Rapid Vienna,4440,5,15,11,10,57,40,17,56
SV Josko Rie,4440,6,13,5,18,34,45,-11,44
RZ Pellets W,4440,7,12,7,17,49,61,-12,43
Admira Wacke,4440,8,10,7,19,42,67,-25,37
St. Pölten,4440,9,9,9,18,38,59,-21,36
Mattersburg,4440,10,6,12,18,30,55,-25,30
FC Salzburg,4441,1,19,9,8,61,32,29,66
SK Sturm Gra,4441,2,20,4,12,59,35,24,64
SC Rheindorf,4441,3,18,8,10,56,48,8,62
Vienna,4441,4,19,3,14,57,53,4,60
Rapid Vienna,4441,5,12,13,11,50,40,10,49
RZ Pellets W,4441,6,12,9,15,51,55,-4,45
St. Pölten,4441,7,11,11,14,43,52,-9,44
Admira Wacke,4441,8,10,8,18,38,60,-22,38
SV Josko Rie,4441,9,10,8,18,32,54,-22,38
Mattersburg,4441,10,7,11,18,30,48,-18,32
FC Salzburg,4442,1,25,4,7,80,34,46,79
SC Rheindorf,4442,2,22,7,7,60,36,24,73
SK Sturm Gra,4442,3,18,5,13,59,41,18,59
Rapid Vienna,4442,4,15,11,10,58,39,19,56
Vienna,4442,5,17,5,14,61,52,9,56
RZ Pellets W,4442,6,12,11,13,53,53,0,47
Admira Wacke,4442,7,11,4,21,35,64,-29,37
SV Josko Rie,4442,8,10,5,21,31,59,-28,35
Mattersburg,4442,9,7,10,19,32,59,-27,31
St. Pölten,4442,10,7,10,19,37,69,-32,31
SC Rheindorf,4443,1,22,7,7,70,41,29,73
FC Salzburg,4443,2,21,8,7,71,37,34,71
SK Sturm Gra,4443,3,17,10,9,60,37,23,61
Vienna,4443,4,18,7,11,59,50,9,61
Rapid Vienna,4443,5,13,13,10,59,40,19,52
RZ Pellets W,4443,6,12,7,17,47,53,-6,43
Admira Wacke,4443,7,10,8,18,30,55,-25,38
SV Josko Rie,4443,8,11,3,22,30,61,-31,36
St. Pölten,4443,9,8,11,17,40,61,-21,35
Mattersburg,4443,10,5,12,19,36,67,-31,27
FC Salzburg,4444,1,23,6,7,73,35,38,75
Vienna,4444,2,21,4,11,70,48,22,67
SK Sturm Gra,4444,3,18,10,8,55,33,22,64
SC Rheindorf,4444,4,16,10,10,49,41,8,58
Rapid Vienna,4444,5,15,9,12,62,46,16,54
RZ Pellets W,4444,6,12,7,17,54,64,-10,43
SV Josko Rie,4444,7,12,4,20,39,54,-15,40
Admira Wacke,4444,8,10,5,21,35,65,-30,35
St. Pölten,4444,9,8,10,18,41,68,-27,34
Mattersburg,4444,10,7,11,18,40,64,-24,32
FC Salzburg,4445,1,20,8,8,64,27,37,68
SK Sturm Gra,4445,2,19,7,10,61,36,25,64
Vienna,4445,3,19,4,13,61,50,11,61
SC Rheindorf,4445,4,17,9,10,54,49,5,60
Rapid Vienna,4445,5,15,10,11,58,45,13,55
RZ Pellets W,4445,6,11,9,16,38,49,-11,42
Admira Wacke,4445,7,13,3,20,35,58,-23,42
St. Pölten,4445,8,9,11,16,42,60,-18,38
SV Josko Rie,4445,9,11,5,20,36,56,-20,38
Mattersburg,4445,10,8,10,18,33,52,-19,34
FC Salzburg,4446,1,24,7,5,70,29,41,79
SC Rheindorf,4446,2,20,9,7,56,40,16,69
SK Sturm Gra,4446,3,17,8,11,56,38,18,59
Rapid Vienna,4446,4,14,10,12,61,40,21,52
Vienna,4446,5,15,6,15,57,54,3,51
RZ Pellets W,4446,6,12,9,15,43,52,-9,45
SV Josko Rie,4446,7,11,9,16,35,48,-13,42
Mattersburg,4446,8,9,8,19,33,57,-24,35
Admira Wacke,4446,9,9,7,20,34,61,-27,34
St. Pölten,4446,10,7,11,18,39,65,-26,32
FC Salzburg,4447,1,21,6,9,64,34,30,69
SC Rheindorf,4447,2,20,8,8,61,46,15,68
Vienna,4447,3,19,6,11,72,54,18,63
SK Sturm Gra,4447,4,19,5,12,59,35,24,62
Rapid Vienna,4447,5,16,11,9,57,36,21,59
St. Pölten,4447,6,10,9,17,47,65,-18,39
Mattersburg,4447,7,11,5,20,42,52,-10,38
Admira Wacke,4447,8,11,5,20,39,71,-32,38
RZ Pellets W,4447,9,10,6,20,40,64,-24,36
SV Josko Rie,4447,10,10,5,21,30,54,-24,35
FC Salzburg,4448,1,21,8,7,63,28,35,71
SK Sturm Gra,4448,2,22,5,9,57,32,25,71
Vienna,4448,3,16,9,11,63,50,13,57
SC Rheindorf,4448,4,15,12,9,47,39,8,57
RZ Pellets W,4448,5,13,9,14,49,56,-7,48
Rapid Vienna,4448,6,11,14,11,59,50,9,47
SV Josko Rie,4448,7,13,6,17,40,49,-9,45
Admira Wacke,4448,8,11,7,18,37,58,-21,40
St. Pölten,4448,9,9,9,18,36,63,-27,36
Mattersburg,4448,10,4,11,21,33,59,-26,23
FC Salzburg,4449,1,23,6,7,68,27,41,75
SK Sturm Gra,4449,2,19,8,9,60,36,24,65
Vienna,4449,3,20,3,13,61,56,5,63
SC Rheindorf,4449,4,18,7,11,54,42,12,61
Rapid Vienna,4449,5,13,10,13,50,41,9,49
SV Josko Rie,4449,6,12,5,19,35,54,-19,41
Admira Wacke,4449,7,11,6,19,41,58,-17,39
Mattersburg,4449,8,9,11,16,37,52,-15,38
RZ Pellets W,4449,9,10,7,19,44,64,-20,37
St. Pölten,4449,10,9,9,18,45,65,-20,36
SC Rheindorf,4450,1,23,8,5,66,36,30,77
FC Salzburg,4450,2,22,8,6,60,25,35,74
SK Sturm Gra,4450,3,19,5,12,56,38,18,62
Vienna,4450,4,15,4,17,58,54,4,49
Rapid Vienna,4450,5,13,8,15,57,45,12,47
Admira Wacke,4450,6,13,7,16,39,59,-20,46
Mattersburg,4450,7,10,11,15,42,55,-13,41
RZ Pellets W,4450,8,12,5,19,43,60,-17,41
St. Pölten,4450,9,9,10,17,40,67,-27,37
SV Josko Rie,4450,10,8,6,22,31,53,-22,30
FC Salzburg,4451,1,21,10,5,70,29,41,73
Vienna,4451,2,19,5,12,62,49,13,62
SC Rheindorf,4451,3,17,11,8,49,39,10,62
Rapid Vienna,4451,4,15,12,9,56,35,21,57
SK Sturm Gra,4451,5,16,9,11,55,41,14,57
RZ Pellets W,4451,6,13,5,18,45,64,-19,44
Mattersburg,4451,7,10,9,17,43,55,-12,39
Admira Wacke,4451,8,11,6,19,43,59,-16,39
SV Josko Rie,4451,9,10,8,18,35,55,-20,38
St. Pölten,4451,10,5,11,20,35,67,-32,26
FC Salzburg,4452,1,22,7,7,66,33,33,73
SC Rheindorf,4452,2,19,8,9,56,46,10,65
SK Sturm Gra,4452,3,19,6,11,61,38,23,63
Vienna,4452,4,16,7,13,66,58,8,55
RZ Pellets W,4452,5,14,7,15,47,48,-1,49
Admira Wacke,4452,6,13,6,17,40,57,-17,45
St. Pölten,4452,7,12,7,17,39,57,-18,43
Rapid Vienna,4452,8,11,9,16,47,41,6,42
Mattersburg,4452,9,9,10,17,35,52,-17,37
SV Josko Rie,4452,10,9,5,22,27,54,-27,32
FC Salzburg,4453,1,22,7,7,72,33,39,73
SC Rheindorf,4453,2,19,9,8,57,41,16,66
SK Sturm Gra,4453,3,19,8,9,62,35,27,65
Vienna,4453,4,16,9,11,59,55,4,57
Rapid Vienna,4453,5,13,8,15,56,45,11,47
Admira Wacke,4453,6,12,10,14,43,58,-15,46
Mattersburg,4453,7,10,8,18,41,55,-14,38
RZ Pellets W,4453,8,9,10,17,46,67,-21,37
SV Josko Rie,4453,9,11,3,22,31,53,-22,36
St. Pölten,4453,10,8,10,18,43,68,-25,34
FC Salzburg,4454,1,21,7,8,66,31,35,70
SK Sturm Gra,4454,2,22,4,10,63,37,26,70
SC Rheindorf,4454,3,19,10,7,62,45,17,67
Rapid Vienna,4454,4,14,12,10,59,38,21,54
Vienna,4454,5,15,7,14,58,54,4,52
RZ Pellets W,4454,6,11,8,17,43,53,-10,41
Admira Wacke,4454,7,12,5,19,35,57,-22,41
Mattersburg,4454,8,10,7,19,40,65,-25,37
St. Pölten,4454,9,8,11,17,41,64,-23,35
SV Josko Rie,4454,10,9,7,20,33,56,-23,34
SK Sturm Gra,4455,1,19,6,11,59,35,24,63
SC Rheindorf,4455,2,18,8,10,55,41,14,62
FC Salzburg,4455,3,17,10,9,55,34,21,61
Vienna,4455,4,19,4,13,63,50,13,61
Rapid Vienna,4455,5,14,11,11,57,40,17,53
RZ Pellets W,4455,6,15,5,16,44,49,-5,50
Admira Wacke,4455,7,12,9,15,44,60,-16,45
SV Josko Rie,4455,8,12,7,17,40,53,-13,43
St. Pölten,4455,9,7,11,18,42,68,-26,32
Mattersburg,4455,10,8,7,21,40,69,-29,31
SK Sturm Gra,4456,1,20,7,9,60,34,26,67
Vienna,4456,2,20,7,9,69,49,20,67
FC Salzburg,4456,3,19,7,10,61,33,28,64
SC Rheindorf,4456,4,19,7,10,58,43,15,64
Rapid Vienna,4456,5,15,10,11,52,37,15,55
Mattersburg,4456,6,11,8,17,40,53,-13,41
RZ Pellets W,4456,7,10,9,17,40,52,-12,39
SV Josko Rie,4456,8,10,8,18,30,53,-23,38
Admira Wacke,4456,9,9,9,18,31,56,-25,36
St. Pölten,4456,10,7,8,21,39,70,-31,29
FC Salzburg,4457,1,23,6,7,70,30,40,75
Vienna,4457,2,22,4,10,67,51,16,70
SC Rheindorf,4457,3,18,8,10,52,42,10,62
Rapid Vienna,4457,4,15,9,12,64,44,20,54
SK Sturm Gra,4457,5,15,7,14,50,38,12,52
Admira Wacke,4457,6,13,7,16,34,51,-17,46
SV Josko Rie,4457,7,12,5,19,38,50,-12,41
St. Pölten,4457,8,10,9,17,41,60,-19,39
RZ Pellets W,4457,9,9,8,19,43,63,-20,35
Mattersburg,4457,10,8,7,21,38,68,-30,31
FC Salzburg,4458,1,21,9,6,66,30,36,72
SK Sturm Gra,4458,2,21,6,9,66,33,33,69
Vienna,4458,3,18,7,11,63,51,12,61
Rapid Vienna,4458,4,17,9,10,74,40,34,60
SC Rheindorf,4458,5,16,7,13,47,49,-2,55
RZ Pellets W,4458,6,12,7,17,44,61,-17,43
SV Josko Rie,4458,7,13,4,19,39,57,-18,43
St. Pölten,4458,8,8,11,17,46,66,-20,35
Admira Wacke,4458,9,8,9,19,30,63,-33,33
Mattersburg,4458,10,7,9,20,41,66,-25,30
SC Rheindorf,4459,1,20,5,11,59,44,15,65
SK Sturm Gra,4459,2,20,4,12,58,34,24,64
Rapid Vienna,4459,3,18,10,8,55,31,24,64
FC Salzburg,4459,4,19,6,11,63,37,26,63
Vienna,4459,5,17,10,9,58,48,10,61
Admira Wacke,4459,6,14,7,15,41,51,-10,49
RZ Pellets W,4459,7,12,9,15,46,57,-11,45
SV Josko Rie,4459,8,10,4,22,33,57,-24,34
Mattersburg,4459,9,8,8,20,37,58,-21,32
St. Pölten,4459,10,6,9,21,36,69,-33,27
SC Rheindorf,4460,1,21,8,7,62,41,21,71
SK Sturm Gra,4460,2,20,7,9,59,35,24,67
FC Salzburg,4460,3,18,12,6,59,31,28,66
Vienna,4460,4,19,6,11,71,53,18,63
Rapid Vienna,4460,5,12,12,12,47,39,8,48
Admira Wacke,4460,6,13,5,18,43,57,-14,44
RZ Pellets W,4460,7,10,10,16,44,56,-12,40
St. Pölten,4460,8,9,11,16,48,67,-19,38
SV Josko Rie,4460,9,9,8,19,39,61,-22,35
Mattersburg,4460,10,6,7,23,30,62,-32,25
Vienna,4461,1,21,5,10,66,50,16,68
FC Salzburg,4461,2,18,11,7,61,28,33,65
SK Sturm Gra,4461,3,19,6,11,63,34,29,63
SC Rheindorf,4461,4,18,9,9,57,42,15,63
Rapid Vienna,4461,5,14,11,11,62,43,19,53
Admira Wacke,4461,6,16,4,16,42,57,-15,52
RZ Pellets W,4461,7,13,6,17,48,62,-14,45
Mattersburg,4461,8,8,8,20,33,56,-23,32
SV Josko Rie,4461,9,8,7,21,29,62,-33,31
St. Pölten,4461,10,7,9,20,36,63,-27,30
FC Salzburg,4462,1,22,7,7,67,28,39,73
SC Rheindorf,4462,2,19,10,7,54,38,16,67
SK Sturm Gra,4462,3,15,8,13,50,38,12,53
Vienna,4462,4,15,7,14,58,55,3,52
Rapid Vienna,4462,5,14,9,13,52,48,4,51
RZ Pellets W,4462,6,15,5,16,52,52,0,50
Mattersburg,4462,7,11,7,18,36,54,-18,40
St. Pölten,4462,8,9,12,15,40,53,-13,39
Admira Wacke,4462,9,11,6,19,37,65,-28,39
SV Josko Rie,4462,10,11,5,20,35,50,-15,38
FC Salzburg,4463,1,22,5,9,64,30,34,71
SK Sturm Gra,4463,2,21,5,10,65,37,28,68
Vienna,4463,3,19,5,12,63,50,13,62
Rapid Vienna,4463,4,16,11,9,68,41,27,59
SC Rheindorf,4463,5,16,10,10,53,46,7,58
Admira Wacke,4463,6,12,7,17,36,56,-20,43
RZ Pellets W,4463,7,11,8,17,45,59,-14,41
Mattersburg,4463,8,10,8,18,35,55,-20,38
St. Pölten,4463,9,8,10,18,45,68,-23,34
SV Josko Rie,4463,10,7,7,22,31,63,-32,28
SK Sturm Gra,4464,1,21,7,8,66,35,31,70
SC Rheindorf,4464,2,20,10,6,60,36,24,70
FC Salzburg,4464,3,19,9,8,65,33,32,66
Vienna,4464,4,18,5,13,55,53,2,59
Rapid Vienna,4464,5,15,12,9,58,43,15,57
Admira Wacke,4464,6,11,7,18,38,58,-20,40
RZ Pellets W,4464,7,10,8,18,42,57,-15,38
St. Pölten,4464,8,9,10,17,41,59,-18,37
SV Josko Rie,4464,9,9,6,21,33,53,-20,33
Mattersburg,4464,10,7,8,21,28,59,-31,29
SC Rheindorf,4465,1,22,7,7,58,41,17,73
FC Salzburg,4465,2,20,8,8,66,35,31,68
SK Sturm Gra,4465,3,17,7,12,56,33,23,58
Vienna,4465,4,17,6,13,59,49,10,57
Rapid Vienna,4465,5,15,10,11,59,44,15,55
SV Josko Rie,4465,6,11,8,17,32,49,-17,41
St. Pölten,4465,7,9,12,15,48,62,-14,39
Admira Wacke,4465,8,10,8,18,33,57,-24,38
RZ Pellets W,4465,9,8,12,16,45,62,-17,36
Mattersburg,4465,10,9,6,21,41,65,-24,33
SC Rheindorf,4466,1,22,8,6,58,35,23,74
Vienna,4466,2,21,4,11,63,48,15,67
FC Salzburg,4466,3,18,9,9,58,33,25,63
SK Sturm Gra,4466,4,17,8,11,59,36,23,59
Rapid Vienna,4466,5,14,9,13,54,43,11,51
RZ Pellets W,4466,6,15,6,15,48,50,-2,51
SV Josko Rie,4466,7,12,5,19,33,52,-19,41
Mattersburg,4466,8,10,5,21,37,52,-15,35
St. Pölten,4466,9,9,7,20,41,67,-26,34
Admira Wacke,4466,10,8,7,21,30,65,-35,31
Vienna,4467,1,22,6,8,73,41,32,72
SC Rheindorf,4467,2,21,8,7,62,42,20,71
FC Salzburg,4467,3,18,11,7,57,26,31,65
Rapid Vienna,4467,4,15,10,11,58,38,20,55
SK Sturm Gra,4467,5,14,8,14,54,47,7,50
RZ Pellets W,4467,6,13,9,14,46,52,-6,48
Admira Wacke,4467,7,12,7,17,40,62,-22,43
SV Josko Rie,4467,8,12,4,20,34,50,-16,40
Mattersburg,4467,9,8,8,20,36,60,-24,32
St. Pölten,4467,10,4,11,21,36,78,-42,23
FC Salzburg,4468,1,22,9,5,62,24,38,75
SK Sturm Gra,4468,2,21,6,9,60,31,29,69
Vienna,4468,3,21,5,10,64,45,19,68
SC Rheindorf,4468,4,20,7,9,56,39,17,67
Rapid Vienna,4468,5,15,9,12,52,37,15,54
Admira Wacke,4468,6,11,7,18,42,61,-19,40
RZ Pellets W,4468,7,10,8,18,45,60,-15,38
Mattersburg,4468,8,9,9,18,36,52,-16,36
SV Josko Rie,4468,9,7,7,22,23,54,-31,28
St. Pölten,4468,10,7,7,22,36,73,-37,28
FC Salzburg,4469,1,23,5,8,72,32,40,74
SC Rheindorf,4469,2,20,8,8,57,40,17,68
SK Sturm Gra,4469,3,18,7,11,56,42,14,61
Vienna,4469,4,19,4,13,70,62,8,61
Rapid Vienna,4469,5,11,12,13,55,46,9,45
RZ Pellets W,4469,6,12,7,17,47,57,-10,43
Admira Wacke,4469,7,11,6,19,37,64,-27,39
Mattersburg,4469,8,9,11,16,41,59,-18,38
SV Josko Rie,4469,8,11,5,20,41,59,-18,38
St. Pölten,4469,10,8,11,17,46,61,-15,35
SK Sturm Gra,4470,1,22,6,8,72,30,42,72
FC Salzburg,4470,2,20,9,7,62,34,28,69
SC Rheindorf,4470,3,19,6,11,58,43,15,63
Rapid Vienna,4470,4,16,10,10,60,39,21,58
Vienna,4470,5,18,4,14,64,56,8,58
SV Josko Rie,4470,6,12,7,17,37,57,-20,43
RZ Pellets W,4470,7,11,7,18,44,56,-12,40
Admira Wacke,4470,8,10,6,20,38,65,-27,36
St. Pölten,4470,9,8,9,19,39,72,-33,33
Mattersburg,4470,10,8,8,20,32,54,-22,32
SC Rheindorf,4471,1,22,7,7,65,42,23,73
SK Sturm Gra,4471,2,22,6,8,59,27,32,72
FC Salzburg,4471,3,20,8,8,69,34,35,68
Vienna,4471,4,20,4,12,61,47,14,64
Rapid Vienna,4471,5,13,12,11,55,42,13,51
RZ Pellets W,4471,6,12,6,18,48,61,-13,42
Admira Wacke,4471,7,12,6,18,37,56,-19,42
SV Josko Rie,4471,8,10,4,22,34,59,-25,34
St. Pölten,4471,9,8,7,21,36,70,-34,31
Mattersburg,4471,10,6,10,20,37,63,-26,28
SC Rheindorf,4472,1,21,8,7,62,38,24,71
SK Sturm Gra,4472,2,21,5,10,54,28,26,68
FC Salzburg,4472,3,17,10,9,61,33,28,61
Rapid Vienna,4472,4,15,11,10,54,39,15,56
Vienna,4472,5,17,5,14,58,50,8,56
RZ Pellets W,4472,6,13,6,17,44,54,-10,45
Admira Wacke,4472,7,13,6,17,42,58,-16,45
St. Pölten,4472,8,10,12,14,46,61,-15,42
SV Josko Rie,4472,9,10,5,21,31,55,-24,35
Mattersburg,4472,10,5,8,23,28,64,-36,23
FC Salzburg,4473,1,22,7,7,74,31,43,73
SK Sturm Gra,4473,2,20,6,10,59,36,23,66
SC Rheindorf,4473,3,19,7,10,64,42,22,64
Vienna,4473,4,17,6,13,58,52,6,57
Rapid Vienna,4473,5,13,12,11,54,42,12,51
RZ Pellets W,4473,6,13,8,15,45,54,-9,47
St. Pölten,4473,7,10,8,18,41,58,-17,38
SV Josko Rie,4473,8,11,5,20,32,57,-25,38
Mattersburg,4473,9,7,13,16,32,53,-21,34
Admira Wacke,4473,10,9,6,21,31,65,-34,33
FC Salzburg,4474,1,22,7,7,67,28,39,73
SK Sturm Gra,4474,2,22,7,7,69,34,35,73
Vienna,4474,3,20,4,12,63,54,9,64
SC Rheindorf,4474,4,18,8,10,56,48,8,62
Rapid Vienna,4474,5,17,9,10,62,42,20,60
Admira Wacke,4474,6,11,7,18,38,57,-19,40
RZ Pellets W,4474,7,10,9,17,41,59,-18,39
Mattersburg,4474,8,10,6,20,44,59,-15,36
St. Pölten,4474,9,6,11,19,43,70,-27,29
SV Josko Rie,4474,10,7,6,23,29,61,-32,27
FC Salzburg,4475,1,21,7,8,60,30,30,70
SC Rheindorf,4475,2,20,7,9,52,37,15,67
SK Sturm Gra,4475,3,19,6,11,56,35,21,63
Vienna,4475,4,16,7,13,67,53,14,55
Rapid Vienna,4475,5,14,11,11,53,37,16,53
RZ Pellets W,4475,6,13,11,12,48,52,-4,50
Admira Wacke,4475,7,14,4,18,40,60,-20,46
SV Josko Rie,4475,8,10,4,22,34,59,-25,34
St. Pölten,4475,9,7,11,18,35,60,-25,32
Mattersburg,4475,10,7,10,19,36,58,-22,31
FC Salzburg,4476,1,21,9,6,70,34,36,72
SK Sturm Gra,4476,2,19,7,10,56,29,27,64
Rapid Vienna,4476,3,17,9,10,62,34,28,60
SC Rheindorf,4476,4,18,6,12,56,47,9,60
Vienna,4476,5,17,4,15,58,55,3,55
RZ Pellets W,4476,6,12,10,14,39,50,-11,46
SV Josko Rie,4476,7,11,5,20,34,59,-25,38
Admira Wacke,4476,8,10,8,18,31,58,-27,38
St. Pölten,4476,9,9,9,18,40,61,-21,36
Mattersburg,4476,10,8,9,19,35,54,-19,33
FC Salzburg,4477,1,22,6,8,67,28,39,72
SK Sturm Gra,4477,2,22,6,8,72,34,38,72
Vienna,4477,3,21,4,11,62,46,16,67
SC Rheindorf,4477,4,20,7,9,54,41,13,67
Rapid Vienna,4477,5,16,8,12,61,46,15,56
SV Josko Rie,4477,6,12,6,18,37,55,-18,42
RZ Pellets W,4477,7,11,6,19,39,61,-22,39
Admira Wacke,4477,8,11,5,20,45,64,-19,38
St. Pölten,4477,9,6,11,19,40,67,-27,29
Mattersburg,4477,10,6,7,23,28,63,-35,25
SC Rheindorf,4478,1,21,7,8,59,41,18,70
FC Salzburg,4478,2,21,6,9,69,33,36,69
SK Sturm Gra,4478,3,19,7,10,64,38,26,64
Rapid Vienna,4478,4,18,10,8,58,33,25,64
Vienna,4478,5,17,6,13,61,49,12,57
RZ Pellets W,4478,6,13,9,14,43,48,-5,48
Admira Wacke,4478,7,11,7,18,28,54,-26,40
St. Pölten,4478,8,10,8,18,43,61,-18,38
Mattersburg,4478,9,6,9,21,34,68,-34,27
SV Josko Rie,4478,10,7,5,24,28,62,-34,26
SK Sturm Gra,4479,1,21,5,10,61,31,30,68
FC Salzburg,4479,2,20,7,9,61,31,30,67
SC Rheindorf,4479,3,19,9,8,56,42,14,66
Vienna,4479,4,20,3,13,70,51,19,63
Rapid Vienna,4479,5,13,12,11,60,50,10,51
RZ Pellets W,4479,6,14,8,14,54,54,0,50
Admira Wacke,4479,7,11,6,19,36,59,-23,39
St. Pölten,4479,8,9,9,18,47,73,-26,36
SV Josko Rie,4479,9,9,5,22,30,63,-33,32
Mattersburg,4479,10,7,10,19,38,59,-21,31
FC Salzburg,4480,1,19,10,7,61,31,30,67
SC Rheindorf,4480,2,18,11,7,58,41,17,65
SK Sturm Gra,4480,3,18,7,11,56,34,22,61
Rapid Vienna,4480,4,14,11,11,58,41,17,53
Vienna,4480,5,14,6,16,52,53,-1,48
RZ Pellets W,4480,6,12,11,13,45,53,-8,47
Admira Wacke,4480,7,12,10,14,39,53,-14,46
St. Pölten,4480,8,9,12,15,39,57,-18,39
SV Josko Rie,4480,9,9,8,19,32,53,-21,35
Mattersburg,4480,10,8,8,20,32,56,-24,32
SC Rheindorf,4481,1,23,7,6,63,36,27,76
SK Sturm Gra,4481,2,19,9,8,59,31,28,66
Vienna,4481,3,20,5,11,69,55,14,65
FC Salzburg,4481,4,19,7,10,66,42,24,64
Rapid Vienna,4481,5,16,10,10,64,42,22,58
RZ Pellets W,4481,6,11,10,15,46,59,-13,43
Admira Wacke,4481,7,10,6,20,37,66,-29,36
St. Pölten,4481,8,9,8,19,44,64,-20,35
SV Josko Rie,4481,9,8,6,22,31,57,-26,30
Mattersburg,4481,10,7,8,21,36,63,-27,29
SC Rheindorf,4482,1,22,9,5,54,35,19,75
Vienna,4482,2,19,6,11,63,46,17,63
FC Salzburg,4482,3,18,7,11,55,31,24,61
SK Sturm Gra,4482,4,16,10,10,51,30,21,58
Rapid Vienna,4482,5,15,10,11,57,41,16,55
Admira Wacke,4482,6,15,5,16,41,53,-12,50
RZ Pellets W,4482,7,12,7,17,42,54,-12,43
Mattersburg,4482,8,10,7,19,39,52,-13,37
St. Pölten,4482,9,9,8,19,41,63,-22,35
SV Josko Rie,4482,10,7,5,24,27,65,-38,26
SC Rheindorf,4483,1,22,8,6,67,40,27,74
SK Sturm Gra,4483,2,20,8,8,62,31,31,68
Vienna,4483,3,18,5,13,55,52,3,59
FC Salzburg,4483,4,16,8,12,53,36,17,56
Rapid Vienna,4483,5,15,10,11,59,36,23,55
RZ Pellets W,4483,6,14,7,15,52,61,-9,49
Admira Wacke,4483,7,13,5,18,42,64,-22,44
St. Pölten,4483,8,10,9,17,46,67,-21,39
Mattersburg,4483,9,6,13,17,34,51,-17,31
SV Josko Rie,4483,10,6,7,23,28,60,-32,25
SC Rheindorf,4484,1,19,9,8,54,37,17,66
FC Salzburg,4484,2,19,8,9,63,31,32,65
Vienna,4484,3,18,9,9,63,45,18,63
SK Sturm Gra,4484,4,16,10,10,51,34,17,58
RZ Pellets W,4484,5,15,7,14,51,51,0,52
Admira Wacke,4484,6,15,6,15,42,57,-15,51
Rapid Vienna,4484,7,10,14,12,48,44,4,44
St. Pölten,4484,8,10,11,15,42,59,-17,41
SV Josko Rie,4484,9,7,9,20,31,59,-28,30
Mattersburg,4484,10,6,7,23,32,60,-28,25
SK Sturm Gra,4485,1,21,8,7,72,35,37,71
SC Rheindorf,4485,2,20,9,7,58,39,19,69
FC Salzburg,4485,3,19,7,10,63,35,28,64
Vienna,4485,4,15,8,13,60,63,-3,53
Rapid Vienna,4485,5,13,11,12,55,44,11,50
RZ Pellets W,4485,6,11,9,16,49,57,-8,42
Admira Wacke,4485,7,12,6,18,43,65,-22,42
Mattersburg,4485,8,9,10,17,37,52,-15,37
SV Josko Rie,4485,9,8,10,18,35,59,-24,34
St. Pölten,4485,10,7,12,17,42,65,-23,33
SK Sturm Gra,4486,1,22,6,8,62,32,30,72
FC Salzburg,4486,2,21,6,9,67,32,35,69
Vienna,4486,3,21,6,9,75,51,24,69
SC Rheindorf,4486,4,17,8,11,53,49,4,59
Rapid Vienna,4486,5,14,10,12,57,41,16,52
RZ Pellets W,4486,6,12,8,16,44,59,-15,44
Admira Wacke,4486,7,12,7,17,37,52,-15,43
Mattersburg,4486,8,9,7,20,36,64,-28,34
St. Pölten,4486,9,7,11,18,40,65,-25,32
SV Josko Rie,4486,10,8,5,23,30,56,-26,29
SC Rheindorf,4487,1,21,8,7,58,38,20,71
SK Sturm Gra,4487,2,20,6,10,64,35,29,66
FC Salzburg,4487,3,18,10,8,68,36,32,64
Rapid Vienna,4487,4,16,9,11,59,40,19,57
Vienna,4487,5,16,6,14,57,56,1,54
RZ Pellets W,4487,6,12,7,17,43,56,-13,43
SV Josko Rie,4487,7,12,5,19,41,55,-14,41
Admira Wacke,4487,8,10,8,18,35,56,-21,38
St. Pölten,4487,9,10,8,18,39,62,-23,38
Mattersburg,4487,10,7,9,20,36,66,-30,30
Vienna,4488,1,20,6,10,70,48,22,66
SK Sturm Gra,4488,2,18,9,9,54,33,21,63
SC Rheindorf,4488,3,18,8,10,54,42,12,62
FC Salzburg,4488,4,17,9,10,53,32,21,60
Rapid Vienna,4488,5,13,11,12,57,43,14,50
RZ Pellets W,4488,6,11,10,15,41,50,-9,43
Admira Wacke,4488,7,12,6,18,37,58,-21,42
SV Josko Rie,4488,8,11,6,19,34,53,-19,39
Mattersburg,4488,9,10,8,18,40,57,-17,38
St. Pölten,4488,10,9,9,18,36,60,-24,36
SC Rheindorf,4489,1,21,5,10,65,49,16,68
Vienna,4489,2,21,4,11,65,49,16,67
FC Salzburg,4489,3,19,7,10,65,35,30,64
SK Sturm Gra,4489,4,19,6,11,54,40,14,63
Rapid Vienna,4489,5,15,10,11,55,38,17,55
RZ Pellets W,4489,6,12,9,15,46,51,-5,45
SV Josko Rie,4489,7,13,3,20,38,49,-11,42
Admira Wacke,4489,8,10,8,18,36,63,-27,38
St. Pölten,4489,9,9,9,18,42,62,-20,36
Mattersburg,4489,10,7,7,22,34,64,-30,28
SC Rheindorf,4490,1,22,8,6,60,39,21,74
Vienna,4490,2,22,2,12,71,47,24,68
FC Salzburg,4490,3,20,7,9,69,35,34,67
SK Sturm Gra,4490,4,21,4,11,64,39,25,67
RZ Pellets W,4490,5,13,8,15,44,53,-9,47
Rapid Vienna,4490,6,11,11,14,54,46,8,44
SV Josko Rie,4490,7,13,4,19,36,53,-17,43
Admira Wacke,4490,8,12,5,19,37,62,-25,41
Mattersburg,4490,9,7,9,20,32,61,-29,30
St. Pölten,4490,10,6,8,22,38,70,-32,26
FC Salzburg,4491,1,20,7,9,71,36,35,67
SK Sturm Gra,4491,2,19,7,10,63,32,31,64
SC Rheindorf,4491,3,18,9,9,54,43,11,63
Vienna,4491,4,17,6,13,58,52,6,57
Rapid Vienna,4491,5,14,11,11,53,38,15,53
RZ Pellets W,4491,6,15,6,15,44,53,-9,51
St. Pölten,4491,7,12,7,17,42,60,-18,43
SV Josko Rie,4491,8,10,8,18,35,51,-16,38
Admira Wacke,4491,9,9,7,20,36,71,-35,34
Mattersburg,4491,10,8,8,20,37,57,-20,32
FC Salzburg,4492,1,20,10,6,64,31,33,70
SC Rheindorf,4492,2,19,6,11,59,45,14,63
Vienna,4492,3,19,3,14,64,53,11,60
Rapid Vienna,4492,4,16,11,9,57,36,21,59
SK Sturm Gra,4492,5,17,5,14,56,44,12,56
RZ Pellets W,4492,6,12,8,16,47,65,-18,44
Admira Wacke,4492,7,12,8,16,38,56,-18,44
SV Josko Rie,4492,8,12,7,17,41,53,-12,43
Mattersburg,4492,9,10,7,19,39,53,-14,37
St. Pölten,4492,10,5,11,20,38,67,-29,26
FC Salzburg,4493,1,21,9,6,67,30,37,72
SK Sturm Gra,4493,2,19,7,10,55,33,22,64
SC Rheindorf,4493,3,19,7,10,56,46,10,64
Vienna,4493,4,19,3,14,60,59,1,60
RZ Pellets W,4493,5,16,7,13,48,44,4,55
Rapid Vienna,4493,6,14,9,13,59,46,13,51
SV Josko Rie,4493,7,13,4,19,34,45,-11,43
St. Pölten,4493,8,9,9,18,40,58,-18,36
Admira Wacke,4493,9,10,5,21,39,64,-25,35
Mattersburg,4493,10,7,6,23,29,62,-33,27
FC Salzburg,4494,1,22,6,8,60,26,34,72
SK Sturm Gra,4494,2,19,7,10,55,32,23,64
Vienna,4494,3,18,4,14,58,52,6,58
Rapid Vienna,4494,4,15,12,9,54,36,18,57
SC Rheindorf,4494,5,15,9,12,46,44,2,54
RZ Pellets W,4494,6,11,9,16,44,50,-6,42
SV Josko Rie,4494,7,12,6,18,35,49,-14,42
Admira Wacke,4494,8,10,9,17,31,58,-27,39
Mattersburg,4494,9,9,8,19,38,56,-18,35
St. Pölten,4494,10,7,14,15,35,53,-18,35
FC Salzburg,4495,1,22,7,7,64,28,36,73
SK Sturm Gra,4495,2,19,8,9,62,33,29,65
Vienna,4495,3,18,9,9,64,51,13,63
SC Rheindorf,4495,4,17,8,11,49,43,6,59
Rapid Vienna,4495,5,15,11,10,56,35,21,56
St. Pölten,4495,6,10,8,18,43,66,-23,38
Mattersburg,4495,7,8,12,16,41,55,-14,36
RZ Pellets W,4495,8,9,9,18,41,61,-20,36
Admira Wacke,4495,9,9,9,18,40,64,-24,36
SV Josko Rie,4495,10,10,5,21,36,60,-24,35
FC Salzburg,4496,1,23,6,7,65,28,37,75
SC Rheindorf,4496,2,19,8,9,54,38,16,65
Vienna,4496,3,18,6,12,64,52,12,60
SK Sturm Gra,4496,4,18,5,13,58,37,21,59
Rapid Vienna,4496,5,15,8,13,62,47,15,53
Admira Wacke,4496,6,14,3,19,36,56,-20,45
SV Josko Rie,4496,7,12,4,20,39,59,-20,40
RZ Pellets W,4496,8,10,8,18,41,62,-21,38
St. Pölten,4496,9,9,10,17,42,69,-27,37
Mattersburg,4496,10,8,10,18,37,50,-13,34
SC Rheindorf,4497,1,22,7,7,59,36,23,73
SK Sturm Gra,4497,2,21,6,9,58,33,25,69
FC Salzburg,4497,3,20,5,11,63,33,30,65
Vienna,4497,4,17,4,15,62,54,8,55
Rapid Vienna,4497,5,13,11,12,53,41,12,50
Admira Wacke,4497,6,14,3,19,44,67,-23,45
RZ Pellets W,4497,7,11,7,18,40,55,-15,40
Mattersburg,4497,8,11,7,18,43,60,-17,40
St. Pölten,4497,9,10,8,18,45,63,-18,38
SV Josko Rie,4497,10,10,4,22,32,57,-25,34
SK Sturm Gra,4498,1,20,7,9,63,32,31,67
SC Rheindorf,4498,2,20,7,9,57,45,12,67
FC Salzburg,4498,3,19,6,11,62,40,22,63
Rapid Vienna,4498,4,16,10,10,66,41,25,58
Vienna,4498,5,17,4,15,62,59,3,55
RZ Pellets W,4498,6,12,7,17,45,55,-10,43
Admira Wacke,4498,7,11,9,16,42,62,-20,42
Mattersburg,4498,8,10,9,17,38,55,-17,39
St. Pölten,4498,9,10,7,19,41,63,-22,37
SV Josko Rie,4498,10,9,6,21,34,58,-24,33
SK Sturm Gra,4499,1,23,5,8,65,27,38,74
FC Salzburg,4499,2,21,6,9,64,32,32,69
SC Rheindorf,4499,3,18,10,8,57,42,15,64
Vienna,4499,4,18,6,12,63,47,16,60
Rapid Vienna,4499,5,17,8,11,57,40,17,59
RZ Pellets W,4499,6,11,12,13,40,47,-7,45
St. Pölten,4499,7,9,10,17,37,66,-29,37
Admira Wacke,4499,8,9,6,21,32,62,-30,33
SV Josko Rie,4499,9,9,5,22,33,53,-20,32
Mattersburg,4499,10,7,8,21,39,71,-32,29
FC Salzburg,4500,1,22,6,8,63,31,32,72
SK Sturm Gra,4500,2,19,8,9,65,34,31,65
SC Rheindorf,4500,3,18,8,10,56,41,15,62
Vienna,4500,4,19,5,12,58,51,7,62
RZ Pellets W,4500,5,13,10,13,50,55,-5,49
Rapid Vienna,4500,6,13,9,14,52,48,4,48
Admira Wacke,4500,7,12,7,17,42,54,-12,43
Mattersburg,4500,8,10,8,18,46,63,-17,38
SV Josko Rie,4500,9,9,6,21,28,58,-30,33
St. Pölten,4500,10,6,11,19,43,68,-25,29
SC Rheindorf,4501,1,21,8,7,61,41,20,71
FC Salzburg,4501,2,21,6,9,71,34,37,69
SK Sturm Gra,4501,3,17,10,9,51,28,23,61
Vienna,4501,4,17,7,12,56,51,5,58
Rapid Vienna,4501,5,14,9,13,56,43,13,51
SV Josko Rie,4501,6,13,7,16,39,48,-9,46
RZ Pellets W,4501,7,13,5,18,48,58,-10,44
Admira Wacke,4501,8,12,5,19,40,66,-26,41
Mattersburg,4501,9,9,8,19,33,53,-20,35
St. Pölten,4501,10,6,9,21,40,73,-33,27
FC Salzburg,4502,1,22,8,6,72,31,41,74
SK Sturm Gra,4502,2,21,6,9,65,32,33,69
Vienna,4502,3,19,6,11,63,51,12,63
SC Rheindorf,4502,4,19,5,12,52,41,11,62
Rapid Vienna,4502,5,12,10,14,58,54,4,46
Mattersburg,4502,6,13,6,17,43,56,-13,45
RZ Pellets W,4502,7,11,7,18,47,64,-17,40
SV Josko Rie,4502,8,11,5,20,34,54,-20,38
Admira Wacke,4502,9,8,10,18,35,64,-29,34
St. Pölten,4502,10,6,13,17,40,62,-22,31
FC Salzburg,4503,1,23,6,7,68,28,40,75
SC Rheindorf,4503,2,20,8,8,61,42,19,68
SK Sturm Gra,4503,3,17,6,13,59,43,16,57
Vienna,4503,4,17,6,13,65,56,9,57
Rapid Vienna,4503,5,15,11,10,58,43,15,56
RZ Pellets W,4503,6,14,5,17,44,55,-11,47
SV Josko Rie,4503,7,11,6,19,33,49,-16,39
St. Pölten,4503,8,9,11,16,38,60,-22,38
Admira Wacke,4503,9,11,5,20,31,59,-28,38
Mattersburg,4503,10,7,8,21,37,59,-22,29
FC Salzburg,4504,1,20,9,7,71,43,28,69
SC Rheindorf,4504,2,21,6,9,55,44,11,69
SK Sturm Gra,4504,3,19,6,11,55,32,23,63
Vienna,4504,4,18,6,12,64,55,9,60
Rapid Vienna,4504,5,13,10,13,61,47,14,49
Admira Wacke,4504,6,12,7,17,37,53,-16,43
RZ Pellets W,4504,7,11,8,17,42,52,-10,41
St. Pölten,4504,8,11,8,17,47,62,-15,41
Mattersburg,4504,9,8,11,17,39,57,-18,35
SV Josko Rie,4504,10,8,7,21,28,54,-26,31
SK Sturm Gra,4505,1,23,5,8,59,28,31,74
FC Salzburg,4505,2,22,6,8,61,26,35,72
SC Rheindorf,4505,3,18,7,11,47,43,4,61
Vienna,4505,4,17,5,14,55,47,8,56
Rapid Vienna,4505,5,13,12,11,51,41,10,51
RZ Pellets W,4505,6,14,8,14,42,45,-3,50
Admira Wacke,4505,7,12,6,18,34,56,-22,42
Mattersburg,4505,8,9,8,19,34,50,-16,35
SV Josko Rie,4505,9,10,5,21,33,51,-18,35
St. Pölten,4505,10,7,8,21,38,67,-29,29
SK Sturm Gra,4506,1,22,6,8,60,29,31,72
SC Rheindorf,4506,2,20,8,8,64,36,28,68
FC Salzburg,4506,3,19,7,10,59,32,27,64
Vienna,4506,4,19,3,14,67,55,12,60
RZ Pellets W,4506,5,16,7,13,49,50,-1,55
Rapid Vienna,4506,6,14,10,12,56,45,11,52
Admira Wacke,4506,7,14,3,19,39,61,-22,45
SV Josko Rie,4506,8,10,5,21,31,59,-28,35
St. Pölten,4506,9,8,10,18,41,60,-19,34
Mattersburg,4506,10,5,7,24,30,69,-39,22
FC Salzburg,4507,1,19,9,8,63,29,34,66
SC Rheindorf,4507,2,19,8,9,56,44,12,65
SK Sturm Gra,4507,3,18,7,11,60,42,18,61
Vienna,4507,4,19,3,14,65,56,9,60
Rapid Vienna,4507,5,14,10,12,56,45,11,52
RZ Pellets W,4507,6,14,8,14,45,51,-6,50
SV Josko Rie,4507,7,13,3,20,41,55,-14,42
Admira Wacke,4507,8,12,6,18,36,58,-22,42
St. Pölten,4507,9,9,7,20,44,66,-22,34
Mattersburg,4507,10,8,9,19,35,55,-20,33
Vienna,4508,1,21,6,9,68,47,21,69
FC Salzburg,4508,2,19,9,8,65,30,35,66
SC Rheindorf,4508,3,19,8,9,60,45,15,65
SK Sturm Gra,4508,4,18,7,11,56,35,21,61
Rapid Vienna,4508,5,16,10,10,63,38,25,58
RZ Pellets W,4508,6,12,6,18,46,61,-15,42
Mattersburg,4508,7,11,8,17,45,60,-15,41
Admira Wacke,4508,8,10,7,19,35,68,-33,37
St. Pölten,4508,9,8,10,18,41,66,-25,34
SV Josko Rie,4508,10,9,3,24,33,62,-29,30
FC Salzburg,4509,1,23,7,6,67,29,38,76
SC Rheindorf,4509,2,20,7,9,59,40,19,67
Vienna,4509,3,20,5,11,80,54,26,65
SK Sturm Gra,4509,4,17,8,11,58,41,17,59
Rapid Vienna,4509,5,14,10,12,55,37,18,52
RZ Pellets W,4509,6,12,9,15,47,52,-5,45
St. Pölten,4509,7,10,9,17,43,66,-23,39
Admira Wacke,4509,8,11,4,21,30,64,-34,37
Mattersburg,4509,9,7,11,18,31,55,-24,32
SV Josko Rie,4509,10,9,4,23,36,68,-32,31
FC Salzburg,4510,1,20,10,6,63,27,36,70
SK Sturm Gra,4510,2,20,7,9,58,33,25,67
SC Rheindorf,4510,3,19,8,9,56,39,17,65
Vienna,4510,4,20,5,11,64,52,12,65
Rapid Vienna,4510,5,14,9,13,55,45,10,51
RZ Pellets W,4510,6,12,6,18,43,56,-13,42
SV Josko Rie,4510,7,11,8,17,32,48,-16,41
Mattersburg,4510,8,8,10,18,40,62,-22,34
Admira Wacke,4510,9,9,7,20,30,59,-29,34
St. Pölten,4510,10,8,8,20,43,63,-20,32
FC Salzburg,4511,1,20,6,10,59,31,28,66
Vienna,4511,2,21,3,12,69,53,16,66
SK Sturm Gra,4511,3,18,10,8,60,31,29,64
SC Rheindorf,4511,4,18,9,9,51,40,11,63
Rapid Vienna,4511,5,13,14,9,52,36,16,53
RZ Pellets W,4511,6,12,10,14,43,54,-11,46
SV Josko Rie,4511,7,11,8,17,36,48,-12,41
Admira Wacke,4511,8,8,10,18,35,59,-24,34
Mattersburg,4511,9,6,13,17,32,53,-21,31
St. Pölten,4511,10,8,7,21,32,64,-32,31
SC Rheindorf,4512,1,21,6,9,58,41,17,69
FC Salzburg,4512,2,20,8,8,68,34,34,68
SK Sturm Gra,4512,3,19,8,9,57,34,23,65
Vienna,4512,4,19,4,13,54,53,1,61
Rapid Vienna,4512,5,16,8,12,62,41,21,56
RZ Pellets W,4512,6,13,7,16,41,54,-13,46
Admira Wacke,4512,7,12,5,19,38,55,-17,41
SV Josko Rie,4512,8,10,8,18,29,49,-20,38
St. Pölten,4512,9,7,10,19,37,62,-25,31
Mattersburg,4512,10,8,6,22,35,56,-21,30
FC Salzburg,4513,1,25,4,7,68,25,43,79
SC Rheindorf,4513,2,22,7,7,65,37,28,73
SK Sturm Gra,4513,3,19,4,13,55,39,16,61
Rapid Vienna,4513,4,16,11,9,58,36,22,59
Vienna,4513,5,17,5,14,62,50,12,56
Admira Wacke,4513,6,12,5,19,37,69,-32,41
RZ Pellets W,4513,7,11,7,18,40,58,-18,40
SV Josko Rie,4513,8,10,6,20,31,57,-26,36
St. Pölten,4513,9,8,9,19,38,61,-23,33
Mattersburg,4513,10,8,6,22,37,59,-22,30
SK Sturm Gra,4514,1,23,5,8,67,31,36,74
FC Salzburg,4514,2,20,8,8,64,31,33,68
Vienna,4514,3,21,5,10,62,48,14,68
SC Rheindorf,4514,4,18,7,11,49,41,8,61
Rapid Vienna,4514,5,15,10,11,60,38,22,55
RZ Pellets W,4514,6,10,9,17,44,58,-14,39
Admira Wacke,4514,7,10,9,17,36,59,-23,39
SV Josko Rie,4514,8,9,7,20,31,56,-25,34
Mattersburg,4514,9,7,11,18,38,63,-25,32
St. Pölten,4514,10,6,11,19,36,62,-26,29
SC Rheindorf,4515,1,20,8,8,64,43,21,68
FC Salzburg,4515,2,20,7,9,59,32,27,67
SK Sturm Gra,4515,3,19,5,12,62,40,22,62
Vienna,4515,4,18,6,12,57,49,8,60
Rapid Vienna,4515,5,13,12,11,55,41,14,51
RZ Pellets W,4515,6,12,6,18,48,55,-7,42
Mattersburg,4515,7,11,8,17,37,54,-17,41
SV Josko Rie,4515,8,11,7,18,39,55,-16,40
Admira Wacke,4515,9,9,9,18,33,62,-29,36
St. Pölten,4515,10,7,12,17,42,65,-23,33
FC Salzburg,4516,1,20,8,8,61,27,34,68
SC Rheindorf,4516,2,20,7,9,56,42,14,67
SK Sturm Gra,4516,3,18,10,8,53,28,25,64
Vienna,4516,4,16,7,13,58,53,5,55
Rapid Vienna,4516,5,13,13,10,57,42,15,52
RZ Pellets W,4516,6,12,8,16,44,56,-12,44
Mattersburg,4516,7,11,9,16,43,51,-8,42
Admira Wacke,4516,8,12,5,19,46,67,-21,41
SV Josko Rie,4516,9,10,6,20,34,57,-23,36
St. Pölten,4516,10,7,9,20,40,69,-29,30
SC Rheindorf,4517,1,22,8,6,59,37,22,74
FC Salzburg,4517,2,20,9,7,66,35,31,69
SK Sturm Gra,4517,3,18,8,10,61,38,23,62
Vienna,4517,4,18,4,14,56,52,4,58
Rapid Vienna,4517,5,10,14,12,49,47,2,44
Mattersburg,4517,6,12,8,16,42,53,-11,44
RZ Pellets W,4517,7,12,6,18,44,54,-10,42
SV Josko Rie,4517,8,12,3,21,38,58,-20,39
Admira Wacke,4517,9,10,5,21,34,56,-22,35
St. Pölten,4517,10,7,13,16,41,60,-19,34
SK Sturm Gra,4518,1,21,7,8,57,34,23,70
SC Rheindorf,4518,2,21,6,9,64,43,21,69
FC Salzburg,4518,3,17,10,9,61,36,25,61
Vienna,4518,4,17,6,13,57,50,7,57
Rapid Vienna,4518,5,13,14,9,54,37,17,53
RZ Pellets W,4518,6,13,7,16,45,55,-10,46
Admira Wacke,4518,7,12,7,17,39,54,-15,43
SV Josko Rie,4518,8,9,8,19,32,52,-20,35
St. Pölten,4518,9,8,9,19,42,66,-24,33
Mattersburg,4518,10,7,10,19,34,58,-24,31
SC Rheindorf,4519,1,22,9,5,58,37,21,75
FC Salzburg,4519,2,19,8,9,69,35,34,65
Vienna,4519,3,18,5,13,61,52,9,59
SK Sturm Gra,4519,4,17,7,12,56,33,23,58
Rapid Vienna,4519,5,15,11,10,54,39,15,56
RZ Pellets W,4519,6,14,5,17,50,64,-14,47
Admira Wacke,4519,7,12,5,19,40,61,-21,41
St. Pölten,4519,8,11,7,18,44,58,-14,40
Mattersburg,4519,9,7,11,18,41,61,-20,32
SV Josko Rie,4519,10,9,4,23,27,60,-33,31
FC Salzburg,4520,1,22,6,8,61,31,30,72
SK Sturm Gra,4520,2,22,5,9,64,27,37,71
Vienna,4520,3,19,7,10,63,48,15,64
SC Rheindorf,4520,4,18,9,9,55,41,14,63
Rapid Vienna,4520,5,14,9,13,57,44,13,51
RZ Pellets W,4520,6,12,10,14,43,51,-8,46
SV Josko Rie,4520,7,10,8,18,35,53,-18,38
St. Pölten,4520,8,8,10,18,40,63,-23,34
Admira Wacke,4520,9,8,8,20,33,65,-32,32
Mattersburg,4520,10,8,6,22,31,59,-28,30
FC Salzburg,4521,1,22,9,5,70,30,40,75
SC Rheindorf,4521,2,21,6,9,59,40,19,69
SK Sturm Gra,4521,3,20,6,10,58,31,27,66
Vienna,4521,4,20,5,11,66,49,17,65
RZ Pellets W,4521,5,12,8,16,43,58,-15,44
Rapid Vienna,4521,6,10,13,13,46,43,3,43
SV Josko Rie,4521,7,13,4,19,39,54,-15,43
Admira Wacke,4521,8,10,9,17,36,57,-21,39
Mattersburg,4521,9,7,11,18,35,55,-20,32
St. Pölten,4521,10,4,11,21,32,67,-35,23
SC Rheindorf,4522,1,21,8,7,67,42,25,71
FC Salzburg,4522,2,20,9,7,65,36,29,69
Vienna,4522,3,20,5,11,65,53,12,65
SK Sturm Gra,4522,4,19,4,13,56,36,20,61
Rapid Vienna,4522,5,15,10,11,58,47,11,55
RZ Pellets W,4522,6,12,10,14,47,58,-11,46
St. Pölten,4522,7,9,11,16,49,62,-13,38
SV Josko Rie,4522,8,10,5,21,35,54,-19,35
Admira Wacke,4522,9,10,4,22,41,65,-24,34
Mattersburg,4522,10,7,8,21,35,65,-30,29
FC Salzburg,4523,1,20,8,8,68,31,37,68
SC Rheindorf,4523,2,19,10,7,55,37,18,67
SK Sturm Gra,4523,3,18,7,11,55,33,22,61
Vienna,4523,4,16,9,11,58,48,10,57
Rapid Vienna,4523,5,14,10,12,58,41,17,52
RZ Pellets W,4523,6,12,7,17,49,61,-12,43
SV Josko Rie,4523,7,12,6,18,37,55,-18,42
St. Pölten,4523,8,9,12,15,37,56,-19,39
Admira Wacke,4523,9,11,6,19,35,61,-26,39
Mattersburg,4523,10,5,13,18,36,65,-29,28
FC Salzburg,4524,1,22,7,7,65,30,35,73
Vienna,4524,2,22,2,12,73,46,27,68
SC Rheindorf,4524,3,19,8,9,58,44,14,65
SK Sturm Gra,4524,4,19,7,10,58,34,24,64
Rapid Vienna,4524,5,13,8,15,52,41,11,47
RZ Pellets W,4524,6,13,8,15,47,58,-11,47
St. Pölten,4524,7,10,9,17,40,62,-22,39
SV Josko Rie,4524,8,10,6,20,32,56,-24,36
Mattersburg,4524,9,8,9,19,37,60,-23,33
Admira Wacke,4524,10,9,6,21,31,62,-31,33
SK Sturm Gra,4525,1,22,6,8,63,30,33,72
FC Salzburg,4525,2,20,10,6,60,27,33,70
SC Rheindorf,4525,3,19,7,10,53,43,10,64
Vienna,4525,4,17,7,12,58,50,8,58
Rapid Vienna,4525,5,13,12,11,50,41,9,51
RZ Pellets W,4525,6,11,6,19,35,49,-14,39
Admira Wacke,4525,7,11,5,20,38,58,-20,38
St. Pölten,4525,8,10,8,18,41,62,-21,38
SV Josko Rie,4525,9,11,5,20,35,57,-22,38
Mattersburg,4525,10,8,10,18,41,57,-16,34
FC Salzburg,4526,1,21,9,6,63,29,34,72
SC Rheindorf,4526,2,21,6,9,51,36,15,69
SK Sturm Gra,4526,3,19,7,10,57,35,22,64
Vienna,4526,4,18,4,14,54,48,6,58
Rapid Vienna,4526,5,14,11,11,58,44,14,53
Admira Wacke,4526,6,15,4,17,41,59,-18,49
RZ Pellets W,4526,7,11,7,18,43,51,-8,40
SV Josko Rie,4526,8,10,5,21,29,51,-22,35
Mattersburg,4526,9,8,9,19,41,55,-14,33
St. Pölten,4526,10,8,8,20,40,69,-29,32
FC Salzburg,4527,1,21,6,9,59,32,27,69
SK Sturm Gra,4527,2,20,7,9,64,39,25,67
SC Rheindorf,4527,3,20,6,10,53,42,11,66
Rapid Vienna,4527,4,14,12,10,58,41,17,54
Vienna,4527,5,15,5,16,58,58,0,50
Admira Wacke,4527,6,14,8,14,39,49,-10,50
RZ Pellets W,4527,7,13,9,14,47,50,-3,48
St. Pölten,4527,8,9,8,19,49,69,-20,35
Mattersburg,4527,9,8,9,19,40,59,-19,33
SV Josko Rie,4527,10,9,4,23,31,59,-28,31
FC Salzburg,4528,1,22,5,9,66,31,35,71
Vienna,4528,2,20,6,10,61,51,10,66
SK Sturm Gra,4528,3,16,12,8,57,30,27,60
SC Rheindorf,4528,4,14,14,8,51,43,8,56
RZ Pellets W,4528,5,13,9,14,48,54,-6,48
Mattersburg,4528,6,12,7,17,47,54,-7,43
Rapid Vienna,4528,7,10,12,14,51,52,-1,42
Admira Wacke,4528,8,11,6,19,40,64,-24,39
St. Pölten,4528,9,8,12,16,40,59,-19,36
SV Josko Rie,4528,10,9,7,20,33,56,-23,34
FC Salzburg,4529,1,20,10,6,65,28,37,70
SC Rheindorf,4529,2,20,8,8,57,40,17,68
SK Sturm Gra,4529,3,18,7,11,60,36,24,61
Vienna,4529,4,17,6,13,67,57,10,57
Rapid Vienna,4529,5,14,10,12,51,40,11,52
SV Josko Rie,4529,6,12,8,16,42,54,-12,44
RZ Pellets W,4529,7,11,10,15,45,51,-6,43
Mattersburg,4529,8,10,6,20,33,54,-21,36
St. Pölten,4529,9,9,9,18,35,59,-24,36
Admira Wacke,4529,10,10,4,22,30,66,-36,34
SC Rheindorf,4530,1,20,9,7,57,40,17,69
FC Salzburg,4530,2,20,7,9,71,34,37,67
Vienna,4530,3,21,4,11,65,48,17,67
SK Sturm Gra,4530,4,18,7,11,53,33,20,61
Rapid Vienna,4530,5,13,11,12,52,38,14,50
SV Josko Rie,4530,6,13,8,15,42,54,-12,47
RZ Pellets W,4530,7,12,6,18,46,61,-15,42
Admira Wacke,4530,8,10,8,18,38,62,-24,38
St. Pölten,4530,9,8,8,20,39,68,-29,32
Mattersburg,4530,10,6,10,20,35,60,-25,28
Vienna,4531,1,21,6,9,63,48,15,69
SK Sturm Gra,4531,2,20,7,9,59,30,29,67
FC Salzburg,4531,3,19,7,10,61,31,30,64
SC Rheindorf,4531,4,16,6,14,49,48,1,54
Rapid Vienna,4531,5,13,10,13,53,46,7,49
St. Pölten,4531,6,10,12,14,43,56,-13,42
RZ Pellets W,4531,7,10,11,15,41,51,-10,41
Admira Wacke,4531,8,11,7,18,36,58,-22,40
SV Josko Rie,4531,9,11,6,19,36,56,-20,39
Mattersburg,4531,10,9,8,19,35,52,-17,35
FC Salzburg,4532,1,22,8,6,68,31,37,74
SC Rheindorf,4532,2,20,7,9,58,46,12,67
Vienna,4532,3,20,4,12,66,50,16,64
SK Sturm Gra,4532,4,17,10,9,62,40,22,61
Rapid Vienna,4532,5,15,9,12,64,45,19,54
Admira Wacke,4532,6,12,6,18,35,56,-21,42
SV Josko Rie,4532,7,11,8,17,38,55,-17,41
RZ Pellets W,4532,8,11,5,20,46,63,-17,38
St. Pölten,4532,9,9,8,19,43,65,-22,35
Mattersburg,4532,10,6,9,21,32,61,-29,27
FC Salzburg,4533,1,22,5,9,66,34,32,71
SC Rheindorf,4533,2,19,7,10,55,44,11,64
SK Sturm Gra,4533,3,19,5,12,55,32,23,62
Vienna,4533,4,19,4,13,66,57,9,61
Rapid Vienna,4533,5,14,11,11,59,38,21,53
St. Pölten,4533,6,13,11,12,54,57,-3,50
RZ Pellets W,4533,7,13,8,15,44,51,-7,47
SV Josko Rie,4533,8,12,2,22,41,64,-23,38
Admira Wacke,4533,9,9,6,21,33,67,-34,33
Mattersburg,4533,10,6,9,21,37,66,-29,27
SK Sturm Gra,4534,1,23,4,9,59,32,27,73
FC Salzburg,4534,2,19,7,10,63,35,28,64
SC Rheindorf,4534,3,20,4,12,63,42,21,64
Vienna,4534,4,18,4,14,57,54,3,58
Rapid Vienna,4534,5,14,9,13,57,41,16,51
RZ Pellets W,4534,6,14,6,16,42,47,-5,48
Admira Wacke,4534,7,12,6,18,30,54,-24,42
SV Josko Rie,4534,8,12,4,20,37,57,-20,40
Mattersburg,4534,9,9,9,18,36,61,-25,36
St. Pölten,4534,10,8,9,19,45,66,-21,33
FC Salzburg,4535,1,22,7,7,67,27,40,73
SC Rheindorf,4535,2,19,7,10,59,44,15,64
Vienna,4535,3,19,6,11,66,54,12,63
SK Sturm Gra,4535,4,18,8,10,64,37,27,62
Rapid Vienna,4535,5,15,11,10,55,35,20,56
SV Josko Rie,4535,6,12,8,16,37,51,-14,44
RZ Pellets W,4535,7,10,8,18,41,62,-21,38
Mattersburg,4535,8,7,13,16,31,52,-21,34
Admira Wacke,4535,9,8,8,20,34,64,-30,32
St. Pölten,4535,10,6,12,18,34,62,-28,30
FC Salzburg,4536,1,24,6,6,74,28,46,78
SK Sturm Gra,4536,2,22,5,9,64,32,32,71
Vienna,4536,3,20,3,13,62,47,15,63
SC Rheindorf,4536,4,18,7,11,54,51,3,61
Rapid Vienna,4536,5,14,9,13,58,43,15,51
RZ Pellets W,4536,6,14,9,13,51,51,0,51
Admira Wacke,4536,7,12,6,18,36,57,-21,42
SV Josko Rie,4536,8,10,5,21,34,62,-28,35
Mattersburg,4536,9,7,7,22,36,66,-30,28
St. Pölten,4536,10,7,7,22,38,70,-32,28
FC Salzburg,4537,1,23,8,5,74,26,48,77
SC Rheindorf,4537,2,22,6,8,61,38,23,72
SK Sturm Gra,4537,3,15,13,8,54,33,21,58
Vienna,4537,4,17,7,12,67,53,14,58
Rapid Vienna,4537,5,11,14,11,55,52,3,47
RZ Pellets W,4537,6,12,8,16,46,59,-13,44
St. Pölten,4537,7,11,8,17,43,58,-15,41
Admira Wacke,4537,8,11,7,18,39,62,-23,40
Mattersburg,4537,9,7,9,20,36,61,-25,30
SV Josko Rie,4537,10,8,6,22,30,63,-33,30
SC Rheindorf,4538,1,22,7,7,63,42,21,73
FC Salzburg,4538,2,20,9,7,72,35,37,69
Vienna,4538,3,21,4,11,75,53,22,67
SK Sturm Gra,4538,4,18,6,12,56,35,21,60
Rapid Vienna,4538,5,13,11,12,59,44,15,50
RZ Pellets W,4538,6,12,7,17,48,64,-16,43
Admira Wacke,4538,7,12,5,19,37,61,-24,41
SV Josko Rie,4538,8,10,6,20,30,53,-23,36
St. Pölten,4538,9,8,9,19,44,65,-21,33
Mattersburg,4538,10,8,8,20,36,68,-32,32
FC Salzburg,4539,1,22,5,9,72,37,35,71
SC Rheindorf,4539,2,22,5,9,60,43,17,71
SK Sturm Gra,4539,3,19,6,11,58,37,21,63
Vienna,4539,4,20,3,13,65,51,14,63
Rapid Vienna,4539,5,15,10,11,57,43,14,55
RZ Pellets W,4539,6,13,7,16,45,50,-5,46
SV Josko Rie,4539,7,12,6,18,38,52,-14,42
Admira Wacke,4539,8,11,6,19,42,65,-23,39
Mattersburg,4539,9,8,8,20,38,59,-21,32
St. Pölten,4539,10,5,10,21,37,75,-38,25
SK Sturm Gra,4540,1,23,5,8,65,28,37,74
Vienna,4540,2,21,3,12,67,53,14,66
FC Salzburg,4540,3,19,7,10,65,37,28,64
SC Rheindorf,4540,4,18,7,11,54,47,7,61
Rapid Vienna,4540,5,16,10,10,62,40,22,58
SV Josko Rie,4540,6,12,6,18,38,55,-17,42
RZ Pellets W,4540,7,12,4,20,43,57,-14,40
Admira Wacke,4540,8,11,7,18,32,56,-24,40
Mattersburg,4540,9,8,7,21,36,59,-23,31
St. Pölten,4540,10,5,14,17,38,68,-30,29
SK Sturm Gra,4541,1,21,7,8,65,32,33,70
SC Rheindorf,4541,2,21,5,10,52,37,15,68
FC Salzburg,4541,3,20,5,11,63,37,26,65
Vienna,4541,4,17,7,12,62,52,10,58
SV Josko Rie,4541,5,12,9,15,36,46,-10,45
Rapid Vienna,4541,6,11,11,14,59,51,8,44
Mattersburg,4541,7,12,6,18,43,57,-14,42
Admira Wacke,4541,8,11,7,18,37,62,-25,40
RZ Pellets W,4541,9,11,6,19,43,62,-19,39
St. Pölten,4541,10,8,9,19,44,68,-24,33
FC Salzburg,4542,1,22,7,7,63,27,36,73
SK Sturm Gra,4542,2,19,5,12,56,32,24,62
SC Rheindorf,4542,3,19,5,12,57,48,9,62
Vienna,4542,4,16,7,13,59,51,8,55
Rapid Vienna,4542,5,13,12,11,57,43,14,51
RZ Pellets W,4542,6,13,10,13,47,51,-4,49
Admira Wacke,4542,7,12,6,18,38,63,-25,42
St. Pölten,4542,8,10,9,17,41,60,-19,39
SV Josko Rie,4542,9,11,5,20,30,53,-23,38
Mattersburg,4542,10,8,8,20,33,53,-20,32
SK Sturm Gra,4543,1,21,6,9,67,33,34,69
Vienna,4543,2,21,4,11,63,50,13,67
SC Rheindorf,4543,3,19,5,12,51,42,9,62
FC Salzburg,4543,4,15,9,12,62,44,18,54
SV Josko Rie,4543,5,14,6,16,40,50,-10,48
Admira Wacke,4543,6,14,6,16,41,57,-16,48
Rapid Vienna,4543,7,11,11,14,50,42,8,44
Mattersburg,4543,8,12,7,17,44,57,-13,43
RZ Pellets W,4543,9,11,7,18,47,59,-12,40
St. Pölten,4543,10,7,9,20,37,68,-31,30
FC Salzburg,4544,1,24,7,5,71,28,43,79
SK Sturm Gra,4544,2,23,7,6,76,34,42,76
SC Rheindorf,4544,3,18,9,9,57,44,13,63
Vienna,4544,4,19,5,12,62,53,9,62
Rapid Vienna,4544,5,15,11,10,64,41,23,56
RZ Pellets W,4544,6,14,5,17,55,61,-6,47
Mattersburg,4544,7,9,8,19,36,56,-20,35
St. Pölten,4544,8,8,7,21,41,74,-33,31
SV Josko Rie,4544,9,9,3,24,30,62,-32,30
Admira Wacke,4544,10,8,4,24,30,69,-39,28
SK Sturm Gra,4545,1,23,5,8,67,29,38,74
FC Salzburg,4545,2,20,10,6,69,31,38,70
SC Rheindorf,4545,3,17,9,10,59,49,10,60
Vienna,4545,4,15,6,15,56,59,-3,51
Rapid Vienna,4545,5,12,12,12,53,44,9,48
RZ Pellets W,4545,6,13,8,15,42,50,-8,47
SV Josko Rie,4545,7,13,4,19,41,58,-17,43
Admira Wacke,4545,8,12,4,20,35,58,-23,40
St. Pölten,4545,9,8,12,16,45,65,-20,36
Mattersburg,4545,10,8,8,20,33,57,-24,32
FC Salzburg,4546,1,20,9,7,65,30,35,69
SC Rheindorf,4546,2,20,7,9,48,42,6,67
SK Sturm Gra,4546,3,19,6,11,65,40,25,63
Rapid Vienna,4546,4,16,11,9,64,39,25,59
Vienna,4546,5,18,5,13,67,56,11,59
RZ Pellets W,4546,6,13,6,17,47,53,-6,45
SV Josko Rie,4546,7,12,4,20,40,54,-14,40
Admira Wacke,4546,8,10,6,20,34,63,-29,36
Mattersburg,4546,9,8,11,17,34,51,-17,35
St. Pölten,4546,10,7,9,20,32,68,-36,30
SC Rheindorf,4547,1,22,5,9,54,40,14,71
FC Salzburg,4547,2,19,10,7,65,31,34,67
Rapid Vienna,4547,3,17,10,9,59,41,18,61
Vienna,4547,4,18,4,14,60,55,5,58
SK Sturm Gra,4547,5,16,8,12,55,36,19,56
RZ Pellets W,4547,6,13,6,17,48,60,-12,45
SV Josko Rie,4547,7,11,5,20,35,51,-16,38
St. Pölten,4547,8,10,8,18,45,63,-18,38
Admira Wacke,4547,9,10,6,20,34,60,-26,36
Mattersburg,4547,10,9,8,19,40,58,-18,35
FC Salzburg,4548,1,21,6,9,79,41,38,69
SC Rheindorf,4548,2,19,5,12,58,48,10,62
Vienna,4548,3,16,11,9,61,52,9,59
SK Sturm Gra,4548,4,17,7,12,53,34,19,58
Rapid Vienna,4548,5,14,11,11,59,44,15,53
St. Pölten,4548,6,13,10,13,51,58,-7,49
Admira Wacke,4548,7,11,9,16,37,59,-22,42
RZ Pellets W,4548,8,9,11,16,42,58,-16,38
SV Josko Rie,4548,9,10,7,19,34,56,-22,37
Mattersburg,4548,10,8,7,21,37,61,-24,31
SC Rheindorf,4549,1,20,7,9,52,41,11,67
FC Salzburg,4549,2,20,6,10,69,35,34,66
SK Sturm Gra,4549,3,20,6,10,58,33,25,66
Rapid Vienna,4549,4,18,9,9,62,38,24,63
Vienna,4549,5,16,4,16,63,58,5,52
RZ Pellets W,4549,6,11,13,12,47,53,-6,46
Admira Wacke,4549,7,11,6,19,38,62,-24,39
SV Josko Rie,4549,8,10,7,19,35,57,-22,37
St. Pölten,4549,9,6,14,16,40,63,-23,32
Mattersburg,4549,10,7,10,19,37,61,-24,31
FC Salzburg,4550,1,22,8,6,67,26,41,74
Vienna,4550,2,20,7,9,61,47,14,67
SK Sturm Gra,4550,3,19,8,9,60,33,27,65
SC Rheindorf,4550,4,16,8,12,44,41,3,56
Admira Wacke,4550,5,12,8,16,40,58,-18,44
Rapid Vienna,4550,6,11,10,15,57,49,8,43
RZ Pellets W,4550,7,11,8,17,44,57,-13,41
St. Pölten,4550,8,9,13,14,42,57,-15,40
Mattersburg,4550,9,9,10,17,38,56,-18,37
SV Josko Rie,4550,10,6,10,20,34,63,-29,28
SC Rheindorf,4551,1,24,6,6,72,37,35,78
FC Salzburg,4551,2,20,8,8,63,33,30,68
SK Sturm Gra,4551,3,20,5,11,70,39,31,65
Vienna,4551,4,16,8,12,54,50,4,56
Rapid Vienna,4551,5,13,13,10,48,33,15,52
Admira Wacke,4551,6,14,6,16,40,55,-15,48
RZ Pellets W,4551,7,11,7,18,44,60,-16,40
SV Josko Rie,4551,8,9,8,19,35,53,-18,35
St. Pölten,4551,9,8,8,20,39,69,-30,32
Mattersburg,4551,10,6,9,21,29,65,-36,27
FC Salzburg,4552,1,24,6,6,72,26,46,78
SK Sturm Gra,4552,2,20,4,12,58,31,27,64
SC Rheindorf,4552,3,17,10,9,48,38,10,61
Rapid Vienna,4552,4,17,7,12,57,38,19,58
Vienna,4552,5,15,6,15,56,64,-8,51
RZ Pellets W,4552,6,13,8,15,48,56,-8,47
St. Pölten,4552,7,10,10,16,47,60,-13,40
Mattersburg,4552,8,10,9,17,44,58,-14,39
Admira Wacke,4552,9,9,7,20,31,64,-33,34
SV Josko Rie,4552,10,8,7,21,36,62,-26,31
SC Rheindorf,4553,1,21,10,5,61,34,27,73
SK Sturm Gra,4553,2,20,7,9,59,27,32,67
FC Salzburg,4553,3,19,8,9,59,32,27,65
Rapid Vienna,4553,4,15,8,13,55,38,17,53
Vienna,4553,5,15,8,13,52,53,-1,53
RZ Pellets W,4553,6,13,5,18,46,59,-13,44
SV Josko Rie,4553,7,11,6,19,40,54,-14,39
Admira Wacke,4553,8,10,9,17,35,60,-25,39
St. Pölten,4553,9,10,8,18,39,60,-21,38
Mattersburg,4553,10,8,7,21,33,62,-29,31
FC Salzburg,4554,1,23,8,5,73,27,46,77
SK Sturm Gra,4554,2,21,4,11,61,31,30,67
Vienna,4554,3,19,6,11,57,45,12,63
SC Rheindorf,4554,4,18,6,12,55,51,4,60
Rapid Vienna,4554,5,14,9,13,51,42,9,51
RZ Pellets W,4554,6,10,10,16,42,56,-14,40
SV Josko Rie,4554,7,11,5,20,35,53,-18,38
Admira Wacke,4554,8,10,7,19,32,60,-28,37
Mattersburg,4554,9,8,11,17,39,54,-15,35
St. Pölten,4554,10,9,8,19,39,65,-26,35
FC Salzburg,4555,1,21,6,9,65,37,28,69
SK Sturm Gra,4555,2,18,6,12,57,38,19,60
SC Rheindorf,4555,3,17,9,10,57,45,12,60
Vienna,4555,4,18,4,14,58,56,2,58
Rapid Vienna,4555,5,14,9,13,56,42,14,51
Admira Wacke,4555,6,13,8,15,44,56,-12,47
RZ Pellets W,4555,7,11,11,14,49,55,-6,44
Mattersburg,4555,8,10,11,15,43,54,-11,41
St. Pölten,4555,9,9,11,16,47,66,-19,38
SV Josko Rie,4555,10,9,5,22,36,63,-27,32
FC Salzburg,4556,1,22,8,6,71,32,39,74
SC Rheindorf,4556,2,21,7,8,55,45,10,70
SK Sturm Gra,4556,3,17,7,12,56,39,17,58
Rapid Vienna,4556,4,13,13,10,59,43,16,52
Vienna,4556,5,15,7,14,54,50,4,52
RZ Pellets W,4556,6,14,9,13,46,46,0,51
SV Josko Rie,4556,7,12,5,19,43,57,-14,41
Admira Wacke,4556,8,12,5,19,44,65,-21,41
St. Pölten,4556,9,8,9,19,40,61,-21,33
Mattersburg,4556,10,7,8,21,33,63,-30,29
SC Rheindorf,4557,1,20,9,7,58,39,19,69
FC Salzburg,4557,2,18,10,8,73,38,35,64
SK Sturm Gra,4557,3,19,7,10,62,38,24,64
Vienna,4557,4,18,6,12,66,56,10,60
Rapid Vienna,4557,5,14,11,11,49,36,13,53
RZ Pellets W,4557,6,11,8,17,41,57,-16,41
Admira Wacke,4557,7,12,5,19,42,65,-23,41
SV Josko Rie,4557,8,12,4,20,39,55,-16,40
St. Pölten,4557,9,9,9,18,40,61,-21,36
Mattersburg,4557,10,8,9,19,31,56,-25,33
FC Salzburg,4558,1,24,7,5,74,26,48,79
SC Rheindorf,4558,2,20,7,9,54,39,15,67
Vienna,4558,3,21,4,11,64,52,12,67
SK Sturm Gra,4558,4,18,5,13,52,41,11,59
Rapid Vienna,4558,5,12,11,13,57,45,12,47
Admira Wacke,4558,6,13,6,17,41,60,-19,45
Mattersburg,4558,7,10,8,18,43,54,-11,38
RZ Pellets W,4558,8,10,7,19,48,67,-19,37
St. Pölten,4558,9,8,11,17,41,64,-23,35
SV Josko Rie,4558,10,9,4,23,35,61,-26,31
FC Salzburg,4559,1,21,7,8,64,27,37,70
SK Sturm Gra,4559,2,19,8,9,59,33,26,65
SC Rheindorf,4559,3,17,10,9,51,41,10,61
Vienna,4559,4,18,6,12,61,52,9,60
Rapid Vienna,4559,5,16,8,12,62,39,23,56
RZ Pellets W,4559,6,11,10,15,44,57,-13,43
SV Josko Rie,4559,7,13,4,19,39,56,-17,43
Admira Wacke,4559,8,12,6,18,39,62,-23,42
St. Pölten,4559,9,6,12,18,41,67,-26,30
Mattersburg,4559,10,7,9,20,33,59,-26,30
FC Salzburg,4560,1,20,10,6,59,25,34,70
SC Rheindorf,4560,2,21,7,8,65,42,23,70
SK Sturm Gra,4560,3,18,7,11,62,39,23,61
Vienna,4560,4,18,5,13,59,51,8,59
Rapid Vienna,4560,5,16,9,11,56,35,21,57
RZ Pellets W,4560,6,11,9,16,48,57,-9,42
SV Josko Rie,4560,7,11,5,20,30,50,-20,38
Admira Wacke,4560,8,11,5,20,36,63,-27,38
St. Pölten,4560,9,9,7,20,40,64,-24,34
Mattersburg,4560,10,8,10,18,30,59,-29,34
SK Sturm Gra,4561,1,20,7,9,62,33,29,67
SC Rheindorf,4561,2,20,7,9,53,42,11,67
FC Salzburg,4561,3,19,8,9,60,30,30,65
Vienna,4561,4,19,5,12,66,51,15,62
Rapid Vienna,4561,5,13,12,11,61,53,8,51
RZ Pellets W,4561,6,11,10,15,51,62,-11,43
Admira Wacke,4561,7,12,7,17,37,50,-13,43
St. Pölten,4561,8,10,7,19,50,74,-24,37
Mattersburg,4561,9,9,8,19,44,62,-18,35
SV Josko Rie,4561,10,8,7,21,25,52,-27,31
FC Salzburg,4562,1,22,7,7,69,30,39,73
SK Sturm Gra,4562,2,22,6,8,65,30,35,72
SC Rheindorf,4562,3,18,11,7,58,42,16,65
Rapid Vienna,4562,4,16,10,10,59,39,20,58
Vienna,4562,5,15,7,14,59,55,4,52
RZ Pellets W,4562,6,13,6,17,44,57,-13,45
Admira Wacke,4562,7,11,5,20,42,69,-27,38
SV Josko Rie,4562,8,10,5,21,35,56,-21,35
St. Pölten,4562,9,8,10,18,42,67,-25,34
Mattersburg,4562,10,7,9,20,37,65,-28,30
FC Salzburg,4563,1,22,8,6,66,24,42,74
SC Rheindorf,4563,2,21,4,11,57,48,9,67
SK Sturm Gra,4563,3,20,6,10,57,31,26,66
Vienna,4563,4,20,5,11,65,46,19,65
Rapid Vienna,4563,5,15,10,11,55,34,21,55
RZ Pellets W,4563,6,11,8,17,47,58,-11,41
Admira Wacke,4563,7,10,7,19,31,58,-27,37
St. Pölten,4563,8,9,9,18,41,64,-23,36
Mattersburg,4563,9,9,8,19,37,59,-22,35
SV Josko Rie,4563,10,9,3,24,31,65,-34,30
FC Salzburg,4564,1,22,7,7,65,28,37,73
SC Rheindorf,4564,2,22,5,9,56,40,16,71
SK Sturm Gra,4564,3,20,5,11,53,34,19,65
Rapid Vienna,4564,4,16,8,12,56,37,19,56
Vienna,4564,5,14,5,17,53,61,-8,47
Admira Wacke,4564,6,13,6,17,39,54,-15,45
RZ Pellets W,4564,7,13,5,18,48,56,-8,44
SV Josko Rie,4564,8,13,5,18,33,48,-15,44
St. Pölten,4564,9,10,7,19,42,62,-20,37
Mattersburg,4564,10,7,7,22,35,60,-25,28
FC Salzburg,4565,1,23,6,7,66,26,40,75
SK Sturm Gra,4565,2,22,5,9,55,29,26,71
SC Rheindorf,4565,3,18,8,10,56,46,10,62
Vienna,4565,4,17,4,15,53,54,-1,55
RZ Pellets W,4565,5,16,6,14,50,51,-1,54
Rapid Vienna,4565,6,12,10,14,50,41,9,46
Admira Wacke,4565,7,11,7,18,41,59,-18,40
Mattersburg,4565,8,9,10,17,38,55,-17,37
SV Josko Rie,4565,9,9,7,20,34,56,-22,34
St. Pölten,4565,10,8,7,21,39,65,-26,31
FC Salzburg,4566,1,23,8,5,62,22,40,77
SC Rheindorf,4566,2,18,10,8,52,37,15,64
SK Sturm Gra,4566,3,17,10,9,53,33,20,61
Vienna,4566,4,18,5,13,55,47,8,59
Rapid Vienna,4566,5,16,8,12,53,39,14,56
Admira Wacke,4566,6,11,10,15,40,55,-15,43
RZ Pellets W,4566,7,12,6,18,42,55,-13,42
SV Josko Rie,4566,8,10,6,20,33,52,-19,36
St. Pölten,4566,9,6,12,18,37,62,-25,30
Mattersburg,4566,10,7,9,20,35,60,-25,30
FC Salzburg,4567,1,19,8,9,62,34,28,65
SK Sturm Gra,4567,2,19,6,11,61,37,24,63
SC Rheindorf,4567,3,17,10,9,54,44,10,61
Vienna,4567,4,17,6,13,65,54,11,57
Rapid Vienna,4567,5,14,12,10,62,41,21,54
RZ Pellets W,4567,6,12,9,15,46,53,-7,45
St. Pölten,4567,7,9,12,15,42,58,-16,39
SV Josko Rie,4567,8,11,6,19,34,53,-19,39
Admira Wacke,4567,9,11,6,19,41,68,-27,39
Mattersburg,4567,10,8,11,17,29,54,-25,35
FC Salzburg,4568,1,19,11,6,70,31,39,68
SC Rheindorf,4568,2,20,6,10,53,44,9,66
SK Sturm Gra,4568,3,19,5,12,58,37,21,62
Vienna,4568,4,18,4,14,57,56,1,58
Rapid Vienna,4568,5,15,9,12,52,38,14,54
St. Pölten,4568,6,12,7,17,51,59,-8,43
RZ Pellets W,4568,7,11,8,17,44,57,-13,41
Admira Wacke,4568,8,11,7,18,37,61,-24,40
Mattersburg,4568,9,10,8,18,40,59,-19,38
SV Josko Rie,4568,10,10,5,21,34,54,-20,35
SC Rheindorf,4569,1,21,10,5,52,30,22,73
SK Sturm Gra,4569,2,20,7,9,55,32,23,67
FC Salzburg,4569,3,18,12,6,66,39,27,66
Rapid Vienna,4569,4,16,11,9,57,33,24,59
Vienna,4569,5,17,8,11,68,55,13,59
Admira Wacke,4569,6,11,8,17,41,58,-17,41
RZ Pellets W,4569,7,11,7,18,41,58,-17,40
SV Josko Rie,4569,8,10,5,21,38,58,-20,35
Mattersburg,4569,9,6,10,20,34,58,-24,28
St. Pölten,4569,10,6,10,20,30,61,-31,28
SC Rheindorf,4570,1,20,9,7,55,37,18,69
FC Salzburg,4570,2,19,7,10,61,31,30,64
SK Sturm Gra,4570,3,15,9,12,52,37,15,54
Vienna,4570,4,15,7,14,58,64,-6,52
RZ Pellets W,4570,5,13,8,15,45,53,-8,47
Rapid Vienna,4570,6,10,15,11,50,46,4,45
Admira Wacke,4570,7,12,7,17,42,55,-13,43
SV Josko Rie,4570,8,12,7,17,38,51,-13,43
Mattersburg,4570,9,9,12,15,44,54,-10,39
St. Pölten,4570,10,9,11,16,45,62,-17,38
FC Salzburg,4571,1,21,7,8,69,33,36,70
SK Sturm Gra,4571,2,21,7,8,62,36,26,70
SC Rheindorf,4571,3,19,7,10,61,46,15,64
Rapid Vienna,4571,4,16,10,10,62,38,24,58
Vienna,4571,5,17,6,13,68,68,0,57
RZ Pellets W,4571,6,13,8,15,44,49,-5,47
Admira Wacke,4571,7,12,3,21,39,72,-33,39
SV Josko Rie,4571,8,10,7,19,34,57,-23,37
St. Pölten,4571,9,9,9,18,50,62,-12,36
Mattersburg,4571,10,6,8,22,27,55,-28,26
FC Salzburg,4572,1,21,8,7,71,29,42,71
SC Rheindorf,4572,2,19,8,9,56,43,13,65
SK Sturm Gra,4572,3,16,9,11,53,37,16,57
Rapid Vienna,4572,4,14,10,12,53,39,14,52
RZ Pellets W,4572,5,15,6,15,51,55,-4,51
Vienna,4572,6,14,6,16,59,61,-2,48
SV Josko Rie,4572,7,12,7,17,43,54,-11,43
Admira Wacke,4572,8,11,7,18,37,58,-21,40
Mattersburg,4572,9,11,7,18,34,57,-23,40
St. Pölten,4572,10,8,10,18,47,71,-24,34
FC Salzburg,4573,1,22,7,7,64,28,36,73
Vienna,4573,2,21,5,10,67,46,21,68
SC Rheindorf,4573,3,19,8,9,50,39,11,65
Rapid Vienna,4573,4,16,9,11,59,41,18,57
SK Sturm Gra,4573,5,16,3,17,50,42,8,51
Admira Wacke,4573,6,14,6,16,36,48,-12,48
RZ Pellets W,4573,7,10,10,16,36,51,-15,40
Mattersburg,4573,8,9,8,19,43,60,-17,35
St. Pölten,4573,9,8,11,17,42,64,-22,35
SV Josko Rie,4573,10,9,5,22,30,58,-28,32
FC Salzburg,4574,1,20,9,7,65,30,35,69
Vienna,4574,2,20,6,10,61,45,16,66
SK Sturm Gra,4574,3,18,10,8,65,39,26,64
SC Rheindorf,4574,4,17,10,9,47,38,9,61
Admira Wacke,4574,5,13,6,17,43,62,-19,45
Rapid Vienna,4574,6,10,14,12,55,46,9,44
SV Josko Rie,4574,7,11,8,17,43,51,-8,41
RZ Pellets W,4574,8,10,10,16,43,56,-13,40
Mattersburg,4574,9,8,9,19,36,63,-27,33
St. Pölten,4574,10,7,10,19,38,66,-28,31
SC Rheindorf,4575,1,25,5,6,60,30,30,80
Vienna,4575,2,19,5,12,63,51,12,62
FC Salzburg,4575,3,16,11,9,56,35,21,59
Rapid Vienna,4575,4,14,11,11,59,40,19,53
SK Sturm Gra,4575,5,16,5,15,49,43,6,53
SV Josko Rie,4575,6,13,4,19,38,55,-17,43
RZ Pellets W,4575,7,10,10,16,44,56,-12,40
Admira Wacke,4575,8,11,7,18,36,59,-23,40
St. Pölten,4575,9,8,12,16,42,60,-18,36
Mattersburg,4575,10,8,10,18,40,58,-18,34
FC Salzburg,4576,1,21,10,5,71,29,42,73
SK Sturm Gra,4576,2,23,4,9,62,36,26,73
SC Rheindorf,4576,3,19,7,10,55,40,15,64
Vienna,4576,4,18,5,13,57,48,9,59
RZ Pellets W,4576,5,13,7,16,48,55,-7,46
Rapid Vienna,4576,6,10,13,13,53,54,-1,43
Admira Wacke,4576,7,12,5,19,41,58,-17,41
St. Pölten,4576,8,9,10,17,45,65,-20,37
Mattersburg,4576,9,8,10,18,36,57,-21,34
SV Josko Rie,4576,10,9,5,22,31,57,-26,32
Vienna,4577,1,23,4,9,70,44,26,73
FC Salzburg,4577,2,19,9,8,58,28,30,66
SC Rheindorf,4577,3,16,12,8,56,43,13,60
SK Sturm Gra,4577,4,17,8,11,59,40,19,59
Rapid Vienna,4577,5,12,13,11,51,40,11,49
St. Pölten,4577,6,13,10,13,44,52,-8,49
Admira Wacke,4577,7,13,5,18,35,58,-23,44
RZ Pellets W,4577,8,10,10,16,42,55,-13,40
SV Josko Rie,4577,9,8,5,23,30,55,-25,29
Mattersburg,4577,10,6,10,20,33,63,-30,28
SK Sturm Gra,4578,1,21,8,7,58,29,29,71
FC Salzburg,4578,2,19,8,9,63,34,29,65
Vienna,4578,3,19,5,12,62,52,10,62
SC Rheindorf,4578,4,18,6,12,51,47,4,60
RZ Pellets W,4578,5,15,8,13,46,44,2,53
Rapid Vienna,4578,6,14,10,12,52,40,12,52
St. Pölten,4578,7,10,9,17,44,62,-18,39
Admira Wacke,4578,8,11,6,19,40,59,-19,39
SV Josko Rie,4578,9,9,5,22,30,57,-27,32
Mattersburg,4578,10,7,9,20,36,58,-22,30
FC Salzburg,4579,1,21,7,8,69,32,37,70
SC Rheindorf,4579,2,19,7,10,57,48,9,64
Vienna,4579,3,17,10,9,59,46,13,61
SK Sturm Gra,4579,4,17,9,10,61,37,24,60
Rapid Vienna,4579,5,13,14,9,55,42,13,53
Admira Wacke,4579,6,12,8,16,40,56,-16,44
RZ Pellets W,4579,7,12,8,16,40,59,-19,44
SV Josko Rie,4579,8,9,11,16,38,51,-13,38
St. Pölten,4579,9,6,13,17,41,62,-21,31
Mattersburg,4579,10,6,9,21,35,62,-27,27
FC Salzburg,4580,1,22,4,10,70,34,36,70
Vienna,4580,2,22,2,12,68,47,21,68
SC Rheindorf,4580,3,19,6,11,57,46,11,63
SK Sturm Gra,4580,4,18,6,12,57,39,18,60
Rapid Vienna,4580,5,16,9,11,64,39,25,57
RZ Pellets W,4580,6,14,6,16,46,59,-13,48
SV Josko Rie,4580,7,11,5,20,40,55,-15,38
Admira Wacke,4580,8,11,5,20,33,64,-31,38
St. Pölten,4580,9,7,13,16,38,57,-19,34
Mattersburg,4580,10,8,8,20,36,69,-33,32
FC Salzburg,4581,1,21,8,7,66,26,40,71
SK Sturm Gra,4581,2,21,8,7,62,28,34,71
SC Rheindorf,4581,3,18,7,11,55,49,6,61
Rapid Vienna,4581,4,14,13,9,58,38,20,55
Vienna,4581,5,15,7,14,59,56,3,52
SV Josko Rie,4581,6,11,7,18,38,54,-16,40
RZ Pellets W,4581,7,10,9,17,43,59,-16,39
Admira Wacke,4581,8,9,11,16,32,58,-26,38
Mattersburg,4581,9,8,12,16,40,57,-17,36
St. Pölten,4581,10,7,10,19,41,69,-28,31
FC Salzburg,4582,1,21,8,7,63,29,34,71
Vienna,4582,2,21,3,12,69,53,16,66
SK Sturm Gra,4582,3,19,6,11,57,34,23,63
SC Rheindorf,4582,4,18,6,12,50,45,5,60
Rapid Vienna,4582,5,14,9,13,56,42,14,51
Mattersburg,4582,6,10,10,16,46,57,-11,40
Admira Wacke,4582,7,11,7,18,35,55,-20,40
St. Pölten,4582,8,10,10,16,40,62,-22,40
SV Josko Rie,4582,9,10,7,19,35,51,-16,37
RZ Pellets W,4582,10,10,6,20,40,63,-23,36
FC Salzburg,4583,1,22,8,6,75,34,41,74
SK Sturm Gra,4583,2,22,6,8,60,34,26,72
Vienna,4583,3,19,6,11,73,52,21,63
SC Rheindorf,4583,4,17,11,8,62,46,16,62
Rapid Vienna,4583,5,12,12,12,54,42,12,48
RZ Pellets W,4583,6,12,6,18,42,54,-12,42
St. Pölten,4583,7,8,12,16,44,66,-22,36
SV Josko Rie,4583,8,10,5,21,40,68,-28,35
Admira Wacke,4583,9,9,7,20,35,61,-26,34
Mattersburg,4583,10,8,9,19,36,64,-28,33
FC Salzburg,4584,1,24,7,5,70,28,42,79
SK Sturm Gra,4584,2,20,5,11,59,35,24,65
Vienna,4584,3,19,5,12,65,48,17,62
SC Rheindorf,4584,4,16,6,14,51,53,-2,54
Rapid Vienna,4584,5,14,11,11,57,42,15,53
SV Josko Rie,4584,6,14,5,17,44,55,-11,47
St. Pölten,4584,7,11,9,16,46,62,-16,42
RZ Pellets W,4584,8,10,9,17,46,69,-23,39
Mattersburg,4584,9,9,7,20,41,60,-19,34
Admira Wacke,4584,10,9,4,23,38,65,-27,31
FC Salzburg,4585,1,22,8,6,66,25,41,74
SK Sturm Gra,4585,2,19,9,8,65,37,28,66
SC Rheindorf,4585,3,19,7,10,60,46,14,64
Vienna,4585,4,18,5,13,67,54,13,59
Rapid Vienna,4585,5,12,16,8,52,38,14,52
Admira Wacke,4585,6,13,5,18,42,60,-18,44
RZ Pellets W,4585,7,11,8,17,40,56,-16,41
Mattersburg,4585,8,9,9,18,40,62,-22,36
St. Pölten,4585,9,8,11,17,37,66,-29,35
SV Josko Rie,4585,10,8,4,24,38,63,-25,28
SK Sturm Gra,4586,1,22,6,8,69,34,35,72
SC Rheindorf,4586,2,16,11,9,49,41,8,59
FC Salzburg,4586,3,17,6,13,57,43,14,57
Vienna,4586,4,16,9,11,64,55,9,57
Rapid Vienna,4586,5,15,11,10,59,41,18,56
RZ Pellets W,4586,6,14,7,15,48,50,-2,49
St. Pölten,4586,7,11,8,17,52,64,-12,41
SV Josko Rie,4586,8,10,9,17,32,52,-20,39
Admira Wacke,4586,9,10,7,19,38,60,-22,37
Mattersburg,4586,10,7,10,19,36,64,-28,31
Vienna,4587,1,21,4,11,65,53,12,67
SK Sturm Gra,4587,2,18,8,10,61,33,28,62
FC Salzburg,4587,3,18,8,10,63,38,25,62
SC Rheindorf,4587,4,17,11,8,50,41,9,62
RZ Pellets W,4587,5,16,7,13,51,50,1,55
Rapid Vienna,4587,6,11,13,12,49,39,10,46
SV Josko Rie,4587,7,13,3,20,35,50,-15,42
St. Pölten,4587,8,10,8,18,39,61,-22,38
Admira Wacke,4587,9,10,8,18,34,57,-23,38
Mattersburg,4587,10,6,10,20,31,56,-25,28
SK Sturm Gra,4588,1,23,6,7,61,29,32,75
FC Salzburg,4588,2,21,7,8,62,32,30,70
SC Rheindorf,4588,3,20,6,10,53,39,14,66
Vienna,4588,4,17,3,16,56,52,4,54
Rapid Vienna,4588,5,13,9,14,52,47,5,48
Admira Wacke,4588,6,12,7,17,33,53,-20,43
Mattersburg,4588,7,11,8,17,41,55,-14,41
RZ Pellets W,4588,8,10,7,19,45,59,-14,37
St. Pölten,4588,9,9,9,18,43,61,-18,36
SV Josko Rie,4588,10,9,8,19,35,54,-19,35
SC Rheindorf,4589,1,22,7,7,64,46,18,73
SK Sturm Gra,4589,2,20,5,11,64,40,24,65
FC Salzburg,4589,3,19,7,10,60,34,26,64
Vienna,4589,4,18,4,14,62,54,8,58
Rapid Vienna,4589,5,14,12,10,54,38,16,54
St. Pölten,4589,6,13,8,15,47,58,-11,47
Admira Wacke,4589,7,13,3,20,36,56,-20,42
SV Josko Rie,4589,8,11,8,17,36,49,-13,41
RZ Pellets W,4589,9,11,5,20,46,61,-15,38
Mattersburg,4589,10,5,9,22,32,65,-33,24
FC Salzburg,4590,1,21,8,7,60,31,29,71
SC Rheindorf,4590,2,21,8,7,58,34,24,71
SK Sturm Gra,4590,3,20,6,10,59,40,19,66
Rapid Vienna,4590,4,17,11,8,61,31,30,62
Vienna,4590,5,19,4,13,68,55,13,61
RZ Pellets W,4590,6,12,6,18,41,57,-16,42
Admira Wacke,4590,7,10,4,22,33,68,-35,34
SV Josko Rie,4590,8,9,6,21,33,52,-19,33
Mattersburg,4590,9,7,11,18,34,54,-20,32
St. Pölten,4590,10,7,10,19,37,62,-25,31
FC Salzburg,4591,1,22,7,7,66,29,37,73
SC Rheindorf,4591,2,20,8,8,57,39,18,68
SK Sturm Gra,4591,3,21,4,11,60,31,29,67
Vienna,4591,4,20,5,11,70,47,23,65
Rapid Vienna,4591,5,12,10,14,54,50,4,46
St. Pölten,4591,6,10,11,15,48,62,-14,41
Admira Wacke,4591,7,11,7,18,32,57,-25,40
SV Josko Rie,4591,8,11,4,21,33,52,-19,37
RZ Pellets W,4591,9,10,6,20,40,66,-26,36
Mattersburg,4591,10,7,10,19,38,65,-27,31
SC Rheindorf,4592,1,21,6,9,54,38,16,69
SK Sturm Gra,4592,2,19,8,9,59,33,26,65
FC Salzburg,4592,3,19,7,10,63,41,22,64
Vienna,4592,4,19,5,12,65,54,11,62
Rapid Vienna,4592,5,16,9,11,58,39,19,57
RZ Pellets W,4592,6,16,6,14,50,50,0,54
Admira Wacke,4592,7,11,6,19,35,58,-23,39
Mattersburg,4592,8,10,7,19,37,52,-15,37
SV Josko Rie,4592,9,10,4,22,38,57,-19,34
St. Pölten,4592,10,7,6,23,34,71,-37,27
FC Salzburg,4593,1,20,11,5,68,27,41,71
SK Sturm Gra,4593,2,22,5,9,67,30,37,71
SC Rheindorf,4593,3,20,6,10,60,44,16,66
Vienna,4593,4,17,5,14,56,55,1,56
Rapid Vienna,4593,5,14,11,11,55,44,11,53
Admira Wacke,4593,6,12,6,18,43,64,-21,42
SV Josko Rie,4593,7,11,6,19,38,50,-12,39
RZ Pellets W,4593,8,10,7,19,39,59,-20,37
Mattersburg,4593,9,9,7,20,32,60,-28,34
St. Pölten,4593,10,7,12,17,41,66,-25,33
SC Rheindorf,4594,1,19,7,10,53,36,17,64
SK Sturm Gra,4594,2,18,9,9,54,31,23,63
FC Salzburg,4594,3,17,10,9,59,36,23,61
Vienna,4594,4,18,5,13,68,56,12,59
St. Pölten,4594,5,13,8,15,45,60,-15,47
Mattersburg,4594,6,12,8,16,45,54,-9,44
Admira Wacke,4594,7,13,4,19,36,61,-25,43
RZ Pellets W,4594,8,11,9,16,46,56,-10,42
Rapid Vienna,4594,9,10,10,16,51,51,0,40
SV Josko Rie,4594,10,11,6,19,37,53,-16,39
SC Rheindorf,4595,1,24,4,8,65,35,30,76
FC Salzburg,4595,2,21,7,8,61,27,34,70
SK Sturm Gra,4595,3,18,6,12,60,36,24,60
Rapid Vienna,4595,4,15,11,10,57,42,15,56
Vienna,4595,5,17,5,14,55,49,6,56
Admira Wacke,4595,6,13,6,17,38,55,-17,45
RZ Pellets W,4595,7,12,8,16,44,54,-10,44
SV Josko Rie,4595,8,13,3,20,36,58,-22,42
Mattersburg,4595,9,8,10,18,37,59,-22,34
St. Pölten,4595,10,5,8,23,31,69,-38,23
FC Salzburg,4596,1,22,8,6,68,30,38,74
SC Rheindorf,4596,2,22,6,8,57,40,17,72
Rapid Vienna,4596,3,17,10,9,68,38,30,61
SK Sturm Gra,4596,4,18,7,11,55,34,21,61
Vienna,4596,5,16,8,12,64,57,7,56
Admira Wacke,4596,6,12,9,15,38,50,-12,45
St. Pölten,4596,7,10,8,18,42,66,-24,38
SV Josko Rie,4596,8,11,3,22,34,54,-20,36
RZ Pellets W,4596,9,9,8,19,40,66,-26,35
Mattersburg,4596,10,5,9,22,33,64,-31,24
SC Rheindorf,4597,1,23,8,5,61,27,34,77
Vienna,4597,2,20,6,10,65,50,15,66
FC Salzburg,4597,3,17,10,9,55,33,22,61
SK Sturm Gra,4597,4,17,9,10,57,31,26,60
Admira Wacke,4597,5,14,5,17,44,62,-18,47
Rapid Vienna,4597,6,11,13,12,51,39,12,46
RZ Pellets W,4597,7,11,11,14,43,53,-10,44
SV Josko Rie,4597,8,11,3,22,34,57,-23,36
St. Pölten,4597,9,6,13,17,38,68,-30,31
Mattersburg,4597,10,6,10,20,33,61,-28,28
FC Salzburg,4598,1,25,5,6,67,29,38,80
SC Rheindorf,4598,2,22,4,10,61,42,19,70
SK Sturm Gra,4598,3,19,7,10,64,34,30,64
Vienna,4598,4,16,7,13,63,62,1,55
Rapid Vienna,4598,5,14,10,12,57,41,16,52
Admira Wacke,4598,6,13,7,16,39,57,-18,46
RZ Pellets W,4598,7,11,11,14,43,52,-9,44
SV Josko Rie,4598,8,10,5,21,42,61,-19,35
Mattersburg,4598,9,8,6,22,36,65,-29,30
St. Pölten,4598,10,6,10,20,34,63,-29,28
FC Salzburg,4599,1,23,7,6,73,33,40,76
Vienna,4599,2,19,4,13,65,55,10,61
SC Rheindorf,4599,3,17,8,11,54,44,10,59
SK Sturm Gra,4599,4,17,6,13,63,38,25,57
RZ Pellets W,4599,5,15,8,13,46,46,0,53
Rapid Vienna,4599,6,13,10,13,55,46,9,49
Admira Wacke,4599,7,11,6,19,39,67,-28,39
St. Pölten,4599,8,9,11,16,40,65,-25,38
Mattersburg,4599,9,9,9,18,42,59,-17,36
SV Josko Rie,4599,10,8,9,19,31,55,-24,33
FC Salzburg,4600,1,22,7,7,71,30,41,73
SC Rheindorf,4600,2,22,6,8,55,39,16,72
SK Sturm Gra,4600,3,20,5,11,62,34,28,65
Vienna,4600,4,16,8,12,59,56,3,56
Rapid Vienna,4600,5,14,12,10,55,42,13,54
RZ Pellets W,4600,6,13,6,17,48,58,-10,45
Admira Wacke,4600,7,11,7,18,35,57,-22,40
SV Josko Rie,4600,8,10,6,20,33,56,-23,36
St. Pölten,4600,9,8,9,19,40,63,-23,33
Mattersburg,4600,10,8,6,22,32,55,-23,30
SK Sturm Gra,4601,1,22,6,8,63,30,33,72
FC Salzburg,4601,2,20,6,10,67,34,33,66
SC Rheindorf,4601,3,19,9,8,63,42,21,66
Vienna,4601,4,18,4,14,65,65,0,58
Rapid Vienna,4601,5,13,10,13,50,38,12,49
RZ Pellets W,4601,6,12,7,17,43,55,-12,43
Mattersburg,4601,7,11,9,16,42,58,-16,42
Admira Wacke,4601,8,12,5,19,32,56,-24,41
SV Josko Rie,4601,9,9,7,20,41,64,-23,34
St. Pölten,4601,10,9,7,20,40,64,-24,34
SK Sturm Gra,4602,1,22,5,9,62,33,29,71
FC Salzburg,4602,2,20,8,8,67,30,37,68
SC Rheindorf,4602,3,18,8,10,48,44,4,62
Vienna,4602,4,17,5,14,58,49,9,56
RZ Pellets W,4602,5,14,5,17,48,52,-4,47
Rapid Vienna,4602,6,12,9,15,55,47,8,45
Mattersburg,4602,7,12,7,17,40,53,-13,43
St. Pölten,4602,8,11,7,18,40,61,-21,40
SV Josko Rie,4602,9,11,6,19,31,53,-22,39
Admira Wacke,4602,10,10,6,20,33,60,-27,36
FC Salzburg,4603,1,21,6,9,66,34,32,69
Vienna,4603,2,20,6,10,66,50,16,66
SK Sturm Gra,4603,3,19,7,10,63,39,24,64
SC Rheindorf,4603,4,19,6,11,53,43,10,63
Rapid Vienna,4603,5,14,9,13,54,42,12,51
SV Josko Rie,4603,6,12,7,17,39,52,-13,43
Admira Wacke,4603,7,12,5,19,39,63,-24,41
RZ Pellets W,4603,8,11,7,18,41,56,-15,40
Mattersburg,4603,9,9,9,18,36,53,-17,36
St. Pölten,4603,10,8,8,20,36,61,-25,32
Vienna,4604,1,23,4,9,65,45,20,73
FC Salzburg,4604,2,19,8,9,63,29,34,65
SC Rheindorf,4604,3,17,9,10,47,44,3,60
SK Sturm Gra,4604,4,17,8,11,53,32,21,59
Rapid Vienna,4604,5,15,12,9,65,42,23,57
RZ Pellets W,4604,6,12,8,16,43,56,-13,44
Admira Wacke,4604,7,12,6,18,36,58,-22,42
SV Josko Rie,4604,8,10,5,21,32,58,-26,35
St. Pölten,4604,9,7,12,17,46,66,-20,33
Mattersburg,4604,10,7,10,19,36,56,-20,31
FC Salzburg,4605,1,25,5,6,73,28,45,80
SK Sturm Gra,4605,2,22,6,8,64,30,34,72
SC Rheindorf,4605,3,17,8,11,51,43,8,59
Rapid Vienna,4605,4,16,10,10,59,39,20,58
Vienna,4605,5,14,7,15,51,57,-6,49
SV Josko Rie,4605,6,13,5,18,35,50,-15,44
RZ Pellets W,4605,7,12,7,17,43,53,-10,43
Admira Wacke,4605,8,10,7,19,31,57,-26,37
St. Pölten,4605,9,8,11,17,45,63,-18,35
Mattersburg,4605,10,6,8,22,31,63,-32,26
FC Salzburg,4606,1,24,6,6,70,28,42,78
SK Sturm Gra,4606,2,22,6,8,66,29,37,72
Vienna,4606,3,21,4,11,67,55,12,67
SC Rheindorf,4606,4,18,8,10,56,51,5,62
RZ Pellets W,4606,5,14,4,18,48,62,-14,46
Rapid Vienna,4606,6,12,9,15,57,45,12,45
Admira Wacke,4606,7,10,7,19,36,59,-23,37
St. Pölten,4606,8,8,11,17,48,69,-21,35
Mattersburg,4606,9,9,6,21,36,55,-19,33
SV Josko Rie,4606,10,9,5,22,35,66,-31,32
FC Salzburg,4607,1,24,7,5,73,26,47,79
SK Sturm Gra,4607,2,20,7,9,61,36,25,67
SC Rheindorf,4607,3,19,8,9,59,40,19,65
Vienna,4607,4,18,5,13,62,55,7,59
Rapid Vienna,4607,5,11,10,15,51,47,4,43
SV Josko Rie,4607,6,13,2,21,35,53,-18,41
Admira Wacke,4607,7,12,5,19,33,57,-24,41
RZ Pellets W,4607,8,10,8,18,41,60,-19,38
St. Pölten,4607,9,9,11,16,42,62,-20,38
Mattersburg,4607,10,9,7,20,37,58,-21,34
FC Salzburg,4608,1,21,7,8,68,32,36,70
SC Rheindorf,4608,2,19,9,8,52,34,18,66
Rapid Vienna,4608,3,15,12,9,57,36,21,57
Vienna,4608,4,16,8,12,58,55,3,56
SK Sturm Gra,4608,5,15,10,11,53,35,18,55
RZ Pellets W,4608,6,12,9,15,46,56,-10,45
St. Pölten,4608,7,11,11,14,45,57,-12,44
Admira Wacke,4608,8,12,6,18,38,59,-21,42
SV Josko Rie,4608,9,11,6,19,34,47,-13,39
Mattersburg,4608,10,5,8,23,31,71,-40,23
FC Salzburg,4609,1,23,7,6,68,24,44,76
SK Sturm Gra,4609,2,22,7,7,69,29,40,73
SC Rheindorf,4609,3,19,8,9,59,44,15,65
Vienna,4609,4,16,6,14,62,62,0,54
Rapid Vienna,4609,5,12,14,10,57,40,17,50
RZ Pellets W,4609,6,14,8,14,49,56,-7,50
St. Pölten,4609,7,10,8,18,47,69,-22,38
Mattersburg,4609,8,8,8,20,34,60,-26,32
SV Josko Rie,4609,9,9,5,22,35,63,-28,32
Admira Wacke,4609,10,9,5,22,28,61,-33,32
FC Salzburg,4610,1,23,4,9,65,32,33,73
SK Sturm Gra,4610,2,22,6,8,59,25,34,72
SC Rheindorf,4610,3,17,9,10,51,42,9,60
RZ Pellets W,4610,4,15,8,13,48,50,-2,53
Rapid Vienna,4610,5,13,10,13,57,46,11,49
Vienna,4610,6,14,6,16,53,60,-7,48
SV Josko Rie,4610,7,14,4,18,38,50,-12,46
Admira Wacke,4610,8,12,3,21,35,59,-24,39
St. Pölten,4610,9,9,10,17,44,63,-19,37
Mattersburg,4610,10,5,12,19,28,51,-23,27
FC Salzburg,4611,1,21,6,9,64,38,26,69
SC Rheindorf,4611,2,19,8,9,46,33,13,65
SK Sturm Gra,4611,3,19,6,11,61,35,26,63
Rapid Vienna,4611,4,17,9,10,60,43,17,60
Vienna,4611,5,16,6,14,67,56,11,54
Admira Wacke,4611,6,13,7,16,51,65,-14,46
RZ Pellets W,4611,7,12,7,17,48,63,-15,43
St. Pölten,4611,8,9,11,16,44,61,-17,38
SV Josko Rie,4611,9,10,5,21,35,59,-24,35
Mattersburg,4611,10,7,9,20,36,59,-23,30
FC Salzburg,4612,1,22,8,6,65,28,37,74
Vienna,4612,2,20,7,9,64,43,21,67
SC Rheindorf,4612,3,19,8,9,52,37,15,65
SK Sturm Gra,4612,4,16,9,11,52,37,15,57
RZ Pellets W,4612,5,15,6,15,46,50,-4,51
Rapid Vienna,4612,6,11,12,13,45,38,7,45
St. Pölten,4612,7,10,10,16,46,65,-19,40
SV Josko Rie,4612,8,9,9,18,36,53,-17,36
Admira Wacke,4612,9,9,6,21,30,64,-34,33
Mattersburg,4612,10,7,9,20,33,54,-21,30
FC Salzburg,4613,1,23,6,7,66,31,35,75
SC Rheindorf,4613,2,21,5,10,58,43,15,68
SK Sturm Gra,4613,3,18,7,11,58,36,22,61
Rapid Vienna,4613,4,14,12,10,58,45,13,54
Vienna,4613,5,16,5,15,61,61,0,53
RZ Pellets W,4613,6,13,9,14,46,54,-8,48
Admira Wacke,4613,7,12,6,18,43,59,-16,42
St. Pölten,4613,8,10,10,16,47,60,-13,40
SV Josko Rie,4613,9,10,4,22,34,59,-25,34
Mattersburg,4613,10,7,8,21,35,58,-23,29
SC Rheindorf,4614,1,21,6,9,52,34,18,69
FC Salzburg,4614,2,19,10,7,65,31,34,67
Vienna,4614,3,20,6,10,66,50,16,66
Rapid Vienna,4614,4,14,13,9,61,46,15,55
SK Sturm Gra,4614,5,16,7,13,52,38,14,55
Mattersburg,4614,6,12,7,17,42,52,-10,43
Admira Wacke,4614,7,11,8,17,37,56,-19,41
RZ Pellets W,4614,8,10,8,18,46,63,-17,38
SV Josko Rie,4614,9,9,7,20,31,56,-25,34
St. Pölten,4614,10,6,12,18,38,64,-26,30
FC Salzburg,4615,1,22,5,9,62,26,36,71
SC Rheindorf,4615,2,21,6,9,67,50,17,69
Vienna,4615,3,20,4,12,66,52,14,64
SK Sturm Gra,4615,4,19,6,11,55,30,25,63
Rapid Vienna,4615,5,15,10,11,52,36,16,55
RZ Pellets W,4615,6,13,6,17,49,56,-7,45
SV Josko Rie,4615,7,12,7,17,35,47,-12,43
Admira Wacke,4615,8,11,5,20,39,67,-28,38
St. Pölten,4615,9,9,9,18,39,63,-24,36
Mattersburg,4615,10,6,6,24,32,69,-37,24
FC Salzburg,4616,1,19,7,10,62,34,28,64
Vienna,4616,2,18,8,10,56,47,9,62
SC Rheindorf,4616,3,17,10,9,58,45,13,61
SK Sturm Gra,4616,4,16,9,11,51,33,18,57
Rapid Vienna,4616,5,14,14,8,59,38,21,56
RZ Pellets W,4616,6,12,9,15,39,51,-12,45
St. Pölten,4616,7,10,8,18,46,62,-16,38
SV Josko Rie,4616,8,11,5,20,38,56,-18,38
Mattersburg,4616,9,10,8,18,38,58,-20,38
Admira Wacke,4616,10,9,10,17,31,54,-23,37
SC Rheindorf,4617,1,20,10,6,55,37,18,70
FC Salzburg,4617,2,20,8,8,62,35,27,68
SK Sturm Gra,4617,3,18,10,8,61,37,24,64
Vienna,4617,4,17,7,12,63,51,12,58
Rapid Vienna,4617,5,12,13,11,53,46,7,49
RZ Pellets W,4617,6,14,6,16,45,49,-4,48
SV Josko Rie,4617,7,10,9,17,33,46,-13,39
Admira Wacke,4617,8,10,7,19,34,59,-25,37
St. Pölten,4617,9,8,9,19,36,58,-22,33
Mattersburg,4617,10,6,11,19,32,56,-24,29
FC Salzburg,4618,1,22,6,8,70,30,40,72
SK Sturm Gra,4618,2,21,7,8,62,29,33,70
SC Rheindorf,4618,3,17,12,7,47,42,5,63
Vienna,4618,4,20,2,14,65,52,13,62
Rapid Vienna,4618,5,13,9,14,54,44,10,48
RZ Pellets W,4618,6,12,7,17,52,59,-7,43
SV Josko Rie,4618,7,11,6,19,33,54,-21,39
Admira Wacke,4618,8,11,5,20,36,61,-25,38
Mattersburg,4618,9,8,11,17,39,57,-18,35
St. Pölten,4618,10,8,9,19,39,69,-30,33
SC Rheindorf,4619,1,21,7,8,61,43,18,70
SK Sturm Gra,4619,2,20,5,11,55,34,21,65
FC Salzburg,4619,3,19,7,10,67,31,36,64
Rapid Vienna,4619,4,16,8,12,55,37,18,56
Vienna,4619,5,17,5,14,64,55,9,56
RZ Pellets W,4619,6,14,6,16,50,55,-5,48
SV Josko Rie,4619,7,13,3,20,41,56,-15,42
St. Pölten,4619,8,11,6,19,42,63,-21,39
Admira Wacke,4619,9,10,8,18,36,66,-30,38
Mattersburg,4619,10,8,7,21,35,66,-31,31
FC Salzburg,4620,1,21,9,6,77,33,44,72
Vienna,4620,2,22,5,9,74,45,29,71
SC Rheindorf,4620,3,20,8,8,63,40,23,68
SK Sturm Gra,4620,4,18,4,14,61,38,23,58
Rapid Vienna,4620,5,16,9,11,52,43,9,57
RZ Pellets W,4620,6,14,7,15,50,60,-10,49
Admira Wacke,4620,7,11,3,22,36,65,-29,36
SV Josko Rie,4620,8,10,5,21,36,64,-28,35
St. Pölten,4620,9,8,7,21,39,68,-29,31
Mattersburg,4620,10,8,7,21,35,67,-32,31
FC Salzburg,4621,1,25,6,5,78,26,52,81
SC Rheindorf,4621,2,22,4,10,55,40,15,70
Vienna,4621,3,18,5,13,63,55,8,59
SK Sturm Gra,4621,4,16,8,12,51,35,16,56
RZ Pellets W,4621,5,15,5,16,53,55,-2,50
Rapid Vienna,4621,6,12,10,14,49,46,3,46
Admira Wacke,4621,7,11,9,16,36,54,-18,42
Mattersburg,4621,8,10,10,16,44,55,-11,40
St. Pölten,4621,9,6,12,18,38,68,-30,30
SV Josko Rie,4621,10,7,7,22,25,58,-33,28
SC Rheindorf,4622,1,20,10,6,63,36,27,70
Vienna,4622,2,20,6,10,60,46,14,66
SK Sturm Gra,4622,3,18,9,9,60,36,24,63
Rapid Vienna,4622,4,17,10,9,66,44,22,61
FC Salzburg,4622,5,17,9,10,61,36,25,60
RZ Pellets W,4622,6,13,7,16,57,65,-8,46
St. Pölten,4622,7,10,10,16,47,62,-15,40
SV Josko Rie,4622,8,10,7,19,40,57,-17,37
Admira Wacke,4622,9,9,6,21,35,70,-35,33
Mattersburg,4622,10,5,8,23,31,68,-37,23
SK Sturm Gra,4623,1,21,6,9,62,37,25,69
Vienna,4623,2,20,5,11,69,46,23,65
FC Salzburg,4623,3,19,7,10,59,33,26,64
SC Rheindorf,4623,4,18,8,10,51,39,12,62
Rapid Vienna,4623,5,15,11,10,52,36,16,56
RZ Pellets W,4623,6,11,10,15,44,54,-10,43
Admira Wacke,4623,7,12,7,17,38,53,-15,43
SV Josko Rie,4623,8,12,3,21,34,56,-22,39
Mattersburg,4623,9,8,9,19,33,53,-20,33
St. Pölten,4623,10,7,8,21,37,72,-35,29
SK Sturm Gra,4624,1,20,7,9,62,33,29,67
SC Rheindorf,4624,2,19,10,7,53,35,18,67
FC Salzburg,4624,3,18,10,8,62,32,30,64
Vienna,4624,4,18,7,11,63,51,12,61
Rapid Vienna,4624,5,13,9,14,54,47,7,48
SV Josko Rie,4624,6,12,7,17,40,53,-13,43
Admira Wacke,4624,7,10,9,17,35,56,-21,39
Mattersburg,4624,8,9,10,17,39,58,-19,37
St. Pölten,4624,9,9,10,17,46,67,-21,37
RZ Pellets W,4624,10,8,9,19,38,60,-22,33
FC Salzburg,4625,1,23,7,6,69,29,40,76
SC Rheindorf,4625,2,21,5,10,57,40,17,68
SK Sturm Gra,4625,3,21,4,11,56,34,22,67
Vienna,4625,4,18,5,13,56,49,7,59
Rapid Vienna,4625,5,14,9,13,55,41,14,51
RZ Pellets W,4625,6,13,5,18,45,57,-12,44
Admira Wacke,4625,7,12,6,18,38,61,-23,42
SV Josko Rie,4625,8,10,7,19,34,55,-21,37
Mattersburg,4625,9,9,9,18,35,53,-18,36
St. Pölten,4625,10,5,11,20,39,65,-26,26
FC Salzburg,4626,1,22,6,8,61,25,36,72
SC Rheindorf,4626,2,19,6,11,52,45,7,63
SK Sturm Gra,4626,3,18,7,11,53,38,15,61
Vienna,4626,4,18,6,12,62,52,10,60
Rapid Vienna,4626,5,15,9,12,61,43,18,54
RZ Pellets W,4626,6,15,7,14,53,57,-4,52
Admira Wacke,4626,7,11,9,16,36,55,-19,42
SV Josko Rie,4626,8,12,4,20,37,54,-17,40
Mattersburg,4626,9,10,6,20,41,59,-18,36
St. Pölten,4626,10,6,8,22,40,68,-28,26
FC Salzburg,4627,1,21,7,8,62,33,29,70
SK Sturm Gra,4627,2,17,11,8,57,35,22,62
SC Rheindorf,4627,3,18,7,11,58,44,14,61
Vienna,4627,4,16,8,12,63,53,10,56
Rapid Vienna,4627,5,14,9,13,49,39,10,51
SV Josko Rie,4627,6,11,9,16,34,46,-12,42
RZ Pellets W,4627,7,12,6,18,43,60,-17,42
Mattersburg,4627,8,11,8,17,41,52,-11,41
Admira Wacke,4627,9,11,7,18,36,56,-20,40
St. Pölten,4627,10,8,10,18,38,63,-25,34
FC Salzburg,4628,1,22,9,5,62,27,35,75
Vienna,4628,2,19,5,12,58,45,13,62
SK Sturm Gra,4628,3,18,6,12,53,36,17,60
SC Rheindorf,4628,4,17,6,13,49,45,4,57
RZ Pellets W,4628,5,14,6,16,44,53,-9,48
Admira Wacke,4628,6,13,7,16,40,50,-10,46
Rapid Vienna,4628,7,11,12,13,50,40,10,45
Mattersburg,4628,8,11,9,16,41,52,-11,42
St. Pölten,4628,9,10,7,19,39,62,-23,37
SV Josko Rie,4628,10,9,5,22,34,60,-26,32
FC Salzburg,4629,1,23,7,6,74,30,44,76
SK Sturm Gra,4629,2,22,4,10,61,33,28,70
SC Rheindorf,4629,3,18,8,10,51,39,12,62
Vienna,4629,4,18,7,11,59,47,12,61
Rapid Vienna,4629,5,12,9,15,52,50,2,45
RZ Pellets W,4629,6,12,9,15,45,51,-6,45
SV Josko Rie,4629,7,13,2,21,40,55,-15,41
Admira Wacke,4629,8,10,6,20,30,57,-27,36
St. Pölten,4629,9,9,8,19,34,64,-30,35
Mattersburg,4629,10,8,10,18,44,64,-20,34
SC Rheindorf,4630,1,23,9,4,65,32,33,78
FC Salzburg,4630,2,20,8,8,58,24,34,68
SK Sturm Gra,4630,3,20,6,10,66,38,28,66
Rapid Vienna,4630,4,14,10,12,57,41,16,52
Vienna,4630,5,16,3,17,64,55,9,51
RZ Pellets W,4630,6,14,8,14,51,60,-9,50
Admira Wacke,4630,7,11,7,18,38,68,-30,40
Mattersburg,4630,8,8,11,17,32,48,-16,35
St. Pölten,4630,9,8,8,20,43,74,-31,32
SV Josko Rie,4630,10,8,6,22,29,63,-34,30
SK Sturm Gra,4631,1,21,8,7,69,33,36,71
FC Salzburg,4631,2,20,10,6,64,34,30,70
Vienna,4631,3,21,5,10,71,49,22,68
SC Rheindorf,4631,4,17,9,10,51,47,4,60
Rapid Vienna,4631,5,12,10,14,56,46,10,46
SV Josko Rie,4631,6,12,4,20,34,53,-19,40
RZ Pellets W,4631,7,10,9,17,41,56,-15,39
Admira Wacke,4631,8,10,7,19,33,66,-33,37
Mattersburg,4631,9,8,10,18,42,57,-15,34
St. Pölten,4631,10,8,10,18,42,62,-20,34
FC Salzburg,4632,1,23,6,7,72,32,40,75
SK Sturm Gra,4632,2,18,9,9,58,30,28,63
Vienna,4632,3,19,3,14,70,62,8,60
SC Rheindorf,4632,4,16,8,12,49,44,5,56
Rapid Vienna,4632,5,12,12,12,50,40,10,48
SV Josko Rie,4632,6,12,6,18,37,54,-17,42
RZ Pellets W,4632,7,11,8,17,40,52,-12,41
St. Pölten,4632,8,11,8,17,41,60,-19,41
Mattersburg,4632,9,10,9,17,43,54,-11,39
Admira Wacke,4632,10,9,9,18,33,65,-32,36
FC Salzburg,4633,1,21,10,5,63,28,35,73
SK Sturm Gra,4633,2,21,6,9,70,32,38,69
SC Rheindorf,4633,3,17,11,8,52,42,10,62
Vienna,4633,4,16,6,14,61,56,5,54
Admira Wacke,4633,5,14,8,14,43,55,-12,50
RZ Pellets W,4633,6,13,9,14,48,49,-1,48
Rapid Vienna,4633,7,9,13,14,46,43,3,40
SV Josko Rie,4633,8,9,8,19,36,56,-20,35
St. Pölten,4633,9,9,8,19,42,75,-33,35
Mattersburg,4633,10,5,13,18,35,60,-25,28
FC Salzburg,4634,1,24,6,6,70,27,43,78
SK Sturm Gra,4634,2,19,4,13,65,45,20,61
SC Rheindorf,4634,3,18,7,11,54,45,9,61
Vienna,4634,4,18,6,12,64,56,8,60
Rapid Vienna,4634,5,14,11,11,61,47,14,53
RZ Pellets W,4634,6,12,8,16,46,56,-10,44
St. Pölten,4634,7,11,9,16,47,63,-16,42
Admira Wacke,4634,8,12,6,18,39,57,-18,42
SV Josko Rie,4634,9,10,5,21,36,65,-29,35
Mattersburg,4634,10,7,8,21,39,60,-21,29
FC Salzburg,4635,1,20,6,10,67,39,28,66
SK Sturm Gra,4635,2,18,8,10,59,34,25,62
SC Rheindorf,4635,3,17,9,10,55,46,9,60
Vienna,4635,4,16,7,13,56,48,8,55
Rapid Vienna,4635,5,12,12,12,51,40,11,48
Admira Wacke,4635,6,13,7,16,42,56,-14,46
SV Josko Rie,4635,7,13,4,19,42,56,-14,43
RZ Pellets W,4635,8,12,6,18,49,66,-17,42
St. Pölten,4635,9,10,11,15,44,61,-17,41
Mattersburg,4635,10,9,10,17,42,61,-19,37
FC Salzburg,4636,1,22,7,7,61,28,33,73
SC Rheindorf,4636,2,21,6,9,60,41,19,69
SK Sturm Gra,4636,3,20,7,9,58,32,26,67
Vienna,4636,4,18,6,12,59,45,14,60
Rapid Vienna,4636,5,14,12,10,53,36,17,54
SV Josko Rie,4636,6,13,3,20,36,51,-15,42
RZ Pellets W,4636,7,12,6,18,42,60,-18,42
Admira Wacke,4636,8,9,8,19,35,61,-26,35
Mattersburg,4636,9,7,10,19,32,58,-26,31
St. Pölten,4636,10,6,11,19,35,59,-24,29
FC Salzburg,4637,1,23,8,5,70,27,43,77
Vienna,4637,2,20,6,10,67,53,14,66
SC Rheindorf,4637,3,19,8,9,53,41,12,65
SK Sturm Gra,4637,4,15,10,11,48,35,13,55
Rapid Vienna,4637,5,12,12,12,49,39,10,48
RZ Pellets W,4637,6,11,10,15,46,56,-10,43
Admira Wacke,4637,7,10,9,17,37,58,-21,39
Mattersburg,4637,8,9,10,17,49,62,-13,37
St. Pölten,4637,9,8,9,19,45,65,-20,33
SV Josko Rie,4637,10,9,6,21,30,58,-28,33
SC Rheindorf,4638,1,24,6,6,63,34,29,78
SK Sturm Gra,4638,2,22,6,8,68,32,36,72
FC Salzburg,4638,3,18,8,10,63,37,26,62
Vienna,4638,4,18,2,16,58,60,-2,56
Rapid Vienna,4638,5,14,9,13,57,46,11,51
RZ Pellets W,4638,6,13,7,16,53,60,-7,46
Admira Wacke,4638,7,13,6,17,39,61,-22,45
SV Josko Rie,4638,8,12,5,19,37,55,-18,41
St. Pölten,4638,9,7,9,20,39,69,-30,30
Mattersburg,4638,10,6,8,22,33,56,-23,26
FC Salzburg,4639,1,21,6,9,62,35,27,69
SC Rheindorf,4639,2,21,6,9,62,48,14,69
SK Sturm Gra,4639,3,20,6,10,54,32,22,66
Vienna,4639,4,20,6,10,60,46,14,66
Rapid Vienna,4639,5,14,10,12,52,41,11,52
RZ Pellets W,4639,6,13,7,16,46,50,-4,46
SV Josko Rie,4639,7,11,6,19,40,57,-17,39
Admira Wacke,4639,8,11,6,19,37,58,-21,39
St. Pölten,4639,9,8,7,21,39,62,-23,31
Mattersburg,4639,10,7,8,21,34,57,-23,29
FC Salzburg,4640,1,20,10,6,66,32,34,70
SK Sturm Gra,4640,2,20,7,9,67,37,30,67
SC Rheindorf,4640,3,19,10,7,53,40,13,67
Vienna,4640,4,16,6,14,59,55,4,54
Rapid Vienna,4640,5,13,14,9,57,38,19,53
RZ Pellets W,4640,6,13,9,14,50,54,-4,48
SV Josko Rie,4640,7,11,5,20,38,60,-22,38
Admira Wacke,4640,8,10,8,18,34,58,-24,38
Mattersburg,4640,9,9,6,21,39,61,-22,33
St. Pölten,4640,10,7,9,20,44,72,-28,30
FC Salzburg,4641,1,21,7,8,68,26,42,70
SK Sturm Gra,4641,2,21,4,11,54,33,21,67
SC Rheindorf,4641,3,19,7,10,56,50,6,64
Rapid Vienna,4641,4,16,8,12,60,43,17,56
Vienna,4641,5,15,6,15,65,63,2,51
RZ Pellets W,4641,6,15,5,16,51,53,-2,50
Admira Wacke,4641,7,12,8,16,43,60,-17,44
St. Pölten,4641,8,11,9,16,45,61,-16,42
Mattersburg,4641,9,8,8,20,35,63,-28,32
SV Josko Rie,4641,10,8,6,22,33,58,-25,30
FC Salzburg,4642,1,21,10,5,71,28,43,73
Vienna,4642,2,19,6,11,67,49,18,63
SC Rheindorf,4642,3,17,10,9,49,41,8,61
SK Sturm Gra,4642,4,16,7,13,57,42,15,55
Rapid Vienna,4642,5,15,9,12,58,41,17,54
RZ Pellets W,4642,6,14,7,15,49,49,0,49
Admira Wacke,4642,7,14,5,17,40,66,-26,47
SV Josko Rie,4642,8,12,5,19,34,53,-19,41
Mattersburg,4642,9,9,8,19,39,59,-20,35
St. Pölten,4642,10,4,11,21,37,73,-36,23
FC Salzburg,4643,1,24,7,5,80,31,49,79
SC Rheindorf,4643,2,20,8,8,61,44,17,68
Vienna,4643,3,17,7,12,55,53,2,58
SK Sturm Gra,4643,4,16,8,12,57,38,19,56
Rapid Vienna,4643,5,14,12,10,57,40,17,54
RZ Pellets W,4643,6,13,8,15,47,55,-8,47
St. Pölten,4643,7,11,6,19,44,67,-23,39
SV Josko Rie,4643,8,12,3,21,34,57,-23,39
Admira Wacke,4643,9,9,8,19,34,60,-26,35
Mattersburg,4643,10,7,7,22,32,56,-24,28
FC Salzburg,4644,1,22,7,7,68,25,43,73
SK Sturm Gra,4644,2,23,4,9,69,36,33,73
SC Rheindorf,4644,3,19,7,10,53,40,13,64
Vienna,4644,4,19,4,13,67,53,14,61
Rapid Vienna,4644,5,14,10,12,60,52,8,52
Admira Wacke,4644,6,13,6,17,36,52,-16,45
RZ Pellets W,4644,7,9,9,18,46,70,-24,36
SV Josko Rie,4644,8,9,7,20,29,55,-26,34
St. Pölten,4644,9,8,9,19,41,64,-23,33
Mattersburg,4644,10,7,11,18,33,55,-22,32
FC Salzburg,4645,1,23,7,6,68,28,40,76
SK Sturm Gra,4645,2,22,6,8,62,30,32,72
Vienna,4645,3,20,2,14,68,51,17,62
SC Rheindorf,4645,4,18,6,12,51,48,3,60
Rapid Vienna,4645,5,16,9,11,62,42,20,57
RZ Pellets W,4645,6,11,7,18,39,56,-17,40
St. Pölten,4645,7,10,8,18,42,60,-18,38
Admira Wacke,4645,8,10,7,19,36,62,-26,37
Mattersburg,4645,9,9,7,20,34,60,-26,34
SV Josko Rie,4645,10,8,7,21,28,53,-25,31
Vienna,4646,1,25,3,8,73,46,27,78
FC Salzburg,4646,2,22,6,8,63,33,30,72
SC Rheindorf,4646,3,20,7,9,60,40,20,67
SK Sturm Gra,4646,4,17,9,10,54,32,22,60
Rapid Vienna,4646,5,14,10,12,54,46,8,52
RZ Pellets W,4646,6,12,10,14,46,52,-6,46
Admira Wacke,4646,7,11,8,17,39,58,-19,41
St. Pölten,4646,8,6,10,20,42,67,-25,28
SV Josko Rie,4646,9,7,7,22,31,59,-28,28
Mattersburg,4646,10,6,10,20,29,58,-29,28
FC Salzburg,4647,1,19,8,9,64,32,32,65
SC Rheindorf,4647,2,17,12,7,49,36,13,63
Vienna,4647,3,19,4,13,56,44,12,61
Rapid Vienna,4647,4,13,13,10,56,41,15,52
SK Sturm Gra,4647,5,15,7,14,55,42,13,52
RZ Pellets W,4647,6,14,6,16,44,53,-9,48
SV Josko Rie,4647,7,14,5,17,40,47,-7,47
Admira Wacke,4647,8,12,8,16,39,58,-19,44
St. Pölten,4647,9,8,10,18,45,66,-21,34
Mattersburg,4647,10,9,7,20,30,59,-29,34
SC Rheindorf,4648,1,21,8,7,47,31,16,71
FC Salzburg,4648,2,17,12,7,64,31,33,63
SK Sturm Gra,4648,3,18,8,10,66,37,29,62
Vienna,4648,4,18,6,12,68,55,13,60
Rapid Vienna,4648,5,15,11,10,60,45,15,56
RZ Pellets W,4648,6,12,8,16,50,64,-14,44
SV Josko Rie,4648,7,12,5,19,42,60,-18,41
Admira Wacke,4648,8,11,8,17,43,63,-20,41
St. Pölten,4648,9,8,9,19,38,67,-29,33
Mattersburg,4648,10,6,9,21,30,55,-25,27
FC Salzburg,4649,1,22,8,6,66,28,38,74
SC Rheindorf,4649,2,18,10,8,50,39,11,64
Rapid Vienna,4649,3,17,11,8,59,30,29,62
SK Sturm Gra,4649,4,17,11,8,61,37,24,62
Vienna,4649,5,18,4,14,65,59,6,58
RZ Pellets W,4649,6,10,12,14,45,59,-14,42
St. Pölten,4649,7,8,12,16,47,62,-15,36
Mattersburg,4649,8,9,9,18,34,54,-20,36
Admira Wacke,4649,9,8,7,21,32,68,-36,31
SV Josko Rie,4649,10,8,6,22,25,48,-23,30
FC Salzburg,4650,1,22,5,9,68,31,37,71
SC Rheindorf,4650,2,20,7,9,62,44,18,67
Rapid Vienna,4650,3,19,8,9,62,33,29,65
Vienna,4650,4,19,4,13,68,58,10,61
SK Sturm Gra,4650,5,17,8,11,60,39,21,59
RZ Pellets W,4650,6,12,10,14,44,53,-9,46
SV Josko Rie,4650,7,13,4,19,30,49,-19,43
Admira Wacke,4650,8,10,5,21,32,64,-32,35
St. Pölten,4650,9,6,12,18,40,71,-31,30
Mattersburg,4650,10,6,9,21,38,62,-24,27
FC Salzburg,4651,1,21,7,8,66,31,35,70
SC Rheindorf,4651,2,20,7,9,57,48,9,67
SK Sturm Gra,4651,3,20,5,11,60,31,29,65
Vienna,4651,4,20,4,12,67,55,12,64
Rapid Vienna,4651,5,12,12,12,47,40,7,48
Mattersburg,4651,6,12,7,17,40,50,-10,43
RZ Pellets W,4651,7,12,5,19,41,56,-15,41
St. Pölten,4651,8,10,9,17,44,59,-15,39
Admira Wacke,4651,9,11,5,20,33,60,-27,38
SV Josko Rie,4651,10,9,5,22,32,57,-25,32
FC Salzburg,4652,1,20,6,10,63,35,28,66
SK Sturm Gra,4652,2,20,5,11,57,29,28,65
SC Rheindorf,4652,3,18,9,9,53,43,10,63
Vienna,4652,4,17,6,13,54,51,3,57
Rapid Vienna,4652,5,13,10,13,52,45,7,49
RZ Pellets W,4652,6,12,8,16,44,53,-9,44
St. Pölten,4652,7,12,8,16,47,64,-17,44
Mattersburg,4652,8,11,8,17,41,55,-14,41
SV Josko Rie,4652,9,10,9,17,38,50,-12,39
Admira Wacke,4652,10,9,7,20,36,60,-24,34
FC Salzburg,4653,1,19,9,8,66,35,31,66
SK Sturm Gra,4653,2,20,4,12,59,35,24,64
SC Rheindorf,4653,3,19,7,10,50,42,8,64
Rapid Vienna,4653,4,15,12,9,67,38,29,57
Vienna,4653,5,17,4,15,54,52,2,55
Admira Wacke,4653,6,15,5,16,42,58,-16,50
RZ Pellets W,4653,7,10,10,16,44,55,-11,40
SV Josko Rie,4653,8,11,6,19,31,50,-19,39
St. Pölten,4653,9,10,8,18,41,63,-22,38
Mattersburg,4653,10,8,7,21,30,56,-26,31
SK Sturm Gra,4654,1,23,6,7,71,30,41,75
SC Rheindorf,4654,2,19,10,7,51,40,11,67
FC Salzburg,4654,3,19,9,8,57,29,28,66
Vienna,4654,4,18,5,13,60,49,11,59
Rapid Vienna,4654,5,16,10,10,54,38,16,58
RZ Pellets W,4654,6,12,5,19,47,63,-16,41
SV Josko Rie,4654,7,12,5,19,33,51,-18,41
Admira Wacke,4654,8,10,5,21,35,59,-24,35
St. Pölten,4654,9,7,10,19,39,63,-24,31
Mattersburg,4654,10,8,7,21,35,60,-25,31
FC Salzburg,4655,1,18,11,7,60,29,31,65
SC Rheindorf,4655,2,19,6,11,54,44,10,63
Vienna,4655,3,20,2,14,65,46,19,62
SK Sturm Gra,4655,4,18,6,12,55,38,17,60
Rapid Vienna,4655,5,15,10,11,57,41,16,55
RZ Pellets W,4655,6,13,9,14,48,55,-7,48
St. Pölten,4655,7,11,8,17,39,66,-27,41
Admira Wacke,4655,8,11,7,18,39,62,-23,40
SV Josko Rie,4655,9,10,6,20,33,50,-17,36
Mattersburg,4655,10,8,9,19,33,52,-19,33
SK Sturm Gra,4656,1,22,3,11,68,29,39,69
FC Salzburg,4656,2,20,9,7,61,26,35,69
SC Rheindorf,4656,3,19,7,10,58,46,12,64
Rapid Vienna,4656,4,17,10,9,64,35,29,61
Vienna,4656,5,15,8,13,53,50,3,53
RZ Pellets W,4656,6,15,7,14,45,53,-8,52
Admira Wacke,4656,7,12,7,17,39,63,-24,43
SV Josko Rie,4656,8,10,6,20,35,60,-25,36
St. Pölten,4656,9,7,11,18,37,62,-25,32
Mattersburg,4656,10,6,6,24,27,63,-36,24
FC Salzburg,4657,1,22,6,8,62,29,33,72
SK Sturm Gra,4657,2,20,7,9,62,32,30,67
SC Rheindorf,4657,3,19,8,9,56,44,12,65
Rapid Vienna,4657,4,15,10,11,57,44,13,55
Vienna,4657,5,15,5,16,57,58,-1,50
Mattersburg,4657,6,11,8,17,39,54,-15,41
SV Josko Rie,4657,7,12,4,20,35,53,-18,40
RZ Pellets W,4657,8,11,6,19,43,57,-14,39
Admira Wacke,4657,9,11,6,19,37,61,-24,39
St. Pölten,4657,10,10,8,18,41,57,-16,38
FC Salzburg,4658,1,23,6,7,65,29,36,75
SK Sturm Gra,4658,2,21,6,9,57,36,21,69
Vienna,4658,3,20,5,11,72,47,25,65
SC Rheindorf,4658,4,17,8,11,51,39,12,59
Rapid Vienna,4658,5,12,13,11,55,40,15,49
RZ Pellets W,4658,6,12,8,16,47,61,-14,44
Admira Wacke,4658,7,11,6,19,38,61,-23,39
St. Pölten,4658,8,10,8,18,40,65,-25,38
Mattersburg,4658,9,9,8,19,41,58,-17,35
SV Josko Rie,4658,10,9,4,23,32,62,-30,31
SC Rheindorf,4659,1,23,7,6,61,34,27,76
FC Salzburg,4659,2,20,6,10,72,43,29,66
SK Sturm Gra,4659,3,20,6,10,61,37,24,66
Vienna,4659,4,19,5,12,68,54,14,62
Rapid Vienna,4659,5,14,9,13,60,50,10,51
RZ Pellets W,4659,6,14,6,16,46,53,-7,48
Admira Wacke,4659,7,14,4,18,37,58,-21,46
St. Pölten,4659,8,9,8,19,44,67,-23,35
SV Josko Rie,4659,9,9,5,22,37,61,-24,32
Mattersburg,4659,10,7,6,23,34,63,-29,27
SC Rheindorf,4660,1,21,7,8,62,40,22,70
SK Sturm Gra,4660,2,21,6,9,57,35,22,69
FC Salzburg,4660,3,18,12,6,63,32,31,66
Vienna,4660,4,17,8,11,59,51,8,59
Rapid Vienna,4660,5,16,9,11,60,42,18,57
RZ Pellets W,4660,6,11,10,15,46,55,-9,43
St. Pölten,4660,7,9,11,16,41,57,-16,38
Admira Wacke,4660,8,8,9,19,30,52,-22,33
SV Josko Rie,4660,9,8,8,20,33,58,-25,32
Mattersburg,4660,10,5,12,19,37,66,-29,27
FC Salzburg,4661,1,23,6,7,64,31,33,75
SK Sturm Gra,4661,2,19,9,8,65,35,30,66
SC Rheindorf,4661,3,19,4,13,55,44,11,61
Vienna,4661,4,16,6,14,63,56,7,54
Rapid Vienna,4661,5,14,9,13,54,42,12,51
RZ Pellets W,4661,6,11,9,16,47,64,-17,42
St. Pölten,4661,7,10,11,15,46,58,-12,41
SV Josko Rie,4661,8,11,7,18,35,51,-16,40
Admira Wacke,4661,9,10,7,19,34,64,-30,37
Mattersburg,4661,10,8,10,18,36,54,-18,34
FC Salzburg,4662,1,23,7,6,66,27,39,76
SK Sturm Gra,4662,2,22,5,9,62,31,31,71
SC Rheindorf,4662,3,18,10,8,57,45,12,64
Vienna,4662,4,18,5,13,66,57,9,59
Rapid Vienna,4662,5,16,9,11,64,43,21,57
RZ Pellets W,4662,6,14,5,17,51,51,0,47
Admira Wacke,4662,7,11,8,17,37,57,-20,41
St. Pölten,4662,8,7,9,20,42,68,-26,30
SV Josko Rie,4662,9,8,6,22,30,64,-34,30
Mattersburg,4662,10,7,8,21,34,66,-32,29
SC Rheindorf,4663,1,22,9,5,62,35,27,75
FC Salzburg,4663,2,23,5,8,75,39,36,74
Vienna,4663,3,21,3,12,67,49,18,66
SK Sturm Gra,4663,4,19,7,10,61,33,28,64
Rapid Vienna,4663,5,13,10,13,53,44,9,49
SV Josko Rie,4663,6,12,4,20,30,51,-21,40
RZ Pellets W,4663,7,11,6,19,43,65,-22,39
Mattersburg,4663,8,10,8,18,43,60,-17,38
Admira Wacke,4663,9,8,7,21,35,68,-33,31
St. Pölten,4663,10,6,11,19,42,67,-25,29
FC Salzburg,4664,1,23,8,5,75,21,54,77
SC Rheindorf,4664,2,20,7,9,49,33,16,67
SK Sturm Gra,4664,3,17,10,9,53,30,23,61
Vienna,4664,4,18,4,14,63,58,5,58
Rapid Vienna,4664,5,15,12,9,53,32,21,57
RZ Pellets W,4664,6,13,8,15,46,53,-7,47
Admira Wacke,4664,7,9,9,18,32,56,-24,36
Mattersburg,4664,8,8,9,19,34,56,-22,33
SV Josko Rie,4664,9,9,5,22,34,67,-33,32
St. Pölten,4664,10,7,10,19,35,68,-33,31
FC Salzburg,4665,1,20,8,8,57,29,28,68
SK Sturm Gra,4665,2,19,7,10,62,34,28,64
SC Rheindorf,4665,3,18,8,10,55,43,12,62
Rapid Vienna,4665,4,16,11,9,54,36,18,59
Vienna,4665,5,17,5,14,59,51,8,56
RZ Pellets W,4665,6,12,8,16,38,49,-11,44
Mattersburg,4665,7,11,9,16,47,54,-7,42
Admira Wacke,4665,8,12,5,19,34,58,-24,41
SV Josko Rie,4665,9,11,3,22,32,56,-24,36
St. Pölten,4665,10,8,8,20,39,67,-28,32
SK Sturm Gra,4666,1,23,7,6,64,24,40,76
FC Salzburg,4666,2,22,5,9,61,30,31,71
Vienna,4666,3,20,3,13,69,52,17,63
SC Rheindorf,4666,4,19,6,11,53,47,6,63
Rapid Vienna,4666,5,16,9,11,56,36,20,57
RZ Pellets W,4666,6,10,11,15,40,54,-14,41
Mattersburg,4666,7,10,7,19,37,49,-12,37
SV Josko Rie,4666,8,11,4,21,30,55,-25,37
Admira Wacke,4666,9,9,7,20,31,64,-33,34
St. Pölten,4666,10,6,9,21,42,72,-30,27
Vienna,4667,1,20,5,11,63,44,19,65
FC Salzburg,4667,2,18,10,8,64,38,26,64
SK Sturm Gra,4667,3,19,6,11,56,30,26,63
SC Rheindorf,4667,4,16,11,9,52,44,8,59
Rapid Vienna,4667,5,16,10,10,58,36,22,58
RZ Pellets W,4667,6,13,7,16,45,56,-11,46
Admira Wacke,4667,7,11,7,18,36,65,-29,40
St. Pölten,4667,8,9,11,16,38,59,-21,38
Mattersburg,4667,9,9,8,19,39,55,-16,35
SV Josko Rie,4667,10,8,7,21,32,56,-24,31
Vienna,4668,1,23,3,10,79,52,27,72
FC Salzburg,4668,2,21,8,7,69,35,34,71
SC Rheindorf,4668,3,19,7,10,52,45,7,64
SK Sturm Gra,4668,4,14,6,16,48,41,7,48
Rapid Vienna,4668,5,12,11,13,56,47,9,47
RZ Pellets W,4668,6,13,7,16,48,54,-6,46
SV Josko Rie,4668,7,12,7,17,37,52,-15,43
Admira Wacke,4668,8,13,3,20,37,60,-23,42
Mattersburg,4668,9,10,8,18,34,52,-18,38
St. Pölten,4668,10,8,10,18,40,62,-22,34
Rapid Vienna,4669,1,20,9,7,64,32,32,69
SC Rheindorf,4669,2,20,7,9,58,42,16,67
FC Salzburg,4669,3,20,6,10,63,37,26,66
SK Sturm Gra,4669,4,17,5,14,55,37,18,56
Vienna,4669,5,16,7,13,57,47,10,55
Admira Wacke,4669,6,12,6,18,40,62,-22,42
RZ Pellets W,4669,7,11,7,18,36,53,-17,40
SV Josko Rie,4669,8,11,7,18,33,54,-21,40
Mattersburg,4669,9,9,9,18,30,50,-20,36
St. Pölten,4669,10,8,9,19,37,59,-22,33
FC Salzburg,4670,1,20,10,6,64,33,31,70
SK Sturm Gra,4670,2,21,6,9,68,35,33,69
SC Rheindorf,4670,3,19,6,11,58,48,10,63
Vienna,4670,4,16,7,13,62,57,5,55
Rapid Vienna,4670,5,15,8,13,60,45,15,53
SV Josko Rie,4670,6,12,7,17,39,50,-11,43
St. Pölten,4670,7,11,10,15,44,58,-14,43
RZ Pellets W,4670,8,11,5,20,40,59,-19,38
Admira Wacke,4670,9,10,6,20,32,64,-32,36
Mattersburg,4670,10,9,7,20,41,59,-18,34
FC Salzburg,4671,1,21,6,9,63,27,36,69
Rapid Vienna,4671,2,18,10,8,59,37,22,64
Vienna,4671,3,19,6,11,68,50,18,63
SK Sturm Gra,4671,4,18,8,10,58,37,21,62
SC Rheindorf,4671,5,18,8,10,50,42,8,62
RZ Pellets W,4671,6,13,7,16,45,56,-11,46
St. Pölten,4671,7,10,9,17,46,62,-16,39
SV Josko Rie,4671,8,9,8,19,32,57,-25,35
Mattersburg,4671,9,8,9,19,39,62,-23,33
Admira Wacke,4671,10,9,3,24,37,67,-30,30
SC Rheindorf,4672,1,19,10,7,59,42,17,67
SK Sturm Gra,4672,2,18,8,10,51,29,22,62
Vienna,4672,3,19,5,12,62,54,8,62
FC Salzburg,4672,4,16,11,9,54,31,23,59
Rapid Vienna,4672,5,16,10,10,56,36,20,58
RZ Pellets W,4672,6,13,8,15,49,51,-2,47
Admira Wacke,4672,7,10,8,18,37,61,-24,38
Mattersburg,4672,8,8,12,16,39,57,-18,36
SV Josko Rie,4672,9,9,6,21,34,56,-22,33
St. Pölten,4672,10,6,14,16,35,59,-24,32
FC Salzburg,4673,1,23,5,8,64,26,38,74
SC Rheindorf,4673,2,22,6,8,56,36,20,72
Vienna,4673,3,21,5,10,66,48,18,68
SK Sturm Gra,4673,4,18,6,12,59,37,22,60
Rapid Vienna,4673,5,14,10,12,55,45,10,52
SV Josko Rie,4673,6,15,5,16,44,46,-2,50
RZ Pellets W,4673,7,12,4,20,38,58,-20,40
Admira Wacke,4673,8,10,6,20,34,62,-28,36
St. Pölten,4673,9,7,10,19,41,66,-25,31
Mattersburg,4673,10,6,7,23,29,62,-33,25
FC Salzburg,4674,1,20,10,6,64,33,31,70
SC Rheindorf,4674,2,20,7,9,59,43,16,67
SK Sturm Gra,4674,3,19,5,12,56,39,17,62
Vienna,4674,4,17,9,10,73,58,15,60
Rapid Vienna,4674,5,13,13,10,56,40,16,52
RZ Pellets W,4674,6,12,6,18,41,61,-20,42
Mattersburg,4674,7,10,8,18,40,50,-10,38
St. Pölten,4674,8,9,10,17,47,64,-17,37
Admira Wacke,4674,9,9,9,18,37,62,-25,36
SV Josko Rie,4674,10,10,5,21,33,56,-23,35
SC Rheindorf,4675,1,21,8,7,58,44,14,71
SK Sturm Gra,4675,2,20,8,8,59,28,31,68
FC Salzburg,4675,3,20,6,10,74,36,38,66
Rapid Vienna,4675,4,19,9,8,66,31,35,66
Vienna,4675,5,18,8,10,68,47,21,62
RZ Pellets W,4675,6,11,9,16,48,58,-10,42
Mattersburg,4675,7,10,8,18,38,62,-24,38
Admira Wacke,4675,8,9,6,21,35,72,-37,33
SV Josko Rie,4675,9,8,5,23,35,64,-29,29
St. Pölten,4675,10,7,7,22,42,81,-39,28
FC Salzburg,4676,1,22,5,9,64,30,34,71
SK Sturm Gra,4676,2,20,6,10,62,35,27,66
Vienna,4676,3,19,6,11,68,52,16,63
SC Rheindorf,4676,4,19,6,11,49,43,6,63
Rapid Vienna,4676,5,15,10,11,51,36,15,55
SV Josko Rie,4676,6,14,4,18,37,50,-13,46
RZ Pellets W,4676,7,11,10,15,42,54,-12,43
Admira Wacke,4676,8,10,5,21,36,61,-25,35
St. Pölten,4676,9,8,10,18,36,60,-24,34
Mattersburg,4676,10,7,8,21,32,56,-24,29
FC Salzburg,4677,1,24,8,4,73,26,47,80
SK Sturm Gra,4677,2,18,10,8,54,31,23,64
SC Rheindorf,4677,3,18,8,10,48,39,9,62
Vienna,4677,4,18,5,13,57,51,6,59
Rapid Vienna,4677,5,12,14,10,54,37,17,50
RZ Pellets W,4677,6,11,9,16,45,60,-15,42
SV Josko Rie,4677,7,11,7,18,34,50,-16,40
Admira Wacke,4677,8,10,9,17,39,61,-22,39
St. Pölten,4677,9,8,13,15,37,53,-16,37
Mattersburg,4677,10,5,7,24,28,61,-33,22
FC Salzburg,4678,1,22,7,7,68,34,34,73
SK Sturm Gra,4678,2,22,4,10,68,34,34,70
SC Rheindorf,4678,3,21,6,9,59,44,15,69
Vienna,4678,4,18,5,13,61,55,6,59
Rapid Vienna,4678,5,15,9,12,66,47,19,54
RZ Pellets W,4678,6,11,7,18,48,61,-13,40
Mattersburg,4678,7,10,10,16,39,54,-15,40
SV Josko Rie,4678,8,11,5,20,39,57,-18,38
Admira Wacke,4678,9,8,8,20,32,63,-31,32
St. Pölten,4678,10,6,11,19,35,66,-31,29
FC Salzburg,4679,1,23,6,7,66,30,36,75
SC Rheindorf,4679,2,18,10,8,52,42,10,64
Vienna,4679,3,17,7,12,58,46,12,58
Rapid Vienna,4679,4,15,12,9,52,36,16,57
SK Sturm Gra,4679,5,15,8,13,49,36,13,53
Admira Wacke,4679,6,13,6,17,42,58,-16,45
RZ Pellets W,4679,7,12,8,16,41,53,-12,44
Mattersburg,4679,8,8,11,17,34,46,-12,35
St. Pölten,4679,9,8,10,18,36,59,-23,34
SV Josko Rie,4679,10,9,6,21,34,58,-24,33
FC Salzburg,4680,1,22,6,8,66,32,34,72
SC Rheindorf,4680,2,22,6,8,58,33,25,72
SK Sturm Gra,4680,3,20,6,10,56,37,19,66
Vienna,4680,4,18,7,11,64,50,14,61
RZ Pellets W,4680,5,13,8,15,47,53,-6,47
Rapid Vienna,4680,6,11,11,14,45,44,1,44
Admira Wacke,4680,7,10,8,18,38,61,-23,38
Mattersburg,4680,8,8,10,18,30,48,-18,34
SV Josko Rie,4680,9,8,9,19,29,51,-22,33
St. Pölten,4680,10,8,9,19,39,63,-24,33
FC Salzburg,4681,1,19,10,7,57,25,32,67
SC Rheindorf,4681,2,18,10,8,55,38,17,64
SK Sturm Gra,4681,3,19,6,11,56,33,23,63
Vienna,4681,4,16,8,12,62,55,7,56
Rapid Vienna,4681,5,15,10,11,52,40,12,55
RZ Pellets W,4681,6,12,8,16,39,47,-8,44
Admira Wacke,4681,7,11,9,16,39,57,-18,42
St. Pölten,4681,8,7,15,14,36,55,-19,36
SV Josko Rie,4681,9,9,8,19,33,53,-20,35
Mattersburg,4681,10,8,8,20,31,57,-26,32
SK Sturm Gra,4682,1,22,6,8,68,30,38,72
FC Salzburg,4682,2,20,9,7,67,33,34,69
SC Rheindorf,4682,3,18,9,9,52,42,10,63
Vienna,4682,4,19,5,12,62,50,12,62
Rapid Vienna,4682,5,16,11,9,68,37,31,59
Admira Wacke,4682,6,13,8,15,46,62,-16,47
St. Pölten,4682,7,9,8,19,41,68,-27,35
RZ Pellets W,4682,8,8,9,19,37,66,-29,33
Mattersburg,4682,9,7,10,19,37,59,-22,31
SV Josko Rie,4682,10,7,7,22,27,58,-31,28
SC Rheindorf,4683,1,22,8,6,58,37,21,74
FC Salzburg,4683,2,19,5,12,63,38,25,62
SK Sturm Gra,4683,3,18,6,12,62,38,24,60
Vienna,4683,4,18,5,13,58,51,7,59
Rapid Vienna,4683,5,14,8,14,57,51,6,50
RZ Pellets W,4683,6,13,8,15,44,49,-5,47
Admira Wacke,4683,7,14,5,17,45,60,-15,47
St. Pölten,4683,8,9,10,17,49,66,-17,37
Mattersburg,4683,9,9,9,18,33,52,-19,36
SV Josko Rie,4683,10,10,4,22,31,58,-27,34
FC Salzburg,4684,1,18,9,9,63,35,28,63
SC Rheindorf,4684,2,17,9,10,58,53,5,60
Vienna,4684,3,18,4,14,60,66,-6,58
SK Sturm Gra,4684,4,15,9,12,50,35,15,54
Rapid Vienna,4684,5,13,11,12,53,40,13,50
SV Josko Rie,4684,6,13,7,16,41,43,-2,46
Admira Wacke,4684,7,13,6,17,42,58,-16,45
Mattersburg,4684,8,12,8,16,47,56,-9,44
St. Pölten,4684,9,11,9,16,48,62,-14,42
RZ Pellets W,4684,10,9,10,17,38,52,-14,37
FC Salzburg,4685,1,22,6,8,68,30,38,72
SC Rheindorf,4685,2,19,10,7,56,39,17,67
SK Sturm Gra,4685,3,19,6,11,62,39,23,63
Vienna,4685,4,17,6,13,59,49,10,57
Rapid Vienna,4685,5,13,10,13,58,44,14,49
SV Josko Rie,4685,6,13,4,19,40,52,-12,43
RZ Pellets W,4685,7,11,8,17,39,53,-14,41
Admira Wacke,4685,8,11,7,18,36,64,-28,40
St. Pölten,4685,9,10,8,18,41,68,-27,38
Mattersburg,4685,10,7,11,18,34,55,-21,32
FC Salzburg,4686,1,22,5,9,66,27,39,71
SK Sturm Gra,4686,2,21,5,10,56,35,21,68
SC Rheindorf,4686,3,20,7,9,55,40,15,67
Vienna,4686,4,18,5,13,59,46,13,59
Rapid Vienna,4686,5,13,12,11,48,33,15,51
St. Pölten,4686,6,11,11,14,47,60,-13,44
RZ Pellets W,4686,7,11,8,17,41,55,-14,41
SV Josko Rie,4686,8,10,6,20,29,51,-22,36
Mattersburg,4686,9,9,8,19,39,58,-19,35
Admira Wacke,4686,10,9,5,22,30,65,-35,32
FC Salzburg,4687,1,20,8,8,67,35,32,68
SK Sturm Gra,4687,2,19,7,10,56,33,23,64
SC Rheindorf,4687,3,17,9,10,54,47,7,60
Rapid Vienna,4687,4,16,11,9,57,37,20,59
Vienna,4687,5,17,5,14,60,49,11,56
RZ Pellets W,4687,6,14,6,16,46,51,-5,48
Admira Wacke,4687,7,13,8,15,38,54,-16,47
Mattersburg,4687,8,10,9,17,36,53,-17,39
SV Josko Rie,4687,9,9,5,22,31,58,-27,32
St. Pölten,4687,10,6,10,20,40,68,-28,28
FC Salzburg,4688,1,24,6,6,82,33,49,78
SK Sturm Gra,4688,2,21,6,9,67,34,33,69
SC Rheindorf,4688,3,19,8,9,60,47,13,65
Vienna,4688,4,18,7,11,62,46,16,61
Rapid Vienna,4688,5,11,10,15,50,50,0,43
RZ Pellets W,4688,6,11,6,19,46,63,-17,39
Admira Wacke,4688,7,10,8,18,37,69,-32,38
SV Josko Rie,4688,8,10,7,19,38,52,-14,37
Mattersburg,4688,9,9,9,18,33,62,-29,36
St. Pölten,4688,10,7,13,16,39,58,-19,34
FC Salzburg,4689,1,23,5,8,75,30,45,74
SK Sturm Gra,4689,2,20,6,10,60,32,28,66
SC Rheindorf,4689,3,17,11,8,56,44,12,62
Rapid Vienna,4689,4,16,9,11,51,37,14,57
Vienna,4689,5,17,6,13,59,50,9,57
RZ Pellets W,4689,6,14,5,17,48,56,-8,47
SV Josko Rie,4689,7,12,4,20,42,65,-23,40
Admira Wacke,4689,8,10,5,21,34,67,-33,35
Mattersburg,4689,9,9,7,20,38,57,-19,34
St. Pölten,4689,10,7,12,17,40,65,-25,33
FC Salzburg,4690,1,22,9,5,73,33,40,75
SC Rheindorf,4690,2,18,11,7,61,42,19,65
SK Sturm Gra,4690,3,18,8,10,59,36,23,62
Rapid Vienna,4690,4,15,11,10,63,45,18,56
Vienna,4690,5,14,8,14,58,60,-2,50
Admira Wacke,4690,6,14,8,14,47,57,-10,50
RZ Pellets W,4690,7,11,10,15,46,55,-9,43
SV Josko Rie,4690,8,10,5,21,36,61,-25,35
Mattersburg,4690,9,8,9,19,38,60,-22,33
St. Pölten,4690,10,7,7,22,42,74,-32,28
SK Sturm Gra,4691,1,21,6,9,67,37,30,69
SC Rheindorf,4691,2,21,4,11,54,42,12,67
FC Salzburg,4691,3,19,7,10,60,32,28,64
Vienna,4691,4,17,4,15,60,57,3,55
Rapid Vienna,4691,5,15,9,12,60,42,18,54
RZ Pellets W,4691,6,12,9,15,50,61,-11,45
SV Josko Rie,4691,7,13,5,18,30,44,-14,44
Admira Wacke,4691,8,11,7,18,38,63,-25,40
St. Pölten,4691,9,9,11,16,44,61,-17,38
Mattersburg,4691,10,6,10,20,31,55,-24,28
Vienna,4692,1,21,4,11,71,51,20,67
FC Salzburg,4692,2,19,7,10,66,40,26,64
SC Rheindorf,4692,3,19,7,10,60,46,14,64
SK Sturm Gra,4692,4,18,5,13,56,40,16,59
Rapid Vienna,4692,5,16,9,11,55,37,18,57
Mattersburg,4692,6,12,9,15,47,58,-11,45
St. Pölten,4692,7,10,10,16,48,65,-17,40
RZ Pellets W,4692,8,10,9,17,42,55,-13,39
Admira Wacke,4692,9,11,5,20,41,70,-29,38
SV Josko Rie,4692,10,10,3,23,37,61,-24,33
FC Salzburg,4693,1,23,8,5,68,24,44,77
SC Rheindorf,4693,2,18,9,9,48,38,10,63
Vienna,4693,3,20,2,14,61,56,5,62
SK Sturm Gra,4693,4,17,7,12,57,32,25,58
Rapid Vienna,4693,5,14,11,11,57,46,11,53
RZ Pellets W,4693,6,13,5,18,53,61,-8,44
Admira Wacke,4693,7,11,8,17,36,61,-25,41
Mattersburg,4693,8,9,9,18,41,55,-14,36
St. Pölten,4693,9,7,12,17,41,64,-23,33
SV Josko Rie,4693,10,8,9,19,35,60,-25,33
FC Salzburg,4694,1,21,8,7,68,32,36,71
SC Rheindorf,4694,2,21,7,8,54,36,18,70
SK Sturm Gra,4694,3,19,6,11,55,35,20,63
Vienna,4694,4,18,7,11,67,59,8,61
Admira Wacke,4694,5,14,7,15,37,51,-14,49
Rapid Vienna,4694,6,12,12,12,52,36,16,48
RZ Pellets W,4694,7,11,8,17,50,63,-13,41
SV Josko Rie,4694,8,9,7,20,33,58,-25,34
St. Pölten,4694,9,7,12,17,38,56,-18,33
Mattersburg,4694,10,8,6,22,36,64,-28,30
FC Salzburg,4695,1,22,8,6,65,31,34,74
SC Rheindorf,4695,2,22,6,8,56,36,20,72
SK Sturm Gra,4695,3,18,7,11,57,34,23,61
Vienna,4695,4,19,4,13,66,51,15,61
Rapid Vienna,4695,5,16,9,11,54,41,13,57
RZ Pellets W,4695,6,12,10,14,39,50,-11,46
SV Josko Rie,4695,7,11,7,18,38,51,-13,40
St. Pölten,4695,8,8,10,18,46,71,-25,34
Admira Wacke,4695,9,8,6,22,28,58,-30,30
Mattersburg,4695,10,5,11,20,36,62,-26,26
FC Salzburg,4696,1,23,7,6,76,29,47,76
SC Rheindorf,4696,2,20,7,9,60,49,11,67
SK Sturm Gra,4696,3,19,9,8,57,30,27,66
Vienna,4696,4,16,7,13,62,57,5,55
Rapid Vienna,4696,5,14,11,11,57,43,14,53
Admira Wacke,4696,6,13,5,18,40,62,-22,44
SV Josko Rie,4696,7,13,2,21,41,61,-20,41
RZ Pellets W,4696,8,11,7,18,49,60,-11,40
St. Pölten,4696,9,8,9,19,36,65,-29,33
Mattersburg,4696,10,8,6,22,35,57,-22,30
FC Salzburg,4697,1,23,5,8,70,35,35,74
SK Sturm Gra,4697,2,21,5,10,60,31,29,68
Vienna,4697,3,21,4,11,70,53,17,67
SC Rheindorf,4697,4,19,6,11,57,43,14,63
RZ Pellets W,4697,5,12,7,17,48,57,-9,43
Rapid Vienna,4697,6,10,12,14,50,45,5,42
Mattersburg,4697,7,11,9,16,46,58,-12,42
Admira Wacke,4697,8,10,7,19,29,57,-28,37
SV Josko Rie,4697,9,9,8,19,36,58,-22,35
St. Pölten,4697,10,8,9,19,44,73,-29,33
FC Salzburg,4698,1,19,11,6,61,32,29,68
SK Sturm Gra,4698,2,20,6,10,60,33,27,66
SC Rheindorf,4698,3,19,5,12,55,41,14,62
Vienna,4698,4,17,7,12,60,54,6,58
Rapid Vienna,4698,5,16,8,12,57,34,23,56
Admira Wacke,4698,6,12,6,18,39,68,-29,42
SV Josko Rie,4698,7,10,9,17,34,48,-14,39
RZ Pellets W,4698,8,11,6,19,43,65,-22,39
St. Pölten,4698,9,9,9,18,40,58,-18,36
Mattersburg,4698,10,8,11,17,35,51,-16,35
SC Rheindorf,4699,1,22,8,6,54,36,18,74
Vienna,4699,2,22,3,11,65,49,16,69
FC Salzburg,4699,3,19,8,9,65,32,33,65
SK Sturm Gra,4699,4,19,6,11,54,31,23,63
Rapid Vienna,4699,5,11,10,15,47,40,7,43
RZ Pellets W,4699,6,12,6,18,41,56,-15,42
Admira Wacke,4699,7,12,6,18,35,60,-25,42
SV Josko Rie,4699,8,12,2,22,33,55,-22,38
Mattersburg,4699,9,9,9,18,34,53,-19,36
St. Pölten,4699,10,9,8,19,47,63,-16,35
FC Salzburg,4700,1,21,8,7,66,34,32,71
SC Rheindorf,4700,2,21,5,10,58,43,15,68
SK Sturm Gra,4700,3,18,7,11,56,35,21,61
Vienna,4700,4,18,3,15,55,57,-2,57
Rapid Vienna,4700,5,15,11,10,55,36,19,56
Admira Wacke,4700,6,14,6,16,44,56,-12,48
RZ Pellets W,4700,7,10,12,14,43,56,-13,42
SV Josko Rie,4700,8,12,4,20,43,53,-10,40
St. Pölten,4700,9,7,11,18,39,65,-26,32
Mattersburg,4700,10,6,9,21,35,59,-24,27
FC Salzburg,4701,1,19,9,8,61,32,29,66
SK Sturm Gra,4701,2,19,6,11,55,33,22,63
SC Rheindorf,4701,3,18,7,11,59,45,14,61
Rapid Vienna,4701,4,14,12,10,57,45,12,54
Vienna,4701,5,16,4,16,57,54,3,52
St. Pölten,4701,6,12,10,14,41,56,-15,46
RZ Pellets W,4701,7,13,6,17,49,62,-13,45
Mattersburg,4701,8,10,10,16,39,52,-13,40
Admira Wacke,4701,9,11,5,20,36,55,-19,38
SV Josko Rie,4701,10,9,9,18,35,55,-20,36
FC Salzburg,4702,1,22,8,6,71,27,44,74
SK Sturm Gra,4702,2,19,6,11,60,38,22,63
Vienna,4702,3,18,8,10,69,56,13,62
SC Rheindorf,4702,4,17,9,10,56,52,4,60
Rapid Vienna,4702,5,13,10,13,54,47,7,49
RZ Pellets W,4702,6,12,9,15,50,56,-6,45
St. Pölten,4702,7,10,11,15,49,64,-15,41
SV Josko Rie,4702,8,11,5,20,32,53,-21,38
Mattersburg,4702,9,9,10,17,43,58,-15,37
Admira Wacke,4702,10,9,4,23,30,63,-33,31
SC Rheindorf,4703,1,21,8,7,63,44,19,71
FC Salzburg,4703,2,20,9,7,62,30,32,69
Vienna,4703,3,18,4,14,60,51,9,58
SK Sturm Gra,4703,4,16,9,11,55,40,15,57
Rapid Vienna,4703,5,15,10,11,55,37,18,55
RZ Pellets W,4703,6,13,8,15,45,52,-7,47
St. Pölten,4703,7,12,8,16,48,62,-14,44
Admira Wacke,4703,8,11,7,18,36,60,-24,40
SV Josko Rie,4703,9,10,4,22,35,60,-25,34
Mattersburg,4703,10,7,7,22,33,56,-23,28
FC Salzburg,4704,1,20,11,5,70,32,38,71
SC Rheindorf,4704,2,18,9,9,57,43,14,63
Vienna,4704,3,19,5,12,60,47,13,62
SK Sturm Gra,4704,4,18,6,12,46,31,15,60
Rapid Vienna,4704,5,13,12,11,48,38,10,51
RZ Pellets W,4704,6,14,7,15,48,52,-4,49
Admira Wacke,4704,7,12,7,17,38,54,-16,43
St. Pölten,4704,8,9,9,18,41,60,-19,36
Mattersburg,4704,9,7,12,17,32,52,-20,33
SV Josko Rie,4704,10,9,4,23,28,59,-31,31
SK Sturm Gra,4705,1,23,4,9,68,35,33,73
FC Salzburg,4705,2,21,7,8,71,36,35,70
SC Rheindorf,4705,3,20,7,9,60,47,13,67
Rapid Vienna,4705,4,15,11,10,51,38,13,56
Vienna,4705,5,17,4,15,65,54,11,55
Admira Wacke,4705,6,13,4,19,44,62,-18,43
SV Josko Rie,4705,7,12,5,19,31,53,-22,41
RZ Pellets W,4705,8,10,6,20,40,60,-20,36
Mattersburg,4705,9,9,7,20,37,57,-20,34
St. Pölten,4705,10,8,9,19,43,68,-25,33
FC Salzburg,4706,1,23,6,7,70,30,40,75
SC Rheindorf,4706,2,19,6,11,58,43,15,63
SK Sturm Gra,4706,3,18,8,10,56,33,23,62
Vienna,4706,4,17,4,15,57,53,4,55
Rapid Vienna,4706,5,11,15,10,53,42,11,48
RZ Pellets W,4706,6,13,6,17,46,54,-8,45
Admira Wacke,4706,7,13,4,19,35,57,-22,43
SV Josko Rie,4706,8,12,5,19,37,57,-20,41
St. Pölten,4706,9,9,10,17,45,70,-25,37
Mattersburg,4706,10,9,8,19,42,60,-18,35
FC Salzburg,4707,1,21,8,7,65,26,39,71
SC Rheindorf,4707,2,19,10,7,52,36,16,67
SK Sturm Gra,4707,3,19,5,12,61,42,19,62
Vienna,4707,4,17,5,14,58,54,4,56
Rapid Vienna,4707,5,15,8,13,55,46,9,53
RZ Pellets W,4707,6,13,7,16,46,60,-14,46
Admira Wacke,4707,7,12,7,17,34,51,-17,43
Mattersburg,4707,8,10,10,16,42,52,-10,40
St. Pölten,4707,9,8,10,18,43,64,-21,34
SV Josko Rie,4707,10,9,4,23,28,53,-25,31
FC Salzburg,4708,1,19,9,8,65,33,32,66
SC Rheindorf,4708,2,19,7,10,56,40,16,64
SK Sturm Gra,4708,3,19,5,12,52,33,19,62
Rapid Vienna,4708,4,16,13,7,59,37,22,61
Vienna,4708,5,18,5,13,53,47,6,59
Admira Wacke,4708,6,13,8,15,42,53,-11,47
RZ Pellets W,4708,7,10,10,16,41,53,-12,40
SV Josko Rie,4708,8,10,6,20,36,55,-19,36
Mattersburg,4708,9,8,9,19,35,61,-26,33
St. Pölten,4708,10,6,12,18,42,69,-27,30
SC Rheindorf,4709,1,20,8,8,54,34,20,68
FC Salzburg,4709,2,19,8,9,57,29,28,65
Vienna,4709,3,18,9,9,58,45,13,63
SK Sturm Gra,4709,4,16,8,12,50,37,13,56
Rapid Vienna,4709,5,12,11,13,56,52,4,47
RZ Pellets W,4709,6,12,8,16,47,53,-6,44
SV Josko Rie,4709,7,12,7,17,37,49,-12,43
Admira Wacke,4709,8,11,8,17,36,58,-22,41
St. Pölten,4709,9,11,7,18,40,60,-20,40
Mattersburg,4709,10,6,12,18,35,53,-18,30
SC Rheindorf,4710,1,21,7,8,64,40,24,70
FC Salzburg,4710,2,18,10,8,66,36,30,64
Vienna,4710,3,18,7,11,65,50,15,61
SK Sturm Gra,4710,4,16,8,12,62,46,16,56
Rapid Vienna,4710,5,15,11,10,51,36,15,56
Admira Wacke,4710,6,13,9,14,42,52,-10,48
SV Josko Rie,4710,7,13,4,19,40,55,-15,43
RZ Pellets W,4710,8,12,6,18,48,62,-14,42
St. Pölten,4710,9,8,8,20,40,74,-34,32
Mattersburg,4710,10,7,8,21,33,60,-27,29
FC Salzburg,4711,1,21,8,7,74,36,38,71
SC Rheindorf,4711,2,21,7,8,60,42,18,70
SK Sturm Gra,4711,3,18,5,13,56,41,15,59
Rapid Vienna,4711,4,15,10,11,62,42,20,55
Vienna,4711,5,16,5,15,59,59,0,53
St. Pölten,4711,6,12,9,15,49,66,-17,45
RZ Pellets W,4711,7,12,6,18,53,54,-1,42
SV Josko Rie,4711,8,12,5,19,37,52,-15,41
Admira Wacke,4711,9,10,6,20,36,70,-34,36
Mattersburg,4711,10,8,9,19,35,59,-24,33
SK Sturm Gra,4712,1,22,6,8,66,28,38,72
FC Salzburg,4712,2,21,7,8,60,28,32,70
Vienna,4712,3,20,6,10,64,43,21,66
SC Rheindorf,4712,4,19,8,9,55,40,15,65
Rapid Vienna,4712,5,13,10,13,56,45,11,49
Admira Wacke,4712,6,12,9,15,35,49,-14,45
SV Josko Rie,4712,7,12,3,21,38,60,-22,39
RZ Pellets W,4712,8,10,6,20,37,63,-26,36
St. Pölten,4712,9,9,8,19,40,66,-26,35
Mattersburg,4712,10,6,9,21,28,57,-29,27
SK Sturm Gra,4713,1,23,6,7,66,29,37,75
Vienna,4713,2,21,5,10,65,45,20,68
SC Rheindorf,4713,3,17,12,7,57,47,10,63
FC Salzburg,4713,4,17,9,10,63,35,28,60
Rapid Vienna,4713,5,12,13,11,54,41,13,49
SV Josko Rie,4713,6,12,5,19,37,53,-16,41
RZ Pellets W,4713,7,11,7,18,39,57,-18,40
Mattersburg,4713,8,10,8,18,39,60,-21,38
Admira Wacke,4713,9,8,9,19,37,66,-29,33
St. Pölten,4713,10,6,12,18,40,64,-24,30
SC Rheindorf,4714,1,21,8,7,61,35,26,71
FC Salzburg,4714,2,20,10,6,64,30,34,70
SK Sturm Gra,4714,3,20,6,10,57,32,25,66
Vienna,4714,4,16,6,14,56,53,3,54
Rapid Vienna,4714,5,13,11,12,55,42,13,50
SV Josko Rie,4714,6,14,3,19,42,53,-11,45
RZ Pellets W,4714,7,11,8,17,43,56,-13,41
St. Pölten,4714,8,10,8,18,40,59,-19,38
Mattersburg,4714,9,10,8,18,39,63,-24,38
Admira Wacke,4714,10,8,6,22,30,64,-34,30
SC Rheindorf,4715,1,21,6,9,60,41,19,69
Vienna,4715,2,20,7,9,64,44,20,67
FC Salzburg,4715,3,18,8,10,61,35,26,62
SK Sturm Gra,4715,4,18,5,13,54,36,18,59
Rapid Vienna,4715,5,15,11,10,57,38,19,56
Admira Wacke,4715,6,15,5,16,38,51,-13,50
RZ Pellets W,4715,7,10,8,18,38,59,-21,38
Mattersburg,4715,8,9,8,19,37,56,-19,35
St. Pölten,4715,9,9,8,19,43,68,-25,35
SV Josko Rie,4715,10,9,6,21,30,54,-24,33
SC Rheindorf,4716,1,21,9,6,60,40,20,72
FC Salzburg,4716,2,19,8,9,74,39,35,65
SK Sturm Gra,4716,3,18,9,9,55,37,18,63
Rapid Vienna,4716,4,13,11,12,60,44,16,50
Vienna,4716,5,14,8,14,57,53,4,50
SV Josko Rie,4716,6,12,6,18,40,51,-11,42
Admira Wacke,4716,7,12,6,18,38,62,-24,42
Mattersburg,4716,8,11,7,18,42,56,-14,40
RZ Pellets W,4716,9,10,8,18,37,55,-18,38
St. Pölten,4716,10,9,10,17,38,64,-26,37
SK Sturm Gra,4717,1,20,5,11,57,38,19,65
SC Rheindorf,4717,2,19,8,9,56,39,17,65
FC Salzburg,4717,3,19,7,10,69,41,28,64
Vienna,4717,4,19,4,13,71,53,18,61
Rapid Vienna,4717,5,15,7,14,58,48,10,52
St. Pölten,4717,6,12,9,15,48,62,-14,45
RZ Pellets W,4717,7,12,5,19,45,57,-12,41
SV Josko Rie,4717,8,12,4,20,34,55,-21,40
Admira Wacke,4717,9,11,6,19,41,72,-31,39
Mattersburg,4717,10,9,9,18,43,57,-14,36
FC Salzburg,4718,1,20,8,8,67,36,31,68
SC Rheindorf,4718,2,19,9,8,66,43,23,66
SK Sturm Gra,4718,3,18,8,10,56,34,22,62
Vienna,4718,4,18,5,13,59,52,7,59
Rapid Vienna,4718,5,15,11,10,56,37,19,56
RZ Pellets W,4718,6,14,8,14,46,47,-1,50
Admira Wacke,4718,7,11,6,19,35,64,-29,39
SV Josko Rie,4718,8,11,5,20,35,56,-21,38
Mattersburg,4718,9,7,11,18,35,60,-25,32
St. Pölten,4718,10,5,13,18,40,66,-26,28
SK Sturm Gra,4719,1,22,6,8,57,26,31,72
Vienna,4719,2,21,4,11,75,53,22,67
FC Salzburg,4719,3,19,9,8,62,33,29,66
SC Rheindorf,4719,4,18,4,14,52,42,10,58
Rapid Vienna,4719,5,11,13,12,51,50,1,46
RZ Pellets W,4719,6,13,7,16,48,54,-6,46
SV Josko Rie,4719,7,12,4,20,41,67,-26,40
St. Pölten,4719,8,10,8,18,42,63,-21,38
Admira Wacke,4719,9,10,7,19,36,59,-23,37
Mattersburg,4719,10,9,8,19,40,57,-17,35
SK Sturm Gra,4720,1,20,7,9,62,36,26,67
SC Rheindorf,4720,2,19,8,9,56,40,16,65
Vienna,4720,3,18,6,12,60,52,8,60
FC Salzburg,4720,4,17,8,11,55,30,25,59
Rapid Vienna,4720,5,14,11,11,56,38,18,53
Mattersburg,4720,6,12,8,16,43,52,-9,44
RZ Pellets W,4720,7,12,6,18,46,60,-14,42
Admira Wacke,4720,8,11,8,17,35,58,-23,41
SV Josko Rie,4720,9,11,4,21,27,53,-26,37
St. Pölten,4720,10,7,12,17,40,61,-21,33
FC Salzburg,4721,1,20,9,7,69,32,37,69
SC Rheindorf,4721,2,20,9,7,55,39,16,69
SK Sturm Gra,4721,3,17,8,11,57,43,14,59
Rapid Vienna,4721,4,16,10,10,63,42,21,58
Vienna,4721,5,17,6,13,65,51,14,57
RZ Pellets W,4721,6,14,6,16,46,54,-8,48
Admira Wacke,4721,7,11,8,17,38,57,-19,41
SV Josko Rie,4721,8,11,5,20,34,55,-21,38
Mattersburg,4721,9,7,11,18,35,60,-25,32
St. Pölten,4721,10,7,8,21,35,64,-29,29
SC Rheindorf,4722,1,19,8,9,52,41,11,65
FC Salzburg,4722,2,19,6,11,57,39,18,63
Vienna,4722,3,19,3,14,69,57,12,60
SK Sturm Gra,4722,4,18,4,14,56,35,21,58
Rapid Vienna,4722,5,14,10,12,57,48,9,52
Mattersburg,4722,6,13,7,16,47,51,-4,46
RZ Pellets W,4722,7,13,7,16,46,52,-6,46
Admira Wacke,4722,8,11,8,17,36,59,-23,41
St. Pölten,4722,9,10,9,17,40,61,-21,39
SV Josko Rie,4722,10,9,8,19,37,54,-17,35
FC Salzburg,4723,1,23,7,6,66,24,42,76
SC Rheindorf,4723,2,21,8,7,57,36,21,71
Vienna,4723,3,18,6,12,67,54,13,60
SK Sturm Gra,4723,4,18,5,13,57,40,17,59
Admira Wacke,4723,5,15,7,14,40,51,-11,52
Rapid Vienna,4723,6,13,12,11,53,39,14,51
RZ Pellets W,4723,7,12,7,17,44,51,-7,43
SV Josko Rie,4723,8,9,4,23,30,59,-29,31
St. Pölten,4723,9,7,9,20,36,65,-29,30
Mattersburg,4723,10,7,9,20,29,60,-31,30
FC Salzburg,4724,1,20,9,7,63,32,31,69
SC Rheindorf,4724,2,19,7,10,51,43,8,64
Vienna,4724,3,20,3,13,63,50,13,63
SK Sturm Gra,4724,4,17,9,10,54,33,21,60
Rapid Vienna,4724,5,14,10,12,55,39,16,52
St. Pölten,4724,6,11,10,15,43,59,-16,43
SV Josko Rie,4724,7,12,5,19,35,48,-13,41
Admira Wacke,4724,8,11,6,19,38,61,-23,39
RZ Pellets W,4724,9,10,8,18,45,58,-13,38
Mattersburg,4724,10,9,7,20,33,57,-24,34
SC Rheindorf,4725,1,21,9,6,61,38,23,72
FC Salzburg,4725,2,18,10,8,65,34,31,64
Rapid Vienna,4725,3,18,9,9,59,33,26,63
SK Sturm Gra,4725,4,17,9,10,58,38,20,60
Vienna,4725,5,16,6,14,65,65,0,54
Admira Wacke,4725,6,12,7,17,39,68,-29,43
RZ Pellets W,4725,7,12,6,18,48,59,-11,42
Mattersburg,4725,8,9,9,18,37,57,-20,36
St. Pölten,4725,9,9,8,19,45,65,-20,35
SV Josko Rie,4725,10,10,3,23,35,55,-20,33
Vienna,4726,1,22,4,10,68,45,23,70
SC Rheindorf,4726,2,19,9,8,56,40,16,66
SK Sturm Gra,4726,3,18,7,11,56,36,20,61
FC Salzburg,4726,4,17,9,10,56,32,24,60
Rapid Vienna,4726,5,15,9,12,53,40,13,54
RZ Pellets W,4726,6,12,9,15,47,50,-3,45
SV Josko Rie,4726,7,10,8,18,34,57,-23,38
St. Pölten,4726,8,9,9,18,50,70,-20,36
Admira Wacke,4726,9,10,6,20,28,57,-29,36
Mattersburg,4726,10,8,10,18,34,55,-21,34
SK Sturm Gra,4727,1,23,4,9,73,35,38,73
SC Rheindorf,4727,2,19,10,7,59,41,18,67
FC Salzburg,4727,3,18,9,9,59,34,25,63
Vienna,4727,4,19,4,13,62,57,5,61
Rapid Vienna,4727,5,12,11,13,52,45,7,47
SV Josko Rie,4727,6,13,4,19,38,49,-11,43
RZ Pellets W,4727,7,11,9,16,48,58,-10,42
Admira Wacke,4727,8,11,5,20,37,68,-31,38
Mattersburg,4727,9,9,9,18,41,59,-18,36
St. Pölten,4727,10,8,9,19,50,73,-23,33
FC Salzburg,4728,1,22,6,8,61,30,31,72
SC Rheindorf,4728,2,19,8,9,57,37,20,65
SK Sturm Gra,4728,3,18,7,11,47,28,19,61
Vienna,4728,4,18,6,12,58,47,11,60
Rapid Vienna,4728,5,13,12,11,55,39,16,51
RZ Pellets W,4728,6,13,10,13,43,53,-10,49
SV Josko Rie,4728,7,13,6,17,37,53,-16,45
Admira Wacke,4728,8,11,8,17,36,54,-18,41
St. Pölten,4728,9,6,10,20,38,65,-27,28
Mattersburg,4728,10,6,9,21,34,60,-26,27
FC Salzburg,4729,1,21,9,6,63,26,37,72
SC Rheindorf,4729,2,18,10,8,52,42,10,64
SK Sturm Gra,4729,3,18,9,9,56,33,23,63
Vienna,4729,4,18,6,12,61,48,13,60
Rapid Vienna,4729,5,15,8,13,58,43,15,53
Admira Wacke,4729,6,13,7,16,41,57,-16,46
RZ Pellets W,4729,7,13,6,17,46,55,-9,45
Mattersburg,4729,8,10,7,19,43,57,-14,37
SV Josko Rie,4729,9,9,6,21,39,64,-25,33
St. Pölten,4729,10,6,10,20,35,69,-34,28
FC Salzburg,4730,1,21,9,6,74,36,38,72
SC Rheindorf,4730,2,19,8,9,54,43,11,65
SK Sturm Gra,4730,3,19,7,10,60,34,26,64
Vienna,4730,4,18,8,10,61,47,14,62
RZ Pellets W,4730,5,13,10,13,51,50,1,49
Rapid Vienna,4730,6,11,11,14,51,49,2,44
SV Josko Rie,4730,7,12,6,18,41,55,-14,42
Admira Wacke,4730,8,10,8,18,29,55,-26,38
St. Pölten,4730,9,8,9,19,40,65,-25,33
Mattersburg,4730,10,7,8,21,37,64,-27,29
FC Salzburg,4731,1,21,6,9,65,32,33,69
SK Sturm Gra,4731,2,21,6,9,60,29,31,69
Rapid Vienna,4731,3,19,9,8,59,33,26,66
Vienna,4731,4,20,4,12,66,53,13,64
SC Rheindorf,4731,5,19,6,11,48,41,7,63
RZ Pellets W,4731,6,12,8,16,39,48,-9,44
Admira Wacke,4731,7,10,7,19,34,57,-23,37
SV Josko Rie,4731,8,10,4,22,32,55,-23,34
St. Pölten,4731,9,8,7,21,35,68,-33,31
Mattersburg,4731,10,7,9,20,34,56,-22,30
FC Salzburg,4732,1,22,7,7,67,29,38,73
SC Rheindorf,4732,2,19,6,11,57,50,7,63
Rapid Vienna,4732,3,18,8,10,64,36,28,62
SK Sturm Gra,4732,4,19,4,13,59,43,16,61
Vienna,4732,5,18,3,15,58,52,6,57
Mattersburg,4732,6,11,9,16,43,54,-11,42
Admira Wacke,4732,7,11,9,16,35,57,-22,42
RZ Pellets W,4732,8,11,8,17,44,55,-11,41
St. Pölten,4732,9,8,9,19,42,66,-24,33
SV Josko Rie,4732,10,9,5,22,37,64,-27,32
FC Salzburg,4733,1,22,8,6,62,26,36,74
Vienna,4733,2,19,6,11,64,50,14,63
SK Sturm Gra,4733,3,18,7,11,59,38,21,61
SC Rheindorf,4733,4,17,9,10,52,42,10,60
Rapid Vienna,4733,5,13,10,13,55,44,11,49
RZ Pellets W,4733,6,14,6,16,48,62,-14,48
Mattersburg,4733,7,10,8,18,38,53,-15,38
SV Josko Rie,4733,8,11,5,20,31,53,-22,38
St. Pölten,4733,9,8,12,16,42,60,-18,36
Admira Wacke,4733,10,10,5,21,32,55,-23,35
FC Salzburg,4734,1,23,6,7,67,31,36,75
SC Rheindorf,4734,2,22,6,8,63,44,19,72
SK Sturm Gra,4734,3,18,6,12,56,32,24,60
Vienna,4734,4,18,5,13,60,48,12,59
Rapid Vienna,4734,5,15,10,11,55,40,15,55
Admira Wacke,4734,6,14,5,17,43,59,-16,47
RZ Pellets W,4734,7,13,4,19,45,62,-17,43
Mattersburg,4734,8,9,8,19,42,62,-20,35
St. Pölten,4734,9,9,7,20,37,61,-24,34
SV Josko Rie,4734,10,8,5,23,31,60,-29,29
FC Salzburg,4735,1,23,6,7,74,30,44,75
SC Rheindorf,4735,2,19,9,8,58,39,19,66
SK Sturm Gra,4735,3,18,9,9,58,33,25,63
Vienna,4735,4,17,6,13,60,58,2,57
Rapid Vienna,4735,5,12,10,14,51,45,6,46
RZ Pellets W,4735,6,13,7,16,53,56,-3,46
SV Josko Rie,4735,7,11,9,16,38,53,-15,42
Admira Wacke,4735,8,12,4,20,36,67,-31,40
Mattersburg,4735,9,9,8,19,41,65,-24,35
St. Pölten,4735,10,6,12,18,41,64,-23,30
FC Salzburg,4736,1,21,7,8,73,32,41,70
SC Rheindorf,4736,2,19,7,10,52,41,11,64
SK Sturm Gra,4736,3,19,5,12,64,41,23,62
Vienna,4736,4,17,5,14,63,55,8,56
Rapid Vienna,4736,5,14,10,12,53,38,15,52
RZ Pellets W,4736,6,13,6,17,48,60,-12,45
Admira Wacke,4736,7,11,9,16,34,61,-27,42
St. Pölten,4736,8,10,9,17,44,57,-13,39
Mattersburg,4736,9,10,7,19,34,62,-28,37
SV Josko Rie,4736,10,9,9,18,31,49,-18,36
FC Salzburg,4737,1,21,7,8,69,34,35,70
SK Sturm Gra,4737,2,19,9,8,56,31,25,66
SC Rheindorf,4737,3,19,9,8,58,42,16,66
Vienna,4737,4,18,5,13,67,56,11,59
Rapid Vienna,4737,5,15,9,12,51,37,14,54
RZ Pellets W,4737,6,11,8,17,43,58,-15,41
SV Josko Rie,4737,7,12,5,19,40,59,-19,41
Admira Wacke,4737,8,11,6,19,33,59,-26,39
St. Pölten,4737,9,9,8,19,37,60,-23,35
Mattersburg,4737,10,8,8,20,38,56,-18,32
SK Sturm Gra,4738,1,21,5,10,60,35,25,68
Vienna,4738,2,21,3,12,65,50,15,66
FC Salzburg,4738,3,19,8,9,61,33,28,65
SC Rheindorf,4738,4,19,6,11,59,42,17,63
Rapid Vienna,4738,5,11,11,14,54,42,12,44
SV Josko Rie,4738,6,13,4,19,39,53,-14,43
RZ Pellets W,4738,7,12,7,17,43,58,-15,43
St. Pölten,4738,8,11,8,17,42,58,-16,41
Admira Wacke,4738,9,12,4,20,40,69,-29,40
Mattersburg,4738,10,10,6,20,35,58,-23,36
FC Salzburg,4739,1,22,6,8,62,28,34,72
Vienna,4739,2,20,6,10,65,45,20,66
SC Rheindorf,4739,3,19,8,9,52,42,10,65
SK Sturm Gra,4739,4,19,6,11,56,37,19,63
Rapid Vienna,4739,5,15,8,13,53,44,9,53
RZ Pellets W,4739,6,12,9,15,49,55,-6,45
Mattersburg,4739,7,12,8,16,41,49,-8,44
SV Josko Rie,4739,8,11,3,22,33,55,-22,36
Admira Wacke,4739,9,9,5,22,31,61,-30,32
St. Pölten,4739,10,7,9,20,42,68,-26,30
FC Salzburg,4740,1,21,6,9,67,34,33,69
SC Rheindorf,4740,2,20,6,10,69,47,22,66
Vienna,4740,3,20,5,11,61,56,5,65
SK Sturm Gra,4740,4,18,7,11,54,32,22,61
Rapid Vienna,4740,5,15,10,11,53,37,16,55
Admira Wacke,4740,6,13,6,17,41,60,-19,45
RZ Pellets W,4740,7,11,6,19,41,51,-10,39
SV Josko Rie,4740,8,11,6,19,40,56,-16,39
St. Pölten,4740,9,11,6,19,36,57,-21,39
Mattersburg,4740,10,7,8,21,34,66,-32,29
FC Salzburg,4741,1,23,7,6,71,28,43,76
SK Sturm Gra,4741,2,18,9,9,61,33,28,63
Rapid Vienna,4741,3,16,12,8,56,36,20,60
Vienna,4741,4,16,8,12,68,60,8,56
SC Rheindorf,4741,5,15,11,10,50,48,2,56
RZ Pellets W,4741,6,11,12,13,47,54,-7,45
SV Josko Rie,4741,7,12,6,18,38,52,-14,42
Admira Wacke,4741,8,10,7,19,35,59,-24,37
Mattersburg,4741,9,7,11,18,38,62,-24,32
St. Pölten,4741,10,4,13,19,35,67,-32,25
SC Rheindorf,4742,1,20,5,11,53,45,8,65
FC Salzburg,4742,2,19,7,10,67,40,27,64
SK Sturm Gra,4742,3,18,8,10,60,33,27,62
Vienna,4742,4,17,8,11,66,54,12,59
Rapid Vienna,4742,5,14,11,11,52,38,14,53
RZ Pellets W,4742,6,13,8,15,51,57,-6,47
St. Pölten,4742,7,12,9,15,52,59,-7,45
Admira Wacke,4742,8,13,6,17,45,68,-23,45
SV Josko Rie,4742,9,8,8,20,32,56,-24,32
Mattersburg,4742,10,6,10,20,33,61,-28,28
SC Rheindorf,4743,1,21,7,8,58,38,20,70
FC Salzburg,4743,2,20,7,9,61,30,31,67
SK Sturm Gra,4743,3,21,4,11,59,32,27,67
Rapid Vienna,4743,4,16,10,10,62,37,25,58
Vienna,4743,5,17,5,14,51,54,-3,56
RZ Pellets W,4743,6,12,9,15,47,56,-9,45
Admira Wacke,4743,7,9,9,18,34,61,-27,36
SV Josko Rie,4743,8,10,5,21,32,54,-22,35
St. Pölten,4743,9,8,10,18,45,66,-21,34
Mattersburg,4743,10,8,10,18,35,56,-21,34
SC Rheindorf,4744,1,21,9,6,55,36,19,72
FC Salzburg,4744,2,20,10,6,63,27,36,70
SK Sturm Gra,4744,3,18,7,11,57,39,18,61
Vienna,4744,4,17,6,13,56,56,0,57
Rapid Vienna,4744,5,15,11,10,65,41,24,56
RZ Pellets W,4744,6,14,7,15,47,63,-16,49
Admira Wacke,4744,7,11,7,18,34,52,-18,40
St. Pölten,4744,8,9,9,18,41,55,-14,36
Mattersburg,4744,9,8,9,19,32,49,-17,33
SV Josko Rie,4744,10,7,5,24,26,58,-32,26
FC Salzburg,4745,1,20,8,8,64,29,35,68
SK Sturm Gra,4745,2,19,5,12,59,39,20,62
SC Rheindorf,4745,3,18,6,12,50,45,5,60
Vienna,4745,4,17,5,14,60,58,2,56
Rapid Vienna,4745,5,14,9,13,54,40,14,51
RZ Pellets W,4745,6,13,6,17,44,53,-9,45
Admira Wacke,4745,7,13,6,17,40,61,-21,45
SV Josko Rie,4745,8,13,4,19,35,50,-15,43
Mattersburg,4745,9,10,9,17,42,54,-12,39
St. Pölten,4745,10,10,8,18,45,64,-19,38
SC Rheindorf,4746,1,20,9,7,55,36,19,69
FC Salzburg,4746,2,19,11,6,62,30,32,68
SK Sturm Gra,4746,3,19,6,11,60,34,26,63
Rapid Vienna,4746,4,15,11,10,57,41,16,56
Vienna,4746,5,18,2,16,55,52,3,56
Admira Wacke,4746,6,12,7,17,39,59,-20,43
RZ Pellets W,4746,7,11,7,18,43,55,-12,40
SV Josko Rie,4746,8,11,7,18,36,51,-15,40
St. Pölten,4746,9,8,10,18,39,64,-25,34
Mattersburg,4746,10,7,10,19,36,60,-24,31
FC Salzburg,4747,1,21,7,8,73,40,33,70
SC Rheindorf,4747,2,20,7,9,58,44,14,67
SK Sturm Gra,4747,3,20,6,10,62,32,30,66
Vienna,4747,4,19,5,12,61,53,8,62
RZ Pellets W,4747,5,15,6,15,48,52,-4,51
Rapid Vienna,4747,6,13,10,13,50,39,11,49
Mattersburg,4747,7,12,7,17,37,50,-13,43
Admira Wacke,4747,8,10,8,18,37,59,-22,38
SV Josko Rie,4747,9,10,5,21,30,52,-22,35
St. Pölten,4747,10,6,7,23,33,68,-35,25
FC Salzburg,4748,1,23,6,7,75,31,44,75
Vienna,4748,2,21,5,10,65,49,16,68
SK Sturm Gra,4748,3,19,5,12,59,44,15,62
SC Rheindorf,4748,4,18,7,11,57,41,16,61
Rapid Vienna,4748,5,14,10,12,54,41,13,52
RZ Pellets W,4748,6,11,9,16,40,58,-18,42
SV Josko Rie,4748,7,12,5,19,37,50,-13,41
Admira Wacke,4748,8,12,4,20,36,60,-24,40
St. Pölten,4748,9,9,7,20,42,69,-27,34
Mattersburg,4748,10,7,10,19,32,54,-22,31
FC Salzburg,4749,1,21,9,6,68,35,33,72
SK Sturm Gra,4749,2,20,6,10,65,38,27,66
Vienna,4749,3,17,6,13,63,59,4,57
SC Rheindorf,4749,4,15,9,12,52,50,2,54
Rapid Vienna,4749,5,13,11,12,57,46,11,50
RZ Pellets W,4749,6,14,7,15,51,55,-4,49
St. Pölten,4749,7,10,10,16,54,68,-14,40
SV Josko Rie,4749,8,10,9,17,48,61,-13,39
Admira Wacke,4749,9,10,7,19,38,65,-27,37
Mattersburg,4749,10,7,12,17,38,57,-19,33
SC Rheindorf,4750,1,20,8,8,54,36,18,68
FC Salzburg,4750,2,19,9,8,59,26,33,66
Vienna,4750,3,19,3,14,64,58,6,60
SK Sturm Gra,4750,4,17,8,11,53,32,21,59
Rapid Vienna,4750,5,11,15,10,49,38,11,48
RZ Pellets W,4750,6,13,9,14,47,49,-2,48
Mattersburg,4750,7,10,9,17,41,52,-11,39
SV Josko Rie,4750,8,10,8,18,35,56,-21,38
Admira Wacke,4750,9,10,7,19,32,64,-32,37
St. Pölten,4750,10,9,8,19,37,60,-23,35
FC Salzburg,4751,1,23,7,6,74,27,47,76
SC Rheindorf,4751,2,20,7,9,54,38,16,67
Vienna,4751,3,18,7,11,60,51,9,61
Rapid Vienna,4751,4,15,11,10,59,39,20,56
SK Sturm Gra,4751,5,16,5,15,56,42,14,53
RZ Pellets W,4751,6,13,7,16,43,55,-12,46
SV Josko Rie,4751,7,11,5,20,34,55,-21,38
Admira Wacke,4751,8,11,5,20,36,64,-28,38
St. Pölten,4751,9,9,10,17,38,60,-22,37
Mattersburg,4751,10,8,8,20,33,56,-23,32
FC Salzburg,4752,1,21,8,7,66,26,40,71
Vienna,4752,2,20,5,11,60,47,13,65
SC Rheindorf,4752,3,19,6,11,49,41,8,63
SK Sturm Gra,4752,4,17,6,13,52,34,18,57
Rapid Vienna,4752,5,15,10,11,57,38,19,55
St. Pölten,4752,6,11,10,15,42,60,-18,43
RZ Pellets W,4752,7,12,5,19,47,60,-13,41
Admira Wacke,4752,8,11,8,17,37,61,-24,41
Mattersburg,4752,9,9,10,17,42,58,-16,37
SV Josko Rie,4752,10,8,6,22,31,58,-27,30
FC Salzburg,4753,1,22,6,8,60,30,30,72
SC Rheindorf,4753,2,21,7,8,56,40,16,70
SK Sturm Gra,4753,3,17,10,9,59,39,20,61
Vienna,4753,4,17,4,15,59,53,6,55
RZ Pellets W,4753,5,14,8,14,45,52,-7,50
Rapid Vienna,4753,6,13,10,13,58,44,14,49
Admira Wacke,4753,7,13,3,20,39,57,-18,42
Mattersburg,4753,8,11,7,18,40,53,-13,40
SV Josko Rie,4753,9,9,6,21,33,58,-25,33
St. Pölten,4753,10,7,11,18,43,66,-23,32
SC Rheindorf,4754,1,21,6,9,59,42,17,69
FC Salzburg,4754,2,19,10,7,76,32,44,67
SK Sturm Gra,4754,3,19,6,11,59,39,20,63
Vienna,4754,4,19,6,11,68,58,10,63
Rapid Vienna,4754,5,16,11,9,65,41,24,59
RZ Pellets W,4754,6,11,7,18,52,63,-11,40
Mattersburg,4754,7,10,10,16,44,56,-12,40
Admira Wacke,4754,8,10,8,18,31,60,-29,38
St. Pölten,4754,9,7,10,19,41,68,-27,31
SV Josko Rie,4754,10,8,6,22,27,63,-36,30
FC Salzburg,4755,1,20,8,8,63,33,30,68
SC Rheindorf,4755,2,20,8,8,55,40,15,68
SK Sturm Gra,4755,3,18,11,7,55,28,27,65
Rapid Vienna,4755,4,16,10,10,57,38,19,58
Vienna,4755,5,16,6,14,58,57,1,54
Admira Wacke,4755,6,12,10,14,40,48,-8,46
RZ Pellets W,4755,7,11,9,16,45,54,-9,42
Mattersburg,4755,8,8,10,18,35,54,-19,34
SV Josko Rie,4755,9,8,8,20,32,56,-24,32
St. Pölten,4755,10,6,10,20,34,66,-32,28
FC Salzburg,4756,1,19,9,8,68,35,33,66
SK Sturm Gra,4756,2,19,7,10,62,35,27,64
Vienna,4756,3,20,4,12,64,55,9,64
SC Rheindorf,4756,4,18,9,9,54,43,11,63
Rapid Vienna,4756,5,14,10,12,55,39,16,52
RZ Pellets W,4756,6,13,6,17,46,56,-10,45
Admira Wacke,4756,7,12,7,17,44,62,-18,43
Mattersburg,4756,8,9,10,17,43,56,-13,37
SV Josko Rie,4756,9,11,4,21,30,56,-26,37
St. Pölten,4756,10,7,10,19,37,66,-29,31
FC Salzburg,4757,1,24,5,7,73,33,40,77
SC Rheindorf,4757,2,21,7,8,56,36,20,70
Vienna,4757,3,22,2,12,66,46,20,68
SK Sturm Gra,4757,4,21,3,12,60,40,20,66
RZ Pellets W,4757,5,15,4,17,48,51,-3,49
Rapid Vienna,4757,6,12,11,13,48,40,8,47
Admira Wacke,4757,7,11,6,19,40,64,-24,39
Mattersburg,4757,8,9,8,19,39,62,-23,35
SV Josko Rie,4757,9,9,4,23,29,57,-28,31
St. Pölten,4757,10,7,8,21,34,64,-30,29
FC Salzburg,4758,1,19,11,6,70,38,32,68
SC Rheindorf,4758,2,20,6,10,61,47,14,66
Vienna,4758,3,21,3,12,62,50,12,66
SK Sturm Gra,4758,4,18,7,11,53,29,24,61
Rapid Vienna,4758,5,16,12,8,62,38,24,60
Admira Wacke,4758,6,13,7,16,38,55,-17,46
RZ Pellets W,4758,7,10,7,19,36,58,-22,37
SV Josko Rie,4758,8,10,5,21,35,53,-18,35
St. Pölten,4758,9,9,7,20,38,63,-25,34
Mattersburg,4758,10,8,7,21,37,61,-24,31
SC Rheindorf,4759,1,23,7,6,68,41,27,76
FC Salzburg,4759,2,21,8,7,65,35,30,71
Vienna,4759,3,20,4,12,71,52,19,64
SK Sturm Gra,4759,4,19,6,11,52,32,20,63
Rapid Vienna,4759,5,13,11,12,52,41,11,50
SV Josko Rie,4759,6,11,6,19,34,50,-16,39
RZ Pellets W,4759,7,10,8,18,44,66,-22,38
Mattersburg,4759,8,10,6,20,43,65,-22,36
Admira Wacke,4759,9,10,6,20,36,60,-24,36
St. Pölten,4759,10,8,8,20,41,64,-23,32
FC Salzburg,4760,1,24,7,5,79,29,50,79
SK Sturm Gra,4760,2,22,4,10,65,32,33,70
SC Rheindorf,4760,3,19,7,10,49,42,7,64
Vienna,4760,4,19,3,14,63,55,8,60
RZ Pellets W,4760,5,12,10,14,46,55,-9,46
Rapid Vienna,4760,6,10,10,16,49,54,-5,40
SV Josko Rie,4760,7,10,7,19,34,48,-14,37
St. Pölten,4760,8,9,10,17,40,58,-18,37
Admira Wacke,4760,9,9,9,18,37,66,-29,36
Mattersburg,4760,10,7,11,18,33,56,-23,32
FC Salzburg,4761,1,22,7,7,71,34,37,73
SC Rheindorf,4761,2,20,5,11,57,45,12,65
SK Sturm Gra,4761,3,19,7,10,56,36,20,64
Vienna,4761,4,20,3,13,66,50,16,63
Rapid Vienna,4761,5,14,9,13,56,47,9,51
RZ Pellets W,4761,6,14,6,16,46,54,-8,48
St. Pölten,4761,7,11,9,16,49,60,-11,42
Admira Wacke,4761,8,12,5,19,37,60,-23,41
SV Josko Rie,4761,9,10,3,23,33,62,-29,33
Mattersburg,4761,10,8,6,22,37,60,-23,30
Vienna,4762,1,22,5,9,70,45,25,71
FC Salzburg,4762,2,21,7,8,68,30,38,70
SK Sturm Gra,4762,3,20,7,9,64,35,29,67
SC Rheindorf,4762,4,19,7,10,53,42,11,64
Rapid Vienna,4762,5,14,11,11,54,38,16,53
SV Josko Rie,4762,6,14,3,19,39,50,-11,45
Admira Wacke,4762,7,10,6,20,32,62,-30,36
RZ Pellets W,4762,8,8,10,18,39,64,-25,34
St. Pölten,4762,9,8,9,19,42,66,-24,33
Mattersburg,4762,10,7,9,20,33,62,-29,30
SC Rheindorf,4763,1,22,6,8,68,46,22,72
FC Salzburg,4763,2,20,8,8,70,35,35,68
SK Sturm Gra,4763,3,20,8,8,70,37,33,68
Vienna,4763,4,16,7,13,53,48,5,55
RZ Pellets W,4763,5,13,8,15,49,56,-7,47
Rapid Vienna,4763,6,9,14,13,53,53,0,41
St. Pölten,4763,7,10,11,15,41,60,-19,41
Admira Wacke,4763,8,10,10,16,38,60,-22,40
SV Josko Rie,4763,9,10,5,21,36,57,-21,35
Mattersburg,4763,10,8,7,21,35,61,-26,31
SC Rheindorf,4764,1,22,7,7,59,37,22,73
FC Salzburg,4764,2,19,8,9,65,37,28,65
SK Sturm Gra,4764,3,18,6,12,65,39,26,60
Vienna,4764,4,17,6,13,68,62,6,57
Rapid Vienna,4764,5,12,11,13,57,51,6,47
RZ Pellets W,4764,6,11,9,16,44,57,-13,42
Mattersburg,4764,7,10,11,15,37,49,-12,41
Admira Wacke,4764,8,11,8,17,39,61,-22,41
SV Josko Rie,4764,9,10,8,18,31,46,-15,38
St. Pölten,4764,10,9,8,19,42,68,-26,35
FC Salzburg,4765,1,22,7,7,72,33,39,73
Vienna,4765,2,22,6,8,71,46,25,72
SC Rheindorf,4765,3,16,8,12,56,44,12,56
SK Sturm Gra,4765,4,15,10,11,54,39,15,55
SV Josko Rie,4765,5,14,4,18,41,56,-15,46
Rapid Vienna,4765,6,11,11,14,49,56,-7,44
RZ Pellets W,4765,7,12,7,17,45,52,-7,43
St. Pölten,4765,8,9,11,16,42,62,-20,38
Mattersburg,4765,9,9,10,17,38,54,-16,37
Admira Wacke,4765,10,10,6,20,42,68,-26,36
Vienna,4766,1,22,6,8,75,49,26,72
FC Salzburg,4766,2,18,11,7,64,32,32,65
SC Rheindorf,4766,3,17,12,7,54,42,12,63
SK Sturm Gra,4766,4,17,9,10,55,35,20,60
Rapid Vienna,4766,5,13,12,11,58,45,13,51
RZ Pellets W,4766,6,12,9,15,43,54,-11,45
St. Pölten,4766,7,10,9,17,48,61,-13,39
Admira Wacke,4766,8,11,4,21,37,63,-26,37
SV Josko Rie,4766,9,9,8,19,27,52,-25,35
Mattersburg,4766,10,6,10,20,31,59,-28,28
FC Salzburg,4767,1,21,7,8,67,30,37,70
SK Sturm Gra,4767,2,20,5,11,55,38,17,65
SC Rheindorf,4767,3,16,10,10,47,41,6,58
Vienna,4767,4,17,5,14,66,53,13,56
Rapid Vienna,4767,5,15,10,11,53,38,15,55
RZ Pellets W,4767,6,15,8,13,49,50,-1,53
Admira Wacke,4767,7,11,7,18,44,61,-17,40
St. Pölten,4767,8,10,10,16,43,62,-19,40
Mattersburg,4767,9,9,8,19,40,60,-20,35
SV Josko Rie,4767,10,8,6,22,34,65,-31,30
FC Salzburg,4768,1,21,6,9,68,32,36,69
Vienna,4768,2,20,4,12,71,50,21,64
SK Sturm Gra,4768,3,18,8,10,57,34,23,62
SC Rheindorf,4768,4,18,8,10,54,43,11,62
Rapid Vienna,4768,5,15,11,10,53,38,15,56
Admira Wacke,4768,6,13,7,16,47,60,-13,46
RZ Pellets W,4768,7,13,5,18,48,59,-11,44
Mattersburg,4768,8,9,8,19,38,60,-22,35
SV Josko Rie,4768,9,9,7,20,29,56,-27,34
St. Pölten,4768,10,7,10,19,37,70,-33,31
SC Rheindorf,4769,1,22,6,8,58,42,16,72
FC Salzburg,4769,2,20,10,6,63,25,38,70
SK Sturm Gra,4769,3,18,8,10,56,31,25,62
Rapid Vienna,4769,4,15,13,8,59,40,19,58
Vienna,4769,5,15,5,16,57,56,1,50
Admira Wacke,4769,6,14,7,15,45,60,-15,49
RZ Pellets W,4769,7,13,7,16,55,61,-6,46
Mattersburg,4769,8,9,8,19,44,58,-14,35
SV Josko Rie,4769,9,9,5,22,30,61,-31,32
St. Pölten,4769,10,6,9,21,48,81,-33,27
SK Sturm Gra,4770,1,19,9,8,64,32,32,66
FC Salzburg,4770,2,18,10,8,60,31,29,64
Rapid Vienna,4770,3,15,12,9,59,39,20,57
Vienna,4770,4,16,9,11,61,48,13,57
SC Rheindorf,4770,5,15,12,9,47,43,4,57
RZ Pellets W,4770,6,13,8,15,46,53,-7,47
Mattersburg,4770,7,10,10,16,37,52,-15,40
Admira Wacke,4770,8,9,9,18,39,67,-28,36
St. Pölten,4770,9,8,11,17,37,57,-20,35
SV Josko Rie,4770,10,9,6,21,35,63,-28,33
FC Salzburg,4771,1,22,5,9,66,29,37,71
SK Sturm Gra,4771,2,21,4,11,55,32,23,67
Vienna,4771,3,19,5,12,59,50,9,62
SC Rheindorf,4771,4,19,5,12,58,55,3,62
Rapid Vienna,4771,5,14,11,11,59,42,17,53
RZ Pellets W,4771,6,12,9,15,47,51,-4,45
Admira Wacke,4771,7,11,7,18,35,55,-20,40
Mattersburg,4771,8,11,6,19,38,51,-13,39
SV Josko Rie,4771,9,11,5,20,37,56,-19,38
St. Pölten,4771,10,8,7,21,47,80,-33,31
FC Salzburg,4772,1,22,7,7,65,34,31,73
SK Sturm Gra,4772,2,21,8,7,66,33,33,71
SC Rheindorf,4772,3,19,10,7,57,39,18,67
Vienna,4772,4,19,6,11,67,53,14,63
Rapid Vienna,4772,5,14,8,14,50,38,12,50
RZ Pellets W,4772,6,10,9,17,42,58,-16,39
Admira Wacke,4772,7,10,8,18,39,62,-23,38
St. Pölten,4772,8,8,10,18,41,65,-24,34
Mattersburg,4772,9,8,9,19,31,52,-21,33
SV Josko Rie,4772,10,9,5,22,32,56,-24,32
FC Salzburg,4773,1,20,8,8,62,34,28,68
SC Rheindorf,4773,2,20,8,8,59,39,20,68
Vienna,4773,3,20,5,11,69,51,18,65
SK Sturm Gra,4773,4,18,7,11,58,34,24,61
Rapid Vienna,4773,5,14,13,9,59,43,16,55
Mattersburg,4773,6,12,6,18,41,53,-12,42
SV Josko Rie,4773,7,12,6,18,37,51,-14,42
Admira Wacke,4773,8,9,8,19,35,60,-25,35
RZ Pellets W,4773,9,9,7,20,40,64,-24,34
St. Pölten,4773,10,5,14,17,44,75,-31,29
SC Rheindorf,4774,1,20,8,8,54,33,21,68
FC Salzburg,4774,2,18,7,11,61,35,26,61
Vienna,4774,3,17,9,10,69,54,15,60
SK Sturm Gra,4774,4,17,8,11,58,41,17,59
Rapid Vienna,4774,5,17,8,11,54,40,14,59
RZ Pellets W,4774,6,14,5,17,52,60,-8,47
SV Josko Rie,4774,7,11,8,17,39,53,-14,41
Mattersburg,4774,8,10,8,18,34,54,-20,38
St. Pölten,4774,9,9,10,17,38,58,-20,37
Admira Wacke,4774,10,9,5,22,37,68,-31,32
FC Salzburg,4775,1,22,7,7,73,38,35,73
SC Rheindorf,4775,2,19,8,9,55,43,12,65
SK Sturm Gra,4775,3,17,9,10,59,35,24,60
Vienna,4775,4,17,8,11,67,52,15,59
Rapid Vienna,4775,5,15,10,11,68,47,21,55
Admira Wacke,4775,6,14,6,16,41,62,-21,48
RZ Pellets W,4775,7,13,7,16,52,56,-4,46
Mattersburg,4775,8,8,9,19,35,55,-20,33
SV Josko Rie,4775,9,9,5,22,36,67,-31,32
St. Pölten,4775,10,6,11,19,35,66,-31,29
FC Salzburg,4776,1,24,7,5,68,26,42,79
SC Rheindorf,4776,2,20,7,9,55,42,13,67
SK Sturm Gra,4776,3,17,9,10,58,38,20,60
Vienna,4776,4,18,6,12,66,49,17,60
Rapid Vienna,4776,5,15,11,10,65,44,21,56
RZ Pellets W,4776,6,12,10,14,44,57,-13,46
Admira Wacke,4776,7,10,7,19,35,59,-24,37
St. Pölten,4776,8,7,12,17,36,60,-24,33
Mattersburg,4776,9,7,9,20,36,62,-26,30
SV Josko Rie,4776,10,8,6,22,27,53,-26,30
FC Salzburg,4777,1,21,9,6,71,34,37,72
Vienna,4777,2,19,6,11,68,50,18,63
SK Sturm Gra,4777,3,18,8,10,63,40,23,62
SC Rheindorf,4777,4,18,5,13,54,52,2,59
Rapid Vienna,4777,5,13,12,11,50,34,16,51
Admira Wacke,4777,6,12,7,17,43,60,-17,43
Mattersburg,4777,7,10,11,15,42,52,-10,41
SV Josko Rie,4777,8,12,5,19,39,58,-19,41
RZ Pellets W,4777,9,9,8,19,47,69,-22,35
St. Pölten,4777,10,8,9,19,38,66,-28,33
FC Salzburg,4778,1,20,10,6,73,34,39,70
SK Sturm Gra,4778,2,20,7,9,60,29,31,67
SC Rheindorf,4778,3,20,7,9,53,38,15,67
Rapid Vienna,4778,4,16,9,11,64,43,21,57
Vienna,4778,5,16,7,13,56,55,1,55
RZ Pellets W,4778,6,13,7,16,42,51,-9,46
Admira Wacke,4778,7,11,8,17,35,64,-29,41
Mattersburg,4778,8,11,6,19,38,54,-16,39
SV Josko Rie,4778,9,11,3,22,40,60,-20,36
St. Pölten,4778,10,5,10,21,33,66,-33,25
SK Sturm Gra,4779,1,22,5,9,64,28,36,71
FC Salzburg,4779,2,21,6,9,62,28,34,69
Rapid Vienna,4779,3,17,10,9,55,34,21,61
Vienna,4779,4,19,3,14,57,49,8,60
SC Rheindorf,4779,5,17,9,10,48,44,4,60
RZ Pellets W,4779,6,11,8,17,44,60,-16,41
Admira Wacke,4779,7,12,4,20,35,62,-27,40
St. Pölten,4779,8,10,9,17,39,57,-18,39
SV Josko Rie,4779,9,11,4,21,34,49,-15,37
Mattersburg,4779,10,7,8,21,30,57,-27,29
FC Salzburg,4780,1,21,8,7,68,32,36,71
SK Sturm Gra,4780,2,21,7,8,65,34,31,70
SC Rheindorf,4780,3,18,9,9,56,45,11,63
Vienna,4780,4,18,8,10,62,49,13,62
Rapid Vienna,4780,5,12,12,12,50,41,9,48
RZ Pellets W,4780,6,11,13,12,49,53,-4,46
Admira Wacke,4780,7,11,7,18,38,63,-25,40
SV Josko Rie,4780,8,10,8,18,38,56,-18,38
St. Pölten,4780,9,7,9,20,36,63,-27,30
Mattersburg,4780,10,6,9,21,29,55,-26,27
FC Salzburg,4781,1,22,9,5,65,26,39,75
SK Sturm Gra,4781,2,20,5,11,58,32,26,65
Vienna,4781,3,18,6,12,63,53,10,60
SC Rheindorf,4781,4,16,9,11,49,42,7,57
RZ Pellets W,4781,5,15,7,14,55,53,2,52
Rapid Vienna,4781,6,13,12,11,51,37,14,51
Admira Wacke,4781,7,13,5,18,36,57,-21,44
SV Josko Rie,4781,8,10,6,20,36,61,-25,36
St. Pölten,4781,9,8,10,18,36,62,-26,34
Mattersburg,4781,10,6,9,21,28,54,-26,27
FC Salzburg,4782,1,23,9,4,65,23,42,78
SC Rheindorf,4782,2,22,7,7,57,37,20,73
Vienna,4782,3,20,5,11,65,52,13,65
SK Sturm Gra,4782,4,18,6,12,61,37,24,60
Rapid Vienna,4782,5,13,10,13,53,45,8,49
RZ Pellets W,4782,6,12,7,17,43,52,-9,43
SV Josko Rie,4782,7,10,9,17,34,49,-15,39
Admira Wacke,4782,8,11,3,22,37,65,-28,36
Mattersburg,4782,9,9,7,20,32,57,-25,34
St. Pölten,4782,10,5,11,20,35,65,-30,26
FC Salzburg,4783,1,22,8,6,61,28,33,74
SK Sturm Gra,4783,2,18,8,10,57,36,21,62
SC Rheindorf,4783,3,17,9,10,50,42,8,60
Vienna,4783,4,18,3,15,65,60,5,57
RZ Pellets W,4783,5,14,8,14,48,53,-5,50
Rapid Vienna,4783,6,11,13,12,51,38,13,46
St. Pölten,4783,7,10,11,15,52,66,-14,41
SV Josko Rie,4783,8,11,7,18,43,55,-12,40
Admira Wacke,4783,9,10,6,20,38,63,-25,36
Mattersburg,4783,10,9,7,20,34,58,-24,34
FC Salzburg,4784,1,23,7,6,73,26,47,76
SC Rheindorf,4784,2,22,6,8,64,40,24,72
SK Sturm Gra,4784,3,21,7,8,63,32,31,70
Vienna,4784,4,19,5,12,67,59,8,62
Rapid Vienna,4784,5,14,12,10,55,36,19,54
RZ Pellets W,4784,6,12,6,18,45,59,-14,42
Mattersburg,4784,7,9,8,19,33,53,-20,35
St. Pölten,4784,8,9,7,20,40,70,-30,34
Admira Wacke,4784,9,9,6,21,36,67,-31,33
SV Josko Rie,4784,10,8,4,24,27,61,-34,28
FC Salzburg,4785,1,22,7,7,67,34,33,73
Vienna,4785,2,20,7,9,71,51,20,67
SK Sturm Gra,4785,3,19,8,9,62,37,25,65
SC Rheindorf,4785,4,17,10,9,53,43,10,61
RZ Pellets W,4785,5,14,6,16,53,64,-11,48
Rapid Vienna,4785,6,11,13,12,52,39,13,46
SV Josko Rie,4785,7,13,4,19,43,56,-13,43
Admira Wacke,4785,8,11,5,20,45,65,-20,38
St. Pölten,4785,9,8,10,18,40,68,-28,34
Mattersburg,4785,10,6,8,22,35,64,-29,26
SK Sturm Gra,4786,1,22,7,7,66,31,35,73
FC Salzburg,4786,2,18,10,8,60,34,26,64
SC Rheindorf,4786,3,18,9,9,62,50,12,63
Vienna,4786,4,18,6,12,63,51,12,60
Admira Wacke,4786,5,15,7,14,48,56,-8,52
RZ Pellets W,4786,6,12,9,15,51,54,-3,45
Rapid Vienna,4786,7,11,10,15,53,48,5,43
SV Josko Rie,4786,8,11,6,19,32,52,-20,39
Mattersburg,4786,9,8,9,19,36,63,-27,33
St. Pölten,4786,10,7,7,22,38,70,-32,28
FC Salzburg,4787,1,22,5,9,69,30,39,71
Vienna,4787,2,22,3,11,65,47,18,69
SC Rheindorf,4787,3,18,7,11,50,43,7,61
SK Sturm Gra,4787,4,18,4,14,57,38,19,58
Rapid Vienna,4787,5,16,8,12,56,44,12,56
Admira Wacke,4787,6,13,5,18,35,53,-18,44
RZ Pellets W,4787,7,10,12,14,44,57,-13,42
SV Josko Rie,4787,8,11,8,17,35,49,-14,41
St. Pölten,4787,9,7,13,16,38,58,-20,34
Mattersburg,4787,10,7,7,22,35,65,-30,28
SK Sturm Gra,4788,1,24,5,7,61,27,34,77
FC Salzburg,4788,2,21,6,9,59,30,29,69
Vienna,4788,3,21,4,11,65,54,11,67
SC Rheindorf,4788,4,17,6,13,45,44,1,57
Rapid Vienna,4788,5,13,11,12,60,42,18,50
RZ Pellets W,4788,6,11,8,17,47,57,-10,41
St. Pölten,4788,7,10,11,15,43,61,-18,41
Admira Wacke,4788,8,10,7,19,34,58,-24,37
Mattersburg,4788,9,8,10,18,40,58,-18,34
SV Josko Rie,4788,10,8,6,22,34,57,-23,30
FC Salzburg,4789,1,21,6,9,69,32,37,69
SC Rheindorf,4789,2,21,6,9,55,44,11,69
SK Sturm Gra,4789,3,20,7,9,60,32,28,67
Vienna,4789,4,19,6,11,71,51,20,63
Rapid Vienna,4789,5,14,9,13,55,44,11,51
RZ Pellets W,4789,6,12,6,18,45,55,-10,42
SV Josko Rie,4789,7,12,2,22,38,68,-30,38
Mattersburg,4789,8,9,9,18,43,53,-10,36
St. Pölten,4789,9,9,9,18,44,69,-25,36
Admira Wacke,4789,10,10,6,20,37,69,-32,36
SC Rheindorf,4790,1,22,7,7,60,38,22,73
FC Salzburg,4790,2,21,8,7,66,30,36,71
SK Sturm Gra,4790,3,22,4,10,61,37,24,70
Vienna,4790,4,18,4,14,57,51,6,58
Rapid Vienna,4790,5,16,9,11,61,41,20,57
RZ Pellets W,4790,6,12,4,20,46,63,-17,40
Admira Wacke,4790,7,12,4,20,34,57,-23,40
SV Josko Rie,4790,8,10,6,20,30,52,-22,36
Mattersburg,4790,9,9,7,20,42,60,-18,34
St. Pölten,4790,10,7,9,20,38,66,-28,30
FC Salzburg,4791,1,22,7,7,69,32,37,73
Vienna,4791,2,20,5,11,68,47,21,65
SC Rheindorf,4791,3,18,9,9,55,41,14,63
SK Sturm Gra,4791,4,16,7,13,53,41,12,55
RZ Pellets W,4791,5,14,9,13,52,52,0,51
Rapid Vienna,4791,6,13,11,12,55,40,15,50
SV Josko Rie,4791,7,12,6,18,40,49,-9,42
Admira Wacke,4791,8,12,4,20,36,66,-30,40
St. Pölten,4791,9,9,7,20,40,69,-29,34
Mattersburg,4791,10,8,7,21,33,64,-31,31
FC Salzburg,4792,1,22,7,7,70,31,39,73
Vienna,4792,2,23,3,10,65,46,19,72
SK Sturm Gra,4792,3,19,7,10,63,36,27,64
SC Rheindorf,4792,4,17,7,12,58,50,8,58
Rapid Vienna,4792,5,13,9,14,50,45,5,48
RZ Pellets W,4792,6,13,7,16,54,58,-4,46
Mattersburg,4792,7,11,5,20,40,57,-17,38
St. Pölten,4792,8,8,13,15,43,68,-25,37
Admira Wacke,4792,9,9,8,19,36,64,-28,35
SV Josko Rie,4792,10,9,6,21,33,57,-24,33
SK Sturm Gra,4793,1,19,11,6,64,27,37,68
FC Salzburg,4793,2,19,9,8,63,33,30,66
Vienna,4793,3,18,7,11,67,51,16,61
SC Rheindorf,4793,4,17,6,13,49,51,-2,57
Rapid Vienna,4793,5,14,12,10,53,34,19,54
Admira Wacke,4793,6,12,9,15,33,49,-16,45
SV Josko Rie,4793,7,12,6,18,38,55,-17,42
RZ Pellets W,4793,8,11,7,18,43,55,-12,40
St. Pölten,4793,9,8,10,18,35,67,-32,34
Mattersburg,4793,10,5,13,18,31,54,-23,28
SC Rheindorf,4794,1,22,6,8,59,40,19,72
FC Salzburg,4794,2,19,8,9,67,32,35,65
SK Sturm Gra,4794,3,20,5,11,60,35,25,65
Vienna,4794,4,20,5,11,65,48,17,65
Rapid Vienna,4794,5,18,9,9,59,32,27,63
RZ Pellets W,4794,6,13,6,17,45,59,-14,45
SV Josko Rie,4794,7,12,3,21,32,55,-23,39
St. Pölten,4794,8,9,7,20,40,67,-27,34
Admira Wacke,4794,9,9,5,22,35,75,-40,32
Mattersburg,4794,10,7,8,21,37,56,-19,29
SK Sturm Gra,4795,1,20,7,9,65,34,31,67
SC Rheindorf,4795,2,19,7,10,61,39,22,64
Vienna,4795,3,20,4,12,62,49,13,64
FC Salzburg,4795,4,17,7,12,60,42,18,58
RZ Pellets W,4795,5,13,10,13,52,55,-3,49
Rapid Vienna,4795,6,12,12,12,56,42,14,48
St. Pölten,4795,7,11,11,14,48,61,-13,44
Admira Wacke,4795,8,10,7,19,32,67,-35,37
Mattersburg,4795,9,9,8,19,36,59,-23,35
SV Josko Rie,4795,10,10,5,21,32,56,-24,35
SK Sturm Gra,4796,1,20,8,8,65,33,32,68
SC Rheindorf,4796,2,20,7,9,65,44,21,67
FC Salzburg,4796,3,19,7,10,64,34,30,64
Vienna,4796,4,19,5,12,65,50,15,62
RZ Pellets W,4796,5,15,8,13,57,53,4,53
Rapid Vienna,4796,6,13,8,15,51,49,2,47
St. Pölten,4796,7,12,8,16,49,64,-15,44
Admira Wacke,4796,8,11,5,20,33,65,-32,38
SV Josko Rie,4796,9,10,4,22,32,59,-27,34
Mattersburg,4796,10,7,8,21,36,66,-30,29
FC Salzburg,4797,1,22,7,7,69,28,41,73
SC Rheindorf,4797,2,20,8,8,54,40,14,68
SK Sturm Gra,4797,3,20,5,11,62,33,29,65
Vienna,4797,4,18,6,12,62,49,13,60
Rapid Vienna,4797,5,15,11,10,58,42,16,56
RZ Pellets W,4797,6,11,8,17,47,58,-11,41
Admira Wacke,4797,7,11,8,17,39,63,-24,41
SV Josko Rie,4797,8,11,5,20,32,52,-20,38
St. Pölten,4797,9,10,8,18,38,64,-26,38
Mattersburg,4797,10,5,8,23,34,66,-32,23
FC Salzburg,4798,1,19,10,7,60,32,28,67
SC Rheindorf,4798,2,20,7,9,58,42,16,67
SK Sturm Gra,4798,3,20,6,10,62,30,32,66
Vienna,4798,4,20,4,12,63,52,11,64
Rapid Vienna,4798,5,16,8,12,62,41,21,56
St. Pölten,4798,6,11,8,17,44,59,-15,41
Admira Wacke,4798,7,12,4,20,35,65,-30,40
Mattersburg,4798,8,9,10,17,38,51,-13,37
RZ Pellets W,4798,9,10,6,20,42,65,-23,36
SV Josko Rie,4798,10,9,5,22,30,57,-27,32
FC Salzburg,4799,1,18,14,4,68,30,38,68
SK Sturm Gra,4799,2,20,5,11,61,32,29,65
SC Rheindorf,4799,3,18,8,10,52,48,4,62
Vienna,4799,4,17,5,14,54,55,-1,56
SV Josko Rie,4799,5,17,4,15,45,41,4,55
Rapid Vienna,4799,6,11,13,12,49,42,7,46
Admira Wacke,4799,7,13,5,18,37,57,-20,44
RZ Pellets W,4799,8,12,7,17,45,57,-12,43
Mattersburg,4799,9,8,10,18,36,52,-16,34
St. Pölten,4799,10,4,13,19,36,69,-33,25
SK Sturm Gra,4800,1,23,4,9,66,40,26,73
FC Salzburg,4800,2,20,7,9,68,33,35,67
SC Rheindorf,4800,3,18,7,11,57,46,11,61
Vienna,4800,4,18,4,14,61,48,13,58
Rapid Vienna,4800,5,14,10,12,51,35,16,52
Admira Wacke,4800,6,14,3,19,37,59,-22,45
SV Josko Rie,4800,7,12,7,17,39,50,-11,43
Mattersburg,4800,8,11,9,16,47,61,-14,42
RZ Pellets W,4800,9,11,6,19,41,62,-21,39
St. Pölten,4800,10,5,11,20,37,70,-33,26
SC Rheindorf,4801,1,22,8,6,56,37,19,74
SK Sturm Gra,4801,2,19,5,12,60,32,28,62
FC Salzburg,4801,3,17,9,10,61,40,21,60
Vienna,4801,4,16,6,14,55,50,5,54
RZ Pellets W,4801,5,15,7,14,46,45,1,52
Rapid Vienna,4801,6,13,10,13,54,44,10,49
Admira Wacke,4801,7,13,6,17,36,52,-16,45
Mattersburg,4801,8,9,10,17,41,53,-12,37
SV Josko Rie,4801,9,9,10,17,38,58,-20,37
St. Pölten,4801,10,5,13,18,33,69,-36,28
FC Salzburg,4802,1,22,8,6,68,29,39,74
SC Rheindorf,4802,2,18,8,10,54,47,7,62
Vienna,4802,3,17,7,12,64,49,15,58
SK Sturm Gra,4802,4,17,6,13,54,41,13,57
Rapid Vienna,4802,5,15,10,11,53,40,13,55
St. Pölten,4802,6,12,10,14,47,55,-8,46
RZ Pellets W,4802,7,11,7,18,43,58,-15,40
Admira Wacke,4802,8,12,4,20,34,55,-21,40
SV Josko Rie,4802,9,11,6,19,34,53,-19,39
Mattersburg,4802,10,8,8,20,40,64,-24,32
FC Salzburg,4803,1,20,9,7,68,32,36,69
SK Sturm Gra,4803,2,20,7,9,61,38,23,67
SC Rheindorf,4803,3,18,7,11,51,47,4,61
Rapid Vienna,4803,4,15,10,11,65,46,19,55
Vienna,4803,5,16,5,15,59,61,-2,53
RZ Pellets W,4803,6,14,10,12,57,56,1,52
St. Pölten,4803,7,10,9,17,41,59,-18,39
Admira Wacke,4803,8,10,8,18,33,55,-22,38
SV Josko Rie,4803,9,10,7,19,35,56,-21,37
Mattersburg,4803,10,7,8,21,32,52,-20,29
FC Salzburg,4804,1,21,5,10,64,32,32,68
SC Rheindorf,4804,2,20,6,10,57,45,12,66
SK Sturm Gra,4804,3,19,8,9,57,32,25,65
Vienna,4804,4,18,6,12,60,53,7,60
Rapid Vienna,4804,5,14,12,10,62,43,19,54
RZ Pellets W,4804,6,13,7,16,52,55,-3,46
SV Josko Rie,4804,7,12,6,18,41,54,-13,42
Admira Wacke,4804,8,9,9,18,36,63,-27,36
Mattersburg,4804,9,9,8,19,44,61,-17,35
St. Pölten,4804,10,7,9,20,39,74,-35,30
SK Sturm Gra,4805,1,23,5,8,66,31,35,74
FC Salzburg,4805,2,19,10,7,57,27,30,67
SC Rheindorf,4805,3,19,8,9,55,41,14,65
Vienna,4805,4,18,5,13,57,47,10,59
Rapid Vienna,4805,5,12,12,12,53,41,12,48
Mattersburg,4805,6,10,11,15,35,48,-13,41
RZ Pellets W,4805,7,10,9,17,42,60,-18,39
Admira Wacke,4805,8,10,8,18,34,55,-21,38
SV Josko Rie,4805,9,9,7,20,33,56,-23,34
St. Pölten,4805,10,8,9,19,43,69,-26,33
FC Salzburg,4806,1,21,10,5,65,29,36,73
SC Rheindorf,4806,2,19,9,8,49,36,13,66
SK Sturm Gra,4806,3,18,7,11,54,33,21,61
Vienna,4806,4,16,6,14,56,54,2,54
Rapid Vienna,4806,5,14,10,12,54,40,14,52
RZ Pellets W,4806,6,14,7,15,44,49,-5,49
Mattersburg,4806,7,10,8,18,37,55,-18,38
Admira Wacke,4806,8,9,10,17,28,51,-23,37
St. Pölten,4806,9,8,11,17,35,56,-21,35
SV Josko Rie,4806,10,9,6,21,29,48,-19,33
FC Salzburg,4807,1,23,8,5,74,31,43,77
SC Rheindorf,4807,2,20,8,8,60,40,20,68
Rapid Vienna,4807,3,16,12,8,58,31,27,60
SK Sturm Gra,4807,4,17,8,11,58,36,22,59
Vienna,4807,5,16,6,14,51,54,-3,54
SV Josko Rie,4807,6,15,4,17,44,55,-11,49
RZ Pellets W,4807,7,11,10,15,52,59,-7,43
St. Pölten,4807,8,7,11,18,45,69,-24,32
Admira Wacke,4807,9,9,5,22,34,68,-34,32
Mattersburg,4807,10,5,10,21,30,63,-33,25
FC Salzburg,4808,1,20,10,6,70,28,42,70
SC Rheindorf,4808,2,18,9,9,57,42,15,63
SK Sturm Gra,4808,3,17,10,9,54,38,16,61
Vienna,4808,4,17,8,11,58,53,5,59
Rapid Vienna,4808,5,12,13,11,58,46,12,49
RZ Pellets W,4808,6,13,7,16,43,52,-9,46
SV Josko Rie,4808,7,12,6,18,37,51,-14,42
Admira Wacke,4808,8,10,11,15,35,53,-18,41
Mattersburg,4808,9,8,9,19,36,57,-21,33
St. Pölten,4808,10,5,13,18,39,67,-28,28
FC Salzburg,4809,1,22,6,8,67,29,38,72
SK Sturm Gra,4809,2,21,4,11,69,35,34,67
SC Rheindorf,4809,3,20,7,9,56,46,10,67
Vienna,4809,4,20,6,10,73,53,20,66
RZ Pellets W,4809,5,15,6,15,50,50,0,51
Rapid Vienna,4809,6,12,13,11,53,44,9,49
SV Josko Rie,4809,7,10,5,21,28,53,-25,35
Admira Wacke,4809,8,9,8,19,34,68,-34,35
St. Pölten,4809,9,8,9,19,36,65,-29,33
Mattersburg,4809,10,8,6,22,32,55,-23,30
FC Salzburg,4810,1,24,7,5,73,28,45,79
SC Rheindorf,4810,2,20,6,10,51,43,8,66
SK Sturm Gra,4810,3,19,6,11,58,35,23,63
Vienna,4810,4,19,5,12,63,48,15,62
Rapid Vienna,4810,5,14,11,11,60,44,16,53
RZ Pellets W,4810,6,11,9,16,43,55,-12,42
SV Josko Rie,4810,7,12,5,19,37,49,-12,41
St. Pölten,4810,8,10,8,18,46,65,-19,38
Admira Wacke,4810,9,9,5,22,27,61,-34,32
Mattersburg,4810,10,6,10,20,34,64,-30,28
FC Salzburg,4811,1,25,6,5,82,29,53,81
SK Sturm Gra,4811,2,22,4,10,71,37,34,70
SC Rheindorf,4811,3,21,5,10,56,44,12,68
Vienna,4811,4,19,3,14,61,53,8,60
Rapid Vienna,4811,5,14,9,13,52,41,11,51
RZ Pellets W,4811,6,14,7,15,46,54,-8,49
St. Pölten,4811,7,10,7,19,44,65,-21,37
Admira Wacke,4811,8,10,4,22,32,66,-34,34
Mattersburg,4811,9,8,7,21,32,61,-29,31
SV Josko Rie,4811,10,8,6,22,28,54,-26,30
FC Salzburg,4812,1,20,9,7,67,35,32,69
SC Rheindorf,4812,2,18,7,11,54,44,10,61
Vienna,4812,3,17,9,10,64,53,11,60
RZ Pellets W,4812,4,14,9,13,47,50,-3,51
SK Sturm Gra,4812,5,14,8,14,57,47,10,50
Rapid Vienna,4812,6,13,10,13,56,47,9,49
Admira Wacke,4812,7,13,7,16,40,52,-12,46
SV Josko Rie,4812,8,12,5,19,41,56,-15,41
St. Pölten,4812,9,10,7,19,44,66,-22,37
Mattersburg,4812,10,9,9,18,35,55,-20,36
FC Salzburg,4813,1,20,9,7,67,30,37,69
SC Rheindorf,4813,2,20,6,10,62,41,21,66
SK Sturm Gra,4813,3,18,7,11,57,38,19,61
Vienna,4813,4,17,6,13,63,55,8,57
Rapid Vienna,4813,5,15,11,10,52,37,15,56
RZ Pellets W,4813,6,14,7,15,52,54,-2,49
Admira Wacke,4813,7,12,5,19,38,63,-25,41
SV Josko Rie,4813,8,11,6,19,36,55,-19,39
St. Pölten,4813,9,8,10,18,35,63,-28,34
Mattersburg,4813,10,6,11,19,29,55,-26,29
FC Salzburg,4814,1,21,8,7,70,32,38,71
SC Rheindorf,4814,2,19,8,9,59,40,19,65
SK Sturm Gra,4814,3,18,8,10,51,29,22,62
Vienna,4814,4,17,8,11,65,56,9,59
Rapid Vienna,4814,5,14,10,12,55,43,12,52
RZ Pellets W,4814,6,12,8,16,45,57,-12,44
SV Josko Rie,4814,7,12,7,17,36,52,-16,43
Admira Wacke,4814,8,13,4,19,43,66,-23,43
St. Pölten,4814,9,7,13,16,42,61,-19,34
Mattersburg,4814,10,6,8,22,27,57,-30,26
FC Salzburg,4815,1,21,8,7,66,26,40,71
SK Sturm Gra,4815,2,21,6,9,57,33,24,69
SC Rheindorf,4815,3,19,8,9,59,40,19,65
Vienna,4815,4,18,4,14,55,50,5,58
Rapid Vienna,4815,5,14,10,12,50,38,12,52
Admira Wacke,4815,6,14,5,17,35,52,-17,47
RZ Pellets W,4815,7,13,7,16,46,53,-7,46
Mattersburg,4815,8,9,8,19,33,56,-23,35
SV Josko Rie,4815,9,10,4,22,34,61,-27,34
St. Pölten,4815,10,7,8,21,43,69,-26,29
SC Rheindorf,4816,1,19,10,7,56,44,12,67
Vienna,4816,2,19,7,10,66,53,13,64
FC Salzburg,4816,3,18,8,10,63,34,29,62
SK Sturm Gra,4816,4,17,9,10,54,33,21,60
Rapid Vienna,4816,5,14,9,13,52,44,8,51
St. Pölten,4816,6,12,9,15,46,54,-8,45
Admira Wacke,4816,7,13,5,18,39,60,-21,44
RZ Pellets W,4816,8,12,7,17,49,59,-10,43
Mattersburg,4816,9,10,7,19,44,59,-15,37
SV Josko Rie,4816,10,8,5,23,26,55,-29,29
SK Sturm Gra,4817,1,24,4,8,67,32,35,76
SC Rheindorf,4817,2,22,6,8,56,39,17,72
FC Salzburg,4817,3,20,7,9,62,36,26,67
Vienna,4817,4,18,4,14,56,51,5,58
Rapid Vienna,4817,5,12,9,15,51,45,6,45
RZ Pellets W,4817,6,13,6,17,50,60,-10,45
SV Josko Rie,4817,7,13,5,18,41,51,-10,44
St. Pölten,4817,8,9,10,17,38,57,-19,37
Mattersburg,4817,9,8,9,19,37,58,-21,33
Admira Wacke,4817,10,9,4,23,34,63,-29,31
FC Salzburg,4818,1,22,7,7,70,37,33,73
SC Rheindorf,4818,2,21,6,9,60,38,22,69
SK Sturm Gra,4818,3,20,7,9,61,31,30,67
Rapid Vienna,4818,4,17,9,10,61,40,21,60
Vienna,4818,5,16,6,14,64,61,3,54
RZ Pellets W,4818,6,12,9,15,49,56,-7,45
Admira Wacke,4818,7,11,4,21,34,65,-31,37
Mattersburg,4818,8,9,8,19,35,55,-20,35
SV Josko Rie,4818,9,10,5,21,33,57,-24,35
St. Pölten,4818,10,7,9,20,36,63,-27,30
FC Salzburg,4819,1,21,7,8,68,32,36,70
SK Sturm Gra,4819,2,21,5,10,65,33,32,68
SC Rheindorf,4819,3,20,7,9,59,50,9,67
Rapid Vienna,4819,4,16,11,9,56,33,23,59
Vienna,4819,5,16,5,15,59,67,-8,53
RZ Pellets W,4819,6,14,9,13,44,43,1,51
Admira Wacke,4819,7,11,8,17,38,59,-21,41
SV Josko Rie,4819,8,9,7,20,37,55,-18,34
Mattersburg,4819,9,8,8,20,33,56,-23,32
St. Pölten,4819,10,7,7,22,32,63,-31,28
FC Salzburg,4820,1,25,5,6,75,31,44,80
SK Sturm Gra,4820,2,21,6,9,66,34,32,69
Vienna,4820,3,20,6,10,61,48,13,66
SC Rheindorf,4820,4,14,11,11,49,50,-1,53
Rapid Vienna,4820,5,13,9,14,53,48,5,48
Admira Wacke,4820,6,12,6,18,42,63,-21,42
SV Josko Rie,4820,7,11,7,18,39,53,-14,40
Mattersburg,4820,8,10,7,19,45,52,-7,37
RZ Pellets W,4820,9,10,6,20,37,61,-24,36
St. Pölten,4820,10,7,11,18,38,65,-27,32
FC Salzburg,4821,1,20,8,8,68,34,34,68
SK Sturm Gra,4821,2,20,8,8,62,28,34,68
SC Rheindorf,4821,3,19,11,6,56,41,15,68
Vienna,4821,4,18,6,12,59,52,7,60
RZ Pellets W,4821,5,11,12,13,44,49,-5,45
Rapid Vienna,4821,6,10,14,12,48,43,5,44
Admira Wacke,4821,7,11,7,18,37,61,-24,40
St. Pölten,4821,8,9,10,17,37,58,-21,37
SV Josko Rie,4821,9,9,6,21,33,51,-18,33
Mattersburg,4821,10,7,10,19,32,59,-27,31
SC Rheindorf,4822,1,23,8,5,68,37,31,77
FC Salzburg,4822,2,19,10,7,57,27,30,67
SK Sturm Gra,4822,3,20,6,10,62,36,26,66
Vienna,4822,4,21,3,12,65,47,18,66
Rapid Vienna,4822,5,15,9,12,61,42,19,54
RZ Pellets W,4822,6,11,10,15,45,57,-12,43
SV Josko Rie,4822,7,11,4,21,34,55,-21,37
Admira Wacke,4822,8,10,6,20,36,65,-29,36
Mattersburg,4822,9,8,7,21,35,64,-29,31
St. Pölten,4822,10,7,7,22,38,71,-33,28
FC Salzburg,4823,1,21,8,7,67,35,32,71
SC Rheindorf,4823,2,19,11,6,59,42,17,68
Vienna,4823,3,17,9,10,67,56,11,60
SK Sturm Gra,4823,4,17,8,11,58,39,19,59
Rapid Vienna,4823,5,12,10,14,54,41,13,46
RZ Pellets W,4823,6,12,9,15,45,57,-12,45
Admira Wacke,4823,7,12,6,18,38,61,-23,42
Mattersburg,4823,8,10,8,18,41,52,-11,38
St. Pölten,4823,9,8,12,16,41,61,-20,36
SV Josko Rie,4823,10,9,5,22,31,57,-26,32
FC Salzburg,4824,1,22,6,8,70,27,43,72
SC Rheindorf,4824,2,20,11,5,61,40,21,71
Rapid Vienna,4824,3,16,12,8,61,37,24,60
SK Sturm Gra,4824,4,18,5,13,57,37,20,59
Vienna,4824,5,16,7,13,55,60,-5,55
RZ Pellets W,4824,6,14,8,14,52,53,-1,50
SV Josko Rie,4824,7,10,7,19,36,52,-16,37
Admira Wacke,4824,8,10,6,20,36,64,-28,36
Mattersburg,4824,9,6,13,17,37,61,-24,31
St. Pölten,4824,10,5,11,20,41,75,-34,26
FC Salzburg,4825,1,22,8,6,68,32,36,74
SK Sturm Gra,4825,2,20,7,9,59,36,23,67
SC Rheindorf,4825,3,19,8,9,56,39,17,65
Vienna,4825,4,16,6,14,57,56,1,54
Rapid Vienna,4825,5,13,11,12,55,45,10,50
Admira Wacke,4825,6,12,5,19,42,59,-17,41
Mattersburg,4825,7,9,12,15,37,45,-8,39
RZ Pellets W,4825,8,9,10,17,41,57,-16,37
SV Josko Rie,4825,9,10,6,20,32,58,-26,36
St. Pölten,4825,10,8,11,17,39,59,-20,35
SC Rheindorf,4826,1,22,7,7,57,38,19,73
Vienna,4826,2,21,5,10,72,47,25,68
SK Sturm Gra,4826,3,19,7,10,62,36,26,64
FC Salzburg,4826,4,19,5,12,62,43,19,62
Rapid Vienna,4826,5,15,9,12,63,44,19,54
Admira Wacke,4826,6,13,5,18,44,60,-16,44
RZ Pellets W,4826,7,10,12,14,48,59,-11,42
Mattersburg,4826,8,9,8,19,35,55,-20,35
St. Pölten,4826,9,7,11,18,36,70,-34,32
SV Josko Rie,4826,10,8,5,23,26,53,-27,29
FC Salzburg,4827,1,19,9,8,62,29,33,66
SC Rheindorf,4827,2,19,9,8,55,44,11,66
SK Sturm Gra,4827,3,18,8,10,52,30,22,62
Vienna,4827,4,17,5,14,54,49,5,56
Rapid Vienna,4827,5,13,11,12,50,39,11,50
Admira Wacke,4827,6,13,6,17,40,50,-10,45
RZ Pellets W,4827,7,12,7,17,38,49,-11,43
Mattersburg,4827,8,12,7,17,42,60,-18,43
SV Josko Rie,4827,9,12,3,21,35,53,-18,39
St. Pölten,4827,10,7,11,18,39,64,-25,32
FC Salzburg,4828,1,24,6,6,75,29,46,78
SC Rheindorf,4828,2,21,10,5,58,39,19,73
SK Sturm Gra,4828,3,21,8,7,66,34,32,71
Vienna,4828,4,19,5,12,62,52,10,62
Rapid Vienna,4828,5,14,9,13,60,43,17,51
RZ Pellets W,4828,6,14,6,16,49,57,-8,48
Admira Wacke,4828,7,10,7,19,34,62,-28,37
SV Josko Rie,4828,8,8,6,22,29,57,-28,30
Mattersburg,4828,9,7,8,21,34,60,-26,29
St. Pölten,4828,10,5,9,22,36,70,-34,24
SK Sturm Gra,4829,1,21,5,10,59,32,27,68
Vienna,4829,2,20,5,11,58,46,12,65
SC Rheindorf,4829,3,20,4,12,58,49,9,64
Rapid Vienna,4829,4,18,9,9,67,35,32,63
FC Salzburg,4829,5,17,10,9,61,36,25,61
Admira Wacke,4829,6,12,9,15,42,56,-14,45
RZ Pellets W,4829,7,11,9,16,44,61,-17,42
St. Pölten,4829,8,9,8,19,39,58,-19,35
Mattersburg,4829,9,8,8,20,39,64,-25,32
SV Josko Rie,4829,10,8,5,23,26,56,-30,29
FC Salzburg,4830,1,23,7,6,72,31,41,76
SC Rheindorf,4830,2,22,6,8,64,44,20,72
SK Sturm Gra,4830,3,21,4,11,60,34,26,67
Rapid Vienna,4830,4,16,9,11,60,41,19,57
Vienna,4830,5,16,6,14,64,60,4,54
RZ Pellets W,4830,6,12,8,16,49,67,-18,44
St. Pölten,4830,7,10,7,19,46,66,-20,37
SV Josko Rie,4830,8,10,7,19,31,51,-20,37
Admira Wacke,4830,9,10,6,20,33,61,-28,36
Mattersburg,4830,10,7,6,23,41,65,-24,27
Vienna,4831,1,21,4,11,64,47,17,67
FC Salzburg,4831,2,19,9,8,62,30,32,66
SC Rheindorf,4831,3,17,11,8,52,43,9,62
SK Sturm Gra,4831,4,18,6,12,55,36,19,60
Rapid Vienna,4831,5,14,11,11,53,38,15,53
RZ Pellets W,4831,6,13,10,13,48,51,-3,49
SV Josko Rie,4831,7,11,8,17,36,49,-13,41
Mattersburg,4831,8,9,10,17,34,53,-19,37
Admira Wacke,4831,9,8,9,19,32,57,-25,33
St. Pölten,4831,10,6,10,20,37,69,-32,28
FC Salzburg,4832,1,22,6,8,71,27,44,72
SK Sturm Gra,4832,2,20,6,10,65,38,27,66
SC Rheindorf,4832,3,20,6,10,62,44,18,66
Rapid Vienna,4832,4,16,13,7,60,38,22,61
Vienna,4832,5,16,5,15,62,62,0,53
Admira Wacke,4832,6,12,6,18,42,63,-21,42
RZ Pellets W,4832,7,9,10,17,36,58,-22,37
St. Pölten,4832,8,8,11,17,43,62,-19,35
Mattersburg,4832,9,9,8,19,37,59,-22,35
SV Josko Rie,4832,10,10,5,21,39,66,-27,35
SC Rheindorf,4833,1,21,7,8,60,40,20,70
FC Salzburg,4833,2,21,6,9,63,30,33,69
SK Sturm Gra,4833,3,19,10,7,58,30,28,67
Vienna,4833,4,17,6,13,60,49,11,57
Rapid Vienna,4833,5,13,12,11,63,44,19,51
RZ Pellets W,4833,6,12,6,18,33,54,-21,42
Admira Wacke,4833,7,10,8,18,36,58,-22,38
SV Josko Rie,4833,8,12,2,22,31,54,-23,38
Mattersburg,4833,9,8,11,17,34,57,-23,35
St. Pölten,4833,10,7,12,17,42,64,-22,33
Vienna,4834,1,22,3,11,71,52,19,69
FC Salzburg,4834,2,19,9,8,61,28,33,66
SC Rheindorf,4834,3,19,8,9,57,44,13,65
SK Sturm Gra,4834,4,19,6,11,58,39,19,63
Rapid Vienna,4834,5,15,10,11,60,39,21,55
RZ Pellets W,4834,6,16,6,14,51,55,-4,54
Admira Wacke,4834,7,11,5,20,34,57,-23,38
Mattersburg,4834,8,9,7,20,32,56,-24,34
St. Pölten,4834,9,8,8,20,47,70,-23,32
SV Josko Rie,4834,10,8,6,22,27,58,-31,30
SC Rheindorf,4835,1,21,7,8,59,38,21,70
FC Salzburg,4835,2,20,8,8,62,35,27,68
Vienna,4835,3,20,3,13,62,48,14,63
SK Sturm Gra,4835,4,19,5,12,56,34,22,62
Rapid Vienna,4835,5,14,10,12,60,39,21,52
RZ Pellets W,4835,6,15,7,14,44,47,-3,52
Admira Wacke,4835,7,9,10,17,36,65,-29,37
SV Josko Rie,4835,8,9,7,20,32,55,-23,34
Mattersburg,4835,9,7,11,18,32,51,-19,32
St. Pölten,4835,10,7,10,19,37,68,-31,31
SC Rheindorf,4836,1,24,6,6,66,38,28,78
FC Salzburg,4836,2,21,8,7,70,34,36,71
Vienna,4836,3,19,6,11,67,51,16,63
SK Sturm Gra,4836,4,17,8,11,55,38,17,59
Rapid Vienna,4836,5,11,11,14,54,47,7,44
RZ Pellets W,4836,6,11,11,14,48,54,-6,44
Mattersburg,4836,7,10,9,17,40,56,-16,39
St. Pölten,4836,8,10,7,19,41,70,-29,37
Admira Wacke,4836,9,9,8,19,34,65,-31,35
SV Josko Rie,4836,10,8,6,22,33,55,-22,30
FC Salzburg,4837,1,24,6,6,76,32,44,78
SK Sturm Gra,4837,2,22,5,9,80,38,42,71
SC Rheindorf,4837,3,19,9,8,71,50,21,66
Vienna,4837,4,20,5,11,61,52,9,65
Rapid Vienna,4837,5,16,9,11,57,37,20,57
RZ Pellets W,4837,6,12,6,18,46,61,-15,42
SV Josko Rie,4837,7,11,4,21,36,61,-25,37
Admira Wacke,4837,8,10,6,20,34,71,-37,36
St. Pölten,4837,9,7,8,21,42,76,-34,29
Mattersburg,4837,10,6,8,22,36,61,-25,26
FC Salzburg,4838,1,19,11,6,61,28,33,68
SC Rheindorf,4838,2,20,6,10,56,45,11,66
SK Sturm Gra,4838,3,18,6,12,52,36,16,60
RZ Pellets W,4838,4,17,6,13,59,53,6,57
Vienna,4838,5,16,5,15,59,53,6,53
Rapid Vienna,4838,6,13,10,13,56,45,11,49
SV Josko Rie,4838,7,13,5,18,39,52,-13,44
Admira Wacke,4838,8,11,8,17,37,61,-24,41
St. Pölten,4838,9,9,10,17,46,64,-18,37
Mattersburg,4838,10,7,7,22,33,61,-28,28
FC Salzburg,4839,1,21,10,5,74,30,44,73
SC Rheindorf,4839,2,22,5,9,61,39,22,71
SK Sturm Gra,4839,3,19,8,9,60,33,27,65
Vienna,4839,4,19,6,11,64,53,11,63
Rapid Vienna,4839,5,12,11,13,48,39,9,47
Admira Wacke,4839,6,13,7,16,41,62,-21,46
RZ Pellets W,4839,7,11,8,17,42,59,-17,41
Mattersburg,4839,8,8,8,20,31,52,-21,32
St. Pölten,4839,9,6,13,17,42,68,-26,31
SV Josko Rie,4839,10,9,4,23,29,57,-28,31
FC Salzburg,4840,1,24,4,8,73,30,43,76
SC Rheindorf,4840,2,21,5,10,61,52,9,68
Vienna,4840,3,19,5,12,56,48,8,62
SK Sturm Gra,4840,4,18,5,13,60,44,16,59
RZ Pellets W,4840,5,17,6,13,52,52,0,57
Rapid Vienna,4840,6,14,10,12,62,46,16,52
Admira Wacke,4840,7,12,6,18,40,61,-21,42
St. Pölten,4840,8,8,10,18,42,66,-24,34
SV Josko Rie,4840,9,10,2,24,32,57,-25,32
Mattersburg,4840,10,7,7,22,34,56,-22,28
FC Salzburg,4841,1,21,8,7,66,33,33,71
SC Rheindorf,4841,2,21,6,9,61,41,20,69
SK Sturm Gra,4841,3,20,6,10,64,34,30,66
Vienna,4841,4,18,5,13,65,59,6,59
Rapid Vienna,4841,5,16,8,12,60,41,19,56
RZ Pellets W,4841,6,14,6,16,53,61,-8,48
Admira Wacke,4841,7,12,7,17,35,55,-20,43
SV Josko Rie,4841,8,10,8,18,32,49,-17,38
Mattersburg,4841,9,7,7,22,36,61,-25,28
St. Pölten,4841,10,7,7,22,39,77,-38,28
FC Salzburg,4842,1,22,7,7,62,25,37,73
SC Rheindorf,4842,2,19,9,8,59,41,18,66
SK Sturm Gra,4842,3,18,8,10,61,35,26,62
Rapid Vienna,4842,4,17,10,9,56,32,24,61
Vienna,4842,5,16,8,12,54,47,7,56
Admira Wacke,4842,6,14,6,16,39,53,-14,48
RZ Pellets W,4842,7,9,11,16,38,54,-16,38
SV Josko Rie,4842,8,9,7,20,31,56,-25,34
Mattersburg,4842,9,7,11,18,35,56,-21,32
St. Pölten,4842,10,6,9,21,36,72,-36,27
FC Salzburg,4843,1,21,8,7,77,32,45,71
SK Sturm Gra,4843,2,19,6,11,54,35,19,63
SC Rheindorf,4843,3,18,9,9,56,42,14,63
Vienna,4843,4,18,8,10,63,57,6,62
Rapid Vienna,4843,5,13,13,10,57,41,16,52
RZ Pellets W,4843,6,13,5,18,52,61,-9,44
St. Pölten,4843,7,11,9,16,46,64,-18,42
SV Josko Rie,4843,8,11,6,19,40,60,-20,39
Admira Wacke,4843,9,10,7,19,32,59,-27,37
Mattersburg,4843,10,6,9,21,38,64,-26,27
FC Salzburg,4844,1,21,6,9,67,33,34,69
SC Rheindorf,4844,2,19,10,7,50,34,16,67
SK Sturm Gra,4844,3,20,6,10,63,33,30,66
Vienna,4844,4,18,5,13,56,56,0,59
Admira Wacke,4844,5,15,8,13,43,47,-4,53
Rapid Vienna,4844,6,12,10,14,52,45,7,46
RZ Pellets W,4844,7,11,8,17,42,57,-15,41
SV Josko Rie,4844,8,10,7,19,29,49,-20,37
Mattersburg,4844,9,8,10,18,38,57,-19,34
St. Pölten,4844,10,7,8,21,36,65,-29,29
FC Salzburg,4845,1,22,8,6,68,26,42,74
SC Rheindorf,4845,2,19,9,8,53,37,16,66
Vienna,4845,3,20,4,12,65,49,16,64
Rapid Vienna,4845,4,16,10,10,61,40,21,58
SK Sturm Gra,4845,5,17,7,12,55,37,18,58
SV Josko Rie,4845,6,12,5,19,33,55,-22,41
Admira Wacke,4845,7,11,6,19,34,61,-27,39
RZ Pellets W,4845,8,10,8,18,37,54,-17,38
St. Pölten,4845,9,8,9,19,40,61,-21,33
Mattersburg,4845,10,7,10,19,31,57,-26,31
SC Rheindorf,4846,1,21,8,7,63,39,24,71
FC Salzburg,4846,2,21,5,10,67,35,32,68
SK Sturm Gra,4846,3,19,9,8,56,28,28,66
Vienna,4846,4,18,9,9,60,44,16,63
Rapid Vienna,4846,5,13,14,9,52,38,14,53
RZ Pellets W,4846,6,12,7,17,46,54,-8,43
Mattersburg,4846,7,10,7,19,33,61,-28,37
Admira Wacke,4846,8,9,8,19,33,59,-26,35
St. Pölten,4846,9,8,10,18,42,63,-21,34
SV Josko Rie,4846,10,8,5,23,28,59,-31,29
FC Salzburg,4847,1,21,9,6,67,27,40,72
SC Rheindorf,4847,2,20,10,6,59,41,18,70
SK Sturm Gra,4847,3,19,8,9,52,31,21,65
Vienna,4847,4,19,6,11,62,48,14,63
Rapid Vienna,4847,5,15,10,11,59,39,20,55
RZ Pellets W,4847,6,13,6,17,47,59,-12,45
SV Josko Rie,4847,7,9,7,20,32,50,-18,34
Admira Wacke,4847,8,9,7,20,32,62,-30,34
Mattersburg,4847,9,6,12,18,30,54,-24,30
St. Pölten,4847,10,7,9,20,37,66,-29,30
FC Salzburg,4848,1,22,5,9,70,32,38,71
Vienna,4848,2,20,7,9,63,44,19,67
SK Sturm Gra,4848,3,18,9,9,61,29,32,63
SC Rheindorf,4848,4,18,9,9,59,50,9,63
Rapid Vienna,4848,5,13,13,10,60,38,22,52
SV Josko Rie,4848,6,13,2,21,43,58,-15,41
RZ Pellets W,4848,7,10,9,17,41,59,-18,39
Mattersburg,4848,8,10,8,18,39,60,-21,38
Admira Wacke,4848,9,10,4,22,37,78,-41,34
St. Pölten,4848,10,7,12,17,40,65,-25,33
SC Rheindorf,4849,1,20,8,8,54,36,18,68
FC Salzburg,4849,2,19,8,9,62,33,29,65
SK Sturm Gra,4849,3,19,7,10,64,34,30,64
Vienna,4849,4,17,6,13,56,53,3,57
Admira Wacke,4849,5,15,6,15,41,54,-13,51
Rapid Vienna,4849,6,13,11,12,52,42,10,50
SV Josko Rie,4849,7,13,6,17,37,46,-9,45
RZ Pellets W,4849,8,11,8,17,43,56,-13,41
St. Pölten,4849,9,7,11,18,39,67,-28,32
Mattersburg,4849,10,7,7,22,39,66,-27,28
FC Salzburg,4850,1,20,7,9,65,37,28,67
SC Rheindorf,4850,2,20,7,9,55,38,17,67
SK Sturm Gra,4850,3,20,5,11,65,37,28,65
Vienna,4850,4,19,4,13,66,58,8,61
RZ Pellets W,4850,5,16,5,15,49,56,-7,53
Rapid Vienna,4850,6,12,11,13,52,42,10,47
SV Josko Rie,4850,7,11,6,19,43,56,-13,39
Admira Wacke,4850,8,10,9,17,35,56,-21,39
Mattersburg,4850,9,9,7,20,39,60,-21,34
St. Pölten,4850,10,8,9,19,43,72,-29,33
SC Rheindorf,4851,1,20,7,9,53,39,14,67
FC Salzburg,4851,2,19,5,12,64,43,21,62
SK Sturm Gra,4851,3,18,7,11,52,32,20,61
Vienna,4851,4,16,3,17,62,57,5,51
Rapid Vienna,4851,5,13,11,12,50,36,14,50
SV Josko Rie,4851,6,14,6,16,44,46,-2,48
RZ Pellets W,4851,7,12,8,16,45,58,-13,44
Admira Wacke,4851,8,12,7,17,41,65,-24,43
Mattersburg,4851,9,10,10,16,37,53,-16,40
St. Pölten,4851,10,10,8,18,45,64,-19,38
FC Salzburg,4852,1,22,5,9,74,32,42,71
SC Rheindorf,4852,2,20,5,11,60,43,17,65
SK Sturm Gra,4852,3,19,5,12,57,43,14,62
Vienna,4852,4,19,3,14,66,57,9,60
Rapid Vienna,4852,5,14,9,13,56,44,12,51
RZ Pellets W,4852,6,14,7,15,49,55,-6,49
SV Josko Rie,4852,7,14,3,19,32,47,-15,45
Admira Wacke,4852,8,11,7,18,36,59,-23,40
St. Pölten,4852,9,9,8,19,46,64,-18,35
Mattersburg,4852,10,8,8,20,32,64,-32,32
SC Rheindorf,4853,1,19,9,8,57,45,12,66
Vienna,4853,2,19,6,11,65,49,16,63
SK Sturm Gra,4853,3,18,8,10,65,36,29,62
FC Salzburg,4853,4,17,7,12,63,40,23,58
Rapid Vienna,4853,5,14,11,11,55,40,15,53
SV Josko Rie,4853,6,11,9,16,40,53,-13,42
St. Pölten,4853,7,11,9,16,43,58,-15,42
RZ Pellets W,4853,8,10,9,17,44,56,-12,39
Admira Wacke,4853,9,9,9,18,39,73,-34,36
Mattersburg,4853,10,7,13,16,34,55,-21,34
FC Salzburg,4854,1,23,7,6,70,32,38,76
SK Sturm Gra,4854,2,19,9,8,51,32,19,66
Vienna,4854,3,19,7,10,63,50,13,64
SC Rheindorf,4854,4,15,9,12,46,44,2,54
Rapid Vienna,4854,5,13,10,13,56,39,17,49
RZ Pellets W,4854,6,12,8,16,46,57,-11,44
Admira Wacke,4854,7,10,8,18,37,56,-19,38
Mattersburg,4854,8,10,7,19,43,61,-18,37
SV Josko Rie,4854,9,10,6,20,36,55,-19,36
St. Pölten,4854,10,7,13,16,38,60,-22,34
SK Sturm Gra,4855,1,22,6,8,64,34,30,72
FC Salzburg,4855,2,22,5,9,69,31,38,71
Vienna,4855,3,20,4,12,62,50,12,64
SC Rheindorf,4855,4,17,7,12,47,46,1,58
Rapid Vienna,4855,5,13,10,13,59,48,11,49
RZ Pellets W,4855,6,14,6,16,58,62,-4,48
SV Josko Rie,4855,7,14,2,20,40,59,-19,44
St. Pölten,4855,8,10,9,17,41,56,-15,39
Admira Wacke,4855,9,11,5,20,34,56,-22,38
Mattersburg,4855,10,5,10,21,34,66,-32,25
FC Salzburg,4856,1,23,7,6,76,33,43,76
SK Sturm Gra,4856,2,18,7,11,54,33,21,61
SC Rheindorf,4856,3,18,7,11,56,45,11,61
Vienna,4856,4,17,5,14,63,62,1,56
Admira Wacke,4856,5,13,9,14,38,48,-10,48
RZ Pellets W,4856,6,12,8,16,46,60,-14,44
SV Josko Rie,4856,7,12,6,18,36,50,-14,42
Rapid Vienna,4856,8,9,13,14,48,47,1,40
St. Pölten,4856,9,7,14,15,43,65,-22,35
Mattersburg,4856,10,7,12,17,37,54,-17,33
FC Salzburg,4857,1,21,6,9,66,29,37,69
SK Sturm Gra,4857,2,20,8,8,61,31,30,68
SC Rheindorf,4857,3,18,9,9,52,43,9,63
Vienna,4857,4,17,7,12,59,52,7,58
Rapid Vienna,4857,5,14,13,9,53,38,15,55
Admira Wacke,4857,6,13,6,17,35,53,-18,45
Mattersburg,4857,7,11,9,16,34,46,-12,42
RZ Pellets W,4857,8,10,8,18,44,59,-15,38
SV Josko Rie,4857,9,10,4,22,31,55,-24,34
St. Pölten,4857,10,7,8,21,37,66,-29,29
FC Salzburg,4858,1,18,10,8,63,34,29,64
Vienna,4858,2,18,7,11,63,51,12,61
Rapid Vienna,4858,3,17,8,11,64,41,23,59
SC Rheindorf,4858,4,16,10,10,50,44,6,58
SK Sturm Gra,4858,5,16,6,14,58,44,14,54
RZ Pellets W,4858,6,15,5,16,46,51,-5,50
St. Pölten,4858,7,11,10,15,42,57,-15,43
Admira Wacke,4858,8,12,7,17,35,53,-18,43
SV Josko Rie,4858,9,11,5,20,32,50,-18,38
Mattersburg,4858,10,8,8,20,30,58,-28,32
FC Salzburg,4859,1,22,8,6,70,29,41,74
SK Sturm Gra,4859,2,19,6,11,57,41,16,63
Rapid Vienna,4859,3,17,10,9,67,36,31,61
SC Rheindorf,4859,4,17,6,13,52,50,2,57
Vienna,4859,5,17,5,14,57,57,0,56
RZ Pellets W,4859,6,12,6,18,52,54,-2,42
SV Josko Rie,4859,7,12,6,18,42,55,-13,42
St. Pölten,4859,8,10,9,17,42,62,-20,39
Mattersburg,4859,9,10,9,17,40,62,-22,39
Admira Wacke,4859,10,9,5,22,36,69,-33,32
SK Sturm Gra,4860,1,22,5,9,68,31,37,71
FC Salzburg,4860,2,21,6,9,71,33,38,69
SC Rheindorf,4860,3,21,5,10,60,50,10,68
Rapid Vienna,4860,4,16,10,10,63,43,20,58
Vienna,4860,5,17,5,14,62,59,3,56
Admira Wacke,4860,6,13,4,19,39,62,-23,43
SV Josko Rie,4860,7,12,4,20,37,52,-15,40
RZ Pellets W,4860,8,10,9,17,46,58,-12,39
St. Pölten,4860,9,10,9,17,46,63,-17,39
Mattersburg,4860,10,5,9,22,29,70,-41,24
SC Rheindorf,4861,1,24,5,7,67,39,28,77
Vienna,4861,2,19,4,13,57,51,6,61
FC Salzburg,4861,3,17,9,10,64,34,30,60
SK Sturm Gra,4861,4,17,8,11,55,36,19,59
Rapid Vienna,4861,5,11,14,11,55,42,13,47
SV Josko Rie,4861,6,13,5,18,36,53,-17,44
RZ Pellets W,4861,7,10,11,15,46,58,-12,41
St. Pölten,4861,8,10,10,16,43,61,-18,40
Admira Wacke,4861,9,10,8,18,42,64,-22,38
Mattersburg,4861,10,5,14,17,37,64,-27,29
Vienna,4862,1,21,4,11,65,49,16,67
SK Sturm Gra,4862,2,19,8,9,60,35,25,65
FC Salzburg,4862,3,19,6,11,62,34,28,63
SC Rheindorf,4862,4,16,9,11,54,47,7,57
RZ Pellets W,4862,5,15,7,14,45,50,-5,52
Rapid Vienna,4862,6,11,14,11,51,38,13,47
St. Pölten,4862,7,12,10,14,46,55,-9,46
Admira Wacke,4862,8,11,8,17,34,54,-20,41
Mattersburg,4862,9,8,10,18,32,52,-20,34
SV Josko Rie,4862,10,7,6,23,30,65,-35,27
SC Rheindorf,4863,1,21,8,7,59,37,22,71
FC Salzburg,4863,2,21,4,11,63,39,24,67
Vienna,4863,3,20,6,10,60,47,13,66
SK Sturm Gra,4863,4,16,9,11,56,39,17,57
RZ Pellets W,4863,5,14,9,13,49,51,-2,51
Rapid Vienna,4863,6,12,12,12,51,40,11,48
Admira Wacke,4863,7,12,9,15,43,57,-14,45
Mattersburg,4863,8,8,10,18,37,52,-15,34
St. Pölten,4863,9,7,9,20,36,64,-28,30
SV Josko Rie,4863,10,8,6,22,30,58,-28,30
FC Salzburg,4864,1,25,4,7,84,33,51,79
SK Sturm Gra,4864,2,20,6,10,67,39,28,66
SC Rheindorf,4864,3,20,5,11,55,41,14,65
Vienna,4864,4,18,4,14,66,62,4,58
Rapid Vienna,4864,5,16,8,12,59,42,17,56
RZ Pellets W,4864,6,12,8,16,42,51,-9,44
Admira Wacke,4864,7,11,6,19,38,63,-25,39
St. Pölten,4864,8,10,8,18,41,69,-28,38
SV Josko Rie,4864,9,10,3,23,31,57,-26,33
Mattersburg,4864,10,8,8,20,31,57,-26,32
SK Sturm Gra,4865,1,21,6,9,56,28,28,69
FC Salzburg,4865,2,20,7,9,62,32,30,67
SC Rheindorf,4865,3,18,7,11,49,43,6,61
Rapid Vienna,4865,4,16,12,8,62,35,27,60
Vienna,4865,5,17,8,11,53,43,10,59
Admira Wacke,4865,6,14,7,15,48,58,-10,49
SV Josko Rie,4865,7,11,6,19,33,51,-18,39
RZ Pellets W,4865,8,10,6,20,37,61,-24,36
St. Pölten,4865,9,8,8,20,38,64,-26,32
Mattersburg,4865,10,7,9,20,33,56,-23,30
SC Rheindorf,4866,1,21,8,7,60,39,21,71
FC Salzburg,4866,2,20,8,8,62,31,31,68
Vienna,4866,3,21,5,10,63,44,19,68
SK Sturm Gra,4866,4,16,8,12,53,35,18,56
Rapid Vienna,4866,5,14,12,10,54,39,15,54
Admira Wacke,4866,6,12,8,16,37,56,-19,44
St. Pölten,4866,7,9,12,15,41,58,-17,39
RZ Pellets W,4866,8,10,6,20,38,58,-20,36
SV Josko Rie,4866,9,9,7,20,39,60,-21,34
Mattersburg,4866,10,5,12,19,32,59,-27,27
FC Salzburg,4867,1,19,10,7,64,29,35,67
SC Rheindorf,4867,2,19,7,10,58,43,15,64
Vienna,4867,3,18,6,12,60,51,9,60
SK Sturm Gra,4867,4,17,8,11,57,38,19,59
Rapid Vienna,4867,5,13,13,10,55,38,17,52
Admira Wacke,4867,6,13,5,18,44,60,-16,44
Mattersburg,4867,7,11,9,16,43,58,-15,42
RZ Pellets W,4867,8,10,9,17,43,61,-18,39
St. Pölten,4867,9,10,8,18,42,61,-19,38
SV Josko Rie,4867,10,8,9,19,28,55,-27,33
SC Rheindorf,4868,1,22,7,7,62,43,19,73
FC Salzburg,4868,2,22,6,8,68,33,35,72
SK Sturm Gra,4868,3,18,8,10,62,36,26,62
Vienna,4868,4,18,5,13,64,51,13,59
Rapid Vienna,4868,5,11,13,12,53,47,6,46
SV Josko Rie,4868,6,12,6,18,39,52,-13,42
Admira Wacke,4868,7,12,4,20,38,63,-25,40
RZ Pellets W,4868,8,11,6,19,44,61,-17,39
Mattersburg,4868,9,8,13,15,44,56,-12,37
St. Pölten,4868,10,6,12,18,32,64,-32,30
FC Salzburg,4869,1,24,6,6,74,35,39,78
SC Rheindorf,4869,2,22,9,5,66,34,32,75
Vienna,4869,3,19,4,13,64,53,11,61
Rapid Vienna,4869,4,16,8,12,66,42,24,56
SK Sturm Gra,4869,5,15,8,13,55,42,13,53
SV Josko Rie,4869,6,13,4,19,37,55,-18,43
RZ Pellets W,4869,7,12,5,19,48,62,-14,41
Admira Wacke,4869,8,11,4,21,35,66,-31,37
St. Pölten,4869,9,7,12,17,37,59,-22,33
Mattersburg,4869,10,6,10,20,34,68,-34,28
SC Rheindorf,4870,1,23,9,4,63,34,29,78
FC Salzburg,4870,2,21,7,8,60,31,29,70
SK Sturm Gra,4870,3,17,7,12,60,36,24,58
Vienna,4870,4,17,7,12,63,56,7,58
Rapid Vienna,4870,5,13,9,14,53,45,8,48
Admira Wacke,4870,6,13,7,16,40,54,-14,46
RZ Pellets W,4870,7,11,8,17,42,58,-16,41
St. Pölten,4870,8,9,10,17,40,61,-21,37
SV Josko Rie,4870,9,9,6,21,33,56,-23,33
Mattersburg,4870,10,8,8,20,34,57,-23,32
FC Salzburg,4871,1,23,6,7,67,30,37,75
SC Rheindorf,4871,2,17,11,8,53,41,12,62
Vienna,4871,3,19,4,13,63,56,7,61
SK Sturm Gra,4871,4,18,5,13,55,39,16,59
Rapid Vienna,4871,5,15,9,12,60,41,19,54
RZ Pellets W,4871,6,12,7,17,41,51,-10,43
Admira Wacke,4871,7,11,9,16,43,59,-16,42
St. Pölten,4871,8,10,8,18,47,74,-27,38
SV Josko Rie,4871,9,11,4,21,39,58,-19,37
Mattersburg,4871,10,8,9,19,42,61,-19,33
FC Salzburg,4872,1,21,7,8,67,34,33,70
SC Rheindorf,4872,2,18,9,9,58,46,12,63
Vienna,4872,3,18,6,12,61,50,11,60
SK Sturm Gra,4872,4,18,5,13,59,44,15,59
Rapid Vienna,4872,5,14,8,14,50,44,6,50
Admira Wacke,4872,6,14,6,16,42,53,-11,48
RZ Pellets W,4872,7,13,8,15,49,52,-3,47
St. Pölten,4872,8,10,8,18,39,60,-21,38
SV Josko Rie,4872,9,10,7,19,35,52,-17,37
Mattersburg,4872,10,8,8,20,33,58,-25,32
SC Rheindorf,4873,1,24,4,8,65,45,20,76
SK Sturm Gra,4873,2,21,5,10,63,39,24,68
FC Salzburg,4873,3,20,6,10,57,31,26,66
Vienna,4873,4,20,4,12,68,49,19,64
RZ Pellets W,4873,5,13,7,16,54,63,-9,46
Rapid Vienna,4873,6,11,12,13,58,48,10,45
Admira Wacke,4873,7,13,6,17,40,57,-17,45
Mattersburg,4873,8,10,7,19,44,61,-17,37
SV Josko Rie,4873,9,10,4,22,35,58,-23,34
St. Pölten,4873,10,7,7,22,36,69,-33,28
FC Salzburg,4874,1,21,5,10,63,31,32,68
SK Sturm Gra,4874,2,20,6,10,64,34,30,66
Rapid Vienna,4874,3,19,8,9,59,36,23,65
SC Rheindorf,4874,4,19,8,9,57,40,17,65
Vienna,4874,5,18,3,15,56,58,-2,57
RZ Pellets W,4874,6,13,7,16,46,55,-9,46
SV Josko Rie,4874,7,12,5,19,34,55,-21,41
Admira Wacke,4874,8,11,7,18,41,61,-20,40
St. Pölten,4874,9,8,7,21,36,65,-29,31
Mattersburg,4874,10,7,8,21,39,60,-21,29
FC Salzburg,4875,1,20,8,8,70,30,40,68
SK Sturm Gra,4875,2,20,6,10,68,46,22,66
SC Rheindorf,4875,3,19,8,9,52,38,14,65
Rapid Vienna,4875,4,15,10,11,58,40,18,55
Vienna,4875,5,16,7,13,65,57,8,55
RZ Pellets W,4875,6,11,9,16,49,67,-18,42
SV Josko Rie,4875,7,12,3,21,35,59,-24,39
Admira Wacke,4875,8,10,8,18,39,59,-20,38
Mattersburg,4875,9,9,10,17,40,55,-15,37
St. Pölten,4875,10,9,9,18,40,65,-25,36
FC Salzburg,4876,1,22,7,7,64,24,40,73
Rapid Vienna,4876,2,17,10,9,63,38,25,61
SC Rheindorf,4876,3,18,7,11,54,46,8,61
SK Sturm Gra,4876,4,18,5,13,54,38,16,59
Vienna,4876,5,19,2,15,71,57,14,59
RZ Pellets W,4876,6,13,5,18,39,56,-17,44
SV Josko Rie,4876,7,13,3,20,42,60,-18,42
Admira Wacke,4876,8,12,5,19,32,57,-25,41
Mattersburg,4876,9,10,8,18,40,54,-14,38
St. Pölten,4876,10,8,8,20,38,67,-29,32
FC Salzburg,4877,1,21,8,7,70,31,39,71
SK Sturm Gra,4877,2,20,5,11,59,40,19,65
SC Rheindorf,4877,3,19,7,10,54,44,10,64
Vienna,4877,4,18,5,13,63,61,2,59
Rapid Vienna,4877,5,16,10,10,63,39,24,58
RZ Pellets W,4877,6,14,5,17,55,61,-6,47
St. Pölten,4877,7,11,9,16,49,64,-15,42
Admira Wacke,4877,8,9,8,19,34,60,-26,35
Mattersburg,4877,9,9,7,20,44,62,-18,34
SV Josko Rie,4877,10,8,6,22,33,62,-29,30
SK Sturm Gra,4878,1,20,7,9,61,29,32,67
Vienna,4878,2,20,4,12,68,45,23,64
FC Salzburg,4878,3,19,6,11,56,36,20,63
Rapid Vienna,4878,4,17,10,9,54,29,25,61
SC Rheindorf,4878,5,18,7,11,50,49,1,61
RZ Pellets W,4878,6,13,8,15,43,57,-14,47
St. Pölten,4878,7,9,11,16,37,59,-22,38
Admira Wacke,4878,8,10,7,19,35,57,-22,37
SV Josko Rie,4878,9,10,4,22,31,55,-24,34
Mattersburg,4878,10,9,6,21,37,56,-19,33
SK Sturm Gra,4879,1,23,4,9,65,33,32,73
FC Salzburg,4879,2,20,9,7,60,33,27,69
Vienna,4879,3,19,5,12,61,47,14,62
SC Rheindorf,4879,4,18,8,10,51,39,12,62
Rapid Vienna,4879,5,16,10,10,65,38,27,58
Admira Wacke,4879,6,11,6,19,41,63,-22,39
RZ Pellets W,4879,7,10,8,18,42,59,-17,38
SV Josko Rie,4879,8,11,4,21,34,53,-19,37
St. Pölten,4879,9,9,8,19,42,70,-28,35
Mattersburg,4879,10,7,10,19,36,62,-26,31
FC Salzburg,4880,1,20,8,8,64,33,31,68
SK Sturm Gra,4880,2,20,7,9,62,35,27,67
SC Rheindorf,4880,3,19,9,8,53,36,17,66
Vienna,4880,4,20,3,13,57,51,6,63
RZ Pellets W,4880,5,15,5,16,48,54,-6,50
Rapid Vienna,4880,6,12,12,12,55,44,11,48
Mattersburg,4880,7,10,8,18,41,55,-14,38
St. Pölten,4880,8,9,10,17,40,57,-17,37
SV Josko Rie,4880,9,11,2,23,34,63,-29,35
Admira Wacke,4880,10,10,4,22,36,62,-26,34
Vienna,4881,1,21,5,10,68,48,20,68
FC Salzburg,4881,2,19,8,9,58,34,24,65
SK Sturm Gra,4881,3,19,6,11,57,39,18,63
SC Rheindorf,4881,4,18,7,11,53,46,7,61
Rapid Vienna,4881,5,14,11,11,54,40,14,53
RZ Pellets W,4881,6,13,11,12,48,44,4,50
SV Josko Rie,4881,7,11,4,21,41,60,-19,37
St. Pölten,4881,8,9,9,18,47,70,-23,36
Admira Wacke,4881,9,10,6,20,33,67,-34,36
Mattersburg,4881,10,8,9,19,46,57,-11,33
SK Sturm Gra,4882,1,22,5,9,65,29,36,71
FC Salzburg,4882,2,21,7,8,63,29,34,70
SC Rheindorf,4882,3,17,10,9,61,52,9,61
Vienna,4882,4,17,5,14,59,51,8,56
Rapid Vienna,4882,5,12,10,14,54,46,8,46
Admira Wacke,4882,6,13,6,17,36,54,-18,45
SV Josko Rie,4882,7,12,5,19,39,57,-18,41
RZ Pellets W,4882,8,10,11,15,38,58,-20,41
St. Pölten,4882,9,9,9,18,47,70,-23,36
Mattersburg,4882,10,9,8,19,41,57,-16,35
SK Sturm Gra,4883,1,20,6,10,61,36,25,66
FC Salzburg,4883,2,19,8,9,60,36,24,65
Vienna,4883,3,18,7,11,68,51,17,61
SC Rheindorf,4883,4,17,7,12,51,46,5,58
Rapid Vienna,4883,5,15,10,11,58,38,20,55
Admira Wacke,4883,6,13,6,17,36,52,-16,45
RZ Pellets W,4883,7,11,8,17,45,58,-13,41
SV Josko Rie,4883,8,11,6,19,34,48,-14,39
St. Pölten,4883,9,10,9,17,40,69,-29,39
Mattersburg,4883,10,7,11,18,37,56,-19,32
FC Salzburg,4884,1,20,10,6,63,27,36,70
Vienna,4884,2,21,4,11,63,49,14,67
SK Sturm Gra,4884,3,20,6,10,67,34,33,66
SC Rheindorf,4884,4,18,10,8,54,37,17,64
Rapid Vienna,4884,5,10,13,13,47,48,-1,43
SV Josko Rie,4884,6,12,5,19,34,50,-16,41
Mattersburg,4884,7,11,8,17,37,54,-17,41
Admira Wacke,4884,8,9,11,16,41,62,-21,38
St. Pölten,4884,9,8,10,18,36,59,-23,34
RZ Pellets W,4884,10,8,9,19,33,55,-22,33
SK Sturm Gra,4885,1,22,6,8,65,29,36,72
FC Salzburg,4885,2,18,10,8,60,33,27,64
Vienna,4885,3,18,8,10,59,46,13,62
SC Rheindorf,4885,4,18,7,11,51,40,11,61
RZ Pellets W,4885,5,12,9,15,44,49,-5,45
Rapid Vienna,4885,6,11,11,14,47,41,6,44
Admira Wacke,4885,7,12,7,17,42,60,-18,43
St. Pölten,4885,8,10,9,17,44,61,-17,39
SV Josko Rie,4885,9,10,6,20,33,57,-24,36
Mattersburg,4885,10,9,7,20,36,65,-29,34
SC Rheindorf,4886,1,21,7,8,54,42,12,70
SK Sturm Gra,4886,2,22,3,11,73,34,39,69
FC Salzburg,4886,3,20,9,7,59,29,30,69
Vienna,4886,4,18,6,12,64,55,9,60
Rapid Vienna,4886,5,14,9,13,57,41,16,51
Admira Wacke,4886,6,15,5,16,49,56,-7,50
SV Josko Rie,4886,7,10,7,19,38,56,-18,37
RZ Pellets W,4886,8,10,6,20,39,68,-29,36
St. Pölten,4886,9,8,9,19,47,74,-27,33
Mattersburg,4886,10,7,9,20,34,59,-25,30
FC Salzburg,4887,1,23,9,4,69,23,46,78
SK Sturm Gra,4887,2,20,5,11,57,38,19,65
Vienna,4887,3,18,7,11,64,48,16,61
SC Rheindorf,4887,4,15,8,13,50,51,-1,53
Rapid Vienna,4887,5,14,9,13,59,48,11,51
RZ Pellets W,4887,6,13,7,16,42,56,-14,46
SV Josko Rie,4887,7,13,6,17,41,50,-9,45
Admira Wacke,4887,8,10,9,17,31,52,-21,39
Mattersburg,4887,9,8,8,20,35,58,-23,32
St. Pölten,4887,10,5,14,17,36,60,-24,29
FC Salzburg,4888,1,22,8,6,63,28,35,74
SK Sturm Gra,4888,2,19,6,11,53,28,25,63
Vienna,4888,3,19,6,11,60,42,18,63
SC Rheindorf,4888,4,18,9,9,60,50,10,63
Rapid Vienna,4888,5,15,10,11,57,41,16,55
RZ Pellets W,4888,6,14,8,14,53,52,1,50
Admira Wacke,4888,7,11,8,17,33,57,-24,41
SV Josko Rie,4888,8,9,8,19,34,54,-20,35
St. Pölten,4888,9,6,11,19,40,68,-28,29
Mattersburg,4888,10,6,8,22,30,63,-33,26
FC Salzburg,4889,1,25,5,6,69,26,43,80
SC Rheindorf,4889,2,21,5,10,60,49,11,68
Vienna,4889,3,19,4,13,61,51,10,61
SK Sturm Gra,4889,4,18,6,12,51,38,13,60
RZ Pellets W,4889,5,12,9,15,47,53,-6,45
Rapid Vienna,4889,6,10,13,13,50,42,8,43
Mattersburg,4889,7,11,7,18,41,60,-19,40
St. Pölten,4889,8,9,9,18,44,61,-17,36
Admira Wacke,4889,9,9,9,18,32,56,-24,36
SV Josko Rie,4889,10,10,5,21,39,58,-19,35
FC Salzburg,4890,1,22,7,7,72,30,42,73
SC Rheindorf,4890,2,18,13,5,54,37,17,67
SK Sturm Gra,4890,3,20,5,11,62,33,29,65
Vienna,4890,4,19,3,14,66,54,12,60
Rapid Vienna,4890,5,14,10,12,63,46,17,52
Admira Wacke,4890,6,14,4,18,37,58,-21,46
RZ Pellets W,4890,7,12,6,18,45,67,-22,42
SV Josko Rie,4890,8,10,4,22,38,59,-21,34
St. Pölten,4890,9,8,10,18,45,73,-28,34
Mattersburg,4890,10,8,8,20,30,55,-25,32
SK Sturm Gra,4891,1,21,7,8,65,34,31,70
FC Salzburg,4891,2,18,9,9,62,32,30,63
Rapid Vienna,4891,3,18,8,10,59,39,20,62
SC Rheindorf,4891,4,18,8,10,50,37,13,62
Vienna,4891,5,16,5,15,62,63,-1,53
SV Josko Rie,4891,6,13,6,17,41,51,-10,45
Admira Wacke,4891,7,12,7,17,40,60,-20,43
RZ Pellets W,4891,8,12,5,19,49,60,-11,41
St. Pölten,4891,9,9,8,19,42,63,-21,35
Mattersburg,4891,10,8,7,21,36,67,-31,31
FC Salzburg,4892,1,21,8,7,65,30,35,71
SC Rheindorf,4892,2,16,13,7,53,44,9,61
Vienna,4892,3,18,6,12,59,50,9,60
Rapid Vienna,4892,4,15,12,9,64,42,22,57
SK Sturm Gra,4892,5,16,7,13,55,43,12,55
RZ Pellets W,4892,6,15,10,11,42,42,0,55
St. Pölten,4892,7,8,13,15,45,61,-16,37
SV Josko Rie,4892,8,10,6,20,35,52,-17,36
Admira Wacke,4892,9,10,6,20,38,67,-29,36
Mattersburg,4892,10,6,9,21,37,62,-25,27
SC Rheindorf,4893,1,20,10,6,65,44,21,70
Vienna,4893,2,21,6,9,67,42,25,69
SK Sturm Gra,4893,3,21,5,10,59,28,31,68
FC Salzburg,4893,4,18,10,8,64,36,28,64
Rapid Vienna,4893,5,13,10,13,56,47,9,49
RZ Pellets W,4893,6,12,5,19,40,54,-14,41
Admira Wacke,4893,7,12,4,20,31,55,-24,40
Mattersburg,4893,8,9,12,15,41,55,-14,39
SV Josko Rie,4893,9,10,6,20,31,57,-26,36
St. Pölten,4893,10,6,8,22,34,70,-36,26
FC Salzburg,4894,1,23,8,5,69,22,47,77
SC Rheindorf,4894,2,22,6,8,59,37,22,72
SK Sturm Gra,4894,3,19,4,13,55,42,13,61
Vienna,4894,4,18,7,11,64,54,10,61
Rapid Vienna,4894,5,15,10,11,68,48,20,55
Admira Wacke,4894,6,12,8,16,44,61,-17,44
RZ Pellets W,4894,7,10,10,16,42,54,-12,40
St. Pölten,4894,8,7,10,19,45,69,-24,31
SV Josko Rie,4894,9,7,9,20,31,55,-24,30
Mattersburg,4894,10,7,8,21,29,64,-35,29
SC Rheindorf,4895,1,22,7,7,62,44,18,73
FC Salzburg,4895,2,21,6,9,66,31,35,69
Vienna,4895,3,19,8,9,74,53,21,65
SK Sturm Gra,4895,4,18,6,12,59,35,24,60
Rapid Vienna,4895,5,14,10,12,62,47,15,52
RZ Pellets W,4895,6,12,10,14,49,60,-11,46
Admira Wacke,4895,7,11,9,16,41,62,-21,42
SV Josko Rie,4895,8,11,5,20,32,52,-20,38
St. Pölten,4895,9,6,11,19,42,71,-29,29
Mattersburg,4895,10,6,8,22,40,72,-32,26
FC Salzburg,4896,1,22,6,8,65,29,36,72
SK Sturm Gra,4896,2,21,6,9,62,37,25,69
SC Rheindorf,4896,3,20,6,10,58,45,13,66
Vienna,4896,4,18,5,13,58,51,7,59
Rapid Vienna,4896,5,16,9,11,59,36,23,57
RZ Pellets W,4896,6,11,9,16,43,51,-8,42
Admira Wacke,4896,7,11,5,20,36,62,-26,38
SV Josko Rie,4896,8,11,5,20,35,61,-26,38
Mattersburg,4896,9,9,9,18,38,50,-12,36
St. Pölten,4896,10,5,12,19,38,70,-32,27
SC Rheindorf,4897,1,20,8,8,60,42,18,68
FC Salzburg,4897,2,18,12,6,66,29,37,66
Vienna,4897,3,19,5,12,61,46,15,62
SK Sturm Gra,4897,4,17,9,10,56,35,21,60
RZ Pellets W,4897,5,14,9,13,50,56,-6,51
Rapid Vienna,4897,6,11,14,11,50,41,9,47
Admira Wacke,4897,7,13,6,17,36,54,-18,45
SV Josko Rie,4897,8,10,7,19,35,57,-22,37
St. Pölten,4897,9,7,10,19,40,62,-22,31
Mattersburg,4897,10,7,8,21,33,65,-32,29
FC Salzburg,4898,1,21,9,6,71,27,44,72
SC Rheindorf,4898,2,20,7,9,63,46,17,67
SK Sturm Gra,4898,3,20,4,12,58,43,15,64
Rapid Vienna,4898,4,16,9,11,54,37,17,57
Vienna,4898,5,17,5,14,59,56,3,56
RZ Pellets W,4898,6,12,7,17,43,55,-12,43
Admira Wacke,4898,7,11,6,19,34,56,-22,39
SV Josko Rie,4898,8,10,7,19,36,54,-18,37
St. Pölten,4898,9,10,7,19,38,62,-24,37
Mattersburg,4898,10,8,9,19,35,55,-20,33
FC Salzburg,4899,1,23,7,6,73,29,44,76
SC Rheindorf,4899,2,18,11,7,56,42,14,65
SK Sturm Gra,4899,3,17,8,11,51,33,18,59
Vienna,4899,4,18,5,13,65,58,7,59
Rapid Vienna,4899,5,13,13,10,54,41,13,52
RZ Pellets W,4899,6,14,9,13,49,50,-1,51
SV Josko Rie,4899,7,11,7,18,38,49,-11,40
Admira Wacke,4899,8,8,10,18,35,64,-29,34
Mattersburg,4899,9,8,9,19,39,65,-26,33
St. Pölten,4899,10,6,9,21,36,65,-29,27
SK Sturm Gra,4900,1,21,8,7,59,30,29,71
FC Salzburg,4900,2,18,11,7,62,31,31,65
Vienna,4900,3,17,11,8,61,47,14,62
SC Rheindorf,4900,4,16,9,11,50,47,3,57
Rapid Vienna,4900,5,15,9,12,57,44,13,54
Admira Wacke,4900,6,11,9,16,39,59,-20,42
St. Pölten,4900,7,9,11,16,42,59,-17,38
SV Josko Rie,4900,8,10,7,19,33,47,-14,37
Mattersburg,4900,9,9,9,18,38,52,-14,36
RZ Pellets W,4900,10,8,8,20,41,66,-25,32
FC Salzburg,4901,1,21,8,7,69,27,42,71
Vienna,4901,2,18,8,10,54,46,8,62
SK Sturm Gra,4901,3,18,7,11,54,32,22,61
SC Rheindorf,4901,4,17,6,13,53,48,5,57
Rapid Vienna,4901,5,15,9,12,51,34,17,54
RZ Pellets W,4901,6,12,10,14,43,50,-7,46
SV Josko Rie,4901,7,13,5,18,44,57,-13,44
Admira Wacke,4901,8,11,5,20,33,58,-25,38
St. Pölten,4901,9,9,10,17,46,66,-20,37
Mattersburg,4901,10,8,8,20,35,64,-29,32
Vienna,4902,1,21,7,8,65,48,17,70
SK Sturm Gra,4902,2,21,5,10,69,41,28,68
FC Salzburg,4902,3,19,9,8,66,36,30,66
Rapid Vienna,4902,4,17,11,8,60,35,25,62
SC Rheindorf,4902,5,16,8,12,48,43,5,56
Admira Wacke,4902,6,14,6,16,42,54,-12,48
RZ Pellets W,4902,7,9,11,16,42,55,-13,38
Mattersburg,4902,8,8,9,19,35,55,-20,33
SV Josko Rie,4902,9,9,4,23,32,59,-27,31
St. Pölten,4902,10,7,8,21,37,70,-33,29
SC Rheindorf,4903,1,24,5,7,57,38,19,77
FC Salzburg,4903,2,19,8,9,65,32,33,65
SK Sturm Gra,4903,3,19,6,11,63,40,23,63
Vienna,4903,4,19,4,13,63,53,10,61
RZ Pellets W,4903,5,16,8,12,57,50,7,56
Rapid Vienna,4903,6,15,10,11,59,44,15,55
SV Josko Rie,4903,7,11,6,19,36,54,-18,39
Admira Wacke,4903,8,11,6,19,38,60,-22,39
Mattersburg,4903,9,7,6,23,35,66,-31,27
St. Pölten,4903,10,5,9,22,38,74,-36,24
SC Rheindorf,4904,1,21,8,7,60,46,14,71
FC Salzburg,4904,2,20,9,7,70,34,36,69
SK Sturm Gra,4904,3,17,8,11,52,34,18,59
Vienna,4904,4,17,5,14,64,50,14,56
Rapid Vienna,4904,5,12,11,13,59,48,11,47
RZ Pellets W,4904,6,12,8,16,47,59,-12,44
SV Josko Rie,4904,7,13,5,18,40,54,-14,44
St. Pölten,4904,8,10,9,17,45,67,-22,39
Admira Wacke,4904,9,10,7,19,35,65,-30,37
Mattersburg,4904,10,8,10,18,39,54,-15,34
FC Salzburg,4905,1,22,7,7,62,25,37,73
Vienna,4905,2,21,4,11,66,50,16,67
SK Sturm Gra,4905,3,19,8,9,62,33,29,65
SC Rheindorf,4905,4,15,9,12,47,44,3,54
Rapid Vienna,4905,5,14,10,12,48,36,12,52
SV Josko Rie,4905,6,15,2,19,41,53,-12,47
Admira Wacke,4905,7,14,5,17,34,50,-16,47
RZ Pellets W,4905,8,10,7,19,42,59,-17,37
St. Pölten,4905,9,7,11,18,36,65,-29,32
Mattersburg,4905,10,7,9,20,32,55,-23,30
SC Rheindorf,4906,1,24,5,7,73,40,33,77
FC Salzburg,4906,2,21,7,8,66,35,31,70
Vienna,4906,3,21,4,11,68,47,21,67
SK Sturm Gra,4906,4,18,6,12,51,37,14,60
Rapid Vienna,4906,5,11,13,12,54,43,11,46
RZ Pellets W,4906,6,12,7,17,41,49,-8,43
Admira Wacke,4906,7,10,9,17,39,62,-23,39
Mattersburg,4906,8,9,9,18,36,56,-20,36
St. Pölten,4906,9,8,10,18,38,67,-29,34
SV Josko Rie,4906,10,9,4,23,32,62,-30,31
FC Salzburg,4907,1,19,10,7,62,33,29,67
SK Sturm Gra,4907,2,19,8,9,63,41,22,65
SC Rheindorf,4907,3,16,12,8,54,47,7,60
Vienna,4907,4,17,7,12,69,50,19,58
Rapid Vienna,4907,5,12,12,12,50,38,12,48
Admira Wacke,4907,6,13,8,15,46,60,-14,47
RZ Pellets W,4907,7,12,8,16,50,56,-6,44
St. Pölten,4907,8,7,16,13,43,59,-16,37
SV Josko Rie,4907,9,10,6,20,33,55,-22,36
Mattersburg,4907,10,7,9,20,33,64,-31,30
FC Salzburg,4908,1,23,6,7,71,32,39,75
SC Rheindorf,4908,2,21,6,9,58,39,19,69
SK Sturm Gra,4908,3,20,7,9,64,32,32,67
Rapid Vienna,4908,4,15,10,11,56,41,15,55
Vienna,4908,5,15,7,14,56,55,1,52
RZ Pellets W,4908,6,13,8,15,52,58,-6,47
Admira Wacke,4908,7,12,7,17,41,57,-16,43
SV Josko Rie,4908,8,11,5,20,29,53,-24,38
St. Pölten,4908,9,7,8,21,32,66,-34,29
Mattersburg,4908,10,6,10,20,38,64,-26,28
SC Rheindorf,4909,1,20,8,8,61,42,19,68
FC Salzburg,4909,2,19,10,7,58,29,29,67
SK Sturm Gra,4909,3,18,6,12,62,42,20,60
Vienna,4909,4,17,6,13,62,53,9,57
Rapid Vienna,4909,5,14,13,9,59,41,18,55
RZ Pellets W,4909,6,11,8,17,38,55,-17,41
SV Josko Rie,4909,7,12,4,20,39,57,-18,40
Admira Wacke,4909,8,11,7,18,38,61,-23,40
St. Pölten,4909,9,10,9,17,41,58,-17,39
Mattersburg,4909,10,7,11,18,33,53,-20,32
FC Salzburg,4910,1,21,8,7,64,29,35,71
SC Rheindorf,4910,2,20,8,8,55,36,19,68
Vienna,4910,3,21,4,11,63,47,16,67
Rapid Vienna,4910,4,14,10,12,63,48,15,52
SK Sturm Gra,4910,5,15,7,14,51,42,9,52
RZ Pellets W,4910,6,12,8,16,47,59,-12,44
Admira Wacke,4910,7,10,10,16,35,53,-18,40
SV Josko Rie,4910,8,12,4,20,33,54,-21,40
St. Pölten,4910,9,8,11,17,36,55,-19,35
Mattersburg,4910,10,7,10,19,35,59,-24,31
SK Sturm Gra,4911,1,21,6,9,68,32,36,69
FC Salzburg,4911,2,20,7,9,64,36,28,67
Vienna,4911,3,20,6,10,65,42,23,66
SC Rheindorf,4911,4,17,9,10,54,52,2,60
Rapid Vienna,4911,5,14,12,10,61,44,17,54
RZ Pellets W,4911,6,12,9,15,41,56,-15,45
Mattersburg,4911,7,9,11,16,35,49,-14,38
Admira Wacke,4911,8,9,8,19,34,62,-28,35
SV Josko Rie,4911,9,10,3,23,33,56,-23,33
St. Pölten,4911,10,7,11,18,35,61,-26,32
SC Rheindorf,4912,1,21,7,8,54,34,20,70
SK Sturm Gra,4912,2,20,7,9,60,34,26,67
FC Salzburg,4912,3,19,9,8,64,32,32,66
Vienna,4912,4,17,8,11,62,50,12,59
RZ Pellets W,4912,5,14,6,16,46,50,-4,48
Admira Wacke,4912,6,11,8,17,37,57,-20,41
Mattersburg,4912,7,10,9,17,37,51,-14,39
SV Josko Rie,4912,8,11,5,20,33,55,-22,38
Rapid Vienna,4912,9,9,10,17,45,50,-5,37
St. Pölten,4912,10,9,9,18,42,67,-25,36
SC Rheindorf,4913,1,24,6,6,71,41,30,78
FC Salzburg,4913,2,21,9,6,64,28,36,72
SK Sturm Gra,4913,3,20,7,9,60,32,28,67
Vienna,4913,4,18,5,13,66,63,3,59
Rapid Vienna,4913,5,16,9,11,59,45,14,57
SV Josko Rie,4913,6,12,3,21,38,55,-17,39
RZ Pellets W,4913,7,10,6,20,39,58,-19,36
St. Pölten,4913,8,9,9,18,43,64,-21,36
Admira Wacke,4913,9,10,4,22,39,68,-29,34
Mattersburg,4913,10,8,6,22,37,62,-25,30
FC Salzburg,4914,1,22,8,6,68,34,34,74
SC Rheindorf,4914,2,20,8,8,59,40,19,68
Vienna,4914,3,20,5,11,68,47,21,65
SK Sturm Gra,4914,4,19,4,13,61,42,19,61
Rapid Vienna,4914,5,14,10,12,52,41,11,52
Admira Wacke,4914,6,11,10,15,41,58,-17,43
SV Josko Rie,4914,7,11,5,20,33,52,-19,38
Mattersburg,4914,8,8,10,18,39,55,-16,34
RZ Pellets W,4914,9,8,10,18,41,60,-19,34
St. Pölten,4914,10,7,10,19,36,69,-33,31
FC Salzburg,4915,1,22,6,8,67,31,36,72
SC Rheindorf,4915,2,21,7,8,60,40,20,70
SK Sturm Gra,4915,3,19,6,11,57,33,24,63
Vienna,4915,4,18,6,12,59,51,8,60
Mattersburg,4915,5,12,8,16,37,47,-10,44
RZ Pellets W,4915,6,12,8,16,43,55,-12,44
Admira Wacke,4915,7,13,5,18,35,55,-20,44
Rapid Vienna,4915,8,10,11,15,47,43,4,41
St. Pölten,4915,9,7,12,17,44,70,-26,33
SV Josko Rie,4915,10,9,5,22,30,54,-24,32
FC Salzburg,4916,1,22,9,5,69,28,41,75
SC Rheindorf,4916,2,18,8,10,56,43,13,62
Vienna,4916,3,18,5,13,69,57,12,59
SK Sturm Gra,4916,4,18,5,13,59,47,12,59
SV Josko Rie,4916,5,14,6,16,39,45,-6,48
RZ Pellets W,4916,6,12,11,13,48,52,-4,47
Rapid Vienna,4916,7,10,14,12,53,51,2,44
Admira Wacke,4916,8,11,7,18,36,58,-22,40
St. Pölten,4916,9,9,11,16,42,60,-18,38
Mattersburg,4916,10,5,10,21,30,60,-30,25
SK Sturm Gra,4917,1,21,7,8,67,34,33,70
SC Rheindorf,4917,2,20,6,10,59,50,9,66
FC Salzburg,4917,3,16,14,6,60,33,27,62
Vienna,4917,4,18,7,11,65,50,15,61
Rapid Vienna,4917,5,11,15,10,53,41,12,48
St. Pölten,4917,6,12,9,15,51,65,-14,45
RZ Pellets W,4917,7,11,9,16,48,54,-6,42
SV Josko Rie,4917,8,9,9,18,34,54,-20,36
Admira Wacke,4917,9,9,6,21,36,67,-31,33
Mattersburg,4917,10,6,12,18,33,58,-25,30
SK Sturm Gra,4918,1,21,5,10,64,36,28,68
SC Rheindorf,4918,2,20,7,9,59,43,16,67
Vienna,4918,3,19,7,10,67,52,15,64
FC Salzburg,4918,4,18,5,13,67,40,27,59
Rapid Vienna,4918,5,14,10,12,49,39,10,52
RZ Pellets W,4918,6,13,5,18,50,60,-10,44
Admira Wacke,4918,7,11,9,16,37,63,-26,42
St. Pölten,4918,8,10,8,18,46,64,-18,38
SV Josko Rie,4918,9,9,8,19,36,55,-19,35
Mattersburg,4918,10,9,8,19,34,57,-23,35
FC Salzburg,4919,1,20,11,5,65,30,35,71
SK Sturm Gra,4919,2,19,8,9,67,38,29,65
Vienna,4919,3,20,4,12,67,54,13,64
SC Rheindorf,4919,4,17,9,10,54,44,10,60
Rapid Vienna,4919,5,16,11,9,71,43,28,59
RZ Pellets W,4919,6,16,4,16,53,58,-5,52
Admira Wacke,4919,7,11,7,18,35,63,-28,40
SV Josko Rie,4919,8,9,6,21,33,61,-28,33
St. Pölten,4919,9,6,11,19,40,66,-26,29
Mattersburg,4919,10,7,7,22,33,61,-28,28
FC Salzburg,4920,1,20,8,8,58,32,26,68
SK Sturm Gra,4920,2,20,6,10,67,33,34,66
Vienna,4920,3,18,6,12,65,57,8,60
SC Rheindorf,4920,4,16,9,11,57,53,4,57
RZ Pellets W,4920,5,16,6,14,50,50,0,54
Admira Wacke,4920,6,14,6,16,39,55,-16,48
Rapid Vienna,4920,7,12,11,13,50,43,7,47
St. Pölten,4920,8,10,8,18,46,72,-26,38
SV Josko Rie,4920,9,9,8,19,38,57,-19,35
Mattersburg,4920,10,8,6,22,39,57,-18,30
FC Salzburg,4921,1,23,5,8,74,30,44,74
SK Sturm Gra,4921,2,18,8,10,56,34,22,62
SC Rheindorf,4921,3,16,11,9,49,44,5,59
Rapid Vienna,4921,4,16,10,10,59,39,20,58
Vienna,4921,5,17,7,12,52,47,5,58
RZ Pellets W,4921,6,12,8,16,46,55,-9,44
Admira Wacke,4921,7,12,7,17,40,62,-22,43
Mattersburg,4921,8,9,8,19,30,47,-17,35
SV Josko Rie,4921,9,9,7,20,27,49,-22,34
St. Pölten,4921,10,7,11,18,36,62,-26,32
FC Salzburg,4922,1,20,8,8,69,34,35,68
Vienna,4922,2,21,5,10,78,54,24,68
SC Rheindorf,4922,3,20,8,8,61,41,20,68
SK Sturm Gra,4922,4,16,10,10,52,35,17,58
Rapid Vienna,4922,5,14,11,11,66,45,21,53
Admira Wacke,4922,6,12,7,17,37,53,-16,43
RZ Pellets W,4922,7,11,9,16,43,57,-14,42
St. Pölten,4922,8,9,10,17,39,64,-25,37
SV Josko Rie,4922,9,8,9,19,33,58,-25,33
Mattersburg,4922,10,6,9,21,35,72,-37,27
FC Salzburg,4923,1,22,8,6,70,28,42,74
SC Rheindorf,4923,2,19,9,8,55,44,11,66
SK Sturm Gra,4923,3,19,7,10,63,41,22,64
Vienna,4923,4,17,4,15,61,57,4,55
Rapid Vienna,4923,5,13,10,13,56,43,13,49
RZ Pellets W,4923,6,11,9,16,48,60,-12,42
St. Pölten,4923,7,10,9,17,55,72,-17,39
Mattersburg,4923,8,9,11,16,39,51,-12,38
Admira Wacke,4923,9,11,5,20,34,59,-25,38
SV Josko Rie,4923,10,11,4,21,32,58,-26,37
SC Rheindorf,4924,1,23,6,7,65,37,28,75
FC Salzburg,4924,2,20,9,7,61,29,32,69
SK Sturm Gra,4924,3,20,6,10,55,28,27,66
Vienna,4924,4,17,6,13,55,53,2,57
Rapid Vienna,4924,5,14,11,11,52,36,16,53
RZ Pellets W,4924,6,12,7,17,43,54,-11,43
Admira Wacke,4924,7,12,7,17,37,59,-22,43
Mattersburg,4924,8,8,11,17,36,52,-16,35
SV Josko Rie,4924,9,8,6,22,33,56,-23,30
St. Pölten,4924,10,7,9,20,33,66,-33,30
SK Sturm Gra,4925,1,21,5,10,62,29,33,68
FC Salzburg,4925,2,18,10,8,64,33,31,64
Vienna,4925,3,20,3,13,63,53,10,63
SC Rheindorf,4925,4,16,8,12,51,47,4,56
RZ Pellets W,4925,5,15,7,14,48,52,-4,52
Rapid Vienna,4925,6,12,10,14,49,49,0,46
SV Josko Rie,4925,7,13,4,19,40,53,-13,43
Admira Wacke,4925,8,12,5,19,35,59,-24,41
St. Pölten,4925,9,9,9,18,46,64,-18,36
Mattersburg,4925,10,9,9,18,37,56,-19,36
SC Rheindorf,4926,1,22,6,8,55,36,19,72
FC Salzburg,4926,2,20,8,8,66,34,32,68
Vienna,4926,3,20,6,10,65,53,12,66
SK Sturm Gra,4926,4,20,4,12,61,35,26,64
Rapid Vienna,4926,5,16,10,10,57,39,18,58
Admira Wacke,4926,6,13,5,18,42,61,-19,44
SV Josko Rie,4926,7,12,5,19,46,60,-14,41
RZ Pellets W,4926,8,10,8,18,40,56,-16,38
St. Pölten,4926,9,6,10,20,47,76,-29,28
Mattersburg,4926,10,7,6,23,35,64,-29,27
FC Salzburg,4927,1,19,12,5,60,30,30,69
SC Rheindorf,4927,2,20,9,7,55,39,16,69
Vienna,4927,3,18,5,13,62,54,8,59
Rapid Vienna,4927,4,16,8,12,68,48,20,56
SK Sturm Gra,4927,5,16,8,12,51,38,13,56
St. Pölten,4927,6,11,10,15,46,58,-12,43
SV Josko Rie,4927,7,12,6,18,37,47,-10,42
RZ Pellets W,4927,8,9,11,16,45,62,-17,38
Admira Wacke,4927,9,9,7,20,31,60,-29,34
Mattersburg,4927,10,7,10,19,37,56,-19,31
Vienna,4928,1,22,5,9,79,48,31,71
SC Rheindorf,4928,2,20,8,8,56,41,15,68
SK Sturm Gra,4928,3,18,7,11,57,38,19,61
FC Salzburg,4928,4,16,8,12,58,38,20,56
Rapid Vienna,4928,5,12,13,11,59,45,14,49
RZ Pellets W,4928,6,13,5,18,49,63,-14,44
Mattersburg,4928,7,10,9,17,34,52,-18,39
Admira Wacke,4928,8,10,9,17,32,58,-26,39
SV Josko Rie,4928,9,8,11,17,33,52,-19,35
St. Pölten,4928,10,8,11,17,44,66,-22,35
Vienna,4929,1,22,2,12,74,49,25,68
FC Salzburg,4929,2,20,7,9,69,37,32,67
SC Rheindorf,4929,3,19,8,9,52,42,10,65
SK Sturm Gra,4929,4,19,5,12,53,31,22,62
Rapid Vienna,4929,5,15,10,11,57,44,13,55
RZ Pellets W,4929,6,11,9,16,43,50,-7,42
SV Josko Rie,4929,7,12,6,18,35,55,-20,42
St. Pölten,4929,8,10,10,16,45,62,-17,40
Admira Wacke,4929,9,9,5,22,37,67,-30,32
Mattersburg,4929,10,7,10,19,36,64,-28,31
FC Salzburg,4930,1,22,5,9,66,27,39,71
SC Rheindorf,4930,2,21,7,8,58,41,17,70
SK Sturm Gra,4930,3,18,9,9,56,30,26,63
Vienna,4930,4,19,6,11,63,48,15,63
Rapid Vienna,4930,5,13,10,13,56,42,14,49
RZ Pellets W,4930,6,14,6,16,49,56,-7,48
Mattersburg,4930,7,10,9,17,37,54,-17,39
St. Pölten,4930,8,8,10,18,40,65,-25,34
Admira Wacke,4930,9,10,4,22,34,73,-39,34
SV Josko Rie,4930,10,9,6,21,30,53,-23,33
SK Sturm Gra,4931,1,22,4,10,63,39,24,70
Vienna,4931,2,20,6,10,71,51,20,66
SC Rheindorf,4931,3,18,9,9,57,44,13,63
Rapid Vienna,4931,4,16,12,8,56,34,22,60
FC Salzburg,4931,5,16,10,10,55,33,22,58
RZ Pellets W,4931,6,10,9,17,40,54,-14,39
SV Josko Rie,4931,7,10,9,17,34,49,-15,39
Admira Wacke,4931,8,10,6,20,36,63,-27,36
Mattersburg,4931,9,9,8,19,36,56,-20,35
St. Pölten,4931,10,8,9,19,42,67,-25,33
FC Salzburg,4932,1,22,4,10,64,25,39,70
SC Rheindorf,4932,2,19,9,8,56,44,12,66
SK Sturm Gra,4932,3,18,6,12,55,38,17,60
Vienna,4932,4,16,6,14,53,56,-3,54
Rapid Vienna,4932,5,14,11,11,61,46,15,53
RZ Pellets W,4932,6,14,5,17,47,57,-10,47
Admira Wacke,4932,7,13,8,15,39,51,-12,47
Mattersburg,4932,8,10,8,18,35,51,-16,38
SV Josko Rie,4932,9,9,8,19,35,55,-20,35
St. Pölten,4932,10,7,11,18,42,64,-22,32
FC Salzburg,4933,1,20,6,10,68,36,32,66
SC Rheindorf,4933,2,19,7,10,54,44,10,64
Rapid Vienna,4933,3,17,10,9,53,38,15,61
Vienna,4933,4,18,7,11,60,57,3,61
SK Sturm Gra,4933,5,18,6,12,62,38,24,60
RZ Pellets W,4933,6,13,8,15,47,52,-5,47
SV Josko Rie,4933,7,11,7,18,38,49,-11,40
Admira Wacke,4933,8,11,5,20,41,62,-21,38
St. Pölten,4933,9,9,9,18,45,66,-21,36
Mattersburg,4933,10,8,7,21,38,64,-26,31
SK Sturm Gra,4934,1,22,7,7,64,27,37,73
FC Salzburg,4934,2,19,9,8,59,34,25,66
Vienna,4934,3,19,5,12,71,47,24,62
SC Rheindorf,4934,4,16,8,12,48,50,-2,56
RZ Pellets W,4934,5,15,10,11,54,49,5,55
Rapid Vienna,4934,6,14,9,13,56,46,10,51
SV Josko Rie,4934,7,10,7,19,36,54,-18,37
Mattersburg,4934,8,8,11,17,33,56,-23,35
St. Pölten,4934,9,7,13,16,36,56,-20,34
Admira Wacke,4934,10,7,7,22,29,67,-38,28
SK Sturm Gra,4935,1,20,9,7,59,27,32,69
FC Salzburg,4935,2,19,8,9,60,33,27,65
Vienna,4935,3,19,4,13,64,50,14,61
SC Rheindorf,4935,4,16,7,13,43,43,0,55
Rapid Vienna,4935,5,14,10,12,52,37,15,52
RZ Pellets W,4935,6,13,7,16,40,45,-5,46
SV Josko Rie,4935,7,13,4,19,39,55,-16,43
St. Pölten,4935,8,11,8,17,40,64,-24,41
Admira Wacke,4935,9,10,7,19,31,56,-25,37
Mattersburg,4935,10,9,8,19,37,55,-18,35
FC Salzburg,4936,1,22,8,6,65,26,39,74
SC Rheindorf,4936,2,20,5,11,50,39,11,65
Vienna,4936,3,20,4,12,70,53,17,64
SK Sturm Gra,4936,4,19,5,12,53,36,17,62
RZ Pellets W,4936,5,17,6,13,44,45,-1,57
Admira Wacke,4936,6,14,6,16,44,54,-10,48
Rapid Vienna,4936,7,8,12,16,41,45,-4,36
St. Pölten,4936,8,9,8,19,44,67,-23,35
Mattersburg,4936,9,8,10,18,36,57,-21,34
SV Josko Rie,4936,10,9,4,23,34,59,-25,31
Vienna,4937,1,24,4,8,74,44,30,76
SC Rheindorf,4937,2,20,9,7,53,37,16,69
FC Salzburg,4937,3,19,7,10,61,35,26,64
SK Sturm Gra,4937,4,18,7,11,59,36,23,61
Rapid Vienna,4937,5,15,10,11,57,41,16,55
Admira Wacke,4937,6,12,7,17,38,58,-20,43
RZ Pellets W,4937,7,11,7,18,46,59,-13,40
St. Pölten,4937,8,8,9,19,40,65,-25,33
Mattersburg,4937,9,8,8,20,39,61,-22,32
SV Josko Rie,4937,10,8,6,22,30,61,-31,30
FC Salzburg,4938,1,20,8,8,68,37,31,68
SK Sturm Gra,4938,2,21,5,10,54,30,24,68
SC Rheindorf,4938,3,20,5,11,60,40,20,65
Rapid Vienna,4938,4,17,9,10,59,37,22,60
Vienna,4938,5,17,5,14,62,56,6,56
Admira Wacke,4938,6,12,7,17,40,56,-16,43
SV Josko Rie,4938,7,12,4,20,33,53,-20,40
RZ Pellets W,4938,8,10,8,18,41,57,-16,38
Mattersburg,4938,9,9,8,19,41,63,-22,35
St. Pölten,4938,10,9,7,20,49,78,-29,34
FC Salzburg,4939,1,23,4,9,73,34,39,73
SC Rheindorf,4939,2,19,6,11,57,51,6,63
SK Sturm Gra,4939,3,18,8,10,63,40,23,62
Rapid Vienna,4939,4,16,11,9,68,45,23,59
Vienna,4939,5,18,3,15,60,56,4,57
RZ Pellets W,4939,6,12,11,13,44,50,-6,47
Mattersburg,4939,7,10,9,17,47,57,-10,39
SV Josko Rie,4939,8,10,7,19,31,50,-19,37
Admira Wacke,4939,9,9,7,20,39,74,-35,34
St. Pölten,4939,10,6,12,18,34,59,-25,30
FC Salzburg,4940,1,22,8,6,67,28,39,74
SC Rheindorf,4940,2,18,9,9,55,43,12,63
Rapid Vienna,4940,3,17,9,10,63,42,21,60
SK Sturm Gra,4940,4,18,6,12,59,38,21,60
Vienna,4940,5,17,7,12,65,57,8,58
SV Josko Rie,4940,6,11,6,19,35,53,-18,39
St. Pölten,4940,7,9,11,16,41,64,-23,38
RZ Pellets W,4940,8,10,7,19,37,58,-21,37
Mattersburg,4940,9,9,9,18,37,53,-16,36
Admira Wacke,4940,10,7,12,17,34,57,-23,33
SC Rheindorf,4941,1,19,10,7,51,38,13,67
FC Salzburg,4941,2,18,11,7,63,32,31,65
Vienna,4941,3,19,7,10,65,45,20,64
SK Sturm Gra,4941,4,19,4,13,61,39,22,61
Rapid Vienna,4941,5,14,12,10,53,35,18,54
RZ Pellets W,4941,6,10,10,16,42,59,-17,40
SV Josko Rie,4941,7,10,8,18,39,61,-22,38
Mattersburg,4941,8,9,10,17,42,54,-12,37
St. Pölten,4941,9,8,12,16,32,57,-25,36
Admira Wacke,4941,10,9,6,21,36,64,-28,33
FC Salzburg,4942,1,24,6,6,76,32,44,78
SK Sturm Gra,4942,2,22,7,7,63,30,33,73
SC Rheindorf,4942,3,20,8,8,66,42,24,68
Vienna,4942,4,18,4,14,72,61,11,58
RZ Pellets W,4942,5,13,8,15,45,49,-4,47
Rapid Vienna,4942,6,9,15,12,46,42,4,42
Mattersburg,4942,7,11,9,16,42,52,-10,42
Admira Wacke,4942,8,10,4,22,36,74,-38,34
SV Josko Rie,4942,9,9,4,23,32,66,-34,31
St. Pölten,4942,10,6,11,19,34,64,-30,29
FC Salzburg,4943,1,24,5,7,71,30,41,77
SC Rheindorf,4943,2,20,6,10,61,42,19,66
SK Sturm Gra,4943,3,19,8,9,62,36,26,65
Vienna,4943,4,18,3,15,54,56,-2,57
Rapid Vienna,4943,5,13,10,13,49,39,10,49
RZ Pellets W,4943,6,14,7,15,47,49,-2,49
Admira Wacke,4943,7,14,4,18,42,59,-17,46
SV Josko Rie,4943,8,13,2,21,36,53,-17,41
St. Pölten,4943,9,6,11,19,40,68,-28,29
Mattersburg,4943,10,7,8,21,32,62,-30,29
SK Sturm Gra,4944,1,22,6,8,58,23,35,72
FC Salzburg,4944,2,20,8,8,65,30,35,68
SC Rheindorf,4944,3,18,10,8,47,41,6,64
Vienna,4944,4,19,5,12,55,45,10,62
RZ Pellets W,4944,5,14,9,13,49,45,4,51
Rapid Vienna,4944,6,13,11,12,53,46,7,50
Admira Wacke,4944,7,11,5,20,28,60,-32,38
SV Josko Rie,4944,8,10,6,20,32,50,-18,36
Mattersburg,4944,9,7,11,18,36,53,-17,32
St. Pölten,4944,10,6,9,21,38,68,-30,27
FC Salzburg,4945,1,24,7,5,66,25,41,79
SK Sturm Gra,4945,2,20,5,11,65,34,31,65
Vienna,4945,3,20,5,11,61,45,16,65
SC Rheindorf,4945,4,20,5,11,52,38,14,65
Rapid Vienna,4945,5,14,10,12,51,37,14,52
RZ Pellets W,4945,6,10,10,16,40,55,-15,40
Admira Wacke,4945,7,12,4,20,35,61,-26,40
SV Josko Rie,4945,8,11,5,20,33,49,-16,38
St. Pölten,4945,9,9,8,19,33,62,-29,35
Mattersburg,4945,10,7,7,22,33,63,-30,28
SC Rheindorf,4946,1,23,6,7,59,38,21,75
FC Salzburg,4946,2,20,8,8,63,33,30,68
Vienna,4946,3,21,3,12,61,44,17,66
SK Sturm Gra,4946,4,18,5,13,51,32,19,59
Rapid Vienna,4946,5,16,10,10,56,31,25,58
SV Josko Rie,4946,6,12,6,18,40,53,-13,42
RZ Pellets W,4946,7,11,6,19,50,62,-12,39
Admira Wacke,4946,8,11,6,19,38,66,-28,39
St. Pölten,4946,9,10,7,19,43,71,-28,37
Mattersburg,4946,10,6,7,23,35,66,-31,25
SK Sturm Gra,4947,1,22,6,8,65,32,33,72
FC Salzburg,4947,2,21,7,8,59,28,31,70
Rapid Vienna,4947,3,16,11,9,59,35,24,59
Vienna,4947,4,18,4,14,62,53,9,58
SC Rheindorf,4947,5,17,7,12,51,48,3,58
St. Pölten,4947,6,12,8,16,47,64,-17,44
RZ Pellets W,4947,7,9,9,18,43,65,-22,36
Mattersburg,4947,8,8,11,17,34,51,-17,35
Admira Wacke,4947,9,9,8,19,31,57,-26,35
SV Josko Rie,4947,10,9,7,20,36,54,-18,34
SC Rheindorf,4948,1,19,10,7,50,37,13,67
FC Salzburg,4948,2,20,6,10,67,33,34,66
SK Sturm Gra,4948,3,19,8,9,59,30,29,65
Vienna,4948,4,18,8,10,61,46,15,62
Rapid Vienna,4948,5,16,9,11,56,38,18,57
SV Josko Rie,4948,6,12,5,19,38,56,-18,41
St. Pölten,4948,7,10,9,17,41,61,-20,39
Admira Wacke,4948,8,12,3,21,42,70,-28,39
RZ Pellets W,4948,9,10,7,19,42,62,-20,37
Mattersburg,4948,10,7,9,20,35,58,-23,30
SK Sturm Gra,4949,1,22,7,7,65,31,34,73
FC Salzburg,4949,2,20,5,11,64,33,31,65
SC Rheindorf,4949,3,19,7,10,53,39,14,64
Vienna,4949,4,16,7,13,56,51,5,55
Admira Wacke,4949,5,16,5,15,41,52,-11,53
Rapid Vienna,4949,6,11,11,14,54,51,3,44
RZ Pellets W,4949,7,11,10,15,46,53,-7,43
SV Josko Rie,4949,8,12,5,19,30,49,-19,41
Mattersburg,4949,9,8,9,19,36,57,-21,33
St. Pölten,4949,10,7,10,19,41,70,-29,31
Vienna,4950,1,22,4,10,63,46,17,70
FC Salzburg,4950,2,20,6,10,62,34,28,66
SC Rheindorf,4950,3,19,7,10,55,46,9,64
SK Sturm Gra,4950,4,19,6,11,55,36,19,63
Rapid Vienna,4950,5,14,11,11,51,36,15,53
RZ Pellets W,4950,6,14,7,15,50,52,-2,49
SV Josko Rie,4950,7,12,4,20,40,52,-12,40
Admira Wacke,4950,8,11,6,19,35,63,-28,39
Mattersburg,4950,9,8,10,18,35,53,-18,34
St. Pölten,4950,10,5,11,20,35,63,-28,26
FC Salzburg,4951,1,20,7,9,65,33,32,67
SK Sturm Gra,4951,2,19,8,9,65,36,29,65
SC Rheindorf,4951,3,19,7,10,52,44,8,64
Vienna,4951,4,18,6,12,62,56,6,60
Rapid Vienna,4951,5,14,11,11,54,38,16,53
Admira Wacke,4951,6,13,7,16,39,58,-19,46
RZ Pellets W,4951,7,12,6,18,48,60,-12,42
SV Josko Rie,4951,8,11,8,17,33,48,-15,41
St. Pölten,4951,9,7,12,17,39,59,-20,33
Mattersburg,4951,10,7,8,21,40,65,-25,29
FC Salzburg,4952,1,21,7,8,68,39,29,70
Rapid Vienna,4952,2,17,11,8,67,36,31,62
SK Sturm Gra,4952,3,18,7,11,59,40,19,61
SC Rheindorf,4952,4,17,9,10,53,48,5,60
Vienna,4952,5,16,7,13,64,55,9,55
Admira Wacke,4952,6,12,9,15,44,56,-12,45
RZ Pellets W,4952,7,12,6,18,37,58,-21,42
Mattersburg,4952,8,10,7,19,35,52,-17,37
SV Josko Rie,4952,9,10,5,21,41,67,-26,35
St. Pölten,4952,10,8,10,18,41,58,-17,34
Vienna,4953,1,22,3,11,70,52,18,69
FC Salzburg,4953,2,19,9,8,63,28,35,66
SC Rheindorf,4953,3,19,9,8,63,48,15,66
SK Sturm Gra,4953,4,17,7,12,63,45,18,58
Rapid Vienna,4953,5,15,12,9,59,43,16,57
SV Josko Rie,4953,6,14,4,18,49,53,-4,46
RZ Pellets W,4953,7,13,7,16,52,61,-9,46
Admira Wacke,4953,8,9,7,20,40,76,-36,34
St. Pölten,4953,9,7,12,17,39,65,-26,33
Mattersburg,4953,10,6,8,22,37,64,-27,26
FC Salzburg,4954,1,19,10,7,58,30,28,67
SK Sturm Gra,4954,2,21,4,11,60,34,26,67
Vienna,4954,3,20,4,12,72,50,22,64
SC Rheindorf,4954,4,18,7,11,52,47,5,61
Rapid Vienna,4954,5,14,11,11,57,40,17,53
RZ Pellets W,4954,6,14,7,15,54,61,-7,49
St. Pölten,4954,7,11,8,17,45,63,-18,41
Mattersburg,4954,8,9,8,19,37,59,-22,35
Admira Wacke,4954,9,9,7,20,34,63,-29,34
SV Josko Rie,4954,10,9,6,21,34,56,-22,33
FC Salzburg,4955,1,25,5,6,69,28,41,80
SK Sturm Gra,4955,2,19,6,11,56,35,21,63
SC Rheindorf,4955,3,18,8,10,52,43,9,62
Vienna,4955,4,17,5,14,58,52,6,56
Rapid Vienna,4955,5,14,9,13,53,41,12,51
RZ Pellets W,4955,6,13,8,15,48,54,-6,47
St. Pölten,4955,7,11,9,16,43,59,-16,42
Mattersburg,4955,8,10,7,19,35,54,-19,37
Admira Wacke,4955,9,10,6,20,32,57,-25,36
SV Josko Rie,4955,10,9,5,22,39,62,-23,32
SC Rheindorf,4956,1,21,8,7,61,42,19,71
SK Sturm Gra,4956,2,21,6,9,61,27,34,69
FC Salzburg,4956,3,20,6,10,67,33,34,66
Vienna,4956,4,20,4,12,67,52,15,64
Rapid Vienna,4956,5,14,11,11,58,41,17,53
RZ Pellets W,4956,6,12,10,14,44,55,-11,46
Admira Wacke,4956,7,12,5,19,33,62,-29,41
Mattersburg,4956,8,10,8,18,35,56,-21,38
SV Josko Rie,4956,9,9,4,23,31,56,-25,31
St. Pölten,4956,10,6,8,22,37,70,-33,26
FC Salzburg,4957,1,24,5,7,68,29,39,77
SC Rheindorf,4957,2,19,8,9,60,43,17,65
SK Sturm Gra,4957,3,18,10,8,63,34,29,64
Vienna,4957,4,17,5,14,65,58,7,56
Rapid Vienna,4957,5,11,11,14,55,49,6,44
Mattersburg,4957,6,11,10,15,47,59,-12,43
Admira Wacke,4957,7,12,7,17,39,59,-20,43
RZ Pellets W,4957,8,12,6,18,42,58,-16,42
SV Josko Rie,4957,9,10,8,18,41,56,-15,38
St. Pölten,4957,10,7,8,21,41,76,-35,29
SC Rheindorf,4958,1,21,8,7,61,41,20,71
FC Salzburg,4958,2,20,8,8,65,36,29,68
SK Sturm Gra,4958,3,17,7,12,56,35,21,58
Vienna,4958,4,16,6,14,61,59,2,54
Rapid Vienna,4958,5,14,9,13,62,48,14,51
Admira Wacke,4958,6,11,11,14,40,58,-18,44
RZ Pellets W,4958,7,12,7,17,50,62,-12,43
St. Pölten,4958,8,10,10,16,44,64,-20,40
Mattersburg,4958,9,8,11,17,46,59,-13,35
SV Josko Rie,4958,10,10,5,21,36,59,-23,35
FC Salzburg,4959,1,23,7,6,63,25,38,76
SK Sturm Gra,4959,2,18,8,10,59,33,26,62
Vienna,4959,3,18,3,15,59,53,6,57
SC Rheindorf,4959,4,16,6,14,53,47,6,54
Rapid Vienna,4959,5,15,8,13,53,46,7,53
RZ Pellets W,4959,6,14,9,13,49,47,2,51
Admira Wacke,4959,7,13,6,17,38,55,-17,45
SV Josko Rie,4959,8,12,4,20,34,51,-17,40
Mattersburg,4959,9,11,7,18,38,59,-21,40
St. Pölten,4959,10,5,12,19,37,67,-30,27
SC Rheindorf,4960,1,23,6,7,62,41,21,75
Vienna,4960,2,22,5,9,73,46,27,71
FC Salzburg,4960,3,21,6,9,71,30,41,69
Rapid Vienna,4960,4,14,11,11,58,42,16,53
SK Sturm Gra,4960,5,15,6,15,49,40,9,51
RZ Pellets W,4960,6,11,8,17,39,53,-14,41
Admira Wacke,4960,7,12,5,19,37,61,-24,41
Mattersburg,4960,8,10,7,19,40,50,-10,37
St. Pölten,4960,9,8,11,17,39,66,-27,35
SV Josko Rie,4960,10,9,5,22,35,74,-39,32
FC Salzburg,4961,1,21,9,6,74,32,42,72
Vienna,4961,2,20,5,11,70,51,19,65
SK Sturm Gra,4961,3,19,7,10,55,29,26,64
SC Rheindorf,4961,4,17,9,10,52,38,14,60
Rapid Vienna,4961,5,16,9,11,55,38,17,57
St. Pölten,4961,6,11,7,18,35,59,-24,40
Mattersburg,4961,7,9,12,15,41,56,-15,39
RZ Pellets W,4961,8,11,6,19,46,62,-16,39
SV Josko Rie,4961,9,10,4,22,27,57,-30,34
Admira Wacke,4961,10,9,6,21,33,66,-33,33
FC Salzburg,4962,1,20,9,7,65,27,38,69
Vienna,4962,2,18,8,10,65,51,14,62
SK Sturm Gra,4962,3,18,7,11,53,34,19,61
SC Rheindorf,4962,4,17,9,10,49,41,8,60
Rapid Vienna,4962,5,15,10,11,54,41,13,55
Admira Wacke,4962,6,13,6,17,42,58,-16,45
RZ Pellets W,4962,7,11,9,16,53,59,-6,42
SV Josko Rie,4962,8,11,5,20,38,57,-19,38
St. Pölten,4962,9,8,11,17,43,70,-27,35
Mattersburg,4962,10,8,8,20,33,57,-24,32
FC Salzburg,4963,1,22,6,8,71,35,36,72
SK Sturm Gra,4963,2,22,6,8,66,32,34,72
Vienna,4963,3,19,7,10,58,45,13,64
SC Rheindorf,4963,4,16,11,9,53,39,14,59
RZ Pellets W,4963,5,12,8,16,45,52,-7,44
Mattersburg,4963,6,12,5,19,39,56,-17,41
Rapid Vienna,4963,7,10,10,16,50,56,-6,40
St. Pölten,4963,8,10,8,18,48,66,-18,38
Admira Wacke,4963,9,11,5,20,35,61,-26,38
SV Josko Rie,4963,10,10,6,20,32,55,-23,36
FC Salzburg,4964,1,19,11,6,64,28,36,68
SC Rheindorf,4964,2,19,9,8,54,38,16,66
SK Sturm Gra,4964,3,16,10,10,52,32,20,58
Vienna,4964,4,18,4,14,63,54,9,58
Rapid Vienna,4964,5,13,15,8,61,45,16,54
SV Josko Rie,4964,6,11,9,16,36,51,-15,42
RZ Pellets W,4964,7,11,8,17,49,62,-13,41
St. Pölten,4964,8,10,9,17,39,58,-19,39
Mattersburg,4964,9,9,9,18,42,60,-18,36
Admira Wacke,4964,10,8,8,20,36,68,-32,32
SC Rheindorf,4965,1,21,6,9,64,44,20,69
SK Sturm Gra,4965,2,21,5,10,65,32,33,68
FC Salzburg,4965,3,18,10,8,59,29,30,64
Vienna,4965,4,19,3,14,60,57,3,60
Admira Wacke,4965,5,17,5,14,38,45,-7,56
Rapid Vienna,4965,6,13,12,11,61,47,14,51
Mattersburg,4965,7,9,8,19,40,54,-14,35
SV Josko Rie,4965,8,10,5,21,31,59,-28,35
St. Pölten,4965,9,8,10,18,42,65,-23,34
RZ Pellets W,4965,10,8,8,20,37,65,-28,32
FC Salzburg,4966,1,21,6,9,66,34,32,69
SC Rheindorf,4966,2,21,6,9,59,39,20,69
Vienna,4966,3,21,4,11,71,53,18,67
Rapid Vienna,4966,4,15,12,9,56,39,17,57
RZ Pellets W,4966,5,16,6,14,51,52,-1,54
SK Sturm Gra,4966,6,16,5,15,55,40,15,53
Admira Wacke,4966,7,13,7,16,40,52,-12,46
Mattersburg,4966,8,11,7,18,49,63,-14,40
SV Josko Rie,4966,9,7,7,22,27,58,-31,28
St. Pölten,4966,10,5,8,23,33,77,-44,23
FC Salzburg,4967,1,22,7,7,75,33,42,73
SC Rheindorf,4967,2,19,8,9,62,48,14,65
Rapid Vienna,4967,3,18,10,8,64,41,23,64
SK Sturm Gra,4967,4,18,9,9,62,34,28,63
Vienna,4967,5,18,7,11,64,54,10,61
RZ Pellets W,4967,6,12,8,16,49,60,-11,44
St. Pölten,4967,7,9,11,16,47,59,-12,38
Admira Wacke,4967,8,9,6,21,33,65,-32,33
Mattersburg,4967,9,7,9,20,33,59,-26,30
SV Josko Rie,4967,10,6,9,21,30,66,-36,27
FC Salzburg,4968,1,23,5,8,65,27,38,74
SK Sturm Gra,4968,2,21,4,11,63,38,25,67
SC Rheindorf,4968,3,19,6,11,54,47,7,63
Vienna,4968,4,19,2,15,61,51,10,59
RZ Pellets W,4968,5,14,7,15,54,53,1,49
Rapid Vienna,4968,6,12,12,12,56,48,8,48
Admira Wacke,4968,7,13,4,19,32,56,-24,43
SV Josko Rie,4968,8,13,3,20,41,60,-19,42
St. Pölten,4968,9,10,9,17,47,62,-15,39
Mattersburg,4968,10,6,8,22,37,68,-31,26
FC Salzburg,4969,1,22,6,8,71,31,40,72
Vienna,4969,2,20,5,11,62,52,10,65
SC Rheindorf,4969,3,18,6,12,61,49,12,60
SK Sturm Gra,4969,4,15,10,11,57,40,17,55
Rapid Vienna,4969,5,14,11,11,57,43,14,53
RZ Pellets W,4969,6,12,8,16,47,55,-8,44
Mattersburg,4969,7,11,8,17,44,56,-12,41
Admira Wacke,4969,8,9,11,16,36,60,-24,38
SV Josko Rie,4969,9,11,4,21,39,62,-23,37
St. Pölten,4969,10,9,9,18,43,69,-26,36
FC Salzburg,4970,1,21,6,9,68,29,39,69
SC Rheindorf,4970,2,19,8,9,55,47,8,65
Rapid Vienna,4970,3,16,11,9,56,36,20,59
SK Sturm Gra,4970,4,16,10,10,58,41,17,58
Vienna,4970,5,17,5,14,57,59,-2,56
RZ Pellets W,4970,6,16,6,14,56,53,3,54
Admira Wacke,4970,7,12,5,19,32,55,-23,41
SV Josko Rie,4970,8,10,5,21,42,64,-22,35
Mattersburg,4970,9,9,7,20,42,59,-17,34
St. Pölten,4970,10,8,9,19,37,60,-23,33
FC Salzburg,4971,1,21,11,4,71,27,44,74
SC Rheindorf,4971,2,19,9,8,57,38,19,66
Vienna,4971,3,18,7,11,57,46,11,61
SK Sturm Gra,4971,4,14,14,8,48,30,18,56
Rapid Vienna,4971,5,11,13,12,48,38,10,46
RZ Pellets W,4971,6,11,12,13,46,52,-6,45
Admira Wacke,4971,7,9,10,17,39,67,-28,37
SV Josko Rie,4971,8,9,8,19,37,58,-21,35
St. Pölten,4971,9,7,14,15,34,59,-25,35
Mattersburg,4971,10,7,10,19,39,61,-22,31
FC Salzburg,4972,1,21,10,5,63,31,32,73
SC Rheindorf,4972,2,17,12,7,56,41,15,63
Vienna,4972,3,19,6,11,65,56,9,63
SK Sturm Gra,4972,4,17,9,10,56,36,20,60
RZ Pellets W,4972,5,15,5,16,49,53,-4,50
Rapid Vienna,4972,6,12,12,12,58,43,15,48
Admira Wacke,4972,7,12,7,17,39,63,-24,43
Mattersburg,4972,8,9,9,18,35,53,-18,36
St. Pölten,4972,9,6,14,16,40,58,-18,32
SV Josko Rie,4972,10,7,6,23,30,57,-27,27
SK Sturm Gra,4973,1,23,4,9,63,29,34,73
FC Salzburg,4973,2,22,5,9,72,32,40,71
SC Rheindorf,4973,3,21,6,9,56,44,12,69
Rapid Vienna,4973,4,16,12,8,61,36,25,60
Vienna,4973,5,17,6,13,61,50,11,57
RZ Pellets W,4973,6,11,7,18,48,64,-16,40
St. Pölten,4973,7,10,8,18,45,64,-19,38
Admira Wacke,4973,8,9,7,20,32,58,-26,34
SV Josko Rie,4973,9,9,5,22,30,60,-30,32
Mattersburg,4973,10,8,8,20,33,64,-31,32
SK Sturm Gra,4974,1,20,9,7,59,30,29,69
FC Salzburg,4974,2,20,8,8,72,36,36,68
SC Rheindorf,4974,3,18,7,11,57,49,8,61
Vienna,4974,4,17,8,11,72,54,18,59
Rapid Vienna,4974,5,16,10,10,62,32,30,58
RZ Pellets W,4974,6,13,7,16,46,57,-11,46
Mattersburg,4974,7,9,8,19,36,58,-22,35
Admira Wacke,4974,8,9,8,19,36,62,-26,35
St. Pölten,4974,9,8,11,17,36,66,-30,35
SV Josko Rie,4974,10,9,6,21,35,67,-32,33
FC Salzburg,4975,1,21,6,9,69,32,37,69
SC Rheindorf,4975,2,21,6,9,66,50,16,69
Vienna,4975,3,20,5,11,66,51,15,65
SK Sturm Gra,4975,4,18,7,11,60,39,21,61
Rapid Vienna,4975,5,13,10,13,60,48,12,49
St. Pölten,4975,6,11,9,16,46,64,-18,42
RZ Pellets W,4975,7,9,11,16,51,69,-18,38
Admira Wacke,4975,8,10,7,19,43,61,-18,37
SV Josko Rie,4975,9,10,7,19,35,58,-23,37
Mattersburg,4975,10,8,10,18,34,58,-24,34
FC Salzburg,4976,1,21,6,9,67,29,38,69
SC Rheindorf,4976,2,19,8,9,52,40,12,65
SK Sturm Gra,4976,3,19,6,11,56,34,22,63
Vienna,4976,4,20,3,13,66,55,11,63
RZ Pellets W,4976,5,17,5,14,49,51,-2,56
Rapid Vienna,4976,6,13,9,14,61,49,12,48
Admira Wacke,4976,7,13,6,17,42,55,-13,45
St. Pölten,4976,8,10,8,18,38,66,-28,38
SV Josko Rie,4976,9,10,5,21,32,55,-23,35
Mattersburg,4976,10,6,8,22,30,59,-29,26
SK Sturm Gra,4977,1,22,6,8,58,30,28,72
FC Salzburg,4977,2,19,8,9,61,31,30,65
SC Rheindorf,4977,3,18,11,7,54,39,15,65
Vienna,4977,4,17,6,13,58,53,5,57
Rapid Vienna,4977,5,13,10,13,52,43,9,49
RZ Pellets W,4977,6,13,8,15,54,60,-6,47
Admira Wacke,4977,7,12,7,17,39,58,-19,43
SV Josko Rie,4977,8,12,5,19,37,51,-14,41
St. Pölten,4977,9,6,12,18,40,64,-24,30
Mattersburg,4977,10,6,11,19,40,64,-24,29
SC Rheindorf,4978,1,19,10,7,51,34,17,67
SK Sturm Gra,4978,2,18,10,8,57,31,26,64
Vienna,4978,3,18,4,14,58,54,4,58
FC Salzburg,4978,4,17,6,13,58,35,23,57
Rapid Vienna,4978,5,14,13,9,50,35,15,55
RZ Pellets W,4978,6,13,8,15,52,54,-2,47
Admira Wacke,4978,7,13,4,19,37,57,-20,43
SV Josko Rie,4978,8,11,6,19,39,53,-14,39
Mattersburg,4978,9,8,11,17,37,61,-24,35
St. Pölten,4978,10,9,8,19,41,66,-25,35
FC Salzburg,4979,1,23,6,7,74,28,46,75
SK Sturm Gra,4979,2,19,10,7,59,28,31,67
SC Rheindorf,4979,3,19,7,10,55,44,11,64
Vienna,4979,4,17,4,15,55,51,4,55
RZ Pellets W,4979,5,15,9,12,55,52,3,54
Rapid Vienna,4979,6,13,12,11,59,37,22,51
St. Pölten,4979,7,10,11,15,41,58,-17,41
Admira Wacke,4979,8,10,4,22,28,71,-43,34
SV Josko Rie,4979,9,10,3,23,34,59,-25,33
Mattersburg,4979,10,7,8,21,31,63,-32,29
FC Salzburg,4980,1,22,5,9,69,33,36,71
SK Sturm Gra,4980,2,21,7,8,67,36,31,70
SC Rheindorf,4980,3,17,9,10,54,44,10,60
Rapid Vienna,4980,4,15,11,10,66,43,23,56
Vienna,4980,5,16,5,15,56,58,-2,53
RZ Pellets W,4980,6,13,9,14,46,57,-11,48
Admira Wacke,4980,7,12,9,15,42,52,-10,45
SV Josko Rie,4980,8,10,5,21,38,60,-22,35
St. Pölten,4980,9,7,11,18,38,68,-30,32
Mattersburg,4980,10,7,9,20,36,61,-25,30
SC Rheindorf,4981,1,21,7,8,53,35,18,70
SK Sturm Gra,4981,2,21,6,9,59,32,27,69
FC Salzburg,4981,3,18,9,9,58,35,23,63
Vienna,4981,4,17,10,9,62,45,17,61
Rapid Vienna,4981,5,14,9,13,49,39,10,51
Admira Wacke,4981,6,12,5,19,40,58,-18,41
RZ Pellets W,4981,7,9,10,17,43,58,-15,37
St. Pölten,4981,8,9,10,17,41,62,-21,37
Mattersburg,4981,9,8,12,16,42,58,-16,36
SV Josko Rie,4981,10,10,4,22,38,63,-25,34
SC Rheindorf,4982,1,23,5,8,73,41,32,74
FC Salzburg,4982,2,20,10,6,63,29,34,70
Vienna,4982,3,20,4,12,61,50,11,64
SK Sturm Gra,4982,4,19,4,13,61,39,22,61
RZ Pellets W,4982,5,14,8,14,42,49,-7,50
Rapid Vienna,4982,6,12,9,15,50,40,10,45
Admira Wacke,4982,7,11,9,16,34,52,-18,42
SV Josko Rie,4982,8,12,2,22,33,61,-28,38
St. Pölten,4982,9,9,7,20,41,65,-24,34
Mattersburg,4982,10,7,8,21,33,65,-32,29
FC Salzburg,4983,1,22,8,6,65,27,38,74
SC Rheindorf,4983,2,19,9,8,60,44,16,66
SK Sturm Gra,4983,3,19,8,9,62,31,31,65
Vienna,4983,4,19,5,12,59,47,12,62
Rapid Vienna,4983,5,16,10,10,57,36,21,58
RZ Pellets W,4983,6,9,11,16,45,62,-17,38
Admira Wacke,4983,7,10,8,18,34,61,-27,38
SV Josko Rie,4983,8,10,7,19,32,53,-21,37
Mattersburg,4983,9,8,9,19,43,64,-21,33
St. Pölten,4983,10,7,7,22,37,69,-32,28
SK Sturm Gra,4984,1,20,8,8,68,39,29,68
SC Rheindorf,4984,2,21,5,10,63,47,16,68
FC Salzburg,4984,3,20,7,9,65,35,30,67
Rapid Vienna,4984,4,18,10,8,65,35,30,64
Vienna,4984,5,16,5,15,57,57,0,53
RZ Pellets W,4984,6,12,8,16,45,59,-14,44
Admira Wacke,4984,7,12,7,17,37,55,-18,43
SV Josko Rie,4984,8,11,4,21,33,54,-21,37
St. Pölten,4984,9,8,7,21,40,66,-26,31
Mattersburg,4984,10,8,7,21,36,62,-26,31
SC Rheindorf,4985,1,19,7,10,57,46,11,64
FC Salzburg,4985,2,17,10,9,59,32,27,61
SK Sturm Gra,4985,3,18,5,13,54,32,22,59
Vienna,4985,4,18,4,14,57,56,1,58
Rapid Vienna,4985,5,14,14,8,55,34,21,56
Admira Wacke,4985,6,13,7,16,36,56,-20,46
RZ Pellets W,4985,7,12,8,16,52,55,-3,44
St. Pölten,4985,8,10,12,14,44,60,-16,42
SV Josko Rie,4985,9,11,7,18,38,55,-17,40
Mattersburg,4985,10,6,10,20,32,58,-26,28
FC Salzburg,4986,1,22,6,8,67,40,27,72
SC Rheindorf,4986,2,20,10,6,60,39,21,70
Vienna,4986,3,21,6,9,71,44,27,69
SK Sturm Gra,4986,4,16,7,13,54,43,11,55
Rapid Vienna,4986,5,15,9,12,59,41,18,54
Admira Wacke,4986,6,13,6,17,41,57,-16,45
Mattersburg,4986,7,11,9,16,49,55,-6,42
RZ Pellets W,4986,8,9,8,19,45,67,-22,35
SV Josko Rie,4986,9,9,7,20,33,57,-24,34
St. Pölten,4986,10,6,8,22,36,72,-36,26
FC Salzburg,4987,1,21,9,6,65,30,35,72
SC Rheindorf,4987,2,19,8,9,57,39,18,65
SK Sturm Gra,4987,3,17,8,11,53,33,20,59
Vienna,4987,4,16,8,12,64,57,7,56
RZ Pellets W,4987,5,14,9,13,49,54,-5,51
Admira Wacke,4987,6,15,6,15,47,54,-7,51
Rapid Vienna,4987,7,13,9,14,50,41,9,48
SV Josko Rie,4987,8,12,5,19,41,54,-13,41
Mattersburg,4987,9,6,12,18,34,61,-27,30
St. Pölten,4987,10,6,8,22,37,74,-37,26
FC Salzburg,4988,1,21,7,8,65,32,33,70
SK Sturm Gra,4988,2,19,7,10,55,32,23,64
Vienna,4988,3,19,6,11,67,53,14,63
SC Rheindorf,4988,4,16,9,11,46,39,7,57
Rapid Vienna,4988,5,12,13,11,51,36,15,49
SV Josko Rie,4988,6,13,6,17,37,50,-13,45
RZ Pellets W,4988,7,12,7,17,43,57,-14,43
Admira Wacke,4988,8,10,8,18,35,54,-19,38
St. Pölten,4988,9,9,10,17,39,63,-24,37
Mattersburg,4988,10,8,9,19,38,60,-22,33
FC Salzburg,4989,1,21,6,9,66,31,35,69
SC Rheindorf,4989,2,18,9,9,57,45,12,63
Rapid Vienna,4989,3,17,10,9,59,35,24,61
Vienna,4989,4,18,4,14,65,57,8,58
SK Sturm Gra,4989,5,16,9,11,58,40,18,57
RZ Pellets W,4989,6,13,5,18,44,59,-15,44
Admira Wacke,4989,7,13,5,18,37,57,-20,44
St. Pölten,4989,8,10,10,16,47,60,-13,40
SV Josko Rie,4989,9,10,6,20,31,50,-19,36
Mattersburg,4989,10,8,8,20,31,61,-30,32
FC Salzburg,4990,1,22,9,5,72,29,43,75
SK Sturm Gra,4990,2,20,8,8,64,27,37,68
SC Rheindorf,4990,3,19,10,7,57,38,19,67
Vienna,4990,4,19,6,11,66,54,12,63
Rapid Vienna,4990,5,11,15,10,59,41,18,48
RZ Pellets W,4990,6,12,7,17,47,55,-8,43
Admira Wacke,4990,7,10,9,17,34,60,-26,39
SV Josko Rie,4990,8,10,5,21,32,55,-23,35
Mattersburg,4990,9,8,7,21,37,73,-36,31
St. Pölten,4990,10,6,10,20,35,71,-36,28
SC Rheindorf,4991,1,21,7,8,61,41,20,70
Vienna,4991,2,19,7,10,65,45,20,64
FC Salzburg,4991,3,19,6,11,65,43,22,63
SK Sturm Gra,4991,4,18,8,10,69,39,30,62
Rapid Vienna,4991,5,15,10,11,59,43,16,55
RZ Pellets W,4991,6,10,10,16,40,59,-19,40
Admira Wacke,4991,7,11,7,18,34,56,-22,40
SV Josko Rie,4991,8,10,8,18,35,55,-20,38
St. Pölten,4991,9,8,10,18,38,64,-26,34
Mattersburg,4991,10,8,9,19,36,57,-21,33
SC Rheindorf,4992,1,21,8,7,56,38,18,71
FC Salzburg,4992,2,18,12,6,60,28,32,66
SK Sturm Gra,4992,3,19,9,8,58,33,25,66
Vienna,4992,4,17,9,10,63,53,10,60
Rapid Vienna,4992,5,12,14,10,59,44,15,50
RZ Pellets W,4992,6,13,7,16,46,59,-13,46
Admira Wacke,4992,7,12,6,18,43,61,-18,42
SV Josko Rie,4992,8,10,7,19,34,49,-15,37
St. Pölten,4992,9,7,8,21,39,67,-28,29
Mattersburg,4992,10,6,10,20,37,63,-26,28
SC Rheindorf,4993,1,22,8,6,58,35,23,74
FC Salzburg,4993,2,22,7,7,71,31,40,73
Vienna,4993,3,20,5,11,65,47,18,65
SK Sturm Gra,4993,4,16,7,13,52,39,13,55
Rapid Vienna,4993,5,12,8,16,51,47,4,44
RZ Pellets W,4993,6,13,5,18,44,58,-14,44
Mattersburg,4993,7,11,7,18,37,54,-17,40
Admira Wacke,4993,8,10,7,19,36,64,-28,37
St. Pölten,4993,9,9,9,18,40,59,-19,36
SV Josko Rie,4993,10,9,9,18,36,56,-20,36
FC Salzburg,4994,1,22,8,6,62,27,35,74
SK Sturm Gra,4994,2,20,6,10,62,35,27,66
SC Rheindorf,4994,3,19,9,8,58,41,17,66
Vienna,4994,4,16,8,12,53,48,5,56
Rapid Vienna,4994,5,13,11,12,58,42,16,50
RZ Pellets W,4994,6,10,11,15,41,53,-12,41
SV Josko Rie,4994,7,11,6,19,33,51,-18,39
Admira Wacke,4994,8,11,6,19,38,58,-20,39
Mattersburg,4994,9,9,7,20,37,60,-23,34
St. Pölten,4994,10,7,12,17,39,66,-27,33
FC Salzburg,4995,1,23,8,5,68,26,42,77
SK Sturm Gra,4995,2,24,3,9,65,30,35,75
Vienna,4995,3,18,4,14,59,52,7,58
Rapid Vienna,4995,4,15,12,9,63,37,26,57
SC Rheindorf,4995,5,17,5,14,47,43,4,56
RZ Pellets W,4995,6,11,8,17,45,61,-16,41
SV Josko Rie,4995,7,11,7,18,31,48,-17,40
Mattersburg,4995,8,8,10,18,38,57,-19,34
Admira Wacke,4995,9,10,4,22,32,64,-32,34
St. Pölten,4995,10,7,11,18,40,70,-30,32
FC Salzburg,4996,1,20,8,8,66,31,35,68
SK Sturm Gra,4996,2,19,9,8,63,33,30,66
SC Rheindorf,4996,3,20,6,10,54,43,11,66
Vienna,4996,4,20,4,12,68,50,18,64
Rapid Vienna,4996,5,13,11,12,53,47,6,50
RZ Pellets W,4996,6,12,9,15,46,55,-9,45
Admira Wacke,4996,7,12,7,17,38,59,-21,43
SV Josko Rie,4996,8,10,5,21,36,58,-22,35
Mattersburg,4996,9,8,9,19,37,57,-20,33
St. Pölten,4996,10,7,10,19,42,70,-28,31
SK Sturm Gra,4997,1,22,6,8,68,33,35,72
SC Rheindorf,4997,2,17,12,7,57,41,16,63
FC Salzburg,4997,3,18,8,10,59,33,26,62
Vienna,4997,4,19,5,12,59,51,8,62
Rapid Vienna,4997,5,16,9,11,55,35,20,57
RZ Pellets W,4997,6,12,7,17,41,56,-15,43
Admira Wacke,4997,7,12,5,19,34,60,-26,41
Mattersburg,4997,8,8,11,17,34,52,-18,35
SV Josko Rie,4997,9,9,8,19,41,62,-21,35
St. Pölten,4997,10,5,13,18,37,62,-25,28
FC Salzburg,4998,1,22,6,8,62,26,36,72
Vienna,4998,2,19,7,10,65,47,18,64
SC Rheindorf,4998,3,18,6,12,48,44,4,60
SK Sturm Gra,4998,4,16,9,11,56,39,17,57
Rapid Vienna,4998,5,15,11,10,58,41,17,56
Admira Wacke,4998,6,16,4,16,41,52,-11,52
RZ Pellets W,4998,7,13,6,17,46,53,-7,45
Mattersburg,4998,8,9,9,18,38,53,-15,36
SV Josko Rie,4998,9,10,5,21,33,59,-26,35
St. Pölten,4998,10,7,7,22,36,69,-33,28
FC Salzburg,4999,1,20,8,8,70,37,33,68
SC Rheindorf,4999,2,19,10,7,62,44,18,67
SK Sturm Gra,4999,3,18,8,10,60,32,28,62
Vienna,4999,4,17,6,13,56,52,4,57
Rapid Vienna,4999,5,15,11,10,51,39,12,56
Admira Wacke,4999,6,13,7,16,44,56,-12,46
RZ Pellets W,4999,7,10,10,16,43,56,-13,40
St. Pölten,4999,8,9,10,17,45,66,-21,37
SV Josko Rie,4999,9,10,4,22,37,57,-20,34
Mattersburg,4999,10,6,12,18,35,64,-29,30
SC Rheindorf,5000,1,21,6,9,56,34,22,69
FC Salzburg,5000,2,17,9,10,61,41,20,60
Vienna,5000,3,18,5,13,59,49,10,59
Rapid Vienna,5000,4,15,10,11,56,38,18,55
SK Sturm Gra,5000,5,15,10,11,53,41,12,55
RZ Pellets W,5000,6,14,10,12,48,49,-1,52
Admira Wacke,5000,7,12,8,16,37,58,-21,44
SV Josko Rie,5000,8,13,3,20,39,55,-16,42
Mattersburg,5000,9,9,8,19,36,53,-17,35
St. Pölten,5000,10,6,11,19,35,62,-27,29
FC Salzburg,5001,1,22,6,8,63,31,32,72
SK Sturm Gra,5001,2,19,7,10,55,35,20,64
SC Rheindorf,5001,3,18,8,10,57,52,5,62
Vienna,5001,4,18,5,13,64,54,10,59
Rapid Vienna,5001,5,14,11,11,58,43,15,53
St. Pölten,5001,6,12,9,15,49,60,-11,45
SV Josko Rie,5001,7,13,4,19,40,50,-10,43
RZ Pellets W,5001,8,10,6,20,37,54,-17,36
Admira Wacke,5001,9,10,6,20,31,54,-23,36
Mattersburg,5001,10,9,8,19,38,59,-21,35
FC Salzburg,5002,1,23,6,7,67,25,42,75
SK Sturm Gra,5002,2,23,5,8,60,33,27,74
Vienna,5002,3,20,6,10,69,43,26,66
SC Rheindorf,5002,4,18,10,8,53,40,13,64
Rapid Vienna,5002,5,14,10,12,54,46,8,52
RZ Pellets W,5002,6,12,8,16,40,51,-11,44
Admira Wacke,5002,7,10,8,18,34,59,-25,38
SV Josko Rie,5002,8,9,8,19,29,50,-21,35
Mattersburg,5002,9,8,7,21,35,56,-21,31
St. Pölten,5002,10,5,8,23,33,71,-38,23
FC Salzburg,5003,1,23,9,4,77,28,49,78
Vienna,5003,2,20,4,12,58,48,10,64
SC Rheindorf,5003,3,17,8,11,52,46,6,59
SK Sturm Gra,5003,4,15,10,11,50,33,17,55
Rapid Vienna,5003,5,13,12,11,49,41,8,51
St. Pölten,5003,6,10,11,15,43,56,-13,41
RZ Pellets W,5003,7,10,9,17,39,52,-13,39
Admira Wacke,5003,8,11,6,19,34,59,-25,39
SV Josko Rie,5003,9,11,5,20,37,54,-17,38
Mattersburg,5003,10,10,6,20,36,58,-22,36
FC Salzburg,5004,1,21,7,8,63,33,30,70
SK Sturm Gra,5004,2,19,10,7,60,33,27,67
Vienna,5004,3,20,7,9,69,50,19,67
SC Rheindorf,5004,4,17,9,10,52,43,9,60
Admira Wacke,5004,5,14,4,18,38,57,-19,46
SV Josko Rie,5004,6,13,4,19,35,53,-18,43
Rapid Vienna,5004,7,11,8,17,49,47,2,41
RZ Pellets W,5004,8,11,7,18,48,62,-14,40
Mattersburg,5004,9,9,8,19,45,60,-15,35
St. Pölten,5004,10,6,14,16,45,66,-21,32
FC Salzburg,5005,1,19,10,7,62,30,32,67
SK Sturm Gra,5005,2,20,6,10,70,35,35,66
SC Rheindorf,5005,3,19,8,9,60,47,13,65
Vienna,5005,4,18,3,15,54,50,4,57
Rapid Vienna,5005,5,14,11,11,55,38,17,53
St. Pölten,5005,6,15,8,13,49,52,-3,53
RZ Pellets W,5005,7,11,10,15,40,53,-13,43
SV Josko Rie,5005,8,11,5,20,39,58,-19,38
Admira Wacke,5005,9,8,8,20,27,59,-32,32
Mattersburg,5005,10,5,11,20,31,65,-34,26
FC Salzburg,5006,1,21,7,8,65,35,30,70
SC Rheindorf,5006,2,19,7,10,56,40,16,64
Vienna,5006,3,19,4,13,59,52,7,61
SK Sturm Gra,5006,4,18,6,12,53,29,24,60
Rapid Vienna,5006,5,13,14,9,51,33,18,53
RZ Pellets W,5006,6,11,10,15,43,57,-14,43
Admira Wacke,5006,7,11,9,16,38,51,-13,42
SV Josko Rie,5006,8,13,3,20,35,51,-16,42
Mattersburg,5006,9,8,9,19,34,60,-26,33
St. Pölten,5006,10,7,11,18,36,62,-26,32
SC Rheindorf,5007,1,24,7,5,61,35,26,79
FC Salzburg,5007,2,23,5,8,71,31,40,74
SK Sturm Gra,5007,3,19,7,10,57,34,23,64
Vienna,5007,4,19,6,11,57,46,11,63
Rapid Vienna,5007,5,13,9,14,49,35,14,48
RZ Pellets W,5007,6,11,8,17,42,55,-13,41
Admira Wacke,5007,7,10,8,18,27,54,-27,38
Mattersburg,5007,8,8,10,18,35,58,-23,34
St. Pölten,5007,9,7,10,19,39,60,-21,31
SV Josko Rie,5007,10,8,6,22,27,57,-30,30
SK Sturm Gra,5008,1,21,5,10,58,32,26,68
SC Rheindorf,5008,2,20,5,11,58,41,17,65
FC Salzburg,5008,3,19,7,10,61,36,25,64
Rapid Vienna,5008,4,16,9,11,64,38,26,57
Vienna,5008,5,18,3,15,60,56,4,57
RZ Pellets W,5008,6,14,5,17,44,54,-10,47
Mattersburg,5008,7,13,7,16,39,50,-11,46
SV Josko Rie,5008,8,12,4,20,33,49,-16,40
Admira Wacke,5008,9,11,3,22,35,62,-27,36
St. Pölten,5008,10,8,8,20,38,72,-34,32
FC Salzburg,5009,1,23,7,6,72,31,41,76
SC Rheindorf,5009,2,22,6,8,57,34,23,72
SK Sturm Gra,5009,3,20,6,10,62,38,24,66
Rapid Vienna,5009,4,15,11,10,58,37,21,56
Vienna,5009,5,15,6,15,51,49,2,51
RZ Pellets W,5009,6,11,7,18,40,57,-17,40
Admira Wacke,5009,7,11,7,18,33,61,-28,40
St. Pölten,5009,8,8,12,16,42,66,-24,36
SV Josko Rie,5009,9,10,4,22,28,51,-23,34
Mattersburg,5009,10,8,8,20,41,60,-19,32
Vienna,5010,1,20,6,10,64,49,15,66
FC Salzburg,5010,2,19,8,9,62,32,30,65
SK Sturm Gra,5010,3,20,5,11,60,33,27,65
SC Rheindorf,5010,4,16,9,11,52,45,7,57
Rapid Vienna,5010,5,16,8,12,52,37,15,56
Admira Wacke,5010,6,13,6,17,41,57,-16,45
RZ Pellets W,5010,7,11,8,17,43,54,-11,41
St. Pölten,5010,8,10,9,17,37,57,-20,39
Mattersburg,5010,9,8,10,18,38,57,-19,34
SV Josko Rie,5010,10,9,7,20,31,59,-28,34
FC Salzburg,5011,1,22,5,9,67,33,34,71
SC Rheindorf,5011,2,19,7,10,60,50,10,64
SK Sturm Gra,5011,3,18,6,12,56,36,20,60
Rapid Vienna,5011,4,14,12,10,56,41,15,54
Vienna,5011,5,16,6,14,55,54,1,54
Admira Wacke,5011,6,13,7,16,38,53,-15,46
RZ Pellets W,5011,7,12,8,16,47,58,-11,44
St. Pölten,5011,8,10,8,18,41,61,-20,38
SV Josko Rie,5011,9,10,6,20,35,53,-18,36
Mattersburg,5011,10,8,11,17,32,48,-16,35
SC Rheindorf,5012,1,21,7,8,55,34,21,70
FC Salzburg,5012,2,20,8,8,66,32,34,68
SK Sturm Gra,5012,3,19,6,11,55,32,23,63
Rapid Vienna,5012,4,16,10,10,57,39,18,58
Vienna,5012,5,18,4,14,64,56,8,58
RZ Pellets W,5012,6,12,9,15,45,56,-11,45
Admira Wacke,5012,7,12,8,16,40,53,-13,44
St. Pölten,5012,8,10,8,18,41,62,-21,38
SV Josko Rie,5012,9,11,4,21,34,59,-25,37
Mattersburg,5012,10,6,6,24,34,68,-34,24
FC Salzburg,5013,1,22,8,6,66,32,34,74
SC Rheindorf,5013,2,21,7,8,64,38,26,70
SK Sturm Gra,5013,3,19,9,8,65,36,29,66
Vienna,5013,4,17,6,13,60,53,7,57
Rapid Vienna,5013,5,12,11,13,52,44,8,47
Admira Wacke,5013,6,13,6,17,38,55,-17,45
St. Pölten,5013,7,10,9,17,44,59,-15,39
RZ Pellets W,5013,8,9,8,19,37,65,-28,35
SV Josko Rie,5013,9,7,11,18,25,46,-21,32
Mattersburg,5013,10,7,11,18,33,56,-23,32
FC Salzburg,5014,1,20,11,5,59,26,33,71
SC Rheindorf,5014,2,20,7,9,57,40,17,67
Vienna,5014,3,20,5,11,64,45,19,65
SK Sturm Gra,5014,4,19,4,13,59,37,22,61
Rapid Vienna,5014,5,13,12,11,55,40,15,51
RZ Pellets W,5014,6,13,7,16,48,59,-11,46
SV Josko Rie,5014,7,11,6,19,38,49,-11,39
Admira Wacke,5014,8,10,8,18,33,60,-27,38
St. Pölten,5014,9,8,8,20,38,70,-32,32
Mattersburg,5014,10,7,10,19,37,62,-25,31
FC Salzburg,5015,1,23,5,8,68,30,38,74
Vienna,5015,2,21,4,11,74,50,24,67
SK Sturm Gra,5015,3,19,6,11,53,32,21,63
Rapid Vienna,5015,4,16,12,8,66,35,31,60
SC Rheindorf,5015,5,17,8,11,56,45,11,59
SV Josko Rie,5015,6,13,5,18,40,52,-12,44
Admira Wacke,5015,7,10,8,18,35,68,-33,38
RZ Pellets W,5015,8,9,7,20,42,68,-26,34
St. Pölten,5015,9,8,10,18,39,69,-30,34
Mattersburg,5015,10,6,11,19,31,55,-24,29
FC Salzburg,5016,1,22,7,7,77,36,41,73
Vienna,5016,2,21,4,11,74,53,21,67
SK Sturm Gra,5016,3,19,7,10,65,37,28,64
SC Rheindorf,5016,4,18,7,11,54,49,5,61
Rapid Vienna,5016,5,15,11,10,68,45,23,56
RZ Pellets W,5016,6,13,7,16,45,54,-9,46
SV Josko Rie,5016,7,12,5,19,33,56,-23,41
Mattersburg,5016,8,8,10,18,36,55,-19,34
Admira Wacke,5016,9,10,4,22,33,72,-39,34
St. Pölten,5016,10,6,10,20,40,68,-28,28
FC Salzburg,5017,1,22,9,5,63,27,36,75
SK Sturm Gra,5017,2,21,4,11,63,33,30,67
Vienna,5017,3,20,5,11,65,50,15,65
SC Rheindorf,5017,4,18,8,10,55,40,15,62
Rapid Vienna,5017,5,13,11,12,49,42,7,50
RZ Pellets W,5017,6,12,6,18,46,58,-12,42
Admira Wacke,5017,7,10,9,17,40,62,-22,39
SV Josko Rie,5017,8,10,8,18,40,58,-18,38
Mattersburg,5017,9,9,9,18,43,62,-19,36
St. Pölten,5017,10,7,7,22,35,67,-32,28
SC Rheindorf,5018,1,21,7,8,61,39,22,70
FC Salzburg,5018,2,20,8,8,65,35,30,68
SK Sturm Gra,5018,3,18,7,11,62,39,23,61
Vienna,5018,4,18,6,12,63,46,17,60
Rapid Vienna,5018,5,15,11,10,63,41,22,56
RZ Pellets W,5018,6,12,8,16,49,57,-8,44
St. Pölten,5018,7,11,7,18,39,59,-20,40
SV Josko Rie,5018,8,10,6,20,36,56,-20,36
Admira Wacke,5018,9,10,6,20,35,74,-39,36
Mattersburg,5018,10,7,10,19,35,62,-27,31
SC Rheindorf,5019,1,19,6,11,54,45,9,63
FC Salzburg,5019,2,18,7,11,57,40,17,61
SK Sturm Gra,5019,3,18,6,12,58,44,14,60
Vienna,5019,4,18,4,14,65,58,7,58
Rapid Vienna,5019,5,15,11,10,58,37,21,56
RZ Pellets W,5019,6,16,4,16,51,61,-10,52
Admira Wacke,5019,7,13,6,17,48,58,-10,45
SV Josko Rie,5019,8,11,6,19,42,55,-13,39
St. Pölten,5019,9,8,12,16,48,64,-16,36
Mattersburg,5019,10,9,8,19,36,55,-19,35
FC Salzburg,5020,1,22,7,7,66,27,39,73
SK Sturm Gra,5020,2,20,8,8,69,37,32,68
SC Rheindorf,5020,3,17,9,10,56,48,8,60
Vienna,5020,4,17,6,13,63,58,5,57
RZ Pellets W,5020,5,11,12,13,44,58,-14,45
Rapid Vienna,5020,6,10,13,13,54,45,9,43
SV Josko Rie,5020,7,12,5,19,41,58,-17,41
Admira Wacke,5020,8,11,8,17,39,57,-18,41
Mattersburg,5020,9,9,10,17,38,55,-17,37
St. Pölten,5020,10,7,10,19,38,65,-27,31
SK Sturm Gra,5021,1,21,8,7,70,38,32,71
Vienna,5021,2,21,4,11,73,49,24,67
FC Salzburg,5021,3,19,9,8,63,38,25,66
SC Rheindorf,5021,4,19,8,9,55,44,11,65
Rapid Vienna,5021,5,12,13,11,57,42,15,49
Mattersburg,5021,6,11,10,15,39,54,-15,43
RZ Pellets W,5021,7,10,11,15,48,60,-12,41
SV Josko Rie,5021,8,11,3,22,33,56,-23,36
Admira Wacke,5021,9,10,5,21,34,64,-30,35
St. Pölten,5021,10,6,9,21,43,70,-27,27
FC Salzburg,5022,1,23,6,7,74,27,47,75
SC Rheindorf,5022,2,19,8,9,51,43,8,65
SK Sturm Gra,5022,3,19,7,10,57,33,24,64
Vienna,5022,4,18,4,14,67,55,12,58
Rapid Vienna,5022,5,13,10,13,54,44,10,49
RZ Pellets W,5022,6,13,8,15,51,54,-3,47
St. Pölten,5022,7,11,8,17,43,61,-18,41
Admira Wacke,5022,8,12,4,20,35,63,-28,40
SV Josko Rie,5022,9,10,6,20,33,63,-30,36
Mattersburg,5022,10,7,9,20,37,59,-22,30
FC Salzburg,5023,1,20,8,8,63,34,29,68
SK Sturm Gra,5023,2,20,6,10,70,39,31,66
Vienna,5023,3,17,9,10,69,52,17,60
Rapid Vienna,5023,4,15,11,10,55,36,19,56
SC Rheindorf,5023,5,15,10,11,50,47,3,55
RZ Pellets W,5023,6,13,7,16,45,59,-14,46
Mattersburg,5023,7,10,10,16,40,54,-14,40
Admira Wacke,5023,8,9,10,17,36,56,-20,37
SV Josko Rie,5023,9,10,5,21,30,54,-24,35
St. Pölten,5023,10,8,10,18,37,64,-27,34
FC Salzburg,5024,1,25,5,6,78,30,48,80
SK Sturm Gra,5024,2,20,7,9,58,31,27,67
SC Rheindorf,5024,3,19,9,8,52,45,7,66
Vienna,5024,4,19,5,12,65,57,8,62
Admira Wacke,5024,5,14,4,18,48,64,-16,46
Rapid Vienna,5024,6,11,12,13,52,44,8,45
RZ Pellets W,5024,7,9,10,17,46,57,-11,37
St. Pölten,5024,8,8,10,18,43,66,-23,34
SV Josko Rie,5024,9,8,9,19,33,55,-22,33
Mattersburg,5024,10,8,7,21,37,63,-26,31
FC Salzburg,5025,1,21,7,8,63,33,30,70
Vienna,5025,2,20,4,12,61,46,15,64
SK Sturm Gra,5025,3,19,6,11,62,37,25,63
SC Rheindorf,5025,4,19,6,11,56,42,14,63
Rapid Vienna,5025,5,17,9,10,54,32,22,60
Admira Wacke,5025,6,12,8,16,39,57,-18,44
RZ Pellets W,5025,7,12,5,19,45,63,-18,41
SV Josko Rie,5025,8,11,4,21,31,57,-26,37
St. Pölten,5025,9,9,7,20,42,68,-26,34
Mattersburg,5025,10,7,10,19,33,51,-18,31
SK Sturm Gra,5026,1,21,6,9,61,30,31,69
SC Rheindorf,5026,2,20,8,8,57,41,16,68
FC Salzburg,5026,3,19,10,7,62,29,33,67
Vienna,5026,4,17,4,15,60,61,-1,55
Rapid Vienna,5026,5,14,11,11,60,45,15,53
Admira Wacke,5026,6,12,8,16,37,53,-16,44
RZ Pellets W,5026,7,10,9,17,41,55,-14,39
Mattersburg,5026,8,10,8,18,38,56,-18,38
SV Josko Rie,5026,9,9,8,19,36,52,-16,35
St. Pölten,5026,10,7,10,19,37,67,-30,31
FC Salzburg,5027,1,23,5,8,74,34,40,74
SK Sturm Gra,5027,2,20,5,11,65,45,20,65
SC Rheindorf,5027,3,18,6,12,57,56,1,60
Vienna,5027,4,18,5,13,64,58,6,59
Rapid Vienna,5027,5,16,10,10,64,38,26,58
Admira Wacke,5027,6,12,6,18,39,56,-17,42
RZ Pellets W,5027,7,11,7,18,46,64,-18,40
SV Josko Rie,5027,8,11,4,21,38,58,-20,37
St. Pölten,5027,9,9,10,17,44,65,-21,37
Mattersburg,5027,10,10,6,20,38,55,-17,36
Vienna,5028,1,24,3,9,71,46,25,75
FC Salzburg,5028,2,22,6,8,63,31,32,72
SC Rheindorf,5028,3,20,6,10,61,43,18,66
SK Sturm Gra,5028,4,19,5,12,62,42,20,62
Rapid Vienna,5028,5,13,10,13,55,47,8,49
RZ Pellets W,5028,6,12,7,17,48,55,-7,43
SV Josko Rie,5028,7,10,7,19,34,51,-17,37
Admira Wacke,5028,8,9,9,18,31,57,-26,36
St. Pölten,5028,9,8,11,17,42,64,-22,35
Mattersburg,5028,10,6,10,20,39,70,-31,28
SK Sturm Gra,5029,1,20,8,8,61,29,32,68
FC Salzburg,5029,2,17,7,12,60,41,19,58
Vienna,5029,3,17,7,12,63,53,10,58
SC Rheindorf,5029,4,17,6,13,50,52,-2,57
Rapid Vienna,5029,5,15,11,10,55,35,20,56
RZ Pellets W,5029,6,14,8,14,45,51,-6,50
Admira Wacke,5029,7,12,7,17,39,56,-17,43
SV Josko Rie,5029,8,11,9,16,42,56,-14,42
St. Pölten,5029,9,9,11,16,46,64,-18,38
Mattersburg,5029,10,7,8,21,36,60,-24,29
FC Salzburg,5030,1,21,8,7,65,29,36,71
SC Rheindorf,5030,2,21,6,9,56,36,20,69
Rapid Vienna,5030,3,19,8,9,67,39,28,65
SK Sturm Gra,5030,4,19,7,10,68,39,29,64
Vienna,5030,5,19,5,12,74,53,21,62
RZ Pellets W,5030,6,10,10,16,39,56,-17,40
Admira Wacke,5030,7,11,6,19,33,59,-26,39
St. Pölten,5030,8,10,7,19,43,69,-26,37
SV Josko Rie,5030,9,9,6,21,33,61,-28,33
Mattersburg,5030,10,6,7,23,33,70,-37,25
FC Salzburg,5031,1,22,10,4,66,25,41,76
SC Rheindorf,5031,2,17,10,9,53,44,9,61
SK Sturm Gra,5031,3,17,8,11,57,36,21,59
Rapid Vienna,5031,4,15,11,10,57,40,17,56
Vienna,5031,5,15,7,14,59,52,7,52
Admira Wacke,5031,6,15,6,15,44,54,-10,51
RZ Pellets W,5031,7,11,9,16,39,55,-16,42
Mattersburg,5031,8,10,9,17,38,51,-13,39
St. Pölten,5031,9,9,9,18,35,59,-24,36
SV Josko Rie,5031,10,8,3,25,27,59,-32,27
FC Salzburg,5032,1,22,8,6,68,36,32,74
SC Rheindorf,5032,2,19,11,6,61,42,19,68
Vienna,5032,3,19,4,13,65,60,5,61
SK Sturm Gra,5032,4,16,7,13,61,41,20,55
Rapid Vienna,5032,5,14,10,12,60,41,19,52
RZ Pellets W,5032,6,12,7,17,45,53,-8,43
Admira Wacke,5032,7,12,6,18,40,62,-22,42
SV Josko Rie,5032,8,11,6,19,38,54,-16,39
St. Pölten,5032,9,8,11,17,41,64,-23,35
Mattersburg,5032,10,8,8,20,37,63,-26,32
SC Rheindorf,5033,1,21,7,8,54,34,20,70
SK Sturm Gra,5033,2,21,6,9,63,33,30,69
FC Salzburg,5033,3,20,7,9,69,35,34,67
Vienna,5033,4,21,4,11,62,48,14,67
Rapid Vienna,5033,5,17,9,10,58,37,21,60
RZ Pellets W,5033,6,12,10,14,45,55,-10,46
Admira Wacke,5033,7,10,7,19,34,59,-25,37
SV Josko Rie,5033,8,10,5,21,35,56,-21,35
St. Pölten,5033,9,7,8,21,39,69,-30,29
Mattersburg,5033,10,5,9,22,32,65,-33,24
SC Rheindorf,5034,1,24,7,5,70,39,31,79
SK Sturm Gra,5034,2,22,6,8,60,28,32,72
FC Salzburg,5034,3,20,9,7,67,32,35,69
Vienna,5034,4,16,7,13,61,55,6,55
Rapid Vienna,5034,5,13,11,12,57,51,6,50
Admira Wacke,5034,6,13,7,16,44,57,-13,46
RZ Pellets W,5034,7,10,11,15,45,57,-12,41
SV Josko Rie,5034,8,8,6,22,38,65,-27,30
Mattersburg,5034,9,6,10,20,37,65,-28,28
St. Pölten,5034,10,6,10,20,43,73,-30,28
FC Salzburg,5035,1,24,6,6,69,22,47,78
SC Rheindorf,5035,2,19,8,9,50,37,13,65
SK Sturm Gra,5035,3,19,6,11,59,34,25,63
Vienna,5035,4,16,7,13,53,52,1,55
Rapid Vienna,5035,5,13,9,14,50,44,6,48
SV Josko Rie,5035,6,14,6,16,38,47,-9,48
RZ Pellets W,5035,7,10,10,16,41,59,-18,40
Admira Wacke,5035,8,11,7,18,34,53,-19,40
St. Pölten,5035,9,9,7,20,41,66,-25,34
Mattersburg,5035,10,8,8,20,35,56,-21,32
FC Salzburg,5036,1,22,8,6,69,27,42,74
SK Sturm Gra,5036,2,23,5,8,61,29,32,74
SC Rheindorf,5036,3,20,8,8,59,41,18,68
Rapid Vienna,5036,4,15,12,9,56,35,21,57
Vienna,5036,5,16,6,14,56,56,0,54
Admira Wacke,5036,6,11,6,19,35,59,-24,39
SV Josko Rie,5036,7,10,8,18,32,48,-16,38
RZ Pellets W,5036,8,10,7,19,50,64,-14,37
St. Pölten,5036,9,7,10,19,41,72,-31,31
Mattersburg,5036,10,5,12,19,36,64,-28,27
FC Salzburg,5037,1,21,8,7,70,32,38,71
Vienna,5037,2,21,4,11,67,53,14,67
SC Rheindorf,5037,3,19,7,10,59,44,15,64
SK Sturm Gra,5037,4,15,8,13,58,43,15,53
Rapid Vienna,5037,5,11,14,11,54,47,7,47
Mattersburg,5037,6,10,11,15,43,57,-14,41
St. Pölten,5037,7,10,10,16,45,63,-18,40
RZ Pellets W,5037,8,9,11,16,41,56,-15,38
Admira Wacke,5037,9,10,8,18,34,54,-20,38
SV Josko Rie,5037,10,10,7,19,34,56,-22,37
FC Salzburg,5038,1,20,11,5,62,26,36,71
SC Rheindorf,5038,2,19,7,10,60,43,17,64
Vienna,5038,3,16,7,13,58,56,2,55
Rapid Vienna,5038,4,15,9,12,57,41,16,54
SK Sturm Gra,5038,5,16,6,14,49,40,9,54
RZ Pellets W,5038,6,11,11,14,47,52,-5,44
Admira Wacke,5038,7,11,11,14,39,57,-18,44
St. Pölten,5038,8,10,10,16,40,55,-15,40
SV Josko Rie,5038,9,9,8,19,29,49,-20,35
Mattersburg,5038,10,9,8,19,33,55,-22,35
Vienna,5039,1,21,5,10,65,47,18,68
SC Rheindorf,5039,2,21,5,10,53,41,12,68
FC Salzburg,5039,3,18,10,8,58,29,29,64
SK Sturm Gra,5039,4,19,7,10,60,33,27,64
Rapid Vienna,5039,5,15,11,10,53,38,15,56
RZ Pellets W,5039,6,13,6,17,46,59,-13,45
Admira Wacke,5039,7,11,5,20,35,59,-24,38
St. Pölten,5039,8,8,11,17,44,61,-17,35
SV Josko Rie,5039,9,8,8,20,30,51,-21,32
Mattersburg,5039,10,8,8,20,36,62,-26,32
SC Rheindorf,5040,1,21,8,7,72,39,33,71
FC Salzburg,5040,2,19,9,8,60,33,27,66
SK Sturm Gra,5040,3,18,9,9,64,40,24,63
Vienna,5040,4,18,4,14,68,55,13,58
Rapid Vienna,5040,5,15,12,9,62,38,24,57
RZ Pellets W,5040,6,12,7,17,44,58,-14,43
Mattersburg,5040,7,10,10,16,39,60,-21,40
SV Josko Rie,5040,8,11,5,20,35,61,-26,38
Admira Wacke,5040,9,9,8,19,34,64,-30,35
St. Pölten,5040,10,7,8,21,38,68,-30,29
FC Salzburg,5041,1,23,6,7,74,33,41,75
SC Rheindorf,5041,2,20,7,9,62,50,12,67
SK Sturm Gra,5041,3,17,9,10,57,32,25,60
Vienna,5041,4,19,2,15,71,65,6,59
Rapid Vienna,5041,5,14,12,10,58,42,16,54
RZ Pellets W,5041,6,13,5,18,45,60,-15,44
Admira Wacke,5041,7,10,10,16,44,64,-20,40
St. Pölten,5041,8,10,9,17,47,64,-17,39
Mattersburg,5041,9,9,7,20,35,57,-22,34
SV Josko Rie,5041,10,9,5,22,33,59,-26,32
SC Rheindorf,5042,1,21,8,7,57,37,20,71
FC Salzburg,5042,2,19,10,7,65,34,31,67
SK Sturm Gra,5042,3,21,4,11,55,30,25,67
Vienna,5042,4,19,7,10,67,52,15,64
Rapid Vienna,5042,5,12,13,11,57,47,10,49
RZ Pellets W,5042,6,11,8,17,44,57,-13,41
SV Josko Rie,5042,7,9,10,17,35,51,-16,37
Mattersburg,5042,8,9,8,19,50,64,-14,35
Admira Wacke,5042,9,8,11,17,34,66,-32,35
St. Pölten,5042,10,8,7,21,37,63,-26,31
FC Salzburg,5043,1,23,7,6,61,19,42,76
Vienna,5043,2,21,6,9,68,48,20,69
SC Rheindorf,5043,3,18,8,10,55,45,10,62
SK Sturm Gra,5043,4,16,9,11,58,39,19,57
Rapid Vienna,5043,5,15,11,10,55,41,14,56
RZ Pellets W,5043,6,11,11,14,49,52,-3,44
Mattersburg,5043,7,9,9,18,43,57,-14,36
Admira Wacke,5043,8,9,7,20,35,68,-33,34
St. Pölten,5043,9,8,9,19,39,67,-28,33
SV Josko Rie,5043,10,9,5,22,35,62,-27,32
Vienna,5044,1,19,8,9,71,52,19,65
FC Salzburg,5044,2,18,10,8,65,32,33,64
SC Rheindorf,5044,3,18,10,8,60,43,17,64
Rapid Vienna,5044,4,17,10,9,64,40,24,61
SK Sturm Gra,5044,5,17,7,12,58,42,16,58
RZ Pellets W,5044,6,14,6,16,50,57,-7,48
SV Josko Rie,5044,7,11,6,19,40,63,-23,39
Admira Wacke,5044,8,10,7,19,34,59,-25,37
Mattersburg,5044,9,8,8,20,36,55,-19,32
St. Pölten,5044,10,7,10,19,35,70,-35,31
FC Salzburg,5045,1,24,6,6,67,29,38,78
SC Rheindorf,5045,2,20,6,10,55,45,10,66
SK Sturm Gra,5045,3,16,8,12,57,37,20,56
Vienna,5045,4,18,2,16,61,56,5,56
Rapid Vienna,5045,5,13,11,12,62,40,22,50
St. Pölten,5045,6,12,9,15,50,60,-10,45
RZ Pellets W,5045,7,11,9,16,50,58,-8,42
Admira Wacke,5045,8,12,6,18,27,54,-27,42
SV Josko Rie,5045,9,12,5,19,37,53,-16,41
Mattersburg,5045,10,5,12,19,33,67,-34,27
FC Salzburg,5046,1,23,7,6,72,31,41,76
SK Sturm Gra,5046,2,20,6,10,59,26,33,66
Vienna,5046,3,18,5,13,58,50,8,59
SC Rheindorf,5046,4,16,8,12,47,54,-7,56
Rapid Vienna,5046,5,13,10,13,52,36,16,49
RZ Pellets W,5046,6,11,11,14,46,54,-8,44
Admira Wacke,5046,7,12,7,17,43,67,-24,43
Mattersburg,5046,8,10,7,19,42,56,-14,37
St. Pölten,5046,9,9,10,17,41,63,-22,37
SV Josko Rie,5046,10,9,7,20,37,60,-23,34
SK Sturm Gra,5047,1,22,4,10,59,29,30,70
FC Salzburg,5047,2,21,6,9,63,34,29,69
SC Rheindorf,5047,3,21,6,9,56,41,15,69
Vienna,5047,4,19,5,12,61,46,15,62
Rapid Vienna,5047,5,12,12,12,56,46,10,48
RZ Pellets W,5047,6,13,5,18,41,57,-16,44
Admira Wacke,5047,7,13,5,18,39,56,-17,44
SV Josko Rie,5047,8,13,4,19,39,55,-16,43
St. Pölten,5047,9,9,6,21,45,68,-23,33
Mattersburg,5047,10,7,7,22,36,63,-27,28
FC Salzburg,5048,1,24,5,7,66,27,39,77
SC Rheindorf,5048,2,22,5,9,63,37,26,71
Rapid Vienna,5048,3,17,9,10,56,39,17,60
SK Sturm Gra,5048,4,18,6,12,55,38,17,60
Vienna,5048,5,18,3,15,58,49,9,57
RZ Pellets W,5048,6,13,8,15,55,55,0,47
SV Josko Rie,5048,7,10,7,19,38,60,-22,37
Admira Wacke,5048,8,10,6,20,37,65,-28,36
Mattersburg,5048,9,7,10,19,41,69,-28,31
St. Pölten,5048,10,6,11,19,39,69,-30,29
FC Salzburg,5049,1,22,6,8,68,26,42,72
SK Sturm Gra,5049,2,20,8,8,57,30,27,68
SC Rheindorf,5049,3,20,8,8,56,40,16,68
Rapid Vienna,5049,4,14,12,10,58,34,24,54
Vienna,5049,5,17,3,16,52,57,-5,54
RZ Pellets W,5049,6,13,10,13,47,58,-11,49
Admira Wacke,5049,7,14,4,18,38,52,-14,46
SV Josko Rie,5049,8,10,3,23,30,54,-24,33
Mattersburg,5049,9,8,8,20,44,66,-22,32
St. Pölten,5049,10,7,8,21,34,67,-33,29
SC Rheindorf,5050,1,21,7,8,63,42,21,70
SK Sturm Gra,5050,2,20,7,9,62,33,29,67
FC Salzburg,5050,3,20,6,10,61,33,28,66
Vienna,5050,4,19,4,13,67,53,14,61
Rapid Vienna,5050,5,14,9,13,50,41,9,51
RZ Pellets W,5050,6,12,7,17,48,57,-9,43
Admira Wacke,5050,7,11,9,16,39,61,-22,42
SV Josko Rie,5050,8,13,3,20,34,56,-22,42
Mattersburg,5050,9,9,7,20,39,62,-23,34
St. Pölten,5050,10,8,7,21,42,67,-25,31
SK Sturm Gra,5051,1,21,8,7,69,28,41,71
FC Salzburg,5051,2,20,5,11,59,34,25,65
SC Rheindorf,5051,3,18,6,12,50,44,6,60
Vienna,5051,4,18,4,14,63,55,8,58
Rapid Vienna,5051,5,15,10,11,54,38,16,55
Admira Wacke,5051,6,15,5,16,48,58,-10,50
SV Josko Rie,5051,7,13,4,19,35,53,-18,43
RZ Pellets W,5051,8,11,9,16,50,64,-14,42
Mattersburg,5051,9,8,9,19,38,63,-25,33
St. Pölten,5051,10,6,10,20,35,64,-29,28
FC Salzburg,5052,1,20,7,9,67,33,34,67
SC Rheindorf,5052,2,18,9,9,57,45,12,63
Vienna,5052,3,19,6,11,66,55,11,63
SK Sturm Gra,5052,4,16,7,13,56,44,12,55
Rapid Vienna,5052,5,13,12,11,55,43,12,51
RZ Pellets W,5052,6,12,8,16,55,62,-7,44
Mattersburg,5052,7,11,10,15,43,57,-14,43
Admira Wacke,5052,8,11,9,16,34,54,-20,42
St. Pölten,5052,9,9,10,17,46,62,-16,37
SV Josko Rie,5052,10,8,8,20,28,52,-24,32
FC Salzburg,5053,1,24,6,6,73,29,44,78
SK Sturm Gra,5053,2,23,4,9,66,31,35,73
SC Rheindorf,5053,3,20,7,9,62,49,13,67
Vienna,5053,4,16,4,16,57,57,0,52
Rapid Vienna,5053,5,12,11,13,60,47,13,47
Admira Wacke,5053,6,13,6,17,37,55,-18,45
RZ Pellets W,5053,7,12,5,19,39,55,-16,41
St. Pölten,5053,8,9,10,17,48,68,-20,37
SV Josko Rie,5053,9,11,3,22,36,60,-24,36
Mattersburg,5053,10,8,8,20,39,66,-27,32
FC Salzburg,5054,1,21,9,6,62,24,38,72
SC Rheindorf,5054,2,18,8,10,49,38,11,62
Vienna,5054,3,18,7,11,63,49,14,61
SK Sturm Gra,5054,4,18,6,12,55,34,21,60
Rapid Vienna,5054,5,15,9,12,54,47,7,54
RZ Pellets W,5054,6,13,9,14,45,49,-4,48
Admira Wacke,5054,7,12,7,17,37,57,-20,43
SV Josko Rie,5054,8,12,4,20,36,52,-16,40
St. Pölten,5054,9,7,12,17,41,62,-21,33
Mattersburg,5054,10,5,11,20,33,63,-30,26
FC Salzburg,5055,1,20,6,10,59,31,28,66
Rapid Vienna,5055,2,17,10,9,62,37,25,61
SC Rheindorf,5055,3,18,6,12,47,44,3,60
SK Sturm Gra,5055,4,17,6,13,53,40,13,57
Vienna,5055,5,18,3,15,52,49,3,57
RZ Pellets W,5055,6,13,10,13,44,45,-1,49
Mattersburg,5055,7,12,8,16,39,50,-11,44
Admira Wacke,5055,8,13,4,19,37,55,-18,43
St. Pölten,5055,9,8,12,16,45,64,-19,36
SV Josko Rie,5055,10,9,5,22,25,48,-23,32
FC Salzburg,5056,1,23,7,6,73,30,43,76
SC Rheindorf,5056,2,21,5,10,58,41,17,68
SK Sturm Gra,5056,3,20,3,13,60,35,25,63
Vienna,5056,4,19,4,13,63,54,9,61
Rapid Vienna,5056,5,16,8,12,56,41,15,56
RZ Pellets W,5056,6,12,8,16,44,55,-11,44
Admira Wacke,5056,7,11,7,18,33,60,-27,40
SV Josko Rie,5056,8,10,5,21,34,52,-18,35
St. Pölten,5056,9,8,9,19,39,65,-26,33
Mattersburg,5056,10,7,10,19,29,56,-27,31
FC Salzburg,5057,1,21,8,7,63,31,32,71
SC Rheindorf,5057,2,20,8,8,57,42,15,68
Vienna,5057,3,20,5,11,65,49,16,65
SK Sturm Gra,5057,4,19,4,13,64,39,25,61
Rapid Vienna,5057,5,15,11,10,52,39,13,56
Admira Wacke,5057,6,12,7,17,40,64,-24,43
RZ Pellets W,5057,7,11,9,16,49,57,-8,42
SV Josko Rie,5057,8,11,5,20,36,53,-17,38
Mattersburg,5057,9,10,6,20,39,60,-21,36
St. Pölten,5057,10,5,9,22,37,68,-31,24
FC Salzburg,5058,1,22,6,8,68,33,35,72
SC Rheindorf,5058,2,19,7,10,59,42,17,64
SK Sturm Gra,5058,3,19,6,11,66,51,15,63
Vienna,5058,4,17,7,12,61,50,11,58
Rapid Vienna,5058,5,16,8,12,62,41,21,56
RZ Pellets W,5058,6,15,6,15,52,54,-2,51
Mattersburg,5058,7,11,6,19,37,55,-18,39
Admira Wacke,5058,8,10,6,20,36,72,-36,36
St. Pölten,5058,9,9,8,19,39,58,-19,35
SV Josko Rie,5058,10,9,6,21,31,55,-24,33
FC Salzburg,5059,1,22,5,9,68,32,36,71
SK Sturm Gra,5059,2,19,7,10,57,31,26,64
SC Rheindorf,5059,3,18,9,9,54,41,13,63
Vienna,5059,4,17,5,14,59,51,8,56
RZ Pellets W,5059,5,16,7,13,44,43,1,55
Rapid Vienna,5059,6,13,14,9,52,36,16,53
SV Josko Rie,5059,7,14,4,18,41,52,-11,46
Mattersburg,5059,8,9,9,18,43,58,-15,36
Admira Wacke,5059,9,9,7,20,32,63,-31,34
St. Pölten,5059,10,5,9,22,33,76,-43,24
FC Salzburg,5060,1,22,5,9,72,34,38,71
Vienna,5060,2,21,5,10,68,44,24,68
SK Sturm Gra,5060,3,20,3,13,60,40,20,63
SC Rheindorf,5060,4,17,10,9,52,41,11,61
Rapid Vienna,5060,5,13,10,13,49,42,7,49
Admira Wacke,5060,6,13,5,18,39,58,-19,44
RZ Pellets W,5060,7,11,9,16,41,57,-16,42
St. Pölten,5060,8,10,10,16,42,56,-14,40
Mattersburg,5060,9,10,8,18,37,57,-20,38
SV Josko Rie,5060,10,8,5,23,32,63,-31,29
FC Salzburg,5061,1,24,6,6,72,31,41,78
SC Rheindorf,5061,2,19,7,10,55,44,11,64
SK Sturm Gra,5061,3,18,7,11,52,30,22,61
Vienna,5061,4,18,5,13,60,51,9,59
Rapid Vienna,5061,5,12,13,11,58,47,11,49
St. Pölten,5061,6,11,9,16,45,60,-15,42
Admira Wacke,5061,7,11,8,17,45,64,-19,41
Mattersburg,5061,8,10,7,19,49,68,-19,37
RZ Pellets W,5061,9,9,8,19,42,61,-19,35
SV Josko Rie,5061,10,9,8,19,31,53,-22,35
FC Salzburg,5062,1,19,9,8,62,31,31,66
SC Rheindorf,5062,2,19,9,8,56,42,14,66
SK Sturm Gra,5062,3,19,7,10,58,31,27,64
Rapid Vienna,5062,4,14,12,10,54,39,15,54
Vienna,5062,5,16,6,14,57,50,7,54
Admira Wacke,5062,6,13,6,17,40,56,-16,45
RZ Pellets W,5062,7,13,5,18,43,55,-12,44
Mattersburg,5062,8,7,13,16,37,55,-18,34
St. Pölten,5062,9,7,13,16,38,61,-23,34
SV Josko Rie,5062,10,8,10,18,27,52,-25,34
FC Salzburg,5063,1,19,8,9,63,41,22,65
SC Rheindorf,5063,2,18,10,8,51,42,9,64
SK Sturm Gra,5063,3,19,6,11,59,36,23,63
Rapid Vienna,5063,4,17,8,11,56,38,18,59
Vienna,5063,5,16,7,13,57,52,5,55
RZ Pellets W,5063,6,14,7,15,56,61,-5,49
Admira Wacke,5063,7,13,4,19,37,54,-17,43
SV Josko Rie,5063,8,11,7,18,35,50,-15,40
St. Pölten,5063,9,8,10,18,40,57,-17,34
Mattersburg,5063,10,7,9,20,37,60,-23,30
FC Salzburg,5064,1,22,7,7,70,27,43,73
SC Rheindorf,5064,2,19,8,9,51,42,9,65
Vienna,5064,3,20,4,12,67,55,12,64
SK Sturm Gra,5064,4,17,6,13,56,40,16,57
Rapid Vienna,5064,5,12,13,11,52,37,15,49
RZ Pellets W,5064,6,13,8,15,48,60,-12,47
Admira Wacke,5064,7,12,8,16,36,52,-16,44
Mattersburg,5064,8,8,11,17,40,55,-15,35
SV Josko Rie,5064,9,8,9,19,33,59,-26,33
St. Pölten,5064,10,6,12,18,33,59,-26,30
FC Salzburg,5065,1,20,9,7,67,32,35,69
Rapid Vienna,5065,2,19,10,7,64,35,29,67
SC Rheindorf,5065,3,18,8,10,51,43,8,62
SK Sturm Gra,5065,4,15,9,12,52,39,13,54
Vienna,5065,5,15,7,14,59,56,3,52
RZ Pellets W,5065,6,13,6,17,46,54,-8,45
SV Josko Rie,5065,7,12,4,20,39,59,-20,40
Mattersburg,5065,8,10,8,18,37,53,-16,38
Admira Wacke,5065,9,10,8,18,37,57,-20,38
St. Pölten,5065,10,9,9,18,40,64,-24,36
SC Rheindorf,5066,1,21,6,9,66,47,19,69
SK Sturm Gra,5066,2,19,8,9,56,30,26,65
FC Salzburg,5066,3,19,6,11,64,43,21,63
Vienna,5066,4,19,6,11,71,53,18,63
Rapid Vienna,5066,5,17,9,10,67,43,24,60
Admira Wacke,5066,6,12,6,18,41,65,-24,42
RZ Pellets W,5066,7,10,10,16,43,62,-19,40
Mattersburg,5066,8,9,11,16,43,54,-11,38
St. Pölten,5066,9,7,11,18,43,65,-22,32
SV Josko Rie,5066,10,8,5,23,35,67,-32,29
SC Rheindorf,5067,1,22,6,8,56,36,20,72
SK Sturm Gra,5067,2,22,4,10,64,32,32,70
FC Salzburg,5067,3,20,7,9,62,29,33,67
Vienna,5067,4,20,4,12,61,51,10,64
Rapid Vienna,5067,5,13,8,15,55,45,10,47
SV Josko Rie,5067,6,12,6,18,40,56,-16,42
Admira Wacke,5067,7,11,6,19,34,60,-26,39
Mattersburg,5067,8,10,8,18,45,54,-9,38
St. Pölten,5067,9,9,8,19,38,66,-28,35
RZ Pellets W,5067,10,9,7,20,39,65,-26,34
FC Salzburg,5068,1,24,6,6,70,25,45,78
SK Sturm Gra,5068,2,21,5,10,64,34,30,68
Vienna,5068,3,19,5,12,56,51,5,62
SC Rheindorf,5068,4,18,7,11,54,41,13,61
Rapid Vienna,5068,5,15,9,12,52,36,16,54
RZ Pellets W,5068,6,13,6,17,45,56,-11,45
SV Josko Rie,5068,7,12,5,19,36,56,-20,41
St. Pölten,5068,8,9,10,17,46,63,-17,37
Admira Wacke,5068,9,8,8,20,39,70,-31,32
Mattersburg,5068,10,6,9,21,28,58,-30,27
FC Salzburg,5069,1,21,7,8,59,30,29,70
SK Sturm Gra,5069,2,20,6,10,63,31,32,66
SC Rheindorf,5069,3,19,9,8,59,42,17,66
Vienna,5069,4,19,4,13,62,48,14,61
Rapid Vienna,5069,5,13,13,10,55,40,15,52
Mattersburg,5069,6,13,7,16,46,53,-7,46
Admira Wacke,5069,7,10,8,18,39,62,-23,38
RZ Pellets W,5069,8,10,7,19,42,64,-22,37
St. Pölten,5069,9,8,9,19,40,69,-29,33
SV Josko Rie,5069,10,8,8,20,28,54,-26,32
FC Salzburg,5070,1,22,7,7,64,29,35,73
Vienna,5070,2,22,5,9,68,43,25,71
SC Rheindorf,5070,3,20,9,7,57,42,15,69
SK Sturm Gra,5070,4,19,6,11,55,30,25,63
Rapid Vienna,5070,5,16,11,9,61,36,25,59
RZ Pellets W,5070,6,10,9,17,34,54,-20,39
SV Josko Rie,5070,7,11,5,20,30,55,-25,38
Admira Wacke,5070,8,10,7,19,32,53,-21,37
St. Pölten,5070,9,7,11,18,42,63,-21,32
Mattersburg,5070,10,4,8,24,28,66,-38,20
SK Sturm Gra,5071,1,20,9,7,66,33,33,69
FC Salzburg,5071,2,19,9,8,69,35,34,66
Vienna,5071,3,20,5,11,69,58,11,65
SC Rheindorf,5071,4,16,10,10,50,44,6,58
RZ Pellets W,5071,5,12,10,14,51,58,-7,46
Rapid Vienna,5071,6,9,15,12,53,46,7,42
SV Josko Rie,5071,7,11,6,19,37,57,-20,39
Mattersburg,5071,8,10,7,19,38,56,-18,37
Admira Wacke,5071,9,9,10,17,36,60,-24,37
St. Pölten,5071,10,7,13,16,39,61,-22,34
FC Salzburg,5072,1,22,6,8,63,30,33,72
Vienna,5072,2,19,6,11,63,49,14,63
SC Rheindorf,5072,3,17,10,9,56,41,15,61
SK Sturm Gra,5072,4,16,9,11,55,39,16,57
Rapid Vienna,5072,5,13,12,11,57,43,14,51
RZ Pellets W,5072,6,11,10,15,41,55,-14,43
Mattersburg,5072,7,10,10,16,38,51,-13,40
SV Josko Rie,5072,8,10,7,19,33,53,-20,37
Admira Wacke,5072,9,9,9,18,36,60,-24,36
St. Pölten,5072,10,8,11,17,38,59,-21,35
SC Rheindorf,5073,1,21,10,5,58,36,22,73
FC Salzburg,5073,2,21,9,6,68,26,42,72
SK Sturm Gra,5073,3,19,4,13,59,35,24,61
Vienna,5073,4,17,5,14,57,60,-3,56
Rapid Vienna,5073,5,12,13,11,48,39,9,49
RZ Pellets W,5073,6,13,9,14,47,52,-5,48
Admira Wacke,5073,7,13,7,16,40,57,-17,46
St. Pölten,5073,8,9,11,16,42,61,-19,38
Mattersburg,5073,9,7,7,22,35,58,-23,28
SV Josko Rie,5073,10,7,7,22,28,58,-30,28
FC Salzburg,5074,1,22,7,7,72,31,41,73
SC Rheindorf,5074,2,21,7,8,58,35,23,70
SK Sturm Gra,5074,3,19,4,13,51,40,11,61
Vienna,5074,4,17,9,10,66,55,11,60
Rapid Vienna,5074,5,15,8,13,53,39,14,53
RZ Pellets W,5074,6,13,7,16,43,53,-10,46
Admira Wacke,5074,7,12,4,20,40,64,-24,40
SV Josko Rie,5074,8,10,7,19,30,53,-23,37
Mattersburg,5074,9,7,12,17,34,52,-18,33
St. Pölten,5074,10,7,9,20,36,61,-25,30
SC Rheindorf,5075,1,22,5,9,66,44,22,71
SK Sturm Gra,5075,2,22,4,10,65,33,32,70
FC Salzburg,5075,3,19,11,6,63,35,28,68
Vienna,5075,4,19,4,13,60,49,11,61
Admira Wacke,5075,5,13,8,15,43,55,-12,47
Rapid Vienna,5075,6,11,12,13,52,45,7,45
RZ Pellets W,5075,7,13,6,17,42,52,-10,45
Mattersburg,5075,8,10,7,19,39,59,-20,37
St. Pölten,5075,9,8,7,21,36,64,-28,31
SV Josko Rie,5075,10,8,6,22,30,60,-30,30
SC Rheindorf,5076,1,22,8,6,53,31,22,74
SK Sturm Gra,5076,2,21,5,10,57,32,25,68
FC Salzburg,5076,3,16,12,8,57,33,24,60
Vienna,5076,4,17,5,14,66,61,5,56
Rapid Vienna,5076,5,12,14,10,60,45,15,50
Admira Wacke,5076,6,11,7,18,42,63,-21,40
St. Pölten,5076,7,10,8,18,50,65,-15,38
RZ Pellets W,5076,8,10,8,18,45,65,-20,38
Mattersburg,5076,9,9,10,17,37,54,-17,37
SV Josko Rie,5076,10,10,7,19,41,59,-18,37
SC Rheindorf,5077,1,20,6,10,56,42,14,66
FC Salzburg,5077,2,19,7,10,57,32,25,64
Rapid Vienna,5077,3,18,8,10,63,37,26,62
SK Sturm Gra,5077,4,19,5,12,57,37,20,62
Vienna,5077,5,18,3,15,59,57,2,57
RZ Pellets W,5077,6,13,8,15,47,53,-6,47
Mattersburg,5077,7,11,7,18,38,52,-14,40
Admira Wacke,5077,8,11,6,19,35,55,-20,39
St. Pölten,5077,9,9,9,18,47,72,-25,36
SV Josko Rie,5077,10,9,7,20,32,54,-22,34
SC Rheindorf,5078,1,22,8,6,59,34,25,74
FC Salzburg,5078,2,20,7,9,61,32,29,67
Vienna,5078,3,21,4,11,70,47,23,67
Rapid Vienna,5078,4,16,10,10,57,35,22,58
SK Sturm Gra,5078,5,17,7,12,56,39,17,58
Admira Wacke,5078,6,13,6,17,39,61,-22,45
St. Pölten,5078,7,9,9,18,44,68,-24,36
RZ Pellets W,5078,8,9,7,20,40,60,-20,34
Mattersburg,5078,9,9,7,20,36,56,-20,34
SV Josko Rie,5078,10,9,5,22,38,68,-30,32
FC Salzburg,5079,1,23,7,6,62,22,40,76
Vienna,5079,2,22,4,10,60,46,14,70
SK Sturm Gra,5079,3,20,3,13,64,34,30,63
SC Rheindorf,5079,4,19,6,11,57,41,16,63
Rapid Vienna,5079,5,13,11,12,45,37,8,50
Admira Wacke,5079,6,14,4,18,35,53,-18,46
SV Josko Rie,5079,7,10,8,18,31,53,-22,38
RZ Pellets W,5079,8,10,5,21,42,61,-19,35
Mattersburg,5079,9,8,9,19,33,57,-24,33
St. Pölten,5079,10,7,11,18,41,66,-25,32
FC Salzburg,5080,1,19,9,8,64,36,28,66
Vienna,5080,2,19,8,9,64,47,17,65
SK Sturm Gra,5080,3,20,4,12,62,37,25,64
SC Rheindorf,5080,4,19,7,10,59,43,16,64
St. Pölten,5080,5,12,10,14,50,61,-11,46
RZ Pellets W,5080,6,13,5,18,46,60,-14,44
Rapid Vienna,5080,7,10,11,15,48,48,0,41
Mattersburg,5080,8,11,8,17,46,57,-11,41
SV Josko Rie,5080,9,10,7,19,40,62,-22,37
Admira Wacke,5080,10,9,7,20,33,61,-28,34
SC Rheindorf,5081,1,22,8,6,52,33,19,74
FC Salzburg,5081,2,22,6,8,70,37,33,72
SK Sturm Gra,5081,3,19,7,10,58,35,23,64
Vienna,5081,4,18,6,12,64,53,11,60
Rapid Vienna,5081,5,15,9,12,59,43,16,54
RZ Pellets W,5081,6,11,6,19,43,58,-15,39
SV Josko Rie,5081,7,10,7,19,34,53,-19,37
St. Pölten,5081,8,9,9,18,40,57,-17,36
Admira Wacke,5081,9,10,6,20,35,67,-32,36
Mattersburg,5081,10,8,8,20,35,54,-19,32
SC Rheindorf,5082,1,22,7,7,56,35,21,73
SK Sturm Gra,5082,2,22,6,8,69,34,35,72
FC Salzburg,5082,3,19,9,8,62,33,29,66
Vienna,5082,4,19,5,12,61,47,14,62
Rapid Vienna,5082,5,15,13,8,75,39,36,58
Admira Wacke,5082,6,11,8,17,32,52,-20,41
Mattersburg,5082,7,9,8,19,33,56,-23,35
St. Pölten,5082,8,8,9,19,39,70,-31,33
RZ Pellets W,5082,9,9,5,22,41,75,-34,32
SV Josko Rie,5082,10,8,6,22,28,55,-27,30
FC Salzburg,5083,1,20,8,8,64,35,29,68
Vienna,5083,2,20,7,9,61,46,15,67
SC Rheindorf,5083,3,18,10,8,57,37,20,64
SK Sturm Gra,5083,4,15,10,11,53,38,15,55
Rapid Vienna,5083,5,14,10,12,50,36,14,52
Admira Wacke,5083,6,12,9,15,40,54,-14,45
RZ Pellets W,5083,7,12,5,19,37,58,-21,41
St. Pölten,5083,8,9,10,17,43,58,-15,37
Mattersburg,5083,9,8,10,18,36,56,-20,34
SV Josko Rie,5083,10,9,7,20,29,52,-23,34
FC Salzburg,5084,1,25,4,7,76,31,45,79
SC Rheindorf,5084,2,21,6,9,61,41,20,69
SK Sturm Gra,5084,3,20,4,12,61,44,17,64
Vienna,5084,4,17,4,15,61,53,8,55
Rapid Vienna,5084,5,15,9,12,63,47,16,54
Admira Wacke,5084,6,16,5,15,46,49,-3,53
RZ Pellets W,5084,7,11,7,18,45,56,-11,40
SV Josko Rie,5084,8,11,4,21,37,59,-22,37
St. Pölten,5084,9,7,9,20,36,71,-35,30
Mattersburg,5084,10,8,6,22,33,68,-35,30
SK Sturm Gra,5085,1,21,5,10,59,31,28,68
FC Salzburg,5085,2,21,5,10,62,36,26,68
SC Rheindorf,5085,3,20,8,8,55,36,19,68
Vienna,5085,4,20,5,11,62,45,17,65
Rapid Vienna,5085,5,13,11,12,55,43,12,50
RZ Pellets W,5085,6,12,8,16,46,55,-9,44
Admira Wacke,5085,7,12,5,19,35,54,-19,41
Mattersburg,5085,8,10,9,17,42,54,-12,39
SV Josko Rie,5085,9,10,8,18,32,49,-17,38
St. Pölten,5085,10,4,10,22,33,78,-45,22
SC Rheindorf,5086,1,23,6,7,70,44,26,75
FC Salzburg,5086,2,20,8,8,65,34,31,68
Vienna,5086,3,18,6,12,63,51,12,60
SK Sturm Gra,5086,4,17,4,15,57,46,11,55
RZ Pellets W,5086,5,14,8,14,48,49,-1,50
Rapid Vienna,5086,6,12,9,15,49,43,6,45
SV Josko Rie,5086,7,11,7,18,39,54,-15,40
St. Pölten,5086,8,11,7,18,44,70,-26,40
Admira Wacke,5086,9,10,8,18,37,61,-24,38
Mattersburg,5086,10,8,9,19,39,59,-20,33
SK Sturm Gra,5087,1,19,7,10,59,34,25,64
FC Salzburg,5087,2,18,8,10,66,37,29,62
SC Rheindorf,5087,3,18,7,11,60,48,12,61
Vienna,5087,4,16,7,13,62,59,3,55
RZ Pellets W,5087,5,16,6,14,53,53,0,54
Rapid Vienna,5087,6,13,11,12,54,43,11,50
St. Pölten,5087,7,11,10,15,42,55,-13,43
Admira Wacke,5087,8,12,6,18,40,58,-18,42
SV Josko Rie,5087,9,10,7,19,31,51,-20,37
Mattersburg,5087,10,9,7,20,38,67,-29,34
FC Salzburg,5088,1,21,7,8,70,33,37,70
SK Sturm Gra,5088,2,19,8,9,65,35,30,65
SC Rheindorf,5088,3,19,8,9,58,42,16,65
Vienna,5088,4,19,4,13,62,54,8,61
Rapid Vienna,5088,5,13,11,12,56,37,19,50
RZ Pellets W,5088,6,12,8,16,42,56,-14,44
SV Josko Rie,5088,7,12,5,19,35,49,-14,41
Admira Wacke,5088,8,12,5,19,39,62,-23,41
Mattersburg,5088,9,9,8,19,38,58,-20,35
St. Pölten,5088,10,7,10,19,35,74,-39,31
Vienna,5089,1,21,6,9,69,45,24,69
FC Salzburg,5089,2,21,5,10,64,32,32,68
SC Rheindorf,5089,3,20,8,8,59,42,17,68
SK Sturm Gra,5089,4,20,6,10,58,32,26,66
Rapid Vienna,5089,5,13,13,10,49,36,13,52
RZ Pellets W,5089,6,13,7,16,47,59,-12,46
Admira Wacke,5089,7,11,9,16,39,58,-19,42
SV Josko Rie,5089,8,9,7,20,36,57,-21,34
St. Pölten,5089,9,6,10,20,39,73,-34,28
Mattersburg,5089,10,6,9,21,32,58,-26,27
FC Salzburg,5090,1,22,6,8,73,30,43,72
SC Rheindorf,5090,2,21,8,7,58,38,20,71
SK Sturm Gra,5090,3,20,7,9,61,32,29,67
Vienna,5090,4,18,7,11,66,52,14,61
Rapid Vienna,5090,5,16,10,10,64,44,20,58
RZ Pellets W,5090,6,13,9,14,42,50,-8,48
Mattersburg,5090,7,9,7,20,30,53,-23,34
SV Josko Rie,5090,8,9,5,22,32,62,-30,32
St. Pölten,5090,9,7,9,20,33,65,-32,30
Admira Wacke,5090,10,8,6,22,33,66,-33,30
SC Rheindorf,5091,1,22,8,6,55,36,19,74
FC Salzburg,5091,2,21,8,7,75,35,40,71
SK Sturm Gra,5091,3,17,10,9,54,33,21,61
Vienna,5091,4,16,6,14,54,46,8,54
Rapid Vienna,5091,5,13,13,10,51,38,13,52
RZ Pellets W,5091,6,13,8,15,45,52,-7,47
Mattersburg,5091,7,13,6,17,43,57,-14,45
Admira Wacke,5091,8,10,9,17,35,56,-21,39
St. Pölten,5091,9,6,11,19,37,60,-23,29
SV Josko Rie,5091,10,7,5,24,26,62,-36,26
FC Salzburg,5092,1,21,8,7,69,28,41,71
SK Sturm Gra,5092,2,19,9,8,62,33,29,66
SC Rheindorf,5092,3,18,8,10,50,40,10,62
Vienna,5092,4,19,4,13,67,56,11,61
Admira Wacke,5092,5,14,8,14,42,53,-11,50
Rapid Vienna,5092,6,10,12,14,46,41,5,42
Mattersburg,5092,7,11,9,16,37,51,-14,42
St. Pölten,5092,8,9,10,17,39,60,-21,37
RZ Pellets W,5092,9,9,8,19,41,66,-25,35
SV Josko Rie,5092,10,9,6,21,29,54,-25,33
FC Salzburg,5093,1,21,7,8,65,35,30,70
Vienna,5093,2,20,6,10,66,45,21,66
SK Sturm Gra,5093,3,17,8,11,61,40,21,59
SC Rheindorf,5093,4,15,11,10,52,51,1,56
Rapid Vienna,5093,5,14,11,11,56,42,14,53
RZ Pellets W,5093,6,14,8,14,49,52,-3,50
SV Josko Rie,5093,7,13,5,18,39,50,-11,44
Mattersburg,5093,8,10,7,19,40,56,-16,37
Admira Wacke,5093,9,10,5,21,31,63,-32,35
St. Pölten,5093,10,7,10,19,42,67,-25,31
SC Rheindorf,5094,1,20,6,10,62,47,15,66
FC Salzburg,5094,2,18,9,9,58,33,25,63
SK Sturm Gra,5094,3,18,7,11,68,44,24,61
Vienna,5094,4,19,3,14,67,57,10,60
Rapid Vienna,5094,5,13,11,12,52,38,14,50
Admira Wacke,5094,6,14,7,15,44,53,-9,49
RZ Pellets W,5094,7,12,10,14,44,49,-5,46
St. Pölten,5094,8,9,10,17,43,72,-29,37
SV Josko Rie,5094,9,10,6,20,33,55,-22,36
Mattersburg,5094,10,9,7,20,35,58,-23,34
SC Rheindorf,5095,1,22,8,6,73,40,33,74
SK Sturm Gra,5095,2,20,5,11,60,36,24,65
Vienna,5095,3,20,4,12,64,47,17,64
FC Salzburg,5095,4,18,6,12,59,41,18,60
Rapid Vienna,5095,5,14,11,11,61,44,17,53
RZ Pellets W,5095,6,12,7,17,48,62,-14,43
Admira Wacke,5095,7,12,6,18,39,63,-24,42
Mattersburg,5095,8,11,7,18,44,61,-17,40
SV Josko Rie,5095,9,8,9,19,29,53,-24,33
St. Pölten,5095,10,7,9,20,39,69,-30,30
FC Salzburg,5096,1,23,8,5,65,26,39,77
Vienna,5096,2,21,4,11,70,46,24,67
SK Sturm Gra,5096,3,20,6,10,64,37,27,66
SC Rheindorf,5096,4,19,8,9,54,41,13,65
Rapid Vienna,5096,5,11,12,13,45,40,5,45
Admira Wacke,5096,6,12,6,18,41,63,-22,42
RZ Pellets W,5096,7,10,10,16,42,58,-16,40
Mattersburg,5096,8,9,9,18,36,55,-19,36
SV Josko Rie,5096,9,9,5,22,33,56,-23,32
St. Pölten,5096,10,5,14,17,37,65,-28,29
SC Rheindorf,5097,1,24,5,7,60,37,23,77
FC Salzburg,5097,2,21,8,7,67,30,37,71
Rapid Vienna,5097,3,16,11,9,61,34,27,59
Vienna,5097,4,17,8,11,64,55,9,59
SK Sturm Gra,5097,5,18,4,14,62,46,16,58
RZ Pellets W,5097,6,13,9,14,48,55,-7,48
Admira Wacke,5097,7,13,5,18,40,58,-18,44
SV Josko Rie,5097,8,10,4,22,32,54,-22,34
Mattersburg,5097,9,6,9,21,34,61,-27,27
St. Pölten,5097,10,6,9,21,35,73,-38,27
SC Rheindorf,5098,1,23,5,8,61,41,20,74
FC Salzburg,5098,2,21,8,7,69,35,34,71
Vienna,5098,3,17,7,12,58,53,5,58
SK Sturm Gra,5098,4,16,7,13,50,37,13,55
Rapid Vienna,5098,5,14,12,10,62,40,22,54
RZ Pellets W,5098,6,12,7,17,45,56,-11,43
Admira Wacke,5098,7,10,8,18,39,62,-23,38
Mattersburg,5098,8,9,10,17,40,52,-12,37
SV Josko Rie,5098,9,10,5,21,35,58,-23,35
St. Pölten,5098,10,8,11,17,39,64,-25,35
FC Salzburg,5099,1,22,4,10,61,32,29,70
SC Rheindorf,5099,2,21,7,8,56,38,18,70
Vienna,5099,3,22,3,11,72,51,21,69
SK Sturm Gra,5099,4,17,7,12,53,36,17,58
Rapid Vienna,5099,5,13,12,11,47,36,11,51
St. Pölten,5099,6,13,7,16,52,64,-12,46
RZ Pellets W,5099,7,12,9,15,46,58,-12,45
Admira Wacke,5099,8,10,8,18,38,56,-18,38
SV Josko Rie,5099,9,10,3,23,30,61,-31,33
Mattersburg,5099,10,7,6,23,34,57,-23,27
FC Salzburg,5100,1,22,8,6,69,33,36,74
SK Sturm Gra,5100,2,21,5,10,63,32,31,68
SC Rheindorf,5100,3,20,7,9,57,41,16,67
Vienna,5100,4,18,5,13,57,53,4,59
Rapid Vienna,5100,5,13,12,11,58,40,18,51
RZ Pellets W,5100,6,11,8,17,49,62,-13,41
SV Josko Rie,5100,7,10,7,19,31,49,-18,37
St. Pölten,5100,8,10,7,19,42,65,-23,37
Admira Wacke,5100,9,9,8,19,42,68,-26,35
Mattersburg,5100,10,8,9,19,38,63,-25,33
FC Salzburg,5101,1,20,9,7,67,28,39,69
SK Sturm Gra,5101,2,20,9,7,68,36,32,69
SC Rheindorf,5101,3,18,10,8,55,39,16,64
Rapid Vienna,5101,4,15,10,11,63,50,13,55
Vienna,5101,5,16,5,15,63,61,2,53
RZ Pellets W,5101,6,11,8,17,48,58,-10,41
Admira Wacke,5101,7,11,8,17,38,60,-22,41
SV Josko Rie,5101,8,11,6,19,33,52,-19,39
Mattersburg,5101,9,8,10,18,39,56,-17,34
St. Pölten,5101,10,9,7,20,38,72,-34,34
FC Salzburg,5102,1,22,9,5,68,29,39,75
SK Sturm Gra,5102,2,22,6,8,59,28,31,72
SC Rheindorf,5102,3,18,7,11,53,40,13,61
Vienna,5102,4,17,5,14,64,63,1,56
Rapid Vienna,5102,5,13,10,13,52,44,8,49
Admira Wacke,5102,6,11,10,15,42,56,-14,43
RZ Pellets W,5102,7,11,7,18,48,62,-14,40
St. Pölten,5102,8,11,7,18,44,65,-21,40
SV Josko Rie,5102,9,11,6,19,41,59,-18,39
Mattersburg,5102,10,7,7,22,41,66,-25,28
SC Rheindorf,5103,1,21,10,5,60,35,25,73
FC Salzburg,5103,2,19,8,9,61,29,32,65
SK Sturm Gra,5103,3,19,7,10,57,33,24,64
Vienna,5103,4,18,5,13,60,50,10,59
Rapid Vienna,5103,5,14,10,12,61,42,19,52
Admira Wacke,5103,6,12,8,16,36,53,-17,44
SV Josko Rie,5103,7,11,6,19,31,54,-23,39
St. Pölten,5103,8,9,9,18,44,66,-22,36
Mattersburg,5103,9,9,8,19,40,64,-24,35
RZ Pellets W,5103,10,9,7,20,36,60,-24,34
FC Salzburg,5104,1,20,11,5,61,28,33,71
Vienna,5104,2,20,5,11,67,51,16,65
SC Rheindorf,5104,3,19,7,10,59,45,14,64
SK Sturm Gra,5104,4,15,7,14,49,39,10,52
Rapid Vienna,5104,5,13,11,12,61,48,13,50
RZ Pellets W,5104,6,13,7,16,46,52,-6,46
SV Josko Rie,5104,7,11,7,18,38,57,-19,40
Admira Wacke,5104,8,10,10,16,36,56,-20,40
St. Pölten,5104,9,10,7,19,42,66,-24,37
Mattersburg,5104,10,9,8,19,43,60,-17,35
SC Rheindorf,5105,1,22,7,7,58,37,21,73
FC Salzburg,5105,2,20,5,11,60,37,23,65
SK Sturm Gra,5105,3,18,6,12,57,36,21,60
Vienna,5105,4,18,4,14,65,53,12,58
Rapid Vienna,5105,5,15,9,12,60,43,17,54
RZ Pellets W,5105,6,15,8,13,52,52,0,53
SV Josko Rie,5105,7,12,5,19,34,53,-19,41
Admira Wacke,5105,8,10,8,18,33,58,-25,38
St. Pölten,5105,9,9,8,19,42,69,-27,35
Mattersburg,5105,10,7,8,21,35,58,-23,29
SC Rheindorf,5106,1,22,7,7,62,40,22,73
FC Salzburg,5106,2,20,7,9,63,35,28,67
Rapid Vienna,5106,3,17,10,9,65,38,27,61
SK Sturm Gra,5106,4,17,7,12,55,35,20,58
Vienna,5106,5,15,5,16,61,59,2,50
Admira Wacke,5106,6,13,6,17,39,58,-19,45
RZ Pellets W,5106,7,12,7,17,37,52,-15,43
St. Pölten,5106,8,10,9,17,48,64,-16,39
Mattersburg,5106,9,10,8,18,40,58,-18,38
SV Josko Rie,5106,10,8,6,22,30,61,-31,30
FC Salzburg,5107,1,20,7,9,62,28,34,67
SC Rheindorf,5107,2,18,9,9,56,44,12,63
SK Sturm Gra,5107,3,18,8,10,62,36,26,62
Vienna,5107,4,19,5,12,68,52,16,62
Rapid Vienna,5107,5,14,13,9,59,42,17,55
Mattersburg,5107,6,13,6,17,41,56,-15,45
Admira Wacke,5107,7,12,5,19,39,66,-27,41
RZ Pellets W,5107,8,10,9,17,39,53,-14,39
St. Pölten,5107,9,8,10,18,41,65,-24,34
SV Josko Rie,5107,10,9,6,21,33,58,-25,33
FC Salzburg,5108,1,23,6,7,69,29,40,75
SK Sturm Gra,5108,2,21,6,9,63,33,30,69
Vienna,5108,3,21,2,13,65,53,12,65
SC Rheindorf,5108,4,16,7,13,46,44,2,55
Rapid Vienna,5108,5,14,11,11,54,40,14,53
RZ Pellets W,5108,6,12,7,17,46,63,-17,43
Mattersburg,5108,7,11,6,19,43,55,-12,39
Admira Wacke,5108,8,10,8,18,34,59,-25,38
St. Pölten,5108,9,9,9,18,46,65,-19,36
SV Josko Rie,5108,10,9,6,21,33,58,-25,33
FC Salzburg,5109,1,21,8,7,65,28,37,71
SK Sturm Gra,5109,2,20,6,10,53,30,23,66
SC Rheindorf,5109,3,19,8,9,54,41,13,65
Vienna,5109,4,20,2,14,64,53,11,62
Rapid Vienna,5109,5,14,13,9,58,39,19,55
Admira Wacke,5109,6,14,4,18,38,54,-16,46
RZ Pellets W,5109,7,12,6,18,43,52,-9,42
St. Pölten,5109,8,10,9,17,44,65,-21,39
Mattersburg,5109,9,7,10,19,36,63,-27,31
SV Josko Rie,5109,10,8,4,24,28,58,-30,28
Vienna,5110,1,20,5,11,66,45,21,65
SK Sturm Gra,5110,2,18,10,8,55,27,28,64
FC Salzburg,5110,3,18,9,9,61,38,23,63
SC Rheindorf,5110,4,18,8,10,51,42,9,62
Rapid Vienna,5110,5,11,14,11,46,40,6,47
St. Pölten,5110,6,11,10,15,41,58,-17,43
RZ Pellets W,5110,7,10,12,14,39,52,-13,42
Mattersburg,5110,8,9,10,17,39,49,-10,37
Admira Wacke,5110,9,10,6,20,36,62,-26,36
SV Josko Rie,5110,10,9,8,19,38,59,-21,35
SK Sturm Gra,5111,1,25,3,8,73,31,42,78
SC Rheindorf,5111,2,18,8,10,57,44,13,62
FC Salzburg,5111,3,17,9,10,58,39,19,60
Vienna,5111,4,17,5,14,62,52,10,56
Rapid Vienna,5111,5,13,9,14,51,45,6,48
RZ Pellets W,5111,6,12,9,15,46,56,-10,45
Mattersburg,5111,7,11,9,16,53,62,-9,42
Admira Wacke,5111,8,11,7,18,33,56,-23,40
St. Pölten,5111,9,9,10,17,44,67,-23,37
SV Josko Rie,5111,10,9,7,20,32,57,-25,34
SC Rheindorf,5112,1,21,7,8,56,38,18,70
Vienna,5112,2,21,6,9,70,42,28,69
FC Salzburg,5112,3,19,8,9,65,34,31,65
Rapid Vienna,5112,4,16,10,10,54,36,18,58
SK Sturm Gra,5112,5,16,4,16,55,42,13,52
Admira Wacke,5112,6,14,3,19,39,66,-27,45
RZ Pellets W,5112,7,11,8,17,38,54,-16,41
St. Pölten,5112,8,11,7,18,43,61,-18,40
SV Josko Rie,5112,9,10,7,19,33,53,-20,37
Mattersburg,5112,10,8,6,22,31,58,-27,30
SC Rheindorf,5113,1,19,10,7,54,40,14,67
SK Sturm Gra,5113,2,20,6,10,71,43,28,66
FC Salzburg,5113,3,20,6,10,60,33,27,66
Vienna,5113,4,17,4,15,64,55,9,55
RZ Pellets W,5113,5,15,7,14,48,50,-2,52
Rapid Vienna,5113,6,13,10,13,53,42,11,49
Admira Wacke,5113,7,14,6,16,44,58,-14,48
Mattersburg,5113,8,9,10,17,41,58,-17,37
SV Josko Rie,5113,9,10,5,21,33,52,-19,35
St. Pölten,5113,10,7,8,21,34,71,-37,29
FC Salzburg,5114,1,20,9,7,62,28,34,69
SC Rheindorf,5114,2,18,9,9,53,39,14,63
Vienna,5114,3,19,6,11,61,49,12,63
SK Sturm Gra,5114,4,17,10,9,60,36,24,61
Rapid Vienna,5114,5,15,13,8,56,37,19,58
RZ Pellets W,5114,6,11,8,17,50,62,-12,41
SV Josko Rie,5114,7,10,8,18,35,47,-12,38
Mattersburg,5114,8,9,9,18,41,60,-19,36
Admira Wacke,5114,9,10,6,20,29,60,-31,36
St. Pölten,5114,10,7,10,19,41,70,-29,31
SK Sturm Gra,5115,1,22,6,8,67,33,34,72
FC Salzburg,5115,2,20,8,8,67,28,39,68
Vienna,5115,3,19,7,10,62,47,15,64
SC Rheindorf,5115,4,18,8,10,54,44,10,62
Rapid Vienna,5115,5,13,9,14,51,41,10,48
RZ Pellets W,5115,6,11,10,15,46,62,-16,43
Admira Wacke,5115,7,12,5,19,38,61,-23,41
SV Josko Rie,5115,8,10,7,19,39,57,-18,37
St. Pölten,5115,9,9,10,17,42,66,-24,37
Mattersburg,5115,10,6,10,20,35,62,-27,28
FC Salzburg,5116,1,22,7,7,68,31,37,73
SC Rheindorf,5116,2,22,6,8,59,35,24,72
SK Sturm Gra,5116,3,21,5,10,60,28,32,68
Vienna,5116,4,16,6,14,59,56,3,54
Rapid Vienna,5116,5,14,10,12,56,42,14,52
RZ Pellets W,5116,6,14,7,15,48,60,-12,49
St. Pölten,5116,7,11,9,16,46,61,-15,42
Admira Wacke,5116,8,11,6,19,37,62,-25,39
SV Josko Rie,5116,9,8,6,22,31,59,-28,30
Mattersburg,5116,10,6,8,22,34,64,-30,26
FC Salzburg,5117,1,20,8,8,56,29,27,68
SK Sturm Gra,5117,2,19,8,9,61,35,26,65
Vienna,5117,3,18,7,11,62,48,14,61
SC Rheindorf,5117,4,17,8,11,51,46,5,59
Rapid Vienna,5117,5,15,10,11,58,39,19,55
Admira Wacke,5117,6,15,5,16,40,50,-10,50
RZ Pellets W,5117,7,10,8,18,40,60,-20,38
SV Josko Rie,5117,8,9,9,18,34,51,-17,36
St. Pölten,5117,9,9,8,19,41,63,-22,35
Mattersburg,5117,10,8,9,19,29,51,-22,33
FC Salzburg,5118,1,19,10,7,66,31,35,67
SC Rheindorf,5118,2,20,7,9,59,43,16,67
Vienna,5118,3,21,4,11,64,55,9,67
Rapid Vienna,5118,4,17,9,10,61,37,24,60
SK Sturm Gra,5118,5,16,7,13,55,41,14,55
RZ Pellets W,5118,6,12,6,18,46,60,-14,42
SV Josko Rie,5118,7,10,7,19,41,59,-18,37
Admira Wacke,5118,8,9,9,18,34,63,-29,36
St. Pölten,5118,9,8,11,17,42,63,-21,35
Mattersburg,5118,10,8,10,18,40,56,-16,34
FC Salzburg,5119,1,21,9,6,72,28,44,72
SK Sturm Gra,5119,2,20,5,11,58,33,25,65
SC Rheindorf,5119,3,19,8,9,52,41,11,65
Vienna,5119,4,19,4,13,61,49,12,61
Rapid Vienna,5119,5,13,12,11,57,43,14,51
RZ Pellets W,5119,6,13,7,16,48,63,-15,46
Mattersburg,5119,7,11,7,18,44,58,-14,40
SV Josko Rie,5119,8,11,5,20,34,54,-20,38
Admira Wacke,5119,9,11,5,20,36,63,-27,38
St. Pölten,5119,10,6,10,20,32,62,-30,28
FC Salzburg,5120,1,23,5,8,62,27,35,74
Vienna,5120,2,20,6,10,68,47,21,66
SC Rheindorf,5120,3,19,6,11,53,46,7,63
SK Sturm Gra,5120,4,19,5,12,59,36,23,62
Rapid Vienna,5120,5,15,10,11,58,40,18,55
SV Josko Rie,5120,6,12,5,19,33,48,-15,41
RZ Pellets W,5120,7,10,11,15,38,55,-17,41
St. Pölten,5120,8,8,10,18,45,65,-20,34
Admira Wacke,5120,9,9,7,20,32,61,-29,34
Mattersburg,5120,10,8,9,19,33,56,-23,33
SK Sturm Gra,5121,1,21,8,7,66,36,30,71
SC Rheindorf,5121,2,20,9,7,56,37,19,69
FC Salzburg,5121,3,19,8,9,67,33,34,65
Vienna,5121,4,20,4,12,70,60,10,64
Rapid Vienna,5121,5,14,11,11,65,47,18,53
RZ Pellets W,5121,6,11,9,16,49,57,-8,42
Admira Wacke,5121,7,12,6,18,43,60,-17,42
SV Josko Rie,5121,8,8,10,18,37,59,-22,34
Mattersburg,5121,9,6,12,18,40,68,-28,30
St. Pölten,5121,10,5,11,20,34,70,-36,26
Vienna,5122,1,22,4,10,62,45,17,70
FC Salzburg,5122,2,20,5,11,70,38,32,65
SK Sturm Gra,5122,3,19,5,12,56,32,24,62
SC Rheindorf,5122,4,17,11,8,53,44,9,62
Rapid Vienna,5122,5,15,13,8,59,43,16,58
Admira Wacke,5122,6,14,8,14,43,51,-8,50
St. Pölten,5122,7,8,13,15,47,65,-18,37
RZ Pellets W,5122,8,10,7,19,43,63,-20,37
SV Josko Rie,5122,9,8,7,21,32,57,-25,31
Mattersburg,5122,10,7,7,22,38,65,-27,28
FC Salzburg,5123,1,19,10,7,69,34,35,67
SC Rheindorf,5123,2,18,9,9,52,44,8,63
SK Sturm Gra,5123,3,17,11,8,60,33,27,62
Vienna,5123,4,18,7,11,61,48,13,61
Rapid Vienna,5123,5,13,12,11,52,36,16,51
RZ Pellets W,5123,6,14,7,15,48,55,-7,49
SV Josko Rie,5123,7,11,6,19,40,58,-18,39
Admira Wacke,5123,8,10,8,18,30,57,-27,38
Mattersburg,5123,9,8,12,16,39,54,-15,36
St. Pölten,5123,10,6,10,20,38,70,-32,28
FC Salzburg,5124,1,21,8,7,62,26,36,71
SC Rheindorf,5124,2,20,8,8,55,35,20,68
Vienna,5124,3,19,4,13,63,50,13,61
SK Sturm Gra,5124,4,16,9,11,53,35,18,57
Rapid Vienna,5124,5,14,13,9,61,37,24,55
RZ Pellets W,5124,6,12,5,19,39,59,-20,41
Admira Wacke,5124,7,11,7,18,33,57,-24,40
St. Pölten,5124,8,10,9,17,48,66,-18,39
Mattersburg,5124,9,9,8,19,35,54,-19,35
SV Josko Rie,5124,10,9,7,20,29,59,-30,34
SC Rheindorf,5125,1,21,8,7,53,41,12,71
FC Salzburg,5125,2,19,11,6,58,25,33,68
SK Sturm Gra,5125,3,17,7,12,53,39,14,58
Rapid Vienna,5125,4,14,13,9,55,38,17,55
Vienna,5125,5,17,4,15,56,48,8,55
RZ Pellets W,5125,6,13,10,13,39,48,-9,49
Admira Wacke,5125,7,11,7,18,34,53,-19,40
Mattersburg,5125,8,9,8,19,42,54,-12,35
SV Josko Rie,5125,9,10,5,21,34,53,-19,35
St. Pölten,5125,10,7,11,18,36,61,-25,32
FC Salzburg,5126,1,25,6,5,76,25,51,81
SC Rheindorf,5126,2,21,7,8,60,46,14,70
Vienna,5126,3,19,4,13,65,53,12,61
SK Sturm Gra,5126,4,16,6,14,52,38,14,54
Rapid Vienna,5126,5,10,14,12,52,46,6,44
RZ Pellets W,5126,6,12,8,16,44,53,-9,44
Admira Wacke,5126,7,13,4,19,36,57,-21,43
SV Josko Rie,5126,8,11,6,19,31,51,-20,39
St. Pölten,5126,9,9,8,19,38,63,-25,35
Mattersburg,5126,10,8,9,19,34,56,-22,33
FC Salzburg,5127,1,22,5,9,66,37,29,71
SC Rheindorf,5127,2,20,6,10,54,45,9,66
SK Sturm Gra,5127,3,17,8,11,53,34,19,59
Vienna,5127,4,18,5,13,62,50,12,59
Rapid Vienna,5127,5,14,13,9,56,36,20,55
Admira Wacke,5127,6,13,5,18,39,53,-14,44
RZ Pellets W,5127,7,12,7,17,47,63,-16,43
St. Pölten,5127,8,10,8,18,41,61,-20,38
SV Josko Rie,5127,9,10,6,20,32,54,-22,36
Mattersburg,5127,10,9,7,20,42,59,-17,34
FC Salzburg,5128,1,24,6,6,63,20,43,78
SC Rheindorf,5128,2,20,6,10,57,43,14,66
SK Sturm Gra,5128,3,19,8,9,59,32,27,65
Vienna,5128,4,20,4,12,66,51,15,64
Rapid Vienna,5128,5,14,9,13,53,42,11,51
RZ Pellets W,5128,6,11,7,18,49,61,-12,40
Mattersburg,5128,7,10,10,16,41,57,-16,40
Admira Wacke,5128,8,10,7,19,31,60,-29,37
St. Pölten,5128,9,9,8,19,36,62,-26,35
SV Josko Rie,5128,10,8,5,23,32,59,-27,29
SC Rheindorf,5129,1,19,9,8,54,36,18,66
FC Salzburg,5129,2,16,13,7,61,39,22,61
SK Sturm Gra,5129,3,17,7,12,56,36,20,58
Vienna,5129,4,16,7,13,57,52,5,55
Rapid Vienna,5129,5,13,14,9,59,38,21,53
RZ Pellets W,5129,6,14,6,16,45,55,-10,48
Admira Wacke,5129,7,14,6,16,44,62,-18,48
SV Josko Rie,5129,8,12,6,18,37,54,-17,42
Mattersburg,5129,9,10,8,18,39,53,-14,38
St. Pölten,5129,10,6,10,20,37,64,-27,28
SC Rheindorf,5130,1,21,6,9,56,42,14,69
SK Sturm Gra,5130,2,20,6,10,63,33,30,66
FC Salzburg,5130,3,19,7,10,60,37,23,64
Vienna,5130,4,18,8,10,66,53,13,62
Rapid Vienna,5130,5,13,9,14,50,38,12,48
RZ Pellets W,5130,6,12,10,14,41,49,-8,46
Admira Wacke,5130,7,12,5,19,34,53,-19,41
SV Josko Rie,5130,8,11,6,19,32,50,-18,39
St. Pölten,5130,9,8,10,18,36,59,-23,34
Mattersburg,5130,10,7,11,18,38,62,-24,32
FC Salzburg,5131,1,23,7,6,70,24,46,76
SC Rheindorf,5131,2,20,7,9,56,39,17,67
SK Sturm Gra,5131,3,20,6,10,62,35,27,66
Vienna,5131,4,17,5,14,53,51,2,56
Rapid Vienna,5131,5,13,11,12,53,39,14,50
Admira Wacke,5131,6,13,5,18,42,63,-21,44
RZ Pellets W,5131,7,12,6,18,44,58,-14,42
SV Josko Rie,5131,8,12,4,20,34,53,-19,40
Mattersburg,5131,9,9,7,20,43,66,-23,34
St. Pölten,5131,10,7,10,19,46,75,-29,31
SK Sturm Gra,5132,1,19,9,8,64,29,35,66
FC Salzburg,5132,2,20,6,10,64,32,32,66
Vienna,5132,3,18,8,10,62,48,14,62
SC Rheindorf,5132,4,17,6,13,48,46,2,57
Rapid Vienna,5132,5,14,11,11,56,38,18,53
RZ Pellets W,5132,6,12,9,15,40,50,-10,45
St. Pölten,5132,7,11,10,15,45,64,-19,43
SV Josko Rie,5132,8,13,3,20,35,58,-23,42
Admira Wacke,5132,9,9,9,18,38,64,-26,36
Mattersburg,5132,10,7,9,20,32,55,-23,30
FC Salzburg,5133,1,23,6,7,68,35,33,75
SC Rheindorf,5133,2,20,6,10,55,44,11,66
SK Sturm Gra,5133,3,18,6,12,65,42,23,60
Vienna,5133,4,17,5,14,69,61,8,56
Admira Wacke,5133,5,14,8,14,44,52,-8,50
Rapid Vienna,5133,6,12,12,12,56,44,12,48
St. Pölten,5133,7,10,11,15,48,60,-12,41
RZ Pellets W,5133,8,11,5,20,41,58,-17,38
SV Josko Rie,5133,9,10,7,19,38,63,-25,37
Mattersburg,5133,10,7,10,19,35,60,-25,31
Vienna,5134,1,22,3,11,72,55,17,69
SC Rheindorf,5134,2,20,7,9,65,43,22,67
FC Salzburg,5134,3,20,5,11,60,36,24,65
SK Sturm Gra,5134,4,19,7,10,62,37,25,64
Rapid Vienna,5134,5,14,10,12,59,42,17,52
RZ Pellets W,5134,6,12,7,17,49,60,-11,43
Admira Wacke,5134,7,12,5,19,34,64,-30,41
SV Josko Rie,5134,8,11,4,21,39,58,-19,37
St. Pölten,5134,9,9,9,18,46,70,-24,36
Mattersburg,5134,10,6,13,17,41,62,-21,31
SC Rheindorf,5135,1,21,7,8,54,42,12,70
FC Salzburg,5135,2,20,7,9,69,36,33,67
Vienna,5135,3,21,4,11,67,46,21,67
SK Sturm Gra,5135,4,19,6,11,56,38,18,63
Rapid Vienna,5135,5,14,11,11,51,36,15,53
RZ Pellets W,5135,6,14,5,17,50,59,-9,47
SV Josko Rie,5135,7,13,5,18,40,52,-12,44
Mattersburg,5135,8,8,12,16,38,54,-16,36
Admira Wacke,5135,9,8,6,22,31,67,-36,30
St. Pölten,5135,10,5,11,20,36,62,-26,26
FC Salzburg,5136,1,19,9,8,66,37,29,66
Rapid Vienna,5136,2,18,10,8,62,35,27,64
SC Rheindorf,5136,3,18,8,10,52,40,12,62
SK Sturm Gra,5136,4,17,10,9,55,30,25,61
Vienna,5136,5,18,6,12,60,51,9,60
RZ Pellets W,5136,6,12,7,17,47,56,-9,43
Admira Wacke,5136,7,10,10,16,34,52,-18,40
St. Pölten,5136,8,9,12,15,41,62,-21,39
Mattersburg,5136,9,8,8,20,33,61,-28,32
SV Josko Rie,5136,10,8,6,22,30,56,-26,30
FC Salzburg,5137,1,22,7,7,61,28,33,73
SC Rheindorf,5137,2,20,6,10,58,40,18,66
Rapid Vienna,5137,3,17,10,9,59,36,23,61
SK Sturm Gra,5137,4,17,10,9,55,32,23,61
Vienna,5137,5,17,4,15,53,55,-2,55
SV Josko Rie,5137,6,14,3,19,38,50,-12,45
Admira Wacke,5137,7,12,7,17,39,53,-14,43
St. Pölten,5137,8,10,10,16,43,61,-18,40
RZ Pellets W,5137,9,10,5,21,41,60,-19,35
Mattersburg,5137,10,7,6,23,34,66,-32,27
FC Salzburg,5138,1,22,7,7,69,27,42,73
SC Rheindorf,5138,2,21,5,10,63,46,17,68
Rapid Vienna,5138,3,19,8,9,67,37,30,65
Vienna,5138,4,18,8,10,64,52,12,62
SK Sturm Gra,5138,5,17,7,12,55,40,15,58
Admira Wacke,5138,6,12,6,18,39,61,-22,42
RZ Pellets W,5138,7,11,7,18,39,56,-17,40
St. Pölten,5138,8,8,12,16,45,59,-14,36
SV Josko Rie,5138,9,8,8,20,34,67,-33,32
Mattersburg,5138,10,5,10,21,34,64,-30,25
FC Salzburg,5139,1,22,8,6,63,27,36,74
SC Rheindorf,5139,2,22,8,6,60,34,26,74
SK Sturm Gra,5139,3,16,7,13,49,32,17,55
Vienna,5139,4,16,7,13,59,52,7,55
Rapid Vienna,5139,5,13,10,13,51,43,8,49
RZ Pellets W,5139,6,13,9,14,49,55,-6,48
SV Josko Rie,5139,7,12,5,19,34,50,-16,41
St. Pölten,5139,8,10,9,17,38,56,-18,39
Admira Wacke,5139,9,11,5,20,38,65,-27,38
Mattersburg,5139,10,7,8,21,33,60,-27,29
FC Salzburg,5140,1,20,9,7,62,27,35,69
SC Rheindorf,5140,2,19,10,7,61,42,19,67
Vienna,5140,3,17,7,12,65,58,7,58
Rapid Vienna,5140,4,15,10,11,55,43,12,55
SK Sturm Gra,5140,5,15,9,12,53,38,15,54
RZ Pellets W,5140,6,13,8,15,50,57,-7,47
SV Josko Rie,5140,7,12,4,20,37,53,-16,40
Admira Wacke,5140,8,10,7,19,34,60,-26,37
St. Pölten,5140,9,9,9,18,46,68,-22,36
Mattersburg,5140,10,8,11,17,34,51,-17,35
FC Salzburg,5141,1,20,9,7,67,30,37,69
Vienna,5141,2,19,7,10,61,49,12,64
SK Sturm Gra,5141,3,17,8,11,59,35,24,59
SC Rheindorf,5141,4,18,5,13,50,46,4,59
Admira Wacke,5141,5,13,9,14,39,53,-14,48
Rapid Vienna,5141,6,11,11,14,56,49,7,44
St. Pölten,5141,7,11,11,14,43,56,-13,44
SV Josko Rie,5141,8,13,5,18,40,53,-13,44
RZ Pellets W,5141,9,10,8,18,42,57,-15,38
Mattersburg,5141,10,6,11,19,29,58,-29,29
SC Rheindorf,5142,1,24,7,5,65,35,30,79
FC Salzburg,5142,2,20,8,8,62,30,32,68
SK Sturm Gra,5142,3,18,7,11,59,39,20,61
Vienna,5142,4,17,5,14,58,52,6,56
Admira Wacke,5142,5,15,7,14,38,49,-11,52
Rapid Vienna,5142,6,13,12,11,56,40,16,51
RZ Pellets W,5142,7,10,9,17,45,61,-16,39
St. Pölten,5142,8,7,13,16,42,67,-25,34
SV Josko Rie,5142,9,7,8,21,30,58,-28,29
Mattersburg,5142,10,6,10,20,39,63,-24,28
FC Salzburg,5143,1,24,8,4,78,31,47,80
SK Sturm Gra,5143,2,18,10,8,62,33,29,64
SC Rheindorf,5143,3,17,9,10,56,48,8,60
Vienna,5143,4,18,5,13,64,59,5,59
Rapid Vienna,5143,5,10,15,11,52,44,8,45
RZ Pellets W,5143,6,12,9,15,47,59,-12,45
Admira Wacke,5143,7,12,7,17,47,62,-15,43
St. Pölten,5143,8,8,11,17,40,63,-23,35
SV Josko Rie,5143,9,10,4,22,34,54,-20,34
Mattersburg,5143,10,8,8,20,33,60,-27,32
SC Rheindorf,5144,1,22,6,8,62,39,23,72
SK Sturm Gra,5144,2,20,7,9,57,28,29,67
FC Salzburg,5144,3,21,4,11,62,34,28,67
Vienna,5144,4,17,7,12,62,51,11,58
Rapid Vienna,5144,5,14,10,12,54,44,10,52
RZ Pellets W,5144,6,12,8,16,38,51,-13,44
SV Josko Rie,5144,7,13,3,20,38,53,-15,42
Mattersburg,5144,8,9,9,18,39,61,-22,36
St. Pölten,5144,9,9,8,19,45,68,-23,35
Admira Wacke,5144,10,10,4,22,34,62,-28,34
FC Salzburg,5145,1,21,6,9,60,28,32,69
SK Sturm Gra,5145,2,21,6,9,58,26,32,69
SC Rheindorf,5145,3,21,6,9,53,39,14,69
Vienna,5145,4,18,4,14,58,52,6,58
Rapid Vienna,5145,5,15,8,13,59,41,18,53
SV Josko Rie,5145,6,12,6,18,33,47,-14,42
RZ Pellets W,5145,7,11,8,17,44,60,-16,41
Admira Wacke,5145,8,10,7,19,33,62,-29,37
St. Pölten,5145,9,8,10,18,45,68,-23,34
Mattersburg,5145,10,7,11,18,32,52,-20,32
SK Sturm Gra,5146,1,21,7,8,59,27,32,70
FC Salzburg,5146,2,20,6,10,61,27,34,66
Vienna,5146,3,20,6,10,69,45,24,66
SC Rheindorf,5146,4,18,5,13,52,47,5,59
Rapid Vienna,5146,5,16,10,10,59,34,25,58
RZ Pellets W,5146,6,12,7,17,43,62,-19,43
SV Josko Rie,5146,7,12,5,19,34,52,-18,41
Admira Wacke,5146,8,12,3,21,35,66,-31,39
St. Pölten,5146,9,9,11,16,42,60,-18,38
Mattersburg,5146,10,6,8,22,30,64,-34,26
FC Salzburg,5147,1,22,8,6,71,30,41,74
Vienna,5147,2,21,5,10,59,42,17,68
SK Sturm Gra,5147,3,18,9,9,64,39,25,63
SC Rheindorf,5147,4,16,10,10,51,46,5,58
Rapid Vienna,5147,5,11,14,11,54,48,6,47
Admira Wacke,5147,6,13,8,15,40,55,-15,47
RZ Pellets W,5147,7,10,11,15,50,59,-9,41
Mattersburg,5147,8,9,10,17,39,57,-18,37
SV Josko Rie,5147,9,8,6,22,36,60,-24,30
St. Pölten,5147,10,7,9,20,44,72,-28,30
FC Salzburg,5148,1,20,10,6,69,34,35,70
Vienna,5148,2,21,7,8,69,47,22,70
SK Sturm Gra,5148,3,19,9,8,60,34,26,66
SC Rheindorf,5148,4,16,9,11,54,54,0,57
Rapid Vienna,5148,5,14,12,10,55,37,18,54
SV Josko Rie,5148,6,14,5,17,36,45,-9,47
RZ Pellets W,5148,7,13,6,17,49,57,-8,45
St. Pölten,5148,8,8,9,19,51,74,-23,33
Admira Wacke,5148,9,8,5,23,30,67,-37,29
Mattersburg,5148,10,6,10,20,38,62,-24,28
SK Sturm Gra,5149,1,23,5,8,64,30,34,74
Vienna,5149,2,23,5,8,73,40,33,74
FC Salzburg,5149,3,22,5,9,73,38,35,71
SC Rheindorf,5149,4,17,7,12,53,45,8,58
Rapid Vienna,5149,5,12,10,14,57,55,2,46
Admira Wacke,5149,6,14,4,18,44,54,-10,46
RZ Pellets W,5149,7,12,4,20,48,68,-20,40
Mattersburg,5149,8,9,7,20,39,61,-22,34
St. Pölten,5149,9,8,9,19,40,70,-30,33
SV Josko Rie,5149,10,9,6,21,38,68,-30,33
FC Salzburg,5150,1,22,6,8,67,28,39,72
SK Sturm Gra,5150,2,22,5,9,63,31,32,71
SC Rheindorf,5150,3,18,6,12,59,51,8,60
Vienna,5150,4,18,5,13,66,64,2,59
Rapid Vienna,5150,5,16,8,12,64,42,22,56
SV Josko Rie,5150,6,13,6,17,34,51,-17,45
RZ Pellets W,5150,7,11,9,16,45,60,-15,42
Admira Wacke,5150,8,9,9,18,44,67,-23,36
St. Pölten,5150,9,8,9,19,43,67,-24,33
Mattersburg,5150,10,8,7,21,37,61,-24,31
FC Salzburg,5151,1,21,5,10,73,36,37,68
SC Rheindorf,5151,2,17,12,7,54,40,14,63
SK Sturm Gra,5151,3,18,7,11,53,36,17,61
Vienna,5151,4,17,7,12,58,48,10,58
Rapid Vienna,5151,5,16,9,11,58,42,16,57
RZ Pellets W,5151,6,16,8,12,50,51,-1,56
SV Josko Rie,5151,7,10,9,17,38,51,-13,39
St. Pölten,5151,8,7,12,17,38,68,-30,33
Admira Wacke,5151,9,8,8,20,33,60,-27,32
Mattersburg,5151,10,6,11,19,37,60,-23,29
SC Rheindorf,5152,1,21,6,9,56,39,17,69
SK Sturm Gra,5152,2,21,5,10,58,32,26,68
FC Salzburg,5152,3,19,9,8,63,32,31,66
Vienna,5152,4,17,8,11,55,47,8,59
Rapid Vienna,5152,5,10,12,14,42,39,3,42
Admira Wacke,5152,6,11,8,17,33,53,-20,41
RZ Pellets W,5152,7,10,10,16,42,58,-16,40
Mattersburg,5152,8,10,9,17,37,53,-16,39
SV Josko Rie,5152,9,10,8,18,29,47,-18,38
St. Pölten,5152,10,9,9,18,48,63,-15,36
FC Salzburg,5153,1,21,9,6,66,25,41,72
SK Sturm Gra,5153,2,21,8,7,61,32,29,71
Vienna,5153,3,21,4,11,65,48,17,67
SC Rheindorf,5153,4,16,12,8,48,39,9,60
RZ Pellets W,5153,5,12,8,16,40,58,-18,44
Rapid Vienna,5153,6,9,13,14,46,45,1,40
SV Josko Rie,5153,7,10,8,18,34,50,-16,38
St. Pölten,5153,8,8,12,16,41,57,-16,36
Admira Wacke,5153,9,10,6,20,39,62,-23,36
Mattersburg,5153,10,7,10,19,37,61,-24,31
FC Salzburg,5154,1,21,7,8,60,30,30,70
SC Rheindorf,5154,2,20,6,10,61,40,21,66
SK Sturm Gra,5154,3,19,5,12,58,28,30,62
Vienna,5154,4,16,5,15,54,55,-1,53
RZ Pellets W,5154,5,14,9,13,48,53,-5,51
Rapid Vienna,5154,6,12,13,11,57,43,14,49
Admira Wacke,5154,7,13,5,18,36,64,-28,44
SV Josko Rie,5154,8,10,8,18,30,49,-19,38
St. Pölten,5154,9,9,8,19,40,63,-23,35
Mattersburg,5154,10,8,10,18,37,56,-19,34
SK Sturm Gra,5155,1,20,7,9,63,36,27,67
SC Rheindorf,5155,2,18,9,9,50,42,8,63
FC Salzburg,5155,3,18,8,10,57,35,22,62
Vienna,5155,4,19,5,12,71,54,17,62
Rapid Vienna,5155,5,14,11,11,53,40,13,53
Admira Wacke,5155,6,12,7,17,33,53,-20,43
RZ Pellets W,5155,7,12,6,18,45,63,-18,42
SV Josko Rie,5155,8,12,5,19,37,51,-14,41
Mattersburg,5155,9,9,10,17,39,49,-10,37
St. Pölten,5155,10,7,10,19,41,66,-25,31
FC Salzburg,5156,1,19,8,9,67,33,34,65
SK Sturm Gra,5156,2,20,5,11,66,40,26,65
SC Rheindorf,5156,3,18,10,8,58,40,18,64
Vienna,5156,4,18,4,14,64,65,-1,58
Rapid Vienna,5156,5,13,10,13,62,48,14,49
RZ Pellets W,5156,6,13,9,14,50,56,-6,48
Admira Wacke,5156,7,11,10,15,43,58,-15,43
Mattersburg,5156,8,10,7,19,42,62,-20,37
St. Pölten,5156,9,9,10,17,41,66,-25,37
SV Josko Rie,5156,10,9,7,20,30,55,-25,34
SK Sturm Gra,5157,1,21,6,9,70,32,38,69
FC Salzburg,5157,2,18,12,6,62,29,33,66
SC Rheindorf,5157,3,19,9,8,48,35,13,66
Vienna,5157,4,18,4,14,57,54,3,58
Rapid Vienna,5157,5,13,12,11,64,50,14,51
RZ Pellets W,5157,6,12,8,16,54,63,-9,44
SV Josko Rie,5157,7,11,5,20,42,62,-20,38
St. Pölten,5157,8,9,10,17,46,63,-17,37
Mattersburg,5157,9,10,7,19,38,60,-22,37
Admira Wacke,5157,10,10,5,21,38,71,-33,35
FC Salzburg,5158,1,19,8,9,63,37,26,65
SK Sturm Gra,5158,2,17,10,9,62,41,21,61
Rapid Vienna,5158,3,15,13,8,75,46,29,58
Vienna,5158,4,18,4,14,60,52,8,58
SC Rheindorf,5158,5,17,7,12,56,53,3,58
RZ Pellets W,5158,6,14,9,13,50,54,-4,51
Mattersburg,5158,7,9,11,16,47,57,-10,38
SV Josko Rie,5158,8,10,7,19,39,63,-24,37
Admira Wacke,5158,9,9,9,18,47,70,-23,36
St. Pölten,5158,10,9,8,19,42,68,-26,35
SK Sturm Gra,5159,1,22,7,7,64,29,35,73
FC Salzburg,5159,2,18,11,7,72,38,34,65
SC Rheindorf,5159,3,18,9,9,56,40,16,63
Vienna,5159,4,17,9,10,61,49,12,60
Rapid Vienna,5159,5,15,9,12,58,40,18,54
RZ Pellets W,5159,6,9,13,14,45,58,-13,40
Admira Wacke,5159,7,10,7,19,40,64,-24,37
St. Pölten,5159,8,7,13,16,38,56,-18,34
Mattersburg,5159,9,8,10,18,33,58,-25,34
SV Josko Rie,5159,10,9,6,21,27,62,-35,33
FC Salzburg,5160,1,19,9,8,61,37,24,66
SC Rheindorf,5160,2,18,11,7,54,40,14,65
SK Sturm Gra,5160,3,16,9,11,59,35,24,57
Vienna,5160,4,16,9,11,61,52,9,57
Rapid Vienna,5160,5,13,12,11,56,42,14,51
RZ Pellets W,5160,6,13,7,16,45,52,-7,46
Admira Wacke,5160,7,11,9,16,42,55,-13,42
Mattersburg,5160,8,11,7,18,41,62,-21,40
St. Pölten,5160,9,9,9,18,42,64,-22,36
SV Josko Rie,5160,10,9,8,19,32,54,-22,35
FC Salzburg,5161,1,22,6,8,63,32,31,72
SC Rheindorf,5161,2,20,8,8,54,40,14,68
SK Sturm Gra,5161,3,19,5,12,70,40,30,62
Vienna,5161,4,18,6,12,68,56,12,60
Rapid Vienna,5161,5,14,10,12,58,50,8,52
Admira Wacke,5161,6,14,5,17,40,64,-24,47
RZ Pellets W,5161,7,13,7,16,46,51,-5,46
SV Josko Rie,5161,8,10,5,21,38,57,-19,35
St. Pölten,5161,9,9,7,20,46,68,-22,34
Mattersburg,5161,10,8,7,21,36,61,-25,31
FC Salzburg,5162,1,22,7,7,72,29,43,73
SK Sturm Gra,5162,2,21,6,9,58,32,26,69
SC Rheindorf,5162,3,21,5,10,60,39,21,68
Vienna,5162,4,19,5,12,63,53,10,62
Rapid Vienna,5162,5,13,10,13,60,46,14,49
RZ Pellets W,5162,6,14,6,16,51,54,-3,48
Admira Wacke,5162,7,12,7,17,41,66,-25,43
SV Josko Rie,5162,8,10,5,21,32,53,-21,35
Mattersburg,5162,9,8,7,21,35,69,-34,31
St. Pölten,5162,10,7,8,21,37,68,-31,29
FC Salzburg,5163,1,22,8,6,62,24,38,74
SK Sturm Gra,5163,2,19,7,10,55,34,21,64
Vienna,5163,3,18,7,11,62,47,15,61
SC Rheindorf,5163,4,18,7,11,52,41,11,61
Rapid Vienna,5163,5,14,11,11,52,38,14,53
St. Pölten,5163,6,9,12,15,50,64,-14,39
Admira Wacke,5163,7,11,6,19,38,60,-22,39
Mattersburg,5163,8,9,11,16,37,52,-15,38
RZ Pellets W,5163,9,9,9,18,42,61,-19,36
SV Josko Rie,5163,10,7,10,19,34,63,-29,31
FC Salzburg,5164,1,23,5,8,65,30,35,74
Vienna,5164,2,20,5,11,66,48,18,65
SC Rheindorf,5164,3,19,8,9,59,52,7,65
SK Sturm Gra,5164,4,16,8,12,53,34,19,56
RZ Pellets W,5164,5,13,9,14,40,50,-10,48
Rapid Vienna,5164,6,11,12,13,49,42,7,45
Admira Wacke,5164,7,11,7,18,36,57,-21,40
St. Pölten,5164,8,9,11,16,41,60,-19,38
Mattersburg,5164,9,9,9,18,41,55,-14,36
SV Josko Rie,5164,10,10,4,22,35,57,-22,34
FC Salzburg,5165,1,21,7,8,68,35,33,70
SC Rheindorf,5165,2,19,8,9,60,47,13,65
Vienna,5165,3,19,5,12,72,52,20,62
SK Sturm Gra,5165,4,17,10,9,54,31,23,61
Rapid Vienna,5165,5,15,11,10,58,42,16,56
Admira Wacke,5165,6,13,8,15,41,52,-11,47
RZ Pellets W,5165,7,12,7,17,52,63,-11,43
Mattersburg,5165,8,9,8,19,38,62,-24,35
SV Josko Rie,5165,9,9,7,20,32,60,-28,34
St. Pölten,5165,10,6,9,21,33,64,-31,27
SK Sturm Gra,5166,1,21,6,9,59,27,32,69
Vienna,5166,2,21,4,11,73,48,25,67
FC Salzburg,5166,3,18,11,7,65,34,31,65
SC Rheindorf,5166,4,16,7,13,57,59,-2,55
Rapid Vienna,5166,5,15,8,13,58,44,14,53
SV Josko Rie,5166,6,14,4,18,39,54,-15,46
Admira Wacke,5166,7,12,4,20,35,59,-24,40
RZ Pellets W,5166,8,10,9,17,46,65,-19,39
St. Pölten,5166,9,10,8,18,42,64,-22,38
Mattersburg,5166,10,8,9,19,37,57,-20,33
FC Salzburg,5167,1,24,6,6,79,29,50,78
SC Rheindorf,5167,2,20,8,8,61,43,18,68
SK Sturm Gra,5167,3,17,10,9,57,32,25,61
Vienna,5167,4,16,4,16,59,57,2,52
Rapid Vienna,5167,5,12,14,10,56,46,10,50
RZ Pellets W,5167,6,11,9,16,40,55,-15,42
St. Pölten,5167,7,10,10,16,43,60,-17,40
Admira Wacke,5167,8,11,6,19,38,61,-23,39
Mattersburg,5167,9,8,11,17,42,63,-21,35
SV Josko Rie,5167,10,8,8,20,28,57,-29,32
SC Rheindorf,5168,1,22,6,8,66,41,25,72
SK Sturm Gra,5168,2,21,6,9,59,37,22,69
FC Salzburg,5168,3,20,8,8,66,30,36,68
Vienna,5168,4,18,9,9,64,49,15,63
Rapid Vienna,5168,5,13,11,12,62,48,14,50
Admira Wacke,5168,6,11,9,16,42,56,-14,42
RZ Pellets W,5168,7,11,8,17,43,62,-19,41
St. Pölten,5168,8,10,9,17,49,65,-16,39
SV Josko Rie,5168,9,8,8,20,32,59,-27,32
Mattersburg,5168,10,5,8,23,29,65,-36,23
Vienna,5169,1,21,7,8,64,45,19,70
FC Salzburg,5169,2,19,11,6,65,32,33,68
SC Rheindorf,5169,3,19,9,8,57,41,16,66
SK Sturm Gra,5169,4,17,5,14,54,38,16,56
Rapid Vienna,5169,5,16,7,13,63,45,18,55
RZ Pellets W,5169,6,13,7,16,43,51,-8,46
St. Pölten,5169,7,10,7,19,36,60,-24,37
Admira Wacke,5169,8,10,7,19,32,59,-27,37
SV Josko Rie,5169,9,9,7,20,36,59,-23,34
Mattersburg,5169,10,7,11,18,34,54,-20,32
FC Salzburg,5170,1,22,6,8,69,30,39,72
SC Rheindorf,5170,2,20,9,7,55,40,15,69
SK Sturm Gra,5170,3,18,5,13,53,36,17,59
Vienna,5170,4,17,6,13,60,52,8,57
Rapid Vienna,5170,5,13,12,11,56,47,9,51
Admira Wacke,5170,6,13,8,15,41,51,-10,47
RZ Pellets W,5170,7,11,7,18,46,63,-17,40
St. Pölten,5170,8,9,11,16,38,57,-19,38
Mattersburg,5170,9,7,12,17,36,55,-19,33
SV Josko Rie,5170,10,8,8,20,31,54,-23,32
FC Salzburg,5171,1,22,7,7,71,31,40,73
SK Sturm Gra,5171,2,21,7,8,66,35,31,70
SC Rheindorf,5171,3,20,8,8,66,46,20,68
Vienna,5171,4,16,3,17,51,59,-8,51
Rapid Vienna,5171,5,12,12,12,49,40,9,48
Admira Wacke,5171,6,13,6,17,35,55,-20,45
RZ Pellets W,5171,7,12,5,19,46,59,-13,41
SV Josko Rie,5171,8,11,7,18,40,54,-14,40
Mattersburg,5171,9,10,9,17,33,46,-13,39
St. Pölten,5171,10,7,8,21,34,66,-32,29
FC Salzburg,5172,1,21,8,7,73,31,42,71
SC Rheindorf,5172,2,21,7,8,60,40,20,70
Vienna,5172,3,19,5,12,60,50,10,62
SK Sturm Gra,5172,4,17,5,14,59,41,18,56
Rapid Vienna,5172,5,12,12,12,53,47,6,48
RZ Pellets W,5172,6,13,8,15,47,54,-7,47
St. Pölten,5172,7,11,9,16,49,67,-18,42
Admira Wacke,5172,8,10,9,17,39,61,-22,39
Mattersburg,5172,9,9,7,20,37,63,-26,34
SV Josko Rie,5172,10,9,6,21,35,58,-23,33
FC Salzburg,5173,1,21,9,6,65,26,39,72
SC Rheindorf,5173,2,19,8,9,53,38,15,65
Vienna,5173,3,19,6,11,61,48,13,63
SK Sturm Gra,5173,4,19,4,13,58,39,19,61
SV Josko Rie,5173,5,14,4,18,38,48,-10,46
Rapid Vienna,5173,6,12,9,15,60,57,3,45
RZ Pellets W,5173,7,11,9,16,42,58,-16,42
Admira Wacke,5173,8,11,7,18,38,62,-24,40
Mattersburg,5173,9,9,8,19,40,56,-16,35
St. Pölten,5173,10,9,8,19,40,63,-23,35
FC Salzburg,5174,1,22,6,8,69,29,40,72
SK Sturm Gra,5174,2,17,9,10,57,36,21,60
Vienna,5174,3,17,6,13,58,54,4,57
SC Rheindorf,5174,4,17,6,13,49,48,1,57
Rapid Vienna,5174,5,13,10,13,55,50,5,49
RZ Pellets W,5174,6,13,7,16,47,60,-13,46
St. Pölten,5174,7,12,8,16,50,59,-9,44
Admira Wacke,5174,8,12,7,17,39,58,-19,43
Mattersburg,5174,9,10,9,17,39,49,-10,39
SV Josko Rie,5174,10,11,4,21,32,52,-20,37
FC Salzburg,5175,1,19,9,8,71,36,35,66
SC Rheindorf,5175,2,19,5,12,57,41,16,62
SK Sturm Gra,5175,3,17,4,15,59,44,15,55
Vienna,5175,4,17,4,15,60,56,4,55
Rapid Vienna,5175,5,14,11,11,54,44,10,53
RZ Pellets W,5175,6,14,7,15,55,55,0,49
Admira Wacke,5175,7,14,6,16,43,63,-20,48
SV Josko Rie,5175,8,13,3,20,37,60,-23,42
Mattersburg,5175,9,11,7,18,45,58,-13,40
St. Pölten,5175,10,9,10,17,41,65,-24,37
SK Sturm Gra,5176,1,21,5,10,63,40,23,68
FC Salzburg,5176,2,19,10,7,68,33,35,67
Vienna,5176,3,21,3,12,71,58,13,66
SC Rheindorf,5176,4,19,8,9,55,45,10,65
Rapid Vienna,5176,5,14,9,13,56,43,13,51
Admira Wacke,5176,6,12,6,18,40,60,-20,42
RZ Pellets W,5176,7,11,7,18,45,61,-16,40
St. Pölten,5176,8,10,9,17,41,59,-18,39
SV Josko Rie,5176,9,10,6,20,35,54,-19,36
Mattersburg,5176,10,8,7,21,38,59,-21,31
SC Rheindorf,5177,1,21,9,6,69,39,30,72
FC Salzburg,5177,2,19,10,7,65,31,34,67
SK Sturm Gra,5177,3,18,10,8,56,26,30,64
Vienna,5177,4,16,7,13,58,55,3,55
RZ Pellets W,5177,5,16,6,14,51,52,-1,54
Rapid Vienna,5177,6,14,8,14,60,43,17,50
Mattersburg,5177,7,12,7,17,39,60,-21,43
SV Josko Rie,5177,8,10,9,17,38,51,-13,39
Admira Wacke,5177,9,7,7,22,26,68,-42,28
St. Pölten,5177,10,4,13,19,33,70,-37,25
FC Salzburg,5178,1,22,6,8,71,35,36,72
Vienna,5178,2,22,3,11,64,39,25,69
SC Rheindorf,5178,3,20,7,9,54,39,15,67
SK Sturm Gra,5178,4,16,7,13,50,36,14,55
Rapid Vienna,5178,5,13,10,13,62,46,16,49
Admira Wacke,5178,6,14,6,16,36,53,-17,48
SV Josko Rie,5178,7,13,3,20,32,47,-15,42
St. Pölten,5178,8,9,11,16,40,65,-25,38
RZ Pellets W,5178,9,8,8,20,40,62,-22,32
Mattersburg,5178,10,7,11,18,38,65,-27,32
FC Salzburg,5179,1,22,6,8,78,29,49,72
SC Rheindorf,5179,2,20,8,8,61,43,18,68
Vienna,5179,3,18,5,13,59,55,4,59
SK Sturm Gra,5179,4,17,7,12,54,40,14,58
Rapid Vienna,5179,5,14,13,9,56,38,18,55
RZ Pellets W,5179,6,12,7,17,45,56,-11,43
Admira Wacke,5179,7,11,7,18,34,65,-31,40
SV Josko Rie,5179,8,10,7,19,36,55,-19,37
Mattersburg,5179,9,9,8,19,38,57,-19,35
St. Pölten,5179,10,8,10,18,37,60,-23,34
SK Sturm Gra,5180,1,22,5,9,63,38,25,71
SC Rheindorf,5180,2,19,9,8,61,44,17,66
Vienna,5180,3,20,5,11,65,51,14,65
FC Salzburg,5180,4,19,7,10,56,28,28,64
Rapid Vienna,5180,5,12,11,13,49,38,11,47
SV Josko Rie,5180,6,12,5,19,38,55,-17,41
Mattersburg,5180,7,9,12,15,35,50,-15,39
RZ Pellets W,5180,8,10,8,18,44,57,-13,38
St. Pölten,5180,9,9,9,18,41,59,-18,36
Admira Wacke,5180,10,10,5,21,34,66,-32,35
FC Salzburg,5181,1,25,5,6,69,25,44,80
SK Sturm Gra,5181,2,22,5,9,66,32,34,71
Vienna,5181,3,18,5,13,66,53,13,59
SC Rheindorf,5181,4,16,10,10,50,44,6,58
Rapid Vienna,5181,5,13,11,12,51,45,6,50
RZ Pellets W,5181,6,11,9,16,43,58,-15,42
SV Josko Rie,5181,7,12,5,19,34,48,-14,41
St. Pölten,5181,8,8,11,17,42,63,-21,35
Admira Wacke,5181,9,9,6,21,37,65,-28,33
Mattersburg,5181,10,6,13,17,40,65,-25,31
FC Salzburg,5182,1,21,8,7,65,33,32,71
SC Rheindorf,5182,2,19,10,7,50,37,13,67
SK Sturm Gra,5182,3,19,8,9,64,36,28,65
Vienna,5182,4,18,4,14,62,53,9,58
Rapid Vienna,5182,5,15,12,9,63,43,20,57
SV Josko Rie,5182,6,12,6,18,38,50,-12,42
RZ Pellets W,5182,7,10,8,18,46,62,-16,38
St. Pölten,5182,8,9,9,18,43,66,-23,36
Mattersburg,5182,9,8,9,19,40,61,-21,33
Admira Wacke,5182,10,9,6,21,28,58,-30,33
SC Rheindorf,5183,1,22,7,7,57,35,22,73
SK Sturm Gra,5183,2,22,5,9,61,27,34,71
FC Salzburg,5183,3,19,7,10,62,32,30,64
Rapid Vienna,5183,4,16,11,9,59,43,16,59
Vienna,5183,5,16,8,12,61,51,10,56
SV Josko Rie,5183,6,15,2,19,37,50,-13,47
Admira Wacke,5183,7,12,5,19,37,63,-26,41
RZ Pellets W,5183,8,10,8,18,48,62,-14,38
St. Pölten,5183,9,7,9,20,36,69,-33,30
Mattersburg,5183,10,5,10,21,32,58,-26,25
FC Salzburg,5184,1,22,6,8,69,31,38,72
SC Rheindorf,5184,2,19,8,9,59,48,11,65
Vienna,5184,3,19,7,10,71,54,17,64
SK Sturm Gra,5184,4,18,6,12,62,36,26,60
Rapid Vienna,5184,5,15,8,13,59,44,15,53
RZ Pellets W,5184,6,12,11,13,48,54,-6,47
Admira Wacke,5184,7,11,6,19,38,63,-25,39
Mattersburg,5184,8,8,11,17,37,57,-20,35
SV Josko Rie,5184,9,9,8,19,32,56,-24,35
St. Pölten,5184,10,6,11,19,39,71,-32,29
FC Salzburg,5185,1,20,12,4,65,26,39,72
SC Rheindorf,5185,2,18,9,9,56,41,15,63
SK Sturm Gra,5185,3,16,7,13,53,41,12,55
Vienna,5185,4,14,8,14,56,59,-3,50
Mattersburg,5185,5,13,7,16,45,51,-6,46
Rapid Vienna,5185,6,11,11,14,56,44,12,44
RZ Pellets W,5185,7,12,8,16,51,61,-10,44
SV Josko Rie,5185,8,12,6,18,36,49,-13,42
St. Pölten,5185,9,11,9,16,42,62,-20,42
Admira Wacke,5185,10,12,5,19,33,59,-26,41
FC Salzburg,5186,1,17,13,6,56,28,28,64
SC Rheindorf,5186,2,19,7,10,56,41,15,64
Vienna,5186,3,20,3,13,62,54,8,63
SK Sturm Gra,5186,4,18,8,10,60,39,21,62
Rapid Vienna,5186,5,16,12,8,60,35,25,60
RZ Pellets W,5186,6,15,6,15,48,54,-6,51
Mattersburg,5186,7,9,9,18,41,54,-13,36
Admira Wacke,5186,8,8,11,17,34,57,-23,35
St. Pölten,5186,9,9,7,20,41,66,-25,34
SV Josko Rie,5186,10,9,4,23,27,57,-30,31
FC Salzburg,5187,1,24,5,7,73,28,45,77
SK Sturm Gra,5187,2,23,6,7,64,25,39,75
SC Rheindorf,5187,3,19,8,9,61,45,16,65
Rapid Vienna,5187,4,16,9,11,61,43,18,57
Vienna,5187,5,18,3,15,57,53,4,57
RZ Pellets W,5187,6,14,5,17,43,57,-14,47
Admira Wacke,5187,7,11,5,20,33,64,-31,38
St. Pölten,5187,8,8,10,18,38,61,-23,34
SV Josko Rie,5187,9,10,4,22,32,56,-24,34
Mattersburg,5187,10,7,5,24,33,63,-30,26
FC Salzburg,5188,1,20,7,9,63,32,31,67
Vienna,5188,2,19,7,10,61,49,12,64
SK Sturm Gra,5188,3,18,6,12,61,42,19,60
SC Rheindorf,5188,4,17,8,11,54,53,1,59
Rapid Vienna,5188,5,12,12,12,54,46,8,48
Admira Wacke,5188,6,13,7,16,44,62,-18,46
RZ Pellets W,5188,7,12,9,15,44,49,-5,45
Mattersburg,5188,8,10,9,17,48,63,-15,39
SV Josko Rie,5188,9,11,5,20,40,54,-14,38
St. Pölten,5188,10,8,10,18,44,63,-19,34
FC Salzburg,5189,1,23,8,5,74,32,42,77
SC Rheindorf,5189,2,19,9,8,55,39,16,66
SK Sturm Gra,5189,3,18,8,10,59,33,26,62
Vienna,5189,4,16,8,12,63,55,8,56
Rapid Vienna,5189,5,16,7,13,59,44,15,55
RZ Pellets W,5189,6,13,6,17,42,57,-15,45
SV Josko Rie,5189,7,11,7,18,37,52,-15,40
St. Pölten,5189,8,10,8,18,38,61,-23,38
Admira Wacke,5189,9,10,6,20,36,65,-29,36
Mattersburg,5189,10,7,7,22,35,60,-25,28
SC Rheindorf,5190,1,22,8,6,59,32,27,74
SK Sturm Gra,5190,2,19,8,9,66,41,25,65
FC Salzburg,5190,3,18,8,10,62,37,25,62
Vienna,5190,4,15,10,11,60,53,7,55
Rapid Vienna,5190,5,13,10,13,54,44,10,49
SV Josko Rie,5190,6,13,6,17,38,51,-13,45
RZ Pellets W,5190,7,11,8,17,45,61,-16,41
Admira Wacke,5190,8,10,8,18,41,61,-20,38
St. Pölten,5190,9,9,9,18,44,65,-21,36
Mattersburg,5190,10,9,7,20,38,62,-24,34
FC Salzburg,5191,1,22,6,8,71,33,38,72
Vienna,5191,2,19,5,12,59,52,7,62
SC Rheindorf,5191,3,18,7,11,51,45,6,61
SK Sturm Gra,5191,4,17,6,13,58,42,16,57
Rapid Vienna,5191,5,15,9,12,54,40,14,54
RZ Pellets W,5191,6,15,6,15,53,60,-7,51
St. Pölten,5191,7,11,9,16,49,60,-11,42
SV Josko Rie,5191,8,12,4,20,41,54,-13,40
Admira Wacke,5191,9,11,5,20,37,59,-22,38
Mattersburg,5191,10,8,7,21,34,62,-28,31
SK Sturm Gra,5192,1,23,4,9,57,30,27,73
SC Rheindorf,5192,2,22,4,10,61,45,16,70
FC Salzburg,5192,3,20,8,8,62,25,37,68
Vienna,5192,4,17,8,11,61,56,5,59
Rapid Vienna,5192,5,14,8,14,52,39,13,50
RZ Pellets W,5192,6,11,8,17,45,55,-10,41
Mattersburg,5192,7,10,9,17,36,50,-14,39
Admira Wacke,5192,8,11,4,21,33,57,-24,37
SV Josko Rie,5192,9,10,6,20,33,57,-24,36
St. Pölten,5192,10,9,7,20,39,65,-26,34
Vienna,5193,1,21,5,10,72,48,24,68
FC Salzburg,5193,2,20,6,10,62,36,26,66
SC Rheindorf,5193,3,18,9,9,50,38,12,63
Rapid Vienna,5193,4,17,9,10,63,39,24,60
SK Sturm Gra,5193,5,17,7,12,57,38,19,58
RZ Pellets W,5193,6,15,7,14,52,55,-3,52
SV Josko Rie,5193,7,10,8,18,33,55,-22,38
Admira Wacke,5193,8,9,6,21,32,67,-35,33
Mattersburg,5193,9,7,11,18,35,52,-17,32
St. Pölten,5193,10,7,10,19,39,67,-28,31
FC Salzburg,5194,1,20,10,6,65,31,34,70
SK Sturm Gra,5194,2,21,7,8,56,29,27,70
Vienna,5194,3,21,4,11,58,45,13,67
SC Rheindorf,5194,4,19,8,9,57,39,18,65
Rapid Vienna,5194,5,13,7,16,55,47,8,46
RZ Pellets W,5194,6,12,6,18,46,59,-13,42
SV Josko Rie,5194,7,12,3,21,33,48,-15,39
St. Pölten,5194,8,10,9,17,38,58,-20,39
Admira Wacke,5194,9,11,5,20,38,65,-27,38
Mattersburg,5194,10,7,9,20,38,63,-25,30
Vienna,5195,1,20,3,13,62,52,10,63
SC Rheindorf,5195,2,17,11,8,50,39,11,62
FC Salzburg,5195,3,17,9,10,58,31,27,60
SK Sturm Gra,5195,4,18,6,12,55,32,23,60
Rapid Vienna,5195,5,13,13,10,54,36,18,52
RZ Pellets W,5195,6,14,5,17,48,58,-10,47
Admira Wacke,5195,7,13,7,16,41,59,-18,46
SV Josko Rie,5195,8,11,9,16,42,53,-11,42
St. Pölten,5195,9,11,8,17,40,62,-22,41
Mattersburg,5195,10,5,11,20,31,59,-28,26
FC Salzburg,5196,1,23,8,5,72,27,45,77
SC Rheindorf,5196,2,21,8,7,71,50,21,71
SK Sturm Gra,5196,3,19,6,11,63,41,22,63
Vienna,5196,4,19,4,13,65,52,13,61
Rapid Vienna,5196,5,16,11,9,56,36,20,59
RZ Pellets W,5196,6,10,11,15,42,55,-13,41
SV Josko Rie,5196,7,10,4,22,30,53,-23,34
Admira Wacke,5196,8,8,9,19,30,60,-30,33
St. Pölten,5196,9,8,8,20,35,66,-31,32
Mattersburg,5196,10,8,7,21,36,60,-24,31
FC Salzburg,5197,1,20,9,7,70,35,35,69
SC Rheindorf,5197,2,18,10,8,56,41,15,64
SK Sturm Gra,5197,3,17,9,10,53,33,20,60
Rapid Vienna,5197,4,16,11,9,53,33,20,59
Vienna,5197,5,17,7,12,63,55,8,58
RZ Pellets W,5197,6,15,7,14,48,49,-1,52
SV Josko Rie,5197,7,11,6,19,38,55,-17,39
St. Pölten,5197,8,10,8,18,42,66,-24,38
Admira Wacke,5197,9,9,6,21,28,57,-29,33
Mattersburg,5197,10,6,9,21,33,60,-27,27
FC Salzburg,5198,1,23,7,6,73,33,40,76
SC Rheindorf,5198,2,20,8,8,72,49,23,68
SK Sturm Gra,5198,3,18,5,13,55,40,15,59
Vienna,5198,4,16,7,13,60,60,0,55
Rapid Vienna,5198,5,12,13,11,53,42,11,49
RZ Pellets W,5198,6,14,7,15,53,59,-6,49
Admira Wacke,5198,7,11,9,16,36,54,-18,42
SV Josko Rie,5198,8,10,8,18,37,54,-17,38
Mattersburg,5198,9,9,7,20,39,61,-22,34
St. Pölten,5198,10,7,9,20,39,65,-26,30
FC Salzburg,5199,1,21,7,8,73,40,33,70
SC Rheindorf,5199,2,18,10,8,49,41,8,64
Vienna,5199,3,18,4,14,68,59,9,58
SK Sturm Gra,5199,4,16,8,12,51,37,14,56
Rapid Vienna,5199,5,13,13,10,58,42,16,52
Admira Wacke,5199,6,12,11,13,39,47,-8,47
SV Josko Rie,5199,7,11,11,14,42,48,-6,44
Mattersburg,5199,8,10,10,16,42,56,-14,40
RZ Pellets W,5199,9,10,8,18,42,59,-17,38
St. Pölten,5199,10,5,10,21,32,67,-35,25
SC Rheindorf,5200,1,21,7,8,51,33,18,70
FC Salzburg,5200,2,20,8,8,65,35,30,68
SK Sturm Gra,5200,3,19,6,11,57,31,26,63
Vienna,5200,4,20,3,13,62,49,13,63
Rapid Vienna,5200,5,17,9,10,63,44,19,60
RZ Pellets W,5200,6,15,6,15,44,45,-1,51
St. Pölten,5200,7,9,11,16,40,55,-15,38
Admira Wacke,5200,8,10,6,20,35,67,-32,36
SV Josko Rie,5200,9,9,6,21,31,55,-24,33
Mattersburg,5200,10,6,6,24,36,70,-34,24
SK Sturm Gra,5201,1,22,5,9,55,30,25,71
Vienna,5201,2,20,6,10,68,52,16,66
SC Rheindorf,5201,3,19,9,8,52,36,16,66
FC Salzburg,5201,4,19,8,9,62,31,31,65
Rapid Vienna,5201,5,16,8,12,58,45,13,56
St. Pölten,5201,6,11,6,19,49,64,-15,39
Admira Wacke,5201,7,10,8,18,32,54,-22,38
RZ Pellets W,5201,8,9,9,18,37,57,-20,36
Mattersburg,5201,9,8,9,19,38,60,-22,33
SV Josko Rie,5201,10,9,6,21,32,54,-22,33
SC Rheindorf,5202,1,21,10,5,60,37,23,73
FC Salzburg,5202,2,20,8,8,63,33,30,68
Vienna,5202,3,20,6,10,66,52,14,66
SK Sturm Gra,5202,4,16,6,14,50,39,11,54
Rapid Vienna,5202,5,12,11,13,58,45,13,47
Admira Wacke,5202,6,13,7,16,37,56,-19,46
RZ Pellets W,5202,7,13,6,17,48,55,-7,45
Mattersburg,5202,8,10,9,17,38,50,-12,39
SV Josko Rie,5202,9,9,6,21,27,51,-24,33
St. Pölten,5202,10,7,9,20,45,74,-29,30
FC Salzburg,5203,1,20,7,9,68,37,31,67
SC Rheindorf,5203,2,19,10,7,50,32,18,67
Vienna,5203,3,19,6,11,65,49,16,63
SK Sturm Gra,5203,4,18,7,11,59,42,17,61
Rapid Vienna,5203,5,15,12,9,62,39,23,57
RZ Pellets W,5203,6,11,9,16,48,58,-10,42
St. Pölten,5203,7,10,9,17,48,67,-19,39
SV Josko Rie,5203,8,11,4,21,37,58,-21,37
Admira Wacke,5203,9,10,7,19,33,65,-32,37
Mattersburg,5203,10,7,9,20,35,58,-23,30
FC Salzburg,5204,1,21,7,8,65,30,35,70
SC Rheindorf,5204,2,20,8,8,52,34,18,68
Vienna,5204,3,18,6,12,61,52,9,60
SK Sturm Gra,5204,4,17,7,12,58,37,21,58
Rapid Vienna,5204,5,14,9,13,51,46,5,51
Admira Wacke,5204,6,13,8,15,41,56,-15,47
SV Josko Rie,5204,7,11,8,17,37,48,-11,41
RZ Pellets W,5204,8,11,8,17,43,60,-17,41
St. Pölten,5204,9,7,12,17,44,67,-23,33
Mattersburg,5204,10,6,11,19,31,53,-22,29
FC Salzburg,5205,1,24,7,5,75,22,53,79
SK Sturm Gra,5205,2,19,8,9,67,34,33,65
SC Rheindorf,5205,3,18,9,9,54,41,13,63
Vienna,5205,4,18,7,11,63,51,12,61
Rapid Vienna,5205,5,14,11,11,56,41,15,53
Admira Wacke,5205,6,13,5,18,36,62,-26,44
RZ Pellets W,5205,7,11,7,18,43,60,-17,40
SV Josko Rie,5205,8,8,8,20,29,51,-22,32
St. Pölten,5205,9,7,11,18,36,69,-33,32
Mattersburg,5205,10,7,9,20,28,56,-28,30
FC Salzburg,5206,1,24,6,6,78,27,51,78
SC Rheindorf,5206,2,21,9,6,66,46,20,72
Vienna,5206,3,18,6,12,61,48,13,60
SK Sturm Gra,5206,4,17,7,12,59,37,22,58
Rapid Vienna,5206,5,12,10,14,48,44,4,46
Admira Wacke,5206,6,13,6,17,42,61,-19,45
Mattersburg,5206,7,11,7,18,45,62,-17,40
RZ Pellets W,5206,8,11,5,20,34,59,-25,38
SV Josko Rie,5206,9,10,5,21,30,51,-21,35
St. Pölten,5206,10,8,9,19,37,65,-28,33
FC Salzburg,5207,1,22,8,6,76,29,47,74
SK Sturm Gra,5207,2,22,6,8,67,36,31,72
SC Rheindorf,5207,3,20,8,8,57,40,17,68
Vienna,5207,4,20,4,12,67,55,12,64
Rapid Vienna,5207,5,13,12,11,55,42,13,51
Mattersburg,5207,6,8,12,16,38,58,-20,36
RZ Pellets W,5207,7,10,6,20,36,60,-24,36
Admira Wacke,5207,8,10,5,21,34,63,-29,35
St. Pölten,5207,9,6,15,15,40,61,-21,33
SV Josko Rie,5207,10,8,6,22,32,58,-26,30
FC Salzburg,5208,1,23,7,6,68,27,41,76
SK Sturm Gra,5208,2,22,6,8,61,30,31,72
Vienna,5208,3,19,5,12,60,51,9,62
SC Rheindorf,5208,4,19,5,12,56,48,8,62
Rapid Vienna,5208,5,16,11,9,62,37,25,59
Mattersburg,5208,6,10,10,16,44,60,-16,40
RZ Pellets W,5208,7,10,7,19,46,59,-13,37
SV Josko Rie,5208,8,10,6,20,35,56,-21,36
Admira Wacke,5208,9,9,6,21,33,64,-31,33
St. Pölten,5208,10,6,9,21,33,66,-33,27
FC Salzburg,5209,1,20,7,9,65,33,32,67
SC Rheindorf,5209,2,18,11,7,55,39,16,65
SK Sturm Gra,5209,3,20,4,12,61,36,25,64
Vienna,5209,4,19,6,11,63,48,15,63
Rapid Vienna,5209,5,12,14,10,48,38,10,50
St. Pölten,5209,6,10,11,15,42,54,-12,41
SV Josko Rie,5209,7,12,5,19,40,56,-16,41
RZ Pellets W,5209,8,11,7,18,38,59,-21,40
Admira Wacke,5209,9,11,6,19,38,67,-29,39
Mattersburg,5209,10,7,9,20,40,60,-20,30
FC Salzburg,5210,1,19,9,8,67,33,34,66
SC Rheindorf,5210,2,18,8,10,53,42,11,62
SK Sturm Gra,5210,3,18,7,11,60,39,21,61
Rapid Vienna,5210,4,16,11,9,61,40,21,59
Vienna,5210,5,17,7,12,62,53,9,58
Mattersburg,5210,6,12,6,18,39,55,-16,42
RZ Pellets W,5210,7,12,5,19,46,59,-13,41
SV Josko Rie,5210,8,11,8,17,35,55,-20,41
St. Pölten,5210,9,10,9,17,50,67,-17,39
Admira Wacke,5210,10,8,8,20,33,63,-30,32
FC Salzburg,5211,1,21,9,6,67,32,35,72
SC Rheindorf,5211,2,20,8,8,51,37,14,68
Vienna,5211,3,17,8,11,61,53,8,59
SK Sturm Gra,5211,4,14,9,13,51,37,14,51
RZ Pellets W,5211,5,13,9,14,50,54,-4,48
Admira Wacke,5211,6,12,9,15,39,55,-16,45
Rapid Vienna,5211,7,10,11,15,50,44,6,41
SV Josko Rie,5211,8,11,7,18,35,51,-16,40
Mattersburg,5211,9,9,9,18,38,55,-17,36
St. Pölten,5211,10,9,9,18,37,61,-24,36
FC Salzburg,5212,1,21,8,7,62,28,34,71
SC Rheindorf,5212,2,19,9,8,50,39,11,66
SK Sturm Gra,5212,3,19,5,12,58,35,23,62
Vienna,5212,4,18,5,13,63,54,9,59
Rapid Vienna,5212,5,13,10,13,54,42,12,49
RZ Pellets W,5212,6,13,9,14,47,51,-4,48
SV Josko Rie,5212,7,12,6,18,35,48,-13,42
Mattersburg,5212,8,10,8,18,33,54,-21,38
Admira Wacke,5212,9,10,7,19,36,60,-24,37
St. Pölten,5212,10,8,7,21,36,63,-27,31
FC Salzburg,5213,1,23,6,7,75,28,47,75
SK Sturm Gra,5213,2,19,8,9,61,35,26,65
Rapid Vienna,5213,3,18,8,10,67,37,30,62
SC Rheindorf,5213,4,18,7,11,50,43,7,61
Vienna,5213,5,17,4,15,65,54,11,55
St. Pölten,5213,6,12,8,16,54,63,-9,44
RZ Pellets W,5213,7,11,8,17,46,65,-19,41
Admira Wacke,5213,8,11,7,18,37,63,-26,40
SV Josko Rie,5213,9,11,4,21,28,60,-32,37
Mattersburg,5213,10,7,6,23,36,71,-35,27
FC Salzburg,5214,1,20,8,8,60,31,29,68
Vienna,5214,2,20,5,11,63,45,18,65
SC Rheindorf,5214,3,17,9,10,52,42,10,60
SK Sturm Gra,5214,4,17,8,11,59,36,23,59
RZ Pellets W,5214,5,15,8,13,42,44,-2,53
Rapid Vienna,5214,6,13,12,11,55,40,15,51
Admira Wacke,5214,7,11,7,18,38,60,-22,40
SV Josko Rie,5214,8,11,5,20,35,52,-17,38
St. Pölten,5214,9,9,9,18,42,69,-27,36
Mattersburg,5214,10,7,9,20,31,58,-27,30
SK Sturm Gra,5215,1,23,3,10,71,39,32,72
FC Salzburg,5215,2,20,8,8,62,27,35,68
SC Rheindorf,5215,3,19,7,10,56,45,11,64
Vienna,5215,4,18,6,12,63,54,9,60
Rapid Vienna,5215,5,12,10,14,56,46,10,46
Admira Wacke,5215,6,14,4,18,41,62,-21,46
RZ Pellets W,5215,7,11,7,18,48,60,-12,40
SV Josko Rie,5215,8,12,4,20,35,55,-20,40
Mattersburg,5215,9,10,9,17,38,54,-16,39
St. Pölten,5215,10,8,8,20,36,64,-28,32
FC Salzburg,5216,1,22,7,7,69,32,37,73
SC Rheindorf,5216,2,22,6,8,65,43,22,72
SK Sturm Gra,5216,3,20,5,11,57,34,23,65
Vienna,5216,4,20,4,12,61,44,17,64
Rapid Vienna,5216,5,13,10,13,52,40,12,49
RZ Pellets W,5216,6,13,4,19,47,65,-18,43
Admira Wacke,5216,7,13,4,19,40,64,-24,43
St. Pölten,5216,8,10,8,18,48,71,-23,38
SV Josko Rie,5216,9,9,5,22,39,63,-24,32
Mattersburg,5216,10,8,7,21,36,58,-22,31
FC Salzburg,5217,1,22,7,7,70,27,43,73
SK Sturm Gra,5217,2,22,5,9,63,33,30,71
SC Rheindorf,5217,3,20,7,9,54,43,11,67
Vienna,5217,4,18,4,14,68,57,11,58
Rapid Vienna,5217,5,16,8,12,59,36,23,56
RZ Pellets W,5217,6,13,6,17,48,57,-9,45
Admira Wacke,5217,7,10,7,19,33,61,-28,37
St. Pölten,5217,8,9,7,20,40,72,-32,34
Mattersburg,5217,9,8,9,19,33,56,-23,33
SV Josko Rie,5217,10,9,6,21,29,55,-26,33
SC Rheindorf,5218,1,21,7,8,59,42,17,70
Vienna,5218,2,21,4,11,70,50,20,67
SK Sturm Gra,5218,3,18,9,9,57,35,22,63
FC Salzburg,5218,4,17,9,10,64,40,24,60
Rapid Vienna,5218,5,14,10,12,59,41,18,52
St. Pölten,5218,6,12,7,17,49,71,-22,43
Admira Wacke,5218,7,12,6,18,34,56,-22,42
Mattersburg,5218,8,11,8,17,48,52,-4,41
RZ Pellets W,5218,9,10,8,18,48,70,-22,38
SV Josko Rie,5218,10,7,6,23,30,61,-31,27
FC Salzburg,5219,1,21,9,6,65,29,36,72
SC Rheindorf,5219,2,21,7,8,64,39,25,70
Rapid Vienna,5219,3,17,11,8,64,36,28,62
SK Sturm Gra,5219,4,19,5,12,57,38,19,62
Vienna,5219,5,16,6,14,66,63,3,54
RZ Pellets W,5219,6,12,8,16,50,60,-10,44
St. Pölten,5219,7,11,6,19,47,69,-22,39
Admira Wacke,5219,8,10,5,21,37,68,-31,35
Mattersburg,5219,9,9,7,20,40,61,-21,34
SV Josko Rie,5219,10,10,4,22,31,58,-27,34
FC Salzburg,5220,1,22,8,6,72,37,35,74
SK Sturm Gra,5220,2,20,7,9,61,34,27,67
SC Rheindorf,5220,3,19,6,11,60,48,12,63
Vienna,5220,4,20,3,13,63,54,9,63
Rapid Vienna,5220,5,14,11,11,60,41,19,53
St. Pölten,5220,6,11,9,16,45,62,-17,42
SV Josko Rie,5220,7,11,5,20,34,53,-19,38
Admira Wacke,5220,8,10,7,19,33,64,-31,37
RZ Pellets W,5220,9,10,6,20,39,53,-14,36
Mattersburg,5220,10,7,10,19,37,58,-21,31
FC Salzburg,5221,1,21,6,9,64,33,31,69
SK Sturm Gra,5221,2,19,7,10,55,34,21,64
Vienna,5221,3,19,6,11,64,51,13,63
SC Rheindorf,5221,4,17,11,8,52,41,11,62
Rapid Vienna,5221,5,12,13,11,59,43,16,49
RZ Pellets W,5221,6,13,8,15,49,53,-4,47
Admira Wacke,5221,7,11,7,18,30,52,-22,40
St. Pölten,5221,8,9,10,17,35,57,-22,37
SV Josko Rie,5221,9,10,6,20,32,56,-24,36
Mattersburg,5221,10,6,12,18,38,58,-20,30
FC Salzburg,5222,1,22,6,8,69,39,30,72
SC Rheindorf,5222,2,19,6,11,53,44,9,63
SK Sturm Gra,5222,3,18,7,11,59,38,21,61
Vienna,5222,4,18,7,11,61,51,10,61
Rapid Vienna,5222,5,15,12,9,60,36,24,57
RZ Pellets W,5222,6,10,8,18,41,61,-20,38
Admira Wacke,5222,7,9,11,16,32,56,-24,38
St. Pölten,5222,8,8,13,15,42,57,-15,37
Mattersburg,5222,9,10,7,19,42,62,-20,37
SV Josko Rie,5222,10,11,3,22,36,51,-15,36
SK Sturm Gra,5223,1,23,3,10,59,35,24,72
FC Salzburg,5223,2,20,7,9,64,32,32,67
SC Rheindorf,5223,3,19,8,9,57,38,19,65
Vienna,5223,4,18,4,14,64,55,9,58
RZ Pellets W,5223,5,15,5,16,51,53,-2,50
Rapid Vienna,5223,6,13,9,14,50,43,7,48
SV Josko Rie,5223,7,12,5,19,36,54,-18,41
Admira Wacke,5223,8,11,5,20,37,54,-17,38
Mattersburg,5223,9,9,8,19,33,63,-30,35
St. Pölten,5223,10,8,10,18,41,65,-24,34
FC Salzburg,5224,1,21,8,7,68,32,36,71
SC Rheindorf,5224,2,19,9,8,61,46,15,66
SK Sturm Gra,5224,3,20,5,11,67,35,32,65
Vienna,5224,4,18,7,11,57,47,10,61
Rapid Vienna,5224,5,14,10,12,53,38,15,52
RZ Pellets W,5224,6,14,6,16,46,55,-9,48
SV Josko Rie,5224,7,10,10,16,36,52,-16,40
St. Pölten,5224,8,11,6,19,48,64,-16,39
Admira Wacke,5224,9,8,8,20,32,63,-31,32
Mattersburg,5224,10,6,9,21,36,72,-36,27
FC Salzburg,5225,1,22,8,6,73,34,39,74
SK Sturm Gra,5225,2,20,6,10,60,35,25,66
SC Rheindorf,5225,3,18,8,10,54,43,11,62
Vienna,5225,4,17,7,12,57,53,4,58
Rapid Vienna,5225,5,15,11,10,62,39,23,56
Mattersburg,5225,6,11,8,17,37,50,-13,41
SV Josko Rie,5225,7,10,7,19,35,57,-22,37
RZ Pellets W,5225,8,9,9,18,44,60,-16,36
Admira Wacke,5225,9,9,8,19,31,59,-28,35
St. Pölten,5225,10,7,12,17,37,60,-23,33
FC Salzburg,5226,1,22,7,7,75,41,34,73
SK Sturm Gra,5226,2,21,5,10,60,32,28,68
Vienna,5226,3,20,4,12,71,51,20,64
SC Rheindorf,5226,4,19,5,12,52,50,2,62
Rapid Vienna,5226,5,15,11,10,63,44,19,56
SV Josko Rie,5226,6,12,5,19,43,57,-14,41
RZ Pellets W,5226,7,11,6,19,44,66,-22,39
Admira Wacke,5226,8,10,6,20,34,63,-29,36
St. Pölten,5226,9,8,10,18,39,59,-20,34
Mattersburg,5226,10,8,9,19,42,60,-18,33
SK Sturm Gra,5227,1,19,9,8,60,33,27,66
FC Salzburg,5227,2,19,8,9,59,33,26,65
SC Rheindorf,5227,3,19,7,10,55,41,14,64
Vienna,5227,4,18,8,10,60,47,13,62
RZ Pellets W,5227,5,15,6,15,53,52,1,51
Rapid Vienna,5227,6,12,10,14,58,50,8,46
SV Josko Rie,5227,7,14,4,18,34,47,-13,46
Admira Wacke,5227,8,12,9,15,34,54,-20,45
Mattersburg,5227,9,7,7,22,35,62,-27,28
St. Pölten,5227,10,6,10,20,35,64,-29,28
FC Salzburg,5228,1,21,8,7,63,31,32,71
SC Rheindorf,5228,2,19,8,9,54,40,14,65
Vienna,5228,3,19,5,12,66,51,15,62
Rapid Vienna,5228,4,16,9,11,59,37,22,57
SK Sturm Gra,5228,5,16,9,11,50,32,18,57
Admira Wacke,5228,6,12,6,18,41,60,-19,42
RZ Pellets W,5228,7,12,5,19,43,55,-12,41
SV Josko Rie,5228,8,12,4,20,37,60,-23,40
St. Pölten,5228,9,9,9,18,38,64,-26,36
Mattersburg,5228,10,8,9,19,31,52,-21,33
SK Sturm Gra,5229,1,21,7,8,72,34,38,70
FC Salzburg,5229,2,19,9,8,61,36,25,66
Vienna,5229,3,20,4,12,69,55,14,64
SC Rheindorf,5229,4,19,6,11,61,47,14,63
Rapid Vienna,5229,5,14,11,11,63,44,19,53
RZ Pellets W,5229,6,15,8,13,54,59,-5,53
SV Josko Rie,5229,7,10,7,19,40,62,-22,37
Mattersburg,5229,8,8,11,17,43,56,-13,35
Admira Wacke,5229,9,10,5,21,35,71,-36,35
St. Pölten,5229,10,5,10,21,34,68,-34,25
SC Rheindorf,5230,1,20,7,9,51,32,19,67
FC Salzburg,5230,2,19,9,8,55,25,30,66
Vienna,5230,3,20,5,11,65,46,19,65
RZ Pellets W,5230,4,18,5,13,53,47,6,59
SK Sturm Gra,5230,5,17,7,12,53,44,9,58
Rapid Vienna,5230,6,11,9,16,45,46,-1,42
Mattersburg,5230,7,12,6,18,45,54,-9,42
Admira Wacke,5230,8,11,9,16,35,56,-21,42
St. Pölten,5230,9,8,8,20,38,63,-25,32
SV Josko Rie,5230,10,9,5,22,30,57,-27,32
SK Sturm Gra,5231,1,23,4,9,60,34,26,73
FC Salzburg,5231,2,21,7,8,65,28,37,70
SC Rheindorf,5231,3,20,7,9,56,43,13,67
Vienna,5231,4,18,8,10,62,45,17,62
Rapid Vienna,5231,5,15,10,11,64,44,20,55
RZ Pellets W,5231,6,12,8,16,46,52,-6,44
Admira Wacke,5231,7,10,6,20,32,64,-32,36
SV Josko Rie,5231,8,10,4,22,39,55,-16,34
St. Pölten,5231,9,8,9,19,40,70,-30,33
Mattersburg,5231,10,7,9,20,35,64,-29,30
FC Salzburg,5232,1,23,6,7,72,28,44,75
SK Sturm Gra,5232,2,22,3,11,64,37,27,69
SC Rheindorf,5232,3,19,6,11,48,37,11,63
Vienna,5232,4,18,5,13,66,63,3,59
RZ Pellets W,5232,5,15,8,13,44,49,-5,53
Rapid Vienna,5232,6,13,12,11,58,43,15,51
Admira Wacke,5232,7,12,6,18,42,59,-17,42
SV Josko Rie,5232,8,11,5,20,34,56,-22,38
St. Pölten,5232,9,9,8,19,44,65,-21,35
Mattersburg,5232,10,4,9,23,38,73,-35,21
SK Sturm Gra,5233,1,24,6,6,70,28,42,78
FC Salzburg,5233,2,22,7,7,68,31,37,73
SC Rheindorf,5233,3,19,7,10,53,40,13,64
Vienna,5233,4,18,6,12,65,56,9,60
Rapid Vienna,5233,5,12,13,11,49,40,9,49
RZ Pellets W,5233,6,11,7,18,41,59,-18,40
St. Pölten,5233,7,9,10,17,36,60,-24,37
Admira Wacke,5233,8,9,7,20,36,58,-22,34
Mattersburg,5233,9,7,12,17,39,59,-20,33
SV Josko Rie,5233,10,10,3,23,35,61,-26,33
FC Salzburg,5234,1,22,10,4,65,25,40,76
Vienna,5234,2,20,5,11,64,47,17,65
SK Sturm Gra,5234,3,19,5,12,53,35,18,62
SC Rheindorf,5234,4,18,8,10,60,45,15,62
Rapid Vienna,5234,5,15,9,12,59,45,14,54
Admira Wacke,5234,6,14,4,18,38,53,-15,46
RZ Pellets W,5234,7,12,7,17,53,58,-5,43
SV Josko Rie,5234,8,11,7,18,33,53,-20,40
St. Pölten,5234,9,9,6,21,37,73,-36,33
Mattersburg,5234,10,5,9,22,33,61,-28,24
FC Salzburg,5235,1,25,5,6,66,28,38,80
SC Rheindorf,5235,2,20,8,8,56,38,18,68
Vienna,5235,3,21,5,10,62,45,17,68
SK Sturm Gra,5235,4,18,4,14,60,44,16,58
RZ Pellets W,5235,5,13,10,13,44,50,-6,49
Rapid Vienna,5235,6,12,12,12,53,43,10,48
Admira Wacke,5235,7,13,6,17,43,58,-15,45
SV Josko Rie,5235,8,10,4,22,30,55,-25,34
Mattersburg,5235,9,7,6,23,33,56,-23,27
St. Pölten,5235,10,4,14,18,32,62,-30,26
FC Salzburg,5236,1,20,7,9,63,32,31,67
SC Rheindorf,5236,2,19,9,8,61,41,20,66
SK Sturm Gra,5236,3,20,4,12,60,34,26,64
Rapid Vienna,5236,4,18,8,10,57,34,23,62
Vienna,5236,5,17,4,15,63,56,7,55
Admira Wacke,5236,6,12,7,17,37,60,-23,43
RZ Pellets W,5236,7,12,6,18,46,61,-15,42
St. Pölten,5236,8,11,8,17,40,58,-18,41
SV Josko Rie,5236,9,9,6,21,36,61,-25,33
Mattersburg,5236,10,7,11,18,38,64,-26,32
SK Sturm Gra,5237,1,22,7,7,63,31,32,73
FC Salzburg,5237,2,22,6,8,66,29,37,72
SC Rheindorf,5237,3,19,8,9,55,40,15,65
Vienna,5237,4,17,5,14,52,48,4,56
Rapid Vienna,5237,5,13,12,11,55,45,10,51
RZ Pellets W,5237,6,13,7,16,46,58,-12,46
Admira Wacke,5237,7,13,7,16,39,53,-14,46
SV Josko Rie,5237,8,11,5,20,32,50,-18,38
Mattersburg,5237,9,8,6,22,37,58,-21,30
St. Pölten,5237,10,6,9,21,36,69,-33,27
FC Salzburg,5238,1,24,5,7,65,28,37,77
SK Sturm Gra,5238,2,23,4,9,62,32,30,73
SC Rheindorf,5238,3,19,9,8,62,43,19,66
Vienna,5238,4,16,8,12,56,49,7,56
Rapid Vienna,5238,5,13,10,13,57,43,14,49
Admira Wacke,5238,6,12,6,18,41,53,-12,42
Mattersburg,5238,7,11,6,19,41,61,-20,39
SV Josko Rie,5238,8,11,5,20,29,51,-22,38
RZ Pellets W,5238,9,10,7,19,42,63,-21,37
St. Pölten,5238,10,7,8,21,36,68,-32,29
FC Salzburg,5239,1,23,4,9,73,32,41,73
SC Rheindorf,5239,2,21,5,10,54,36,18,68
SK Sturm Gra,5239,3,21,4,11,67,36,31,67
Vienna,5239,4,20,4,12,66,55,11,64
Rapid Vienna,5239,5,14,11,11,56,44,12,53
Admira Wacke,5239,6,15,3,18,38,61,-23,48
RZ Pellets W,5239,7,12,7,17,45,57,-12,43
SV Josko Rie,5239,8,11,5,20,34,57,-23,38
St. Pölten,5239,9,8,7,21,37,65,-28,31
Mattersburg,5239,10,7,6,23,38,65,-27,27
Vienna,5240,1,23,4,9,68,47,21,73
SK Sturm Gra,5240,2,21,6,9,55,29,26,69
FC Salzburg,5240,3,19,8,9,67,36,31,65
SC Rheindorf,5240,4,18,8,10,49,42,7,62
Rapid Vienna,5240,5,14,12,10,52,38,14,54
RZ Pellets W,5240,6,12,9,15,51,57,-6,45
Admira Wacke,5240,7,12,4,20,39,61,-22,40
SV Josko Rie,5240,8,11,4,21,35,50,-15,37
Mattersburg,5240,9,8,7,21,35,60,-25,31
St. Pölten,5240,10,7,8,21,37,68,-31,29
FC Salzburg,5241,1,20,9,7,61,29,32,69
SK Sturm Gra,5241,2,19,8,9,57,34,23,65
SC Rheindorf,5241,3,19,8,9,56,39,17,65
Vienna,5241,4,18,6,12,60,50,10,60
Rapid Vienna,5241,5,14,10,12,53,38,15,52
RZ Pellets W,5241,6,13,10,13,46,45,1,49
SV Josko Rie,5241,7,11,5,20,30,51,-21,38
St. Pölten,5241,8,9,9,18,40,68,-28,36
Mattersburg,5241,9,9,7,20,39,57,-18,34
Admira Wacke,5241,10,9,6,21,34,65,-31,33
SK Sturm Gra,5242,1,22,6,8,63,37,26,72
SC Rheindorf,5242,2,19,10,7,63,38,25,67
FC Salzburg,5242,3,20,6,10,65,34,31,66
Vienna,5242,4,15,7,14,65,63,2,52
Rapid Vienna,5242,5,12,11,13,53,43,10,47
RZ Pellets W,5242,6,13,7,16,48,56,-8,46
Admira Wacke,5242,7,13,7,16,43,59,-16,46
St. Pölten,5242,8,9,13,14,43,60,-17,40
SV Josko Rie,5242,9,11,6,19,38,59,-21,39
Mattersburg,5242,10,6,7,23,43,75,-32,25
FC Salzburg,5243,1,21,7,8,61,28,33,70
SC Rheindorf,5243,2,21,5,10,63,44,19,68
SK Sturm Gra,5243,3,18,8,10,53,35,18,62
Vienna,5243,4,18,5,13,57,50,7,59
Rapid Vienna,5243,5,14,13,9,60,40,20,55
RZ Pellets W,5243,6,15,7,14,48,48,0,52
St. Pölten,5243,7,9,10,17,42,62,-20,37
SV Josko Rie,5243,8,10,5,21,34,58,-24,35
Admira Wacke,5243,9,8,10,18,32,60,-28,34
Mattersburg,5243,10,8,6,22,38,63,-25,30
FC Salzburg,5244,1,20,8,8,63,27,36,68
SC Rheindorf,5244,2,20,7,9,50,38,12,67
SK Sturm Gra,5244,3,19,7,10,63,34,29,64
Vienna,5244,4,19,6,11,56,48,8,63
Rapid Vienna,5244,5,18,8,10,64,40,24,62
St. Pölten,5244,6,10,10,16,42,61,-19,40
SV Josko Rie,5244,7,10,8,18,28,45,-17,38
RZ Pellets W,5244,8,9,9,18,42,63,-21,36
Admira Wacke,5244,9,10,5,21,34,63,-29,35
Mattersburg,5244,10,7,8,21,36,59,-23,29
SC Rheindorf,5245,1,19,10,7,59,41,18,67
FC Salzburg,5245,2,20,5,11,66,36,30,65
Vienna,5245,3,19,7,10,68,48,20,64
SK Sturm Gra,5245,4,18,9,9,59,33,26,63
Rapid Vienna,5245,5,13,12,11,54,40,14,51
Admira Wacke,5245,6,14,5,17,39,69,-30,47
RZ Pellets W,5245,7,12,7,17,47,60,-13,43
SV Josko Rie,5245,8,11,6,19,38,54,-16,39
Mattersburg,5245,9,8,8,20,41,60,-19,32
St. Pölten,5245,10,6,11,19,40,70,-30,29
SC Rheindorf,5246,1,19,9,8,56,45,11,66
SK Sturm Gra,5246,2,19,6,11,56,39,17,63
Vienna,5246,3,18,7,11,67,55,12,61
Rapid Vienna,5246,4,15,14,7,58,35,23,59
FC Salzburg,5246,5,14,9,13,51,36,15,51
Admira Wacke,5246,6,14,6,16,53,61,-8,48
SV Josko Rie,5246,7,14,4,18,35,48,-13,46
RZ Pellets W,5246,8,9,10,17,40,53,-13,37
Mattersburg,5246,9,8,11,17,33,56,-23,35
St. Pölten,5246,10,7,10,19,36,57,-21,31
FC Salzburg,5247,1,23,6,7,74,35,39,75
Vienna,5247,2,23,3,10,70,52,18,72
Rapid Vienna,5247,3,19,8,9,68,37,31,65
SC Rheindorf,5247,4,19,6,11,61,49,12,63
SK Sturm Gra,5247,5,18,5,13,54,40,14,59
Admira Wacke,5247,6,15,4,17,46,57,-11,49
RZ Pellets W,5247,7,10,6,20,43,66,-23,36
St. Pölten,5247,8,7,11,18,40,65,-25,32
Mattersburg,5247,9,8,6,22,35,63,-28,30
SV Josko Rie,5247,10,8,5,23,30,57,-27,29
SC Rheindorf,5248,1,21,6,9,60,42,18,69
FC Salzburg,5248,2,19,9,8,70,34,36,66
Vienna,5248,3,20,4,12,62,47,15,64
SK Sturm Gra,5248,4,19,5,12,55,33,22,62
RZ Pellets W,5248,5,13,8,15,51,61,-10,47
Admira Wacke,5248,6,13,7,16,36,57,-21,46
Rapid Vienna,5248,7,11,12,13,45,37,8,45
SV Josko Rie,5248,8,10,7,19,35,56,-21,37
St. Pölten,5248,9,7,12,17,35,58,-23,33
Mattersburg,5248,10,7,10,19,39,63,-24,31
FC Salzburg,5249,1,22,9,5,78,29,49,75
SC Rheindorf,5249,2,19,6,11,63,49,14,63
SK Sturm Gra,5249,3,18,8,10,60,38,22,62
Rapid Vienna,5249,4,16,11,9,62,43,19,59
Vienna,5249,5,16,5,15,56,57,-1,53
Admira Wacke,5249,6,12,8,16,40,58,-18,44
Mattersburg,5249,7,10,9,17,39,61,-22,39
RZ Pellets W,5249,8,10,8,18,49,58,-9,38
SV Josko Rie,5249,9,9,8,19,26,50,-24,35
St. Pölten,5249,10,6,12,18,38,68,-30,30
FC Salzburg,5250,1,23,7,6,67,28,39,76
SC Rheindorf,5250,2,20,7,9,61,45,16,67
Vienna,5250,3,18,5,13,54,52,2,59
SK Sturm Gra,5250,4,16,7,13,58,40,18,55
Rapid Vienna,5250,5,14,9,13,52,41,11,51
Admira Wacke,5250,6,14,6,16,43,54,-11,48
RZ Pellets W,5250,7,13,7,16,47,55,-8,46
SV Josko Rie,5250,8,10,6,20,35,56,-21,36
Mattersburg,5250,9,8,9,19,36,54,-18,33
St. Pölten,5250,10,7,11,18,40,68,-28,32
FC Salzburg,5251,1,23,6,7,74,33,41,75
SK Sturm Gra,5251,2,18,10,8,52,29,23,64
SC Rheindorf,5251,3,17,10,9,51,37,14,61
Vienna,5251,4,17,8,11,68,58,10,59
Rapid Vienna,5251,5,13,12,11,55,42,13,51
Mattersburg,5251,6,11,7,18,45,58,-13,40
RZ Pellets W,5251,7,11,7,18,43,63,-20,40
St. Pölten,5251,8,9,11,16,48,58,-10,38
Admira Wacke,5251,9,10,7,19,36,65,-29,37
SV Josko Rie,5251,10,10,4,22,35,64,-29,34
SC Rheindorf,5252,1,22,6,8,60,42,18,72
SK Sturm Gra,5252,2,21,7,8,63,36,27,70
FC Salzburg,5252,3,21,6,9,67,38,29,69
Vienna,5252,4,17,7,12,60,50,10,58
Rapid Vienna,5252,5,15,8,13,60,44,16,53
RZ Pellets W,5252,6,11,10,15,43,50,-7,43
Admira Wacke,5252,7,12,7,17,31,50,-19,43
SV Josko Rie,5252,8,11,5,20,33,57,-24,38
St. Pölten,5252,9,8,7,21,37,59,-22,31
Mattersburg,5252,10,7,7,22,32,60,-28,28
FC Salzburg,5253,1,22,7,7,71,34,37,73
SC Rheindorf,5253,2,20,5,11,55,46,9,65
SK Sturm Gra,5253,3,19,7,10,63,32,31,64
Vienna,5253,4,19,4,13,61,52,9,61
Rapid Vienna,5253,5,13,10,13,58,45,13,49
Admira Wacke,5253,6,12,9,15,38,61,-23,45
RZ Pellets W,5253,7,11,8,17,44,59,-15,41
Mattersburg,5253,8,10,7,19,39,57,-18,37
St. Pölten,5253,9,9,9,18,46,66,-20,36
SV Josko Rie,5253,10,10,4,22,34,57,-23,34
FC Salzburg,5254,1,23,7,6,70,29,41,76
SC Rheindorf,5254,2,18,11,7,56,39,17,65
Vienna,5254,3,20,3,13,62,51,11,63
SK Sturm Gra,5254,4,16,6,14,60,51,9,54
Rapid Vienna,5254,5,11,12,13,58,46,12,45
Mattersburg,5254,6,11,11,14,43,53,-10,44
Admira Wacke,5254,7,12,7,17,43,61,-18,43
RZ Pellets W,5254,8,12,6,18,39,56,-17,42
St. Pölten,5254,9,10,9,17,45,61,-16,39
SV Josko Rie,5254,10,9,4,23,28,57,-29,31
SC Rheindorf,5255,1,21,7,8,59,41,18,70
FC Salzburg,5255,2,18,12,6,58,33,25,66
Vienna,5255,3,19,6,11,64,54,10,63
SK Sturm Gra,5255,4,15,8,13,58,42,16,53
Rapid Vienna,5255,5,14,9,13,57,50,7,51
Mattersburg,5255,6,12,11,13,41,48,-7,47
RZ Pellets W,5255,7,12,7,17,51,55,-4,43
Admira Wacke,5255,8,12,6,18,38,56,-18,42
St. Pölten,5255,9,8,10,18,45,65,-20,34
SV Josko Rie,5255,10,9,4,23,28,55,-27,31
FC Salzburg,5256,1,20,6,10,73,38,35,66
Vienna,5256,2,20,6,10,74,59,15,66
SK Sturm Gra,5256,3,18,8,10,59,39,20,62
Rapid Vienna,5256,4,17,9,10,60,38,22,60
SC Rheindorf,5256,5,18,6,12,52,48,4,60
RZ Pellets W,5256,6,12,9,15,41,53,-12,45
SV Josko Rie,5256,7,12,5,19,37,50,-13,41
Admira Wacke,5256,8,11,7,18,37,59,-22,40
St. Pölten,5256,9,9,11,16,43,64,-21,38
Mattersburg,5256,10,5,9,22,31,59,-28,24
FC Salzburg,5257,1,22,8,6,72,28,44,74
SC Rheindorf,5257,2,18,8,10,60,47,13,62
SK Sturm Gra,5257,3,18,6,12,54,34,20,60
Rapid Vienna,5257,4,14,12,10,51,35,16,54
Vienna,5257,5,13,7,16,52,58,-6,46
RZ Pellets W,5257,6,12,9,15,42,57,-15,45
St. Pölten,5257,7,12,8,16,47,60,-13,44
Admira Wacke,5257,8,11,9,16,40,61,-21,42
Mattersburg,5257,9,10,7,19,39,57,-18,37
SV Josko Rie,5257,10,11,4,21,36,56,-20,37
SC Rheindorf,5258,1,23,5,8,65,41,24,74
FC Salzburg,5258,2,21,7,8,67,31,36,70
SK Sturm Gra,5258,3,19,4,13,57,39,18,61
Vienna,5258,4,16,5,15,59,62,-3,53
Rapid Vienna,5258,5,13,11,12,55,46,9,50
RZ Pellets W,5258,6,14,6,16,56,56,0,48
SV Josko Rie,5258,7,14,4,18,42,52,-10,46
Admira Wacke,5258,8,13,4,19,43,65,-22,43
Mattersburg,5258,9,10,8,18,36,57,-21,38
St. Pölten,5258,10,6,8,22,35,66,-31,26
SK Sturm Gra,5259,1,22,5,9,68,31,37,71
SC Rheindorf,5259,2,21,6,9,55,43,12,69
FC Salzburg,5259,3,20,5,11,65,32,33,65
Vienna,5259,4,17,4,15,55,50,5,55
RZ Pellets W,5259,5,14,8,14,49,50,-1,50
Admira Wacke,5259,6,15,5,16,40,56,-16,50
Rapid Vienna,5259,7,11,11,14,50,46,4,44
Mattersburg,5259,8,10,8,18,43,57,-14,38
SV Josko Rie,5259,9,11,5,20,32,54,-22,38
St. Pölten,5259,10,6,9,21,33,71,-38,27
SK Sturm Gra,5260,1,21,7,8,70,34,36,70
SC Rheindorf,5260,2,21,7,8,55,41,14,70
FC Salzburg,5260,3,19,8,9,58,29,29,65
Vienna,5260,4,18,3,15,69,56,13,57
Rapid Vienna,5260,5,14,9,13,57,43,14,51
RZ Pellets W,5260,6,14,7,15,50,58,-8,49
Admira Wacke,5260,7,13,7,16,42,50,-8,46
SV Josko Rie,5260,8,10,5,21,28,59,-31,35
Mattersburg,5260,9,8,8,20,37,60,-23,32
St. Pölten,5260,10,7,9,20,32,68,-36,30
SC Rheindorf,5261,1,19,9,8,57,42,15,66
FC Salzburg,5261,2,18,10,8,64,32,32,64
Vienna,5261,3,20,4,12,68,53,15,64
Rapid Vienna,5261,4,17,8,11,61,37,24,59
SK Sturm Gra,5261,5,18,4,14,58,39,19,58
RZ Pellets W,5261,6,12,10,14,46,51,-5,46
SV Josko Rie,5261,7,11,7,18,34,54,-20,40
Mattersburg,5261,8,9,9,18,34,55,-21,36
Admira Wacke,5261,9,9,9,18,36,66,-30,36
St. Pölten,5261,10,6,12,18,38,67,-29,30
FC Salzburg,5262,1,20,8,8,65,32,33,68
SC Rheindorf,5262,2,18,10,8,52,39,13,64
Rapid Vienna,5262,3,15,12,9,58,44,14,57
Vienna,5262,4,16,8,12,59,47,12,56
SK Sturm Gra,5262,5,17,5,14,56,44,12,56
RZ Pellets W,5262,6,13,9,14,42,46,-4,48
Admira Wacke,5262,7,11,11,14,40,54,-14,44
SV Josko Rie,5262,8,9,9,18,36,50,-14,36
St. Pölten,5262,9,8,12,16,39,59,-20,36
Mattersburg,5262,10,7,8,21,33,65,-32,29
FC Salzburg,5263,1,23,8,5,74,24,50,77
SK Sturm Gra,5263,2,19,7,10,60,37,23,64
SC Rheindorf,5263,3,17,7,12,53,46,7,58
Rapid Vienna,5263,4,15,10,11,52,38,14,55
RZ Pellets W,5263,5,15,8,13,50,46,4,53
Vienna,5263,6,15,6,15,51,60,-9,51
Admira Wacke,5263,7,13,8,15,46,54,-8,47
SV Josko Rie,5263,8,9,7,20,33,57,-24,34
Mattersburg,5263,9,7,10,19,38,63,-25,31
St. Pölten,5263,10,7,9,20,39,71,-32,30
FC Salzburg,5264,1,25,7,4,68,25,43,82
SK Sturm Gra,5264,2,20,5,11,68,35,33,65
Vienna,5264,3,17,6,13,60,49,11,57
SC Rheindorf,5264,4,16,7,13,50,45,5,55
Rapid Vienna,5264,5,13,12,11,53,42,11,51
Admira Wacke,5264,6,13,6,17,39,56,-17,45
RZ Pellets W,5264,7,12,7,17,41,56,-15,43
St. Pölten,5264,8,11,8,17,44,60,-16,41
SV Josko Rie,5264,9,10,4,22,26,57,-31,34
Mattersburg,5264,10,8,8,20,38,62,-24,32
FC Salzburg,5265,1,21,8,7,66,31,35,71
SC Rheindorf,5265,2,20,7,9,58,40,18,67
SK Sturm Gra,5265,3,19,7,10,57,35,22,64
Vienna,5265,4,17,2,17,58,52,6,53
Rapid Vienna,5265,5,13,12,11,60,46,14,51
RZ Pellets W,5265,6,13,7,16,48,56,-8,46
Mattersburg,5265,7,12,6,18,39,52,-13,42
Admira Wacke,5265,8,11,8,17,39,59,-20,41
St. Pölten,5265,9,9,8,19,44,70,-26,35
SV Josko Rie,5265,10,10,5,21,28,56,-28,35
FC Salzburg,5266,1,21,9,6,66,31,35,72
SK Sturm Gra,5266,2,17,10,9,67,45,22,61
SC Rheindorf,5266,3,18,7,11,59,49,10,61
Vienna,5266,4,18,7,11,58,51,7,61
Rapid Vienna,5266,5,12,13,11,49,37,12,49
RZ Pellets W,5266,6,13,9,14,49,55,-6,48
SV Josko Rie,5266,7,12,7,17,36,47,-11,43
St. Pölten,5266,8,8,11,17,51,72,-21,35
Admira Wacke,5266,9,9,7,20,36,65,-29,34
Mattersburg,5266,10,7,10,19,37,56,-19,31
SC Rheindorf,5267,1,21,8,7,58,38,20,71
SK Sturm Gra,5267,2,21,5,10,66,34,32,68
FC Salzburg,5267,3,19,6,11,60,36,24,63
Vienna,5267,4,19,4,13,63,52,11,61
Rapid Vienna,5267,5,17,8,11,61,41,20,59
RZ Pellets W,5267,6,14,5,17,52,62,-10,47
Admira Wacke,5267,7,12,5,19,34,57,-23,41
St. Pölten,5267,8,9,8,19,41,68,-27,35
SV Josko Rie,5267,9,9,6,21,38,64,-26,33
Mattersburg,5267,10,8,7,21,40,61,-21,31
FC Salzburg,5268,1,23,8,5,69,27,42,77
Rapid Vienna,5268,2,17,11,8,69,40,29,62
SK Sturm Gra,5268,3,17,9,10,56,41,15,60
SC Rheindorf,5268,4,17,8,11,55,44,11,59
Vienna,5268,5,17,6,13,60,49,11,57
Admira Wacke,5268,6,14,6,16,44,62,-18,48
RZ Pellets W,5268,7,11,8,17,53,61,-8,41
SV Josko Rie,5268,8,11,4,21,38,62,-24,37
Mattersburg,5268,9,8,7,21,40,68,-28,31
St. Pölten,5268,10,7,9,20,39,69,-30,30
FC Salzburg,5269,1,20,7,9,66,37,29,67
SK Sturm Gra,5269,2,20,6,10,56,31,25,66
Vienna,5269,3,20,2,14,56,43,13,62
SC Rheindorf,5269,4,18,8,10,47,41,6,62
Rapid Vienna,5269,5,17,9,10,61,35,26,60
Mattersburg,5269,6,12,7,17,43,55,-12,43
SV Josko Rie,5269,7,12,5,19,36,52,-16,41
Admira Wacke,5269,8,11,5,20,33,64,-31,38
RZ Pellets W,5269,9,11,4,21,43,60,-17,37
St. Pölten,5269,10,8,9,19,42,65,-23,33
FC Salzburg,5270,1,21,7,8,64,32,32,70
Vienna,5270,2,22,3,11,67,47,20,69
SK Sturm Gra,5270,3,18,11,7,61,33,28,65
SC Rheindorf,5270,4,15,8,13,51,53,-2,53
Rapid Vienna,5270,5,12,15,9,52,36,16,51
Admira Wacke,5270,6,12,7,17,36,61,-25,43
St. Pölten,5270,7,9,13,14,47,60,-13,40
RZ Pellets W,5270,8,10,9,17,43,56,-13,39
Mattersburg,5270,9,9,9,18,37,54,-17,36
SV Josko Rie,5270,10,8,6,22,32,58,-26,30
FC Salzburg,5271,1,23,7,6,74,27,47,76
SK Sturm Gra,5271,2,20,6,10,61,33,28,66
SC Rheindorf,5271,3,20,6,10,53,35,18,66
Vienna,5271,4,19,4,13,66,53,13,61
Rapid Vienna,5271,5,13,12,11,49,39,10,51
RZ Pellets W,5271,6,12,10,14,46,54,-8,46
SV Josko Rie,5271,7,12,5,19,36,52,-16,41
Admira Wacke,5271,8,11,6,19,40,64,-24,39
Mattersburg,5271,9,7,8,21,30,65,-35,29
St. Pölten,5271,10,6,10,20,37,70,-33,28
FC Salzburg,5272,1,20,7,9,63,32,31,67
SC Rheindorf,5272,2,19,8,9,58,46,12,65
Vienna,5272,3,20,5,11,59,50,9,65
SK Sturm Gra,5272,4,17,8,11,58,35,23,59
Rapid Vienna,5272,5,13,14,9,61,41,20,53
RZ Pellets W,5272,6,13,6,17,48,57,-9,45
Admira Wacke,5272,7,12,5,19,35,58,-23,41
St. Pölten,5272,8,11,7,18,47,63,-16,40
SV Josko Rie,5272,9,10,6,20,34,55,-21,36
Mattersburg,5272,10,7,10,19,36,62,-26,31
FC Salzburg,5273,1,21,8,7,71,28,43,71
SC Rheindorf,5273,2,19,6,11,55,44,11,63
SK Sturm Gra,5273,3,18,7,11,53,30,23,61
Vienna,5273,4,18,6,12,64,54,10,60
Rapid Vienna,5273,5,14,13,9,61,48,13,55
RZ Pellets W,5273,6,14,6,16,50,55,-5,48
Admira Wacke,5273,7,11,6,19,38,66,-28,39
Mattersburg,5273,8,10,7,19,35,52,-17,37
St. Pölten,5273,9,10,7,19,45,72,-27,37
SV Josko Rie,5273,10,10,4,22,35,58,-23,34
SC Rheindorf,5274,1,20,8,8,57,39,18,68
SK Sturm Gra,5274,2,20,7,9,56,30,26,67
Vienna,5274,3,19,7,10,67,51,16,64
FC Salzburg,5274,4,18,9,9,63,39,24,63
Rapid Vienna,5274,5,16,13,7,67,37,30,61
Mattersburg,5274,6,11,9,16,52,60,-8,42
RZ Pellets W,5274,7,12,6,18,49,69,-20,42
St. Pölten,5274,8,9,8,19,46,73,-27,35
Admira Wacke,5274,9,8,8,20,38,68,-30,32
SV Josko Rie,5274,10,8,3,25,29,58,-29,27
SK Sturm Gra,5275,1,22,5,9,61,29,32,71
SC Rheindorf,5275,2,21,8,7,51,35,16,71
FC Salzburg,5275,3,20,5,11,60,35,25,65
Vienna,5275,4,19,5,12,56,44,12,62
Rapid Vienna,5275,5,14,9,13,59,48,11,51
SV Josko Rie,5275,6,13,6,17,39,48,-9,45
RZ Pellets W,5275,7,12,8,16,48,58,-10,44
Mattersburg,5275,8,9,10,17,45,53,-8,37
Admira Wacke,5275,9,10,5,21,33,64,-31,35
St. Pölten,5275,10,6,7,23,33,71,-38,25
FC Salzburg,5276,1,24,6,6,78,32,46,78
SC Rheindorf,5276,2,23,5,8,55,35,20,74
SK Sturm Gra,5276,3,21,7,8,68,30,38,70
Vienna,5276,4,18,5,13,62,54,8,59
RZ Pellets W,5276,5,12,8,16,44,59,-15,44
Admira Wacke,5276,6,13,4,19,36,58,-22,43
Rapid Vienna,5276,7,9,11,16,50,50,0,38
St. Pölten,5276,8,7,12,17,42,65,-23,33
Mattersburg,5276,9,8,9,19,41,67,-26,33
SV Josko Rie,5276,10,10,3,23,33,59,-26,33
FC Salzburg,5277,1,21,6,9,65,36,29,69
SC Rheindorf,5277,2,21,5,10,58,41,17,68
SK Sturm Gra,5277,3,20,5,11,63,35,28,65
Vienna,5277,4,17,4,15,59,59,0,55
RZ Pellets W,5277,5,15,6,15,48,53,-5,51
Rapid Vienna,5277,6,13,10,13,50,42,8,49
Mattersburg,5277,7,11,9,16,39,50,-11,42
SV Josko Rie,5277,8,11,6,19,31,47,-16,39
Admira Wacke,5277,9,9,8,19,32,60,-28,35
St. Pölten,5277,10,8,9,19,37,59,-22,33
FC Salzburg,5278,1,21,6,9,70,40,30,69
SC Rheindorf,5278,2,21,6,9,54,35,19,69
SK Sturm Gra,5278,3,18,8,10,61,38,23,62
Vienna,5278,4,18,4,14,66,54,12,58
RZ Pellets W,5278,5,13,9,14,47,56,-9,48
Admira Wacke,5278,6,13,9,14,38,50,-12,48
Rapid Vienna,5278,7,12,8,16,56,53,3,44
Mattersburg,5278,8,10,8,18,40,58,-18,38
SV Josko Rie,5278,9,11,2,23,28,52,-24,35
St. Pölten,5278,10,8,10,18,42,66,-24,34
FC Salzburg,5279,1,25,4,7,69,28,41,79
SC Rheindorf,5279,2,19,7,10,55,43,12,64
Vienna,5279,3,19,5,12,66,55,11,62
SK Sturm Gra,5279,4,18,6,12,59,35,24,60
Rapid Vienna,5279,5,15,10,11,59,39,20,55
RZ Pellets W,5279,6,12,8,16,43,57,-14,44
Admira Wacke,5279,7,10,7,19,33,61,-28,37
Mattersburg,5279,8,10,6,20,37,61,-24,36
St. Pölten,5279,9,8,11,17,41,58,-17,35
SV Josko Rie,5279,10,10,4,22,33,58,-25,34
FC Salzburg,5280,1,21,6,9,61,34,27,69
SK Sturm Gra,5280,2,20,5,11,62,36,26,65
Vienna,5280,3,17,9,10,59,55,4,60
SC Rheindorf,5280,4,16,9,11,52,45,7,57
RZ Pellets W,5280,5,14,8,14,57,52,5,50
Rapid Vienna,5280,6,13,9,14,53,41,12,48
SV Josko Rie,5280,7,12,5,19,35,49,-14,41
St. Pölten,5280,8,11,7,18,41,62,-21,40
Admira Wacke,5280,9,11,7,18,37,63,-26,40
Mattersburg,5280,10,8,9,19,35,55,-20,33
SK Sturm Gra,5281,1,21,6,9,66,33,33,69
SC Rheindorf,5281,2,19,9,8,58,43,15,66
FC Salzburg,5281,3,16,13,7,64,32,32,61
Vienna,5281,4,17,6,13,57,51,6,57
Rapid Vienna,5281,5,12,14,10,54,40,14,50
Admira Wacke,5281,6,11,9,16,33,58,-25,42
Mattersburg,5281,7,10,11,15,37,48,-11,41
RZ Pellets W,5281,8,10,7,19,38,52,-14,37
SV Josko Rie,5281,9,9,8,19,33,60,-27,35
St. Pölten,5281,10,7,13,16,34,57,-23,34
Vienna,5282,1,24,3,9,71,45,26,75
SC Rheindorf,5282,2,19,10,7,53,36,17,67
FC Salzburg,5282,3,18,6,12,57,35,22,60
Rapid Vienna,5282,4,15,9,12,58,43,15,54
SK Sturm Gra,5282,5,16,5,15,50,40,10,53
St. Pölten,5282,6,10,12,14,47,57,-10,42
Admira Wacke,5282,7,11,8,17,34,62,-28,41
SV Josko Rie,5282,8,10,8,18,34,53,-19,38
RZ Pellets W,5282,9,10,7,19,38,55,-17,37
Mattersburg,5282,10,8,10,18,37,53,-16,34
FC Salzburg,5283,1,21,8,7,64,29,35,71
SC Rheindorf,5283,2,20,8,8,54,35,19,68
SK Sturm Gra,5283,3,20,5,11,57,35,22,65
Vienna,5283,4,18,6,12,56,50,6,60
Rapid Vienna,5283,5,13,12,11,52,42,10,51
Admira Wacke,5283,6,12,9,15,40,54,-14,45
SV Josko Rie,5283,7,11,4,21,36,61,-25,37
RZ Pellets W,5283,8,10,6,20,43,59,-16,36
Mattersburg,5283,9,9,8,19,40,56,-16,35
St. Pölten,5283,10,8,10,18,48,69,-21,34
Vienna,5284,1,24,4,8,69,47,22,76
FC Salzburg,5284,2,19,10,7,63,30,33,67
SK Sturm Gra,5284,3,18,6,12,58,42,16,60
SC Rheindorf,5284,4,17,8,11,56,44,12,59
RZ Pellets W,5284,5,15,7,14,54,47,7,52
Rapid Vienna,5284,6,11,8,17,51,54,-3,41
St. Pölten,5284,7,10,11,15,48,60,-12,41
Mattersburg,5284,8,10,9,17,40,58,-18,39
SV Josko Rie,5284,9,9,7,20,33,55,-22,34
Admira Wacke,5284,10,8,8,20,30,65,-35,32
FC Salzburg,5285,1,23,8,5,68,29,39,77
SC Rheindorf,5285,2,20,7,9,57,41,16,67
SK Sturm Gra,5285,3,17,7,12,56,41,15,58
Vienna,5285,4,15,6,15,53,51,2,51
Admira Wacke,5285,5,13,10,13,41,50,-9,49
Rapid Vienna,5285,6,11,13,12,49,46,3,46
RZ Pellets W,5285,7,11,8,17,43,55,-12,41
Mattersburg,5285,8,10,8,18,44,59,-15,38
SV Josko Rie,5285,9,10,6,20,40,59,-19,36
St. Pölten,5285,10,9,9,18,45,65,-20,36
FC Salzburg,5286,1,22,4,10,62,31,31,70
SC Rheindorf,5286,2,20,7,9,58,42,16,67
SK Sturm Gra,5286,3,18,7,11,57,34,23,61
Vienna,5286,4,19,4,13,67,58,9,61
RZ Pellets W,5286,5,15,5,16,52,55,-3,50
Rapid Vienna,5286,6,13,10,13,49,40,9,49
Admira Wacke,5286,7,14,5,17,40,58,-18,47
St. Pölten,5286,8,11,8,17,47,62,-15,41
Mattersburg,5286,9,8,8,20,33,58,-25,32
SV Josko Rie,5286,10,8,6,22,34,61,-27,30
FC Salzburg,5287,1,22,9,5,70,28,42,75
SK Sturm Gra,5287,2,19,7,10,63,36,27,64
SC Rheindorf,5287,3,17,8,11,57,51,6,59
Vienna,5287,4,17,5,14,62,56,6,56
Rapid Vienna,5287,5,12,12,12,51,41,10,48
Admira Wacke,5287,6,13,5,18,36,63,-27,44
St. Pölten,5287,7,11,7,18,41,57,-16,40
Mattersburg,5287,8,9,12,15,43,55,-12,39
SV Josko Rie,5287,9,12,3,21,33,52,-19,39
RZ Pellets W,5287,10,10,8,18,40,57,-17,38
SK Sturm Gra,5288,1,25,4,7,69,30,39,79
FC Salzburg,5288,2,19,7,10,64,36,28,64
SC Rheindorf,5288,3,19,7,10,55,43,12,64
Rapid Vienna,5288,4,16,11,9,64,37,27,59
Vienna,5288,5,16,9,11,53,46,7,57
RZ Pellets W,5288,6,12,8,16,43,55,-12,44
Mattersburg,5288,7,9,12,15,38,54,-16,39
Admira Wacke,5288,8,10,7,19,32,56,-24,37
SV Josko Rie,5288,9,8,5,23,27,55,-28,29
St. Pölten,5288,10,7,8,21,38,71,-33,29
FC Salzburg,5289,1,22,6,8,66,30,36,72
SK Sturm Gra,5289,2,19,7,10,60,39,21,64
SC Rheindorf,5289,3,19,7,10,55,45,10,64
Vienna,5289,4,18,6,12,61,54,7,60
Rapid Vienna,5289,5,15,10,11,57,42,15,55
RZ Pellets W,5289,6,14,7,15,49,52,-3,49
SV Josko Rie,5289,7,13,4,19,36,50,-14,43
Mattersburg,5289,8,9,7,20,40,58,-18,34
St. Pölten,5289,9,9,7,20,40,67,-27,34
Admira Wacke,5289,10,9,5,22,33,60,-27,32
FC Salzburg,5290,1,20,10,6,64,29,35,70
SC Rheindorf,5290,2,21,7,8,57,38,19,70
Vienna,5290,3,20,5,11,65,47,18,65
SK Sturm Gra,5290,4,18,10,8,55,30,25,64
Rapid Vienna,5290,5,13,9,14,57,46,11,48
RZ Pellets W,5290,6,12,11,13,51,54,-3,47
SV Josko Rie,5290,7,10,7,19,42,64,-22,37
Admira Wacke,5290,8,10,7,19,36,63,-27,37
St. Pölten,5290,9,8,9,19,41,66,-25,33
Mattersburg,5290,10,6,9,21,30,61,-31,27
SK Sturm Gra,5291,1,22,5,9,71,37,34,71
SC Rheindorf,5291,2,19,9,8,52,40,12,66
FC Salzburg,5291,3,20,5,11,64,32,32,65
Vienna,5291,4,18,5,13,58,51,7,59
Rapid Vienna,5291,5,12,12,12,49,40,9,48
SV Josko Rie,5291,6,13,5,18,36,46,-10,44
RZ Pellets W,5291,7,11,11,14,44,56,-12,44
St. Pölten,5291,8,9,9,18,42,63,-21,36
Admira Wacke,5291,9,9,8,19,38,67,-29,35
Mattersburg,5291,10,7,11,18,39,61,-22,32
FC Salzburg,5292,1,23,7,6,72,31,41,76
SK Sturm Gra,5292,2,19,9,8,61,30,31,66
SC Rheindorf,5292,3,16,8,12,50,49,1,56
Vienna,5292,4,16,6,14,56,52,4,54
Rapid Vienna,5292,5,13,12,11,58,49,9,51
RZ Pellets W,5292,6,13,7,16,47,54,-7,46
SV Josko Rie,5292,7,11,9,16,37,46,-9,42
Mattersburg,5292,8,11,7,18,37,50,-13,40
St. Pölten,5292,9,8,10,18,40,67,-27,34
Admira Wacke,5292,10,8,9,19,29,59,-30,33
SK Sturm Gra,5293,1,19,8,9,51,29,22,65
Vienna,5293,2,20,5,11,59,44,15,65
SC Rheindorf,5293,3,20,5,11,54,42,12,65
FC Salzburg,5293,4,19,7,10,66,35,31,64
Rapid Vienna,5293,5,14,12,10,59,38,21,54
RZ Pellets W,5293,6,11,9,16,46,55,-9,42
Mattersburg,5293,7,10,10,16,38,51,-13,40
Admira Wacke,5293,8,11,6,19,36,64,-28,39
SV Josko Rie,5293,9,11,4,21,35,55,-20,37
St. Pölten,5293,10,7,10,19,43,74,-31,31
FC Salzburg,5294,1,20,11,5,66,28,38,71
Vienna,5294,2,21,5,10,66,46,20,68
SK Sturm Gra,5294,3,20,7,9,60,31,29,67
Rapid Vienna,5294,4,14,11,11,51,39,12,53
SC Rheindorf,5294,5,14,9,13,46,49,-3,51
SV Josko Rie,5294,6,13,6,17,33,43,-10,45
RZ Pellets W,5294,7,12,6,18,48,61,-13,42
Admira Wacke,5294,8,12,6,18,34,54,-20,42
St. Pölten,5294,9,8,9,19,38,65,-27,33
Mattersburg,5294,10,5,12,19,37,63,-26,27
FC Salzburg,5295,1,20,8,8,58,30,28,68
Vienna,5295,2,22,2,12,67,52,15,68
SC Rheindorf,5295,3,20,7,9,57,41,16,67
SK Sturm Gra,5295,4,20,5,11,57,38,19,65
Rapid Vienna,5295,5,16,8,12,61,42,19,56
St. Pölten,5295,6,12,8,16,50,56,-6,44
RZ Pellets W,5295,7,13,5,18,48,61,-13,44
Admira Wacke,5295,8,12,4,20,35,66,-31,40
SV Josko Rie,5295,9,9,4,23,31,53,-22,31
Mattersburg,5295,10,7,7,22,33,58,-25,28
FC Salzburg,5296,1,21,6,9,72,38,34,69
SK Sturm Gra,5296,2,19,6,11,59,36,23,63
SC Rheindorf,5296,3,17,10,9,47,39,8,61
Rapid Vienna,5296,4,16,8,12,58,40,18,56
Vienna,5296,5,16,6,14,58,55,3,54
RZ Pellets W,5296,6,13,6,17,42,55,-13,45
Admira Wacke,5296,7,13,6,17,39,58,-19,45
Mattersburg,5296,8,10,8,18,40,58,-18,38
SV Josko Rie,5296,9,11,5,20,35,57,-22,38
St. Pölten,5296,10,8,11,17,44,58,-14,35
FC Salzburg,5297,1,21,6,9,74,39,35,69
SK Sturm Gra,5297,2,21,6,9,63,34,29,69
SC Rheindorf,5297,3,19,10,7,60,41,19,67
Vienna,5297,4,15,8,13,56,57,-1,53
Rapid Vienna,5297,5,14,10,12,59,36,23,52
RZ Pellets W,5297,6,12,9,15,48,60,-12,45
Admira Wacke,5297,7,12,8,16,40,57,-17,44
Mattersburg,5297,8,9,11,16,44,58,-14,38
SV Josko Rie,5297,9,9,6,21,29,54,-25,33
St. Pölten,5297,10,5,12,19,37,74,-37,27
FC Salzburg,5298,1,21,8,7,71,29,42,71
SC Rheindorf,5298,2,19,7,10,56,41,15,64
SK Sturm Gra,5298,3,17,7,12,53,33,20,58
Vienna,5298,4,18,3,15,60,64,-4,57
RZ Pellets W,5298,5,14,10,12,48,45,3,52
Rapid Vienna,5298,6,13,12,11,59,40,19,51
SV Josko Rie,5298,7,14,5,17,34,46,-12,47
Admira Wacke,5298,8,9,9,18,27,51,-24,36
Mattersburg,5298,9,8,11,17,41,58,-17,35
St. Pölten,5298,10,7,8,21,33,75,-42,29
FC Salzburg,5299,1,20,9,7,64,32,32,69
SC Rheindorf,5299,2,20,7,9,67,51,16,67
Vienna,5299,3,19,8,9,65,42,23,65
SK Sturm Gra,5299,4,16,6,14,62,49,13,54
Rapid Vienna,5299,5,13,14,9,52,39,13,53
RZ Pellets W,5299,6,14,7,15,47,56,-9,49
SV Josko Rie,5299,7,11,6,19,42,56,-14,39
Admira Wacke,5299,8,10,8,18,32,58,-26,38
St. Pölten,5299,9,7,12,17,42,67,-25,33
Mattersburg,5299,10,7,9,20,38,61,-23,30
FC Salzburg,5300,1,21,8,7,63,27,36,71
SK Sturm Gra,5300,2,19,7,10,60,36,24,64
Vienna,5300,3,17,10,9,65,50,15,61
SC Rheindorf,5300,4,16,10,10,48,43,5,58
Rapid Vienna,5300,5,15,9,12,59,40,19,54
RZ Pellets W,5300,6,14,6,16,46,60,-14,48
SV Josko Rie,5300,7,12,9,15,40,49,-9,45
St. Pölten,5300,8,10,8,18,40,60,-20,38
Mattersburg,5300,9,7,9,20,39,60,-21,30
Admira Wacke,5300,10,7,8,21,32,67,-35,29
FC Salzburg,5301,1,22,5,9,66,36,30,71
SC Rheindorf,5301,2,22,5,9,57,38,19,71
SK Sturm Gra,5301,3,21,5,10,66,34,32,68
Vienna,5301,4,18,3,15,58,56,2,57
Rapid Vienna,5301,5,14,13,9,63,43,20,55
Admira Wacke,5301,6,12,6,18,39,61,-22,42
RZ Pellets W,5301,7,11,6,19,49,61,-12,39
SV Josko Rie,5301,8,11,6,19,36,54,-18,39
Mattersburg,5301,9,8,9,19,38,63,-25,33
St. Pölten,5301,10,8,8,20,40,66,-26,32
SC Rheindorf,5302,1,21,8,7,66,45,21,71
SK Sturm Gra,5302,2,21,6,9,57,29,28,69
FC Salzburg,5302,3,20,8,8,64,43,21,68
Rapid Vienna,5302,4,19,7,10,68,32,36,64
Vienna,5302,5,17,4,15,63,56,7,55
RZ Pellets W,5302,6,13,9,14,52,57,-5,48
Mattersburg,5302,7,9,9,18,39,55,-16,36
SV Josko Rie,5302,8,10,5,21,29,54,-25,35
Admira Wacke,5302,9,10,5,21,34,65,-31,35
St. Pölten,5302,10,5,9,22,36,72,-36,24
FC Salzburg,5303,1,24,6,6,63,25,38,78
SK Sturm Gra,5303,2,21,4,11,61,37,24,67
SC Rheindorf,5303,3,19,7,10,58,42,16,64
Vienna,5303,4,19,5,12,61,48,13,62
Rapid Vienna,5303,5,14,10,12,60,49,11,52
RZ Pellets W,5303,6,15,6,15,50,57,-7,51
SV Josko Rie,5303,7,12,4,20,34,51,-17,40
St. Pölten,5303,8,9,8,19,41,66,-25,35
Admira Wacke,5303,9,10,4,22,33,61,-28,34
Mattersburg,5303,10,6,8,22,32,57,-25,26
FC Salzburg,5304,1,23,5,8,74,31,43,74
SC Rheindorf,5304,2,19,9,8,51,35,16,66
SK Sturm Gra,5304,3,17,9,10,53,31,22,60
Vienna,5304,4,17,7,12,54,45,9,58
Rapid Vienna,5304,5,13,11,12,53,42,11,50
Admira Wacke,5304,6,14,6,16,38,54,-16,48
RZ Pellets W,5304,7,10,10,16,41,55,-14,40
SV Josko Rie,5304,8,12,3,21,30,54,-24,39
Mattersburg,5304,9,8,11,17,34,50,-16,35
St. Pölten,5304,10,6,11,19,39,70,-31,29
SK Sturm Gra,5305,1,20,7,9,62,36,26,67
SC Rheindorf,5305,2,18,8,10,51,42,9,62
Vienna,5305,3,18,5,13,61,53,8,59
FC Salzburg,5305,4,16,9,11,63,44,19,57
Rapid Vienna,5305,5,13,12,11,64,43,21,51
SV Josko Rie,5305,6,15,3,18,43,53,-10,48
RZ Pellets W,5305,7,12,8,16,46,59,-13,44
Admira Wacke,5305,8,11,7,18,40,57,-17,40
Mattersburg,5305,9,11,7,18,40,58,-18,40
St. Pölten,5305,10,8,10,18,40,65,-25,34
FC Salzburg,5306,1,23,8,5,68,31,37,77
SK Sturm Gra,5306,2,21,4,11,58,27,31,67
SC Rheindorf,5306,3,19,7,10,66,48,18,64
Vienna,5306,4,17,7,12,57,48,9,58
Rapid Vienna,5306,5,13,11,12,49,43,6,50
RZ Pellets W,5306,6,13,6,17,43,47,-4,45
Admira Wacke,5306,7,12,6,18,38,61,-23,42
Mattersburg,5306,8,10,8,18,41,58,-17,38
SV Josko Rie,5306,9,11,5,20,35,54,-19,38
St. Pölten,5306,10,5,10,21,32,70,-38,25
FC Salzburg,5307,1,19,7,10,57,33,24,64
Vienna,5307,2,18,7,11,60,50,10,61
SC Rheindorf,5307,3,17,10,9,48,38,10,61
Rapid Vienna,5307,4,14,10,12,55,39,16,52
SK Sturm Gra,5307,5,15,7,14,50,41,9,52
St. Pölten,5307,6,12,10,14,41,53,-12,46
RZ Pellets W,5307,7,13,5,18,46,53,-7,44
Admira Wacke,5307,8,12,7,17,31,53,-22,43
SV Josko Rie,5307,9,11,7,18,35,49,-14,40
Mattersburg,5307,10,9,10,17,39,53,-14,37
SC Rheindorf,5308,1,21,7,8,58,40,18,70
FC Salzburg,5308,2,20,8,8,63,36,27,68
SK Sturm Gra,5308,3,18,5,13,51,32,19,59
Vienna,5308,4,18,5,13,60,52,8,59
Rapid Vienna,5308,5,14,12,10,53,36,17,54
RZ Pellets W,5308,6,12,7,17,55,71,-16,43
St. Pölten,5308,7,10,11,15,46,61,-15,41
SV Josko Rie,5308,8,12,3,21,34,53,-19,39
Admira Wacke,5308,9,11,6,19,43,63,-20,39
Mattersburg,5308,10,8,8,20,43,62,-19,32
SC Rheindorf,5309,1,23,7,6,52,31,21,76
FC Salzburg,5309,2,17,12,7,58,31,27,63
SK Sturm Gra,5309,3,17,8,11,58,36,22,59
Vienna,5309,4,16,4,16,58,53,5,52
Rapid Vienna,5309,5,13,12,11,58,41,17,51
RZ Pellets W,5309,6,12,8,16,49,67,-18,44
Admira Wacke,5309,7,12,6,18,45,69,-24,42
Mattersburg,5309,8,10,9,17,42,54,-12,39
SV Josko Rie,5309,9,11,6,19,36,54,-18,39
St. Pölten,5309,10,8,10,18,38,58,-20,34
SK Sturm Gra,5310,1,21,7,8,60,31,29,70
FC Salzburg,5310,2,20,9,7,69,30,39,69
SC Rheindorf,5310,3,20,6,10,58,41,17,66
Rapid Vienna,5310,4,16,10,10,65,42,23,58
Vienna,5310,5,17,6,13,60,53,7,57
SV Josko Rie,5310,6,12,6,18,30,44,-14,42
Admira Wacke,5310,7,12,6,18,40,61,-21,42
St. Pölten,5310,8,10,8,18,44,66,-22,38
RZ Pellets W,5310,9,9,9,18,37,59,-22,36
Mattersburg,5310,10,5,9,22,26,62,-36,24
Vienna,5311,1,21,5,10,73,50,23,68
FC Salzburg,5311,2,20,7,9,67,35,32,67
SC Rheindorf,5311,3,20,7,9,54,42,12,67
SK Sturm Gra,5311,4,18,6,12,57,40,17,60
Rapid Vienna,5311,5,11,15,10,50,42,8,48
RZ Pellets W,5311,6,13,7,16,42,49,-7,46
SV Josko Rie,5311,7,11,8,17,41,54,-13,41
Admira Wacke,5311,8,10,7,19,34,59,-25,37
St. Pölten,5311,9,7,14,15,43,65,-22,35
Mattersburg,5311,10,7,8,21,37,62,-25,29
FC Salzburg,5312,1,23,6,7,70,33,37,75
SK Sturm Gra,5312,2,19,5,12,57,43,14,62
Rapid Vienna,5312,3,16,10,10,59,40,19,58
SC Rheindorf,5312,4,16,8,12,48,43,5,56
Vienna,5312,5,16,7,13,54,52,2,55
RZ Pellets W,5312,6,13,9,14,50,49,1,48
Mattersburg,5312,7,10,9,17,38,52,-14,39
SV Josko Rie,5312,8,11,5,20,34,51,-17,38
St. Pölten,5312,9,9,10,17,43,62,-19,37
Admira Wacke,5312,10,10,5,21,36,64,-28,35
FC Salzburg,5313,1,21,10,5,65,29,36,73
SK Sturm Gra,5313,2,21,5,10,65,40,25,68
SC Rheindorf,5313,3,19,7,10,57,46,11,64
Vienna,5313,4,17,5,14,60,49,11,56
Admira Wacke,5313,5,14,9,13,39,47,-8,51
Rapid Vienna,5313,6,11,12,13,48,43,5,45
RZ Pellets W,5313,7,13,4,19,46,59,-13,43
SV Josko Rie,5313,8,12,7,17,34,47,-13,43
Mattersburg,5313,9,8,9,19,35,58,-23,33
St. Pölten,5313,10,5,10,21,37,68,-31,25
FC Salzburg,5314,1,19,10,7,67,37,30,67
SK Sturm Gra,5314,2,18,10,8,63,33,30,64
Vienna,5314,3,18,7,11,64,50,14,61
SC Rheindorf,5314,4,18,6,12,52,46,6,60
Rapid Vienna,5314,5,14,14,8,60,36,24,56
RZ Pellets W,5314,6,12,9,15,49,58,-9,45
Mattersburg,5314,7,9,9,18,50,69,-19,36
SV Josko Rie,5314,8,10,6,20,35,55,-20,36
St. Pölten,5314,9,10,6,20,41,68,-27,36
Admira Wacke,5314,10,9,9,18,45,74,-29,36
FC Salzburg,5315,1,24,6,6,68,26,42,78
SK Sturm Gra,5315,2,21,7,8,65,37,28,70
SC Rheindorf,5315,3,20,9,7,59,37,22,69
Vienna,5315,4,15,8,13,54,55,-1,53
RZ Pellets W,5315,5,14,9,13,55,56,-1,51
Rapid Vienna,5315,6,12,10,14,55,48,7,46
SV Josko Rie,5315,7,10,7,19,35,56,-21,37
Admira Wacke,5315,8,11,4,21,39,63,-24,37
St. Pölten,5315,9,6,12,18,38,70,-32,30
Mattersburg,5315,10,6,10,20,39,59,-20,28
SK Sturm Gra,5316,1,19,5,12,57,36,21,62
SC Rheindorf,5316,2,18,8,10,54,41,13,62
Vienna,5316,3,19,3,14,69,52,17,60
FC Salzburg,5316,4,17,8,11,55,31,24,59
Admira Wacke,5316,5,17,6,13,42,51,-9,57
Rapid Vienna,5316,6,13,12,11,57,44,13,51
RZ Pellets W,5316,7,12,7,17,42,53,-11,43
Mattersburg,5316,8,10,10,16,36,54,-18,40
SV Josko Rie,5316,9,11,5,20,32,52,-20,38
St. Pölten,5316,10,8,8,20,35,65,-30,32
FC Salzburg,5317,1,18,11,7,71,36,35,65
SK Sturm Gra,5317,2,19,5,12,61,35,26,62
SC Rheindorf,5317,3,17,8,11,53,46,7,59
Rapid Vienna,5317,4,15,11,10,61,37,24,56
Vienna,5317,5,16,5,15,57,58,-1,53
Mattersburg,5317,6,13,7,16,40,54,-14,46
SV Josko Rie,5317,7,12,7,17,38,58,-20,43
RZ Pellets W,5317,8,10,10,16,50,58,-8,40
Admira Wacke,5317,9,10,10,16,39,62,-23,40
St. Pölten,5317,10,8,10,18,35,61,-26,34
FC Salzburg,5318,1,20,10,6,63,27,36,70
SC Rheindorf,5318,2,19,8,9,51,42,9,65
SK Sturm Gra,5318,3,19,7,10,66,34,32,64
Vienna,5318,4,20,3,13,59,50,9,63
RZ Pellets W,5318,5,12,7,17,38,49,-11,43
Mattersburg,5318,6,12,7,17,45,57,-12,43
Admira Wacke,5318,7,12,7,17,41,55,-14,43
Rapid Vienna,5318,8,9,13,14,44,43,1,40
SV Josko Rie,5318,9,11,5,20,31,55,-24,38
St. Pölten,5318,10,8,9,19,38,64,-26,33
FC Salzburg,5319,1,24,6,6,67,26,41,78
SC Rheindorf,5319,2,20,9,7,55,41,14,69
SK Sturm Gra,5319,3,18,7,11,53,31,22,61
Vienna,5319,4,18,4,14,62,51,11,58
Rapid Vienna,5319,5,11,13,12,55,50,5,46
Admira Wacke,5319,6,12,6,18,40,58,-18,42
RZ Pellets W,5319,7,9,12,15,41,55,-14,39
St. Pölten,5319,8,7,16,13,42,57,-15,37
SV Josko Rie,5319,9,9,6,21,36,58,-22,33
Mattersburg,5319,10,8,9,19,34,58,-24,33
FC Salzburg,5320,1,22,6,8,62,31,31,72
Vienna,5320,2,21,4,11,67,49,18,67
SC Rheindorf,5320,3,19,9,8,54,39,15,66
SK Sturm Gra,5320,4,19,6,11,55,34,21,63
Rapid Vienna,5320,5,12,16,8,57,39,18,52
SV Josko Rie,5320,6,13,6,17,36,55,-19,45
Admira Wacke,5320,7,10,8,18,41,63,-22,38
St. Pölten,5320,8,9,10,17,44,59,-15,37
RZ Pellets W,5320,9,8,9,19,41,62,-21,33
Mattersburg,5320,10,5,10,21,41,67,-26,25
FC Salzburg,5321,1,22,8,6,67,32,35,74
SC Rheindorf,5321,2,20,7,9,61,41,20,67
Vienna,5321,3,20,5,11,64,49,15,65
SK Sturm Gra,5321,4,18,6,12,54,39,15,60
Rapid Vienna,5321,5,15,11,10,62,42,20,56
RZ Pellets W,5321,6,15,7,14,52,53,-1,52
SV Josko Rie,5321,7,9,9,18,38,56,-18,36
Admira Wacke,5321,8,9,7,20,39,65,-26,34
Mattersburg,5321,9,7,8,21,35,64,-29,29
St. Pölten,5321,10,6,10,20,39,70,-31,28
SC Rheindorf,5322,1,21,7,8,54,44,10,70
FC Salzburg,5322,2,19,9,8,62,32,30,66
SK Sturm Gra,5322,3,19,6,11,59,35,24,63
Vienna,5322,4,20,3,13,63,50,13,63
Rapid Vienna,5322,5,15,12,9,54,34,20,57
RZ Pellets W,5322,6,14,5,17,44,50,-6,47
SV Josko Rie,5322,7,11,6,19,36,58,-22,39
Admira Wacke,5322,8,11,4,21,36,60,-24,37
Mattersburg,5322,9,8,8,20,37,61,-24,32
St. Pölten,5322,10,7,10,19,40,61,-21,31
FC Salzburg,5323,1,22,7,7,71,29,42,73
SC Rheindorf,5323,2,21,7,8,49,34,15,70
Vienna,5323,3,19,6,11,62,50,12,63
SK Sturm Gra,5323,4,18,7,11,59,39,20,61
Rapid Vienna,5323,5,15,8,13,55,44,11,53
RZ Pellets W,5323,6,10,9,17,46,59,-13,39
Mattersburg,5323,7,10,8,18,45,57,-12,38
SV Josko Rie,5323,8,11,5,20,42,61,-19,38
Admira Wacke,5323,9,9,8,19,37,64,-27,35
St. Pölten,5323,10,6,13,17,41,70,-29,31
FC Salzburg,5324,1,22,6,8,66,28,38,72
Vienna,5324,2,20,3,13,66,55,11,63
SK Sturm Gra,5324,3,19,5,12,63,39,24,62
Rapid Vienna,5324,4,16,9,11,60,41,19,57
SC Rheindorf,5324,5,14,9,13,48,48,0,51
Admira Wacke,5324,6,14,6,16,35,50,-15,48
Mattersburg,5324,7,11,10,15,38,52,-14,43
RZ Pellets W,5324,8,12,6,18,45,56,-11,42
SV Josko Rie,5324,9,9,8,19,34,54,-20,35
St. Pölten,5324,10,7,10,19,38,70,-32,31
SC Rheindorf,5325,1,20,10,6,59,41,18,70
FC Salzburg,5325,2,20,8,8,65,29,36,68
SK Sturm Gra,5325,3,19,10,7,62,32,30,67
Vienna,5325,4,17,7,12,60,55,5,58
Rapid Vienna,5325,5,14,13,9,64,42,22,55
RZ Pellets W,5325,6,11,7,18,48,59,-11,40
SV Josko Rie,5325,7,10,8,18,35,52,-17,38
Admira Wacke,5325,8,10,6,20,35,66,-31,36
Mattersburg,5325,9,7,13,16,39,54,-15,34
St. Pölten,5325,10,7,8,21,44,81,-37,29
FC Salzburg,5326,1,22,6,8,67,34,33,72
SC Rheindorf,5326,2,21,7,8,62,45,17,70
SK Sturm Gra,5326,3,20,8,8,68,33,35,68
Vienna,5326,4,19,4,13,69,51,18,61
SV Josko Rie,5326,5,15,5,16,45,51,-6,50
Rapid Vienna,5326,6,12,11,13,55,46,9,47
RZ Pellets W,5326,7,12,8,16,53,67,-14,44
Admira Wacke,5326,8,9,6,21,33,69,-36,33
Mattersburg,5326,9,8,7,21,38,67,-29,31
St. Pölten,5326,10,6,10,20,39,66,-27,28
FC Salzburg,5327,1,20,11,5,60,30,30,71
SC Rheindorf,5327,2,19,8,9,58,39,19,65
SK Sturm Gra,5327,3,19,6,11,58,35,23,63
Vienna,5327,4,18,6,12,59,52,7,60
Rapid Vienna,5327,5,14,11,11,59,39,20,53
RZ Pellets W,5327,6,11,8,17,45,55,-10,41
Admira Wacke,5327,7,12,5,19,36,64,-28,41
St. Pölten,5327,8,10,9,17,39,59,-20,39
SV Josko Rie,5327,9,8,10,18,39,55,-16,34
Mattersburg,5327,10,6,12,18,42,67,-25,30
FC Salzburg,5328,1,20,11,5,66,30,36,71
Vienna,5328,2,18,6,12,64,50,14,60
SC Rheindorf,5328,3,18,6,12,54,42,12,60
Rapid Vienna,5328,4,16,11,9,68,44,24,59
SK Sturm Gra,5328,5,17,7,12,55,41,14,58
RZ Pellets W,5328,6,10,11,15,49,61,-12,41
SV Josko Rie,5328,7,11,8,17,33,48,-15,41
Admira Wacke,5328,8,10,9,17,36,61,-25,39
St. Pölten,5328,9,8,10,18,46,72,-26,34
Mattersburg,5328,10,8,9,19,41,63,-22,33
SC Rheindorf,5329,1,25,5,6,61,32,29,80
FC Salzburg,5329,2,19,8,9,56,32,24,65
SK Sturm Gra,5329,3,16,11,9,56,35,21,59
Vienna,5329,4,18,4,14,75,54,21,58
Rapid Vienna,5329,5,15,12,9,65,44,21,57
SV Josko Rie,5329,6,14,3,19,37,56,-19,45
Admira Wacke,5329,7,12,4,20,39,68,-29,40
RZ Pellets W,5329,8,11,5,20,43,62,-19,38
St. Pölten,5329,9,9,9,18,41,63,-22,36
Mattersburg,5329,10,7,7,22,31,58,-27,28
FC Salzburg,5330,1,23,7,6,69,27,42,76
SK Sturm Gra,5330,2,21,5,10,61,31,30,68
SC Rheindorf,5330,3,20,6,10,56,39,17,66
Vienna,5330,4,15,5,16,51,56,-5,50
Rapid Vienna,5330,5,12,12,12,61,53,8,48
RZ Pellets W,5330,6,13,9,14,51,56,-5,48
Admira Wacke,5330,7,13,9,14,45,58,-13,48
SV Josko Rie,5330,8,10,7,19,42,59,-17,37
Mattersburg,5330,9,6,12,18,38,65,-27,30
St. Pölten,5330,10,5,12,19,38,68,-30,27
FC Salzburg,5331,1,21,9,6,70,34,36,72
SC Rheindorf,5331,2,17,8,11,52,47,5,59
Vienna,5331,3,17,6,13,59,58,1,57
Rapid Vienna,5331,4,15,11,10,59,42,17,56
SK Sturm Gra,5331,5,16,6,14,51,38,13,54
Mattersburg,5331,6,13,9,14,52,55,-3,48
Admira Wacke,5331,7,12,5,19,31,52,-21,41
St. Pölten,5331,8,10,10,16,42,56,-14,40
RZ Pellets W,5331,9,11,5,20,49,59,-10,38
SV Josko Rie,5331,10,11,5,20,33,57,-24,38
FC Salzburg,5332,1,22,8,6,70,33,37,74
SC Rheindorf,5332,2,22,7,7,56,31,25,73
SK Sturm Gra,5332,3,18,6,12,53,36,17,60
Vienna,5332,4,18,6,12,61,49,12,60
Rapid Vienna,5332,5,12,13,11,53,42,11,49
Admira Wacke,5332,6,12,7,17,42,61,-19,43
RZ Pellets W,5332,7,10,8,18,37,52,-15,38
St. Pölten,5332,8,9,8,19,37,63,-26,35
Mattersburg,5332,9,7,13,16,35,48,-13,34
SV Josko Rie,5332,10,9,6,21,34,63,-29,33
FC Salzburg,5333,1,23,7,6,66,24,42,76
SK Sturm Gra,5333,2,19,9,8,70,37,33,66
SC Rheindorf,5333,3,18,8,10,48,38,10,62
Vienna,5333,4,17,9,10,64,58,6,60
RZ Pellets W,5333,5,15,8,13,56,52,4,53
Rapid Vienna,5333,6,12,11,13,49,47,2,47
Mattersburg,5333,7,10,8,18,35,56,-21,38
Admira Wacke,5333,8,9,7,20,36,60,-24,34
SV Josko Rie,5333,9,7,11,18,38,62,-24,32
St. Pölten,5333,10,6,10,20,40,68,-28,28
FC Salzburg,5334,1,22,8,6,68,28,40,74
SK Sturm Gra,5334,2,21,5,10,63,34,29,68
Vienna,5334,3,20,3,13,61,51,10,63
SC Rheindorf,5334,4,17,5,14,49,52,-3,56
RZ Pellets W,5334,5,14,6,16,46,53,-7,48
St. Pölten,5334,6,13,7,16,47,61,-14,46
Rapid Vienna,5334,7,11,12,13,50,40,10,45
SV Josko Rie,5334,8,12,4,20,38,58,-20,40
Admira Wacke,5334,9,12,3,21,34,62,-28,39
Mattersburg,5334,10,7,9,20,38,55,-17,30
FC Salzburg,5335,1,22,8,6,72,30,42,74
SC Rheindorf,5335,2,22,6,8,61,40,21,72
SK Sturm Gra,5335,3,18,11,7,59,33,26,65
Vienna,5335,4,18,5,13,65,55,10,59
Rapid Vienna,5335,5,15,11,10,54,37,17,56
RZ Pellets W,5335,6,14,5,17,42,56,-14,47
SV Josko Rie,5335,7,11,5,20,38,50,-12,38
Admira Wacke,5335,8,10,5,21,34,70,-36,35
St. Pölten,5335,9,6,11,19,40,69,-29,29
Mattersburg,5335,10,6,9,21,34,59,-25,27
FC Salzburg,5336,1,24,7,5,72,25,47,79
SC Rheindorf,5336,2,24,6,6,65,33,32,78
SK Sturm Gra,5336,3,20,6,10,57,40,17,66
Vienna,5336,4,19,7,10,63,41,22,64
Rapid Vienna,5336,5,13,10,13,57,40,17,49
RZ Pellets W,5336,6,13,6,17,45,66,-21,45
Admira Wacke,5336,7,10,7,19,35,61,-26,37
St. Pölten,5336,8,8,9,19,43,62,-19,33
SV Josko Rie,5336,9,9,6,21,31,60,-29,33
Mattersburg,5336,10,5,6,25,30,70,-40,21
SC Rheindorf,5337,1,21,9,6,60,35,25,72
SK Sturm Gra,5337,2,20,6,10,65,40,25,66
FC Salzburg,5337,3,19,8,9,59,37,22,65
Vienna,5337,4,19,5,12,66,57,9,62
RZ Pellets W,5337,5,14,6,16,51,56,-5,48
Rapid Vienna,5337,6,11,10,15,52,45,7,43
SV Josko Rie,5337,7,12,4,20,39,57,-18,40
St. Pölten,5337,8,9,9,18,45,62,-17,36
Admira Wacke,5337,9,9,9,18,33,58,-25,36
Mattersburg,5337,10,9,8,19,40,63,-23,35
SK Sturm Gra,5338,1,21,8,7,65,29,36,71
FC Salzburg,5338,2,21,6,9,73,31,42,69
SC Rheindorf,5338,3,18,6,12,56,46,10,60
Vienna,5338,4,18,4,14,58,55,3,58
Rapid Vienna,5338,5,14,12,10,54,35,19,54
RZ Pellets W,5338,6,14,7,15,42,52,-10,49
Admira Wacke,5338,7,12,8,16,36,52,-16,44
SV Josko Rie,5338,8,10,6,20,33,60,-27,36
Mattersburg,5338,9,9,7,20,35,59,-24,34
St. Pölten,5338,10,6,10,20,33,66,-33,28
SC Rheindorf,5339,1,21,9,6,57,36,21,72
FC Salzburg,5339,2,21,7,8,67,31,36,70
SK Sturm Gra,5339,3,19,9,8,62,31,31,66
Vienna,5339,4,15,8,13,66,56,10,53
Rapid Vienna,5339,5,13,9,14,53,44,9,48
SV Josko Rie,5339,6,12,6,18,34,55,-21,42
Admira Wacke,5339,7,11,8,17,36,58,-22,41
RZ Pellets W,5339,8,10,10,16,40,58,-18,40
Mattersburg,5339,9,9,10,17,38,53,-15,37
St. Pölten,5339,10,7,8,21,39,70,-31,29
Vienna,5340,1,21,4,11,70,52,18,67
SK Sturm Gra,5340,2,19,8,9,59,32,27,65
SC Rheindorf,5340,3,19,6,11,57,48,9,63
FC Salzburg,5340,4,17,6,13,59,38,21,57
Rapid Vienna,5340,5,13,13,10,52,35,17,52
RZ Pellets W,5340,6,13,11,12,43,49,-6,50
Admira Wacke,5340,7,13,6,17,41,56,-15,45
Mattersburg,5340,8,9,9,18,44,63,-19,36
SV Josko Rie,5340,9,10,5,21,32,55,-23,35
St. Pölten,5340,10,6,12,18,39,68,-29,30
SK Sturm Gra,5341,1,21,8,7,65,35,30,71
FC Salzburg,5341,2,20,9,7,69,30,39,69
Vienna,5341,3,19,5,12,70,52,18,62
SC Rheindorf,5341,4,18,7,11,54,45,9,61
Rapid Vienna,5341,5,15,10,11,62,45,17,55
Admira Wacke,5341,6,11,10,15,38,55,-17,43
SV Josko Rie,5341,7,13,4,19,35,54,-19,43
St. Pölten,5341,8,8,11,17,42,66,-24,35
RZ Pellets W,5341,9,9,8,19,45,70,-25,35
Mattersburg,5341,10,5,10,21,32,60,-28,25
SK Sturm Gra,5342,1,21,6,9,70,35,35,69
SC Rheindorf,5342,2,21,6,9,58,33,25,69
FC Salzburg,5342,3,20,8,8,62,30,32,68
Vienna,5342,4,18,5,13,58,52,6,59
Rapid Vienna,5342,5,14,11,11,56,46,10,53
RZ Pellets W,5342,6,14,4,18,43,53,-10,46
Admira Wacke,5342,7,11,5,20,36,61,-25,38
Mattersburg,5342,8,10,7,19,38,56,-18,37
St. Pölten,5342,9,9,9,18,41,66,-25,36
SV Josko Rie,5342,10,9,5,22,30,60,-30,32
FC Salzburg,5343,1,21,6,9,67,32,35,69
SK Sturm Gra,5343,2,21,5,10,65,32,33,68
SC Rheindorf,5343,3,19,9,8,62,44,18,66
Vienna,5343,4,18,7,11,62,51,11,61
RZ Pellets W,5343,5,15,5,16,55,54,1,50
Rapid Vienna,5343,6,12,10,14,50,49,1,46
SV Josko Rie,5343,7,12,6,18,35,52,-17,42
St. Pölten,5343,8,10,11,15,49,63,-14,41
Admira Wacke,5343,9,11,4,21,37,76,-39,37
Mattersburg,5343,10,6,7,23,32,61,-29,25
SC Rheindorf,5344,1,22,6,8,61,39,22,72
FC Salzburg,5344,2,20,7,9,57,31,26,67
Vienna,5344,3,20,3,13,65,55,10,63
SK Sturm Gra,5344,4,17,9,10,55,36,19,60
Rapid Vienna,5344,5,16,10,10,64,41,23,58
Admira Wacke,5344,6,12,8,16,42,55,-13,44
RZ Pellets W,5344,7,9,10,17,42,58,-16,37
St. Pölten,5344,8,8,12,16,43,62,-19,36
Mattersburg,5344,9,8,10,18,33,54,-21,34
SV Josko Rie,5344,10,8,5,23,32,63,-31,29
Vienna,5345,1,21,5,10,64,45,19,68
SC Rheindorf,5345,2,20,8,8,49,31,18,68
FC Salzburg,5345,3,18,7,11,62,38,24,61
SK Sturm Gra,5345,4,17,8,11,53,40,13,59
RZ Pellets W,5345,5,14,7,15,49,55,-6,49
Rapid Vienna,5345,6,12,11,13,50,40,10,47
Admira Wacke,5345,7,12,9,15,40,58,-18,45
SV Josko Rie,5345,8,10,6,20,36,55,-19,36
Mattersburg,5345,9,7,13,16,33,49,-16,34
St. Pölten,5345,10,7,10,19,35,60,-25,31
FC Salzburg,5346,1,21,8,7,65,29,36,71
SK Sturm Gra,5346,2,19,10,7,60,30,30,67
SC Rheindorf,5346,3,18,8,10,48,43,5,62
Vienna,5346,4,16,9,11,60,52,8,57
RZ Pellets W,5346,5,15,8,13,55,52,3,53
SV Josko Rie,5346,6,14,4,18,41,53,-12,46
Rapid Vienna,5346,7,11,12,13,55,47,8,45
Admira Wacke,5346,8,12,7,17,37,55,-18,43
Mattersburg,5346,9,7,10,19,34,57,-23,31
St. Pölten,5346,10,4,10,22,34,71,-37,22
SC Rheindorf,5347,1,22,7,7,59,36,23,73
FC Salzburg,5347,2,21,7,8,63,27,36,70
Vienna,5347,3,18,4,14,60,52,8,58
SK Sturm Gra,5347,4,17,6,13,60,46,14,57
Rapid Vienna,5347,5,15,10,11,58,48,10,55
RZ Pellets W,5347,6,13,5,18,45,56,-11,44
Admira Wacke,5347,7,11,8,17,40,56,-16,41
SV Josko Rie,5347,8,12,4,20,33,53,-20,40
St. Pölten,5347,9,9,8,19,42,63,-21,35
Mattersburg,5347,10,8,9,19,33,56,-23,33
SC Rheindorf,5348,1,21,8,7,63,39,24,71
FC Salzburg,5348,2,20,7,9,63,31,32,67
Vienna,5348,3,19,5,12,57,49,8,62
SK Sturm Gra,5348,4,16,8,12,57,43,14,56
Rapid Vienna,5348,5,13,12,11,53,46,7,51
Admira Wacke,5348,6,12,8,16,36,50,-14,44
St. Pölten,5348,7,11,10,15,44,57,-13,43
SV Josko Rie,5348,8,12,5,19,33,47,-14,41
RZ Pellets W,5348,9,10,7,19,40,54,-14,37
Mattersburg,5348,10,6,10,20,32,62,-30,28
SC Rheindorf,5349,1,23,8,5,68,43,25,77
FC Salzburg,5349,2,18,12,6,61,31,30,66
SK Sturm Gra,5349,3,16,9,11,58,37,21,57
Vienna,5349,4,17,6,13,66,60,6,57
Rapid Vienna,5349,5,13,11,12,50,40,10,50
RZ Pellets W,5349,6,13,8,15,46,51,-5,47
Admira Wacke,5349,7,11,6,19,39,65,-26,39
St. Pölten,5349,8,9,10,17,43,62,-19,37
Mattersburg,5349,9,8,12,16,33,46,-13,36
SV Josko Rie,5349,10,7,8,21,27,56,-29,29
SK Sturm Gra,5350,1,22,7,7,70,32,38,73
FC Salzburg,5350,2,19,9,8,69,35,34,66
SC Rheindorf,5350,3,17,10,9,58,46,12,61
Vienna,5350,4,18,3,15,61,53,8,57
Rapid Vienna,5350,5,14,12,10,60,42,18,54
SV Josko Rie,5350,6,14,4,18,42,54,-12,46
RZ Pellets W,5350,7,11,8,17,45,62,-17,41
Admira Wacke,5350,8,11,6,19,34,62,-28,39
St. Pölten,5350,9,8,9,19,37,67,-30,33
Mattersburg,5350,10,8,8,20,38,61,-23,32
SK Sturm Gra,5351,1,20,8,8,61,28,33,68
Vienna,5351,2,21,4,11,69,47,22,67
FC Salzburg,5351,3,20,6,10,61,31,30,66
SC Rheindorf,5351,4,18,9,9,49,37,12,63
Rapid Vienna,5351,5,12,11,13,44,39,5,47
Admira Wacke,5351,6,13,6,17,39,59,-20,45
RZ Pellets W,5351,7,12,8,16,46,57,-11,44
St. Pölten,5351,8,10,8,18,37,67,-30,38
Mattersburg,5351,9,8,10,18,39,55,-16,34
SV Josko Rie,5351,10,9,4,23,30,55,-25,31
FC Salzburg,5352,1,21,7,8,69,29,40,70
SK Sturm Gra,5352,2,22,4,10,60,39,21,70
Vienna,5352,3,21,5,10,63,43,20,68
SC Rheindorf,5352,4,17,6,13,51,46,5,57
Rapid Vienna,5352,5,12,11,13,52,46,6,47
RZ Pellets W,5352,6,12,8,16,44,56,-12,44
SV Josko Rie,5352,7,10,10,16,36,52,-16,40
St. Pölten,5352,8,9,10,17,45,66,-21,37
Admira Wacke,5352,9,10,7,19,38,61,-23,37
Mattersburg,5352,10,8,8,20,35,55,-20,32
SC Rheindorf,5353,1,20,7,9,55,37,18,67
FC Salzburg,5353,2,19,9,8,60,31,29,66
SK Sturm Gra,5353,3,20,6,10,60,34,26,66
Vienna,5353,4,18,8,10,59,47,12,62
Rapid Vienna,5353,5,10,16,10,52,40,12,46
Admira Wacke,5353,6,12,6,18,37,56,-19,42
RZ Pellets W,5353,7,10,11,15,42,54,-12,41
St. Pölten,5353,8,10,9,17,40,63,-23,39
SV Josko Rie,5353,9,11,5,20,40,55,-15,38
Mattersburg,5353,10,8,7,21,35,63,-28,31
SK Sturm Gra,5354,1,22,6,8,59,34,25,72
FC Salzburg,5354,2,20,8,8,75,39,36,68
SC Rheindorf,5354,3,20,5,11,56,42,14,65
Vienna,5354,4,18,6,12,53,48,5,60
Rapid Vienna,5354,5,16,11,9,64,39,25,59
RZ Pellets W,5354,6,11,8,17,45,53,-8,41
St. Pölten,5354,7,10,9,17,40,62,-22,39
SV Josko Rie,5354,8,10,7,19,35,56,-21,37
Admira Wacke,5354,9,9,5,22,31,58,-27,32
Mattersburg,5354,10,8,7,21,34,61,-27,31
FC Salzburg,5355,1,19,11,6,68,30,38,68
SC Rheindorf,5355,2,20,7,9,57,36,21,67
Vienna,5355,3,17,9,10,62,46,16,60
Rapid Vienna,5355,4,15,11,10,58,40,18,56
SK Sturm Gra,5355,5,17,5,14,48,37,11,56
RZ Pellets W,5355,6,15,7,14,42,54,-12,52
SV Josko Rie,5355,7,11,7,18,31,48,-17,40
Admira Wacke,5355,8,11,7,18,39,62,-23,40
Mattersburg,5355,9,8,8,20,35,61,-26,32
St. Pölten,5355,10,5,12,19,36,62,-26,27
FC Salzburg,5356,1,21,8,7,61,28,33,71
SC Rheindorf,5356,2,21,5,10,63,42,21,68
SK Sturm Gra,5356,3,20,6,10,54,29,25,66
Rapid Vienna,5356,4,15,10,11,59,42,17,55
Vienna,5356,5,16,6,14,56,50,6,54
RZ Pellets W,5356,6,14,7,15,44,50,-6,49
Admira Wacke,5356,7,11,9,16,36,57,-21,42
SV Josko Rie,5356,8,10,4,22,29,54,-25,34
St. Pölten,5356,9,7,12,17,43,69,-26,33
Mattersburg,5356,10,8,7,21,37,61,-24,31
SC Rheindorf,5357,1,21,6,9,56,36,20,69
SK Sturm Gra,5357,2,21,4,11,57,33,24,67
FC Salzburg,5357,3,17,12,7,61,34,27,63
Vienna,5357,4,19,5,12,57,48,9,62
Rapid Vienna,5357,5,13,11,12,52,44,8,50
Admira Wacke,5357,6,13,5,18,40,56,-16,44
RZ Pellets W,5357,7,11,9,16,49,59,-10,42
Mattersburg,5357,8,10,9,17,46,57,-11,39
SV Josko Rie,5357,9,10,4,22,35,59,-24,34
St. Pölten,5357,10,7,11,18,40,67,-27,32
Vienna,5358,1,22,5,9,71,44,27,71
FC Salzburg,5358,2,20,6,10,61,33,28,66
SC Rheindorf,5358,3,17,9,10,56,50,6,60
SK Sturm Gra,5358,4,16,8,12,48,34,14,56
RZ Pellets W,5358,5,15,5,16,53,58,-5,50
Rapid Vienna,5358,6,13,10,13,53,47,6,49
Admira Wacke,5358,7,12,9,15,36,51,-15,45
SV Josko Rie,5358,8,12,4,20,42,57,-15,40
St. Pölten,5358,9,9,10,17,44,62,-18,37
Mattersburg,5358,10,8,6,22,36,64,-28,30
SC Rheindorf,5359,1,23,6,7,66,41,25,75
Vienna,5359,2,21,6,9,72,49,23,69
FC Salzburg,5359,3,19,7,10,57,32,25,64
SK Sturm Gra,5359,4,16,5,15,49,36,13,53
Rapid Vienna,5359,5,11,13,12,51,41,10,46
Mattersburg,5359,6,11,8,17,38,47,-9,41
Admira Wacke,5359,7,10,11,15,31,52,-21,41
RZ Pellets W,5359,8,12,4,20,37,57,-20,40
St. Pölten,5359,9,9,10,17,42,59,-17,37
SV Josko Rie,5359,10,9,8,19,28,57,-29,35
FC Salzburg,5360,1,21,7,8,63,30,33,70
SC Rheindorf,5360,2,20,7,9,54,41,13,67
SK Sturm Gra,5360,3,19,7,10,57,36,21,64
Rapid Vienna,5360,4,16,8,12,57,37,20,56
Vienna,5360,5,18,2,16,57,57,0,56
Admira Wacke,5360,6,14,9,13,44,53,-9,51
Mattersburg,5360,7,12,8,16,39,51,-12,44
RZ Pellets W,5360,8,11,10,15,43,51,-8,43
SV Josko Rie,5360,9,9,5,22,31,52,-21,32
St. Pölten,5360,10,5,7,24,30,67,-37,22
FC Salzburg,5361,1,21,8,7,69,32,37,71
SC Rheindorf,5361,2,20,7,9,54,38,16,67
Vienna,5361,3,18,6,12,61,52,9,60
SK Sturm Gra,5361,4,15,6,15,50,44,6,51
Rapid Vienna,5361,5,12,13,11,46,35,11,49
Admira Wacke,5361,6,12,11,13,44,55,-11,47
RZ Pellets W,5361,7,12,8,16,49,60,-11,44
Mattersburg,5361,8,11,9,16,39,49,-10,42
SV Josko Rie,5361,9,12,6,18,38,53,-15,42
St. Pölten,5361,10,6,8,22,35,67,-32,26
FC Salzburg,5362,1,20,8,8,63,32,31,68
SK Sturm Gra,5362,2,20,8,8,60,34,26,68
Vienna,5362,3,21,5,10,71,53,18,68
Rapid Vienna,5362,4,15,11,10,60,42,18,56
SC Rheindorf,5362,5,17,5,14,50,45,5,56
RZ Pellets W,5362,6,14,12,10,52,48,4,54
SV Josko Rie,5362,7,10,6,20,33,48,-15,36
Admira Wacke,5362,8,10,6,20,29,57,-28,36
Mattersburg,5362,9,8,7,21,33,60,-27,31
St. Pölten,5362,10,7,8,21,36,68,-32,29
FC Salzburg,5363,1,20,8,8,63,30,33,68
SC Rheindorf,5363,2,20,7,9,58,40,18,67
SK Sturm Gra,5363,3,18,8,10,61,38,23,62
Vienna,5363,4,18,6,12,58,50,8,60
Rapid Vienna,5363,5,13,15,8,58,40,18,54
RZ Pellets W,5363,6,13,8,15,46,62,-16,47
St. Pölten,5363,7,11,8,17,47,61,-14,41
Admira Wacke,5363,8,11,4,21,36,59,-23,37
Mattersburg,5363,9,7,11,18,43,59,-16,32
SV Josko Rie,5363,10,9,5,22,30,61,-31,32
FC Salzburg,5364,1,20,11,5,68,28,40,71
SC Rheindorf,5364,2,20,9,7,53,39,14,69
SK Sturm Gra,5364,3,18,5,13,61,33,28,59
Vienna,5364,4,18,4,14,63,57,6,58
Rapid Vienna,5364,5,12,14,10,58,50,8,50
RZ Pellets W,5364,6,11,11,14,46,54,-8,44
Admira Wacke,5364,7,12,8,16,37,56,-19,44
Mattersburg,5364,8,9,11,16,46,54,-8,38
SV Josko Rie,5364,9,10,5,21,32,62,-30,35
St. Pölten,5364,10,7,8,21,40,71,-31,29
SC Rheindorf,5365,1,19,10,7,60,42,18,67
FC Salzburg,5365,2,18,11,7,62,29,33,65
SK Sturm Gra,5365,3,18,7,11,58,36,22,61
Rapid Vienna,5365,4,15,9,12,54,43,11,54
RZ Pellets W,5365,5,16,6,14,51,52,-1,54
Vienna,5365,6,16,5,15,61,55,6,53
St. Pölten,5365,7,9,13,14,37,53,-16,40
Admira Wacke,5365,8,11,6,19,36,56,-20,39
SV Josko Rie,5365,9,9,7,20,31,57,-26,34
Mattersburg,5365,10,9,6,21,34,61,-27,33
FC Salzburg,5366,1,22,7,7,62,30,32,73
SK Sturm Gra,5366,2,21,6,9,71,31,40,69
SC Rheindorf,5366,3,17,11,8,56,39,17,62
Vienna,5366,4,18,5,13,62,58,4,59
RZ Pellets W,5366,5,15,7,14,50,52,-2,52
Rapid Vienna,5366,6,12,12,12,51,43,8,48
Admira Wacke,5366,7,13,7,16,42,55,-13,46
SV Josko Rie,5366,8,9,7,20,33,60,-27,34
Mattersburg,5366,9,6,10,20,35,61,-26,28
St. Pölten,5366,10,6,10,20,37,70,-33,28
SK Sturm Gra,5367,1,21,8,7,69,30,39,71
FC Salzburg,5367,2,19,10,7,57,27,30,67
SC Rheindorf,5367,3,18,8,10,44,37,7,62
Vienna,5367,4,15,9,12,52,49,3,54
Rapid Vienna,5367,5,14,11,11,47,37,10,53
SV Josko Rie,5367,6,13,5,18,40,48,-8,44
Mattersburg,5367,7,10,10,16,44,52,-8,40
RZ Pellets W,5367,8,10,9,17,39,56,-17,39
Admira Wacke,5367,9,10,6,20,34,65,-31,36
St. Pölten,5367,10,7,10,19,43,68,-25,31
FC Salzburg,5368,1,21,11,4,68,29,39,74
SC Rheindorf,5368,2,20,8,8,52,41,11,68
Vienna,5368,3,21,4,11,70,47,23,67
SK Sturm Gra,5368,4,19,5,12,60,37,23,62
Rapid Vienna,5368,5,13,9,14,55,50,5,48
RZ Pellets W,5368,6,11,10,15,43,56,-13,43
SV Josko Rie,5368,7,11,5,20,36,49,-13,38
Admira Wacke,5368,8,10,7,19,38,61,-23,37
Mattersburg,5368,9,8,11,17,35,51,-16,35
St. Pölten,5368,10,7,8,21,37,73,-36,29
SK Sturm Gra,5369,1,21,8,7,63,31,32,71
FC Salzburg,5369,2,18,12,6,61,30,31,66
Vienna,5369,3,20,6,10,71,51,20,66
SC Rheindorf,5369,4,18,6,12,53,44,9,60
Rapid Vienna,5369,5,13,13,10,51,38,13,52
RZ Pellets W,5369,6,14,6,16,45,56,-11,48
Admira Wacke,5369,7,12,8,16,39,50,-11,44
St. Pölten,5369,8,7,10,19,39,66,-27,31
Mattersburg,5369,9,8,7,21,33,62,-29,31
SV Josko Rie,5369,10,7,8,21,30,57,-27,29
SC Rheindorf,5370,1,22,8,6,60,37,23,74
FC Salzburg,5370,2,20,6,10,67,35,32,66
Vienna,5370,3,19,5,12,72,59,13,62
SK Sturm Gra,5370,4,18,7,11,56,38,18,61
Rapid Vienna,5370,5,14,9,13,58,46,12,51
Admira Wacke,5370,6,14,6,16,49,60,-11,48
RZ Pellets W,5370,7,12,8,16,46,59,-13,44
SV Josko Rie,5370,8,10,7,19,29,53,-24,37
St. Pölten,5370,9,7,10,19,41,66,-25,31
Mattersburg,5370,10,8,6,22,32,57,-25,30
FC Salzburg,5371,1,21,7,8,61,27,34,70
SC Rheindorf,5371,2,21,7,8,56,35,21,70
SK Sturm Gra,5371,3,20,7,9,57,29,28,67
Vienna,5371,4,18,5,13,54,58,-4,59
Rapid Vienna,5371,5,14,11,11,53,39,14,53
RZ Pellets W,5371,6,11,9,16,38,51,-13,42
Admira Wacke,5371,7,13,3,20,38,57,-19,42
SV Josko Rie,5371,8,12,5,19,32,46,-14,41
Mattersburg,5371,9,6,11,19,32,51,-19,29
St. Pölten,5371,10,6,11,19,34,62,-28,29
SC Rheindorf,5372,1,21,7,8,59,42,17,70
FC Salzburg,5372,2,20,8,8,73,34,39,68
SK Sturm Gra,5372,3,19,6,11,65,37,28,63
Vienna,5372,4,18,4,14,71,60,11,58
Rapid Vienna,5372,5,15,11,10,61,37,24,56
RZ Pellets W,5372,6,13,7,16,48,59,-11,46
Admira Wacke,5372,7,12,5,19,39,63,-24,41
SV Josko Rie,5372,8,11,6,19,41,60,-19,39
St. Pölten,5372,9,9,9,18,40,72,-32,36
Mattersburg,5372,10,6,9,21,38,71,-33,27
SC Rheindorf,5373,1,24,5,7,70,42,28,77
FC Salzburg,5373,2,21,7,8,61,27,34,70
SK Sturm Gra,5373,3,21,5,10,67,36,31,68
Rapid Vienna,5373,4,16,11,9,61,37,24,59
Vienna,5373,5,17,5,14,61,56,5,56
RZ Pellets W,5373,6,12,9,15,41,52,-11,45
Mattersburg,5373,7,11,7,18,39,58,-19,40
SV Josko Rie,5373,8,8,8,20,32,53,-21,32
Admira Wacke,5373,9,8,7,21,40,74,-34,31
St. Pölten,5373,10,6,8,22,41,78,-37,26
SC Rheindorf,5374,1,21,7,8,56,42,14,70
SK Sturm Gra,5374,2,20,7,9,58,32,26,67
FC Salzburg,5374,3,18,7,11,62,40,22,61
Rapid Vienna,5374,4,17,9,10,60,37,23,60
Vienna,5374,5,16,4,16,67,59,8,52
RZ Pellets W,5374,6,14,6,16,53,58,-5,48
Admira Wacke,5374,7,13,3,20,35,60,-25,42
Mattersburg,5374,8,11,7,18,42,54,-12,40
St. Pölten,5374,9,8,10,18,41,61,-20,34
SV Josko Rie,5374,10,9,6,21,31,62,-31,33
FC Salzburg,5375,1,21,8,7,69,34,35,71
SK Sturm Gra,5375,2,20,7,9,59,31,28,67
Vienna,5375,3,20,4,12,63,49,14,64
SC Rheindorf,5375,4,18,7,11,49,40,9,61
SV Josko Rie,5375,5,14,4,18,38,52,-14,46
Rapid Vienna,5375,6,11,12,13,53,45,8,45
RZ Pellets W,5375,7,13,6,17,45,58,-13,45
Mattersburg,5375,8,10,8,18,40,53,-13,38
Admira Wacke,5375,9,10,8,18,42,63,-21,38
St. Pölten,5375,10,7,8,21,39,72,-33,29
SK Sturm Gra,5376,1,21,7,8,66,33,33,70
FC Salzburg,5376,2,18,11,7,66,38,28,65
SC Rheindorf,5376,3,18,7,11,50,42,8,61
Vienna,5376,4,18,6,12,66,55,11,60
Rapid Vienna,5376,5,14,8,14,56,47,9,50
RZ Pellets W,5376,6,14,6,16,46,48,-2,48
Mattersburg,5376,7,10,9,17,40,57,-17,39
Admira Wacke,5376,8,11,6,19,39,61,-22,39
St. Pölten,5376,9,9,9,18,39,62,-23,36
SV Josko Rie,5376,10,10,5,21,38,63,-25,35
SK Sturm Gra,5377,1,20,6,10,57,36,21,66
FC Salzburg,5377,2,19,7,10,66,39,27,64
Vienna,5377,3,19,6,11,65,54,11,63
SC Rheindorf,5377,4,17,9,10,49,41,8,60
Rapid Vienna,5377,5,15,11,10,55,36,19,56
RZ Pellets W,5377,6,13,10,13,45,46,-1,49
Admira Wacke,5377,7,12,6,18,38,56,-18,42
SV Josko Rie,5377,8,12,5,19,37,52,-15,41
Mattersburg,5377,9,8,7,21,39,62,-23,31
St. Pölten,5377,10,7,9,20,37,66,-29,30
FC Salzburg,5378,1,19,10,7,63,29,34,67
SK Sturm Gra,5378,2,18,10,8,61,34,27,64
SC Rheindorf,5378,3,16,12,8,51,45,6,60
Vienna,5378,4,17,8,11,68,56,12,59
Rapid Vienna,5378,5,13,11,12,49,37,12,50
RZ Pellets W,5378,6,12,7,17,43,57,-14,43
Admira Wacke,5378,7,11,8,17,44,62,-18,41
Mattersburg,5378,8,10,9,17,40,55,-15,39
St. Pölten,5378,9,9,9,18,42,66,-24,36
SV Josko Rie,5378,10,9,8,19,33,53,-20,35
SC Rheindorf,5379,1,21,8,7,61,40,21,71
Vienna,5379,2,20,6,10,61,45,16,66
SK Sturm Gra,5379,3,19,8,9,72,38,34,65
FC Salzburg,5379,4,17,10,9,55,35,20,61
Rapid Vienna,5379,5,13,14,9,54,40,14,53
SV Josko Rie,5379,6,13,3,20,37,53,-16,42
RZ Pellets W,5379,7,11,7,18,40,58,-18,40
St. Pölten,5379,8,10,7,19,44,62,-18,37
Admira Wacke,5379,9,10,7,19,32,60,-28,37
Mattersburg,5379,10,7,8,21,34,59,-25,29
FC Salzburg,5380,1,23,6,7,67,27,40,75
Vienna,5380,2,20,6,10,62,43,19,66
SC Rheindorf,5380,3,18,10,8,55,40,15,64
SK Sturm Gra,5380,4,18,9,9,56,35,21,63
Rapid Vienna,5380,5,15,9,12,56,39,17,54
RZ Pellets W,5380,6,10,11,15,40,54,-14,41
SV Josko Rie,5380,7,11,7,18,33,50,-17,40
Admira Wacke,5380,8,11,5,20,36,61,-25,38
Mattersburg,5380,9,7,8,21,36,64,-28,29
St. Pölten,5380,10,6,11,19,32,60,-28,29
Vienna,5381,1,23,3,10,70,44,26,72
SC Rheindorf,5381,2,21,5,10,49,35,14,68
FC Salzburg,5381,3,19,7,10,57,31,26,64
SK Sturm Gra,5381,4,19,4,13,56,38,18,61
RZ Pellets W,5381,5,15,6,15,50,54,-4,51
Rapid Vienna,5381,6,13,9,14,52,47,5,48
Admira Wacke,5381,7,11,9,16,36,58,-22,42
Mattersburg,5381,8,11,7,18,41,56,-15,40
St. Pölten,5381,9,9,9,18,40,58,-18,36
SV Josko Rie,5381,10,8,3,25,29,59,-30,27
FC Salzburg,5382,1,21,8,7,71,31,40,71
Vienna,5382,2,22,4,10,70,44,26,70
SK Sturm Gra,5382,3,20,6,10,62,36,26,66
SC Rheindorf,5382,4,18,10,8,52,42,10,64
Rapid Vienna,5382,5,14,11,11,51,39,12,53
RZ Pellets W,5382,6,13,7,16,47,58,-11,46
Admira Wacke,5382,7,12,4,20,36,62,-26,40
St. Pölten,5382,8,9,7,20,47,73,-26,34
Mattersburg,5382,9,6,12,18,40,58,-18,30
SV Josko Rie,5382,10,7,7,22,35,68,-33,28
FC Salzburg,5383,1,22,9,5,71,28,43,75
SK Sturm Gra,5383,2,21,5,10,57,32,25,68
Vienna,5383,3,17,6,13,63,52,11,57
SC Rheindorf,5383,4,16,8,12,47,47,0,56
RZ Pellets W,5383,5,16,5,15,47,50,-3,53
Rapid Vienna,5383,6,12,9,15,54,45,9,45
St. Pölten,5383,7,12,6,18,49,64,-15,42
Admira Wacke,5383,8,12,4,20,36,66,-30,40
Mattersburg,5383,9,11,6,19,45,64,-19,39
SV Josko Rie,5383,10,10,4,22,34,55,-21,34
FC Salzburg,5384,1,23,8,5,70,32,38,77
SC Rheindorf,5384,2,21,5,10,58,44,14,68
Rapid Vienna,5384,3,20,7,9,72,37,35,67
Vienna,5384,4,18,4,14,58,54,4,58
SK Sturm Gra,5384,5,16,8,12,58,39,19,56
RZ Pellets W,5384,6,12,6,18,47,62,-15,42
Admira Wacke,5384,7,11,9,16,42,61,-19,42
SV Josko Rie,5384,8,10,5,21,29,52,-23,35
Mattersburg,5384,9,7,9,20,39,64,-25,30
St. Pölten,5384,10,7,9,20,38,66,-28,30
SC Rheindorf,5385,1,22,8,6,62,44,18,74
FC Salzburg,5385,2,21,6,9,65,35,30,69
SK Sturm Gra,5385,3,16,11,9,60,36,24,59
Rapid Vienna,5385,4,14,13,9,62,39,23,55
Vienna,5385,5,14,6,16,56,58,-2,48
RZ Pellets W,5385,6,13,7,16,46,59,-13,46
Admira Wacke,5385,7,11,8,17,37,58,-21,41
SV Josko Rie,5385,8,12,4,20,41,57,-16,40
Mattersburg,5385,9,9,8,19,43,59,-16,35
St. Pölten,5385,10,7,11,18,47,74,-27,32
SC Rheindorf,5386,1,23,7,6,61,36,25,76
FC Salzburg,5386,2,20,8,8,72,33,39,68
Vienna,5386,3,20,4,12,66,52,14,64
SK Sturm Gra,5386,4,17,7,12,52,38,14,58
Rapid Vienna,5386,5,14,10,12,56,48,8,52
RZ Pellets W,5386,6,13,7,16,44,53,-9,46
Admira Wacke,5386,7,13,6,17,40,62,-22,45
St. Pölten,5386,8,7,12,17,36,57,-21,33
Mattersburg,5386,9,8,7,21,39,59,-20,31
SV Josko Rie,5386,10,9,4,23,34,62,-28,31
FC Salzburg,5387,1,23,6,7,71,30,41,75
SC Rheindorf,5387,2,21,7,8,66,41,25,70
SK Sturm Gra,5387,3,22,3,11,56,32,24,69
Vienna,5387,4,19,6,11,68,51,17,63
Rapid Vienna,5387,5,14,9,13,55,41,14,51
Admira Wacke,5387,6,13,4,19,42,64,-22,43
RZ Pellets W,5387,7,11,6,19,42,65,-23,39
Mattersburg,5387,8,10,7,19,39,60,-21,37
SV Josko Rie,5387,9,9,6,21,34,58,-24,33
St. Pölten,5387,10,6,10,20,37,68,-31,28
FC Salzburg,5388,1,24,8,4,71,27,44,80
Vienna,5388,2,19,7,10,67,51,16,64
SK Sturm Gra,5388,3,18,7,11,62,42,20,61
SC Rheindorf,5388,4,17,8,11,51,38,13,59
Rapid Vienna,5388,5,14,11,11,56,44,12,53
RZ Pellets W,5388,6,13,7,16,44,56,-12,46
Admira Wacke,5388,7,13,5,18,41,59,-18,44
St. Pölten,5388,8,8,11,17,39,59,-20,35
Mattersburg,5388,9,8,6,22,29,56,-27,30
SV Josko Rie,5388,10,8,6,22,33,61,-28,30
SK Sturm Gra,5389,1,20,6,10,63,33,30,66
SC Rheindorf,5389,2,18,8,10,50,43,7,62
FC Salzburg,5389,3,17,9,10,57,34,23,60
Vienna,5389,4,17,7,12,64,55,9,58
Rapid Vienna,5389,5,15,10,11,52,38,14,55
RZ Pellets W,5389,6,14,8,14,53,53,0,50
SV Josko Rie,5389,7,11,9,16,28,42,-14,42
Admira Wacke,5389,8,11,7,18,37,58,-21,40
St. Pölten,5389,9,8,10,18,45,69,-24,34
Mattersburg,5389,10,7,10,19,31,55,-24,31
FC Salzburg,5390,1,22,8,6,66,29,37,74
SC Rheindorf,5390,2,22,7,7,51,36,15,73
SK Sturm Gra,5390,3,20,6,10,54,30,24,66
Vienna,5390,4,19,4,13,69,52,17,61
RZ Pellets W,5390,5,15,7,14,48,50,-2,52
Rapid Vienna,5390,6,10,13,13,46,43,3,43
Mattersburg,5390,7,10,8,18,38,53,-15,38
Admira Wacke,5390,8,10,7,19,35,60,-25,37
SV Josko Rie,5390,9,9,3,24,31,61,-30,30
St. Pölten,5390,10,6,11,19,38,62,-24,29
FC Salzburg,5391,1,20,10,6,63,28,35,70
SK Sturm Gra,5391,2,19,6,11,54,35,19,63
SC Rheindorf,5391,3,19,6,11,50,48,2,63
Rapid Vienna,5391,4,16,10,10,59,40,19,58
Vienna,5391,5,17,4,15,61,56,5,55
Admira Wacke,5391,6,13,5,18,39,55,-16,44
RZ Pellets W,5391,7,11,7,18,43,52,-9,40
St. Pölten,5391,8,10,9,17,44,60,-16,39
SV Josko Rie,5391,9,11,6,19,40,57,-17,39
Mattersburg,5391,10,9,7,20,35,57,-22,34
FC Salzburg,5392,1,20,7,9,67,33,34,67
SC Rheindorf,5392,2,19,8,9,60,44,16,65
Vienna,5392,3,18,8,10,58,50,8,62
Rapid Vienna,5392,4,17,10,9,65,41,24,61
SK Sturm Gra,5392,5,17,7,12,60,42,18,58
Admira Wacke,5392,6,12,7,17,43,56,-13,43
St. Pölten,5392,7,10,10,16,48,66,-18,40
RZ Pellets W,5392,8,10,8,18,43,64,-21,38
Mattersburg,5392,9,8,9,19,39,58,-19,33
SV Josko Rie,5392,10,9,6,21,32,61,-29,33
FC Salzburg,5393,1,23,8,5,76,28,48,77
SK Sturm Gra,5393,2,19,7,10,56,37,19,64
SC Rheindorf,5393,3,19,5,12,52,41,11,62
Vienna,5393,4,17,5,14,60,59,1,56
Rapid Vienna,5393,5,12,12,12,55,41,14,48
RZ Pellets W,5393,6,12,9,15,46,57,-11,45
Admira Wacke,5393,7,13,5,18,39,57,-18,44
Mattersburg,5393,8,10,10,16,42,55,-13,40
SV Josko Rie,5393,9,8,8,20,32,57,-25,32
St. Pölten,5393,10,7,11,18,40,66,-26,32
SC Rheindorf,5394,1,21,8,7,58,36,22,71
Vienna,5394,2,22,5,9,68,49,19,71
FC Salzburg,5394,3,16,12,8,62,40,22,60
SK Sturm Gra,5394,4,17,8,11,53,35,18,59
Rapid Vienna,5394,5,11,12,13,48,45,3,45
RZ Pellets W,5394,6,12,8,16,42,48,-6,44
Admira Wacke,5394,7,12,7,17,44,59,-15,43
SV Josko Rie,5394,8,11,5,20,34,53,-19,38
St. Pölten,5394,9,8,10,18,37,60,-23,34
Mattersburg,5394,10,8,9,19,37,58,-21,33
FC Salzburg,5395,1,21,8,7,67,32,35,71
Vienna,5395,2,19,6,11,62,51,11,63
SC Rheindorf,5395,3,18,8,10,52,42,10,62
SK Sturm Gra,5395,4,17,6,13,59,39,20,57
Admira Wacke,5395,5,14,7,15,43,58,-15,49
Rapid Vienna,5395,6,11,11,14,55,45,10,44
RZ Pellets W,5395,7,10,13,13,46,55,-9,43
SV Josko Rie,5395,8,11,8,17,36,49,-13,41
Mattersburg,5395,9,8,9,19,35,58,-23,33
St. Pölten,5395,10,7,12,17,40,66,-26,33
SC Rheindorf,5396,1,20,6,10,54,38,16,66
FC Salzburg,5396,2,17,9,10,55,32,23,60
SK Sturm Gra,5396,3,17,7,12,59,38,21,58
Vienna,5396,4,17,7,12,64,57,7,58
Rapid Vienna,5396,5,15,11,10,53,37,16,56
Admira Wacke,5396,6,13,8,15,39,53,-14,47
SV Josko Rie,5396,7,12,8,16,41,52,-11,44
RZ Pellets W,5396,8,11,6,19,37,58,-21,39
St. Pölten,5396,9,8,12,16,41,59,-18,36
Mattersburg,5396,10,9,8,19,34,53,-19,35
SC Rheindorf,5397,1,22,7,7,62,41,21,73
SK Sturm Gra,5397,2,18,11,7,67,36,31,65
FC Salzburg,5397,3,17,8,11,58,36,22,59
Vienna,5397,4,17,7,12,65,53,12,58
Admira Wacke,5397,5,13,8,15,41,52,-11,47
Rapid Vienna,5397,6,11,13,12,52,43,9,46
RZ Pellets W,5397,7,12,9,15,44,55,-11,45
SV Josko Rie,5397,8,13,6,17,35,50,-15,45
Mattersburg,5397,9,8,8,20,35,61,-26,32
St. Pölten,5397,10,6,9,21,36,68,-32,27
FC Salzburg,5398,1,20,8,8,65,36,29,68
SC Rheindorf,5398,2,21,5,10,55,44,11,68
SK Sturm Gra,5398,3,20,4,12,70,37,33,64
RZ Pellets W,5398,4,18,6,12,53,48,5,60
Vienna,5398,5,17,6,13,65,60,5,57
Rapid Vienna,5398,6,15,7,14,55,43,12,52
Admira Wacke,5398,7,12,5,19,40,60,-20,41
SV Josko Rie,5398,8,10,5,21,36,58,-22,35
Mattersburg,5398,9,9,7,20,40,66,-26,34
St. Pölten,5398,10,6,11,19,35,62,-27,29
SK Sturm Gra,5399,1,23,5,8,65,27,38,74
FC Salzburg,5399,2,22,5,9,64,36,28,71
SC Rheindorf,5399,3,19,7,10,59,43,16,64
Vienna,5399,4,17,6,13,60,53,7,57
Rapid Vienna,5399,5,13,9,14,55,44,11,48
RZ Pellets W,5399,6,12,6,18,43,58,-15,42
Admira Wacke,5399,7,11,9,16,35,57,-22,42
St. Pölten,5399,8,10,10,16,52,67,-15,40
Mattersburg,5399,9,10,6,20,40,60,-20,36
SV Josko Rie,5399,10,9,5,22,31,59,-28,32
FC Salzburg,5400,1,21,8,7,68,32,36,71
SC Rheindorf,5400,2,21,7,8,69,42,27,70
Vienna,5400,3,18,6,12,66,56,10,60
Rapid Vienna,5400,4,16,11,9,59,37,22,59
SK Sturm Gra,5400,5,16,11,9,52,36,16,59
RZ Pellets W,5400,6,13,7,16,45,54,-9,46
St. Pölten,5400,7,8,12,16,38,66,-28,36
Admira Wacke,5400,8,9,8,19,33,61,-28,35
SV Josko Rie,5400,9,9,7,20,34,53,-19,34
Mattersburg,5400,10,7,7,22,32,59,-27,28
SC Rheindorf,5401,1,24,6,6,66,37,29,78
FC Salzburg,5401,2,19,7,10,63,34,29,64
SK Sturm Gra,5401,3,18,6,12,58,34,24,60
Vienna,5401,4,15,7,14,54,52,2,52
Rapid Vienna,5401,5,13,11,12,49,40,9,50
Admira Wacke,5401,6,13,7,16,35,56,-21,46
RZ Pellets W,5401,7,11,10,15,48,58,-10,43
Mattersburg,5401,8,10,7,19,38,53,-15,37
St. Pölten,5401,9,10,7,19,40,68,-28,37
SV Josko Rie,5401,10,10,6,20,36,55,-19,36
FC Salzburg,5402,1,21,7,8,69,33,36,70
SK Sturm Gra,5402,2,18,7,11,61,40,21,61
SC Rheindorf,5402,3,17,10,9,47,40,7,61
Vienna,5402,4,17,7,12,56,44,12,58
Rapid Vienna,5402,5,14,11,11,59,42,17,53
St. Pölten,5402,6,11,11,14,38,53,-15,44
Admira Wacke,5402,7,12,7,17,36,59,-23,43
Mattersburg,5402,8,10,10,16,49,55,-6,40
RZ Pellets W,5402,9,9,9,18,38,56,-18,36
SV Josko Rie,5402,10,9,5,22,29,60,-31,32
SK Sturm Gra,5403,1,22,5,9,59,34,25,71
FC Salzburg,5403,2,20,8,8,60,30,30,68
SC Rheindorf,5403,3,19,7,10,60,43,17,64
Rapid Vienna,5403,4,16,10,10,58,36,22,58
Vienna,5403,5,17,7,12,60,52,8,58
RZ Pellets W,5403,6,15,5,16,42,51,-9,50
Admira Wacke,5403,7,10,6,20,32,55,-23,36
St. Pölten,5403,8,8,10,18,47,69,-22,34
Mattersburg,5403,9,9,7,20,34,56,-22,34
SV Josko Rie,5403,10,9,5,22,35,61,-26,32
FC Salzburg,5404,1,18,7,11,58,36,22,61
Rapid Vienna,5404,2,16,12,8,65,40,25,60
SC Rheindorf,5404,3,17,8,11,54,48,6,59
SK Sturm Gra,5404,4,16,7,13,60,48,12,55
Vienna,5404,5,16,7,13,56,56,0,55
RZ Pellets W,5404,6,14,7,15,48,53,-5,49
Admira Wacke,5404,7,13,7,16,34,51,-17,46
St. Pölten,5404,8,11,9,16,42,54,-12,42
Mattersburg,5404,9,9,10,17,39,52,-13,37
SV Josko Rie,5404,10,8,10,18,28,46,-18,34
SK Sturm Gra,5405,1,19,9,8,60,29,31,66
FC Salzburg,5405,2,19,8,9,62,39,23,65
Vienna,5405,3,20,3,13,65,48,17,63
SC Rheindorf,5405,4,17,8,11,48,44,4,59
RZ Pellets W,5405,5,16,6,14,45,46,-1,54
Rapid Vienna,5405,6,13,11,12,54,41,13,50
SV Josko Rie,5405,7,13,3,20,37,55,-18,42
St. Pölten,5405,8,10,9,17,38,58,-20,39
Admira Wacke,5405,9,9,9,18,35,62,-27,36
Mattersburg,5405,10,7,8,21,33,55,-22,29
FC Salzburg,5406,1,22,7,7,69,29,40,73
SK Sturm Gra,5406,2,19,6,11,53,33,20,63
SC Rheindorf,5406,3,18,7,11,54,44,10,61
Vienna,5406,4,16,7,13,57,50,7,55
Rapid Vienna,5406,5,13,12,11,58,45,13,51
RZ Pellets W,5406,6,13,9,14,55,58,-3,48
Mattersburg,5406,7,12,8,16,43,51,-8,44
Admira Wacke,5406,8,12,7,17,38,58,-20,43
SV Josko Rie,5406,9,9,5,22,32,59,-27,32
St. Pölten,5406,10,6,12,18,40,72,-32,30
FC Salzburg,5407,1,20,8,8,69,39,30,68
SK Sturm Gra,5407,2,20,6,10,62,32,30,66
SC Rheindorf,5407,3,17,8,11,54,44,10,59
Vienna,5407,4,17,5,14,61,51,10,56
Rapid Vienna,5407,5,14,11,11,64,46,18,53
RZ Pellets W,5407,6,12,8,16,47,55,-8,44
Mattersburg,5407,7,10,11,15,41,58,-17,41
SV Josko Rie,5407,8,11,7,18,41,55,-14,40
Admira Wacke,5407,9,10,8,18,42,72,-30,38
St. Pölten,5407,10,8,10,18,39,68,-29,34
SK Sturm Gra,5408,1,21,6,9,54,29,25,69
Vienna,5408,2,20,5,11,65,46,19,65
FC Salzburg,5408,3,18,9,9,68,39,29,63
SC Rheindorf,5408,4,18,7,11,55,44,11,61
Rapid Vienna,5408,5,13,11,12,50,42,8,50
RZ Pellets W,5408,6,14,8,14,41,49,-8,50
SV Josko Rie,5408,7,12,6,18,34,49,-15,42
Admira Wacke,5408,8,11,7,18,40,62,-22,40
St. Pölten,5408,9,8,9,19,38,62,-24,33
Mattersburg,5408,10,7,8,21,36,59,-23,29
SK Sturm Gra,5409,1,20,7,9,66,36,30,67
SC Rheindorf,5409,2,20,7,9,60,40,20,67
Vienna,5409,3,19,6,11,69,54,15,63
Rapid Vienna,5409,4,16,13,7,55,33,22,61
FC Salzburg,5409,5,18,6,12,61,39,22,60
Admira Wacke,5409,6,13,6,17,38,57,-19,45
SV Josko Rie,5409,7,11,6,19,38,52,-14,39
RZ Pellets W,5409,8,11,5,20,47,61,-14,38
Mattersburg,5409,9,7,10,19,33,60,-27,31
St. Pölten,5409,10,7,10,19,38,73,-35,31
FC Salzburg,5410,1,20,7,9,63,33,30,67
Vienna,5410,2,19,6,11,66,54,12,63
SC Rheindorf,5410,3,18,7,11,56,47,9,61
SK Sturm Gra,5410,4,17,9,10,57,41,16,60
Rapid Vienna,5410,5,16,10,10,58,43,15,58
RZ Pellets W,5410,6,15,9,12,57,51,6,54
SV Josko Rie,5410,7,13,5,18,37,46,-9,44
Admira Wacke,5410,8,11,5,20,37,62,-25,38
St. Pölten,5410,9,7,9,20,35,65,-30,30
Mattersburg,5410,10,5,11,20,33,57,-24,26
FC Salzburg,5411,1,20,7,9,68,37,31,67
SK Sturm Gra,5411,2,20,7,9,59,34,25,67
SC Rheindorf,5411,3,19,7,10,61,53,8,64
Vienna,5411,4,18,6,12,62,53,9,60
Rapid Vienna,5411,5,15,12,9,61,34,27,57
RZ Pellets W,5411,6,11,9,16,39,51,-12,42
SV Josko Rie,5411,7,12,5,19,45,52,-7,41
Mattersburg,5411,8,11,8,17,37,60,-23,41
St. Pölten,5411,9,8,8,20,37,64,-27,32
Admira Wacke,5411,10,9,5,22,35,66,-31,32
SK Sturm Gra,5412,1,21,6,9,58,31,27,69
FC Salzburg,5412,2,21,5,10,66,33,33,68
Vienna,5412,3,20,4,12,66,51,15,64
SC Rheindorf,5412,4,18,8,10,58,46,12,62
Rapid Vienna,5412,5,17,10,9,58,38,20,61
RZ Pellets W,5412,6,15,4,17,45,53,-8,49
SV Josko Rie,5412,7,10,7,19,35,55,-20,37
Mattersburg,5412,8,9,7,20,36,61,-25,34
Admira Wacke,5412,9,10,4,22,33,60,-27,34
St. Pölten,5412,10,6,11,19,36,63,-27,29
SK Sturm Gra,5413,1,23,6,7,70,28,42,75
FC Salzburg,5413,2,21,7,8,65,28,37,70
SC Rheindorf,5413,3,18,8,10,53,42,11,62
Vienna,5413,4,17,5,14,53,50,3,56
Rapid Vienna,5413,5,12,12,12,57,43,14,48
RZ Pellets W,5413,6,11,10,15,45,63,-18,43
Admira Wacke,5413,7,11,5,20,44,66,-22,38
SV Josko Rie,5413,8,10,8,18,27,50,-23,38
St. Pölten,5413,9,8,11,17,45,70,-25,35
Mattersburg,5413,10,8,10,18,43,62,-19,34
FC Salzburg,5414,1,22,7,7,64,32,32,73
SK Sturm Gra,5414,2,22,5,9,62,34,28,71
SC Rheindorf,5414,3,21,7,8,64,40,24,70
Vienna,5414,4,15,5,16,59,59,0,50
Rapid Vienna,5414,5,12,11,13,57,50,7,47
RZ Pellets W,5414,6,12,10,14,45,54,-9,46
Admira Wacke,5414,7,11,8,17,37,56,-19,41
Mattersburg,5414,8,10,8,18,40,57,-17,38
SV Josko Rie,5414,9,9,7,20,31,54,-23,34
St. Pölten,5414,10,7,10,19,42,65,-23,31
SK Sturm Gra,5415,1,21,7,8,64,29,35,70
Vienna,5415,2,18,9,9,63,48,15,63
FC Salzburg,5415,3,18,8,10,56,31,25,62
SC Rheindorf,5415,4,16,10,10,50,40,10,58
Rapid Vienna,5415,5,14,8,14,50,40,10,50
RZ Pellets W,5415,6,10,10,16,41,55,-14,40
St. Pölten,5415,7,10,10,16,45,63,-18,40
Admira Wacke,5415,8,10,8,18,32,59,-27,38
SV Josko Rie,5415,9,9,10,17,40,59,-19,37
Mattersburg,5415,10,8,12,16,37,54,-17,36
FC Salzburg,5416,1,22,5,9,60,31,29,71
SC Rheindorf,5416,2,17,8,11,51,41,10,59
SK Sturm Gra,5416,3,17,6,13,60,43,17,57
Vienna,5416,4,17,4,15,58,51,7,55
Rapid Vienna,5416,5,14,11,11,55,38,17,53
RZ Pellets W,5416,6,15,6,15,52,49,3,51
Mattersburg,5416,7,13,8,15,39,48,-9,47
SV Josko Rie,5416,8,13,4,19,39,56,-17,43
Admira Wacke,5416,9,10,6,20,33,68,-35,36
St. Pölten,5416,10,9,8,19,39,61,-22,35
SC Rheindorf,5417,1,22,7,7,61,42,19,73
FC Salzburg,5417,2,21,8,7,67,31,36,71
SK Sturm Gra,5417,3,22,5,9,71,41,30,71
Vienna,5417,4,18,5,13,60,52,8,59
Rapid Vienna,5417,5,14,9,13,51,39,12,51
RZ Pellets W,5417,6,13,6,17,43,51,-8,45
Admira Wacke,5417,7,11,4,21,39,62,-23,37
SV Josko Rie,5417,8,9,7,20,35,60,-25,34
Mattersburg,5417,9,8,9,19,39,57,-18,33
St. Pölten,5417,10,8,8,20,40,71,-31,32
FC Salzburg,5418,1,21,9,6,67,29,38,72
SC Rheindorf,5418,2,21,7,8,60,48,12,70
SK Sturm Gra,5418,3,20,7,9,66,39,27,67
Vienna,5418,4,17,5,14,58,53,5,56
Rapid Vienna,5418,5,15,10,11,53,41,12,55
Admira Wacke,5418,6,12,6,18,39,56,-17,42
SV Josko Rie,5418,7,11,8,17,41,56,-15,41
RZ Pellets W,5418,8,11,6,19,41,57,-16,39
Mattersburg,5418,9,8,7,21,34,58,-24,31
St. Pölten,5418,10,6,11,19,39,61,-22,29
FC Salzburg,5419,1,20,10,6,58,28,30,70
SK Sturm Gra,5419,2,21,6,9,76,37,39,69
SC Rheindorf,5419,3,20,9,7,54,32,22,69
Rapid Vienna,5419,4,16,9,11,65,38,27,57
Vienna,5419,5,15,5,16,60,54,6,50
RZ Pellets W,5419,6,12,8,16,43,56,-13,44
SV Josko Rie,5419,7,10,8,18,33,56,-23,38
Admira Wacke,5419,8,10,7,19,31,60,-29,37
St. Pölten,5419,9,7,11,18,41,76,-35,32
Mattersburg,5419,10,6,13,17,35,59,-24,31
FC Salzburg,5420,1,23,5,8,68,34,34,74
SC Rheindorf,5420,2,19,5,12,58,50,8,62
SK Sturm Gra,5420,3,18,7,11,59,39,20,61
Vienna,5420,4,18,6,12,60,57,3,60
Rapid Vienna,5420,5,15,11,10,63,41,22,56
RZ Pellets W,5420,6,12,7,17,42,54,-12,43
Admira Wacke,5420,7,12,5,19,34,61,-27,41
Mattersburg,5420,8,9,10,17,34,44,-10,37
St. Pölten,5420,9,9,9,18,45,64,-19,36
SV Josko Rie,5420,10,8,9,19,37,56,-19,33
FC Salzburg,5421,1,22,7,7,69,35,34,73
SK Sturm Gra,5421,2,22,6,8,66,34,32,72
SC Rheindorf,5421,3,18,11,7,55,38,17,65
Vienna,5421,4,19,4,13,66,50,16,61
Rapid Vienna,5421,5,10,13,13,47,46,1,43
RZ Pellets W,5421,6,10,10,16,40,56,-16,40
Admira Wacke,5421,7,11,6,19,40,61,-21,39
St. Pölten,5421,8,10,8,18,46,68,-22,38
Mattersburg,5421,9,9,8,19,39,59,-20,35
SV Josko Rie,5421,10,10,5,21,41,62,-21,35
FC Salzburg,5422,1,23,7,6,70,27,43,76
SC Rheindorf,5422,2,22,8,6,60,39,21,74
SK Sturm Gra,5422,3,16,9,11,55,40,15,57
Vienna,5422,4,16,9,11,61,49,12,57
Rapid Vienna,5422,5,12,14,10,58,45,13,50
RZ Pellets W,5422,6,12,11,13,47,52,-5,47
Admira Wacke,5422,7,11,7,18,36,62,-26,40
SV Josko Rie,5422,8,10,4,22,31,52,-21,34
Mattersburg,5422,9,7,11,18,40,56,-16,32
St. Pölten,5422,10,6,10,20,33,69,-36,28
SC Rheindorf,5423,1,23,5,8,62,37,25,74
SK Sturm Gra,5423,2,20,6,10,54,33,21,66
Vienna,5423,3,19,6,11,64,47,17,63
FC Salzburg,5423,4,18,7,11,63,39,24,61
Rapid Vienna,5423,5,12,13,11,50,39,11,49
Admira Wacke,5423,6,12,6,18,33,59,-26,42
RZ Pellets W,5423,7,10,10,16,39,57,-18,40
SV Josko Rie,5423,8,10,6,20,34,51,-17,36
St. Pölten,5423,9,9,9,18,38,60,-22,36
Mattersburg,5423,10,9,8,19,37,52,-15,35
SK Sturm Gra,5424,1,23,6,7,62,30,32,75
FC Salzburg,5424,2,17,10,9,52,33,19,61
Vienna,5424,3,19,3,14,59,51,8,60
SC Rheindorf,5424,4,17,8,11,54,43,11,59
Rapid Vienna,5424,5,15,10,11,60,41,19,55
Admira Wacke,5424,6,12,7,17,38,61,-23,43
St. Pölten,5424,7,11,9,16,46,64,-18,42
RZ Pellets W,5424,8,11,6,19,43,53,-10,39
Mattersburg,5424,9,8,12,16,35,52,-17,36
SV Josko Rie,5424,10,8,7,21,33,54,-21,31
FC Salzburg,5425,1,20,9,7,63,32,31,69
SC Rheindorf,5425,2,18,12,6,55,40,15,66
Vienna,5425,3,18,5,13,65,49,16,59
SK Sturm Gra,5425,4,15,10,11,51,36,15,55
Rapid Vienna,5425,5,13,11,12,55,46,9,50
Admira Wacke,5425,6,14,7,15,45,59,-14,49
RZ Pellets W,5425,7,10,8,18,35,54,-19,38
St. Pölten,5425,8,8,13,15,45,62,-17,37
SV Josko Rie,5425,9,11,4,21,34,59,-25,37
Mattersburg,5425,10,9,9,18,36,47,-11,36
FC Salzburg,5426,1,24,5,7,72,32,40,77
SC Rheindorf,5426,2,20,6,10,58,43,15,66
SK Sturm Gra,5426,3,19,5,12,60,42,18,62
Vienna,5426,4,18,6,12,61,52,9,60
Rapid Vienna,5426,5,15,8,13,59,46,13,53
Mattersburg,5426,6,13,7,16,41,51,-10,46
RZ Pellets W,5426,7,12,6,18,44,55,-11,42
Admira Wacke,5426,8,12,4,20,35,67,-32,40
St. Pölten,5426,9,8,8,20,45,66,-21,32
SV Josko Rie,5426,10,9,5,22,32,53,-21,32
FC Salzburg,5427,1,20,10,6,57,26,31,70
SC Rheindorf,5427,2,19,9,8,58,38,20,66
Vienna,5427,3,19,5,12,63,51,12,62
Rapid Vienna,5427,4,16,10,10,52,34,18,58
SK Sturm Gra,5427,5,15,9,12,48,34,14,54
RZ Pellets W,5427,6,15,5,16,55,53,2,50
Admira Wacke,5427,7,11,6,19,34,60,-26,39
Mattersburg,5427,8,9,10,17,34,51,-17,37
St. Pölten,5427,9,7,11,18,36,66,-30,32
SV Josko Rie,5427,10,7,9,20,31,55,-24,30
FC Salzburg,5428,1,19,11,6,62,28,34,68
SC Rheindorf,5428,2,19,8,9,60,43,17,65
SK Sturm Gra,5428,3,17,7,12,60,41,19,58
Vienna,5428,4,16,5,15,54,56,-2,53
Rapid Vienna,5428,5,13,12,11,55,41,14,51
Admira Wacke,5428,6,15,6,15,45,54,-9,51
RZ Pellets W,5428,7,12,9,15,50,54,-4,45
SV Josko Rie,5428,8,10,8,18,38,61,-23,38
Mattersburg,5428,9,8,12,16,37,54,-17,36
St. Pölten,5428,10,6,12,18,42,71,-29,30
FC Salzburg,5429,1,23,5,8,66,27,39,74
SC Rheindorf,5429,2,20,7,9,57,40,17,67
Vienna,5429,3,21,2,13,71,51,20,65
SK Sturm Gra,5429,4,20,5,11,64,47,17,65
Rapid Vienna,5429,5,16,9,11,70,46,24,57
RZ Pellets W,5429,6,13,6,17,56,65,-9,45
Mattersburg,5429,7,10,8,18,42,56,-14,38
SV Josko Rie,5429,8,11,2,23,35,63,-28,35
Admira Wacke,5429,9,10,4,22,33,72,-39,34
St. Pölten,5429,10,9,6,21,49,76,-27,33
FC Salzburg,5430,1,24,4,8,73,29,44,76
Vienna,5430,2,21,5,10,61,49,12,68
SK Sturm Gra,5430,3,19,4,13,58,37,21,61
SC Rheindorf,5430,4,16,9,11,49,43,6,57
Rapid Vienna,5430,5,14,10,12,61,43,18,52
RZ Pellets W,5430,6,11,9,16,43,53,-10,42
SV Josko Rie,5430,7,13,3,20,33,48,-15,42
Admira Wacke,5430,8,11,6,19,35,67,-32,39
Mattersburg,5430,9,8,11,17,32,51,-19,35
St. Pölten,5430,10,8,9,19,38,63,-25,33
FC Salzburg,5431,1,22,8,6,71,30,41,74
SC Rheindorf,5431,2,19,7,10,60,46,14,64
SK Sturm Gra,5431,3,18,9,9,59,34,25,63
Vienna,5431,4,19,5,12,55,50,5,62
Rapid Vienna,5431,5,14,10,12,61,42,19,52
RZ Pellets W,5431,6,13,7,16,46,57,-11,46
SV Josko Rie,5431,7,11,5,20,31,50,-19,38
Admira Wacke,5431,8,9,8,19,36,63,-27,35
St. Pölten,5431,9,8,10,18,42,59,-17,34
Mattersburg,5431,10,8,9,19,35,65,-30,33
FC Salzburg,5432,1,24,6,6,68,25,43,78
SC Rheindorf,5432,2,21,8,7,58,37,21,71
SK Sturm Gra,5432,3,21,4,11,62,37,25,67
Vienna,5432,4,21,3,12,66,46,20,66
RZ Pellets W,5432,5,14,5,17,45,53,-8,47
Rapid Vienna,5432,6,11,9,16,48,43,5,42
Mattersburg,5432,7,11,6,19,37,59,-22,39
SV Josko Rie,5432,8,10,5,21,28,55,-27,35
St. Pölten,5432,9,8,9,19,41,62,-21,33
Admira Wacke,5432,10,9,5,22,33,69,-36,32
FC Salzburg,5433,1,21,8,7,60,27,33,71
SK Sturm Gra,5433,2,20,8,8,61,34,27,68
SC Rheindorf,5433,3,20,7,9,60,34,26,67
Vienna,5433,4,19,3,14,64,60,4,60
Rapid Vienna,5433,5,13,10,13,56,45,11,49
RZ Pellets W,5433,6,11,8,17,43,56,-13,41
Mattersburg,5433,7,10,10,16,34,49,-15,40
Admira Wacke,5433,8,11,7,18,37,61,-24,40
SV Josko Rie,5433,9,10,4,22,33,58,-25,34
St. Pölten,5433,10,8,9,19,42,66,-24,33
FC Salzburg,5434,1,22,7,7,70,27,43,73
SC Rheindorf,5434,2,21,8,7,57,39,18,71
Vienna,5434,3,19,4,13,63,55,8,61
SK Sturm Gra,5434,4,18,6,12,60,37,23,60
Rapid Vienna,5434,5,16,9,11,56,44,12,57
RZ Pellets W,5434,6,13,6,17,44,55,-11,45
SV Josko Rie,5434,7,13,5,18,39,52,-13,44
Admira Wacke,5434,8,11,4,21,31,56,-25,37
Mattersburg,5434,9,7,9,20,38,61,-23,30
St. Pölten,5434,10,7,8,21,33,65,-32,29
FC Salzburg,5435,1,22,7,7,65,28,37,73
SC Rheindorf,5435,2,20,6,10,57,43,14,66
Vienna,5435,3,19,6,11,64,52,12,63
SK Sturm Gra,5435,4,15,10,11,53,35,18,55
Rapid Vienna,5435,5,14,10,12,57,41,16,52
RZ Pellets W,5435,6,15,6,15,47,57,-10,51
Admira Wacke,5435,7,10,8,18,43,68,-25,38
St. Pölten,5435,8,9,10,17,44,62,-18,37
SV Josko Rie,5435,9,10,5,21,31,55,-24,35
Mattersburg,5435,10,7,10,19,38,58,-20,31
Vienna,5436,1,21,6,9,68,42,26,69
SC Rheindorf,5436,2,21,6,9,64,44,20,69
FC Salzburg,5436,3,20,6,10,64,36,28,66
SK Sturm Gra,5436,4,18,8,10,56,38,18,62
Rapid Vienna,5436,5,13,11,12,57,45,12,50
Admira Wacke,5436,6,13,6,17,39,59,-20,45
RZ Pellets W,5436,7,11,7,18,37,56,-19,40
Mattersburg,5436,8,10,7,19,38,55,-17,37
St. Pölten,5436,9,7,13,16,43,63,-20,34
SV Josko Rie,5436,10,8,6,22,28,56,-28,30
SC Rheindorf,5437,1,20,8,8,63,48,15,68
FC Salzburg,5437,2,17,10,9,62,37,25,61
SK Sturm Gra,5437,3,18,7,11,61,38,23,61
Rapid Vienna,5437,4,16,10,10,60,42,18,58
Vienna,5437,5,17,6,13,67,59,8,57
RZ Pellets W,5437,6,10,11,15,44,56,-12,41
Mattersburg,5437,7,10,10,16,33,45,-12,40
Admira Wacke,5437,8,10,8,18,33,54,-21,38
St. Pölten,5437,9,10,8,18,43,68,-25,38
SV Josko Rie,5437,10,9,8,19,36,55,-19,35
FC Salzburg,5438,1,21,8,7,62,28,34,71
SK Sturm Gra,5438,2,21,5,10,52,29,23,68
Vienna,5438,3,18,6,12,64,55,9,60
SC Rheindorf,5438,4,17,7,12,54,44,10,58
Rapid Vienna,5438,5,14,11,11,58,38,20,53
RZ Pellets W,5438,6,13,8,15,50,56,-6,47
SV Josko Rie,5438,7,13,3,20,38,49,-11,42
Admira Wacke,5438,8,11,6,19,33,64,-31,39
Mattersburg,5438,9,8,11,17,40,58,-18,35
St. Pölten,5438,10,6,11,19,34,64,-30,29
FC Salzburg,5439,1,22,6,8,64,27,37,72
SC Rheindorf,5439,2,22,6,8,56,42,14,72
SK Sturm Gra,5439,3,22,3,11,62,32,30,69
Vienna,5439,4,18,4,14,70,56,14,58
RZ Pellets W,5439,5,13,7,16,44,54,-10,46
Mattersburg,5439,6,11,8,17,48,55,-7,41
SV Josko Rie,5439,7,12,5,19,37,59,-22,41
Rapid Vienna,5439,8,10,10,16,51,52,-1,40
Admira Wacke,5439,9,11,6,19,36,64,-28,39
St. Pölten,5439,10,7,9,20,40,67,-27,30
FC Salzburg,5440,1,23,6,7,73,30,43,75
SC Rheindorf,5440,2,23,5,8,57,39,18,74
Vienna,5440,3,21,5,10,65,47,18,68
Rapid Vienna,5440,4,16,11,9,58,38,20,59
SK Sturm Gra,5440,5,16,5,15,55,41,14,53
RZ Pellets W,5440,6,13,9,14,49,57,-8,48
SV Josko Rie,5440,7,12,2,22,43,69,-26,38
Admira Wacke,5440,8,8,10,18,36,64,-28,34
Mattersburg,5440,9,8,6,22,35,61,-26,30
St. Pölten,5440,10,7,7,22,40,65,-25,28
FC Salzburg,5441,1,22,7,7,67,26,41,73
SC Rheindorf,5441,2,19,8,9,60,47,13,65
SK Sturm Gra,5441,3,19,7,10,61,37,24,64
Vienna,5441,4,19,3,14,61,59,2,60
Rapid Vienna,5441,5,15,8,13,58,44,14,53
SV Josko Rie,5441,6,14,4,18,38,50,-12,46
RZ Pellets W,5441,7,12,6,18,47,56,-9,42
Admira Wacke,5441,8,10,7,19,39,64,-25,37
St. Pölten,5441,9,10,6,20,46,70,-24,36
Mattersburg,5441,10,9,6,21,37,61,-24,33
FC Salzburg,5442,1,21,8,7,67,32,35,71
SK Sturm Gra,5442,2,20,9,7,59,30,29,69
Vienna,5442,3,16,8,12,56,49,7,56
SC Rheindorf,5442,4,16,8,12,53,47,6,56
RZ Pellets W,5442,5,14,8,14,51,56,-5,50
Rapid Vienna,5442,6,12,13,11,56,47,9,49
SV Josko Rie,5442,7,11,7,18,42,55,-13,40
St. Pölten,5442,8,9,11,16,42,61,-19,38
Admira Wacke,5442,9,10,7,19,40,63,-23,37
Mattersburg,5442,10,7,9,20,34,60,-26,30
FC Salzburg,5443,1,23,7,6,69,28,41,76
SC Rheindorf,5443,2,21,6,9,58,40,18,69
SK Sturm Gra,5443,3,19,6,11,56,36,20,63
Vienna,5443,4,17,3,16,55,55,0,54
Rapid Vienna,5443,5,13,10,13,55,40,15,49
Admira Wacke,5443,6,13,5,18,42,61,-19,44
Mattersburg,5443,7,11,8,17,44,57,-13,41
RZ Pellets W,5443,8,10,10,16,44,55,-11,40
SV Josko Rie,5443,9,12,4,20,30,53,-23,40
St. Pölten,5443,10,7,9,20,37,65,-28,30
FC Salzburg,5444,1,22,9,5,76,29,47,75
SC Rheindorf,5444,2,22,8,6,67,40,27,74
SK Sturm Gra,5444,3,17,6,13,54,38,16,57
Vienna,5444,4,16,7,13,61,56,5,55
Rapid Vienna,5444,5,12,14,10,48,38,10,50
Admira Wacke,5444,6,13,7,16,39,62,-23,46
RZ Pellets W,5444,7,11,8,17,42,54,-12,41
SV Josko Rie,5444,8,11,5,20,37,54,-17,38
St. Pölten,5444,9,8,11,17,48,73,-25,35
Mattersburg,5444,10,7,7,22,35,63,-28,28
FC Salzburg,5445,1,20,8,8,63,30,33,68
SC Rheindorf,5445,2,20,7,9,59,41,18,67
SK Sturm Gra,5445,3,20,6,10,60,34,26,66
Vienna,5445,4,20,4,12,59,47,12,64
Rapid Vienna,5445,5,16,9,11,60,41,19,57
St. Pölten,5445,6,11,10,15,44,58,-14,43
Admira Wacke,5445,7,9,9,18,38,60,-22,36
RZ Pellets W,5445,8,10,5,21,39,67,-28,35
SV Josko Rie,5445,9,9,7,20,31,52,-21,34
Mattersburg,5445,10,8,9,19,34,57,-23,33
FC Salzburg,5446,1,19,12,5,67,32,35,69
SC Rheindorf,5446,2,20,8,8,56,39,17,68
SK Sturm Gra,5446,3,19,6,11,55,33,22,63
Vienna,5446,4,19,5,12,67,51,16,62
Rapid Vienna,5446,5,14,9,13,50,43,7,51
RZ Pellets W,5446,6,13,6,17,46,59,-13,45
Admira Wacke,5446,7,12,7,17,47,63,-16,43
SV Josko Rie,5446,8,10,6,20,38,57,-19,36
St. Pölten,5446,9,9,9,18,45,70,-25,36
Mattersburg,5446,10,6,10,20,37,61,-24,28
Vienna,5447,1,22,4,10,77,46,31,70
FC Salzburg,5447,2,19,7,10,62,34,28,64
SC Rheindorf,5447,3,19,7,10,57,45,12,64
SK Sturm Gra,5447,4,18,8,10,51,34,17,62
Rapid Vienna,5447,5,14,11,11,48,42,6,53
Admira Wacke,5447,6,14,7,15,44,52,-8,49
RZ Pellets W,5447,7,12,6,18,53,64,-11,42
Mattersburg,5447,8,9,9,18,40,60,-20,36
SV Josko Rie,5447,9,10,6,20,32,52,-20,36
St. Pölten,5447,10,7,7,22,32,67,-35,28
Vienna,5448,1,21,6,9,72,51,21,69
SC Rheindorf,5448,2,20,5,11,61,50,11,65
FC Salzburg,5448,3,18,10,8,65,35,30,64
SK Sturm Gra,5448,4,19,6,11,60,37,23,63
RZ Pellets W,5448,5,15,8,13,43,45,-2,53
Rapid Vienna,5448,6,10,13,13,54,49,5,43
Admira Wacke,5448,7,11,7,18,43,61,-18,40
SV Josko Rie,5448,8,10,7,19,36,58,-22,37
St. Pölten,5448,9,8,10,18,46,71,-25,34
Mattersburg,5448,10,8,8,20,41,64,-23,32
SC Rheindorf,5449,1,22,5,9,62,43,19,71
SK Sturm Gra,5449,2,21,6,9,58,30,28,69
FC Salzburg,5449,3,20,6,10,65,36,29,66
Vienna,5449,4,17,6,13,62,58,4,57
Rapid Vienna,5449,5,14,10,12,57,44,13,52
SV Josko Rie,5449,6,13,6,17,42,47,-5,45
St. Pölten,5449,7,11,10,15,44,63,-19,43
RZ Pellets W,5449,8,11,8,17,39,49,-10,41
Admira Wacke,5449,9,10,6,20,40,63,-23,36
Mattersburg,5449,10,5,9,22,32,68,-36,24
Rapid Vienna,5450,1,19,10,7,63,32,31,67
SK Sturm Gra,5450,2,20,6,10,69,35,34,66
FC Salzburg,5450,3,18,11,7,59,29,30,65
SC Rheindorf,5450,4,17,9,10,53,44,9,60
Vienna,5450,5,19,3,14,58,53,5,60
RZ Pellets W,5450,6,12,9,15,47,53,-6,45
Admira Wacke,5450,7,11,5,20,35,68,-33,38
St. Pölten,5450,8,8,9,19,41,66,-25,33
SV Josko Rie,5450,9,9,6,21,30,55,-25,33
Mattersburg,5450,10,6,14,16,32,52,-20,32
SC Rheindorf,5451,1,22,7,7,56,31,25,73
FC Salzburg,5451,2,20,9,7,63,26,37,69
SK Sturm Gra,5451,3,18,9,9,55,32,23,63
Rapid Vienna,5451,4,15,11,10,56,36,20,56
Vienna,5451,5,15,5,16,52,53,-1,50
Admira Wacke,5451,6,12,6,18,38,58,-20,42
Mattersburg,5451,7,11,7,18,39,58,-19,40
RZ Pellets W,5451,8,10,9,17,45,56,-11,39
SV Josko Rie,5451,9,10,7,19,37,56,-19,37
St. Pölten,5451,10,8,8,20,35,70,-35,32
FC Salzburg,5452,1,23,4,9,68,34,34,73
SK Sturm Gra,5452,2,20,6,10,57,30,27,66
Vienna,5452,3,21,3,12,69,54,15,66
SC Rheindorf,5452,4,19,4,13,54,47,7,61
Rapid Vienna,5452,5,17,9,10,61,38,23,60
RZ Pellets W,5452,6,11,8,17,41,62,-21,41
Admira Wacke,5452,7,11,5,20,36,54,-18,38
SV Josko Rie,5452,8,11,4,21,33,49,-16,37
St. Pölten,5452,9,9,10,17,42,64,-22,37
Mattersburg,5452,10,8,7,21,34,63,-29,31
FC Salzburg,5453,1,23,7,6,66,28,38,76
SC Rheindorf,5453,2,19,7,10,55,41,14,64
SK Sturm Gra,5453,3,19,6,11,55,33,22,63
Rapid Vienna,5453,4,17,10,9,57,34,23,61
Vienna,5453,5,17,6,13,58,51,7,57
Admira Wacke,5453,6,14,6,16,39,54,-15,48
RZ Pellets W,5453,7,10,9,17,43,56,-13,39
St. Pölten,5453,8,7,12,17,37,59,-22,33
Mattersburg,5453,9,7,11,18,36,61,-25,32
SV Josko Rie,5453,10,8,4,24,28,57,-29,28
FC Salzburg,5454,1,21,9,6,69,34,35,72
SC Rheindorf,5454,2,19,8,9,55,42,13,65
SK Sturm Gra,5454,3,18,5,13,54,40,14,59
Vienna,5454,4,16,8,12,57,52,5,56
Rapid Vienna,5454,5,15,8,13,59,38,21,53
RZ Pellets W,5454,6,12,7,17,48,62,-14,43
Admira Wacke,5454,7,11,10,15,44,61,-17,43
SV Josko Rie,5454,8,12,5,19,38,52,-14,41
St. Pölten,5454,9,9,10,17,47,66,-19,37
Mattersburg,5454,10,8,8,20,38,62,-24,32
FC Salzburg,5455,1,22,10,4,67,24,43,76
SC Rheindorf,5455,2,20,7,9,58,36,22,67
SK Sturm Gra,5455,3,19,9,8,57,34,23,66
Vienna,5455,4,18,7,11,58,47,11,61
Rapid Vienna,5455,5,11,13,12,48,40,8,46
RZ Pellets W,5455,6,13,7,16,49,53,-4,46
SV Josko Rie,5455,7,13,6,17,40,51,-11,45
St. Pölten,5455,8,7,10,19,37,62,-25,31
Admira Wacke,5455,9,8,7,21,34,68,-34,31
Mattersburg,5455,10,7,8,21,35,68,-33,29
SC Rheindorf,5456,1,22,7,7,61,35,26,73
FC Salzburg,5456,2,21,8,7,64,32,32,71
SK Sturm Gra,5456,3,18,9,9,63,35,28,63
Vienna,5456,4,19,5,12,62,57,5,62
Rapid Vienna,5456,5,12,11,13,55,46,9,47
RZ Pellets W,5456,6,13,6,17,45,54,-9,45
SV Josko Rie,5456,7,11,5,20,34,53,-19,38
Admira Wacke,5456,8,10,7,19,37,60,-23,37
St. Pölten,5456,9,8,10,18,37,65,-28,34
Mattersburg,5456,10,8,8,20,35,56,-21,32
FC Salzburg,5457,1,21,9,6,67,28,39,72
SC Rheindorf,5457,2,19,9,8,58,46,12,66
Vienna,5457,3,18,8,10,57,45,12,62
Rapid Vienna,5457,4,16,12,8,60,37,23,60
SK Sturm Gra,5457,5,16,7,13,56,39,17,55
Admira Wacke,5457,6,12,7,17,38,56,-18,43
RZ Pellets W,5457,7,11,7,18,40,56,-16,40
SV Josko Rie,5457,8,11,4,21,37,55,-18,37
St. Pölten,5457,9,9,10,17,41,64,-23,37
Mattersburg,5457,10,6,9,21,28,56,-28,27
FC Salzburg,5458,1,22,7,7,69,34,35,73
SC Rheindorf,5458,2,18,9,9,57,44,13,63
Vienna,5458,3,19,5,12,62,43,19,62
SK Sturm Gra,5458,4,18,7,11,57,34,23,61
Rapid Vienna,5458,5,14,11,11,58,42,16,53
RZ Pellets W,5458,6,13,10,13,42,48,-6,49
Admira Wacke,5458,7,12,6,18,41,59,-18,42
Mattersburg,5458,8,8,9,19,35,58,-23,33
SV Josko Rie,5458,9,8,8,20,33,62,-29,32
St. Pölten,5458,10,6,12,18,38,68,-30,30
FC Salzburg,5459,1,20,9,7,68,30,38,69
SC Rheindorf,5459,2,20,7,9,56,46,10,67
SK Sturm Gra,5459,3,18,8,10,54,34,20,62
Vienna,5459,4,17,6,13,64,54,10,57
Rapid Vienna,5459,5,11,14,11,56,47,9,47
RZ Pellets W,5459,6,12,10,14,52,58,-6,46
Admira Wacke,5459,7,13,6,17,47,65,-18,45
SV Josko Rie,5459,8,11,7,18,31,51,-20,40
St. Pölten,5459,9,9,7,20,38,60,-22,34
Mattersburg,5459,10,7,10,19,33,54,-21,31
FC Salzburg,5460,1,22,8,6,66,29,37,74
SK Sturm Gra,5460,2,21,6,9,61,31,30,69
SC Rheindorf,5460,3,20,8,8,59,42,17,68
Vienna,5460,4,19,5,12,62,58,4,62
Rapid Vienna,5460,5,11,12,13,52,44,8,45
RZ Pellets W,5460,6,11,9,16,45,56,-11,42
Admira Wacke,5460,7,12,6,18,36,60,-24,42
St. Pölten,5460,8,9,8,19,40,68,-28,35
SV Josko Rie,5460,9,8,7,21,35,50,-15,31
Mattersburg,5460,10,6,13,17,40,58,-18,31
SK Sturm Gra,5461,1,22,7,7,66,31,35,73
SC Rheindorf,5461,2,20,6,10,59,45,14,66
FC Salzburg,5461,3,18,7,11,63,38,25,61
Vienna,5461,4,18,3,15,63,54,9,57
Rapid Vienna,5461,5,14,9,13,49,43,6,51
RZ Pellets W,5461,6,12,8,16,47,59,-12,44
Admira Wacke,5461,7,11,9,16,41,58,-17,42
SV Josko Rie,5461,8,12,5,19,36,53,-17,41
St. Pölten,5461,9,8,12,16,42,61,-19,36
Mattersburg,5461,10,8,8,20,39,63,-24,32
SC Rheindorf,5462,1,23,7,6,59,35,24,76
SK Sturm Gra,5462,2,20,5,11,63,31,32,65
FC Salzburg,5462,3,18,10,8,54,30,24,64
Vienna,5462,4,17,7,12,59,53,6,58
RZ Pellets W,5462,5,13,7,16,51,61,-10,46
Admira Wacke,5462,6,13,6,17,39,54,-15,45
Rapid Vienna,5462,7,11,11,14,47,43,4,44
St. Pölten,5462,8,9,11,16,44,63,-19,38
Mattersburg,5462,9,8,9,19,33,53,-20,33
SV Josko Rie,5462,10,10,3,23,31,57,-26,33
FC Salzburg,5463,1,20,7,9,65,40,25,67
SC Rheindorf,5463,2,20,6,10,57,47,10,66
Vienna,5463,3,21,2,13,66,51,15,65
SK Sturm Gra,5463,4,17,8,11,54,35,19,59
Rapid Vienna,5463,5,14,9,13,56,48,8,51
RZ Pellets W,5463,6,15,6,15,56,63,-7,51
Admira Wacke,5463,7,12,5,19,39,59,-20,41
Mattersburg,5463,8,10,7,19,38,51,-13,37
SV Josko Rie,5463,9,10,6,20,34,51,-17,36
St. Pölten,5463,10,8,10,18,41,61,-20,34
FC Salzburg,5464,1,25,5,6,75,25,50,80
Vienna,5464,2,19,4,13,66,54,12,61
SK Sturm Gra,5464,3,17,7,12,60,43,17,58
SC Rheindorf,5464,4,14,8,14,46,49,-3,50
SV Josko Rie,5464,5,14,5,17,37,48,-11,47
Rapid Vienna,5464,6,12,10,14,48,45,3,46
RZ Pellets W,5464,7,13,7,16,43,51,-8,46
Admira Wacke,5464,8,12,8,16,35,52,-17,44
Mattersburg,5464,9,9,9,18,34,55,-21,36
St. Pölten,5464,10,8,11,17,44,66,-22,35
FC Salzburg,5465,1,22,8,6,65,28,37,74
SK Sturm Gra,5465,2,20,6,10,68,39,29,66
SC Rheindorf,5465,3,18,10,8,57,41,16,64
Vienna,5465,4,17,6,13,58,48,10,57
Admira Wacke,5465,5,15,5,16,44,60,-16,50
RZ Pellets W,5465,6,14,7,15,45,50,-5,49
Rapid Vienna,5465,7,11,11,14,51,49,2,44
SV Josko Rie,5465,8,11,4,21,35,54,-19,37
St. Pölten,5465,9,9,9,18,46,66,-20,36
Mattersburg,5465,10,7,6,23,37,71,-34,27
Vienna,5466,1,20,5,11,58,44,14,65
FC Salzburg,5466,2,18,10,8,62,34,28,64
SK Sturm Gra,5466,3,18,8,10,61,38,23,62
SC Rheindorf,5466,4,17,10,9,53,47,6,61
Rapid Vienna,5466,5,15,11,10,60,41,19,56
RZ Pellets W,5466,6,12,9,15,41,51,-10,45
SV Josko Rie,5466,7,13,4,19,35,54,-19,43
Admira Wacke,5466,8,11,8,17,38,55,-17,41
St. Pölten,5466,9,7,13,16,43,58,-15,34
Mattersburg,5466,10,6,8,22,31,60,-29,26
Vienna,5467,1,21,5,10,68,49,19,68
FC Salzburg,5467,2,19,9,8,71,36,35,66
SC Rheindorf,5467,3,18,6,12,51,48,3,60
SK Sturm Gra,5467,4,17,8,11,53,34,19,59
Rapid Vienna,5467,5,15,13,8,62,37,25,58
RZ Pellets W,5467,6,13,6,17,47,61,-14,45
Mattersburg,5467,7,10,8,18,39,54,-15,38
SV Josko Rie,5467,8,11,5,20,33,54,-21,38
Admira Wacke,5467,9,9,10,17,36,59,-23,37
St. Pölten,5467,10,8,8,20,41,69,-28,32
FC Salzburg,5468,1,22,7,7,67,37,30,73
SK Sturm Gra,5468,2,19,7,10,61,38,23,64
Vienna,5468,3,19,4,13,71,60,11,61
SC Rheindorf,5468,4,16,8,12,48,43,5,56
Rapid Vienna,5468,5,11,13,12,50,46,4,46
SV Josko Rie,5468,6,13,3,20,40,53,-13,42
RZ Pellets W,5468,7,12,5,19,43,57,-14,41
Admira Wacke,5468,8,11,8,17,42,60,-18,41
Mattersburg,5468,9,10,10,16,36,51,-15,40
St. Pölten,5468,10,9,11,16,47,60,-13,38
FC Salzburg,5469,1,23,8,5,67,28,39,77
SC Rheindorf,5469,2,20,7,9,64,44,20,67
SK Sturm Gra,5469,3,20,4,12,59,39,20,64
Vienna,5469,4,19,4,13,67,55,12,61
Rapid Vienna,5469,5,14,10,12,58,42,16,52
RZ Pellets W,5469,6,13,7,16,46,54,-8,46
Admira Wacke,5469,7,11,8,17,38,59,-21,41
SV Josko Rie,5469,8,10,3,23,36,64,-28,33
Mattersburg,5469,9,7,11,18,37,56,-19,32
St. Pölten,5469,10,8,8,20,41,72,-31,32
SC Rheindorf,5470,1,24,5,7,71,37,34,77
SK Sturm Gra,5470,2,23,3,10,66,32,34,72
FC Salzburg,5470,3,21,7,8,66,28,38,70
Vienna,5470,4,19,4,13,62,52,10,61
Rapid Vienna,5470,5,13,11,12,52,40,12,50
RZ Pellets W,5470,6,13,8,15,41,49,-8,47
SV Josko Rie,5470,7,10,5,21,33,55,-22,35
Mattersburg,5470,8,8,10,18,34,59,-25,34
Admira Wacke,5470,9,8,8,20,30,66,-36,32
St. Pölten,5470,10,7,7,22,41,78,-37,28
FC Salzburg,5471,1,20,7,9,60,27,33,67
SC Rheindorf,5471,2,19,7,10,59,41,18,64
Vienna,5471,3,20,4,12,67,50,17,64
SK Sturm Gra,5471,4,19,5,12,54,35,19,62
Rapid Vienna,5471,5,14,11,11,52,40,12,53
SV Josko Rie,5471,6,14,6,16,36,45,-9,48
RZ Pellets W,5471,7,12,8,16,44,58,-14,44
Mattersburg,5471,8,10,5,21,35,61,-26,35
Admira Wacke,5471,9,10,5,21,30,59,-29,35
St. Pölten,5471,10,8,10,18,42,63,-21,34
FC Salzburg,5472,1,22,7,7,62,26,36,73
Vienna,5472,2,20,7,9,61,44,17,67
SC Rheindorf,5472,3,17,11,8,52,42,10,62
SK Sturm Gra,5472,4,18,5,13,62,39,23,59
Rapid Vienna,5472,5,14,10,12,57,37,20,52
SV Josko Rie,5472,6,13,4,19,38,55,-17,43
St. Pölten,5472,7,10,10,16,44,60,-16,40
RZ Pellets W,5472,8,10,7,19,38,61,-23,37
Mattersburg,5472,9,10,6,20,33,53,-20,36
Admira Wacke,5472,10,10,5,21,33,63,-30,35
SC Rheindorf,5473,1,20,7,9,59,46,13,67
FC Salzburg,5473,2,19,7,10,67,43,24,64
Vienna,5473,3,17,7,12,61,52,9,58
RZ Pellets W,5473,4,17,6,13,59,56,3,57
SK Sturm Gra,5473,5,15,8,13,56,44,12,53
Rapid Vienna,5473,6,13,13,10,53,38,15,52
Admira Wacke,5473,7,13,7,16,44,57,-13,46
SV Josko Rie,5473,8,10,8,18,29,47,-18,38
Mattersburg,5473,9,7,11,18,39,58,-19,32
St. Pölten,5473,10,7,10,19,44,70,-26,31
FC Salzburg,5474,1,22,7,7,65,31,34,73
SK Sturm Gra,5474,2,21,5,10,67,33,34,68
SC Rheindorf,5474,3,17,12,7,48,37,11,63
Vienna,5474,4,15,8,13,60,53,7,53
Rapid Vienna,5474,5,13,10,13,52,45,7,49
RZ Pellets W,5474,6,13,7,16,46,55,-9,46
Mattersburg,5474,7,12,5,19,41,54,-13,41
SV Josko Rie,5474,8,11,5,20,31,51,-20,38
St. Pölten,5474,9,10,7,19,45,67,-22,37
Admira Wacke,5474,10,9,8,19,33,62,-29,35
FC Salzburg,5475,1,21,6,9,67,38,29,69
SK Sturm Gra,5475,2,19,7,10,57,31,26,64
SC Rheindorf,5475,3,18,10,8,61,50,11,64
Vienna,5475,4,17,5,14,55,51,4,56
RZ Pellets W,5475,5,15,7,14,51,56,-5,52
Rapid Vienna,5475,6,13,10,13,53,44,9,49
Admira Wacke,5475,7,14,4,18,43,53,-10,46
SV Josko Rie,5475,8,11,7,18,35,56,-21,40
Mattersburg,5475,9,9,9,18,47,61,-14,36
St. Pölten,5475,10,6,9,21,42,71,-29,27
SC Rheindorf,5476,1,22,7,7,59,36,23,73
SK Sturm Gra,5476,2,22,5,9,58,28,30,71
FC Salzburg,5476,3,20,8,8,65,33,32,68
Vienna,5476,4,19,3,14,63,52,11,60
Rapid Vienna,5476,5,14,11,11,49,36,13,53
RZ Pellets W,5476,6,13,9,14,45,54,-9,48
SV Josko Rie,5476,7,9,9,18,31,49,-18,36
Admira Wacke,5476,8,10,5,21,31,63,-32,35
St. Pölten,5476,9,7,11,18,34,59,-25,32
Mattersburg,5476,10,6,8,22,30,55,-25,26
FC Salzburg,5477,1,20,9,7,69,31,38,69
Vienna,5477,2,20,5,11,63,50,13,65
SC Rheindorf,5477,3,18,10,8,53,42,11,64
SK Sturm Gra,5477,4,19,4,13,61,40,21,61
Rapid Vienna,5477,5,11,13,12,46,40,6,46
Admira Wacke,5477,6,12,6,18,37,63,-26,42
RZ Pellets W,5477,7,11,8,17,47,58,-11,41
St. Pölten,5477,8,11,8,17,52,64,-12,41
SV Josko Rie,5477,9,10,8,18,30,53,-23,38
Mattersburg,5477,10,8,9,19,42,59,-17,33
SC Rheindorf,5478,1,21,7,8,58,37,21,70
FC Salzburg,5478,2,20,8,8,61,33,28,68
Vienna,5478,3,21,3,12,66,49,17,66
SK Sturm Gra,5478,4,18,7,11,63,36,27,61
Rapid Vienna,5478,5,15,10,11,61,47,14,55
RZ Pellets W,5478,6,11,10,15,43,54,-11,43
Admira Wacke,5478,7,11,7,18,36,58,-22,40
Mattersburg,5478,8,9,9,18,37,57,-20,36
SV Josko Rie,5478,9,10,5,21,37,59,-22,35
St. Pölten,5478,10,6,10,20,43,75,-32,28
SK Sturm Gra,5479,1,22,5,9,59,31,28,71
SC Rheindorf,5479,2,21,7,8,61,41,20,70
FC Salzburg,5479,3,19,7,10,62,38,24,64
Vienna,5479,4,16,5,15,56,56,0,53
Rapid Vienna,5479,5,12,13,11,48,40,8,49
RZ Pellets W,5479,6,12,10,14,50,56,-6,46
St. Pölten,5479,7,11,10,15,52,62,-10,43
Admira Wacke,5479,8,11,6,19,38,62,-24,39
SV Josko Rie,5479,9,10,6,20,39,53,-14,36
Mattersburg,5479,10,7,9,20,36,62,-26,30
SK Sturm Gra,5480,1,22,5,9,64,32,32,71
FC Salzburg,5480,2,20,9,7,66,33,33,69
SC Rheindorf,5480,3,20,5,11,56,47,9,65
Vienna,5480,4,18,5,13,66,58,8,59
Rapid Vienna,5480,5,13,11,12,59,44,15,50
RZ Pellets W,5480,6,11,8,17,45,59,-14,41
Admira Wacke,5480,7,10,9,17,40,62,-22,39
Mattersburg,5480,8,9,11,16,47,62,-15,38
St. Pölten,5480,9,9,10,17,46,66,-20,37
SV Josko Rie,5480,10,9,5,22,32,58,-26,32
SK Sturm Gra,5481,1,21,6,9,55,25,30,69
Vienna,5481,2,19,5,12,53,44,9,62
FC Salzburg,5481,3,18,7,11,56,33,23,61
SC Rheindorf,5481,4,17,10,9,47,39,8,61
Rapid Vienna,5481,5,14,13,9,60,40,20,55
RZ Pellets W,5481,6,14,9,13,46,43,3,51
Admira Wacke,5481,7,12,9,15,36,53,-17,45
Mattersburg,5481,8,9,7,20,35,56,-21,34
SV Josko Rie,5481,9,9,4,23,29,54,-25,31
St. Pölten,5481,10,7,10,19,33,63,-30,31
FC Salzburg,5482,1,24,5,7,70,31,39,77
SK Sturm Gra,5482,2,19,8,9,61,30,31,65
SC Rheindorf,5482,3,19,7,10,54,42,12,64
Vienna,5482,4,19,6,11,60,47,13,63
Rapid Vienna,5482,5,14,10,12,50,38,12,52
RZ Pellets W,5482,6,13,7,16,40,56,-16,46
Admira Wacke,5482,7,12,7,17,35,55,-20,43
SV Josko Rie,5482,8,12,5,19,35,49,-14,41
Mattersburg,5482,9,6,9,21,32,56,-24,27
St. Pölten,5482,10,5,10,21,30,63,-33,25
SK Sturm Gra,5483,1,22,4,10,69,32,37,70
FC Salzburg,5483,2,19,8,9,64,36,28,65
SC Rheindorf,5483,3,18,10,8,55,43,12,64
Vienna,5483,4,18,7,11,59,51,8,61
Rapid Vienna,5483,5,15,10,11,54,43,11,55
RZ Pellets W,5483,6,11,9,16,45,54,-9,42
SV Josko Rie,5483,7,12,4,20,32,50,-18,40
St. Pölten,5483,8,9,11,16,40,62,-22,38
Admira Wacke,5483,9,10,6,20,38,60,-22,36
Mattersburg,5483,10,7,9,20,33,58,-25,30
FC Salzburg,5484,1,20,8,8,59,29,30,68
SC Rheindorf,5484,2,19,9,8,56,39,17,66
SK Sturm Gra,5484,3,19,4,13,58,33,25,61
Vienna,5484,4,17,7,12,59,49,10,58
Rapid Vienna,5484,5,15,12,9,57,39,18,57
RZ Pellets W,5484,6,13,8,15,42,54,-12,47
St. Pölten,5484,7,10,11,15,43,53,-10,41
Mattersburg,5484,8,9,9,18,38,54,-16,36
Admira Wacke,5484,9,9,6,21,32,66,-34,33
SV Josko Rie,5484,10,7,10,19,28,56,-28,31
FC Salzburg,5485,1,22,8,6,61,26,35,74
SK Sturm Gra,5485,2,20,6,10,61,32,29,66
SC Rheindorf,5485,3,19,6,11,55,44,11,63
Rapid Vienna,5485,4,17,9,10,57,35,22,60
RZ Pellets W,5485,5,16,6,14,55,51,4,54
Vienna,5485,6,13,7,16,52,58,-6,46
Admira Wacke,5485,7,13,5,18,43,64,-21,44
SV Josko Rie,5485,8,10,8,18,31,47,-16,38
St. Pölten,5485,9,8,9,19,37,68,-31,33
Mattersburg,5485,10,6,8,22,31,58,-27,26
SC Rheindorf,5486,1,21,6,9,55,43,12,69
SK Sturm Gra,5486,2,20,5,11,59,35,24,65
FC Salzburg,5486,3,18,8,10,61,32,29,62
Vienna,5486,4,16,6,14,60,54,6,54
Admira Wacke,5486,5,13,11,12,44,50,-6,50
SV Josko Rie,5486,6,15,3,18,44,56,-12,48
Rapid Vienna,5486,7,12,11,13,54,45,9,47
RZ Pellets W,5486,8,11,7,18,46,64,-18,40
Mattersburg,5486,9,10,8,18,29,51,-22,38
St. Pölten,5486,10,6,11,19,43,65,-22,29
FC Salzburg,5487,1,23,9,4,74,31,43,78
SC Rheindorf,5487,2,20,8,8,62,45,17,68
SK Sturm Gra,5487,3,18,8,10,56,32,24,62
Vienna,5487,4,18,4,14,57,55,2,58
Rapid Vienna,5487,5,16,8,12,68,42,26,56
RZ Pellets W,5487,6,13,9,14,45,51,-6,48
Admira Wacke,5487,7,11,6,19,37,58,-21,39
SV Josko Rie,5487,8,9,6,21,32,57,-25,33
Mattersburg,5487,9,7,9,20,37,62,-25,30
St. Pölten,5487,10,6,11,19,40,75,-35,29
SK Sturm Gra,5488,1,21,4,11,62,33,29,67
Vienna,5488,2,20,6,10,66,47,19,66
SC Rheindorf,5488,3,17,9,10,54,45,9,60
FC Salzburg,5488,4,17,8,11,58,34,24,59
RZ Pellets W,5488,5,15,6,15,47,55,-8,51
Rapid Vienna,5488,6,13,10,13,56,46,10,49
Admira Wacke,5488,7,14,7,15,41,56,-15,49
Mattersburg,5488,8,12,5,19,39,55,-16,41
SV Josko Rie,5488,9,12,4,20,38,56,-18,40
St. Pölten,5488,10,5,9,22,36,70,-34,24
FC Salzburg,5489,1,22,5,9,70,34,36,71
SK Sturm Gra,5489,2,21,4,11,63,32,31,67
SC Rheindorf,5489,3,16,8,12,53,53,0,56
Vienna,5489,4,17,4,15,61,58,3,55
RZ Pellets W,5489,5,14,9,13,46,48,-2,51
Rapid Vienna,5489,6,12,11,13,57,45,12,47
Admira Wacke,5489,7,13,7,16,44,61,-17,46
SV Josko Rie,5489,8,11,7,18,30,54,-24,40
St. Pölten,5489,9,10,8,18,43,61,-18,38
Mattersburg,5489,10,7,11,18,32,53,-21,32
FC Salzburg,5490,1,22,6,8,65,32,33,72
Vienna,5490,2,18,6,12,62,51,11,60
SC Rheindorf,5490,3,16,11,9,53,43,10,59
SK Sturm Gra,5490,4,16,7,13,55,41,14,55
Rapid Vienna,5490,5,13,12,11,57,45,12,51
RZ Pellets W,5490,6,13,7,16,42,50,-8,46
Admira Wacke,5490,7,13,7,16,45,62,-17,46
SV Josko Rie,5490,8,12,6,18,41,52,-11,42
St. Pölten,5490,9,8,11,17,37,61,-24,35
Mattersburg,5490,10,8,9,19,39,59,-20,33
SC Rheindorf,5491,1,19,9,8,52,39,13,66
Vienna,5491,2,20,5,11,65,56,9,65
SK Sturm Gra,5491,3,18,8,10,63,34,29,62
Rapid Vienna,5491,4,15,12,9,63,38,25,57
FC Salzburg,5491,5,16,9,11,58,38,20,57
RZ Pellets W,5491,6,12,10,14,43,56,-13,46
Admira Wacke,5491,7,13,5,18,40,59,-19,44
SV Josko Rie,5491,8,10,5,21,33,56,-23,35
Mattersburg,5491,9,7,13,16,36,52,-16,34
St. Pölten,5491,10,7,10,19,38,63,-25,31
FC Salzburg,5492,1,19,10,7,64,32,32,67
SK Sturm Gra,5492,2,20,7,9,62,31,31,67
SC Rheindorf,5492,3,19,6,11,56,38,18,63
Vienna,5492,4,19,6,11,68,56,12,63
Admira Wacke,5492,5,15,5,16,41,62,-21,50
RZ Pellets W,5492,6,13,9,14,50,57,-7,48
Rapid Vienna,5492,7,12,10,14,48,40,8,46
St. Pölten,5492,8,9,10,17,41,62,-21,37
Mattersburg,5492,9,7,9,20,38,61,-23,30
SV Josko Rie,5492,10,8,6,22,31,60,-29,30
FC Salzburg,5493,1,20,8,8,66,32,34,68
SK Sturm Gra,5493,2,19,8,9,57,32,25,65
Vienna,5493,3,20,3,13,59,47,12,63
SC Rheindorf,5493,4,18,7,11,51,48,3,61
Rapid Vienna,5493,5,13,12,11,52,44,8,51
RZ Pellets W,5493,6,13,7,16,48,56,-8,46
SV Josko Rie,5493,7,13,5,18,39,50,-11,44
St. Pölten,5493,8,11,8,17,47,64,-17,41
Admira Wacke,5493,9,11,5,20,37,62,-25,38
Mattersburg,5493,10,6,9,21,39,60,-21,27
FC Salzburg,5494,1,22,8,6,71,27,44,74
SK Sturm Gra,5494,2,23,5,8,65,31,34,74
Vienna,5494,3,18,5,13,61,52,9,59
SC Rheindorf,5494,4,16,8,12,54,48,6,56
Rapid Vienna,5494,5,13,9,14,57,45,12,48
Admira Wacke,5494,6,14,6,16,43,52,-9,48
RZ Pellets W,5494,7,14,6,16,44,54,-10,48
SV Josko Rie,5494,8,11,3,22,36,69,-33,36
St. Pölten,5494,9,8,10,18,44,69,-25,34
Mattersburg,5494,10,8,6,22,37,65,-28,30
FC Salzburg,5495,1,22,7,7,69,31,38,73
SK Sturm Gra,5495,2,20,7,9,62,31,31,67
SC Rheindorf,5495,3,19,6,11,53,44,9,63
Vienna,5495,4,19,5,12,68,55,13,62
Rapid Vienna,5495,5,14,11,11,56,43,13,53
Mattersburg,5495,6,10,9,17,41,54,-13,39
Admira Wacke,5495,7,11,6,19,37,61,-24,39
St. Pölten,5495,8,9,10,17,46,63,-17,37
RZ Pellets W,5495,9,10,6,20,41,69,-28,36
SV Josko Rie,5495,10,10,5,21,36,58,-22,35
FC Salzburg,5496,1,23,6,7,63,26,37,75
SK Sturm Gra,5496,2,22,4,10,75,35,40,70
SC Rheindorf,5496,3,21,5,10,62,47,15,68
Vienna,5496,4,18,5,13,66,50,16,59
RZ Pellets W,5496,5,15,6,15,46,54,-8,51
Rapid Vienna,5496,6,12,10,14,49,47,2,46
SV Josko Rie,5496,7,10,7,19,38,58,-20,37
Admira Wacke,5496,8,10,7,19,40,70,-30,37
Mattersburg,5496,9,10,6,20,37,59,-22,36
St. Pölten,5496,10,7,8,21,39,69,-30,29
FC Salzburg,5497,1,19,10,7,69,33,36,67
SK Sturm Gra,5497,2,19,8,9,59,34,25,65
SC Rheindorf,5497,3,18,8,10,56,43,13,62
Vienna,5497,4,19,3,14,59,54,5,60
Rapid Vienna,5497,5,16,11,9,55,32,23,59
SV Josko Rie,5497,6,11,9,16,37,50,-13,42
RZ Pellets W,5497,7,11,7,18,44,53,-9,40
St. Pölten,5497,8,10,7,19,41,64,-23,37
Admira Wacke,5497,9,9,9,18,30,56,-26,36
Mattersburg,5497,10,9,6,21,27,58,-31,33
SC Rheindorf,5498,1,21,7,8,61,41,20,70
FC Salzburg,5498,2,19,10,7,57,29,28,67
SK Sturm Gra,5498,3,18,7,11,60,36,24,61
Vienna,5498,4,15,4,17,56,58,-2,49
Admira Wacke,5498,5,14,6,16,42,57,-15,48
Rapid Vienna,5498,6,12,10,14,46,45,1,46
SV Josko Rie,5498,7,14,4,18,42,50,-8,46
RZ Pellets W,5498,8,10,12,14,36,45,-9,42
St. Pölten,5498,9,9,11,16,36,55,-19,38
Mattersburg,5498,10,9,7,20,33,53,-20,34
SC Rheindorf,5499,1,20,8,8,62,41,21,68
FC Salzburg,5499,2,20,6,10,58,30,28,66
SK Sturm Gra,5499,3,19,9,8,54,29,25,66
Vienna,5499,4,17,5,14,60,57,3,56
Rapid Vienna,5499,5,13,11,12,54,38,16,50
RZ Pellets W,5499,6,12,9,15,42,53,-11,45
SV Josko Rie,5499,7,12,6,18,31,48,-17,42
Admira Wacke,5499,8,10,7,19,35,61,-26,37
Mattersburg,5499,9,8,12,16,35,52,-17,36
St. Pölten,5499,10,9,7,20,40,62,-22,34
FC Salzburg,5500,1,23,7,6,74,29,45,76
SC Rheindorf,5500,2,19,7,10,57,42,15,64
Vienna,5500,3,19,4,13,66,57,9,61
SK Sturm Gra,5500,4,17,7,12,55,39,16,58
Rapid Vienna,5500,5,13,10,13,51,45,6,49
RZ Pellets W,5500,6,13,9,14,44,51,-7,48
Admira Wacke,5500,7,13,7,16,43,63,-20,46
Mattersburg,5500,8,10,7,19,36,51,-15,37
St. Pölten,5500,9,9,10,17,39,59,-20,37
SV Josko Rie,5500,10,7,6,23,30,59,-29,27
FC Salzburg,5501,1,20,8,8,65,31,34,68
Vienna,5501,2,21,4,11,63,46,17,67
SC Rheindorf,5501,3,19,7,10,54,44,10,64
SK Sturm Gra,5501,4,18,8,10,58,37,21,62
Rapid Vienna,5501,5,15,11,10,55,42,13,56
RZ Pellets W,5501,6,11,9,16,47,55,-8,42
Admira Wacke,5501,7,11,9,16,39,52,-13,42
St. Pölten,5501,8,9,11,16,45,67,-22,38
SV Josko Rie,5501,9,9,5,22,31,53,-22,32
Mattersburg,5501,10,6,10,20,30,60,-30,28
SK Sturm Gra,5502,1,22,6,8,61,28,33,72
FC Salzburg,5502,2,21,7,8,72,33,39,70
SC Rheindorf,5502,3,19,8,9,53,44,9,65
Vienna,5502,4,20,4,12,64,53,11,64
Rapid Vienna,5502,5,13,12,11,55,43,12,51
RZ Pellets W,5502,6,12,9,15,46,51,-5,45
SV Josko Rie,5502,7,10,9,17,40,52,-12,39
Mattersburg,5502,8,8,11,17,39,58,-19,35
Admira Wacke,5502,9,9,6,21,36,70,-34,33
St. Pölten,5502,10,5,10,21,35,69,-34,25
FC Salzburg,5503,1,24,7,5,71,34,37,79
SC Rheindorf,5503,2,22,6,8,57,33,24,72
SK Sturm Gra,5503,3,21,7,8,69,38,31,70
Rapid Vienna,5503,4,16,9,11,62,38,24,57
Vienna,5503,5,16,7,13,57,55,2,55
RZ Pellets W,5503,6,11,8,17,48,63,-15,41
Admira Wacke,5503,7,9,8,19,38,65,-27,35
St. Pölten,5503,8,6,13,17,41,66,-25,31
SV Josko Rie,5503,9,7,9,20,31,58,-27,30
Mattersburg,5503,10,6,10,20,33,57,-24,28
FC Salzburg,5504,1,21,9,6,66,31,35,72
SC Rheindorf,5504,2,22,6,8,55,38,17,72
SK Sturm Gra,5504,3,19,5,12,60,41,19,62
Vienna,5504,4,18,8,10,59,43,16,62
Rapid Vienna,5504,5,13,9,14,50,42,8,48
RZ Pellets W,5504,6,13,8,15,49,49,0,47
Admira Wacke,5504,7,13,5,18,40,56,-16,44
SV Josko Rie,5504,8,10,6,20,37,60,-23,36
St. Pölten,5504,9,9,9,18,39,63,-24,36
Mattersburg,5504,10,5,9,22,32,64,-32,24
FC Salzburg,5505,1,21,6,9,64,33,31,69
SC Rheindorf,5505,2,19,6,11,55,43,12,63
SK Sturm Gra,5505,3,18,7,11,50,30,20,61
Vienna,5505,4,19,4,13,59,52,7,61
Rapid Vienna,5505,5,12,15,9,51,38,13,51
St. Pölten,5505,6,10,10,16,48,61,-13,40
SV Josko Rie,5505,7,11,7,18,35,48,-13,40
Mattersburg,5505,8,11,7,18,39,55,-16,40
RZ Pellets W,5505,9,11,6,19,50,70,-20,39
Admira Wacke,5505,10,11,6,19,35,56,-21,39
FC Salzburg,5506,1,23,5,8,67,27,40,74
SC Rheindorf,5506,2,19,7,10,50,39,11,64
SK Sturm Gra,5506,3,19,6,11,58,31,27,63
Vienna,5506,4,18,3,15,54,49,5,57
RZ Pellets W,5506,5,15,10,11,48,44,4,55
Rapid Vienna,5506,6,14,9,13,47,39,8,51
Admira Wacke,5506,7,11,6,19,32,58,-26,39
SV Josko Rie,5506,8,10,7,19,29,53,-24,37
Mattersburg,5506,9,7,11,18,38,60,-22,32
St. Pölten,5506,10,6,12,18,34,57,-23,30
FC Salzburg,5507,1,20,8,8,65,31,34,68
SK Sturm Gra,5507,2,20,6,10,61,31,30,66
SC Rheindorf,5507,3,17,6,13,53,44,9,57
Rapid Vienna,5507,4,15,11,10,62,38,24,56
Vienna,5507,5,15,8,13,57,62,-5,53
RZ Pellets W,5507,6,11,10,15,44,56,-12,43
Admira Wacke,5507,7,10,11,15,38,57,-19,41
Mattersburg,5507,8,10,9,17,40,54,-14,39
SV Josko Rie,5507,9,11,5,20,31,58,-27,38
St. Pölten,5507,10,8,12,16,40,60,-20,36
FC Salzburg,5508,1,23,6,7,77,33,44,75
SC Rheindorf,5508,2,18,10,8,58,46,12,64
SK Sturm Gra,5508,3,17,8,11,55,38,17,59
Vienna,5508,4,17,8,11,55,43,12,59
Rapid Vienna,5508,5,14,10,12,56,44,12,52
RZ Pellets W,5508,6,12,8,16,45,54,-9,44
St. Pölten,5508,7,10,11,15,48,63,-15,41
Admira Wacke,5508,8,10,7,19,34,63,-29,37
Mattersburg,5508,9,9,9,18,38,54,-16,36
SV Josko Rie,5508,10,7,9,20,35,63,-28,30
FC Salzburg,5509,1,23,8,5,69,30,39,77
SC Rheindorf,5509,2,21,8,7,59,41,18,71
SK Sturm Gra,5509,3,19,6,11,62,33,29,63
Vienna,5509,4,19,6,11,67,57,10,63
Rapid Vienna,5509,5,10,14,12,49,45,4,44
SV Josko Rie,5509,6,12,5,19,39,51,-12,41
RZ Pellets W,5509,7,10,10,16,40,52,-12,40
Admira Wacke,5509,8,9,8,19,29,53,-24,35
Mattersburg,5509,9,8,8,20,34,57,-23,32
St. Pölten,5509,10,7,11,18,40,69,-29,32
FC Salzburg,5510,1,23,8,5,74,32,42,77
SC Rheindorf,5510,2,17,11,8,51,43,8,62
Rapid Vienna,5510,3,15,13,8,64,40,24,58
Vienna,5510,4,18,4,14,54,51,3,58
SK Sturm Gra,5510,5,16,8,12,53,41,12,56
RZ Pellets W,5510,6,13,9,14,50,55,-5,48
SV Josko Rie,5510,7,10,8,18,32,49,-17,38
Admira Wacke,5510,8,10,5,21,37,63,-26,35
St. Pölten,5510,9,8,10,18,40,59,-19,34
Mattersburg,5510,10,7,10,19,30,52,-22,31
SC Rheindorf,5511,1,21,6,9,64,41,23,69
FC Salzburg,5511,2,20,7,9,61,34,27,67
SK Sturm Gra,5511,3,18,8,10,58,36,22,62
Vienna,5511,4,17,7,12,56,48,8,58
Rapid Vienna,5511,5,15,10,11,58,45,13,55
Admira Wacke,5511,6,12,7,17,34,50,-16,43
Mattersburg,5511,7,10,8,18,40,57,-17,38
SV Josko Rie,5511,8,10,7,19,32,55,-23,37
RZ Pellets W,5511,9,9,9,18,40,55,-15,36
St. Pölten,5511,10,8,11,17,40,62,-22,35
FC Salzburg,5512,1,23,6,7,69,31,38,75
SK Sturm Gra,5512,2,19,3,14,59,41,18,60
SC Rheindorf,5512,3,18,6,12,48,39,9,60
Vienna,5512,4,18,5,13,62,58,4,59
RZ Pellets W,5512,5,15,8,13,49,47,2,53
Rapid Vienna,5512,6,14,8,14,57,46,11,50
Admira Wacke,5512,7,12,6,18,38,59,-21,42
SV Josko Rie,5512,8,10,8,18,37,52,-15,38
Mattersburg,5512,9,9,8,19,43,64,-21,35
St. Pölten,5512,10,8,10,18,36,61,-25,34
FC Salzburg,5513,1,21,8,7,70,34,36,71
SC Rheindorf,5513,2,22,5,9,59,40,19,71
SK Sturm Gra,5513,3,17,9,10,54,33,21,60
RZ Pellets W,5513,4,15,10,11,53,49,4,55
Vienna,5513,5,16,4,16,55,57,-2,52
Rapid Vienna,5513,6,13,9,14,44,38,6,48
Admira Wacke,5513,7,11,8,17,33,52,-19,41
Mattersburg,5513,8,9,9,18,39,51,-12,36
St. Pölten,5513,9,9,9,18,40,64,-24,36
SV Josko Rie,5513,10,9,5,22,32,61,-29,32
SK Sturm Gra,5514,1,19,9,8,63,34,29,66
FC Salzburg,5514,2,17,10,9,56,35,21,61
Vienna,5514,3,18,7,11,61,48,13,61
SC Rheindorf,5514,4,17,7,12,55,50,5,58
Rapid Vienna,5514,5,12,11,13,54,43,11,47
Mattersburg,5514,6,12,9,15,39,48,-9,45
RZ Pellets W,5514,7,12,9,15,45,55,-10,45
St. Pölten,5514,8,10,8,18,39,60,-21,38
SV Josko Rie,5514,9,9,10,17,33,51,-18,37
Admira Wacke,5514,10,9,10,17,34,55,-21,37
FC Salzburg,5515,1,23,6,7,69,28,41,75
SK Sturm Gra,5515,2,22,4,10,61,33,28,70
SC Rheindorf,5515,3,19,7,10,56,40,16,64
Vienna,5515,4,19,5,12,60,45,15,62
Rapid Vienna,5515,5,11,14,11,48,38,10,47
RZ Pellets W,5515,6,11,10,15,44,56,-12,43
Admira Wacke,5515,7,12,7,17,36,58,-22,43
St. Pölten,5515,8,8,10,18,38,65,-27,34
SV Josko Rie,5515,9,9,6,21,34,54,-20,33
Mattersburg,5515,10,6,11,19,29,58,-29,29
FC Salzburg,5516,1,20,9,7,66,27,39,69
SK Sturm Gra,5516,2,18,9,9,57,30,27,63
SC Rheindorf,5516,3,18,8,10,48,41,7,62
Vienna,5516,4,18,7,11,62,50,12,61
Rapid Vienna,5516,5,14,13,9,54,37,17,55
RZ Pellets W,5516,6,11,10,15,45,54,-9,43
Mattersburg,5516,7,10,10,16,37,54,-17,40
Admira Wacke,5516,8,11,7,18,39,67,-28,40
SV Josko Rie,5516,9,10,5,21,37,58,-21,35
St. Pölten,5516,10,6,10,20,36,63,-27,28
SC Rheindorf,5517,1,22,7,7,59,37,22,73
FC Salzburg,5517,2,21,8,7,61,26,35,71
SK Sturm Gra,5517,3,17,10,9,65,36,29,61
Vienna,5517,4,18,6,12,60,54,6,60
RZ Pellets W,5517,5,12,10,14,43,54,-11,46
Rapid Vienna,5517,6,11,12,13,49,45,4,45
St. Pölten,5517,7,10,13,13,53,58,-5,43
Admira Wacke,5517,8,12,5,19,40,59,-19,41
SV Josko Rie,5517,9,8,6,22,28,56,-28,30
Mattersburg,5517,10,6,9,21,38,71,-33,27
Vienna,5518,1,20,5,11,62,47,15,65
SC Rheindorf,5518,2,19,8,9,55,40,15,65
SK Sturm Gra,5518,3,17,10,9,51,29,22,61
FC Salzburg,5518,4,16,9,11,53,35,18,57
Rapid Vienna,5518,5,13,12,11,55,38,17,51
RZ Pellets W,5518,6,14,7,15,44,47,-3,49
Admira Wacke,5518,7,12,8,16,41,57,-16,44
SV Josko Rie,5518,8,10,7,19,32,47,-15,37
Mattersburg,5518,9,9,9,18,31,54,-23,36
St. Pölten,5518,10,8,9,19,33,63,-30,33
FC Salzburg,5519,1,22,8,6,69,33,36,74
SK Sturm Gra,5519,2,22,5,9,66,30,36,71
SC Rheindorf,5519,3,17,11,8,55,43,12,62
Vienna,5519,4,17,6,13,61,56,5,57
Rapid Vienna,5519,5,10,12,14,52,48,4,42
RZ Pellets W,5519,6,11,9,16,44,54,-10,42
Admira Wacke,5519,7,12,5,19,35,58,-23,41
St. Pölten,5519,8,11,7,18,41,58,-17,40
SV Josko Rie,5519,9,11,4,21,35,61,-26,37
Mattersburg,5519,10,9,9,18,37,54,-17,36
FC Salzburg,5520,1,21,8,7,67,31,36,71
SC Rheindorf,5520,2,20,7,9,54,44,10,67
Vienna,5520,3,18,7,11,66,50,16,61
Rapid Vienna,5520,4,16,10,10,70,42,28,58
SK Sturm Gra,5520,5,17,6,13,59,41,18,57
Mattersburg,5520,6,12,9,15,42,49,-7,45
RZ Pellets W,5520,7,12,4,20,42,60,-18,40
Admira Wacke,5520,8,9,12,15,38,63,-25,39
SV Josko Rie,5520,9,10,5,21,32,55,-23,35
St. Pölten,5520,10,6,10,20,36,71,-35,28
FC Salzburg,5521,1,20,10,6,64,33,31,70
SC Rheindorf,5521,2,20,9,7,65,42,23,69
SK Sturm Gra,5521,3,20,7,9,64,31,33,67
Vienna,5521,4,21,4,11,61,47,14,67
RZ Pellets W,5521,5,13,8,15,45,60,-15,47
Rapid Vienna,5521,6,10,14,12,51,42,9,44
Admira Wacke,5521,7,11,7,18,34,56,-22,40
SV Josko Rie,5521,8,11,5,20,37,55,-18,38
Mattersburg,5521,9,7,11,18,34,57,-23,32
St. Pölten,5521,10,4,11,21,35,67,-32,23
SK Sturm Gra,5522,1,23,6,7,66,27,39,75
FC Salzburg,5522,2,22,5,9,72,35,37,71
Vienna,5522,3,22,3,11,70,53,17,69
SC Rheindorf,5522,4,17,10,9,55,45,10,61
Rapid Vienna,5522,5,14,12,10,56,38,18,54
RZ Pellets W,5522,6,10,9,17,41,61,-20,39
Admira Wacke,5522,7,10,8,18,41,65,-24,38
SV Josko Rie,5522,8,10,5,21,36,56,-20,35
Mattersburg,5522,9,7,9,20,34,61,-27,30
St. Pölten,5522,10,7,9,20,40,70,-30,30
SC Rheindorf,5523,1,21,9,6,61,38,23,72
FC Salzburg,5523,2,20,9,7,65,30,35,69
SK Sturm Gra,5523,3,18,8,10,57,36,21,62
Vienna,5523,4,18,3,15,57,51,6,57
Rapid Vienna,5523,5,13,11,12,50,42,8,50
SV Josko Rie,5523,6,15,3,18,43,52,-9,48
RZ Pellets W,5523,7,12,8,16,46,53,-7,44
Mattersburg,5523,8,10,6,20,39,63,-24,36
Admira Wacke,5523,9,10,5,21,35,63,-28,35
St. Pölten,5523,10,7,10,19,34,59,-25,31
FC Salzburg,5524,1,21,7,8,62,34,28,70
SK Sturm Gra,5524,2,22,4,10,56,33,23,70
SC Rheindorf,5524,3,18,7,11,55,42,13,61
Vienna,5524,4,16,7,13,58,53,5,55
Rapid Vienna,5524,5,15,8,13,63,40,23,53
RZ Pellets W,5524,6,12,9,15,43,52,-9,45
Admira Wacke,5524,7,13,3,20,36,59,-23,42
St. Pölten,5524,8,9,11,16,41,59,-18,38
SV Josko Rie,5524,9,9,8,19,37,57,-20,35
Mattersburg,5524,10,7,12,17,33,55,-22,33
SC Rheindorf,5525,1,21,6,9,58,40,18,69
Vienna,5525,2,21,4,11,68,53,15,67
SK Sturm Gra,5525,3,20,6,10,58,33,25,66
FC Salzburg,5525,4,18,10,8,61,33,28,64
Rapid Vienna,5525,5,12,12,12,53,47,6,48
Admira Wacke,5525,6,14,5,17,48,58,-10,47
RZ Pellets W,5525,7,11,8,17,45,56,-11,41
Mattersburg,5525,8,9,10,17,32,47,-15,37
St. Pölten,5525,9,9,7,20,40,69,-29,34
SV Josko Rie,5525,10,9,4,23,33,60,-27,31
SK Sturm Gra,5526,1,21,6,9,60,33,27,69
FC Salzburg,5526,2,18,11,7,62,27,35,65
SC Rheindorf,5526,3,17,11,8,50,34,16,62
Vienna,5526,4,19,3,14,58,44,14,60
Rapid Vienna,5526,5,12,9,15,52,48,4,45
Admira Wacke,5526,6,13,5,18,35,58,-23,44
RZ Pellets W,5526,7,11,10,15,44,55,-11,43
SV Josko Rie,5526,8,12,5,19,36,55,-19,41
Mattersburg,5526,9,9,10,17,34,54,-20,37
St. Pölten,5526,10,8,10,18,36,59,-23,34
FC Salzburg,5527,1,20,6,10,68,34,34,66
SK Sturm Gra,5527,2,20,6,10,59,31,28,66
Vienna,5527,3,19,6,11,59,47,12,63
Rapid Vienna,5527,4,16,13,7,58,35,23,61
SC Rheindorf,5527,5,16,8,12,51,44,7,56
RZ Pellets W,5527,6,15,5,16,43,54,-11,50
Admira Wacke,5527,7,11,6,19,32,55,-23,39
St. Pölten,5527,8,9,10,17,45,63,-18,37
Mattersburg,5527,9,8,9,19,33,56,-23,33
SV Josko Rie,5527,10,8,7,21,32,61,-29,31
FC Salzburg,5528,1,21,8,7,68,33,35,71
Vienna,5528,2,20,3,13,62,52,10,63
SC Rheindorf,5528,3,18,8,10,50,47,3,62
Rapid Vienna,5528,4,16,9,11,53,35,18,57
SK Sturm Gra,5528,5,17,6,13,52,39,13,57
RZ Pellets W,5528,6,13,9,14,54,53,1,48
Mattersburg,5528,7,12,7,17,50,58,-8,43
Admira Wacke,5528,8,11,6,19,34,58,-24,39
SV Josko Rie,5528,9,9,6,21,32,61,-29,33
St. Pölten,5528,10,7,10,19,46,65,-19,31
FC Salzburg,5529,1,27,5,4,81,24,57,86
SC Rheindorf,5529,2,22,7,7,55,37,18,73
Vienna,5529,3,18,4,14,66,57,9,58
SK Sturm Gra,5529,4,17,6,13,55,43,12,57
Admira Wacke,5529,5,13,7,16,42,54,-12,46
RZ Pellets W,5529,6,11,8,17,48,65,-17,41
Rapid Vienna,5529,7,10,10,16,47,47,0,40
SV Josko Rie,5529,8,11,5,20,37,55,-18,38
St. Pölten,5529,9,9,9,18,45,67,-22,36
Mattersburg,5529,10,7,9,20,35,62,-27,30
SK Sturm Gra,5530,1,21,8,7,60,29,31,71
Vienna,5530,2,21,5,10,65,51,14,68
FC Salzburg,5530,3,19,10,7,64,33,31,67
SC Rheindorf,5530,4,19,8,9,50,36,14,65
Rapid Vienna,5530,5,11,13,12,55,43,12,46
St. Pölten,5530,6,10,9,17,42,67,-25,39
RZ Pellets W,5530,7,9,11,16,44,54,-10,38
Mattersburg,5530,8,8,12,16,33,49,-16,36
SV Josko Rie,5530,9,9,6,21,33,53,-20,33
Admira Wacke,5530,10,9,6,21,32,63,-31,33
SC Rheindorf,5531,1,18,11,7,55,39,16,65
FC Salzburg,5531,2,19,7,10,69,36,33,64
Vienna,5531,3,19,6,11,66,55,11,63
SK Sturm Gra,5531,4,17,9,10,56,37,19,60
Rapid Vienna,5531,5,14,13,9,52,32,20,55
RZ Pellets W,5531,6,15,9,12,51,46,5,54
St. Pölten,5531,7,10,9,17,38,57,-19,39
SV Josko Rie,5531,8,10,6,20,34,55,-21,36
Admira Wacke,5531,9,9,5,22,33,64,-31,32
Mattersburg,5531,10,6,11,19,29,62,-33,29
SK Sturm Gra,5532,1,21,5,10,64,38,26,68
FC Salzburg,5532,2,19,9,8,61,28,33,66
Vienna,5532,3,19,5,12,62,54,8,62
SC Rheindorf,5532,4,18,6,12,58,45,13,60
Rapid Vienna,5532,5,12,13,11,53,41,12,49
RZ Pellets W,5532,6,12,8,16,44,54,-10,44
St. Pölten,5532,7,11,9,16,46,60,-14,42
Admira Wacke,5532,8,11,7,18,37,59,-22,40
Mattersburg,5532,9,10,7,19,37,55,-18,37
SV Josko Rie,5532,10,10,5,21,26,54,-28,35
SK Sturm Gra,5533,1,22,4,10,66,34,32,70
SC Rheindorf,5533,2,18,7,11,56,50,6,61
Vienna,5533,3,18,6,12,53,45,8,60
Rapid Vienna,5533,4,16,11,9,58,36,22,59
FC Salzburg,5533,5,16,9,11,55,39,16,57
RZ Pellets W,5533,6,13,4,19,45,54,-9,43
SV Josko Rie,5533,7,12,5,19,40,58,-18,41
Admira Wacke,5533,8,11,6,19,35,60,-25,39
Mattersburg,5533,9,10,8,18,35,53,-18,38
St. Pölten,5533,10,9,10,17,42,56,-14,37
SK Sturm Gra,5534,1,22,5,9,56,25,31,71
FC Salzburg,5534,2,18,13,5,58,27,31,67
SC Rheindorf,5534,3,18,5,13,47,40,7,59
Vienna,5534,4,17,6,13,59,54,5,57
Rapid Vienna,5534,5,14,13,9,52,37,15,55
RZ Pellets W,5534,6,12,10,14,48,54,-6,46
Admira Wacke,5534,7,13,4,19,49,64,-15,43
Mattersburg,5534,8,9,9,18,38,56,-18,36
St. Pölten,5534,9,9,8,19,41,64,-23,35
SV Josko Rie,5534,10,9,5,22,30,57,-27,32
FC Salzburg,5535,1,23,7,6,66,28,38,76
SC Rheindorf,5535,2,19,7,10,52,40,12,64
Vienna,5535,3,18,5,13,58,51,7,59
SK Sturm Gra,5535,4,14,10,12,55,40,15,52
Admira Wacke,5535,5,13,8,15,40,55,-15,47
Rapid Vienna,5535,6,11,13,12,52,43,9,46
RZ Pellets W,5535,7,12,6,18,50,60,-10,42
Mattersburg,5535,8,10,8,18,42,58,-16,38
St. Pölten,5535,9,10,8,18,47,66,-19,38
SV Josko Rie,5535,10,10,8,18,33,54,-21,38
FC Salzburg,5536,1,24,7,5,73,27,46,79
SK Sturm Gra,5536,2,19,4,13,59,41,18,61
SC Rheindorf,5536,3,16,9,11,52,48,4,57
Vienna,5536,4,17,5,14,62,61,1,56
Rapid Vienna,5536,5,15,8,13,61,41,20,53
RZ Pellets W,5536,6,12,9,15,43,49,-6,45
SV Josko Rie,5536,7,13,5,18,35,49,-14,44
Admira Wacke,5536,8,12,4,20,33,61,-28,40
Mattersburg,5536,9,10,9,17,35,48,-13,39
St. Pölten,5536,10,6,12,18,40,68,-28,30
SC Rheindorf,5537,1,20,7,9,55,39,16,67
FC Salzburg,5537,2,19,8,9,62,36,26,65
Vienna,5537,3,19,6,11,67,46,21,63
Rapid Vienna,5537,4,16,12,8,58,35,23,60
SK Sturm Gra,5537,5,17,8,11,55,34,21,59
Admira Wacke,5537,6,13,6,17,33,49,-16,45
RZ Pellets W,5537,7,10,9,17,37,56,-19,39
Mattersburg,5537,8,10,7,19,35,58,-23,37
St. Pölten,5537,9,8,9,19,41,65,-24,33
SV Josko Rie,5537,10,8,8,20,32,57,-25,32
FC Salzburg,5538,1,25,6,5,79,33,46,81
SK Sturm Gra,5538,2,20,8,8,60,30,30,68
SC Rheindorf,5538,3,20,6,10,54,37,17,66
Vienna,5538,4,19,5,12,60,48,12,62
Rapid Vienna,5538,5,11,9,16,47,48,-1,42
SV Josko Rie,5538,6,13,3,20,34,58,-24,42
RZ Pellets W,5538,7,10,11,15,44,56,-12,41
Admira Wacke,5538,8,10,7,19,39,61,-22,37
St. Pölten,5538,9,8,9,19,42,69,-27,33
Mattersburg,5538,10,8,8,20,37,56,-19,32
FC Salzburg,5539,1,23,6,7,75,34,41,75
SK Sturm Gra,5539,2,21,7,8,70,34,36,70
SC Rheindorf,5539,3,20,6,10,61,42,19,66
Vienna,5539,4,18,3,15,60,56,4,57
Rapid Vienna,5539,5,13,11,12,57,40,17,50
RZ Pellets W,5539,6,13,10,13,45,49,-4,49
Admira Wacke,5539,7,12,4,20,40,61,-21,40
St. Pölten,5539,8,8,9,19,34,68,-34,33
Mattersburg,5539,9,8,9,19,36,73,-37,33
SV Josko Rie,5539,10,9,5,22,36,57,-21,32
FC Salzburg,5540,1,22,6,8,63,30,33,72
SK Sturm Gra,5540,2,19,6,11,58,33,25,63
SC Rheindorf,5540,3,19,5,12,51,48,3,62
Vienna,5540,4,19,4,13,57,50,7,61
Rapid Vienna,5540,5,13,11,12,55,44,11,50
SV Josko Rie,5540,6,15,5,16,42,43,-1,50
RZ Pellets W,5540,7,14,6,16,48,53,-5,48
Admira Wacke,5540,8,10,7,19,33,55,-22,37
St. Pölten,5540,9,8,8,20,46,74,-28,32
Mattersburg,5540,10,7,10,19,34,57,-23,31
SK Sturm Gra,5541,1,21,8,7,67,36,31,71
FC Salzburg,5541,2,21,7,8,67,34,33,70
SC Rheindorf,5541,3,17,8,11,53,48,5,59
Vienna,5541,4,17,5,14,63,57,6,56
Rapid Vienna,5541,5,14,11,11,52,41,11,53
RZ Pellets W,5541,6,13,7,16,50,54,-4,46
Admira Wacke,5541,7,12,7,17,39,56,-17,43
St. Pölten,5541,8,8,12,16,44,69,-25,36
Mattersburg,5541,9,8,10,18,38,54,-16,34
SV Josko Rie,5541,10,9,5,22,32,56,-24,32
SC Rheindorf,5542,1,22,7,7,58,37,21,73
SK Sturm Gra,5542,2,20,7,9,57,32,25,67
FC Salzburg,5542,3,19,9,8,62,33,29,66
Vienna,5542,4,20,5,11,71,59,12,65
Rapid Vienna,5542,5,14,9,13,49,37,12,51
RZ Pellets W,5542,6,14,6,16,49,57,-8,48
SV Josko Rie,5542,7,14,4,18,38,43,-5,46
Mattersburg,5542,8,8,9,19,37,59,-22,33
Admira Wacke,5542,9,9,5,22,31,63,-32,32
St. Pölten,5542,10,5,9,22,35,67,-32,24
FC Salzburg,5543,1,23,7,6,63,24,39,76
SK Sturm Gra,5543,2,21,8,7,64,37,27,71
SC Rheindorf,5543,3,18,10,8,65,45,20,64
Vienna,5543,4,18,5,13,61,54,7,59
RZ Pellets W,5543,5,12,9,15,42,52,-10,45
Admira Wacke,5543,6,12,8,16,37,53,-16,44
Rapid Vienna,5543,7,11,10,15,56,50,6,43
Mattersburg,5543,8,9,9,18,47,64,-17,36
SV Josko Rie,5543,9,9,5,22,32,59,-27,32
St. Pölten,5543,10,6,11,19,37,66,-29,29
SC Rheindorf,5544,1,20,8,8,59,38,21,68
SK Sturm Gra,5544,2,20,7,9,57,29,28,67
FC Salzburg,5544,3,18,11,7,63,30,33,65
Vienna,5544,4,20,5,11,65,53,12,65
Rapid Vienna,5544,5,13,11,12,46,34,12,50
RZ Pellets W,5544,6,14,7,15,46,53,-7,49
Admira Wacke,5544,7,11,10,15,37,52,-15,43
SV Josko Rie,5544,8,12,6,18,34,51,-17,42
Mattersburg,5544,9,7,8,21,36,65,-29,29
St. Pölten,5544,10,5,7,24,31,69,-38,22
Vienna,5545,1,23,4,9,62,43,19,73
SC Rheindorf,5545,2,20,6,10,60,40,20,66
FC Salzburg,5545,3,18,9,9,57,29,28,63
Rapid Vienna,5545,4,16,10,10,60,39,21,58
SK Sturm Gra,5545,5,15,8,13,52,39,13,53
RZ Pellets W,5545,6,12,8,16,45,54,-9,44
Mattersburg,5545,7,12,8,16,41,50,-9,44
Admira Wacke,5545,8,11,6,19,39,59,-20,39
St. Pölten,5545,9,9,9,18,42,70,-28,36
SV Josko Rie,5545,10,8,4,24,31,66,-35,28
SC Rheindorf,5546,1,19,8,9,61,46,15,65
FC Salzburg,5546,2,18,8,10,67,38,29,62
Vienna,5546,3,18,6,12,58,48,10,60
SK Sturm Gra,5546,4,16,9,11,57,41,16,57
Admira Wacke,5546,5,15,10,11,51,53,-2,55
Rapid Vienna,5546,6,13,12,11,59,45,14,51
SV Josko Rie,5546,7,11,9,16,44,59,-15,42
RZ Pellets W,5546,8,10,8,18,43,67,-24,38
Mattersburg,5546,9,8,9,19,38,56,-18,33
St. Pölten,5546,10,8,9,19,42,67,-25,33
SK Sturm Gra,5547,1,21,7,8,70,31,39,70
SC Rheindorf,5547,2,20,7,9,53,36,17,67
FC Salzburg,5547,3,18,11,7,62,30,32,65
Vienna,5547,4,19,7,10,61,48,13,64
Rapid Vienna,5547,5,12,13,11,52,43,9,49
Admira Wacke,5547,6,12,7,17,37,59,-22,43
St. Pölten,5547,7,10,11,15,43,60,-17,41
SV Josko Rie,5547,8,11,7,18,36,52,-16,40
RZ Pellets W,5547,9,11,5,20,39,61,-22,38
Mattersburg,5547,10,4,9,23,29,62,-33,21
FC Salzburg,5548,1,21,6,9,63,33,30,69
Vienna,5548,2,21,6,9,77,56,21,69
SK Sturm Gra,5548,3,19,8,9,64,40,24,65
SC Rheindorf,5548,4,18,10,8,57,45,12,64
SV Josko Rie,5548,5,13,7,16,46,52,-6,46
Rapid Vienna,5548,6,11,11,14,54,44,10,44
RZ Pellets W,5548,7,11,7,18,44,59,-15,40
St. Pölten,5548,8,10,9,17,48,70,-22,39
Mattersburg,5548,9,8,9,19,39,61,-22,33
Admira Wacke,5548,10,8,7,21,33,65,-32,31
SK Sturm Gra,5549,1,22,6,8,74,37,37,72
FC Salzburg,5549,2,21,5,10,67,38,29,68
Rapid Vienna,5549,3,20,8,8,62,33,29,68
SC Rheindorf,5549,4,20,7,9,57,43,14,67
Vienna,5549,5,19,6,11,59,45,14,63
RZ Pellets W,5549,6,10,8,18,37,54,-17,38
Admira Wacke,5549,7,11,4,21,35,63,-28,37
Mattersburg,5549,8,9,6,21,40,61,-21,33
St. Pölten,5549,9,7,10,19,39,65,-26,31
SV Josko Rie,5549,10,9,4,23,32,63,-31,31
FC Salzburg,5550,1,19,10,7,64,31,33,67
SK Sturm Gra,5550,2,19,9,8,60,31,29,66
Vienna,5550,3,19,5,12,66,52,14,62
Rapid Vienna,5550,4,17,10,9,66,39,27,61
SC Rheindorf,5550,5,16,8,12,50,47,3,56
RZ Pellets W,5550,6,14,8,14,50,52,-2,50
St. Pölten,5550,7,11,9,16,43,60,-17,42
Admira Wacke,5550,8,11,6,19,35,63,-28,39
SV Josko Rie,5550,9,8,6,22,28,58,-30,30
Mattersburg,5550,10,6,9,21,33,62,-29,27
FC Salzburg,5551,1,23,6,7,78,35,43,75
SK Sturm Gra,5551,2,19,6,11,61,37,24,63
SC Rheindorf,5551,3,17,6,13,49,51,-2,57
Vienna,5551,4,17,5,14,63,58,5,56
Rapid Vienna,5551,5,13,10,13,57,47,10,49
Admira Wacke,5551,6,13,7,16,41,61,-20,46
RZ Pellets W,5551,7,13,6,17,49,57,-8,45
SV Josko Rie,5551,8,13,5,18,41,57,-16,44
St. Pölten,5551,9,9,10,17,42,58,-16,37
Mattersburg,5551,10,8,9,19,40,60,-20,33
FC Salzburg,5552,1,22,6,8,65,31,34,72
SK Sturm Gra,5552,2,22,5,9,61,33,28,71
SC Rheindorf,5552,3,19,9,8,56,41,15,66
Rapid Vienna,5552,4,12,13,11,53,41,12,49
Vienna,5552,5,14,7,15,53,50,3,49
SV Josko Rie,5552,6,13,8,15,36,45,-9,47
RZ Pellets W,5552,7,11,7,18,42,59,-17,40
Admira Wacke,5552,8,10,9,17,37,59,-22,39
St. Pölten,5552,9,7,12,17,41,61,-20,33
Mattersburg,5552,10,6,12,18,31,55,-24,30
FC Salzburg,5553,1,22,8,6,71,32,39,74
SC Rheindorf,5553,2,19,8,9,56,41,15,65
Vienna,5553,3,18,5,13,68,56,12,59
SK Sturm Gra,5553,4,17,7,12,54,38,16,58
Rapid Vienna,5553,5,13,11,12,53,41,12,50
RZ Pellets W,5553,6,11,9,16,43,56,-13,42
Admira Wacke,5553,7,12,6,18,37,61,-24,42
Mattersburg,5553,8,11,7,18,39,50,-11,40
St. Pölten,5553,9,10,9,17,40,60,-20,39
SV Josko Rie,5553,10,7,10,19,29,55,-26,31
FC Salzburg,5554,1,22,8,6,73,34,39,74
SC Rheindorf,5554,2,18,10,8,53,41,12,64
SK Sturm Gra,5554,3,18,9,9,55,35,20,63
Vienna,5554,4,18,3,15,59,55,4,57
Rapid Vienna,5554,5,15,11,10,53,38,15,56
RZ Pellets W,5554,6,13,9,14,50,52,-2,48
Admira Wacke,5554,7,12,4,20,34,53,-19,40
St. Pölten,5554,8,8,13,15,37,53,-16,37
SV Josko Rie,5554,9,10,4,22,31,60,-29,34
Mattersburg,5554,10,6,9,21,39,63,-24,27
FC Salzburg,5555,1,21,9,6,64,26,38,72
SC Rheindorf,5555,2,21,6,9,60,46,14,69
SK Sturm Gra,5555,3,19,9,8,61,33,28,66
Vienna,5555,4,16,7,13,59,51,8,55
Rapid Vienna,5555,5,14,9,13,50,39,11,51
RZ Pellets W,5555,6,13,9,14,49,55,-6,48
Admira Wacke,5555,7,11,8,17,43,61,-18,41
SV Josko Rie,5555,8,10,3,23,30,59,-29,33
St. Pölten,5555,9,7,11,18,40,63,-23,32
Mattersburg,5555,10,7,11,18,36,59,-23,32
SC Rheindorf,5556,1,21,7,8,63,38,25,70
FC Salzburg,5556,2,19,11,6,57,28,29,68
SK Sturm Gra,5556,3,20,6,10,66,37,29,66
RZ Pellets W,5556,4,15,8,13,53,51,2,53
Rapid Vienna,5556,5,13,13,10,56,37,19,52
Vienna,5556,6,15,6,15,61,64,-3,51
Admira Wacke,5556,7,12,7,17,39,58,-19,43
SV Josko Rie,5556,8,10,8,18,42,61,-19,38
St. Pölten,5556,9,7,8,21,37,71,-34,29
Mattersburg,5556,10,6,10,20,35,64,-29,28
FC Salzburg,5557,1,21,8,7,67,33,34,71
SK Sturm Gra,5557,2,22,4,10,58,31,27,70
Vienna,5557,3,19,5,12,65,54,11,62
SC Rheindorf,5557,4,18,5,13,54,49,5,59
Rapid Vienna,5557,5,16,9,11,62,42,20,57
RZ Pellets W,5557,6,12,6,18,48,62,-14,42
Admira Wacke,5557,7,12,5,19,41,61,-20,41
SV Josko Rie,5557,8,11,5,20,32,49,-17,38
Mattersburg,5557,9,9,9,18,38,55,-17,36
St. Pölten,5557,10,8,8,20,40,69,-29,32
FC Salzburg,5558,1,23,6,7,67,27,40,75
SC Rheindorf,5558,2,18,9,9,54,39,15,63
Vienna,5558,3,19,6,11,57,49,8,63
SK Sturm Gra,5558,4,17,5,14,50,36,14,56
Rapid Vienna,5558,5,15,10,11,57,42,15,55
RZ Pellets W,5558,6,11,10,15,40,49,-9,43
Admira Wacke,5558,7,11,8,17,35,58,-23,41
St. Pölten,5558,8,9,12,15,43,59,-16,39
SV Josko Rie,5558,9,10,6,20,33,50,-17,36
Mattersburg,5558,10,7,8,21,31,58,-27,29
FC Salzburg,5559,1,22,5,9,66,32,34,71
Vienna,5559,2,18,6,12,72,54,18,60
SC Rheindorf,5559,3,18,6,12,56,48,8,60
SK Sturm Gra,5559,4,15,12,9,60,39,21,57
Rapid Vienna,5559,5,15,11,10,65,40,25,56
SV Josko Rie,5559,6,13,5,18,34,53,-19,44
RZ Pellets W,5559,7,10,11,15,43,52,-9,41
Admira Wacke,5559,8,10,9,17,34,64,-30,39
St. Pölten,5559,9,9,10,17,42,67,-25,37
Mattersburg,5559,10,8,9,19,40,63,-23,33
SK Sturm Gra,5560,1,23,4,9,63,29,34,73
FC Salzburg,5560,2,21,6,9,69,36,33,69
SC Rheindorf,5560,3,20,8,8,57,41,16,68
Vienna,5560,4,20,7,9,66,45,21,67
Admira Wacke,5560,5,12,7,17,33,54,-21,43
Rapid Vienna,5560,6,10,12,14,40,37,3,42
SV Josko Rie,5560,7,12,5,19,38,51,-13,41
RZ Pellets W,5560,8,11,7,18,43,60,-17,40
St. Pölten,5560,9,6,12,18,35,64,-29,30
Mattersburg,5560,10,5,12,19,35,62,-27,27
FC Salzburg,5561,1,24,6,6,68,29,39,78
Vienna,5561,2,19,7,10,66,46,20,64
SK Sturm Gra,5561,3,19,6,11,57,34,23,63
SC Rheindorf,5561,4,15,11,10,55,51,4,56
Rapid Vienna,5561,5,14,10,12,50,38,12,52
Admira Wacke,5561,6,14,8,14,45,58,-13,50
RZ Pellets W,5561,7,11,8,17,50,60,-10,41
St. Pölten,5561,8,9,9,18,44,66,-22,36
SV Josko Rie,5561,9,8,6,22,29,61,-32,30
Mattersburg,5561,10,6,11,19,31,52,-21,29
SC Rheindorf,5562,1,22,7,7,62,37,25,73
Vienna,5562,2,22,5,9,65,40,25,71
FC Salzburg,5562,3,21,7,8,64,33,31,70
SK Sturm Gra,5562,4,18,7,11,58,37,21,61
Rapid Vienna,5562,5,14,9,13,52,42,10,51
RZ Pellets W,5562,6,11,10,15,42,54,-12,43
Admira Wacke,5562,7,12,7,17,42,60,-18,43
SV Josko Rie,5562,8,9,7,20,35,59,-24,34
St. Pölten,5562,9,6,11,19,34,60,-26,29
Mattersburg,5562,10,6,8,22,35,67,-32,26
Vienna,5563,1,21,5,10,74,52,22,68
FC Salzburg,5563,2,19,7,10,58,33,25,64
SK Sturm Gra,5563,3,19,5,12,57,33,24,62
Rapid Vienna,5563,4,16,11,9,56,36,20,59
RZ Pellets W,5563,5,17,7,12,58,51,7,58
SC Rheindorf,5563,6,17,7,12,52,49,3,58
Admira Wacke,5563,7,14,6,16,42,54,-12,48
Mattersburg,5563,8,8,9,19,36,55,-19,33
SV Josko Rie,5563,9,7,8,21,31,58,-27,29
St. Pölten,5563,10,4,11,21,29,72,-43,23
FC Salzburg,5564,1,23,5,8,72,35,37,74
Vienna,5564,2,21,5,10,64,47,17,68
SK Sturm Gra,5564,3,18,7,11,57,40,17,61
SC Rheindorf,5564,4,17,9,10,50,43,7,60
Rapid Vienna,5564,5,15,9,12,57,40,17,54
RZ Pellets W,5564,6,14,8,14,52,52,0,50
SV Josko Rie,5564,7,12,6,18,41,58,-17,42
Admira Wacke,5564,8,11,7,18,39,57,-18,40
Mattersburg,5564,9,7,9,20,32,59,-27,30
St. Pölten,5564,10,6,7,23,33,66,-33,25
FC Salzburg,5565,1,22,8,6,69,33,36,74
SC Rheindorf,5565,2,19,7,10,51,39,12,64
SK Sturm Gra,5565,3,18,8,10,56,31,25,62
Vienna,5565,4,19,3,14,61,53,8,60
Rapid Vienna,5565,5,15,8,13,52,39,13,53
Admira Wacke,5565,6,12,7,17,33,56,-23,43
SV Josko Rie,5565,7,11,8,17,38,52,-14,41
St. Pölten,5565,8,10,9,17,37,59,-22,39
RZ Pellets W,5565,9,10,6,20,41,57,-16,36
Mattersburg,5565,10,7,10,19,34,53,-19,31
SC Rheindorf,5566,1,23,7,6,65,38,27,76
FC Salzburg,5566,2,21,7,8,65,32,33,70
SK Sturm Gra,5566,3,20,5,11,61,38,23,65
Vienna,5566,4,18,5,13,63,51,12,59
Rapid Vienna,5566,5,13,13,10,54,38,16,52
Admira Wacke,5566,6,14,4,18,41,59,-18,46
RZ Pellets W,5566,7,11,9,16,46,59,-13,42
Mattersburg,5566,8,10,7,19,42,55,-13,37
St. Pölten,5566,9,9,6,21,38,70,-32,33
SV Josko Rie,5566,10,8,3,25,29,64,-35,27
Vienna,5567,1,22,3,11,72,45,27,69
FC Salzburg,5567,2,19,11,6,68,37,31,68
SC Rheindorf,5567,3,20,7,9,57,40,17,67
SK Sturm Gra,5567,4,17,8,11,60,40,20,59
Rapid Vienna,5567,5,15,10,11,54,39,15,55
RZ Pellets W,5567,6,13,7,16,43,56,-13,46
Mattersburg,5567,7,10,10,16,43,59,-16,40
Admira Wacke,5567,8,9,8,19,35,64,-29,35
SV Josko Rie,5567,9,8,7,21,28,54,-26,31
St. Pölten,5567,10,7,9,20,38,64,-26,30
FC Salzburg,5568,1,23,5,8,68,28,40,74
SC Rheindorf,5568,2,21,6,9,59,40,19,69
Rapid Vienna,5568,3,16,10,10,58,39,19,58
Vienna,5568,4,17,6,13,60,51,9,57
SK Sturm Gra,5568,5,15,11,10,49,32,17,56
RZ Pellets W,5568,6,15,7,14,47,52,-5,52
SV Josko Rie,5568,7,12,6,18,35,50,-15,42
Admira Wacke,5568,8,10,7,19,36,61,-25,37
St. Pölten,5568,9,9,7,20,37,64,-27,34
Mattersburg,5568,10,5,9,22,36,68,-32,24
FC Salzburg,5569,1,20,10,6,67,29,38,70
SC Rheindorf,5569,2,18,9,9,50,40,10,63
Vienna,5569,3,19,5,12,63,52,11,62
SK Sturm Gra,5569,4,16,10,10,55,35,20,58
Rapid Vienna,5569,5,13,9,14,55,49,6,48
RZ Pellets W,5569,6,13,8,15,49,56,-7,47
Admira Wacke,5569,7,13,6,17,44,56,-12,45
SV Josko Rie,5569,8,12,5,19,31,46,-15,41
St. Pölten,5569,9,9,8,19,44,70,-26,35
Mattersburg,5569,10,8,8,20,36,61,-25,32
SC Rheindorf,5570,1,24,5,7,61,41,20,77
SK Sturm Gra,5570,2,20,7,9,61,33,28,67
FC Salzburg,5570,3,16,10,10,62,39,23,58
Vienna,5570,4,18,4,14,56,55,1,58
Rapid Vienna,5570,5,13,12,11,59,42,17,51
RZ Pellets W,5570,6,12,11,13,47,49,-2,47
Admira Wacke,5570,7,12,9,15,36,53,-17,45
SV Josko Rie,5570,8,11,6,19,38,54,-16,39
Mattersburg,5570,9,6,11,19,30,57,-27,29
St. Pölten,5570,10,6,9,21,43,70,-27,27
SC Rheindorf,5571,1,20,7,9,62,45,17,67
FC Salzburg,5571,2,20,6,10,68,34,34,66
Vienna,5571,3,20,6,10,62,49,13,66
SK Sturm Gra,5571,4,17,7,12,53,34,19,58
Rapid Vienna,5571,5,16,9,11,57,41,16,57
Mattersburg,5571,6,13,5,18,43,57,-14,44
Admira Wacke,5571,7,11,6,19,37,59,-22,39
SV Josko Rie,5571,8,11,4,21,34,60,-26,37
RZ Pellets W,5571,9,9,9,18,40,58,-18,36
St. Pölten,5571,10,9,9,18,43,62,-19,36
SC Rheindorf,5572,1,21,5,10,56,42,14,68
Vienna,5572,2,20,4,12,58,48,10,64
SK Sturm Gra,5572,3,19,6,11,61,34,27,63
Rapid Vienna,5572,4,18,9,9,60,37,23,63
FC Salzburg,5572,5,18,8,10,58,35,23,62
RZ Pellets W,5572,6,14,7,15,44,52,-8,49
Admira Wacke,5572,7,14,7,15,40,50,-10,49
St. Pölten,5572,8,7,10,19,37,62,-25,31
SV Josko Rie,5572,9,8,7,21,35,60,-25,31
Mattersburg,5572,10,5,9,22,29,58,-29,24
FC Salzburg,5573,1,21,9,6,64,27,37,72
SK Sturm Gra,5573,2,21,5,10,60,31,29,68
SC Rheindorf,5573,3,19,6,11,50,48,2,63
Rapid Vienna,5573,4,16,10,10,55,32,23,58
Vienna,5573,5,16,4,16,54,53,1,52
SV Josko Rie,5573,6,13,5,18,38,48,-10,44
Admira Wacke,5573,7,12,6,18,43,62,-19,42
RZ Pellets W,5573,8,11,7,18,39,56,-17,40
St. Pölten,5573,9,10,8,18,43,61,-18,38
Mattersburg,5573,10,6,10,20,32,60,-28,28
SC Rheindorf,5574,1,21,7,8,65,47,18,70
SK Sturm Gra,5574,2,21,4,11,64,31,33,67
FC Salzburg,5574,3,19,10,7,59,30,29,67
Vienna,5574,4,19,3,14,60,53,7,60
Rapid Vienna,5574,5,16,8,12,58,44,14,56
Admira Wacke,5574,6,14,7,15,44,52,-8,49
RZ Pellets W,5574,7,11,7,18,43,64,-21,40
SV Josko Rie,5574,8,11,5,20,43,56,-13,38
Mattersburg,5574,9,8,7,21,37,66,-29,31
St. Pölten,5574,10,7,8,21,38,68,-30,29
FC Salzburg,5575,1,19,10,7,64,32,32,67
SK Sturm Gra,5575,2,20,7,9,58,32,26,67
SC Rheindorf,5575,3,20,6,10,51,40,11,66
Vienna,5575,4,19,7,10,68,49,19,64
Admira Wacke,5575,5,14,8,14,46,50,-4,50
Rapid Vienna,5575,6,11,10,15,49,48,1,43
St. Pölten,5575,7,10,8,18,40,63,-23,38
RZ Pellets W,5575,8,10,7,19,38,57,-19,37
SV Josko Rie,5575,9,10,6,20,32,53,-21,36
Mattersburg,5575,10,9,7,20,40,62,-22,34
FC Salzburg,5576,1,25,6,5,64,23,41,81
SC Rheindorf,5576,2,20,9,7,63,41,22,69
Vienna,5576,3,19,7,10,63,47,16,64
SK Sturm Gra,5576,4,19,6,11,71,42,29,63
RZ Pellets W,5576,5,13,8,15,47,58,-11,47
Rapid Vienna,5576,6,9,16,11,52,44,8,43
SV Josko Rie,5576,7,12,5,19,36,54,-18,41
Admira Wacke,5576,8,12,5,19,34,55,-21,41
St. Pölten,5576,9,9,9,18,46,71,-25,36
Mattersburg,5576,10,4,5,27,30,71,-41,17
SC Rheindorf,5577,1,22,7,7,61,38,23,73
SK Sturm Gra,5577,2,20,8,8,63,29,34,68
FC Salzburg,5577,3,20,5,11,63,35,28,65
Vienna,5577,4,19,4,13,61,55,6,61
Rapid Vienna,5577,5,12,12,12,59,51,8,48
Mattersburg,5577,6,11,9,16,40,51,-11,42
St. Pölten,5577,7,11,8,17,43,62,-19,41
RZ Pellets W,5577,8,10,8,18,44,61,-17,38
Admira Wacke,5577,9,10,7,19,32,58,-26,37
SV Josko Rie,5577,10,8,6,22,32,58,-26,30
FC Salzburg,5578,1,24,6,6,81,31,50,78
SK Sturm Gra,5578,2,18,9,9,57,32,25,63
SC Rheindorf,5578,3,17,9,10,60,51,9,60
Rapid Vienna,5578,4,15,10,11,62,45,17,55
Vienna,5578,5,16,6,14,63,50,13,54
SV Josko Rie,5578,6,13,5,18,38,48,-10,44
RZ Pellets W,5578,7,10,12,14,44,55,-11,42
Admira Wacke,5578,8,10,9,17,36,60,-24,39
St. Pölten,5578,9,8,9,19,44,76,-32,33
Mattersburg,5578,10,8,7,21,37,74,-37,31
FC Salzburg,5579,1,20,7,9,65,30,35,67
Vienna,5579,2,21,4,11,67,55,12,67
SC Rheindorf,5579,3,18,7,11,53,47,6,61
Rapid Vienna,5579,4,15,11,10,55,36,19,56
SK Sturm Gra,5579,5,16,7,13,53,41,12,55
Admira Wacke,5579,6,14,5,17,38,52,-14,47
Mattersburg,5579,7,10,10,16,39,54,-15,40
St. Pölten,5579,8,10,9,17,46,60,-14,39
RZ Pellets W,5579,9,10,7,19,43,59,-16,37
SV Josko Rie,5579,10,10,5,21,30,55,-25,35
FC Salzburg,5580,1,23,6,7,72,28,44,75
SC Rheindorf,5580,2,20,8,8,54,44,10,68
Vienna,5580,3,20,6,10,67,54,13,66
SK Sturm Gra,5580,4,18,7,11,58,35,23,61
Rapid Vienna,5580,5,16,10,10,60,37,23,58
RZ Pellets W,5580,6,10,10,16,49,62,-13,40
Mattersburg,5580,7,9,9,18,39,56,-17,36
Admira Wacke,5580,8,10,5,21,35,61,-26,35
St. Pölten,5580,9,8,10,18,37,66,-29,34
SV Josko Rie,5580,10,9,3,24,37,65,-28,30
SC Rheindorf,5581,1,23,7,6,60,39,21,76
SK Sturm Gra,5581,2,21,5,10,58,30,28,68
FC Salzburg,5581,3,19,10,7,62,31,31,67
Vienna,5581,4,18,7,11,62,49,13,61
Rapid Vienna,5581,5,11,10,15,50,47,3,43
Admira Wacke,5581,6,11,8,17,35,60,-25,41
RZ Pellets W,5581,7,10,10,16,43,55,-12,40
St. Pölten,5581,8,9,13,14,49,63,-14,40
SV Josko Rie,5581,9,8,7,21,32,56,-24,31
Mattersburg,5581,10,7,9,20,35,56,-21,30
FC Salzburg,5582,1,22,8,6,68,31,37,74
SC Rheindorf,5582,2,19,7,10,57,44,13,64
SK Sturm Gra,5582,3,17,10,9,49,30,19,61
Vienna,5582,4,18,4,14,65,55,10,58
Rapid Vienna,5582,5,13,11,12,51,43,8,50
Admira Wacke,5582,6,13,5,18,43,61,-18,44
St. Pölten,5582,7,10,12,14,39,52,-13,42
RZ Pellets W,5582,8,11,7,18,43,57,-14,40
SV Josko Rie,5582,9,9,6,21,36,56,-20,33
Mattersburg,5582,10,7,12,17,36,58,-22,33
SK Sturm Gra,5583,1,21,6,9,55,29,26,69
Vienna,5583,2,20,4,12,62,50,12,64
SC Rheindorf,5583,3,19,7,10,50,39,11,64
FC Salzburg,5583,4,18,7,11,62,37,25,61
Rapid Vienna,5583,5,12,13,11,49,36,13,49
SV Josko Rie,5583,6,14,4,18,35,51,-16,46
RZ Pellets W,5583,7,12,7,17,39,53,-14,43
Admira Wacke,5583,8,12,4,20,36,61,-25,40
St. Pölten,5583,9,9,10,17,39,55,-16,37
Mattersburg,5583,10,9,6,21,38,54,-16,33
FC Salzburg,5584,1,22,6,8,71,31,40,72
SK Sturm Gra,5584,2,19,7,10,54,30,24,64
Vienna,5584,3,20,4,12,65,55,10,64
SC Rheindorf,5584,4,18,10,8,58,49,9,64
Rapid Vienna,5584,5,18,8,10,61,34,27,62
RZ Pellets W,5584,6,11,8,17,40,56,-16,41
Admira Wacke,5584,7,11,6,19,32,59,-27,39
Mattersburg,5584,8,8,10,18,35,59,-24,34
St. Pölten,5584,9,7,10,19,35,55,-20,31
SV Josko Rie,5584,10,8,7,21,26,49,-23,31
FC Salzburg,5585,1,22,8,6,73,32,41,74
SC Rheindorf,5585,2,21,6,9,61,47,14,69
SK Sturm Gra,5585,3,21,4,11,65,38,27,67
Vienna,5585,4,18,5,13,67,60,7,59
Rapid Vienna,5585,5,11,13,12,54,46,8,46
RZ Pellets W,5585,6,12,7,17,48,62,-14,43
Admira Wacke,5585,7,12,6,18,45,66,-21,42
St. Pölten,5585,8,9,11,16,48,65,-17,38
Mattersburg,5585,9,9,10,17,41,55,-14,37
SV Josko Rie,5585,10,8,4,24,31,62,-31,28
Vienna,5586,1,21,4,11,63,52,11,67
FC Salzburg,5586,2,19,9,8,65,33,32,66
SC Rheindorf,5586,3,19,9,8,54,42,12,66
SK Sturm Gra,5586,4,19,6,11,60,35,25,63
Rapid Vienna,5586,5,16,9,11,61,36,25,57
RZ Pellets W,5586,6,13,6,17,50,62,-12,45
St. Pölten,5586,7,10,8,18,44,64,-20,38
SV Josko Rie,5586,8,10,6,20,33,54,-21,36
Admira Wacke,5586,9,10,6,20,33,56,-23,36
Mattersburg,5586,10,7,9,20,37,66,-29,30
SK Sturm Gra,5587,1,21,5,10,63,35,28,68
SC Rheindorf,5587,2,20,8,8,55,39,16,68
Vienna,5587,3,19,4,13,67,52,15,61
FC Salzburg,5587,4,17,6,13,52,35,17,57
RZ Pellets W,5587,5,16,6,14,57,60,-3,54
Rapid Vienna,5587,6,12,13,11,52,42,10,49
SV Josko Rie,5587,7,12,7,17,37,53,-16,43
Admira Wacke,5587,8,12,6,18,40,57,-17,42
Mattersburg,5587,9,10,9,17,45,57,-12,39
St. Pölten,5587,10,4,10,22,36,74,-38,22
SC Rheindorf,5588,1,22,7,7,60,39,21,73
SK Sturm Gra,5588,2,22,5,9,68,28,40,71
FC Salzburg,5588,3,18,10,8,70,36,34,64
Vienna,5588,4,18,5,13,59,53,6,59
RZ Pellets W,5588,5,16,5,15,47,53,-6,53
Rapid Vienna,5588,6,13,12,11,60,51,9,51
SV Josko Rie,5588,7,10,7,19,32,53,-21,37
St. Pölten,5588,8,9,8,19,42,69,-27,35
Admira Wacke,5588,9,9,6,21,33,66,-33,33
Mattersburg,5588,10,7,7,22,37,60,-23,28
SC Rheindorf,5589,1,21,9,6,63,38,25,72
SK Sturm Gra,5589,2,20,6,10,64,37,27,66
FC Salzburg,5589,3,19,8,9,63,32,31,65
Rapid Vienna,5589,4,14,11,11,55,39,16,53
Vienna,5589,5,15,6,15,60,58,2,51
Admira Wacke,5589,6,12,6,18,37,62,-25,42
SV Josko Rie,5589,7,12,5,19,35,50,-15,41
RZ Pellets W,5589,8,10,8,18,43,57,-14,38
St. Pölten,5589,9,10,8,18,40,67,-27,38
Mattersburg,5589,10,10,7,19,36,56,-20,37
SC Rheindorf,5590,1,22,8,6,68,36,32,74
SK Sturm Gra,5590,2,21,7,8,63,35,28,70
FC Salzburg,5590,3,19,8,9,59,30,29,65
Vienna,5590,4,18,3,15,61,57,4,57
Rapid Vienna,5590,5,13,9,14,54,40,14,48
Admira Wacke,5590,6,14,5,17,38,54,-16,47
SV Josko Rie,5590,7,12,5,19,36,55,-19,41
St. Pölten,5590,8,9,10,17,43,71,-28,37
RZ Pellets W,5590,9,9,7,20,42,63,-21,34
Mattersburg,5590,10,9,6,21,33,56,-23,33
SK Sturm Gra,5591,1,24,4,8,63,30,33,76
FC Salzburg,5591,2,21,10,5,67,29,38,73
SC Rheindorf,5591,3,22,7,7,63,40,23,73
Vienna,5591,4,17,3,16,60,64,-4,54
Rapid Vienna,5591,5,11,14,11,51,43,8,47
Admira Wacke,5591,6,13,6,17,40,58,-18,45
RZ Pellets W,5591,7,10,7,19,51,61,-10,37
SV Josko Rie,5591,8,9,7,20,34,56,-22,34
Mattersburg,5591,9,8,8,20,39,56,-17,32
St. Pölten,5591,10,7,10,19,40,71,-31,31
SK Sturm Gra,5592,1,23,5,8,63,33,30,74
Vienna,5592,2,21,4,11,68,50,18,67
FC Salzburg,5592,3,19,8,9,67,39,28,65
SC Rheindorf,5592,4,17,9,10,61,44,17,60
RZ Pellets W,5592,5,15,8,13,49,48,1,53
Rapid Vienna,5592,6,13,11,12,57,45,12,50
Admira Wacke,5592,7,12,4,20,35,61,-26,40
St. Pölten,5592,8,7,12,17,47,72,-25,33
Mattersburg,5592,9,7,9,20,37,60,-23,30
SV Josko Rie,5592,10,8,6,22,29,61,-32,30
FC Salzburg,5593,1,21,8,7,70,30,40,71
SK Sturm Gra,5593,2,20,5,11,58,36,22,65
SC Rheindorf,5593,3,20,4,12,55,43,12,64
Vienna,5593,4,20,3,13,58,45,13,63
Rapid Vienna,5593,5,15,9,12,56,41,15,54
Admira Wacke,5593,6,14,5,17,42,57,-15,47
RZ Pellets W,5593,7,12,6,18,39,51,-12,42
SV Josko Rie,5593,8,10,6,20,36,56,-20,36
Mattersburg,5593,9,8,9,19,38,56,-18,33
St. Pölten,5593,10,8,9,19,36,73,-37,33
SK Sturm Gra,5594,1,21,5,10,70,42,28,68
Vienna,5594,2,19,7,10,65,47,18,64
SC Rheindorf,5594,3,18,10,8,56,41,15,64
FC Salzburg,5594,4,19,6,11,66,40,26,63
Rapid Vienna,5594,5,12,11,13,50,41,9,47
RZ Pellets W,5594,6,10,12,14,46,56,-10,42
SV Josko Rie,5594,7,12,5,19,35,54,-19,41
Admira Wacke,5594,8,11,7,18,34,61,-27,40
St. Pölten,5594,9,9,10,17,45,63,-18,37
Mattersburg,5594,10,8,9,19,38,60,-22,33
FC Salzburg,5595,1,25,6,5,70,29,41,81
SK Sturm Gra,5595,2,22,4,10,61,27,34,70
SC Rheindorf,5595,3,19,8,9,49,42,7,65
Vienna,5595,4,16,5,15,54,54,0,53
Rapid Vienna,5595,5,12,12,12,47,39,8,48
SV Josko Rie,5595,6,14,4,18,34,42,-8,46
RZ Pellets W,5595,7,12,7,17,44,56,-12,43
Admira Wacke,5595,8,13,4,19,39,56,-17,43
St. Pölten,5595,9,8,7,21,42,64,-22,31
Mattersburg,5595,10,7,7,22,34,65,-31,28
FC Salzburg,5596,1,22,6,8,64,26,38,72
SC Rheindorf,5596,2,21,9,6,69,46,23,72
Vienna,5596,3,17,8,11,65,53,12,59
Rapid Vienna,5596,4,16,9,11,58,40,18,57
SK Sturm Gra,5596,5,15,8,13,55,43,12,53
RZ Pellets W,5596,6,12,11,13,44,50,-6,47
Admira Wacke,5596,7,11,7,18,35,62,-27,40
Mattersburg,5596,8,9,8,19,35,53,-18,35
St. Pölten,5596,9,8,10,18,36,62,-26,34
SV Josko Rie,5596,10,7,8,21,30,56,-26,29
FC Salzburg,5597,1,19,9,8,64,31,33,66
SC Rheindorf,5597,2,19,8,9,55,46,9,65
Vienna,5597,3,18,8,10,61,45,16,62
SK Sturm Gra,5597,4,17,7,12,52,39,13,58
Admira Wacke,5597,5,14,6,16,38,52,-14,48
Rapid Vienna,5597,6,10,15,11,48,42,6,45
RZ Pellets W,5597,7,10,10,16,42,56,-14,40
SV Josko Rie,5597,8,10,9,17,40,54,-14,39
Mattersburg,5597,9,9,10,17,38,51,-13,37
St. Pölten,5597,10,8,10,18,46,68,-22,34
FC Salzburg,5598,1,22,6,8,74,33,41,72
SK Sturm Gra,5598,2,21,3,12,67,37,30,66
SC Rheindorf,5598,3,19,9,8,57,41,16,66
Rapid Vienna,5598,4,18,8,10,62,40,22,62
Vienna,5598,5,16,6,14,60,54,6,54
St. Pölten,5598,6,13,7,16,41,60,-19,46
RZ Pellets W,5598,7,13,5,18,44,56,-12,44
Admira Wacke,5598,8,12,6,18,40,58,-18,42
SV Josko Rie,5598,9,8,5,23,26,57,-31,29
Mattersburg,5598,10,7,7,22,32,67,-35,28
SC Rheindorf,5599,1,19,9,8,57,44,13,66
FC Salzburg,5599,2,19,8,9,67,39,28,65
SK Sturm Gra,5599,3,18,9,9,66,40,26,63
Rapid Vienna,5599,4,16,11,9,62,36,26,59
Vienna,5599,5,17,5,14,58,58,0,56
St. Pölten,5599,6,12,8,16,52,65,-13,44
RZ Pellets W,5599,7,10,13,13,43,54,-11,43
Admira Wacke,5599,8,12,6,18,44,59,-15,42
Mattersburg,5599,9,8,8,20,36,59,-23,32
SV Josko Rie,5599,10,9,3,24,34,65,-31,30
FC Salzburg,5600,1,24,7,5,78,31,47,79
SC Rheindorf,5600,2,19,6,11,60,48,12,63
SK Sturm Gra,5600,3,19,4,13,51,36,15,61
Vienna,5600,4,17,7,12,65,59,6,58
Rapid Vienna,5600,5,13,13,10,54,39,15,52
RZ Pellets W,5600,6,12,7,17,50,60,-10,43
Mattersburg,5600,7,12,7,17,52,63,-11,43
SV Josko Rie,5600,8,12,3,21,43,57,-14,39
Admira Wacke,5600,9,11,4,21,38,69,-31,37
St. Pölten,5600,10,7,10,19,38,67,-29,31
FC Salzburg,5601,1,21,9,6,61,25,36,72
SC Rheindorf,5601,2,22,6,8,52,38,14,72
SK Sturm Gra,5601,3,19,5,12,58,36,22,62
Vienna,5601,4,19,5,12,64,49,15,62
Rapid Vienna,5601,5,14,12,10,52,35,17,54
Admira Wacke,5601,6,12,4,20,33,57,-24,40
SV Josko Rie,5601,7,11,6,19,38,52,-14,39
RZ Pellets W,5601,8,10,7,19,41,59,-18,37
St. Pölten,5601,9,8,12,16,42,65,-23,36
Mattersburg,5601,10,6,10,20,34,59,-25,28
FC Salzburg,5602,1,23,5,8,67,30,37,74
SK Sturm Gra,5602,2,20,7,9,63,32,31,67
Vienna,5602,3,17,5,14,62,54,8,56
SC Rheindorf,5602,4,16,8,12,51,50,1,56
Admira Wacke,5602,5,14,6,16,42,55,-13,48
Rapid Vienna,5602,6,10,15,11,56,50,6,45
RZ Pellets W,5602,7,12,8,16,46,55,-9,44
St. Pölten,5602,8,8,14,14,43,58,-15,38
SV Josko Rie,5602,9,11,4,21,35,59,-24,37
Mattersburg,5602,10,9,8,19,33,55,-22,35
SC Rheindorf,5603,1,23,6,7,57,39,18,75
SK Sturm Gra,5603,2,18,7,11,54,34,20,61
Vienna,5603,3,17,9,10,56,49,7,60
FC Salzburg,5603,4,16,10,10,58,36,22,58
Rapid Vienna,5603,5,15,9,12,63,43,20,54
St. Pölten,5603,6,10,12,14,39,55,-16,42
Admira Wacke,5603,7,12,6,18,39,59,-20,42
Mattersburg,5603,8,10,10,16,35,45,-10,40
RZ Pellets W,5603,9,10,6,20,40,63,-23,36
SV Josko Rie,5603,10,9,5,22,34,52,-18,32
Vienna,5604,1,21,6,9,64,48,16,69
FC Salzburg,5604,2,20,7,9,67,35,32,67
SC Rheindorf,5604,3,19,8,9,51,39,12,65
SK Sturm Gra,5604,4,17,7,12,57,36,21,58
Rapid Vienna,5604,5,12,11,13,48,42,6,47
SV Josko Rie,5604,6,12,6,18,39,47,-8,42
RZ Pellets W,5604,7,12,6,18,41,55,-14,42
St. Pölten,5604,8,9,13,14,42,57,-15,40
Admira Wacke,5604,9,11,7,18,40,65,-25,40
Mattersburg,5604,10,7,9,20,30,55,-25,30
SK Sturm Gra,5605,1,19,8,9,58,30,28,65
FC Salzburg,5605,2,18,10,8,64,32,32,64
SC Rheindorf,5605,3,16,9,11,53,48,5,57
Vienna,5605,4,16,6,14,56,52,4,54
Rapid Vienna,5605,5,13,11,12,50,46,4,50
RZ Pellets W,5605,6,13,8,15,46,52,-6,47
St. Pölten,5605,7,11,11,14,48,60,-12,44
Admira Wacke,5605,8,11,9,16,34,57,-23,42
SV Josko Rie,5605,9,12,5,19,36,53,-17,41
Mattersburg,5605,10,10,5,21,46,61,-15,35
SK Sturm Gra,5606,1,22,7,7,61,28,33,73
SC Rheindorf,5606,2,22,5,9,61,47,14,71
FC Salzburg,5606,3,20,9,7,60,31,29,69
Vienna,5606,4,18,5,13,62,56,6,59
Rapid Vienna,5606,5,16,8,12,63,40,23,56
RZ Pellets W,5606,6,12,6,18,48,59,-11,42
Admira Wacke,5606,7,10,8,18,41,64,-23,38
SV Josko Rie,5606,8,9,6,21,32,52,-20,33
St. Pölten,5606,9,7,11,18,38,66,-28,32
Mattersburg,5606,10,7,9,20,34,57,-23,30
FC Salzburg,5607,1,21,9,6,60,27,33,72
SK Sturm Gra,5607,2,19,8,9,61,33,28,65
SC Rheindorf,5607,3,19,7,10,51,42,9,64
Rapid Vienna,5607,4,16,10,10,56,35,21,58
Vienna,5607,5,16,9,11,57,49,8,57
RZ Pellets W,5607,6,13,9,14,44,45,-1,48
Admira Wacke,5607,7,11,8,17,29,53,-24,41
SV Josko Rie,5607,8,10,5,21,32,57,-25,35
St. Pölten,5607,9,8,7,21,43,66,-23,31
Mattersburg,5607,10,6,10,20,35,61,-26,28
FC Salzburg,5608,1,21,9,6,61,24,37,72
SK Sturm Gra,5608,2,22,5,9,62,32,30,71
Vienna,5608,3,21,5,10,69,43,26,68
SC Rheindorf,5608,4,20,5,11,52,44,8,65
Rapid Vienna,5608,5,14,12,10,50,35,15,54
RZ Pellets W,5608,6,14,7,15,45,54,-9,49
Admira Wacke,5608,7,12,4,20,36,57,-21,40
St. Pölten,5608,8,8,8,20,41,62,-21,32
SV Josko Rie,5608,9,7,7,22,27,59,-32,28
Mattersburg,5608,10,5,10,21,35,68,-33,25
FC Salzburg,5609,1,21,10,5,64,23,41,73
SK Sturm Gra,5609,2,20,8,8,64,32,32,68
Vienna,5609,3,19,5,12,59,47,12,62
SC Rheindorf,5609,4,15,12,9,49,45,4,57
Rapid Vienna,5609,5,14,12,10,51,35,16,54
RZ Pellets W,5609,6,10,10,16,41,56,-15,40
Admira Wacke,5609,7,10,7,19,36,62,-26,37
SV Josko Rie,5609,8,10,7,19,33,60,-27,37
Mattersburg,5609,9,8,11,17,36,52,-16,35
St. Pölten,5609,10,7,10,19,37,58,-21,31
FC Salzburg,5610,1,21,10,5,66,25,41,73
SK Sturm Gra,5610,2,22,4,10,68,37,31,70
SC Rheindorf,5610,3,19,8,9,55,44,11,65
Vienna,5610,4,18,6,12,65,56,9,60
Rapid Vienna,5610,5,13,9,14,55,44,11,48
Admira Wacke,5610,6,13,4,19,38,60,-22,43
RZ Pellets W,5610,7,9,12,15,43,57,-14,39
St. Pölten,5610,8,9,10,17,36,56,-20,37
SV Josko Rie,5610,9,10,5,21,37,61,-24,35
Mattersburg,5610,10,8,8,20,38,61,-23,32
FC Salzburg,5611,1,23,8,5,72,26,46,77
SC Rheindorf,5611,2,19,7,10,49,36,13,64
SK Sturm Gra,5611,3,17,7,12,48,31,17,58
Vienna,5611,4,16,8,12,61,56,5,56
Rapid Vienna,5611,5,15,10,11,61,41,20,55
RZ Pellets W,5611,6,13,8,15,46,55,-9,47
SV Josko Rie,5611,7,14,4,18,33,44,-11,46
Admira Wacke,5611,8,12,10,14,38,53,-15,46
Mattersburg,5611,9,7,8,21,36,69,-33,29
St. Pölten,5611,10,5,8,23,30,63,-33,23
FC Salzburg,5612,1,20,9,7,60,31,29,69
SC Rheindorf,5612,2,19,10,7,60,41,19,67
SK Sturm Gra,5612,3,18,7,11,57,42,15,61
Vienna,5612,4,18,3,15,66,58,8,57
Rapid Vienna,5612,5,15,11,10,57,38,19,56
RZ Pellets W,5612,6,13,9,14,44,46,-2,48
SV Josko Rie,5612,7,12,6,18,42,56,-14,42
Admira Wacke,5612,8,11,8,17,37,55,-18,41
St. Pölten,5612,9,8,10,18,31,57,-26,34
Mattersburg,5612,10,6,7,23,42,72,-30,25
FC Salzburg,5613,1,21,8,7,60,27,33,71
SK Sturm Gra,5613,2,21,6,9,60,33,27,69
SC Rheindorf,5613,3,18,8,10,56,45,11,62
Vienna,5613,4,16,7,13,57,55,2,55
RZ Pellets W,5613,5,14,8,14,52,48,4,50
Rapid Vienna,5613,6,11,12,13,57,52,5,45
SV Josko Rie,5613,7,12,8,16,49,55,-6,44
Admira Wacke,5613,8,12,5,19,39,63,-24,41
St. Pölten,5613,9,8,10,18,40,69,-29,34
Mattersburg,5613,10,6,10,20,29,52,-23,28
SC Rheindorf,5614,1,22,7,7,64,37,27,73
FC Salzburg,5614,2,21,5,10,66,33,33,68
Vienna,5614,3,21,3,12,62,50,12,66
SK Sturm Gra,5614,4,19,3,14,54,34,20,60
Rapid Vienna,5614,5,16,9,11,53,33,20,57
RZ Pellets W,5614,6,15,7,14,44,50,-6,52
SV Josko Rie,5614,7,11,5,20,40,55,-15,38
St. Pölten,5614,8,9,9,18,37,63,-26,36
Admira Wacke,5614,9,10,3,23,36,75,-39,33
Mattersburg,5614,10,7,7,22,34,60,-26,28
SK Sturm Gra,5615,1,22,6,8,64,31,33,72
FC Salzburg,5615,2,20,6,10,70,41,29,66
Vienna,5615,3,18,9,9,64,49,15,63
SC Rheindorf,5615,4,18,9,9,53,41,12,63
Rapid Vienna,5615,5,13,12,11,58,49,9,51
Admira Wacke,5615,6,11,8,17,42,60,-18,41
RZ Pellets W,5615,7,10,9,17,47,57,-10,39
Mattersburg,5615,8,9,11,16,33,48,-15,38
SV Josko Rie,5615,9,8,10,18,28,51,-23,34
St. Pölten,5615,10,7,8,21,34,66,-32,29
FC Salzburg,5616,1,19,11,6,65,31,34,68
SK Sturm Gra,5616,2,18,7,11,56,35,21,61
Vienna,5616,3,18,7,11,64,49,15,61
SC Rheindorf,5616,4,14,13,9,51,47,4,55
Rapid Vienna,5616,5,13,12,11,51,41,10,51
RZ Pellets W,5616,6,14,5,17,48,57,-9,47
Admira Wacke,5616,7,13,7,16,41,55,-14,46
Mattersburg,5616,8,10,8,18,39,55,-16,38
SV Josko Rie,5616,9,10,7,19,33,53,-20,37
St. Pölten,5616,10,8,9,19,38,63,-25,33
FC Salzburg,5617,1,21,9,6,62,30,32,72
Vienna,5617,2,19,6,11,65,47,18,63
SC Rheindorf,5617,3,16,13,7,46,37,9,61
SK Sturm Gra,5617,4,15,9,12,53,41,12,54
Rapid Vienna,5617,5,13,13,10,57,44,13,52
Admira Wacke,5617,6,10,10,16,35,59,-24,40
RZ Pellets W,5617,7,10,9,17,43,58,-15,39
Mattersburg,5617,8,10,8,18,38,49,-11,38
SV Josko Rie,5617,9,11,5,20,36,51,-15,38
St. Pölten,5617,10,9,10,17,40,59,-19,37
FC Salzburg,5618,1,21,8,7,67,32,35,71
SK Sturm Gra,5618,2,21,4,11,64,38,26,67
Vienna,5618,3,19,4,13,65,53,12,61
Rapid Vienna,5618,4,14,14,8,57,40,17,56
SC Rheindorf,5618,5,16,8,12,51,50,1,56
RZ Pellets W,5618,6,13,7,16,52,58,-6,46
Admira Wacke,5618,7,11,9,16,42,60,-18,42
SV Josko Rie,5618,8,11,6,19,33,53,-20,39
Mattersburg,5618,9,8,9,19,38,64,-26,33
St. Pölten,5618,10,7,9,20,44,65,-21,30
FC Salzburg,5619,1,19,11,6,63,32,31,68
SK Sturm Gra,5619,2,19,7,10,58,37,21,64
SC Rheindorf,5619,3,18,8,10,57,45,12,62
Rapid Vienna,5619,4,17,8,11,63,41,22,59
Vienna,5619,5,16,8,12,56,48,8,56
RZ Pellets W,5619,6,11,8,17,45,57,-12,41
Mattersburg,5619,7,11,7,18,37,54,-17,40
Admira Wacke,5619,8,11,7,18,33,57,-24,40
St. Pölten,5619,9,9,10,17,43,61,-18,37
SV Josko Rie,5619,10,9,6,21,28,51,-23,33
FC Salzburg,5620,1,24,7,5,77,27,50,79
SC Rheindorf,5620,2,19,7,10,56,44,12,64
SK Sturm Gra,5620,3,18,7,11,59,35,24,61
Rapid Vienna,5620,4,18,7,11,58,38,20,61
Vienna,5620,5,19,3,14,63,64,-1,60
Admira Wacke,5620,6,13,7,16,40,54,-14,46
RZ Pellets W,5620,7,10,11,15,41,52,-11,41
St. Pölten,5620,8,9,8,19,42,64,-22,35
SV Josko Rie,5620,9,10,4,22,40,67,-27,34
Mattersburg,5620,10,6,7,23,37,68,-31,25
SC Rheindorf,5621,1,22,7,7,61,41,20,73
SK Sturm Gra,5621,2,21,6,9,58,29,29,69
FC Salzburg,5621,3,18,6,12,67,45,22,60
Vienna,5621,4,18,5,13,68,64,4,59
Rapid Vienna,5621,5,13,12,11,54,42,12,51
Admira Wacke,5621,6,14,6,16,45,61,-16,48
RZ Pellets W,5621,7,12,7,17,49,58,-9,43
Mattersburg,5621,8,10,8,18,42,52,-10,38
SV Josko Rie,5621,9,8,8,20,26,49,-23,32
St. Pölten,5621,10,6,11,19,31,60,-29,29
FC Salzburg,5622,1,20,8,8,59,27,32,68
SK Sturm Gra,5622,2,20,5,11,59,37,22,65
Vienna,5622,3,20,3,13,65,49,16,63
SC Rheindorf,5622,4,18,9,9,58,43,15,63
Rapid Vienna,5622,5,15,11,10,59,41,18,56
RZ Pellets W,5622,6,13,5,18,48,60,-12,44
SV Josko Rie,5622,7,11,6,19,36,52,-16,39
Admira Wacke,5622,8,11,6,19,38,65,-27,39
Mattersburg,5622,9,10,7,19,36,55,-19,37
St. Pölten,5622,10,7,10,19,41,70,-29,31
FC Salzburg,5623,1,25,5,6,68,29,39,80
SK Sturm Gra,5623,2,22,5,9,64,36,28,71
SC Rheindorf,5623,3,21,6,9,60,47,13,69
Rapid Vienna,5623,4,14,9,13,56,41,15,51
Vienna,5623,5,15,6,15,58,55,3,51
RZ Pellets W,5623,6,12,8,16,50,55,-5,44
Admira Wacke,5623,7,13,5,18,38,56,-18,44
SV Josko Rie,5623,8,8,9,19,31,50,-19,33
St. Pölten,5623,9,8,8,20,38,66,-28,32
Mattersburg,5623,10,8,7,21,33,61,-28,31
SC Rheindorf,5624,1,20,7,9,59,45,14,67
SK Sturm Gra,5624,2,20,6,10,63,33,30,66
FC Salzburg,5624,3,18,11,7,59,31,28,65
Vienna,5624,4,20,4,12,65,53,12,64
Rapid Vienna,5624,5,14,10,12,57,45,12,52
RZ Pellets W,5624,6,14,6,16,49,56,-7,48
St. Pölten,5624,7,10,8,18,46,62,-16,38
Admira Wacke,5624,8,10,6,20,36,63,-27,36
SV Josko Rie,5624,9,9,7,20,35,55,-20,34
Mattersburg,5624,10,8,9,19,37,63,-26,33
FC Salzburg,5625,1,23,6,7,64,31,33,75
SK Sturm Gra,5625,2,22,5,9,58,29,29,71
SC Rheindorf,5625,3,19,7,10,51,40,11,64
Vienna,5625,4,18,4,14,64,54,10,58
RZ Pellets W,5625,5,14,5,17,50,59,-9,47
Admira Wacke,5625,6,12,6,18,38,58,-20,42
Rapid Vienna,5625,7,10,10,16,49,48,1,40
SV Josko Rie,5625,8,10,10,16,32,47,-15,40
Mattersburg,5625,9,9,9,18,38,55,-17,36
St. Pölten,5625,10,7,10,19,47,70,-23,31
FC Salzburg,5626,1,23,7,6,75,28,47,76
SC Rheindorf,5626,2,19,11,6,55,36,19,68
SK Sturm Gra,5626,3,20,7,9,58,30,28,67
Vienna,5626,4,16,6,14,56,54,2,54
Rapid Vienna,5626,5,13,12,11,61,43,18,51
RZ Pellets W,5626,6,14,6,16,50,60,-10,48
Mattersburg,5626,7,9,12,15,36,53,-17,39
SV Josko Rie,5626,8,10,6,20,34,56,-22,36
Admira Wacke,5626,9,10,5,21,32,61,-29,35
St. Pölten,5626,10,6,8,22,36,72,-36,26
FC Salzburg,5627,1,22,8,6,69,33,36,74
SC Rheindorf,5627,2,22,7,7,63,40,23,73
Vienna,5627,3,20,4,12,67,49,18,64
SK Sturm Gra,5627,4,19,5,12,53,38,15,62
Rapid Vienna,5627,5,15,9,12,63,44,19,54
RZ Pellets W,5627,6,14,5,17,48,62,-14,47
SV Josko Rie,5627,7,12,3,21,39,60,-21,39
St. Pölten,5627,8,8,9,19,41,65,-24,33
Admira Wacke,5627,9,9,5,22,33,64,-31,32
Mattersburg,5627,10,8,7,21,40,61,-21,31
Vienna,5628,1,21,6,9,65,44,21,69
FC Salzburg,5628,2,19,11,6,63,28,35,68
SC Rheindorf,5628,3,18,9,9,50,41,9,63
SK Sturm Gra,5628,4,17,8,11,58,35,23,59
Rapid Vienna,5628,5,12,11,13,49,44,5,47
RZ Pellets W,5628,6,12,9,15,51,55,-4,45
St. Pölten,5628,7,11,9,16,45,62,-17,42
Admira Wacke,5628,8,10,7,19,33,61,-28,37
Mattersburg,5628,9,9,8,19,37,59,-22,35
SV Josko Rie,5628,10,9,6,21,32,54,-22,33
SC Rheindorf,5629,1,18,10,8,53,37,16,64
FC Salzburg,5629,2,18,8,10,66,38,28,62
Rapid Vienna,5629,3,17,11,8,58,36,22,62
SK Sturm Gra,5629,4,18,8,10,62,41,21,62
Vienna,5629,5,17,8,11,63,54,9,59
RZ Pellets W,5629,6,12,9,15,49,55,-6,45
Admira Wacke,5629,7,13,4,19,37,59,-22,43
SV Josko Rie,5629,8,9,9,18,36,54,-18,36
Mattersburg,5629,9,9,8,19,39,55,-16,35
St. Pölten,5629,10,6,11,19,33,67,-34,29
FC Salzburg,5630,1,23,7,6,76,32,44,76
SK Sturm Gra,5630,2,20,6,10,60,30,30,66
SC Rheindorf,5630,3,19,9,8,49,37,12,66
Vienna,5630,4,16,5,15,55,59,-4,53
SV Josko Rie,5630,5,15,5,16,37,43,-6,50
RZ Pellets W,5630,6,14,6,16,49,58,-9,48
St. Pölten,5630,7,11,9,16,46,61,-15,42
Rapid Vienna,5630,8,9,9,18,48,52,-4,36
Mattersburg,5630,9,9,7,20,38,56,-18,34
Admira Wacke,5630,10,9,7,20,34,64,-30,34
FC Salzburg,5631,1,20,9,7,62,28,34,69
SC Rheindorf,5631,2,20,7,9,57,44,13,67
SK Sturm Gra,5631,3,16,12,8,53,29,24,60
Rapid Vienna,5631,4,16,9,11,64,42,22,57
Vienna,5631,5,16,8,12,60,51,9,56
RZ Pellets W,5631,6,13,9,14,45,57,-12,48
Mattersburg,5631,7,9,10,17,37,53,-16,37
SV Josko Rie,5631,8,10,6,20,34,57,-23,36
Admira Wacke,5631,9,10,6,20,32,59,-27,36
St. Pölten,5631,10,7,10,19,38,62,-24,31
FC Salzburg,5632,1,21,8,7,68,30,38,71
SK Sturm Gra,5632,2,19,9,8,63,32,31,66
SC Rheindorf,5632,3,19,7,10,54,45,9,64
Vienna,5632,4,15,7,14,60,56,4,52
Admira Wacke,5632,5,13,9,14,50,55,-5,48
RZ Pellets W,5632,6,13,7,16,46,58,-12,46
Rapid Vienna,5632,7,11,12,13,50,48,2,45
St. Pölten,5632,8,11,8,17,42,64,-22,41
SV Josko Rie,5632,9,11,3,22,27,50,-23,36
Mattersburg,5632,10,8,8,20,38,60,-22,32
FC Salzburg,5633,1,21,6,9,66,28,38,69
Rapid Vienna,5633,2,19,7,10,71,44,27,64
SK Sturm Gra,5633,3,19,5,12,56,39,17,62
Vienna,5633,4,19,4,13,62,46,16,61
SC Rheindorf,5633,5,18,6,12,54,46,8,60
Admira Wacke,5633,6,14,5,17,42,60,-18,47
RZ Pellets W,5633,7,11,8,17,45,59,-14,41
St. Pölten,5633,8,10,8,18,48,74,-26,38
Mattersburg,5633,9,10,6,20,38,58,-20,36
SV Josko Rie,5633,10,10,3,23,34,62,-28,33
Vienna,5634,1,23,4,9,76,44,32,73
SC Rheindorf,5634,2,22,6,8,56,38,18,72
FC Salzburg,5634,3,21,5,10,74,36,38,68
SK Sturm Gra,5634,4,20,5,11,53,36,17,65
Rapid Vienna,5634,5,15,10,11,52,39,13,55
Admira Wacke,5634,6,12,5,19,35,62,-27,41
RZ Pellets W,5634,7,11,7,18,44,61,-17,40
SV Josko Rie,5634,8,11,4,21,31,56,-25,37
St. Pölten,5634,9,7,10,19,34,57,-23,31
Mattersburg,5634,10,6,8,22,33,59,-26,26
FC Salzburg,5635,1,22,9,5,75,28,47,75
SK Sturm Gra,5635,2,21,4,11,67,36,31,67
SC Rheindorf,5635,3,19,7,10,52,48,4,64
Vienna,5635,4,16,8,12,64,58,6,56
Admira Wacke,5635,5,13,7,16,45,58,-13,46
Rapid Vienna,5635,6,11,12,13,52,47,5,45
RZ Pellets W,5635,7,10,10,16,40,57,-17,40
SV Josko Rie,5635,8,10,7,19,30,51,-21,37
Mattersburg,5635,9,9,7,20,43,59,-16,34
St. Pölten,5635,10,7,13,16,41,67,-26,34
FC Salzburg,5636,1,22,6,8,65,25,40,72
SC Rheindorf,5636,2,22,6,8,56,39,17,72
Vienna,5636,3,20,2,14,60,51,9,62
SK Sturm Gra,5636,4,18,6,12,63,36,27,60
Rapid Vienna,5636,5,15,9,12,53,37,16,54
SV Josko Rie,5636,6,14,4,18,35,53,-18,46
RZ Pellets W,5636,7,11,8,17,43,59,-16,41
Mattersburg,5636,8,10,10,16,36,52,-16,40
Admira Wacke,5636,9,10,8,18,34,52,-18,38
St. Pölten,5636,10,5,7,24,32,73,-41,22
FC Salzburg,5637,1,21,9,6,75,35,40,72
Vienna,5637,2,21,4,11,72,52,20,67
SC Rheindorf,5637,3,19,7,10,58,48,10,64
Rapid Vienna,5637,4,16,10,10,60,36,24,58
SK Sturm Gra,5637,5,14,8,14,50,44,6,50
RZ Pellets W,5637,6,13,8,15,44,54,-10,47
Admira Wacke,5637,7,10,9,17,36,55,-19,39
St. Pölten,5637,8,10,8,18,50,73,-23,38
SV Josko Rie,5637,9,10,6,20,38,63,-25,36
Mattersburg,5637,10,8,7,21,37,60,-23,31
FC Salzburg,5638,1,19,12,5,70,33,37,69
SK Sturm Gra,5638,2,20,7,9,67,31,36,67
Vienna,5638,3,18,5,13,62,54,8,59
SC Rheindorf,5638,4,17,8,11,48,46,2,59
Rapid Vienna,5638,5,14,11,11,56,45,11,53
Admira Wacke,5638,6,14,5,17,47,65,-18,47
RZ Pellets W,5638,7,12,6,18,45,63,-18,42
SV Josko Rie,5638,8,10,6,20,37,58,-21,36
St. Pölten,5638,9,8,11,17,41,62,-21,35
Mattersburg,5638,10,8,9,19,38,54,-16,33
FC Salzburg,5639,1,20,10,6,65,29,36,70
SK Sturm Gra,5639,2,20,8,8,66,38,28,68
SC Rheindorf,5639,3,19,6,11,61,49,12,63
Vienna,5639,4,17,5,14,58,55,3,56
Rapid Vienna,5639,5,12,12,12,52,43,9,48
RZ Pellets W,5639,6,13,8,15,49,52,-3,47
SV Josko Rie,5639,7,13,5,18,46,58,-12,44
Admira Wacke,5639,8,11,4,21,34,59,-25,37
Mattersburg,5639,9,9,9,18,37,61,-24,36
St. Pölten,5639,10,8,9,19,43,67,-24,33
FC Salzburg,5640,1,24,6,6,73,26,47,78
SK Sturm Gra,5640,2,19,7,10,55,29,26,64
Vienna,5640,3,18,7,11,65,47,18,61
SC Rheindorf,5640,4,17,9,10,58,46,12,60
Rapid Vienna,5640,5,14,9,13,53,41,12,51
SV Josko Rie,5640,6,12,5,19,30,46,-16,41
RZ Pellets W,5640,7,11,8,17,45,63,-18,41
Admira Wacke,5640,8,11,8,17,33,61,-28,41
St. Pölten,5640,9,8,9,19,40,68,-28,33
Mattersburg,5640,10,6,12,18,35,60,-25,30
FC Salzburg,5641,1,22,8,6,71,30,41,74
SC Rheindorf,5641,2,21,5,10,58,47,11,68
Vienna,5641,3,19,4,13,68,54,14,61
SK Sturm Gra,5641,4,16,7,13,50,35,15,55
St. Pölten,5641,5,13,8,15,44,55,-11,47
Admira Wacke,5641,6,14,5,17,43,60,-17,47
Rapid Vienna,5641,7,11,12,13,53,42,11,45
RZ Pellets W,5641,8,10,8,18,43,59,-16,38
SV Josko Rie,5641,9,11,4,21,38,58,-20,37
Mattersburg,5641,10,9,7,20,38,66,-28,34
FC Salzburg,5642,1,22,6,8,63,31,32,72
SK Sturm Gra,5642,2,21,6,9,64,30,34,69
SC Rheindorf,5642,3,19,7,10,53,50,3,64
Vienna,5642,4,16,8,12,61,54,7,56
Rapid Vienna,5642,5,15,10,11,62,41,21,55
RZ Pellets W,5642,6,12,8,16,48,58,-10,44
St. Pölten,5642,7,9,10,17,44,61,-17,37
SV Josko Rie,5642,8,9,8,19,37,51,-14,35
Mattersburg,5642,9,9,8,19,33,54,-21,35
Admira Wacke,5642,10,10,5,21,32,67,-35,35
SC Rheindorf,5643,1,21,7,8,63,39,24,70
FC Salzburg,5643,2,20,8,8,62,30,32,68
Vienna,5643,3,18,7,11,58,48,10,61
SK Sturm Gra,5643,4,17,8,11,50,31,19,59
Rapid Vienna,5643,5,13,10,13,50,40,10,49
Admira Wacke,5643,6,11,10,15,32,52,-20,43
SV Josko Rie,5643,7,12,4,20,36,52,-16,40
Mattersburg,5643,8,9,11,16,36,49,-13,38
RZ Pellets W,5643,9,10,8,18,39,56,-17,38
St. Pölten,5643,10,7,11,18,34,63,-29,32
SK Sturm Gra,5644,1,22,6,8,58,27,31,72
FC Salzburg,5644,2,19,10,7,57,28,29,67
SC Rheindorf,5644,3,20,7,9,56,43,13,67
Vienna,5644,4,16,5,15,61,56,5,53
Admira Wacke,5644,5,13,8,15,40,53,-13,47
RZ Pellets W,5644,6,12,6,18,48,66,-18,42
Rapid Vienna,5644,7,10,11,15,51,45,6,41
St. Pölten,5644,8,10,10,16,41,57,-16,40
SV Josko Rie,5644,9,10,7,19,33,51,-18,37
Mattersburg,5644,10,8,10,18,37,56,-19,34
SC Rheindorf,5645,1,23,8,5,64,36,28,77
FC Salzburg,5645,2,17,10,9,60,34,26,61
SK Sturm Gra,5645,3,16,9,11,47,32,15,57
Vienna,5645,4,16,8,12,59,51,8,56
Rapid Vienna,5645,5,13,12,11,56,43,13,51
Admira Wacke,5645,6,15,6,15,38,50,-12,51
SV Josko Rie,5645,7,14,3,19,40,47,-7,45
RZ Pellets W,5645,8,8,12,16,38,56,-18,36
Mattersburg,5645,9,9,7,20,35,58,-23,34
St. Pölten,5645,10,7,9,20,37,67,-30,30
FC Salzburg,5646,1,20,8,8,68,32,36,68
SC Rheindorf,5646,2,20,6,10,58,41,17,66
SK Sturm Gra,5646,3,20,5,11,62,34,28,65
Vienna,5646,4,18,5,13,61,52,9,59
Admira Wacke,5646,5,15,5,16,44,57,-13,50
Rapid Vienna,5646,6,12,12,12,51,42,9,48
RZ Pellets W,5646,7,11,11,14,41,51,-10,44
St. Pölten,5646,8,11,9,16,42,62,-20,42
Mattersburg,5646,9,9,9,18,35,59,-24,36
SV Josko Rie,5646,10,7,4,25,29,61,-32,25
SC Rheindorf,5647,1,22,6,8,58,41,17,72
FC Salzburg,5647,2,19,10,7,60,28,32,67
SK Sturm Gra,5647,3,20,4,12,64,38,26,64
Vienna,5647,4,18,4,14,63,57,6,58
Rapid Vienna,5647,5,15,11,10,66,38,28,56
RZ Pellets W,5647,6,14,6,16,48,52,-4,48
Admira Wacke,5647,7,11,9,16,34,60,-26,42
SV Josko Rie,5647,8,11,7,18,38,50,-12,40
St. Pölten,5647,9,7,9,20,35,69,-34,30
Mattersburg,5647,10,7,6,23,34,67,-33,27
SC Rheindorf,5648,1,23,8,5,65,41,24,77
FC Salzburg,5648,2,21,6,9,66,34,32,69
SK Sturm Gra,5648,3,18,5,13,53,36,17,59
Vienna,5648,4,17,8,11,59,51,8,59
Rapid Vienna,5648,5,13,11,12,60,48,12,50
SV Josko Rie,5648,6,12,6,18,38,50,-12,42
RZ Pellets W,5648,7,10,9,17,44,55,-11,39
Admira Wacke,5648,8,10,8,18,37,62,-25,38
St. Pölten,5648,9,8,10,18,43,66,-23,34
Mattersburg,5648,10,7,11,18,35,57,-22,32
FC Salzburg,5649,1,22,9,5,68,30,38,75
SC Rheindorf,5649,2,19,9,8,55,42,13,66
Vienna,5649,3,19,6,11,60,48,12,63
SK Sturm Gra,5649,4,18,7,11,51,31,20,61
Rapid Vienna,5649,5,13,12,11,55,38,17,51
RZ Pellets W,5649,6,12,7,17,42,56,-14,43
St. Pölten,5649,7,11,9,16,51,61,-10,42
SV Josko Rie,5649,8,10,5,21,33,57,-24,35
Admira Wacke,5649,9,9,6,21,27,57,-30,33
Mattersburg,5649,10,7,10,19,31,53,-22,31
SC Rheindorf,5650,1,25,4,7,67,39,28,79
SK Sturm Gra,5650,2,21,5,10,67,39,28,68
FC Salzburg,5650,3,19,7,10,65,39,26,64
Vienna,5650,4,17,4,15,70,63,7,55
Rapid Vienna,5650,5,14,11,11,57,46,11,53
SV Josko Rie,5650,6,13,6,17,45,52,-7,45
RZ Pellets W,5650,7,12,7,17,54,62,-8,43
Admira Wacke,5650,8,11,6,19,36,68,-32,39
Mattersburg,5650,9,7,9,20,35,60,-25,30
St. Pölten,5650,10,6,11,19,45,73,-28,29
FC Salzburg,5651,1,20,9,7,62,35,27,69
SC Rheindorf,5651,2,20,9,7,50,32,18,69
Vienna,5651,3,20,4,12,68,52,16,64
SK Sturm Gra,5651,4,17,5,14,53,41,12,56
Rapid Vienna,5651,5,15,10,11,68,46,22,55
RZ Pellets W,5651,6,13,8,15,52,57,-5,47
Admira Wacke,5651,7,10,10,16,33,59,-26,40
St. Pölten,5651,8,8,11,17,41,61,-20,35
Mattersburg,5651,9,8,9,19,36,56,-20,33
SV Josko Rie,5651,10,7,9,20,38,62,-24,30
SC Rheindorf,5652,1,19,9,8,60,39,21,66
SK Sturm Gra,5652,2,17,11,8,60,33,27,62
FC Salzburg,5652,3,18,7,11,54,34,20,61
Vienna,5652,4,15,9,12,66,65,1,54
Rapid Vienna,5652,5,12,13,11,52,37,15,49
Admira Wacke,5652,6,12,8,16,40,56,-16,44
RZ Pellets W,5652,7,11,9,16,48,58,-10,42
SV Josko Rie,5652,8,11,7,18,31,48,-17,40
St. Pölten,5652,9,10,10,16,39,61,-22,40
Mattersburg,5652,10,10,7,19,35,54,-19,37
SK Sturm Gra,5653,1,23,5,8,70,34,36,74
FC Salzburg,5653,2,20,5,11,59,32,27,65
Vienna,5653,3,19,5,12,72,54,18,62
SC Rheindorf,5653,4,19,5,12,50,45,5,62
Rapid Vienna,5653,5,15,10,11,56,44,12,55
SV Josko Rie,5653,6,14,5,17,38,49,-11,47
Admira Wacke,5653,7,12,5,19,40,58,-18,41
RZ Pellets W,5653,8,11,7,18,39,57,-18,40
St. Pölten,5653,9,8,9,19,40,66,-26,33
Mattersburg,5653,10,7,8,21,35,60,-25,29
FC Salzburg,5654,1,21,8,7,69,30,39,71
Vienna,5654,2,21,5,10,69,49,20,68
SC Rheindorf,5654,3,19,8,9,58,45,13,65
SK Sturm Gra,5654,4,19,6,11,61,39,22,63
Rapid Vienna,5654,5,14,12,10,48,34,14,54
RZ Pellets W,5654,6,11,9,16,41,57,-16,42
SV Josko Rie,5654,7,11,7,18,37,55,-18,40
St. Pölten,5654,8,7,13,16,40,61,-21,34
Admira Wacke,5654,9,8,10,18,35,63,-28,34
Mattersburg,5654,10,5,10,21,34,59,-25,25
SC Rheindorf,5655,1,21,6,9,55,39,16,69
SK Sturm Gra,5655,2,20,6,10,58,34,24,66
FC Salzburg,5655,3,18,10,8,59,36,23,64
Rapid Vienna,5655,4,17,11,8,63,37,26,62
Vienna,5655,5,18,4,14,62,52,10,58
RZ Pellets W,5655,6,15,7,14,48,52,-4,52
Mattersburg,5655,7,10,9,17,42,52,-10,39
SV Josko Rie,5655,8,9,7,20,33,55,-22,34
Admira Wacke,5655,9,9,4,23,37,69,-32,31
St. Pölten,5655,10,7,8,21,38,69,-31,29
FC Salzburg,5656,1,23,6,7,70,28,42,75
SK Sturm Gra,5656,2,19,7,10,59,38,21,64
SC Rheindorf,5656,3,19,7,10,54,43,11,64
Vienna,5656,4,18,4,14,60,52,8,58
RZ Pellets W,5656,5,15,6,15,53,59,-6,51
Rapid Vienna,5656,6,13,10,13,58,44,14,49
SV Josko Rie,5656,7,11,8,17,30,47,-17,41
St. Pölten,5656,8,9,11,16,46,62,-16,38
Admira Wacke,5656,9,10,8,18,37,61,-24,38
Mattersburg,5656,10,6,7,23,34,67,-33,25
FC Salzburg,5657,1,23,5,8,68,31,37,74
SC Rheindorf,5657,2,20,6,10,50,36,14,66
Vienna,5657,3,20,3,13,64,43,21,63
SK Sturm Gra,5657,4,18,8,10,51,31,20,62
Rapid Vienna,5657,5,16,8,12,56,37,19,56
Mattersburg,5657,6,12,8,16,37,50,-13,44
RZ Pellets W,5657,7,10,9,17,36,56,-20,39
Admira Wacke,5657,8,11,6,19,33,57,-24,39
SV Josko Rie,5657,9,9,5,22,32,58,-26,32
St. Pölten,5657,10,7,10,19,38,66,-28,31
FC Salzburg,5658,1,20,7,9,70,37,33,67
Vienna,5658,2,20,6,10,70,46,24,66
SK Sturm Gra,5658,3,19,6,11,60,38,22,63
SC Rheindorf,5658,4,19,6,11,51,39,12,63
Rapid Vienna,5658,5,13,11,12,53,39,14,50
SV Josko Rie,5658,6,13,5,18,35,51,-16,44
Admira Wacke,5658,7,13,4,19,37,61,-24,43
RZ Pellets W,5658,8,10,10,16,42,59,-17,40
St. Pölten,5658,9,9,9,18,41,71,-30,36
Mattersburg,5658,10,7,10,19,30,48,-18,31
FC Salzburg,5659,1,21,6,9,72,36,36,69
SK Sturm Gra,5659,2,20,8,8,60,29,31,68
SC Rheindorf,5659,3,20,6,10,60,48,12,66
Vienna,5659,4,19,6,11,64,47,17,63
Rapid Vienna,5659,5,13,9,14,54,44,10,48
RZ Pellets W,5659,6,13,7,16,52,61,-9,46
Admira Wacke,5659,7,13,6,17,40,61,-21,45
SV Josko Rie,5659,8,11,5,20,33,52,-19,38
St. Pölten,5659,9,7,10,19,31,59,-28,31
Mattersburg,5659,10,6,11,19,35,64,-29,29
SC Rheindorf,5660,1,22,6,8,60,37,23,72
SK Sturm Gra,5660,2,21,5,10,63,33,30,68
FC Salzburg,5660,3,18,8,10,57,30,27,62
Rapid Vienna,5660,4,16,9,11,56,41,15,57
Vienna,5660,5,16,4,16,53,57,-4,52
RZ Pellets W,5660,6,14,6,16,48,55,-7,48
SV Josko Rie,5660,7,13,4,19,32,47,-15,43
Admira Wacke,5660,8,12,7,17,40,57,-17,43
Mattersburg,5660,9,8,8,20,38,54,-16,32
St. Pölten,5660,10,7,9,20,33,69,-36,30
FC Salzburg,5661,1,22,7,7,64,26,38,73
SK Sturm Gra,5661,2,21,6,9,62,37,25,69
SC Rheindorf,5661,3,17,10,9,46,43,3,61
Vienna,5661,4,17,8,11,57,51,6,59
Rapid Vienna,5661,5,15,10,11,60,36,24,55
RZ Pellets W,5661,6,12,9,15,43,49,-6,45
SV Josko Rie,5661,7,12,3,21,36,52,-16,39
Admira Wacke,5661,8,11,6,19,35,60,-25,39
Mattersburg,5661,9,10,8,18,36,49,-13,38
St. Pölten,5661,10,5,9,22,33,69,-36,24
FC Salzburg,5662,1,20,8,8,65,30,35,68
SK Sturm Gra,5662,2,19,8,9,62,38,24,65
SC Rheindorf,5662,3,19,7,10,54,45,9,64
Vienna,5662,4,19,5,12,67,49,18,62
Rapid Vienna,5662,5,16,9,11,59,39,20,57
RZ Pellets W,5662,6,13,8,15,46,50,-4,47
SV Josko Rie,5662,7,11,6,19,37,55,-18,39
St. Pölten,5662,8,8,10,18,41,65,-24,34
Admira Wacke,5662,9,9,7,20,41,72,-31,34
Mattersburg,5662,10,8,8,20,34,63,-29,32
FC Salzburg,5663,1,20,10,6,59,26,33,70
Vienna,5663,2,22,4,10,66,43,23,70
SC Rheindorf,5663,3,18,9,9,54,43,11,63
SK Sturm Gra,5663,4,18,7,11,54,33,21,61
RZ Pellets W,5663,5,14,6,16,45,55,-10,48
Rapid Vienna,5663,6,12,11,13,52,42,10,47
Admira Wacke,5663,7,11,7,18,34,62,-28,40
SV Josko Rie,5663,8,10,6,20,34,51,-17,36
St. Pölten,5663,9,9,9,18,41,61,-20,36
Mattersburg,5663,10,5,13,18,31,54,-23,28
Vienna,5664,1,21,6,9,68,49,19,69
SK Sturm Gra,5664,2,20,6,10,59,28,31,66
FC Salzburg,5664,3,19,8,9,63,35,28,65
SC Rheindorf,5664,4,16,10,10,53,53,0,58
Rapid Vienna,5664,5,13,11,12,51,39,12,50
Mattersburg,5664,6,13,7,16,44,54,-10,46
RZ Pellets W,5664,7,12,6,18,46,63,-17,42
SV Josko Rie,5664,8,13,2,21,37,52,-15,41
Admira Wacke,5664,9,11,7,18,38,55,-17,40
St. Pölten,5664,10,7,7,22,35,66,-31,28
FC Salzburg,5665,1,22,6,8,72,35,37,72
SC Rheindorf,5665,2,19,7,10,55,43,12,64
Vienna,5665,3,20,2,14,65,58,7,62
SK Sturm Gra,5665,4,17,6,13,59,40,19,57
Rapid Vienna,5665,5,15,9,12,62,44,18,54
Admira Wacke,5665,6,15,5,16,42,54,-12,50
RZ Pellets W,5665,7,12,7,17,43,60,-17,43
SV Josko Rie,5665,8,12,3,21,34,52,-18,39
Mattersburg,5665,9,10,7,19,41,59,-18,37
St. Pölten,5665,10,7,10,19,40,68,-28,31
SC Rheindorf,5666,1,24,6,6,56,31,25,78
FC Salzburg,5666,2,21,8,7,58,25,33,71
SK Sturm Gra,5666,3,19,6,11,57,36,21,63
Vienna,5666,4,18,5,13,58,52,6,59
Rapid Vienna,5666,5,15,9,12,52,38,14,54
RZ Pellets W,5666,6,14,7,15,50,53,-3,49
Admira Wacke,5666,7,11,7,18,39,57,-18,40
St. Pölten,5666,8,8,8,20,42,65,-23,32
SV Josko Rie,5666,9,9,5,22,30,57,-27,32
Mattersburg,5666,10,6,9,21,38,66,-28,27
SC Rheindorf,5667,1,20,9,7,52,35,17,69
FC Salzburg,5667,2,18,10,8,66,35,31,64
SK Sturm Gra,5667,3,17,9,10,58,36,22,60
Vienna,5667,4,18,6,12,62,53,9,60
RZ Pellets W,5667,5,14,8,14,47,52,-5,50
Rapid Vienna,5667,6,10,14,12,51,45,6,44
Admira Wacke,5667,7,11,8,17,36,60,-24,41
Mattersburg,5667,8,9,10,17,41,54,-13,37
SV Josko Rie,5667,9,9,9,18,34,54,-20,36
St. Pölten,5667,10,6,13,17,37,60,-23,31
FC Salzburg,5668,1,20,5,11,60,32,28,65
SC Rheindorf,5668,2,19,8,9,50,35,15,65
Vienna,5668,3,18,5,13,62,53,9,59
SK Sturm Gra,5668,4,17,7,12,53,38,15,58
Rapid Vienna,5668,5,13,9,14,52,46,6,48
RZ Pellets W,5668,6,13,7,16,45,54,-9,46
St. Pölten,5668,7,12,10,14,47,59,-12,46
Mattersburg,5668,8,10,10,16,42,51,-9,40
Admira Wacke,5668,9,11,7,18,36,59,-23,40
SV Josko Rie,5668,10,9,8,19,28,48,-20,35
FC Salzburg,5669,1,19,10,7,67,34,33,67
SK Sturm Gra,5669,2,19,6,11,61,34,27,63
SC Rheindorf,5669,3,17,10,9,50,38,12,61
Vienna,5669,4,18,5,13,62,55,7,59
RZ Pellets W,5669,5,17,6,13,59,51,8,57
Rapid Vienna,5669,6,12,10,14,50,49,1,46
Admira Wacke,5669,7,12,8,16,40,56,-16,44
SV Josko Rie,5669,8,12,3,21,36,54,-18,39
Mattersburg,5669,9,10,6,20,35,56,-21,36
St. Pölten,5669,10,8,8,20,39,72,-33,32
SK Sturm Gra,5670,1,22,4,10,65,31,34,70
SC Rheindorf,5670,2,20,6,10,56,45,11,66
Vienna,5670,3,20,5,11,67,48,19,65
Rapid Vienna,5670,4,18,10,8,62,35,27,64
FC Salzburg,5670,5,17,11,8,61,32,29,62
RZ Pellets W,5670,6,11,9,16,46,58,-12,42
Admira Wacke,5670,7,12,6,18,38,61,-23,42
Mattersburg,5670,8,9,7,20,44,65,-21,34
St. Pölten,5670,9,8,8,20,38,72,-34,32
SV Josko Rie,5670,10,8,4,24,29,59,-30,28
SC Rheindorf,5671,1,21,9,6,60,35,25,72
Vienna,5671,2,21,6,9,67,47,20,69
SK Sturm Gra,5671,3,20,4,12,60,30,30,64
FC Salzburg,5671,4,18,10,8,59,34,25,64
Rapid Vienna,5671,5,12,10,14,46,45,1,46
Admira Wacke,5671,6,13,6,17,43,64,-21,45
SV Josko Rie,5671,7,10,7,19,32,52,-20,37
RZ Pellets W,5671,8,9,8,19,45,61,-16,35
St. Pölten,5671,9,8,10,18,41,65,-24,34
Mattersburg,5671,10,7,12,17,39,59,-20,33
FC Salzburg,5672,1,20,8,8,62,32,30,68
SK Sturm Gra,5672,2,20,6,10,61,35,26,66
SC Rheindorf,5672,3,17,12,7,54,42,12,63
Vienna,5672,4,17,5,14,69,62,7,56
RZ Pellets W,5672,5,16,8,12,57,51,6,56
Rapid Vienna,5672,6,15,10,11,58,35,23,55
SV Josko Rie,5672,7,11,7,18,37,53,-16,40
Admira Wacke,5672,8,10,5,21,40,73,-33,35
St. Pölten,5672,9,8,9,19,43,70,-27,33
Mattersburg,5672,10,6,10,20,35,63,-28,28
FC Salzburg,5673,1,24,6,6,73,32,41,78
SC Rheindorf,5673,2,22,6,8,59,39,20,72
SK Sturm Gra,5673,3,19,6,11,61,40,21,63
Rapid Vienna,5673,4,14,11,11,53,36,17,53
Vienna,5673,5,15,8,13,56,53,3,53
Admira Wacke,5673,6,11,8,17,32,51,-19,41
RZ Pellets W,5673,7,9,10,17,43,62,-19,37
St. Pölten,5673,8,9,10,17,41,62,-21,37
Mattersburg,5673,9,9,9,18,39,52,-13,36
SV Josko Rie,5673,10,9,4,23,31,61,-30,31
FC Salzburg,5674,1,23,7,6,69,26,43,76
SK Sturm Gra,5674,2,19,8,9,56,31,25,65
Vienna,5674,3,18,5,13,64,62,2,59
SC Rheindorf,5674,4,16,10,10,51,49,2,58
Rapid Vienna,5674,5,15,10,11,54,36,18,55
Mattersburg,5674,6,11,8,17,38,50,-12,41
Admira Wacke,5674,7,12,4,20,39,63,-24,40
RZ Pellets W,5674,8,9,11,16,40,55,-15,38
St. Pölten,5674,9,9,10,17,42,59,-17,37
SV Josko Rie,5674,10,10,3,23,30,52,-22,33
SC Rheindorf,5675,1,23,7,6,57,36,21,76
FC Salzburg,5675,2,22,8,6,72,31,41,74
SK Sturm Gra,5675,3,20,7,9,61,34,27,67
Vienna,5675,4,15,7,14,64,60,4,52
Rapid Vienna,5675,5,12,12,12,60,45,15,48
St. Pölten,5675,6,10,11,15,47,61,-14,41
Admira Wacke,5675,7,11,7,18,37,60,-23,40
RZ Pellets W,5675,8,10,8,18,46,66,-20,38
SV Josko Rie,5675,9,10,4,22,31,55,-24,34
Mattersburg,5675,10,6,11,19,34,61,-27,29
SC Rheindorf,5676,1,20,7,9,61,43,18,67
FC Salzburg,5676,2,19,9,8,62,36,26,66
Vienna,5676,3,20,3,13,67,58,9,63
SK Sturm Gra,5676,4,17,7,12,60,41,19,58
Rapid Vienna,5676,5,14,13,9,62,40,22,55
RZ Pellets W,5676,6,15,7,14,49,50,-1,52
SV Josko Rie,5676,7,13,5,18,42,53,-11,44
Admira Wacke,5676,8,11,6,19,39,67,-28,39
St. Pölten,5676,9,8,9,19,45,68,-23,33
Mattersburg,5676,10,6,8,22,36,67,-31,26
FC Salzburg,5677,1,24,5,7,71,31,40,77
SC Rheindorf,5677,2,20,5,11,53,42,11,65
SK Sturm Gra,5677,3,18,8,10,56,37,19,62
Vienna,5677,4,18,5,13,64,49,15,59
RZ Pellets W,5677,5,15,8,13,55,51,4,53
Rapid Vienna,5677,6,14,9,13,57,45,12,51
SV Josko Rie,5677,7,12,4,20,38,54,-16,40
St. Pölten,5677,8,9,12,15,40,56,-16,39
Admira Wacke,5677,9,8,7,21,29,70,-41,31
Mattersburg,5677,10,7,7,22,31,59,-28,28
FC Salzburg,5678,1,20,9,7,70,33,37,69
SC Rheindorf,5678,2,21,6,9,52,37,15,69
SK Sturm Gra,5678,3,21,5,10,60,32,28,68
Vienna,5678,4,18,7,11,63,50,13,61
Rapid Vienna,5678,5,15,12,9,55,37,18,57
Admira Wacke,5678,6,12,6,18,38,60,-22,42
St. Pölten,5678,7,9,11,16,41,56,-15,38
RZ Pellets W,5678,8,9,7,20,41,62,-21,34
Mattersburg,5678,9,8,9,19,39,63,-24,33
SV Josko Rie,5678,10,9,4,23,29,58,-29,31
Vienna,5679,1,22,2,12,68,53,15,68
FC Salzburg,5679,2,20,6,10,65,37,28,66
SC Rheindorf,5679,3,19,9,8,55,42,13,66
SK Sturm Gra,5679,4,19,8,9,59,36,23,65
SV Josko Rie,5679,5,15,5,16,40,49,-9,50
Rapid Vienna,5679,6,10,12,14,52,44,8,42
RZ Pellets W,5679,7,12,6,18,44,56,-12,42
Admira Wacke,5679,8,11,7,18,34,55,-21,40
Mattersburg,5679,9,8,9,19,42,61,-19,33
St. Pölten,5679,10,7,10,19,33,59,-26,31
FC Salzburg,5680,1,19,9,8,63,37,26,66
SK Sturm Gra,5680,2,19,9,8,55,30,25,66
SC Rheindorf,5680,3,18,10,8,60,42,18,64
Vienna,5680,4,17,8,11,68,60,8,59
Rapid Vienna,5680,5,12,13,11,49,35,14,49
Admira Wacke,5680,6,13,8,15,41,58,-17,47
Mattersburg,5680,7,11,10,15,45,54,-9,43
RZ Pellets W,5680,8,9,10,17,50,65,-15,37
SV Josko Rie,5680,9,10,3,23,33,54,-21,33
St. Pölten,5680,10,7,10,19,37,66,-29,31
SC Rheindorf,5681,1,22,7,7,59,39,20,73
FC Salzburg,5681,2,22,6,8,63,35,28,72
Vienna,5681,3,20,3,13,67,52,15,63
SK Sturm Gra,5681,4,17,8,11,57,39,18,59
Rapid Vienna,5681,5,13,10,13,53,42,11,49
RZ Pellets W,5681,6,13,6,17,47,57,-10,45
Mattersburg,5681,7,9,12,15,42,50,-8,39
SV Josko Rie,5681,8,11,6,19,35,50,-15,39
Admira Wacke,5681,9,10,7,19,38,66,-28,37
St. Pölten,5681,10,6,9,21,41,72,-31,27
FC Salzburg,5682,1,20,7,9,59,31,28,67
SK Sturm Gra,5682,2,18,7,11,60,35,25,61
SC Rheindorf,5682,3,18,7,11,50,42,8,61
Vienna,5682,4,17,3,16,63,60,3,54
Rapid Vienna,5682,5,14,11,11,54,36,18,53
Admira Wacke,5682,6,16,3,17,41,59,-18,51
RZ Pellets W,5682,7,13,10,13,50,51,-1,49
Mattersburg,5682,8,10,9,17,36,48,-12,39
SV Josko Rie,5682,9,11,5,20,30,51,-21,38
St. Pölten,5682,10,7,10,19,41,71,-30,31
FC Salzburg,5683,1,22,7,7,69,31,38,73
SC Rheindorf,5683,2,21,9,6,58,35,23,72
SK Sturm Gra,5683,3,19,5,12,60,40,20,62
Rapid Vienna,5683,4,17,8,11,54,37,17,59
Vienna,5683,5,16,6,14,63,55,8,54
RZ Pellets W,5683,6,12,9,15,43,51,-8,45
Admira Wacke,5683,7,12,7,17,36,57,-21,43
Mattersburg,5683,8,9,8,19,37,57,-20,35
St. Pölten,5683,9,8,8,20,46,70,-24,32
SV Josko Rie,5683,10,8,5,23,31,64,-33,29
SK Sturm Gra,5684,1,21,6,9,64,31,33,69
SC Rheindorf,5684,2,21,6,9,63,46,17,69
FC Salzburg,5684,3,17,10,9,62,39,23,61
Vienna,5684,4,19,4,13,65,53,12,61
Admira Wacke,5684,5,14,7,15,42,54,-12,49
Rapid Vienna,5684,6,10,15,11,48,41,7,45
RZ Pellets W,5684,7,10,10,16,47,61,-14,40
Mattersburg,5684,8,10,7,19,35,53,-18,37
St. Pölten,5684,9,7,13,16,38,62,-24,34
SV Josko Rie,5684,10,9,6,21,33,57,-24,33
FC Salzburg,5685,1,23,7,6,68,28,40,76
Vienna,5685,2,22,4,10,66,53,13,70
SK Sturm Gra,5685,3,20,7,9,65,35,30,67
SC Rheindorf,5685,4,19,8,9,52,43,9,65
Rapid Vienna,5685,5,16,9,11,59,37,22,57
RZ Pellets W,5685,6,10,7,19,44,63,-19,37
St. Pölten,5685,7,8,11,17,48,65,-17,35
Admira Wacke,5685,8,9,8,19,32,58,-26,35
SV Josko Rie,5685,9,8,8,20,28,51,-23,32
Mattersburg,5685,10,6,9,21,38,67,-29,27
FC Salzburg,5686,1,20,11,5,75,34,41,71
Vienna,5686,2,19,7,10,69,56,13,64
SC Rheindorf,5686,3,18,7,11,55,46,9,61
SK Sturm Gra,5686,4,18,6,12,58,40,18,60
Rapid Vienna,5686,5,12,13,11,55,39,16,49
RZ Pellets W,5686,6,11,10,15,46,55,-9,43
Mattersburg,5686,7,11,7,18,40,54,-14,40
St. Pölten,5686,8,10,10,16,43,62,-19,40
Admira Wacke,5686,9,10,9,17,39,64,-25,39
SV Josko Rie,5686,10,8,6,22,28,58,-30,30
FC Salzburg,5687,1,20,9,7,63,32,31,69
SK Sturm Gra,5687,2,21,6,9,62,33,29,69
SC Rheindorf,5687,3,19,5,12,53,47,6,62
Vienna,5687,4,17,7,12,58,51,7,58
Rapid Vienna,5687,5,16,9,11,56,38,18,57
RZ Pellets W,5687,6,13,7,16,44,49,-5,46
SV Josko Rie,5687,7,12,5,19,34,49,-15,41
Admira Wacke,5687,8,9,11,16,31,52,-21,38
St. Pölten,5687,9,10,7,19,42,62,-20,37
Mattersburg,5687,10,6,8,22,32,62,-30,26
SC Rheindorf,5688,1,20,8,8,52,36,16,68
FC Salzburg,5688,2,20,7,9,67,35,32,67
SK Sturm Gra,5688,3,20,7,9,56,31,25,67
Vienna,5688,4,16,6,14,60,53,7,54
Rapid Vienna,5688,5,12,11,13,48,41,7,47
RZ Pellets W,5688,6,12,10,14,38,48,-10,46
Admira Wacke,5688,7,12,8,16,37,53,-16,44
SV Josko Rie,5688,8,11,8,17,36,51,-15,41
St. Pölten,5688,9,6,14,16,36,58,-22,32
Mattersburg,5688,10,7,9,20,33,57,-24,30
FC Salzburg,5689,1,23,7,6,66,28,38,76
SK Sturm Gra,5689,2,20,3,13,62,37,25,63
Rapid Vienna,5689,3,15,12,9,52,34,18,57
SC Rheindorf,5689,4,16,9,11,52,46,6,57
Vienna,5689,5,15,7,14,52,51,1,52
Admira Wacke,5689,6,14,6,16,40,55,-15,48
RZ Pellets W,5689,7,10,11,15,52,63,-11,41
SV Josko Rie,5689,8,11,7,18,34,50,-16,40
St. Pölten,5689,9,8,9,19,37,65,-28,33
Mattersburg,5689,10,7,11,18,40,58,-18,32
FC Salzburg,5690,1,21,8,7,67,30,37,71
Vienna,5690,2,20,7,9,69,47,22,67
SC Rheindorf,5690,3,17,9,10,50,45,5,60
SK Sturm Gra,5690,4,15,11,10,58,38,20,56
Admira Wacke,5690,5,12,11,13,41,54,-13,47
Mattersburg,5690,6,11,12,13,40,45,-5,45
RZ Pellets W,5690,7,10,9,17,44,57,-13,39
St. Pölten,5690,8,10,9,17,41,62,-21,39
Rapid Vienna,5690,9,8,14,14,52,53,-1,38
SV Josko Rie,5690,10,9,4,23,33,64,-31,31
FC Salzburg,5691,1,23,6,7,72,33,39,75
SK Sturm Gra,5691,2,20,6,10,61,31,30,66
SC Rheindorf,5691,3,19,7,10,58,53,5,64
Vienna,5691,4,19,5,12,63,55,8,62
Rapid Vienna,5691,5,14,10,12,60,45,15,52
Admira Wacke,5691,6,12,6,18,33,50,-17,42
RZ Pellets W,5691,7,9,10,17,43,59,-16,37
St. Pölten,5691,8,8,11,17,44,67,-23,35
SV Josko Rie,5691,9,9,7,20,37,60,-23,34
Mattersburg,5691,10,6,14,16,42,60,-18,32
FC Salzburg,5692,1,20,7,9,66,33,33,67
SC Rheindorf,5692,2,20,5,11,59,51,8,65
SK Sturm Gra,5692,3,20,4,12,62,43,19,64
Vienna,5692,4,20,3,13,65,53,12,63
Rapid Vienna,5692,5,14,10,12,54,42,12,52
Admira Wacke,5692,6,14,4,18,42,57,-15,46
RZ Pellets W,5692,7,11,9,16,44,55,-11,42
St. Pölten,5692,8,10,8,18,46,61,-15,38
Mattersburg,5692,9,10,7,19,38,57,-19,37
SV Josko Rie,5692,10,10,5,21,30,54,-24,35
FC Salzburg,5693,1,21,9,6,62,25,37,72
SK Sturm Gra,5693,2,19,7,10,56,36,20,64
Vienna,5693,3,19,6,11,70,49,21,63
SC Rheindorf,5693,4,15,12,9,49,45,4,57
Admira Wacke,5693,5,15,6,15,42,50,-8,51
Rapid Vienna,5693,6,12,11,13,53,44,9,47
RZ Pellets W,5693,7,10,12,14,42,53,-11,42
St. Pölten,5693,8,8,10,18,41,66,-25,34
SV Josko Rie,5693,9,8,9,19,36,61,-25,33
Mattersburg,5693,10,7,10,19,38,60,-22,31
SC Rheindorf,5694,1,20,10,6,53,34,19,70
FC Salzburg,5694,2,19,11,6,60,30,30,68
SK Sturm Gra,5694,3,20,6,10,54,32,22,66
Vienna,5694,4,15,8,13,62,54,8,53
RZ Pellets W,5694,5,15,7,14,57,58,-1,52
Rapid Vienna,5694,6,11,14,11,51,40,11,47
Admira Wacke,5694,7,13,6,17,38,54,-16,45
St. Pölten,5694,8,9,8,19,42,65,-23,35
SV Josko Rie,5694,9,9,6,21,28,51,-23,33
Mattersburg,5694,10,8,6,22,38,65,-27,30
FC Salzburg,5695,1,20,10,6,64,31,33,70
SC Rheindorf,5695,2,18,10,8,58,46,12,64
SK Sturm Gra,5695,3,17,10,9,59,34,25,61
Vienna,5695,4,18,6,12,63,50,13,60
Rapid Vienna,5695,5,13,11,12,56,45,11,50
RZ Pellets W,5695,6,13,7,16,44,56,-12,46
Mattersburg,5695,7,9,11,16,42,55,-13,38
Admira Wacke,5695,8,11,5,20,32,57,-25,38
St. Pölten,5695,9,8,11,17,41,62,-21,35
SV Josko Rie,5695,10,9,7,20,30,53,-23,34
FC Salzburg,5696,1,21,9,6,75,32,43,72
SK Sturm Gra,5696,2,20,7,9,58,29,29,67
SC Rheindorf,5696,3,18,9,9,54,42,12,63
Vienna,5696,4,18,7,11,58,50,8,61
Rapid Vienna,5696,5,15,9,12,62,39,23,54
RZ Pellets W,5696,6,14,8,14,51,53,-2,50
Mattersburg,5696,7,10,8,18,41,60,-19,38
SV Josko Rie,5696,8,9,7,20,35,61,-26,34
Admira Wacke,5696,9,8,8,20,30,62,-32,32
St. Pölten,5696,10,7,8,21,41,77,-36,29
SC Rheindorf,5697,1,21,5,10,59,42,17,68
FC Salzburg,5697,2,19,9,8,61,35,26,66
Vienna,5697,3,20,5,11,71,51,20,65
Rapid Vienna,5697,4,17,10,9,59,35,24,61
SK Sturm Gra,5697,5,19,4,13,56,38,18,61
RZ Pellets W,5697,6,14,8,14,49,55,-6,50
Admira Wacke,5697,7,12,5,19,39,63,-24,41
SV Josko Rie,5697,8,10,5,21,35,61,-26,35
St. Pölten,5697,9,7,10,19,36,61,-25,31
Mattersburg,5697,10,5,11,20,34,58,-24,26
FC Salzburg,5698,1,24,5,7,76,36,40,77
SK Sturm Gra,5698,2,20,6,10,59,32,27,66
SC Rheindorf,5698,3,19,8,9,56,44,12,65
Rapid Vienna,5698,4,16,9,11,57,37,20,57
RZ Pellets W,5698,5,15,8,13,51,50,1,53
Vienna,5698,6,15,4,17,63,60,3,49
Admira Wacke,5698,7,12,5,19,38,67,-29,41
Mattersburg,5698,8,8,10,18,38,57,-19,34
SV Josko Rie,5698,9,9,5,22,28,54,-26,32
St. Pölten,5698,10,8,8,20,36,65,-29,32
FC Salzburg,5699,1,22,7,7,69,33,36,73
SK Sturm Gra,5699,2,22,6,8,70,29,41,72
Vienna,5699,3,21,6,9,70,48,22,69
SC Rheindorf,5699,4,18,7,11,55,47,8,61
Rapid Vienna,5699,5,16,9,11,60,41,19,57
Mattersburg,5699,6,10,10,16,43,58,-15,40
St. Pölten,5699,7,8,9,19,37,63,-26,33
Admira Wacke,5699,8,9,6,21,29,61,-32,33
SV Josko Rie,5699,9,8,8,20,30,52,-22,32
RZ Pellets W,5699,10,8,8,20,40,71,-31,32
FC Salzburg,5700,1,24,6,6,70,23,47,78
SC Rheindorf,5700,2,19,8,9,52,41,11,65
SK Sturm Gra,5700,3,19,7,10,63,35,28,64
Vienna,5700,4,16,8,12,57,56,1,56
Rapid Vienna,5700,5,12,14,10,56,43,13,50
Admira Wacke,5700,6,15,5,16,48,60,-12,50
RZ Pellets W,5700,7,9,9,18,42,58,-16,36
St. Pölten,5700,8,7,13,16,44,66,-22,34
Mattersburg,5700,9,8,9,19,39,63,-24,33
SV Josko Rie,5700,10,9,5,22,35,61,-26,32
Vienna,5701,1,21,5,10,63,44,19,68
SC Rheindorf,5701,2,20,6,10,60,46,14,66
FC Salzburg,5701,3,19,7,10,73,42,31,64
SK Sturm Gra,5701,4,19,4,13,51,36,15,61
Rapid Vienna,5701,5,16,10,10,58,41,17,58
RZ Pellets W,5701,6,14,6,16,46,54,-8,48
Mattersburg,5701,7,12,6,18,50,64,-14,42
Admira Wacke,5701,8,12,6,18,42,57,-15,42
St. Pölten,5701,9,7,11,18,40,62,-22,32
SV Josko Rie,5701,10,7,5,24,30,67,-37,26
SK Sturm Gra,5702,1,19,8,9,56,38,18,65
FC Salzburg,5702,2,19,6,11,61,37,24,63
Vienna,5702,3,19,5,12,65,53,12,62
Rapid Vienna,5702,4,15,9,12,56,40,16,54
SC Rheindorf,5702,5,16,6,14,60,56,4,54
SV Josko Rie,5702,6,14,5,17,35,45,-10,47
Admira Wacke,5702,7,13,7,16,43,60,-17,46
St. Pölten,5702,8,11,10,15,51,63,-12,43
RZ Pellets W,5702,9,11,7,18,48,60,-12,40
Mattersburg,5702,10,8,7,21,34,57,-23,31
FC Salzburg,5703,1,22,4,10,62,30,32,70
SK Sturm Gra,5703,2,20,7,9,64,29,35,67
Vienna,5703,3,19,6,11,67,51,16,63
SC Rheindorf,5703,4,17,9,10,53,40,13,60
Rapid Vienna,5703,5,13,14,9,51,37,14,53
Admira Wacke,5703,6,14,7,15,38,56,-18,49
RZ Pellets W,5703,7,10,8,18,50,60,-10,38
SV Josko Rie,5703,8,10,7,19,32,53,-21,37
St. Pölten,5703,9,8,9,19,40,69,-29,33
Mattersburg,5703,10,7,9,20,30,62,-32,30
SC Rheindorf,5704,1,21,8,7,65,46,19,71
FC Salzburg,5704,2,20,8,8,66,32,34,68
Vienna,5704,3,21,3,12,69,53,16,66
Rapid Vienna,5704,4,15,10,11,57,40,17,55
SK Sturm Gra,5704,5,17,4,15,56,39,17,55
RZ Pellets W,5704,6,14,8,14,47,55,-8,50
Admira Wacke,5704,7,10,8,18,37,55,-18,38
St. Pölten,5704,8,9,10,17,44,67,-23,37
SV Josko Rie,5704,9,9,6,21,33,63,-30,33
Mattersburg,5704,10,8,7,21,37,61,-24,31
FC Salzburg,5705,1,20,10,6,69,32,37,70
SC Rheindorf,5705,2,18,9,9,55,45,10,63
Vienna,5705,3,18,8,10,64,54,10,62
SK Sturm Gra,5705,4,18,7,11,60,42,18,61
Rapid Vienna,5705,5,12,12,12,53,42,11,48
RZ Pellets W,5705,6,12,8,16,46,54,-8,44
Mattersburg,5705,7,12,7,17,48,58,-10,43
Admira Wacke,5705,8,11,5,20,36,66,-30,38
SV Josko Rie,5705,9,10,6,20,41,56,-15,36
St. Pölten,5705,10,8,10,18,46,69,-23,34
FC Salzburg,5706,1,22,6,8,63,30,33,72
Rapid Vienna,5706,2,17,9,10,63,43,20,60
SK Sturm Gra,5706,3,18,6,12,60,40,20,60
Vienna,5706,4,18,4,14,56,48,8,58
SC Rheindorf,5706,5,14,12,10,50,42,8,54
RZ Pellets W,5706,6,12,7,17,46,60,-14,43
SV Josko Rie,5706,7,13,4,19,32,50,-18,43
Mattersburg,5706,8,10,8,18,36,50,-14,38
Admira Wacke,5706,9,11,5,20,35,61,-26,38
St. Pölten,5706,10,8,13,15,48,65,-17,37
FC Salzburg,5707,1,22,8,6,75,32,43,74
SK Sturm Gra,5707,2,22,6,8,64,31,33,72
SC Rheindorf,5707,3,19,10,7,59,48,11,67
Vienna,5707,4,18,7,11,65,54,11,61
Rapid Vienna,5707,5,12,13,11,62,45,17,49
SV Josko Rie,5707,6,12,6,18,38,60,-22,42
RZ Pellets W,5707,7,10,7,19,46,65,-19,37
St. Pölten,5707,8,9,9,18,47,66,-19,36
Admira Wacke,5707,9,8,9,19,31,59,-28,33
Mattersburg,5707,10,6,9,21,34,61,-27,27
FC Salzburg,5708,1,22,6,8,66,37,29,72
SK Sturm Gra,5708,2,20,8,8,70,37,33,68
SC Rheindorf,5708,3,20,8,8,60,43,17,68
Rapid Vienna,5708,4,14,11,11,55,41,14,53
Vienna,5708,5,15,4,17,51,53,-2,49
RZ Pellets W,5708,6,13,9,14,50,54,-4,48
Admira Wacke,5708,7,10,9,17,31,57,-26,39
SV Josko Rie,5708,8,10,7,19,32,48,-16,37
St. Pölten,5708,9,9,8,19,38,61,-23,35
Mattersburg,5708,10,8,8,20,36,58,-22,32
SC Rheindorf,5709,1,20,6,10,58,45,13,66
SK Sturm Gra,5709,2,19,7,10,60,36,24,64
FC Salzburg,5709,3,17,12,7,63,34,29,63
Rapid Vienna,5709,4,16,11,9,56,36,20,59
Vienna,5709,5,15,7,14,57,53,4,52
RZ Pellets W,5709,6,13,7,16,43,56,-13,46
SV Josko Rie,5709,7,12,4,20,36,55,-19,40
Admira Wacke,5709,8,10,9,17,34,53,-19,39
St. Pölten,5709,9,10,7,19,41,60,-19,37
Mattersburg,5709,10,10,6,20,44,64,-20,36
FC Salzburg,5710,1,21,9,6,67,31,36,72
SC Rheindorf,5710,2,19,9,8,58,45,13,66
Rapid Vienna,5710,3,17,10,9,65,36,29,61
Vienna,5710,4,17,10,9,59,42,17,61
SK Sturm Gra,5710,5,15,9,12,52,38,14,54
RZ Pellets W,5710,6,12,8,16,41,50,-9,44
Admira Wacke,5710,7,12,3,21,35,68,-33,39
St. Pölten,5710,8,9,9,18,45,65,-20,36
Mattersburg,5710,9,7,11,18,35,58,-23,32
SV Josko Rie,5710,10,7,10,19,32,56,-24,31
FC Salzburg,5711,1,23,7,6,75,26,49,76
SK Sturm Gra,5711,2,21,5,10,62,35,27,68
SC Rheindorf,5711,3,17,12,7,54,42,12,63
Vienna,5711,4,17,5,14,59,51,8,56
RZ Pellets W,5711,5,14,8,14,45,54,-9,50
Rapid Vienna,5711,6,13,10,13,53,42,11,49
SV Josko Rie,5711,7,11,6,19,34,56,-22,39
Admira Wacke,5711,8,9,8,19,32,54,-22,35
St. Pölten,5711,9,7,11,18,42,67,-25,32
Mattersburg,5711,10,8,8,20,38,67,-29,32
FC Salzburg,5712,1,24,7,5,67,26,41,79
SK Sturm Gra,5712,2,19,8,9,54,30,24,65
SC Rheindorf,5712,3,18,9,9,60,47,13,63
Vienna,5712,4,18,3,15,63,57,6,57
Rapid Vienna,5712,5,15,10,11,55,35,20,55
RZ Pellets W,5712,6,11,8,17,44,53,-9,41
Admira Wacke,5712,7,11,7,18,32,53,-21,40
SV Josko Rie,5712,8,9,8,19,31,54,-23,35
St. Pölten,5712,9,7,12,17,37,64,-27,33
Mattersburg,5712,10,8,8,20,37,61,-24,32
SK Sturm Gra,5713,1,20,7,9,60,34,26,67
Vienna,5713,2,21,4,11,69,51,18,67
FC Salzburg,5713,3,18,11,7,67,36,31,65
SC Rheindorf,5713,4,18,7,11,54,46,8,61
Rapid Vienna,5713,5,13,11,12,56,42,14,50
Admira Wacke,5713,6,12,9,15,39,57,-18,45
RZ Pellets W,5713,7,11,8,17,40,51,-11,41
SV Josko Rie,5713,8,11,5,20,40,61,-21,38
St. Pölten,5713,9,7,12,17,42,64,-22,33
Mattersburg,5713,10,8,8,20,41,66,-25,32
FC Salzburg,5714,1,21,9,6,69,31,38,72
SC Rheindorf,5714,2,21,8,7,60,39,21,71
SK Sturm Gra,5714,3,17,7,12,61,39,22,58
Vienna,5714,4,16,5,15,64,66,-2,53
Rapid Vienna,5714,5,12,13,11,49,37,12,49
RZ Pellets W,5714,6,13,9,14,48,55,-7,48
Admira Wacke,5714,7,10,12,14,44,59,-15,42
SV Josko Rie,5714,8,10,7,19,33,54,-21,37
Mattersburg,5714,9,8,9,19,39,60,-21,33
St. Pölten,5714,10,8,9,19,45,72,-27,33
FC Salzburg,5715,1,21,8,7,66,29,37,71
Vienna,5715,2,21,6,9,71,45,26,69
SK Sturm Gra,5715,3,20,6,10,62,37,25,66
SC Rheindorf,5715,4,18,5,13,56,51,5,59
Rapid Vienna,5715,5,12,13,11,51,43,8,49
Admira Wacke,5715,6,12,7,17,37,55,-18,43
RZ Pellets W,5715,7,11,9,16,47,62,-15,42
Mattersburg,5715,8,10,8,18,35,51,-16,38
SV Josko Rie,5715,9,10,5,21,33,58,-25,35
St. Pölten,5715,10,7,9,20,39,66,-27,30
SC Rheindorf,5716,1,21,6,9,58,45,13,69
SK Sturm Gra,5716,2,21,4,11,64,36,28,67
FC Salzburg,5716,3,19,8,9,62,35,27,65
Vienna,5716,4,18,6,12,69,51,18,60
Rapid Vienna,5716,5,16,10,10,61,37,24,58
Admira Wacke,5716,6,11,6,19,32,63,-31,39
RZ Pellets W,5716,7,10,8,18,40,53,-13,38
St. Pölten,5716,8,10,8,18,49,72,-23,38
SV Josko Rie,5716,9,11,4,21,31,49,-18,37
Mattersburg,5716,10,9,8,19,38,63,-25,35
FC Salzburg,5717,1,20,10,6,71,38,33,70
SC Rheindorf,5717,2,20,8,8,65,40,25,68
Vienna,5717,3,20,4,12,71,56,15,64
SK Sturm Gra,5717,4,17,7,12,59,44,15,58
Rapid Vienna,5717,5,14,12,10,54,37,17,54
RZ Pellets W,5717,6,13,9,14,46,53,-7,48
SV Josko Rie,5717,7,11,6,19,41,56,-15,39
Admira Wacke,5717,8,10,6,20,36,66,-30,36
St. Pölten,5717,9,7,10,19,39,64,-25,31
Mattersburg,5717,10,7,10,19,34,62,-28,31
SK Sturm Gra,5718,1,22,5,9,61,33,28,71
FC Salzburg,5718,2,19,8,9,63,32,31,65
Vienna,5718,3,21,2,13,70,60,10,65
SC Rheindorf,5718,4,18,7,11,58,46,12,61
Rapid Vienna,5718,5,14,9,13,53,37,16,51
RZ Pellets W,5718,6,12,6,18,42,63,-21,42
St. Pölten,5718,7,10,11,15,49,63,-14,41
SV Josko Rie,5718,8,12,5,19,30,49,-19,41
Admira Wacke,5718,9,10,6,20,39,63,-24,36
Mattersburg,5718,10,9,7,20,41,60,-19,34
FC Salzburg,5719,1,23,7,6,73,25,48,76
SK Sturm Gra,5719,2,23,5,8,60,27,33,74
SC Rheindorf,5719,3,18,7,11,52,40,12,61
Vienna,5719,4,17,7,12,54,50,4,58
Rapid Vienna,5719,5,14,11,11,54,38,16,53
RZ Pellets W,5719,6,10,11,15,40,47,-7,41
Admira Wacke,5719,7,11,5,20,31,60,-29,38
SV Josko Rie,5719,8,11,3,22,33,58,-25,36
Mattersburg,5719,9,8,10,18,39,59,-20,34
St. Pölten,5719,10,6,12,18,32,64,-32,30
SC Rheindorf,5720,1,22,6,8,62,40,22,72
FC Salzburg,5720,2,20,10,6,68,31,37,70
SK Sturm Gra,5720,3,20,5,11,59,40,19,65
Vienna,5720,4,18,7,11,65,50,15,61
Rapid Vienna,5720,5,14,10,12,53,37,16,52
Admira Wacke,5720,6,13,6,17,39,62,-23,45
RZ Pellets W,5720,7,12,7,17,46,51,-5,43
SV Josko Rie,5720,8,10,6,20,35,54,-19,36
St. Pölten,5720,9,7,10,19,39,71,-32,31
Mattersburg,5720,10,6,9,21,34,64,-30,27
FC Salzburg,5721,1,21,8,7,65,28,37,71
SK Sturm Gra,5721,2,21,7,8,60,27,33,70
SC Rheindorf,5721,3,19,8,9,61,44,17,65
Vienna,5721,4,18,5,13,55,46,9,59
Rapid Vienna,5721,5,12,12,12,50,41,9,48
Admira Wacke,5721,6,13,5,18,40,63,-23,44
RZ Pellets W,5721,7,12,7,17,48,56,-8,43
Mattersburg,5721,8,10,9,17,39,57,-18,39
St. Pölten,5721,9,8,10,18,39,67,-28,34
SV Josko Rie,5721,10,9,3,24,34,62,-28,30
FC Salzburg,5722,1,22,10,4,68,26,42,76
SK Sturm Gra,5722,2,19,6,11,65,39,26,63
SC Rheindorf,5722,3,17,8,11,52,56,-4,59
Vienna,5722,4,17,6,13,64,57,7,57
Rapid Vienna,5722,5,15,11,10,67,43,24,56
RZ Pellets W,5722,6,13,7,16,50,56,-6,46
Admira Wacke,5722,7,11,6,19,42,64,-22,39
SV Josko Rie,5722,8,10,7,19,33,53,-20,37
Mattersburg,5722,9,8,10,18,35,56,-21,34
St. Pölten,5722,10,8,9,19,40,66,-26,33
SC Rheindorf,5723,1,21,6,9,58,42,16,69
SK Sturm Gra,5723,2,20,8,8,55,28,27,68
FC Salzburg,5723,3,19,9,8,63,32,31,66
RZ Pellets W,5723,4,15,9,12,51,51,0,54
Vienna,5723,5,15,8,13,61,58,3,53
Rapid Vienna,5723,6,13,9,14,54,41,13,48
Mattersburg,5723,7,11,9,16,48,56,-8,42
SV Josko Rie,5723,8,10,7,19,30,50,-20,37
Admira Wacke,5723,9,9,7,20,33,62,-29,34
St. Pölten,5723,10,6,10,20,43,76,-33,28
FC Salzburg,5724,1,21,5,10,65,31,34,68
SC Rheindorf,5724,2,19,9,8,55,43,12,66
Vienna,5724,3,20,5,11,59,43,16,65
SK Sturm Gra,5724,4,16,9,11,53,34,19,57
Rapid Vienna,5724,5,13,14,9,55,42,13,53
Admira Wacke,5724,6,12,11,13,41,55,-14,47
RZ Pellets W,5724,7,12,8,16,42,54,-12,44
SV Josko Rie,5724,8,11,5,20,37,55,-18,38
St. Pölten,5724,9,8,9,19,40,62,-22,33
Mattersburg,5724,10,5,11,20,32,60,-28,26
FC Salzburg,5725,1,23,7,6,73,29,44,76
SK Sturm Gra,5725,2,21,6,9,70,38,32,69
SC Rheindorf,5725,3,20,7,9,56,40,16,67
Vienna,5725,4,18,4,14,61,59,2,58
Admira Wacke,5725,5,12,6,18,38,56,-18,42
St. Pölten,5725,6,11,8,17,50,62,-12,41
RZ Pellets W,5725,7,11,8,17,44,58,-14,41
Rapid Vienna,5725,8,10,9,17,43,50,-7,39
SV Josko Rie,5725,9,11,6,19,30,52,-22,39
Mattersburg,5725,10,9,7,20,36,57,-21,34
Vienna,5726,1,21,4,11,65,56,9,67
FC Salzburg,5726,2,19,9,8,67,31,36,66
SK Sturm Gra,5726,3,19,5,12,61,37,24,62
SC Rheindorf,5726,4,18,7,11,53,44,9,61
Rapid Vienna,5726,5,16,10,10,61,39,22,58
RZ Pellets W,5726,6,13,7,16,49,54,-5,46
SV Josko Rie,5726,7,10,8,18,38,55,-17,38
Admira Wacke,5726,8,11,4,21,41,69,-28,37
St. Pölten,5726,9,9,9,18,40,68,-28,36
Mattersburg,5726,10,8,9,19,39,61,-22,33
SK Sturm Gra,5727,1,21,8,7,55,28,27,71
FC Salzburg,5727,2,19,10,7,63,32,31,67
SC Rheindorf,5727,3,18,9,9,56,41,15,63
Vienna,5727,4,19,5,12,63,50,13,62
Rapid Vienna,5727,5,12,13,11,57,40,17,49
Mattersburg,5727,6,9,12,15,39,56,-17,39
Admira Wacke,5727,7,10,9,17,32,59,-27,39
RZ Pellets W,5727,8,9,10,17,37,54,-17,37
SV Josko Rie,5727,9,8,9,19,30,53,-23,33
St. Pölten,5727,10,7,11,18,40,59,-19,32
FC Salzburg,5728,1,21,7,8,59,31,28,70
SK Sturm Gra,5728,2,17,10,9,56,31,25,61
SC Rheindorf,5728,3,17,10,9,51,42,9,61
Vienna,5728,4,17,6,13,53,54,-1,57
Rapid Vienna,5728,5,12,12,12,52,44,8,48
St. Pölten,5728,6,12,11,13,46,50,-4,47
SV Josko Rie,5728,7,14,3,19,42,53,-11,45
RZ Pellets W,5728,8,11,11,14,56,63,-7,44
Admira Wacke,5728,9,9,9,18,30,57,-27,36
Mattersburg,5728,10,6,9,21,43,63,-20,27
SC Rheindorf,5729,1,22,5,9,63,43,20,71
FC Salzburg,5729,2,18,9,9,63,38,25,63
Rapid Vienna,5729,3,16,12,8,67,39,28,60
SK Sturm Gra,5729,4,16,10,10,53,38,15,58
Vienna,5729,5,17,5,14,66,52,14,56
RZ Pellets W,5729,6,15,8,13,50,52,-2,53
SV Josko Rie,5729,7,11,6,19,40,59,-19,39
Admira Wacke,5729,8,10,6,20,34,61,-27,36
St. Pölten,5729,9,8,9,19,39,66,-27,33
Mattersburg,5729,10,8,8,20,40,67,-27,32
FC Salzburg,5730,1,20,8,8,67,35,32,68
SC Rheindorf,5730,2,19,7,10,62,44,18,64
SK Sturm Gra,5730,3,19,5,12,57,37,20,62
Vienna,5730,4,18,7,11,62,51,11,61
Rapid Vienna,5730,5,13,13,10,58,44,14,52
RZ Pellets W,5730,6,13,9,14,46,57,-11,48
SV Josko Rie,5730,7,13,5,18,38,49,-11,44
Admira Wacke,5730,8,12,4,20,39,60,-21,40
St. Pölten,5730,9,7,11,18,36,59,-23,32
Mattersburg,5730,10,8,7,21,35,64,-29,31
FC Salzburg,5731,1,21,6,9,64,32,32,69
Vienna,5731,2,19,7,10,60,44,16,64
SK Sturm Gra,5731,3,19,6,11,71,41,30,63
SC Rheindorf,5731,4,17,7,12,52,47,5,58
Rapid Vienna,5731,5,16,8,12,56,44,12,56
Admira Wacke,5731,6,14,4,18,41,61,-20,46
RZ Pellets W,5731,7,12,8,16,43,49,-6,44
SV Josko Rie,5731,8,12,4,20,31,50,-19,40
Mattersburg,5731,9,10,6,20,36,58,-22,36
St. Pölten,5731,10,7,10,19,36,64,-28,31
FC Salzburg,5732,1,22,6,8,69,25,44,72
SK Sturm Gra,5732,2,18,8,10,59,37,22,62
Vienna,5732,3,19,4,13,66,59,7,61
SC Rheindorf,5732,4,17,8,11,53,55,-2,59
Rapid Vienna,5732,5,16,10,10,65,36,29,58
RZ Pellets W,5732,6,13,8,15,45,59,-14,47
Admira Wacke,5732,7,12,6,18,39,58,-19,42
SV Josko Rie,5732,8,11,6,19,41,57,-16,39
St. Pölten,5732,9,8,12,16,43,67,-24,36
Mattersburg,5732,10,6,8,22,34,61,-27,26
FC Salzburg,5733,1,22,8,6,67,31,36,74
SC Rheindorf,5733,2,20,10,6,64,45,19,70
Vienna,5733,3,21,4,11,62,48,14,67
SK Sturm Gra,5733,4,17,7,12,55,37,18,58
Admira Wacke,5733,5,16,7,13,51,53,-2,55
Rapid Vienna,5733,6,13,10,13,57,46,11,49
RZ Pellets W,5733,7,11,7,18,43,61,-18,40
Mattersburg,5733,8,8,8,20,38,59,-21,32
St. Pölten,5733,9,7,9,20,37,64,-27,30
SV Josko Rie,5733,10,9,2,25,28,58,-30,29
FC Salzburg,5734,1,20,9,7,69,26,43,69
SC Rheindorf,5734,2,20,7,9,56,41,15,67
Vienna,5734,3,20,6,10,66,51,15,66
SK Sturm Gra,5734,4,20,5,11,57,35,22,65
Rapid Vienna,5734,5,12,13,11,57,40,17,49
RZ Pellets W,5734,6,12,7,17,45,56,-11,43
Admira Wacke,5734,7,10,8,18,39,70,-31,38
St. Pölten,5734,8,9,10,17,39,58,-19,37
Mattersburg,5734,9,10,6,20,40,65,-25,36
SV Josko Rie,5734,10,9,5,22,34,60,-26,32
FC Salzburg,5735,1,20,7,9,63,29,34,67
SK Sturm Gra,5735,2,19,8,9,60,36,24,65
SC Rheindorf,5735,3,16,12,8,47,33,14,60
Vienna,5735,4,16,9,11,57,49,8,57
Rapid Vienna,5735,5,13,10,13,53,48,5,49
RZ Pellets W,5735,6,14,6,16,52,53,-1,48
Admira Wacke,5735,7,12,6,18,37,58,-21,42
Mattersburg,5735,8,10,11,15,35,50,-15,41
SV Josko Rie,5735,9,10,9,17,32,50,-18,39
St. Pölten,5735,10,7,8,21,38,68,-30,29
SC Rheindorf,5736,1,21,5,10,62,47,15,68
FC Salzburg,5736,2,19,8,9,71,39,32,65
SK Sturm Gra,5736,3,19,8,9,58,32,26,65
Vienna,5736,4,19,5,12,63,52,11,62
Rapid Vienna,5736,5,13,12,11,63,43,20,51
RZ Pellets W,5736,6,12,10,14,48,53,-5,46
Admira Wacke,5736,7,12,7,17,40,65,-25,43
SV Josko Rie,5736,8,11,5,20,35,59,-24,38
St. Pölten,5736,9,8,9,19,42,68,-26,33
Mattersburg,5736,10,8,7,21,37,61,-24,31
FC Salzburg,5737,1,23,7,6,69,26,43,76
SC Rheindorf,5737,2,21,10,5,62,35,27,73
SK Sturm Gra,5737,3,18,6,12,60,40,20,60
Vienna,5737,4,17,7,12,63,53,10,58
Rapid Vienna,5737,5,13,10,13,53,46,7,49
RZ Pellets W,5737,6,13,7,16,47,55,-8,46
SV Josko Rie,5737,7,14,4,18,40,51,-11,46
St. Pölten,5737,8,10,8,18,41,64,-23,38
Admira Wacke,5737,9,8,6,22,31,69,-38,30
Mattersburg,5737,10,6,9,21,36,63,-27,27
FC Salzburg,5738,1,23,7,6,64,25,39,76
SC Rheindorf,5738,2,20,7,9,53,42,11,67
Vienna,5738,3,18,7,11,65,50,15,61
SK Sturm Gra,5738,4,16,8,12,56,38,18,56
Rapid Vienna,5738,5,12,11,13,48,42,6,47
Mattersburg,5738,6,13,8,15,44,49,-5,47
RZ Pellets W,5738,7,14,5,17,45,51,-6,47
Admira Wacke,5738,8,11,7,18,38,57,-19,40
SV Josko Rie,5738,9,9,6,21,30,54,-24,33
St. Pölten,5738,10,6,10,20,39,74,-35,28
FC Salzburg,5739,1,22,8,6,68,29,39,74
SC Rheindorf,5739,2,20,8,8,58,44,14,68
SK Sturm Gra,5739,3,20,5,11,59,37,22,65
Vienna,5739,4,18,3,15,59,54,5,57
Rapid Vienna,5739,5,11,12,13,53,42,11,45
RZ Pellets W,5739,6,12,6,18,47,56,-9,42
SV Josko Rie,5739,7,12,6,18,40,59,-19,42
Mattersburg,5739,8,11,8,17,43,50,-7,41
Admira Wacke,5739,9,12,5,19,35,61,-26,41
St. Pölten,5739,10,7,9,20,32,62,-30,30
FC Salzburg,5740,1,20,6,10,63,33,30,66
SK Sturm Gra,5740,2,20,6,10,65,36,29,66
SC Rheindorf,5740,3,18,10,8,49,36,13,64
Rapid Vienna,5740,4,17,9,10,63,38,25,60
Vienna,5740,5,18,6,12,62,51,11,60
Mattersburg,5740,6,11,9,16,41,56,-15,42
St. Pölten,5740,7,11,7,18,45,63,-18,40
SV Josko Rie,5740,8,11,5,20,35,53,-18,38
Admira Wacke,5740,9,11,5,20,36,64,-28,38
RZ Pellets W,5740,10,9,5,22,45,74,-29,32
FC Salzburg,5741,1,23,6,7,67,30,37,75
SC Rheindorf,5741,2,19,8,9,54,40,14,65
Vienna,5741,3,19,5,12,66,50,16,62
Rapid Vienna,5741,4,15,9,12,64,46,18,54
SK Sturm Gra,5741,5,16,5,15,52,40,12,53
RZ Pellets W,5741,6,14,8,14,52,60,-8,50
Admira Wacke,5741,7,13,5,18,37,61,-24,44
SV Josko Rie,5741,8,10,7,19,42,58,-16,37
St. Pölten,5741,9,9,8,19,41,70,-29,35
Mattersburg,5741,10,8,7,21,39,59,-20,31
SK Sturm Gra,5742,1,22,7,7,63,28,35,73
SC Rheindorf,5742,2,20,8,8,50,35,15,68
FC Salzburg,5742,3,19,6,11,59,37,22,63
Vienna,5742,4,17,5,14,54,53,1,56
Rapid Vienna,5742,5,15,10,11,56,38,18,55
RZ Pellets W,5742,6,14,8,14,46,50,-4,50
Admira Wacke,5742,7,13,6,17,38,48,-10,45
St. Pölten,5742,8,10,7,19,43,64,-21,37
SV Josko Rie,5742,9,9,5,22,29,53,-24,32
Mattersburg,5742,10,7,6,23,30,62,-32,27
FC Salzburg,5743,1,22,6,8,64,29,35,72
SC Rheindorf,5743,2,20,6,10,53,48,5,66
SK Sturm Gra,5743,3,19,5,12,59,41,18,62
Vienna,5743,4,18,4,14,59,51,8,58
Rapid Vienna,5743,5,14,11,11,58,39,19,53
SV Josko Rie,5743,6,13,5,18,41,53,-12,44
RZ Pellets W,5743,7,12,6,18,43,54,-11,42
St. Pölten,5743,8,10,10,16,42,57,-15,40
Admira Wacke,5743,9,10,8,18,37,59,-22,38
Mattersburg,5743,10,7,9,20,36,61,-25,30
FC Salzburg,5744,1,20,8,8,65,32,33,68
SC Rheindorf,5744,2,20,8,8,54,39,15,68
Vienna,5744,3,18,7,11,66,51,15,61
SK Sturm Gra,5744,4,17,9,10,60,36,24,60
Rapid Vienna,5744,5,15,11,10,59,43,16,56
Admira Wacke,5744,6,12,6,18,40,58,-18,42
St. Pölten,5744,7,12,6,18,46,66,-20,42
RZ Pellets W,5744,8,10,7,19,41,56,-15,37
SV Josko Rie,5744,9,10,5,21,30,56,-26,35
Mattersburg,5744,10,8,9,19,38,62,-24,33
FC Salzburg,5745,1,23,6,7,73,29,44,75
SK Sturm Gra,5745,2,21,6,9,61,32,29,69
SC Rheindorf,5745,3,18,8,10,54,44,10,62
Vienna,5745,4,19,4,13,65,47,18,61
Rapid Vienna,5745,5,13,12,11,56,42,14,51
RZ Pellets W,5745,6,15,5,16,48,55,-7,50
Mattersburg,5745,7,10,9,17,41,59,-18,39
Admira Wacke,5745,8,10,8,18,37,64,-27,38
SV Josko Rie,5745,9,10,5,21,31,62,-31,35
St. Pölten,5745,10,5,9,22,35,67,-32,24
FC Salzburg,5746,1,22,7,7,68,26,42,73
SC Rheindorf,5746,2,21,7,8,55,39,16,70
SK Sturm Gra,5746,3,20,6,10,63,33,30,66
Rapid Vienna,5746,4,17,8,11,58,45,13,59
Vienna,5746,5,18,4,14,61,46,15,58
SV Josko Rie,5746,6,11,6,19,33,57,-24,39
RZ Pellets W,5746,7,9,9,18,44,65,-21,36
Admira Wacke,5746,8,9,8,19,35,64,-29,35
St. Pölten,5746,9,8,10,18,39,59,-20,34
Mattersburg,5746,10,8,9,19,36,58,-22,33
FC Salzburg,5747,1,19,9,8,59,27,32,66
SC Rheindorf,5747,2,19,9,8,50,33,17,66
Vienna,5747,3,17,8,11,56,49,7,59
SK Sturm Gra,5747,4,16,9,11,52,37,15,57
RZ Pellets W,5747,5,15,6,15,48,51,-3,51
St. Pölten,5747,6,12,8,16,45,60,-15,44
Rapid Vienna,5747,7,10,13,13,44,40,4,43
SV Josko Rie,5747,8,11,6,19,35,48,-13,39
Admira Wacke,5747,9,10,7,19,30,57,-27,37
Mattersburg,5747,10,9,9,18,33,50,-17,36
SC Rheindorf,5748,1,25,6,5,70,39,31,81
FC Salzburg,5748,2,22,5,9,68,33,35,71
Vienna,5748,3,19,4,13,61,47,14,61
SK Sturm Gra,5748,4,18,6,12,58,36,22,60
Rapid Vienna,5748,5,13,8,15,51,46,5,47
RZ Pellets W,5748,6,12,9,15,47,53,-6,45
Mattersburg,5748,7,12,7,17,41,51,-10,43
SV Josko Rie,5748,8,10,6,20,37,58,-21,36
Admira Wacke,5748,9,9,6,21,32,69,-37,33
St. Pölten,5748,10,7,9,20,38,71,-33,30
FC Salzburg,5749,1,20,10,6,64,31,33,70
Rapid Vienna,5749,2,20,8,8,66,35,31,68
SK Sturm Gra,5749,3,19,7,10,63,38,25,64
Vienna,5749,4,18,9,9,67,51,16,63
SC Rheindorf,5749,5,15,14,7,49,38,11,59
RZ Pellets W,5749,6,11,6,19,39,58,-19,39
Admira Wacke,5749,7,9,8,19,30,54,-24,35
SV Josko Rie,5749,8,9,7,20,31,60,-29,34
St. Pölten,5749,9,7,12,17,42,64,-22,33
Mattersburg,5749,10,6,11,19,33,55,-22,29
FC Salzburg,5750,1,24,6,6,76,34,42,78
SC Rheindorf,5750,2,20,9,7,69,47,22,69
SK Sturm Gra,5750,3,18,7,11,56,36,20,61
Vienna,5750,4,17,6,13,66,54,12,57
Rapid Vienna,5750,5,14,9,13,59,43,16,51
Admira Wacke,5750,6,12,8,16,43,62,-19,44
RZ Pellets W,5750,7,11,7,18,42,61,-19,40
SV Josko Rie,5750,8,10,8,18,30,46,-16,38
Mattersburg,5750,9,8,9,19,38,71,-33,33
St. Pölten,5750,10,7,9,20,37,62,-25,30
SC Rheindorf,5751,1,20,11,5,55,35,20,71
FC Salzburg,5751,2,18,9,9,61,29,32,63
SK Sturm Gra,5751,3,19,6,11,55,30,25,63
Rapid Vienna,5751,4,15,12,9,64,36,28,57
Vienna,5751,5,17,6,13,65,54,11,57
RZ Pellets W,5751,6,11,9,16,43,60,-17,42
Admira Wacke,5751,7,10,11,15,40,57,-17,41
Mattersburg,5751,8,9,9,18,35,54,-19,36
SV Josko Rie,5751,9,10,4,22,35,63,-28,34
St. Pölten,5751,10,8,9,19,39,74,-35,33
SK Sturm Gra,5752,1,21,7,8,58,28,30,70
Vienna,5752,2,20,5,11,71,48,23,65
FC Salzburg,5752,3,19,7,10,68,37,31,64
SC Rheindorf,5752,4,18,9,9,51,45,6,63
Rapid Vienna,5752,5,14,12,10,62,39,23,54
RZ Pellets W,5752,6,12,9,15,46,56,-10,45
Admira Wacke,5752,7,12,6,18,36,55,-19,42
SV Josko Rie,5752,8,9,7,20,29,56,-27,34
St. Pölten,5752,9,8,10,18,39,68,-29,34
Mattersburg,5752,10,6,10,20,39,67,-28,28
FC Salzburg,5753,1,19,10,7,58,32,26,67
SC Rheindorf,5753,2,20,7,9,52,38,14,67
Vienna,5753,3,19,6,11,70,52,18,63
SK Sturm Gra,5753,4,17,7,12,52,36,16,58
Rapid Vienna,5753,5,14,13,9,54,36,18,55
RZ Pellets W,5753,6,13,10,13,51,55,-4,49
Admira Wacke,5753,7,11,6,19,35,59,-24,39
Mattersburg,5753,8,9,10,17,43,58,-15,37
SV Josko Rie,5753,9,10,6,20,35,54,-19,36
St. Pölten,5753,10,6,9,21,36,66,-30,27
SC Rheindorf,5754,1,20,8,8,62,41,21,68
FC Salzburg,5754,2,20,6,10,59,28,31,66
SK Sturm Gra,5754,3,18,8,10,59,39,20,62
Vienna,5754,4,19,3,14,68,55,13,60
Rapid Vienna,5754,5,15,9,12,55,41,14,54
RZ Pellets W,5754,6,13,6,17,50,56,-6,45
Admira Wacke,5754,7,12,8,16,42,58,-16,44
SV Josko Rie,5754,8,10,9,17,40,56,-16,39
St. Pölten,5754,9,8,9,19,40,78,-38,33
Mattersburg,5754,10,6,12,18,35,58,-23,30
FC Salzburg,5755,1,22,9,5,70,28,42,75
Vienna,5755,2,19,6,11,62,48,14,63
SC Rheindorf,5755,3,17,9,10,54,42,12,60
SK Sturm Gra,5755,4,17,8,11,50,33,17,59
RZ Pellets W,5755,5,15,10,11,56,51,5,55
Rapid Vienna,5755,6,11,11,14,52,46,6,44
SV Josko Rie,5755,7,10,7,19,33,58,-25,37
Admira Wacke,5755,8,9,9,18,31,60,-29,36
St. Pölten,5755,9,8,10,18,41,65,-24,34
Mattersburg,5755,10,8,9,19,42,60,-18,33
FC Salzburg,5756,1,21,7,8,75,34,41,70
SC Rheindorf,5756,2,19,8,9,55,39,16,65
SK Sturm Gra,5756,3,16,8,12,52,40,12,56
Vienna,5756,4,16,8,12,57,58,-1,56
Rapid Vienna,5756,5,15,10,11,62,40,22,55
SV Josko Rie,5756,6,12,7,17,36,47,-11,43
Admira Wacke,5756,7,11,9,16,33,53,-20,42
RZ Pellets W,5756,8,11,8,17,42,58,-16,41
Mattersburg,5756,9,9,8,19,38,59,-21,35
St. Pölten,5756,10,7,13,16,41,63,-22,34
FC Salzburg,5757,1,21,7,8,64,31,33,70
SC Rheindorf,5757,2,20,7,9,52,41,11,67
Rapid Vienna,5757,3,16,9,11,61,37,24,57
SK Sturm Gra,5757,4,16,9,11,54,39,15,57
Vienna,5757,5,16,5,15,64,58,6,53
RZ Pellets W,5757,6,13,8,15,41,49,-8,47
Admira Wacke,5757,7,13,6,17,39,58,-19,45
SV Josko Rie,5757,8,13,5,18,41,53,-12,44
Mattersburg,5757,9,9,8,19,40,61,-21,35
St. Pölten,5757,10,7,8,21,40,69,-29,29
FC Salzburg,5758,1,21,6,9,62,29,33,69
SC Rheindorf,5758,2,18,9,9,54,44,10,63
Vienna,5758,3,19,5,12,61,44,17,62
SK Sturm Gra,5758,4,16,10,10,52,34,18,58
RZ Pellets W,5758,5,17,5,14,57,53,4,56
Rapid Vienna,5758,6,13,12,11,52,41,11,51
SV Josko Rie,5758,7,12,6,18,34,46,-12,42
Admira Wacke,5758,8,10,6,20,32,63,-31,36
St. Pölten,5758,9,8,11,17,37,58,-21,35
Mattersburg,5758,10,7,8,21,33,62,-29,29
FC Salzburg,5759,1,20,8,8,66,36,30,68
SC Rheindorf,5759,2,21,5,10,58,38,20,68
SK Sturm Gra,5759,3,20,6,10,64,36,28,66
Vienna,5759,4,18,5,13,55,50,5,59
RZ Pellets W,5759,5,15,6,15,46,49,-3,51
Rapid Vienna,5759,6,11,13,12,51,42,9,46
Admira Wacke,5759,7,10,8,18,36,61,-25,38
Mattersburg,5759,8,9,10,17,34,46,-12,37
St. Pölten,5759,9,8,12,16,39,60,-21,36
SV Josko Rie,5759,10,8,7,21,24,55,-31,31
FC Salzburg,5760,1,23,7,6,70,26,44,76
SC Rheindorf,5760,2,20,8,8,59,39,20,68
SK Sturm Gra,5760,3,17,6,13,56,39,17,57
Rapid Vienna,5760,4,13,13,10,56,42,14,52
Vienna,5760,5,15,7,14,57,56,1,52
RZ Pellets W,5760,6,14,8,14,50,52,-2,50
SV Josko Rie,5760,7,12,7,17,38,52,-14,43
St. Pölten,5760,8,8,10,18,39,63,-24,34
Admira Wacke,5760,9,9,7,20,35,63,-28,34
Mattersburg,5760,10,8,9,19,34,62,-28,33
SC Rheindorf,5761,1,22,5,9,55,37,18,71
FC Salzburg,5761,2,20,9,7,59,26,33,69
SK Sturm Gra,5761,3,17,6,13,52,32,20,57
Vienna,5761,4,16,6,14,54,50,4,54
Rapid Vienna,5761,5,13,14,9,57,39,18,53
RZ Pellets W,5761,6,15,6,15,44,53,-9,51
Admira Wacke,5761,7,15,6,15,43,58,-15,51
SV Josko Rie,5761,8,11,7,18,39,53,-14,40
Mattersburg,5761,9,8,8,20,37,56,-19,32
St. Pölten,5761,10,5,9,22,36,72,-36,24
FC Salzburg,5762,1,22,7,7,69,33,36,73
SC Rheindorf,5762,2,19,7,10,57,41,16,64
SK Sturm Gra,5762,3,19,6,11,66,40,26,63
Vienna,5762,4,18,6,12,60,46,14,60
Rapid Vienna,5762,5,12,12,12,52,43,9,48
RZ Pellets W,5762,6,14,6,16,48,54,-6,48
Admira Wacke,5762,7,14,6,16,42,58,-16,48
St. Pölten,5762,8,8,11,17,42,72,-30,35
SV Josko Rie,5762,9,9,6,21,32,58,-26,33
Mattersburg,5762,10,7,9,20,36,59,-23,30
SC Rheindorf,5763,1,21,10,5,62,38,24,73
FC Salzburg,5763,2,19,8,9,64,33,31,65
SK Sturm Gra,5763,3,20,5,11,59,40,19,65
Vienna,5763,4,15,5,16,59,57,2,50
Rapid Vienna,5763,5,11,12,13,52,46,6,45
RZ Pellets W,5763,6,13,5,18,52,61,-9,44
St. Pölten,5763,7,12,8,16,51,66,-15,44
SV Josko Rie,5763,8,13,5,18,35,51,-16,44
Admira Wacke,5763,9,11,7,18,40,58,-18,40
Mattersburg,5763,10,9,7,20,36,60,-24,34
FC Salzburg,5764,1,21,8,7,66,29,37,71
SK Sturm Gra,5764,2,20,6,10,58,27,31,66
SC Rheindorf,5764,3,19,7,10,51,46,5,64
Vienna,5764,4,18,7,11,62,47,15,61
Rapid Vienna,5764,5,14,8,14,53,46,7,50
RZ Pellets W,5764,6,12,9,15,47,52,-5,45
St. Pölten,5764,7,11,9,16,42,59,-17,42
Admira Wacke,5764,8,12,5,19,35,61,-26,41
SV Josko Rie,5764,9,8,8,20,33,54,-21,32
Mattersburg,5764,10,8,7,21,39,65,-26,31
SC Rheindorf,5765,1,19,11,6,45,31,14,68
FC Salzburg,5765,2,18,7,11,62,41,21,61
Vienna,5765,3,17,9,10,57,47,10,60
SK Sturm Gra,5765,4,16,8,12,58,36,22,56
Rapid Vienna,5765,5,14,12,10,60,40,20,54
SV Josko Rie,5765,6,14,5,17,37,52,-15,47
RZ Pellets W,5765,7,11,11,14,45,53,-8,44
Mattersburg,5765,8,9,10,17,32,49,-17,37
St. Pölten,5765,9,7,12,17,39,58,-19,33
Admira Wacke,5765,10,8,9,19,33,61,-28,33
FC Salzburg,5766,1,22,8,6,70,27,43,74
SK Sturm Gra,5766,2,20,8,8,67,33,34,68
SC Rheindorf,5766,3,18,7,11,49,47,2,61
Vienna,5766,4,16,7,13,64,57,7,55
Rapid Vienna,5766,5,13,12,11,55,45,10,51
Admira Wacke,5766,6,13,9,14,45,55,-10,48
Mattersburg,5766,7,9,12,15,36,50,-14,39
RZ Pellets W,5766,8,9,8,19,39,58,-19,35
St. Pölten,5766,9,6,13,17,38,60,-22,31
SV Josko Rie,5766,10,7,10,19,33,64,-31,31
SC Rheindorf,5767,1,21,8,7,63,37,26,71
FC Salzburg,5767,2,19,8,9,63,31,32,65
Vienna,5767,3,18,7,11,61,50,11,61
SK Sturm Gra,5767,4,16,9,11,50,32,18,57
RZ Pellets W,5767,5,14,9,13,46,50,-4,51
Rapid Vienna,5767,6,12,13,11,51,42,9,49
St. Pölten,5767,7,10,10,16,40,63,-23,40
Mattersburg,5767,8,8,10,18,38,55,-17,34
Admira Wacke,5767,9,8,10,18,30,54,-24,34
SV Josko Rie,5767,10,9,6,21,32,60,-28,33
SC Rheindorf,5768,1,22,8,6,53,33,20,74
FC Salzburg,5768,2,22,7,7,68,32,36,73
SK Sturm Gra,5768,3,18,5,13,64,38,26,59
Vienna,5768,4,17,5,14,56,56,0,56
Rapid Vienna,5768,5,13,10,13,51,40,11,49
RZ Pellets W,5768,6,13,7,16,53,54,-1,46
Mattersburg,5768,7,10,10,16,40,54,-14,40
Admira Wacke,5768,8,9,9,18,34,55,-21,36
St. Pölten,5768,9,8,11,17,39,71,-32,35
SV Josko Rie,5768,10,8,8,20,29,54,-25,32
Vienna,5769,1,23,3,10,69,49,20,72
FC Salzburg,5769,2,19,11,6,65,29,36,68
SK Sturm Gra,5769,3,20,5,11,66,38,28,65
Rapid Vienna,5769,4,15,14,7,60,40,20,59
SC Rheindorf,5769,5,17,6,13,49,44,5,57
SV Josko Rie,5769,6,12,6,18,36,50,-14,42
RZ Pellets W,5769,7,10,10,16,45,56,-11,40
Admira Wacke,5769,8,10,7,19,38,63,-25,37
Mattersburg,5769,9,9,6,21,37,63,-26,33
St. Pölten,5769,10,6,10,20,37,70,-33,28
FC Salzburg,5770,1,20,9,7,69,31,38,69
SC Rheindorf,5770,2,19,10,7,58,40,18,67
SK Sturm Gra,5770,3,18,7,11,54,30,24,61
Vienna,5770,4,18,7,11,63,52,11,61
Rapid Vienna,5770,5,16,8,12,60,40,20,56
RZ Pellets W,5770,6,13,5,18,40,50,-10,44
SV Josko Rie,5770,7,10,10,16,34,54,-20,40
St. Pölten,5770,8,8,12,16,40,65,-25,36
Admira Wacke,5770,9,10,6,20,31,61,-30,36
Mattersburg,5770,10,6,10,20,32,58,-26,28
SK Sturm Gra,5771,1,21,5,10,67,34,33,68
FC Salzburg,5771,2,20,6,10,58,30,28,66
SC Rheindorf,5771,3,19,8,9,59,43,16,65
Vienna,5771,4,18,5,13,66,55,11,59
Rapid Vienna,5771,5,12,9,15,58,52,6,45
RZ Pellets W,5771,6,13,6,17,47,64,-17,45
Admira Wacke,5771,7,13,4,19,45,67,-22,43
SV Josko Rie,5771,8,12,6,18,36,55,-19,42
Mattersburg,5771,9,10,8,18,41,56,-15,38
St. Pölten,5771,10,10,7,19,44,65,-21,37
FC Salzburg,5772,1,22,6,8,68,30,38,72
Vienna,5772,2,19,6,11,66,51,15,63
SC Rheindorf,5772,3,18,8,10,63,52,11,62
SK Sturm Gra,5772,4,18,6,12,59,41,18,60
Rapid Vienna,5772,5,12,12,12,56,44,12,48
RZ Pellets W,5772,6,14,6,16,48,57,-9,48
Admira Wacke,5772,7,13,6,17,37,53,-16,45
St. Pölten,5772,8,9,10,17,40,60,-20,37
SV Josko Rie,5772,9,10,5,21,35,61,-26,35
Mattersburg,5772,10,7,11,18,33,56,-23,32
FC Salzburg,5773,1,23,6,7,67,32,35,75
SC Rheindorf,5773,2,20,7,9,58,43,15,67
Vienna,5773,3,19,4,13,69,57,12,61
SK Sturm Gra,5773,4,17,8,11,57,33,24,59
Rapid Vienna,5773,5,12,13,11,47,34,13,49
St. Pölten,5773,6,13,7,16,43,56,-13,46
Admira Wacke,5773,7,12,7,17,33,56,-23,43
RZ Pellets W,5773,8,11,8,17,39,53,-14,41
SV Josko Rie,5773,9,11,3,22,36,57,-21,36
Mattersburg,5773,10,6,9,21,32,60,-28,27
FC Salzburg,5774,1,20,8,8,64,34,30,68
SC Rheindorf,5774,2,19,8,9,52,35,17,65
SK Sturm Gra,5774,3,18,6,12,54,34,20,60
Vienna,5774,4,19,3,14,64,53,11,60
RZ Pellets W,5774,5,16,8,12,58,49,9,56
SV Josko Rie,5774,6,13,4,19,34,56,-22,43
St. Pölten,5774,7,10,11,15,44,58,-14,41
Admira Wacke,5774,8,12,4,20,35,59,-24,40
Rapid Vienna,5774,9,8,12,16,45,47,-2,36
Mattersburg,5774,10,9,8,19,36,61,-25,35
FC Salzburg,5775,1,22,5,9,65,28,37,71
SC Rheindorf,5775,2,20,10,6,54,36,18,70
SK Sturm Gra,5775,3,18,7,11,61,40,21,61
Vienna,5775,4,18,6,12,70,56,14,60
Rapid Vienna,5775,5,15,11,10,58,37,21,56
RZ Pellets W,5775,6,12,8,16,43,54,-11,44
SV Josko Rie,5775,7,10,7,19,37,50,-13,37
Admira Wacke,5775,8,9,8,19,35,66,-31,35
St. Pölten,5775,9,8,10,18,39,64,-25,34
Mattersburg,5775,10,9,6,21,33,64,-31,33
SK Sturm Gra,5776,1,22,3,11,62,34,28,69
SC Rheindorf,5776,2,19,9,8,54,39,15,66
FC Salzburg,5776,3,17,9,10,59,34,25,60
Vienna,5776,4,18,6,12,62,49,13,60
Rapid Vienna,5776,5,16,9,11,62,43,19,57
RZ Pellets W,5776,6,15,7,14,51,51,0,52
St. Pölten,5776,7,11,8,17,41,62,-21,41
Admira Wacke,5776,8,10,6,20,39,71,-32,36
Mattersburg,5776,9,8,8,20,36,58,-22,32
SV Josko Rie,5776,10,8,7,21,28,53,-25,31
FC Salzburg,5777,1,24,7,5,71,30,41,79
SK Sturm Gra,5777,2,22,5,9,63,34,29,71
SC Rheindorf,5777,3,19,7,10,57,42,15,64
Vienna,5777,4,18,3,15,57,56,1,57
RZ Pellets W,5777,5,13,10,13,50,58,-8,49
Rapid Vienna,5777,6,12,11,13,57,46,11,47
SV Josko Rie,5777,7,9,9,18,35,54,-19,36
Mattersburg,5777,8,8,10,18,41,61,-20,34
Admira Wacke,5777,9,9,7,20,35,63,-28,34
St. Pölten,5777,10,7,9,20,46,68,-22,30
FC Salzburg,5778,1,20,8,8,64,37,27,68
SK Sturm Gra,5778,2,19,9,8,60,35,25,66
SC Rheindorf,5778,3,20,6,10,60,40,20,66
Vienna,5778,4,18,4,14,61,55,6,58
Rapid Vienna,5778,5,15,9,12,52,40,12,54
RZ Pellets W,5778,6,11,11,14,45,53,-8,44
Admira Wacke,5778,7,12,7,17,43,58,-15,43
Mattersburg,5778,8,11,7,18,43,59,-16,40
SV Josko Rie,5778,9,9,6,21,32,56,-24,33
St. Pölten,5778,10,7,9,20,35,62,-27,30
SC Rheindorf,5779,1,21,6,9,63,39,24,69
Vienna,5779,2,21,6,9,68,47,21,69
FC Salzburg,5779,3,19,11,6,57,28,29,68
SK Sturm Gra,5779,4,16,7,13,53,39,14,55
Admira Wacke,5779,5,13,7,16,34,53,-19,46
Rapid Vienna,5779,6,11,12,13,47,38,9,45
RZ Pellets W,5779,7,11,9,16,43,54,-11,42
St. Pölten,5779,8,10,8,18,44,62,-18,38
Mattersburg,5779,9,9,8,19,38,59,-21,35
SV Josko Rie,5779,10,9,6,21,34,62,-28,33
FC Salzburg,5780,1,20,7,9,61,30,31,67
SC Rheindorf,5780,2,20,6,10,58,42,16,66
SK Sturm Gra,5780,3,20,4,12,59,41,18,64
Vienna,5780,4,19,5,12,58,48,10,62
Rapid Vienna,5780,5,14,10,12,58,42,16,52
Admira Wacke,5780,6,14,7,15,40,49,-9,49
RZ Pellets W,5780,7,13,5,18,46,60,-14,44
Mattersburg,5780,8,11,7,18,34,52,-18,40
SV Josko Rie,5780,9,9,8,19,27,46,-19,35
St. Pölten,5780,10,6,9,21,34,65,-31,27
SC Rheindorf,5781,1,22,6,8,65,52,13,72
SK Sturm Gra,5781,2,20,6,10,62,37,25,66
FC Salzburg,5781,3,19,9,8,58,33,25,66
Vienna,5781,4,18,6,12,71,54,17,60
Rapid Vienna,5781,5,14,13,9,70,50,20,55
Admira Wacke,5781,6,12,7,17,41,56,-15,43
RZ Pellets W,5781,7,11,6,19,44,67,-23,39
SV Josko Rie,5781,8,10,6,20,37,55,-18,36
St. Pölten,5781,9,8,10,18,43,64,-21,34
Mattersburg,5781,10,5,13,18,36,59,-23,28
FC Salzburg,5782,1,22,8,6,66,32,34,74
SK Sturm Gra,5782,2,20,7,9,57,29,28,67
SC Rheindorf,5782,3,20,6,10,54,37,17,66
Vienna,5782,4,18,6,12,57,50,7,60
Rapid Vienna,5782,5,13,10,13,51,42,9,49
RZ Pellets W,5782,6,12,8,16,46,51,-5,44
St. Pölten,5782,7,8,12,16,43,61,-18,36
Mattersburg,5782,8,10,6,20,36,60,-24,36
SV Josko Rie,5782,9,9,8,19,34,53,-19,35
Admira Wacke,5782,10,10,5,21,35,64,-29,35
FC Salzburg,5783,1,20,9,7,60,28,32,69
SC Rheindorf,5783,2,19,10,7,58,37,21,67
Vienna,5783,3,19,6,11,66,58,8,63
SK Sturm Gra,5783,4,18,8,10,60,37,23,62
Rapid Vienna,5783,5,13,9,14,57,49,8,48
RZ Pellets W,5783,6,13,9,14,47,54,-7,48
Admira Wacke,5783,7,13,4,19,42,64,-22,43
SV Josko Rie,5783,8,12,6,18,43,56,-13,42
St. Pölten,5783,9,7,10,19,44,67,-23,31
Mattersburg,5783,10,5,11,20,38,65,-27,26
SK Sturm Gra,5784,1,22,4,10,61,28,33,70
Vienna,5784,2,21,6,9,68,46,22,69
FC Salzburg,5784,3,21,5,10,58,33,25,68
SC Rheindorf,5784,4,19,6,11,56,44,12,63
Rapid Vienna,5784,5,13,9,14,56,44,12,48
RZ Pellets W,5784,6,13,6,17,45,55,-10,45
St. Pölten,5784,7,10,9,17,41,56,-15,39
SV Josko Rie,5784,8,11,5,20,33,52,-19,38
Admira Wacke,5784,9,10,8,18,32,61,-29,38
Mattersburg,5784,10,7,8,21,35,66,-31,29
SC Rheindorf,5785,1,22,6,8,62,33,29,72
SK Sturm Gra,5785,2,20,6,10,61,35,26,66
FC Salzburg,5785,3,18,11,7,62,30,32,65
Rapid Vienna,5785,4,13,12,11,54,40,14,51
Vienna,5785,5,14,9,13,56,56,0,51
RZ Pellets W,5785,6,13,7,16,48,53,-5,46
St. Pölten,5785,7,11,12,13,42,54,-12,45
Admira Wacke,5785,8,11,7,18,38,66,-28,40
SV Josko Rie,5785,9,10,8,18,34,50,-16,38
Mattersburg,5785,10,6,6,24,28,68,-40,24
SC Rheindorf,5786,1,20,9,7,53,36,17,69
FC Salzburg,5786,2,20,8,8,66,34,32,68
Rapid Vienna,5786,3,16,11,9,62,39,23,59
SK Sturm Gra,5786,4,17,7,12,54,37,17,58
Vienna,5786,5,17,6,13,66,57,9,57
RZ Pellets W,5786,6,12,8,16,45,54,-9,44
Admira Wacke,5786,7,12,7,17,38,58,-20,43
SV Josko Rie,5786,8,11,5,20,31,52,-21,38
St. Pölten,5786,9,9,9,18,46,67,-21,36
Mattersburg,5786,10,6,10,20,29,56,-27,28
FC Salzburg,5787,1,21,9,6,65,33,32,72
SK Sturm Gra,5787,2,20,5,11,60,42,18,65
Vienna,5787,3,19,6,11,66,50,16,63
SC Rheindorf,5787,4,18,8,10,55,48,7,62
Rapid Vienna,5787,5,17,9,10,62,38,24,60
RZ Pellets W,5787,6,11,7,18,40,55,-15,40
St. Pölten,5787,7,9,10,17,40,63,-23,37
Admira Wacke,5787,8,9,9,18,39,55,-16,36
Mattersburg,5787,9,9,9,18,38,58,-20,36
SV Josko Rie,5787,10,8,6,22,28,51,-23,30
SC Rheindorf,5788,1,26,5,5,71,37,34,83
SK Sturm Gra,5788,2,19,7,10,60,33,27,64
FC Salzburg,5788,3,18,8,10,65,37,28,62
Vienna,5788,4,19,2,15,67,60,7,59
Rapid Vienna,5788,5,15,12,9,58,40,18,57
RZ Pellets W,5788,6,13,9,14,52,54,-2,48
Admira Wacke,5788,7,11,7,18,42,71,-29,40
Mattersburg,5788,8,8,7,21,38,60,-22,31
SV Josko Rie,5788,9,9,4,23,27,56,-29,31
St. Pölten,5788,10,7,9,20,35,67,-32,30
SK Sturm Gra,5789,1,20,8,8,57,33,24,68
SC Rheindorf,5789,2,18,8,10,56,49,7,62
FC Salzburg,5789,3,18,7,11,65,40,25,61
Vienna,5789,4,17,7,12,68,57,11,58
Rapid Vienna,5789,5,14,12,10,51,34,17,54
RZ Pellets W,5789,6,14,4,18,47,57,-10,46
Admira Wacke,5789,7,13,5,18,45,64,-19,44
SV Josko Rie,5789,8,12,6,18,41,52,-11,42
Mattersburg,5789,9,9,8,19,35,55,-20,35
St. Pölten,5789,10,7,11,18,38,62,-24,32
FC Salzburg,5790,1,20,8,8,63,31,32,68
SC Rheindorf,5790,2,19,9,8,62,42,20,66
SK Sturm Gra,5790,3,19,7,10,62,36,26,64
Vienna,5790,4,19,7,10,59,47,12,64
Rapid Vienna,5790,5,16,9,11,59,37,22,57
Admira Wacke,5790,6,12,7,17,36,59,-23,43
St. Pölten,5790,7,11,8,17,46,66,-20,41
RZ Pellets W,5790,8,11,6,19,46,63,-17,39
Mattersburg,5790,9,7,10,19,43,63,-20,31
SV Josko Rie,5790,10,9,3,24,34,66,-32,30
FC Salzburg,5791,1,20,8,8,69,34,35,68
SK Sturm Gra,5791,2,20,8,8,58,27,31,68
SC Rheindorf,5791,3,20,6,10,55,41,14,66
Vienna,5791,4,18,5,13,70,59,11,59
Rapid Vienna,5791,5,13,11,12,52,39,13,50
RZ Pellets W,5791,6,12,10,14,49,57,-8,46
Admira Wacke,5791,7,11,6,19,40,65,-25,39
Mattersburg,5791,8,10,7,19,42,62,-20,37
St. Pölten,5791,9,9,8,19,46,71,-25,35
SV Josko Rie,5791,10,10,5,21,37,63,-26,35
SK Sturm Gra,5792,1,21,7,8,73,41,32,70
FC Salzburg,5792,2,17,10,9,56,28,28,61
Vienna,5792,3,17,10,9,60,48,12,61
Rapid Vienna,5792,4,16,12,8,62,42,20,60
SC Rheindorf,5792,5,16,7,13,49,46,3,55
Mattersburg,5792,6,11,9,16,44,53,-9,42
RZ Pellets W,5792,7,10,9,17,48,63,-15,39
SV Josko Rie,5792,8,10,8,18,37,53,-16,38
Admira Wacke,5792,9,10,7,19,31,57,-26,37
St. Pölten,5792,10,8,9,19,43,72,-29,33
FC Salzburg,5793,1,23,6,7,68,30,38,75
SC Rheindorf,5793,2,21,8,7,59,38,21,71
Vienna,5793,3,21,6,9,64,43,21,69
SK Sturm Gra,5793,4,20,4,12,55,31,24,64
Rapid Vienna,5793,5,17,10,9,58,37,21,61
RZ Pellets W,5793,6,11,9,16,46,59,-13,42
Admira Wacke,5793,7,9,8,19,37,70,-33,35
SV Josko Rie,5793,8,10,4,22,33,54,-21,34
St. Pölten,5793,9,9,7,20,40,67,-27,34
Mattersburg,5793,10,5,6,25,33,64,-31,21
SC Rheindorf,5794,1,22,7,7,64,45,19,73
Vienna,5794,2,19,6,11,70,60,10,63
FC Salzburg,5794,3,18,8,10,61,37,24,62
SK Sturm Gra,5794,4,19,5,12,65,42,23,62
Rapid Vienna,5794,5,17,10,9,65,39,26,61
RZ Pellets W,5794,6,11,8,17,42,55,-13,41
Admira Wacke,5794,7,10,9,17,39,61,-22,39
SV Josko Rie,5794,8,10,5,21,38,58,-20,35
St. Pölten,5794,9,9,8,19,37,61,-24,35
Mattersburg,5794,10,7,10,19,34,57,-23,31
FC Salzburg,5795,1,24,6,6,70,27,43,78
SK Sturm Gra,5795,2,22,6,8,65,34,31,72
SC Rheindorf,5795,3,18,8,10,55,45,10,62
Rapid Vienna,5795,4,14,9,13,58,45,13,51
Vienna,5795,5,15,6,15,53,54,-1,51
Admira Wacke,5795,6,14,8,14,45,55,-10,50
RZ Pellets W,5795,7,11,8,17,45,61,-16,41
SV Josko Rie,5795,8,9,6,21,26,54,-28,33
St. Pölten,5795,9,6,14,16,41,62,-21,32
Mattersburg,5795,10,7,9,20,37,58,-21,30
FC Salzburg,5796,1,21,6,9,67,36,31,69
SC Rheindorf,5796,2,21,6,9,50,37,13,69
Vienna,5796,3,20,5,11,60,44,16,65
SK Sturm Gra,5796,4,16,11,9,51,31,20,59
Rapid Vienna,5796,5,13,13,10,54,38,16,52
Mattersburg,5796,6,12,7,17,41,50,-9,43
Admira Wacke,5796,7,10,10,16,37,52,-15,40
RZ Pellets W,5796,8,10,7,19,38,60,-22,37
St. Pölten,5796,9,9,8,19,39,65,-26,35
SV Josko Rie,5796,10,9,5,22,30,54,-24,32
FC Salzburg,5797,1,22,6,8,69,25,44,72
SK Sturm Gra,5797,2,21,5,10,64,33,31,68
SC Rheindorf,5797,3,18,7,11,53,43,10,61
Vienna,5797,4,17,6,13,62,50,12,57
RZ Pellets W,5797,5,13,8,15,47,62,-15,47
Rapid Vienna,5797,6,11,12,13,49,46,3,45
SV Josko Rie,5797,7,11,7,18,39,54,-15,40
Mattersburg,5797,8,11,7,18,38,54,-16,40
Admira Wacke,5797,9,10,7,19,40,65,-25,37
St. Pölten,5797,10,7,13,16,40,69,-29,34
SK Sturm Gra,5798,1,22,6,8,67,29,38,72
FC Salzburg,5798,2,20,9,7,65,32,33,69
SC Rheindorf,5798,3,18,10,8,58,39,19,64
Vienna,5798,4,17,6,13,59,52,7,57
Rapid Vienna,5798,5,14,12,10,58,37,21,54
RZ Pellets W,5798,6,12,8,16,46,58,-12,44
Admira Wacke,5798,7,12,3,21,39,74,-35,39
Mattersburg,5798,8,9,8,19,36,59,-23,35
St. Pölten,5798,9,8,10,18,41,67,-26,34
SV Josko Rie,5798,10,9,6,21,35,57,-22,33
SK Sturm Gra,5799,1,21,5,10,53,31,22,68
FC Salzburg,5799,2,19,8,9,62,34,28,65
Vienna,5799,3,19,5,12,69,56,13,62
Rapid Vienna,5799,4,14,11,11,68,46,22,53
SC Rheindorf,5799,5,14,9,13,43,47,-4,51
RZ Pellets W,5799,6,14,7,15,47,51,-4,49
Mattersburg,5799,7,11,10,15,45,52,-7,43
SV Josko Rie,5799,8,11,6,19,34,50,-16,39
St. Pölten,5799,9,9,9,18,40,64,-24,36
Admira Wacke,5799,10,10,6,20,36,66,-30,36
FC Salzburg,5800,1,21,7,8,79,40,39,70
SK Sturm Gra,5800,2,22,4,10,63,29,34,70
Vienna,5800,3,17,5,14,61,57,4,56
SC Rheindorf,5800,4,14,13,9,45,42,3,55
RZ Pellets W,5800,5,13,8,15,47,55,-8,47
Rapid Vienna,5800,6,10,13,13,51,44,7,43
Mattersburg,5800,7,12,7,17,41,54,-13,43
Admira Wacke,5800,8,12,7,17,38,58,-20,43
SV Josko Rie,5800,9,12,3,21,40,60,-20,39
St. Pölten,5800,10,9,9,18,45,71,-26,36
SK Sturm Gra,5801,1,22,4,10,63,33,30,70
FC Salzburg,5801,2,20,8,8,62,26,36,68
SC Rheindorf,5801,3,19,7,10,61,44,17,64
Vienna,5801,4,18,3,15,63,52,11,57
Rapid Vienna,5801,5,15,9,12,56,39,17,54
RZ Pellets W,5801,6,12,7,17,47,62,-15,43
Mattersburg,5801,7,11,8,17,39,53,-14,41
St. Pölten,5801,8,11,6,19,38,62,-24,39
Admira Wacke,5801,9,12,3,21,35,66,-31,39
SV Josko Rie,5801,10,10,5,21,34,61,-27,35
FC Salzburg,5802,1,20,9,7,67,26,41,69
SC Rheindorf,5802,2,18,9,9,60,50,10,63
SK Sturm Gra,5802,3,17,8,11,61,38,23,59
Vienna,5802,4,17,6,13,57,49,8,57
Rapid Vienna,5802,5,16,8,12,61,41,20,56
Admira Wacke,5802,6,15,5,16,43,52,-9,50
RZ Pellets W,5802,7,11,9,16,44,61,-17,42
Mattersburg,5802,8,11,6,19,41,60,-19,39
SV Josko Rie,5802,9,10,5,21,34,63,-29,35
St. Pölten,5802,10,8,9,19,41,69,-28,33
FC Salzburg,5803,1,26,4,6,75,22,53,82
SK Sturm Gra,5803,2,18,7,11,56,39,17,61
SC Rheindorf,5803,3,17,10,9,47,43,4,61
Rapid Vienna,5803,4,15,12,9,56,41,15,57
Vienna,5803,5,16,5,15,58,51,7,53
RZ Pellets W,5803,6,12,7,17,47,58,-11,43
Admira Wacke,5803,7,11,7,18,40,61,-21,40
SV Josko Rie,5803,8,10,7,19,32,53,-21,37
St. Pölten,5803,9,8,11,17,39,61,-22,35
Mattersburg,5803,10,8,8,20,35,56,-21,32
FC Salzburg,5804,1,21,7,8,63,32,31,70
SC Rheindorf,5804,2,20,6,10,58,42,16,66
SK Sturm Gra,5804,3,20,4,12,61,36,25,64
Vienna,5804,4,20,2,14,59,51,8,62
Rapid Vienna,5804,5,17,9,10,61,40,21,60
SV Josko Rie,5804,6,14,5,17,41,50,-9,47
RZ Pellets W,5804,7,12,6,18,35,48,-13,42
Admira Wacke,5804,8,12,5,19,36,57,-21,41
St. Pölten,5804,9,8,8,20,40,73,-33,32
Mattersburg,5804,10,7,6,23,33,58,-25,27
SC Rheindorf,5805,1,21,6,9,65,42,23,69
FC Salzburg,5805,2,20,8,8,65,36,29,68
SK Sturm Gra,5805,3,20,5,11,63,33,30,65
Vienna,5805,4,19,5,12,66,58,8,62
Rapid Vienna,5805,5,11,13,12,51,41,10,46
St. Pölten,5805,6,12,7,17,49,63,-14,43
RZ Pellets W,5805,7,11,8,17,42,57,-15,41
SV Josko Rie,5805,8,11,5,20,33,55,-22,38
Admira Wacke,5805,9,11,5,20,33,63,-30,38
Mattersburg,5805,10,8,10,18,32,51,-19,34
FC Salzburg,5806,1,22,7,7,69,35,34,73
Vienna,5806,2,20,3,13,62,42,20,63
SK Sturm Gra,5806,3,18,6,12,56,36,20,60
SC Rheindorf,5806,4,16,12,8,53,47,6,60
Rapid Vienna,5806,5,15,10,11,57,39,18,55
Admira Wacke,5806,6,12,9,15,37,53,-16,45
Mattersburg,5806,7,11,9,16,43,50,-7,42
RZ Pellets W,5806,8,10,9,17,38,61,-23,39
SV Josko Rie,5806,9,9,5,22,33,58,-25,32
St. Pölten,5806,10,8,8,20,39,66,-27,32
SC Rheindorf,5807,1,20,10,6,56,37,19,70
FC Salzburg,5807,2,20,7,9,63,32,31,67
SK Sturm Gra,5807,3,19,7,10,51,30,21,64
Vienna,5807,4,18,5,13,60,51,9,59
Rapid Vienna,5807,5,14,12,10,59,36,23,54
RZ Pellets W,5807,6,11,9,16,40,53,-13,42
SV Josko Rie,5807,7,10,7,19,31,55,-24,37
Admira Wacke,5807,8,10,7,19,37,62,-25,37
St. Pölten,5807,9,9,9,18,43,60,-17,36
Mattersburg,5807,10,8,9,19,35,59,-24,33
FC Salzburg,5808,1,22,7,7,64,32,32,73
SC Rheindorf,5808,2,20,8,8,61,41,20,68
SK Sturm Gra,5808,3,17,10,9,58,37,21,61
Vienna,5808,4,16,6,14,61,62,-1,54
Rapid Vienna,5808,5,12,10,14,53,45,8,46
Admira Wacke,5808,6,13,5,18,43,58,-15,44
St. Pölten,5808,7,10,11,15,43,58,-15,41
RZ Pellets W,5808,8,11,7,18,47,58,-11,40
SV Josko Rie,5808,9,11,6,19,36,56,-20,39
Mattersburg,5808,10,8,10,18,35,54,-19,34
FC Salzburg,5809,1,22,7,7,71,30,41,73
SC Rheindorf,5809,2,21,8,7,55,36,19,71
SK Sturm Gra,5809,3,19,6,11,58,33,25,63
Vienna,5809,4,17,6,13,62,51,11,57
Rapid Vienna,5809,5,15,10,11,55,38,17,55
Admira Wacke,5809,6,14,4,18,44,63,-19,46
RZ Pellets W,5809,7,12,6,18,48,62,-14,42
SV Josko Rie,5809,8,10,5,21,35,61,-26,35
Mattersburg,5809,9,8,8,20,34,56,-22,32
St. Pölten,5809,10,7,10,19,35,67,-32,31
SC Rheindorf,5810,1,24,7,5,64,34,30,79
SK Sturm Gra,5810,2,22,5,9,67,35,32,71
FC Salzburg,5810,3,19,7,10,56,34,22,64
Vienna,5810,4,19,4,13,66,52,14,61
RZ Pellets W,5810,5,16,6,14,54,51,3,54
Rapid Vienna,5810,6,13,8,15,47,42,5,47
SV Josko Rie,5810,7,13,3,20,36,56,-20,42
Admira Wacke,5810,8,10,6,20,36,64,-28,36
Mattersburg,5810,9,9,6,21,37,61,-24,33
St. Pölten,5810,10,4,10,22,36,70,-34,22
SC Rheindorf,5811,1,21,9,6,56,35,21,72
FC Salzburg,5811,2,21,8,7,67,30,37,71
Vienna,5811,3,21,6,9,69,42,27,69
SK Sturm Gra,5811,4,19,6,11,58,39,19,63
RZ Pellets W,5811,5,15,8,13,54,55,-1,53
Rapid Vienna,5811,6,12,10,14,48,40,8,46
SV Josko Rie,5811,7,10,6,20,33,54,-21,36
Mattersburg,5811,8,10,6,20,31,57,-26,36
Admira Wacke,5811,9,9,7,20,32,60,-28,34
St. Pölten,5811,10,4,10,22,34,70,-36,22
FC Salzburg,5812,1,19,10,7,68,32,36,67
Vienna,5812,2,20,4,12,62,52,10,64
SC Rheindorf,5812,3,17,11,8,52,40,12,62
Rapid Vienna,5812,4,15,11,10,58,41,17,56
SK Sturm Gra,5812,5,15,11,10,50,33,17,56
RZ Pellets W,5812,6,11,11,14,41,49,-8,44
Mattersburg,5812,7,11,8,17,45,59,-14,41
SV Josko Rie,5812,8,10,8,18,35,51,-16,38
Admira Wacke,5812,9,9,7,20,32,62,-30,34
St. Pölten,5812,10,8,9,19,43,67,-24,33
FC Salzburg,5813,1,24,4,8,70,31,39,76
SK Sturm Gra,5813,2,23,4,9,70,33,37,73
Vienna,5813,3,21,2,13,65,48,17,65
SC Rheindorf,5813,4,18,7,11,46,42,4,61
Rapid Vienna,5813,5,14,10,12,60,46,14,52
Admira Wacke,5813,6,12,4,20,39,60,-21,40
RZ Pellets W,5813,7,11,6,19,43,60,-17,39
St. Pölten,5813,8,9,10,17,39,60,-21,37
Mattersburg,5813,9,9,8,19,35,55,-20,35
SV Josko Rie,5813,10,10,3,23,35,67,-32,33
SC Rheindorf,5814,1,22,5,9,70,37,33,71
FC Salzburg,5814,2,21,5,10,67,37,30,68
SK Sturm Gra,5814,3,19,5,12,60,36,24,62
Vienna,5814,4,18,7,11,65,59,6,61
Rapid Vienna,5814,5,17,9,10,64,43,21,60
RZ Pellets W,5814,6,13,8,15,47,55,-8,47
St. Pölten,5814,7,10,7,19,40,68,-28,37
Admira Wacke,5814,8,10,6,20,37,67,-30,36
SV Josko Rie,5814,9,9,6,21,32,61,-29,33
Mattersburg,5814,10,8,8,20,39,58,-19,32
FC Salzburg,5815,1,20,8,8,58,32,26,68
SC Rheindorf,5815,2,20,7,9,56,43,13,67
SK Sturm Gra,5815,3,20,5,11,63,35,28,65
Vienna,5815,4,20,4,12,66,48,18,64
Rapid Vienna,5815,5,13,10,13,53,44,9,49
Admira Wacke,5815,6,11,9,16,38,56,-18,42
Mattersburg,5815,7,10,9,17,38,54,-16,39
RZ Pellets W,5815,8,10,8,18,46,59,-13,38
St. Pölten,5815,9,10,8,18,45,66,-21,38
SV Josko Rie,5815,10,10,4,22,28,54,-26,34
FC Salzburg,5816,1,19,11,6,61,28,33,68
Rapid Vienna,5816,2,18,10,8,60,38,22,64
SK Sturm Gra,5816,3,20,4,12,57,35,22,64
SC Rheindorf,5816,4,18,8,10,62,45,17,62
Vienna,5816,5,19,3,14,62,51,11,60
RZ Pellets W,5816,6,14,6,16,46,52,-6,48
SV Josko Rie,5816,7,13,5,18,34,49,-15,44
Admira Wacke,5816,8,11,5,20,36,60,-24,38
St. Pölten,5816,9,7,11,18,36,67,-31,32
Mattersburg,5816,10,5,9,22,33,62,-29,24
FC Salzburg,5817,1,20,8,8,65,31,34,68
SK Sturm Gra,5817,2,19,6,11,61,39,22,63
Vienna,5817,3,19,6,11,62,50,12,63
SC Rheindorf,5817,4,16,9,11,49,45,4,57
Rapid Vienna,5817,5,15,11,10,55,39,16,56
RZ Pellets W,5817,6,15,7,14,51,52,-1,52
SV Josko Rie,5817,7,15,4,17,48,53,-5,49
Admira Wacke,5817,8,10,6,20,36,65,-29,36
St. Pölten,5817,9,8,9,19,38,66,-28,33
Mattersburg,5817,10,5,10,21,34,59,-25,25
FC Salzburg,5818,1,23,6,7,69,29,40,75
SC Rheindorf,5818,2,17,12,7,57,45,12,63
SK Sturm Gra,5818,3,18,7,11,63,39,24,61
Vienna,5818,4,18,6,12,65,48,17,60
Rapid Vienna,5818,5,14,10,12,56,42,14,52
SV Josko Rie,5818,6,13,5,18,43,55,-12,44
Admira Wacke,5818,7,13,3,20,35,62,-27,42
Mattersburg,5818,8,10,8,18,39,55,-16,38
RZ Pellets W,5818,9,11,5,20,45,62,-17,38
St. Pölten,5818,10,8,8,20,40,75,-35,32
SK Sturm Gra,5819,1,22,5,9,71,32,39,71
SC Rheindorf,5819,2,19,9,8,52,40,12,66
FC Salzburg,5819,3,19,8,9,60,37,23,65
Vienna,5819,4,21,2,13,66,52,14,65
Rapid Vienna,5819,5,13,9,14,57,46,11,48
RZ Pellets W,5819,6,13,6,17,49,64,-15,45
St. Pölten,5819,7,10,10,16,42,57,-15,40
Mattersburg,5819,8,10,7,19,46,56,-10,37
SV Josko Rie,5819,9,10,6,20,29,54,-25,36
Admira Wacke,5819,10,10,4,22,33,67,-34,34
FC Salzburg,5820,1,21,9,6,64,28,36,72
SC Rheindorf,5820,2,21,8,7,61,39,22,71
SK Sturm Gra,5820,3,20,7,9,56,28,28,67
Vienna,5820,4,16,6,14,60,64,-4,54
Rapid Vienna,5820,5,13,11,12,53,46,7,50
RZ Pellets W,5820,6,11,9,16,41,54,-13,42
Admira Wacke,5820,7,12,5,19,39,56,-17,41
St. Pölten,5820,8,8,11,17,44,62,-18,35
SV Josko Rie,5820,9,9,8,19,35,59,-24,35
Mattersburg,5820,10,7,10,19,34,51,-17,31
FC Salzburg,5821,1,22,6,8,68,31,37,72
SC Rheindorf,5821,2,21,5,10,63,50,13,68
Vienna,5821,3,19,7,10,62,48,14,64
SK Sturm Gra,5821,4,18,7,11,60,37,23,61
Rapid Vienna,5821,5,15,12,9,51,32,19,57
Admira Wacke,5821,6,9,11,16,38,57,-19,38
RZ Pellets W,5821,7,9,10,17,43,57,-14,37
SV Josko Rie,5821,8,10,6,20,31,56,-25,36
Mattersburg,5821,9,8,10,18,40,60,-20,34
St. Pölten,5821,10,8,8,20,44,72,-28,32
FC Salzburg,5822,1,23,6,7,75,31,44,75
SC Rheindorf,5822,2,19,8,9,60,48,12,65
Vienna,5822,3,18,8,10,62,49,13,62
SK Sturm Gra,5822,4,17,10,9,60,37,23,61
Rapid Vienna,5822,5,14,10,12,54,44,10,52
RZ Pellets W,5822,6,13,8,15,54,61,-7,47
Admira Wacke,5822,7,12,9,15,37,53,-16,45
SV Josko Rie,5822,8,10,6,20,33,53,-20,36
St. Pölten,5822,9,10,6,20,40,63,-23,36
Mattersburg,5822,10,5,7,24,31,67,-36,22
SC Rheindorf,5823,1,20,8,8,48,34,14,68
FC Salzburg,5823,2,18,8,10,53,31,22,62
SK Sturm Gra,5823,3,17,9,10,53,32,21,60
Vienna,5823,4,18,6,12,58,50,8,60
Rapid Vienna,5823,5,14,12,10,53,35,18,54
RZ Pellets W,5823,6,13,6,17,48,54,-6,45
Admira Wacke,5823,7,13,6,17,33,57,-24,45
SV Josko Rie,5823,8,12,4,20,33,50,-17,40
St. Pölten,5823,9,9,9,18,42,58,-16,36
Mattersburg,5823,10,7,10,19,30,50,-20,31
FC Salzburg,5824,1,23,5,8,69,35,34,74
SK Sturm Gra,5824,2,22,6,8,61,28,33,72
SC Rheindorf,5824,3,20,5,11,63,38,25,65
Vienna,5824,4,16,6,14,58,58,0,54
Rapid Vienna,5824,5,11,15,10,51,40,11,48
Admira Wacke,5824,6,11,6,19,34,60,-26,39
RZ Pellets W,5824,7,10,8,18,46,58,-12,38
St. Pölten,5824,8,9,11,16,44,68,-24,38
SV Josko Rie,5824,9,10,8,18,32,57,-25,38
Mattersburg,5824,10,8,10,18,43,59,-16,34
SK Sturm Gra,5825,1,22,5,9,63,34,29,71
FC Salzburg,5825,2,21,6,9,68,34,34,69
Vienna,5825,3,22,3,11,68,50,18,69
SC Rheindorf,5825,4,19,6,11,56,50,6,63
Rapid Vienna,5825,5,13,9,14,59,51,8,48
Admira Wacke,5825,6,12,8,16,38,57,-19,44
RZ Pellets W,5825,7,10,7,19,48,64,-16,37
SV Josko Rie,5825,8,11,4,21,36,56,-20,37
St. Pölten,5825,9,10,6,20,41,61,-20,36
Mattersburg,5825,10,9,8,19,39,59,-20,35
FC Salzburg,5826,1,20,8,8,62,30,32,68
SC Rheindorf,5826,2,20,8,8,57,38,19,68
SK Sturm Gra,5826,3,20,6,10,71,36,35,66
Vienna,5826,4,19,5,12,59,54,5,62
RZ Pellets W,5826,5,14,7,15,52,59,-7,49
Rapid Vienna,5826,6,11,15,10,46,34,12,48
SV Josko Rie,5826,7,11,7,18,29,45,-16,40
St. Pölten,5826,8,9,11,16,46,70,-24,38
Admira Wacke,5826,9,9,5,22,30,60,-30,32
Mattersburg,5826,10,7,8,21,34,60,-26,29
SC Rheindorf,5827,1,21,5,10,59,39,20,68
SK Sturm Gra,5827,2,20,6,10,59,39,20,66
Rapid Vienna,5827,3,18,9,9,67,41,26,63
FC Salzburg,5827,4,17,10,9,54,32,22,61
Vienna,5827,5,18,4,14,57,48,9,58
RZ Pellets W,5827,6,14,9,13,53,53,0,51
SV Josko Rie,5827,7,12,5,19,36,52,-16,41
Admira Wacke,5827,8,10,7,19,37,63,-26,37
St. Pölten,5827,9,8,9,19,41,62,-21,33
Mattersburg,5827,10,6,8,22,36,70,-34,26
FC Salzburg,5828,1,24,7,5,66,29,37,79
SK Sturm Gra,5828,2,22,5,9,60,33,27,71
SC Rheindorf,5828,3,19,7,10,57,42,15,64
Rapid Vienna,5828,4,17,9,10,68,47,21,60
Vienna,5828,5,16,6,14,55,49,6,54
RZ Pellets W,5828,6,13,6,17,47,55,-8,45
Admira Wacke,5828,7,12,4,20,39,60,-21,40
SV Josko Rie,5828,8,10,5,21,38,61,-23,35
St. Pölten,5828,9,8,8,20,41,73,-32,32
Mattersburg,5828,10,8,5,23,39,61,-22,29
FC Salzburg,5829,1,18,10,8,61,38,23,64
SC Rheindorf,5829,2,17,10,9,49,39,10,61
Vienna,5829,3,18,6,12,63,54,9,60
SK Sturm Gra,5829,4,17,8,11,54,35,19,59
RZ Pellets W,5829,5,16,6,14,55,52,3,54
Rapid Vienna,5829,6,13,13,10,56,41,15,52
Admira Wacke,5829,7,12,7,17,37,55,-18,43
St. Pölten,5829,8,10,9,17,43,57,-14,39
SV Josko Rie,5829,9,11,6,19,36,51,-15,39
Mattersburg,5829,10,6,9,21,35,67,-32,27
FC Salzburg,5830,1,21,8,7,66,27,39,71
SK Sturm Gra,5830,2,20,5,11,60,33,27,65
SC Rheindorf,5830,3,17,11,8,55,38,17,62
Rapid Vienna,5830,4,15,10,11,54,40,14,55
Vienna,5830,5,16,5,15,62,63,-1,53
Mattersburg,5830,6,12,10,14,42,49,-7,46
Admira Wacke,5830,7,12,8,16,35,52,-17,44
RZ Pellets W,5830,8,11,8,17,45,60,-15,41
SV Josko Rie,5830,9,10,7,19,34,53,-19,37
St. Pölten,5830,10,5,10,21,35,73,-38,25
FC Salzburg,5831,1,21,6,9,63,32,31,69
SK Sturm Gra,5831,2,20,7,9,58,30,28,67
SC Rheindorf,5831,3,18,8,10,50,41,9,62
Vienna,5831,4,18,5,13,66,56,10,59
Rapid Vienna,5831,5,14,10,12,52,44,8,52
Admira Wacke,5831,6,15,7,14,44,50,-6,52
RZ Pellets W,5831,7,14,5,17,52,57,-5,47
SV Josko Rie,5831,8,14,2,20,47,57,-10,44
Mattersburg,5831,9,7,7,22,33,64,-31,28
St. Pölten,5831,10,6,9,21,43,77,-34,27
SC Rheindorf,5832,1,19,8,9,53,37,16,65
FC Salzburg,5832,2,18,8,10,58,28,30,62
SK Sturm Gra,5832,3,18,8,10,54,34,20,62
Vienna,5832,4,17,8,11,63,52,11,59
SV Josko Rie,5832,5,15,6,15,41,50,-9,51
Rapid Vienna,5832,6,12,12,12,56,45,11,48
RZ Pellets W,5832,7,13,9,14,51,52,-1,48
Admira Wacke,5832,8,8,13,15,34,61,-27,37
St. Pölten,5832,9,9,8,19,42,64,-22,35
Mattersburg,5832,10,4,14,18,25,54,-29,26
SC Rheindorf,5833,1,22,8,6,56,35,21,74
FC Salzburg,5833,2,20,11,5,59,23,36,71
SK Sturm Gra,5833,3,20,6,10,58,33,25,66
Vienna,5833,4,19,4,13,65,57,8,61
Rapid Vienna,5833,5,15,9,12,60,39,21,54
RZ Pellets W,5833,6,14,6,16,49,56,-7,48
St. Pölten,5833,7,10,7,19,44,60,-16,37
Admira Wacke,5833,8,9,8,19,34,57,-23,35
Mattersburg,5833,9,7,9,20,29,62,-33,30
SV Josko Rie,5833,10,8,4,24,29,61,-32,28
FC Salzburg,5834,1,21,8,7,58,25,33,71
SC Rheindorf,5834,2,21,6,9,54,38,16,69
SK Sturm Gra,5834,3,20,5,11,58,33,25,65
Vienna,5834,4,15,8,13,52,48,4,53
Rapid Vienna,5834,5,14,10,12,51,39,12,52
RZ Pellets W,5834,6,11,10,15,45,56,-11,43
Admira Wacke,5834,7,12,6,18,34,56,-22,42
St. Pölten,5834,8,10,8,18,38,58,-20,38
Mattersburg,5834,9,8,12,16,37,51,-14,36
SV Josko Rie,5834,10,10,3,23,27,50,-23,33
SK Sturm Gra,5835,1,19,9,8,55,27,28,66
FC Salzburg,5835,2,18,6,12,63,40,23,60
SC Rheindorf,5835,3,17,7,12,46,45,1,58
Rapid Vienna,5835,4,15,12,9,60,39,21,57
Vienna,5835,5,17,6,13,69,58,11,57
RZ Pellets W,5835,6,13,6,17,47,66,-19,45
SV Josko Rie,5835,7,13,5,18,40,48,-8,44
St. Pölten,5835,8,10,10,16,49,62,-13,40
Admira Wacke,5835,9,11,6,19,37,63,-26,39
Mattersburg,5835,10,9,9,18,42,60,-18,36
FC Salzburg,5836,1,22,7,7,66,29,37,73
SC Rheindorf,5836,2,20,9,7,59,35,24,69
Vienna,5836,3,19,6,11,67,49,18,63
SK Sturm Gra,5836,4,17,8,11,54,38,16,59
Rapid Vienna,5836,5,16,10,10,57,38,19,58
Admira Wacke,5836,6,11,7,18,34,63,-29,40
RZ Pellets W,5836,7,10,9,17,42,55,-13,39
Mattersburg,5836,8,9,9,18,37,57,-20,36
SV Josko Rie,5836,9,9,5,22,29,52,-23,32
St. Pölten,5836,10,8,8,20,39,68,-29,32
FC Salzburg,5837,1,22,8,6,62,26,36,74
SK Sturm Gra,5837,2,18,7,11,60,42,18,61
SC Rheindorf,5837,3,16,11,9,60,47,13,59
Rapid Vienna,5837,4,15,10,11,58,44,14,55
Vienna,5837,5,16,6,14,57,55,2,54
St. Pölten,5837,6,12,9,15,50,60,-10,45
SV Josko Rie,5837,7,13,4,19,38,53,-15,43
RZ Pellets W,5837,8,11,8,17,45,56,-11,41
Admira Wacke,5837,9,10,6,20,31,59,-28,36
Mattersburg,5837,10,8,9,19,39,58,-19,33
FC Salzburg,5838,1,25,6,5,74,25,49,81
SK Sturm Gra,5838,2,18,8,10,60,35,25,62
SC Rheindorf,5838,3,18,7,11,57,49,8,61
Vienna,5838,4,17,8,11,57,52,5,59
Rapid Vienna,5838,5,16,9,11,63,38,25,57
SV Josko Rie,5838,6,13,4,19,35,46,-11,43
Mattersburg,5838,7,11,7,18,39,57,-18,40
Admira Wacke,5838,8,10,7,19,34,65,-31,37
RZ Pellets W,5838,9,8,12,16,34,49,-15,36
St. Pölten,5838,10,7,6,23,35,72,-37,27
SK Sturm Gra,5839,1,21,7,8,60,30,30,70
FC Salzburg,5839,2,17,13,6,61,29,32,64
SC Rheindorf,5839,3,18,8,10,57,43,14,62
Vienna,5839,4,17,6,13,55,54,1,57
Rapid Vienna,5839,5,13,12,11,52,39,13,51
RZ Pellets W,5839,6,13,7,16,51,60,-9,46
Mattersburg,5839,7,10,8,18,39,56,-17,38
SV Josko Rie,5839,8,11,5,20,36,55,-19,38
St. Pölten,5839,9,8,13,15,36,54,-18,37
Admira Wacke,5839,10,9,7,20,34,61,-27,34
FC Salzburg,5840,1,20,9,7,64,31,33,69
SK Sturm Gra,5840,2,21,5,10,56,27,29,68
SC Rheindorf,5840,3,19,6,11,58,50,8,63
Vienna,5840,4,18,6,12,61,53,8,60
Rapid Vienna,5840,5,14,9,13,48,36,12,51
RZ Pellets W,5840,6,12,7,17,51,63,-12,43
Mattersburg,5840,7,10,10,16,39,51,-12,40
SV Josko Rie,5840,8,11,5,20,33,51,-18,38
Admira Wacke,5840,9,10,6,20,34,64,-30,36
St. Pölten,5840,10,8,11,17,44,62,-18,35
FC Salzburg,5841,1,23,7,6,70,32,38,76
SK Sturm Gra,5841,2,20,6,10,63,34,29,66
SC Rheindorf,5841,3,20,4,12,59,53,6,64
Vienna,5841,4,19,4,13,71,61,10,61
Rapid Vienna,5841,5,12,13,11,56,42,14,49
SV Josko Rie,5841,6,13,5,18,45,57,-12,44
Admira Wacke,5841,7,11,8,17,38,62,-24,41
RZ Pellets W,5841,8,11,6,19,46,62,-16,39
Mattersburg,5841,9,10,8,18,41,54,-13,38
St. Pölten,5841,10,7,7,22,36,68,-32,28
FC Salzburg,5842,1,21,7,8,62,27,35,70
SK Sturm Gra,5842,2,19,8,9,59,31,28,65
Vienna,5842,3,19,6,11,62,46,16,63
SC Rheindorf,5842,4,18,8,10,55,42,13,62
Rapid Vienna,5842,5,17,10,9,66,38,28,61
Admira Wacke,5842,6,13,5,18,35,56,-21,44
RZ Pellets W,5842,7,12,5,19,46,67,-21,41
Mattersburg,5842,8,10,7,19,35,55,-20,37
SV Josko Rie,5842,9,8,7,21,27,53,-26,31
St. Pölten,5842,10,6,11,19,34,66,-32,29
SC Rheindorf,5843,1,23,6,7,59,33,26,75
FC Salzburg,5843,2,19,8,9,64,36,28,65
Vienna,5843,3,20,3,13,63,51,12,63
SK Sturm Gra,5843,4,17,6,13,54,35,19,57
Rapid Vienna,5843,5,13,12,11,52,41,11,51
RZ Pellets W,5843,6,14,7,15,49,51,-2,49
SV Josko Rie,5843,7,12,6,18,32,53,-21,42
Admira Wacke,5843,8,11,5,20,34,56,-22,38
Mattersburg,5843,9,9,7,20,37,58,-21,34
St. Pölten,5843,10,8,8,20,36,66,-30,32
FC Salzburg,5844,1,20,6,10,67,36,31,66
SC Rheindorf,5844,2,19,9,8,56,38,18,66
Vienna,5844,3,19,5,12,67,52,15,62
Rapid Vienna,5844,4,17,10,9,62,38,24,61
SK Sturm Gra,5844,5,18,6,12,57,38,19,60
RZ Pellets W,5844,6,12,10,14,47,58,-11,46
SV Josko Rie,5844,7,14,4,18,38,52,-14,46
Admira Wacke,5844,8,10,9,17,38,60,-22,39
St. Pölten,5844,9,7,9,20,45,75,-30,30
Mattersburg,5844,10,5,10,21,34,64,-30,25
SC Rheindorf,5845,1,23,6,7,59,39,20,75
FC Salzburg,5845,2,17,10,9,56,32,24,61
SK Sturm Gra,5845,3,16,9,11,54,34,20,57
Vienna,5845,4,17,6,13,61,48,13,57
Rapid Vienna,5845,5,12,12,12,57,45,12,48
Admira Wacke,5845,6,11,10,15,36,56,-20,43
Mattersburg,5845,7,11,8,17,42,56,-14,41
RZ Pellets W,5845,8,10,9,17,38,58,-20,39
St. Pölten,5845,9,8,13,15,45,60,-15,37
SV Josko Rie,5845,10,10,7,19,31,51,-20,37
SK Sturm Gra,5846,1,19,8,9,57,31,26,65
FC Salzburg,5846,2,17,11,8,61,34,27,62
Vienna,5846,3,19,5,12,58,47,11,62
SC Rheindorf,5846,4,18,7,11,56,44,12,61
Rapid Vienna,5846,5,16,10,10,53,35,18,58
RZ Pellets W,5846,6,12,7,17,46,55,-9,43
Admira Wacke,5846,7,11,8,17,37,56,-19,41
SV Josko Rie,5846,8,12,4,20,33,50,-17,40
Mattersburg,5846,9,10,9,17,34,53,-19,39
St. Pölten,5846,10,8,7,21,37,67,-30,31
FC Salzburg,5847,1,22,6,8,63,29,34,72
SK Sturm Gra,5847,2,20,5,11,56,33,23,65
Vienna,5847,3,19,4,13,64,53,11,61
SC Rheindorf,5847,4,18,7,11,50,41,9,61
Rapid Vienna,5847,5,16,11,9,58,37,21,59
RZ Pellets W,5847,6,15,5,16,52,52,0,50
Mattersburg,5847,7,10,9,17,42,53,-11,39
SV Josko Rie,5847,8,12,2,22,40,63,-23,38
Admira Wacke,5847,9,9,7,20,31,68,-37,34
St. Pölten,5847,10,7,8,21,37,64,-27,29
FC Salzburg,5848,1,21,8,7,72,34,38,71
SC Rheindorf,5848,2,20,6,10,58,41,17,66
Vienna,5848,3,19,5,12,59,50,9,62
SK Sturm Gra,5848,4,17,9,10,56,35,21,60
Rapid Vienna,5848,5,16,9,11,63,37,26,57
SV Josko Rie,5848,6,14,7,15,42,51,-9,49
RZ Pellets W,5848,7,10,10,16,49,59,-10,40
St. Pölten,5848,8,8,10,18,40,68,-28,34
Mattersburg,5848,9,8,9,19,36,59,-23,33
Admira Wacke,5848,10,8,5,23,28,69,-41,29
FC Salzburg,5849,1,21,6,9,68,34,34,69
SC Rheindorf,5849,2,19,7,10,52,45,7,64
Rapid Vienna,5849,3,17,9,10,58,35,23,60
SK Sturm Gra,5849,4,18,4,14,58,38,20,58
Vienna,5849,5,16,8,12,58,54,4,56
RZ Pellets W,5849,6,11,11,14,42,59,-17,44
SV Josko Rie,5849,7,12,6,18,33,49,-16,42
Admira Wacke,5849,8,11,5,20,40,58,-18,38
St. Pölten,5849,9,9,10,17,40,55,-15,37
Mattersburg,5849,10,9,8,19,35,57,-22,35
SC Rheindorf,5850,1,21,8,7,60,40,20,71
SK Sturm Gra,5850,2,21,7,8,57,24,33,70
FC Salzburg,5850,3,18,9,9,63,36,27,63
Vienna,5850,4,18,5,13,73,53,20,59
Rapid Vienna,5850,5,14,10,12,57,46,11,52
Admira Wacke,5850,6,13,7,16,37,60,-23,46
SV Josko Rie,5850,7,11,7,18,33,49,-16,40
St. Pölten,5850,8,10,8,18,40,62,-22,38
RZ Pellets W,5850,9,9,7,20,36,57,-21,34
Mattersburg,5850,10,6,10,20,39,68,-29,28
SK Sturm Gra,5851,1,20,6,10,59,34,25,66
FC Salzburg,5851,2,20,5,11,69,36,33,65
SC Rheindorf,5851,3,19,7,10,61,47,14,64
Vienna,5851,4,19,7,10,63,52,11,64
Rapid Vienna,5851,5,17,9,10,59,43,16,60
RZ Pellets W,5851,6,13,9,14,45,53,-8,48
St. Pölten,5851,7,10,9,17,44,62,-18,39
SV Josko Rie,5851,8,10,6,20,39,51,-12,36
Admira Wacke,5851,9,9,9,18,33,59,-26,36
Mattersburg,5851,10,5,9,22,28,63,-35,24
SC Rheindorf,5852,1,22,6,8,55,43,12,72
FC Salzburg,5852,2,20,10,6,69,30,39,70
SK Sturm Gra,5852,3,20,5,11,57,30,27,65
Vienna,5852,4,18,4,14,60,47,13,58
Rapid Vienna,5852,5,15,9,12,53,39,14,54
RZ Pellets W,5852,6,13,8,15,41,54,-13,47
Admira Wacke,5852,7,12,7,17,37,56,-19,43
SV Josko Rie,5852,8,9,6,21,36,59,-23,33
Mattersburg,5852,9,8,9,19,33,56,-23,33
St. Pölten,5852,10,7,8,21,38,65,-27,29
FC Salzburg,5853,1,20,6,10,65,32,33,66
SK Sturm Gra,5853,2,19,8,9,52,27,25,65
Vienna,5853,3,17,7,12,62,56,6,58
SC Rheindorf,5853,4,16,9,11,49,46,3,57
RZ Pellets W,5853,5,16,6,14,50,52,-2,54
Rapid Vienna,5853,6,13,9,14,46,38,8,48
Admira Wacke,5853,7,12,6,18,37,54,-17,42
SV Josko Rie,5853,8,12,6,18,41,59,-18,42
Mattersburg,5853,9,9,10,17,39,52,-13,37
St. Pölten,5853,10,7,11,18,43,68,-25,32
FC Salzburg,5854,1,21,6,9,67,32,35,69
Vienna,5854,2,20,5,11,59,47,12,65
SC Rheindorf,5854,3,17,11,8,52,40,12,62
SK Sturm Gra,5854,4,18,6,12,62,32,30,60
Rapid Vienna,5854,5,16,8,12,62,41,21,56
Admira Wacke,5854,6,13,7,16,36,48,-12,46
SV Josko Rie,5854,7,11,5,20,33,58,-25,38
RZ Pellets W,5854,8,9,10,17,42,68,-26,37
Mattersburg,5854,9,9,9,18,39,62,-23,36
St. Pölten,5854,10,9,7,20,46,70,-24,34
FC Salzburg,5855,1,18,12,6,67,33,34,66
SK Sturm Gra,5855,2,19,5,12,57,37,20,62
SC Rheindorf,5855,3,16,10,10,46,38,8,58
Rapid Vienna,5855,4,15,12,9,58,40,18,57
Vienna,5855,5,16,5,15,63,61,2,53
Admira Wacke,5855,6,13,6,17,41,62,-21,45
RZ Pellets W,5855,7,12,6,18,45,57,-12,42
SV Josko Rie,5855,8,11,7,18,35,50,-15,40
Mattersburg,5855,9,9,12,15,36,48,-12,39
St. Pölten,5855,10,7,13,16,42,64,-22,34
FC Salzburg,5856,1,21,8,7,71,30,41,71
SC Rheindorf,5856,2,20,10,6,59,39,20,70
Vienna,5856,3,18,7,11,62,50,12,61
SK Sturm Gra,5856,4,17,8,11,57,37,20,59
Rapid Vienna,5856,5,14,10,12,54,39,15,52
RZ Pellets W,5856,6,14,8,14,48,56,-8,50
Mattersburg,5856,7,10,8,18,41,60,-19,38
SV Josko Rie,5856,8,10,5,21,34,62,-28,35
Admira Wacke,5856,9,10,4,22,40,68,-28,34
St. Pölten,5856,10,5,14,17,39,64,-25,29
FC Salzburg,5857,1,23,6,7,70,32,38,75
SC Rheindorf,5857,2,20,7,9,56,38,18,67
Vienna,5857,3,19,6,11,68,49,19,63
SK Sturm Gra,5857,4,14,10,12,51,38,13,52
RZ Pellets W,5857,5,13,9,14,43,52,-9,48
St. Pölten,5857,6,12,9,15,41,58,-17,45
Admira Wacke,5857,7,12,6,18,37,57,-20,42
Rapid Vienna,5857,8,9,13,14,42,42,0,40
SV Josko Rie,5857,9,10,6,20,34,54,-20,36
Mattersburg,5857,10,8,8,20,34,56,-22,32
FC Salzburg,5858,1,24,5,7,73,29,44,77
Vienna,5858,2,18,6,12,64,56,8,60
SC Rheindorf,5858,3,16,8,12,51,46,5,56
SK Sturm Gra,5858,4,15,10,11,50,36,14,55
Rapid Vienna,5858,5,14,12,10,61,43,18,54
Admira Wacke,5858,6,14,5,17,45,66,-21,47
RZ Pellets W,5858,7,13,7,16,48,59,-11,46
SV Josko Rie,5858,8,11,6,19,36,51,-15,39
Mattersburg,5858,9,9,9,18,38,51,-13,36
St. Pölten,5858,10,8,8,20,41,70,-29,32
FC Salzburg,5859,1,19,9,8,61,32,29,66
SC Rheindorf,5859,2,17,11,8,61,49,12,62
SK Sturm Gra,5859,3,18,6,12,57,39,18,60
Vienna,5859,4,19,2,15,72,59,13,59
Rapid Vienna,5859,5,16,8,12,60,45,15,56
Admira Wacke,5859,6,14,6,16,49,63,-14,48
RZ Pellets W,5859,7,12,6,18,47,62,-15,42
St. Pölten,5859,8,11,7,18,43,66,-23,40
SV Josko Rie,5859,9,11,5,20,37,54,-17,38
Mattersburg,5859,10,9,8,19,38,56,-18,35
SC Rheindorf,5860,1,21,8,7,55,37,18,71
SK Sturm Gra,5860,2,21,6,9,65,34,31,69
FC Salzburg,5860,3,17,13,6,61,32,29,64
Vienna,5860,4,17,7,12,63,60,3,58
Rapid Vienna,5860,5,11,14,11,54,43,11,47
RZ Pellets W,5860,6,12,10,14,49,54,-5,46
Admira Wacke,5860,7,11,11,14,40,58,-18,44
SV Josko Rie,5860,8,9,9,18,32,52,-20,36
Mattersburg,5860,9,7,8,21,39,59,-20,29
St. Pölten,5860,10,6,10,20,36,65,-29,28
FC Salzburg,5861,1,21,8,7,68,33,35,71
SK Sturm Gra,5861,2,21,6,9,60,31,29,69
SC Rheindorf,5861,3,19,8,9,60,45,15,65
Vienna,5861,4,15,8,13,55,53,2,53
Rapid Vienna,5861,5,11,14,11,60,47,13,47
Admira Wacke,5861,6,12,8,16,39,59,-20,44
Mattersburg,5861,7,11,8,17,42,55,-13,41
RZ Pellets W,5861,8,11,8,17,47,67,-20,41
SV Josko Rie,5861,9,11,5,20,40,57,-17,38
St. Pölten,5861,10,6,11,19,40,64,-24,29
SC Rheindorf,5862,1,21,7,8,63,44,19,70
Vienna,5862,2,22,3,11,66,45,21,69
SK Sturm Gra,5862,3,20,7,9,58,34,24,67
FC Salzburg,5862,4,19,7,10,63,41,22,64
Rapid Vienna,5862,5,14,10,12,54,39,15,52
RZ Pellets W,5862,6,14,7,15,46,55,-9,49
SV Josko Rie,5862,7,12,4,20,38,53,-15,40
St. Pölten,5862,8,8,9,19,40,62,-22,33
Mattersburg,5862,9,8,8,20,35,58,-23,32
Admira Wacke,5862,10,8,6,22,30,62,-32,30
FC Salzburg,5863,1,22,5,9,63,32,31,71
SK Sturm Gra,5863,2,19,8,9,62,38,24,65
SC Rheindorf,5863,3,18,8,10,51,44,7,62
Vienna,5863,4,18,5,13,61,51,10,59
Rapid Vienna,5863,5,14,13,9,56,36,20,55
SV Josko Rie,5863,6,13,4,19,41,54,-13,43
Admira Wacke,5863,7,13,3,20,38,57,-19,42
Mattersburg,5863,8,9,10,17,39,56,-17,37
St. Pölten,5863,9,9,10,17,39,61,-22,37
RZ Pellets W,5863,10,9,6,21,41,62,-21,33
FC Salzburg,5864,1,20,10,6,70,28,42,70
SK Sturm Gra,5864,2,18,8,10,56,36,20,62
SC Rheindorf,5864,3,15,12,9,51,40,11,57
Vienna,5864,4,17,5,14,62,62,0,56
Rapid Vienna,5864,5,14,10,12,56,43,13,52
Admira Wacke,5864,6,12,8,16,38,50,-12,44
St. Pölten,5864,7,11,11,14,41,55,-14,44
RZ Pellets W,5864,8,12,6,18,41,61,-20,42
SV Josko Rie,5864,9,11,5,20,34,55,-21,38
Mattersburg,5864,10,8,9,19,34,53,-19,33
SK Sturm Gra,5865,1,21,6,9,60,30,30,69
FC Salzburg,5865,2,19,9,8,64,34,30,66
Vienna,5865,3,20,3,13,68,52,16,63
SC Rheindorf,5865,4,15,9,12,42,43,-1,54
RZ Pellets W,5865,5,15,8,13,41,43,-2,53
Rapid Vienna,5865,6,12,13,11,52,37,15,49
Admira Wacke,5865,7,13,8,15,40,56,-16,47
SV Josko Rie,5865,8,9,7,20,33,57,-24,34
Mattersburg,5865,9,9,7,20,33,59,-26,34
St. Pölten,5865,10,8,8,20,39,61,-22,32
SC Rheindorf,5866,1,20,7,9,62,50,12,67
FC Salzburg,5866,2,19,9,8,68,36,32,66
SK Sturm Gra,5866,3,19,7,10,57,29,28,64
Vienna,5866,4,18,6,12,62,55,7,60
Rapid Vienna,5866,5,11,15,10,44,35,9,48
Admira Wacke,5866,6,13,7,16,46,58,-12,46
St. Pölten,5866,7,11,9,16,38,58,-20,42
SV Josko Rie,5866,8,11,6,19,35,51,-16,39
RZ Pellets W,5866,9,8,10,18,37,59,-22,34
Mattersburg,5866,10,6,12,18,40,58,-18,30
FC Salzburg,5867,1,21,8,7,73,34,39,71
SC Rheindorf,5867,2,20,6,10,50,34,16,66
SK Sturm Gra,5867,3,20,5,11,65,39,26,65
Vienna,5867,4,18,4,14,61,54,7,58
Rapid Vienna,5867,5,14,11,11,55,43,12,53
Admira Wacke,5867,6,15,5,16,42,55,-13,50
SV Josko Rie,5867,7,11,5,20,37,59,-22,38
RZ Pellets W,5867,8,10,7,19,44,65,-21,37
Mattersburg,5867,9,9,9,18,42,60,-18,36
St. Pölten,5867,10,8,8,20,38,64,-26,32
FC Salzburg,5868,1,20,8,8,62,26,36,68
Vienna,5868,2,21,5,10,66,47,19,68
SK Sturm Gra,5868,3,18,6,12,58,38,20,60
SC Rheindorf,5868,4,16,7,13,51,44,7,55
Rapid Vienna,5868,5,13,11,12,53,47,6,50
RZ Pellets W,5868,6,11,9,16,46,57,-11,42
St. Pölten,5868,7,10,12,14,42,58,-16,42
Mattersburg,5868,8,10,9,17,37,49,-12,39
SV Josko Rie,5868,9,11,6,19,35,56,-21,39
Admira Wacke,5868,10,8,11,17,36,64,-28,35
SC Rheindorf,5869,1,24,5,7,62,42,20,77
FC Salzburg,5869,2,22,8,6,70,30,40,74
SK Sturm Gra,5869,3,18,7,11,63,35,28,61
Vienna,5869,4,17,4,15,60,56,4,55
Rapid Vienna,5869,5,15,7,14,58,49,9,52
Admira Wacke,5869,6,12,10,14,38,53,-15,46
RZ Pellets W,5869,7,11,9,16,40,57,-17,42
Mattersburg,5869,8,9,7,20,46,63,-17,34
St. Pölten,5869,9,9,7,20,43,67,-24,34
SV Josko Rie,5869,10,9,4,23,31,59,-28,31
SK Sturm Gra,5870,1,21,5,10,63,35,28,68
FC Salzburg,5870,2,19,10,7,57,29,28,67
SC Rheindorf,5870,3,18,7,11,51,38,13,61
Vienna,5870,4,18,7,11,63,51,12,61
Rapid Vienna,5870,5,12,10,14,50,47,3,46
RZ Pellets W,5870,6,12,9,15,45,52,-7,45
SV Josko Rie,5870,7,12,7,17,40,54,-14,43
Admira Wacke,5870,8,12,5,19,36,59,-23,41
Mattersburg,5870,9,9,9,18,39,55,-16,36
St. Pölten,5870,10,8,9,19,43,67,-24,33
FC Salzburg,5871,1,23,8,5,70,28,42,77
SC Rheindorf,5871,2,20,6,10,56,45,11,66
Rapid Vienna,5871,3,18,9,9,68,37,31,63
SK Sturm Gra,5871,4,18,7,11,58,36,22,61
Vienna,5871,5,17,5,14,59,59,0,56
RZ Pellets W,5871,6,12,9,15,49,55,-6,45
Admira Wacke,5871,7,10,8,18,37,59,-22,38
St. Pölten,5871,8,10,7,19,44,65,-21,37
SV Josko Rie,5871,9,10,4,22,29,56,-27,34
Mattersburg,5871,10,6,9,21,30,60,-30,27
FC Salzburg,5872,1,22,9,5,70,29,41,75
SC Rheindorf,5872,2,20,7,9,55,44,11,67
Vienna,5872,3,19,4,13,64,49,15,61
SK Sturm Gra,5872,4,17,8,11,62,38,24,59
Rapid Vienna,5872,5,13,11,12,55,47,8,50
RZ Pellets W,5872,6,12,10,14,49,53,-4,46
Mattersburg,5872,7,10,9,17,37,60,-23,39
St. Pölten,5872,8,10,7,19,45,68,-23,37
Admira Wacke,5872,9,10,6,20,36,61,-25,36
SV Josko Rie,5872,10,10,3,23,30,54,-24,33
FC Salzburg,5873,1,23,5,8,64,31,33,74
SK Sturm Gra,5873,2,22,5,9,56,28,28,71
Vienna,5873,3,20,5,11,60,45,15,65
SC Rheindorf,5873,4,18,6,12,60,47,13,60
Rapid Vienna,5873,5,14,11,11,54,36,18,53
Admira Wacke,5873,6,13,4,19,35,59,-24,43
RZ Pellets W,5873,7,11,6,19,42,60,-18,39
St. Pölten,5873,8,8,11,17,38,60,-22,35
SV Josko Rie,5873,9,9,6,21,38,59,-21,33
Mattersburg,5873,10,8,9,19,36,58,-22,33
SC Rheindorf,5874,1,22,7,7,59,42,17,73
FC Salzburg,5874,2,20,9,7,68,34,34,69
SK Sturm Gra,5874,3,18,8,10,57,33,24,62
Vienna,5874,4,17,5,14,57,50,7,56
Rapid Vienna,5874,5,12,12,12,51,39,12,48
RZ Pellets W,5874,6,12,7,17,40,52,-12,43
Admira Wacke,5874,7,12,7,17,35,55,-20,43
St. Pölten,5874,8,9,13,14,37,52,-15,40
SV Josko Rie,5874,9,10,5,21,36,62,-26,35
Mattersburg,5874,10,8,7,21,36,57,-21,31
FC Salzburg,5875,1,22,8,6,67,24,43,74
SC Rheindorf,5875,2,20,9,7,57,39,18,69
SK Sturm Gra,5875,3,19,6,11,59,32,27,63
Rapid Vienna,5875,4,16,9,11,58,39,19,57
Vienna,5875,5,17,6,13,58,54,4,57
RZ Pellets W,5875,6,13,7,16,44,51,-7,46
Admira Wacke,5875,7,10,8,18,32,55,-23,38
SV Josko Rie,5875,8,9,6,21,30,54,-24,33
St. Pölten,5875,9,8,9,19,35,66,-31,33
Mattersburg,5875,10,8,8,20,34,60,-26,32
SC Rheindorf,5876,1,22,8,6,65,40,25,74
FC Salzburg,5876,2,22,7,7,70,31,39,73
SK Sturm Gra,5876,3,20,6,10,59,32,27,66
Rapid Vienna,5876,4,16,12,8,56,34,22,60
Vienna,5876,5,15,7,14,54,54,0,52
RZ Pellets W,5876,6,11,8,17,46,57,-11,41
SV Josko Rie,5876,7,11,4,21,30,51,-21,37
Admira Wacke,5876,8,9,9,18,39,63,-24,36
St. Pölten,5876,9,7,11,18,43,66,-23,32
Mattersburg,5876,10,8,6,22,33,67,-34,30
SC Rheindorf,5877,1,20,7,9,64,43,21,67
SK Sturm Gra,5877,2,20,4,12,59,34,25,64
FC Salzburg,5877,3,19,7,10,58,41,17,64
Vienna,5877,4,18,5,13,57,49,8,59
RZ Pellets W,5877,5,13,9,14,47,51,-4,48
Admira Wacke,5877,6,14,6,16,39,53,-14,48
Rapid Vienna,5877,7,12,10,14,55,48,7,46
Mattersburg,5877,8,11,9,16,39,48,-9,42
SV Josko Rie,5877,9,9,6,21,38,61,-23,33
St. Pölten,5877,10,7,11,18,41,69,-28,32
FC Salzburg,5878,1,19,9,8,60,31,29,66
SK Sturm Gra,5878,2,20,6,10,55,34,21,66
SC Rheindorf,5878,3,19,5,12,50,43,7,62
Vienna,5878,4,18,5,13,71,52,19,59
Rapid Vienna,5878,5,16,7,13,55,45,10,55
RZ Pellets W,5878,6,14,6,16,47,52,-5,48
Mattersburg,5878,7,10,11,15,41,50,-9,41
Admira Wacke,5878,8,10,10,16,32,50,-18,40
SV Josko Rie,5878,9,10,4,22,30,58,-28,34
St. Pölten,5878,10,8,9,19,46,72,-26,33
SC Rheindorf,5879,1,21,8,7,57,41,16,71
SK Sturm Gra,5879,2,21,5,10,66,29,37,68
Vienna,5879,3,21,5,10,71,50,21,68
Rapid Vienna,5879,4,16,11,9,59,38,21,59
FC Salzburg,5879,5,16,11,9,59,42,17,59
SV Josko Rie,5879,6,13,5,18,38,50,-12,44
RZ Pellets W,5879,7,9,9,18,37,55,-18,36
Admira Wacke,5879,8,9,7,20,30,64,-34,34
Mattersburg,5879,9,8,9,19,36,59,-23,33
St. Pölten,5879,10,6,10,20,38,63,-25,28
SC Rheindorf,5880,1,21,9,6,63,37,26,72
FC Salzburg,5880,2,18,10,8,63,33,30,64
Vienna,5880,3,19,5,12,65,53,12,62
SK Sturm Gra,5880,4,16,12,8,56,37,19,60
Rapid Vienna,5880,5,11,13,12,47,40,7,46
RZ Pellets W,5880,6,10,12,14,40,50,-10,42
Admira Wacke,5880,7,12,4,20,35,64,-29,40
Mattersburg,5880,8,10,9,17,39,53,-14,39
SV Josko Rie,5880,9,9,8,19,38,55,-17,35
St. Pölten,5880,10,7,12,17,37,61,-24,33
FC Salzburg,5881,1,23,5,8,72,28,44,74
SK Sturm Gra,5881,2,21,4,11,59,32,27,67
Vienna,5881,3,20,5,11,67,53,14,65
SC Rheindorf,5881,4,19,6,11,55,47,8,63
Rapid Vienna,5881,5,14,8,14,48,39,9,50
RZ Pellets W,5881,6,10,10,16,36,50,-14,40
SV Josko Rie,5881,7,11,6,19,34,51,-17,39
Admira Wacke,5881,8,10,8,18,30,58,-28,38
Mattersburg,5881,9,9,8,19,36,55,-19,35
St. Pölten,5881,10,7,12,17,39,63,-24,33
FC Salzburg,5882,1,21,8,7,64,29,35,71
Vienna,5882,2,21,3,12,65,51,14,66
SK Sturm Gra,5882,3,20,5,11,57,31,26,65
SC Rheindorf,5882,4,19,8,9,55,42,13,65
Rapid Vienna,5882,5,15,10,11,57,39,18,55
RZ Pellets W,5882,6,13,9,14,53,50,3,48
Admira Wacke,5882,7,11,8,17,40,58,-18,41
St. Pölten,5882,8,9,7,20,40,76,-36,34
Mattersburg,5882,9,8,7,21,33,59,-26,31
SV Josko Rie,5882,10,8,5,23,32,61,-29,29
SK Sturm Gra,5883,1,23,5,8,63,30,33,74
SC Rheindorf,5883,2,22,6,8,49,35,14,72
FC Salzburg,5883,3,20,7,9,61,30,31,67
Vienna,5883,4,19,3,14,68,62,6,60
Admira Wacke,5883,5,14,4,18,37,59,-22,46
Rapid Vienna,5883,6,11,10,15,51,45,6,43
RZ Pellets W,5883,7,11,8,17,49,58,-9,41
SV Josko Rie,5883,8,12,3,21,38,56,-18,39
Mattersburg,5883,9,8,9,19,31,50,-19,33
St. Pölten,5883,10,8,9,19,38,60,-22,33
SK Sturm Gra,5884,1,22,4,10,63,32,31,70
FC Salzburg,5884,2,22,4,10,58,35,23,70
SC Rheindorf,5884,3,19,8,9,57,42,15,65
Rapid Vienna,5884,4,15,11,10,58,42,16,56
Vienna,5884,5,17,5,14,60,55,5,56
Admira Wacke,5884,6,12,6,18,45,60,-15,42
RZ Pellets W,5884,7,12,6,18,43,60,-17,42
SV Josko Rie,5884,8,11,6,19,38,55,-17,39
St. Pölten,5884,9,7,12,17,39,58,-19,33
Mattersburg,5884,10,8,8,20,42,64,-22,32
FC Salzburg,5885,1,20,8,8,66,29,37,68
SC Rheindorf,5885,2,19,10,7,52,33,19,67
SK Sturm Gra,5885,3,19,8,9,63,33,30,65
Vienna,5885,4,18,6,12,57,50,7,60
Rapid Vienna,5885,5,13,11,12,53,46,7,50
RZ Pellets W,5885,6,13,10,13,48,55,-7,49
Admira Wacke,5885,7,10,7,19,33,58,-25,37
Mattersburg,5885,8,9,8,19,40,58,-18,35
SV Josko Rie,5885,9,10,4,22,30,55,-25,34
St. Pölten,5885,10,6,14,16,44,69,-25,32
FC Salzburg,5886,1,22,9,5,67,26,41,75
SC Rheindorf,5886,2,21,7,8,61,40,21,70
SK Sturm Gra,5886,3,19,8,9,65,34,31,65
Vienna,5886,4,14,9,13,52,56,-4,51
Rapid Vienna,5886,5,11,13,12,46,41,5,46
RZ Pellets W,5886,6,12,10,14,47,54,-7,46
Admira Wacke,5886,7,11,10,15,42,60,-18,43
SV Josko Rie,5886,8,10,8,18,36,54,-18,38
Mattersburg,5886,9,10,5,21,44,63,-19,35
St. Pölten,5886,10,5,11,20,37,69,-32,26
SC Rheindorf,5887,1,21,8,7,57,39,18,71
FC Salzburg,5887,2,20,8,8,62,29,33,68
SK Sturm Gra,5887,3,20,8,8,57,28,29,68
Vienna,5887,4,20,7,9,61,43,18,67
Rapid Vienna,5887,5,15,11,10,56,37,19,56
RZ Pellets W,5887,6,11,5,20,37,57,-20,38
Admira Wacke,5887,7,11,5,20,42,63,-21,38
SV Josko Rie,5887,8,10,6,20,29,52,-23,36
Mattersburg,5887,9,9,6,21,34,56,-22,33
St. Pölten,5887,10,6,10,20,39,70,-31,28
FC Salzburg,5888,1,22,6,8,73,34,39,72
Vienna,5888,2,20,5,11,62,45,17,65
SK Sturm Gra,5888,3,19,6,11,60,39,21,63
SC Rheindorf,5888,4,18,9,9,52,43,9,63
Rapid Vienna,5888,5,17,9,10,60,38,22,60
Admira Wacke,5888,6,12,7,17,38,58,-20,43
RZ Pellets W,5888,7,11,9,16,42,53,-11,42
Mattersburg,5888,8,9,8,19,36,54,-18,35
SV Josko Rie,5888,9,10,5,21,37,58,-21,35
St. Pölten,5888,10,4,12,20,32,70,-38,24
FC Salzburg,5889,1,22,6,8,63,31,32,72
SK Sturm Gra,5889,2,21,7,8,63,34,29,70
Rapid Vienna,5889,3,18,10,8,67,34,33,64
SC Rheindorf,5889,4,18,7,11,56,51,5,61
Vienna,5889,5,17,6,13,62,52,10,57
RZ Pellets W,5889,6,13,6,17,51,58,-7,45
Mattersburg,5889,7,10,8,18,37,55,-18,38
Admira Wacke,5889,8,9,8,19,33,58,-25,35
St. Pölten,5889,9,8,10,18,38,63,-25,34
SV Josko Rie,5889,10,8,4,24,27,61,-34,28
FC Salzburg,5890,1,22,6,8,62,28,34,72
SK Sturm Gra,5890,2,18,10,8,61,38,23,64
SC Rheindorf,5890,3,18,8,10,53,43,10,62
Vienna,5890,4,17,5,14,64,51,13,56
Rapid Vienna,5890,5,12,11,13,55,47,8,47
SV Josko Rie,5890,6,14,5,17,39,45,-6,47
RZ Pellets W,5890,7,11,10,15,49,60,-11,43
Admira Wacke,5890,8,12,7,17,39,61,-22,43
Mattersburg,5890,9,8,13,15,40,60,-20,37
St. Pölten,5890,10,6,9,21,34,63,-29,27
FC Salzburg,5891,1,20,7,9,66,36,30,67
SC Rheindorf,5891,2,20,7,9,56,38,18,67
SK Sturm Gra,5891,3,20,4,12,59,37,22,64
Vienna,5891,4,17,7,12,61,54,7,58
Rapid Vienna,5891,5,12,12,12,51,37,14,48
RZ Pellets W,5891,6,13,7,16,46,60,-14,46
Admira Wacke,5891,7,12,6,18,44,62,-18,42
SV Josko Rie,5891,8,12,6,18,39,57,-18,42
Mattersburg,5891,9,10,8,18,38,53,-15,38
St. Pölten,5891,10,8,8,20,43,69,-26,32
FC Salzburg,5892,1,20,7,9,67,36,31,67
SC Rheindorf,5892,2,19,10,7,63,41,22,67
SK Sturm Gra,5892,3,15,10,11,53,34,19,55
Vienna,5892,4,16,5,15,54,50,4,53
Rapid Vienna,5892,5,14,10,12,51,40,11,52
RZ Pellets W,5892,6,13,9,14,45,54,-9,48
Admira Wacke,5892,7,13,6,17,37,53,-16,45
St. Pölten,5892,8,10,10,16,44,61,-17,40
SV Josko Rie,5892,9,11,6,19,36,53,-17,39
Mattersburg,5892,10,9,7,20,33,61,-28,34
FC Salzburg,5893,1,21,8,7,65,28,37,71
SC Rheindorf,5893,2,19,8,9,54,40,14,65
Vienna,5893,3,18,8,10,60,43,17,62
SK Sturm Gra,5893,4,17,8,11,54,38,16,59
Rapid Vienna,5893,5,16,10,10,61,36,25,58
RZ Pellets W,5893,6,14,8,14,49,52,-3,50
Admira Wacke,5893,7,10,7,19,30,60,-30,37
St. Pölten,5893,8,7,14,15,42,62,-20,35
Mattersburg,5893,9,7,11,18,37,57,-20,32
SV Josko Rie,5893,10,8,4,24,27,63,-36,28
FC Salzburg,5894,1,20,10,6,68,27,41,70
SK Sturm Gra,5894,2,18,6,12,53,34,19,60
SC Rheindorf,5894,3,17,9,10,47,41,6,60
Vienna,5894,4,17,7,12,59,57,2,58
Rapid Vienna,5894,5,14,10,12,57,41,16,52
St. Pölten,5894,6,12,10,14,49,57,-8,46
Admira Wacke,5894,7,13,5,18,41,63,-22,44
RZ Pellets W,5894,8,12,7,17,46,56,-10,43
Mattersburg,5894,9,8,11,17,34,56,-22,35
SV Josko Rie,5894,10,9,5,22,31,53,-22,32
FC Salzburg,5895,1,22,7,7,64,29,35,73
SC Rheindorf,5895,2,20,7,9,55,39,16,67
Vienna,5895,3,19,7,10,65,49,16,64
SK Sturm Gra,5895,4,19,5,12,56,35,21,62
Rapid Vienna,5895,5,12,13,11,54,42,12,49
RZ Pellets W,5895,6,13,9,14,52,58,-6,48
Admira Wacke,5895,7,11,7,18,37,64,-27,40
St. Pölten,5895,8,9,9,18,46,65,-19,36
SV Josko Rie,5895,9,9,5,22,31,57,-26,32
Mattersburg,5895,10,6,11,19,36,58,-22,29
FC Salzburg,5896,1,22,7,7,62,27,35,73
SK Sturm Gra,5896,2,19,8,9,59,39,20,65
SC Rheindorf,5896,3,18,10,8,68,48,20,64
Vienna,5896,4,17,5,14,56,54,2,56
Rapid Vienna,5896,5,13,10,13,56,44,12,49
Admira Wacke,5896,6,13,6,17,38,55,-17,45
RZ Pellets W,5896,7,11,7,18,44,58,-14,40
St. Pölten,5896,8,9,11,16,45,63,-18,38
SV Josko Rie,5896,9,9,8,19,33,50,-17,35
Mattersburg,5896,10,9,8,19,36,59,-23,35
SK Sturm Gra,5897,1,21,6,9,63,30,33,69
FC Salzburg,5897,2,20,8,8,64,38,26,68
Vienna,5897,3,19,4,13,62,51,11,61
SC Rheindorf,5897,4,18,6,12,57,47,10,60
Rapid Vienna,5897,5,13,10,13,60,44,16,49
St. Pölten,5897,6,11,9,16,38,55,-17,42
RZ Pellets W,5897,7,12,5,19,42,60,-18,41
SV Josko Rie,5897,8,12,4,20,37,55,-18,40
Mattersburg,5897,9,10,9,17,39,52,-13,39
Admira Wacke,5897,10,8,11,17,31,61,-30,35
SC Rheindorf,5898,1,20,7,9,55,40,15,67
Vienna,5898,2,21,4,11,73,61,12,67
FC Salzburg,5898,3,19,8,9,63,36,27,65
SK Sturm Gra,5898,4,18,9,9,59,37,22,63
Rapid Vienna,5898,5,18,8,10,65,35,30,62
Admira Wacke,5898,6,12,6,18,37,61,-24,42
Mattersburg,5898,7,11,8,17,39,52,-13,41
RZ Pellets W,5898,8,9,8,19,43,61,-18,35
St. Pölten,5898,9,8,10,18,47,70,-23,34
SV Josko Rie,5898,10,7,6,23,27,55,-28,27
SK Sturm Gra,5899,1,22,6,8,66,31,35,72
FC Salzburg,5899,2,21,7,8,69,34,35,70
Rapid Vienna,5899,3,14,12,10,61,43,18,54
SC Rheindorf,5899,4,16,6,14,50,49,1,54
Vienna,5899,5,14,7,15,59,64,-5,49
SV Josko Rie,5899,6,14,5,17,49,52,-3,47
RZ Pellets W,5899,7,12,11,13,50,54,-4,47
Admira Wacke,5899,8,12,9,15,43,59,-16,45
Mattersburg,5899,9,8,8,20,34,64,-30,32
St. Pölten,5899,10,8,7,21,40,71,-31,31
FC Salzburg,5900,1,21,8,7,67,27,40,71
SK Sturm Gra,5900,2,20,5,11,60,34,26,65
Rapid Vienna,5900,3,19,7,10,65,40,25,64
Vienna,5900,4,19,6,11,63,51,12,63
SC Rheindorf,5900,5,17,8,11,54,44,10,59
RZ Pellets W,5900,6,13,9,14,47,54,-7,48
Admira Wacke,5900,7,11,7,18,37,65,-28,40
SV Josko Rie,5900,8,12,3,21,35,56,-21,39
Mattersburg,5900,9,8,7,21,35,61,-26,31
St. Pölten,5900,10,6,8,22,35,66,-31,26
FC Salzburg,5901,1,24,6,6,66,26,40,78
SC Rheindorf,5901,2,23,6,7,67,39,28,75
SK Sturm Gra,5901,3,19,8,9,56,32,24,65
Vienna,5901,4,17,5,14,63,58,5,56
Admira Wacke,5901,5,13,5,18,37,62,-25,44
Rapid Vienna,5901,6,11,10,15,52,49,3,43
RZ Pellets W,5901,7,11,8,17,47,57,-10,41
SV Josko Rie,5901,8,12,4,20,30,52,-22,40
Mattersburg,5901,9,9,6,21,44,61,-17,33
St. Pölten,5901,10,8,8,20,40,66,-26,32
FC Salzburg,5902,1,21,7,8,59,28,31,70
SK Sturm Gra,5902,2,20,7,9,58,33,25,67
Vienna,5902,3,21,4,11,68,52,16,67
SC Rheindorf,5902,4,20,5,11,56,47,9,65
Rapid Vienna,5902,5,16,8,12,69,42,27,56
RZ Pellets W,5902,6,12,9,15,52,55,-3,45
Admira Wacke,5902,7,11,7,18,42,63,-21,40
SV Josko Rie,5902,8,9,6,21,33,61,-28,33
St. Pölten,5902,9,8,9,19,39,72,-33,33
Mattersburg,5902,10,7,8,21,40,63,-23,29
SK Sturm Gra,5903,1,21,6,9,60,31,29,69
FC Salzburg,5903,2,19,8,9,60,32,28,65
SC Rheindorf,5903,3,17,10,9,56,47,9,61
Vienna,5903,4,15,8,13,57,46,11,53
Rapid Vienna,5903,5,14,10,12,49,38,11,52
Mattersburg,5903,6,13,6,17,44,51,-7,45
RZ Pellets W,5903,7,10,10,16,52,63,-11,40
Admira Wacke,5903,8,9,13,14,34,52,-18,40
St. Pölten,5903,9,9,10,17,38,59,-21,37
SV Josko Rie,5903,10,10,5,21,34,65,-31,35
FC Salzburg,5904,1,23,8,5,75,31,44,77
SK Sturm Gra,5904,2,20,6,10,65,39,26,66
Vienna,5904,3,18,5,13,61,55,6,59
SC Rheindorf,5904,4,18,5,13,48,48,0,59
Rapid Vienna,5904,5,16,9,11,64,43,21,57
RZ Pellets W,5904,6,13,7,16,47,57,-10,46
SV Josko Rie,5904,7,13,3,20,40,55,-15,42
St. Pölten,5904,8,9,10,17,50,67,-17,37
Admira Wacke,5904,9,10,5,21,36,64,-28,35
Mattersburg,5904,10,7,8,21,38,65,-27,29
FC Salzburg,5905,1,25,6,5,78,28,50,81
SC Rheindorf,5905,2,22,4,10,58,39,19,70
SK Sturm Gra,5905,3,19,5,12,58,37,21,62
Vienna,5905,4,18,4,14,61,56,5,58
Rapid Vienna,5905,5,15,12,9,59,38,21,57
Admira Wacke,5905,6,12,8,16,43,60,-17,44
RZ Pellets W,5905,7,11,7,18,48,57,-9,40
SV Josko Rie,5905,8,10,8,18,30,53,-23,38
Mattersburg,5905,9,8,8,20,36,64,-28,32
St. Pölten,5905,10,5,8,23,33,72,-39,23
FC Salzburg,5906,1,23,5,8,70,29,41,74
SK Sturm Gra,5906,2,20,8,8,56,29,27,68
SC Rheindorf,5906,3,18,9,9,56,48,8,63
Vienna,5906,4,18,7,11,60,50,10,61
Rapid Vienna,5906,5,13,13,10,50,35,15,52
Admira Wacke,5906,6,12,4,20,39,63,-24,40
RZ Pellets W,5906,7,11,6,19,48,65,-17,39
Mattersburg,5906,8,9,10,17,38,56,-18,37
St. Pölten,5906,9,7,12,17,40,60,-20,33
SV Josko Rie,5906,10,9,6,21,31,53,-22,33
FC Salzburg,5907,1,19,8,9,59,31,28,65
SK Sturm Gra,5907,2,19,6,11,57,34,23,63
SC Rheindorf,5907,3,19,6,11,53,40,13,63
Vienna,5907,4,18,7,11,57,46,11,61
Rapid Vienna,5907,5,15,12,9,61,41,20,57
RZ Pellets W,5907,6,14,7,15,49,57,-8,49
St. Pölten,5907,7,10,11,15,47,58,-11,41
Admira Wacke,5907,8,10,7,19,33,60,-27,37
SV Josko Rie,5907,9,10,6,20,30,49,-19,36
Mattersburg,5907,10,7,8,21,34,64,-30,29
SC Rheindorf,5908,1,21,7,8,53,37,16,70
FC Salzburg,5908,2,20,7,9,69,39,30,67
Vienna,5908,3,19,4,13,59,52,7,61
Rapid Vienna,5908,4,16,10,10,62,44,18,58
SK Sturm Gra,5908,5,17,7,12,56,40,16,58
RZ Pellets W,5908,6,14,7,15,47,52,-5,49
Admira Wacke,5908,7,11,8,17,35,54,-19,41
St. Pölten,5908,8,8,11,17,48,67,-19,35
SV Josko Rie,5908,9,9,6,21,34,57,-23,33
Mattersburg,5908,10,8,7,21,28,49,-21,31
Vienna,5909,1,23,2,11,70,44,26,71
FC Salzburg,5909,2,19,7,10,59,34,25,64
SC Rheindorf,5909,3,19,7,10,63,41,22,64
SK Sturm Gra,5909,4,19,6,11,57,34,23,63
Rapid Vienna,5909,5,14,10,12,60,45,15,52
Admira Wacke,5909,6,15,3,18,43,64,-21,48
RZ Pellets W,5909,7,11,8,17,45,56,-11,41
SV Josko Rie,5909,8,12,4,20,34,60,-26,40
St. Pölten,5909,9,10,7,19,42,65,-23,37
Mattersburg,5909,10,5,12,19,31,61,-30,27
FC Salzburg,5910,1,23,7,6,74,27,47,76
Vienna,5910,2,21,6,9,58,37,21,69
SC Rheindorf,5910,3,18,11,7,52,40,12,65
SK Sturm Gra,5910,4,18,6,12,54,41,13,60
Rapid Vienna,5910,5,14,10,12,56,39,17,52
RZ Pellets W,5910,6,9,12,15,39,52,-13,39
St. Pölten,5910,7,9,10,17,39,57,-18,37
Admira Wacke,5910,8,9,8,19,34,62,-28,35
Mattersburg,5910,9,8,10,18,33,55,-22,34
SV Josko Rie,5910,10,8,6,22,27,56,-29,30
FC Salzburg,5911,1,21,10,5,68,32,36,73
SK Sturm Gra,5911,2,18,7,11,56,36,20,61
SC Rheindorf,5911,3,16,10,10,50,47,3,58
Rapid Vienna,5911,4,15,11,10,63,40,23,56
Vienna,5911,5,16,7,13,58,53,5,55
RZ Pellets W,5911,6,11,8,17,47,63,-16,41
Mattersburg,5911,7,11,7,18,46,59,-13,40
Admira Wacke,5911,8,11,7,18,36,59,-23,40
St. Pölten,5911,9,9,11,16,50,65,-15,38
SV Josko Rie,5911,10,9,8,19,32,52,-20,35
FC Salzburg,5912,1,22,8,6,70,28,42,74
SK Sturm Gra,5912,2,19,6,11,59,38,21,63
SC Rheindorf,5912,3,17,9,10,55,46,9,60
Vienna,5912,4,18,5,13,67,54,13,59
Rapid Vienna,5912,5,14,11,11,55,44,11,53
Admira Wacke,5912,6,14,5,17,39,52,-13,47
Mattersburg,5912,7,12,8,16,44,55,-11,44
RZ Pellets W,5912,8,9,11,16,40,57,-17,38
SV Josko Rie,5912,9,10,5,21,34,60,-26,35
St. Pölten,5912,10,6,10,20,37,66,-29,28
FC Salzburg,5913,1,19,9,8,63,37,26,66
Vienna,5913,2,19,6,11,58,47,11,63
SK Sturm Gra,5913,3,18,8,10,59,37,22,62
SC Rheindorf,5913,4,17,8,11,56,46,10,59
Rapid Vienna,5913,5,13,14,9,54,34,20,53
SV Josko Rie,5913,6,13,6,17,38,47,-9,45
RZ Pellets W,5913,7,10,11,15,41,50,-9,41
Admira Wacke,5913,8,10,10,16,37,60,-23,40
Mattersburg,5913,9,9,7,20,31,51,-20,34
St. Pölten,5913,10,8,9,19,41,69,-28,33
SK Sturm Gra,5914,1,20,6,10,60,32,28,66
FC Salzburg,5914,2,18,11,7,62,30,32,65
SC Rheindorf,5914,3,18,9,9,52,40,12,63
Vienna,5914,4,16,10,10,62,55,7,58
Rapid Vienna,5914,5,15,11,10,55,41,14,56
RZ Pellets W,5914,6,12,8,16,46,56,-10,44
SV Josko Rie,5914,7,12,8,16,42,52,-10,44
Admira Wacke,5914,8,10,7,19,33,60,-27,37
Mattersburg,5914,9,8,9,19,38,59,-21,33
St. Pölten,5914,10,6,11,19,42,67,-25,29
FC Salzburg,5915,1,21,7,8,68,37,31,70
SK Sturm Gra,5915,2,19,9,8,61,30,31,66
Vienna,5915,3,19,4,13,60,48,12,61
SC Rheindorf,5915,4,17,7,12,49,47,2,58
Rapid Vienna,5915,5,15,10,11,58,41,17,55
RZ Pellets W,5915,6,13,8,15,47,54,-7,47
Mattersburg,5915,7,10,10,16,45,56,-11,40
SV Josko Rie,5915,8,10,9,17,35,54,-19,39
Admira Wacke,5915,9,10,6,20,37,64,-27,36
St. Pölten,5915,10,6,10,20,37,66,-29,28
FC Salzburg,5916,1,24,6,6,74,31,43,78
SC Rheindorf,5916,2,19,8,9,55,38,17,65
SK Sturm Gra,5916,3,19,5,12,61,32,29,62
Vienna,5916,4,17,7,12,58,50,8,58
Rapid Vienna,5916,5,14,11,11,59,45,14,53
St. Pölten,5916,6,12,7,17,51,63,-12,43
RZ Pellets W,5916,7,11,7,18,38,57,-19,40
SV Josko Rie,5916,8,10,6,20,34,60,-26,36
Mattersburg,5916,9,9,8,19,43,62,-19,35
Admira Wacke,5916,10,9,7,20,34,69,-35,34
FC Salzburg,5917,1,24,7,5,77,23,54,79
SC Rheindorf,5917,2,21,6,9,60,39,21,69
SK Sturm Gra,5917,3,19,7,10,59,41,18,64
Rapid Vienna,5917,4,15,11,10,54,38,16,56
Vienna,5917,5,16,6,14,55,54,1,54
RZ Pellets W,5917,6,14,7,15,49,51,-2,49
SV Josko Rie,5917,7,12,4,20,32,53,-21,40
Admira Wacke,5917,8,9,8,19,36,62,-26,35
St. Pölten,5917,9,7,10,19,41,68,-27,31
Mattersburg,5917,10,6,8,22,30,64,-34,26
FC Salzburg,5918,1,23,4,9,70,37,33,73
SC Rheindorf,5918,2,22,7,7,60,42,18,73
SK Sturm Gra,5918,3,20,5,11,64,38,26,65
Vienna,5918,4,17,4,15,63,55,8,55
Rapid Vienna,5918,5,11,13,12,56,45,11,46
Admira Wacke,5918,6,13,6,17,43,65,-22,45
SV Josko Rie,5918,7,12,4,20,32,52,-20,40
St. Pölten,5918,8,10,9,17,51,68,-17,39
RZ Pellets W,5918,9,9,8,19,45,62,-17,35
Mattersburg,5918,10,9,8,19,40,60,-20,35
FC Salzburg,5919,1,22,6,8,64,31,33,72
Vienna,5919,2,20,4,12,65,47,18,64
SC Rheindorf,5919,3,19,5,12,54,46,8,62
SK Sturm Gra,5919,4,17,7,12,53,42,11,58
Rapid Vienna,5919,5,14,9,13,54,38,16,51
RZ Pellets W,5919,6,13,7,16,45,56,-11,46
Admira Wacke,5919,7,11,9,16,32,51,-19,42
Mattersburg,5919,8,11,8,17,45,51,-6,41
SV Josko Rie,5919,9,11,7,18,32,52,-20,40
St. Pölten,5919,10,6,10,20,41,71,-30,28
SK Sturm Gra,5920,1,21,7,8,62,33,29,70
SC Rheindorf,5920,2,21,6,9,61,46,15,69
FC Salzburg,5920,3,18,11,7,58,31,27,65
Vienna,5920,4,19,5,12,69,53,16,62
Rapid Vienna,5920,5,14,10,12,52,37,15,52
RZ Pellets W,5920,6,12,6,18,44,60,-16,42
Admira Wacke,5920,7,11,9,16,36,57,-21,42
Mattersburg,5920,8,11,8,17,42,55,-13,41
St. Pölten,5920,9,7,9,20,42,64,-22,30
SV Josko Rie,5920,10,8,5,23,33,63,-30,29
FC Salzburg,5921,1,22,9,5,68,31,37,75
SC Rheindorf,5921,2,19,7,10,55,37,18,64
Vienna,5921,3,20,4,12,60,50,10,64
SK Sturm Gra,5921,4,18,8,10,59,34,25,62
Rapid Vienna,5921,5,12,12,12,49,39,10,48
Mattersburg,5921,6,11,8,17,40,53,-13,41
Admira Wacke,5921,7,11,6,19,35,63,-28,39
RZ Pellets W,5921,8,10,7,19,44,63,-19,37
SV Josko Rie,5921,9,10,6,20,39,59,-20,36
St. Pölten,5921,10,8,11,17,41,61,-20,35
FC Salzburg,5922,1,21,6,9,74,31,43,69
SK Sturm Gra,5922,2,20,7,9,62,33,29,67
SC Rheindorf,5922,3,19,6,11,52,44,8,63
Vienna,5922,4,19,4,13,60,61,-1,61
Rapid Vienna,5922,5,17,8,11,60,36,24,59
RZ Pellets W,5922,6,13,7,16,46,49,-3,46
Admira Wacke,5922,7,14,4,18,41,62,-21,46
St. Pölten,5922,8,10,7,19,34,59,-25,37
SV Josko Rie,5922,9,11,3,22,35,54,-19,36
Mattersburg,5922,10,6,8,22,31,66,-35,26
FC Salzburg,5923,1,21,8,7,64,28,36,71
SC Rheindorf,5923,2,19,9,8,57,43,14,66
SK Sturm Gra,5923,3,18,9,9,52,31,21,63
Vienna,5923,4,20,3,13,69,50,19,63
Rapid Vienna,5923,5,14,11,11,57,43,14,53
RZ Pellets W,5923,6,12,10,14,51,55,-4,46
SV Josko Rie,5923,7,11,6,19,37,51,-14,39
Admira Wacke,5923,8,11,6,19,43,67,-24,39
St. Pölten,5923,9,8,9,19,39,69,-30,33
Mattersburg,5923,10,7,7,22,30,62,-32,28
FC Salzburg,5924,1,24,5,7,71,29,42,77
SK Sturm Gra,5924,2,19,9,8,59,35,24,66
SC Rheindorf,5924,3,16,11,9,55,43,12,59
Vienna,5924,4,18,2,16,59,56,3,56
RZ Pellets W,5924,5,15,5,16,45,53,-8,50
Rapid Vienna,5924,6,12,9,15,58,44,14,45
Mattersburg,5924,7,12,9,15,38,45,-7,45
SV Josko Rie,5924,8,11,5,20,36,61,-25,38
Admira Wacke,5924,9,10,6,20,34,59,-25,36
St. Pölten,5924,10,8,9,19,39,69,-30,33
FC Salzburg,5925,1,21,9,6,65,27,38,72
SC Rheindorf,5925,2,20,7,9,52,37,15,67
Vienna,5925,3,20,5,11,63,46,17,65
SK Sturm Gra,5925,4,19,7,10,58,31,27,64
Rapid Vienna,5925,5,13,12,11,55,44,11,51
Admira Wacke,5925,6,11,9,16,34,55,-21,42
St. Pölten,5925,7,10,10,16,41,59,-18,40
RZ Pellets W,5925,8,10,9,17,43,57,-14,39
Mattersburg,5925,9,8,8,20,36,59,-23,32
SV Josko Rie,5925,10,6,8,22,26,58,-32,26
FC Salzburg,5926,1,20,11,5,65,24,41,71
SC Rheindorf,5926,2,21,7,8,56,40,16,70
SK Sturm Gra,5926,3,20,6,10,63,34,29,66
Vienna,5926,4,18,6,12,63,48,15,60
Rapid Vienna,5926,5,15,13,8,54,38,16,58
Admira Wacke,5926,6,10,9,17,37,61,-24,39
Mattersburg,5926,7,10,8,18,40,56,-16,38
RZ Pellets W,5926,8,10,6,20,42,62,-20,36
St. Pölten,5926,9,9,9,18,42,66,-24,36
SV Josko Rie,5926,10,7,5,24,30,63,-33,26
FC Salzburg,5927,1,21,10,5,78,33,45,73
SC Rheindorf,5927,2,20,9,7,54,37,17,69
Vienna,5927,3,18,6,12,62,62,0,60
SK Sturm Gra,5927,4,16,8,12,54,39,15,56
RZ Pellets W,5927,5,14,6,16,42,46,-4,48
Rapid Vienna,5927,6,11,11,14,56,46,10,44
SV Josko Rie,5927,7,11,6,19,37,51,-14,39
Mattersburg,5927,8,10,8,18,32,53,-21,38
St. Pölten,5927,9,8,12,16,37,58,-21,36
Admira Wacke,5927,10,9,8,19,29,56,-27,35
FC Salzburg,5928,1,21,5,10,76,36,40,68
SK Sturm Gra,5928,2,20,7,9,63,35,28,67
SC Rheindorf,5928,3,18,7,11,51,43,8,61
Vienna,5928,4,19,3,14,61,50,11,60
Rapid Vienna,5928,5,15,8,13,61,43,18,53
RZ Pellets W,5928,6,13,8,15,47,55,-8,47
Admira Wacke,5928,7,12,5,19,35,64,-29,41
Mattersburg,5928,8,11,7,18,40,58,-18,40
SV Josko Rie,5928,9,11,7,18,32,52,-20,40
St. Pölten,5928,10,7,9,20,38,68,-30,30
SC Rheindorf,5929,1,22,8,6,58,35,23,74
SK Sturm Gra,5929,2,21,5,10,62,34,28,68
FC Salzburg,5929,3,18,11,7,63,34,29,65
Vienna,5929,4,19,5,12,67,51,16,62
RZ Pellets W,5929,5,14,9,13,52,51,1,51
Rapid Vienna,5929,6,12,11,13,45,39,6,47
Admira Wacke,5929,7,12,5,19,37,58,-21,41
SV Josko Rie,5929,8,10,5,21,31,60,-29,35
Mattersburg,5929,9,8,8,20,41,64,-23,32
St. Pölten,5929,10,6,9,21,35,65,-30,27
FC Salzburg,5930,1,21,8,7,64,28,36,71
Vienna,5930,2,21,5,10,63,46,17,68
SK Sturm Gra,5930,3,16,9,11,53,32,21,57
SC Rheindorf,5930,4,16,9,11,49,42,7,57
Rapid Vienna,5930,5,11,16,9,49,34,15,49
Admira Wacke,5930,6,13,5,18,39,59,-20,44
Mattersburg,5930,7,10,9,17,39,55,-16,39
SV Josko Rie,5930,8,10,8,18,36,55,-19,38
RZ Pellets W,5930,9,9,10,17,45,63,-18,37
St. Pölten,5930,10,8,11,17,34,57,-23,35
FC Salzburg,5931,1,22,7,7,63,31,32,73
SK Sturm Gra,5931,2,21,6,9,69,34,35,69
SC Rheindorf,5931,3,20,6,10,57,45,12,66
Vienna,5931,4,21,2,13,67,49,18,65
RZ Pellets W,5931,5,13,9,14,47,57,-10,48
SV Josko Rie,5931,6,13,7,16,44,53,-9,46
Rapid Vienna,5931,7,11,10,15,44,41,3,43
Admira Wacke,5931,8,10,5,21,33,62,-29,35
Mattersburg,5931,9,8,9,19,36,57,-21,33
St. Pölten,5931,10,4,13,19,38,69,-31,25
SC Rheindorf,5932,1,24,5,7,66,42,24,77
FC Salzburg,5932,2,22,7,7,69,35,34,73
SK Sturm Gra,5932,3,19,6,11,58,36,22,63
Vienna,5932,4,20,3,13,65,47,18,63
Rapid Vienna,5932,5,13,10,13,51,41,10,49
Admira Wacke,5932,6,13,4,19,41,65,-24,43
RZ Pellets W,5932,7,11,6,19,44,58,-14,39
SV Josko Rie,5932,8,10,5,21,34,57,-23,35
St. Pölten,5932,9,9,8,19,40,64,-24,35
Mattersburg,5932,10,7,10,19,37,60,-23,31
FC Salzburg,5933,1,22,8,6,66,30,36,74
SC Rheindorf,5933,2,20,5,11,51,45,6,65
SK Sturm Gra,5933,3,19,7,10,59,33,26,64
Vienna,5933,4,20,3,13,68,55,13,63
Rapid Vienna,5933,5,17,9,10,62,40,22,60
RZ Pellets W,5933,6,12,9,15,45,48,-3,45
Admira Wacke,5933,7,13,6,17,39,55,-16,45
SV Josko Rie,5933,8,8,7,21,31,54,-23,31
St. Pölten,5933,9,6,12,18,41,74,-33,30
Mattersburg,5933,10,5,10,21,32,60,-28,25
FC Salzburg,5934,1,21,8,7,67,34,33,71
SK Sturm Gra,5934,2,21,4,11,65,37,28,67
SC Rheindorf,5934,3,20,7,9,56,42,14,67
Vienna,5934,4,17,8,11,68,59,9,59
Rapid Vienna,5934,5,15,8,13,63,46,17,53
RZ Pellets W,5934,6,12,6,18,44,55,-11,42
Admira Wacke,5934,7,12,6,18,39,61,-22,42
SV Josko Rie,5934,8,10,7,19,35,54,-19,37
St. Pölten,5934,9,8,11,17,46,71,-25,35
Mattersburg,5934,10,6,11,19,36,60,-24,29
FC Salzburg,5935,1,21,5,10,64,37,27,68
SC Rheindorf,5935,2,20,8,8,56,39,17,68
SK Sturm Gra,5935,3,19,7,10,61,35,26,64
Vienna,5935,4,19,3,14,62,53,9,60
Rapid Vienna,5935,5,15,10,11,58,46,12,55
RZ Pellets W,5935,6,14,5,17,54,59,-5,47
Admira Wacke,5935,7,12,7,17,42,56,-14,43
Mattersburg,5935,8,8,10,18,36,57,-21,34
St. Pölten,5935,9,8,10,18,36,58,-22,34
SV Josko Rie,5935,10,9,5,22,28,57,-29,32
FC Salzburg,5936,1,25,5,6,81,29,52,80
SC Rheindorf,5936,2,19,7,10,53,39,14,64
SK Sturm Gra,5936,3,19,4,13,55,41,14,61
Vienna,5936,4,19,2,15,65,61,4,59
Rapid Vienna,5936,5,16,9,11,63,40,23,57
RZ Pellets W,5936,6,14,7,15,50,57,-7,49
Admira Wacke,5936,7,13,5,18,44,62,-18,44
SV Josko Rie,5936,8,10,7,19,36,56,-20,37
Mattersburg,5936,9,8,9,19,39,60,-21,33
St. Pölten,5936,10,5,9,22,39,80,-41,24
FC Salzburg,5937,1,22,8,6,76,34,42,74
SK Sturm Gra,5937,2,21,7,8,62,32,30,70
SC Rheindorf,5937,3,20,5,11,62,46,16,65
Vienna,5937,4,18,8,10,60,49,11,62
Rapid Vienna,5937,5,16,9,11,55,35,20,57
RZ Pellets W,5937,6,14,6,16,50,59,-9,48
Admira Wacke,5937,7,11,5,20,36,64,-28,38
SV Josko Rie,5937,8,10,5,21,30,53,-23,35
Mattersburg,5937,9,8,8,20,38,62,-24,32
St. Pölten,5937,10,5,9,22,34,69,-35,24
FC Salzburg,5938,1,24,6,6,73,33,40,78
SC Rheindorf,5938,2,23,4,9,61,43,18,73
Vienna,5938,3,18,6,12,60,46,14,60
SK Sturm Gra,5938,4,17,7,12,55,38,17,58
Rapid Vienna,5938,5,14,9,13,55,43,12,51
RZ Pellets W,5938,6,13,7,16,46,50,-4,46
Admira Wacke,5938,7,10,8,18,32,61,-29,38
Mattersburg,5938,8,9,8,19,36,58,-22,35
St. Pölten,5938,9,9,8,19,47,70,-23,35
SV Josko Rie,5938,10,8,7,21,33,56,-23,31
FC Salzburg,5939,1,21,8,7,69,33,36,71
SK Sturm Gra,5939,2,20,5,11,58,34,24,65
SC Rheindorf,5939,3,19,8,9,57,44,13,65
Vienna,5939,4,19,5,12,70,54,16,62
RZ Pellets W,5939,5,14,7,15,45,57,-12,49
Rapid Vienna,5939,6,11,12,13,51,44,7,45
SV Josko Rie,5939,7,10,8,18,35,53,-18,38
St. Pölten,5939,8,10,7,19,42,65,-23,37
Mattersburg,5939,9,8,11,17,38,52,-14,35
Admira Wacke,5939,10,10,5,21,34,63,-29,35
FC Salzburg,5940,1,21,8,7,63,28,35,71
SC Rheindorf,5940,2,20,8,8,56,44,12,68
SK Sturm Gra,5940,3,18,5,13,55,37,18,59
Admira Wacke,5940,4,15,7,14,45,55,-10,52
Vienna,5940,5,15,5,16,49,51,-2,50
RZ Pellets W,5940,6,14,6,16,49,53,-4,48
Rapid Vienna,5940,7,12,11,13,58,51,7,47
Mattersburg,5940,8,10,11,15,44,51,-7,41
SV Josko Rie,5940,9,11,7,18,35,52,-17,40
St. Pölten,5940,10,6,8,22,41,73,-32,26
SK Sturm Gra,5941,1,24,3,9,63,33,30,75
FC Salzburg,5941,2,21,7,8,74,33,41,70
SC Rheindorf,5941,3,19,7,10,56,44,12,64
Vienna,5941,4,16,3,17,57,56,1,51
Rapid Vienna,5941,5,13,11,12,59,50,9,50
Admira Wacke,5941,6,14,6,16,37,52,-15,48
RZ Pellets W,5941,7,12,8,16,46,59,-13,44
SV Josko Rie,5941,8,11,3,22,33,53,-20,36
Mattersburg,5941,9,9,8,19,34,55,-21,35
St. Pölten,5941,10,9,8,19,42,66,-24,35
FC Salzburg,5942,1,21,6,9,69,34,35,69
SK Sturm Gra,5942,2,19,8,9,73,39,34,65
SC Rheindorf,5942,3,19,8,9,64,52,12,65
Vienna,5942,4,19,4,13,71,55,16,61
Rapid Vienna,5942,5,13,12,11,53,47,6,51
RZ Pellets W,5942,6,13,8,15,43,53,-10,47
Mattersburg,5942,7,10,8,18,43,52,-9,38
SV Josko Rie,5942,8,11,4,21,35,63,-28,37
St. Pölten,5942,9,8,11,17,44,71,-27,35
Admira Wacke,5942,10,9,7,20,35,64,-29,34
FC Salzburg,5943,1,19,8,9,66,33,33,65
SK Sturm Gra,5943,2,19,8,9,65,32,33,65
Vienna,5943,3,20,5,11,64,49,15,65
SC Rheindorf,5943,4,18,10,8,52,42,10,64
Rapid Vienna,5943,5,17,10,9,63,44,19,61
RZ Pellets W,5943,6,13,6,17,44,58,-14,45
St. Pölten,5943,7,11,8,17,43,56,-13,41
Admira Wacke,5943,8,10,8,18,33,61,-28,38
SV Josko Rie,5943,9,8,6,22,32,64,-32,30
Mattersburg,5943,10,4,13,19,31,54,-23,25
FC Salzburg,5944,1,21,9,6,60,27,33,72
Vienna,5944,2,21,5,10,60,44,16,68
SK Sturm Gra,5944,3,18,7,11,55,32,23,61
SC Rheindorf,5944,4,16,9,11,45,40,5,57
Rapid Vienna,5944,5,14,10,12,55,43,12,52
RZ Pellets W,5944,6,13,7,16,45,54,-9,46
Admira Wacke,5944,7,11,9,16,39,55,-16,42
Mattersburg,5944,8,9,9,18,39,56,-17,36
St. Pölten,5944,9,8,9,19,42,64,-22,33
SV Josko Rie,5944,10,9,6,21,28,53,-25,33
FC Salzburg,5945,1,23,5,8,64,29,35,74
SC Rheindorf,5945,2,19,8,9,50,37,13,65
SK Sturm Gra,5945,3,19,7,10,57,35,22,64
Vienna,5945,4,20,4,12,62,47,15,64
Rapid Vienna,5945,5,16,10,10,56,36,20,58
RZ Pellets W,5945,6,10,9,17,41,58,-17,39
Admira Wacke,5945,7,10,8,18,34,59,-25,38
SV Josko Rie,5945,8,9,9,18,32,49,-17,36
Mattersburg,5945,9,9,7,20,38,55,-17,34
St. Pölten,5945,10,7,9,20,35,64,-29,30
FC Salzburg,5946,1,22,7,7,67,27,40,73
Vienna,5946,2,21,4,11,71,49,22,67
SK Sturm Gra,5946,3,20,6,10,56,32,24,66
SC Rheindorf,5946,4,19,8,9,57,43,14,65
Rapid Vienna,5946,5,14,10,12,48,34,14,52
RZ Pellets W,5946,6,12,4,20,44,66,-22,40
SV Josko Rie,5946,7,11,5,20,35,56,-21,38
Admira Wacke,5946,8,11,4,21,34,60,-26,37
Mattersburg,5946,9,9,8,19,36,58,-22,35
St. Pölten,5946,10,7,12,17,43,66,-23,33
SK Sturm Gra,5947,1,22,6,8,66,30,36,72
SC Rheindorf,5947,2,22,6,8,54,38,16,72
FC Salzburg,5947,3,20,7,9,67,32,35,67
Vienna,5947,4,19,5,12,69,54,15,62
RZ Pellets W,5947,5,15,10,11,53,51,2,55
Rapid Vienna,5947,6,10,11,15,50,54,-4,41
SV Josko Rie,5947,7,9,7,20,37,61,-24,34
Admira Wacke,5947,8,10,4,22,38,69,-31,34
St. Pölten,5947,9,8,9,19,42,64,-22,33
Mattersburg,5947,10,8,9,19,38,61,-23,33
SC Rheindorf,5948,1,21,9,6,63,41,22,72
SK Sturm Gra,5948,2,20,6,10,68,37,31,66
FC Salzburg,5948,3,18,9,9,62,37,25,63
Vienna,5948,4,17,8,11,60,52,8,59
Rapid Vienna,5948,5,12,14,10,54,44,10,50
St. Pölten,5948,6,12,8,16,50,67,-17,44
RZ Pellets W,5948,7,10,9,17,47,58,-11,39
Mattersburg,5948,8,10,8,18,41,56,-15,38
SV Josko Rie,5948,9,9,7,20,34,60,-26,34
Admira Wacke,5948,10,10,4,22,39,66,-27,34
SK Sturm Gra,5949,1,22,5,9,62,32,30,71
Rapid Vienna,5949,2,18,9,9,61,35,26,63
Vienna,5949,3,19,6,11,63,48,15,63
SC Rheindorf,5949,4,19,5,12,54,46,8,62
FC Salzburg,5949,5,18,5,13,58,39,19,59
RZ Pellets W,5949,6,13,9,14,47,55,-8,48
Admira Wacke,5949,7,11,6,19,35,57,-22,39
Mattersburg,5949,8,9,9,18,35,53,-18,36
SV Josko Rie,5949,9,9,6,21,34,55,-21,33
St. Pölten,5949,10,8,8,20,40,69,-29,32
FC Salzburg,5950,1,22,8,6,75,32,43,74
SC Rheindorf,5950,2,19,7,10,57,45,12,64
SK Sturm Gra,5950,3,19,5,12,61,38,23,62
Vienna,5950,4,17,6,13,61,56,5,57
Rapid Vienna,5950,5,12,12,12,55,45,10,48
Admira Wacke,5950,6,13,9,14,42,54,-12,48
RZ Pellets W,5950,7,10,10,16,47,65,-18,40
Mattersburg,5950,8,10,9,17,45,58,-13,39
SV Josko Rie,5950,9,8,9,19,31,56,-25,33
St. Pölten,5950,10,7,11,18,35,60,-25,32
FC Salzburg,5951,1,22,8,6,65,29,36,74
Vienna,5951,2,20,5,11,68,49,19,65
SC Rheindorf,5951,3,16,10,10,57,50,7,58
SK Sturm Gra,5951,4,16,8,12,55,39,16,56
Rapid Vienna,5951,5,14,12,10,58,41,17,54
Mattersburg,5951,6,11,10,15,34,45,-11,43
RZ Pellets W,5951,7,10,10,16,44,53,-9,40
SV Josko Rie,5951,8,11,5,20,33,49,-16,38
St. Pölten,5951,9,10,6,20,44,70,-26,36
Admira Wacke,5951,10,10,6,20,34,67,-33,36
FC Salzburg,5952,1,21,8,7,60,31,29,71
SK Sturm Gra,5952,2,19,6,11,59,38,21,63
Vienna,5952,3,19,4,13,63,54,9,61
SC Rheindorf,5952,4,17,9,10,48,39,9,60
Rapid Vienna,5952,5,16,9,11,54,36,18,57
Admira Wacke,5952,6,13,6,17,36,51,-15,45
RZ Pellets W,5952,7,12,8,16,36,45,-9,44
SV Josko Rie,5952,8,11,7,18,35,48,-13,40
Mattersburg,5952,9,7,11,18,32,53,-21,32
St. Pölten,5952,10,7,8,21,35,63,-28,29
FC Salzburg,5953,1,21,7,8,69,31,38,70
SC Rheindorf,5953,2,19,10,7,51,36,15,67
Vienna,5953,3,20,4,12,63,54,9,64
SK Sturm Gra,5953,4,18,8,10,55,34,21,62
Rapid Vienna,5953,5,13,12,11,54,36,18,51
St. Pölten,5953,6,10,11,15,43,59,-16,41
Admira Wacke,5953,7,12,5,19,37,61,-24,41
RZ Pellets W,5953,8,11,5,20,41,61,-20,38
SV Josko Rie,5953,9,9,7,20,30,55,-25,34
Mattersburg,5953,10,8,9,19,41,57,-16,33
FC Salzburg,5954,1,22,7,7,68,24,44,73
SK Sturm Gra,5954,2,18,7,11,50,30,20,61
Vienna,5954,3,18,6,12,60,54,6,60
SC Rheindorf,5954,4,16,6,14,50,51,-1,54
Rapid Vienna,5954,5,11,13,12,48,39,9,46
SV Josko Rie,5954,6,13,6,17,38,52,-14,45
RZ Pellets W,5954,7,12,8,16,41,47,-6,44
Admira Wacke,5954,8,12,8,16,36,53,-17,44
Mattersburg,5954,9,9,11,16,38,52,-14,38
St. Pölten,5954,10,7,12,17,35,62,-27,33
FC Salzburg,5955,1,22,6,8,68,27,41,72
SC Rheindorf,5955,2,21,5,10,54,41,13,68
SK Sturm Gra,5955,3,17,8,11,57,31,26,59
Vienna,5955,4,17,6,13,60,51,9,57
Rapid Vienna,5955,5,13,10,13,48,41,7,49
RZ Pellets W,5955,6,12,10,14,43,51,-8,46
Mattersburg,5955,7,12,7,17,39,52,-13,43
SV Josko Rie,5955,8,12,4,20,31,50,-19,40
Admira Wacke,5955,9,10,8,18,37,68,-31,38
St. Pölten,5955,10,8,8,20,40,65,-25,32
FC Salzburg,5956,1,21,8,7,72,32,40,71
SC Rheindorf,5956,2,21,6,9,53,39,14,69
Rapid Vienna,5956,3,17,10,9,64,38,26,61
SK Sturm Gra,5956,4,16,6,14,51,41,10,54
Vienna,5956,5,15,7,14,55,51,4,52
RZ Pellets W,5956,6,14,4,18,43,56,-13,46
SV Josko Rie,5956,7,11,7,18,37,54,-17,40
Admira Wacke,5956,8,11,7,18,40,61,-21,40
St. Pölten,5956,9,9,9,18,38,60,-22,36
Mattersburg,5956,10,8,10,18,31,52,-21,34
FC Salzburg,5957,1,23,5,8,68,31,37,74
SK Sturm Gra,5957,2,19,5,12,52,36,16,62
Vienna,5957,3,19,5,12,62,51,11,62
Rapid Vienna,5957,4,16,11,9,56,36,20,59
SC Rheindorf,5957,5,18,5,13,55,52,3,59
Admira Wacke,5957,6,13,6,17,40,53,-13,45
SV Josko Rie,5957,7,13,4,19,37,52,-15,43
RZ Pellets W,5957,8,11,7,18,41,54,-13,40
St. Pölten,5957,9,8,9,19,38,61,-23,33
Mattersburg,5957,10,8,7,21,33,56,-23,31
SC Rheindorf,5958,1,24,6,6,62,33,29,78
SK Sturm Gra,5958,2,20,4,12,56,35,21,64
Vienna,5958,3,20,3,13,67,54,13,63
FC Salzburg,5958,4,17,9,10,64,41,23,60
Rapid Vienna,5958,5,12,13,11,56,45,11,49
RZ Pellets W,5958,6,14,5,17,50,56,-6,47
Admira Wacke,5958,7,14,5,17,39,55,-16,47
SV Josko Rie,5958,8,10,7,19,31,51,-20,37
Mattersburg,5958,9,8,9,19,32,52,-20,33
St. Pölten,5958,10,7,7,22,39,74,-35,28
SC Rheindorf,5959,1,21,8,7,57,37,20,71
SK Sturm Gra,5959,2,20,9,7,64,31,33,69
FC Salzburg,5959,3,21,6,9,69,38,31,69
Vienna,5959,4,17,4,15,60,54,6,55
Rapid Vienna,5959,5,14,10,12,53,38,15,52
Admira Wacke,5959,6,13,7,16,42,59,-17,46
RZ Pellets W,5959,7,11,8,17,44,57,-13,41
SV Josko Rie,5959,8,11,6,19,38,59,-21,39
Mattersburg,5959,9,8,7,21,35,61,-26,31
St. Pölten,5959,10,8,7,21,37,65,-28,31
FC Salzburg,5960,1,20,9,7,70,36,34,69
SK Sturm Gra,5960,2,19,9,8,56,29,27,66
Vienna,5960,3,19,6,11,69,52,17,63
SC Rheindorf,5960,4,17,7,12,52,45,7,58
Rapid Vienna,5960,5,13,9,14,52,44,8,48
Admira Wacke,5960,6,12,8,16,42,64,-22,44
RZ Pellets W,5960,7,11,9,16,48,61,-13,42
St. Pölten,5960,8,10,11,15,50,65,-15,41
SV Josko Rie,5960,9,11,4,21,32,50,-18,37
Mattersburg,5960,10,8,8,20,34,59,-25,32
Vienna,5961,1,21,5,10,65,44,21,68
SC Rheindorf,5961,2,20,6,10,58,46,12,66
SK Sturm Gra,5961,3,18,6,12,61,36,25,60
FC Salzburg,5961,4,16,10,10,54,32,22,58
Admira Wacke,5961,5,14,6,16,42,53,-11,48
Rapid Vienna,5961,6,11,12,13,48,42,6,45
RZ Pellets W,5961,7,12,6,18,43,63,-20,42
St. Pölten,5961,8,11,8,17,48,65,-17,41
SV Josko Rie,5961,9,12,4,20,35,56,-21,40
Mattersburg,5961,10,10,7,19,40,57,-17,37
FC Salzburg,5962,1,22,6,8,70,31,39,72
SC Rheindorf,5962,2,19,9,8,57,46,11,66
SK Sturm Gra,5962,3,20,5,11,57,40,17,65
Rapid Vienna,5962,4,15,11,10,64,36,28,56
Vienna,5962,5,17,4,15,56,55,1,55
RZ Pellets W,5962,6,14,8,14,53,55,-2,50
SV Josko Rie,5962,7,13,4,19,39,55,-16,43
Admira Wacke,5962,8,12,4,20,31,57,-26,40
Mattersburg,5962,9,8,11,17,34,48,-14,35
St. Pölten,5962,10,4,10,22,34,72,-38,22
FC Salzburg,5963,1,24,6,6,65,28,37,78
SC Rheindorf,5963,2,22,6,8,59,40,19,72
Vienna,5963,3,21,4,11,66,51,15,67
SK Sturm Gra,5963,4,18,9,9,56,32,24,63
Rapid Vienna,5963,5,12,10,14,49,42,7,46
RZ Pellets W,5963,6,11,11,14,46,52,-6,44
SV Josko Rie,5963,7,11,5,20,35,53,-18,38
Admira Wacke,5963,8,10,4,22,40,70,-30,34
St. Pölten,5963,9,7,10,19,42,65,-23,31
Mattersburg,5963,10,7,9,20,33,58,-25,30
Vienna,5964,1,21,5,10,71,48,23,68
FC Salzburg,5964,2,19,7,10,55,29,26,64
SK Sturm Gra,5964,3,18,9,9,50,30,20,63
SC Rheindorf,5964,4,19,6,11,56,46,10,63
Rapid Vienna,5964,5,16,10,10,56,36,20,58
RZ Pellets W,5964,6,13,7,16,48,55,-7,46
Admira Wacke,5964,7,12,5,19,39,58,-19,41
St. Pölten,5964,8,9,11,16,46,67,-21,38
SV Josko Rie,5964,9,9,6,21,33,55,-22,33
Mattersburg,5964,10,7,8,21,32,62,-30,29
FC Salzburg,5965,1,20,9,7,63,34,29,69
SC Rheindorf,5965,2,18,10,8,49,40,9,64
SK Sturm Gra,5965,3,18,9,9,64,37,27,63
Vienna,5965,4,19,4,13,59,47,12,61
Rapid Vienna,5965,5,16,11,9,61,33,28,59
Admira Wacke,5965,6,11,7,18,37,57,-20,40
SV Josko Rie,5965,7,11,6,19,37,53,-16,39
RZ Pellets W,5965,8,10,9,17,41,59,-18,39
Mattersburg,5965,9,8,10,18,33,51,-18,34
St. Pölten,5965,10,6,11,19,36,69,-33,29
FC Salzburg,5966,1,21,6,9,64,35,29,69
SK Sturm Gra,5966,2,21,6,9,64,37,27,69
Vienna,5966,3,18,5,13,65,50,15,59
SC Rheindorf,5966,4,17,7,12,58,56,2,58
Rapid Vienna,5966,5,13,12,11,59,41,18,51
SV Josko Rie,5966,6,14,4,18,42,52,-10,46
Admira Wacke,5966,7,13,7,16,43,60,-17,46
RZ Pellets W,5966,8,11,8,17,46,58,-12,41
Mattersburg,5966,9,9,8,19,39,59,-20,35
St. Pölten,5966,10,7,9,20,36,68,-32,30
Vienna,5967,1,22,4,10,60,42,18,70
SK Sturm Gra,5967,2,21,6,9,64,33,31,69
FC Salzburg,5967,3,20,7,9,65,37,28,67
SC Rheindorf,5967,4,19,7,10,56,42,14,64
Rapid Vienna,5967,5,13,12,11,56,42,14,51
Admira Wacke,5967,6,13,5,18,38,62,-24,44
RZ Pellets W,5967,7,10,8,18,44,59,-15,38
SV Josko Rie,5967,8,10,7,19,36,55,-19,37
St. Pölten,5967,9,6,13,17,46,72,-26,31
Mattersburg,5967,10,6,11,19,33,54,-21,29
SC Rheindorf,5968,1,18,11,7,56,41,15,65
FC Salzburg,5968,2,19,7,10,65,34,31,64
Vienna,5968,3,20,3,13,67,56,11,63
RZ Pellets W,5968,4,17,5,14,53,56,-3,56
SK Sturm Gra,5968,5,17,4,15,57,48,9,55
Admira Wacke,5968,6,15,6,15,42,56,-14,51
Rapid Vienna,5968,7,12,11,13,55,42,13,47
Mattersburg,5968,8,10,7,19,40,58,-18,37
SV Josko Rie,5968,9,9,7,20,35,60,-25,34
St. Pölten,5968,10,7,11,18,46,65,-19,32
SC Rheindorf,5969,1,21,10,5,61,35,26,73
FC Salzburg,5969,2,20,9,7,75,41,34,69
SK Sturm Gra,5969,3,17,7,12,55,33,22,58
Rapid Vienna,5969,4,15,12,9,59,38,21,57
Vienna,5969,5,17,4,15,60,55,5,55
RZ Pellets W,5969,6,14,7,15,44,51,-7,49
Admira Wacke,5969,7,11,8,17,37,63,-26,41
Mattersburg,5969,8,10,8,18,38,53,-15,38
SV Josko Rie,5969,9,10,4,22,36,64,-28,34
St. Pölten,5969,10,7,7,22,36,68,-32,28
FC Salzburg,5970,1,25,7,4,74,25,49,82
SC Rheindorf,5970,2,21,6,9,57,40,17,69
SK Sturm Gra,5970,3,19,6,11,63,36,27,63
Vienna,5970,4,17,5,14,56,51,5,56
Rapid Vienna,5970,5,15,10,11,56,41,15,55
RZ Pellets W,5970,6,14,5,17,54,60,-6,47
SV Josko Rie,5970,7,13,3,20,38,52,-14,42
Admira Wacke,5970,8,10,7,19,31,58,-27,37
St. Pölten,5970,9,6,10,20,36,73,-37,28
Mattersburg,5970,10,6,9,21,37,66,-29,27
FC Salzburg,5971,1,24,6,6,71,27,44,78
Vienna,5971,2,20,4,12,66,51,15,64
SK Sturm Gra,5971,3,18,8,10,55,31,24,62
Rapid Vienna,5971,4,15,11,10,56,34,22,56
SC Rheindorf,5971,5,17,5,14,51,47,4,56
Admira Wacke,5971,6,13,7,16,37,55,-18,46
RZ Pellets W,5971,7,12,7,17,39,62,-23,43
SV Josko Rie,5971,8,11,5,20,33,51,-18,38
Mattersburg,5971,9,7,11,18,38,59,-21,32
St. Pölten,5971,10,7,8,21,41,70,-29,29
Vienna,5972,1,20,6,10,69,48,21,66
SK Sturm Gra,5972,2,18,10,8,60,35,25,64
FC Salzburg,5972,3,19,5,12,61,38,23,62
SC Rheindorf,5972,4,18,8,10,52,49,3,62
Rapid Vienna,5972,5,16,10,10,52,34,18,58
RZ Pellets W,5972,6,14,8,14,47,51,-4,50
SV Josko Rie,5972,7,12,5,19,35,50,-15,41
Mattersburg,5972,8,10,8,18,42,56,-14,38
Admira Wacke,5972,9,9,5,22,28,59,-31,32
St. Pölten,5972,10,7,9,20,35,61,-26,30
Vienna,5973,1,23,4,9,68,43,25,73
SK Sturm Gra,5973,2,22,4,10,66,34,32,70
FC Salzburg,5973,3,19,10,7,60,35,25,67
SC Rheindorf,5973,4,20,4,12,56,49,7,64
Rapid Vienna,5973,5,12,13,11,55,42,13,49
St. Pölten,5973,6,10,11,15,42,60,-18,41
Admira Wacke,5973,7,12,5,19,35,62,-27,41
RZ Pellets W,5973,8,10,9,17,43,54,-11,39
Mattersburg,5973,9,7,11,18,34,52,-18,32
SV Josko Rie,5973,10,7,5,24,34,62,-28,26
FC Salzburg,5974,1,20,8,8,63,32,31,68
SK Sturm Gra,5974,2,19,10,7,58,30,28,67
Vienna,5974,3,20,5,11,66,52,14,65
SC Rheindorf,5974,4,17,11,8,52,41,11,62
RZ Pellets W,5974,5,13,8,15,48,52,-4,47
Rapid Vienna,5974,6,12,10,14,54,44,10,46
Admira Wacke,5974,7,12,9,15,40,60,-20,45
St. Pölten,5974,8,9,11,16,41,55,-14,38
SV Josko Rie,5974,9,10,6,20,37,59,-22,36
Mattersburg,5974,10,5,8,23,31,65,-34,23
FC Salzburg,5975,1,23,5,8,73,37,36,74
SK Sturm Gra,5975,2,20,6,10,66,36,30,66
RZ Pellets W,5975,3,17,8,11,55,46,9,59
SC Rheindorf,5975,4,17,8,11,53,44,9,59
Vienna,5975,5,18,3,15,53,51,2,57
Rapid Vienna,5975,6,15,8,13,64,48,16,53
Admira Wacke,5975,7,11,7,18,37,60,-23,40
Mattersburg,5975,8,9,10,17,43,63,-20,37
SV Josko Rie,5975,9,8,6,22,31,60,-29,30
St. Pölten,5975,10,7,9,20,42,72,-30,30
SC Rheindorf,5976,1,21,4,11,56,42,14,67
FC Salzburg,5976,2,20,6,10,63,35,28,66
SK Sturm Gra,5976,3,18,7,11,60,33,27,61
Vienna,5976,4,17,5,14,60,51,9,56
RZ Pellets W,5976,5,15,6,15,45,51,-6,51
Admira Wacke,5976,6,14,6,16,35,58,-23,48
Rapid Vienna,5976,7,12,10,14,58,46,12,46
SV Josko Rie,5976,8,12,7,17,35,49,-14,43
Mattersburg,5976,9,8,10,18,36,58,-22,34
St. Pölten,5976,10,8,9,19,36,61,-25,33
FC Salzburg,5977,1,22,7,7,62,25,37,73
SK Sturm Gra,5977,2,20,5,11,65,31,34,65
SC Rheindorf,5977,3,18,8,10,55,38,17,62
Vienna,5977,4,17,6,13,66,60,6,57
Rapid Vienna,5977,5,15,11,10,62,43,19,56
RZ Pellets W,5977,6,13,8,15,48,56,-8,47
St. Pölten,5977,7,13,7,16,47,60,-13,46
Admira Wacke,5977,8,11,5,20,40,63,-23,38
SV Josko Rie,5977,9,11,4,21,35,64,-29,37
Mattersburg,5977,10,5,9,22,33,73,-40,24
FC Salzburg,5978,1,22,9,5,65,30,35,75
SC Rheindorf,5978,2,22,5,9,58,35,23,71
SK Sturm Gra,5978,3,17,9,10,53,34,19,60
Vienna,5978,4,17,7,12,56,53,3,58
Rapid Vienna,5978,5,16,9,11,68,42,26,57
Admira Wacke,5978,6,15,6,15,40,50,-10,51
RZ Pellets W,5978,7,11,8,17,42,52,-10,41
Mattersburg,5978,8,8,9,19,31,53,-22,33
St. Pölten,5978,9,9,6,21,38,70,-32,33
SV Josko Rie,5978,10,7,4,25,33,65,-32,25
FC Salzburg,5979,1,24,5,7,75,33,42,77
SC Rheindorf,5979,2,20,9,7,55,38,17,69
SK Sturm Gra,5979,3,20,5,11,62,39,23,65
Vienna,5979,4,16,7,13,58,56,2,55
Rapid Vienna,5979,5,14,11,11,63,44,19,53
RZ Pellets W,5979,6,11,7,18,41,58,-17,40
Admira Wacke,5979,7,12,4,20,38,61,-23,40
SV Josko Rie,5979,8,12,3,21,32,59,-27,39
St. Pölten,5979,9,8,10,18,42,60,-18,34
Mattersburg,5979,10,9,7,20,40,58,-18,34
FC Salzburg,5980,1,21,8,7,77,30,47,71
SC Rheindorf,5980,2,21,6,9,55,44,11,69
Vienna,5980,3,19,8,9,71,45,26,65
SK Sturm Gra,5980,4,16,6,14,57,41,16,54
Rapid Vienna,5980,5,13,12,11,52,42,10,51
RZ Pellets W,5980,6,11,9,16,49,61,-12,42
Mattersburg,5980,7,10,9,17,38,58,-20,39
St. Pölten,5980,8,10,8,18,42,61,-19,38
Admira Wacke,5980,9,11,5,20,42,72,-30,38
SV Josko Rie,5980,10,10,5,21,31,60,-29,35
FC Salzburg,5981,1,21,7,8,67,33,34,70
SK Sturm Gra,5981,2,17,9,10,54,34,20,60
SC Rheindorf,5981,3,16,10,10,47,45,2,58
Rapid Vienna,5981,4,15,9,12,59,41,18,54
Vienna,5981,5,16,6,14,60,56,4,54
RZ Pellets W,5981,6,15,8,13,52,56,-4,53
SV Josko Rie,5981,7,12,6,18,38,48,-10,42
Admira Wacke,5981,8,11,9,16,42,62,-20,42
Mattersburg,5981,9,8,9,19,38,58,-20,33
St. Pölten,5981,10,7,11,18,36,60,-24,32
FC Salzburg,5982,1,21,8,7,71,30,41,71
SK Sturm Gra,5982,2,21,7,8,59,27,32,70
SC Rheindorf,5982,3,20,6,10,61,47,14,66
Vienna,5982,4,16,7,13,55,52,3,55
Admira Wacke,5982,5,14,7,15,35,49,-14,49
Rapid Vienna,5982,6,11,12,13,47,38,9,45
SV Josko Rie,5982,7,12,3,21,31,55,-24,39
RZ Pellets W,5982,8,10,8,18,40,60,-20,38
Mattersburg,5982,9,9,9,18,37,55,-18,36
St. Pölten,5982,10,9,7,20,44,67,-23,34
FC Salzburg,5983,1,22,5,9,68,28,40,71
SK Sturm Gra,5983,2,20,8,8,64,33,31,68
SC Rheindorf,5983,3,20,8,8,58,41,17,68
Vienna,5983,4,16,8,12,57,51,6,56
Rapid Vienna,5983,5,12,14,10,59,43,16,50
RZ Pellets W,5983,6,13,8,15,45,53,-8,47
Admira Wacke,5983,7,12,6,18,34,59,-25,42
St. Pölten,5983,8,8,11,17,47,70,-23,35
SV Josko Rie,5983,9,10,5,21,37,62,-25,35
Mattersburg,5983,10,6,9,21,30,59,-29,27
FC Salzburg,5984,1,20,7,9,62,35,27,67
SC Rheindorf,5984,2,17,8,11,52,48,4,59
SK Sturm Gra,5984,3,16,10,10,58,37,21,58
RZ Pellets W,5984,4,16,8,12,63,52,11,56
Vienna,5984,5,17,5,14,54,58,-4,56
Rapid Vienna,5984,6,14,11,11,65,50,15,53
Admira Wacke,5984,7,13,6,17,41,58,-17,45
Mattersburg,5984,8,9,9,18,42,59,-17,36
SV Josko Rie,5984,9,10,5,21,28,49,-21,35
St. Pölten,5984,10,6,15,15,45,64,-19,33
Vienna,5985,1,22,3,11,68,50,18,69
FC Salzburg,5985,2,20,7,9,59,31,28,67
SK Sturm Gra,5985,3,20,5,11,62,35,27,65
SC Rheindorf,5985,4,17,9,10,50,44,6,60
Rapid Vienna,5985,5,15,11,10,53,35,18,56
RZ Pellets W,5985,6,12,9,15,44,51,-7,45
SV Josko Rie,5985,7,11,8,17,35,51,-16,41
Admira Wacke,5985,8,11,7,18,46,65,-19,40
Mattersburg,5985,9,7,10,19,38,60,-22,31
St. Pölten,5985,10,7,7,22,40,73,-33,28
FC Salzburg,5986,1,22,7,7,67,30,37,73
Vienna,5986,2,21,5,10,67,44,23,68
SK Sturm Gra,5986,3,19,7,10,59,34,25,64
SC Rheindorf,5986,4,18,7,11,52,44,8,61
Rapid Vienna,5986,5,12,11,13,53,48,5,47
RZ Pellets W,5986,6,13,7,16,48,61,-13,46
SV Josko Rie,5986,7,13,5,18,39,49,-10,44
Mattersburg,5986,8,10,6,20,39,58,-19,36
Admira Wacke,5986,9,9,7,20,34,65,-31,34
St. Pölten,5986,10,7,10,19,44,69,-25,31
SK Sturm Gra,5987,1,19,9,8,62,37,25,66
FC Salzburg,5987,2,18,11,7,60,32,28,65
SC Rheindorf,5987,3,19,8,9,64,49,15,65
Vienna,5987,4,17,9,10,70,55,15,60
Rapid Vienna,5987,5,12,9,15,50,48,2,45
Admira Wacke,5987,6,12,8,16,43,59,-16,44
SV Josko Rie,5987,7,12,6,18,33,47,-14,42
RZ Pellets W,5987,8,11,6,19,52,64,-12,39
Mattersburg,5987,9,10,9,17,37,56,-19,39
St. Pölten,5987,10,9,7,20,45,69,-24,34
FC Salzburg,5988,1,21,6,9,66,39,27,69
SC Rheindorf,5988,2,20,5,11,58,42,16,65
Vienna,5988,3,20,4,12,65,49,16,64
SK Sturm Gra,5988,4,18,7,11,60,42,18,61
RZ Pellets W,5988,5,15,7,14,52,47,5,52
Rapid Vienna,5988,6,13,10,13,54,39,15,49
SV Josko Rie,5988,7,13,5,18,36,53,-17,44
Admira Wacke,5988,8,13,5,18,41,66,-25,44
St. Pölten,5988,9,8,9,19,37,63,-26,33
Mattersburg,5988,10,7,6,23,33,62,-29,27
FC Salzburg,5989,1,23,7,6,73,33,40,76
SC Rheindorf,5989,2,19,8,9,51,38,13,65
SK Sturm Gra,5989,3,18,8,10,54,33,21,62
Vienna,5989,4,17,6,13,56,51,5,57
RZ Pellets W,5989,5,15,5,16,45,51,-6,50
Mattersburg,5989,6,12,10,14,46,48,-2,46
Rapid Vienna,5989,7,11,10,15,58,53,5,43
Admira Wacke,5989,8,11,6,19,37,61,-24,39
SV Josko Rie,5989,9,9,8,19,34,55,-21,35
St. Pölten,5989,10,7,8,21,33,64,-31,29
SC Rheindorf,5990,1,20,9,7,49,35,14,69
SK Sturm Gra,5990,2,20,7,9,56,35,21,67
FC Salzburg,5990,3,20,4,12,71,40,31,64
Rapid Vienna,5990,4,17,10,9,62,34,28,61
Vienna,5990,5,18,4,14,55,51,4,58
RZ Pellets W,5990,6,13,8,15,46,52,-6,47
Admira Wacke,5990,7,12,4,20,36,63,-27,40
Mattersburg,5990,8,11,6,19,45,57,-12,39
St. Pölten,5990,9,8,9,19,36,63,-27,33
SV Josko Rie,5990,10,9,3,24,28,54,-26,30
SC Rheindorf,5991,1,23,6,7,61,33,28,75
FC Salzburg,5991,2,22,7,7,67,30,37,73
SK Sturm Gra,5991,3,22,7,7,67,36,31,73
Vienna,5991,4,20,4,12,63,50,13,64
Rapid Vienna,5991,5,12,13,11,57,46,11,49
RZ Pellets W,5991,6,11,6,19,41,61,-20,39
Admira Wacke,5991,7,9,7,20,29,53,-24,34
St. Pölten,5991,8,7,11,18,43,64,-21,32
Mattersburg,5991,9,8,8,20,33,58,-25,32
SV Josko Rie,5991,10,8,7,21,26,56,-30,31
Vienna,5992,1,20,6,10,70,47,23,66
SC Rheindorf,5992,2,20,6,10,56,41,15,66
Rapid Vienna,5992,3,17,10,9,59,39,20,61
FC Salzburg,5992,4,16,10,10,64,45,19,58
SK Sturm Gra,5992,5,15,7,14,53,41,12,52
RZ Pellets W,5992,6,14,10,12,50,50,0,52
Admira Wacke,5992,7,12,5,19,43,65,-22,41
Mattersburg,5992,8,8,12,16,37,53,-16,36
SV Josko Rie,5992,9,9,8,19,39,61,-22,35
St. Pölten,5992,10,7,10,19,34,63,-29,31
FC Salzburg,5993,1,18,10,8,58,27,31,64
SK Sturm Gra,5993,2,20,4,12,61,34,27,64
Vienna,5993,3,19,4,13,64,53,11,61
SC Rheindorf,5993,4,17,9,10,50,48,2,60
Rapid Vienna,5993,5,15,11,10,59,40,19,56
Admira Wacke,5993,6,13,9,14,46,54,-8,48
RZ Pellets W,5993,7,13,6,17,50,58,-8,45
SV Josko Rie,5993,8,13,3,20,40,59,-19,42
St. Pölten,5993,9,9,7,20,33,65,-32,34
Mattersburg,5993,10,7,9,20,28,51,-23,30
SK Sturm Gra,5994,1,21,7,8,64,32,32,70
FC Salzburg,5994,2,19,8,9,62,32,30,65
SC Rheindorf,5994,3,20,5,11,52,40,12,65
Vienna,5994,4,20,2,14,64,57,7,62
Rapid Vienna,5994,5,13,13,10,54,39,15,52
Admira Wacke,5994,6,13,7,16,43,55,-12,46
RZ Pellets W,5994,7,12,9,15,42,52,-10,45
Mattersburg,5994,8,10,7,19,37,58,-21,37
SV Josko Rie,5994,9,10,6,20,34,55,-21,36
St. Pölten,5994,10,6,8,22,32,64,-32,26
FC Salzburg,5995,1,21,8,7,68,30,38,71
SC Rheindorf,5995,2,20,9,7,60,47,13,69
SK Sturm Gra,5995,3,19,8,9,64,32,32,65
Vienna,5995,4,16,8,12,57,53,4,56
Rapid Vienna,5995,5,13,9,14,49,41,8,48
SV Josko Rie,5995,6,12,6,18,35,49,-14,42
RZ Pellets W,5995,7,11,7,18,41,54,-13,40
Admira Wacke,5995,8,11,5,20,32,59,-27,38
Mattersburg,5995,9,8,12,16,37,56,-19,36
St. Pölten,5995,10,8,10,18,40,62,-22,34
FC Salzburg,5996,1,23,6,7,64,30,34,75
SC Rheindorf,5996,2,20,6,10,54,40,14,66
Vienna,5996,3,19,6,11,61,47,14,63
SK Sturm Gra,5996,4,19,4,13,62,37,25,61
Rapid Vienna,5996,5,13,11,12,60,45,15,50
Admira Wacke,5996,6,13,9,14,40,57,-17,48
RZ Pellets W,5996,7,11,10,15,44,54,-10,43
St. Pölten,5996,8,8,11,17,38,63,-25,35
SV Josko Rie,5996,9,9,5,22,33,56,-23,32
Mattersburg,5996,10,7,8,21,34,61,-27,29
FC Salzburg,5997,1,21,9,6,67,24,43,72
SC Rheindorf,5997,2,21,8,7,58,37,21,71
Vienna,5997,3,19,5,12,63,55,8,62
SK Sturm Gra,5997,4,17,6,13,62,48,14,57
Rapid Vienna,5997,5,14,13,9,64,40,24,55
Admira Wacke,5997,6,12,5,19,36,53,-17,41
RZ Pellets W,5997,7,12,5,19,45,63,-18,41
SV Josko Rie,5997,8,11,4,21,37,58,-21,37
St. Pölten,5997,9,10,7,19,40,68,-28,37
Mattersburg,5997,10,7,10,19,33,59,-26,31
SC Rheindorf,5998,1,24,4,8,57,36,21,76
FC Salzburg,5998,2,21,8,7,69,31,38,71
SK Sturm Gra,5998,3,20,6,10,60,37,23,66
Vienna,5998,4,20,5,11,68,53,15,65
Rapid Vienna,5998,5,15,9,12,61,42,19,54
RZ Pellets W,5998,6,14,6,16,51,57,-6,48
Mattersburg,5998,7,10,7,19,39,54,-15,37
SV Josko Rie,5998,8,10,6,20,37,63,-26,36
Admira Wacke,5998,9,9,3,24,28,62,-34,30
St. Pölten,5998,10,6,8,22,39,74,-35,26
SC Rheindorf,5999,1,21,6,9,54,42,12,69
Vienna,5999,2,20,6,10,65,50,15,66
FC Salzburg,5999,3,18,11,7,56,28,28,65
SK Sturm Gra,5999,4,19,6,11,62,35,27,63
Rapid Vienna,5999,5,13,11,12,55,41,14,50
Admira Wacke,5999,6,14,6,16,41,52,-11,48
RZ Pellets W,5999,7,11,6,19,39,57,-18,39
Mattersburg,5999,8,9,9,18,34,53,-19,36
SV Josko Rie,5999,9,10,6,20,30,52,-22,36
St. Pölten,5999,10,7,9,20,41,67,-26,30
FC Salzburg,6000,1,22,8,6,72,30,42,74
SC Rheindorf,6000,2,22,6,8,67,40,27,72
SK Sturm Gra,6000,3,20,9,7,64,30,34,69
Vienna,6000,4,16,6,14,60,60,0,54
Rapid Vienna,6000,5,13,10,13,55,45,10,49
Admira Wacke,6000,6,12,6,18,41,61,-20,42
SV Josko Rie,6000,7,13,2,21,44,61,-17,41
Mattersburg,6000,8,10,7,19,39,55,-16,37
RZ Pellets W,6000,9,10,5,21,42,70,-28,35
St. Pölten,6000,10,7,11,18,38,70,-32,32
FC Salzburg,6001,1,17,13,6,59,29,30,64
Vienna,6001,2,17,8,11,60,50,10,59
SK Sturm Gra,6001,3,16,9,11,58,37,21,57
SC Rheindorf,6001,4,16,7,13,49,46,3,55
Rapid Vienna,6001,5,13,12,11,50,38,12,51
RZ Pellets W,6001,6,13,6,17,44,59,-15,45
Mattersburg,6001,7,12,8,16,44,51,-7,44
St. Pölten,6001,8,10,11,15,41,60,-19,41
SV Josko Rie,6001,9,10,9,17,40,54,-14,39
Admira Wacke,6001,10,10,9,17,40,61,-21,39
FC Salzburg,6002,1,23,8,5,75,37,38,77
SK Sturm Gra,6002,2,21,8,7,77,35,42,71
Vienna,6002,3,19,5,12,66,55,11,62
SC Rheindorf,6002,4,17,9,10,52,48,4,60
Rapid Vienna,6002,5,13,9,14,56,46,10,48
RZ Pellets W,6002,6,12,10,14,43,50,-7,46
St. Pölten,6002,7,8,13,15,44,61,-17,37
Admira Wacke,6002,8,9,7,20,36,63,-27,34
Mattersburg,6002,9,8,8,20,39,61,-22,32
SV Josko Rie,6002,10,9,5,22,35,67,-32,32
FC Salzburg,6003,1,21,8,7,70,30,40,71
Vienna,6003,2,20,5,11,59,48,11,65
SK Sturm Gra,6003,3,19,7,10,53,36,17,64
SC Rheindorf,6003,4,17,8,11,49,41,8,59
Rapid Vienna,6003,5,14,12,10,52,34,18,54
RZ Pellets W,6003,6,12,9,15,48,55,-7,45
Admira Wacke,6003,7,10,10,16,27,51,-24,40
SV Josko Rie,6003,8,11,2,23,30,56,-26,35
St. Pölten,6003,9,7,12,17,44,58,-14,33
Mattersburg,6003,10,8,9,19,36,59,-23,33
SC Rheindorf,6004,1,20,10,6,59,36,23,70
FC Salzburg,6004,2,19,7,10,64,36,28,64
SK Sturm Gra,6004,3,17,8,11,56,36,20,59
Rapid Vienna,6004,4,15,12,9,58,35,23,57
Vienna,6004,5,15,6,15,62,65,-3,51
Admira Wacke,6004,6,14,6,16,40,50,-10,48
RZ Pellets W,6004,7,12,7,17,46,62,-16,43
SV Josko Rie,6004,8,11,5,20,39,58,-19,38
Mattersburg,6004,9,9,9,18,37,61,-24,36
St. Pölten,6004,10,8,10,18,35,57,-22,34
SC Rheindorf,6005,1,20,9,7,52,34,18,69
FC Salzburg,6005,2,19,11,6,62,30,32,68
SK Sturm Gra,6005,3,19,9,8,59,30,29,66
Rapid Vienna,6005,4,15,9,12,55,38,17,54
Vienna,6005,5,16,5,15,59,57,2,53
RZ Pellets W,6005,6,11,11,14,36,44,-8,44
Admira Wacke,6005,7,12,6,18,34,56,-22,42
Mattersburg,6005,8,9,11,16,34,47,-13,38
St. Pölten,6005,9,8,10,18,38,62,-24,34
SV Josko Rie,6005,10,8,5,23,28,59,-31,29
SK Sturm Gra,6006,1,23,6,7,67,33,34,75
FC Salzburg,6006,2,17,9,10,61,37,24,60
Vienna,6006,3,17,6,13,63,54,9,57
SC Rheindorf,6006,4,16,8,12,55,47,8,56
Rapid Vienna,6006,5,11,13,12,55,45,10,46
RZ Pellets W,6006,6,12,9,15,50,61,-11,45
Admira Wacke,6006,7,12,8,16,41,64,-23,44
SV Josko Rie,6006,8,13,4,19,38,57,-19,43
St. Pölten,6006,9,10,11,15,53,63,-10,41
Mattersburg,6006,10,8,8,20,36,58,-22,32
FC Salzburg,6007,1,23,6,7,67,28,39,75
SK Sturm Gra,6007,2,21,6,9,56,31,25,69
Vienna,6007,3,18,6,12,58,45,13,60
SC Rheindorf,6007,4,16,9,11,51,50,1,57
Rapid Vienna,6007,5,15,10,11,61,43,18,55
Admira Wacke,6007,6,12,7,17,37,60,-23,43
St. Pölten,6007,7,11,7,18,46,63,-17,40
RZ Pellets W,6007,8,10,7,19,45,55,-10,37
SV Josko Rie,6007,9,10,7,19,35,59,-24,37
Mattersburg,6007,10,7,9,20,37,59,-22,30
FC Salzburg,6008,1,21,7,8,61,31,30,70
Rapid Vienna,6008,2,18,10,8,65,35,30,64
SC Rheindorf,6008,3,18,8,10,52,40,12,62
SK Sturm Gra,6008,4,16,9,11,52,32,20,57
Vienna,6008,5,15,8,13,56,53,3,53
RZ Pellets W,6008,6,12,10,14,44,54,-10,46
SV Josko Rie,6008,7,13,5,18,34,44,-10,44
Admira Wacke,6008,8,10,10,16,38,59,-21,40
Mattersburg,6008,9,8,9,19,34,51,-17,33
St. Pölten,6008,10,7,8,21,34,71,-37,29
SC Rheindorf,6009,1,21,7,8,51,33,18,70
SK Sturm Gra,6009,2,21,5,10,67,37,30,68
Vienna,6009,3,20,4,12,64,50,14,64
FC Salzburg,6009,4,17,8,11,54,34,20,59
Rapid Vienna,6009,5,13,11,12,56,44,12,50
RZ Pellets W,6009,6,12,8,16,49,51,-2,44
Admira Wacke,6009,7,13,5,18,38,54,-16,44
SV Josko Rie,6009,8,10,8,18,36,57,-21,38
St. Pölten,6009,9,8,9,19,39,69,-30,33
Mattersburg,6009,10,7,11,18,31,56,-25,32
SC Rheindorf,6010,1,24,6,6,60,34,26,78
FC Salzburg,6010,2,22,5,9,67,31,36,71
SK Sturm Gra,6010,3,21,6,9,56,29,27,69
Vienna,6010,4,19,5,12,62,51,11,62
Rapid Vienna,6010,5,14,8,14,51,45,6,50
RZ Pellets W,6010,6,11,7,18,42,59,-17,40
SV Josko Rie,6010,7,10,7,19,33,52,-19,37
St. Pölten,6010,8,8,12,16,45,62,-17,36
Mattersburg,6010,9,8,9,19,39,61,-22,33
Admira Wacke,6010,10,7,7,22,26,57,-31,28
FC Salzburg,6011,1,23,8,5,66,23,43,77
SC Rheindorf,6011,2,19,7,10,58,44,14,64
SK Sturm Gra,6011,3,17,10,9,54,32,22,61
Vienna,6011,4,18,5,13,62,53,9,59
Admira Wacke,6011,5,13,7,16,38,55,-17,46
Rapid Vienna,6011,6,11,12,13,52,44,8,45
RZ Pellets W,6011,7,12,8,16,39,50,-11,44
Mattersburg,6011,8,9,10,17,41,52,-11,37
SV Josko Rie,6011,9,10,5,21,34,58,-24,35
St. Pölten,6011,10,7,10,19,42,75,-33,31
FC Salzburg,6012,1,24,5,7,64,31,33,77
SC Rheindorf,6012,2,20,7,9,51,32,19,67
Vienna,6012,3,20,3,13,64,52,12,63
SK Sturm Gra,6012,4,19,4,13,64,35,29,61
Rapid Vienna,6012,5,13,9,14,54,46,8,48
Mattersburg,6012,6,13,8,15,40,47,-7,47
RZ Pellets W,6012,7,13,6,17,45,59,-14,45
SV Josko Rie,6012,8,11,3,22,36,55,-19,36
St. Pölten,6012,9,9,9,18,48,71,-23,36
Admira Wacke,6012,10,9,4,23,32,70,-38,31
SK Sturm Gra,6013,1,21,7,8,71,31,40,70
SC Rheindorf,6013,2,18,11,7,48,39,9,65
FC Salzburg,6013,3,19,7,10,56,31,25,64
Vienna,6013,4,19,6,11,68,50,18,63
Rapid Vienna,6013,5,14,9,13,44,38,6,51
St. Pölten,6013,6,11,11,14,45,55,-10,44
SV Josko Rie,6013,7,11,5,20,32,55,-23,38
RZ Pellets W,6013,8,11,5,20,38,63,-25,38
Admira Wacke,6013,9,10,7,19,33,57,-24,37
Mattersburg,6013,10,7,10,19,44,60,-16,31
FC Salzburg,6014,1,20,10,6,64,31,33,70
SK Sturm Gra,6014,2,19,8,9,61,32,29,65
SC Rheindorf,6014,3,19,8,9,57,43,14,65
Vienna,6014,4,19,5,12,66,49,17,62
Rapid Vienna,6014,5,13,11,12,48,40,8,50
RZ Pellets W,6014,6,13,8,15,40,48,-8,47
Admira Wacke,6014,7,12,8,16,43,57,-14,44
Mattersburg,6014,8,9,10,17,40,55,-15,37
SV Josko Rie,6014,9,9,4,23,34,65,-31,31
St. Pölten,6014,10,7,8,21,36,69,-33,29
FC Salzburg,6015,1,21,8,7,68,30,38,71
SC Rheindorf,6015,2,19,8,9,59,43,16,65
Vienna,6015,3,17,8,11,61,56,5,59
Rapid Vienna,6015,4,14,13,9,57,37,20,55
SK Sturm Gra,6015,4,16,7,13,57,37,20,55
RZ Pellets W,6015,6,12,5,19,49,69,-20,41
St. Pölten,6015,7,10,10,16,41,61,-20,40
Admira Wacke,6015,8,11,7,18,38,58,-20,40
SV Josko Rie,6015,9,10,8,18,40,55,-15,38
Mattersburg,6015,10,8,10,18,35,59,-24,34
SC Rheindorf,6016,1,23,7,6,62,35,27,76
FC Salzburg,6016,2,22,8,6,60,25,35,74
Vienna,6016,3,18,4,14,60,56,4,58
SK Sturm Gra,6016,4,17,5,14,53,40,13,56
RZ Pellets W,6016,5,15,6,15,52,57,-5,51
Admira Wacke,6016,6,14,7,15,38,48,-10,49
Rapid Vienna,6016,7,11,12,13,57,47,10,45
SV Josko Rie,6016,8,13,3,20,43,59,-16,42
St. Pölten,6016,9,7,8,21,37,71,-34,29
Mattersburg,6016,10,6,8,22,37,61,-24,26
SK Sturm Gra,6017,1,21,6,9,61,31,30,69
FC Salzburg,6017,2,20,8,8,63,30,33,68
SC Rheindorf,6017,3,20,7,9,55,36,19,67
Vienna,6017,4,18,4,14,57,48,9,58
RZ Pellets W,6017,5,18,4,14,57,53,4,58
Rapid Vienna,6017,6,16,9,11,61,45,16,57
Admira Wacke,6017,7,10,6,20,38,66,-28,36
SV Josko Rie,6017,8,10,4,22,32,57,-25,34
Mattersburg,6017,9,9,6,21,37,66,-29,33
St. Pölten,6017,10,5,12,19,37,66,-29,27
FC Salzburg,6018,1,22,8,6,65,30,35,74
SK Sturm Gra,6018,2,19,6,11,59,35,24,63
SC Rheindorf,6018,3,17,12,7,48,36,12,63
Rapid Vienna,6018,4,16,8,12,55,42,13,56
Vienna,6018,5,17,5,14,60,52,8,56
Admira Wacke,6018,6,13,6,17,41,55,-14,45
RZ Pellets W,6018,7,11,7,18,46,63,-17,40
Mattersburg,6018,8,10,8,18,41,55,-14,38
St. Pölten,6018,9,9,9,18,41,61,-20,36
SV Josko Rie,6018,10,8,7,21,33,60,-27,31
FC Salzburg,6019,1,24,6,6,69,28,41,78
SC Rheindorf,6019,2,20,9,7,59,45,14,69
Rapid Vienna,6019,3,16,10,10,63,38,25,58
Vienna,6019,4,17,6,13,63,53,10,57
SK Sturm Gra,6019,5,15,7,14,51,41,10,52
Admira Wacke,6019,6,14,6,16,45,58,-13,48
RZ Pellets W,6019,7,10,9,17,44,63,-19,39
SV Josko Rie,6019,8,10,7,19,33,55,-22,37
Mattersburg,6019,9,8,10,18,38,55,-17,34
St. Pölten,6019,10,6,10,20,39,68,-29,28
FC Salzburg,6020,1,22,8,6,70,35,35,74
SK Sturm Gra,6020,2,21,5,10,59,32,27,68
Vienna,6020,3,19,5,12,60,48,12,62
SC Rheindorf,6020,4,16,10,10,54,46,8,58
Rapid Vienna,6020,5,14,10,12,55,38,17,52
Mattersburg,6020,6,10,9,17,43,55,-12,39
SV Josko Rie,6020,7,11,6,19,36,57,-21,39
St. Pölten,6020,8,9,10,17,37,62,-25,37
RZ Pellets W,6020,9,8,12,16,38,53,-15,36
Admira Wacke,6020,10,11,3,22,34,60,-26,36
FC Salzburg,6021,1,25,5,6,75,33,42,80
SK Sturm Gra,6021,2,23,6,7,69,31,38,75
Vienna,6021,3,17,8,11,57,48,9,59
SC Rheindorf,6021,4,15,11,10,51,50,1,56
Rapid Vienna,6021,5,12,11,13,51,41,10,47
SV Josko Rie,6021,6,12,7,17,38,52,-14,43
St. Pölten,6021,7,9,11,16,37,54,-17,38
RZ Pellets W,6021,8,10,5,21,38,60,-22,35
Admira Wacke,6021,9,9,8,19,29,56,-27,35
Mattersburg,6021,10,8,8,20,35,55,-20,32
FC Salzburg,6022,1,20,10,6,65,32,33,70
SK Sturm Gra,6022,2,20,5,11,64,36,28,65
Vienna,6022,3,20,4,12,61,50,11,64
SC Rheindorf,6022,4,19,5,12,57,47,10,62
Rapid Vienna,6022,5,12,11,13,55,45,10,47
RZ Pellets W,6022,6,13,6,17,47,57,-10,45
Mattersburg,6022,7,11,10,15,41,51,-10,43
SV Josko Rie,6022,8,11,5,20,33,57,-24,38
Admira Wacke,6022,9,9,9,18,33,57,-24,36
St. Pölten,6022,10,8,9,19,35,59,-24,33
FC Salzburg,6023,1,21,10,5,59,22,37,73
SC Rheindorf,6023,2,18,9,9,56,42,14,63
Rapid Vienna,6023,3,17,10,9,62,36,26,61
SK Sturm Gra,6023,4,17,8,11,53,38,15,59
Vienna,6023,5,15,4,17,54,56,-2,49
RZ Pellets W,6023,6,12,8,16,45,54,-9,44
Admira Wacke,6023,7,12,7,17,36,55,-19,43
Mattersburg,6023,8,9,9,18,34,51,-17,36
SV Josko Rie,6023,9,10,6,20,29,50,-21,36
St. Pölten,6023,10,8,11,17,40,64,-24,35
FC Salzburg,6024,1,20,7,9,63,35,28,67
Vienna,6024,2,19,5,12,58,52,6,62
SC Rheindorf,6024,3,18,7,11,56,41,15,61
Rapid Vienna,6024,4,16,12,8,63,40,23,60
SK Sturm Gra,6024,5,17,8,11,60,40,20,59
RZ Pellets W,6024,6,12,8,16,44,55,-11,44
SV Josko Rie,6024,7,13,3,20,34,52,-18,42
St. Pölten,6024,8,10,9,17,43,61,-18,39
Mattersburg,6024,9,9,8,19,39,59,-20,35
Admira Wacke,6024,10,9,7,20,33,58,-25,34
SK Sturm Gra,6025,1,20,8,8,68,34,34,68
FC Salzburg,6025,2,20,8,8,62,33,29,68
Vienna,6025,3,20,4,12,66,55,11,64
SC Rheindorf,6025,4,19,7,10,57,48,9,64
Rapid Vienna,6025,5,14,11,11,56,42,14,53
RZ Pellets W,6025,6,13,9,14,50,57,-7,48
Admira Wacke,6025,7,12,8,16,35,52,-17,44
Mattersburg,6025,8,7,10,19,42,59,-17,31
SV Josko Rie,6025,9,8,7,21,30,55,-25,31
St. Pölten,6025,10,6,10,20,40,71,-31,28
Vienna,6026,1,20,5,11,68,54,14,65
FC Salzburg,6026,2,18,9,9,53,27,26,63
SK Sturm Gra,6026,3,19,5,12,56,35,21,62
SC Rheindorf,6026,4,18,6,12,49,45,4,60
Rapid Vienna,6026,5,15,11,10,60,41,19,56
Admira Wacke,6026,6,13,6,17,39,50,-11,45
St. Pölten,6026,7,10,12,14,40,53,-13,42
RZ Pellets W,6026,8,11,8,17,46,61,-15,41
SV Josko Rie,6026,9,10,7,19,34,52,-18,37
Mattersburg,6026,10,8,7,21,39,66,-27,31
SK Sturm Gra,6027,1,21,7,8,62,29,33,70
FC Salzburg,6027,2,19,10,7,69,34,35,67
Vienna,6027,3,20,6,10,66,53,13,66
SC Rheindorf,6027,4,18,6,12,56,50,6,60
Rapid Vienna,6027,5,13,12,11,53,45,8,51
RZ Pellets W,6027,6,13,9,14,50,52,-2,48
Admira Wacke,6027,7,11,5,20,43,66,-23,38
St. Pölten,6027,8,7,13,16,36,60,-24,34
Mattersburg,6027,9,8,8,20,33,54,-21,32
SV Josko Rie,6027,10,8,8,20,30,55,-25,32
SC Rheindorf,6028,1,19,9,8,59,43,16,66
FC Salzburg,6028,2,18,9,9,62,37,25,63
Vienna,6028,3,18,6,12,58,49,9,60
SK Sturm Gra,6028,4,18,5,13,56,35,21,59
Rapid Vienna,6028,5,13,12,11,56,43,13,51
Admira Wacke,6028,6,14,7,15,44,56,-12,49
RZ Pellets W,6028,7,13,8,15,42,47,-5,47
St. Pölten,6028,8,9,9,18,39,62,-23,36
Mattersburg,6028,9,9,8,19,39,58,-19,35
SV Josko Rie,6028,10,9,7,20,35,60,-25,34
SK Sturm Gra,6029,1,22,5,9,68,28,40,71
FC Salzburg,6029,2,19,8,9,62,30,32,65
SC Rheindorf,6029,3,19,7,10,54,54,0,64
Vienna,6029,4,17,4,15,60,57,3,55
Rapid Vienna,6029,5,13,13,10,64,42,22,52
RZ Pellets W,6029,6,15,5,16,54,65,-11,50
SV Josko Rie,6029,7,12,4,20,39,58,-19,40
Admira Wacke,6029,8,11,7,18,37,60,-23,40
Mattersburg,6029,9,9,9,18,36,55,-19,36
St. Pölten,6029,10,8,8,20,41,66,-25,32
FC Salzburg,6030,1,22,7,7,68,30,38,73
SC Rheindorf,6030,2,20,7,9,55,38,17,67
SK Sturm Gra,6030,3,20,6,10,61,34,27,66
Vienna,6030,4,18,3,15,60,55,5,57
Rapid Vienna,6030,5,14,13,9,54,38,16,55
RZ Pellets W,6030,6,13,6,17,44,59,-15,45
SV Josko Rie,6030,7,13,3,20,40,55,-15,42
Admira Wacke,6030,8,10,5,21,36,65,-29,35
Mattersburg,6030,9,8,9,19,40,59,-19,33
St. Pölten,6030,10,8,9,19,38,63,-25,33
FC Salzburg,6031,1,19,10,7,71,33,38,67
SK Sturm Gra,6031,2,19,8,9,59,31,28,65
SC Rheindorf,6031,3,17,10,9,50,45,5,61
Vienna,6031,4,16,6,14,55,58,-3,54
Rapid Vienna,6031,5,15,8,13,63,52,11,53
Admira Wacke,6031,6,12,11,13,41,51,-10,47
St. Pölten,6031,7,11,10,15,48,61,-13,43
RZ Pellets W,6031,8,11,6,19,44,60,-16,39
Mattersburg,6031,9,9,9,18,47,60,-13,36
SV Josko Rie,6031,10,9,6,21,31,58,-27,33
FC Salzburg,6032,1,21,8,7,62,29,33,71
SC Rheindorf,6032,2,19,11,6,52,38,14,68
Vienna,6032,3,19,7,10,70,52,18,64
SK Sturm Gra,6032,4,16,8,12,56,39,17,56
Rapid Vienna,6032,5,14,8,14,61,48,13,50
RZ Pellets W,6032,6,13,10,13,46,57,-11,49
Admira Wacke,6032,7,14,5,17,38,55,-17,47
SV Josko Rie,6032,8,10,4,22,33,56,-23,34
Mattersburg,6032,9,7,9,20,37,55,-18,30
St. Pölten,6032,10,6,12,18,36,62,-26,30
FC Salzburg,6033,1,20,8,8,60,30,30,68
SK Sturm Gra,6033,2,19,7,10,61,36,25,64
SC Rheindorf,6033,3,17,9,10,58,47,11,60
Rapid Vienna,6033,4,14,13,9,54,33,21,55
RZ Pellets W,6033,5,16,6,14,51,56,-5,54
Vienna,6033,6,15,5,16,51,57,-6,50
Admira Wacke,6033,7,12,8,16,43,56,-13,44
Mattersburg,6033,8,11,5,20,38,58,-20,38
St. Pölten,6033,9,9,8,19,41,64,-23,35
SV Josko Rie,6033,10,9,7,20,36,56,-20,34
FC Salzburg,6034,1,20,9,7,63,32,31,69
SC Rheindorf,6034,2,18,10,8,54,38,16,64
SK Sturm Gra,6034,3,18,8,10,63,39,24,62
Vienna,6034,4,18,5,13,57,49,8,59
RZ Pellets W,6034,5,13,9,14,47,51,-4,48
Rapid Vienna,6034,6,11,13,12,52,45,7,46
Admira Wacke,6034,7,13,6,17,37,59,-22,45
St. Pölten,6034,8,11,11,14,45,58,-13,44
SV Josko Rie,6034,9,7,8,21,33,54,-21,29
Mattersburg,6034,10,6,11,19,38,64,-26,29
SK Sturm Gra,6035,1,20,7,9,64,41,23,67
FC Salzburg,6035,2,19,7,10,62,33,29,64
SC Rheindorf,6035,3,18,8,10,56,46,10,62
Vienna,6035,4,16,9,11,64,53,11,57
Rapid Vienna,6035,5,15,10,11,57,43,14,55
SV Josko Rie,6035,6,13,7,16,40,47,-7,46
Mattersburg,6035,7,12,7,17,47,59,-12,43
Admira Wacke,6035,8,12,7,17,40,58,-18,43
RZ Pellets W,6035,9,10,7,19,43,62,-19,37
St. Pölten,6035,10,5,11,20,37,68,-31,26
SK Sturm Gra,6036,1,22,5,9,62,33,29,71
FC Salzburg,6036,2,20,9,7,62,26,36,69
SC Rheindorf,6036,3,19,8,9,46,35,11,65
Vienna,6036,4,16,7,13,54,45,9,55
Rapid Vienna,6036,5,11,13,12,49,41,8,46
Admira Wacke,6036,6,13,6,17,47,59,-12,45
RZ Pellets W,6036,7,12,7,17,47,62,-15,43
SV Josko Rie,6036,8,10,8,18,33,51,-18,38
St. Pölten,6036,9,9,10,17,38,61,-23,37
Mattersburg,6036,10,6,11,19,27,52,-25,29
FC Salzburg,6037,1,20,9,7,63,33,30,69
SK Sturm Gra,6037,2,19,7,10,61,32,29,64
Vienna,6037,3,18,5,13,57,47,10,59
SC Rheindorf,6037,4,17,8,11,49,42,7,59
Rapid Vienna,6037,5,16,10,10,62,38,24,58
Admira Wacke,6037,6,13,9,14,38,52,-14,48
Mattersburg,6037,7,12,8,16,38,51,-13,44
SV Josko Rie,6037,8,13,2,21,37,53,-16,41
RZ Pellets W,6037,9,8,7,21,39,67,-28,31
St. Pölten,6037,10,7,9,20,40,69,-29,30
FC Salzburg,6038,1,25,5,6,78,32,46,80
SK Sturm Gra,6038,2,19,6,11,60,40,20,63
SC Rheindorf,6038,3,17,10,9,56,45,11,61
Vienna,6038,4,15,8,13,60,62,-2,53
Rapid Vienna,6038,5,12,10,14,65,54,11,46
RZ Pellets W,6038,6,10,11,15,42,51,-9,41
Admira Wacke,6038,7,11,7,18,37,64,-27,40
St. Pölten,6038,8,9,12,15,45,60,-15,39
Mattersburg,6038,9,10,8,18,41,58,-17,38
SV Josko Rie,6038,10,11,5,20,38,56,-18,38
SK Sturm Gra,6039,1,21,6,9,64,32,32,69
FC Salzburg,6039,2,18,9,9,62,37,25,63
Vienna,6039,3,19,6,11,67,52,15,63
SC Rheindorf,6039,4,18,8,10,54,46,8,62
Rapid Vienna,6039,5,16,9,11,57,39,18,57
Admira Wacke,6039,6,13,6,17,37,53,-16,45
RZ Pellets W,6039,7,11,10,15,44,53,-9,43
St. Pölten,6039,8,11,7,18,45,64,-19,40
SV Josko Rie,6039,9,10,5,21,30,57,-27,35
Mattersburg,6039,10,6,8,22,32,59,-27,26
SK Sturm Gra,6040,1,22,3,11,67,33,34,69
FC Salzburg,6040,2,20,9,7,65,36,29,69
SC Rheindorf,6040,3,21,6,9,61,42,19,69
Vienna,6040,4,17,5,14,59,53,6,56
Rapid Vienna,6040,5,14,13,9,50,33,17,55
RZ Pellets W,6040,6,14,8,14,51,57,-6,50
Admira Wacke,6040,7,11,6,19,33,61,-28,39
Mattersburg,6040,8,10,8,18,40,55,-15,38
SV Josko Rie,6040,9,9,6,21,31,57,-26,33
St. Pölten,6040,10,5,10,21,38,68,-30,25
FC Salzburg,6041,1,22,6,8,69,34,35,72
SK Sturm Gra,6041,2,19,8,9,55,34,21,65
Rapid Vienna,6041,3,15,13,8,56,32,24,58
SC Rheindorf,6041,4,16,10,10,50,40,10,58
Vienna,6041,5,18,3,15,60,56,4,57
SV Josko Rie,6041,6,12,6,18,37,49,-12,42
RZ Pellets W,6041,7,10,9,17,41,54,-13,39
Mattersburg,6041,8,10,9,17,36,51,-15,39
Admira Wacke,6041,9,11,4,21,30,60,-30,37
St. Pölten,6041,10,8,10,18,37,61,-24,34
SK Sturm Gra,6042,1,24,4,8,63,30,33,76
FC Salzburg,6042,2,19,10,7,60,26,34,67
SC Rheindorf,6042,3,17,8,11,51,41,10,59
Rapid Vienna,6042,4,15,10,11,60,45,15,55
Vienna,6042,5,17,4,15,62,60,2,55
Admira Wacke,6042,6,14,5,17,45,57,-12,47
RZ Pellets W,6042,7,12,7,17,43,52,-9,43
SV Josko Rie,6042,8,12,3,21,34,54,-20,39
St. Pölten,6042,9,7,12,17,33,58,-25,33
Mattersburg,6042,10,7,9,20,33,61,-28,30
SC Rheindorf,6043,1,22,7,7,55,39,16,73
FC Salzburg,6043,2,22,6,8,67,31,36,72
Vienna,6043,3,19,5,12,64,46,18,62
SK Sturm Gra,6043,4,18,7,11,58,39,19,61
Admira Wacke,6043,5,16,4,16,44,50,-6,52
Rapid Vienna,6043,6,14,9,13,54,42,12,51
RZ Pellets W,6043,7,13,4,19,39,53,-14,43
SV Josko Rie,6043,8,11,5,20,35,58,-23,38
St. Pölten,6043,9,8,7,21,38,67,-29,31
Mattersburg,6043,10,6,8,22,31,60,-29,26
FC Salzburg,6044,1,21,7,8,65,34,31,70
SK Sturm Gra,6044,2,20,5,11,66,38,28,65
Vienna,6044,3,20,3,13,67,61,6,63
SC Rheindorf,6044,4,16,11,9,58,44,14,59
Rapid Vienna,6044,5,12,13,11,51,38,13,49
RZ Pellets W,6044,6,14,7,15,46,53,-7,49
SV Josko Rie,6044,7,13,6,17,46,57,-11,45
Mattersburg,6044,8,8,11,17,33,53,-20,35
St. Pölten,6044,9,8,9,19,42,67,-25,33
Admira Wacke,6044,10,9,6,21,30,59,-29,33
FC Salzburg,6045,1,21,8,7,63,27,36,71
SK Sturm Gra,6045,2,22,3,11,63,31,32,69
Vienna,6045,3,21,6,9,66,39,27,69
SC Rheindorf,6045,4,19,9,8,56,39,17,66
Rapid Vienna,6045,5,15,12,9,56,36,20,57
SV Josko Rie,6045,6,12,5,19,35,56,-21,41
RZ Pellets W,6045,7,9,9,18,47,61,-14,36
St. Pölten,6045,8,8,9,19,42,70,-28,33
Admira Wacke,6045,9,9,5,22,26,69,-43,32
Mattersburg,6045,10,7,8,21,35,61,-26,29
FC Salzburg,6046,1,23,6,7,69,33,36,75
SK Sturm Gra,6046,2,20,7,9,68,42,26,67
SC Rheindorf,6046,3,20,6,10,54,45,9,66
Vienna,6046,4,19,7,10,64,53,11,64
Rapid Vienna,6046,5,16,8,12,60,46,14,56
RZ Pellets W,6046,6,13,6,17,46,54,-8,45
Admira Wacke,6046,7,13,6,17,49,63,-14,45
Mattersburg,6046,8,8,8,20,38,56,-18,32
St. Pölten,6046,9,8,8,20,43,66,-23,32
SV Josko Rie,6046,10,7,4,25,31,64,-33,25
FC Salzburg,6047,1,21,8,7,65,29,36,71
SC Rheindorf,6047,2,19,7,10,56,43,13,64
SK Sturm Gra,6047,3,18,9,9,62,36,26,63
Vienna,6047,4,18,8,10,60,52,8,62
Rapid Vienna,6047,5,14,11,11,53,41,12,53
RZ Pellets W,6047,6,11,11,14,56,59,-3,44
St. Pölten,6047,7,9,10,17,45,66,-21,37
Admira Wacke,6047,8,8,12,16,41,62,-21,36
SV Josko Rie,6047,9,8,8,20,32,60,-28,32
Mattersburg,6047,10,7,10,19,36,58,-22,31
FC Salzburg,6048,1,21,9,6,72,35,37,72
Vienna,6048,2,22,5,9,72,48,24,71
SC Rheindorf,6048,3,20,8,8,58,43,15,68
SK Sturm Gra,6048,4,18,5,13,61,40,21,59
Rapid Vienna,6048,5,15,11,10,60,41,19,56
RZ Pellets W,6048,6,14,6,16,44,50,-6,48
St. Pölten,6048,7,9,10,17,40,57,-17,37
Admira Wacke,6048,8,10,4,22,36,66,-30,34
Mattersburg,6048,9,8,7,21,31,60,-29,31
SV Josko Rie,6048,10,7,7,22,27,61,-34,28
FC Salzburg,6049,1,21,8,7,61,30,31,71
SC Rheindorf,6049,2,21,6,9,61,39,22,69
SK Sturm Gra,6049,3,19,6,11,63,37,26,63
Vienna,6049,4,19,4,13,64,57,7,61
Rapid Vienna,6049,5,13,10,13,57,49,8,49
SV Josko Rie,6049,6,14,4,18,40,49,-9,46
Admira Wacke,6049,7,13,7,16,42,59,-17,46
RZ Pellets W,6049,8,12,7,17,43,57,-14,43
St. Pölten,6049,9,6,12,18,38,65,-27,30
Mattersburg,6049,10,6,8,22,33,60,-27,26
FC Salzburg,6050,1,25,6,5,73,30,43,81
SC Rheindorf,6050,2,20,6,10,61,44,17,66
SK Sturm Gra,6050,3,19,7,10,57,33,24,64
Vienna,6050,4,18,6,12,63,53,10,60
Rapid Vienna,6050,5,14,10,12,58,40,18,52
St. Pölten,6050,6,10,9,17,38,58,-20,39
RZ Pellets W,6050,7,10,8,18,42,58,-16,38
SV Josko Rie,6050,8,10,6,20,36,67,-31,36
Admira Wacke,6050,9,10,5,21,37,67,-30,35
Mattersburg,6050,10,8,9,19,38,53,-15,33
FC Salzburg,6051,1,20,9,7,75,32,43,69
SK Sturm Gra,6051,2,20,4,12,59,39,20,64
Vienna,6051,3,18,8,10,64,50,14,62
SC Rheindorf,6051,4,17,11,8,52,44,8,62
RZ Pellets W,6051,5,15,6,15,50,56,-6,51
Rapid Vienna,6051,6,12,9,15,54,48,6,45
SV Josko Rie,6051,7,13,5,18,45,56,-11,44
St. Pölten,6051,8,12,8,16,42,56,-14,44
Admira Wacke,6051,9,9,5,22,32,63,-31,32
Mattersburg,6051,10,8,7,21,38,67,-29,31
FC Salzburg,6052,1,23,6,7,69,31,38,75
Vienna,6052,2,20,6,10,70,51,19,66
SK Sturm Gra,6052,3,19,6,11,54,31,23,63
SC Rheindorf,6052,4,17,7,12,53,46,7,58
Admira Wacke,6052,5,13,8,15,42,59,-17,47
Rapid Vienna,6052,6,12,9,15,51,46,5,45
RZ Pellets W,6052,7,11,9,16,39,53,-14,42
SV Josko Rie,6052,8,12,4,20,34,59,-25,40
St. Pölten,6052,9,9,9,18,41,57,-16,36
Mattersburg,6052,10,8,8,20,36,56,-20,32
FC Salzburg,6053,1,22,8,6,64,31,33,74
SC Rheindorf,6053,2,18,8,10,60,46,14,62
Vienna,6053,3,18,8,10,60,50,10,62
SK Sturm Gra,6053,4,18,6,12,59,28,31,60
Rapid Vienna,6053,5,14,10,12,54,38,16,52
RZ Pellets W,6053,6,14,9,13,43,47,-4,51
Admira Wacke,6053,7,11,8,17,37,59,-22,41
Mattersburg,6053,8,9,8,19,29,52,-23,35
SV Josko Rie,6053,9,9,6,21,31,51,-20,33
St. Pölten,6053,10,7,9,20,32,67,-35,30
FC Salzburg,6054,1,20,7,9,67,33,34,67
SC Rheindorf,6054,2,20,7,9,54,40,14,67
Vienna,6054,3,20,6,10,62,42,20,66
SK Sturm Gra,6054,4,18,8,10,55,37,18,62
Rapid Vienna,6054,5,17,7,12,61,42,19,58
RZ Pellets W,6054,6,12,9,15,47,49,-2,45
SV Josko Rie,6054,7,12,6,18,36,55,-19,42
Admira Wacke,6054,8,11,8,17,39,59,-20,41
Mattersburg,6054,9,8,8,20,40,65,-25,32
St. Pölten,6054,10,5,8,23,38,77,-39,23
FC Salzburg,6055,1,21,8,7,65,29,36,71
Vienna,6055,2,21,4,11,63,44,19,67
SK Sturm Gra,6055,3,21,3,12,58,36,22,66
SC Rheindorf,6055,4,17,10,9,51,39,12,61
Rapid Vienna,6055,5,13,10,13,52,42,10,49
RZ Pellets W,6055,6,13,9,14,41,46,-5,48
Admira Wacke,6055,7,11,7,18,34,58,-24,40
St. Pölten,6055,8,9,11,16,41,57,-16,38
SV Josko Rie,6055,9,9,7,20,28,53,-25,34
Mattersburg,6055,10,6,9,21,34,63,-29,27
FC Salzburg,6056,1,23,6,7,69,31,38,75
Vienna,6056,2,21,5,10,61,42,19,68
SK Sturm Gra,6056,3,18,9,9,57,28,29,63
SC Rheindorf,6056,4,17,7,12,47,47,0,58
Rapid Vienna,6056,5,13,11,12,54,44,10,50
St. Pölten,6056,6,11,9,16,43,56,-13,42
Admira Wacke,6056,7,12,6,18,39,56,-17,42
RZ Pellets W,6056,8,11,8,17,44,51,-7,41
SV Josko Rie,6056,9,11,5,20,36,64,-28,38
Mattersburg,6056,10,6,8,22,38,69,-31,26
FC Salzburg,6057,1,22,7,7,60,27,33,73
SC Rheindorf,6057,2,21,7,8,55,32,23,70
SK Sturm Gra,6057,3,19,7,10,55,28,27,64
Vienna,6057,4,17,7,12,57,50,7,58
Rapid Vienna,6057,5,15,11,10,54,37,17,56
RZ Pellets W,6057,6,12,9,15,44,55,-11,45
Admira Wacke,6057,7,12,8,16,37,55,-18,44
Mattersburg,6057,8,8,7,21,32,58,-26,31
St. Pölten,6057,9,7,10,19,39,68,-29,31
SV Josko Rie,6057,10,9,3,24,31,54,-23,30
FC Salzburg,6058,1,22,7,7,62,30,32,73
SK Sturm Gra,6058,2,22,4,10,64,32,32,70
SC Rheindorf,6058,3,19,7,10,50,39,11,64
Vienna,6058,4,15,9,12,55,48,7,54
Rapid Vienna,6058,5,14,8,14,49,42,7,50
Admira Wacke,6058,6,14,4,18,37,54,-17,46
RZ Pellets W,6058,7,13,6,17,44,59,-15,45
Mattersburg,6058,8,10,10,16,40,47,-7,40
SV Josko Rie,6058,9,10,7,19,38,54,-16,37
St. Pölten,6058,10,4,12,20,35,69,-34,24
FC Salzburg,6059,1,22,7,7,67,26,41,73
SK Sturm Gra,6059,2,22,5,9,66,33,33,71
SC Rheindorf,6059,3,19,8,9,51,38,13,65
Vienna,6059,4,18,4,14,61,59,2,58
Rapid Vienna,6059,5,13,9,14,52,45,7,48
RZ Pellets W,6059,6,14,4,18,46,57,-11,46
SV Josko Rie,6059,7,12,7,17,39,50,-11,43
Mattersburg,6059,8,8,11,17,32,51,-19,35
Admira Wacke,6059,9,9,6,21,34,65,-31,33
St. Pölten,6059,10,7,11,18,46,70,-24,32
FC Salzburg,6060,1,22,6,8,72,34,38,72
SC Rheindorf,6060,2,22,5,9,61,36,25,71
SK Sturm Gra,6060,3,20,4,12,55,32,23,64
Vienna,6060,4,17,4,15,52,48,4,55
RZ Pellets W,6060,5,17,4,15,43,49,-6,55
Rapid Vienna,6060,6,14,9,13,56,45,11,51
SV Josko Rie,6060,7,12,5,19,39,58,-19,41
St. Pölten,6060,8,9,10,17,48,66,-18,37
Mattersburg,6060,9,9,6,21,36,62,-26,33
Admira Wacke,6060,10,9,5,22,35,67,-32,32
Vienna,6061,1,22,4,10,74,49,25,70
FC Salzburg,6061,2,20,9,7,67,32,35,69
SC Rheindorf,6061,3,19,7,10,55,48,7,64
SK Sturm Gra,6061,4,17,8,11,60,43,17,59
Rapid Vienna,6061,5,12,8,16,53,50,3,44
St. Pölten,6061,6,11,11,14,43,55,-12,44
Mattersburg,6061,7,11,9,16,44,55,-11,42
SV Josko Rie,6061,8,11,7,18,44,54,-10,40
RZ Pellets W,6061,9,9,8,19,38,67,-29,35
Admira Wacke,6061,10,9,7,20,30,55,-25,34
FC Salzburg,6062,1,21,5,10,60,30,30,68
Vienna,6062,2,19,4,13,61,60,1,61
SK Sturm Gra,6062,3,18,6,12,55,36,19,60
SC Rheindorf,6062,4,16,10,10,56,45,11,58
Rapid Vienna,6062,5,13,8,15,53,46,7,47
RZ Pellets W,6062,6,13,8,15,46,55,-9,47
Admira Wacke,6062,7,13,4,19,35,56,-21,43
SV Josko Rie,6062,8,13,3,20,31,47,-16,42
Mattersburg,6062,9,11,8,17,43,57,-14,41
St. Pölten,6062,10,10,10,16,46,54,-8,40
SK Sturm Gra,6063,1,23,5,8,65,31,34,74
FC Salzburg,6063,2,20,7,9,65,32,33,67
Vienna,6063,3,21,4,11,71,53,18,67
SC Rheindorf,6063,4,17,8,11,50,49,1,59
Rapid Vienna,6063,5,14,9,13,59,41,18,51
RZ Pellets W,6063,6,10,11,15,43,54,-11,41
Admira Wacke,6063,7,11,7,18,39,65,-26,40
Mattersburg,6063,8,10,8,18,40,56,-16,38
St. Pölten,6063,9,8,10,18,44,69,-25,34
SV Josko Rie,6063,10,8,7,21,32,58,-26,31
SC Rheindorf,6064,1,25,5,6,58,36,22,80
FC Salzburg,6064,2,22,6,8,73,32,41,72
SK Sturm Gra,6064,3,18,4,14,62,43,19,58
Vienna,6064,4,17,6,13,63,58,5,57
Rapid Vienna,6064,5,13,10,13,52,43,9,49
RZ Pellets W,6064,6,13,7,16,47,58,-11,46
Admira Wacke,6064,7,12,6,18,43,61,-18,42
St. Pölten,6064,8,10,8,18,42,62,-20,38
SV Josko Rie,6064,9,9,7,20,38,52,-14,34
Mattersburg,6064,10,8,7,21,42,75,-33,31
SK Sturm Gra,6065,1,22,5,9,64,30,34,71
FC Salzburg,6065,2,19,9,8,62,31,31,66
Vienna,6065,3,19,7,10,70,54,16,64
SC Rheindorf,6065,4,18,5,13,48,40,8,59
Rapid Vienna,6065,5,14,8,14,50,40,10,50
SV Josko Rie,6065,6,13,7,16,34,46,-12,46
Admira Wacke,6065,7,14,4,18,42,62,-20,46
RZ Pellets W,6065,8,11,7,18,43,58,-15,40
Mattersburg,6065,9,7,11,18,38,61,-23,32
St. Pölten,6065,10,8,7,21,39,68,-29,31
FC Salzburg,6066,1,24,4,8,70,33,37,76
SC Rheindorf,6066,2,20,8,8,57,34,23,68
Vienna,6066,3,18,6,12,62,59,3,60
SK Sturm Gra,6066,4,16,8,12,57,46,11,56
Rapid Vienna,6066,5,13,11,12,57,46,11,50
RZ Pellets W,6066,6,14,7,15,53,48,5,49
Admira Wacke,6066,7,12,7,17,41,57,-16,43
Mattersburg,6066,8,9,9,18,34,56,-22,36
St. Pölten,6066,9,8,10,18,44,69,-25,34
SV Josko Rie,6066,10,8,6,22,30,57,-27,30
FC Salzburg,6067,1,20,8,8,58,29,29,68
Vienna,6067,2,20,6,10,65,46,19,66
SK Sturm Gra,6067,3,20,5,11,70,40,30,65
SC Rheindorf,6067,4,19,6,11,59,47,12,63
Rapid Vienna,6067,5,14,11,11,55,38,17,53
Admira Wacke,6067,6,14,5,17,39,55,-16,47
RZ Pellets W,6067,7,11,8,17,49,65,-16,41
Mattersburg,6067,8,11,6,19,41,55,-14,39
SV Josko Rie,6067,9,11,5,20,31,54,-23,38
St. Pölten,6067,10,7,6,23,39,77,-38,27
SC Rheindorf,6068,1,18,11,7,54,36,18,65
FC Salzburg,6068,2,19,7,10,62,35,27,64
Vienna,6068,3,18,5,13,59,50,9,59
SK Sturm Gra,6068,4,17,7,12,60,41,19,58
Rapid Vienna,6068,5,15,10,11,57,38,19,55
RZ Pellets W,6068,6,15,6,15,50,58,-8,51
SV Josko Rie,6068,7,12,8,16,35,47,-12,44
Admira Wacke,6068,8,12,5,19,35,57,-22,41
St. Pölten,6068,9,9,10,17,47,62,-15,37
Mattersburg,6068,10,6,9,21,29,64,-35,27
SK Sturm Gra,6069,1,21,7,8,63,28,35,70
FC Salzburg,6069,2,19,10,7,59,29,30,67
SC Rheindorf,6069,3,18,8,10,50,46,4,62
Vienna,6069,4,18,5,13,60,56,4,59
Rapid Vienna,6069,5,13,12,11,50,34,16,51
RZ Pellets W,6069,6,12,10,14,46,51,-5,46
Admira Wacke,6069,7,12,7,17,44,58,-14,43
SV Josko Rie,6069,8,9,7,20,35,59,-24,34
Mattersburg,6069,9,8,9,19,32,51,-19,33
St. Pölten,6069,10,7,11,18,37,64,-27,32
SC Rheindorf,6070,1,20,7,9,60,43,17,67
FC Salzburg,6070,2,19,8,9,64,38,26,65
Vienna,6070,3,20,5,11,62,50,12,65
SK Sturm Gra,6070,4,19,5,12,64,39,25,62
Rapid Vienna,6070,5,13,10,13,55,49,6,49
RZ Pellets W,6070,6,14,7,15,51,55,-4,49
SV Josko Rie,6070,7,12,6,18,34,52,-18,42
Admira Wacke,6070,8,11,8,17,36,54,-18,41
Mattersburg,6070,9,8,9,19,38,61,-23,33
St. Pölten,6070,10,7,9,20,43,66,-23,30
FC Salzburg,6071,1,22,6,8,66,34,32,72
SK Sturm Gra,6071,2,19,8,9,62,36,26,65
Vienna,6071,3,20,4,12,67,51,16,64
SC Rheindorf,6071,4,17,11,8,50,42,8,62
Rapid Vienna,6071,5,12,13,11,54,40,14,49
SV Josko Rie,6071,6,13,7,16,38,46,-8,46
Admira Wacke,6071,7,11,7,18,37,65,-28,40
RZ Pellets W,6071,8,10,7,19,37,54,-17,37
St. Pölten,6071,9,6,14,16,37,59,-22,32
Mattersburg,6071,10,6,11,19,34,55,-21,29
FC Salzburg,6072,1,21,9,6,65,32,33,72
SK Sturm Gra,6072,2,21,6,9,58,28,30,69
SC Rheindorf,6072,3,17,10,9,54,46,8,61
Vienna,6072,4,15,7,14,64,62,2,52
RZ Pellets W,6072,5,12,9,15,46,56,-10,45
Rapid Vienna,6072,6,11,11,14,49,45,4,44
Admira Wacke,6072,7,12,8,16,41,52,-11,44
St. Pölten,6072,8,10,12,14,39,54,-15,42
SV Josko Rie,6072,9,10,7,19,35,53,-18,37
Mattersburg,6072,10,8,7,21,32,55,-23,31
SC Rheindorf,6073,1,24,4,8,59,42,17,76
FC Salzburg,6073,2,23,6,7,73,28,45,75
Vienna,6073,3,19,4,13,62,52,10,61
Rapid Vienna,6073,4,17,9,10,61,39,22,60
SK Sturm Gra,6073,5,15,7,14,53,42,11,52
RZ Pellets W,6073,6,12,10,14,47,54,-7,46
SV Josko Rie,6073,7,11,6,19,35,52,-17,39
Admira Wacke,6073,8,10,5,21,38,69,-31,35
St. Pölten,6073,9,7,10,19,42,69,-27,31
Mattersburg,6073,10,7,9,20,37,60,-23,30
FC Salzburg,6074,1,21,4,11,69,34,35,67
SC Rheindorf,6074,2,19,9,8,54,37,17,66
SK Sturm Gra,6074,3,20,5,11,59,34,25,65
Vienna,6074,4,20,5,11,66,47,19,65
RZ Pellets W,6074,5,16,6,14,54,56,-2,54
Rapid Vienna,6074,6,13,10,13,50,41,9,49
Admira Wacke,6074,7,12,5,19,39,64,-25,41
St. Pölten,6074,8,10,10,16,43,65,-22,40
SV Josko Rie,6074,9,8,6,22,28,56,-28,30
Mattersburg,6074,10,7,8,21,31,59,-28,29
FC Salzburg,6075,1,22,5,9,62,33,29,71
SK Sturm Gra,6075,2,19,4,13,53,31,22,61
Rapid Vienna,6075,3,16,11,9,53,30,23,59
Vienna,6075,4,18,5,13,56,50,6,59
SC Rheindorf,6075,5,16,10,10,54,44,10,58
RZ Pellets W,6075,6,14,6,16,51,52,-1,48
Admira Wacke,6075,7,13,7,16,42,58,-16,46
SV Josko Rie,6075,8,10,7,19,31,54,-23,37
St. Pölten,6075,9,8,9,19,36,61,-25,33
Mattersburg,6075,10,8,8,20,34,59,-25,32
FC Salzburg,6076,1,21,9,6,65,27,38,72
SC Rheindorf,6076,2,20,9,7,60,43,17,69
SK Sturm Gra,6076,3,19,6,11,64,34,30,63
Rapid Vienna,6076,4,16,12,8,52,32,20,60
Vienna,6076,5,18,5,13,61,57,4,59
Admira Wacke,6076,6,11,8,17,37,54,-17,41
RZ Pellets W,6076,7,11,6,19,40,58,-18,39
SV Josko Rie,6076,8,11,3,22,30,56,-26,36
Mattersburg,6076,9,9,7,20,37,60,-23,34
St. Pölten,6076,10,6,11,19,40,65,-25,29
SC Rheindorf,6077,1,23,6,7,58,32,26,75
FC Salzburg,6077,2,20,8,8,69,36,33,68
SK Sturm Gra,6077,3,21,5,10,63,37,26,68
Vienna,6077,4,16,7,13,58,50,8,55
Rapid Vienna,6077,5,11,12,13,51,41,10,45
RZ Pellets W,6077,6,12,6,18,41,63,-22,42
SV Josko Rie,6077,7,12,5,19,37,55,-18,41
St. Pölten,6077,8,10,9,17,43,59,-16,39
Mattersburg,6077,9,9,9,18,36,55,-19,36
Admira Wacke,6077,10,9,7,20,31,59,-28,34
FC Salzburg,6078,1,21,9,6,65,30,35,72
SK Sturm Gra,6078,2,21,7,8,65,34,31,70
SC Rheindorf,6078,3,17,10,9,56,51,5,61
Rapid Vienna,6078,4,15,12,9,59,42,17,57
Vienna,6078,5,14,7,15,59,59,0,49
Admira Wacke,6078,6,12,8,16,43,59,-16,44
RZ Pellets W,6078,7,13,4,19,52,60,-8,43
SV Josko Rie,6078,8,10,6,20,34,53,-19,36
Mattersburg,6078,9,9,8,19,36,60,-24,35
St. Pölten,6078,10,7,11,18,44,65,-21,32
FC Salzburg,6079,1,20,7,9,63,40,23,67
SC Rheindorf,6079,2,19,10,7,61,44,17,67
Vienna,6079,3,19,5,12,73,54,19,62
SK Sturm Gra,6079,4,18,7,11,60,36,24,61
Rapid Vienna,6079,5,13,13,10,62,44,18,52
SV Josko Rie,6079,6,12,8,16,38,50,-12,44
RZ Pellets W,6079,7,12,8,16,44,63,-19,44
Admira Wacke,6079,8,12,3,21,39,62,-23,39
Mattersburg,6079,9,9,7,20,42,64,-22,34
St. Pölten,6079,10,7,10,19,39,64,-25,31
FC Salzburg,6080,1,22,9,5,71,29,42,75
SK Sturm Gra,6080,2,20,7,9,62,33,29,67
SC Rheindorf,6080,3,16,9,11,52,43,9,57
Vienna,6080,4,17,6,13,57,59,-2,57
Rapid Vienna,6080,5,14,10,12,52,35,17,52
Admira Wacke,6080,6,15,4,17,38,52,-14,49
RZ Pellets W,6080,7,14,6,16,47,53,-6,48
SV Josko Rie,6080,8,10,7,19,38,62,-24,37
Mattersburg,6080,9,9,9,18,42,57,-15,36
St. Pölten,6080,10,5,9,22,33,69,-36,24
SC Rheindorf,6081,1,22,8,6,67,46,21,74
FC Salzburg,6081,2,20,8,8,66,38,28,68
Vienna,6081,3,20,8,8,70,48,22,68
SK Sturm Gra,6081,4,15,8,13,52,39,13,53
Admira Wacke,6081,5,15,6,15,41,58,-17,51
RZ Pellets W,6081,6,13,7,16,49,50,-1,46
Rapid Vienna,6081,7,10,13,13,52,42,10,43
Mattersburg,6081,8,8,10,18,35,56,-21,34
SV Josko Rie,6081,9,10,4,22,34,56,-22,34
St. Pölten,6081,10,5,12,19,34,67,-33,27
FC Salzburg,6082,1,21,8,7,68,28,40,71
SC Rheindorf,6082,2,21,6,9,63,44,19,69
SK Sturm Gra,6082,3,20,5,11,54,32,22,65
Vienna,6082,4,19,6,11,63,53,10,63
Rapid Vienna,6082,5,14,11,11,51,39,12,53
RZ Pellets W,6082,6,12,8,16,43,53,-10,44
Admira Wacke,6082,7,11,7,18,32,50,-18,40
Mattersburg,6082,8,10,5,21,34,60,-26,35
SV Josko Rie,6082,9,10,3,23,32,56,-24,33
St. Pölten,6082,10,8,9,19,34,59,-25,33
SC Rheindorf,6083,1,20,8,8,61,35,26,68
FC Salzburg,6083,2,20,7,9,60,38,22,67
SK Sturm Gra,6083,3,19,9,8,71,36,35,66
Vienna,6083,4,17,8,11,66,54,12,59
Rapid Vienna,6083,5,14,11,11,59,44,15,53
SV Josko Rie,6083,6,12,7,17,36,49,-13,43
RZ Pellets W,6083,7,10,7,19,39,57,-18,37
Mattersburg,6083,8,9,9,18,40,62,-22,36
Admira Wacke,6083,9,10,6,20,31,64,-33,36
St. Pölten,6083,10,9,8,19,44,68,-24,35
FC Salzburg,6084,1,22,9,5,71,28,43,75
SC Rheindorf,6084,2,19,9,8,56,37,19,66
SK Sturm Gra,6084,3,18,7,11,53,38,15,61
Vienna,6084,4,16,6,14,59,54,5,54
Rapid Vienna,6084,5,13,10,13,52,40,12,49
RZ Pellets W,6084,6,14,7,15,52,56,-4,49
SV Josko Rie,6084,7,11,9,16,42,49,-7,42
Admira Wacke,6084,8,11,7,18,41,67,-26,40
St. Pölten,6084,9,9,10,17,43,66,-23,37
Mattersburg,6084,10,7,6,23,37,71,-34,27
FC Salzburg,6085,1,21,9,6,68,36,32,72
SC Rheindorf,6085,2,20,8,8,55,37,18,68
SK Sturm Gra,6085,3,17,8,11,50,33,17,59
Vienna,6085,4,18,4,14,68,53,15,58
Rapid Vienna,6085,5,14,14,8,62,42,20,56
RZ Pellets W,6085,6,13,9,14,48,55,-7,48
Admira Wacke,6085,7,10,10,16,36,56,-20,40
Mattersburg,6085,8,8,9,19,33,55,-22,33
SV Josko Rie,6085,9,8,9,19,32,54,-22,33
St. Pölten,6085,10,6,10,20,36,67,-31,28
FC Salzburg,6086,1,21,7,8,68,35,33,70
SC Rheindorf,6086,2,20,5,11,55,44,11,65
SK Sturm Gra,6086,3,19,5,12,67,43,24,62
Vienna,6086,4,19,5,12,72,59,13,62
Rapid Vienna,6086,5,13,10,13,54,39,15,49
St. Pölten,6086,6,11,10,15,45,58,-13,43
Mattersburg,6086,7,11,9,16,40,55,-15,42
RZ Pellets W,6086,8,11,7,18,46,63,-17,40
Admira Wacke,6086,9,12,4,20,32,62,-30,40
SV Josko Rie,6086,10,9,6,21,32,53,-21,33
SK Sturm Gra,6087,1,19,10,7,67,30,37,67
SC Rheindorf,6087,2,20,7,9,56,44,12,67
FC Salzburg,6087,3,19,9,8,66,36,30,66
Vienna,6087,4,16,9,11,59,49,10,57
Rapid Vienna,6087,5,12,10,14,49,43,6,46
RZ Pellets W,6087,6,12,8,16,42,56,-14,44
St. Pölten,6087,7,11,9,16,40,54,-14,42
Admira Wacke,6087,8,11,8,17,37,57,-20,41
SV Josko Rie,6087,9,11,5,20,34,51,-17,38
Mattersburg,6087,10,8,7,21,37,67,-30,31
FC Salzburg,6088,1,21,9,6,59,26,33,72
Vienna,6088,2,20,5,11,65,40,25,65
SC Rheindorf,6088,3,18,7,11,48,40,8,61
SK Sturm Gra,6088,4,16,10,10,46,30,16,58
Rapid Vienna,6088,5,15,11,10,59,43,16,56
Admira Wacke,6088,6,12,7,17,36,58,-22,43
RZ Pellets W,6088,7,10,9,17,44,56,-12,39
SV Josko Rie,6088,8,11,4,21,34,52,-18,37
Mattersburg,6088,9,8,11,17,34,54,-20,35
St. Pölten,6088,10,8,9,19,42,68,-26,33
FC Salzburg,6089,1,23,7,6,70,26,44,76
SK Sturm Gra,6089,2,21,6,9,59,30,29,69
SC Rheindorf,6089,3,17,8,11,49,42,7,59
Vienna,6089,4,19,2,15,60,55,5,59
Rapid Vienna,6089,5,15,10,11,56,38,18,55
RZ Pellets W,6089,6,14,9,13,50,50,0,51
Admira Wacke,6089,7,12,8,16,41,56,-15,44
Mattersburg,6089,8,9,10,17,35,52,-17,37
St. Pölten,6089,9,5,12,19,34,64,-30,27
SV Josko Rie,6089,10,7,4,25,26,67,-41,25
SK Sturm Gra,6090,1,22,5,9,63,29,34,71
FC Salzburg,6090,2,20,9,7,60,27,33,69
SC Rheindorf,6090,3,19,4,13,54,48,6,61
Rapid Vienna,6090,4,15,11,10,64,39,25,56
Vienna,6090,5,17,4,15,58,57,1,55
RZ Pellets W,6090,6,15,5,16,47,51,-4,50
SV Josko Rie,6090,7,11,6,19,36,54,-18,39
Mattersburg,6090,8,9,9,18,38,56,-18,36
St. Pölten,6090,9,9,9,18,41,69,-28,36
Admira Wacke,6090,10,8,8,20,32,63,-31,32
FC Salzburg,6091,1,22,7,7,69,31,38,73
SC Rheindorf,6091,2,19,8,9,53,40,13,65
Vienna,6091,3,17,8,11,57,50,7,59
SK Sturm Gra,6091,4,15,12,9,50,33,17,57
Rapid Vienna,6091,5,13,11,12,59,41,18,50
RZ Pellets W,6091,6,12,9,15,42,53,-11,45
Admira Wacke,6091,7,13,5,18,38,56,-18,44
Mattersburg,6091,8,11,8,17,41,57,-16,41
SV Josko Rie,6091,9,9,8,19,33,55,-22,35
St. Pölten,6091,10,6,10,20,40,66,-26,28
FC Salzburg,6092,1,24,6,6,69,28,41,78
SC Rheindorf,6092,2,18,8,10,63,46,17,62
SK Sturm Gra,6092,3,17,9,10,59,35,24,60
Vienna,6092,4,17,7,12,65,63,2,58
Rapid Vienna,6092,5,14,13,9,55,39,16,55
RZ Pellets W,6092,6,12,8,16,50,53,-3,44
Admira Wacke,6092,7,12,7,17,41,62,-21,43
SV Josko Rie,6092,8,11,5,20,33,51,-18,38
Mattersburg,6092,9,8,8,20,36,61,-25,32
St. Pölten,6092,10,7,9,20,35,68,-33,30
FC Salzburg,6093,1,21,9,6,63,25,38,72
Vienna,6093,2,20,3,13,57,51,6,63
Rapid Vienna,6093,3,17,11,8,59,36,23,62
SC Rheindorf,6093,4,18,8,10,57,45,12,62
SK Sturm Gra,6093,5,17,10,9,51,29,22,61
RZ Pellets W,6093,6,12,6,18,45,57,-12,42
Admira Wacke,6093,7,11,6,19,32,58,-26,39
SV Josko Rie,6093,8,10,4,22,34,52,-18,34
St. Pölten,6093,9,8,10,18,40,64,-24,34
Mattersburg,6093,10,8,9,19,41,62,-21,33
SK Sturm Gra,6094,1,20,8,8,61,35,26,68
SC Rheindorf,6094,2,19,7,10,55,45,10,64
FC Salzburg,6094,3,18,9,9,64,35,29,63
Vienna,6094,4,19,5,12,59,50,9,62
Rapid Vienna,6094,5,17,8,11,67,46,21,59
RZ Pellets W,6094,6,14,5,17,52,62,-10,47
SV Josko Rie,6094,7,11,7,18,36,52,-16,40
Admira Wacke,6094,8,10,7,19,40,65,-25,37
Mattersburg,6094,9,9,8,19,37,55,-18,35
St. Pölten,6094,10,6,10,20,37,63,-26,28
FC Salzburg,6095,1,23,7,6,65,27,38,76
SC Rheindorf,6095,2,20,8,8,59,47,12,68
Vienna,6095,3,17,9,10,58,49,9,60
Rapid Vienna,6095,4,16,8,12,55,39,16,56
SK Sturm Gra,6095,5,15,6,15,53,39,14,51
RZ Pellets W,6095,6,12,7,17,43,58,-15,43
St. Pölten,6095,7,11,8,17,50,62,-12,41
Admira Wacke,6095,8,12,5,19,36,62,-26,41
SV Josko Rie,6095,9,11,6,19,31,46,-15,39
Mattersburg,6095,10,7,8,21,36,57,-21,29
FC Salzburg,6096,1,23,5,8,68,32,36,74
SK Sturm Gra,6096,2,23,4,9,67,32,35,73
SC Rheindorf,6096,3,17,11,8,58,50,8,62
Rapid Vienna,6096,4,14,11,11,51,36,15,53
Vienna,6096,5,16,5,15,58,50,8,53
RZ Pellets W,6096,6,15,7,14,54,54,0,52
Mattersburg,6096,7,10,8,18,39,52,-13,38
Admira Wacke,6096,8,10,7,19,32,59,-27,37
SV Josko Rie,6096,9,8,7,21,27,60,-33,31
St. Pölten,6096,10,4,15,17,36,65,-29,27
SC Rheindorf,6097,1,19,9,8,55,37,18,66
Vienna,6097,2,19,6,11,69,45,24,63
FC Salzburg,6097,3,18,8,10,63,40,23,62
SK Sturm Gra,6097,4,19,5,12,55,33,22,62
Rapid Vienna,6097,5,15,11,10,53,39,14,56
SV Josko Rie,6097,6,12,9,15,39,52,-13,45
RZ Pellets W,6097,7,12,8,16,42,52,-10,44
Admira Wacke,6097,8,10,9,17,32,61,-29,39
Mattersburg,6097,9,9,6,21,43,63,-20,33
St. Pölten,6097,10,7,9,20,37,66,-29,30
FC Salzburg,6098,1,23,7,6,70,30,40,76
SK Sturm Gra,6098,2,20,5,11,60,33,27,65
SC Rheindorf,6098,3,18,6,12,55,50,5,60
Vienna,6098,4,18,5,13,66,51,15,59
Rapid Vienna,6098,5,14,11,11,48,35,13,53
RZ Pellets W,6098,6,12,8,16,47,55,-8,44
Admira Wacke,6098,7,13,5,18,38,62,-24,44
SV Josko Rie,6098,8,9,11,16,37,53,-16,38
Mattersburg,6098,9,7,10,19,36,59,-23,31
St. Pölten,6098,10,6,12,18,36,65,-29,30
FC Salzburg,6099,1,22,8,6,71,30,41,74
SC Rheindorf,6099,2,21,5,10,53,40,13,68
SK Sturm Gra,6099,3,20,3,13,61,35,26,63
Vienna,6099,4,17,5,14,61,53,8,56
Admira Wacke,6099,5,16,4,16,38,60,-22,52
Rapid Vienna,6099,6,14,8,14,51,44,7,50
RZ Pellets W,6099,7,12,7,17,37,47,-10,43
St. Pölten,6099,8,9,10,17,39,59,-20,37
SV Josko Rie,6099,9,10,6,20,33,52,-19,36
Mattersburg,6099,10,6,10,20,33,57,-24,28
SC Rheindorf,6100,1,22,5,9,58,39,19,71
FC Salzburg,6100,2,20,8,8,65,32,33,68
Vienna,6100,3,20,4,12,65,51,14,64
SK Sturm Gra,6100,4,18,6,12,57,38,19,60
Rapid Vienna,6100,5,11,13,12,55,43,12,46
Admira Wacke,6100,6,12,7,17,36,56,-20,43
RZ Pellets W,6100,7,11,6,19,44,57,-13,39
SV Josko Rie,6100,8,11,6,19,36,58,-22,39
St. Pölten,6100,9,10,9,17,40,63,-23,39
Mattersburg,6100,10,9,8,19,40,59,-19,35
FC Salzburg,6101,1,22,7,7,71,37,34,73
SC Rheindorf,6101,2,19,5,12,59,50,9,62
Vienna,6101,3,16,8,12,62,59,3,56
Rapid Vienna,6101,4,15,9,12,62,44,18,54
SK Sturm Gra,6101,5,15,8,13,51,38,13,53
RZ Pellets W,6101,6,15,6,15,49,56,-7,51
SV Josko Rie,6101,7,13,5,18,38,48,-10,44
Mattersburg,6101,8,12,6,18,44,55,-11,42
Admira Wacke,6101,9,11,5,20,42,61,-19,38
St. Pölten,6101,10,8,9,19,33,63,-30,33
FC Salzburg,6102,1,22,9,5,71,24,47,75
SC Rheindorf,6102,2,20,7,9,57,45,12,67
SK Sturm Gra,6102,3,19,8,9,56,33,23,65
Vienna,6102,4,18,7,11,62,53,9,61
Rapid Vienna,6102,5,12,11,13,53,48,5,47
RZ Pellets W,6102,6,10,10,16,47,56,-9,40
St. Pölten,6102,7,9,11,16,44,63,-19,38
SV Josko Rie,6102,8,10,8,18,35,55,-20,38
Admira Wacke,6102,9,8,9,19,34,63,-29,33
Mattersburg,6102,10,8,8,20,41,60,-19,32
FC Salzburg,6103,1,20,7,9,64,33,31,67
SK Sturm Gra,6103,2,20,6,10,60,33,27,66
SC Rheindorf,6103,3,19,7,10,58,46,12,64
Vienna,6103,4,18,6,12,59,47,12,60
Rapid Vienna,6103,5,16,9,11,58,36,22,57
RZ Pellets W,6103,6,12,8,16,46,55,-9,44
St. Pölten,6103,7,11,9,16,46,59,-13,42
Admira Wacke,6103,8,11,8,17,33,58,-25,41
SV Josko Rie,6103,9,10,6,20,35,61,-26,36
Mattersburg,6103,10,7,6,23,33,64,-31,27
SC Rheindorf,6104,1,23,8,5,65,38,27,77
SK Sturm Gra,6104,2,21,5,10,66,31,35,68
FC Salzburg,6104,3,19,10,7,63,31,32,67
Vienna,6104,4,19,2,15,52,53,-1,59
Admira Wacke,6104,5,13,7,16,38,56,-18,46
Rapid Vienna,6104,6,11,11,14,50,46,4,44
St. Pölten,6104,7,11,7,18,50,67,-17,40
RZ Pellets W,6104,8,11,6,19,36,55,-19,39
SV Josko Rie,6104,9,11,4,21,37,54,-17,37
Mattersburg,6104,10,7,8,21,33,59,-26,29
FC Salzburg,6105,1,24,6,6,78,27,51,78
SC Rheindorf,6105,2,19,10,7,53,40,13,67
SK Sturm Gra,6105,3,19,7,10,65,39,26,64
Vienna,6105,4,19,5,12,61,49,12,62
Rapid Vienna,6105,5,12,9,15,54,47,7,45
St. Pölten,6105,6,9,11,16,45,64,-19,38
Admira Wacke,6105,7,10,8,18,31,57,-26,38
RZ Pellets W,6105,8,9,10,17,43,62,-19,37
SV Josko Rie,6105,9,10,7,19,32,53,-21,37
Mattersburg,6105,10,8,9,19,37,61,-24,33
SC Rheindorf,6106,1,21,8,7,61,39,22,71
SK Sturm Gra,6106,2,20,7,9,64,33,31,67
FC Salzburg,6106,3,18,10,8,65,35,30,64
Vienna,6106,4,17,7,12,58,53,5,58
Rapid Vienna,6106,5,13,13,10,52,41,11,52
RZ Pellets W,6106,6,11,7,18,46,60,-14,40
Admira Wacke,6106,7,10,9,17,39,62,-23,39
St. Pölten,6106,8,9,11,16,43,68,-25,38
Mattersburg,6106,9,9,8,19,43,60,-17,35
SV Josko Rie,6106,10,9,6,21,30,50,-20,33
FC Salzburg,6107,1,19,9,8,66,30,36,66
SK Sturm Gra,6107,2,18,9,9,59,32,27,63
SC Rheindorf,6107,3,18,9,9,55,41,14,63
Vienna,6107,4,17,7,12,60,55,5,58
RZ Pellets W,6107,5,14,9,13,49,48,1,51
Rapid Vienna,6107,6,12,14,10,48,34,14,50
Admira Wacke,6107,7,12,7,17,36,62,-26,43
SV Josko Rie,6107,8,10,6,20,32,57,-25,36
St. Pölten,6107,9,9,7,20,38,65,-27,34
Mattersburg,6107,10,7,11,18,35,54,-19,32
FC Salzburg,6108,1,23,6,7,66,28,38,75
SK Sturm Gra,6108,2,21,6,9,61,31,30,69
SC Rheindorf,6108,3,19,10,7,47,32,15,67
Vienna,6108,4,17,6,13,60,53,7,57
Rapid Vienna,6108,5,14,9,13,50,42,8,51
Admira Wacke,6108,6,14,3,19,37,58,-21,45
RZ Pellets W,6108,7,12,6,18,46,57,-11,42
SV Josko Rie,6108,8,10,8,18,38,55,-17,38
St. Pölten,6108,9,7,9,20,40,64,-24,30
Mattersburg,6108,10,7,9,20,32,57,-25,30
FC Salzburg,6109,1,21,9,6,64,25,39,72
SC Rheindorf,6109,2,18,11,7,53,39,14,65
Vienna,6109,3,19,6,11,64,49,15,63
SK Sturm Gra,6109,4,18,6,12,60,40,20,60
Rapid Vienna,6109,5,12,11,13,50,44,6,47
Admira Wacke,6109,6,14,3,19,42,60,-18,45
St. Pölten,6109,7,11,8,17,39,58,-19,41
SV Josko Rie,6109,8,11,4,21,34,58,-24,37
RZ Pellets W,6109,9,9,9,18,46,62,-16,36
Mattersburg,6109,10,7,13,16,40,57,-17,34
FC Salzburg,6110,1,24,7,5,75,28,47,79
Vienna,6110,2,20,6,10,65,49,16,66
SC Rheindorf,6110,3,19,8,9,56,46,10,65
SK Sturm Gra,6110,4,18,7,11,63,41,22,61
Rapid Vienna,6110,5,13,11,12,51,41,10,50
Mattersburg,6110,6,11,9,16,42,54,-12,42
RZ Pellets W,6110,7,10,8,18,43,61,-18,38
Admira Wacke,6110,8,11,5,20,40,63,-23,38
St. Pölten,6110,9,8,10,18,40,66,-26,34
SV Josko Rie,6110,10,8,5,23,25,51,-26,29
Vienna,6111,1,24,4,8,75,45,30,76
FC Salzburg,6111,2,19,8,9,66,37,29,65
SK Sturm Gra,6111,3,16,9,11,55,39,16,57
SC Rheindorf,6111,4,15,10,11,49,48,1,55
Rapid Vienna,6111,5,11,12,13,52,44,8,45
RZ Pellets W,6111,6,12,9,15,46,54,-8,45
Admira Wacke,6111,7,11,8,17,34,55,-21,41
SV Josko Rie,6111,8,11,6,19,34,50,-16,39
Mattersburg,6111,9,10,8,18,38,55,-17,38
St. Pölten,6111,10,8,12,16,37,59,-22,36
FC Salzburg,6112,1,21,5,10,63,32,31,68
SC Rheindorf,6112,2,18,8,10,55,38,17,62
Rapid Vienna,6112,3,17,7,12,61,41,20,58
SK Sturm Gra,6112,4,17,6,13,56,42,14,57
Vienna,6112,5,15,7,14,56,53,3,52
RZ Pellets W,6112,6,13,8,15,48,53,-5,47
SV Josko Rie,6112,7,14,5,17,37,47,-10,47
Admira Wacke,6112,8,14,5,17,41,61,-20,47
Mattersburg,6112,9,11,6,19,40,59,-19,39
St. Pölten,6112,10,7,9,20,40,71,-31,30
FC Salzburg,6113,1,21,7,8,62,29,33,70
Vienna,6113,2,22,4,10,66,48,18,70
SC Rheindorf,6113,3,19,8,9,60,41,19,65
SK Sturm Gra,6113,4,19,6,11,56,35,21,63
Rapid Vienna,6113,5,13,11,12,47,38,9,50
Admira Wacke,6113,6,14,6,16,43,53,-10,48
RZ Pellets W,6113,7,13,6,17,47,55,-8,45
St. Pölten,6113,8,9,10,17,39,63,-24,37
Mattersburg,6113,9,8,7,21,32,60,-28,31
SV Josko Rie,6113,10,7,5,24,29,59,-30,26
FC Salzburg,6114,1,18,8,10,59,30,29,62
SC Rheindorf,6114,2,18,8,10,56,46,10,62
SK Sturm Gra,6114,3,18,7,11,59,44,15,61
Vienna,6114,4,17,5,14,59,58,1,56
Rapid Vienna,6114,5,15,10,11,56,37,19,55
RZ Pellets W,6114,6,12,10,14,52,56,-4,46
Admira Wacke,6114,7,13,7,16,45,64,-19,46
SV Josko Rie,6114,8,12,6,18,37,48,-11,42
Mattersburg,6114,9,9,11,16,37,52,-15,38
St. Pölten,6114,10,7,10,19,40,65,-25,31
FC Salzburg,6115,1,23,9,4,63,23,40,78
SC Rheindorf,6115,2,23,7,6,61,33,28,76
SK Sturm Gra,6115,3,18,6,12,59,42,17,60
Vienna,6115,4,18,6,12,64,54,10,60
Rapid Vienna,6115,5,12,11,13,51,46,5,47
RZ Pellets W,6115,6,13,6,17,45,53,-8,45
Admira Wacke,6115,7,10,7,19,33,59,-26,37
St. Pölten,6115,8,9,9,18,43,61,-18,36
Mattersburg,6115,9,9,7,20,40,55,-15,34
SV Josko Rie,6115,10,9,4,23,33,66,-33,31
FC Salzburg,6116,1,22,8,6,70,31,39,74
SK Sturm Gra,6116,2,21,5,10,62,33,29,68
SC Rheindorf,6116,3,18,9,9,55,45,10,63
Vienna,6116,4,18,7,11,68,55,13,61
RZ Pellets W,6116,5,14,7,15,54,57,-3,49
Rapid Vienna,6116,6,13,9,14,47,40,7,48
Admira Wacke,6116,7,9,10,17,34,58,-24,37
SV Josko Rie,6116,8,10,6,20,29,52,-23,36
Mattersburg,6116,9,9,8,19,40,62,-22,35
St. Pölten,6116,10,7,9,20,37,63,-26,30
FC Salzburg,6117,1,23,5,8,67,27,40,74
SC Rheindorf,6117,2,21,6,9,56,38,18,69
SK Sturm Gra,6117,3,20,6,10,58,30,28,66
Vienna,6117,4,18,4,14,60,59,1,58
Rapid Vienna,6117,5,14,10,12,57,38,19,52
RZ Pellets W,6117,6,14,7,15,47,53,-6,49
SV Josko Rie,6117,7,13,3,20,32,48,-16,42
St. Pölten,6117,8,10,10,16,47,64,-17,40
Admira Wacke,6117,9,10,5,21,35,66,-31,35
Mattersburg,6117,10,6,6,24,33,69,-36,24
SC Rheindorf,6118,1,19,8,9,55,44,11,65
FC Salzburg,6118,2,18,10,8,63,37,26,64
SK Sturm Gra,6118,3,19,6,11,61,37,24,63
Vienna,6118,4,19,6,11,65,52,13,63
RZ Pellets W,6118,5,15,7,14,51,54,-3,52
Rapid Vienna,6118,6,13,11,12,57,40,17,50
Admira Wacke,6118,7,11,7,18,37,58,-21,40
Mattersburg,6118,8,9,11,16,35,54,-19,38
SV Josko Rie,6118,9,10,4,22,30,52,-22,34
St. Pölten,6118,10,8,8,20,38,64,-26,32
FC Salzburg,6119,1,22,10,4,73,29,44,76
SK Sturm Gra,6119,2,18,6,12,54,31,23,60
Vienna,6119,3,18,6,12,67,56,11,60
SC Rheindorf,6119,4,15,9,12,53,54,-1,54
Rapid Vienna,6119,5,14,10,12,50,41,9,52
RZ Pellets W,6119,6,15,5,16,57,64,-7,50
SV Josko Rie,6119,7,13,4,19,39,55,-16,43
Mattersburg,6119,8,11,8,17,41,57,-16,41
Admira Wacke,6119,9,10,6,20,35,60,-25,36
St. Pölten,6119,10,7,10,19,37,59,-22,31
SK Sturm Gra,6120,1,21,5,10,59,39,20,68
FC Salzburg,6120,2,21,4,11,76,39,37,67
SC Rheindorf,6120,3,19,7,10,57,44,13,64
Rapid Vienna,6120,4,16,10,10,68,41,27,58
Vienna,6120,5,17,7,12,61,59,2,58
Mattersburg,6120,6,11,9,16,46,56,-10,42
RZ Pellets W,6120,7,11,8,17,40,56,-16,41
Admira Wacke,6120,8,12,5,19,37,62,-25,41
St. Pölten,6120,9,8,10,18,44,67,-23,34
SV Josko Rie,6120,10,9,5,22,30,55,-25,32
FC Salzburg,6121,1,22,6,8,62,26,36,72
SC Rheindorf,6121,2,19,9,8,52,40,12,66
SK Sturm Gra,6121,3,19,7,10,62,29,33,64
Vienna,6121,4,18,6,12,60,45,15,60
Rapid Vienna,6121,5,14,11,11,56,41,15,53
Admira Wacke,6121,6,11,10,15,36,54,-18,43
RZ Pellets W,6121,7,12,7,17,48,70,-22,43
SV Josko Rie,6121,8,12,3,21,36,52,-16,39
St. Pölten,6121,9,9,9,18,41,65,-24,36
Mattersburg,6121,10,6,8,22,33,64,-31,26
FC Salzburg,6122,1,22,5,9,65,31,34,71
Vienna,6122,2,21,4,11,71,50,21,67
SK Sturm Gra,6122,3,19,7,10,58,34,24,64
SC Rheindorf,6122,4,17,8,11,53,46,7,59
Rapid Vienna,6122,5,13,11,12,57,42,15,50
RZ Pellets W,6122,6,11,9,16,42,55,-13,42
Admira Wacke,6122,7,11,9,16,36,54,-18,42
St. Pölten,6122,8,10,7,19,39,63,-24,37
Mattersburg,6122,9,9,9,18,39,59,-20,36
SV Josko Rie,6122,10,11,3,22,35,61,-26,36
FC Salzburg,6123,1,21,7,8,65,32,33,70
SK Sturm Gra,6123,2,22,4,10,64,37,27,70
SC Rheindorf,6123,3,19,6,11,59,50,9,63
Rapid Vienna,6123,4,17,9,10,62,36,26,60
Vienna,6123,5,19,3,14,68,55,13,60
St. Pölten,6123,6,13,8,15,49,55,-6,47
SV Josko Rie,6123,7,10,7,19,40,59,-19,37
RZ Pellets W,6123,8,9,9,18,34,63,-29,36
Admira Wacke,6123,9,10,5,21,38,67,-29,35
Mattersburg,6123,10,7,8,21,38,63,-25,29
SC Rheindorf,6124,1,23,7,6,62,39,23,76
FC Salzburg,6124,2,20,5,11,64,42,22,65
Vienna,6124,3,19,4,13,63,52,11,61
Rapid Vienna,6124,4,17,9,10,63,42,21,60
SK Sturm Gra,6124,5,14,9,13,54,45,9,51
RZ Pellets W,6124,6,12,8,16,41,51,-10,44
SV Josko Rie,6124,7,12,5,19,40,50,-10,41
Mattersburg,6124,8,11,8,17,38,51,-13,41
Admira Wacke,6124,9,9,7,20,39,64,-25,34
St. Pölten,6124,10,6,12,18,36,64,-28,30
SK Sturm Gra,6125,1,21,7,8,72,30,42,70
FC Salzburg,6125,2,20,9,7,61,32,29,69
SC Rheindorf,6125,3,19,8,9,59,44,15,65
Rapid Vienna,6125,4,16,10,10,61,39,22,58
Vienna,6125,5,17,6,13,63,56,7,57
SV Josko Rie,6125,6,15,4,17,43,56,-13,49
RZ Pellets W,6125,7,10,9,17,44,57,-13,39
Admira Wacke,6125,8,11,6,19,31,60,-29,39
Mattersburg,6125,9,8,7,21,46,67,-21,31
St. Pölten,6125,10,6,8,22,34,73,-39,26
SK Sturm Gra,6126,1,21,7,8,55,29,26,70
FC Salzburg,6126,2,20,7,9,67,34,33,67
SC Rheindorf,6126,3,20,7,9,51,38,13,67
RZ Pellets W,6126,4,16,7,13,50,47,3,55
Vienna,6126,5,14,8,14,57,50,7,50
Rapid Vienna,6126,6,11,13,12,53,40,13,46
Admira Wacke,6126,7,13,3,20,31,57,-26,42
SV Josko Rie,6126,8,11,6,19,32,54,-22,39
St. Pölten,6126,9,9,7,20,38,59,-21,34
Mattersburg,6126,10,8,9,19,29,55,-26,33
SC Rheindorf,6127,1,20,6,10,57,42,15,66
FC Salzburg,6127,2,20,5,11,63,31,32,65
SK Sturm Gra,6127,3,20,5,11,57,36,21,65
Vienna,6127,4,19,4,13,60,47,13,61
Rapid Vienna,6127,5,17,8,11,59,40,19,59
SV Josko Rie,6127,6,13,4,19,35,50,-15,43
RZ Pellets W,6127,7,11,7,18,38,61,-23,40
St. Pölten,6127,8,10,9,17,48,62,-14,39
Mattersburg,6127,9,10,6,20,34,54,-20,36
Admira Wacke,6127,10,10,6,20,42,70,-28,36
SK Sturm Gra,6128,1,20,7,9,64,37,27,67
FC Salzburg,6128,2,20,6,10,65,33,32,66
SC Rheindorf,6128,3,18,10,8,59,37,22,64
Vienna,6128,4,17,6,13,57,51,6,57
Rapid Vienna,6128,5,15,11,10,56,40,16,56
RZ Pellets W,6128,6,11,8,17,43,59,-16,41
SV Josko Rie,6128,7,11,7,18,34,52,-18,40
Admira Wacke,6128,8,11,7,18,37,57,-20,40
Mattersburg,6128,9,9,10,17,41,60,-19,37
St. Pölten,6128,10,8,8,20,36,66,-30,32
FC Salzburg,6129,1,21,7,8,68,31,37,70
SC Rheindorf,6129,2,21,6,9,57,40,17,69
Vienna,6129,3,19,4,13,63,55,8,61
Rapid Vienna,6129,4,15,9,12,54,41,13,54
SK Sturm Gra,6129,5,15,7,14,50,37,13,52
RZ Pellets W,6129,6,12,7,17,50,61,-11,43
St. Pölten,6129,7,11,9,16,41,59,-18,42
SV Josko Rie,6129,8,12,5,19,43,55,-12,41
Admira Wacke,6129,9,10,7,19,37,60,-23,37
Mattersburg,6129,10,8,11,17,36,60,-24,35
SK Sturm Gra,6130,1,22,7,7,67,33,34,73
FC Salzburg,6130,2,21,9,6,70,31,39,72
SC Rheindorf,6130,3,18,8,10,58,43,15,62
Rapid Vienna,6130,4,15,9,12,58,42,16,54
Vienna,6130,5,17,2,17,56,63,-7,53
Admira Wacke,6130,6,13,7,16,43,57,-14,46
SV Josko Rie,6130,7,12,7,17,43,49,-6,43
St. Pölten,6130,8,10,10,16,38,57,-19,40
RZ Pellets W,6130,9,10,5,21,39,64,-25,35
Mattersburg,6130,10,6,8,22,37,70,-33,26
FC Salzburg,6131,1,20,9,7,66,29,37,69
SK Sturm Gra,6131,2,20,6,10,62,37,25,66
SC Rheindorf,6131,3,18,8,10,52,42,10,62
Vienna,6131,4,16,4,16,56,52,4,52
RZ Pellets W,6131,5,15,7,14,51,53,-2,52
Rapid Vienna,6131,6,12,11,13,51,47,4,47
SV Josko Rie,6131,7,12,7,17,36,49,-13,43
St. Pölten,6131,8,9,10,17,43,64,-21,37
Mattersburg,6131,9,9,9,18,39,56,-17,36
Admira Wacke,6131,10,9,9,18,31,58,-27,36
FC Salzburg,6132,1,23,6,7,71,34,37,75
SC Rheindorf,6132,2,19,9,8,56,37,19,66
Vienna,6132,3,19,6,11,65,55,10,63
SK Sturm Gra,6132,4,17,6,13,57,39,18,57
Rapid Vienna,6132,5,15,8,13,58,49,9,53
RZ Pellets W,6132,6,14,7,15,47,52,-5,49
Admira Wacke,6132,7,14,4,18,37,56,-19,46
Mattersburg,6132,8,8,10,18,44,60,-16,34
St. Pölten,6132,9,7,10,19,39,61,-22,31
SV Josko Rie,6132,10,8,6,22,30,61,-31,30
FC Salzburg,6133,1,23,8,5,68,25,43,77
SK Sturm Gra,6133,2,19,6,11,55,36,19,63
SC Rheindorf,6133,3,17,7,12,50,48,2,58
Rapid Vienna,6133,4,16,9,11,61,39,22,57
Vienna,6133,5,16,5,15,64,59,5,53
RZ Pellets W,6133,6,13,9,14,51,58,-7,48
SV Josko Rie,6133,7,13,7,16,41,52,-11,46
Admira Wacke,6133,8,11,5,20,37,63,-26,38
Mattersburg,6133,9,8,8,20,33,53,-20,32
St. Pölten,6133,10,7,10,19,43,70,-27,31
FC Salzburg,6134,1,21,6,9,59,28,31,69
SK Sturm Gra,6134,2,21,6,9,57,29,28,69
SC Rheindorf,6134,3,19,8,9,50,37,13,65
Vienna,6134,4,16,7,13,53,57,-4,55
Rapid Vienna,6134,5,12,11,13,52,41,11,47
Mattersburg,6134,6,12,9,15,46,51,-5,45
RZ Pellets W,6134,7,12,7,17,47,60,-13,43
Admira Wacke,6134,8,11,6,19,35,59,-24,39
SV Josko Rie,6134,9,11,5,20,42,56,-14,38
St. Pölten,6134,10,8,9,19,44,67,-23,33
FC Salzburg,6135,1,22,8,6,70,31,39,74
SC Rheindorf,6135,2,18,11,7,55,38,17,65
Vienna,6135,3,18,7,11,66,54,12,61
SK Sturm Gra,6135,4,18,5,13,51,35,16,59
Rapid Vienna,6135,5,16,9,11,62,44,18,57
Admira Wacke,6135,6,13,6,17,35,53,-18,45
St. Pölten,6135,7,10,9,17,42,61,-19,39
RZ Pellets W,6135,8,10,8,18,42,59,-17,38
SV Josko Rie,6135,9,10,5,21,37,59,-22,35
Mattersburg,6135,10,7,8,21,37,63,-26,29
FC Salzburg,6136,1,22,6,8,67,33,34,72
SK Sturm Gra,6136,2,18,6,12,59,38,21,60
Vienna,6136,3,18,6,12,67,56,11,60
SC Rheindorf,6136,4,17,9,10,47,40,7,60
Admira Wacke,6136,5,15,5,16,40,58,-18,50
Rapid Vienna,6136,6,13,10,13,56,46,10,49
SV Josko Rie,6136,7,13,4,19,37,50,-13,43
RZ Pellets W,6136,8,11,9,16,48,56,-8,42
St. Pölten,6136,9,10,7,19,43,59,-16,37
Mattersburg,6136,10,9,6,21,40,68,-28,33
SK Sturm Gra,6137,1,22,8,6,62,27,35,74
FC Salzburg,6137,2,20,7,9,62,30,32,67
Vienna,6137,3,21,4,11,70,51,19,67
SC Rheindorf,6137,4,18,9,9,63,49,14,63
Rapid Vienna,6137,5,12,14,10,51,36,15,50
Admira Wacke,6137,6,13,5,18,37,63,-26,44
RZ Pellets W,6137,7,9,10,17,37,58,-21,37
Mattersburg,6137,8,8,10,18,38,57,-19,34
SV Josko Rie,6137,9,9,6,21,30,50,-20,33
St. Pölten,6137,10,7,9,20,34,63,-29,30
SC Rheindorf,6138,1,24,7,5,64,36,28,79
FC Salzburg,6138,2,20,9,7,63,32,31,69
SK Sturm Gra,6138,3,17,8,11,67,41,26,59
Vienna,6138,4,16,7,13,58,58,0,55
Rapid Vienna,6138,5,14,11,11,55,44,11,53
Admira Wacke,6138,6,14,6,16,54,58,-4,48
Mattersburg,6138,7,9,10,17,36,54,-18,37
St. Pölten,6138,8,10,7,19,47,71,-24,37
RZ Pellets W,6138,9,9,9,18,39,58,-19,36
SV Josko Rie,6138,10,6,8,22,28,59,-31,26
FC Salzburg,6139,1,22,5,9,71,30,41,71
SK Sturm Gra,6139,2,22,4,10,65,32,33,70
SC Rheindorf,6139,3,17,10,9,48,40,8,61
Rapid Vienna,6139,4,16,10,10,56,39,17,58
Vienna,6139,5,17,5,14,60,55,5,56
Admira Wacke,6139,6,13,6,17,35,54,-19,45
RZ Pellets W,6139,7,11,9,16,52,64,-12,42
SV Josko Rie,6139,8,12,6,18,34,50,-16,42
Mattersburg,6139,9,8,8,20,33,59,-26,32
St. Pölten,6139,10,5,11,20,35,66,-31,26
FC Salzburg,6140,1,23,5,8,71,35,36,74
SK Sturm Gra,6140,2,22,6,8,59,29,30,72
SC Rheindorf,6140,3,20,6,10,56,39,17,66
Vienna,6140,4,16,6,14,63,53,10,54
Admira Wacke,6140,5,14,5,17,41,56,-15,47
RZ Pellets W,6140,6,13,6,17,48,57,-9,45
Rapid Vienna,6140,7,11,10,15,48,45,3,43
SV Josko Rie,6140,8,12,5,19,30,49,-19,41
Mattersburg,6140,9,8,8,20,35,60,-25,32
St. Pölten,6140,10,7,11,18,36,64,-28,32
SK Sturm Gra,6141,1,17,13,6,59,29,30,64
SC Rheindorf,6141,2,18,10,8,52,35,17,64
Rapid Vienna,6141,3,16,13,7,61,38,23,61
Vienna,6141,4,18,7,11,68,50,18,61
FC Salzburg,6141,5,17,7,12,65,42,23,58
RZ Pellets W,6141,6,12,9,15,53,60,-7,45
Admira Wacke,6141,7,12,9,15,38,51,-13,45
Mattersburg,6141,8,9,9,18,33,59,-26,36
SV Josko Rie,6141,9,9,5,22,36,63,-27,32
St. Pölten,6141,10,7,8,21,39,77,-38,29
FC Salzburg,6142,1,21,10,5,68,26,42,73
SC Rheindorf,6142,2,20,10,6,52,36,16,70
SK Sturm Gra,6142,3,19,8,9,62,34,28,65
Rapid Vienna,6142,4,14,9,13,57,42,15,51
Vienna,6142,5,15,6,15,55,55,0,51
RZ Pellets W,6142,6,13,6,17,44,58,-14,45
SV Josko Rie,6142,7,11,6,19,36,55,-19,39
St. Pölten,6142,8,9,11,16,48,60,-12,38
Admira Wacke,6142,9,9,9,18,39,65,-26,36
Mattersburg,6142,10,7,9,20,36,66,-30,30
SC Rheindorf,6143,1,19,11,6,56,41,15,68
FC Salzburg,6143,2,17,10,9,55,30,25,61
Vienna,6143,3,18,6,12,62,47,15,60
SK Sturm Gra,6143,4,16,9,11,53,35,18,57
Rapid Vienna,6143,5,15,11,10,61,41,20,56
RZ Pellets W,6143,6,14,9,13,50,45,5,51
SV Josko Rie,6143,7,12,5,19,39,52,-13,41
St. Pölten,6143,8,7,12,17,35,65,-30,33
Mattersburg,6143,9,6,14,16,31,49,-18,32
Admira Wacke,6143,10,7,11,18,29,66,-37,32
SK Sturm Gra,6144,1,21,4,11,59,35,24,67
SC Rheindorf,6144,2,19,7,10,55,40,15,64
FC Salzburg,6144,3,19,6,11,65,37,28,63
Vienna,6144,4,19,4,13,62,54,8,61
Rapid Vienna,6144,5,13,10,13,54,40,14,49
Admira Wacke,6144,6,13,6,17,40,58,-18,45
RZ Pellets W,6144,7,10,11,15,43,54,-11,41
Mattersburg,6144,8,10,10,16,41,53,-12,40
St. Pölten,6144,9,9,10,17,45,70,-25,37
SV Josko Rie,6144,10,10,6,20,36,59,-23,36
FC Salzburg,6145,1,20,5,11,62,33,29,65
SK Sturm Gra,6145,2,20,4,12,62,44,18,64
Vienna,6145,3,18,4,14,68,54,14,58
SC Rheindorf,6145,4,16,9,11,49,50,-1,57
Rapid Vienna,6145,5,13,11,12,56,41,15,50
RZ Pellets W,6145,6,14,8,14,53,50,3,50
Mattersburg,6145,7,11,10,15,38,48,-10,43
Admira Wacke,6145,8,12,5,19,35,55,-20,41
SV Josko Rie,6145,9,10,8,18,32,52,-20,38
St. Pölten,6145,10,8,12,16,36,64,-28,36
FC Salzburg,6146,1,23,7,6,72,30,42,76
SK Sturm Gra,6146,2,20,6,10,69,46,23,66
SC Rheindorf,6146,3,19,7,10,56,47,9,64
Rapid Vienna,6146,4,16,11,9,60,36,24,59
Vienna,6146,5,16,3,17,60,60,0,51
RZ Pellets W,6146,6,12,9,15,48,58,-10,45
Admira Wacke,6146,7,13,5,18,34,55,-21,44
SV Josko Rie,6146,8,11,6,19,30,48,-18,39
St. Pölten,6146,9,7,11,18,38,64,-26,32
Mattersburg,6146,10,6,9,21,31,54,-23,27
SC Rheindorf,6147,1,20,6,10,61,43,18,66
FC Salzburg,6147,2,19,7,10,62,36,26,64
SK Sturm Gra,6147,3,18,7,11,54,35,19,61
Vienna,6147,4,17,5,14,70,65,5,56
Rapid Vienna,6147,5,14,11,11,52,34,18,53
Admira Wacke,6147,6,13,6,17,41,58,-17,45
RZ Pellets W,6147,7,12,8,16,43,56,-13,44
St. Pölten,6147,8,11,9,16,47,59,-12,42
Mattersburg,6147,9,10,7,19,41,56,-15,37
SV Josko Rie,6147,10,11,4,21,39,68,-29,37
Vienna,6148,1,23,5,8,67,45,22,74
FC Salzburg,6148,2,20,7,9,60,32,28,67
SK Sturm Gra,6148,3,20,6,10,65,34,31,66
Rapid Vienna,6148,4,15,11,10,57,35,22,56
SC Rheindorf,6148,5,15,10,11,52,50,2,55
RZ Pellets W,6148,6,11,7,18,43,61,-18,40
Mattersburg,6148,7,10,8,18,42,54,-12,38
Admira Wacke,6148,8,11,5,20,37,61,-24,38
St. Pölten,6148,9,8,11,17,44,68,-24,35
SV Josko Rie,6148,10,10,4,22,36,63,-27,34
SK Sturm Gra,6149,1,20,8,8,61,32,29,68
FC Salzburg,6149,2,20,7,9,58,29,29,67
SC Rheindorf,6149,3,19,9,8,59,40,19,66
Vienna,6149,4,19,6,11,71,53,18,63
Rapid Vienna,6149,5,15,10,11,58,41,17,55
Admira Wacke,6149,6,15,7,14,41,50,-9,52
SV Josko Rie,6149,7,12,4,20,38,60,-22,40
RZ Pellets W,6149,8,10,6,20,43,60,-17,36
Mattersburg,6149,9,7,9,20,35,65,-30,30
St. Pölten,6149,10,6,8,22,35,69,-34,26
SC Rheindorf,6150,1,20,10,6,61,37,24,70
SK Sturm Gra,6150,2,20,6,10,58,35,23,66
FC Salzburg,6150,3,19,8,9,66,33,33,65
Rapid Vienna,6150,4,17,8,11,65,41,24,59
Vienna,6150,5,18,4,14,68,63,5,58
RZ Pellets W,6150,6,11,8,17,49,68,-19,41
Admira Wacke,6150,7,11,7,18,31,55,-24,40
SV Josko Rie,6150,8,11,5,20,32,53,-21,38
St. Pölten,6150,9,8,11,17,43,65,-22,35
Mattersburg,6150,10,8,7,21,37,60,-23,31
SC Rheindorf,6151,1,23,4,9,61,46,15,73
Vienna,6151,2,20,6,10,71,52,19,66
FC Salzburg,6151,3,17,10,9,67,36,31,61
SK Sturm Gra,6151,4,18,7,11,63,44,19,61
RZ Pellets W,6151,5,14,5,17,47,54,-7,47
Rapid Vienna,6151,6,12,10,14,56,48,8,46
Admira Wacke,6151,7,12,6,18,36,60,-24,42
Mattersburg,6151,8,9,10,17,45,62,-17,37
SV Josko Rie,6151,9,10,6,20,33,54,-21,36
St. Pölten,6151,10,9,8,19,43,66,-23,35
FC Salzburg,6152,1,19,6,11,61,37,24,63
SK Sturm Gra,6152,2,19,6,11,57,33,24,63
SC Rheindorf,6152,3,19,4,13,51,40,11,61
Vienna,6152,4,19,4,13,58,50,8,61
Rapid Vienna,6152,5,13,12,11,62,47,15,51
RZ Pellets W,6152,6,15,5,16,50,58,-8,50
Mattersburg,6152,7,13,8,15,43,50,-7,47
Admira Wacke,6152,8,13,7,16,44,58,-14,46
SV Josko Rie,6152,9,10,4,22,29,52,-23,34
St. Pölten,6152,10,8,8,20,38,68,-30,32
SC Rheindorf,6153,1,22,6,8,60,41,19,72
FC Salzburg,6153,2,20,8,8,67,34,33,68
SK Sturm Gra,6153,3,18,8,10,55,32,23,62
Rapid Vienna,6153,4,17,10,9,63,32,31,61
Vienna,6153,5,17,6,13,58,56,2,57
RZ Pellets W,6153,6,11,9,16,38,50,-12,42
Admira Wacke,6153,7,11,6,19,35,61,-26,39
St. Pölten,6153,8,9,8,19,42,65,-23,35
SV Josko Rie,6153,9,10,5,21,37,64,-27,35
Mattersburg,6153,10,7,10,19,35,55,-20,31
FC Salzburg,6154,1,23,5,8,70,27,43,74
SK Sturm Gra,6154,2,20,5,11,50,27,23,65
Vienna,6154,3,19,7,10,65,49,16,64
SC Rheindorf,6154,4,19,7,10,53,43,10,64
Rapid Vienna,6154,5,12,11,13,54,43,11,47
RZ Pellets W,6154,6,12,10,14,46,55,-9,46
Mattersburg,6154,7,10,8,18,37,55,-18,38
Admira Wacke,6154,8,11,5,20,39,66,-27,38
SV Josko Rie,6154,9,10,5,21,32,54,-22,35
St. Pölten,6154,10,6,13,17,33,60,-27,31
SC Rheindorf,6155,1,22,8,6,66,40,26,74
FC Salzburg,6155,2,21,8,7,59,27,32,71
Vienna,6155,3,22,3,11,74,50,24,69
Rapid Vienna,6155,4,15,10,11,58,38,20,55
SK Sturm Gra,6155,5,16,7,13,54,48,6,55
RZ Pellets W,6155,6,12,8,16,45,55,-10,44
St. Pölten,6155,7,10,9,17,47,63,-16,39
SV Josko Rie,6155,8,10,4,22,37,62,-25,34
Admira Wacke,6155,9,9,7,20,32,59,-27,34
Mattersburg,6155,10,6,10,20,27,57,-30,28
SC Rheindorf,6156,1,23,5,8,54,41,13,74
FC Salzburg,6156,2,21,7,8,65,32,33,70
SK Sturm Gra,6156,3,18,8,10,61,32,29,62
Vienna,6156,4,17,7,12,65,52,13,58
Rapid Vienna,6156,5,13,10,13,51,43,8,49
RZ Pellets W,6156,6,11,12,13,47,52,-5,45
Admira Wacke,6156,7,9,10,17,37,63,-26,37
SV Josko Rie,6156,8,10,6,20,33,50,-17,36
St. Pölten,6156,9,8,11,17,42,63,-21,35
Mattersburg,6156,10,8,8,20,30,57,-27,32
FC Salzburg,6157,1,21,8,7,67,25,42,71
SK Sturm Gra,6157,2,19,9,8,54,33,21,66
SC Rheindorf,6157,3,18,10,8,54,40,14,64
Vienna,6157,4,19,4,13,70,59,11,61
Rapid Vienna,6157,5,11,13,12,46,39,7,46
Admira Wacke,6157,6,11,11,14,41,58,-17,44
SV Josko Rie,6157,7,12,7,17,44,52,-8,43
RZ Pellets W,6157,8,10,9,17,41,59,-18,39
St. Pölten,6157,9,8,10,18,42,66,-24,34
Mattersburg,6157,10,7,7,22,30,58,-28,28
FC Salzburg,6158,1,19,9,8,67,42,25,66
SC Rheindorf,6158,2,18,9,9,60,49,11,63
SK Sturm Gra,6158,3,19,5,12,64,40,24,62
Vienna,6158,4,18,6,12,66,55,11,60
Rapid Vienna,6158,5,13,11,12,59,45,14,50
SV Josko Rie,6158,6,14,6,16,45,47,-2,48
Admira Wacke,6158,7,12,9,15,39,56,-17,45
RZ Pellets W,6158,8,11,8,17,47,66,-19,41
St. Pölten,6158,9,8,9,19,42,68,-26,33
Mattersburg,6158,10,7,10,19,36,57,-21,31
FC Salzburg,6159,1,22,8,6,62,30,32,74
SK Sturm Gra,6159,2,19,6,11,63,37,26,63
SC Rheindorf,6159,3,19,6,11,57,44,13,63
Vienna,6159,4,17,7,12,55,49,6,58
Mattersburg,6159,5,14,7,15,52,57,-5,49
Rapid Vienna,6159,6,12,10,14,48,44,4,46
RZ Pellets W,6159,7,13,7,16,47,57,-10,46
Admira Wacke,6159,8,11,9,16,39,57,-18,42
St. Pölten,6159,9,9,11,16,45,56,-11,38
SV Josko Rie,6159,10,6,5,25,25,62,-37,23
SC Rheindorf,6160,1,21,9,6,58,34,24,72
SK Sturm Gra,6160,2,20,5,11,59,40,19,65
Rapid Vienna,6160,3,17,12,7,56,32,24,63
FC Salzburg,6160,4,17,11,8,64,35,29,62
Vienna,6160,5,15,8,13,60,57,3,53
SV Josko Rie,6160,6,13,6,17,41,53,-12,45
RZ Pellets W,6160,7,11,9,16,43,51,-8,42
St. Pölten,6160,8,7,13,16,41,59,-18,34
Admira Wacke,6160,9,8,7,21,32,68,-36,31
Mattersburg,6160,10,4,14,18,29,54,-25,26
SC Rheindorf,6161,1,22,6,8,61,40,21,72
FC Salzburg,6161,2,19,10,7,56,26,30,67
SK Sturm Gra,6161,3,19,4,13,63,39,24,61
Vienna,6161,4,19,4,13,72,55,17,61
Rapid Vienna,6161,5,17,9,10,65,39,26,60
Mattersburg,6161,6,11,8,17,38,49,-11,41
Admira Wacke,6161,7,12,4,20,34,59,-25,40
RZ Pellets W,6161,8,10,8,18,40,60,-20,38
St. Pölten,6161,9,9,9,18,37,66,-29,36
SV Josko Rie,6161,10,8,6,22,26,59,-33,30
FC Salzburg,6162,1,21,7,8,62,30,32,70
SC Rheindorf,6162,2,21,6,9,57,46,11,69
SK Sturm Gra,6162,3,20,5,11,68,36,32,65
Vienna,6162,4,19,2,15,65,55,10,59
RZ Pellets W,6162,5,16,7,13,55,55,0,55
Rapid Vienna,6162,6,15,8,13,61,52,9,53
Admira Wacke,6162,7,11,7,18,45,62,-17,40
Mattersburg,6162,8,10,7,19,37,61,-24,37
SV Josko Rie,6162,9,10,4,22,36,59,-23,34
St. Pölten,6162,10,5,11,20,31,61,-30,26
FC Salzburg,6163,1,25,5,6,73,27,46,80
SC Rheindorf,6163,2,20,7,9,59,44,15,67
Vienna,6163,3,19,8,9,67,56,11,65
SK Sturm Gra,6163,4,16,7,13,54,38,16,55
Rapid Vienna,6163,5,15,9,12,60,43,17,54
RZ Pellets W,6163,6,13,6,17,50,62,-12,45
Mattersburg,6163,7,9,8,19,38,60,-22,35
Admira Wacke,6163,8,8,11,17,35,58,-23,35
SV Josko Rie,6163,9,9,7,20,37,60,-23,34
St. Pölten,6163,10,8,8,20,38,63,-25,32
FC Salzburg,6164,1,21,10,5,66,32,34,73
SK Sturm Gra,6164,2,21,4,11,62,38,24,67
SC Rheindorf,6164,3,20,4,12,53,43,10,64
Vienna,6164,4,18,6,12,61,47,14,60
Rapid Vienna,6164,5,14,10,12,57,41,16,52
St. Pölten,6164,6,11,9,16,49,62,-13,42
Admira Wacke,6164,7,12,6,18,34,55,-21,42
RZ Pellets W,6164,8,11,7,18,44,63,-19,40
Mattersburg,6164,9,9,8,19,34,54,-20,35
SV Josko Rie,6164,10,7,8,21,29,54,-25,29
SK Sturm Gra,6165,1,21,6,9,62,37,25,69
FC Salzburg,6165,2,19,8,9,58,33,25,65
Vienna,6165,3,19,5,12,68,52,16,62
Rapid Vienna,6165,4,16,10,10,64,42,22,58
SC Rheindorf,6165,5,16,10,10,50,42,8,58
Admira Wacke,6165,6,12,8,16,38,58,-20,44
RZ Pellets W,6165,7,11,7,18,46,57,-11,40
Mattersburg,6165,8,9,9,18,35,53,-18,36
SV Josko Rie,6165,9,9,8,19,38,58,-20,35
St. Pölten,6165,10,8,9,19,38,65,-27,33
SC Rheindorf,6166,1,22,5,9,55,42,13,71
FC Salzburg,6166,2,22,4,10,74,31,43,70
SK Sturm Gra,6166,3,17,8,11,64,39,25,59
Vienna,6166,4,18,5,13,63,50,13,59
Rapid Vienna,6166,5,14,11,11,60,51,9,53
RZ Pellets W,6166,6,14,7,15,52,59,-7,49
SV Josko Rie,6166,7,13,4,19,34,55,-21,43
Admira Wacke,6166,8,12,6,18,39,65,-26,42
St. Pölten,6166,9,9,9,18,39,60,-21,36
Mattersburg,6166,10,5,9,22,35,63,-28,24
FC Salzburg,6167,1,19,9,8,61,32,29,66
SC Rheindorf,6167,2,20,6,10,57,41,16,66
SK Sturm Gra,6167,3,18,8,10,59,33,26,62
Vienna,6167,4,16,8,12,60,53,7,56
Rapid Vienna,6167,5,13,13,10,48,39,9,52
RZ Pellets W,6167,6,12,9,15,50,54,-4,45
Admira Wacke,6167,7,11,10,15,43,60,-17,43
SV Josko Rie,6167,8,12,7,17,37,54,-17,43
Mattersburg,6167,9,8,9,19,42,60,-18,33
St. Pölten,6167,10,6,11,19,31,62,-31,29
FC Salzburg,6168,1,23,4,9,64,34,30,73
SC Rheindorf,6168,2,19,9,8,54,41,13,66
Vienna,6168,3,19,7,10,66,46,20,64
SK Sturm Gra,6168,4,19,5,12,62,39,23,62
Rapid Vienna,6168,5,14,11,11,55,44,11,53
RZ Pellets W,6168,6,14,7,15,50,53,-3,49
SV Josko Rie,6168,7,10,7,19,37,57,-20,37
Admira Wacke,6168,8,9,9,18,38,65,-27,36
St. Pölten,6168,9,6,13,17,44,67,-23,31
Mattersburg,6168,10,6,10,20,36,60,-24,28
Vienna,6169,1,23,4,9,70,44,26,73
SC Rheindorf,6169,2,21,7,8,54,42,12,70
FC Salzburg,6169,3,19,9,8,65,35,30,66
SK Sturm Gra,6169,4,17,6,13,56,35,21,57
Rapid Vienna,6169,5,12,12,12,58,46,12,48
RZ Pellets W,6169,6,13,5,18,44,59,-15,44
Admira Wacke,6169,7,12,6,18,40,61,-21,42
Mattersburg,6169,8,10,8,18,41,55,-14,38
St. Pölten,6169,9,9,11,16,39,58,-19,38
SV Josko Rie,6169,10,7,6,23,26,58,-32,27
FC Salzburg,6170,1,20,9,7,66,32,34,69
SK Sturm Gra,6170,2,20,6,10,58,35,23,66
SC Rheindorf,6170,3,19,9,8,56,38,18,66
Rapid Vienna,6170,4,13,12,11,61,45,16,51
Vienna,6170,5,14,7,15,58,61,-3,49
Admira Wacke,6170,6,12,9,15,37,54,-17,45
RZ Pellets W,6170,7,10,11,15,40,58,-18,41
Mattersburg,6170,8,8,13,15,41,54,-13,37
St. Pölten,6170,9,9,10,17,42,62,-20,37
SV Josko Rie,6170,10,9,6,21,31,51,-20,33
FC Salzburg,6171,1,23,8,5,70,27,43,77
SK Sturm Gra,6171,2,20,7,9,63,35,28,67
SC Rheindorf,6171,3,19,9,8,57,36,21,66
Vienna,6171,4,17,5,14,61,55,6,56
Rapid Vienna,6171,5,14,11,11,51,37,14,53
RZ Pellets W,6171,6,12,6,18,48,59,-11,42
Mattersburg,6171,7,10,8,18,39,54,-15,38
St. Pölten,6171,8,9,9,18,37,65,-28,36
SV Josko Rie,6171,9,10,6,20,26,54,-28,36
Admira Wacke,6171,10,9,5,22,32,62,-30,32
FC Salzburg,6172,1,22,4,10,70,30,40,70
SC Rheindorf,6172,2,21,7,8,58,41,17,70
SK Sturm Gra,6172,3,17,9,10,52,34,18,60
Rapid Vienna,6172,4,15,10,11,56,42,14,55
Vienna,6172,5,17,3,16,62,63,-1,54
St. Pölten,6172,6,13,8,15,52,54,-2,47
Admira Wacke,6172,7,13,8,15,41,54,-13,47
RZ Pellets W,6172,8,13,7,16,50,59,-9,46
SV Josko Rie,6172,9,8,6,22,33,59,-26,30
Mattersburg,6172,10,7,6,23,32,70,-38,27
FC Salzburg,6173,1,24,4,8,73,27,46,76
SC Rheindorf,6173,2,20,7,9,57,46,11,67
SK Sturm Gra,6173,3,20,6,10,62,35,27,66
Vienna,6173,4,19,2,15,69,53,16,59
Rapid Vienna,6173,5,14,8,14,56,48,8,50
Admira Wacke,6173,6,15,3,18,41,61,-20,48
RZ Pellets W,6173,7,11,9,16,43,54,-11,42
SV Josko Rie,6173,8,11,5,20,38,59,-21,38
St. Pölten,6173,9,7,11,18,39,65,-26,32
Mattersburg,6173,10,7,9,20,34,64,-30,30
SC Rheindorf,6174,1,24,6,6,64,34,30,78
SK Sturm Gra,6174,2,19,7,10,61,34,27,64
FC Salzburg,6174,3,18,8,10,62,34,28,62
Vienna,6174,4,16,8,12,54,47,7,56
Rapid Vienna,6174,5,13,12,11,60,43,17,51
SV Josko Rie,6174,6,13,6,17,33,51,-18,45
RZ Pellets W,6174,7,12,7,17,45,56,-11,43
Mattersburg,6174,8,9,8,19,39,59,-20,35
St. Pölten,6174,9,9,7,20,41,69,-28,34
Admira Wacke,6174,10,8,9,19,33,65,-32,33
FC Salzburg,6175,1,22,4,10,74,38,36,70
SK Sturm Gra,6175,2,20,5,11,60,38,22,65
SC Rheindorf,6175,3,19,8,9,54,41,13,65
Vienna,6175,4,17,8,11,67,56,11,59
Rapid Vienna,6175,5,13,10,13,51,40,11,49
Admira Wacke,6175,6,13,6,17,46,65,-19,45
RZ Pellets W,6175,7,13,5,18,45,51,-6,44
SV Josko Rie,6175,8,13,5,18,38,57,-19,44
Mattersburg,6175,9,10,9,17,37,54,-17,39
St. Pölten,6175,10,5,10,21,33,65,-32,25
FC Salzburg,6176,1,21,9,6,63,27,36,72
SC Rheindorf,6176,2,19,7,10,53,38,15,64
SK Sturm Gra,6176,3,18,8,10,58,35,23,62
Vienna,6176,4,17,7,12,61,50,11,58
Rapid Vienna,6176,5,13,14,9,52,38,14,53
RZ Pellets W,6176,6,13,8,15,48,55,-7,47
Admira Wacke,6176,7,12,9,15,41,58,-17,45
SV Josko Rie,6176,8,10,7,19,32,57,-25,37
Mattersburg,6176,9,6,12,18,36,54,-18,30
St. Pölten,6176,10,6,9,21,39,71,-32,27
FC Salzburg,6177,1,25,7,4,70,25,45,82
SC Rheindorf,6177,2,20,6,10,54,38,16,66
SK Sturm Gra,6177,3,18,6,12,54,38,16,60
Vienna,6177,4,15,9,12,54,51,3,54
Rapid Vienna,6177,5,14,10,12,59,44,15,52
Admira Wacke,6177,6,13,7,16,38,58,-20,46
RZ Pellets W,6177,7,11,7,18,44,53,-9,40
SV Josko Rie,6177,8,9,8,19,29,49,-20,35
Mattersburg,6177,9,9,7,20,34,52,-18,34
St. Pölten,6177,10,8,9,19,38,66,-28,33
FC Salzburg,6178,1,22,9,5,78,29,49,75
SK Sturm Gra,6178,2,22,4,10,61,39,22,70
Vienna,6178,3,18,7,11,58,47,11,61
SC Rheindorf,6178,4,17,8,11,53,48,5,59
Rapid Vienna,6178,5,16,10,10,58,40,18,58
RZ Pellets W,6178,6,11,9,16,49,55,-6,42
Admira Wacke,6178,7,9,11,16,34,57,-23,38
St. Pölten,6178,8,9,8,19,44,66,-22,35
SV Josko Rie,6178,9,10,4,22,41,65,-24,34
Mattersburg,6178,10,6,10,20,36,66,-30,28
FC Salzburg,6179,1,21,7,8,58,27,31,70
Vienna,6179,2,21,4,11,69,49,20,67
SC Rheindorf,6179,3,19,8,9,57,42,15,65
SK Sturm Gra,6179,4,18,6,12,57,35,22,60
Admira Wacke,6179,5,12,9,15,42,56,-14,45
Rapid Vienna,6179,6,10,14,12,49,43,6,44
RZ Pellets W,6179,7,11,8,17,45,61,-16,41
Mattersburg,6179,8,9,12,15,43,55,-12,39
SV Josko Rie,6179,9,11,3,22,35,63,-28,36
St. Pölten,6179,10,7,11,18,41,65,-24,32
SK Sturm Gra,6180,1,22,5,9,61,26,35,71
FC Salzburg,6180,2,20,8,8,67,35,32,68
SC Rheindorf,6180,3,17,9,10,51,42,9,60
Vienna,6180,4,18,5,13,57,51,6,59
Rapid Vienna,6180,5,16,9,11,59,42,17,57
RZ Pellets W,6180,6,13,5,18,41,55,-14,44
SV Josko Rie,6180,7,12,6,18,42,52,-10,42
Admira Wacke,6180,8,11,8,17,38,57,-19,41
Mattersburg,6180,9,8,9,19,38,60,-22,33
St. Pölten,6180,10,7,8,21,43,77,-34,29
FC Salzburg,6181,1,20,9,7,69,33,36,69
SK Sturm Gra,6181,2,20,8,8,67,34,33,68
SC Rheindorf,6181,3,19,7,10,53,42,11,64
Vienna,6181,4,19,4,13,63,51,12,61
Rapid Vienna,6181,5,16,10,10,57,36,21,58
RZ Pellets W,6181,6,13,10,13,52,52,0,49
SV Josko Rie,6181,7,13,4,19,47,59,-12,43
St. Pölten,6181,8,9,8,19,39,75,-36,35
Admira Wacke,6181,9,9,5,22,36,67,-31,32
Mattersburg,6181,10,6,7,23,33,67,-34,25
FC Salzburg,6182,1,22,9,5,73,30,43,75
SC Rheindorf,6182,2,18,10,8,54,41,13,64
Vienna,6182,3,19,5,12,56,48,8,62
SK Sturm Gra,6182,4,16,9,11,51,36,15,57
Rapid Vienna,6182,5,14,9,13,52,44,8,51
RZ Pellets W,6182,6,12,9,15,45,52,-7,45
SV Josko Rie,6182,7,11,7,18,37,51,-14,40
Admira Wacke,6182,8,10,9,17,37,61,-24,39
Mattersburg,6182,9,9,8,19,35,51,-16,35
St. Pölten,6182,10,8,7,21,45,71,-26,31
FC Salzburg,6183,1,23,6,7,68,27,41,75
SK Sturm Gra,6183,2,22,6,8,59,26,33,72
Vienna,6183,3,19,7,10,67,48,19,64
SC Rheindorf,6183,4,19,7,10,55,45,10,64
Rapid Vienna,6183,5,12,12,12,53,45,8,48
SV Josko Rie,6183,6,12,6,18,36,54,-18,42
St. Pölten,6183,7,10,11,15,48,62,-14,41
Admira Wacke,6183,8,10,5,21,33,62,-29,35
RZ Pellets W,6183,9,8,10,18,34,59,-25,34
Mattersburg,6183,10,6,8,22,40,65,-25,26
FC Salzburg,6184,1,21,6,9,65,30,35,69
SC Rheindorf,6184,2,19,9,8,60,49,11,66
Vienna,6184,3,20,5,11,73,47,26,65
SK Sturm Gra,6184,4,17,6,13,55,46,9,57
Rapid Vienna,6184,5,16,8,12,68,42,26,56
Admira Wacke,6184,6,13,5,18,38,65,-27,44
SV Josko Rie,6184,7,13,4,19,37,50,-13,43
RZ Pellets W,6184,8,11,7,18,48,61,-13,40
St. Pölten,6184,9,7,13,16,39,63,-24,34
Mattersburg,6184,10,7,9,20,38,68,-30,30
SC Rheindorf,6185,1,20,6,10,52,46,6,66
FC Salzburg,6185,2,18,8,10,61,36,25,62
SK Sturm Gra,6185,3,18,6,12,49,32,17,60
Vienna,6185,4,18,3,15,63,55,8,57
Rapid Vienna,6185,5,15,10,11,60,40,20,55
RZ Pellets W,6185,6,13,8,15,50,52,-2,47
St. Pölten,6185,7,12,11,13,43,52,-9,47
Admira Wacke,6185,8,14,5,17,41,57,-16,47
SV Josko Rie,6185,9,9,6,21,34,57,-23,33
Mattersburg,6185,10,7,9,20,38,64,-26,30
FC Salzburg,6186,1,22,8,6,61,27,34,74
SK Sturm Gra,6186,2,21,4,11,62,38,24,67
SC Rheindorf,6186,3,19,7,10,51,42,9,64
Vienna,6186,4,18,6,12,67,51,16,60
Rapid Vienna,6186,5,12,12,12,54,44,10,48
Admira Wacke,6186,6,12,8,16,42,55,-13,44
Mattersburg,6186,7,10,10,16,38,50,-12,40
SV Josko Rie,6186,8,11,5,20,40,61,-21,38
St. Pölten,6186,9,8,9,19,40,61,-21,33
RZ Pellets W,6186,10,8,9,19,42,68,-26,33
FC Salzburg,6187,1,21,7,8,64,32,32,70
SC Rheindorf,6187,2,20,7,9,56,38,18,67
SK Sturm Gra,6187,3,19,8,9,55,33,22,65
Rapid Vienna,6187,4,16,9,11,60,40,20,57
Vienna,6187,5,18,3,15,61,53,8,57
RZ Pellets W,6187,6,12,8,16,40,53,-13,44
Admira Wacke,6187,7,11,7,18,31,49,-18,40
Mattersburg,6187,8,10,8,18,36,51,-15,38
SV Josko Rie,6187,9,9,8,19,32,55,-23,35
St. Pölten,6187,10,6,11,19,35,66,-31,29
SC Rheindorf,6188,1,22,6,8,58,37,21,72
SK Sturm Gra,6188,2,22,4,10,58,32,26,70
FC Salzburg,6188,3,21,4,11,66,33,33,67
Rapid Vienna,6188,4,16,9,11,66,38,28,57
Vienna,6188,5,17,6,13,54,51,3,57
RZ Pellets W,6188,6,12,7,17,41,57,-16,43
Admira Wacke,6188,7,12,4,20,36,60,-24,40
St. Pölten,6188,8,10,7,19,44,68,-24,37
SV Josko Rie,6188,9,11,4,21,35,60,-25,37
Mattersburg,6188,10,8,7,21,41,63,-22,31
FC Salzburg,6189,1,23,6,7,66,25,41,75
SK Sturm Gra,6189,2,21,7,8,59,30,29,70
SC Rheindorf,6189,3,19,7,10,59,46,13,64
Vienna,6189,4,19,3,14,62,61,1,60
Rapid Vienna,6189,5,14,11,11,52,40,12,53
RZ Pellets W,6189,6,12,8,16,45,50,-5,44
Admira Wacke,6189,7,10,9,17,38,58,-20,39
Mattersburg,6189,8,10,8,18,35,51,-16,38
SV Josko Rie,6189,9,10,5,21,38,56,-18,35
St. Pölten,6189,10,5,10,21,32,69,-37,25
FC Salzburg,6190,1,21,8,7,67,29,38,71
SK Sturm Gra,6190,2,20,3,13,67,37,30,63
Vienna,6190,3,18,6,12,62,53,9,60
SC Rheindorf,6190,4,17,9,10,52,50,2,60
Rapid Vienna,6190,5,13,11,12,53,44,9,50
Admira Wacke,6190,6,14,6,16,39,49,-10,48
RZ Pellets W,6190,7,9,12,15,43,57,-14,39
Mattersburg,6190,8,10,9,17,40,57,-17,39
SV Josko Rie,6190,9,10,6,20,33,51,-18,36
St. Pölten,6190,10,8,10,18,42,71,-29,34
FC Salzburg,6191,1,22,7,7,61,30,31,73
SC Rheindorf,6191,2,18,10,8,55,39,16,64
Rapid Vienna,6191,3,17,11,8,59,38,21,62
SK Sturm Gra,6191,4,18,6,12,62,41,21,60
Vienna,6191,5,15,6,15,60,59,1,51
RZ Pellets W,6191,6,15,5,16,50,54,-4,50
SV Josko Rie,6191,7,10,8,18,35,50,-15,38
Admira Wacke,6191,8,10,8,18,37,60,-23,38
St. Pölten,6191,9,7,12,17,43,67,-24,33
Mattersburg,6191,10,8,7,21,39,63,-24,31
FC Salzburg,6192,1,20,10,6,68,29,39,70
SC Rheindorf,6192,2,21,7,8,60,40,20,70
Vienna,6192,3,19,5,12,62,51,11,62
SK Sturm Gra,6192,4,17,5,14,60,42,18,56
Admira Wacke,6192,5,14,7,15,41,53,-12,49
RZ Pellets W,6192,6,12,8,16,48,58,-10,44
Rapid Vienna,6192,7,11,10,15,47,44,3,43
Mattersburg,6192,8,11,7,18,37,60,-23,40
SV Josko Rie,6192,9,9,7,20,31,55,-24,34
St. Pölten,6192,10,7,12,17,41,63,-22,33
FC Salzburg,6193,1,25,7,4,70,26,44,82
Vienna,6193,2,21,3,12,69,50,19,66
SC Rheindorf,6193,3,16,11,9,56,47,9,59
SK Sturm Gra,6193,4,17,6,13,58,44,14,57
RZ Pellets W,6193,5,14,6,16,51,57,-6,48
Rapid Vienna,6193,6,12,11,13,54,44,10,47
SV Josko Rie,6193,7,12,4,20,38,54,-16,40
St. Pölten,6193,8,10,7,19,39,63,-24,37
Mattersburg,6193,9,9,8,19,37,60,-23,35
Admira Wacke,6193,10,8,9,19,38,65,-27,33
FC Salzburg,6194,1,22,6,8,68,29,39,72
SK Sturm Gra,6194,2,21,6,9,61,36,25,69
SC Rheindorf,6194,3,19,6,11,49,42,7,63
Vienna,6194,4,19,2,15,59,57,2,59
Rapid Vienna,6194,5,13,12,11,54,41,13,51
St. Pölten,6194,6,10,11,15,48,59,-11,41
RZ Pellets W,6194,7,10,8,18,44,60,-16,38
Admira Wacke,6194,8,10,7,19,40,58,-18,37
Mattersburg,6194,9,8,12,16,38,57,-19,36
SV Josko Rie,6194,10,10,6,20,44,66,-22,36
SC Rheindorf,6195,1,22,6,8,57,41,16,72
FC Salzburg,6195,2,21,7,8,64,32,32,70
Vienna,6195,3,22,4,10,75,45,30,70
SK Sturm Gra,6195,4,18,7,11,56,34,22,61
Rapid Vienna,6195,5,15,10,11,63,47,16,55
RZ Pellets W,6195,6,11,7,18,50,62,-12,40
Mattersburg,6195,7,8,11,17,40,63,-23,35
SV Josko Rie,6195,8,8,9,19,35,55,-20,33
St. Pölten,6195,9,7,12,17,44,70,-26,33
Admira Wacke,6195,10,7,9,20,37,72,-35,30
FC Salzburg,6196,1,20,9,7,69,34,35,69
SK Sturm Gra,6196,2,20,7,9,69,39,30,67
SC Rheindorf,6196,3,19,9,8,61,46,15,66
Vienna,6196,4,18,6,12,59,56,3,60
Rapid Vienna,6196,5,14,9,13,59,43,16,51
Admira Wacke,6196,6,14,8,14,52,61,-9,50
RZ Pellets W,6196,7,11,7,18,48,63,-15,40
St. Pölten,6196,8,10,8,18,47,71,-24,38
Mattersburg,6196,9,8,9,19,36,54,-18,33
SV Josko Rie,6196,10,6,8,22,29,62,-33,26
FC Salzburg,6197,1,22,7,7,65,31,34,73
SK Sturm Gra,6197,2,21,5,10,67,38,29,68
SC Rheindorf,6197,3,21,5,10,58,45,13,68
Vienna,6197,4,20,3,13,66,54,12,63
Rapid Vienna,6197,5,12,10,14,55,44,11,46
Mattersburg,6197,6,13,5,18,43,56,-13,44
RZ Pellets W,6197,7,11,8,17,51,59,-8,41
SV Josko Rie,6197,8,10,7,19,39,58,-19,37
St. Pölten,6197,9,8,10,18,39,62,-23,34
Admira Wacke,6197,10,9,6,21,32,68,-36,33
FC Salzburg,6198,1,25,6,5,67,23,44,81
SC Rheindorf,6198,2,20,7,9,61,39,22,67
Vienna,6198,3,18,7,11,61,55,6,61
SK Sturm Gra,6198,4,16,9,11,53,36,17,57
Rapid Vienna,6198,5,14,13,9,61,37,24,55
RZ Pellets W,6198,6,11,11,14,48,52,-4,44
St. Pölten,6198,7,10,9,17,52,75,-23,39
SV Josko Rie,6198,8,10,4,22,36,58,-22,34
Mattersburg,6198,9,7,10,19,35,59,-24,31
Admira Wacke,6198,10,8,6,22,33,73,-40,30
SK Sturm Gra,6199,1,20,7,9,61,39,22,67
SC Rheindorf,6199,2,18,11,7,56,37,19,65
Vienna,6199,3,18,7,11,68,54,14,61
FC Salzburg,6199,4,16,10,10,55,36,19,58
Rapid Vienna,6199,5,14,9,13,53,40,13,51
Admira Wacke,6199,6,14,3,19,42,61,-19,45
RZ Pellets W,6199,7,11,7,18,43,64,-21,40
St. Pölten,6199,8,9,12,15,48,60,-12,39
SV Josko Rie,6199,9,11,6,19,35,50,-15,39
Mattersburg,6199,10,7,12,17,37,57,-20,33
FC Salzburg,6200,1,22,7,7,63,28,35,73
SC Rheindorf,6200,2,21,8,7,63,40,23,71
SK Sturm Gra,6200,3,20,9,7,62,30,32,69
Vienna,6200,4,17,5,14,60,56,4,56
Rapid Vienna,6200,5,12,11,13,56,46,10,47
RZ Pellets W,6200,6,11,10,15,47,62,-15,43
SV Josko Rie,6200,7,12,4,20,38,53,-15,40
St. Pölten,6200,8,7,13,16,40,63,-23,34
Admira Wacke,6200,9,8,9,19,29,61,-32,33
Mattersburg,6200,10,7,10,19,30,49,-19,31
FC Salzburg,6201,1,22,8,6,73,31,42,74
SC Rheindorf,6201,2,21,7,8,59,41,18,70
SK Sturm Gra,6201,3,18,8,10,55,38,17,62
Vienna,6201,4,17,5,14,57,55,2,56
RZ Pellets W,6201,5,15,7,14,50,50,0,52
Rapid Vienna,6201,6,12,12,12,47,40,7,48
SV Josko Rie,6201,7,12,5,19,35,53,-18,41
Admira Wacke,6201,8,9,10,17,38,60,-22,37
Mattersburg,6201,9,7,9,20,36,56,-20,30
St. Pölten,6201,10,7,9,20,42,68,-26,30
SC Rheindorf,6202,1,20,6,10,64,47,17,66
FC Salzburg,6202,2,18,9,9,63,41,22,63
SK Sturm Gra,6202,3,18,7,11,58,35,23,61
Vienna,6202,4,18,3,15,53,55,-2,57
Rapid Vienna,6202,5,15,11,10,62,42,20,56
RZ Pellets W,6202,6,14,7,15,49,50,-1,49
Admira Wacke,6202,7,12,9,15,41,55,-14,45
SV Josko Rie,6202,8,11,6,19,37,53,-16,39
St. Pölten,6202,9,9,9,18,44,67,-23,36
Mattersburg,6202,10,7,9,20,37,63,-26,30
FC Salzburg,6203,1,22,7,7,66,30,36,73
SC Rheindorf,6203,2,19,7,10,52,39,13,64
Vienna,6203,3,19,4,13,68,50,18,61
SK Sturm Gra,6203,4,18,6,12,58,38,20,60
Rapid Vienna,6203,5,15,11,10,57,42,15,56
RZ Pellets W,6203,6,13,6,17,45,57,-12,45
St. Pölten,6203,7,10,10,16,40,57,-17,40
SV Josko Rie,6203,8,10,7,19,39,60,-21,37
Admira Wacke,6203,9,10,6,20,36,59,-23,36
Mattersburg,6203,10,7,10,19,35,64,-29,31
FC Salzburg,6204,1,21,8,7,72,35,37,71
SC Rheindorf,6204,2,19,7,10,54,41,13,64
SK Sturm Gra,6204,3,19,6,11,55,32,23,63
Vienna,6204,4,18,2,16,59,48,11,56
Rapid Vienna,6204,5,14,11,11,63,42,21,53
Admira Wacke,6204,6,14,8,14,37,56,-19,50
RZ Pellets W,6204,7,12,5,19,42,54,-12,41
SV Josko Rie,6204,8,12,4,20,33,61,-28,40
St. Pölten,6204,9,8,12,16,39,57,-18,36
Mattersburg,6204,10,8,7,21,39,67,-28,31
FC Salzburg,6205,1,21,9,6,61,26,35,72
SK Sturm Gra,6205,2,22,4,10,63,34,29,70
SC Rheindorf,6205,3,19,6,11,56,47,9,63
Vienna,6205,4,20,2,14,57,47,10,62
Rapid Vienna,6205,5,18,7,11,54,33,21,61
RZ Pellets W,6205,6,12,9,15,45,53,-8,45
SV Josko Rie,6205,7,12,7,17,40,49,-9,43
Admira Wacke,6205,8,10,5,21,36,64,-28,35
St. Pölten,6205,9,6,10,20,38,66,-28,28
Mattersburg,6205,10,7,7,22,33,64,-31,28
FC Salzburg,6206,1,24,5,7,72,25,47,77
SK Sturm Gra,6206,2,20,5,11,64,36,28,65
SC Rheindorf,6206,3,20,5,11,56,47,9,65
Vienna,6206,4,17,7,12,62,55,7,58
RZ Pellets W,6206,5,15,6,15,49,55,-6,51
Admira Wacke,6206,6,12,7,17,40,59,-19,43
Rapid Vienna,6206,7,10,11,15,49,47,2,41
St. Pölten,6206,8,9,10,17,43,63,-20,37
Mattersburg,6206,9,9,8,19,36,57,-21,35
SV Josko Rie,6206,10,10,4,22,33,60,-27,34
FC Salzburg,6207,1,22,8,6,67,26,41,74
SC Rheindorf,6207,2,20,8,8,56,43,13,68
SK Sturm Gra,6207,3,18,6,12,59,35,24,60
Vienna,6207,4,18,6,12,63,54,9,60
Rapid Vienna,6207,5,13,11,12,47,37,10,50
St. Pölten,6207,6,11,8,17,45,61,-16,41
SV Josko Rie,6207,7,11,7,18,32,49,-17,40
RZ Pellets W,6207,8,11,6,19,45,59,-14,39
Admira Wacke,6207,9,10,8,18,33,59,-26,38
Mattersburg,6207,10,8,8,20,34,58,-24,32
Vienna,6208,1,22,5,9,64,48,16,71
FC Salzburg,6208,2,19,9,8,64,32,32,66
SK Sturm Gra,6208,3,19,6,11,60,35,25,63
SC Rheindorf,6208,4,18,8,10,55,47,8,62
Rapid Vienna,6208,5,12,9,15,54,47,7,45
SV Josko Rie,6208,6,13,5,18,40,49,-9,44
Admira Wacke,6208,7,12,7,17,38,56,-18,43
RZ Pellets W,6208,8,11,7,18,48,64,-16,40
Mattersburg,6208,9,8,11,17,38,53,-15,35
St. Pölten,6208,10,8,9,19,40,70,-30,33
FC Salzburg,6209,1,20,6,10,60,31,29,66
SC Rheindorf,6209,2,19,8,9,52,44,8,65
Vienna,6209,3,18,4,14,58,52,6,58
RZ Pellets W,6209,4,17,6,13,49,48,1,57
SK Sturm Gra,6209,5,16,7,13,50,36,14,55
Rapid Vienna,6209,6,14,11,11,59,41,18,53
Admira Wacke,6209,7,14,7,15,40,53,-13,49
St. Pölten,6209,8,8,10,18,38,57,-19,34
Mattersburg,6209,9,9,7,20,33,58,-25,34
SV Josko Rie,6209,10,9,6,21,33,52,-19,33
FC Salzburg,6210,1,22,8,6,70,31,39,74
SK Sturm Gra,6210,2,20,7,9,59,32,27,67
Vienna,6210,3,20,4,12,62,54,8,64
SC Rheindorf,6210,4,19,5,12,54,45,9,62
Rapid Vienna,6210,5,17,7,12,69,43,26,58
RZ Pellets W,6210,6,12,9,15,42,51,-9,45
Admira Wacke,6210,7,10,8,18,35,58,-23,38
SV Josko Rie,6210,8,10,7,19,37,54,-17,37
St. Pölten,6210,9,8,10,18,34,63,-29,34
Mattersburg,6210,10,6,7,23,33,64,-31,25
FC Salzburg,6211,1,23,5,8,72,38,34,74
SK Sturm Gra,6211,2,21,5,10,68,38,30,68
SC Rheindorf,6211,3,18,7,11,54,50,4,61
Rapid Vienna,6211,4,16,9,11,55,38,17,57
Vienna,6211,5,16,7,13,66,57,9,55
RZ Pellets W,6211,6,15,7,14,53,50,3,52
Admira Wacke,6211,7,11,8,17,44,65,-21,41
SV Josko Rie,6211,8,10,8,18,36,55,-19,38
St. Pölten,6211,9,6,11,19,46,76,-30,29
Mattersburg,6211,10,7,7,22,35,62,-27,28
FC Salzburg,6212,1,22,6,8,57,25,32,72
SK Sturm Gra,6212,2,20,7,9,61,36,25,67
SC Rheindorf,6212,3,19,7,10,52,39,13,64
Vienna,6212,4,17,6,13,57,50,7,57
Rapid Vienna,6212,5,14,10,12,51,39,12,52
SV Josko Rie,6212,6,13,5,18,32,46,-14,44
RZ Pellets W,6212,7,10,10,16,43,57,-14,40
Admira Wacke,6212,8,10,7,19,29,50,-21,37
Mattersburg,6212,9,9,8,19,36,51,-15,35
St. Pölten,6212,10,9,8,19,37,62,-25,35
Vienna,6213,1,22,6,8,68,44,24,72
FC Salzburg,6213,2,19,9,8,60,28,32,66
SK Sturm Gra,6213,3,20,6,10,64,35,29,66
SC Rheindorf,6213,4,17,10,9,56,45,11,61
Rapid Vienna,6213,5,12,12,12,51,42,9,48
RZ Pellets W,6213,6,12,7,17,42,59,-17,43
Mattersburg,6213,7,10,9,17,35,50,-15,39
SV Josko Rie,6213,8,9,9,18,37,61,-24,36
St. Pölten,6213,9,8,10,18,39,65,-26,34
Admira Wacke,6213,10,8,8,20,34,57,-23,32
FC Salzburg,6214,1,22,7,7,66,31,35,73
SK Sturm Gra,6214,2,21,5,10,59,33,26,68
SC Rheindorf,6214,3,20,8,8,54,39,15,68
Vienna,6214,4,20,4,12,66,48,18,64
Rapid Vienna,6214,5,12,14,10,59,47,12,50
Admira Wacke,6214,6,12,7,17,44,61,-17,43
RZ Pellets W,6214,7,11,7,18,45,68,-23,40
SV Josko Rie,6214,8,10,5,21,35,52,-17,35
Mattersburg,6214,9,7,11,18,35,56,-21,32
St. Pölten,6214,10,5,12,19,36,64,-28,27
FC Salzburg,6215,1,21,9,6,70,31,39,72
SK Sturm Gra,6215,2,21,5,10,69,33,36,68
SC Rheindorf,6215,3,18,10,8,55,44,11,64
Vienna,6215,4,18,6,12,64,52,12,60
Rapid Vienna,6215,5,11,11,14,49,50,-1,44
RZ Pellets W,6215,6,11,8,17,47,63,-16,41
SV Josko Rie,6215,7,12,5,19,41,57,-16,41
Admira Wacke,6215,8,11,7,18,37,63,-26,40
Mattersburg,6215,9,9,10,17,36,51,-15,37
St. Pölten,6215,10,7,11,18,43,67,-24,32
FC Salzburg,6216,1,22,9,5,65,28,37,75
SC Rheindorf,6216,2,20,8,8,54,38,16,68
Vienna,6216,3,20,5,11,67,52,15,65
SK Sturm Gra,6216,4,18,7,11,57,35,22,61
Rapid Vienna,6216,5,14,10,12,50,36,14,52
RZ Pellets W,6216,6,11,7,18,44,60,-16,40
Admira Wacke,6216,7,11,7,18,33,55,-22,40
St. Pölten,6216,8,10,7,19,45,67,-22,37
Mattersburg,6216,9,8,9,19,41,59,-18,33
SV Josko Rie,6216,10,9,5,22,30,56,-26,32
SC Rheindorf,6217,1,22,9,5,61,36,25,75
FC Salzburg,6217,2,18,10,8,66,30,36,64
SK Sturm Gra,6217,3,19,6,11,57,34,23,63
Vienna,6217,4,19,4,13,66,58,8,61
Rapid Vienna,6217,5,13,10,13,49,43,6,49
SV Josko Rie,6217,6,12,6,18,41,49,-8,42
Mattersburg,6217,7,11,8,17,40,55,-15,41
RZ Pellets W,6217,8,11,7,18,45,57,-12,40
Admira Wacke,6217,9,10,9,17,34,57,-23,39
St. Pölten,6217,10,5,11,20,34,74,-40,26
SK Sturm Gra,6218,1,23,4,9,59,29,30,73
FC Salzburg,6218,2,20,8,8,61,31,30,68
SC Rheindorf,6218,3,19,8,9,60,44,16,65
Rapid Vienna,6218,4,14,13,9,56,35,21,55
Vienna,6218,5,16,5,15,55,50,5,53
Admira Wacke,6218,6,14,6,16,46,56,-10,48
Mattersburg,6218,7,10,10,16,36,52,-16,40
St. Pölten,6218,8,8,12,16,40,61,-21,36
SV Josko Rie,6218,9,9,5,22,32,59,-27,32
RZ Pellets W,6218,10,8,7,21,34,62,-28,31
SK Sturm Gra,6219,1,22,3,11,67,33,34,69
SC Rheindorf,6219,2,20,9,7,63,42,21,69
FC Salzburg,6219,3,19,9,8,61,33,28,66
Vienna,6219,4,18,4,14,64,50,14,58
Admira Wacke,6219,5,14,5,17,41,61,-20,47
Rapid Vienna,6219,6,12,10,14,57,50,7,46
RZ Pellets W,6219,7,13,5,18,42,58,-16,44
Mattersburg,6219,8,9,10,17,35,55,-20,37
St. Pölten,6219,9,9,8,19,45,66,-21,35
SV Josko Rie,6219,10,10,5,21,32,59,-27,35
FC Salzburg,6220,1,23,4,9,68,35,33,73
SK Sturm Gra,6220,2,21,4,11,63,35,28,67
SC Rheindorf,6220,3,20,7,9,60,37,23,67
Rapid Vienna,6220,4,19,8,9,62,35,27,65
Vienna,6220,5,15,6,15,56,60,-4,51
Admira Wacke,6220,6,14,5,17,40,53,-13,47
RZ Pellets W,6220,7,10,10,16,38,55,-17,40
SV Josko Rie,6220,8,10,6,20,32,58,-26,36
Mattersburg,6220,9,8,10,18,31,47,-16,34
St. Pölten,6220,10,6,8,22,34,69,-35,26
FC Salzburg,6221,1,21,6,9,67,35,32,69
SC Rheindorf,6221,2,20,7,9,55,36,19,67
SK Sturm Gra,6221,3,18,8,10,60,41,19,62
Vienna,6221,4,16,6,14,61,61,0,54
Rapid Vienna,6221,5,12,13,11,53,39,14,49
Admira Wacke,6221,6,13,6,17,41,58,-17,45
SV Josko Rie,6221,7,13,4,19,36,49,-13,43
RZ Pellets W,6221,8,10,8,18,38,57,-19,38
St. Pölten,6221,9,8,13,15,41,57,-16,37
Mattersburg,6221,10,9,9,18,35,54,-19,36
FC Salzburg,6222,1,19,8,9,61,38,23,65
SK Sturm Gra,6222,2,19,6,11,55,33,22,63
SC Rheindorf,6222,3,19,6,11,48,42,6,63
Rapid Vienna,6222,4,16,10,10,58,37,21,58
Vienna,6222,5,18,4,14,64,54,10,58
Mattersburg,6222,6,12,8,16,45,53,-8,44
Admira Wacke,6222,7,12,7,17,34,55,-21,43
RZ Pellets W,6222,8,11,9,16,42,53,-11,42
SV Josko Rie,6222,9,10,6,20,30,49,-19,36
St. Pölten,6222,10,7,10,19,42,65,-23,31
FC Salzburg,6223,1,19,10,7,63,30,33,67
SC Rheindorf,6223,2,19,10,7,57,43,14,67
SK Sturm Gra,6223,3,18,9,9,57,33,24,63
Vienna,6223,4,20,3,13,66,51,15,63
Rapid Vienna,6223,5,18,8,10,65,39,26,62
Mattersburg,6223,6,11,7,18,43,55,-12,40
Admira Wacke,6223,7,10,8,18,32,57,-25,38
St. Pölten,6223,8,9,9,18,41,69,-28,36
RZ Pellets W,6223,9,9,8,19,40,63,-23,35
SV Josko Rie,6223,10,8,6,22,37,61,-24,30
FC Salzburg,6224,1,21,7,8,62,34,28,70
SC Rheindorf,6224,2,20,7,9,60,44,16,67
Rapid Vienna,6224,3,18,9,9,58,33,25,63
SK Sturm Gra,6224,4,17,10,9,55,28,27,61
Vienna,6224,5,16,6,14,58,54,4,54
RZ Pellets W,6224,6,14,9,13,48,51,-3,51
Admira Wacke,6224,7,11,6,19,35,64,-29,39
SV Josko Rie,6224,8,11,5,20,35,51,-16,38
Mattersburg,6224,9,9,9,18,37,56,-19,36
St. Pölten,6224,10,5,8,23,37,70,-33,23
SC Rheindorf,6225,1,22,8,6,56,32,24,74
SK Sturm Gra,6225,2,18,9,9,51,27,24,63
FC Salzburg,6225,3,17,11,8,58,33,25,62
Vienna,6225,4,19,5,12,54,42,12,62
Rapid Vienna,6225,5,13,13,10,58,44,14,52
Admira Wacke,6225,6,12,8,16,43,59,-16,44
RZ Pellets W,6225,7,10,10,16,45,57,-12,40
St. Pölten,6225,8,9,11,16,35,56,-21,38
SV Josko Rie,6225,9,8,8,20,30,53,-23,32
Mattersburg,6225,10,6,9,21,27,54,-27,27
SC Rheindorf,6226,1,20,8,8,54,39,15,68
Rapid Vienna,6226,2,18,10,8,61,32,29,64
Vienna,6226,3,19,7,10,59,47,12,64
SK Sturm Gra,6226,4,18,9,9,62,36,26,63
FC Salzburg,6226,5,16,11,9,58,36,22,59
SV Josko Rie,6226,6,12,6,18,40,58,-18,42
RZ Pellets W,6226,7,11,6,19,40,56,-16,39
Admira Wacke,6226,8,10,6,20,37,63,-26,36
Mattersburg,6226,9,8,10,18,36,54,-18,34
St. Pölten,6226,10,8,7,21,37,63,-26,31
Vienna,6227,1,21,7,8,72,48,24,70
FC Salzburg,6227,2,20,8,8,67,33,34,68
SC Rheindorf,6227,3,19,6,11,56,45,11,63
SK Sturm Gra,6227,4,18,7,11,59,37,22,61
Rapid Vienna,6227,5,14,12,10,53,42,11,54
RZ Pellets W,6227,6,13,5,18,46,56,-10,44
SV Josko Rie,6227,7,11,6,19,32,55,-23,39
Admira Wacke,6227,8,10,6,20,35,65,-30,36
Mattersburg,6227,9,9,7,20,35,54,-19,34
St. Pölten,6227,10,7,12,17,41,61,-20,33
Vienna,6228,1,23,4,9,71,47,24,73
FC Salzburg,6228,2,22,4,10,66,34,32,70
SK Sturm Gra,6228,3,21,4,11,61,37,24,67
SC Rheindorf,6228,4,19,7,10,50,42,8,64
RZ Pellets W,6228,5,14,7,15,52,59,-7,49
Rapid Vienna,6228,6,11,14,11,55,42,13,47
SV Josko Rie,6228,7,14,4,18,38,52,-14,46
Admira Wacke,6228,8,11,5,20,40,61,-21,38
Mattersburg,6228,9,8,8,20,37,61,-24,32
St. Pölten,6228,10,5,7,24,33,68,-35,22
SC Rheindorf,6229,1,22,5,9,58,39,19,71
FC Salzburg,6229,2,21,6,9,69,32,37,69
SK Sturm Gra,6229,3,21,5,10,65,34,31,68
Vienna,6229,4,20,4,12,62,53,9,64
RZ Pellets W,6229,5,14,8,14,46,51,-5,50
Rapid Vienna,6229,6,14,7,15,53,39,14,49
Admira Wacke,6229,7,13,5,18,33,54,-21,44
SV Josko Rie,6229,8,12,3,21,33,55,-22,39
St. Pölten,6229,9,8,6,22,38,74,-36,30
Mattersburg,6229,10,6,9,21,30,56,-26,27
FC Salzburg,6230,1,21,7,8,69,33,36,70
SC Rheindorf,6230,2,18,11,7,56,40,16,65
Vienna,6230,3,19,5,12,63,46,17,62
Rapid Vienna,6230,4,13,13,10,51,40,11,52
SK Sturm Gra,6230,5,14,9,13,55,41,14,51
RZ Pellets W,6230,6,13,9,14,45,55,-10,48
Mattersburg,6230,7,12,8,16,44,54,-10,44
Admira Wacke,6230,8,11,7,18,40,64,-24,40
SV Josko Rie,6230,9,8,10,18,29,48,-19,34
St. Pölten,6230,10,6,11,19,35,66,-31,29
SC Rheindorf,6231,1,22,8,6,61,41,20,74
SK Sturm Gra,6231,2,20,8,8,63,34,29,68
FC Salzburg,6231,3,17,11,8,55,32,23,62
Vienna,6231,4,19,3,14,61,51,10,60
Rapid Vienna,6231,5,13,10,13,55,44,11,49
SV Josko Rie,6231,6,13,4,19,39,55,-16,43
Mattersburg,6231,7,10,9,17,41,52,-11,39
RZ Pellets W,6231,8,9,11,16,39,52,-13,38
Admira Wacke,6231,9,10,8,18,34,59,-25,38
St. Pölten,6231,10,6,10,20,42,70,-28,28
SC Rheindorf,6232,1,25,6,5,73,38,35,81
Vienna,6232,2,22,5,9,60,39,21,71
FC Salzburg,6232,3,17,10,9,59,35,24,61
SK Sturm Gra,6232,4,17,8,11,48,34,14,59
Rapid Vienna,6232,5,15,10,11,59,37,22,55
RZ Pellets W,6232,6,11,7,18,39,56,-17,40
Mattersburg,6232,7,10,9,17,43,56,-13,39
Admira Wacke,6232,8,11,5,20,37,60,-23,38
SV Josko Rie,6232,9,8,6,22,31,58,-27,30
St. Pölten,6232,10,7,8,21,34,70,-36,29
SC Rheindorf,6233,1,20,6,10,50,38,12,66
SK Sturm Gra,6233,2,19,7,10,61,34,27,64
FC Salzburg,6233,3,18,9,9,58,31,27,63
Rapid Vienna,6233,4,17,10,9,61,35,26,61
Vienna,6233,5,17,6,13,58,53,5,57
SV Josko Rie,6233,6,13,6,17,35,47,-12,45
RZ Pellets W,6233,7,12,7,17,39,54,-15,43
Admira Wacke,6233,8,11,6,19,32,57,-25,39
Mattersburg,6233,9,8,9,19,37,60,-23,33
St. Pölten,6233,10,7,10,19,45,67,-22,31
SC Rheindorf,6234,1,20,7,9,55,43,12,67
FC Salzburg,6234,2,19,8,9,64,34,30,65
Vienna,6234,3,18,6,12,69,51,18,60
SK Sturm Gra,6234,4,16,10,10,51,30,21,58
Admira Wacke,6234,5,16,6,14,43,51,-8,54
Rapid Vienna,6234,6,14,10,12,56,40,16,52
RZ Pellets W,6234,7,12,7,17,41,58,-17,43
St. Pölten,6234,8,10,10,16,41,59,-18,40
SV Josko Rie,6234,9,11,3,22,32,55,-23,36
Mattersburg,6234,10,6,9,21,31,62,-31,27
SC Rheindorf,6235,1,20,9,7,56,34,22,69
FC Salzburg,6235,2,20,8,8,67,33,34,68
SK Sturm Gra,6235,3,17,11,8,49,27,22,62
Vienna,6235,4,19,5,12,61,49,12,62
Rapid Vienna,6235,5,16,9,11,53,35,18,57
Mattersburg,6235,6,11,6,19,38,53,-15,39
Admira Wacke,6235,7,11,5,20,38,65,-27,38
SV Josko Rie,6235,8,10,7,19,34,56,-22,37
RZ Pellets W,6235,9,10,6,20,38,61,-23,36
St. Pölten,6235,10,8,10,18,46,67,-21,34
FC Salzburg,6236,1,24,6,6,73,27,46,78
SK Sturm Gra,6236,2,21,6,9,60,32,28,69
SC Rheindorf,6236,3,19,8,9,55,41,14,65
Rapid Vienna,6236,4,14,12,10,55,38,17,54
Vienna,6236,5,16,5,15,54,54,0,53
RZ Pellets W,6236,6,13,6,17,44,53,-9,45
Mattersburg,6236,7,9,10,17,31,52,-21,37
SV Josko Rie,6236,8,10,5,21,34,55,-21,35
Admira Wacke,6236,9,9,7,20,35,60,-25,34
St. Pölten,6236,10,8,9,19,39,68,-29,33
FC Salzburg,6237,1,22,8,6,72,33,39,74
Rapid Vienna,6237,2,18,8,10,56,36,20,62
SC Rheindorf,6237,3,17,10,9,52,43,9,61
SK Sturm Gra,6237,4,17,8,11,56,38,18,59
Vienna,6237,5,18,5,13,67,53,14,59
RZ Pellets W,6237,6,12,7,17,44,51,-7,43
Admira Wacke,6237,7,11,9,16,36,53,-17,42
SV Josko Rie,6237,8,10,6,20,36,57,-21,36
Mattersburg,6237,9,9,7,20,37,65,-28,34
St. Pölten,6237,10,7,10,19,36,63,-27,31
FC Salzburg,6238,1,20,8,8,63,32,31,68
SC Rheindorf,6238,2,19,11,6,52,37,15,68
Vienna,6238,3,20,4,12,68,51,17,64
SK Sturm Gra,6238,4,19,6,11,57,34,23,63
Rapid Vienna,6238,5,14,9,13,58,45,13,51
RZ Pellets W,6238,6,11,8,17,46,59,-13,41
SV Josko Rie,6238,7,12,5,19,40,53,-13,41
St. Pölten,6238,8,9,11,16,50,72,-22,38
Mattersburg,6238,9,9,8,19,37,58,-21,35
Admira Wacke,6238,10,10,4,22,33,63,-30,34
FC Salzburg,6239,1,21,8,7,69,35,34,71
Vienna,6239,2,21,4,11,70,51,19,67
SK Sturm Gra,6239,3,20,6,10,60,36,24,66
SC Rheindorf,6239,4,18,7,11,52,47,5,61
Rapid Vienna,6239,5,12,10,14,59,48,11,46
SV Josko Rie,6239,6,13,5,18,42,52,-10,44
Mattersburg,6239,7,10,9,17,44,61,-17,39
Admira Wacke,6239,8,11,6,19,41,68,-27,39
RZ Pellets W,6239,9,11,5,20,41,61,-20,38
St. Pölten,6239,10,9,8,19,43,62,-19,35
SK Sturm Gra,6240,1,21,7,8,59,29,30,70
FC Salzburg,6240,2,19,9,8,63,30,33,66
SC Rheindorf,6240,3,19,8,9,52,42,10,65
Vienna,6240,4,19,7,10,66,48,18,64
Rapid Vienna,6240,5,13,11,12,49,37,12,50
SV Josko Rie,6240,6,12,6,18,34,49,-15,42
St. Pölten,6240,7,9,11,16,38,59,-21,38
Mattersburg,6240,8,9,9,18,36,54,-18,36
RZ Pellets W,6240,9,9,9,18,38,57,-19,36
Admira Wacke,6240,10,8,7,21,29,59,-30,31
SC Rheindorf,6241,1,21,9,6,54,36,18,72
SK Sturm Gra,6241,2,18,9,9,59,34,25,63
Vienna,6241,3,19,4,13,63,55,8,61
FC Salzburg,6241,4,17,9,10,58,36,22,60
Rapid Vienna,6241,5,12,13,11,51,42,9,49
RZ Pellets W,6241,6,12,8,16,46,57,-11,44
Admira Wacke,6241,7,11,10,15,40,56,-16,43
SV Josko Rie,6241,8,12,6,18,36,49,-13,42
St. Pölten,6241,9,8,11,17,44,60,-16,35
Mattersburg,6241,10,6,9,21,36,62,-26,27
SC Rheindorf,6242,1,20,9,7,55,38,17,69
FC Salzburg,6242,2,18,11,7,64,31,33,65
SK Sturm Gra,6242,3,19,6,11,57,33,24,63
Vienna,6242,4,18,3,15,65,57,8,57
Rapid Vienna,6242,5,13,10,13,51,42,9,49
RZ Pellets W,6242,6,13,9,14,48,52,-4,48
Mattersburg,6242,7,11,10,15,45,51,-6,43
St. Pölten,6242,8,9,10,17,43,64,-21,37
Admira Wacke,6242,9,9,8,19,36,62,-26,35
SV Josko Rie,6242,10,9,6,21,33,67,-34,33
SC Rheindorf,6243,1,20,7,9,49,36,13,67
SK Sturm Gra,6243,2,20,5,11,64,38,26,65
FC Salzburg,6243,3,19,6,11,62,41,21,63
Vienna,6243,4,20,3,13,66,51,15,63
RZ Pellets W,6243,5,15,7,14,52,53,-1,52
Rapid Vienna,6243,6,13,11,12,53,42,11,50
SV Josko Rie,6243,7,12,3,21,32,50,-18,39
Admira Wacke,6243,8,11,4,21,33,59,-26,37
Mattersburg,6243,9,9,9,18,35,54,-19,36
St. Pölten,6243,10,9,9,18,39,61,-22,36
FC Salzburg,6244,1,20,8,8,62,31,31,68
SC Rheindorf,6244,2,21,4,11,60,42,18,67
SK Sturm Gra,6244,3,19,7,10,59,33,26,64
Vienna,6244,4,19,4,13,64,50,14,61
Rapid Vienna,6244,5,13,13,10,53,37,16,52
RZ Pellets W,6244,6,13,7,16,45,52,-7,46
Admira Wacke,6244,7,13,5,18,38,62,-24,44
SV Josko Rie,6244,8,10,6,20,32,55,-23,36
Mattersburg,6244,9,8,11,17,34,55,-21,35
St. Pölten,6244,10,6,11,19,41,71,-30,29
FC Salzburg,6245,1,22,7,7,67,28,39,73
Vienna,6245,2,22,5,9,72,47,25,71
SC Rheindorf,6245,3,19,6,11,52,43,9,63
Rapid Vienna,6245,4,16,9,11,58,40,18,57
SK Sturm Gra,6245,5,16,9,11,58,42,16,57
RZ Pellets W,6245,6,12,8,16,48,56,-8,44
SV Josko Rie,6245,7,11,3,22,35,60,-25,36
Admira Wacke,6245,8,9,9,18,34,60,-26,36
St. Pölten,6245,9,8,11,17,42,65,-23,35
Mattersburg,6245,10,7,9,20,32,57,-25,30
FC Salzburg,6246,1,21,10,5,65,27,38,73
Vienna,6246,2,19,6,11,63,48,15,63
SC Rheindorf,6246,3,16,10,10,45,37,8,58
SK Sturm Gra,6246,4,17,6,13,53,36,17,57
Rapid Vienna,6246,5,14,9,13,63,52,11,51
RZ Pellets W,6246,6,13,8,15,56,61,-5,47
St. Pölten,6246,7,10,10,16,45,62,-17,40
Admira Wacke,6246,8,10,9,17,36,59,-23,39
SV Josko Rie,6246,9,10,8,18,34,53,-19,38
Mattersburg,6246,10,6,12,18,35,60,-25,30
Vienna,6247,1,22,6,8,66,45,21,72
FC Salzburg,6247,2,20,8,8,61,27,34,68
SK Sturm Gra,6247,3,18,9,9,59,34,25,63
SC Rheindorf,6247,4,18,9,9,58,47,11,63
Rapid Vienna,6247,5,11,10,15,51,50,1,43
RZ Pellets W,6247,6,12,6,18,41,52,-11,42
St. Pölten,6247,7,11,9,16,39,57,-18,42
SV Josko Rie,6247,8,12,4,20,38,54,-16,40
Admira Wacke,6247,9,10,7,19,35,62,-27,37
Mattersburg,6247,10,7,10,19,37,57,-20,31
FC Salzburg,6248,1,22,4,10,63,39,24,70
SC Rheindorf,6248,2,20,9,7,57,36,21,69
Vienna,6248,3,22,2,12,66,51,15,68
SK Sturm Gra,6248,4,19,6,11,59,37,22,63
Rapid Vienna,6248,5,13,13,10,59,44,15,52
RZ Pellets W,6248,6,14,8,14,47,51,-4,50
Admira Wacke,6248,7,11,6,19,35,54,-19,39
St. Pölten,6248,8,8,10,18,36,63,-27,34
SV Josko Rie,6248,9,10,3,23,35,55,-20,33
Mattersburg,6248,10,6,9,21,33,60,-27,27
SK Sturm Gra,6249,1,20,8,8,66,33,33,68
FC Salzburg,6249,2,19,10,7,65,35,30,67
SC Rheindorf,6249,3,19,8,9,53,43,10,65
Vienna,6249,4,17,4,15,61,56,5,55
Rapid Vienna,6249,5,14,9,13,55,40,15,51
RZ Pellets W,6249,6,14,9,13,54,52,2,51
Admira Wacke,6249,7,12,6,18,34,56,-22,42
SV Josko Rie,6249,8,9,9,18,32,56,-24,36
St. Pölten,6249,9,8,9,19,42,66,-24,33
Mattersburg,6249,10,9,6,21,32,57,-25,33
FC Salzburg,6250,1,22,5,9,67,31,36,71
Vienna,6250,2,20,5,11,63,49,14,65
SC Rheindorf,6250,3,19,8,9,52,41,11,65
SK Sturm Gra,6250,4,19,5,12,65,38,27,62
Rapid Vienna,6250,5,16,11,9,59,36,23,59
RZ Pellets W,6250,6,15,6,15,52,56,-4,51
St. Pölten,6250,7,9,10,17,39,63,-24,37
Admira Wacke,6250,8,9,8,19,38,63,-25,35
Mattersburg,6250,9,7,11,18,34,57,-23,32
SV Josko Rie,6250,10,7,5,24,32,67,-35,26
SK Sturm Gra,6251,1,24,3,9,63,27,36,75
FC Salzburg,6251,2,21,6,9,66,35,31,69
Vienna,6251,3,17,6,13,62,52,10,57
SC Rheindorf,6251,4,17,6,13,49,45,4,57
Rapid Vienna,6251,5,14,10,12,54,41,13,52
Admira Wacke,6251,6,14,7,15,43,61,-18,49
RZ Pellets W,6251,7,14,6,16,48,56,-8,48
St. Pölten,6251,8,9,8,19,44,70,-26,35
Mattersburg,6251,9,8,9,19,37,57,-20,33
SV Josko Rie,6251,10,8,7,21,35,57,-22,31
FC Salzburg,6252,1,21,5,10,68,35,33,68
Vienna,6252,2,21,4,11,67,46,21,67
SK Sturm Gra,6252,3,20,6,10,64,37,27,66
SC Rheindorf,6252,4,18,7,11,56,43,13,61
Rapid Vienna,6252,5,16,11,9,61,38,23,59
RZ Pellets W,6252,6,13,9,14,48,54,-6,48
SV Josko Rie,6252,7,11,6,19,38,63,-25,39
Admira Wacke,6252,8,10,7,19,37,62,-25,37
St. Pölten,6252,9,6,12,18,34,67,-33,30
Mattersburg,6252,10,7,7,22,35,63,-28,28
SK Sturm Gra,6253,1,24,5,7,67,28,39,77
FC Salzburg,6253,2,22,4,10,63,29,34,70
SC Rheindorf,6253,3,19,6,11,55,43,12,63
Vienna,6253,4,19,5,12,60,52,8,62
Rapid Vienna,6253,5,12,10,14,57,48,9,46
Admira Wacke,6253,6,13,7,16,41,65,-24,46
RZ Pellets W,6253,7,11,7,18,49,56,-7,40
Mattersburg,6253,8,9,9,18,35,56,-21,36
SV Josko Rie,6253,9,9,8,19,31,52,-21,35
St. Pölten,6253,10,6,11,19,40,69,-29,29
SC Rheindorf,6254,1,23,5,8,54,36,18,74
Vienna,6254,2,18,7,11,59,45,14,61
SK Sturm Gra,6254,3,18,5,13,61,37,24,59
FC Salzburg,6254,4,17,6,13,53,37,16,57
Rapid Vienna,6254,5,14,11,11,55,37,18,53
RZ Pellets W,6254,6,13,8,15,44,50,-6,47
SV Josko Rie,6254,7,12,5,19,36,51,-15,41
Admira Wacke,6254,8,10,9,17,31,62,-31,39
St. Pölten,6254,9,9,9,18,41,61,-20,36
Mattersburg,6254,10,8,11,17,32,50,-18,35
Vienna,6255,1,21,4,11,64,47,17,67
FC Salzburg,6255,2,17,13,6,56,27,29,64
SK Sturm Gra,6255,3,18,8,10,58,31,27,62
SC Rheindorf,6255,4,18,8,10,53,47,6,62
Rapid Vienna,6255,5,14,11,11,54,48,6,53
RZ Pellets W,6255,6,13,10,13,53,53,0,49
Admira Wacke,6255,7,14,4,18,44,61,-17,46
SV Josko Rie,6255,8,10,5,21,34,54,-20,35
St. Pölten,6255,9,7,11,18,42,66,-24,32
Mattersburg,6255,10,8,6,22,37,61,-24,30
SC Rheindorf,6256,1,22,7,7,57,37,20,73
FC Salzburg,6256,2,22,4,10,65,27,38,70
Vienna,6256,3,20,4,12,61,53,8,64
SK Sturm Gra,6256,4,18,6,12,53,34,19,60
Rapid Vienna,6256,5,13,9,14,53,44,9,48
SV Josko Rie,6256,6,13,7,16,40,53,-13,46
RZ Pellets W,6256,7,11,9,16,42,49,-7,42
St. Pölten,6256,8,10,10,16,43,64,-21,40
Admira Wacke,6256,9,10,5,21,38,62,-24,35
Mattersburg,6256,10,7,7,22,33,62,-29,28
FC Salzburg,6257,1,23,6,7,66,29,37,75
SK Sturm Gra,6257,2,18,8,10,64,38,26,62
SC Rheindorf,6257,3,17,8,11,57,44,13,59
Vienna,6257,4,16,7,13,58,54,4,55
Admira Wacke,6257,5,14,6,16,44,60,-16,48
Rapid Vienna,6257,6,12,11,13,52,44,8,47
RZ Pellets W,6257,7,12,9,15,48,56,-8,45
SV Josko Rie,6257,8,11,8,17,44,58,-14,41
Mattersburg,6257,9,10,8,18,38,58,-20,38
St. Pölten,6257,10,7,9,20,41,71,-30,30
FC Salzburg,6258,1,20,8,8,71,36,35,68
Vienna,6258,2,21,2,13,67,54,13,65
SK Sturm Gra,6258,3,19,7,10,60,35,25,64
SC Rheindorf,6258,4,17,8,11,49,49,0,59
Rapid Vienna,6258,5,13,10,13,56,42,14,49
RZ Pellets W,6258,6,12,8,16,44,53,-9,44
Mattersburg,6258,7,12,7,17,33,50,-17,43
Admira Wacke,6258,8,11,8,17,42,59,-17,41
SV Josko Rie,6258,9,10,7,19,34,59,-25,37
St. Pölten,6258,10,8,9,19,39,58,-19,33
SK Sturm Gra,6259,1,20,7,9,61,32,29,67
FC Salzburg,6259,2,18,10,8,68,39,29,64
SC Rheindorf,6259,3,18,8,10,56,46,10,62
Vienna,6259,4,18,5,13,62,54,8,59
Rapid Vienna,6259,5,13,12,11,59,41,18,51
RZ Pellets W,6259,6,12,10,14,45,55,-10,46
Admira Wacke,6259,7,13,7,16,47,60,-13,46
Mattersburg,6259,8,10,9,17,39,52,-13,39
SV Josko Rie,6259,9,10,4,22,42,65,-23,34
St. Pölten,6259,10,6,12,18,40,75,-35,30
Vienna,6260,1,20,7,9,60,41,19,67
FC Salzburg,6260,2,19,8,9,61,26,35,65
SC Rheindorf,6260,3,18,10,8,54,42,12,64
SK Sturm Gra,6260,4,17,8,11,55,35,20,59
Rapid Vienna,6260,5,16,7,13,49,40,9,55
Admira Wacke,6260,6,15,4,17,42,53,-11,49
RZ Pellets W,6260,7,12,10,14,45,52,-7,46
SV Josko Rie,6260,8,9,7,20,30,60,-30,34
Mattersburg,6260,9,8,8,20,33,53,-20,32
St. Pölten,6260,10,6,11,19,37,64,-27,29
FC Salzburg,6261,1,21,8,7,66,30,36,71
Vienna,6261,2,22,4,10,66,49,17,70
SC Rheindorf,6261,3,21,7,8,52,42,10,70
SK Sturm Gra,6261,4,20,5,11,59,32,27,65
Rapid Vienna,6261,5,17,9,10,63,38,25,60
Admira Wacke,6261,6,12,5,19,43,66,-23,41
SV Josko Rie,6261,7,11,5,20,35,50,-15,38
RZ Pellets W,6261,8,10,8,18,45,63,-18,38
Mattersburg,6261,9,7,8,21,40,65,-25,29
St. Pölten,6261,10,6,7,23,34,68,-34,25
FC Salzburg,6262,1,23,4,9,67,32,35,73
Vienna,6262,2,23,3,10,74,47,27,72
SC Rheindorf,6262,3,20,6,10,50,41,9,66
SK Sturm Gra,6262,4,18,5,13,55,37,18,59
RZ Pellets W,6262,5,13,7,16,51,60,-9,46
Admira Wacke,6262,6,12,6,18,40,64,-24,42
Rapid Vienna,6262,7,10,11,15,53,48,5,41
St. Pölten,6262,8,9,11,16,45,63,-18,38
SV Josko Rie,6262,9,10,6,20,37,60,-23,36
Mattersburg,6262,10,8,9,19,40,60,-20,33
FC Salzburg,6263,1,23,8,5,72,27,45,77
Vienna,6263,2,21,6,9,67,46,21,69
SC Rheindorf,6263,3,19,11,6,57,39,18,68
SK Sturm Gra,6263,4,18,5,13,60,37,23,59
St. Pölten,6263,5,12,10,14,48,57,-9,46
Rapid Vienna,6263,6,10,11,15,44,40,4,41
RZ Pellets W,6263,7,11,7,18,38,64,-26,40
Admira Wacke,6263,8,10,6,20,36,64,-28,36
Mattersburg,6263,9,8,10,18,33,53,-20,34
SV Josko Rie,6263,10,7,8,21,30,58,-28,29
FC Salzburg,6264,1,24,4,8,72,30,42,76
Vienna,6264,2,20,4,12,58,47,11,64
SK Sturm Gra,6264,3,19,6,11,59,37,22,63
SC Rheindorf,6264,4,15,11,10,48,44,4,56
Rapid Vienna,6264,5,12,13,11,53,43,10,49
Mattersburg,6264,6,13,6,17,47,56,-9,45
Admira Wacke,6264,7,12,6,18,41,63,-22,42
RZ Pellets W,6264,8,11,8,17,43,58,-15,41
St. Pölten,6264,9,8,11,17,39,62,-23,35
SV Josko Rie,6264,10,9,5,22,29,49,-20,32
FC Salzburg,6265,1,19,11,6,60,27,33,68
SK Sturm Gra,6265,2,20,8,8,68,36,32,68
SC Rheindorf,6265,3,18,6,12,56,46,10,60
Rapid Vienna,6265,4,15,11,10,55,37,18,56
Vienna,6265,5,16,5,15,51,53,-2,53
SV Josko Rie,6265,6,15,4,17,40,51,-11,49
RZ Pellets W,6265,7,13,7,16,49,59,-10,46
Admira Wacke,6265,8,12,8,16,37,52,-15,44
St. Pölten,6265,9,7,11,18,45,69,-24,32
Mattersburg,6265,10,6,7,23,31,62,-31,25
FC Salzburg,6266,1,25,4,7,70,25,45,79
SC Rheindorf,6266,2,22,7,7,56,38,18,73
SK Sturm Gra,6266,3,20,4,12,61,36,25,64
Vienna,6266,4,18,5,13,62,55,7,59
Rapid Vienna,6266,5,14,10,12,55,40,15,52
RZ Pellets W,6266,6,12,8,16,44,53,-9,44
Admira Wacke,6266,7,10,7,19,32,55,-23,37
SV Josko Rie,6266,8,11,4,21,28,52,-24,37
St. Pölten,6266,9,8,8,20,36,65,-29,32
Mattersburg,6266,10,5,13,18,32,57,-25,28
SC Rheindorf,6267,1,21,7,8,50,32,18,70
FC Salzburg,6267,2,21,6,9,69,33,36,69
Vienna,6267,3,17,8,11,58,49,9,59
SK Sturm Gra,6267,4,16,9,11,58,36,22,57
Rapid Vienna,6267,5,15,10,11,55,37,18,55
Admira Wacke,6267,6,14,8,14,41,51,-10,50
RZ Pellets W,6267,7,12,5,19,45,67,-22,41
St. Pölten,6267,8,10,7,19,40,64,-24,37
Mattersburg,6267,9,9,8,19,35,56,-21,35
SV Josko Rie,6267,10,8,6,22,35,61,-26,30
FC Salzburg,6268,1,22,6,8,69,29,40,72
Vienna,6268,2,20,4,12,64,50,14,64
SC Rheindorf,6268,3,16,11,9,52,39,13,59
SK Sturm Gra,6268,4,16,9,11,60,44,16,57
Rapid Vienna,6268,5,14,12,10,59,38,21,54
Admira Wacke,6268,6,12,6,18,40,60,-20,42
SV Josko Rie,6268,7,11,6,19,38,60,-22,39
RZ Pellets W,6268,8,8,14,14,39,52,-13,38
St. Pölten,6268,9,9,9,18,43,72,-29,36
Mattersburg,6268,10,8,11,17,43,63,-20,35
FC Salzburg,6269,1,22,7,7,75,32,43,73
SC Rheindorf,6269,2,22,6,8,62,36,26,72
Vienna,6269,3,19,7,10,65,48,17,64
SK Sturm Gra,6269,4,16,6,14,51,37,14,54
Rapid Vienna,6269,5,15,9,12,52,42,10,54
St. Pölten,6269,6,12,7,17,42,63,-21,43
RZ Pellets W,6269,7,10,10,16,41,54,-13,40
Admira Wacke,6269,8,11,7,18,36,64,-28,40
SV Josko Rie,6269,9,9,6,21,30,53,-23,33
Mattersburg,6269,10,8,7,21,34,59,-25,31
Vienna,6270,1,21,3,12,62,47,15,66
SC Rheindorf,6270,2,18,11,7,50,36,14,65
FC Salzburg,6270,3,19,7,10,59,33,26,64
SK Sturm Gra,6270,4,19,5,12,58,41,17,62
Admira Wacke,6270,5,15,5,16,45,58,-13,50
RZ Pellets W,6270,6,14,6,16,53,60,-7,48
Rapid Vienna,6270,7,12,9,15,53,43,10,45
St. Pölten,6270,8,11,7,18,50,65,-15,40
Mattersburg,6270,9,8,11,17,34,50,-16,35
SV Josko Rie,6270,10,8,6,22,31,62,-31,30
SK Sturm Gra,6271,1,22,6,8,63,28,35,72
FC Salzburg,6271,2,22,5,9,64,31,33,71
SC Rheindorf,6271,3,19,6,11,50,45,5,63
Vienna,6271,4,19,4,13,61,47,14,61
Rapid Vienna,6271,5,16,10,10,60,36,24,58
RZ Pellets W,6271,6,14,6,16,44,55,-11,48
Admira Wacke,6271,7,12,6,18,34,56,-22,42
SV Josko Rie,6271,8,11,3,22,31,56,-25,36
Mattersburg,6271,9,8,6,22,33,60,-27,30
St. Pölten,6271,10,7,8,21,36,62,-26,29
SC Rheindorf,6272,1,23,5,8,62,39,23,74
FC Salzburg,6272,2,21,8,7,63,31,32,71
Vienna,6272,3,19,4,13,57,56,1,61
Rapid Vienna,6272,4,17,9,10,57,37,20,60
SK Sturm Gra,6272,5,15,6,15,49,40,9,51
RZ Pellets W,6272,6,12,9,15,50,57,-7,45
Mattersburg,6272,7,12,5,19,42,50,-8,41
Admira Wacke,6272,8,11,7,18,40,61,-21,40
SV Josko Rie,6272,9,12,2,22,38,53,-15,38
St. Pölten,6272,10,7,7,22,35,69,-34,28
SK Sturm Gra,6273,1,23,4,9,64,31,33,73
FC Salzburg,6273,2,20,10,6,63,26,37,70
SC Rheindorf,6273,3,18,8,10,51,40,11,62
Vienna,6273,4,16,6,14,65,55,10,54
SV Josko Rie,6273,5,14,8,14,41,49,-8,50
Rapid Vienna,6273,6,12,12,12,55,45,10,48
RZ Pellets W,6273,7,13,5,18,45,59,-14,44
Admira Wacke,6273,8,10,10,16,38,60,-22,40
St. Pölten,6273,9,5,13,18,41,68,-27,28
Mattersburg,6273,10,6,10,20,35,65,-30,28
FC Salzburg,6274,1,21,8,7,64,26,38,71
SC Rheindorf,6274,2,22,4,10,60,42,18,70
SK Sturm Gra,6274,3,17,8,11,54,36,18,59
Vienna,6274,4,18,5,13,66,57,9,59
Rapid Vienna,6274,5,13,10,13,58,44,14,49
Admira Wacke,6274,6,13,7,16,37,56,-19,46
RZ Pellets W,6274,7,11,9,16,43,56,-13,42
St. Pölten,6274,8,9,11,16,44,63,-19,38
SV Josko Rie,6274,9,10,6,20,37,54,-17,36
Mattersburg,6274,10,7,10,19,33,62,-29,31
FC Salzburg,6275,1,22,5,9,69,29,40,71
Vienna,6275,2,22,4,10,68,45,23,70
SC Rheindorf,6275,3,19,6,11,57,45,12,63
SK Sturm Gra,6275,4,19,4,13,63,46,17,61
Rapid Vienna,6275,5,14,10,12,60,45,15,52
SV Josko Rie,6275,6,13,3,20,29,46,-17,42
Admira Wacke,6275,7,12,5,19,35,64,-29,41
RZ Pellets W,6275,8,11,7,18,44,60,-16,40
Mattersburg,6275,9,11,7,18,39,56,-17,40
St. Pölten,6275,10,8,7,21,39,67,-28,31
FC Salzburg,6276,1,23,5,8,69,34,35,74
Vienna,6276,2,20,2,14,74,54,20,62
SC Rheindorf,6276,3,18,8,10,53,46,7,62
SK Sturm Gra,6276,4,17,5,14,54,43,11,56
RZ Pellets W,6276,5,15,6,15,47,51,-4,51
Rapid Vienna,6276,6,13,10,13,52,43,9,49
Mattersburg,6276,7,11,8,17,45,60,-15,41
SV Josko Rie,6276,8,12,5,19,37,52,-15,41
Admira Wacke,6276,9,12,5,19,35,58,-23,41
St. Pölten,6276,10,7,10,19,41,66,-25,31
FC Salzburg,6277,1,22,7,7,68,29,39,73
SC Rheindorf,6277,2,20,6,10,56,42,14,66
SK Sturm Gra,6277,3,18,7,11,62,40,22,61
Vienna,6277,4,17,4,15,67,61,6,55
Rapid Vienna,6277,5,15,9,12,59,43,16,54
RZ Pellets W,6277,6,14,8,14,58,52,6,50
Admira Wacke,6277,7,13,5,18,38,66,-28,44
Mattersburg,6277,8,10,9,17,38,55,-17,39
SV Josko Rie,6277,9,9,6,21,32,58,-26,33
St. Pölten,6277,10,7,9,20,39,71,-32,30
FC Salzburg,6278,1,21,9,6,64,24,40,72
SK Sturm Gra,6278,2,20,4,12,57,37,20,64
SC Rheindorf,6278,3,19,6,11,55,45,10,63
Vienna,6278,4,19,3,14,65,57,8,60
Rapid Vienna,6278,5,15,12,9,67,41,26,57
RZ Pellets W,6278,6,13,5,18,49,58,-9,44
SV Josko Rie,6278,7,11,8,17,33,47,-14,41
Admira Wacke,6278,8,10,10,16,36,57,-21,40
Mattersburg,6278,9,9,9,18,41,65,-24,36
St. Pölten,6278,10,6,8,22,32,68,-36,26
FC Salzburg,6279,1,22,8,6,62,28,34,74
Vienna,6279,2,20,4,12,57,48,9,64
SK Sturm Gra,6279,3,18,8,10,58,35,23,62
SC Rheindorf,6279,4,18,6,12,51,43,8,60
RZ Pellets W,6279,5,14,7,15,48,52,-4,49
Admira Wacke,6279,6,13,5,18,39,57,-18,44
Rapid Vienna,6279,7,10,13,13,50,43,7,43
SV Josko Rie,6279,8,12,5,19,39,57,-18,41
Mattersburg,6279,9,7,11,18,36,54,-18,32
St. Pölten,6279,10,7,11,18,45,68,-23,32
SK Sturm Gra,6280,1,20,7,9,62,29,33,67
Vienna,6280,2,20,4,12,70,55,15,64
SC Rheindorf,6280,3,18,10,8,53,43,10,64
FC Salzburg,6280,4,17,11,8,55,29,26,62
Rapid Vienna,6280,5,12,11,13,52,43,9,47
Admira Wacke,6280,6,12,8,16,40,58,-18,44
St. Pölten,6280,7,10,11,15,45,59,-14,41
RZ Pellets W,6280,8,11,7,18,45,59,-14,40
Mattersburg,6280,9,7,13,16,39,58,-19,34
SV Josko Rie,6280,10,9,6,21,31,59,-28,33
FC Salzburg,6281,1,18,10,8,61,32,29,64
SK Sturm Gra,6281,2,18,7,11,54,34,20,61
Vienna,6281,3,17,7,12,59,53,6,58
Rapid Vienna,6281,4,14,13,9,56,39,17,55
SC Rheindorf,6281,5,15,9,12,56,48,8,54
Admira Wacke,6281,6,13,9,14,38,53,-15,48
SV Josko Rie,6281,7,11,8,17,28,45,-17,41
RZ Pellets W,6281,8,11,7,18,43,58,-15,40
Mattersburg,6281,9,11,6,19,46,58,-12,39
St. Pölten,6281,10,8,12,16,45,66,-21,36
Rapid Vienna,6282,1,17,11,8,62,37,25,62
FC Salzburg,6282,2,18,8,10,58,37,21,62
SK Sturm Gra,6282,3,18,6,12,58,38,20,60
Vienna,6282,4,16,8,12,58,55,3,56
RZ Pellets W,6282,5,16,7,13,58,52,6,55
SC Rheindorf,6282,6,15,10,11,51,50,1,55
Admira Wacke,6282,7,12,8,16,41,53,-12,44
SV Josko Rie,6282,8,11,8,17,35,48,-13,41
Mattersburg,6282,9,8,9,19,38,55,-17,33
St. Pölten,6282,10,8,7,21,42,76,-34,31
SC Rheindorf,6283,1,21,7,8,53,38,15,70
SK Sturm Gra,6283,2,19,6,11,58,33,25,63
Vienna,6283,3,19,5,12,66,48,18,62
FC Salzburg,6283,4,16,10,10,59,31,28,58
RZ Pellets W,6283,5,14,10,12,50,53,-3,52
Rapid Vienna,6283,6,13,10,13,51,43,8,49
Admira Wacke,6283,7,12,6,18,47,69,-22,42
SV Josko Rie,6283,8,11,6,19,37,56,-19,39
St. Pölten,6283,9,9,7,20,42,69,-27,34
Mattersburg,6283,10,7,11,18,37,60,-23,32
FC Salzburg,6284,1,21,9,6,67,28,39,72
SK Sturm Gra,6284,2,22,5,9,64,33,31,71
SC Rheindorf,6284,3,20,6,10,62,52,10,66
Vienna,6284,4,19,5,12,64,51,13,62
Rapid Vienna,6284,5,11,10,15,50,47,3,43
SV Josko Rie,6284,6,12,7,17,44,56,-12,43
St. Pölten,6284,7,10,10,16,44,61,-17,40
Admira Wacke,6284,8,10,8,18,34,55,-21,38
RZ Pellets W,6284,9,9,8,19,41,61,-20,35
Mattersburg,6284,10,7,10,19,34,60,-26,31
FC Salzburg,6285,1,20,8,8,63,29,34,68
SC Rheindorf,6285,2,20,7,9,66,48,18,67
SK Sturm Gra,6285,3,16,13,7,52,29,23,61
Vienna,6285,4,17,8,11,63,55,8,59
Rapid Vienna,6285,5,15,11,10,58,36,22,56
RZ Pellets W,6285,6,12,10,14,41,49,-8,46
Admira Wacke,6285,7,11,9,16,35,57,-22,42
St. Pölten,6285,8,7,12,17,41,65,-24,33
SV Josko Rie,6285,9,9,6,21,33,61,-28,33
Mattersburg,6285,10,6,10,20,36,59,-23,28
FC Salzburg,6286,1,21,6,9,66,30,36,69
SC Rheindorf,6286,2,19,7,10,51,41,10,64
SK Sturm Gra,6286,3,18,9,9,59,35,24,63
Vienna,6286,4,17,8,11,63,53,10,59
RZ Pellets W,6286,5,14,8,14,54,55,-1,50
Rapid Vienna,6286,6,12,12,12,55,45,10,48
Admira Wacke,6286,7,12,6,18,34,57,-23,42
Mattersburg,6286,8,10,8,18,42,59,-17,38
St. Pölten,6286,9,8,10,18,44,69,-25,34
SV Josko Rie,6286,10,8,8,20,28,52,-24,32
FC Salzburg,6287,1,22,8,6,69,32,37,74
SC Rheindorf,6287,2,21,7,8,54,37,17,70
SK Sturm Gra,6287,3,18,7,11,59,33,26,61
Rapid Vienna,6287,4,16,10,10,57,36,21,58
Vienna,6287,5,17,2,17,59,59,0,53
RZ Pellets W,6287,6,14,5,17,44,52,-8,47
Mattersburg,6287,7,11,8,17,38,56,-18,41
SV Josko Rie,6287,8,11,7,18,39,53,-14,40
St. Pölten,6287,9,9,7,20,37,62,-25,34
Admira Wacke,6287,10,7,7,22,31,67,-36,28
FC Salzburg,6288,1,23,5,8,69,34,35,74
SC Rheindorf,6288,2,19,9,8,55,39,16,66
SK Sturm Gra,6288,3,19,7,10,61,38,23,64
Rapid Vienna,6288,4,15,12,9,60,36,24,57
Vienna,6288,5,17,4,15,57,48,9,55
SV Josko Rie,6288,6,12,9,15,39,46,-7,45
RZ Pellets W,6288,7,11,7,18,39,63,-24,40
Admira Wacke,6288,8,10,5,21,35,66,-31,35
St. Pölten,6288,9,8,10,18,40,64,-24,34
Mattersburg,6288,10,8,8,20,39,60,-21,32
SK Sturm Gra,6289,1,21,6,9,66,33,33,69
FC Salzburg,6289,2,20,8,8,61,33,28,68
SC Rheindorf,6289,3,17,8,11,52,44,8,59
Vienna,6289,4,15,10,11,57,50,7,55
RZ Pellets W,6289,5,15,10,11,52,48,4,55
Rapid Vienna,6289,6,11,11,14,49,49,0,44
SV Josko Rie,6289,7,13,5,18,44,48,-4,44
Mattersburg,6289,8,10,8,18,38,56,-18,38
St. Pölten,6289,9,7,12,17,38,62,-24,33
Admira Wacke,6289,10,9,6,21,27,61,-34,33
FC Salzburg,6290,1,20,7,9,67,31,36,67
SK Sturm Gra,6290,2,21,4,11,62,34,28,67
Vienna,6290,3,20,6,10,65,49,16,66
SC Rheindorf,6290,4,19,9,8,54,39,15,66
RZ Pellets W,6290,5,15,6,15,50,54,-4,51
Rapid Vienna,6290,6,12,11,13,49,43,6,47
Admira Wacke,6290,7,10,9,17,37,60,-23,39
SV Josko Rie,6290,8,10,6,20,35,57,-22,36
St. Pölten,6290,9,7,10,19,39,68,-29,31
Mattersburg,6290,10,6,12,18,28,51,-23,30
FC Salzburg,6291,1,23,6,7,68,29,39,75
SK Sturm Gra,6291,2,22,4,10,62,28,34,70
SC Rheindorf,6291,3,19,8,9,53,38,15,65
Vienna,6291,4,16,6,14,56,54,2,54
Rapid Vienna,6291,5,13,10,13,44,38,6,49
SV Josko Rie,6291,6,13,5,18,38,52,-14,44
RZ Pellets W,6291,7,12,7,17,41,55,-14,43
Admira Wacke,6291,8,12,5,19,34,56,-22,41
Mattersburg,6291,9,8,11,17,31,50,-19,35
St. Pölten,6291,10,6,10,20,33,60,-27,28
SC Rheindorf,6292,1,21,6,9,59,43,16,69
SK Sturm Gra,6292,2,20,8,8,61,32,29,68
FC Salzburg,6292,3,18,11,7,60,31,29,65
Vienna,6292,4,18,5,13,65,53,12,59
RZ Pellets W,6292,5,15,7,14,52,53,-1,52
Rapid Vienna,6292,6,13,12,11,53,38,15,51
Admira Wacke,6292,7,9,10,17,30,57,-27,37
SV Josko Rie,6292,8,10,5,21,31,61,-30,35
Mattersburg,6292,9,8,9,19,37,55,-18,33
St. Pölten,6292,10,6,11,19,43,68,-25,29
FC Salzburg,6293,1,23,6,7,63,28,35,75
Vienna,6293,2,21,6,9,72,48,24,69
SC Rheindorf,6293,3,21,4,11,66,46,20,67
SK Sturm Gra,6293,4,20,5,11,67,35,32,65
Rapid Vienna,6293,5,13,11,12,65,47,18,50
RZ Pellets W,6293,6,11,6,19,41,62,-21,39
Mattersburg,6293,7,10,8,18,37,61,-24,38
Admira Wacke,6293,8,10,7,19,31,64,-33,37
SV Josko Rie,6293,9,9,6,21,36,61,-25,33
St. Pölten,6293,10,6,13,17,45,71,-26,31
FC Salzburg,6294,1,19,10,7,56,28,28,67
SK Sturm Gra,6294,2,20,7,9,60,33,27,67
SC Rheindorf,6294,3,18,7,11,54,48,6,61
Rapid Vienna,6294,4,15,12,9,56,34,22,57
Vienna,6294,5,17,3,16,55,57,-2,54
RZ Pellets W,6294,6,13,6,17,47,57,-10,45
SV Josko Rie,6294,7,13,5,18,40,51,-11,44
St. Pölten,6294,8,12,7,17,49,63,-14,43
Admira Wacke,6294,9,11,7,18,39,59,-20,40
Mattersburg,6294,10,6,8,22,34,60,-26,26
SK Sturm Gra,6295,1,20,6,10,60,34,26,66
SC Rheindorf,6295,2,19,8,9,56,39,17,65
FC Salzburg,6295,3,19,7,10,63,37,26,64
Vienna,6295,4,19,5,12,64,57,7,62
Rapid Vienna,6295,5,15,11,10,57,40,17,56
Admira Wacke,6295,6,13,5,18,45,62,-17,44
RZ Pellets W,6295,7,12,7,17,43,52,-9,43
SV Josko Rie,6295,8,11,5,20,33,51,-18,38
St. Pölten,6295,9,8,11,17,47,72,-25,35
Mattersburg,6295,10,6,11,19,33,57,-24,29
SC Rheindorf,6296,1,23,7,6,64,40,24,76
Vienna,6296,2,21,7,8,72,45,27,70
FC Salzburg,6296,3,20,7,9,62,34,28,67
SK Sturm Gra,6296,4,19,5,12,62,42,20,62
Rapid Vienna,6296,5,10,12,14,49,49,0,42
Mattersburg,6296,6,11,7,18,47,56,-9,40
RZ Pellets W,6296,7,11,6,19,41,62,-21,39
SV Josko Rie,6296,8,10,8,18,34,53,-19,38
Admira Wacke,6296,9,10,8,18,32,57,-25,38
St. Pölten,6296,10,7,9,20,42,67,-25,30
FC Salzburg,6297,1,20,7,9,63,34,29,67
SK Sturm Gra,6297,2,19,5,12,60,35,25,62
SC Rheindorf,6297,3,19,5,12,52,53,-1,62
Vienna,6297,4,18,6,12,63,47,16,60
Rapid Vienna,6297,5,15,10,11,62,47,15,55
RZ Pellets W,6297,6,13,10,13,48,53,-5,49
Mattersburg,6297,7,11,11,14,47,54,-7,44
SV Josko Rie,6297,8,13,4,19,39,52,-13,43
Admira Wacke,6297,9,9,6,21,30,57,-27,33
St. Pölten,6297,10,5,12,19,36,68,-32,27
FC Salzburg,6298,1,23,5,8,76,37,39,74
SK Sturm Gra,6298,2,21,7,8,69,34,35,70
SC Rheindorf,6298,3,18,8,10,52,48,4,62
Vienna,6298,4,19,4,13,59,52,7,61
Rapid Vienna,6298,5,15,9,12,53,41,12,54
RZ Pellets W,6298,6,11,7,18,37,52,-15,40
SV Josko Rie,6298,7,12,4,20,38,55,-17,40
Mattersburg,6298,8,9,9,18,38,54,-16,36
Admira Wacke,6298,9,10,6,20,35,59,-24,36
St. Pölten,6298,10,7,11,18,37,62,-25,32
FC Salzburg,6299,1,22,6,8,67,35,32,72
SC Rheindorf,6299,2,17,7,12,47,42,5,58
SK Sturm Gra,6299,3,17,5,14,53,45,8,56
Rapid Vienna,6299,4,13,13,10,56,40,16,52
RZ Pellets W,6299,5,15,7,14,46,50,-4,52
Vienna,6299,6,15,6,15,60,57,3,51
SV Josko Rie,6299,7,13,7,16,44,51,-7,46
Admira Wacke,6299,8,12,6,18,39,61,-22,42
Mattersburg,6299,9,11,8,17,46,53,-7,41
St. Pölten,6299,10,8,9,19,43,67,-24,33
SC Rheindorf,6300,1,22,7,7,60,38,22,73
FC Salzburg,6300,2,21,9,6,68,28,40,72
SK Sturm Gra,6300,3,21,8,7,62,30,32,71
Vienna,6300,4,18,7,11,66,51,15,61
Rapid Vienna,6300,5,13,12,11,59,43,16,51
RZ Pellets W,6300,6,12,6,18,46,65,-19,42
Admira Wacke,6300,7,11,8,17,36,57,-21,41
SV Josko Rie,6300,8,9,5,22,39,65,-26,32
Mattersburg,6300,9,7,9,20,35,60,-25,30
St. Pölten,6300,10,5,11,20,32,66,-34,26
FC Salzburg,6301,1,22,8,6,67,31,36,74
Vienna,6301,2,20,5,11,67,46,21,65
SK Sturm Gra,6301,3,18,8,10,55,36,19,62
SC Rheindorf,6301,4,17,10,9,51,39,12,61
RZ Pellets W,6301,5,12,9,15,47,53,-6,45
Rapid Vienna,6301,6,9,14,13,50,45,5,41
SV Josko Rie,6301,7,9,10,17,31,44,-13,37
Admira Wacke,6301,8,9,10,17,32,57,-25,37
St. Pölten,6301,9,8,12,16,38,65,-27,36
Mattersburg,6301,10,9,8,19,35,57,-22,35
FC Salzburg,6302,1,23,8,5,72,25,47,77
SC Rheindorf,6302,2,21,7,8,63,43,20,70
SK Sturm Gra,6302,3,18,4,14,60,43,17,58
Vienna,6302,4,17,6,13,64,61,3,57
Rapid Vienna,6302,5,14,11,11,57,43,14,53
RZ Pellets W,6302,6,10,12,14,41,54,-13,42
Mattersburg,6302,7,9,10,17,35,52,-17,37
St. Pölten,6302,8,10,7,19,45,64,-19,37
SV Josko Rie,6302,9,10,5,21,39,60,-21,35
Admira Wacke,6302,10,8,10,18,33,64,-31,34
SC Rheindorf,6303,1,21,8,7,59,32,27,71
FC Salzburg,6303,2,19,10,7,61,29,32,67
Vienna,6303,3,19,4,13,68,51,17,61
SK Sturm Gra,6303,4,17,6,13,52,39,13,57
Rapid Vienna,6303,5,13,11,12,55,48,7,50
St. Pölten,6303,6,13,8,15,48,55,-7,47
RZ Pellets W,6303,7,13,7,16,42,55,-13,46
Mattersburg,6303,8,12,6,18,34,50,-16,42
Admira Wacke,6303,9,11,4,21,38,65,-27,37
SV Josko Rie,6303,10,7,6,23,29,62,-33,27
FC Salzburg,6304,1,23,7,6,66,26,40,76
SC Rheindorf,6304,2,19,9,8,62,43,19,66
Vienna,6304,3,19,5,12,64,60,4,62
Rapid Vienna,6304,4,15,10,11,58,44,14,55
SK Sturm Gra,6304,5,16,6,14,50,38,12,54
RZ Pellets W,6304,6,11,8,17,47,56,-9,41
SV Josko Rie,6304,7,12,4,20,37,53,-16,40
Admira Wacke,6304,8,10,6,20,31,60,-29,36
Mattersburg,6304,9,8,11,17,43,56,-13,35
St. Pölten,6304,10,7,14,15,41,63,-22,35
FC Salzburg,6305,1,24,4,8,76,30,46,76
SK Sturm Gra,6305,2,20,8,8,61,32,29,68
SC Rheindorf,6305,3,17,9,10,55,48,7,60
Rapid Vienna,6305,4,15,13,8,54,37,17,58
Vienna,6305,5,17,5,14,58,52,6,56
Admira Wacke,6305,6,14,5,17,38,54,-16,47
RZ Pellets W,6305,7,11,6,19,42,58,-16,39
Mattersburg,6305,8,10,8,18,32,50,-18,38
SV Josko Rie,6305,9,10,3,23,31,59,-28,33
St. Pölten,6305,10,7,9,20,34,61,-27,30
SC Rheindorf,6306,1,21,7,8,60,41,19,70
FC Salzburg,6306,2,20,9,7,64,29,35,69
Vienna,6306,3,19,4,13,63,49,14,61
Rapid Vienna,6306,4,16,11,9,60,43,17,59
SK Sturm Gra,6306,5,17,7,12,55,36,19,58
St. Pölten,6306,6,11,9,16,46,62,-16,42
SV Josko Rie,6306,7,11,6,19,41,51,-10,39
Mattersburg,6306,8,9,8,19,32,51,-19,35
RZ Pellets W,6306,9,9,8,19,44,69,-25,35
Admira Wacke,6306,10,9,7,20,34,68,-34,34
SC Rheindorf,6307,1,23,6,7,59,37,22,75
SK Sturm Gra,6307,2,21,6,9,62,36,26,69
FC Salzburg,6307,3,20,6,10,61,36,25,66
Vienna,6307,4,18,9,9,59,42,17,63
Rapid Vienna,6307,5,14,12,10,65,47,18,54
SV Josko Rie,6307,6,11,7,18,31,44,-13,40
RZ Pellets W,6307,7,10,6,20,44,69,-25,36
Admira Wacke,6307,8,9,7,20,32,58,-26,34
Mattersburg,6307,9,8,9,19,41,62,-21,33
St. Pölten,6307,10,8,8,20,38,61,-23,32
FC Salzburg,6308,1,23,7,6,69,32,37,76
SC Rheindorf,6308,2,22,7,7,59,40,19,73
SK Sturm Gra,6308,3,16,10,10,51,33,18,58
Vienna,6308,4,14,8,14,63,61,2,50
RZ Pellets W,6308,5,13,8,15,47,53,-6,47
Rapid Vienna,6308,6,12,10,14,52,48,4,46
Admira Wacke,6308,7,12,6,18,41,59,-18,42
St. Pölten,6308,8,10,7,19,44,66,-22,37
Mattersburg,6308,9,9,9,18,42,54,-12,36
SV Josko Rie,6308,10,10,6,20,35,57,-22,36
FC Salzburg,6309,1,22,8,6,62,31,31,74
SC Rheindorf,6309,2,20,7,9,52,37,15,67
SK Sturm Gra,6309,3,18,6,12,58,38,20,60
Vienna,6309,4,15,7,14,58,56,2,52
RZ Pellets W,6309,5,15,7,14,51,52,-1,52
Rapid Vienna,6309,6,14,9,13,53,37,16,51
Admira Wacke,6309,7,14,5,17,34,50,-16,47
Mattersburg,6309,8,10,7,19,36,53,-17,37
St. Pölten,6309,9,8,9,19,41,69,-28,33
SV Josko Rie,6309,10,8,7,21,34,56,-22,31
FC Salzburg,6310,1,19,9,8,63,30,33,66
SK Sturm Gra,6310,2,19,7,10,59,36,23,64
SC Rheindorf,6310,3,18,10,8,50,37,13,64
Vienna,6310,4,17,8,11,61,49,12,59
Rapid Vienna,6310,5,13,11,12,52,44,8,50
RZ Pellets W,6310,6,14,7,15,47,56,-9,49
Admira Wacke,6310,7,13,4,19,41,60,-19,43
SV Josko Rie,6310,8,10,7,19,33,50,-17,37
St. Pölten,6310,9,9,8,19,38,59,-21,35
Mattersburg,6310,10,8,9,19,33,56,-23,33
SK Sturm Gra,6311,1,20,8,8,61,28,33,68
Vienna,6311,2,19,6,11,63,50,13,63
FC Salzburg,6311,3,18,8,10,58,37,21,62
SC Rheindorf,6311,4,15,11,10,48,44,4,56
Mattersburg,6311,5,12,9,15,44,51,-7,45
Admira Wacke,6311,6,13,5,18,31,53,-22,44
RZ Pellets W,6311,7,12,6,18,48,57,-9,42
SV Josko Rie,6311,8,11,8,17,34,50,-16,41
St. Pölten,6311,9,9,12,15,43,58,-15,39
Rapid Vienna,6311,10,8,13,15,43,45,-2,37
FC Salzburg,6312,1,22,7,7,68,27,41,73
SC Rheindorf,6312,2,20,6,10,58,40,18,66
SK Sturm Gra,6312,3,18,6,12,61,39,22,60
Vienna,6312,4,18,6,12,60,53,7,60
Admira Wacke,6312,5,18,3,15,39,54,-15,57
Rapid Vienna,6312,6,13,13,10,53,36,17,52
RZ Pellets W,6312,7,9,8,19,39,59,-20,35
SV Josko Rie,6312,8,9,7,20,33,58,-25,34
Mattersburg,6312,9,7,11,18,39,59,-20,32
St. Pölten,6312,10,7,11,18,41,66,-25,32
SC Rheindorf,6313,1,20,7,9,59,42,17,67
SK Sturm Gra,6313,2,19,7,10,61,34,27,64
FC Salzburg,6313,3,17,10,9,61,40,21,61
Admira Wacke,6313,4,19,4,13,47,48,-1,61
Vienna,6313,5,17,6,13,67,59,8,57
Rapid Vienna,6313,6,14,10,12,54,41,13,52
RZ Pellets W,6313,7,14,6,16,53,57,-4,48
SV Josko Rie,6313,8,10,5,21,33,55,-22,35
St. Pölten,6313,9,8,8,20,42,73,-31,32
Mattersburg,6313,10,7,7,22,34,62,-28,28
FC Salzburg,6314,1,22,8,6,71,35,36,74
SC Rheindorf,6314,2,19,8,9,55,43,12,65
SK Sturm Gra,6314,3,19,7,10,61,32,29,64
Vienna,6314,4,18,5,13,57,52,5,59
Rapid Vienna,6314,5,16,9,11,60,43,17,57
Admira Wacke,6314,6,14,4,18,39,62,-23,46
SV Josko Rie,6314,7,14,3,19,38,45,-7,45
RZ Pellets W,6314,8,12,7,17,48,58,-10,43
Mattersburg,6314,9,8,7,21,37,62,-25,31
St. Pölten,6314,10,5,8,23,39,73,-34,23
FC Salzburg,6315,1,19,9,8,65,32,33,66
Vienna,6315,2,19,6,11,59,49,10,63
SC Rheindorf,6315,3,17,10,9,51,45,6,61
SK Sturm Gra,6315,4,17,8,11,55,41,14,59
Rapid Vienna,6315,5,16,10,10,62,41,21,58
RZ Pellets W,6315,6,13,9,14,52,52,0,48
SV Josko Rie,6315,7,12,5,19,35,46,-11,41
Admira Wacke,6315,8,10,6,20,34,62,-28,36
St. Pölten,6315,9,7,14,15,41,64,-23,35
Mattersburg,6315,10,7,9,20,32,54,-22,30
SC Rheindorf,6316,1,20,9,7,58,34,24,69
Vienna,6316,2,21,5,10,71,50,21,68
FC Salzburg,6316,3,18,13,5,63,34,29,67
SK Sturm Gra,6316,4,14,9,13,50,38,12,51
Rapid Vienna,6316,5,11,15,10,48,34,14,48
Admira Wacke,6316,6,13,9,14,40,55,-15,48
SV Josko Rie,6316,7,13,4,19,53,62,-9,43
RZ Pellets W,6316,8,10,8,18,41,60,-19,38
Mattersburg,6316,9,8,9,19,36,59,-23,33
St. Pölten,6316,10,7,9,20,39,73,-34,30
FC Salzburg,6317,1,21,8,7,68,32,36,71
SC Rheindorf,6317,2,22,5,9,63,45,18,71
SK Sturm Gra,6317,3,19,8,9,63,29,34,65
Vienna,6317,4,18,5,13,60,48,12,59
Rapid Vienna,6317,5,13,11,12,54,44,10,50
RZ Pellets W,6317,6,12,9,15,42,59,-17,45
Admira Wacke,6317,7,9,10,17,35,64,-29,37
St. Pölten,6317,8,8,12,16,51,66,-15,36
Mattersburg,6317,9,8,10,18,42,63,-21,34
SV Josko Rie,6317,10,8,6,22,35,63,-28,30
FC Salzburg,6318,1,22,8,6,66,26,40,74
SK Sturm Gra,6318,2,19,7,10,59,34,25,64
SC Rheindorf,6318,3,19,6,11,52,42,10,63
Rapid Vienna,6318,4,14,15,7,59,36,23,57
Vienna,6318,5,15,5,16,56,54,2,50
Admira Wacke,6318,6,14,5,17,42,56,-14,47
SV Josko Rie,6318,7,14,3,19,36,50,-14,45
RZ Pellets W,6318,8,8,11,17,38,59,-21,35
St. Pölten,6318,9,9,8,19,39,64,-25,35
Mattersburg,6318,10,8,8,20,39,65,-26,32
FC Salzburg,6319,1,22,6,8,57,23,34,72
Vienna,6319,2,20,5,11,68,48,20,65
SC Rheindorf,6319,3,18,9,9,54,41,13,63
SK Sturm Gra,6319,4,19,5,12,61,39,22,62
Admira Wacke,6319,5,15,5,16,48,54,-6,50
Rapid Vienna,6319,6,11,14,11,44,38,6,47
St. Pölten,6319,7,10,10,16,41,63,-22,40
RZ Pellets W,6319,8,9,11,16,40,57,-17,38
SV Josko Rie,6319,9,10,4,22,34,61,-27,34
Mattersburg,6319,10,7,9,20,30,53,-23,30
SC Rheindorf,6320,1,19,9,8,49,36,13,66
FC Salzburg,6320,2,18,9,9,59,28,31,63
SK Sturm Gra,6320,3,18,9,9,58,33,25,63
Vienna,6320,4,16,11,9,55,47,8,59
Rapid Vienna,6320,5,15,12,9,60,40,20,57
RZ Pellets W,6320,6,10,11,15,50,60,-10,41
Admira Wacke,6320,7,10,8,18,37,59,-22,38
Mattersburg,6320,8,9,10,17,35,53,-18,37
SV Josko Rie,6320,9,11,4,21,33,51,-18,37
St. Pölten,6320,10,7,11,18,37,66,-29,32
FC Salzburg,6321,1,20,8,8,56,28,28,68
Vienna,6321,2,21,3,12,62,52,10,66
SK Sturm Gra,6321,3,19,6,11,59,35,24,63
SC Rheindorf,6321,4,18,9,9,55,45,10,63
Rapid Vienna,6321,5,12,12,12,59,48,11,48
RZ Pellets W,6321,6,13,8,15,46,57,-11,47
SV Josko Rie,6321,7,12,5,19,41,56,-15,41
Admira Wacke,6321,8,11,6,19,43,64,-21,39
St. Pölten,6321,9,10,7,19,47,66,-19,37
Mattersburg,6321,10,6,12,18,43,60,-17,30
SC Rheindorf,6322,1,17,13,6,56,39,17,64
SK Sturm Gra,6322,2,19,6,11,67,40,27,63
FC Salzburg,6322,3,18,9,9,60,33,27,63
Vienna,6322,4,18,6,12,61,53,8,60
Mattersburg,6322,5,13,8,15,39,48,-9,47
RZ Pellets W,6322,6,13,8,15,42,55,-13,47
Rapid Vienna,6322,7,10,14,12,51,41,10,44
Admira Wacke,6322,8,13,4,19,34,55,-21,43
SV Josko Rie,6322,9,9,7,20,32,56,-24,34
St. Pölten,6322,10,7,11,18,43,65,-22,32
Vienna,6323,1,20,8,8,64,43,21,68
SC Rheindorf,6323,2,19,8,9,55,43,12,65
FC Salzburg,6323,3,18,10,8,64,32,32,64
SK Sturm Gra,6323,4,18,8,10,63,39,24,62
Rapid Vienna,6323,5,14,12,10,53,39,14,54
RZ Pellets W,6323,6,10,8,18,40,55,-15,38
Mattersburg,6323,7,10,8,18,39,58,-19,38
Admira Wacke,6323,8,10,8,18,33,66,-33,38
SV Josko Rie,6323,9,10,7,19,36,48,-12,37
St. Pölten,6323,10,7,11,18,38,62,-24,32
FC Salzburg,6324,1,23,6,7,73,38,35,75
SC Rheindorf,6324,2,21,8,7,56,41,15,71
Vienna,6324,3,19,7,10,71,51,20,64
Rapid Vienna,6324,4,18,9,9,71,40,31,63
SK Sturm Gra,6324,5,18,6,12,58,37,21,60
RZ Pellets W,6324,6,11,10,15,44,56,-12,43
Admira Wacke,6324,7,10,6,20,34,66,-32,36
St. Pölten,6324,8,8,10,18,39,63,-24,34
Mattersburg,6324,9,6,10,20,34,58,-24,28
SV Josko Rie,6324,10,7,6,23,34,64,-30,27
FC Salzburg,6325,1,20,10,6,66,31,35,70
SK Sturm Gra,6325,2,20,7,9,63,36,27,67
SC Rheindorf,6325,3,19,10,7,54,40,14,67
Rapid Vienna,6325,4,16,11,9,67,42,25,59
Vienna,6325,5,17,2,17,58,56,2,53
RZ Pellets W,6325,6,13,7,16,49,55,-6,46
Mattersburg,6325,7,10,7,19,39,58,-19,37
SV Josko Rie,6325,8,10,7,19,30,49,-19,37
Admira Wacke,6325,9,8,9,19,32,63,-31,33
St. Pölten,6325,10,7,10,19,39,67,-28,31
FC Salzburg,6326,1,23,5,8,67,23,44,74
SC Rheindorf,6326,2,20,5,11,58,41,17,65
Vienna,6326,3,18,7,11,62,52,10,61
SK Sturm Gra,6326,4,17,9,10,56,36,20,60
Rapid Vienna,6326,5,14,9,13,52,39,13,51
RZ Pellets W,6326,6,13,8,15,46,53,-7,47
SV Josko Rie,6326,7,14,4,18,42,52,-10,46
St. Pölten,6326,8,9,9,18,47,69,-22,36
Admira Wacke,6326,9,9,6,21,30,70,-40,33
Mattersburg,6326,10,7,10,19,38,63,-25,31
FC Salzburg,6327,1,24,6,6,66,26,40,78
SC Rheindorf,6327,2,21,7,8,61,36,25,70
SK Sturm Gra,6327,3,22,4,10,64,40,24,70
Vienna,6327,4,17,7,12,60,48,12,58
Rapid Vienna,6327,5,14,13,9,60,40,20,55
RZ Pellets W,6327,6,10,9,17,39,60,-21,39
St. Pölten,6327,7,8,11,17,43,61,-18,35
Admira Wacke,6327,8,9,8,19,34,61,-27,35
Mattersburg,6327,9,6,11,19,35,60,-25,29
SV Josko Rie,6327,10,7,8,21,26,56,-30,29
SC Rheindorf,6328,1,19,9,8,57,43,14,66
SK Sturm Gra,6328,2,19,7,10,63,34,29,64
FC Salzburg,6328,3,18,9,9,61,35,26,63
Rapid Vienna,6328,4,17,10,9,62,35,27,61
Vienna,6328,5,17,6,13,58,50,8,57
SV Josko Rie,6328,6,13,4,19,37,49,-12,43
St. Pölten,6328,7,10,9,17,48,67,-19,39
Admira Wacke,6328,8,11,6,19,38,72,-34,39
Mattersburg,6328,9,9,8,19,42,60,-18,35
RZ Pellets W,6328,10,9,8,19,41,62,-21,35
SC Rheindorf,6329,1,21,6,9,61,45,16,69
FC Salzburg,6329,2,20,8,8,66,32,34,68
Vienna,6329,3,20,3,13,71,57,14,63
SK Sturm Gra,6329,4,19,5,12,64,44,20,62
Rapid Vienna,6329,5,14,10,12,52,44,8,52
RZ Pellets W,6329,6,14,8,14,52,51,1,50
Admira Wacke,6329,7,12,6,18,42,59,-17,42
Mattersburg,6329,8,10,7,19,39,67,-28,37
SV Josko Rie,6329,9,9,8,19,34,53,-19,35
St. Pölten,6329,10,6,9,21,39,68,-29,27
Vienna,6330,1,21,4,11,67,54,13,67
FC Salzburg,6330,2,19,9,8,60,33,27,66
SK Sturm Gra,6330,3,19,6,11,54,33,21,63
SC Rheindorf,6330,4,16,10,10,46,41,5,58
Rapid Vienna,6330,5,15,11,10,57,44,13,56
RZ Pellets W,6330,6,14,5,17,49,52,-3,47
SV Josko Rie,6330,7,12,8,16,46,51,-5,44
Mattersburg,6330,8,11,7,18,45,59,-14,40
Admira Wacke,6330,9,9,7,20,36,61,-25,34
St. Pölten,6330,10,6,9,21,33,65,-32,27
FC Salzburg,6331,1,19,5,12,66,42,24,62
SK Sturm Gra,6331,2,19,5,12,62,38,24,62
Rapid Vienna,6331,3,16,12,8,61,37,24,60
SC Rheindorf,6331,4,18,6,12,57,51,6,60
Vienna,6331,5,17,6,13,64,58,6,57
RZ Pellets W,6331,6,13,7,16,47,61,-14,46
Admira Wacke,6331,7,12,7,17,35,55,-20,43
Mattersburg,6331,8,11,9,16,42,53,-11,42
SV Josko Rie,6331,9,13,3,20,45,59,-14,42
St. Pölten,6331,10,8,8,20,41,66,-25,32
Vienna,6332,1,22,5,9,72,50,22,71
SC Rheindorf,6332,2,18,12,6,52,41,11,66
SK Sturm Gra,6332,3,19,8,9,57,31,26,65
FC Salzburg,6332,4,18,7,11,70,43,27,61
Rapid Vienna,6332,5,14,9,13,63,44,19,51
RZ Pellets W,6332,6,14,6,16,50,59,-9,48
SV Josko Rie,6332,7,13,6,17,40,52,-12,45
Admira Wacke,6332,8,8,9,19,36,71,-35,33
St. Pölten,6332,9,7,10,19,40,60,-20,31
Mattersburg,6332,10,6,10,20,31,60,-29,28
SC Rheindorf,6333,1,21,9,6,59,37,22,72
FC Salzburg,6333,2,21,8,7,69,34,35,71
SK Sturm Gra,6333,3,20,9,7,59,35,24,69
Vienna,6333,4,19,7,10,71,50,21,64
Rapid Vienna,6333,5,10,12,14,47,50,-3,42
RZ Pellets W,6333,6,11,8,17,44,59,-15,41
Admira Wacke,6333,7,11,4,21,44,69,-25,37
St. Pölten,6333,8,8,11,17,44,65,-21,35
SV Josko Rie,6333,9,9,7,20,37,58,-21,34
Mattersburg,6333,10,8,9,19,36,53,-17,33
SC Rheindorf,6334,1,21,9,6,62,41,21,72
FC Salzburg,6334,2,21,7,8,64,33,31,70
Vienna,6334,3,20,5,11,65,52,13,65
SK Sturm Gra,6334,4,18,4,14,60,38,22,58
Rapid Vienna,6334,5,16,10,10,57,35,22,58
RZ Pellets W,6334,6,12,7,17,45,56,-11,43
SV Josko Rie,6334,7,11,5,20,37,56,-19,38
Admira Wacke,6334,8,10,7,19,36,64,-28,37
St. Pölten,6334,9,7,12,17,45,69,-24,33
Mattersburg,6334,10,7,8,21,33,60,-27,29
SK Sturm Gra,6335,1,22,5,9,62,31,31,71
FC Salzburg,6335,2,20,10,6,63,29,34,70
SC Rheindorf,6335,3,20,8,8,60,42,18,68
Vienna,6335,4,18,3,15,60,56,4,57
Rapid Vienna,6335,5,12,14,10,53,40,13,50
RZ Pellets W,6335,6,13,9,14,44,50,-6,48
SV Josko Rie,6335,7,10,8,18,33,52,-19,38
Admira Wacke,6335,8,9,7,20,32,59,-27,34
St. Pölten,6335,9,7,12,17,36,56,-20,33
Mattersburg,6335,10,7,8,21,31,59,-28,29
SK Sturm Gra,6336,1,23,6,7,68,28,40,75
FC Salzburg,6336,2,21,8,7,65,28,37,71
SC Rheindorf,6336,3,18,6,12,52,52,0,60
Vienna,6336,4,17,5,14,57,51,6,56
Rapid Vienna,6336,5,13,7,16,57,48,9,46
Admira Wacke,6336,6,12,8,16,35,59,-24,44
RZ Pellets W,6336,7,11,8,17,51,59,-8,41
St. Pölten,6336,8,9,11,16,51,74,-23,38
Mattersburg,6336,9,9,9,18,40,58,-18,36
SV Josko Rie,6336,10,10,6,20,33,52,-19,36
FC Salzburg,6337,1,19,10,7,59,31,28,67
Vienna,6337,2,21,4,11,65,47,18,67
SK Sturm Gra,6337,3,19,9,8,66,37,29,66
SC Rheindorf,6337,4,16,8,12,54,52,2,56
Rapid Vienna,6337,5,11,13,12,55,41,14,46
Admira Wacke,6337,6,14,3,19,37,56,-19,45
SV Josko Rie,6337,7,13,4,19,42,55,-13,43
RZ Pellets W,6337,8,10,10,16,37,54,-17,40
Mattersburg,6337,9,9,9,18,43,66,-23,36
St. Pölten,6337,10,8,10,18,44,63,-19,34
FC Salzburg,6338,1,22,8,6,73,36,37,74
SC Rheindorf,6338,2,20,8,8,60,45,15,68
SK Sturm Gra,6338,3,19,7,10,59,37,22,64
Vienna,6338,4,16,9,11,67,58,9,57
Rapid Vienna,6338,5,13,10,13,59,45,14,49
RZ Pellets W,6338,6,12,7,17,46,54,-8,43
SV Josko Rie,6338,7,12,7,17,41,56,-15,43
Admira Wacke,6338,8,9,9,18,33,62,-29,36
Mattersburg,6338,9,9,7,20,33,51,-18,34
St. Pölten,6338,10,9,6,21,40,67,-27,33
FC Salzburg,6339,1,20,8,8,69,30,39,68
SK Sturm Gra,6339,2,20,7,9,60,33,27,67
SC Rheindorf,6339,3,20,7,9,60,44,16,67
Vienna,6339,4,19,4,13,64,54,10,61
Rapid Vienna,6339,5,15,8,13,55,40,15,53
Admira Wacke,6339,6,12,6,18,37,62,-25,42
SV Josko Rie,6339,7,11,7,18,38,53,-15,40
Mattersburg,6339,8,9,11,16,39,56,-17,38
RZ Pellets W,6339,9,8,10,18,39,62,-23,34
St. Pölten,6339,10,6,12,18,43,70,-27,30
FC Salzburg,6340,1,21,8,7,66,33,33,71
Vienna,6340,2,21,5,10,70,48,22,68
SK Sturm Gra,6340,3,19,6,11,55,34,21,63
SC Rheindorf,6340,4,18,9,9,56,40,16,63
Rapid Vienna,6340,5,16,11,9,62,38,24,59
RZ Pellets W,6340,6,12,11,13,47,52,-5,47
Admira Wacke,6340,7,11,5,20,38,63,-25,38
SV Josko Rie,6340,8,9,8,19,33,55,-22,35
St. Pölten,6340,9,7,10,19,33,66,-33,31
Mattersburg,6340,10,6,7,23,34,65,-31,25
FC Salzburg,6341,1,24,4,8,70,34,36,76
Vienna,6341,2,20,3,13,75,54,21,63
SC Rheindorf,6341,3,18,7,11,53,45,8,61
SK Sturm Gra,6341,4,16,8,12,54,39,15,56
RZ Pellets W,6341,5,14,7,15,46,50,-4,49
Rapid Vienna,6341,6,12,10,14,49,42,7,46
Admira Wacke,6341,7,12,8,16,39,61,-22,44
Mattersburg,6341,8,10,9,17,37,56,-19,39
SV Josko Rie,6341,9,10,6,20,36,58,-22,36
St. Pölten,6341,10,7,12,17,40,60,-20,33
FC Salzburg,6342,1,22,5,9,74,39,35,71
SK Sturm Gra,6342,2,20,5,11,71,37,34,65
SC Rheindorf,6342,3,17,8,11,49,45,4,59
Vienna,6342,4,17,5,14,59,53,6,56
Rapid Vienna,6342,5,14,13,9,63,44,19,55
RZ Pellets W,6342,6,14,7,15,46,56,-10,49
SV Josko Rie,6342,7,13,5,18,45,55,-10,44
Admira Wacke,6342,8,13,5,18,42,62,-20,44
Mattersburg,6342,9,7,12,17,41,57,-16,33
St. Pölten,6342,10,7,7,22,36,78,-42,28
SC Rheindorf,6343,1,19,8,9,49,36,13,65
FC Salzburg,6343,2,19,7,10,68,39,29,64
Rapid Vienna,6343,3,17,8,11,60,38,22,59
SK Sturm Gra,6343,4,18,5,13,55,38,17,59
Vienna,6343,5,17,7,12,64,57,7,58
RZ Pellets W,6343,6,16,6,14,50,52,-2,54
SV Josko Rie,6343,7,10,10,16,34,50,-16,40
Mattersburg,6343,8,9,10,17,37,54,-17,37
Admira Wacke,6343,9,10,7,19,32,59,-27,37
St. Pölten,6343,10,5,12,19,35,61,-26,27
FC Salzburg,6344,1,23,4,9,75,40,35,73
SC Rheindorf,6344,2,21,8,7,58,39,19,71
SK Sturm Gra,6344,3,18,10,8,63,36,27,64
Vienna,6344,4,19,3,14,66,53,13,60
Rapid Vienna,6344,5,14,10,12,64,46,18,52
RZ Pellets W,6344,6,13,5,18,42,61,-19,44
Admira Wacke,6344,7,10,7,19,40,66,-26,37
St. Pölten,6344,8,9,10,17,38,66,-28,37
SV Josko Rie,6344,9,11,3,22,36,56,-20,36
Mattersburg,6344,10,8,8,20,42,61,-19,32
SC Rheindorf,6345,1,19,9,8,60,43,17,66
FC Salzburg,6345,2,17,10,9,60,36,24,61
SK Sturm Gra,6345,3,18,7,11,58,41,17,61
Vienna,6345,4,18,6,12,66,53,13,60
Rapid Vienna,6345,5,15,11,10,64,43,21,56
RZ Pellets W,6345,6,15,6,15,46,48,-2,51
Admira Wacke,6345,7,12,7,17,37,62,-25,43
SV Josko Rie,6345,8,12,6,18,39,53,-14,42
Mattersburg,6345,9,7,10,19,40,65,-25,31
St. Pölten,6345,10,7,8,21,47,73,-26,29
FC Salzburg,6346,1,23,7,6,62,26,36,76
SC Rheindorf,6346,2,21,8,7,54,42,12,71
SK Sturm Gra,6346,3,20,6,10,69,37,32,66
Vienna,6346,4,15,8,13,54,52,2,53
Rapid Vienna,6346,5,13,11,12,54,42,12,50
RZ Pellets W,6346,6,14,5,17,47,57,-10,47
Admira Wacke,6346,7,13,5,18,45,55,-10,44
St. Pölten,6346,8,10,8,18,47,64,-17,38
SV Josko Rie,6346,9,10,6,20,31,53,-22,36
Mattersburg,6346,10,5,8,23,33,68,-35,23
SC Rheindorf,6347,1,22,6,8,62,39,23,72
FC Salzburg,6347,2,21,8,7,63,32,31,71
SK Sturm Gra,6347,3,18,6,12,53,36,17,60
Vienna,6347,4,17,5,14,58,54,4,56
Rapid Vienna,6347,5,13,11,12,51,41,10,50
Admira Wacke,6347,6,14,8,14,47,54,-7,50
RZ Pellets W,6347,7,11,8,17,38,48,-10,41
St. Pölten,6347,8,10,9,17,46,65,-19,39
Mattersburg,6347,9,10,8,18,38,54,-16,38
SV Josko Rie,6347,10,6,7,23,25,58,-33,25
FC Salzburg,6348,1,21,9,6,66,31,35,72
SC Rheindorf,6348,2,18,9,9,51,41,10,63
Vienna,6348,3,18,6,12,65,50,15,60
SK Sturm Gra,6348,4,18,5,13,61,39,22,59
Rapid Vienna,6348,5,13,11,12,53,41,12,50
RZ Pellets W,6348,6,12,5,19,43,58,-15,41
St. Pölten,6348,7,11,8,17,45,61,-16,41
SV Josko Rie,6348,8,11,7,18,36,52,-16,40
Admira Wacke,6348,9,11,6,19,37,65,-28,39
Mattersburg,6348,10,8,12,16,35,54,-19,36
FC Salzburg,6349,1,23,6,7,71,33,38,75
SC Rheindorf,6349,2,18,10,8,56,41,15,64
SK Sturm Gra,6349,3,18,8,10,61,36,25,62
Vienna,6349,4,18,7,11,64,50,14,61
Rapid Vienna,6349,5,11,11,14,53,48,5,44
Mattersburg,6349,6,11,9,16,46,56,-10,42
RZ Pellets W,6349,7,12,6,18,51,62,-11,42
Admira Wacke,6349,8,12,6,18,36,61,-25,42
St. Pölten,6349,9,9,10,17,48,70,-22,37
SV Josko Rie,6349,10,9,5,22,32,61,-29,32
FC Salzburg,6350,1,20,11,5,64,28,36,71
SC Rheindorf,6350,2,20,9,7,58,37,21,69
SK Sturm Gra,6350,3,17,10,9,55,33,22,61
Rapid Vienna,6350,4,14,10,12,57,40,17,52
Vienna,6350,5,15,6,15,54,56,-2,51
St. Pölten,6350,6,12,8,16,42,53,-11,44
RZ Pellets W,6350,7,11,10,15,45,54,-9,43
Admira Wacke,6350,8,10,12,14,34,50,-16,42
Mattersburg,6350,9,9,6,21,38,67,-29,33
SV Josko Rie,6350,10,9,4,23,35,64,-29,31
FC Salzburg,6351,1,21,8,7,68,31,37,71
SK Sturm Gra,6351,2,19,7,10,58,32,26,64
Vienna,6351,3,18,7,11,62,49,13,61
SC Rheindorf,6351,4,17,8,11,52,42,10,59
Rapid Vienna,6351,5,15,12,9,54,34,20,57
RZ Pellets W,6351,6,15,5,16,52,53,-1,50
SV Josko Rie,6351,7,11,6,19,29,50,-21,39
Mattersburg,6351,8,8,11,17,28,50,-22,35
Admira Wacke,6351,9,9,8,19,33,63,-30,35
St. Pölten,6351,10,6,10,20,33,65,-32,28
Vienna,6352,1,22,4,10,69,44,25,70
FC Salzburg,6352,2,18,11,7,58,28,30,65
SK Sturm Gra,6352,3,17,7,12,56,37,19,58
SC Rheindorf,6352,4,16,10,10,52,43,9,58
Rapid Vienna,6352,5,14,10,12,55,41,14,52
RZ Pellets W,6352,6,13,7,16,50,61,-11,46
Admira Wacke,6352,7,14,4,18,38,59,-21,46
Mattersburg,6352,8,9,11,16,37,50,-13,38
St. Pölten,6352,9,9,10,17,43,63,-20,37
SV Josko Rie,6352,10,7,8,21,26,58,-32,29
SC Rheindorf,6353,1,22,6,8,63,42,21,72
SK Sturm Gra,6353,2,21,5,10,66,35,31,68
FC Salzburg,6353,3,19,8,9,58,32,26,65
Vienna,6353,4,19,3,14,53,51,2,60
RZ Pellets W,6353,5,15,8,13,57,51,6,53
Rapid Vienna,6353,6,14,10,12,55,41,14,52
SV Josko Rie,6353,7,12,4,20,34,52,-18,40
St. Pölten,6353,8,8,9,19,34,60,-26,33
Admira Wacke,6353,9,7,10,19,34,64,-30,31
Mattersburg,6353,10,7,9,20,34,60,-26,30
FC Salzburg,6354,1,23,5,8,71,32,39,74
SC Rheindorf,6354,2,20,8,8,60,38,22,68
SK Sturm Gra,6354,3,18,8,10,61,40,21,62
Vienna,6354,4,18,6,12,63,54,9,60
Rapid Vienna,6354,5,11,12,13,51,42,9,45
Admira Wacke,6354,6,13,5,18,46,63,-17,44
RZ Pellets W,6354,7,12,7,17,51,65,-14,43
SV Josko Rie,6354,8,11,8,17,45,52,-7,41
St. Pölten,6354,9,8,9,19,39,71,-32,33
Mattersburg,6354,10,8,8,20,35,65,-30,32
SK Sturm Gra,6355,1,22,6,8,65,34,31,72
FC Salzburg,6355,2,19,9,8,64,37,27,66
SC Rheindorf,6355,3,20,5,11,59,47,12,65
Vienna,6355,4,16,7,13,65,59,6,55
RZ Pellets W,6355,5,16,5,15,46,51,-5,53
Rapid Vienna,6355,6,14,10,12,59,45,14,52
Admira Wacke,6355,7,10,7,19,40,66,-26,37
St. Pölten,6355,8,8,12,16,44,59,-15,36
Mattersburg,6355,9,7,12,17,37,55,-18,33
SV Josko Rie,6355,10,8,7,21,34,60,-26,31
FC Salzburg,6356,1,18,12,6,63,31,32,66
SC Rheindorf,6356,2,19,9,8,59,37,22,66
SK Sturm Gra,6356,3,18,9,9,61,36,25,63
Vienna,6356,4,17,4,15,64,64,0,55
RZ Pellets W,6356,5,14,7,15,53,57,-4,49
Admira Wacke,6356,6,14,7,15,36,52,-16,49
Rapid Vienna,6356,7,11,15,10,50,38,12,48
SV Josko Rie,6356,8,10,7,19,37,51,-14,37
St. Pölten,6356,9,7,12,17,34,62,-28,33
Mattersburg,6356,10,7,8,21,32,61,-29,29
SC Rheindorf,6357,1,21,10,5,59,37,22,73
FC Salzburg,6357,2,20,10,6,60,27,33,70
SK Sturm Gra,6357,3,19,5,12,60,32,28,62
Vienna,6357,4,16,6,14,57,54,3,54
Rapid Vienna,6357,5,14,10,12,57,44,13,52
Admira Wacke,6357,6,15,6,15,43,55,-12,51
RZ Pellets W,6357,7,12,7,17,44,54,-10,43
SV Josko Rie,6357,8,10,6,20,35,50,-15,36
Mattersburg,6357,9,8,7,21,32,59,-27,31
St. Pölten,6357,10,7,9,20,36,71,-35,30
FC Salzburg,6358,1,23,7,6,77,36,41,76
Vienna,6358,2,20,4,12,70,55,15,64
SC Rheindorf,6358,3,17,10,9,60,49,11,61
SK Sturm Gra,6358,4,17,9,10,53,34,19,60
Rapid Vienna,6358,5,11,15,10,52,42,10,48
Mattersburg,6358,6,11,8,17,43,56,-13,41
RZ Pellets W,6358,7,9,13,14,45,58,-13,40
Admira Wacke,6358,8,10,9,17,39,58,-19,39
SV Josko Rie,6358,9,10,6,20,33,53,-20,36
St. Pölten,6358,10,7,9,20,39,70,-31,30
FC Salzburg,6359,1,20,8,8,63,32,31,68
SC Rheindorf,6359,2,19,10,7,55,40,15,67
SK Sturm Gra,6359,3,18,4,14,62,39,23,58
Vienna,6359,4,16,5,15,54,50,4,53
Rapid Vienna,6359,5,14,9,13,49,40,9,51
RZ Pellets W,6359,6,14,7,15,51,58,-7,49
SV Josko Rie,6359,7,12,5,19,37,55,-18,41
Mattersburg,6359,8,11,7,18,40,59,-19,40
Admira Wacke,6359,9,10,9,17,45,65,-20,39
St. Pölten,6359,10,10,8,18,44,62,-18,38
FC Salzburg,6360,1,22,6,8,68,29,39,72
SC Rheindorf,6360,2,20,8,8,50,39,11,68
SK Sturm Gra,6360,3,19,7,10,55,33,22,64
Vienna,6360,4,18,6,12,64,46,18,60
Rapid Vienna,6360,5,17,8,11,53,39,14,59
RZ Pellets W,6360,6,13,7,16,44,55,-11,46
Admira Wacke,6360,7,12,6,18,41,60,-19,42
SV Josko Rie,6360,8,10,4,22,38,62,-24,34
Mattersburg,6360,9,9,5,22,29,58,-29,32
St. Pölten,6360,10,8,7,21,41,62,-21,31
FC Salzburg,6361,1,23,8,5,73,28,45,77
SC Rheindorf,6361,2,19,6,11,62,46,16,63
Rapid Vienna,6361,3,16,11,9,60,37,23,59
Vienna,6361,4,18,3,15,64,59,5,57
SK Sturm Gra,6361,5,15,11,10,56,40,16,56
RZ Pellets W,6361,6,13,6,17,48,63,-15,45
Mattersburg,6361,7,10,8,18,40,54,-14,38
SV Josko Rie,6361,8,10,6,20,33,54,-21,36
St. Pölten,6361,9,9,9,18,43,68,-25,36
Admira Wacke,6361,10,9,8,19,39,69,-30,35
Vienna,6362,1,22,4,10,62,42,20,70
SK Sturm Gra,6362,2,18,8,10,55,30,25,62
FC Salzburg,6362,3,18,8,10,57,36,21,62
SC Rheindorf,6362,4,18,8,10,49,39,10,62
Rapid Vienna,6362,5,14,10,12,57,42,15,52
RZ Pellets W,6362,6,15,5,16,45,52,-7,50
SV Josko Rie,6362,7,13,7,16,39,50,-11,46
Admira Wacke,6362,8,12,5,19,33,57,-24,41
St. Pölten,6362,9,7,9,20,35,58,-23,30
Mattersburg,6362,10,6,10,20,29,55,-26,28
FC Salzburg,6363,1,20,9,7,68,37,31,69
SC Rheindorf,6363,2,19,7,10,62,52,10,64
Vienna,6363,3,19,5,12,68,53,15,62
Rapid Vienna,6363,4,16,10,10,61,40,21,58
SK Sturm Gra,6363,5,15,7,14,50,47,3,52
RZ Pellets W,6363,6,12,8,16,54,57,-3,44
Admira Wacke,6363,7,11,10,15,42,58,-16,43
St. Pölten,6363,8,9,11,16,43,62,-19,38
Mattersburg,6363,9,7,13,16,38,51,-13,34
SV Josko Rie,6363,10,9,6,21,31,60,-29,33
SC Rheindorf,6364,1,21,9,6,62,43,19,72
FC Salzburg,6364,2,20,10,6,67,32,35,70
SK Sturm Gra,6364,3,20,6,10,66,38,28,66
Vienna,6364,4,15,8,13,59,54,5,53
Rapid Vienna,6364,5,13,11,12,53,45,8,50
RZ Pellets W,6364,6,13,6,17,47,58,-11,45
St. Pölten,6364,7,10,8,18,44,64,-20,38
SV Josko Rie,6364,8,11,4,21,34,56,-22,37
Admira Wacke,6364,9,9,8,19,33,56,-23,35
Mattersburg,6364,10,8,10,18,39,58,-19,34
SC Rheindorf,6365,1,23,5,8,69,41,28,74
SK Sturm Gra,6365,2,21,6,9,69,40,29,69
FC Salzburg,6365,3,21,5,10,70,39,31,68
Vienna,6365,4,19,7,10,67,53,14,64
Rapid Vienna,6365,5,18,7,11,67,39,28,61
RZ Pellets W,6365,6,11,5,20,46,67,-21,38
SV Josko Rie,6365,7,11,4,21,31,56,-25,37
Admira Wacke,6365,8,10,6,20,35,65,-30,36
St. Pölten,6365,9,9,8,19,40,65,-25,35
Mattersburg,6365,10,7,7,22,33,62,-29,28
FC Salzburg,6366,1,20,10,6,64,32,32,70
SK Sturm Gra,6366,2,18,8,10,58,34,24,62
SC Rheindorf,6366,3,17,8,11,50,43,7,59
Vienna,6366,4,17,6,13,57,54,3,57
Rapid Vienna,6366,5,13,13,10,55,40,15,52
SV Josko Rie,6366,6,12,8,16,39,48,-9,44
RZ Pellets W,6366,7,9,12,15,46,59,-13,39
Admira Wacke,6366,8,10,9,17,33,53,-20,39
St. Pölten,6366,9,9,11,16,38,56,-18,38
Mattersburg,6366,10,7,11,18,32,53,-21,32
SC Rheindorf,6367,1,22,7,7,54,35,19,73
FC Salzburg,6367,2,21,8,7,70,31,39,71
Vienna,6367,3,20,5,11,64,51,13,65
SK Sturm Gra,6367,4,20,4,12,60,38,22,64
Rapid Vienna,6367,5,11,10,15,50,49,1,43
St. Pölten,6367,6,12,7,17,43,60,-17,43
RZ Pellets W,6367,7,12,6,18,43,54,-11,42
Admira Wacke,6367,8,11,6,19,38,62,-24,39
SV Josko Rie,6367,9,10,5,21,36,57,-21,35
Mattersburg,6367,10,8,8,20,39,60,-21,32
FC Salzburg,6368,1,21,10,5,67,32,35,73
SC Rheindorf,6368,2,18,10,8,55,43,12,64
Rapid Vienna,6368,3,15,12,9,54,37,17,57
SK Sturm Gra,6368,4,16,8,12,62,40,22,56
Vienna,6368,5,16,7,13,62,54,8,55
RZ Pellets W,6368,6,12,9,15,43,53,-10,45
Admira Wacke,6368,7,12,7,17,40,58,-18,43
SV Josko Rie,6368,8,11,4,21,35,55,-20,37
Mattersburg,6368,9,8,11,17,35,53,-18,35
St. Pölten,6368,10,6,12,18,36,64,-28,30
SC Rheindorf,6369,1,21,6,9,58,40,18,69
FC Salzburg,6369,2,20,7,9,66,32,34,67
SK Sturm Gra,6369,3,19,5,12,63,38,25,62
Rapid Vienna,6369,4,15,11,10,57,40,17,56
Vienna,6369,5,16,5,15,66,65,1,53
RZ Pellets W,6369,6,12,8,16,46,56,-10,44
Admira Wacke,6369,7,11,7,18,37,66,-29,40
SV Josko Rie,6369,8,11,6,19,35,53,-18,39
Mattersburg,6369,9,9,11,16,41,56,-15,38
St. Pölten,6369,10,8,10,18,40,63,-23,34
Vienna,6370,1,23,5,8,66,44,22,74
FC Salzburg,6370,2,21,5,10,66,29,37,68
SK Sturm Gra,6370,3,18,6,12,62,40,22,60
SC Rheindorf,6370,4,17,7,12,53,45,8,58
Rapid Vienna,6370,5,15,8,13,55,45,10,53
RZ Pellets W,6370,6,13,6,17,48,65,-17,45
SV Josko Rie,6370,7,13,4,19,40,57,-17,43
Admira Wacke,6370,8,12,4,20,42,64,-22,40
Mattersburg,6370,9,10,7,19,42,60,-18,37
St. Pölten,6370,10,8,8,20,40,65,-25,32
FC Salzburg,6371,1,21,6,9,60,28,32,69
SC Rheindorf,6371,2,19,7,10,52,40,12,64
SK Sturm Gra,6371,3,19,6,11,55,36,19,63
Rapid Vienna,6371,4,15,12,9,58,37,21,57
Vienna,6371,5,15,8,13,58,53,5,53
RZ Pellets W,6371,6,13,9,14,52,54,-2,48
Admira Wacke,6371,7,12,5,19,37,61,-24,41
Mattersburg,6371,8,10,7,19,37,55,-18,37
St. Pölten,6371,9,9,10,17,44,64,-20,37
SV Josko Rie,6371,10,9,6,21,34,59,-25,33
FC Salzburg,6372,1,20,10,6,68,34,34,70
SC Rheindorf,6372,2,20,10,6,59,35,24,70
SK Sturm Gra,6372,3,19,8,9,55,31,24,65
Vienna,6372,4,16,6,14,69,58,11,54
Rapid Vienna,6372,5,10,15,11,49,40,9,45
Admira Wacke,6372,6,13,5,18,37,61,-24,44
RZ Pellets W,6372,7,11,9,16,46,54,-8,42
SV Josko Rie,6372,8,11,6,19,35,51,-16,39
Mattersburg,6372,9,10,9,17,37,57,-20,39
St. Pölten,6372,10,6,10,20,33,67,-34,28
FC Salzburg,6373,1,22,5,9,71,36,35,71
SC Rheindorf,6373,2,20,8,8,57,42,15,68
SK Sturm Gra,6373,3,18,9,9,61,32,29,63
Vienna,6373,4,18,8,10,62,51,11,62
Rapid Vienna,6373,5,14,11,11,52,38,14,53
Admira Wacke,6373,6,16,4,16,39,56,-17,52
RZ Pellets W,6373,7,10,9,17,51,65,-14,39
Mattersburg,6373,8,10,7,19,40,51,-11,37
St. Pölten,6373,9,8,10,18,34,62,-28,34
SV Josko Rie,6373,10,7,3,26,29,63,-34,24
FC Salzburg,6374,1,22,7,7,62,26,36,73
SC Rheindorf,6374,2,17,7,12,54,42,12,58
SK Sturm Gra,6374,3,17,6,13,63,42,21,57
Vienna,6374,4,17,4,15,61,61,0,55
Rapid Vienna,6374,5,14,12,10,56,40,16,54
RZ Pellets W,6374,6,14,8,14,45,51,-6,50
Admira Wacke,6374,7,12,7,17,31,50,-19,43
St. Pölten,6374,8,10,10,16,44,61,-17,40
Mattersburg,6374,9,8,12,16,42,60,-18,36
SV Josko Rie,6374,10,10,5,21,32,57,-25,35
FC Salzburg,6375,1,20,10,6,62,29,33,70
SC Rheindorf,6375,2,19,10,7,58,40,18,67
SK Sturm Gra,6375,3,18,7,11,66,38,28,61
Rapid Vienna,6375,4,15,13,8,61,36,25,58
Vienna,6375,5,17,7,12,58,55,3,58
RZ Pellets W,6375,6,11,11,14,41,50,-9,44
Admira Wacke,6375,7,11,6,19,36,62,-26,39
St. Pölten,6375,8,9,11,16,42,58,-16,38
SV Josko Rie,6375,9,10,5,21,38,65,-27,35
Mattersburg,6375,10,5,10,21,31,60,-29,25
FC Salzburg,6376,1,22,7,7,73,32,41,73
SC Rheindorf,6376,2,20,8,8,56,36,20,68
SK Sturm Gra,6376,3,20,4,12,55,34,21,64
Rapid Vienna,6376,4,15,12,9,58,42,16,57
Vienna,6376,5,16,6,14,67,66,1,54
RZ Pellets W,6376,6,11,8,17,45,65,-20,41
SV Josko Rie,6376,7,11,6,19,39,57,-18,39
Admira Wacke,6376,8,11,5,20,44,67,-23,38
Mattersburg,6376,9,10,7,19,46,61,-15,37
St. Pölten,6376,10,8,9,19,42,65,-23,33
SK Sturm Gra,6377,1,21,8,7,61,29,32,71
SC Rheindorf,6377,2,19,11,6,60,44,16,68
FC Salzburg,6377,3,19,9,8,65,31,34,66
Vienna,6377,4,20,3,13,65,53,12,63
Rapid Vienna,6377,5,14,9,13,51,39,12,51
RZ Pellets W,6377,6,13,10,13,43,49,-6,49
SV Josko Rie,6377,7,12,4,20,36,55,-19,40
Admira Wacke,6377,8,9,8,19,29,56,-27,35
Mattersburg,6377,9,7,9,20,36,60,-24,30
St. Pölten,6377,10,6,9,21,40,70,-30,27
FC Salzburg,6378,1,21,8,7,60,30,30,71
SC Rheindorf,6378,2,18,11,7,55,38,17,65
SK Sturm Gra,6378,3,18,7,11,58,39,19,61
Vienna,6378,4,17,6,13,59,51,8,57
Rapid Vienna,6378,5,14,10,12,57,44,13,52
RZ Pellets W,6378,6,15,6,15,50,53,-3,51
Admira Wacke,6378,7,13,6,17,41,61,-20,45
SV Josko Rie,6378,8,12,3,21,39,55,-16,39
St. Pölten,6378,9,7,11,18,39,59,-20,32
Mattersburg,6378,10,7,8,21,28,56,-28,29
FC Salzburg,6379,1,22,9,5,65,24,41,75
SC Rheindorf,6379,2,21,5,10,51,36,15,68
Rapid Vienna,6379,3,16,11,9,54,36,18,59
SK Sturm Gra,6379,4,17,5,14,57,40,17,56
Vienna,6379,5,17,5,14,61,54,7,56
RZ Pellets W,6379,6,13,6,17,41,54,-13,45
St. Pölten,6379,7,10,9,17,43,55,-12,39
Mattersburg,6379,8,11,6,19,37,58,-21,39
SV Josko Rie,6379,9,11,3,22,34,63,-29,36
Admira Wacke,6379,10,9,7,20,38,61,-23,34
FC Salzburg,6380,1,22,7,7,72,30,42,73
SK Sturm Gra,6380,2,22,5,9,59,28,31,71
Vienna,6380,3,19,6,11,63,52,11,63
SC Rheindorf,6380,4,19,6,11,54,44,10,63
Rapid Vienna,6380,5,10,13,13,46,43,3,43
Admira Wacke,6380,6,12,7,17,32,51,-19,43
RZ Pellets W,6380,7,11,6,19,47,64,-17,39
SV Josko Rie,6380,8,11,4,21,32,55,-23,37
St. Pölten,6380,9,9,9,18,42,64,-22,36
Mattersburg,6380,10,8,11,17,41,57,-16,35
FC Salzburg,6381,1,22,6,8,67,28,39,72
SK Sturm Gra,6381,2,21,5,10,60,35,25,68
SC Rheindorf,6381,3,19,8,9,51,47,4,65
Vienna,6381,4,20,2,14,63,51,12,62
Rapid Vienna,6381,5,15,10,11,57,40,17,55
RZ Pellets W,6381,6,15,4,17,48,50,-2,49
Admira Wacke,6381,7,11,6,19,32,57,-25,39
SV Josko Rie,6381,8,10,5,21,32,51,-19,35
St. Pölten,6381,9,8,9,19,38,65,-27,33
Mattersburg,6381,10,8,7,21,39,63,-24,31
SC Rheindorf,6382,1,20,7,9,58,39,19,67
SK Sturm Gra,6382,2,18,10,8,53,26,27,64
FC Salzburg,6382,3,18,8,10,62,33,29,62
Rapid Vienna,6382,4,18,8,10,60,36,24,62
Vienna,6382,5,15,6,15,58,61,-3,51
RZ Pellets W,6382,6,12,7,17,46,58,-12,43
Mattersburg,6382,7,11,9,16,39,57,-18,42
Admira Wacke,6382,8,11,8,17,36,55,-19,41
St. Pölten,6382,9,9,9,18,42,64,-22,36
SV Josko Rie,6382,10,7,10,19,31,56,-25,31
FC Salzburg,6383,1,21,10,5,70,30,40,73
SK Sturm Gra,6383,2,22,7,7,55,27,28,73
SC Rheindorf,6383,3,19,6,11,57,49,8,63
Vienna,6383,4,18,3,15,60,57,3,57
SV Josko Rie,6383,5,13,5,18,34,48,-14,44
RZ Pellets W,6383,6,11,10,15,43,55,-12,43
Admira Wacke,6383,7,12,7,17,42,56,-14,43
Mattersburg,6383,8,11,9,16,36,45,-9,42
Rapid Vienna,6383,9,9,10,17,48,47,1,37
St. Pölten,6383,10,6,9,21,35,66,-31,27
FC Salzburg,6384,1,22,7,7,66,36,30,73
Vienna,6384,2,20,5,11,67,49,18,65
SK Sturm Gra,6384,3,19,7,10,62,35,27,64
SC Rheindorf,6384,4,18,8,10,61,43,18,62
Rapid Vienna,6384,5,12,12,12,50,41,9,48
SV Josko Rie,6384,6,12,8,16,42,46,-4,44
RZ Pellets W,6384,7,12,7,17,43,60,-17,43
Admira Wacke,6384,8,11,7,18,34,56,-22,40
Mattersburg,6384,9,9,7,20,41,60,-19,34
St. Pölten,6384,10,7,8,21,35,75,-40,29
SC Rheindorf,6385,1,21,8,7,52,38,14,71
Vienna,6385,2,21,6,9,71,45,26,69
FC Salzburg,6385,3,20,8,8,63,30,33,68
SK Sturm Gra,6385,4,19,8,9,59,38,21,65
Rapid Vienna,6385,5,14,10,12,56,46,10,52
RZ Pellets W,6385,6,14,7,15,49,56,-7,49
Mattersburg,6385,7,9,8,19,35,52,-17,35
Admira Wacke,6385,8,10,5,21,33,57,-24,35
SV Josko Rie,6385,9,9,7,20,33,55,-22,34
St. Pölten,6385,10,6,7,23,33,67,-34,25
FC Salzburg,6386,1,20,8,8,65,28,37,68
SK Sturm Gra,6386,2,21,5,10,65,36,29,68
Vienna,6386,3,20,5,11,70,58,12,65
SC Rheindorf,6386,4,19,7,10,61,47,14,64
Rapid Vienna,6386,5,12,11,13,51,45,6,47
RZ Pellets W,6386,6,14,5,17,51,54,-3,47
SV Josko Rie,6386,7,13,5,18,38,51,-13,44
Admira Wacke,6386,8,12,7,17,38,62,-24,43
St. Pölten,6386,9,6,11,19,37,66,-29,29
Mattersburg,6386,10,7,8,21,36,65,-29,29
Vienna,6387,1,20,4,12,67,59,8,64
FC Salzburg,6387,2,18,9,9,58,31,27,63
SC Rheindorf,6387,3,18,8,10,59,46,13,62
Rapid Vienna,6387,4,16,11,9,61,35,26,59
SK Sturm Gra,6387,5,18,4,14,57,44,13,58
Admira Wacke,6387,6,13,5,18,43,59,-16,44
Mattersburg,6387,7,10,10,16,39,53,-14,40
RZ Pellets W,6387,8,10,9,17,43,55,-12,39
St. Pölten,6387,9,9,12,15,41,57,-16,39
SV Josko Rie,6387,10,8,8,20,30,59,-29,32
Rapid Vienna,6388,1,18,9,9,68,35,33,63
SC Rheindorf,6388,2,19,6,11,52,43,9,63
FC Salzburg,6388,3,18,6,12,60,36,24,60
SK Sturm Gra,6388,4,17,8,11,60,46,14,59
Vienna,6388,5,17,7,12,60,48,12,58
RZ Pellets W,6388,6,15,6,15,45,60,-15,51
Admira Wacke,6388,7,12,8,16,42,57,-15,44
Mattersburg,6388,8,8,12,16,41,55,-14,36
SV Josko Rie,6388,9,9,8,19,35,57,-22,35
St. Pölten,6388,10,8,8,20,43,69,-26,32
FC Salzburg,6389,1,21,8,7,58,27,31,71
SC Rheindorf,6389,2,19,10,7,63,41,22,67
SK Sturm Gra,6389,3,18,9,9,56,35,21,63
Vienna,6389,4,19,4,13,67,48,19,61
Rapid Vienna,6389,5,13,13,10,55,35,20,52
Admira Wacke,6389,6,14,5,17,39,57,-18,47
RZ Pellets W,6389,7,11,7,18,39,55,-16,40
SV Josko Rie,6389,8,12,3,21,32,54,-22,39
Mattersburg,6389,9,7,10,19,37,59,-22,31
St. Pölten,6389,10,8,7,21,35,70,-35,31
SK Sturm Gra,6390,1,22,5,9,61,31,30,71
FC Salzburg,6390,2,20,9,7,69,36,33,69
Vienna,6390,3,19,3,14,62,49,13,60
SC Rheindorf,6390,4,17,9,10,54,46,8,60
Rapid Vienna,6390,5,16,8,12,67,49,18,56
RZ Pellets W,6390,6,12,8,16,46,56,-10,44
Admira Wacke,6390,7,10,8,18,40,63,-23,38
St. Pölten,6390,8,10,7,19,42,70,-28,37
Mattersburg,6390,9,10,6,20,39,59,-20,36
SV Josko Rie,6390,10,10,5,21,33,54,-21,35
FC Salzburg,6391,1,22,7,7,68,27,41,73
SK Sturm Gra,6391,2,21,6,9,59,26,33,69
SC Rheindorf,6391,3,20,8,8,57,40,17,68
Vienna,6391,4,17,7,12,64,47,17,58
Rapid Vienna,6391,5,13,13,10,51,37,14,52
RZ Pellets W,6391,6,12,8,16,43,58,-15,44
Admira Wacke,6391,7,11,7,18,32,62,-30,40
St. Pölten,6391,8,8,10,18,40,67,-27,34
SV Josko Rie,6391,9,7,9,20,31,58,-27,30
Mattersburg,6391,10,5,13,18,32,55,-23,28
FC Salzburg,6392,1,21,8,7,63,28,35,71
Vienna,6392,2,22,4,10,67,42,25,70
SC Rheindorf,6392,3,20,6,10,53,43,10,66
SK Sturm Gra,6392,4,18,5,13,52,36,16,59
Rapid Vienna,6392,5,13,9,14,58,45,13,48
RZ Pellets W,6392,6,14,5,17,46,62,-16,47
Admira Wacke,6392,7,13,5,18,38,54,-16,44
SV Josko Rie,6392,8,11,6,19,35,55,-20,39
Mattersburg,6392,9,8,8,20,39,59,-20,32
St. Pölten,6392,10,7,10,19,32,59,-27,31
SK Sturm Gra,6393,1,20,6,10,54,33,21,66
FC Salzburg,6393,2,19,8,9,66,37,29,65
Rapid Vienna,6393,3,18,9,9,71,43,28,63
SC Rheindorf,6393,4,17,8,11,50,44,6,59
Vienna,6393,5,17,7,12,55,48,7,58
RZ Pellets W,6393,6,13,8,15,45,53,-8,47
Mattersburg,6393,7,10,7,19,39,56,-17,37
Admira Wacke,6393,8,9,10,17,33,60,-27,37
SV Josko Rie,6393,9,9,9,18,41,59,-18,36
St. Pölten,6393,10,8,8,20,49,70,-21,32
FC Salzburg,6394,1,22,6,8,68,30,38,72
SC Rheindorf,6394,2,21,7,8,57,36,21,70
SK Sturm Gra,6394,3,19,8,9,58,34,24,65
Vienna,6394,4,18,6,12,57,49,8,60
Rapid Vienna,6394,5,14,9,13,57,48,9,51
RZ Pellets W,6394,6,12,7,17,51,58,-7,43
Admira Wacke,6394,7,12,7,17,41,57,-16,43
SV Josko Rie,6394,8,12,3,21,32,58,-26,39
St. Pölten,6394,9,9,7,20,37,63,-26,34
Mattersburg,6394,10,6,10,20,34,59,-25,28
FC Salzburg,6395,1,21,8,7,64,30,34,71
SK Sturm Gra,6395,2,19,10,7,58,30,28,67
Vienna,6395,3,19,8,9,61,42,19,65
SC Rheindorf,6395,4,17,9,10,51,42,9,60
Rapid Vienna,6395,5,15,11,10,57,40,17,56
RZ Pellets W,6395,6,14,8,14,53,55,-2,50
Admira Wacke,6395,7,9,8,19,32,59,-27,35
St. Pölten,6395,8,8,10,18,38,62,-24,34
Mattersburg,6395,9,7,9,20,33,56,-23,30
SV Josko Rie,6395,10,7,7,22,25,56,-31,28
FC Salzburg,6396,1,22,7,7,68,32,36,73
SC Rheindorf,6396,2,19,8,9,65,49,16,65
Vienna,6396,3,17,8,11,67,48,19,59
SK Sturm Gra,6396,4,17,6,13,57,42,15,57
Rapid Vienna,6396,5,14,13,9,57,39,18,55
SV Josko Rie,6396,6,13,4,19,40,57,-17,43
RZ Pellets W,6396,7,10,10,16,42,56,-14,40
Admira Wacke,6396,8,11,7,18,34,56,-22,40
Mattersburg,6396,9,8,10,18,32,57,-25,34
St. Pölten,6396,10,8,9,19,36,62,-26,33
SK Sturm Gra,6397,1,19,10,7,58,28,30,67
FC Salzburg,6397,2,19,8,9,60,34,26,65
SC Rheindorf,6397,3,19,8,9,57,40,17,65
Rapid Vienna,6397,4,16,11,9,61,35,26,59
Vienna,6397,5,16,4,16,54,57,-3,52
St. Pölten,6397,6,11,10,15,49,60,-11,43
RZ Pellets W,6397,7,12,6,18,41,54,-13,42
SV Josko Rie,6397,8,9,11,16,32,51,-19,38
Mattersburg,6397,9,9,7,20,39,62,-23,34
Admira Wacke,6397,10,9,7,20,33,63,-30,34
SC Rheindorf,6398,1,23,5,8,59,41,18,74
FC Salzburg,6398,2,21,9,6,67,30,37,72
SK Sturm Gra,6398,3,20,7,9,60,28,32,67
Vienna,6398,4,18,5,13,58,50,8,59
Rapid Vienna,6398,5,14,9,13,50,39,11,51
RZ Pellets W,6398,6,12,6,18,41,55,-14,42
SV Josko Rie,6398,7,12,6,18,38,58,-20,42
Admira Wacke,6398,8,10,8,18,33,55,-22,38
Mattersburg,6398,9,9,8,19,35,52,-17,35
St. Pölten,6398,10,6,7,23,34,67,-33,25
FC Salzburg,6399,1,22,6,8,67,29,38,72
SK Sturm Gra,6399,2,21,7,8,60,27,33,70
SC Rheindorf,6399,3,18,8,10,52,46,6,62
Vienna,6399,4,17,8,11,65,50,15,59
Rapid Vienna,6399,5,13,8,15,49,42,7,47
Admira Wacke,6399,6,13,6,17,32,53,-21,45
SV Josko Rie,6399,7,12,6,18,34,51,-17,42
St. Pölten,6399,8,9,10,17,41,60,-19,37
RZ Pellets W,6399,9,9,9,18,40,65,-25,36
Mattersburg,6399,10,8,8,20,36,53,-17,32
FC Salzburg,6400,1,24,5,7,67,28,39,77
Vienna,6400,2,19,6,11,63,49,14,63
SK Sturm Gra,6400,3,18,8,10,54,32,22,62
SC Rheindorf,6400,4,18,7,11,57,42,15,61
Rapid Vienna,6400,5,16,11,9,57,36,21,59
SV Josko Rie,6400,6,13,6,17,41,53,-12,45
RZ Pellets W,6400,7,9,11,16,44,59,-15,38
Admira Wacke,6400,8,10,8,18,38,61,-23,38
St. Pölten,6400,9,8,8,20,38,69,-31,32
Mattersburg,6400,10,5,10,21,27,57,-30,25
FC Salzburg,6401,1,22,6,8,68,28,40,72
SK Sturm Gra,6401,2,21,5,10,60,37,23,68
Vienna,6401,3,19,5,12,66,54,12,62
SC Rheindorf,6401,4,16,9,11,55,52,3,57
Rapid Vienna,6401,5,14,9,13,61,47,14,51
RZ Pellets W,6401,6,13,6,17,51,58,-7,45
SV Josko Rie,6401,7,13,5,18,45,54,-9,44
St. Pölten,6401,8,9,9,18,47,71,-24,36
Mattersburg,6401,9,8,11,17,40,57,-17,35
Admira Wacke,6401,10,10,5,21,34,69,-35,35
FC Salzburg,6402,1,21,7,8,59,31,28,70
SC Rheindorf,6402,2,20,8,8,55,39,16,68
Vienna,6402,3,19,7,10,69,52,17,64
SK Sturm Gra,6402,4,18,3,15,62,42,20,57
Rapid Vienna,6402,5,13,10,13,56,44,12,49
SV Josko Rie,6402,6,14,5,17,41,53,-12,47
RZ Pellets W,6402,7,11,10,15,46,58,-12,43
Admira Wacke,6402,8,13,4,19,39,58,-19,43
St. Pölten,6402,9,9,10,17,41,62,-21,37
Mattersburg,6402,10,7,6,23,33,62,-29,27
SK Sturm Gra,6403,1,22,6,8,64,30,34,72
SC Rheindorf,6403,2,20,6,10,57,39,18,66
Vienna,6403,3,20,4,12,62,50,12,64
FC Salzburg,6403,4,18,8,10,60,34,26,62
RZ Pellets W,6403,5,14,7,15,48,52,-4,49
Rapid Vienna,6403,6,12,12,12,54,42,12,48
SV Josko Rie,6403,7,12,4,20,33,49,-16,40
Admira Wacke,6403,8,11,4,21,35,65,-30,37
Mattersburg,6403,9,8,10,18,28,46,-18,34
St. Pölten,6403,10,8,9,19,41,75,-34,33
SK Sturm Gra,6404,1,23,5,8,66,30,36,74
FC Salzburg,6404,2,19,11,6,65,26,39,68
SC Rheindorf,6404,3,18,6,12,52,45,7,60
Vienna,6404,4,17,6,13,54,52,2,57
Rapid Vienna,6404,5,14,12,10,59,40,19,54
SV Josko Rie,6404,6,15,4,17,43,50,-7,49
Admira Wacke,6404,7,10,11,15,35,52,-17,41
RZ Pellets W,6404,8,9,9,18,41,62,-21,36
St. Pölten,6404,9,7,10,19,44,73,-29,31
Mattersburg,6404,10,8,6,22,34,63,-29,30
SC Rheindorf,6405,1,20,8,8,64,43,21,68
FC Salzburg,6405,2,20,7,9,67,35,32,67
Rapid Vienna,6405,3,18,9,9,72,40,32,63
SK Sturm Gra,6405,4,17,8,11,53,40,13,59
Vienna,6405,5,19,2,15,62,60,2,59
SV Josko Rie,6405,6,13,6,17,43,51,-8,45
RZ Pellets W,6405,7,11,10,15,45,56,-11,43
Admira Wacke,6405,8,11,7,18,39,61,-22,40
St. Pölten,6405,9,7,10,19,36,65,-29,31
Mattersburg,6405,10,5,11,20,33,63,-30,26
FC Salzburg,6406,1,22,7,7,66,31,35,73
SK Sturm Gra,6406,2,18,9,9,58,34,24,63
SC Rheindorf,6406,3,17,10,9,51,40,11,61
Vienna,6406,4,18,6,12,60,48,12,60
Rapid Vienna,6406,5,13,11,12,58,46,12,50
RZ Pellets W,6406,6,12,10,14,45,54,-9,46
SV Josko Rie,6406,7,11,7,18,42,52,-10,40
Admira Wacke,6406,8,10,8,18,32,58,-26,38
St. Pölten,6406,9,6,15,15,41,66,-25,33
Mattersburg,6406,10,7,9,20,31,55,-24,30
SK Sturm Gra,6407,1,21,6,9,59,34,25,69
SC Rheindorf,6407,2,20,6,10,60,46,14,66
FC Salzburg,6407,3,18,7,11,62,46,16,61
Vienna,6407,4,18,6,12,70,59,11,60
RZ Pellets W,6407,5,15,7,14,53,52,1,52
Rapid Vienna,6407,6,13,12,11,59,39,20,51
SV Josko Rie,6407,7,12,4,20,42,61,-19,40
Admira Wacke,6407,8,10,8,18,37,59,-22,38
Mattersburg,6407,9,8,11,17,37,53,-16,35
St. Pölten,6407,10,8,7,21,40,70,-30,31
SC Rheindorf,6408,1,20,8,8,59,44,15,68
SK Sturm Gra,6408,2,20,7,9,60,26,34,67
FC Salzburg,6408,3,19,9,8,61,28,33,66
Rapid Vienna,6408,4,16,10,10,59,40,19,58
Vienna,6408,5,16,7,13,60,56,4,55
Admira Wacke,6408,6,14,8,14,43,53,-10,50
RZ Pellets W,6408,7,12,7,17,45,52,-7,43
St. Pölten,6408,8,9,7,20,42,71,-29,34
Mattersburg,6408,9,7,10,19,30,58,-28,31
SV Josko Rie,6408,10,7,7,22,29,60,-31,28
FC Salzburg,6409,1,22,7,7,69,33,36,73
SK Sturm Gra,6409,2,18,7,11,58,40,18,61
SC Rheindorf,6409,3,18,7,11,61,50,11,61
SV Josko Rie,6409,4,18,5,13,46,41,5,59
Vienna,6409,5,16,5,15,64,59,5,53
RZ Pellets W,6409,6,14,7,15,52,61,-9,49
Rapid Vienna,6409,7,12,12,12,58,41,17,48
Admira Wacke,6409,8,10,6,20,34,65,-31,36
St. Pölten,6409,9,8,9,19,39,63,-24,33
Mattersburg,6409,10,6,11,19,32,60,-28,29
FC Salzburg,6410,1,20,8,8,61,34,27,68
SC Rheindorf,6410,2,20,7,9,62,40,22,67
Rapid Vienna,6410,3,17,11,8,64,33,31,62
Vienna,6410,4,20,2,14,65,50,15,62
SK Sturm Gra,6410,5,17,7,12,50,32,18,58
Admira Wacke,6410,6,12,6,18,40,65,-25,42
RZ Pellets W,6410,7,11,8,17,47,61,-14,41
SV Josko Rie,6410,8,9,10,17,33,53,-20,37
St. Pölten,6410,9,9,10,17,44,65,-21,37
Mattersburg,6410,10,5,11,20,32,65,-33,26
FC Salzburg,6411,1,22,5,9,68,35,33,71
SK Sturm Gra,6411,2,20,6,10,70,41,29,66
Vienna,6411,3,18,8,10,60,46,14,62
SC Rheindorf,6411,4,18,8,10,49,37,12,62
Rapid Vienna,6411,5,13,10,13,52,39,13,49
Admira Wacke,6411,6,14,6,16,37,55,-18,48
RZ Pellets W,6411,7,12,6,18,46,59,-13,42
SV Josko Rie,6411,8,11,8,17,38,52,-14,41
Mattersburg,6411,9,8,9,19,37,60,-23,33
St. Pölten,6411,10,7,8,21,43,76,-33,29
SK Sturm Gra,6412,1,23,3,10,62,33,29,72
FC Salzburg,6412,2,21,6,9,61,30,31,69
Vienna,6412,3,19,5,12,69,54,15,62
SC Rheindorf,6412,4,16,9,11,51,44,7,57
RZ Pellets W,6412,5,15,5,16,45,54,-9,50
Rapid Vienna,6412,6,12,10,14,47,40,7,46
Admira Wacke,6412,7,12,7,17,34,54,-20,43
Mattersburg,6412,8,10,10,16,42,57,-15,40
SV Josko Rie,6412,9,8,9,19,38,60,-22,33
St. Pölten,6412,10,8,8,20,45,68,-23,32
FC Salzburg,6413,1,22,6,8,72,34,38,72
SK Sturm Gra,6413,2,21,4,11,61,37,24,67
SC Rheindorf,6413,3,19,7,10,48,36,12,64
Rapid Vienna,6413,4,17,8,11,63,43,20,59
Vienna,6413,5,18,4,14,65,52,13,58
Admira Wacke,6413,6,14,5,17,42,62,-20,47
Mattersburg,6413,7,11,7,18,39,51,-12,40
RZ Pellets W,6413,8,11,7,18,43,60,-17,40
St. Pölten,6413,9,9,7,20,44,73,-29,34
SV Josko Rie,6413,10,9,3,24,32,61,-29,30
FC Salzburg,6414,1,20,9,7,65,31,34,69
SK Sturm Gra,6414,2,18,7,11,54,37,17,61
SC Rheindorf,6414,3,16,12,8,50,40,10,60
Vienna,6414,4,18,6,12,60,52,8,60
Admira Wacke,6414,5,16,6,14,47,52,-5,54
Rapid Vienna,6414,6,12,14,10,54,42,12,50
St. Pölten,6414,7,11,9,16,49,59,-10,42
RZ Pellets W,6414,8,10,9,17,45,63,-18,39
SV Josko Rie,6414,9,9,6,21,31,57,-26,33
Mattersburg,6414,10,6,10,20,36,58,-22,28
SK Sturm Gra,6415,1,20,6,10,62,34,28,66
Vienna,6415,2,21,3,12,73,52,21,66
FC Salzburg,6415,3,19,6,11,69,33,36,63
SC Rheindorf,6415,4,19,6,11,52,47,5,63
Rapid Vienna,6415,5,15,10,11,56,40,16,55
RZ Pellets W,6415,6,15,6,15,44,50,-6,51
SV Josko Rie,6415,7,12,5,19,43,60,-17,41
Admira Wacke,6415,8,12,5,19,39,62,-23,41
Mattersburg,6415,9,9,9,18,43,67,-24,36
St. Pölten,6415,10,7,6,23,44,80,-36,27
FC Salzburg,6416,1,21,7,8,70,34,36,70
SC Rheindorf,6416,2,21,5,10,66,42,24,68
Vienna,6416,3,20,4,12,63,51,12,64
SK Sturm Gra,6416,4,17,7,12,57,41,16,58
Rapid Vienna,6416,5,15,10,11,57,40,17,55
SV Josko Rie,6416,6,12,7,17,43,52,-9,43
Mattersburg,6416,7,9,11,16,36,55,-19,38
RZ Pellets W,6416,8,10,8,18,38,61,-23,38
Admira Wacke,6416,9,11,4,21,41,68,-27,37
St. Pölten,6416,10,8,9,19,36,63,-27,33
FC Salzburg,6417,1,23,7,6,72,35,37,76
Vienna,6417,2,19,6,11,67,50,17,63
SK Sturm Gra,6417,3,18,7,11,60,42,18,61
SC Rheindorf,6417,4,16,11,9,57,48,9,59
Rapid Vienna,6417,5,15,12,9,67,43,24,57
Admira Wacke,6417,6,11,7,18,34,61,-27,40
Mattersburg,6417,7,10,9,17,40,54,-14,39
RZ Pellets W,6417,8,11,6,19,48,64,-16,39
St. Pölten,6417,9,9,11,16,40,56,-16,38
SV Josko Rie,6417,10,6,8,22,24,56,-32,26
FC Salzburg,6418,1,21,8,7,70,29,41,71
SK Sturm Gra,6418,2,18,8,10,54,32,22,62
SC Rheindorf,6418,3,17,11,8,58,44,14,62
Vienna,6418,4,18,8,10,62,50,12,62
Rapid Vienna,6418,5,15,9,12,57,39,18,54
Admira Wacke,6418,6,14,6,16,43,59,-16,48
SV Josko Rie,6418,7,14,3,19,41,61,-20,45
St. Pölten,6418,8,10,9,17,41,59,-18,39
RZ Pellets W,6418,9,9,8,19,40,60,-20,35
Mattersburg,6418,10,5,8,23,30,63,-33,23
FC Salzburg,6419,1,21,7,8,66,35,31,70
SC Rheindorf,6419,2,19,9,8,55,42,13,66
SK Sturm Gra,6419,3,19,8,9,53,28,25,65
Vienna,6419,4,19,6,11,62,48,14,63
Rapid Vienna,6419,5,13,13,10,59,42,17,52
RZ Pellets W,6419,6,13,4,19,42,55,-13,43
SV Josko Rie,6419,7,12,6,18,38,52,-14,42
St. Pölten,6419,8,9,10,17,46,65,-19,37
Admira Wacke,6419,9,10,7,19,34,58,-24,37
Mattersburg,6419,10,6,8,22,34,64,-30,26
FC Salzburg,6420,1,22,8,6,71,30,41,74
SC Rheindorf,6420,2,18,6,12,53,50,3,60
Vienna,6420,3,17,8,11,61,51,10,59
SK Sturm Gra,6420,4,16,8,12,58,40,18,56
Rapid Vienna,6420,5,12,11,13,51,44,7,47
Admira Wacke,6420,6,13,7,16,40,55,-15,46
SV Josko Rie,6420,7,12,6,18,39,56,-17,42
RZ Pellets W,6420,8,11,6,19,45,58,-13,39
Mattersburg,6420,9,10,9,17,37,52,-15,39
St. Pölten,6420,10,10,9,17,45,64,-19,39
SK Sturm Gra,6421,1,22,6,8,57,26,31,72
FC Salzburg,6421,2,19,8,9,61,32,29,65
Rapid Vienna,6421,3,17,11,8,61,31,30,62
SC Rheindorf,6421,4,18,7,11,55,49,6,61
Vienna,6421,5,17,4,15,63,56,7,55
SV Josko Rie,6421,6,14,5,17,34,48,-14,47
RZ Pellets W,6421,7,13,6,17,44,59,-15,45
Admira Wacke,6421,8,10,7,19,37,58,-21,37
Mattersburg,6421,9,8,10,18,37,54,-17,34
St. Pölten,6421,10,5,10,21,34,70,-36,25
SC Rheindorf,6422,1,20,9,7,56,36,20,69
SK Sturm Gra,6422,2,20,5,11,63,37,26,65
FC Salzburg,6422,3,17,12,7,65,34,31,63
Vienna,6422,4,17,8,11,66,56,10,59
RZ Pellets W,6422,5,13,10,13,49,47,2,49
Admira Wacke,6422,6,13,5,18,41,62,-21,44
SV Josko Rie,6422,7,11,6,19,32,53,-21,39
Rapid Vienna,6422,8,10,8,18,47,54,-7,38
Mattersburg,6422,9,8,12,16,38,53,-15,36
St. Pölten,6422,10,9,9,18,41,66,-25,36
FC Salzburg,6423,1,22,6,8,66,33,33,72
SK Sturm Gra,6423,2,21,6,9,67,37,30,69
SC Rheindorf,6423,3,20,9,7,55,40,15,69
Vienna,6423,4,20,4,12,67,49,18,64
Rapid Vienna,6423,5,11,12,13,56,46,10,45
SV Josko Rie,6423,6,13,4,19,37,51,-14,43
Admira Wacke,6423,7,11,5,20,34,63,-29,38
RZ Pellets W,6423,8,9,9,18,44,59,-15,36
Mattersburg,6423,9,8,11,17,34,54,-20,35
St. Pölten,6423,10,6,12,18,37,65,-28,30
SK Sturm Gra,6424,1,23,5,8,68,28,40,74
FC Salzburg,6424,2,20,7,9,66,40,26,67
SC Rheindorf,6424,3,20,6,10,61,44,17,66
Vienna,6424,4,18,4,14,66,58,8,58
Rapid Vienna,6424,5,13,12,11,60,43,17,51
RZ Pellets W,6424,6,13,8,15,47,52,-5,47
SV Josko Rie,6424,7,11,7,18,32,51,-19,40
Admira Wacke,6424,8,10,7,19,37,66,-29,37
Mattersburg,6424,9,8,8,20,33,54,-21,32
St. Pölten,6424,10,8,8,20,35,69,-34,32
FC Salzburg,6425,1,21,8,7,68,34,34,71
SK Sturm Gra,6425,2,21,6,9,62,33,29,69
Vienna,6425,3,19,5,12,68,53,15,62
SC Rheindorf,6425,4,16,10,10,50,43,7,58
Rapid Vienna,6425,5,15,10,11,54,41,13,55
RZ Pellets W,6425,6,13,8,15,46,57,-11,47
SV Josko Rie,6425,7,11,5,20,37,56,-19,38
Mattersburg,6425,8,9,8,19,42,58,-16,35
Admira Wacke,6425,9,9,7,20,33,62,-29,34
St. Pölten,6425,10,8,9,19,42,65,-23,33
FC Salzburg,6426,1,20,8,8,63,28,35,68
Vienna,6426,2,20,6,10,66,50,16,66
SC Rheindorf,6426,3,20,6,10,51,37,14,66
SK Sturm Gra,6426,4,17,9,10,59,34,25,60
Rapid Vienna,6426,5,17,9,10,59,35,24,60
RZ Pellets W,6426,6,13,7,16,45,51,-6,46
Mattersburg,6426,7,11,7,18,36,53,-17,40
Admira Wacke,6426,8,10,9,17,42,70,-28,39
SV Josko Rie,6426,9,9,6,21,31,56,-25,33
St. Pölten,6426,10,4,11,21,31,69,-38,23
FC Salzburg,6427,1,21,7,8,69,26,43,70
SK Sturm Gra,6427,2,21,6,9,62,34,28,69
SC Rheindorf,6427,3,20,9,7,54,40,14,69
Vienna,6427,4,19,5,12,63,46,17,62
Rapid Vienna,6427,5,15,10,11,56,35,21,55
RZ Pellets W,6427,6,14,7,15,50,56,-6,49
SV Josko Rie,6427,7,11,4,21,38,56,-18,37
Admira Wacke,6427,8,10,5,21,35,76,-41,35
Mattersburg,6427,9,7,12,17,32,56,-24,33
St. Pölten,6427,10,5,9,22,34,68,-34,24
FC Salzburg,6428,1,20,10,6,68,28,40,70
SK Sturm Gra,6428,2,20,6,10,60,34,26,66
Rapid Vienna,6428,3,18,9,9,64,40,24,63
Vienna,6428,4,17,6,13,54,50,4,57
SC Rheindorf,6428,5,14,11,11,45,42,3,53
Admira Wacke,6428,6,14,7,15,36,54,-18,49
RZ Pellets W,6428,7,12,6,18,43,57,-14,42
SV Josko Rie,6428,8,11,4,21,29,47,-18,37
St. Pölten,6428,9,7,12,17,34,62,-28,33
Mattersburg,6428,10,7,9,20,32,51,-19,30
FC Salzburg,6429,1,22,8,6,62,24,38,74
SC Rheindorf,6429,2,21,7,8,58,42,16,70
SK Sturm Gra,6429,3,20,8,8,61,30,31,68
Rapid Vienna,6429,4,17,8,11,66,35,31,59
Vienna,6429,5,15,8,13,64,54,10,53
RZ Pellets W,6429,6,10,10,16,40,57,-17,40
SV Josko Rie,6429,7,11,4,21,29,59,-30,37
St. Pölten,6429,8,9,7,20,41,69,-28,34
Admira Wacke,6429,9,9,7,20,28,57,-29,34
Mattersburg,6429,10,7,11,18,34,56,-22,32
SC Rheindorf,6430,1,21,8,7,65,43,22,71
FC Salzburg,6430,2,21,7,8,64,31,33,70
SK Sturm Gra,6430,3,21,5,10,61,29,32,68
Vienna,6430,4,19,3,14,60,54,6,60
Admira Wacke,6430,5,13,8,15,37,54,-17,47
Rapid Vienna,6430,6,12,10,14,59,41,18,46
SV Josko Rie,6430,7,10,8,18,32,52,-20,38
RZ Pellets W,6430,8,9,10,17,44,61,-17,37
Mattersburg,6430,9,8,9,19,37,61,-24,33
St. Pölten,6430,10,7,10,19,38,71,-33,31
SK Sturm Gra,6431,1,20,7,9,65,29,36,67
FC Salzburg,6431,2,19,7,10,66,45,21,64
Vienna,6431,3,20,4,12,69,49,20,64
Rapid Vienna,6431,4,17,10,9,57,37,20,61
SC Rheindorf,6431,5,17,9,10,54,44,10,60
SV Josko Rie,6431,6,11,8,17,35,49,-14,41
RZ Pellets W,6431,7,10,9,17,41,59,-18,39
Admira Wacke,6431,8,11,4,21,42,68,-26,37
Mattersburg,6431,9,9,9,18,37,57,-20,36
St. Pölten,6431,10,9,7,20,36,65,-29,34
FC Salzburg,6432,1,23,7,6,64,27,37,76
SC Rheindorf,6432,2,20,10,6,60,37,23,70
SK Sturm Gra,6432,3,19,6,11,57,36,21,63
Vienna,6432,4,18,6,12,61,51,10,60
Rapid Vienna,6432,5,14,9,13,50,39,11,51
RZ Pellets W,6432,6,11,11,14,47,54,-7,44
Admira Wacke,6432,7,12,6,18,39,60,-21,42
Mattersburg,6432,8,8,9,19,35,55,-20,33
St. Pölten,6432,9,7,10,19,36,63,-27,31
SV Josko Rie,6432,10,7,8,21,31,58,-27,29
FC Salzburg,6433,1,20,9,7,58,28,30,69
SC Rheindorf,6433,2,19,8,9,54,42,12,65
SK Sturm Gra,6433,3,19,7,10,52,28,24,64
Vienna,6433,4,19,5,12,57,48,9,62
Rapid Vienna,6433,5,14,13,9,51,32,19,55
St. Pölten,6433,6,11,9,16,42,57,-15,42
Admira Wacke,6433,7,10,7,19,32,58,-26,37
RZ Pellets W,6433,8,9,9,18,39,53,-14,36
SV Josko Rie,6433,9,9,8,19,30,48,-18,35
Mattersburg,6433,10,8,9,19,31,52,-21,33
FC Salzburg,6434,1,23,6,7,69,25,44,75
SC Rheindorf,6434,2,19,11,6,55,36,19,68
SK Sturm Gra,6434,3,18,9,9,57,31,26,63
Vienna,6434,4,17,6,13,57,51,6,57
RZ Pellets W,6434,5,16,8,12,49,47,2,56
SV Josko Rie,6434,6,11,7,18,33,50,-17,40
Rapid Vienna,6434,7,9,10,17,45,47,-2,37
St. Pölten,6434,8,9,9,18,40,60,-20,36
Admira Wacke,6434,9,10,6,20,33,64,-31,36
Mattersburg,6434,10,8,8,20,30,57,-27,32
SC Rheindorf,6435,1,21,7,8,59,42,17,70
SK Sturm Gra,6435,2,21,6,9,66,32,34,69
FC Salzburg,6435,3,19,5,12,62,32,30,62
Vienna,6435,4,19,5,12,63,54,9,62
Rapid Vienna,6435,5,15,10,11,58,43,15,55
RZ Pellets W,6435,6,14,7,15,44,48,-4,49
SV Josko Rie,6435,7,12,6,18,38,52,-14,42
Mattersburg,6435,8,8,9,19,32,56,-24,33
Admira Wacke,6435,9,9,6,21,28,62,-34,33
St. Pölten,6435,10,7,9,20,39,68,-29,30
SK Sturm Gra,6436,1,21,5,10,54,32,22,68
FC Salzburg,6436,2,20,5,11,62,36,26,65
Vienna,6436,3,21,2,13,69,48,21,65
Rapid Vienna,6436,4,19,7,10,65,34,31,64
SC Rheindorf,6436,5,18,7,11,49,40,9,61
RZ Pellets W,6436,6,14,9,13,46,53,-7,51
Admira Wacke,6436,7,14,4,18,41,61,-20,46
Mattersburg,6436,8,7,10,19,34,57,-23,31
SV Josko Rie,6436,9,9,4,23,35,62,-27,31
St. Pölten,6436,10,5,11,20,36,68,-32,26
SC Rheindorf,6437,1,19,9,8,61,40,21,66
FC Salzburg,6437,2,18,8,10,64,38,26,62
SK Sturm Gra,6437,3,16,12,8,56,30,26,60
Vienna,6437,4,18,6,12,60,54,6,60
Rapid Vienna,6437,5,12,12,12,50,46,4,48
Admira Wacke,6437,6,12,10,14,44,55,-11,46
RZ Pellets W,6437,7,12,7,17,41,52,-11,43
SV Josko Rie,6437,8,12,7,17,39,51,-12,43
St. Pölten,6437,9,8,10,18,36,62,-26,34
Mattersburg,6437,10,7,11,18,33,56,-23,32
FC Salzburg,6438,1,20,10,6,61,30,31,70
SC Rheindorf,6438,2,19,10,7,52,38,14,67
SK Sturm Gra,6438,3,17,8,11,56,34,22,59
Rapid Vienna,6438,4,15,11,10,57,33,24,56
Vienna,6438,5,15,9,12,58,51,7,54
St. Pölten,6438,6,10,10,16,38,58,-20,40
Admira Wacke,6438,7,10,9,17,34,56,-22,39
SV Josko Rie,6438,8,10,8,18,37,50,-13,38
RZ Pellets W,6438,9,9,11,16,42,60,-18,38
Mattersburg,6438,10,7,10,19,35,60,-25,31
FC Salzburg,6439,1,21,11,4,68,26,42,74
SC Rheindorf,6439,2,19,9,8,58,40,18,66
SK Sturm Gra,6439,3,19,8,9,60,34,26,65
Vienna,6439,4,17,8,11,65,54,11,59
RZ Pellets W,6439,5,15,6,15,51,52,-1,51
Rapid Vienna,6439,6,12,12,12,59,46,13,48
SV Josko Rie,6439,7,12,7,17,39,54,-15,43
Admira Wacke,6439,8,11,6,19,36,62,-26,39
St. Pölten,6439,9,5,11,20,40,70,-30,26
Mattersburg,6439,10,6,8,22,34,72,-38,26
Vienna,6440,1,20,5,11,66,47,19,65
FC Salzburg,6440,2,18,9,9,66,37,29,63
SC Rheindorf,6440,3,18,7,11,51,47,4,61
SK Sturm Gra,6440,4,16,9,11,53,37,16,57
Rapid Vienna,6440,5,14,10,12,55,37,18,52
RZ Pellets W,6440,6,14,9,13,52,55,-3,51
Admira Wacke,6440,7,13,6,17,41,60,-19,45
SV Josko Rie,6440,8,10,7,19,34,55,-21,37
St. Pölten,6440,9,8,11,17,43,64,-21,35
Mattersburg,6440,10,8,9,19,36,58,-22,33
FC Salzburg,6441,1,25,5,6,76,30,46,80
SK Sturm Gra,6441,2,19,6,11,60,36,24,63
Vienna,6441,3,19,6,11,61,49,12,63
SC Rheindorf,6441,4,18,9,9,54,46,8,63
Rapid Vienna,6441,5,14,9,13,53,42,11,51
Admira Wacke,6441,6,11,8,17,38,57,-19,41
Mattersburg,6441,7,11,7,18,42,59,-17,40
RZ Pellets W,6441,8,9,8,19,42,63,-21,35
SV Josko Rie,6441,9,9,6,21,34,58,-24,33
St. Pölten,6441,10,6,14,16,38,58,-20,32
SC Rheindorf,6442,1,20,9,7,55,34,21,69
FC Salzburg,6442,2,19,9,8,63,35,28,66
SK Sturm Gra,6442,3,19,8,9,67,41,26,65
Rapid Vienna,6442,4,17,10,9,60,40,20,61
Vienna,6442,5,17,8,11,63,47,16,59
RZ Pellets W,6442,6,12,7,17,48,60,-12,43
SV Josko Rie,6442,7,11,6,19,38,58,-20,39
Admira Wacke,6442,8,11,5,20,38,65,-27,38
Mattersburg,6442,9,6,12,18,29,51,-22,30
St. Pölten,6442,10,6,10,20,43,73,-30,28
FC Salzburg,6443,1,20,7,9,65,37,28,67
SC Rheindorf,6443,2,20,7,9,58,36,22,67
Vienna,6443,3,21,4,11,62,42,20,67
SK Sturm Gra,6443,4,18,7,11,59,38,21,61
Rapid Vienna,6443,5,13,14,9,58,41,17,53
Admira Wacke,6443,6,11,9,16,32,53,-21,42
RZ Pellets W,6443,7,11,8,17,46,58,-12,41
SV Josko Rie,6443,8,12,4,20,36,53,-17,40
Mattersburg,6443,9,7,10,19,39,63,-24,31
St. Pölten,6443,10,7,10,19,37,71,-34,31
FC Salzburg,6444,1,23,6,7,67,29,38,75
SC Rheindorf,6444,2,21,8,7,57,35,22,71
SK Sturm Gra,6444,3,21,7,8,64,29,35,70
Vienna,6444,4,17,6,13,63,56,7,57
RZ Pellets W,6444,5,12,10,14,46,52,-6,46
Rapid Vienna,6444,6,10,14,12,47,42,5,44
Admira Wacke,6444,7,11,9,16,42,63,-21,42
SV Josko Rie,6444,8,10,6,20,30,55,-25,36
St. Pölten,6444,9,8,11,17,40,64,-24,35
Mattersburg,6444,10,4,9,23,29,60,-31,21
FC Salzburg,6445,1,22,7,7,71,27,44,73
SC Rheindorf,6445,2,20,6,10,62,43,19,66
SK Sturm Gra,6445,3,20,4,12,57,37,20,64
Vienna,6445,4,17,3,16,59,56,3,54
Rapid Vienna,6445,5,13,11,12,55,43,12,50
RZ Pellets W,6445,6,14,6,16,48,54,-6,48
Admira Wacke,6445,7,14,4,18,44,66,-22,46
St. Pölten,6445,8,10,7,19,44,62,-18,37
Mattersburg,6445,9,10,7,19,37,59,-22,37
SV Josko Rie,6445,10,10,5,21,35,65,-30,35
FC Salzburg,6446,1,25,6,5,74,29,45,81
SK Sturm Gra,6446,2,19,9,8,61,33,28,66
Vienna,6446,3,18,5,13,59,50,9,59
SC Rheindorf,6446,4,16,8,12,43,43,0,56
Rapid Vienna,6446,5,14,12,10,54,37,17,54
Mattersburg,6446,6,11,8,17,38,52,-14,41
RZ Pellets W,6446,7,10,8,18,47,60,-13,38
Admira Wacke,6446,8,11,5,20,39,66,-27,38
SV Josko Rie,6446,9,10,6,20,32,51,-19,36
St. Pölten,6446,10,8,9,19,34,60,-26,33
FC Salzburg,6447,1,18,11,7,60,33,27,65
SK Sturm Gra,6447,2,18,8,10,62,37,25,62
Vienna,6447,3,18,5,13,62,54,8,59
SC Rheindorf,6447,4,17,8,11,53,45,8,59
Rapid Vienna,6447,5,12,10,14,55,46,9,46
Mattersburg,6447,6,12,9,15,45,50,-5,45
RZ Pellets W,6447,7,12,9,15,52,61,-9,45
Admira Wacke,6447,8,11,10,15,34,51,-17,43
St. Pölten,6447,9,9,13,14,40,55,-15,40
SV Josko Rie,6447,10,8,7,21,31,62,-31,31
FC Salzburg,6448,1,21,8,7,61,27,34,71
SK Sturm Gra,6448,2,21,5,10,58,33,25,68
SC Rheindorf,6448,3,19,10,7,55,33,22,67
Vienna,6448,4,18,7,11,58,49,9,61
Rapid Vienna,6448,5,13,12,11,58,42,16,51
RZ Pellets W,6448,6,14,7,15,45,56,-11,49
Admira Wacke,6448,7,12,7,17,37,55,-18,43
SV Josko Rie,6448,8,10,3,23,29,58,-29,33
Mattersburg,6448,9,8,7,21,36,55,-19,31
St. Pölten,6448,10,6,10,20,32,61,-29,28
SC Rheindorf,6449,1,20,9,7,55,38,17,69
FC Salzburg,6449,2,19,9,8,67,33,34,66
Vienna,6449,3,20,5,11,67,46,21,65
SK Sturm Gra,6449,4,18,7,11,56,37,19,61
Rapid Vienna,6449,5,13,13,10,54,37,17,52
RZ Pellets W,6449,6,14,7,15,47,55,-8,49
SV Josko Rie,6449,7,11,7,18,36,55,-19,40
Mattersburg,6449,8,9,6,21,37,63,-26,33
Admira Wacke,6449,9,8,9,19,34,63,-29,33
St. Pölten,6449,10,7,10,19,39,65,-26,31
SC Rheindorf,6450,1,20,9,7,52,40,12,69
FC Salzburg,6450,2,20,8,8,64,30,34,68
SK Sturm Gra,6450,3,19,8,9,60,35,25,65
Vienna,6450,4,18,8,10,70,51,19,62
Rapid Vienna,6450,5,14,12,10,54,40,14,54
SV Josko Rie,6450,6,10,7,19,32,49,-17,37
RZ Pellets W,6450,7,10,7,19,43,62,-19,37
Admira Wacke,6450,8,10,7,19,34,59,-25,37
Mattersburg,6450,9,8,11,17,35,51,-16,35
St. Pölten,6450,10,6,13,17,42,69,-27,31
SC Rheindorf,6451,1,20,9,7,63,44,19,69
FC Salzburg,6451,2,20,7,9,70,35,35,67
SK Sturm Gra,6451,3,19,7,10,59,38,21,64
Vienna,6451,4,18,4,14,70,61,9,58
Rapid Vienna,6451,5,14,10,12,63,51,12,52
RZ Pellets W,6451,6,14,6,16,57,58,-1,48
Admira Wacke,6451,7,11,7,18,44,69,-25,40
SV Josko Rie,6451,8,11,4,21,32,59,-27,37
St. Pölten,6451,9,9,9,18,40,63,-23,36
Mattersburg,6451,10,9,7,20,42,62,-20,34
SC Rheindorf,6452,1,21,9,6,61,37,24,72
FC Salzburg,6452,2,20,9,7,63,26,37,69
SK Sturm Gra,6452,3,18,6,12,60,37,23,60
Vienna,6452,4,19,2,15,67,62,5,59
Rapid Vienna,6452,5,13,12,11,55,42,13,51
Admira Wacke,6452,6,12,7,17,39,56,-17,43
RZ Pellets W,6452,7,12,6,18,41,58,-17,42
Mattersburg,6452,8,9,10,17,41,55,-14,37
SV Josko Rie,6452,9,10,6,20,33,53,-20,36
St. Pölten,6452,10,9,7,20,39,73,-34,34
FC Salzburg,6453,1,22,6,8,62,30,32,72
SC Rheindorf,6453,2,21,5,10,58,37,21,68
SK Sturm Gra,6453,3,21,4,11,60,38,22,67
Rapid Vienna,6453,4,16,11,9,62,37,25,59
RZ Pellets W,6453,5,15,6,15,47,51,-4,51
Vienna,6453,6,15,3,18,55,57,-2,48
Admira Wacke,6453,7,13,4,19,39,60,-21,43
St. Pölten,6453,8,10,8,18,43,62,-19,38
SV Josko Rie,6453,9,10,3,23,29,53,-24,33
Mattersburg,6453,10,9,6,21,31,61,-30,33
SK Sturm Gra,6454,1,20,4,12,65,38,27,64
FC Salzburg,6454,2,19,7,10,59,34,25,64
SC Rheindorf,6454,3,18,9,9,50,45,5,63
Vienna,6454,4,18,7,11,67,51,16,61
RZ Pellets W,6454,5,15,7,14,48,55,-7,52
Rapid Vienna,6454,6,11,14,11,56,43,13,47
Admira Wacke,6454,7,11,6,19,35,58,-23,39
Mattersburg,6454,8,10,8,18,35,54,-19,38
St. Pölten,6454,9,9,10,17,39,56,-17,37
SV Josko Rie,6454,10,11,4,21,35,55,-20,37
SC Rheindorf,6455,1,20,8,8,63,39,24,68
FC Salzburg,6455,2,18,11,7,63,32,31,65
SK Sturm Gra,6455,3,18,8,10,52,32,20,62
Rapid Vienna,6455,4,16,11,9,66,41,25,59
Vienna,6455,5,18,5,13,56,51,5,59
RZ Pellets W,6455,6,11,8,17,42,56,-14,41
Admira Wacke,6455,7,11,6,19,30,60,-30,39
SV Josko Rie,6455,8,10,8,18,37,55,-18,38
St. Pölten,6455,9,8,10,18,40,63,-23,34
Mattersburg,6455,10,8,9,19,40,60,-20,33
FC Salzburg,6456,1,19,11,6,63,34,29,68
SK Sturm Gra,6456,2,19,8,9,59,34,25,65
SC Rheindorf,6456,3,17,8,11,50,45,5,59
Vienna,6456,4,15,6,15,58,59,-1,51
RZ Pellets W,6456,5,14,6,16,56,57,-1,48
SV Josko Rie,6456,6,14,4,18,44,52,-8,46
Rapid Vienna,6456,7,11,12,13,53,47,6,45
Admira Wacke,6456,8,13,5,18,38,59,-21,44
Mattersburg,6456,9,9,11,16,38,53,-15,38
St. Pölten,6456,10,9,9,18,46,65,-19,36
Vienna,6457,1,21,5,10,60,51,9,68
FC Salzburg,6457,2,19,10,7,60,29,31,67
SK Sturm Gra,6457,3,18,8,10,56,36,20,62
Rapid Vienna,6457,4,16,9,11,63,40,23,57
SC Rheindorf,6457,5,16,8,12,49,44,5,56
RZ Pellets W,6457,6,12,8,16,40,51,-11,44
St. Pölten,6457,7,11,9,16,44,57,-13,42
SV Josko Rie,6457,8,11,5,20,30,50,-20,38
Admira Wacke,6457,9,9,8,19,32,55,-23,35
Mattersburg,6457,10,7,10,19,39,60,-21,31
FC Salzburg,6458,1,24,6,6,67,36,31,78
SC Rheindorf,6458,2,19,9,8,54,35,19,66
SK Sturm Gra,6458,3,20,5,11,68,43,25,65
Vienna,6458,4,18,4,14,62,55,7,58
Rapid Vienna,6458,5,14,9,13,58,41,17,51
SV Josko Rie,6458,6,13,5,18,37,47,-10,44
Admira Wacke,6458,7,12,5,19,38,59,-21,41
RZ Pellets W,6458,8,11,5,20,38,56,-18,38
St. Pölten,6458,9,9,11,16,48,69,-21,38
Mattersburg,6458,10,6,9,21,34,63,-29,27
SC Rheindorf,6459,1,22,7,7,60,36,24,73
FC Salzburg,6459,2,18,9,9,61,31,30,63
Vienna,6459,3,19,3,14,68,63,5,60
SK Sturm Gra,6459,4,18,5,13,58,38,20,59
Rapid Vienna,6459,5,15,10,11,52,40,12,55
RZ Pellets W,6459,6,13,9,14,46,54,-8,48
Admira Wacke,6459,7,11,6,19,39,55,-16,39
Mattersburg,6459,8,9,10,17,34,52,-18,37
SV Josko Rie,6459,9,10,5,21,39,61,-22,35
St. Pölten,6459,10,9,8,19,39,66,-27,35
FC Salzburg,6460,1,19,11,6,64,34,30,68
Vienna,6460,2,19,8,9,63,47,16,65
SK Sturm Gra,6460,3,18,9,9,56,38,18,63
SC Rheindorf,6460,4,16,11,9,49,39,10,59
Rapid Vienna,6460,5,12,14,10,54,42,12,50
Mattersburg,6460,6,11,10,15,44,53,-9,43
Admira Wacke,6460,7,11,10,15,40,53,-13,43
RZ Pellets W,6460,8,10,9,17,45,57,-12,39
St. Pölten,6460,9,8,9,19,36,63,-27,33
SV Josko Rie,6460,10,7,7,22,30,55,-25,28
Vienna,6461,1,23,3,10,69,46,23,72
SC Rheindorf,6461,2,20,8,8,61,43,18,68
FC Salzburg,6461,3,19,7,10,65,39,26,64
SK Sturm Gra,6461,4,18,9,9,61,39,22,63
Rapid Vienna,6461,5,11,12,13,46,43,3,45
RZ Pellets W,6461,6,12,9,15,55,63,-8,45
Admira Wacke,6461,7,11,7,18,38,60,-22,40
St. Pölten,6461,8,9,9,18,44,63,-19,36
Mattersburg,6461,9,8,10,18,43,62,-19,34
SV Josko Rie,6461,10,9,6,21,30,54,-24,33
FC Salzburg,6462,1,25,6,5,75,24,51,81
SK Sturm Gra,6462,2,21,4,11,61,37,24,67
SC Rheindorf,6462,3,18,8,10,54,43,11,62
Vienna,6462,4,19,4,13,64,54,10,61
Rapid Vienna,6462,5,12,11,13,53,50,3,47
RZ Pellets W,6462,6,13,6,17,52,62,-10,45
SV Josko Rie,6462,7,12,6,18,41,57,-16,42
Admira Wacke,6462,8,10,8,18,38,56,-18,38
St. Pölten,6462,9,9,10,17,47,67,-20,37
Mattersburg,6462,10,5,9,22,31,66,-35,24
FC Salzburg,6463,1,22,8,6,68,28,40,74
SC Rheindorf,6463,2,20,10,6,61,41,20,70
SK Sturm Gra,6463,3,20,6,10,59,31,28,66
Vienna,6463,4,16,7,13,57,50,7,55
Rapid Vienna,6463,5,14,11,11,51,38,13,53
RZ Pellets W,6463,6,15,4,17,51,55,-4,49
Admira Wacke,6463,7,12,7,17,37,61,-24,43
St. Pölten,6463,8,8,9,19,46,77,-31,33
SV Josko Rie,6463,9,8,8,20,34,61,-27,32
Mattersburg,6463,10,7,6,23,36,58,-22,27
FC Salzburg,6464,1,24,5,7,75,30,45,77
SC Rheindorf,6464,2,20,8,8,57,41,16,68
SK Sturm Gra,6464,3,19,9,8,58,31,27,66
Vienna,6464,4,18,2,16,55,54,1,56
RZ Pellets W,6464,5,12,9,15,49,62,-13,45
SV Josko Rie,6464,6,14,3,19,39,56,-17,45
Rapid Vienna,6464,7,11,10,15,55,49,6,43
Admira Wacke,6464,8,12,6,18,35,59,-24,42
Mattersburg,6464,9,9,8,19,39,57,-18,35
St. Pölten,6464,10,7,8,21,42,65,-23,29
SC Rheindorf,6465,1,22,7,7,62,40,22,73
FC Salzburg,6465,2,19,7,10,57,34,23,64
SK Sturm Gra,6465,3,19,6,11,59,35,24,63
Vienna,6465,4,16,6,14,58,58,0,54
Rapid Vienna,6465,5,14,10,12,61,40,21,52
Admira Wacke,6465,6,12,9,15,41,56,-15,45
RZ Pellets W,6465,7,11,11,14,46,56,-10,44
Mattersburg,6465,8,10,8,18,44,60,-16,38
St. Pölten,6465,9,10,7,19,42,67,-25,37
SV Josko Rie,6465,10,8,7,21,32,56,-24,31
SC Rheindorf,6466,1,20,7,9,53,36,17,67
Vienna,6466,2,20,6,10,67,48,19,66
FC Salzburg,6466,3,18,10,8,62,33,29,64
SK Sturm Gra,6466,4,18,6,12,53,34,19,60
RZ Pellets W,6466,5,14,8,14,42,48,-6,50
Rapid Vienna,6466,6,12,13,11,52,44,8,49
Admira Wacke,6466,7,12,8,16,36,49,-13,44
St. Pölten,6466,8,9,9,18,41,66,-25,36
Mattersburg,6466,9,9,6,21,35,58,-23,33
SV Josko Rie,6466,10,8,7,21,33,58,-25,31
FC Salzburg,6467,1,19,11,6,65,32,33,68
SC Rheindorf,6467,2,19,9,8,63,42,21,66
SK Sturm Gra,6467,3,19,8,9,67,35,32,65
Vienna,6467,4,16,5,15,52,58,-6,53
RZ Pellets W,6467,5,15,6,15,49,60,-11,51
Rapid Vienna,6467,6,13,10,13,53,38,15,49
Mattersburg,6467,7,11,9,16,39,51,-12,42
SV Josko Rie,6467,8,11,8,17,41,55,-14,41
Admira Wacke,6467,9,9,9,18,36,60,-24,36
St. Pölten,6467,10,6,9,21,36,70,-34,27
FC Salzburg,6468,1,21,6,9,70,37,33,69
Vienna,6468,2,19,7,10,63,46,17,64
SC Rheindorf,6468,3,18,9,9,58,47,11,63
Rapid Vienna,6468,4,16,10,10,61,44,17,58
SK Sturm Gra,6468,5,16,7,13,52,38,14,55
RZ Pellets W,6468,6,13,8,15,49,58,-9,47
St. Pölten,6468,7,10,11,15,49,66,-17,41
Admira Wacke,6468,8,10,8,18,39,64,-25,38
SV Josko Rie,6468,9,10,7,19,41,57,-16,37
Mattersburg,6468,10,6,9,21,35,60,-25,27
FC Salzburg,6469,1,21,8,7,72,34,38,71
SC Rheindorf,6469,2,21,8,7,59,40,19,71
SK Sturm Gra,6469,3,18,6,12,56,36,20,60
Vienna,6469,4,18,4,14,62,54,8,58
RZ Pellets W,6469,5,14,7,15,47,56,-9,49
Rapid Vienna,6469,6,12,11,13,62,46,16,47
Admira Wacke,6469,7,11,9,16,36,59,-23,42
St. Pölten,6469,8,10,9,17,43,65,-22,39
Mattersburg,6469,9,6,13,17,34,56,-22,31
SV Josko Rie,6469,10,8,7,21,32,57,-25,31
SK Sturm Gra,6470,1,23,5,8,69,30,39,74
FC Salzburg,6470,2,21,6,9,61,32,29,69
SC Rheindorf,6470,3,17,5,14,50,48,2,56
Rapid Vienna,6470,4,15,9,12,59,44,15,54
Vienna,6470,5,16,6,14,58,55,3,54
SV Josko Rie,6470,6,14,5,17,46,48,-2,47
Mattersburg,6470,7,12,8,16,44,53,-9,44
RZ Pellets W,6470,8,10,8,18,43,63,-20,38
St. Pölten,6470,9,9,10,17,47,73,-26,37
Admira Wacke,6470,10,9,6,21,37,68,-31,33
FC Salzburg,6471,1,24,6,6,73,33,40,78
SK Sturm Gra,6471,2,21,6,9,63,33,30,69
SC Rheindorf,6471,3,19,8,9,52,40,12,65
Vienna,6471,4,18,6,12,61,48,13,60
Rapid Vienna,6471,5,15,9,12,55,41,14,54
RZ Pellets W,6471,6,12,8,16,43,53,-10,44
Mattersburg,6471,7,9,9,18,37,56,-19,36
SV Josko Rie,6471,8,9,6,21,35,54,-19,33
Admira Wacke,6471,9,9,6,21,30,62,-32,33
St. Pölten,6471,10,8,8,20,35,64,-29,32
FC Salzburg,6472,1,20,7,9,65,27,38,67
SC Rheindorf,6472,2,19,10,7,63,48,15,67
Vienna,6472,3,21,4,11,68,54,14,67
SK Sturm Gra,6472,4,17,8,11,57,40,17,59
Rapid Vienna,6472,5,16,8,12,59,40,19,56
RZ Pellets W,6472,6,13,10,13,51,55,-4,49
Admira Wacke,6472,7,9,11,16,30,59,-29,38
St. Pölten,6472,8,8,11,17,45,64,-19,35
Mattersburg,6472,9,8,8,20,35,58,-23,32
SV Josko Rie,6472,10,7,7,22,29,57,-28,28
SC Rheindorf,6473,1,20,8,8,56,46,10,68
SK Sturm Gra,6473,2,21,4,11,65,36,29,67
FC Salzburg,6473,3,20,7,9,61,33,28,67
Vienna,6473,4,19,3,14,67,55,12,60
Rapid Vienna,6473,5,13,9,14,47,40,7,48
SV Josko Rie,6473,6,14,5,17,41,47,-6,47
Admira Wacke,6473,7,14,5,17,40,54,-14,47
RZ Pellets W,6473,8,12,6,18,40,56,-16,42
Mattersburg,6473,9,8,8,20,31,51,-20,32
St. Pölten,6473,10,7,9,20,37,67,-30,30
FC Salzburg,6474,1,20,11,5,67,31,36,71
SC Rheindorf,6474,2,20,10,6,61,41,20,70
Rapid Vienna,6474,3,17,12,7,66,39,27,63
Vienna,6474,4,17,6,13,67,56,11,57
SK Sturm Gra,6474,5,16,7,13,65,39,26,55
Admira Wacke,6474,6,10,12,14,35,53,-18,42
SV Josko Rie,6474,7,12,4,20,32,57,-25,40
RZ Pellets W,6474,8,9,9,18,41,63,-22,36
St. Pölten,6474,9,7,10,19,36,68,-32,31
Mattersburg,6474,10,7,9,20,35,58,-23,30
FC Salzburg,6475,1,22,7,7,65,27,38,73
SK Sturm Gra,6475,2,21,6,9,66,33,33,69
Vienna,6475,3,19,7,10,59,45,14,64
SC Rheindorf,6475,4,18,7,11,53,46,7,61
Rapid Vienna,6475,5,14,11,11,60,46,14,53
Admira Wacke,6475,6,14,4,18,41,59,-18,46
RZ Pellets W,6475,7,12,6,18,53,70,-17,42
Mattersburg,6475,8,9,8,19,39,60,-21,35
SV Josko Rie,6475,9,8,8,20,31,52,-21,32
St. Pölten,6475,10,7,8,21,38,67,-29,29
SC Rheindorf,6476,1,23,5,8,66,42,24,74
FC Salzburg,6476,2,22,6,8,69,31,38,72
SK Sturm Gra,6476,3,20,7,9,63,37,26,67
Vienna,6476,4,16,8,12,60,54,6,56
Rapid Vienna,6476,5,13,12,11,58,49,9,51
RZ Pellets W,6476,6,13,10,13,54,53,1,49
SV Josko Rie,6476,7,10,6,20,37,58,-21,36
Admira Wacke,6476,8,9,7,20,30,63,-33,34
St. Pölten,6476,9,8,8,20,40,70,-30,32
Mattersburg,6476,10,7,9,20,38,58,-20,30
FC Salzburg,6477,1,25,5,6,66,26,40,80
SK Sturm Gra,6477,2,21,5,10,65,33,32,68
SC Rheindorf,6477,3,19,5,12,50,42,8,62
Rapid Vienna,6477,4,16,10,10,57,37,20,58
Vienna,6477,5,17,4,15,60,52,8,55
RZ Pellets W,6477,6,14,5,17,46,59,-13,47
SV Josko Rie,6477,7,13,4,19,42,52,-10,43
Admira Wacke,6477,8,10,5,21,40,66,-26,35
St. Pölten,6477,9,8,9,19,45,74,-29,33
Mattersburg,6477,10,6,10,20,37,67,-30,28
FC Salzburg,6478,1,21,9,6,72,32,40,72
SK Sturm Gra,6478,2,20,7,9,65,34,31,67
SC Rheindorf,6478,3,18,9,9,54,38,16,63
Vienna,6478,4,17,8,11,59,49,10,59
RZ Pellets W,6478,5,15,6,15,55,56,-1,51
Rapid Vienna,6478,6,12,11,13,55,50,5,47
Admira Wacke,6478,7,13,4,19,37,60,-23,43
SV Josko Rie,6478,8,11,7,18,31,51,-20,40
Mattersburg,6478,9,8,9,19,37,63,-26,33
St. Pölten,6478,10,6,8,22,33,65,-32,26
FC Salzburg,6479,1,22,7,7,75,36,39,73
SK Sturm Gra,6479,2,22,6,8,65,33,32,72
SC Rheindorf,6479,3,16,6,14,49,50,-1,54
Rapid Vienna,6479,4,14,10,12,60,44,16,52
Vienna,6479,5,15,7,14,58,57,1,52
St. Pölten,6479,6,14,9,13,51,55,-4,51
Admira Wacke,6479,7,13,6,17,37,60,-23,45
RZ Pellets W,6479,8,11,7,18,50,61,-11,40
Mattersburg,6479,9,10,7,19,35,56,-21,37
SV Josko Rie,6479,10,7,7,22,34,62,-28,28
FC Salzburg,6480,1,21,6,9,58,32,26,69
SC Rheindorf,6480,2,21,6,9,62,38,24,69
Vienna,6480,3,17,7,12,63,59,4,58
SK Sturm Gra,6480,4,16,6,14,51,43,8,54
Admira Wacke,6480,5,15,7,14,45,52,-7,52
RZ Pellets W,6480,6,14,7,15,49,51,-2,49
Rapid Vienna,6480,7,11,11,14,51,43,8,44
St. Pölten,6480,8,10,9,17,44,64,-20,39
SV Josko Rie,6480,9,10,6,20,36,54,-18,36
Mattersburg,6480,10,9,7,20,34,57,-23,34
SC Rheindorf,6481,1,21,7,8,55,42,13,70
Vienna,6481,2,20,2,14,61,52,9,62
FC Salzburg,6481,3,17,10,9,64,36,28,61
SK Sturm Gra,6481,4,17,8,11,54,36,18,59
Rapid Vienna,6481,5,14,12,10,60,39,21,54
St. Pölten,6481,6,11,9,16,45,58,-13,42
SV Josko Rie,6481,7,12,5,19,35,54,-19,41
RZ Pellets W,6481,8,10,9,17,47,63,-16,39
Admira Wacke,6481,9,10,8,18,35,58,-23,38
Mattersburg,6481,10,9,8,19,44,62,-18,35
SC Rheindorf,6482,1,23,4,9,63,34,29,73
FC Salzburg,6482,2,20,8,8,65,37,28,68
SK Sturm Gra,6482,3,19,7,10,66,39,27,64
Vienna,6482,4,17,3,16,62,62,0,54
Rapid Vienna,6482,5,12,13,11,57,48,9,49
St. Pölten,6482,6,11,10,15,49,65,-16,43
Mattersburg,6482,7,11,7,18,37,52,-15,40
Admira Wacke,6482,8,11,7,18,39,58,-19,40
RZ Pellets W,6482,9,10,7,19,43,63,-20,37
SV Josko Rie,6482,10,11,4,21,36,59,-23,37
SC Rheindorf,6483,1,20,9,7,58,40,18,69
FC Salzburg,6483,2,19,11,6,67,29,38,68
SK Sturm Gra,6483,3,20,7,9,67,29,38,67
Vienna,6483,4,18,4,14,53,52,1,58
Rapid Vienna,6483,5,13,11,12,53,46,7,50
RZ Pellets W,6483,6,14,6,16,40,49,-9,48
Admira Wacke,6483,7,11,8,17,37,56,-19,41
Mattersburg,6483,8,9,10,17,39,55,-16,37
SV Josko Rie,6483,9,9,5,22,33,59,-26,32
St. Pölten,6483,10,7,9,20,38,70,-32,30
SK Sturm Gra,6484,1,23,5,8,62,29,33,74
FC Salzburg,6484,2,20,8,8,63,32,31,68
Rapid Vienna,6484,3,18,9,9,68,38,30,63
SC Rheindorf,6484,4,18,9,9,53,43,10,63
Vienna,6484,5,17,4,15,61,56,5,55
RZ Pellets W,6484,6,13,9,14,49,56,-7,48
SV Josko Rie,6484,7,11,5,20,42,57,-15,38
Admira Wacke,6484,8,10,4,22,32,66,-34,34
St. Pölten,6484,9,7,10,19,40,66,-26,31
Mattersburg,6484,10,7,9,20,38,65,-27,30
SC Rheindorf,6485,1,22,6,8,60,39,21,72
FC Salzburg,6485,2,21,8,7,69,31,38,71
SK Sturm Gra,6485,3,19,7,10,56,33,23,64
Vienna,6485,4,16,5,15,56,58,-2,53
Rapid Vienna,6485,5,14,9,13,53,45,8,51
RZ Pellets W,6485,6,12,5,19,48,56,-8,41
SV Josko Rie,6485,7,12,4,20,43,57,-14,40
St. Pölten,6485,8,10,9,17,39,61,-22,39
Mattersburg,6485,9,9,10,17,45,57,-12,37
Admira Wacke,6485,10,9,9,18,30,62,-32,36
FC Salzburg,6486,1,21,8,7,64,29,35,71
SC Rheindorf,6486,2,20,11,5,68,46,22,71
Rapid Vienna,6486,3,19,9,8,71,33,38,66
SK Sturm Gra,6486,4,16,5,15,49,45,4,53
Vienna,6486,5,15,7,14,56,51,5,52
RZ Pellets W,6486,6,13,8,15,47,58,-11,47
Admira Wacke,6486,7,10,8,18,33,62,-29,38
St. Pölten,6486,8,9,10,17,47,62,-15,37
SV Josko Rie,6486,9,10,7,19,32,50,-18,37
Mattersburg,6486,10,7,7,22,31,62,-31,28
FC Salzburg,6487,1,20,6,10,67,36,31,66
SC Rheindorf,6487,2,20,6,10,56,42,14,66
Vienna,6487,3,18,4,14,57,55,2,58
SK Sturm Gra,6487,4,15,7,14,50,39,11,52
Rapid Vienna,6487,5,13,11,12,62,42,20,50
SV Josko Rie,6487,6,15,3,18,37,52,-15,48
Admira Wacke,6487,7,13,8,15,38,52,-14,47
St. Pölten,6487,8,11,8,17,44,58,-14,41
RZ Pellets W,6487,9,10,10,16,40,58,-18,40
Mattersburg,6487,10,9,9,18,34,51,-17,36
FC Salzburg,6488,1,20,10,6,65,29,36,70
Vienna,6488,2,21,6,9,64,42,22,69
SK Sturm Gra,6488,3,21,5,10,59,36,23,68
SC Rheindorf,6488,4,19,7,10,56,50,6,64
Admira Wacke,6488,5,13,5,18,41,65,-24,44
Rapid Vienna,6488,6,10,13,13,51,43,8,43
RZ Pellets W,6488,7,10,10,16,41,51,-10,40
SV Josko Rie,6488,8,9,8,19,35,56,-21,35
Mattersburg,6488,9,8,10,18,36,55,-19,34
St. Pölten,6488,10,8,8,20,37,58,-21,32
FC Salzburg,6489,1,22,6,8,64,28,36,72
SK Sturm Gra,6489,2,20,7,9,66,39,27,67
SC Rheindorf,6489,3,19,5,12,59,52,7,62
Vienna,6489,4,18,5,13,67,61,6,59
Rapid Vienna,6489,5,13,11,12,53,43,10,50
Admira Wacke,6489,6,14,5,17,44,57,-13,47
Mattersburg,6489,7,11,9,16,46,55,-9,42
RZ Pellets W,6489,8,10,8,18,44,58,-14,38
SV Josko Rie,6489,9,11,4,21,39,56,-17,37
St. Pölten,6489,10,8,8,20,42,75,-33,32
SC Rheindorf,6490,1,22,8,6,55,33,22,74
FC Salzburg,6490,2,22,7,7,66,26,40,73
SK Sturm Gra,6490,3,20,6,10,61,30,31,66
RZ Pellets W,6490,4,16,9,11,48,45,3,57
Vienna,6490,5,16,4,16,58,56,2,52
Rapid Vienna,6490,6,10,14,12,47,42,5,44
Admira Wacke,6490,7,11,7,18,37,62,-25,40
SV Josko Rie,6490,8,11,4,21,31,55,-24,37
Mattersburg,6490,9,6,11,19,30,53,-23,29
St. Pölten,6490,10,7,8,21,36,67,-31,29
FC Salzburg,6491,1,25,6,5,74,30,44,81
SK Sturm Gra,6491,2,21,6,9,62,29,33,69
SC Rheindorf,6491,3,18,10,8,59,47,12,64
Vienna,6491,4,17,4,15,58,52,6,55
Rapid Vienna,6491,5,11,11,14,54,45,9,44
St. Pölten,6491,6,12,8,16,50,63,-13,44
Admira Wacke,6491,7,13,4,19,35,66,-31,43
RZ Pellets W,6491,8,9,9,18,33,55,-22,36
SV Josko Rie,6491,9,10,5,21,40,58,-18,35
Mattersburg,6491,10,7,11,18,37,57,-20,32
SC Rheindorf,6492,1,21,7,8,57,45,12,70
FC Salzburg,6492,2,20,7,9,65,37,28,67
SK Sturm Gra,6492,3,16,11,9,53,32,21,59
Vienna,6492,4,17,6,13,58,51,7,57
Rapid Vienna,6492,5,13,15,8,57,38,19,54
RZ Pellets W,6492,6,12,9,15,46,53,-7,45
Admira Wacke,6492,7,12,9,15,43,55,-12,45
SV Josko Rie,6492,8,10,5,21,44,64,-20,35
St. Pölten,6492,9,8,10,18,44,64,-20,34
Mattersburg,6492,10,7,9,20,33,61,-28,30
FC Salzburg,6493,1,19,8,9,63,35,28,65
Vienna,6493,2,19,7,10,62,48,14,64
SK Sturm Gra,6493,3,18,8,10,59,34,25,62
SC Rheindorf,6493,4,18,8,10,58,48,10,62
Rapid Vienna,6493,5,12,13,11,51,39,12,49
RZ Pellets W,6493,6,12,10,14,46,52,-6,46
St. Pölten,6493,7,11,9,16,41,56,-15,42
SV Josko Rie,6493,8,10,8,18,32,51,-19,38
Admira Wacke,6493,9,10,7,19,36,60,-24,37
Mattersburg,6493,10,7,10,19,35,60,-25,31
SC Rheindorf,6494,1,20,8,8,53,37,16,68
FC Salzburg,6494,2,20,7,9,61,32,29,67
SK Sturm Gra,6494,3,19,8,9,65,37,28,65
Vienna,6494,4,18,7,11,62,52,10,61
Rapid Vienna,6494,5,15,10,11,59,40,19,55
St. Pölten,6494,6,12,7,17,46,62,-16,43
RZ Pellets W,6494,7,10,8,18,45,59,-14,38
Admira Wacke,6494,8,10,7,19,35,67,-32,37
SV Josko Rie,6494,9,9,7,20,31,54,-23,34
Mattersburg,6494,10,8,9,19,38,55,-17,33
FC Salzburg,6495,1,22,7,7,73,32,41,73
SC Rheindorf,6495,2,18,9,9,60,41,19,63
Rapid Vienna,6495,3,16,10,10,65,36,29,58
SK Sturm Gra,6495,4,17,7,12,51,40,11,58
Vienna,6495,5,17,5,14,61,57,4,56
RZ Pellets W,6495,6,14,6,16,51,60,-9,48
Admira Wacke,6495,7,12,8,16,45,62,-17,44
St. Pölten,6495,8,11,10,15,42,57,-15,43
Mattersburg,6495,9,8,7,21,36,68,-32,31
SV Josko Rie,6495,10,7,7,22,29,60,-31,28
FC Salzburg,6496,1,19,10,7,61,30,31,67
SC Rheindorf,6496,2,20,7,9,49,35,14,67
SK Sturm Gra,6496,3,18,7,11,56,35,21,61
Vienna,6496,4,18,6,12,61,54,7,60
Rapid Vienna,6496,5,16,9,11,65,40,25,57
Admira Wacke,6496,6,12,9,15,38,54,-16,45
RZ Pellets W,6496,7,12,6,18,44,62,-18,42
SV Josko Rie,6496,8,10,7,19,32,48,-16,37
Mattersburg,6496,9,8,9,19,33,56,-23,33
St. Pölten,6496,10,6,12,18,36,61,-25,30
FC Salzburg,6497,1,19,9,8,60,28,32,66
SC Rheindorf,6497,2,20,6,10,58,42,16,66
Vienna,6497,3,19,6,11,66,47,19,63
SK Sturm Gra,6497,4,17,8,11,53,34,19,59
SV Josko Rie,6497,5,15,2,19,38,46,-8,47
Rapid Vienna,6497,6,12,10,14,44,41,3,46
RZ Pellets W,6497,7,13,7,16,40,50,-10,46
Admira Wacke,6497,8,11,6,19,32,68,-36,39
Mattersburg,6497,9,10,8,18,34,53,-19,38
St. Pölten,6497,10,9,8,19,37,53,-16,35
FC Salzburg,6498,1,23,7,6,74,28,46,76
SK Sturm Gra,6498,2,20,4,12,61,41,20,64
SC Rheindorf,6498,3,18,8,10,52,43,9,62
Vienna,6498,4,19,4,13,62,55,7,61
Rapid Vienna,6498,5,13,12,11,52,40,12,51
RZ Pellets W,6498,6,12,7,17,46,58,-12,43
Admira Wacke,6498,7,11,8,17,42,60,-18,41
SV Josko Rie,6498,8,10,6,20,36,61,-25,36
St. Pölten,6498,9,8,11,17,43,59,-16,35
Mattersburg,6498,10,7,11,18,36,59,-23,32
FC Salzburg,6499,1,19,10,7,67,34,33,67
Vienna,6499,2,19,6,11,67,53,14,63
SC Rheindorf,6499,3,18,9,9,54,43,11,63
SK Sturm Gra,6499,4,19,5,12,60,38,22,62
Rapid Vienna,6499,5,16,9,11,63,39,24,57
RZ Pellets W,6499,6,15,4,17,47,56,-9,49
Admira Wacke,6499,7,11,7,18,37,66,-29,40
St. Pölten,6499,8,10,8,18,40,63,-23,38
Mattersburg,6499,9,9,7,20,39,59,-20,34
SV Josko Rie,6499,10,10,3,23,34,57,-23,33
Vienna,6500,1,21,5,10,64,41,23,68
FC Salzburg,6500,2,19,10,7,57,27,30,67
SC Rheindorf,6500,3,20,6,10,54,41,13,66
SK Sturm Gra,6500,4,20,5,11,54,34,20,65
Rapid Vienna,6500,5,12,13,11,48,40,8,49
RZ Pellets W,6500,6,14,6,16,47,55,-8,48
Mattersburg,6500,7,10,10,16,42,53,-11,40
Admira Wacke,6500,8,12,4,20,36,56,-20,40
SV Josko Rie,6500,9,10,5,21,32,55,-23,35
St. Pölten,6500,10,6,8,22,38,70,-32,26
SK Sturm Gra,6501,1,21,7,8,59,30,29,70
SC Rheindorf,6501,2,20,8,8,53,35,18,68
FC Salzburg,6501,3,17,10,9,63,38,25,61
Vienna,6501,4,19,4,13,60,51,9,61
Rapid Vienna,6501,5,11,12,13,52,48,4,45
RZ Pellets W,6501,6,12,7,17,41,50,-9,43
Admira Wacke,6501,7,11,7,18,40,62,-22,40
Mattersburg,6501,8,10,9,17,43,55,-12,39
SV Josko Rie,6501,9,11,5,20,36,57,-21,38
St. Pölten,6501,10,9,9,18,39,60,-21,36
FC Salzburg,6502,1,19,8,9,72,39,33,65
SC Rheindorf,6502,2,19,7,10,55,42,13,64
Rapid Vienna,6502,3,18,9,9,65,40,25,63
SK Sturm Gra,6502,4,17,9,10,51,33,18,60
Vienna,6502,5,18,4,14,62,56,6,58
RZ Pellets W,6502,6,13,8,15,45,53,-8,47
SV Josko Rie,6502,7,14,3,19,42,60,-18,45
Mattersburg,6502,8,11,8,17,41,56,-15,41
Admira Wacke,6502,9,10,6,20,35,58,-23,36
St. Pölten,6502,10,6,8,22,36,67,-31,26
SC Rheindorf,6503,1,21,5,10,65,47,18,68
FC Salzburg,6503,2,19,9,8,66,31,35,66
SK Sturm Gra,6503,3,17,6,13,56,37,19,57
Vienna,6503,4,16,9,11,58,53,5,57
RZ Pellets W,6503,5,15,6,15,48,53,-5,51
Rapid Vienna,6503,6,13,11,12,58,45,13,50
Admira Wacke,6503,7,10,9,17,37,62,-25,39
SV Josko Rie,6503,8,9,10,17,39,57,-18,37
St. Pölten,6503,9,9,10,17,47,69,-22,37
Mattersburg,6503,10,8,11,17,38,58,-20,35
SC Rheindorf,6504,1,20,8,8,53,40,13,68
Vienna,6504,2,20,6,10,66,48,18,66
FC Salzburg,6504,3,17,10,9,67,33,34,61
Rapid Vienna,6504,4,16,11,9,59,36,23,59
SK Sturm Gra,6504,5,17,8,11,57,38,19,59
Admira Wacke,6504,6,12,6,18,34,57,-23,42
Mattersburg,6504,7,10,10,16,39,49,-10,40
RZ Pellets W,6504,8,11,7,18,39,58,-19,40
St. Pölten,6504,9,7,11,18,36,58,-22,32
SV Josko Rie,6504,10,9,5,22,35,68,-33,32
FC Salzburg,6505,1,21,5,10,69,36,33,68
SK Sturm Gra,6505,2,19,6,11,62,38,24,63
Vienna,6505,3,20,3,13,64,50,14,63
SC Rheindorf,6505,4,18,9,9,53,42,11,63
Rapid Vienna,6505,5,16,8,12,60,42,18,56
Admira Wacke,6505,6,15,5,16,40,48,-8,50
SV Josko Rie,6505,7,12,5,19,33,52,-19,41
RZ Pellets W,6505,8,10,8,18,39,59,-20,38
St. Pölten,6505,9,10,8,18,43,64,-21,38
Mattersburg,6505,10,6,9,21,31,63,-32,27
FC Salzburg,6506,1,20,10,6,62,30,32,70
SC Rheindorf,6506,2,20,9,7,61,42,19,69
Rapid Vienna,6506,3,17,9,10,58,38,20,60
Vienna,6506,4,18,5,13,60,51,9,59
SK Sturm Gra,6506,5,17,4,15,56,42,14,55
RZ Pellets W,6506,6,16,5,15,45,45,0,53
Admira Wacke,6506,7,12,6,18,35,57,-22,42
SV Josko Rie,6506,8,10,7,19,39,55,-16,37
Mattersburg,6506,9,8,9,19,30,53,-23,33
St. Pölten,6506,10,6,8,22,38,71,-33,26
FC Salzburg,6507,1,22,7,7,69,28,41,73
SC Rheindorf,6507,2,18,11,7,55,41,14,65
SK Sturm Gra,6507,3,19,7,10,57,31,26,64
Vienna,6507,4,17,6,13,62,57,5,57
Rapid Vienna,6507,5,14,8,14,50,43,7,50
St. Pölten,6507,6,12,10,14,45,53,-8,46
RZ Pellets W,6507,7,12,9,15,47,56,-9,45
Admira Wacke,6507,8,10,6,20,35,58,-23,36
SV Josko Rie,6507,9,9,6,21,32,58,-26,33
Mattersburg,6507,10,8,8,20,34,61,-27,32
Vienna,6508,1,24,4,8,78,41,37,76
SK Sturm Gra,6508,2,20,6,10,58,32,26,66
FC Salzburg,6508,3,20,5,11,62,38,24,65
SC Rheindorf,6508,4,17,6,13,53,50,3,57
Rapid Vienna,6508,5,14,10,12,55,43,12,52
RZ Pellets W,6508,6,13,10,13,45,52,-7,49
Mattersburg,6508,7,12,7,17,41,53,-12,43
Admira Wacke,6508,8,12,6,18,41,59,-18,42
St. Pölten,6508,9,8,8,20,39,68,-29,32
SV Josko Rie,6508,10,7,4,25,36,72,-36,25
SK Sturm Gra,6509,1,23,4,9,67,37,30,73
FC Salzburg,6509,2,22,5,9,67,31,36,71
Vienna,6509,3,20,8,8,70,46,24,68
SC Rheindorf,6509,4,20,7,9,63,48,15,67
Rapid Vienna,6509,5,14,10,12,54,41,13,52
RZ Pellets W,6509,6,12,6,18,38,57,-19,42
SV Josko Rie,6509,7,11,5,20,36,59,-23,38
Admira Wacke,6509,8,10,5,21,34,60,-26,35
Mattersburg,6509,9,8,8,20,38,57,-19,32
St. Pölten,6509,10,8,6,22,36,67,-31,30
FC Salzburg,6510,1,24,5,7,65,29,36,77
SK Sturm Gra,6510,2,20,6,10,64,36,28,66
Vienna,6510,3,20,3,13,68,54,14,63
SC Rheindorf,6510,4,18,9,9,56,43,13,63
Rapid Vienna,6510,5,14,11,11,58,38,20,53
RZ Pellets W,6510,6,15,7,14,47,53,-6,52
Admira Wacke,6510,7,10,5,21,40,66,-26,35
Mattersburg,6510,8,9,7,20,39,62,-23,34
SV Josko Rie,6510,9,9,5,22,32,61,-29,32
St. Pölten,6510,10,7,10,19,36,63,-27,31
SK Sturm Gra,6511,1,22,4,10,61,28,33,70
SC Rheindorf,6511,2,21,7,8,56,37,19,70
Vienna,6511,3,20,7,9,63,46,17,67
FC Salzburg,6511,4,19,5,12,63,35,28,62
Rapid Vienna,6511,5,15,7,14,57,43,14,52
RZ Pellets W,6511,6,15,6,15,53,59,-6,51
SV Josko Rie,6511,7,14,4,18,38,52,-14,46
Admira Wacke,6511,8,10,7,19,31,64,-33,37
Mattersburg,6511,9,7,9,20,37,64,-27,30
St. Pölten,6511,10,5,8,23,41,72,-31,23
SC Rheindorf,6512,1,22,6,8,57,38,19,72
Vienna,6512,2,22,5,9,77,51,26,71
FC Salzburg,6512,3,16,10,10,61,38,23,58
SK Sturm Gra,6512,4,17,6,13,57,39,18,57
Rapid Vienna,6512,5,13,12,11,58,41,17,51
RZ Pellets W,6512,6,13,8,15,43,52,-9,47
Admira Wacke,6512,7,12,7,17,36,56,-20,43
SV Josko Rie,6512,8,10,5,21,29,58,-29,35
St. Pölten,6512,9,8,10,18,40,62,-22,34
Mattersburg,6512,10,7,11,18,37,60,-23,32
FC Salzburg,6513,1,21,8,7,62,26,36,71
SC Rheindorf,6513,2,19,8,9,53,39,14,65
SK Sturm Gra,6513,3,16,11,9,59,41,18,59
Vienna,6513,4,17,7,12,59,48,11,58
Rapid Vienna,6513,5,12,14,10,53,38,15,50
SV Josko Rie,6513,6,11,7,18,41,53,-12,40
Mattersburg,6513,7,11,7,18,44,58,-14,40
RZ Pellets W,6513,8,10,10,16,44,65,-21,40
Admira Wacke,6513,9,10,8,18,35,57,-22,38
St. Pölten,6513,10,7,12,17,42,67,-25,33
FC Salzburg,6514,1,21,6,9,61,36,25,69
SK Sturm Gra,6514,2,21,5,10,58,26,32,68
SC Rheindorf,6514,3,20,7,9,56,36,20,67
Vienna,6514,4,16,6,14,67,56,11,54
RZ Pellets W,6514,5,15,6,15,44,53,-9,51
Rapid Vienna,6514,6,11,11,14,44,38,6,44
Admira Wacke,6514,7,12,8,16,40,55,-15,44
SV Josko Rie,6514,8,9,9,18,31,55,-24,36
Mattersburg,6514,9,9,8,19,36,58,-22,35
St. Pölten,6514,10,8,10,18,40,64,-24,34
FC Salzburg,6515,1,19,10,7,63,30,33,67
Vienna,6515,2,20,5,11,64,51,13,65
SK Sturm Gra,6515,3,18,8,10,57,33,24,62
SC Rheindorf,6515,4,16,8,12,55,48,7,56
Rapid Vienna,6515,5,13,15,8,52,36,16,54
RZ Pellets W,6515,6,11,9,16,39,54,-15,42
St. Pölten,6515,7,9,12,15,41,58,-17,39
SV Josko Rie,6515,8,11,6,19,38,59,-21,39
Mattersburg,6515,9,10,8,18,43,56,-13,38
Admira Wacke,6515,10,10,5,21,32,59,-27,35
SK Sturm Gra,6516,1,24,4,8,67,33,34,76
FC Salzburg,6516,2,18,6,12,60,36,24,60
SC Rheindorf,6516,3,17,7,12,54,54,0,58
Rapid Vienna,6516,4,15,10,11,63,40,23,55
Vienna,6516,5,16,7,13,62,62,0,55
RZ Pellets W,6516,6,14,8,14,51,56,-5,50
SV Josko Rie,6516,7,11,10,15,39,45,-6,43
Admira Wacke,6516,8,12,4,20,35,63,-28,40
St. Pölten,6516,9,8,9,19,43,62,-19,33
Mattersburg,6516,10,8,9,19,35,58,-23,33
FC Salzburg,6517,1,22,9,5,67,28,39,75
SK Sturm Gra,6517,2,21,4,11,57,35,22,67
SC Rheindorf,6517,3,18,11,7,63,45,18,65
Vienna,6517,4,16,5,15,57,52,5,53
Rapid Vienna,6517,5,14,10,12,57,45,12,52
RZ Pellets W,6517,6,12,8,16,41,53,-12,44
Admira Wacke,6517,7,12,8,16,41,59,-18,44
SV Josko Rie,6517,8,11,4,21,32,57,-25,37
St. Pölten,6517,9,6,14,16,45,65,-20,32
Mattersburg,6517,10,6,11,19,35,56,-21,29
SC Rheindorf,6518,1,21,6,9,62,46,16,69
Vienna,6518,2,21,5,10,69,46,23,68
SK Sturm Gra,6518,3,19,8,9,61,33,28,65
FC Salzburg,6518,4,18,9,9,61,40,21,63
RZ Pellets W,6518,5,15,8,13,50,53,-3,53
Rapid Vienna,6518,6,13,11,12,55,44,11,50
St. Pölten,6518,7,10,9,17,41,64,-23,39
SV Josko Rie,6518,8,11,4,21,36,55,-19,37
Admira Wacke,6518,9,10,6,20,38,65,-27,36
Mattersburg,6518,10,6,6,24,34,61,-27,24
SC Rheindorf,6519,1,20,8,8,54,41,13,68
FC Salzburg,6519,2,17,11,8,56,34,22,62
SK Sturm Gra,6519,3,16,12,8,54,30,24,60
Vienna,6519,4,17,9,10,60,46,14,60
Rapid Vienna,6519,5,14,13,9,62,37,25,55
RZ Pellets W,6519,6,14,10,12,48,53,-5,52
Admira Wacke,6519,7,10,10,16,30,52,-22,40
St. Pölten,6519,8,8,11,17,44,66,-22,35
SV Josko Rie,6519,9,9,5,22,30,58,-28,32
Mattersburg,6519,10,7,7,22,38,59,-21,28
SC Rheindorf,6520,1,23,6,7,62,35,27,75
FC Salzburg,6520,2,20,10,6,61,30,31,70
SK Sturm Gra,6520,3,18,9,9,57,35,22,63
Rapid Vienna,6520,4,15,12,9,63,40,23,57
Vienna,6520,5,16,5,15,60,56,4,53
St. Pölten,6520,6,12,8,16,47,60,-13,44
RZ Pellets W,6520,7,10,10,16,48,61,-13,40
SV Josko Rie,6520,8,11,3,22,33,56,-23,36
Mattersburg,6520,9,8,9,19,35,55,-20,33
Admira Wacke,6520,10,8,6,22,26,64,-38,30
FC Salzburg,6521,1,23,6,7,73,28,45,75
SC Rheindorf,6521,2,19,9,8,53,41,12,66
SK Sturm Gra,6521,3,18,6,12,59,37,22,60
Vienna,6521,4,17,6,13,61,58,3,57
Rapid Vienna,6521,5,14,12,10,57,40,17,54
RZ Pellets W,6521,6,12,9,15,48,58,-10,45
Mattersburg,6521,7,10,12,14,41,53,-12,42
SV Josko Rie,6521,8,11,4,21,37,62,-25,37
St. Pölten,6521,9,9,8,19,46,67,-21,35
Admira Wacke,6521,10,8,6,22,36,67,-31,30
FC Salzburg,6522,1,22,7,7,68,31,37,73
SC Rheindorf,6522,2,22,5,9,64,45,19,71
Vienna,6522,3,17,6,13,60,55,5,57
SK Sturm Gra,6522,4,16,7,13,51,35,16,55
Rapid Vienna,6522,5,12,13,11,58,40,18,49
Admira Wacke,6522,6,12,8,16,35,55,-20,44
SV Josko Rie,6522,7,13,4,19,39,53,-14,43
RZ Pellets W,6522,8,11,8,17,43,53,-10,41
St. Pölten,6522,9,9,11,16,45,71,-26,38
Mattersburg,6522,10,7,9,20,39,64,-25,30
SK Sturm Gra,6523,1,20,7,9,62,35,27,67
Vienna,6523,2,20,7,9,66,45,21,67
FC Salzburg,6523,3,19,9,8,58,26,32,66
SC Rheindorf,6523,4,18,8,10,53,44,9,62
Rapid Vienna,6523,5,12,12,12,55,40,15,48
RZ Pellets W,6523,6,12,7,17,37,54,-17,43
St. Pölten,6523,7,10,11,15,43,54,-11,41
Mattersburg,6523,8,9,9,18,36,57,-21,36
SV Josko Rie,6523,9,10,5,21,32,60,-28,35
Admira Wacke,6523,10,9,7,20,31,58,-27,34
SK Sturm Gra,6524,1,22,7,7,55,22,33,73
FC Salzburg,6524,2,20,10,6,67,29,38,70
Vienna,6524,3,19,7,10,59,42,17,64
Rapid Vienna,6524,4,15,14,7,56,34,22,59
SC Rheindorf,6524,5,16,6,14,47,49,-2,54
SV Josko Rie,6524,6,12,9,15,34,44,-10,45
Admira Wacke,6524,7,12,6,18,43,61,-18,42
RZ Pellets W,6524,8,8,9,19,43,68,-25,33
Mattersburg,6524,9,6,11,19,33,59,-26,29
St. Pölten,6524,10,5,11,20,38,67,-29,26
FC Salzburg,6525,1,20,9,7,64,28,36,69
SC Rheindorf,6525,2,17,12,7,51,42,9,63
SK Sturm Gra,6525,3,19,5,12,60,31,29,62
Vienna,6525,4,17,7,12,60,61,-1,58
Rapid Vienna,6525,5,13,11,12,47,39,8,50
RZ Pellets W,6525,6,14,8,14,51,50,1,50
Admira Wacke,6525,7,11,7,18,35,55,-20,40
SV Josko Rie,6525,8,10,7,19,36,56,-20,37
Mattersburg,6525,9,8,11,17,39,53,-14,35
St. Pölten,6525,10,8,9,19,36,64,-28,33
FC Salzburg,6526,1,24,5,7,67,31,36,77
SC Rheindorf,6526,2,19,7,10,57,42,15,64
SK Sturm Gra,6526,3,19,4,13,55,36,19,61
Vienna,6526,4,18,4,14,63,54,9,58
Rapid Vienna,6526,5,15,9,12,53,39,14,54
Admira Wacke,6526,6,17,3,16,42,53,-11,54
Mattersburg,6526,7,12,8,16,41,51,-10,44
RZ Pellets W,6526,8,10,7,19,41,58,-17,37
SV Josko Rie,6526,9,9,5,22,30,60,-30,32
St. Pölten,6526,10,6,10,20,37,62,-25,28
Vienna,6527,1,21,4,11,68,45,23,67
FC Salzburg,6527,2,18,12,6,56,25,31,66
SC Rheindorf,6527,3,17,8,11,53,51,2,59
SK Sturm Gra,6527,4,16,9,11,51,33,18,57
Rapid Vienna,6527,5,13,9,14,49,40,9,48
RZ Pellets W,6527,6,12,7,17,39,55,-16,43
Admira Wacke,6527,7,11,10,15,35,52,-17,43
SV Josko Rie,6527,8,12,6,18,33,45,-12,42
Mattersburg,6527,9,9,10,17,41,54,-13,37
St. Pölten,6527,10,8,11,17,37,62,-25,35
FC Salzburg,6528,1,23,7,6,72,32,40,76
SK Sturm Gra,6528,2,19,7,10,61,33,28,64
Vienna,6528,3,17,7,12,56,52,4,58
SC Rheindorf,6528,4,15,10,11,50,42,8,55
Rapid Vienna,6528,5,14,11,11,55,37,18,53
RZ Pellets W,6528,6,15,7,14,51,54,-3,52
SV Josko Rie,6528,7,11,7,18,40,58,-18,40
St. Pölten,6528,8,10,7,19,41,66,-25,37
Admira Wacke,6528,9,10,6,20,34,63,-29,36
Mattersburg,6528,10,8,7,21,41,64,-23,31
SK Sturm Gra,6529,1,23,6,7,73,30,43,75
FC Salzburg,6529,2,22,8,6,73,32,41,74
Vienna,6529,3,17,8,11,62,50,12,59
SC Rheindorf,6529,4,16,9,11,50,49,1,57
Rapid Vienna,6529,5,14,11,11,59,39,20,53
Admira Wacke,6529,6,12,8,16,43,62,-19,44
RZ Pellets W,6529,7,12,6,18,42,56,-14,42
SV Josko Rie,6529,8,10,4,22,29,53,-24,34
Mattersburg,6529,9,8,8,20,38,63,-25,32
St. Pölten,6529,10,8,8,20,31,66,-35,32
FC Salzburg,6530,1,22,5,9,69,38,31,71
SC Rheindorf,6530,2,18,7,11,57,47,10,61
SK Sturm Gra,6530,3,17,9,10,59,39,20,60
Vienna,6530,4,18,4,14,55,52,3,58
Rapid Vienna,6530,5,15,11,10,58,42,16,56
RZ Pellets W,6530,6,14,11,11,55,52,3,53
SV Josko Rie,6530,7,12,5,19,39,54,-15,41
Admira Wacke,6530,8,11,6,19,31,55,-24,39
St. Pölten,6530,9,8,8,20,37,61,-24,32
Mattersburg,6530,10,7,10,19,34,54,-20,31
FC Salzburg,6531,1,19,7,10,65,35,30,64
SC Rheindorf,6531,2,16,13,7,55,46,9,61
SK Sturm Gra,6531,3,16,12,8,54,34,20,60
Vienna,6531,4,16,7,13,62,59,3,55
Rapid Vienna,6531,5,13,14,9,52,33,19,53
Admira Wacke,6531,6,13,9,14,42,56,-14,48
RZ Pellets W,6531,7,11,9,16,38,51,-13,42
SV Josko Rie,6531,8,11,6,19,37,58,-21,39
Mattersburg,6531,9,8,11,17,35,47,-12,35
St. Pölten,6531,10,8,10,18,39,60,-21,34
FC Salzburg,6532,1,20,10,6,63,28,35,70
SK Sturm Gra,6532,2,20,6,10,55,30,25,66
SC Rheindorf,6532,3,19,8,9,50,38,12,65
Vienna,6532,4,17,6,13,56,57,-1,57
Rapid Vienna,6532,5,13,13,10,52,40,12,52
Admira Wacke,6532,6,12,6,18,39,56,-17,42
RZ Pellets W,6532,7,10,7,19,41,57,-16,37
SV Josko Rie,6532,8,10,7,19,39,56,-17,37
St. Pölten,6532,9,9,10,17,42,61,-19,37
Mattersburg,6532,10,7,13,16,36,50,-14,34
Vienna,6533,1,23,4,9,62,44,18,73
FC Salzburg,6533,2,22,6,8,62,29,33,72
SC Rheindorf,6533,3,20,5,11,57,40,17,65
SK Sturm Gra,6533,4,18,6,12,52,33,19,60
Rapid Vienna,6533,5,13,11,12,52,39,13,50
RZ Pellets W,6533,6,13,7,16,43,48,-5,46
SV Josko Rie,6533,7,10,9,17,33,47,-14,39
Admira Wacke,6533,8,11,4,21,35,63,-28,37
St. Pölten,6533,9,9,9,18,38,60,-22,36
Mattersburg,6533,10,6,9,21,28,59,-31,27
FC Salzburg,6534,1,19,10,7,69,31,38,67
SK Sturm Gra,6534,2,19,8,9,55,32,23,65
SC Rheindorf,6534,3,17,13,6,56,40,16,64
Vienna,6534,4,17,6,13,61,56,5,57
Rapid Vienna,6534,5,15,9,12,56,40,16,54
RZ Pellets W,6534,6,12,7,17,44,56,-12,43
St. Pölten,6534,7,11,9,16,52,61,-9,42
SV Josko Rie,6534,8,11,7,18,33,47,-14,40
Admira Wacke,6534,9,10,6,20,30,56,-26,36
Mattersburg,6534,10,8,7,21,34,71,-37,31
FC Salzburg,6535,1,24,7,5,74,31,43,79
SC Rheindorf,6535,2,21,6,9,52,37,15,69
SK Sturm Gra,6535,3,19,4,13,58,35,23,61
Vienna,6535,4,17,6,13,65,52,13,57
RZ Pellets W,6535,5,14,6,16,47,53,-6,48
Rapid Vienna,6535,6,12,8,16,54,48,6,44
Mattersburg,6535,7,11,8,17,42,53,-11,41
St. Pölten,6535,8,11,8,17,45,62,-17,41
SV Josko Rie,6535,9,9,7,20,31,61,-30,34
Admira Wacke,6535,10,9,6,21,27,63,-36,33
SC Rheindorf,6536,1,21,8,7,57,39,18,71
FC Salzburg,6536,2,18,10,8,68,39,29,64
SK Sturm Gra,6536,3,17,8,11,58,36,22,59
Rapid Vienna,6536,4,15,13,8,59,35,24,58
Vienna,6536,5,18,4,14,64,62,2,58
RZ Pellets W,6536,6,13,6,17,43,55,-12,45
St. Pölten,6536,7,10,11,15,41,63,-22,41
Admira Wacke,6536,8,10,8,18,36,54,-18,38
SV Josko Rie,6536,9,8,9,19,33,54,-21,33
Mattersburg,6536,10,7,9,20,38,60,-22,30
FC Salzburg,6537,1,22,7,7,66,29,37,73
SK Sturm Gra,6537,2,20,6,10,58,36,22,66
Vienna,6537,3,18,7,11,59,50,9,61
SC Rheindorf,6537,4,16,7,13,52,43,9,55
Rapid Vienna,6537,5,13,9,14,56,47,9,48
Admira Wacke,6537,6,12,7,17,36,61,-25,43
Mattersburg,6537,7,11,9,16,45,50,-5,42
SV Josko Rie,6537,8,11,6,19,36,53,-17,39
RZ Pellets W,6537,9,10,9,17,43,65,-22,39
St. Pölten,6537,10,8,11,17,42,59,-17,35
FC Salzburg,6538,1,24,6,6,76,33,43,78
SC Rheindorf,6538,2,18,8,10,49,37,12,62
Vienna,6538,3,17,7,12,66,52,14,58
Rapid Vienna,6538,4,15,11,10,56,37,19,56
SK Sturm Gra,6538,5,16,7,13,53,42,11,55
Mattersburg,6538,6,11,9,16,37,50,-13,42
Admira Wacke,6538,7,12,6,18,33,56,-23,42
RZ Pellets W,6538,8,11,8,17,43,60,-17,41
SV Josko Rie,6538,9,10,4,22,35,57,-22,34
St. Pölten,6538,10,8,10,18,41,65,-24,34
FC Salzburg,6539,1,23,6,7,72,33,39,75
SK Sturm Gra,6539,2,20,7,9,62,36,26,67
SC Rheindorf,6539,3,19,8,9,57,41,16,65
Vienna,6539,4,18,5,13,63,53,10,59
Rapid Vienna,6539,5,15,11,10,58,40,18,56
St. Pölten,6539,6,11,10,15,51,60,-9,43
RZ Pellets W,6539,7,11,9,16,45,56,-11,42
SV Josko Rie,6539,8,10,7,19,36,57,-21,37
Admira Wacke,6539,9,9,5,22,36,72,-36,32
Mattersburg,6539,10,7,6,23,32,64,-32,27
SK Sturm Gra,6540,1,20,6,10,57,39,18,66
FC Salzburg,6540,2,18,10,8,59,34,25,64
Vienna,6540,3,20,2,14,69,51,18,62
Rapid Vienna,6540,4,17,10,9,63,35,28,61
SC Rheindorf,6540,5,16,9,11,56,48,8,57
RZ Pellets W,6540,6,17,5,14,56,58,-2,56
SV Josko Rie,6540,7,12,5,19,42,51,-9,41
Admira Wacke,6540,8,10,6,20,37,64,-27,36
Mattersburg,6540,9,8,9,19,34,58,-24,33
St. Pölten,6540,10,7,8,21,45,80,-35,29
FC Salzburg,6541,1,23,6,7,73,30,43,75
SK Sturm Gra,6541,2,20,6,10,59,37,22,66
Vienna,6541,3,21,3,12,64,51,13,66
SC Rheindorf,6541,4,18,7,11,59,41,18,61
Rapid Vienna,6541,5,14,13,9,55,42,13,55
RZ Pellets W,6541,6,14,6,16,48,52,-4,48
St. Pölten,6541,7,11,8,17,39,58,-19,41
SV Josko Rie,6541,8,10,5,21,35,61,-26,35
Admira Wacke,6541,9,8,7,21,35,69,-34,31
Mattersburg,6541,10,6,9,21,35,61,-26,27
SC Rheindorf,6542,1,23,6,7,68,41,27,75
FC Salzburg,6542,2,19,9,8,67,37,30,66
SK Sturm Gra,6542,3,18,7,11,65,45,20,61
Vienna,6542,4,17,7,12,75,66,9,58
Rapid Vienna,6542,5,15,9,12,60,37,23,54
SV Josko Rie,6542,6,13,5,18,46,59,-13,44
RZ Pellets W,6542,7,12,8,16,52,68,-16,44
Admira Wacke,6542,8,12,7,17,39,59,-20,43
Mattersburg,6542,9,8,7,21,39,66,-27,31
St. Pölten,6542,10,7,7,22,45,78,-33,28
FC Salzburg,6543,1,21,8,7,72,34,38,71
SK Sturm Gra,6543,2,19,6,11,55,35,20,63
SC Rheindorf,6543,3,19,5,12,55,47,8,62
Vienna,6543,4,18,6,12,63,50,13,60
Rapid Vienna,6543,5,15,8,13,59,48,11,53
RZ Pellets W,6543,6,14,7,15,48,53,-5,49
St. Pölten,6543,7,10,10,16,37,52,-15,40
SV Josko Rie,6543,8,12,2,22,36,57,-21,38
Admira Wacke,6543,9,10,6,20,33,59,-26,36
Mattersburg,6543,10,9,8,19,39,62,-23,35
FC Salzburg,6544,1,22,6,8,72,31,41,72
SC Rheindorf,6544,2,20,8,8,57,41,16,68
Vienna,6544,3,19,5,12,64,51,13,62
Rapid Vienna,6544,4,15,12,9,58,36,22,57
SK Sturm Gra,6544,5,17,5,14,50,39,11,56
RZ Pellets W,6544,6,14,7,15,48,52,-4,49
Admira Wacke,6544,7,12,4,20,40,66,-26,40
St. Pölten,6544,8,10,7,19,43,70,-27,37
SV Josko Rie,6544,9,10,6,20,37,58,-21,36
Mattersburg,6544,10,8,6,22,36,61,-25,30
SK Sturm Gra,6545,1,21,7,8,63,29,34,70
FC Salzburg,6545,2,20,7,9,62,32,30,67
Vienna,6545,3,20,3,13,61,59,2,63
SC Rheindorf,6545,4,18,6,12,51,41,10,60
Rapid Vienna,6545,5,12,13,11,51,43,8,49
Admira Wacke,6545,6,11,9,16,41,60,-19,42
RZ Pellets W,6545,7,10,11,15,47,51,-4,41
SV Josko Rie,6545,8,12,5,19,38,57,-19,41
Mattersburg,6545,9,9,8,19,36,58,-22,35
St. Pölten,6545,10,8,9,19,45,65,-20,33
FC Salzburg,6546,1,23,8,5,67,29,38,77
SK Sturm Gra,6546,2,20,5,11,52,31,21,65
Vienna,6546,3,21,2,13,67,53,14,65
SC Rheindorf,6546,4,19,8,9,56,42,14,65
Rapid Vienna,6546,5,14,8,14,59,45,14,50
RZ Pellets W,6546,6,13,8,15,50,59,-9,47
St. Pölten,6546,7,10,11,15,47,55,-8,41
Admira Wacke,6546,8,9,8,19,38,67,-29,35
SV Josko Rie,6546,9,9,5,22,34,61,-27,32
Mattersburg,6546,10,7,7,22,29,57,-28,28
FC Salzburg,6547,1,24,4,8,74,34,40,76
SK Sturm Gra,6547,2,20,7,9,62,35,27,67
SC Rheindorf,6547,3,19,6,11,60,43,17,63
Vienna,6547,4,19,6,11,62,49,13,63
Rapid Vienna,6547,5,11,12,13,48,44,4,45
Mattersburg,6547,6,12,6,18,41,52,-11,42
RZ Pellets W,6547,7,12,6,18,41,54,-13,42
St. Pölten,6547,8,10,9,17,43,65,-22,39
SV Josko Rie,6547,9,11,4,21,32,57,-25,37
Admira Wacke,6547,10,10,4,22,36,66,-30,34
FC Salzburg,6548,1,20,9,7,61,31,30,69
SK Sturm Gra,6548,2,18,9,9,57,29,28,63
SC Rheindorf,6548,3,19,5,12,52,42,10,62
Vienna,6548,4,19,4,13,63,53,10,61
Rapid Vienna,6548,5,14,10,12,56,39,17,52
RZ Pellets W,6548,6,12,7,17,45,60,-15,43
Mattersburg,6548,7,11,9,16,36,49,-13,42
St. Pölten,6548,8,10,9,17,49,62,-13,39
SV Josko Rie,6548,9,10,7,19,37,60,-23,37
Admira Wacke,6548,10,10,5,21,31,62,-31,35
FC Salzburg,6549,1,21,9,6,68,30,38,72
SK Sturm Gra,6549,2,19,8,9,58,33,25,65
SC Rheindorf,6549,3,18,11,7,56,41,15,65
Vienna,6549,4,17,5,14,62,65,-3,56
Rapid Vienna,6549,5,12,11,13,54,45,9,47
RZ Pellets W,6549,6,13,7,16,48,49,-1,46
St. Pölten,6549,7,11,9,16,45,64,-19,42
Admira Wacke,6549,8,11,6,19,37,64,-27,39
Mattersburg,6549,9,8,10,18,41,56,-15,34
SV Josko Rie,6549,10,9,6,21,43,65,-22,33
FC Salzburg,6550,1,22,8,6,69,30,39,74
SC Rheindorf,6550,2,20,5,11,64,43,21,65
SK Sturm Gra,6550,3,18,8,10,55,34,21,62
Vienna,6550,4,18,4,14,63,56,7,58
Rapid Vienna,6550,5,10,15,11,49,41,8,45
SV Josko Rie,6550,6,12,7,17,36,51,-15,43
RZ Pellets W,6550,7,11,9,16,40,57,-17,42
St. Pölten,6550,8,10,10,16,44,62,-18,40
Mattersburg,6550,9,10,8,18,40,59,-19,38
Admira Wacke,6550,10,8,8,20,33,60,-27,32
FC Salzburg,6551,1,21,9,6,68,30,38,72
SK Sturm Gra,6551,2,21,5,10,63,35,28,68
Vienna,6551,3,21,3,12,69,55,14,66
SC Rheindorf,6551,4,18,10,8,56,45,11,64
RZ Pellets W,6551,5,14,8,14,50,50,0,50
Rapid Vienna,6551,6,10,13,13,48,41,7,43
St. Pölten,6551,7,9,13,14,46,63,-17,40
Admira Wacke,6551,8,10,5,21,38,69,-31,35
Mattersburg,6551,9,8,9,19,38,55,-17,33
SV Josko Rie,6551,10,7,7,22,31,64,-33,28
SC Rheindorf,6552,1,20,8,8,57,43,14,68
FC Salzburg,6552,2,20,7,9,63,30,33,67
SK Sturm Gra,6552,3,19,6,11,60,36,24,63
Vienna,6552,4,18,3,15,60,59,1,57
St. Pölten,6552,5,14,7,15,51,62,-11,49
Admira Wacke,6552,6,14,6,16,40,57,-17,48
Rapid Vienna,6552,7,11,13,12,53,42,11,46
RZ Pellets W,6552,8,13,6,17,47,54,-7,45
SV Josko Rie,6552,9,9,7,20,37,55,-18,34
Mattersburg,6552,10,5,11,20,35,65,-30,26
FC Salzburg,6553,1,22,7,7,65,30,35,73
Vienna,6553,2,19,7,10,70,54,16,64
SC Rheindorf,6553,3,19,6,11,58,48,10,63
Rapid Vienna,6553,4,17,9,10,65,38,27,60
SK Sturm Gra,6553,5,18,6,12,54,34,20,60
Admira Wacke,6553,6,12,6,18,38,59,-21,42
SV Josko Rie,6553,7,11,6,19,36,54,-18,39
RZ Pellets W,6553,8,11,6,19,46,67,-21,39
St. Pölten,6553,9,8,9,19,42,69,-27,33
Mattersburg,6553,10,6,12,18,37,58,-21,30
SK Sturm Gra,6554,1,19,7,10,53,35,18,64
FC Salzburg,6554,2,17,11,8,59,36,23,62
SC Rheindorf,6554,3,16,10,10,55,48,7,58
Vienna,6554,4,14,12,10,53,44,9,54
RZ Pellets W,6554,5,15,9,12,58,57,1,54
Admira Wacke,6554,6,14,8,14,46,50,-4,50
Rapid Vienna,6554,7,12,11,13,54,41,13,47
Mattersburg,6554,8,12,10,14,45,48,-3,46
St. Pölten,6554,9,6,12,18,33,62,-29,30
SV Josko Rie,6554,10,7,6,23,24,59,-35,27
Vienna,6555,1,22,3,11,66,50,16,69
SK Sturm Gra,6555,2,21,5,10,66,33,33,68
SC Rheindorf,6555,3,19,6,11,51,41,10,63
FC Salzburg,6555,4,19,4,13,61,36,25,61
SV Josko Rie,6555,5,14,6,16,45,54,-9,48
Rapid Vienna,6555,6,12,10,14,48,38,10,46
RZ Pellets W,6555,7,12,5,19,42,63,-21,41
Admira Wacke,6555,8,12,5,19,35,58,-23,41
St. Pölten,6555,9,10,8,18,41,60,-19,38
Mattersburg,6555,10,9,8,19,35,57,-22,35
Vienna,6556,1,21,7,8,63,41,22,70
FC Salzburg,6556,2,20,8,8,67,34,33,68
SK Sturm Gra,6556,3,17,10,9,55,32,23,61
SC Rheindorf,6556,4,17,9,10,56,51,5,60
Rapid Vienna,6556,5,14,12,10,53,37,16,54
RZ Pellets W,6556,6,12,7,17,44,58,-14,43
SV Josko Rie,6556,7,11,9,16,39,48,-9,42
Admira Wacke,6556,8,10,10,16,31,50,-19,40
Mattersburg,6556,9,6,11,19,38,64,-26,29
St. Pölten,6556,10,5,11,20,35,66,-31,26
FC Salzburg,6557,1,23,5,8,80,36,44,74
SC Rheindorf,6557,2,22,7,7,59,39,20,73
SK Sturm Gra,6557,3,17,7,12,51,37,14,58
Vienna,6557,4,17,3,16,62,59,3,54
Rapid Vienna,6557,5,13,11,12,57,42,15,50
Admira Wacke,6557,6,12,7,17,40,55,-15,43
Mattersburg,6557,7,12,6,18,48,59,-11,42
RZ Pellets W,6557,8,11,7,18,51,66,-15,40
SV Josko Rie,6557,9,11,7,18,37,59,-22,40
St. Pölten,6557,10,7,10,19,37,70,-33,31
Vienna,6558,1,22,4,10,63,42,21,70
SC Rheindorf,6558,2,19,9,8,56,40,16,66
FC Salzburg,6558,3,19,6,11,60,38,22,63
SK Sturm Gra,6558,4,18,5,13,60,43,17,59
Rapid Vienna,6558,5,14,12,10,58,41,17,54
Admira Wacke,6558,6,13,5,18,45,64,-19,44
Mattersburg,6558,7,10,11,15,42,51,-9,41
RZ Pellets W,6558,8,11,7,18,46,60,-14,40
St. Pölten,6558,9,10,10,16,51,70,-19,40
SV Josko Rie,6558,10,7,5,24,30,62,-32,26
FC Salzburg,6559,1,21,7,8,60,33,27,70
SC Rheindorf,6559,2,20,8,8,53,38,15,68
SK Sturm Gra,6559,3,19,8,9,59,33,26,65
Rapid Vienna,6559,4,16,10,10,65,38,27,58
Vienna,6559,5,17,7,12,67,60,7,58
RZ Pellets W,6559,6,13,8,15,46,54,-8,47
SV Josko Rie,6559,7,10,7,19,36,51,-15,37
Admira Wacke,6559,8,9,7,20,35,62,-27,34
St. Pölten,6559,9,7,11,18,34,61,-27,32
Mattersburg,6559,10,7,9,20,35,60,-25,30
SK Sturm Gra,6560,1,22,5,9,68,38,30,71
FC Salzburg,6560,2,19,7,10,65,34,31,64
SC Rheindorf,6560,3,19,7,10,58,47,11,64
Vienna,6560,4,18,3,15,62,58,4,57
Rapid Vienna,6560,5,15,9,12,58,42,16,54
Admira Wacke,6560,6,16,3,17,43,56,-13,51
RZ Pellets W,6560,7,15,5,16,51,57,-6,50
SV Josko Rie,6560,8,13,2,21,34,47,-13,41
St. Pölten,6560,9,9,6,21,41,69,-28,33
Mattersburg,6560,10,8,5,23,30,62,-32,29
FC Salzburg,6561,1,20,6,10,65,37,28,66
SK Sturm Gra,6561,2,20,6,10,66,39,27,66
Vienna,6561,3,18,10,8,63,48,15,64
SC Rheindorf,6561,4,15,11,10,53,49,4,56
Rapid Vienna,6561,5,13,13,10,60,48,12,52
RZ Pellets W,6561,6,13,9,14,46,52,-6,48
Admira Wacke,6561,7,13,8,15,38,55,-17,47
St. Pölten,6561,8,10,9,17,42,59,-17,39
SV Josko Rie,6561,9,9,6,21,30,53,-23,33
Mattersburg,6561,10,6,8,22,34,57,-23,26
SK Sturm Gra,6562,1,22,4,10,70,33,37,70
FC Salzburg,6562,2,21,6,9,70,33,37,69
Vienna,6562,3,20,6,10,64,48,16,66
SC Rheindorf,6562,4,19,7,10,53,42,11,64
Rapid Vienna,6562,5,16,10,10,60,41,19,58
RZ Pellets W,6562,6,12,7,17,48,62,-14,43
SV Josko Rie,6562,7,11,4,21,32,58,-26,37
Mattersburg,6562,8,9,7,20,44,68,-24,34
Admira Wacke,6562,9,9,7,20,32,56,-24,34
St. Pölten,6562,10,7,10,19,41,73,-32,31
SC Rheindorf,6563,1,21,7,8,57,37,20,70
FC Salzburg,6563,2,20,9,7,67,32,35,69
SK Sturm Gra,6563,3,20,6,10,67,39,28,66
Rapid Vienna,6563,4,17,9,10,63,35,28,60
Vienna,6563,5,13,10,13,55,60,-5,49
RZ Pellets W,6563,6,11,9,16,41,57,-16,42
Mattersburg,6563,7,11,7,18,39,53,-14,40
Admira Wacke,6563,8,11,6,19,36,58,-22,39
St. Pölten,6563,9,8,9,19,45,70,-25,33
SV Josko Rie,6563,10,9,6,21,39,68,-29,33
FC Salzburg,6564,1,23,5,8,69,29,40,74
SC Rheindorf,6564,2,22,6,8,58,39,19,72
Vienna,6564,3,18,8,10,57,46,11,62
SK Sturm Gra,6564,4,16,7,13,51,42,9,55
Rapid Vienna,6564,5,14,11,11,57,36,21,53
RZ Pellets W,6564,6,11,9,16,45,61,-16,42
SV Josko Rie,6564,7,12,4,20,38,47,-9,40
Admira Wacke,6564,8,11,6,19,35,62,-27,39
St. Pölten,6564,9,9,10,17,44,67,-23,37
Mattersburg,6564,10,7,8,21,34,59,-25,29
SC Rheindorf,6565,1,20,7,9,57,43,14,67
Vienna,6565,2,18,9,9,56,42,14,63
FC Salzburg,6565,3,18,8,10,59,29,30,62
Rapid Vienna,6565,4,16,10,10,60,39,21,58
SK Sturm Gra,6565,5,16,7,13,59,44,15,55
Admira Wacke,6565,6,14,6,16,48,59,-11,48
RZ Pellets W,6565,7,11,10,15,48,59,-11,43
St. Pölten,6565,8,9,10,17,41,58,-17,37
Mattersburg,6565,9,9,7,20,37,64,-27,34
SV Josko Rie,6565,10,9,6,21,31,59,-28,33
FC Salzburg,6566,1,23,7,6,70,29,41,76
Vienna,6566,2,19,4,13,61,51,10,61
SK Sturm Gra,6566,3,17,9,10,55,33,22,60
SC Rheindorf,6566,4,17,8,11,55,47,8,59
Rapid Vienna,6566,5,12,15,9,54,39,15,51
RZ Pellets W,6566,6,13,7,16,49,56,-7,46
SV Josko Rie,6566,7,11,6,19,36,48,-12,39
Mattersburg,6566,8,10,8,18,33,53,-20,38
Admira Wacke,6566,9,9,9,18,33,56,-23,36
St. Pölten,6566,10,7,11,18,39,73,-34,32
FC Salzburg,6567,1,25,4,7,71,31,40,79
SC Rheindorf,6567,2,20,6,10,57,44,13,66
Vienna,6567,3,19,4,13,62,54,8,61
SK Sturm Gra,6567,4,16,8,12,49,34,15,56
Rapid Vienna,6567,5,12,11,13,50,39,11,47
RZ Pellets W,6567,6,13,8,15,47,48,-1,47
Admira Wacke,6567,7,12,7,17,34,56,-22,43
SV Josko Rie,6567,8,11,4,21,36,55,-19,37
Mattersburg,6567,9,10,7,19,34,56,-22,37
St. Pölten,6567,10,8,9,19,39,62,-23,33
FC Salzburg,6568,1,23,8,5,71,31,40,77
SK Sturm Gra,6568,2,21,5,10,58,35,23,68
SC Rheindorf,6568,3,21,5,10,64,46,18,68
Vienna,6568,4,18,6,12,58,46,12,60
Rapid Vienna,6568,5,13,11,12,56,42,14,50
RZ Pellets W,6568,6,13,6,17,43,57,-14,45
St. Pölten,6568,7,10,8,18,50,66,-16,38
SV Josko Rie,6568,8,10,6,20,30,49,-19,36
Admira Wacke,6568,9,9,8,19,34,61,-27,35
Mattersburg,6568,10,7,7,22,29,60,-31,28
FC Salzburg,6569,1,21,9,6,66,26,40,72
SK Sturm Gra,6569,2,21,7,8,58,27,31,70
Vienna,6569,3,20,5,11,65,52,13,65
SC Rheindorf,6569,4,16,9,11,51,49,2,57
Rapid Vienna,6569,5,15,10,11,55,42,13,55
Admira Wacke,6569,6,13,4,19,41,62,-21,43
RZ Pellets W,6569,7,11,7,18,44,61,-17,40
Mattersburg,6569,8,9,8,19,37,53,-16,35
SV Josko Rie,6569,9,10,4,22,32,50,-18,34
St. Pölten,6569,10,8,9,19,37,64,-27,33
FC Salzburg,6570,1,20,7,9,64,31,33,67
Vienna,6570,2,21,4,11,64,46,18,67
SC Rheindorf,6570,3,18,11,7,54,37,17,65
SK Sturm Gra,6570,4,19,5,12,54,33,21,62
Rapid Vienna,6570,5,15,11,10,52,36,16,56
St. Pölten,6570,6,12,8,16,45,55,-10,44
Mattersburg,6570,7,10,10,16,35,52,-17,40
RZ Pellets W,6570,8,11,6,19,42,59,-17,39
SV Josko Rie,6570,9,10,5,21,26,51,-25,35
Admira Wacke,6570,10,8,5,23,35,71,-36,29
SC Rheindorf,6571,1,21,6,9,58,39,19,69
FC Salzburg,6571,2,19,6,11,63,35,28,63
Vienna,6571,3,19,4,13,62,54,8,61
SK Sturm Gra,6571,4,17,8,11,60,40,20,59
Rapid Vienna,6571,5,15,9,12,66,45,21,54
RZ Pellets W,6571,6,13,8,15,42,51,-9,47
Admira Wacke,6571,7,12,8,16,41,58,-17,44
Mattersburg,6571,8,8,12,16,35,56,-21,36
SV Josko Rie,6571,9,8,11,17,27,47,-20,35
St. Pölten,6571,10,7,10,19,36,65,-29,31
FC Salzburg,6572,1,21,9,6,67,32,35,72
SC Rheindorf,6572,2,18,11,7,57,41,16,65
SK Sturm Gra,6572,3,18,9,9,59,32,27,63
Vienna,6572,4,18,8,10,61,49,12,62
Rapid Vienna,6572,5,15,9,12,58,51,7,54
RZ Pellets W,6572,6,14,7,15,48,48,0,49
Admira Wacke,6572,7,10,7,19,35,58,-23,37
Mattersburg,6572,8,8,9,19,33,55,-22,33
SV Josko Rie,6572,9,8,7,21,29,53,-24,31
St. Pölten,6572,10,7,10,19,46,74,-28,31
SC Rheindorf,6573,1,23,5,8,61,41,20,74
SK Sturm Gra,6573,2,20,6,10,63,38,25,66
Vienna,6573,3,20,4,12,64,51,13,64
FC Salzburg,6573,4,17,7,12,57,36,21,58
Rapid Vienna,6573,5,15,9,12,57,43,14,54
RZ Pellets W,6573,6,14,7,15,48,52,-4,49
SV Josko Rie,6573,7,12,5,19,38,53,-15,41
Admira Wacke,6573,8,10,8,18,35,60,-25,38
Mattersburg,6573,9,9,9,18,37,56,-19,36
St. Pölten,6573,10,6,8,22,41,71,-30,26
FC Salzburg,6574,1,21,8,7,68,31,37,71
SK Sturm Gra,6574,2,20,8,8,60,33,27,68
SC Rheindorf,6574,3,19,8,9,59,44,15,65
Vienna,6574,4,17,5,14,62,55,7,56
Rapid Vienna,6574,5,14,10,12,57,40,17,52
RZ Pellets W,6574,6,10,10,16,42,57,-15,40
SV Josko Rie,6574,7,10,8,18,37,57,-20,38
St. Pölten,6574,8,8,12,16,43,62,-19,36
Mattersburg,6574,9,10,6,20,40,61,-21,36
Admira Wacke,6574,10,9,9,18,39,67,-28,36
FC Salzburg,6575,1,22,8,6,69,31,38,74
SC Rheindorf,6575,2,22,7,7,64,36,28,73
SK Sturm Gra,6575,3,20,6,10,58,34,24,66
Vienna,6575,4,17,6,13,63,56,7,57
Rapid Vienna,6575,5,14,11,11,54,39,15,53
RZ Pellets W,6575,6,10,10,16,45,59,-14,40
SV Josko Rie,6575,7,11,7,18,35,52,-17,40
Admira Wacke,6575,8,12,4,20,36,62,-26,40
St. Pölten,6575,9,7,10,19,39,65,-26,31
Mattersburg,6575,10,6,9,21,32,61,-29,27
SK Sturm Gra,6576,1,21,7,8,59,28,31,70
FC Salzburg,6576,2,19,9,8,66,32,34,66
Vienna,6576,3,19,6,11,57,44,13,63
SC Rheindorf,6576,4,17,7,12,47,43,4,58
RZ Pellets W,6576,5,14,8,14,48,47,1,50
Rapid Vienna,6576,6,11,9,16,48,48,0,42
Admira Wacke,6576,7,11,9,16,37,63,-26,42
St. Pölten,6576,8,10,9,17,43,66,-23,39
SV Josko Rie,6576,9,10,8,18,35,51,-16,38
Mattersburg,6576,10,8,8,20,36,54,-18,32
FC Salzburg,6577,1,23,8,5,73,32,41,77
SC Rheindorf,6577,2,21,7,8,59,42,17,70
SK Sturm Gra,6577,3,19,4,13,60,37,23,61
Rapid Vienna,6577,4,16,10,10,68,39,29,58
Vienna,6577,5,18,3,15,57,57,0,57
St. Pölten,6577,6,14,6,16,48,60,-12,48
RZ Pellets W,6577,7,13,6,17,50,58,-8,45
Admira Wacke,6577,8,11,6,19,38,64,-26,39
Mattersburg,6577,9,7,6,23,39,75,-36,27
SV Josko Rie,6577,10,6,8,22,25,53,-28,26
FC Salzburg,6578,1,20,10,6,73,35,38,70
SK Sturm Gra,6578,2,20,5,11,66,34,32,65
Vienna,6578,3,20,4,12,69,54,15,64
SC Rheindorf,6578,4,18,7,11,55,44,11,61
Rapid Vienna,6578,5,15,11,10,67,45,22,56
RZ Pellets W,6578,6,13,5,18,46,61,-15,44
Admira Wacke,6578,7,12,5,19,35,67,-32,41
St. Pölten,6578,8,10,10,16,43,59,-16,40
SV Josko Rie,6578,9,10,6,20,33,55,-22,36
Mattersburg,6578,10,7,7,22,35,68,-33,28
FC Salzburg,6579,1,20,8,8,62,33,29,68
SC Rheindorf,6579,2,19,10,7,58,43,15,67
Vienna,6579,3,17,8,11,59,49,10,59
SK Sturm Gra,6579,4,16,10,10,59,37,22,58
Rapid Vienna,6579,5,14,13,9,58,37,21,55
RZ Pellets W,6579,6,11,8,17,38,57,-19,41
Admira Wacke,6579,7,11,7,18,38,53,-15,40
SV Josko Rie,6579,8,10,9,17,34,47,-13,39
St. Pölten,6579,9,7,13,16,45,65,-20,34
Mattersburg,6579,10,8,8,20,34,64,-30,32
SK Sturm Gra,6580,1,22,6,8,64,31,33,72
FC Salzburg,6580,2,21,7,8,66,34,32,70
Vienna,6580,3,21,5,10,75,46,29,68
SC Rheindorf,6580,4,20,7,9,59,46,13,67
Rapid Vienna,6580,5,14,10,12,55,39,16,52
SV Josko Rie,6580,6,12,7,17,43,60,-17,43
Admira Wacke,6580,7,11,6,19,43,66,-23,39
RZ Pellets W,6580,8,9,7,20,40,60,-20,34
Mattersburg,6580,9,7,11,18,38,60,-22,32
St. Pölten,6580,10,5,10,21,39,80,-41,25
FC Salzburg,6581,1,21,8,7,64,28,36,71
SC Rheindorf,6581,2,17,12,7,49,36,13,63
SK Sturm Gra,6581,3,17,10,9,52,34,18,61
Vienna,6581,4,18,7,11,64,54,10,61
Rapid Vienna,6581,5,15,10,11,58,40,18,55
Admira Wacke,6581,6,14,6,16,41,61,-20,48
RZ Pellets W,6581,7,10,9,17,44,57,-13,39
SV Josko Rie,6581,8,11,6,19,34,53,-19,39
Mattersburg,6581,9,8,8,20,47,63,-16,32
St. Pölten,6581,10,6,10,20,39,66,-27,28
FC Salzburg,6582,1,23,5,8,71,25,46,74
SC Rheindorf,6582,2,20,7,9,60,41,19,67
SK Sturm Gra,6582,3,18,5,13,55,37,18,59
Vienna,6582,4,17,6,13,63,53,10,57
RZ Pellets W,6582,5,14,8,14,52,57,-5,50
Admira Wacke,6582,6,13,5,18,39,60,-21,44
Rapid Vienna,6582,7,10,13,13,44,44,0,43
SV Josko Rie,6582,8,12,4,20,39,60,-21,40
Mattersburg,6582,9,10,8,18,44,63,-19,38
St. Pölten,6582,10,8,9,19,34,61,-27,33
SC Rheindorf,6583,1,21,8,7,64,39,25,71
FC Salzburg,6583,2,20,8,8,60,35,25,68
SK Sturm Gra,6583,3,17,10,9,56,35,21,61
Rapid Vienna,6583,4,15,10,11,58,38,20,55
Vienna,6583,5,16,6,14,61,57,4,54
RZ Pellets W,6583,6,13,8,15,49,58,-9,47
SV Josko Rie,6583,7,11,7,18,46,53,-7,40
Admira Wacke,6583,8,11,7,18,32,58,-26,40
St. Pölten,6583,9,8,11,17,39,64,-25,35
Mattersburg,6583,10,6,9,21,34,62,-28,27
FC Salzburg,6584,1,20,8,8,69,33,36,68
SC Rheindorf,6584,2,20,8,8,58,41,17,68
SK Sturm Gra,6584,3,20,7,9,57,31,26,67
Vienna,6584,4,18,5,13,66,52,14,59
Rapid Vienna,6584,5,14,9,13,53,41,12,51
RZ Pellets W,6584,6,12,12,12,44,48,-4,48
Admira Wacke,6584,7,11,8,17,35,61,-26,41
SV Josko Rie,6584,8,10,6,20,33,54,-21,36
St. Pölten,6584,9,9,8,19,40,68,-28,35
Mattersburg,6584,10,6,9,21,36,62,-26,27
FC Salzburg,6585,1,21,6,9,67,31,36,69
SC Rheindorf,6585,2,20,7,9,60,49,11,67
SK Sturm Gra,6585,3,17,5,14,54,41,13,56
Vienna,6585,4,17,5,14,62,60,2,56
RZ Pellets W,6585,5,14,7,15,60,60,0,49
Mattersburg,6585,6,13,9,14,41,47,-6,48
Admira Wacke,6585,7,14,5,17,45,60,-15,47
Rapid Vienna,6585,8,10,12,14,52,51,1,42
SV Josko Rie,6585,9,11,7,18,36,50,-14,40
St. Pölten,6585,10,5,13,18,37,65,-28,28
SC Rheindorf,6586,1,21,6,9,57,40,17,69
FC Salzburg,6586,2,17,10,9,57,35,22,61
SK Sturm Gra,6586,3,19,4,13,55,34,21,61
Vienna,6586,4,19,2,15,58,54,4,59
Rapid Vienna,6586,5,14,12,10,55,37,18,54
Admira Wacke,6586,6,15,4,17,41,50,-9,49
RZ Pellets W,6586,7,13,8,15,51,57,-6,47
SV Josko Rie,6586,8,11,7,18,35,51,-16,40
Mattersburg,6586,9,11,5,20,48,63,-15,38
St. Pölten,6586,10,7,8,21,36,72,-36,29
FC Salzburg,6587,1,22,8,6,68,28,40,74
SK Sturm Gra,6587,2,22,6,8,65,35,30,72
SC Rheindorf,6587,3,19,8,9,54,42,12,65
Rapid Vienna,6587,4,15,11,10,66,43,23,56
Vienna,6587,5,14,8,14,59,58,1,50
RZ Pellets W,6587,6,13,8,15,52,59,-7,47
SV Josko Rie,6587,7,11,4,21,37,55,-18,37
Admira Wacke,6587,8,10,7,19,35,62,-27,37
Mattersburg,6587,9,8,9,19,39,63,-24,33
St. Pölten,6587,10,6,11,19,41,71,-30,29
FC Salzburg,6588,1,23,7,6,71,31,40,76
SK Sturm Gra,6588,2,19,6,11,59,33,26,63
SC Rheindorf,6588,3,18,8,10,54,43,11,62
Vienna,6588,4,18,5,13,57,51,6,59
Rapid Vienna,6588,5,12,13,11,55,42,13,49
RZ Pellets W,6588,6,14,6,16,44,55,-11,48
Admira Wacke,6588,7,14,5,17,41,58,-17,47
St. Pölten,6588,8,9,10,17,40,62,-22,37
SV Josko Rie,6588,9,10,4,22,39,53,-14,34
Mattersburg,6588,10,7,8,21,34,66,-32,29
FC Salzburg,6589,1,20,7,9,65,37,28,67
SK Sturm Gra,6589,2,20,5,11,64,33,31,65
SC Rheindorf,6589,3,19,7,10,53,46,7,64
Vienna,6589,4,18,7,11,68,53,15,61
Admira Wacke,6589,5,15,6,15,45,56,-11,51
RZ Pellets W,6589,6,14,7,15,51,52,-1,49
Rapid Vienna,6589,7,11,11,14,53,45,8,44
SV Josko Rie,6589,8,10,6,20,36,57,-21,36
St. Pölten,6589,9,9,9,18,39,68,-29,36
Mattersburg,6589,10,7,9,20,34,61,-27,30
Vienna,6590,1,23,5,8,75,47,28,74
FC Salzburg,6590,2,21,6,9,71,35,36,69
SK Sturm Gra,6590,3,18,7,11,60,40,20,61
Rapid Vienna,6590,4,15,12,9,62,40,22,57
SC Rheindorf,6590,5,17,6,13,51,50,1,57
RZ Pellets W,6590,6,12,8,16,47,56,-9,44
Admira Wacke,6590,7,12,7,17,37,59,-22,43
SV Josko Rie,6590,8,11,6,19,35,54,-19,39
St. Pölten,6590,9,7,11,18,45,68,-23,32
Mattersburg,6590,10,6,8,22,30,64,-34,26
FC Salzburg,6591,1,21,7,8,75,36,39,70
SC Rheindorf,6591,2,21,5,10,61,43,18,68
SK Sturm Gra,6591,3,20,6,10,53,30,23,66
Vienna,6591,4,18,8,10,61,48,13,62
Rapid Vienna,6591,5,14,11,11,60,41,19,53
Admira Wacke,6591,6,12,8,16,37,52,-15,44
RZ Pellets W,6591,7,11,10,15,50,55,-5,43
St. Pölten,6591,8,9,7,20,44,67,-23,34
SV Josko Rie,6591,9,9,6,21,31,64,-33,33
Mattersburg,6591,10,8,6,22,38,74,-36,30
Vienna,6592,1,22,3,11,63,44,19,69
FC Salzburg,6592,2,20,6,10,64,34,30,66
SK Sturm Gra,6592,3,18,7,11,58,34,24,61
SC Rheindorf,6592,4,16,9,11,47,45,2,57
Rapid Vienna,6592,5,16,8,12,57,43,14,56
RZ Pellets W,6592,6,12,10,14,41,51,-10,46
SV Josko Rie,6592,7,12,5,19,41,54,-13,41
St. Pölten,6592,8,9,11,16,45,63,-18,38
Admira Wacke,6592,9,10,5,21,38,66,-28,35
Mattersburg,6592,10,8,10,18,31,51,-20,34
SC Rheindorf,6593,1,22,7,7,56,39,17,73
SK Sturm Gra,6593,2,21,5,10,66,36,30,68
FC Salzburg,6593,3,19,10,7,66,33,33,67
Vienna,6593,4,17,6,13,61,52,9,57
Rapid Vienna,6593,5,15,10,11,59,44,15,55
Admira Wacke,6593,6,14,7,15,40,54,-14,49
RZ Pellets W,6593,7,10,9,17,45,61,-16,39
Mattersburg,6593,8,10,7,19,36,53,-17,37
SV Josko Rie,6593,9,9,5,22,29,53,-24,32
St. Pölten,6593,10,5,10,21,40,73,-33,25
FC Salzburg,6594,1,21,9,6,65,29,36,72
SC Rheindorf,6594,2,21,6,9,61,40,21,69
Vienna,6594,3,18,8,10,57,47,10,62
SK Sturm Gra,6594,4,18,7,11,62,43,19,61
Rapid Vienna,6594,5,15,11,10,56,40,16,56
RZ Pellets W,6594,6,13,9,14,43,48,-5,48
Admira Wacke,6594,7,12,5,19,43,61,-18,41
SV Josko Rie,6594,8,10,7,19,33,54,-21,37
Mattersburg,6594,9,7,8,21,32,62,-30,29
St. Pölten,6594,10,6,8,22,37,65,-28,26
FC Salzburg,6595,1,27,5,4,75,24,51,86
SK Sturm Gra,6595,2,21,8,7,62,31,31,71
SC Rheindorf,6595,3,20,7,9,62,48,14,67
Vienna,6595,4,19,3,14,59,50,9,60
Rapid Vienna,6595,5,13,12,11,49,35,14,51
RZ Pellets W,6595,6,14,6,16,43,49,-6,48
St. Pölten,6595,7,7,12,17,38,63,-25,33
Admira Wacke,6595,8,9,6,21,29,66,-37,33
SV Josko Rie,6595,9,9,4,23,32,54,-22,31
Mattersburg,6595,10,6,7,23,33,62,-29,25
FC Salzburg,6596,1,24,7,5,66,23,43,79
SC Rheindorf,6596,2,19,6,11,53,39,14,63
SK Sturm Gra,6596,3,18,8,10,62,38,24,62
Rapid Vienna,6596,4,16,10,10,62,43,19,58
Vienna,6596,5,18,2,16,63,58,5,56
RZ Pellets W,6596,6,15,6,15,48,53,-5,51
Admira Wacke,6596,7,11,6,19,41,63,-22,39
St. Pölten,6596,8,9,9,18,51,70,-19,36
Mattersburg,6596,9,7,11,18,35,57,-22,32
SV Josko Rie,6596,10,9,3,24,24,61,-37,30
SK Sturm Gra,6597,1,22,6,8,67,33,34,72
FC Salzburg,6597,2,18,10,8,55,27,28,64
SC Rheindorf,6597,3,17,9,10,54,46,8,60
Vienna,6597,4,18,3,15,48,48,0,57
Rapid Vienna,6597,5,12,11,13,50,45,5,47
Admira Wacke,6597,6,13,7,16,39,52,-13,46
St. Pölten,6597,7,11,9,16,47,67,-20,42
RZ Pellets W,6597,8,11,8,17,41,51,-10,41
SV Josko Rie,6597,9,12,4,20,35,47,-12,40
Mattersburg,6597,10,8,9,19,34,54,-20,33
FC Salzburg,6598,1,19,8,9,62,31,31,65
SC Rheindorf,6598,2,19,6,11,53,44,9,63
SK Sturm Gra,6598,3,19,5,12,64,40,24,62
Vienna,6598,4,18,4,14,66,59,7,58
RZ Pellets W,6598,5,14,8,14,42,48,-6,50
Rapid Vienna,6598,6,13,10,13,48,44,4,49
Admira Wacke,6598,7,14,6,16,37,52,-15,48
St. Pölten,6598,8,10,10,16,37,57,-20,40
SV Josko Rie,6598,9,11,4,21,32,48,-16,37
Mattersburg,6598,10,8,9,19,38,56,-18,33
FC Salzburg,6599,1,20,9,7,65,31,34,69
SC Rheindorf,6599,2,18,10,8,51,37,14,64
SK Sturm Gra,6599,3,18,8,10,65,36,29,62
Vienna,6599,4,19,4,13,56,51,5,61
Rapid Vienna,6599,5,15,9,12,53,39,14,54
RZ Pellets W,6599,6,14,7,15,47,51,-4,49
Admira Wacke,6599,7,11,8,17,32,53,-21,41
SV Josko Rie,6599,8,9,9,18,32,52,-20,36
St. Pölten,6599,9,7,11,18,38,66,-28,32
Mattersburg,6599,10,8,7,21,37,60,-23,31
SK Sturm Gra,6600,1,21,7,8,68,36,32,70
SC Rheindorf,6600,2,17,10,9,52,39,13,61
FC Salzburg,6600,3,17,9,10,55,32,23,60
Vienna,6600,4,16,7,13,63,56,7,55
Rapid Vienna,6600,5,13,13,10,57,41,16,52
RZ Pellets W,6600,6,12,9,15,41,49,-8,45
Admira Wacke,6600,7,11,9,16,37,54,-17,42
Mattersburg,6600,8,10,9,17,37,53,-16,39
St. Pölten,6600,9,9,9,18,40,69,-29,36
SV Josko Rie,6600,10,9,8,19,40,61,-21,35
SC Rheindorf,6601,1,20,8,8,59,40,19,68
FC Salzburg,6601,2,19,9,8,60,31,29,66
Vienna,6601,3,18,8,10,65,50,15,62
SK Sturm Gra,6601,4,17,8,11,54,36,18,59
Rapid Vienna,6601,5,13,11,12,52,42,10,50
Admira Wacke,6601,6,13,8,15,45,56,-11,47
RZ Pellets W,6601,7,11,9,16,40,55,-15,42
SV Josko Rie,6601,8,10,8,18,31,48,-17,38
St. Pölten,6601,9,8,9,19,42,66,-24,33
Mattersburg,6601,10,7,10,19,34,58,-24,31
FC Salzburg,6602,1,22,7,7,67,36,31,73
SK Sturm Gra,6602,2,22,6,8,70,36,34,72
SC Rheindorf,6602,3,19,6,11,62,47,15,63
Vienna,6602,4,17,3,16,63,59,4,54
Rapid Vienna,6602,5,13,12,11,59,46,13,51
SV Josko Rie,6602,6,13,8,15,44,48,-4,47
Mattersburg,6602,7,13,7,16,46,54,-8,46
RZ Pellets W,6602,8,12,6,18,47,60,-13,42
Admira Wacke,6602,9,10,5,21,34,65,-31,35
St. Pölten,6602,10,5,8,23,36,77,-41,23
SC Rheindorf,6603,1,22,6,8,60,39,21,72
SK Sturm Gra,6603,2,20,5,11,66,39,27,65
FC Salzburg,6603,3,19,7,10,68,39,29,64
RZ Pellets W,6603,4,17,6,13,45,44,1,57
Vienna,6603,5,16,5,15,64,61,3,53
Rapid Vienna,6603,6,12,14,10,51,40,11,50
Admira Wacke,6603,7,14,6,16,41,59,-18,48
Mattersburg,6603,8,9,9,18,39,58,-19,36
SV Josko Rie,6603,9,7,8,21,34,60,-26,29
St. Pölten,6603,10,5,12,19,39,68,-29,27
FC Salzburg,6604,1,22,9,5,70,27,43,75
SC Rheindorf,6604,2,21,6,9,62,44,18,69
SK Sturm Gra,6604,3,18,7,11,55,32,23,61
Vienna,6604,4,14,7,15,59,63,-4,49
RZ Pellets W,6604,5,14,6,16,44,51,-7,48
Rapid Vienna,6604,6,12,10,14,45,40,5,46
SV Josko Rie,6604,7,13,5,18,38,52,-14,44
Mattersburg,6604,8,11,7,18,38,52,-14,40
St. Pölten,6604,9,10,8,18,45,61,-16,38
Admira Wacke,6604,10,9,7,20,31,65,-34,34
FC Salzburg,6605,1,21,5,10,66,32,34,68
SC Rheindorf,6605,2,20,8,8,54,38,16,68
Vienna,6605,3,20,5,11,61,46,15,65
SK Sturm Gra,6605,4,19,7,10,58,32,26,64
Rapid Vienna,6605,5,14,9,13,52,47,5,51
RZ Pellets W,6605,6,12,6,18,46,60,-14,42
St. Pölten,6605,7,11,8,17,48,65,-17,41
Admira Wacke,6605,8,12,5,19,39,64,-25,41
Mattersburg,6605,9,9,8,19,41,61,-20,35
SV Josko Rie,6605,10,9,5,22,32,52,-20,32
FC Salzburg,6606,1,21,9,6,68,33,35,72
Vienna,6606,2,18,6,12,58,53,5,60
SC Rheindorf,6606,3,18,5,13,49,43,6,59
Rapid Vienna,6606,4,15,13,8,58,37,21,58
SK Sturm Gra,6606,5,16,9,11,59,40,19,57
RZ Pellets W,6606,6,13,7,16,49,56,-7,46
Mattersburg,6606,7,11,9,16,37,47,-10,42
SV Josko Rie,6606,8,13,3,20,38,52,-14,42
Admira Wacke,6606,9,9,9,18,35,61,-26,36
St. Pölten,6606,10,5,12,19,37,66,-29,27
FC Salzburg,6607,1,21,5,10,56,30,26,68
Vienna,6607,2,20,4,12,63,44,19,64
SC Rheindorf,6607,3,19,6,11,59,45,14,63
SK Sturm Gra,6607,4,16,6,14,50,40,10,54
Rapid Vienna,6607,5,13,13,10,57,42,15,52
Admira Wacke,6607,6,15,6,15,39,50,-11,51
RZ Pellets W,6607,7,14,5,17,49,57,-8,47
St. Pölten,6607,8,10,8,18,41,68,-27,38
SV Josko Rie,6607,9,11,4,21,38,56,-18,37
Mattersburg,6607,10,9,7,20,38,58,-20,34
SK Sturm Gra,6608,1,21,5,10,69,33,36,68
SC Rheindorf,6608,2,20,7,9,56,43,13,67
FC Salzburg,6608,3,19,9,8,58,33,25,66
Vienna,6608,4,17,5,14,59,52,7,56
Rapid Vienna,6608,5,12,13,11,53,41,12,49
Admira Wacke,6608,6,13,7,16,37,52,-15,46
RZ Pellets W,6608,7,10,8,18,47,63,-16,38
SV Josko Rie,6608,8,11,5,20,38,55,-17,38
St. Pölten,6608,9,9,11,16,32,57,-25,38
Mattersburg,6608,10,8,10,18,37,57,-20,34
SC Rheindorf,6609,1,23,6,7,67,38,29,75
FC Salzburg,6609,2,20,6,10,62,36,26,66
SK Sturm Gra,6609,3,18,6,12,59,39,20,60
Vienna,6609,4,17,7,12,60,52,8,58
RZ Pellets W,6609,5,15,5,16,45,54,-9,50
Rapid Vienna,6609,6,13,9,14,55,44,11,48
Admira Wacke,6609,7,14,4,18,37,56,-19,46
St. Pölten,6609,8,10,8,18,52,69,-17,38
SV Josko Rie,6609,9,11,2,23,32,58,-26,35
Mattersburg,6609,10,9,7,20,38,61,-23,34
FC Salzburg,6610,1,22,8,6,66,32,34,74
SK Sturm Gra,6610,2,22,4,10,63,36,27,70
SC Rheindorf,6610,3,17,11,8,60,46,14,62
Vienna,6610,4,17,6,13,60,50,10,57
Rapid Vienna,6610,5,14,8,14,51,42,9,50
Admira Wacke,6610,6,13,6,17,39,57,-18,45
RZ Pellets W,6610,7,11,10,15,42,55,-13,43
Mattersburg,6610,8,10,8,18,39,54,-15,38
SV Josko Rie,6610,9,9,6,21,37,58,-21,33
St. Pölten,6610,10,6,11,19,36,63,-27,29
SK Sturm Gra,6611,1,21,7,8,58,29,29,70
SC Rheindorf,6611,2,20,9,7,53,36,17,69
FC Salzburg,6611,3,20,7,9,68,34,34,67
Rapid Vienna,6611,4,17,8,11,61,39,22,59
Vienna,6611,5,19,2,15,62,52,10,59
RZ Pellets W,6611,6,11,8,17,44,56,-12,41
Mattersburg,6611,7,10,8,18,40,57,-17,38
SV Josko Rie,6611,8,11,5,20,33,56,-23,38
Admira Wacke,6611,9,10,7,19,34,64,-30,37
St. Pölten,6611,10,6,9,21,36,66,-30,27
FC Salzburg,6612,1,24,5,7,67,25,42,77
SC Rheindorf,6612,2,18,7,11,49,43,6,61
SK Sturm Gra,6612,3,17,8,11,54,32,22,59
Vienna,6612,4,17,7,12,62,54,8,58
Rapid Vienna,6612,5,14,10,12,53,41,12,52
RZ Pellets W,6612,6,15,6,15,48,53,-5,51
Admira Wacke,6612,7,14,8,14,40,49,-9,50
SV Josko Rie,6612,8,10,4,22,30,56,-26,34
St. Pölten,6612,9,8,9,19,35,62,-27,33
Mattersburg,6612,10,7,8,21,31,54,-23,29
SC Rheindorf,6613,1,25,5,6,68,34,34,80
SK Sturm Gra,6613,2,19,6,11,57,37,20,63
Vienna,6613,3,18,6,12,73,62,11,60
Rapid Vienna,6613,4,15,10,11,61,44,17,55
FC Salzburg,6613,5,16,7,13,59,44,15,55
RZ Pellets W,6613,6,13,7,16,53,55,-2,46
Admira Wacke,6613,7,11,10,15,40,61,-21,43
Mattersburg,6613,8,9,9,18,39,59,-20,36
St. Pölten,6613,9,7,11,18,39,66,-27,32
SV Josko Rie,6613,10,8,7,21,36,63,-27,31
SC Rheindorf,6614,1,21,10,5,67,36,31,73
FC Salzburg,6614,2,21,8,7,73,35,38,71
SK Sturm Gra,6614,3,17,8,11,55,35,20,59
Rapid Vienna,6614,4,16,10,10,55,33,22,58
Vienna,6614,5,16,6,14,58,57,1,54
SV Josko Rie,6614,6,14,4,18,39,48,-9,46
RZ Pellets W,6614,7,10,9,17,36,55,-19,39
Admira Wacke,6614,8,12,3,21,35,63,-28,39
St. Pölten,6614,9,8,10,18,39,67,-28,34
Mattersburg,6614,10,6,10,20,32,60,-28,28
FC Salzburg,6615,1,20,8,8,64,28,36,68
SK Sturm Gra,6615,2,20,6,10,60,37,23,66
Vienna,6615,3,18,6,12,63,53,10,60
SC Rheindorf,6615,4,15,10,11,47,45,2,55
RZ Pellets W,6615,5,13,10,13,44,44,0,49
Admira Wacke,6615,6,13,9,14,34,48,-14,48
Rapid Vienna,6615,7,10,14,12,52,46,6,44
St. Pölten,6615,8,9,11,16,41,57,-16,38
SV Josko Rie,6615,9,10,6,20,31,55,-24,36
Mattersburg,6615,10,8,8,20,41,64,-23,32
SC Rheindorf,6616,1,22,7,7,63,42,21,73
FC Salzburg,6616,2,20,8,8,65,35,30,68
SK Sturm Gra,6616,3,20,7,9,59,34,25,67
Vienna,6616,4,17,5,14,60,53,7,56
Rapid Vienna,6616,5,13,12,11,53,36,17,51
RZ Pellets W,6616,6,13,8,15,44,55,-11,47
SV Josko Rie,6616,7,12,4,20,37,52,-15,40
Mattersburg,6616,8,10,7,19,44,57,-13,37
Admira Wacke,6616,9,10,6,20,41,70,-29,36
St. Pölten,6616,10,6,10,20,32,64,-32,28
SK Sturm Gra,6617,1,20,9,7,59,30,29,69
SC Rheindorf,6617,2,20,9,7,58,41,17,69
FC Salzburg,6617,3,18,11,7,67,33,34,65
Vienna,6617,4,15,8,13,62,55,7,53
RZ Pellets W,6617,5,12,10,14,51,58,-7,46
Rapid Vienna,6617,6,10,13,13,50,41,9,43
SV Josko Rie,6617,7,11,7,18,33,47,-14,40
St. Pölten,6617,8,9,10,17,37,60,-23,37
Admira Wacke,6617,9,9,10,17,35,64,-29,37
Mattersburg,6617,10,7,11,18,36,59,-23,32
FC Salzburg,6618,1,21,6,9,63,31,32,69
SK Sturm Gra,6618,2,19,9,8,59,35,24,66
SC Rheindorf,6618,3,19,6,11,55,44,11,63
Vienna,6618,4,19,5,12,68,49,19,62
Rapid Vienna,6618,5,17,10,9,59,36,23,61
RZ Pellets W,6618,6,13,8,15,49,52,-3,47
SV Josko Rie,6618,7,12,5,19,33,54,-21,41
Mattersburg,6618,8,9,7,20,36,61,-25,34
St. Pölten,6618,9,8,9,19,37,65,-28,33
Admira Wacke,6618,10,8,5,23,26,58,-32,29
FC Salzburg,6619,1,22,5,9,63,27,36,71
SC Rheindorf,6619,2,21,6,9,58,41,17,69
Vienna,6619,3,19,7,10,67,52,15,64
SK Sturm Gra,6619,4,17,11,8,55,34,21,62
Rapid Vienna,6619,5,15,10,11,52,38,14,55
SV Josko Rie,6619,6,12,7,17,37,51,-14,43
RZ Pellets W,6619,7,11,9,16,45,55,-10,42
Admira Wacke,6619,8,9,7,20,34,62,-28,34
Mattersburg,6619,9,7,10,19,37,58,-21,31
St. Pölten,6619,10,6,10,20,34,64,-30,28
SC Rheindorf,6620,1,22,6,8,56,38,18,72
FC Salzburg,6620,2,22,5,9,69,34,35,71
SK Sturm Gra,6620,3,19,5,12,48,34,14,62
Rapid Vienna,6620,4,15,10,11,60,43,17,55
Vienna,6620,5,15,6,15,60,60,0,51
RZ Pellets W,6620,6,13,7,16,47,58,-11,46
Admira Wacke,6620,7,13,4,19,40,60,-20,43
SV Josko Rie,6620,8,12,6,18,44,55,-11,42
St. Pölten,6620,9,9,8,19,43,59,-16,35
Mattersburg,6620,10,6,11,19,32,58,-26,29
FC Salzburg,6621,1,21,7,8,68,33,35,70
SC Rheindorf,6621,2,20,6,10,58,43,15,66
SK Sturm Gra,6621,3,20,5,11,58,34,24,65
Vienna,6621,4,20,4,12,64,52,12,64
Rapid Vienna,6621,5,13,12,11,50,36,14,51
RZ Pellets W,6621,6,12,7,17,41,54,-13,43
St. Pölten,6621,7,11,8,17,38,56,-18,41
Admira Wacke,6621,8,11,6,19,35,58,-23,39
Mattersburg,6621,9,9,9,18,39,57,-18,36
SV Josko Rie,6621,10,8,6,22,30,58,-28,30
FC Salzburg,6622,1,22,8,6,75,32,43,74
SC Rheindorf,6622,2,21,9,6,59,37,22,72
Vienna,6622,3,19,6,11,61,55,6,63
SK Sturm Gra,6622,4,16,10,10,54,31,23,58
Rapid Vienna,6622,5,14,9,13,60,46,14,51
SV Josko Rie,6622,6,12,6,18,37,52,-15,42
RZ Pellets W,6622,7,10,11,15,46,56,-10,41
Admira Wacke,6622,8,10,7,19,40,69,-29,37
Mattersburg,6622,9,7,11,18,33,58,-25,32
St. Pölten,6622,10,6,9,21,38,67,-29,27
SK Sturm Gra,6623,1,22,4,10,61,31,30,70
FC Salzburg,6623,2,21,6,9,65,29,36,69
SC Rheindorf,6623,3,20,8,8,46,33,13,68
Vienna,6623,4,16,6,14,52,51,1,54
Rapid Vienna,6623,5,14,10,12,57,41,16,52
St. Pölten,6623,6,13,9,14,44,51,-7,48
RZ Pellets W,6623,7,12,8,16,45,56,-11,44
SV Josko Rie,6623,8,11,7,18,32,50,-18,40
Admira Wacke,6623,9,9,7,20,34,63,-29,34
Mattersburg,6623,10,5,9,22,34,65,-31,24
FC Salzburg,6624,1,21,10,5,66,28,38,73
SC Rheindorf,6624,2,19,10,7,53,34,19,67
SK Sturm Gra,6624,3,19,6,11,60,34,26,63
Vienna,6624,4,17,5,14,51,51,0,56
Rapid Vienna,6624,5,13,11,12,53,43,10,50
Admira Wacke,6624,6,13,5,18,38,60,-22,44
RZ Pellets W,6624,7,11,8,17,43,60,-17,41
SV Josko Rie,6624,8,9,9,18,37,49,-12,36
St. Pölten,6624,9,8,11,17,42,61,-19,35
Mattersburg,6624,10,8,9,19,37,60,-23,33
FC Salzburg,6625,1,22,5,9,65,30,35,71
Vienna,6625,2,22,5,9,67,48,19,71
SC Rheindorf,6625,3,20,5,11,54,42,12,65
SK Sturm Gra,6625,4,18,9,9,60,37,23,63
Rapid Vienna,6625,5,16,8,12,62,43,19,56
RZ Pellets W,6625,6,10,8,18,45,55,-10,38
St. Pölten,6625,7,10,8,18,42,64,-22,38
Admira Wacke,6625,8,10,8,18,31,54,-23,38
SV Josko Rie,6625,9,10,5,21,37,57,-20,35
Mattersburg,6625,10,8,7,21,35,68,-33,31
SC Rheindorf,6626,1,21,9,6,67,46,21,72
FC Salzburg,6626,2,19,7,10,67,38,29,64
Rapid Vienna,6626,3,18,10,8,60,35,25,64
SK Sturm Gra,6626,4,18,8,10,62,36,26,62
Vienna,6626,5,14,6,16,55,58,-3,48
Admira Wacke,6626,6,12,7,17,39,54,-15,43
RZ Pellets W,6626,7,9,14,13,44,59,-15,41
SV Josko Rie,6626,8,10,8,18,33,54,-21,38
Mattersburg,6626,9,9,9,18,45,64,-19,36
St. Pölten,6626,10,5,12,19,35,63,-28,27
SC Rheindorf,6627,1,19,10,7,56,40,16,67
SK Sturm Gra,6627,2,19,7,10,59,39,20,64
Vienna,6627,3,19,5,12,61,49,12,62
FC Salzburg,6627,4,16,12,8,61,34,27,60
Rapid Vienna,6627,5,11,13,12,48,42,6,46
St. Pölten,6627,6,12,9,15,49,57,-8,45
RZ Pellets W,6627,7,10,10,16,42,57,-15,40
Admira Wacke,6627,8,10,8,18,34,61,-27,38
SV Josko Rie,6627,9,9,10,17,33,49,-16,37
Mattersburg,6627,10,10,6,20,36,51,-15,36
FC Salzburg,6628,1,21,8,7,70,30,40,71
SC Rheindorf,6628,2,22,5,9,61,39,22,71
Vienna,6628,3,21,3,12,71,60,11,66
SK Sturm Gra,6628,4,18,7,11,70,41,29,61
Rapid Vienna,6628,5,12,12,12,57,45,12,48
Admira Wacke,6628,6,14,5,17,42,63,-21,47
RZ Pellets W,6628,7,10,9,17,43,63,-20,39
St. Pölten,6628,8,9,9,18,45,68,-23,36
SV Josko Rie,6628,9,11,3,22,38,63,-25,36
Mattersburg,6628,10,7,9,20,34,59,-25,30
SK Sturm Gra,6629,1,20,7,9,62,30,32,67
SC Rheindorf,6629,2,18,11,7,56,40,16,65
FC Salzburg,6629,3,19,7,10,62,32,30,64
Vienna,6629,4,18,8,10,66,52,14,62
Rapid Vienna,6629,5,16,7,13,57,39,18,55
Admira Wacke,6629,6,13,6,17,44,68,-24,45
RZ Pellets W,6629,7,11,7,18,45,55,-10,40
Mattersburg,6629,8,11,7,18,47,66,-19,40
St. Pölten,6629,9,9,7,20,41,65,-24,34
SV Josko Rie,6629,10,9,5,22,28,61,-33,32
FC Salzburg,6630,1,21,10,5,67,29,38,73
SC Rheindorf,6630,2,18,11,7,61,45,16,65
SK Sturm Gra,6630,3,17,9,10,55,35,20,60
Vienna,6630,4,17,7,12,61,53,8,58
Rapid Vienna,6630,5,14,11,11,56,39,17,53
Admira Wacke,6630,6,13,4,19,40,59,-19,43
Mattersburg,6630,7,11,8,17,39,55,-16,41
RZ Pellets W,6630,8,10,9,17,45,61,-16,39
SV Josko Rie,6630,9,9,8,19,33,55,-22,35
St. Pölten,6630,10,6,11,19,38,64,-26,29
SK Sturm Gra,6631,1,20,7,9,54,33,21,67
FC Salzburg,6631,2,18,10,8,59,28,31,64
SC Rheindorf,6631,3,18,6,12,54,46,8,60
Vienna,6631,4,18,4,14,58,51,7,58
RZ Pellets W,6631,5,16,8,12,53,49,4,56
SV Josko Rie,6631,6,16,4,16,41,45,-4,52
Rapid Vienna,6631,7,13,12,11,50,40,10,51
Admira Wacke,6631,8,9,10,17,30,58,-28,37
Mattersburg,6631,9,8,7,21,47,61,-14,31
St. Pölten,6631,10,6,8,22,35,70,-35,26
FC Salzburg,6632,1,19,11,6,64,29,35,68
SK Sturm Gra,6632,2,19,9,8,67,40,27,66
SC Rheindorf,6632,3,17,11,8,49,40,9,62
Vienna,6632,4,18,7,11,63,54,9,61
Rapid Vienna,6632,5,13,12,11,53,38,15,51
Admira Wacke,6632,6,14,7,15,48,59,-11,49
SV Josko Rie,6632,7,13,6,17,38,53,-15,45
RZ Pellets W,6632,8,8,10,18,42,59,-17,34
Mattersburg,6632,9,7,9,20,39,65,-26,30
St. Pölten,6632,10,7,8,21,43,69,-26,29
FC Salzburg,6633,1,23,8,5,68,32,36,77
SC Rheindorf,6633,2,19,10,7,53,39,14,67
Vienna,6633,3,20,4,12,59,49,10,64
SK Sturm Gra,6633,4,17,7,12,55,34,21,58
RZ Pellets W,6633,5,14,6,16,48,54,-6,48
Rapid Vienna,6633,6,11,12,13,49,41,8,45
Mattersburg,6633,7,11,8,17,40,51,-11,41
St. Pölten,6633,8,10,9,17,52,67,-15,39
Admira Wacke,6633,9,8,8,20,31,59,-28,32
SV Josko Rie,6633,10,8,6,22,26,55,-29,30
SC Rheindorf,6634,1,22,7,7,63,42,21,73
FC Salzburg,6634,2,21,9,6,62,29,33,72
SK Sturm Gra,6634,3,20,8,8,70,34,36,68
Vienna,6634,4,17,3,16,62,62,0,54
RZ Pellets W,6634,5,13,8,15,49,56,-7,47
Rapid Vienna,6634,6,11,13,12,58,45,13,46
St. Pölten,6634,7,10,8,18,45,66,-21,38
Mattersburg,6634,8,9,10,17,42,62,-20,37
SV Josko Rie,6634,9,11,3,22,34,58,-24,36
Admira Wacke,6634,10,9,5,22,33,64,-31,32
SC Rheindorf,6635,1,23,5,8,58,35,23,74
FC Salzburg,6635,2,21,8,7,63,29,34,71
SK Sturm Gra,6635,3,17,7,12,54,35,19,58
Vienna,6635,4,17,4,15,55,51,4,55
Rapid Vienna,6635,5,14,9,13,54,44,10,51
RZ Pellets W,6635,6,13,8,15,46,53,-7,47
SV Josko Rie,6635,7,12,6,18,38,53,-15,42
St. Pölten,6635,8,10,8,18,44,65,-21,38
Admira Wacke,6635,9,10,5,21,36,62,-26,35
Mattersburg,6635,10,8,10,18,35,56,-21,34
SC Rheindorf,6636,1,22,7,7,60,36,24,73
FC Salzburg,6636,2,19,9,8,62,31,31,66
Vienna,6636,3,19,7,10,61,47,14,64
Rapid Vienna,6636,4,14,11,11,60,41,19,53
SK Sturm Gra,6636,5,13,10,13,47,38,9,49
RZ Pellets W,6636,6,13,8,15,44,51,-7,47
Admira Wacke,6636,7,11,9,16,40,57,-17,42
St. Pölten,6636,8,11,8,17,41,56,-15,41
Mattersburg,6636,9,9,8,19,30,53,-23,35
SV Josko Rie,6636,10,8,5,23,24,59,-35,29
SK Sturm Gra,6637,1,21,8,7,62,29,33,71
FC Salzburg,6637,2,20,7,9,67,37,30,67
SC Rheindorf,6637,3,18,9,9,57,42,15,63
Vienna,6637,4,17,3,16,62,53,9,54
Rapid Vienna,6637,5,13,14,9,58,40,18,53
RZ Pellets W,6637,6,12,9,15,42,54,-12,45
SV Josko Rie,6637,7,12,4,20,37,60,-23,40
St. Pölten,6637,8,9,12,15,43,63,-20,39
Mattersburg,6637,9,9,9,18,40,56,-16,36
Admira Wacke,6637,10,9,5,22,38,72,-34,32
SC Rheindorf,6638,1,20,7,9,55,41,14,67
FC Salzburg,6638,2,19,9,8,59,29,30,66
SK Sturm Gra,6638,3,19,8,9,58,34,24,65
Vienna,6638,4,17,9,10,59,48,11,60
Rapid Vienna,6638,5,15,9,12,56,42,14,54
RZ Pellets W,6638,6,12,10,14,48,55,-7,46
St. Pölten,6638,7,12,9,15,42,55,-13,45
SV Josko Rie,6638,8,10,5,21,26,49,-23,35
Admira Wacke,6638,9,9,7,20,38,59,-21,34
Mattersburg,6638,10,6,9,21,36,65,-29,27
FC Salzburg,6639,1,19,8,9,62,31,31,65
SC Rheindorf,6639,2,19,8,9,56,44,12,65
Vienna,6639,3,19,6,11,65,47,18,63
SK Sturm Gra,6639,4,17,5,14,57,38,19,56
Rapid Vienna,6639,5,14,10,12,53,41,12,52
RZ Pellets W,6639,6,15,7,14,46,52,-6,52
Admira Wacke,6639,7,12,7,17,35,54,-19,43
SV Josko Rie,6639,8,11,7,18,34,52,-18,40
St. Pölten,6639,9,8,10,18,37,63,-26,34
Mattersburg,6639,10,8,8,20,35,58,-23,32
SC Rheindorf,6640,1,22,7,7,61,39,22,73
FC Salzburg,6640,2,22,6,8,70,31,39,72
SK Sturm Gra,6640,3,18,7,11,56,43,13,61
Vienna,6640,4,17,8,11,69,53,16,59
Rapid Vienna,6640,5,12,13,11,67,54,13,49
RZ Pellets W,6640,6,11,10,15,46,63,-17,43
Admira Wacke,6640,7,10,9,17,40,67,-27,39
SV Josko Rie,6640,8,10,8,18,39,53,-14,38
Mattersburg,6640,9,7,10,19,40,63,-23,31
St. Pölten,6640,10,6,12,18,42,64,-22,30
FC Salzburg,6641,1,25,4,7,78,31,47,79
SK Sturm Gra,6641,2,20,6,10,62,35,27,66
SC Rheindorf,6641,3,20,6,10,60,49,11,66
Vienna,6641,4,19,6,11,64,54,10,63
RZ Pellets W,6641,5,14,6,16,51,61,-10,48
Admira Wacke,6641,6,12,6,18,38,58,-20,42
Rapid Vienna,6641,7,10,11,15,49,45,4,41
SV Josko Rie,6641,8,10,5,21,30,52,-22,35
St. Pölten,6641,9,9,7,20,41,63,-22,34
Mattersburg,6641,10,8,9,19,40,65,-25,33
SC Rheindorf,6642,1,19,11,6,54,39,15,68
SK Sturm Gra,6642,2,19,9,8,56,30,26,66
FC Salzburg,6642,3,18,10,8,60,37,23,64
Vienna,6642,4,17,8,11,66,54,12,59
Rapid Vienna,6642,5,16,9,11,61,36,25,57
RZ Pellets W,6642,6,13,5,18,47,59,-12,44
Admira Wacke,6642,7,12,7,17,34,56,-22,43
SV Josko Rie,6642,8,9,8,19,43,57,-14,35
Mattersburg,6642,9,8,9,19,42,65,-23,33
St. Pölten,6642,10,6,10,20,39,69,-30,28
Vienna,6643,1,20,6,10,68,50,18,66
SK Sturm Gra,6643,2,20,5,11,60,35,25,65
FC Salzburg,6643,3,19,7,10,60,31,29,64
SC Rheindorf,6643,4,18,9,9,54,38,16,63
Rapid Vienna,6643,5,14,11,11,56,46,10,53
SV Josko Rie,6643,6,13,4,19,37,47,-10,43
Admira Wacke,6643,7,11,8,17,41,58,-17,41
RZ Pellets W,6643,8,11,6,19,40,66,-26,39
Mattersburg,6643,9,9,10,17,37,57,-20,37
St. Pölten,6643,10,7,10,19,35,60,-25,31
SC Rheindorf,6644,1,21,6,9,54,36,18,69
FC Salzburg,6644,2,21,5,10,69,33,36,68
Vienna,6644,3,20,4,12,66,49,17,64
SK Sturm Gra,6644,4,18,6,12,52,35,17,60
RZ Pellets W,6644,5,13,8,15,49,54,-5,47
Rapid Vienna,6644,6,12,10,14,49,39,10,46
SV Josko Rie,6644,7,13,3,20,41,56,-15,42
Mattersburg,6644,8,10,9,17,37,60,-23,39
Admira Wacke,6644,9,8,12,16,35,63,-28,36
St. Pölten,6644,10,9,7,20,40,67,-27,34
FC Salzburg,6645,1,22,7,7,67,32,35,73
SC Rheindorf,6645,2,19,9,8,54,35,19,66
Vienna,6645,3,20,6,10,65,49,16,66
SK Sturm Gra,6645,4,19,7,10,59,31,28,64
Rapid Vienna,6645,5,13,9,14,51,43,8,48
Admira Wacke,6645,6,14,6,16,38,56,-18,48
RZ Pellets W,6645,7,12,4,20,43,62,-19,40
SV Josko Rie,6645,8,11,5,20,33,55,-22,38
Mattersburg,6645,9,8,9,19,36,55,-19,33
St. Pölten,6645,10,5,12,19,35,63,-28,27
SC Rheindorf,6646,1,22,7,7,67,44,23,73
FC Salzburg,6646,2,21,8,7,70,35,35,71
SK Sturm Gra,6646,3,20,5,11,62,36,26,65
Vienna,6646,4,19,5,12,65,53,12,62
Rapid Vienna,6646,5,11,12,13,50,48,2,45
SV Josko Rie,6646,6,13,4,19,40,51,-11,43
RZ Pellets W,6646,7,12,6,18,45,59,-14,42
Admira Wacke,6646,8,11,4,21,37,62,-25,37
St. Pölten,6646,9,8,12,16,43,66,-23,36
Mattersburg,6646,10,7,9,20,35,60,-25,30
FC Salzburg,6647,1,23,7,6,67,27,40,76
SK Sturm Gra,6647,2,19,8,9,57,32,25,65
SC Rheindorf,6647,3,19,5,12,51,44,7,62
Vienna,6647,4,17,9,10,62,50,12,60
Rapid Vienna,6647,5,13,11,12,57,42,15,50
RZ Pellets W,6647,6,11,11,14,45,58,-13,44
Admira Wacke,6647,7,12,8,16,38,57,-19,44
St. Pölten,6647,8,9,12,15,45,58,-13,39
Mattersburg,6647,9,6,11,19,31,57,-26,29
SV Josko Rie,6647,10,8,4,24,34,62,-28,28
FC Salzburg,6648,1,21,9,6,68,29,39,72
SC Rheindorf,6648,2,18,11,7,58,43,15,65
SK Sturm Gra,6648,3,18,8,10,61,35,26,62
Vienna,6648,4,18,5,13,59,55,4,59
Rapid Vienna,6648,5,13,11,12,55,43,12,50
RZ Pellets W,6648,6,11,10,15,49,56,-7,43
SV Josko Rie,6648,7,11,6,19,37,55,-18,39
St. Pölten,6648,8,9,10,17,41,64,-23,37
Admira Wacke,6648,9,10,7,19,34,61,-27,37
Mattersburg,6648,10,6,13,17,35,56,-21,31
FC Salzburg,6649,1,20,8,8,64,29,35,68
SK Sturm Gra,6649,2,20,8,8,57,29,28,68
SC Rheindorf,6649,3,17,11,8,44,33,11,62
Rapid Vienna,6649,4,16,8,12,59,47,12,56
Vienna,6649,5,16,6,14,56,47,9,54
RZ Pellets W,6649,6,12,9,15,44,54,-10,45
St. Pölten,6649,7,9,10,17,43,63,-20,37
Admira Wacke,6649,8,11,4,21,37,63,-26,37
SV Josko Rie,6649,9,8,12,16,31,49,-18,36
Mattersburg,6649,10,8,10,18,31,52,-21,34
SC Rheindorf,6650,1,20,7,9,58,41,17,67
FC Salzburg,6650,2,19,9,8,56,28,28,66
Vienna,6650,3,19,7,10,70,48,22,64
SK Sturm Gra,6650,4,18,8,10,67,41,26,62
Rapid Vienna,6650,5,15,11,10,50,34,16,56
Admira Wacke,6650,6,11,8,17,44,62,-18,41
RZ Pellets W,6650,7,10,9,17,47,63,-16,39
SV Josko Rie,6650,8,11,6,19,36,56,-20,39
Mattersburg,6650,9,9,8,19,37,60,-23,35
St. Pölten,6650,10,7,9,20,39,71,-32,30
FC Salzburg,6651,1,20,8,8,69,36,33,68
SC Rheindorf,6651,2,19,6,11,54,48,6,63
Vienna,6651,3,19,4,13,65,53,12,61
SK Sturm Gra,6651,4,16,10,10,50,29,21,58
Rapid Vienna,6651,5,12,13,11,50,45,5,49
RZ Pellets W,6651,6,12,8,16,44,49,-5,44
SV Josko Rie,6651,7,11,9,16,38,52,-14,42
St. Pölten,6651,8,9,11,16,41,58,-17,38
Admira Wacke,6651,9,10,8,18,35,58,-23,38
Mattersburg,6651,10,8,11,17,37,55,-18,35
FC Salzburg,6652,1,21,10,5,69,29,40,73
Vienna,6652,2,21,6,9,72,48,24,69
SK Sturm Gra,6652,3,20,6,10,70,35,35,66
SC Rheindorf,6652,4,18,8,10,50,47,3,62
Rapid Vienna,6652,5,14,10,12,57,43,14,52
St. Pölten,6652,6,11,7,18,41,61,-20,40
SV Josko Rie,6652,7,10,7,19,36,59,-23,37
RZ Pellets W,6652,8,9,8,19,34,57,-23,35
Mattersburg,6652,9,8,10,18,42,61,-19,34
Admira Wacke,6652,10,7,10,19,34,65,-31,31
FC Salzburg,6653,1,23,7,6,68,29,39,76
SK Sturm Gra,6653,2,20,7,9,66,37,29,67
SC Rheindorf,6653,3,20,7,9,60,43,17,67
Vienna,6653,4,18,4,14,64,58,6,58
Rapid Vienna,6653,5,13,10,13,51,43,8,49
RZ Pellets W,6653,6,13,8,15,47,49,-2,47
Admira Wacke,6653,7,12,9,15,39,55,-16,45
St. Pölten,6653,8,9,7,20,43,67,-24,34
Mattersburg,6653,9,8,8,20,36,61,-25,32
SV Josko Rie,6653,10,8,5,23,31,63,-32,29
FC Salzburg,6654,1,22,5,9,69,35,34,71
SC Rheindorf,6654,2,19,9,8,48,37,11,66
SK Sturm Gra,6654,3,19,7,10,58,35,23,64
Vienna,6654,4,18,5,13,62,49,13,59
RZ Pellets W,6654,5,16,9,11,50,45,5,57
Rapid Vienna,6654,6,15,8,13,56,48,8,53
SV Josko Rie,6654,7,13,3,20,35,49,-14,42
Admira Wacke,6654,8,10,8,18,39,56,-17,38
Mattersburg,6654,9,7,8,21,33,63,-30,29
St. Pölten,6654,10,6,8,22,37,70,-33,26
FC Salzburg,6655,1,19,10,7,61,33,28,67
SK Sturm Gra,6655,2,19,6,11,59,33,26,63
SC Rheindorf,6655,3,18,6,12,55,46,9,60
Vienna,6655,4,17,5,14,63,53,10,56
Rapid Vienna,6655,5,12,13,11,54,39,15,49
RZ Pellets W,6655,6,13,7,16,48,55,-7,46
SV Josko Rie,6655,7,13,6,17,38,50,-12,45
Mattersburg,6655,8,12,7,17,42,59,-17,43
Admira Wacke,6655,9,11,9,16,40,58,-18,42
St. Pölten,6655,10,8,7,21,37,71,-34,31
FC Salzburg,6656,1,20,10,6,63,31,32,70
SK Sturm Gra,6656,2,21,5,10,62,33,29,68
SC Rheindorf,6656,3,20,5,11,63,42,21,65
Vienna,6656,4,18,6,12,61,55,6,60
Rapid Vienna,6656,5,13,10,13,52,42,10,49
St. Pölten,6656,6,12,8,16,51,61,-10,44
SV Josko Rie,6656,7,13,5,18,44,56,-12,44
Admira Wacke,6656,8,12,5,19,42,67,-25,41
RZ Pellets W,6656,9,10,7,19,44,68,-24,37
Mattersburg,6656,10,7,7,22,38,65,-27,28
SC Rheindorf,6657,1,21,7,8,56,36,20,70
SK Sturm Gra,6657,2,21,6,9,59,32,27,69
FC Salzburg,6657,3,19,10,7,57,26,31,67
Vienna,6657,4,18,7,11,60,48,12,61
RZ Pellets W,6657,5,14,7,15,49,50,-1,49
Rapid Vienna,6657,6,11,11,14,45,40,5,44
Admira Wacke,6657,7,12,6,18,36,57,-21,42
Mattersburg,6657,8,9,8,19,32,56,-24,35
SV Josko Rie,6657,9,8,8,20,29,51,-22,32
St. Pölten,6657,10,8,8,20,35,62,-27,32
FC Salzburg,6658,1,22,8,6,76,31,45,74
SK Sturm Gra,6658,2,20,6,10,66,37,29,66
SC Rheindorf,6658,3,19,5,12,56,51,5,62
Vienna,6658,4,17,7,12,64,52,12,58
SV Josko Rie,6658,5,13,5,18,41,53,-12,44
RZ Pellets W,6658,6,12,7,17,45,56,-11,43
Admira Wacke,6658,7,12,7,17,36,61,-25,43
St. Pölten,6658,8,10,12,14,42,58,-16,42
Rapid Vienna,6658,9,10,11,15,49,48,1,41
Mattersburg,6658,10,5,12,19,33,61,-28,27
SK Sturm Gra,6659,1,21,5,10,57,35,22,68
SC Rheindorf,6659,2,20,7,9,60,44,16,67
Vienna,6659,3,20,5,11,67,54,13,65
FC Salzburg,6659,4,19,7,10,68,35,33,64
RZ Pellets W,6659,5,13,6,17,47,58,-11,45
Admira Wacke,6659,6,13,6,17,42,61,-19,45
Rapid Vienna,6659,7,11,10,15,52,47,5,43
St. Pölten,6659,8,11,8,17,48,58,-10,41
SV Josko Rie,6659,9,10,6,20,32,52,-20,36
Mattersburg,6659,10,8,8,20,33,62,-29,32
FC Salzburg,6660,1,23,5,8,68,25,43,74
SC Rheindorf,6660,2,20,8,8,60,40,20,68
SK Sturm Gra,6660,3,19,7,10,65,38,27,64
Rapid Vienna,6660,4,15,9,12,46,36,10,54
Vienna,6660,5,15,4,17,55,58,-3,49
Mattersburg,6660,6,12,6,18,40,47,-7,42
RZ Pellets W,6660,7,12,6,18,43,60,-17,42
Admira Wacke,6660,8,11,8,17,35,59,-24,41
SV Josko Rie,6660,9,11,6,19,36,55,-19,39
St. Pölten,6660,10,8,9,19,34,64,-30,33
FC Salzburg,6661,1,20,10,6,66,32,34,70
Vienna,6661,2,21,3,12,75,54,21,66
SK Sturm Gra,6661,3,19,6,11,63,36,27,63
SC Rheindorf,6661,4,17,8,11,51,44,7,59
Rapid Vienna,6661,5,15,12,9,59,35,24,57
RZ Pellets W,6661,6,12,10,14,44,54,-10,46
Mattersburg,6661,7,10,9,17,38,56,-18,39
SV Josko Rie,6661,8,10,6,20,32,62,-30,36
Admira Wacke,6661,9,9,7,20,33,59,-26,34
St. Pölten,6661,10,8,7,21,36,65,-29,31
SC Rheindorf,6662,1,23,7,6,60,38,22,76
FC Salzburg,6662,2,21,10,5,68,30,38,73
SK Sturm Gra,6662,3,17,5,14,56,38,18,56
RZ Pellets W,6662,4,16,7,13,53,53,0,55
Vienna,6662,5,16,6,14,62,60,2,54
Rapid Vienna,6662,6,12,11,13,51,42,9,47
Admira Wacke,6662,7,10,11,15,35,55,-20,41
SV Josko Rie,6662,8,11,4,21,39,53,-14,37
Mattersburg,6662,9,9,9,18,30,55,-25,36
St. Pölten,6662,10,6,8,22,38,68,-30,26
FC Salzburg,6663,1,21,7,8,64,35,29,70
SC Rheindorf,6663,2,20,7,9,64,43,21,67
SK Sturm Gra,6663,3,18,9,9,60,37,23,63
Vienna,6663,4,18,6,12,60,53,7,60
RZ Pellets W,6663,5,14,6,16,50,59,-9,48
Admira Wacke,6663,6,14,5,17,41,59,-18,47
Rapid Vienna,6663,7,12,10,14,55,39,16,46
St. Pölten,6663,8,7,13,16,36,60,-24,34
SV Josko Rie,6663,9,9,7,20,34,58,-24,34
Mattersburg,6663,10,8,8,20,41,62,-21,32
FC Salzburg,6664,1,21,7,8,78,34,44,70
SC Rheindorf,6664,2,19,9,8,59,42,17,66
SK Sturm Gra,6664,3,20,4,12,58,37,21,64
Vienna,6664,4,19,5,12,66,59,7,62
Rapid Vienna,6664,5,16,7,13,57,46,11,55
RZ Pellets W,6664,6,13,8,15,49,55,-6,47
Admira Wacke,6664,7,13,4,19,47,65,-18,43
SV Josko Rie,6664,8,10,7,19,35,56,-21,37
St. Pölten,6664,9,8,11,17,41,60,-19,35
Mattersburg,6664,10,5,10,21,35,71,-36,25
FC Salzburg,6665,1,19,8,9,58,32,26,65
SC Rheindorf,6665,2,18,11,7,61,42,19,65
SK Sturm Gra,6665,3,19,7,10,59,35,24,64
Vienna,6665,4,18,9,9,60,48,12,63
Rapid Vienna,6665,5,11,12,13,52,44,8,45
SV Josko Rie,6665,6,9,12,15,40,53,-13,39
RZ Pellets W,6665,7,10,9,17,50,64,-14,39
St. Pölten,6665,8,9,12,15,43,66,-23,39
Mattersburg,6665,9,10,8,18,43,55,-12,38
Admira Wacke,6665,10,9,8,19,33,60,-27,35
FC Salzburg,6666,1,24,6,6,71,30,41,78
SK Sturm Gra,6666,2,19,10,7,60,32,28,67
SC Rheindorf,6666,3,19,9,8,54,40,14,66
Vienna,6666,4,19,6,11,71,56,15,63
Rapid Vienna,6666,5,12,11,13,52,43,9,47
RZ Pellets W,6666,6,10,9,17,48,59,-11,39
Admira Wacke,6666,7,10,8,18,33,58,-25,38
SV Josko Rie,6666,8,10,7,19,33,56,-23,37
St. Pölten,6666,9,8,10,18,43,65,-22,34
Mattersburg,6666,10,7,8,21,39,65,-26,29
FC Salzburg,6667,1,22,8,6,75,37,38,74
Vienna,6667,2,20,6,10,69,55,14,66
SC Rheindorf,6667,3,18,8,10,65,49,16,62
SK Sturm Gra,6667,4,17,8,11,51,33,18,59
Rapid Vienna,6667,5,13,13,10,65,53,12,52
RZ Pellets W,6667,6,11,11,14,43,51,-8,44
SV Josko Rie,6667,7,10,7,19,38,62,-24,37
Admira Wacke,6667,8,9,9,18,40,60,-20,36
Mattersburg,6667,9,8,11,17,38,57,-19,35
St. Pölten,6667,10,6,11,19,43,70,-27,29
FC Salzburg,6668,1,20,8,8,62,31,31,68
SC Rheindorf,6668,2,20,8,8,52,39,13,68
SK Sturm Gra,6668,3,20,6,10,61,37,24,66
Vienna,6668,4,20,6,10,69,49,20,66
Rapid Vienna,6668,5,14,12,10,55,41,14,54
RZ Pellets W,6668,6,12,8,16,44,57,-13,44
Admira Wacke,6668,7,11,6,19,42,66,-24,39
SV Josko Rie,6668,8,11,3,22,35,57,-22,36
Mattersburg,6668,9,9,8,19,34,51,-17,35
St. Pölten,6668,10,7,7,22,39,65,-26,28
FC Salzburg,6669,1,24,6,6,73,28,45,78
SC Rheindorf,6669,2,21,8,7,69,43,26,71
SK Sturm Gra,6669,3,19,5,12,56,35,21,62
Vienna,6669,4,19,4,13,61,56,5,61
Rapid Vienna,6669,5,16,8,12,59,37,22,56
RZ Pellets W,6669,6,14,8,14,45,49,-4,50
Admira Wacke,6669,7,10,5,21,30,61,-31,35
Mattersburg,6669,8,8,8,20,37,60,-23,32
SV Josko Rie,6669,9,8,7,21,31,58,-27,31
St. Pölten,6669,10,7,9,20,42,76,-34,30
Vienna,6670,1,21,5,10,64,45,19,68
FC Salzburg,6670,2,18,10,8,64,32,32,64
SC Rheindorf,6670,3,17,10,9,51,40,11,61
SK Sturm Gra,6670,4,17,8,11,67,41,26,59
Rapid Vienna,6670,5,16,10,10,54,41,13,58
RZ Pellets W,6670,6,13,7,16,51,60,-9,46
SV Josko Rie,6670,7,13,5,18,39,61,-22,44
Mattersburg,6670,8,9,12,15,42,54,-12,39
Admira Wacke,6670,9,9,6,21,36,63,-27,33
St. Pölten,6670,10,6,9,21,38,69,-31,27
FC Salzburg,6671,1,21,7,8,67,31,36,70
SK Sturm Gra,6671,2,21,5,10,64,35,29,68
Vienna,6671,3,18,6,12,68,55,13,60
SC Rheindorf,6671,4,16,11,9,51,46,5,59
Rapid Vienna,6671,5,15,11,10,57,40,17,56
RZ Pellets W,6671,6,13,10,13,53,58,-5,49
SV Josko Rie,6671,7,11,6,19,35,53,-18,39
Admira Wacke,6671,8,10,7,19,37,60,-23,37
St. Pölten,6671,9,8,8,20,41,73,-32,32
Mattersburg,6671,10,7,9,20,33,55,-22,30
SC Rheindorf,6672,1,23,5,8,58,35,23,74
Vienna,6672,2,21,5,10,67,50,17,68
FC Salzburg,6672,3,18,7,11,59,39,20,61
SK Sturm Gra,6672,4,16,7,13,51,38,13,55
Rapid Vienna,6672,5,13,10,13,57,41,16,49
Admira Wacke,6672,6,14,4,18,39,57,-18,46
RZ Pellets W,6672,7,13,5,18,45,58,-13,44
SV Josko Rie,6672,8,12,5,19,35,56,-21,41
Mattersburg,6672,9,10,8,18,39,46,-7,38
St. Pölten,6672,10,6,12,18,34,64,-30,30
FC Salzburg,6673,1,24,5,7,72,29,43,77
SK Sturm Gra,6673,2,21,6,9,56,30,26,69
SC Rheindorf,6673,3,20,5,11,59,46,13,65
Vienna,6673,4,18,4,14,61,48,13,58
Rapid Vienna,6673,5,14,10,12,64,46,18,52
Admira Wacke,6673,6,14,4,18,39,58,-19,46
RZ Pellets W,6673,7,12,8,16,48,60,-12,44
SV Josko Rie,6673,8,10,5,21,29,58,-29,35
Mattersburg,6673,9,8,8,20,38,62,-24,32
St. Pölten,6673,10,8,7,21,44,73,-29,31
FC Salzburg,6674,1,21,7,8,63,26,37,70
Vienna,6674,2,22,3,11,64,54,10,69
SC Rheindorf,6674,3,19,7,10,58,41,17,64
SK Sturm Gra,6674,4,19,5,12,55,36,19,62
Rapid Vienna,6674,5,15,10,11,60,39,21,55
RZ Pellets W,6674,6,14,5,17,45,53,-8,47
St. Pölten,6674,7,10,11,15,46,57,-11,41
Admira Wacke,6674,8,10,5,21,33,66,-33,35
Mattersburg,6674,9,8,9,19,34,57,-23,33
SV Josko Rie,6674,10,7,8,21,25,54,-29,29
SC Rheindorf,6675,1,22,5,9,54,37,17,71
FC Salzburg,6675,2,20,9,7,60,30,30,69
SK Sturm Gra,6675,3,22,3,11,57,32,25,69
Vienna,6675,4,19,4,13,60,49,11,61
RZ Pellets W,6675,5,12,10,14,39,48,-9,46
Admira Wacke,6675,6,14,4,18,43,62,-19,46
Rapid Vienna,6675,7,10,11,15,49,44,5,41
SV Josko Rie,6675,8,11,3,22,43,62,-19,36
Mattersburg,6675,9,8,9,19,38,58,-20,33
St. Pölten,6675,10,7,12,17,40,61,-21,33
FC Salzburg,6676,1,22,9,5,70,28,42,75
SC Rheindorf,6676,2,20,9,7,59,40,19,69
Rapid Vienna,6676,3,17,10,9,61,36,25,61
Vienna,6676,4,18,6,12,65,51,14,60
SK Sturm Gra,6676,5,17,6,13,55,36,19,57
Admira Wacke,6676,6,13,8,15,36,48,-12,47
RZ Pellets W,6676,7,11,7,18,42,56,-14,40
SV Josko Rie,6676,8,8,8,20,32,59,-27,32
Mattersburg,6676,9,8,6,22,31,60,-29,30
St. Pölten,6676,10,6,11,19,33,70,-37,29
FC Salzburg,6677,1,20,10,6,72,30,42,70
SC Rheindorf,6677,2,18,10,8,59,40,19,64
SK Sturm Gra,6677,3,16,11,9,61,38,23,59
Vienna,6677,4,17,7,12,58,52,6,58
Rapid Vienna,6677,5,14,12,10,49,39,10,54
RZ Pellets W,6677,6,15,6,15,51,56,-5,51
St. Pölten,6677,7,10,8,18,50,68,-18,38
SV Josko Rie,6677,8,10,6,20,33,52,-19,36
Mattersburg,6677,9,8,10,18,35,58,-23,34
Admira Wacke,6677,10,8,8,20,29,64,-35,32
FC Salzburg,6678,1,21,9,6,69,33,36,72
SK Sturm Gra,6678,2,20,8,8,67,32,35,68
Vienna,6678,3,17,8,11,60,50,10,59
SC Rheindorf,6678,4,16,9,11,55,42,13,57
RZ Pellets W,6678,5,13,9,14,48,53,-5,48
Rapid Vienna,6678,6,11,14,11,52,45,7,47
Admira Wacke,6678,7,11,8,17,35,63,-28,41
St. Pölten,6678,8,8,11,17,36,59,-23,35
SV Josko Rie,6678,9,8,9,19,33,56,-23,33
Mattersburg,6678,10,7,11,18,38,60,-22,32
FC Salzburg,6679,1,20,7,9,62,36,26,67
SK Sturm Gra,6679,2,19,8,9,60,32,28,65
SC Rheindorf,6679,3,19,7,10,57,44,13,64
Rapid Vienna,6679,4,15,12,9,57,35,22,57
Vienna,6679,5,17,6,13,59,55,4,57
Admira Wacke,6679,6,13,6,17,40,55,-15,45
RZ Pellets W,6679,7,12,7,17,43,56,-13,43
St. Pölten,6679,8,8,12,16,42,60,-18,36
Mattersburg,6679,9,8,9,19,37,59,-22,33
SV Josko Rie,6679,10,9,6,21,32,57,-25,33
FC Salzburg,6680,1,22,7,7,61,26,35,73
SC Rheindorf,6680,2,19,5,12,47,37,10,62
SK Sturm Gra,6680,3,17,10,9,51,32,19,61
Vienna,6680,4,19,4,13,62,55,7,61
Rapid Vienna,6680,5,16,8,12,60,36,24,56
RZ Pellets W,6680,6,12,8,16,46,55,-9,44
Mattersburg,6680,7,11,7,18,42,58,-16,40
Admira Wacke,6680,8,10,9,17,32,51,-19,39
SV Josko Rie,6680,9,10,5,21,26,50,-24,35
St. Pölten,6680,10,8,9,19,38,65,-27,33
FC Salzburg,6681,1,22,9,5,69,26,43,75
SC Rheindorf,6681,2,20,9,7,63,37,26,69
Vienna,6681,3,21,3,12,60,50,10,66
SK Sturm Gra,6681,4,18,7,11,56,44,12,61
Rapid Vienna,6681,5,14,12,10,60,41,19,54
St. Pölten,6681,6,12,7,17,45,63,-18,43
Admira Wacke,6681,7,11,6,19,35,58,-23,39
SV Josko Rie,6681,8,11,3,22,31,53,-22,36
RZ Pellets W,6681,9,8,7,21,42,61,-19,31
Mattersburg,6681,10,8,7,21,31,59,-28,31
SC Rheindorf,6682,1,21,7,8,58,38,20,70
Vienna,6682,2,21,6,9,66,47,19,69
FC Salzburg,6682,3,19,9,8,61,30,31,66
SK Sturm Gra,6682,4,16,8,12,52,35,17,56
RZ Pellets W,6682,5,14,9,13,44,45,-1,51
Rapid Vienna,6682,6,13,11,12,51,40,11,50
SV Josko Rie,6682,7,12,6,18,37,48,-11,42
Admira Wacke,6682,8,9,7,20,31,62,-31,34
Mattersburg,6682,9,8,8,20,37,59,-22,32
St. Pölten,6682,10,7,9,20,43,76,-33,30
FC Salzburg,6683,1,21,9,6,76,30,46,72
SC Rheindorf,6683,2,20,4,12,54,44,10,64
SK Sturm Gra,6683,3,17,9,10,57,40,17,60
Rapid Vienna,6683,4,16,10,10,56,40,16,58
Vienna,6683,5,18,4,14,63,55,8,58
SV Josko Rie,6683,6,13,6,17,33,49,-16,45
Admira Wacke,6683,7,12,8,16,39,57,-18,44
RZ Pellets W,6683,8,11,7,18,41,58,-17,40
Mattersburg,6683,9,6,13,17,30,51,-21,31
St. Pölten,6683,10,5,12,19,39,64,-25,27
SC Rheindorf,6684,1,22,7,7,60,34,26,73
SK Sturm Gra,6684,2,21,5,10,59,37,22,68
FC Salzburg,6684,3,19,7,10,63,32,31,64
Vienna,6684,4,17,8,11,61,47,14,59
Rapid Vienna,6684,5,15,13,8,56,38,18,58
Admira Wacke,6684,6,11,9,16,36,57,-21,42
SV Josko Rie,6684,7,11,6,19,33,56,-23,39
RZ Pellets W,6684,8,9,10,17,42,56,-14,37
St. Pölten,6684,9,7,9,20,34,65,-31,30
Mattersburg,6684,10,6,10,20,34,56,-22,28
SK Sturm Gra,6685,1,20,7,9,58,33,25,67
Vienna,6685,2,21,3,12,67,50,17,66
SC Rheindorf,6685,3,19,9,8,54,40,14,66
FC Salzburg,6685,4,18,10,8,67,39,28,64
Rapid Vienna,6685,5,13,13,10,63,43,20,52
RZ Pellets W,6685,6,12,9,15,45,55,-10,45
St. Pölten,6685,7,10,9,17,44,60,-16,39
SV Josko Rie,6685,8,11,5,20,35,62,-27,38
Admira Wacke,6685,9,9,8,19,36,62,-26,35
Mattersburg,6685,10,6,9,21,34,59,-25,27
FC Salzburg,6686,1,21,9,6,64,25,39,72
SK Sturm Gra,6686,2,19,6,11,58,33,25,63
SC Rheindorf,6686,3,18,7,11,49,44,5,61
Vienna,6686,4,18,5,13,58,48,10,59
RZ Pellets W,6686,5,15,5,16,47,50,-3,50
Admira Wacke,6686,6,14,8,14,43,54,-11,50
Rapid Vienna,6686,7,10,10,16,43,47,-4,40
St. Pölten,6686,8,10,9,17,44,59,-15,39
SV Josko Rie,6686,9,10,5,21,37,58,-21,35
Mattersburg,6686,10,9,8,19,33,58,-25,35
Vienna,6687,1,20,7,9,64,44,20,67
FC Salzburg,6687,2,18,9,9,60,36,24,63
SC Rheindorf,6687,3,19,6,11,50,40,10,63
SK Sturm Gra,6687,4,17,7,12,53,35,18,58
Rapid Vienna,6687,5,14,13,9,56,35,21,55
RZ Pellets W,6687,6,10,10,16,44,54,-10,40
Admira Wacke,6687,7,12,4,20,34,63,-29,40
Mattersburg,6687,8,10,8,18,37,49,-12,38
St. Pölten,6687,9,9,11,16,39,60,-21,38
SV Josko Rie,6687,10,11,5,20,36,57,-21,38
FC Salzburg,6688,1,22,8,6,75,37,38,74
SC Rheindorf,6688,2,20,9,7,63,40,23,69
SK Sturm Gra,6688,3,17,9,10,56,35,21,60
Rapid Vienna,6688,4,17,9,10,60,42,18,60
Vienna,6688,5,16,7,13,57,51,6,55
RZ Pellets W,6688,6,14,9,13,44,49,-5,51
SV Josko Rie,6688,7,13,5,18,40,56,-16,44
Mattersburg,6688,8,6,11,19,31,55,-24,29
Admira Wacke,6688,9,7,8,21,27,61,-34,29
St. Pölten,6688,10,6,9,21,44,71,-27,27
FC Salzburg,6689,1,22,7,7,62,26,36,73
SC Rheindorf,6689,2,20,8,8,56,40,16,68
SK Sturm Gra,6689,3,20,5,11,61,37,24,65
Vienna,6689,4,19,7,10,65,45,20,64
Rapid Vienna,6689,5,13,9,14,52,43,9,48
RZ Pellets W,6689,6,13,8,15,47,54,-7,47
Admira Wacke,6689,7,12,6,18,33,56,-23,42
SV Josko Rie,6689,8,12,5,19,36,57,-21,41
Mattersburg,6689,9,9,7,20,40,56,-16,34
St. Pölten,6689,10,5,8,23,32,70,-38,23
FC Salzburg,6690,1,22,5,9,67,30,37,71
SC Rheindorf,6690,2,20,6,10,64,44,20,66
Vienna,6690,3,19,3,14,60,54,6,60
SK Sturm Gra,6690,4,17,7,12,49,34,15,58
Admira Wacke,6690,5,15,6,15,45,56,-11,51
Rapid Vienna,6690,6,13,11,12,58,43,15,50
RZ Pellets W,6690,7,12,6,18,45,62,-17,42
St. Pölten,6690,8,8,12,16,39,65,-26,36
SV Josko Rie,6690,9,9,8,19,33,54,-21,35
Mattersburg,6690,10,8,10,18,43,61,-18,34
FC Salzburg,6691,1,22,4,10,71,33,38,70
SK Sturm Gra,6691,2,20,5,11,61,33,28,65
Vienna,6691,3,20,5,11,68,49,19,65
Rapid Vienna,6691,4,18,8,10,63,36,27,62
SC Rheindorf,6691,5,17,8,11,60,51,9,59
RZ Pellets W,6691,6,11,11,14,40,54,-14,44
SV Josko Rie,6691,7,10,7,19,35,63,-28,37
St. Pölten,6691,8,9,9,18,49,66,-17,36
Mattersburg,6691,9,9,7,20,33,59,-26,34
Admira Wacke,6691,10,9,6,21,27,63,-36,33
Vienna,6692,1,19,6,11,61,46,15,63
SC Rheindorf,6692,2,19,6,11,53,42,11,63
FC Salzburg,6692,3,17,10,9,61,40,21,61
SK Sturm Gra,6692,4,16,8,12,59,39,20,56
Rapid Vienna,6692,5,14,13,9,65,43,22,55
St. Pölten,6692,6,11,11,14,46,57,-11,44
RZ Pellets W,6692,7,12,7,17,44,59,-15,43
SV Josko Rie,6692,8,12,4,20,36,56,-20,40
Admira Wacke,6692,9,11,6,19,34,55,-21,39
Mattersburg,6692,10,8,11,17,37,59,-22,35
FC Salzburg,6693,1,19,11,6,62,29,33,68
SC Rheindorf,6693,2,18,7,11,55,51,4,61
SK Sturm Gra,6693,3,18,5,13,58,37,21,59
Rapid Vienna,6693,4,16,10,10,61,39,22,58
Vienna,6693,5,17,7,12,61,51,10,58
RZ Pellets W,6693,6,12,11,13,46,51,-5,47
Admira Wacke,6693,7,11,7,18,37,57,-20,40
St. Pölten,6693,8,10,9,17,41,57,-16,39
SV Josko Rie,6693,9,10,7,19,32,55,-23,37
Mattersburg,6693,10,7,10,19,37,63,-26,31
SK Sturm Gra,6694,1,22,6,8,65,32,33,72
Vienna,6694,2,20,6,10,64,50,14,66
SC Rheindorf,6694,3,19,8,9,59,44,15,65
FC Salzburg,6694,4,18,9,9,68,34,34,63
Rapid Vienna,6694,5,15,12,9,61,38,23,57
RZ Pellets W,6694,6,12,9,15,50,55,-5,45
Admira Wacke,6694,7,8,9,19,30,62,-32,33
SV Josko Rie,6694,7,8,9,19,30,62,-32,33
Mattersburg,6694,9,7,11,18,37,57,-20,32
St. Pölten,6694,10,4,15,17,36,66,-30,27
FC Salzburg,6695,1,22,5,9,67,36,31,71
SK Sturm Gra,6695,2,19,9,8,62,32,30,66
SC Rheindorf,6695,3,19,6,11,53,45,8,63
Vienna,6695,4,16,9,11,63,57,6,57
RZ Pellets W,6695,5,12,12,12,49,51,-2,48
Admira Wacke,6695,6,12,9,15,41,57,-16,45
Rapid Vienna,6695,7,11,11,14,54,51,3,44
St. Pölten,6695,8,9,10,17,42,60,-18,37
Mattersburg,6695,9,8,10,18,38,56,-18,34
SV Josko Rie,6695,10,8,7,21,26,50,-24,31
FC Salzburg,6696,1,23,4,9,60,30,30,73
SK Sturm Gra,6696,2,22,5,9,57,26,31,71
Vienna,6696,3,20,5,11,64,50,14,65
SC Rheindorf,6696,4,19,4,13,60,44,16,61
Rapid Vienna,6696,5,16,8,12,56,35,21,56
RZ Pellets W,6696,6,13,6,17,43,61,-18,45
Admira Wacke,6696,7,13,5,18,35,54,-19,44
SV Josko Rie,6696,8,10,4,22,31,54,-23,34
St. Pölten,6696,9,9,6,21,46,72,-26,33
Mattersburg,6696,10,8,7,21,31,57,-26,31
SC Rheindorf,6697,1,21,7,8,56,38,18,70
FC Salzburg,6697,2,21,6,9,66,29,37,69
Vienna,6697,3,20,5,11,70,45,25,65
SK Sturm Gra,6697,4,17,6,13,62,44,18,57
Rapid Vienna,6697,5,14,11,11,64,48,16,53
Admira Wacke,6697,6,12,6,18,38,62,-24,42
RZ Pellets W,6697,7,11,8,17,49,68,-19,41
Mattersburg,6697,8,8,11,17,38,57,-19,35
St. Pölten,6697,9,8,11,17,40,67,-27,35
SV Josko Rie,6697,10,8,9,19,31,56,-25,33
SC Rheindorf,6698,1,20,10,6,58,33,25,70
FC Salzburg,6698,2,21,6,9,65,32,33,69
SK Sturm Gra,6698,3,18,7,11,57,38,19,61
Rapid Vienna,6698,4,16,11,9,54,37,17,59
Vienna,6698,5,17,6,13,55,48,7,57
RZ Pellets W,6698,6,12,10,14,45,53,-8,46
SV Josko Rie,6698,7,11,5,20,32,50,-18,38
Admira Wacke,6698,8,10,6,20,40,70,-30,36
St. Pölten,6698,9,7,12,17,42,64,-22,33
Mattersburg,6698,10,6,11,19,32,55,-23,29
FC Salzburg,6699,1,24,6,6,72,25,47,78
SK Sturm Gra,6699,2,21,6,9,66,32,34,69
SC Rheindorf,6699,3,21,6,9,52,39,13,69
Rapid Vienna,6699,4,14,11,11,56,44,12,53
Vienna,6699,5,15,6,15,54,52,2,51
RZ Pellets W,6699,6,14,7,15,49,54,-5,49
Admira Wacke,6699,7,10,6,20,34,64,-30,36
SV Josko Rie,6699,8,10,6,20,31,61,-30,36
St. Pölten,6699,9,7,11,18,34,56,-22,32
Mattersburg,6699,10,7,9,20,37,58,-21,30
FC Salzburg,6700,1,22,7,7,71,29,42,73
SC Rheindorf,6700,2,21,5,10,56,35,21,68
Vienna,6700,3,19,6,11,62,53,9,63
SK Sturm Gra,6700,4,17,9,10,56,31,25,60
Rapid Vienna,6700,5,14,10,12,54,45,9,52
RZ Pellets W,6700,6,11,9,16,46,53,-7,42
Admira Wacke,6700,7,12,5,19,36,57,-21,41
SV Josko Rie,6700,8,11,6,19,32,58,-26,39
St. Pölten,6700,9,8,12,16,43,64,-21,36
Mattersburg,6700,10,6,9,21,36,67,-31,27
FC Salzburg,6701,1,23,6,7,66,27,39,75
SC Rheindorf,6701,2,18,10,8,57,46,11,64
Vienna,6701,3,19,6,11,62,47,15,63
SK Sturm Gra,6701,4,19,5,12,63,38,25,62
Rapid Vienna,6701,5,16,10,10,53,37,16,58
RZ Pellets W,6701,6,12,8,16,43,56,-13,44
SV Josko Rie,6701,7,10,9,17,33,53,-20,39
Admira Wacke,6701,8,10,7,19,34,61,-27,37
St. Pölten,6701,9,7,10,19,41,64,-23,31
Mattersburg,6701,10,7,7,22,32,55,-23,28
FC Salzburg,6702,1,24,7,5,68,22,46,79
SC Rheindorf,6702,2,21,7,8,58,38,20,70
SK Sturm Gra,6702,3,19,7,10,59,34,25,64
Vienna,6702,4,17,4,15,55,49,6,55
Rapid Vienna,6702,5,13,11,12,54,39,15,50
SV Josko Rie,6702,6,11,9,16,36,53,-17,42
Admira Wacke,6702,7,12,6,18,37,63,-26,42
RZ Pellets W,6702,8,9,10,17,39,54,-15,37
St. Pölten,6702,9,8,10,18,41,69,-28,34
Mattersburg,6702,10,6,9,21,32,58,-26,27
SC Rheindorf,6703,1,22,7,7,65,39,26,73
FC Salzburg,6703,2,21,8,7,70,37,33,71
SK Sturm Gra,6703,3,17,8,11,60,38,22,59
Vienna,6703,4,17,7,12,66,56,10,58
Rapid Vienna,6703,5,15,10,11,55,44,11,55
Admira Wacke,6703,6,12,9,15,39,54,-15,45
RZ Pellets W,6703,7,12,7,17,55,65,-10,43
St. Pölten,6703,8,9,10,17,44,70,-26,37
Mattersburg,6703,9,7,9,20,41,65,-24,30
SV Josko Rie,6703,10,7,7,22,28,55,-27,28
FC Salzburg,6704,1,19,9,8,68,32,36,66
SK Sturm Gra,6704,2,19,7,10,57,31,26,64
SC Rheindorf,6704,3,18,9,9,57,45,12,63
Rapid Vienna,6704,4,17,9,10,52,33,19,60
Vienna,6704,5,16,7,13,60,52,8,55
RZ Pellets W,6704,6,11,10,15,45,56,-11,43
Admira Wacke,6704,7,12,7,17,34,58,-24,43
SV Josko Rie,6704,8,12,6,18,39,49,-10,42
Mattersburg,6704,9,6,12,18,37,60,-23,30
St. Pölten,6704,10,6,12,18,37,70,-33,30
FC Salzburg,6705,1,21,7,8,64,31,33,70
SK Sturm Gra,6705,2,21,5,10,57,28,29,68
SC Rheindorf,6705,3,19,8,9,56,42,14,65
Vienna,6705,4,20,4,12,66,54,12,64
Rapid Vienna,6705,5,11,14,11,60,47,13,47
RZ Pellets W,6705,6,13,5,18,46,57,-11,44
Admira Wacke,6705,7,10,8,18,31,56,-25,38
St. Pölten,6705,8,9,9,18,47,65,-18,36
Mattersburg,6705,9,9,9,18,35,60,-25,36
SV Josko Rie,6705,10,8,9,19,38,60,-22,33
FC Salzburg,6706,1,19,8,9,66,32,34,65
Vienna,6706,2,19,7,10,68,52,16,64
SC Rheindorf,6706,3,18,9,9,48,39,9,63
SK Sturm Gra,6706,4,14,10,12,49,38,11,52
Admira Wacke,6706,5,13,9,14,41,55,-14,48
Rapid Vienna,6706,6,12,11,13,43,36,7,47
SV Josko Rie,6706,7,12,6,18,35,47,-12,42
St. Pölten,6706,8,11,7,18,43,62,-19,40
Mattersburg,6706,9,11,6,19,38,53,-15,39
RZ Pellets W,6706,10,10,9,17,41,58,-17,39
FC Salzburg,6707,1,20,11,5,68,31,37,71
Vienna,6707,2,19,4,13,56,43,13,61
SK Sturm Gra,6707,3,18,5,13,51,37,14,59
SC Rheindorf,6707,4,16,10,10,46,44,2,58
Rapid Vienna,6707,5,14,11,11,62,45,17,53
RZ Pellets W,6707,6,14,7,15,47,56,-9,49
SV Josko Rie,6707,7,12,5,19,35,52,-17,41
Admira Wacke,6707,8,12,5,19,38,56,-18,41
St. Pölten,6707,9,10,10,16,43,61,-18,40
Mattersburg,6707,10,6,10,20,36,57,-21,28
FC Salzburg,6708,1,22,8,6,70,29,41,74
SK Sturm Gra,6708,2,21,5,10,64,31,33,68
SC Rheindorf,6708,3,17,12,7,53,37,16,63
Vienna,6708,4,16,7,13,59,52,7,55
Rapid Vienna,6708,5,13,14,9,56,38,18,53
RZ Pellets W,6708,6,13,8,15,45,53,-8,47
Admira Wacke,6708,7,10,8,18,35,61,-26,38
St. Pölten,6708,8,9,9,18,46,69,-23,36
SV Josko Rie,6708,9,8,9,19,32,61,-29,33
Mattersburg,6708,10,5,12,19,36,65,-29,27
FC Salzburg,6709,1,23,5,8,70,24,46,74
SK Sturm Gra,6709,2,19,8,9,55,29,26,65
Vienna,6709,3,20,4,12,65,51,14,64
SC Rheindorf,6709,4,18,10,8,56,43,13,64
Rapid Vienna,6709,5,17,9,10,58,38,20,60
Admira Wacke,6709,6,11,5,20,40,68,-28,38
St. Pölten,6709,7,8,13,15,42,60,-18,37
SV Josko Rie,6709,8,10,6,20,37,57,-20,36
RZ Pellets W,6709,9,8,8,20,45,67,-22,32
Mattersburg,6709,10,6,12,18,33,64,-31,30
SC Rheindorf,6710,1,23,6,7,65,41,24,75
SK Sturm Gra,6710,2,23,5,8,69,33,36,74
FC Salzburg,6710,3,21,7,8,70,33,37,70
Vienna,6710,4,17,4,15,58,50,8,55
Rapid Vienna,6710,5,14,10,12,60,42,18,52
RZ Pellets W,6710,6,11,7,18,40,55,-15,40
Mattersburg,6710,7,10,6,20,42,61,-19,36
St. Pölten,6710,8,9,9,18,40,69,-29,36
Admira Wacke,6710,9,10,6,20,35,70,-35,36
SV Josko Rie,6710,10,9,6,21,33,58,-25,33
SC Rheindorf,6711,1,21,7,8,53,34,19,70
Vienna,6711,2,21,5,10,73,52,21,68
FC Salzburg,6711,3,18,8,10,58,32,26,62
SK Sturm Gra,6711,4,18,8,10,55,33,22,62
Rapid Vienna,6711,5,12,13,11,48,34,14,49
Mattersburg,6711,6,12,6,18,39,54,-15,42
RZ Pellets W,6711,7,11,7,18,41,60,-19,40
SV Josko Rie,6711,8,11,5,20,37,55,-18,38
St. Pölten,6711,9,9,9,18,46,66,-20,36
Admira Wacke,6711,10,10,6,20,36,66,-30,36
SC Rheindorf,6712,1,21,8,7,53,31,22,71
FC Salzburg,6712,2,20,7,9,63,30,33,67
SK Sturm Gra,6712,3,19,7,10,57,37,20,64
Vienna,6712,4,17,7,12,60,52,8,58
RZ Pellets W,6712,5,15,6,15,48,51,-3,51
Admira Wacke,6712,6,14,6,16,35,57,-22,48
SV Josko Rie,6712,7,13,4,19,37,52,-15,43
Rapid Vienna,6712,8,10,10,16,52,49,3,40
Mattersburg,6712,9,7,11,18,31,45,-14,32
St. Pölten,6712,10,7,8,21,38,70,-32,29
SC Rheindorf,6713,1,19,11,6,52,37,15,68
FC Salzburg,6713,2,19,7,10,59,29,30,64
SK Sturm Gra,6713,3,19,7,10,58,33,25,64
Vienna,6713,4,15,7,14,60,63,-3,52
Rapid Vienna,6713,5,14,7,15,49,37,12,49
RZ Pellets W,6713,6,14,7,15,48,49,-1,49
Admira Wacke,6713,7,13,7,16,39,54,-15,46
SV Josko Rie,6713,8,12,4,20,37,58,-21,40
Mattersburg,6713,9,10,8,18,36,50,-14,38
St. Pölten,6713,10,7,11,18,41,69,-28,32
SC Rheindorf,6714,1,20,8,8,55,38,17,68
SK Sturm Gra,6714,2,19,9,8,61,31,30,66
FC Salzburg,6714,3,18,9,9,68,41,27,63
Vienna,6714,4,19,6,11,65,56,9,63
SV Josko Rie,6714,5,14,6,16,39,47,-8,48
RZ Pellets W,6714,6,14,5,17,51,55,-4,47
Rapid Vienna,6714,7,11,12,13,49,44,5,45
Admira Wacke,6714,8,11,4,21,31,62,-31,37
St. Pölten,6714,9,8,10,18,39,62,-23,34
Mattersburg,6714,10,9,5,22,38,60,-22,32
FC Salzburg,6715,1,21,9,6,67,26,41,72
SC Rheindorf,6715,2,22,4,10,59,37,22,70
SK Sturm Gra,6715,3,22,3,11,58,31,27,69
Vienna,6715,4,17,8,11,61,53,8,59
Admira Wacke,6715,5,15,5,16,41,54,-13,50
Rapid Vienna,6715,6,13,10,13,51,43,8,49
SV Josko Rie,6715,7,10,7,19,36,55,-19,37
RZ Pellets W,6715,8,9,7,20,38,59,-21,34
St. Pölten,6715,9,8,9,19,41,68,-27,33
Mattersburg,6715,10,8,8,20,37,63,-26,32
SC Rheindorf,6716,1,21,8,7,60,40,20,71
SK Sturm Gra,6716,2,21,4,11,57,34,23,67
FC Salzburg,6716,3,20,6,10,70,34,36,66
Rapid Vienna,6716,4,15,10,11,59,45,14,55
Vienna,6716,5,15,7,14,60,56,4,52
RZ Pellets W,6716,6,13,8,15,52,58,-6,47
Mattersburg,6716,7,11,7,18,39,55,-16,40
Admira Wacke,6716,8,11,6,19,41,63,-22,39
SV Josko Rie,6716,9,11,5,20,32,55,-23,38
St. Pölten,6716,10,7,9,20,41,71,-30,30
SC Rheindorf,6717,1,22,6,8,58,41,17,72
SK Sturm Gra,6717,2,20,7,9,61,33,28,67
Vienna,6717,3,21,4,11,68,50,18,67
FC Salzburg,6717,4,19,8,9,58,29,29,65
Rapid Vienna,6717,5,14,11,11,55,38,17,53
RZ Pellets W,6717,6,10,9,17,42,59,-17,39
Admira Wacke,6717,7,11,6,19,36,60,-24,39
St. Pölten,6717,8,8,10,18,43,63,-20,34
SV Josko Rie,6717,9,9,7,20,30,55,-25,34
Mattersburg,6717,10,7,10,19,35,58,-23,31
FC Salzburg,6718,1,23,8,5,69,27,42,77
SK Sturm Gra,6718,2,18,8,10,62,40,22,62
Rapid Vienna,6718,3,17,8,11,55,34,21,59
SC Rheindorf,6718,4,15,11,10,52,51,1,56
Vienna,6718,5,16,7,13,57,51,6,55
Admira Wacke,6718,6,12,8,16,36,51,-15,44
SV Josko Rie,6718,7,11,9,16,42,50,-8,42
RZ Pellets W,6718,8,10,8,18,38,62,-24,38
St. Pölten,6718,9,8,9,19,41,66,-25,33
Mattersburg,6718,10,8,8,20,39,59,-20,32
FC Salzburg,6719,1,20,10,6,61,28,33,70
SC Rheindorf,6719,2,17,9,10,55,44,11,60
Rapid Vienna,6719,3,15,9,12,54,39,15,54
SK Sturm Gra,6719,4,16,6,14,52,39,13,54
RZ Pellets W,6719,5,16,5,15,54,52,2,53
Vienna,6719,6,15,4,17,60,63,-3,49
Admira Wacke,6719,7,13,8,15,35,52,-17,47
SV Josko Rie,6719,8,12,6,18,34,46,-12,42
Mattersburg,6719,9,9,10,17,35,57,-22,37
St. Pölten,6719,10,9,9,18,44,64,-20,36
FC Salzburg,6720,1,24,5,7,67,25,42,77
SK Sturm Gra,6720,2,18,8,10,58,36,22,62
SC Rheindorf,6720,3,18,8,10,52,40,12,62
Vienna,6720,4,19,4,13,65,56,9,61
Rapid Vienna,6720,5,15,10,11,60,43,17,55
Admira Wacke,6720,6,13,4,19,39,60,-21,43
RZ Pellets W,6720,7,10,7,19,41,60,-19,37
SV Josko Rie,6720,8,10,7,19,33,54,-21,37
Mattersburg,6720,9,10,6,20,41,60,-19,36
St. Pölten,6720,10,8,11,17,45,67,-22,35
FC Salzburg,6721,1,24,6,6,61,25,36,78
SC Rheindorf,6721,2,19,6,11,47,40,7,63
Vienna,6721,3,19,5,12,62,45,17,62
SK Sturm Gra,6721,4,15,8,13,47,36,11,53
SV Josko Rie,6721,5,15,3,18,38,49,-11,48
Rapid Vienna,6721,6,11,14,11,45,36,9,47
Admira Wacke,6721,7,13,6,17,34,52,-18,45
RZ Pellets W,6721,8,10,8,18,42,56,-14,38
St. Pölten,6721,9,9,9,18,38,62,-24,36
Mattersburg,6721,10,9,7,20,35,48,-13,34
SC Rheindorf,6722,1,21,8,7,57,38,19,71
FC Salzburg,6722,2,21,7,8,68,36,32,70
SK Sturm Gra,6722,3,20,9,7,56,26,30,69
Vienna,6722,4,17,4,15,62,54,8,55
Rapid Vienna,6722,5,15,7,14,60,44,16,52
SV Josko Rie,6722,6,14,5,17,33,41,-8,47
Admira Wacke,6722,7,12,8,16,35,55,-20,44
RZ Pellets W,6722,8,12,7,17,42,57,-15,43
St. Pölten,6722,9,6,11,19,40,65,-25,29
Mattersburg,6722,10,4,10,22,28,65,-37,22
SK Sturm Gra,6723,1,21,5,10,60,31,29,68
SC Rheindorf,6723,2,20,6,10,51,42,9,66
FC Salzburg,6723,3,17,13,6,62,32,30,64
Vienna,6723,4,18,4,14,61,52,9,58
RZ Pellets W,6723,5,14,8,14,50,54,-4,50
Admira Wacke,6723,6,14,5,17,38,53,-15,47
Rapid Vienna,6723,7,10,11,15,50,48,2,41
St. Pölten,6723,8,10,10,16,48,65,-17,40
SV Josko Rie,6723,9,10,6,20,31,52,-21,36
Mattersburg,6723,10,7,10,19,34,56,-22,31
FC Salzburg,6724,1,20,8,8,71,37,34,68
Vienna,6724,2,20,6,10,66,50,16,66
SK Sturm Gra,6724,3,18,11,7,58,32,26,65
SC Rheindorf,6724,4,19,7,10,54,48,6,64
RZ Pellets W,6724,5,13,10,13,57,57,0,49
Rapid Vienna,6724,6,10,15,11,55,43,12,45
Mattersburg,6724,7,10,9,17,45,59,-14,39
Admira Wacke,6724,8,10,7,19,32,60,-28,37
SV Josko Rie,6724,9,11,3,22,37,60,-23,36
St. Pölten,6724,10,5,12,19,41,70,-29,27
FC Salzburg,6725,1,19,9,8,63,35,28,66
Vienna,6725,2,19,8,9,72,53,19,65
SK Sturm Gra,6725,3,18,7,11,58,36,22,61
SC Rheindorf,6725,4,18,7,11,57,48,9,61
Rapid Vienna,6725,5,17,8,11,55,37,18,59
RZ Pellets W,6725,6,15,5,16,52,59,-7,50
Mattersburg,6725,7,11,7,18,47,53,-6,40
SV Josko Rie,6725,8,11,5,20,37,55,-18,38
St. Pölten,6725,9,9,6,21,43,73,-30,33
Admira Wacke,6725,10,8,8,20,36,71,-35,32
FC Salzburg,6726,1,23,6,7,67,29,38,75
SK Sturm Gra,6726,2,18,7,11,60,35,25,61
Vienna,6726,3,18,6,12,68,55,13,60
SC Rheindorf,6726,4,16,10,10,51,45,6,58
Rapid Vienna,6726,5,14,11,11,58,44,14,53
RZ Pellets W,6726,6,13,6,17,46,54,-8,45
Mattersburg,6726,7,11,9,16,35,50,-15,42
Admira Wacke,6726,8,12,6,18,38,61,-23,42
St. Pölten,6726,9,11,7,18,45,67,-22,40
SV Josko Rie,6726,10,7,6,23,30,58,-28,27
FC Salzburg,6727,1,23,8,5,67,29,38,77
Vienna,6727,2,21,4,11,69,57,12,67
SC Rheindorf,6727,3,19,8,9,57,41,16,65
SK Sturm Gra,6727,4,19,5,12,60,36,24,62
Rapid Vienna,6727,5,13,10,13,58,47,11,49
Admira Wacke,6727,6,12,6,18,37,54,-17,42
SV Josko Rie,6727,7,11,8,17,36,48,-12,41
RZ Pellets W,6727,8,11,5,20,41,56,-15,38
Mattersburg,6727,9,10,7,19,41,59,-18,37
St. Pölten,6727,10,7,7,22,33,72,-39,28
SK Sturm Gra,6728,1,21,7,8,66,33,33,70
FC Salzburg,6728,2,19,9,8,65,34,31,66
Rapid Vienna,6728,3,17,9,10,63,42,21,60
SC Rheindorf,6728,4,18,6,12,53,49,4,60
Vienna,6728,5,18,4,14,54,51,3,58
SV Josko Rie,6728,6,14,4,18,37,50,-13,46
Admira Wacke,6728,7,12,7,17,34,52,-18,43
St. Pölten,6728,8,10,7,19,44,63,-19,37
RZ Pellets W,6728,9,10,6,20,41,60,-19,36
Mattersburg,6728,10,8,7,21,32,55,-23,31
SK Sturm Gra,6729,1,21,7,8,63,34,29,70
SC Rheindorf,6729,2,21,4,11,59,41,18,67
Rapid Vienna,6729,3,18,9,9,63,34,29,63
FC Salzburg,6729,4,19,5,12,58,42,16,62
Vienna,6729,5,18,4,14,59,48,11,58
Admira Wacke,6729,6,14,4,18,42,58,-16,46
RZ Pellets W,6729,7,13,5,18,43,61,-18,44
SV Josko Rie,6729,8,12,3,21,32,50,-18,39
Mattersburg,6729,9,8,8,20,40,63,-23,32
St. Pölten,6729,10,8,7,21,42,70,-28,31
FC Salzburg,6730,1,23,7,6,73,26,47,76
SK Sturm Gra,6730,2,20,4,12,60,40,20,64
SC Rheindorf,6730,3,19,6,11,54,44,10,63
Rapid Vienna,6730,4,15,10,11,60,39,21,55
Vienna,6730,5,16,5,15,53,54,-1,53
Admira Wacke,6730,6,12,7,17,35,55,-20,43
SV Josko Rie,6730,7,12,6,18,44,56,-12,42
RZ Pellets W,6730,8,11,9,16,41,56,-15,42
Mattersburg,6730,9,10,8,18,39,59,-20,38
St. Pölten,6730,10,8,6,22,36,66,-30,30
SK Sturm Gra,6731,1,19,8,9,55,30,25,65
Vienna,6731,2,20,4,12,56,43,13,64
SC Rheindorf,6731,3,19,6,11,54,39,15,63
FC Salzburg,6731,4,19,5,12,56,33,23,62
RZ Pellets W,6731,5,16,8,12,53,49,4,56
Rapid Vienna,6731,6,12,11,13,48,39,9,47
SV Josko Rie,6731,7,13,2,21,39,52,-13,41
Admira Wacke,6731,8,11,5,20,36,66,-30,38
St. Pölten,6731,9,8,11,17,38,64,-26,35
Mattersburg,6731,10,8,10,18,37,57,-20,34
SK Sturm Gra,6732,1,23,6,7,66,32,34,75
FC Salzburg,6732,2,21,8,7,73,35,38,71
SC Rheindorf,6732,3,16,10,10,54,47,7,58
Rapid Vienna,6732,4,15,10,11,60,46,14,55
Vienna,6732,5,15,8,13,64,57,7,53
RZ Pellets W,6732,6,13,7,16,47,53,-6,46
Admira Wacke,6732,7,12,7,17,40,61,-21,43
SV Josko Rie,6732,8,10,9,17,37,52,-15,39
Mattersburg,6732,9,8,9,19,37,59,-22,33
St. Pölten,6732,10,6,8,22,32,68,-36,26
SC Rheindorf,6733,1,22,6,8,63,39,24,72
SK Sturm Gra,6733,2,22,5,9,68,33,35,71
FC Salzburg,6733,3,18,9,9,63,36,27,63
Vienna,6733,4,19,6,11,62,54,8,63
Admira Wacke,6733,5,16,5,15,43,57,-14,53
Rapid Vienna,6733,6,13,9,14,49,42,7,48
RZ Pellets W,6733,7,10,7,19,40,60,-20,37
St. Pölten,6733,8,8,10,18,45,66,-21,34
Mattersburg,6733,9,7,11,18,34,54,-20,32
SV Josko Rie,6733,10,8,6,22,34,60,-26,30
FC Salzburg,6734,1,22,6,8,69,31,38,72
Vienna,6734,2,19,4,13,66,55,11,61
SK Sturm Gra,6734,3,18,6,12,57,36,21,60
SC Rheindorf,6734,4,18,6,12,55,49,6,60
Rapid Vienna,6734,5,13,12,11,49,40,9,51
Admira Wacke,6734,6,13,8,15,42,57,-15,47
SV Josko Rie,6734,7,13,6,17,40,51,-11,45
RZ Pellets W,6734,8,12,8,16,40,51,-11,44
Mattersburg,6734,9,8,8,20,35,54,-19,32
St. Pölten,6734,10,6,12,18,38,67,-29,30
FC Salzburg,6735,1,25,6,5,69,25,44,81
SC Rheindorf,6735,2,20,6,10,54,39,15,66
SK Sturm Gra,6735,3,18,7,11,58,39,19,61
Vienna,6735,4,16,9,11,61,55,6,57
Rapid Vienna,6735,5,10,16,10,51,44,7,46
RZ Pellets W,6735,6,11,8,17,43,58,-15,41
SV Josko Rie,6735,7,12,4,20,47,57,-10,40
Mattersburg,6735,8,10,9,17,41,58,-17,39
St. Pölten,6735,9,8,11,17,44,65,-21,35
Admira Wacke,6735,10,9,6,21,32,60,-28,33
FC Salzburg,6736,1,25,6,5,70,28,42,81
SC Rheindorf,6736,2,18,7,11,57,42,15,61
SK Sturm Gra,6736,3,18,5,13,51,34,17,59
Vienna,6736,4,17,4,15,57,57,0,55
Admira Wacke,6736,5,15,8,13,44,49,-5,53
Rapid Vienna,6736,6,13,12,11,55,41,14,51
RZ Pellets W,6736,7,13,7,16,44,53,-9,46
St. Pölten,6736,8,8,10,18,40,62,-22,34
Mattersburg,6736,9,8,10,18,38,60,-22,34
SV Josko Rie,6736,10,8,5,23,30,60,-30,29
FC Salzburg,6737,1,20,6,10,64,36,28,66
Vienna,6737,2,19,5,12,62,50,12,62
SC Rheindorf,6737,3,17,10,9,54,47,7,61
SK Sturm Gra,6737,4,17,8,11,58,44,14,59
Rapid Vienna,6737,5,15,11,10,61,38,23,56
Admira Wacke,6737,6,13,9,14,45,54,-9,48
RZ Pellets W,6737,7,12,8,16,39,54,-15,44
SV Josko Rie,6737,8,11,4,21,34,56,-22,37
St. Pölten,6737,9,9,9,18,45,62,-17,36
Mattersburg,6737,10,7,10,19,43,64,-21,31
FC Salzburg,6738,1,20,9,7,67,32,35,69
SC Rheindorf,6738,2,18,7,11,49,37,12,61
SK Sturm Gra,6738,3,17,7,12,54,38,16,58
Vienna,6738,4,18,4,14,58,53,5,58
Rapid Vienna,6738,5,15,10,11,58,44,14,55
St. Pölten,6738,6,12,10,14,45,58,-13,46
RZ Pellets W,6738,7,11,9,16,37,51,-14,42
Admira Wacke,6738,8,11,9,16,38,55,-17,42
SV Josko Rie,6738,9,11,6,19,33,48,-15,39
Mattersburg,6738,10,6,11,19,34,57,-23,29
SK Sturm Gra,6739,1,22,6,8,67,29,38,72
FC Salzburg,6739,2,22,6,8,63,30,33,72
Vienna,6739,3,19,3,14,62,54,8,60
SC Rheindorf,6739,4,17,7,12,50,44,6,58
Rapid Vienna,6739,5,14,13,9,59,42,17,55
RZ Pellets W,6739,6,11,7,18,42,54,-12,40
Admira Wacke,6739,7,11,7,18,39,67,-28,40
SV Josko Rie,6739,8,10,6,20,35,56,-21,36
St. Pölten,6739,9,9,9,18,37,61,-24,36
Mattersburg,6739,10,9,8,19,40,57,-17,35
SC Rheindorf,6740,1,18,13,5,57,35,22,67
FC Salzburg,6740,2,20,6,10,60,32,28,66
Vienna,6740,3,20,4,12,63,49,14,64
SK Sturm Gra,6740,4,17,7,12,54,38,16,58
Rapid Vienna,6740,5,15,8,13,58,43,15,53
St. Pölten,6740,6,12,9,15,50,60,-10,45
Admira Wacke,6740,7,12,6,18,40,54,-14,42
Mattersburg,6740,8,11,8,17,37,61,-24,41
RZ Pellets W,6740,9,9,9,18,42,68,-26,36
SV Josko Rie,6740,10,9,4,23,34,55,-21,31
FC Salzburg,6741,1,20,8,8,69,31,38,68
SK Sturm Gra,6741,2,19,8,9,56,31,25,65
SC Rheindorf,6741,3,18,9,9,55,51,4,63
Vienna,6741,4,18,4,14,61,62,-1,58
Rapid Vienna,6741,5,15,10,11,58,38,20,55
RZ Pellets W,6741,6,12,8,16,48,53,-5,44
St. Pölten,6741,7,10,10,16,40,60,-20,40
Admira Wacke,6741,8,11,5,20,34,61,-27,38
Mattersburg,6741,9,9,9,18,38,51,-13,36
SV Josko Rie,6741,10,9,7,20,40,61,-21,34
FC Salzburg,6742,1,21,6,9,61,32,29,69
Vienna,6742,2,19,6,11,68,54,14,63
SC Rheindorf,6742,3,18,8,10,55,43,12,62
SK Sturm Gra,6742,4,17,8,11,61,41,20,59
Rapid Vienna,6742,5,13,12,11,56,40,16,51
RZ Pellets W,6742,6,11,10,15,41,48,-7,43
St. Pölten,6742,7,11,9,16,45,60,-15,42
SV Josko Rie,6742,8,12,5,19,37,49,-12,41
Admira Wacke,6742,9,9,8,19,36,70,-34,35
Mattersburg,6742,10,8,10,18,34,57,-23,34
FC Salzburg,6743,1,21,7,8,66,32,34,70
SK Sturm Gra,6743,2,21,7,8,66,35,31,70
SC Rheindorf,6743,3,17,9,10,52,41,11,60
Vienna,6743,4,17,6,13,59,53,6,57
RZ Pellets W,6743,5,14,5,17,48,60,-12,47
Rapid Vienna,6743,6,11,11,14,49,44,5,44
Admira Wacke,6743,7,10,10,16,35,59,-24,40
St. Pölten,6743,8,9,11,16,40,60,-20,38
SV Josko Rie,6743,9,9,10,17,36,50,-14,37
Mattersburg,6743,10,8,10,18,37,54,-17,34
FC Salzburg,6744,1,24,6,6,65,24,41,78
SC Rheindorf,6744,2,19,11,6,49,35,14,68
SK Sturm Gra,6744,3,18,7,11,59,35,24,61
Vienna,6744,4,17,5,14,57,52,5,56
Admira Wacke,6744,5,16,5,15,37,50,-13,53
Rapid Vienna,6744,6,11,13,12,49,36,13,46
SV Josko Rie,6744,7,12,4,20,35,51,-16,40
St. Pölten,6744,8,9,9,18,40,62,-22,36
RZ Pellets W,6744,9,7,12,17,39,58,-19,33
Mattersburg,6744,10,6,10,20,31,58,-27,28
SK Sturm Gra,6745,1,22,5,9,67,30,37,71
FC Salzburg,6745,2,21,7,8,63,27,36,70
SC Rheindorf,6745,3,21,5,10,59,50,9,68
Vienna,6745,4,18,6,12,64,51,13,60
Rapid Vienna,6745,5,15,10,11,51,39,12,55
RZ Pellets W,6745,6,14,6,16,52,61,-9,48
St. Pölten,6745,7,10,8,18,41,61,-20,38
Admira Wacke,6745,8,11,5,20,37,57,-20,38
SV Josko Rie,6745,9,10,5,21,31,54,-23,35
Mattersburg,6745,10,5,9,22,34,69,-35,24
FC Salzburg,6746,1,20,9,7,61,31,30,69
SC Rheindorf,6746,2,20,7,9,54,40,14,67
SK Sturm Gra,6746,3,19,7,10,61,35,26,64
Vienna,6746,4,15,6,15,61,59,2,51
Rapid Vienna,6746,5,12,11,13,53,42,11,47
Admira Wacke,6746,6,13,5,18,42,59,-17,44
RZ Pellets W,6746,7,12,7,17,48,62,-14,43
SV Josko Rie,6746,8,12,7,17,41,55,-14,43
Mattersburg,6746,9,11,7,18,41,56,-15,40
St. Pölten,6746,10,8,10,18,40,63,-23,34
SC Rheindorf,6747,1,20,10,6,53,32,21,70
SK Sturm Gra,6747,2,20,6,10,64,38,26,66
FC Salzburg,6747,3,18,9,9,69,39,30,63
Vienna,6747,4,18,8,10,68,48,20,62
Rapid Vienna,6747,5,14,11,11,60,48,12,53
RZ Pellets W,6747,6,12,7,17,42,53,-11,43
Admira Wacke,6747,7,12,6,18,43,65,-22,42
SV Josko Rie,6747,8,12,5,19,44,58,-14,41
St. Pölten,6747,9,7,11,18,36,70,-34,32
Mattersburg,6747,10,5,11,20,34,62,-28,26
FC Salzburg,6748,1,23,8,5,69,23,46,77
SK Sturm Gra,6748,2,22,5,9,55,25,30,71
SC Rheindorf,6748,3,19,9,8,55,41,14,66
Vienna,6748,4,16,4,16,60,58,2,52
Admira Wacke,6748,5,13,8,15,42,61,-19,47
RZ Pellets W,6748,6,12,9,15,43,52,-9,45
Rapid Vienna,6748,7,10,11,15,49,45,4,41
Mattersburg,6748,8,9,9,18,35,56,-21,36
St. Pölten,6748,9,9,8,19,42,65,-23,35
SV Josko Rie,6748,10,8,7,21,35,59,-24,31
FC Salzburg,6749,1,20,9,7,62,27,35,69
SC Rheindorf,6749,2,20,9,7,56,41,15,69
Vienna,6749,3,20,7,9,61,42,19,67
SK Sturm Gra,6749,4,19,5,12,59,36,23,62
Rapid Vienna,6749,5,12,10,14,47,41,6,46
RZ Pellets W,6749,6,13,7,16,48,58,-10,46
SV Josko Rie,6749,7,9,9,18,38,52,-14,36
Admira Wacke,6749,8,9,9,18,36,64,-28,36
Mattersburg,6749,9,9,8,19,36,56,-20,35
St. Pölten,6749,10,6,13,17,33,59,-26,31
SC Rheindorf,6750,1,20,8,8,57,37,20,68
FC Salzburg,6750,2,20,7,9,58,29,29,67
SK Sturm Gra,6750,3,18,8,10,58,32,26,62
Vienna,6750,4,18,4,14,64,54,10,58
Rapid Vienna,6750,5,12,11,13,51,46,5,47
RZ Pellets W,6750,6,13,7,16,52,56,-4,46
SV Josko Rie,6750,7,13,4,19,41,54,-13,43
Mattersburg,6750,8,11,10,15,41,60,-19,43
St. Pölten,6750,9,9,8,19,42,68,-26,35
Admira Wacke,6750,10,9,7,20,33,61,-28,34
FC Salzburg,6751,1,20,8,8,65,36,29,68
Vienna,6751,2,20,4,12,68,47,21,64
SK Sturm Gra,6751,3,16,8,12,48,37,11,56
Rapid Vienna,6751,4,15,10,11,57,40,17,55
SC Rheindorf,6751,5,15,10,11,52,52,0,55
Admira Wacke,6751,6,14,5,17,41,57,-16,47
RZ Pellets W,6751,7,12,10,14,45,54,-9,46
SV Josko Rie,6751,8,11,5,20,35,50,-15,38
Mattersburg,6751,9,9,9,18,40,57,-17,36
St. Pölten,6751,10,9,9,18,42,63,-21,36
FC Salzburg,6752,1,24,7,5,68,27,41,79
Vienna,6752,2,20,7,9,69,48,21,67
SK Sturm Gra,6752,3,20,6,10,61,37,24,66
SC Rheindorf,6752,4,19,8,9,60,45,15,65
Rapid Vienna,6752,5,14,12,10,57,44,13,54
RZ Pellets W,6752,6,10,8,18,43,58,-15,38
SV Josko Rie,6752,7,11,4,21,34,55,-21,37
Mattersburg,6752,8,9,7,20,45,67,-22,34
Admira Wacke,6752,9,9,5,22,38,71,-33,32
St. Pölten,6752,10,5,14,17,38,61,-23,29
FC Salzburg,6753,1,24,5,7,66,29,37,77
SK Sturm Gra,6753,2,19,7,10,61,34,27,64
Vienna,6753,3,18,6,12,53,43,10,60
SC Rheindorf,6753,4,17,9,10,47,40,7,60
Rapid Vienna,6753,5,15,8,13,52,40,12,53
Admira Wacke,6753,6,13,4,19,42,61,-19,43
RZ Pellets W,6753,7,12,6,18,45,59,-14,42
St. Pölten,6753,8,10,10,16,47,60,-13,40
SV Josko Rie,6753,9,10,5,21,30,51,-21,35
Mattersburg,6753,10,8,8,20,37,63,-26,32
FC Salzburg,6754,1,23,4,9,69,27,42,73
SC Rheindorf,6754,2,20,7,9,55,44,11,67
SK Sturm Gra,6754,3,18,9,9,63,35,28,63
Vienna,6754,4,18,6,12,58,49,9,60
Rapid Vienna,6754,5,15,11,10,52,41,11,56
RZ Pellets W,6754,6,12,8,16,44,53,-9,44
SV Josko Rie,6754,7,11,5,20,36,51,-15,38
St. Pölten,6754,8,9,10,17,40,58,-18,37
Admira Wacke,6754,9,10,7,19,35,60,-25,37
Mattersburg,6754,10,5,11,20,31,65,-34,26
FC Salzburg,6755,1,19,10,7,64,29,35,67
SC Rheindorf,6755,2,19,10,7,59,41,18,67
Vienna,6755,3,17,6,13,53,50,3,57
Rapid Vienna,6755,4,15,11,10,57,35,22,56
SK Sturm Gra,6755,5,15,8,13,48,30,18,53
SV Josko Rie,6755,6,13,7,16,36,43,-7,46
Admira Wacke,6755,7,12,6,18,36,61,-25,42
Mattersburg,6755,8,11,8,17,38,52,-14,41
RZ Pellets W,6755,9,10,8,18,45,62,-17,38
St. Pölten,6755,10,8,8,20,37,70,-33,32
FC Salzburg,6756,1,20,7,9,68,33,35,67
SK Sturm Gra,6756,2,20,7,9,67,35,32,67
SC Rheindorf,6756,3,19,8,9,54,38,16,65
Vienna,6756,4,17,5,14,55,49,6,56
Rapid Vienna,6756,5,11,14,11,52,51,1,47
RZ Pellets W,6756,6,13,5,18,46,52,-6,44
Admira Wacke,6756,7,13,5,18,40,63,-23,44
St. Pölten,6756,8,10,9,17,45,66,-21,39
Mattersburg,6756,9,10,8,18,41,62,-21,38
SV Josko Rie,6756,10,10,6,20,41,60,-19,36
FC Salzburg,6757,1,21,6,9,67,30,37,69
SC Rheindorf,6757,2,19,11,6,62,45,17,68
SK Sturm Gra,6757,3,19,7,10,58,33,25,64
Vienna,6757,4,19,7,10,61,50,11,64
Rapid Vienna,6757,5,14,8,14,50,45,5,50
Admira Wacke,6757,6,13,4,19,38,62,-24,43
RZ Pellets W,6757,7,11,9,16,48,54,-6,42
Mattersburg,6757,8,8,10,18,34,58,-24,34
St. Pölten,6757,9,7,12,17,43,63,-20,33
SV Josko Rie,6757,10,8,8,20,38,59,-21,32
FC Salzburg,6758,1,23,5,8,67,28,39,74
Vienna,6758,2,22,4,10,64,49,15,70
SK Sturm Gra,6758,3,20,8,8,59,27,32,68
SC Rheindorf,6758,4,18,9,9,47,37,10,63
Rapid Vienna,6758,5,12,11,13,48,41,7,47
RZ Pellets W,6758,6,12,7,17,43,52,-9,43
SV Josko Rie,6758,7,11,7,18,34,48,-14,40
St. Pölten,6758,8,11,7,18,44,64,-20,40
Admira Wacke,6758,9,9,7,20,34,64,-30,34
Mattersburg,6758,10,5,9,22,30,60,-30,24
FC Salzburg,6759,1,22,9,5,76,33,43,75
Vienna,6759,2,21,4,11,66,52,14,67
SK Sturm Gra,6759,3,18,5,13,58,36,22,59
SC Rheindorf,6759,4,18,5,13,59,49,10,59
Rapid Vienna,6759,5,13,13,10,58,46,12,52
Admira Wacke,6759,6,12,5,19,41,59,-18,41
St. Pölten,6759,7,10,10,16,45,62,-17,40
RZ Pellets W,6759,8,10,8,18,38,62,-24,38
Mattersburg,6759,9,8,13,15,41,57,-16,37
SV Josko Rie,6759,10,8,8,20,33,59,-26,32
FC Salzburg,6760,1,18,13,5,65,33,32,67
SK Sturm Gra,6760,2,18,9,9,61,32,29,63
SC Rheindorf,6760,3,18,7,11,52,43,9,61
Vienna,6760,4,18,5,13,62,53,9,59
Rapid Vienna,6760,5,14,12,10,54,40,14,54
St. Pölten,6760,6,12,9,15,51,59,-8,45
RZ Pellets W,6760,7,12,6,18,51,64,-13,42
SV Josko Rie,6760,8,11,7,18,38,58,-20,40
Admira Wacke,6760,9,10,8,18,33,57,-24,38
Mattersburg,6760,10,7,8,21,35,63,-28,29
FC Salzburg,6761,1,19,11,6,66,34,32,68
SC Rheindorf,6761,2,20,8,8,56,42,14,68
SK Sturm Gra,6761,3,19,9,8,61,36,25,66
Vienna,6761,4,19,5,12,73,54,19,62
Rapid Vienna,6761,5,10,14,12,56,48,8,44
Admira Wacke,6761,6,11,8,17,40,65,-25,41
SV Josko Rie,6761,7,11,6,19,37,56,-19,39
RZ Pellets W,6761,8,9,11,16,40,59,-19,38
St. Pölten,6761,9,8,10,18,46,62,-16,34
Mattersburg,6761,10,8,10,18,40,59,-19,34
SC Rheindorf,6762,1,22,8,6,61,33,28,74
FC Salzburg,6762,2,20,6,10,60,33,27,66
SK Sturm Gra,6762,3,19,7,10,60,32,28,64
Vienna,6762,4,19,7,10,74,52,22,64
Rapid Vienna,6762,5,12,13,11,57,43,14,49
RZ Pellets W,6762,6,12,9,15,44,57,-13,45
Admira Wacke,6762,7,12,6,18,37,59,-22,42
Mattersburg,6762,8,9,10,17,40,56,-16,37
St. Pölten,6762,9,7,9,20,41,77,-36,30
SV Josko Rie,6762,10,8,5,23,28,60,-32,29
SC Rheindorf,6763,1,20,10,6,56,36,20,70
FC Salzburg,6763,2,19,10,7,58,27,31,67
SK Sturm Gra,6763,3,20,6,10,61,36,25,66
Vienna,6763,4,19,5,12,66,48,18,62
Rapid Vienna,6763,5,15,11,10,56,34,22,56
RZ Pellets W,6763,6,12,6,18,46,62,-16,42
Mattersburg,6763,7,11,8,17,44,57,-13,41
Admira Wacke,6763,8,9,10,17,35,57,-22,37
SV Josko Rie,6763,9,8,6,22,28,57,-29,30
St. Pölten,6763,10,7,8,21,36,72,-36,29
FC Salzburg,6764,1,20,10,6,63,28,35,70
Vienna,6764,2,20,4,12,67,55,12,64
SK Sturm Gra,6764,3,19,5,12,63,41,22,62
SC Rheindorf,6764,4,18,8,10,54,41,13,62
Admira Wacke,6764,5,14,7,15,44,55,-11,49
Rapid Vienna,6764,6,11,13,12,55,46,9,46
RZ Pellets W,6764,7,12,9,15,45,57,-12,45
Mattersburg,6764,8,11,7,18,46,59,-13,40
SV Josko Rie,6764,9,10,4,22,36,59,-23,34
St. Pölten,6764,10,7,9,20,40,72,-32,30
FC Salzburg,6765,1,20,10,6,59,25,34,70
SK Sturm Gra,6765,2,20,6,10,60,34,26,66
SC Rheindorf,6765,3,19,7,10,62,45,17,64
Vienna,6765,4,18,5,13,64,58,6,59
RZ Pellets W,6765,5,16,7,13,44,43,1,55
Rapid Vienna,6765,6,14,12,10,54,39,15,54
SV Josko Rie,6765,7,10,8,18,33,51,-18,38
St. Pölten,6765,8,9,8,19,36,59,-23,35
Mattersburg,6765,9,7,9,20,37,61,-24,30
Admira Wacke,6765,10,8,6,22,28,62,-34,30
SK Sturm Gra,6766,1,21,6,9,62,30,32,69
FC Salzburg,6766,2,20,8,8,67,28,39,68
Vienna,6766,3,19,6,11,67,47,20,63
SC Rheindorf,6766,4,18,8,10,55,47,8,62
Rapid Vienna,6766,5,12,12,12,58,44,14,48
Admira Wacke,6766,6,13,8,15,43,62,-19,47
RZ Pellets W,6766,7,10,10,16,47,59,-12,40
St. Pölten,6766,8,10,10,16,41,63,-22,40
Mattersburg,6766,9,9,8,19,40,62,-22,35
SV Josko Rie,6766,10,8,4,24,26,64,-38,28
SK Sturm Gra,6767,1,22,8,6,59,26,33,74
FC Salzburg,6767,2,22,5,9,65,34,31,71
SC Rheindorf,6767,3,19,7,10,52,41,11,64
Vienna,6767,4,18,4,14,64,58,6,58
RZ Pellets W,6767,5,16,6,14,54,52,2,54
Rapid Vienna,6767,6,14,8,14,53,42,11,50
Admira Wacke,6767,7,11,5,20,35,59,-24,38
Mattersburg,6767,8,9,8,19,36,53,-17,35
St. Pölten,6767,9,6,14,16,35,57,-22,32
SV Josko Rie,6767,10,8,5,23,24,55,-31,29
FC Salzburg,6768,1,24,8,4,72,30,42,80
SC Rheindorf,6768,2,20,7,9,55,43,12,67
SK Sturm Gra,6768,3,16,9,11,55,38,17,57
Vienna,6768,4,16,4,16,68,59,9,52
Rapid Vienna,6768,5,12,11,13,46,40,6,47
Admira Wacke,6768,6,13,6,17,36,52,-16,45
SV Josko Rie,6768,7,14,2,20,47,59,-12,44
RZ Pellets W,6768,8,11,8,17,48,62,-14,41
St. Pölten,6768,9,9,10,17,43,67,-24,37
Mattersburg,6768,10,8,9,19,31,51,-20,33
FC Salzburg,6769,1,20,8,8,63,32,31,68
Vienna,6769,2,20,7,9,68,49,19,67
SC Rheindorf,6769,3,17,10,9,56,44,12,61
SK Sturm Gra,6769,4,17,8,11,57,39,18,59
Rapid Vienna,6769,5,16,8,12,57,34,23,56
Admira Wacke,6769,6,12,7,17,43,58,-15,43
RZ Pellets W,6769,7,11,8,17,43,58,-15,41
Mattersburg,6769,8,9,9,18,35,54,-19,36
SV Josko Rie,6769,9,9,8,19,36,60,-24,35
St. Pölten,6769,10,9,7,20,36,66,-30,34
FC Salzburg,6770,1,20,7,9,67,39,28,67
Rapid Vienna,6770,2,18,8,10,68,39,29,62
SK Sturm Gra,6770,3,18,8,10,57,34,23,62
Vienna,6770,4,17,7,12,60,52,8,58
SC Rheindorf,6770,5,17,6,13,52,51,1,57
Admira Wacke,6770,6,13,6,17,41,62,-21,45
RZ Pellets W,6770,7,12,8,16,43,53,-10,44
SV Josko Rie,6770,8,12,4,20,43,59,-16,40
Mattersburg,6770,9,9,8,19,35,55,-20,35
St. Pölten,6770,10,9,8,19,43,65,-22,35
Vienna,6771,1,21,4,11,64,47,17,67
SC Rheindorf,6771,2,18,7,11,49,43,6,61
SK Sturm Gra,6771,3,18,5,13,51,35,16,59
FC Salzburg,6771,4,17,6,13,56,36,20,57
RZ Pellets W,6771,5,16,5,15,56,55,1,53
Rapid Vienna,6771,6,13,11,12,53,43,10,50
SV Josko Rie,6771,7,12,7,17,38,47,-9,43
St. Pölten,6771,8,11,8,17,44,62,-18,41
Admira Wacke,6771,9,10,9,17,34,56,-22,39
Mattersburg,6771,10,8,10,18,36,57,-21,34
FC Salzburg,6772,1,23,6,7,73,32,41,75
SC Rheindorf,6772,2,22,5,9,66,42,24,71
SK Sturm Gra,6772,3,19,7,10,61,35,26,64
Vienna,6772,4,18,5,13,62,53,9,59
Rapid Vienna,6772,5,12,9,15,51,49,2,45
RZ Pellets W,6772,6,11,10,15,49,60,-11,43
SV Josko Rie,6772,7,11,6,19,34,55,-21,39
Admira Wacke,6772,8,10,8,18,36,58,-22,38
St. Pölten,6772,9,9,9,18,41,70,-29,36
Mattersburg,6772,10,9,7,20,39,58,-19,34
SC Rheindorf,6773,1,21,6,9,61,39,22,69
FC Salzburg,6773,2,18,8,10,58,35,23,62
Vienna,6773,3,18,6,12,57,50,7,60
SK Sturm Gra,6773,4,16,9,11,51,37,14,57
RZ Pellets W,6773,5,17,6,13,49,45,4,57
SV Josko Rie,6773,6,15,3,18,37,49,-12,48
Rapid Vienna,6773,7,11,14,11,55,41,14,47
Admira Wacke,6773,8,12,6,18,40,58,-18,42
Mattersburg,6773,9,7,10,19,39,62,-23,31
St. Pölten,6773,10,8,6,22,40,71,-31,30
FC Salzburg,6774,1,21,9,6,68,32,36,72
SC Rheindorf,6774,2,21,8,7,63,43,20,71
SK Sturm Gra,6774,3,20,8,8,62,32,30,68
Vienna,6774,4,15,7,14,57,53,4,52
RZ Pellets W,6774,5,13,8,15,51,57,-6,47
Rapid Vienna,6774,6,12,10,14,54,46,8,46
SV Josko Rie,6774,7,13,5,18,43,56,-13,44
Admira Wacke,6774,8,12,5,19,40,60,-20,41
St. Pölten,6774,9,9,6,21,38,68,-30,33
Mattersburg,6774,10,8,6,22,35,64,-29,30
FC Salzburg,6775,1,24,5,7,69,27,42,77
SK Sturm Gra,6775,2,22,4,10,57,37,20,70
Vienna,6775,3,19,5,12,56,44,12,62
SC Rheindorf,6775,4,17,7,12,44,41,3,58
Rapid Vienna,6775,5,16,9,11,56,39,17,57
St. Pölten,6775,6,11,8,17,49,63,-14,41
Admira Wacke,6775,7,11,6,19,39,61,-22,39
RZ Pellets W,6775,8,10,6,20,40,62,-22,36
SV Josko Rie,6775,9,10,5,21,32,51,-19,35
Mattersburg,6775,10,8,9,19,37,54,-17,33
SC Rheindorf,6776,1,20,9,7,55,37,18,69
FC Salzburg,6776,2,20,6,10,69,36,33,66
Vienna,6776,3,19,5,12,57,49,8,62
SK Sturm Gra,6776,4,18,4,14,60,45,15,58
Rapid Vienna,6776,5,13,14,9,55,39,16,53
RZ Pellets W,6776,6,12,8,16,47,54,-7,44
Admira Wacke,6776,7,11,9,16,37,53,-16,42
Mattersburg,6776,8,11,8,17,40,57,-17,41
St. Pölten,6776,9,9,9,18,41,64,-23,36
SV Josko Rie,6776,10,8,6,22,30,57,-27,30
FC Salzburg,6777,1,20,8,8,61,31,30,68
SC Rheindorf,6777,2,19,7,10,69,47,22,64
Vienna,6777,3,20,4,12,72,53,19,64
SK Sturm Gra,6777,4,17,6,13,59,42,17,57
Rapid Vienna,6777,5,14,12,10,57,44,13,54
RZ Pellets W,6777,6,13,9,14,43,54,-11,48
Admira Wacke,6777,7,12,5,19,38,64,-26,41
Mattersburg,6777,8,11,7,18,37,49,-12,40
St. Pölten,6777,9,8,11,17,41,64,-23,35
SV Josko Rie,6777,10,9,5,22,29,58,-29,32
SK Sturm Gra,6778,1,20,8,8,61,32,29,68
FC Salzburg,6778,2,19,8,9,67,38,29,65
SC Rheindorf,6778,3,17,11,8,57,44,13,62
Vienna,6778,4,17,8,11,67,54,13,59
Admira Wacke,6778,5,15,6,15,40,52,-12,51
Rapid Vienna,6778,6,13,10,13,56,54,2,49
RZ Pellets W,6778,7,11,8,17,43,54,-11,41
St. Pölten,6778,8,9,10,17,36,56,-20,37
Mattersburg,6778,9,7,12,17,35,53,-18,33
SV Josko Rie,6778,10,9,5,22,34,59,-25,32
SC Rheindorf,6779,1,22,8,6,58,39,19,74
SK Sturm Gra,6779,2,20,4,12,55,31,24,64
FC Salzburg,6779,3,19,6,11,62,35,27,63
Vienna,6779,4,17,6,13,63,54,9,57
Rapid Vienna,6779,5,14,11,11,56,41,15,53
Admira Wacke,6779,6,13,9,14,39,49,-10,48
RZ Pellets W,6779,7,10,11,15,40,53,-13,41
St. Pölten,6779,8,8,10,18,42,67,-25,34
Mattersburg,6779,9,8,9,19,36,58,-22,33
SV Josko Rie,6779,10,8,8,20,31,55,-24,32
FC Salzburg,6780,1,21,9,6,78,36,42,72
SK Sturm Gra,6780,2,20,7,9,63,32,31,67
SC Rheindorf,6780,3,21,4,11,60,40,20,67
Vienna,6780,4,20,5,11,64,47,17,65
Rapid Vienna,6780,5,14,12,10,59,48,11,54
Admira Wacke,6780,6,13,6,17,48,62,-14,45
RZ Pellets W,6780,7,11,8,17,51,63,-12,41
SV Josko Rie,6780,8,8,7,21,31,59,-28,31
Mattersburg,6780,9,8,7,21,33,65,-32,31
St. Pölten,6780,10,7,9,20,41,76,-35,30
FC Salzburg,6781,1,21,8,7,71,27,44,71
SC Rheindorf,6781,2,21,8,7,58,36,22,71
Vienna,6781,3,20,5,11,63,44,19,65
SK Sturm Gra,6781,4,15,12,9,54,36,18,57
Rapid Vienna,6781,5,15,10,11,61,41,20,55
RZ Pellets W,6781,6,11,6,19,41,60,-19,39
Admira Wacke,6781,7,10,9,17,31,60,-29,39
SV Josko Rie,6781,8,10,7,19,33,55,-22,37
Mattersburg,6781,9,8,10,18,33,54,-21,34
St. Pölten,6781,10,7,9,20,32,64,-32,30
SC Rheindorf,6782,1,23,6,7,58,37,21,75
FC Salzburg,6782,2,22,7,7,66,28,38,73
Vienna,6782,3,18,8,10,58,48,10,62
Rapid Vienna,6782,4,16,10,10,59,35,24,58
SK Sturm Gra,6782,5,17,4,15,52,43,9,55
SV Josko Rie,6782,6,13,5,18,40,53,-13,44
Admira Wacke,6782,7,10,8,18,36,59,-23,38
St. Pölten,6782,8,9,10,17,44,63,-19,37
RZ Pellets W,6782,9,7,11,18,38,61,-23,32
Mattersburg,6782,10,7,7,22,34,58,-24,28
FC Salzburg,6783,1,23,8,5,72,29,43,77
SK Sturm Gra,6783,2,22,7,7,76,39,37,73
Vienna,6783,3,19,6,11,67,51,16,63
SC Rheindorf,6783,4,17,6,13,53,47,6,57
Rapid Vienna,6783,5,13,10,13,49,39,10,49
RZ Pellets W,6783,6,12,10,14,48,53,-5,46
SV Josko Rie,6783,7,10,8,18,36,54,-18,38
St. Pölten,6783,8,9,9,18,45,75,-30,36
Mattersburg,6783,9,8,8,20,34,60,-26,32
Admira Wacke,6783,10,7,8,21,37,70,-33,29
FC Salzburg,6784,1,20,10,6,68,34,34,70
SK Sturm Gra,6784,2,20,6,10,62,38,24,66
Vienna,6784,3,20,6,10,69,47,22,66
SC Rheindorf,6784,4,17,10,9,49,37,12,61
Rapid Vienna,6784,5,13,14,9,54,38,16,53
Admira Wacke,6784,6,15,4,17,39,54,-15,49
Mattersburg,6784,7,9,9,18,38,57,-19,36
RZ Pellets W,6784,8,9,8,19,42,61,-19,35
St. Pölten,6784,9,8,9,19,42,69,-27,33
SV Josko Rie,6784,10,9,4,23,34,62,-28,31
FC Salzburg,6785,1,22,5,9,70,33,37,71
SK Sturm Gra,6785,2,22,5,9,63,32,31,71
SC Rheindorf,6785,3,21,8,7,60,40,20,71
Rapid Vienna,6785,4,15,10,11,60,37,23,55
Admira Wacke,6785,5,14,6,16,42,63,-21,48
Vienna,6785,6,14,4,18,53,60,-7,46
RZ Pellets W,6785,7,11,6,19,52,65,-13,39
Mattersburg,6785,8,9,9,18,38,57,-19,36
SV Josko Rie,6785,9,11,3,22,30,54,-24,36
St. Pölten,6785,10,9,8,19,37,64,-27,35
FC Salzburg,6786,1,20,10,6,71,33,38,70
SC Rheindorf,6786,2,19,10,7,65,48,17,67
Vienna,6786,3,20,3,13,62,49,13,63
SK Sturm Gra,6786,4,18,6,12,58,37,21,60
Rapid Vienna,6786,5,15,10,11,59,40,19,55
RZ Pellets W,6786,6,14,8,14,47,50,-3,50
SV Josko Rie,6786,7,12,6,18,39,58,-19,42
St. Pölten,6786,8,9,9,18,40,65,-25,36
Admira Wacke,6786,9,9,5,22,32,62,-30,32
Mattersburg,6786,10,7,7,22,38,69,-31,28
FC Salzburg,6787,1,23,6,7,68,34,34,75
SC Rheindorf,6787,2,21,8,7,66,39,27,71
SK Sturm Gra,6787,3,19,8,9,62,37,25,65
Rapid Vienna,6787,4,15,10,11,58,37,21,55
Vienna,6787,5,17,4,15,61,57,4,55
RZ Pellets W,6787,6,11,6,19,50,67,-17,39
SV Josko Rie,6787,7,11,6,19,31,48,-17,39
Admira Wacke,6787,8,11,5,20,38,62,-24,38
St. Pölten,6787,9,9,8,19,44,70,-26,35
Mattersburg,6787,10,8,9,19,35,62,-27,33
FC Salzburg,6788,1,24,6,6,71,26,45,78
Vienna,6788,2,21,7,8,68,46,22,70
SC Rheindorf,6788,3,19,8,9,60,42,18,65
SK Sturm Gra,6788,4,19,7,10,54,34,20,64
Rapid Vienna,6788,5,13,12,11,55,43,12,51
Admira Wacke,6788,6,12,6,18,40,63,-23,42
SV Josko Rie,6788,7,11,6,19,35,53,-18,39
St. Pölten,6788,8,8,11,17,40,61,-21,35
RZ Pellets W,6788,9,8,9,19,38,63,-25,33
Mattersburg,6788,10,5,8,23,27,57,-30,23
FC Salzburg,6789,1,21,9,6,65,30,35,72
Vienna,6789,2,21,4,11,72,49,23,67
SC Rheindorf,6789,3,19,9,8,56,40,16,66
SK Sturm Gra,6789,4,18,7,11,57,41,16,61
Rapid Vienna,6789,5,14,13,9,50,36,14,55
RZ Pellets W,6789,6,14,5,17,46,50,-4,47
Admira Wacke,6789,7,13,6,17,41,50,-9,45
Mattersburg,6789,8,10,8,18,38,47,-9,38
St. Pölten,6789,9,6,9,21,36,76,-40,27
SV Josko Rie,6789,10,7,4,25,24,66,-42,25
FC Salzburg,6790,1,20,7,9,66,34,32,67
SC Rheindorf,6790,2,20,7,9,59,44,15,67
SK Sturm Gra,6790,3,18,7,11,58,40,18,61
Vienna,6790,4,16,7,13,60,55,5,55
Rapid Vienna,6790,5,14,11,11,57,44,13,53
Admira Wacke,6790,6,15,7,14,43,52,-9,52
RZ Pellets W,6790,7,13,7,16,48,53,-5,46
SV Josko Rie,6790,8,11,7,18,38,51,-13,40
Mattersburg,6790,9,7,11,18,38,67,-29,32
St. Pölten,6790,10,5,11,20,39,66,-27,26
FC Salzburg,6791,1,19,7,10,64,38,26,64
SC Rheindorf,6791,2,18,9,9,58,42,16,63
Vienna,6791,3,20,3,13,62,50,12,63
SK Sturm Gra,6791,4,18,5,13,48,36,12,59
Rapid Vienna,6791,5,16,8,12,58,41,17,56
RZ Pellets W,6791,6,14,8,14,50,50,0,50
Mattersburg,6791,7,10,9,17,42,60,-18,39
SV Josko Rie,6791,8,11,5,20,41,64,-23,38
Admira Wacke,6791,9,11,5,20,37,60,-23,38
St. Pölten,6791,10,9,9,18,43,62,-19,36
SK Sturm Gra,6792,1,24,5,7,67,27,40,77
FC Salzburg,6792,2,21,7,8,65,34,31,70
Vienna,6792,3,18,4,14,64,54,10,58
SC Rheindorf,6792,4,16,10,10,51,46,5,58
RZ Pellets W,6792,5,13,9,14,49,61,-12,48
Rapid Vienna,6792,6,11,13,12,54,44,10,46
Admira Wacke,6792,7,12,6,18,37,59,-22,42
Mattersburg,6792,8,9,10,17,41,58,-17,37
St. Pölten,6792,9,9,10,17,47,66,-19,37
SV Josko Rie,6792,10,7,6,23,33,59,-26,27
SC Rheindorf,6793,1,19,9,8,62,41,21,66
Vienna,6793,2,20,6,10,69,54,15,66
FC Salzburg,6793,3,19,6,11,64,35,29,63
SK Sturm Gra,6793,4,19,6,11,60,37,23,63
Rapid Vienna,6793,5,17,10,9,59,36,23,61
Admira Wacke,6793,6,15,7,14,48,56,-8,52
RZ Pellets W,6793,7,10,8,18,42,66,-24,38
Mattersburg,6793,8,10,5,21,40,62,-22,35
SV Josko Rie,6793,9,8,6,22,36,63,-27,30
St. Pölten,6793,10,6,11,19,40,70,-30,29
FC Salzburg,6794,1,24,6,6,85,32,53,78
SC Rheindorf,6794,2,17,10,9,52,42,10,61
Vienna,6794,3,18,4,14,63,59,4,58
SK Sturm Gra,6794,4,17,6,13,66,44,22,57
Rapid Vienna,6794,5,15,10,11,62,46,16,55
RZ Pellets W,6794,6,12,7,17,48,64,-16,43
St. Pölten,6794,7,11,9,16,50,67,-17,42
Mattersburg,6794,8,10,7,19,44,59,-15,37
SV Josko Rie,6794,9,10,7,19,35,58,-23,37
Admira Wacke,6794,10,9,8,19,39,73,-34,35
FC Salzburg,6795,1,22,9,5,72,30,42,75
SC Rheindorf,6795,2,19,7,10,55,46,9,64
SK Sturm Gra,6795,3,18,7,11,51,41,10,61
Vienna,6795,4,15,9,12,54,53,1,54
Rapid Vienna,6795,5,12,12,12,56,48,8,48
RZ Pellets W,6795,6,13,6,17,49,48,1,45
Admira Wacke,6795,7,11,8,17,35,54,-19,41
SV Josko Rie,6795,8,11,6,19,34,51,-17,39
St. Pölten,6795,9,10,7,19,42,65,-23,37
Mattersburg,6795,10,9,9,18,38,50,-12,36
FC Salzburg,6796,1,20,10,6,67,32,35,70
SC Rheindorf,6796,2,20,7,9,54,42,12,67
Vienna,6796,3,19,5,12,61,47,14,62
SK Sturm Gra,6796,4,16,8,12,53,36,17,56
Rapid Vienna,6796,5,14,10,12,64,46,18,52
SV Josko Rie,6796,6,13,3,20,38,57,-19,42
Mattersburg,6796,7,11,8,17,45,52,-7,41
RZ Pellets W,6796,8,10,9,17,41,62,-21,39
Admira Wacke,6796,9,10,7,19,38,64,-26,37
St. Pölten,6796,10,9,9,18,40,63,-23,36
FC Salzburg,6797,1,18,13,5,60,26,34,67
SK Sturm Gra,6797,2,20,7,9,61,32,29,67
SC Rheindorf,6797,3,20,7,9,56,38,18,67
Vienna,6797,4,19,6,11,63,51,12,63
Rapid Vienna,6797,5,16,11,9,57,35,22,59
RZ Pellets W,6797,6,13,6,17,51,56,-5,45
St. Pölten,6797,7,9,11,16,41,60,-19,38
SV Josko Rie,6797,8,10,5,21,33,59,-26,35
Mattersburg,6797,9,7,10,19,39,62,-23,31
Admira Wacke,6797,10,8,4,24,33,75,-42,28
SK Sturm Gra,6798,1,23,4,9,72,32,40,73
SC Rheindorf,6798,2,22,7,7,66,41,25,73
FC Salzburg,6798,3,20,9,7,69,31,38,69
Vienna,6798,4,17,6,13,56,55,1,57
Rapid Vienna,6798,5,13,10,13,48,38,10,49
SV Josko Rie,6798,6,13,4,19,44,60,-16,43
RZ Pellets W,6798,7,10,8,18,42,58,-16,38
Admira Wacke,6798,8,10,6,20,29,61,-32,36
Mattersburg,6798,9,7,13,16,37,56,-19,34
St. Pölten,6798,10,7,9,20,36,67,-31,30
FC Salzburg,6799,1,22,6,8,71,31,40,72
SK Sturm Gra,6799,2,22,5,9,63,32,31,71
Vienna,6799,3,22,4,10,60,44,16,70
SC Rheindorf,6799,4,20,7,9,56,37,19,67
Rapid Vienna,6799,5,12,9,15,50,46,4,45
RZ Pellets W,6799,6,11,8,17,43,62,-19,41
Admira Wacke,6799,7,12,4,20,39,59,-20,40
SV Josko Rie,6799,8,11,5,20,37,56,-19,38
Mattersburg,6799,9,10,7,19,36,59,-23,37
St. Pölten,6799,10,5,11,20,36,65,-29,26
FC Salzburg,6800,1,20,7,9,64,33,31,67
SK Sturm Gra,6800,2,19,6,11,56,35,21,63
Rapid Vienna,6800,3,17,11,8,52,32,20,62
Vienna,6800,4,18,6,12,64,60,4,60
SC Rheindorf,6800,5,16,10,10,50,42,8,58
RZ Pellets W,6800,6,14,4,18,49,57,-8,46
Admira Wacke,6800,7,11,9,16,38,54,-16,42
SV Josko Rie,6800,8,11,5,20,36,52,-16,38
Mattersburg,6800,9,8,11,17,40,55,-15,35
St. Pölten,6800,10,7,9,20,39,68,-29,30
SC Rheindorf,6801,1,21,9,6,65,38,27,72
FC Salzburg,6801,2,21,8,7,66,31,35,71
Vienna,6801,3,19,5,12,61,48,13,62
Rapid Vienna,6801,4,14,13,9,58,41,17,55
SK Sturm Gra,6801,5,16,6,14,56,39,17,54
RZ Pellets W,6801,6,12,8,16,46,60,-14,44
St. Pölten,6801,7,9,12,15,44,63,-19,39
Admira Wacke,6801,8,10,8,18,36,64,-28,38
SV Josko Rie,6801,9,10,7,19,39,53,-14,37
Mattersburg,6801,10,6,8,22,33,67,-34,26
FC Salzburg,6802,1,20,9,7,61,30,31,69
SK Sturm Gra,6802,2,19,7,10,61,33,28,64
SC Rheindorf,6802,3,18,6,12,51,42,9,60
Rapid Vienna,6802,4,15,11,10,52,38,14,56
Vienna,6802,5,15,7,14,60,59,1,52
Admira Wacke,6802,6,13,5,18,44,58,-14,44
Mattersburg,6802,7,12,7,17,42,51,-9,43
RZ Pellets W,6802,8,12,6,18,46,59,-13,42
SV Josko Rie,6802,9,10,7,19,32,53,-21,37
St. Pölten,6802,10,9,9,18,36,62,-26,36
SC Rheindorf,6803,1,22,7,7,59,36,23,73
FC Salzburg,6803,2,20,8,8,67,30,37,68
SK Sturm Gra,6803,3,19,5,12,59,35,24,62
Rapid Vienna,6803,4,15,10,11,57,41,16,55
Vienna,6803,5,15,8,13,60,60,0,53
Admira Wacke,6803,6,14,6,16,47,57,-10,48
RZ Pellets W,6803,7,11,8,17,42,56,-14,41
SV Josko Rie,6803,8,10,7,19,34,58,-24,37
Mattersburg,6803,9,9,7,20,38,62,-24,34
St. Pölten,6803,10,8,8,20,35,63,-28,32
SK Sturm Gra,6804,1,20,8,8,60,32,28,68
SC Rheindorf,6804,2,18,9,9,58,42,16,63
FC Salzburg,6804,3,17,10,9,62,35,27,61
Vienna,6804,4,17,10,9,64,49,15,61
Rapid Vienna,6804,5,12,12,12,54,42,12,48
Admira Wacke,6804,6,13,7,16,35,54,-19,46
RZ Pellets W,6804,7,11,7,18,45,67,-22,40
Mattersburg,6804,8,10,8,18,38,53,-15,38
SV Josko Rie,6804,9,10,6,20,33,56,-23,36
St. Pölten,6804,10,8,11,17,44,63,-19,35
SC Rheindorf,6805,1,21,7,8,54,39,15,70
SK Sturm Gra,6805,2,20,5,11,55,37,18,65
FC Salzburg,6805,3,19,6,11,70,38,32,63
Rapid Vienna,6805,4,16,10,10,57,36,21,58
Vienna,6805,5,18,4,14,58,54,4,58
RZ Pellets W,6805,6,14,5,17,49,54,-5,47
Admira Wacke,6805,7,12,6,18,41,58,-17,42
SV Josko Rie,6805,8,9,9,18,33,56,-23,36
Mattersburg,6805,9,9,8,19,38,55,-17,35
St. Pölten,6805,10,7,10,19,40,68,-28,31
FC Salzburg,6806,1,22,8,6,66,32,34,74
SC Rheindorf,6806,2,19,7,10,57,43,14,64
Vienna,6806,3,17,7,12,59,50,9,58
SK Sturm Gra,6806,4,16,9,11,52,33,19,57
RZ Pellets W,6806,5,15,6,15,51,54,-3,51
Rapid Vienna,6806,6,10,16,10,53,43,10,46
SV Josko Rie,6806,7,11,6,19,37,57,-20,39
Admira Wacke,6806,8,11,6,19,35,60,-25,39
St. Pölten,6806,9,9,10,17,42,61,-19,37
Mattersburg,6806,10,8,9,19,37,56,-19,33
FC Salzburg,6807,1,21,8,7,69,33,36,71
SC Rheindorf,6807,2,19,8,9,60,41,19,65
SK Sturm Gra,6807,3,19,7,10,64,42,22,64
Vienna,6807,4,20,4,12,64,53,11,64
Rapid Vienna,6807,5,13,11,12,55,43,12,50
Admira Wacke,6807,6,13,6,17,37,52,-15,45
Mattersburg,6807,7,11,9,16,39,50,-11,42
RZ Pellets W,6807,8,11,9,16,46,61,-15,42
SV Josko Rie,6807,9,10,4,22,32,57,-25,34
St. Pölten,6807,10,5,10,21,40,74,-34,25
SK Sturm Gra,6808,1,21,7,8,56,32,24,70
FC Salzburg,6808,2,20,9,7,66,32,34,69
Vienna,6808,3,21,2,13,63,47,16,65
SC Rheindorf,6808,4,16,12,8,54,47,7,60
Rapid Vienna,6808,5,16,9,11,55,34,21,57
SV Josko Rie,6808,6,13,5,18,39,51,-12,44
RZ Pellets W,6808,7,11,8,17,39,52,-13,41
St. Pölten,6808,8,7,12,17,39,61,-22,33
Admira Wacke,6808,9,9,4,23,27,62,-35,31
Mattersburg,6808,10,6,12,18,36,56,-20,30
FC Salzburg,6809,1,22,7,7,71,36,35,73
SK Sturm Gra,6809,2,19,8,9,66,37,29,65
Vienna,6809,3,18,5,13,61,53,8,59
SC Rheindorf,6809,4,16,10,10,52,46,6,58
Rapid Vienna,6809,5,16,9,11,61,42,19,57
RZ Pellets W,6809,6,10,10,16,45,57,-12,40
SV Josko Rie,6809,7,11,6,19,38,53,-15,39
Admira Wacke,6809,8,11,6,19,32,61,-29,39
St. Pölten,6809,9,9,10,17,44,62,-18,37
Mattersburg,6809,10,8,9,19,33,56,-23,33
FC Salzburg,6810,1,21,6,9,60,30,30,69
SC Rheindorf,6810,2,20,8,8,55,38,17,68
SK Sturm Gra,6810,3,19,8,9,54,31,23,65
Vienna,6810,4,18,5,13,59,53,6,59
Rapid Vienna,6810,5,14,9,13,54,39,15,51
RZ Pellets W,6810,6,13,8,15,49,52,-3,47
Admira Wacke,6810,7,12,6,18,39,56,-17,42
SV Josko Rie,6810,8,10,6,20,38,59,-21,36
St. Pölten,6810,9,8,10,18,38,63,-25,34
Mattersburg,6810,10,6,12,18,33,58,-25,30
FC Salzburg,6811,1,19,11,6,64,34,30,68
SC Rheindorf,6811,2,18,10,8,54,39,15,64
SK Sturm Gra,6811,3,17,8,11,57,41,16,59
Vienna,6811,4,16,6,14,60,53,7,54
Rapid Vienna,6811,5,13,12,11,51,40,11,51
RZ Pellets W,6811,6,14,7,15,48,54,-6,49
St. Pölten,6811,7,11,8,17,45,61,-16,41
Admira Wacke,6811,8,11,8,17,39,62,-23,41
SV Josko Rie,6811,9,10,7,19,37,52,-15,37
Mattersburg,6811,10,9,7,20,38,57,-19,34
FC Salzburg,6812,1,24,8,4,74,26,48,80
SC Rheindorf,6812,2,20,10,6,59,36,23,70
SK Sturm Gra,6812,3,18,8,10,60,38,22,62
Vienna,6812,4,18,7,11,66,52,14,61
Rapid Vienna,6812,5,12,13,11,52,41,11,49
RZ Pellets W,6812,6,10,9,17,42,57,-15,39
Mattersburg,6812,7,10,6,20,37,64,-27,36
SV Josko Rie,6812,8,10,5,21,41,61,-20,35
Admira Wacke,6812,9,10,4,22,39,73,-34,34
St. Pölten,6812,10,7,12,17,46,68,-22,33
FC Salzburg,6813,1,20,10,6,67,33,34,70
Vienna,6813,2,21,3,12,64,51,13,66
SK Sturm Gra,6813,3,19,5,12,59,38,21,62
SC Rheindorf,6813,4,17,10,9,51,42,9,61
Rapid Vienna,6813,5,12,13,11,52,37,15,49
RZ Pellets W,6813,6,13,7,16,46,59,-13,46
SV Josko Rie,6813,7,13,4,19,39,50,-11,43
Mattersburg,6813,8,9,9,18,42,58,-16,36
Admira Wacke,6813,9,9,7,20,40,68,-28,34
St. Pölten,6813,10,7,12,17,41,65,-24,33
SK Sturm Gra,6814,1,20,8,8,63,33,30,68
SC Rheindorf,6814,2,20,8,8,49,36,13,68
FC Salzburg,6814,3,19,8,9,63,34,29,65
Vienna,6814,4,18,8,10,68,54,14,62
Rapid Vienna,6814,5,12,14,10,59,43,16,50
RZ Pellets W,6814,6,12,7,17,47,58,-11,43
Mattersburg,6814,7,9,9,18,38,58,-20,36
Admira Wacke,6814,8,9,9,18,42,67,-25,36
SV Josko Rie,6814,9,9,8,19,30,48,-18,35
St. Pölten,6814,10,7,11,18,39,67,-28,32
FC Salzburg,6815,1,19,9,8,58,31,27,66
SC Rheindorf,6815,2,19,7,10,52,44,8,64
SK Sturm Gra,6815,3,16,10,10,53,35,18,58
Vienna,6815,4,18,4,14,53,46,7,58
Rapid Vienna,6815,5,14,10,12,56,37,19,52
RZ Pellets W,6815,6,14,6,16,47,54,-7,48
SV Josko Rie,6815,7,14,4,18,39,52,-13,46
Admira Wacke,6815,8,13,4,19,40,58,-18,43
St. Pölten,6815,9,8,13,15,45,58,-13,37
Mattersburg,6815,10,8,7,21,32,60,-28,31
FC Salzburg,6816,1,22,9,5,70,31,39,75
SC Rheindorf,6816,2,21,4,11,57,38,19,67
SK Sturm Gra,6816,3,20,6,10,58,38,20,66
Vienna,6816,4,18,6,12,68,60,8,60
Rapid Vienna,6816,5,13,9,14,56,44,12,48
St. Pölten,6816,6,12,8,16,43,56,-13,44
Admira Wacke,6816,7,12,7,17,41,62,-21,43
RZ Pellets W,6816,8,11,6,19,44,61,-17,39
SV Josko Rie,6816,9,10,6,20,37,58,-21,36
Mattersburg,6816,10,8,5,23,35,61,-26,29
FC Salzburg,6817,1,20,5,11,60,35,25,65
SC Rheindorf,6817,2,19,8,9,54,43,11,65
Vienna,6817,3,20,4,12,75,51,24,64
SK Sturm Gra,6817,4,18,7,11,58,38,20,61
RZ Pellets W,6817,5,13,7,16,46,56,-10,46
SV Josko Rie,6817,6,14,4,18,36,49,-13,46
Admira Wacke,6817,7,13,7,16,39,56,-17,46
Rapid Vienna,6817,8,10,10,16,53,55,-2,40
Mattersburg,6817,9,9,9,18,39,55,-16,36
St. Pölten,6817,10,9,9,18,42,64,-22,36
FC Salzburg,6818,1,18,12,6,66,31,35,66
Rapid Vienna,6818,2,17,10,9,62,42,20,61
SK Sturm Gra,6818,3,18,7,11,58,40,18,61
SC Rheindorf,6818,4,18,7,11,51,44,7,61
Vienna,6818,5,17,6,13,64,52,12,57
Admira Wacke,6818,6,15,6,15,44,55,-11,51
RZ Pellets W,6818,7,14,4,18,41,54,-13,46
SV Josko Rie,6818,8,11,5,20,35,55,-20,38
St. Pölten,6818,9,8,9,19,42,63,-21,33
Mattersburg,6818,10,7,8,21,34,61,-27,29
FC Salzburg,6819,1,21,9,6,67,31,36,72
SC Rheindorf,6819,2,20,8,8,56,43,13,68
Vienna,6819,3,17,9,10,62,52,10,60
SK Sturm Gra,6819,4,16,11,9,57,37,20,59
Rapid Vienna,6819,5,14,11,11,54,39,15,53
Admira Wacke,6819,6,13,9,14,40,53,-13,48
RZ Pellets W,6819,7,10,11,15,51,58,-7,41
St. Pölten,6819,8,9,8,19,44,67,-23,35
SV Josko Rie,6819,9,8,7,21,35,60,-25,31
Mattersburg,6819,10,6,9,21,40,66,-26,27
FC Salzburg,6820,1,21,8,7,63,29,34,71
SK Sturm Gra,6820,2,21,5,10,69,41,28,68
Vienna,6820,3,19,5,12,60,50,10,62
SC Rheindorf,6820,4,17,6,13,50,49,1,57
Rapid Vienna,6820,5,16,7,13,63,42,21,55
Admira Wacke,6820,6,14,5,17,42,58,-16,47
RZ Pellets W,6820,7,12,9,15,48,60,-12,45
SV Josko Rie,6820,8,11,7,18,38,53,-15,40
St. Pölten,6820,9,9,9,18,42,62,-20,36
Mattersburg,6820,10,6,7,23,34,65,-31,25
SK Sturm Gra,6821,1,22,7,7,64,27,37,73
FC Salzburg,6821,2,19,11,6,60,30,30,68
Vienna,6821,3,18,6,12,62,50,12,60
SC Rheindorf,6821,4,17,7,12,53,45,8,58
Rapid Vienna,6821,5,13,14,9,50,37,13,53
RZ Pellets W,6821,6,11,8,17,40,54,-14,41
Admira Wacke,6821,7,11,7,18,36,56,-20,40
St. Pölten,6821,8,8,11,17,43,62,-19,35
SV Josko Rie,6821,9,9,8,19,26,52,-26,35
Mattersburg,6821,10,9,7,20,35,56,-21,34
FC Salzburg,6822,1,21,10,5,70,34,36,73
SC Rheindorf,6822,2,21,9,6,62,40,22,72
SK Sturm Gra,6822,3,20,5,11,69,41,28,65
Vienna,6822,4,17,6,13,56,52,4,57
RZ Pellets W,6822,5,13,8,15,53,54,-1,47
Rapid Vienna,6822,6,12,9,15,46,47,-1,45
SV Josko Rie,6822,7,12,5,19,37,49,-12,41
Admira Wacke,6822,8,12,4,20,35,65,-30,40
St. Pölten,6822,9,8,8,20,42,66,-24,32
Mattersburg,6822,10,7,10,19,39,61,-22,31
SC Rheindorf,6823,1,23,6,7,58,42,16,75
FC Salzburg,6823,2,18,8,10,56,30,26,62
Vienna,6823,3,18,7,11,65,54,11,61
SK Sturm Gra,6823,4,17,8,11,57,32,25,59
Rapid Vienna,6823,5,12,11,13,44,38,6,47
RZ Pellets W,6823,6,13,8,15,45,55,-10,47
Admira Wacke,6823,7,12,9,15,38,54,-16,45
Mattersburg,6823,8,9,10,17,37,50,-13,37
SV Josko Rie,6823,9,9,8,19,35,55,-20,35
St. Pölten,6823,10,8,7,21,37,62,-25,31
FC Salzburg,6824,1,20,9,7,65,29,36,69
Vienna,6824,2,21,5,10,64,42,22,68
SK Sturm Gra,6824,3,20,7,9,66,32,34,67
SC Rheindorf,6824,4,19,9,8,58,46,12,66
Rapid Vienna,6824,5,12,12,12,47,38,9,48
Mattersburg,6824,6,11,9,16,40,53,-13,42
RZ Pellets W,6824,7,11,8,17,46,63,-17,41
St. Pölten,6824,8,10,9,17,46,65,-19,39
Admira Wacke,6824,9,9,7,20,30,64,-34,34
SV Josko Rie,6824,10,8,3,25,29,59,-30,27
FC Salzburg,6825,1,22,7,7,61,27,34,73
SC Rheindorf,6825,2,21,6,9,55,39,16,69
Vienna,6825,3,21,3,12,65,46,19,66
Rapid Vienna,6825,4,15,10,11,52,37,15,55
SK Sturm Gra,6825,5,14,11,11,48,36,12,53
SV Josko Rie,6825,6,15,4,17,41,48,-7,49
RZ Pellets W,6825,7,14,4,18,48,56,-8,46
Admira Wacke,6825,8,11,5,20,38,63,-25,38
St. Pölten,6825,9,9,7,20,39,68,-29,34
Mattersburg,6825,10,6,7,23,24,51,-27,25
FC Salzburg,6826,1,20,8,8,64,31,33,68
SK Sturm Gra,6826,2,18,10,8,63,36,27,64
SC Rheindorf,6826,3,17,8,11,57,45,12,59
Vienna,6826,4,18,5,13,57,54,3,59
RZ Pellets W,6826,5,13,11,12,49,54,-5,50
Rapid Vienna,6826,6,12,13,11,56,46,10,49
Mattersburg,6826,7,8,12,16,34,51,-17,36
SV Josko Rie,6826,8,9,9,18,34,52,-18,36
St. Pölten,6826,9,8,12,16,36,55,-19,36
Admira Wacke,6826,10,9,8,19,34,60,-26,35
FC Salzburg,6827,1,23,5,8,68,31,37,74
SK Sturm Gra,6827,2,23,4,9,65,33,32,73
Rapid Vienna,6827,3,17,9,10,62,41,21,60
SC Rheindorf,6827,4,16,10,10,53,45,8,58
Vienna,6827,5,17,6,13,59,51,8,57
Admira Wacke,6827,6,13,6,17,34,57,-23,45
RZ Pellets W,6827,7,13,5,18,46,55,-9,44
Mattersburg,6827,8,11,7,18,44,58,-14,40
SV Josko Rie,6827,9,10,5,21,34,58,-24,35
St. Pölten,6827,10,5,7,24,34,70,-36,22
SC Rheindorf,6828,1,21,4,11,55,45,10,67
FC Salzburg,6828,2,19,6,11,62,34,28,63
SK Sturm Gra,6828,3,19,6,11,61,38,23,63
Vienna,6828,4,20,3,13,65,47,18,63
Rapid Vienna,6828,5,13,13,10,52,36,16,52
Mattersburg,6828,6,14,7,15,39,46,-7,49
Admira Wacke,6828,7,13,4,19,39,63,-24,43
RZ Pellets W,6828,8,10,9,17,45,62,-17,39
SV Josko Rie,6828,9,11,5,20,35,47,-12,38
St. Pölten,6828,10,7,9,20,29,64,-35,30
SK Sturm Gra,6829,1,22,6,8,57,29,28,72
FC Salzburg,6829,2,21,6,9,63,36,27,69
SC Rheindorf,6829,3,21,4,11,66,39,27,67
Admira Wacke,6829,4,15,7,14,43,54,-11,52
Vienna,6829,5,16,3,17,52,57,-5,51
Rapid Vienna,6829,6,14,8,14,56,50,6,50
RZ Pellets W,6829,7,12,8,16,52,58,-6,44
SV Josko Rie,6829,8,10,5,21,36,54,-18,35
Mattersburg,6829,9,8,10,18,30,55,-25,34
St. Pölten,6829,10,8,9,19,37,60,-23,33
FC Salzburg,6830,1,22,6,8,63,33,30,72
SC Rheindorf,6830,2,21,8,7,58,38,20,71
Vienna,6830,3,21,5,10,70,50,20,68
SK Sturm Gra,6830,4,18,7,11,57,36,21,61
Rapid Vienna,6830,5,14,11,11,53,40,13,53
RZ Pellets W,6830,6,12,6,18,46,60,-14,42
Admira Wacke,6830,7,11,7,18,41,62,-21,40
SV Josko Rie,6830,8,10,8,18,34,53,-19,38
St. Pölten,6830,9,7,10,19,38,63,-25,31
Mattersburg,6830,10,6,8,22,29,54,-25,26
FC Salzburg,6831,1,21,8,7,64,31,33,71
SK Sturm Gra,6831,2,21,6,9,60,30,30,69
Rapid Vienna,6831,3,17,9,10,62,37,25,60
SC Rheindorf,6831,4,17,9,10,53,41,12,60
Vienna,6831,5,15,6,15,57,55,2,51
Admira Wacke,6831,6,13,6,17,39,58,-19,45
SV Josko Rie,6831,7,11,7,18,33,48,-15,40
RZ Pellets W,6831,8,10,10,16,38,56,-18,40
St. Pölten,6831,9,9,9,18,44,69,-25,36
Mattersburg,6831,10,8,6,22,33,58,-25,30
FC Salzburg,6832,1,25,6,5,75,25,50,81
SC Rheindorf,6832,2,19,9,8,54,40,14,66
SK Sturm Gra,6832,3,18,7,11,57,34,23,61
Vienna,6832,4,16,5,15,61,59,2,53
RZ Pellets W,6832,5,14,8,14,48,49,-1,50
Rapid Vienna,6832,6,10,14,12,50,49,1,44
Admira Wacke,6832,7,12,7,17,33,57,-24,43
SV Josko Rie,6832,8,11,4,21,32,55,-23,37
St. Pölten,6832,9,8,9,19,39,63,-24,33
Mattersburg,6832,10,7,11,18,35,53,-18,32
SK Sturm Gra,6833,1,22,7,7,64,25,39,73
FC Salzburg,6833,2,20,7,9,58,28,30,67
SC Rheindorf,6833,3,20,7,9,54,38,16,67
Vienna,6833,4,18,6,12,59,46,13,60
Rapid Vienna,6833,5,15,9,12,55,39,16,54
RZ Pellets W,6833,6,11,8,17,40,60,-20,41
Admira Wacke,6833,7,12,5,19,38,59,-21,41
St. Pölten,6833,8,10,8,18,41,66,-25,38
SV Josko Rie,6833,9,10,6,20,36,55,-19,36
Mattersburg,6833,10,7,7,22,35,64,-29,28
FC Salzburg,6834,1,23,8,5,64,25,39,77
SC Rheindorf,6834,2,22,6,8,62,43,19,72
SK Sturm Gra,6834,3,20,6,10,62,35,27,66
Vienna,6834,4,18,6,12,63,52,11,60
Rapid Vienna,6834,5,12,10,14,56,46,10,46
RZ Pellets W,6834,6,12,8,16,43,59,-16,44
Mattersburg,6834,7,10,9,17,42,58,-16,39
St. Pölten,6834,8,9,11,16,39,58,-19,38
SV Josko Rie,6834,9,9,4,23,34,60,-26,31
Admira Wacke,6834,10,9,4,23,35,64,-29,31
SK Sturm Gra,6835,1,23,5,8,69,31,38,74
SC Rheindorf,6835,2,23,5,8,63,39,24,74
FC Salzburg,6835,3,21,8,7,60,27,33,71
Vienna,6835,4,19,5,12,58,50,8,62
Rapid Vienna,6835,5,14,10,12,66,48,18,52
Admira Wacke,6835,6,11,8,17,40,62,-22,41
RZ Pellets W,6835,7,9,11,16,45,60,-15,38
St. Pölten,6835,8,8,11,17,41,65,-24,35
SV Josko Rie,6835,9,7,6,23,33,66,-33,27
Mattersburg,6835,10,5,11,20,35,62,-27,26
SC Rheindorf,6836,1,22,7,7,56,34,22,73
FC Salzburg,6836,2,21,5,10,63,33,30,68
SK Sturm Gra,6836,3,20,5,11,60,35,25,65
Vienna,6836,4,17,6,13,56,51,5,57
RZ Pellets W,6836,5,15,6,15,50,46,4,51
Rapid Vienna,6836,6,12,12,12,57,43,14,48
Admira Wacke,6836,7,12,7,17,31,52,-21,43
Mattersburg,6836,8,11,7,18,40,59,-19,40
SV Josko Rie,6836,9,10,7,19,39,60,-21,37
St. Pölten,6836,10,5,8,23,35,74,-39,23
SC Rheindorf,6837,1,21,7,8,61,46,15,70
FC Salzburg,6837,2,18,11,7,63,34,29,65
SK Sturm Gra,6837,3,18,7,11,59,39,20,61
Rapid Vienna,6837,4,14,14,8,56,38,18,56
Vienna,6837,5,16,8,12,60,52,8,56
RZ Pellets W,6837,6,14,7,15,47,50,-3,49
Admira Wacke,6837,7,10,7,19,34,56,-22,37
SV Josko Rie,6837,8,10,6,20,35,57,-22,36
Mattersburg,6837,9,7,12,17,40,56,-16,33
St. Pölten,6837,10,7,11,18,37,64,-27,32
SC Rheindorf,6838,1,20,10,6,63,44,19,70
FC Salzburg,6838,2,20,5,11,62,31,31,65
Vienna,6838,3,18,5,13,57,45,12,59
SK Sturm Gra,6838,4,16,7,13,53,44,9,55
Rapid Vienna,6838,5,12,14,10,56,35,21,50
Admira Wacke,6838,6,15,4,17,44,59,-15,49
RZ Pellets W,6838,7,13,7,16,49,59,-10,46
SV Josko Rie,6838,8,12,6,18,37,52,-15,42
Mattersburg,6838,9,9,8,19,38,60,-22,35
St. Pölten,6838,10,6,12,18,39,69,-30,30
SC Rheindorf,6839,1,19,10,7,59,38,21,67
SK Sturm Gra,6839,2,18,10,8,54,29,25,64
FC Salzburg,6839,3,19,7,10,58,36,22,64
Rapid Vienna,6839,4,16,11,9,64,38,26,59
Vienna,6839,5,15,5,16,58,59,-1,50
Admira Wacke,6839,6,13,5,18,41,59,-18,44
Mattersburg,6839,7,10,11,15,40,52,-12,41
RZ Pellets W,6839,8,10,9,17,43,58,-15,39
St. Pölten,6839,9,8,12,16,44,67,-23,36
SV Josko Rie,6839,10,8,8,20,34,59,-25,32
FC Salzburg,6840,1,23,4,9,69,33,36,73
Vienna,6840,2,21,4,11,63,48,15,67
Rapid Vienna,6840,3,18,9,9,65,37,28,63
SC Rheindorf,6840,4,17,8,11,50,43,7,59
SK Sturm Gra,6840,5,17,7,12,49,31,18,58
RZ Pellets W,6840,6,12,7,17,42,53,-11,43
Mattersburg,6840,7,11,9,16,41,50,-9,42
Admira Wacke,6840,8,10,6,20,32,60,-28,36
SV Josko Rie,6840,9,9,6,21,32,61,-29,33
St. Pölten,6840,10,8,8,20,37,64,-27,32
FC Salzburg,6841,1,22,6,8,68,32,36,72
SC Rheindorf,6841,2,21,8,7,57,38,19,71
SK Sturm Gra,6841,3,19,5,12,56,35,21,62
Rapid Vienna,6841,4,14,11,11,55,42,13,53
Vienna,6841,5,15,6,15,51,50,1,51
Admira Wacke,6841,6,13,7,16,48,61,-13,46
RZ Pellets W,6841,7,11,8,17,41,57,-16,41
St. Pölten,6841,8,10,9,17,45,63,-18,39
SV Josko Rie,6841,9,8,10,18,35,54,-19,34
Mattersburg,6841,10,7,10,19,33,57,-24,31
FC Salzburg,6842,1,22,6,8,66,31,35,72
SC Rheindorf,6842,2,19,8,9,55,37,18,65
SK Sturm Gra,6842,3,19,5,12,62,39,23,62
Vienna,6842,4,19,5,12,64,52,12,62
Rapid Vienna,6842,5,16,11,9,55,39,16,59
Admira Wacke,6842,6,12,8,16,47,59,-12,44
RZ Pellets W,6842,7,11,9,16,45,54,-9,42
SV Josko Rie,6842,8,12,5,19,38,53,-15,41
Mattersburg,6842,9,7,8,21,32,59,-27,29
St. Pölten,6842,10,7,7,22,38,79,-41,28
FC Salzburg,6843,1,23,5,8,62,31,31,74
SK Sturm Gra,6843,2,21,5,10,62,34,28,68
Vienna,6843,3,19,5,12,63,49,14,62
SC Rheindorf,6843,4,18,6,12,52,43,9,60
SV Josko Rie,6843,5,14,3,19,39,51,-12,45
Rapid Vienna,6843,6,12,8,16,47,45,2,44
Mattersburg,6843,7,12,6,18,42,55,-13,42
RZ Pellets W,6843,8,12,6,18,45,60,-15,42
Admira Wacke,6843,9,11,5,20,36,59,-23,38
St. Pölten,6843,10,9,9,18,41,62,-21,36
FC Salzburg,6844,1,21,8,7,68,28,40,71
SK Sturm Gra,6844,2,19,6,11,55,37,18,63
Rapid Vienna,6844,3,18,8,10,65,37,28,62
Vienna,6844,4,19,5,12,68,55,13,62
SC Rheindorf,6844,5,18,8,10,56,51,5,62
Admira Wacke,6844,6,12,9,15,45,63,-18,45
RZ Pellets W,6844,7,12,6,18,41,60,-19,42
SV Josko Rie,6844,8,10,6,20,40,57,-17,36
St. Pölten,6844,9,9,7,20,41,65,-24,34
Mattersburg,6844,10,6,9,21,28,54,-26,27
SC Rheindorf,6845,1,20,8,8,56,40,16,68
FC Salzburg,6845,2,18,7,11,63,40,23,61
Rapid Vienna,6845,3,16,10,10,62,40,22,58
SK Sturm Gra,6845,4,17,7,12,57,35,22,58
Vienna,6845,5,16,7,13,56,50,6,55
SV Josko Rie,6845,6,15,5,16,43,45,-2,50
RZ Pellets W,6845,7,10,9,17,38,62,-24,39
St. Pölten,6845,8,8,13,15,45,64,-19,37
Admira Wacke,6845,9,9,10,17,37,58,-21,37
Mattersburg,6845,10,9,8,19,30,53,-23,35
FC Salzburg,6846,1,21,7,8,64,33,31,70
Vienna,6846,2,21,4,11,75,53,22,67
SC Rheindorf,6846,3,19,7,10,60,47,13,64
SK Sturm Gra,6846,4,19,6,11,59,35,24,63
Rapid Vienna,6846,5,14,11,11,57,40,17,53
RZ Pellets W,6846,6,14,6,16,43,54,-11,48
SV Josko Rie,6846,7,13,3,20,33,55,-22,42
Admira Wacke,6846,8,12,5,19,41,58,-17,41
Mattersburg,6846,9,9,8,19,32,54,-22,35
St. Pölten,6846,10,5,9,22,33,68,-35,24
SK Sturm Gra,6847,1,21,8,7,61,30,31,71
FC Salzburg,6847,2,20,7,9,61,30,31,67
SC Rheindorf,6847,3,20,7,9,58,40,18,67
Vienna,6847,4,19,4,13,65,57,8,61
Rapid Vienna,6847,5,11,15,10,52,40,12,48
RZ Pellets W,6847,6,12,8,16,44,56,-12,44
Admira Wacke,6847,7,12,8,16,39,56,-17,44
SV Josko Rie,6847,8,11,5,20,32,52,-20,38
Mattersburg,6847,9,8,7,21,39,62,-23,31
St. Pölten,6847,10,7,9,20,41,69,-28,30
FC Salzburg,6848,1,20,8,8,69,30,39,68
Vienna,6848,2,21,5,10,71,55,16,68
SK Sturm Gra,6848,3,20,7,9,58,29,29,67
SC Rheindorf,6848,4,19,8,9,57,41,16,65
Rapid Vienna,6848,5,12,11,13,53,44,9,47
RZ Pellets W,6848,6,14,5,17,50,57,-7,47
St. Pölten,6848,7,9,10,17,39,62,-23,37
Admira Wacke,6848,8,11,4,21,35,66,-31,37
Mattersburg,6848,9,8,9,19,38,60,-22,33
SV Josko Rie,6848,10,8,9,19,35,61,-26,33
SK Sturm Gra,6849,1,23,5,8,66,29,37,74
FC Salzburg,6849,2,17,12,7,60,31,29,63
SC Rheindorf,6849,3,17,10,9,54,45,9,61
Vienna,6849,4,17,7,12,60,51,9,58
Rapid Vienna,6849,5,12,11,13,54,45,9,47
RZ Pellets W,6849,6,13,7,16,44,53,-9,46
St. Pölten,6849,7,12,9,15,40,55,-15,45
SV Josko Rie,6849,8,11,6,19,34,52,-18,39
Admira Wacke,6849,9,11,6,19,32,54,-22,39
Mattersburg,6849,10,6,9,21,33,62,-29,27
Vienna,6850,1,23,2,11,64,45,19,71
FC Salzburg,6850,2,22,4,10,66,34,32,70
SC Rheindorf,6850,3,19,6,11,53,45,8,63
Rapid Vienna,6850,4,17,9,10,62,42,20,60
SK Sturm Gra,6850,5,17,5,14,56,41,15,56
RZ Pellets W,6850,6,12,8,16,45,54,-9,44
St. Pölten,6850,7,10,8,18,45,66,-21,38
Admira Wacke,6850,8,10,8,18,32,54,-22,38
SV Josko Rie,6850,9,11,4,21,33,55,-22,37
Mattersburg,6850,10,9,6,21,35,55,-20,33
FC Salzburg,6851,1,22,6,8,57,25,32,72
SK Sturm Gra,6851,2,21,6,9,62,24,38,69
SC Rheindorf,6851,3,17,9,10,50,43,7,60
Vienna,6851,4,15,8,13,63,57,6,53
Rapid Vienna,6851,5,12,13,11,48,42,6,49
St. Pölten,6851,6,12,8,16,40,55,-15,44
RZ Pellets W,6851,7,11,9,16,54,60,-6,42
Mattersburg,6851,8,9,13,14,33,46,-13,40
SV Josko Rie,6851,9,10,5,21,37,62,-25,35
Admira Wacke,6851,10,10,5,21,34,64,-30,35
FC Salzburg,6852,1,21,8,7,66,26,40,71
SK Sturm Gra,6852,2,20,6,10,66,37,29,66
SC Rheindorf,6852,3,16,12,8,56,44,12,60
Vienna,6852,4,17,6,13,55,50,5,57
RZ Pellets W,6852,5,16,5,15,54,62,-8,53
Rapid Vienna,6852,6,13,12,11,58,50,8,51
Admira Wacke,6852,7,12,7,17,38,54,-16,43
SV Josko Rie,6852,8,10,7,19,34,52,-18,37
St. Pölten,6852,9,7,11,18,42,72,-30,32
Mattersburg,6852,10,5,12,19,35,57,-22,27
SC Rheindorf,6853,1,22,8,6,58,36,22,74
FC Salzburg,6853,2,19,8,9,57,28,29,65
SK Sturm Gra,6853,3,18,6,12,58,36,22,60
Rapid Vienna,6853,4,15,10,11,58,40,18,55
Vienna,6853,5,16,5,15,57,54,3,53
Admira Wacke,6853,6,14,6,16,41,54,-13,48
RZ Pellets W,6853,7,11,8,17,43,58,-15,41
SV Josko Rie,6853,8,12,4,20,39,52,-13,40
St. Pölten,6853,9,10,8,18,43,68,-25,38
Mattersburg,6853,10,6,11,19,36,64,-28,29
SC Rheindorf,6854,1,21,8,7,57,38,19,71
FC Salzburg,6854,2,20,9,7,62,27,35,69
SK Sturm Gra,6854,3,21,5,10,70,39,31,68
Vienna,6854,4,16,4,16,54,56,-2,52
Admira Wacke,6854,5,14,6,16,39,52,-13,48
RZ Pellets W,6854,6,13,8,15,42,51,-9,47
Rapid Vienna,6854,7,11,12,13,52,43,9,45
SV Josko Rie,6854,8,11,5,20,30,56,-26,38
Mattersburg,6854,9,8,8,20,36,57,-21,32
St. Pölten,6854,10,7,11,18,38,61,-23,32
FC Salzburg,6855,1,21,8,7,68,30,38,71
SC Rheindorf,6855,2,20,8,8,54,39,15,68
SK Sturm Gra,6855,3,19,5,12,56,38,18,62
Vienna,6855,4,18,4,14,58,51,7,58
Rapid Vienna,6855,5,14,11,11,57,41,16,53
RZ Pellets W,6855,6,14,6,16,52,56,-4,48
Admira Wacke,6855,7,10,9,17,33,55,-22,39
SV Josko Rie,6855,8,10,7,19,35,53,-18,37
Mattersburg,6855,9,9,8,19,38,62,-24,35
St. Pölten,6855,10,6,12,18,37,63,-26,30
FC Salzburg,6856,1,22,5,9,75,39,36,71
Vienna,6856,2,21,4,11,66,44,22,67
SC Rheindorf,6856,3,20,6,10,59,46,13,66
SK Sturm Gra,6856,4,19,6,11,53,34,19,63
Rapid Vienna,6856,5,14,10,12,59,41,18,52
Admira Wacke,6856,6,13,8,15,33,48,-15,47
RZ Pellets W,6856,7,11,10,15,43,54,-11,43
SV Josko Rie,6856,8,10,5,21,27,54,-27,35
St. Pölten,6856,9,6,12,18,40,65,-25,30
Mattersburg,6856,10,5,12,19,32,62,-30,27
SK Sturm Gra,6857,1,21,5,10,61,30,31,68
FC Salzburg,6857,2,18,10,8,65,35,30,64
Vienna,6857,3,19,5,12,74,60,14,62
SC Rheindorf,6857,4,17,11,8,57,44,13,62
Rapid Vienna,6857,5,12,13,11,51,38,13,49
RZ Pellets W,6857,6,12,10,14,51,60,-9,46
Admira Wacke,6857,7,11,8,17,34,58,-24,41
Mattersburg,6857,8,9,9,18,39,56,-17,36
St. Pölten,6857,9,7,12,17,44,68,-24,33
SV Josko Rie,6857,10,8,9,19,34,61,-27,33
SC Rheindorf,6858,1,23,5,8,60,47,13,74
FC Salzburg,6858,2,20,6,10,61,34,27,66
Vienna,6858,3,20,4,12,64,50,14,64
SK Sturm Gra,6858,4,16,10,10,52,35,17,58
Rapid Vienna,6858,5,14,12,10,66,44,22,54
RZ Pellets W,6858,6,12,6,18,47,58,-11,42
Mattersburg,6858,7,11,7,18,41,55,-14,40
SV Josko Rie,6858,8,10,8,18,38,55,-17,38
Admira Wacke,6858,9,10,6,20,35,62,-27,36
St. Pölten,6858,10,8,8,20,44,68,-24,32
FC Salzburg,6859,1,21,7,8,66,30,36,70
SK Sturm Gra,6859,2,21,5,10,59,32,27,68
SC Rheindorf,6859,3,19,7,10,55,46,9,64
Vienna,6859,4,15,7,14,56,53,3,52
Admira Wacke,6859,5,16,4,16,42,61,-19,52
Rapid Vienna,6859,6,12,11,13,55,48,7,47
RZ Pellets W,6859,7,14,4,18,47,60,-13,46
St. Pölten,6859,8,11,8,17,38,55,-17,41
Mattersburg,6859,9,8,9,19,43,60,-17,33
SV Josko Rie,6859,10,8,8,20,37,53,-16,32
SC Rheindorf,6860,1,21,6,9,53,42,11,69
SK Sturm Gra,6860,2,21,4,11,63,34,29,67
FC Salzburg,6860,3,19,8,9,60,32,28,65
Vienna,6860,4,18,6,12,62,58,4,60
Rapid Vienna,6860,5,16,11,9,65,33,32,59
RZ Pellets W,6860,6,10,10,16,43,59,-16,40
Admira Wacke,6860,7,10,10,16,42,60,-18,40
Mattersburg,6860,8,9,8,19,36,57,-21,35
St. Pölten,6860,9,8,11,17,39,66,-27,35
SV Josko Rie,6860,10,9,4,23,32,54,-22,31
FC Salzburg,6861,1,20,8,8,62,32,30,68
SC Rheindorf,6861,2,19,10,7,57,38,19,67
SK Sturm Gra,6861,3,18,9,9,60,36,24,63
Vienna,6861,4,18,6,12,65,59,6,60
Rapid Vienna,6861,5,14,12,10,55,40,15,54
RZ Pellets W,6861,6,12,7,17,48,59,-11,43
SV Josko Rie,6861,7,12,5,19,38,49,-11,41
Admira Wacke,6861,8,10,9,17,39,60,-21,39
St. Pölten,6861,9,9,9,18,43,66,-23,36
Mattersburg,6861,10,6,9,21,33,61,-28,27
FC Salzburg,6862,1,24,6,6,66,28,38,78
Rapid Vienna,6862,2,18,10,8,68,42,26,64
SC Rheindorf,6862,3,19,7,10,58,44,14,64
SK Sturm Gra,6862,4,19,6,11,63,37,26,63
Vienna,6862,5,17,6,13,62,57,5,57
RZ Pellets W,6862,6,13,8,15,44,53,-9,47
St. Pölten,6862,7,10,8,18,44,63,-19,38
Admira Wacke,6862,8,10,6,20,38,63,-25,36
Mattersburg,6862,9,9,6,21,32,55,-23,33
SV Josko Rie,6862,10,7,5,24,20,53,-33,26
FC Salzburg,6863,1,21,7,8,70,30,40,70
SK Sturm Gra,6863,2,21,7,8,63,34,29,70
Vienna,6863,3,19,5,12,66,53,13,62
SC Rheindorf,6863,4,16,12,8,58,50,8,60
Rapid Vienna,6863,5,14,9,13,55,43,12,51
RZ Pellets W,6863,6,12,7,17,46,62,-16,43
Admira Wacke,6863,7,12,6,18,38,58,-20,42
St. Pölten,6863,8,9,9,18,45,61,-16,36
SV Josko Rie,6863,9,9,9,18,28,46,-18,36
Mattersburg,6863,10,7,9,20,34,66,-32,30
FC Salzburg,6864,1,21,8,7,62,30,32,71
SK Sturm Gra,6864,2,18,6,12,54,35,19,60
Vienna,6864,3,18,5,13,63,54,9,59
SC Rheindorf,6864,4,16,10,10,47,43,4,58
Rapid Vienna,6864,5,15,11,10,55,38,17,56
RZ Pellets W,6864,6,12,8,16,43,53,-10,44
Admira Wacke,6864,7,13,4,19,39,56,-17,43
SV Josko Rie,6864,8,10,8,18,40,53,-13,38
Mattersburg,6864,9,8,11,17,34,53,-19,35
St. Pölten,6864,10,8,11,17,37,59,-22,35
FC Salzburg,6865,1,22,5,9,67,34,33,71
SK Sturm Gra,6865,2,21,5,10,69,40,29,68
SC Rheindorf,6865,3,20,8,8,66,42,24,68
Vienna,6865,4,18,6,12,60,55,5,60
Rapid Vienna,6865,5,14,11,11,61,43,18,53
RZ Pellets W,6865,6,12,8,16,54,63,-9,44
SV Josko Rie,6865,7,12,2,22,29,52,-23,38
Mattersburg,6865,8,9,9,18,42,59,-17,36
Admira Wacke,6865,9,10,6,20,34,63,-29,36
St. Pölten,6865,10,8,8,20,42,73,-31,32
FC Salzburg,6866,1,20,11,5,65,32,33,71
SC Rheindorf,6866,2,20,8,8,57,37,20,68
SK Sturm Gra,6866,3,19,7,10,59,35,24,64
Vienna,6866,4,18,3,15,63,56,7,57
Rapid Vienna,6866,5,16,7,13,61,44,17,55
Admira Wacke,6866,6,12,8,16,40,57,-17,44
RZ Pellets W,6866,7,10,11,15,40,55,-15,41
SV Josko Rie,6866,8,10,7,19,33,48,-15,37
Mattersburg,6866,9,9,9,18,37,57,-20,36
St. Pölten,6866,10,5,11,20,31,65,-34,26
SC Rheindorf,6867,1,22,9,5,55,34,21,75
FC Salzburg,6867,2,21,9,6,72,30,42,72
SK Sturm Gra,6867,3,19,7,10,57,31,26,64
Vienna,6867,4,16,7,13,59,59,0,55
Rapid Vienna,6867,5,14,9,13,56,44,12,51
RZ Pellets W,6867,6,12,10,14,44,51,-7,46
SV Josko Rie,6867,7,12,6,18,31,52,-21,42
Admira Wacke,6867,8,10,5,21,36,63,-27,35
Mattersburg,6867,9,8,9,19,37,55,-18,33
St. Pölten,6867,10,6,9,21,35,63,-28,27
SC Rheindorf,6868,1,21,7,8,61,39,22,70
FC Salzburg,6868,2,19,10,7,65,36,29,67
Vienna,6868,3,21,3,12,69,57,12,66
Rapid Vienna,6868,4,18,8,10,64,33,31,62
SK Sturm Gra,6868,5,16,9,11,53,39,14,57
St. Pölten,6868,6,10,10,16,50,64,-14,40
RZ Pellets W,6868,7,10,8,18,42,55,-13,38
SV Josko Rie,6868,8,11,5,20,40,59,-19,38
Mattersburg,6868,9,8,10,18,39,56,-17,34
Admira Wacke,6868,10,8,6,22,34,79,-45,30
Vienna,6869,1,22,5,9,76,48,28,71
FC Salzburg,6869,2,20,8,8,62,32,30,68
SK Sturm Gra,6869,3,18,9,9,52,30,22,63
SC Rheindorf,6869,4,17,7,12,51,48,3,58
Rapid Vienna,6869,5,13,14,9,54,37,17,53
Admira Wacke,6869,6,12,6,18,39,59,-20,42
RZ Pellets W,6869,7,10,9,17,47,66,-19,39
Mattersburg,6869,8,9,11,16,42,53,-11,38
SV Josko Rie,6869,9,9,7,20,39,63,-24,34
St. Pölten,6869,10,6,12,18,38,64,-26,30
FC Salzburg,6870,1,24,7,5,67,25,42,79
SC Rheindorf,6870,2,20,7,9,54,39,15,67
SK Sturm Gra,6870,3,20,5,11,60,31,29,65
Vienna,6870,4,18,4,14,56,53,3,58
Rapid Vienna,6870,5,15,9,12,49,38,11,54
SV Josko Rie,6870,6,11,6,19,31,47,-16,39
Admira Wacke,6870,7,10,9,17,40,61,-21,39
RZ Pellets W,6870,8,10,8,18,42,57,-15,38
Mattersburg,6870,9,9,6,21,32,55,-23,33
St. Pölten,6870,10,8,9,19,37,62,-25,33
SC Rheindorf,6871,1,22,6,8,59,41,18,72
FC Salzburg,6871,2,21,7,8,61,30,31,70
SK Sturm Gra,6871,3,18,6,12,59,41,18,60
Vienna,6871,4,16,7,13,59,58,1,55
Rapid Vienna,6871,5,14,10,12,52,36,16,52
SV Josko Rie,6871,6,13,6,17,41,51,-10,45
Admira Wacke,6871,7,13,6,17,38,54,-16,45
RZ Pellets W,6871,8,12,7,17,46,56,-10,43
Mattersburg,6871,9,9,9,18,36,53,-17,36
St. Pölten,6871,10,4,12,20,32,63,-31,24
Vienna,6872,1,21,4,11,71,48,23,67
SC Rheindorf,6872,2,20,6,10,51,40,11,66
FC Salzburg,6872,3,19,7,10,60,32,28,64
SK Sturm Gra,6872,4,18,6,12,61,33,28,60
RZ Pellets W,6872,5,15,7,14,50,53,-3,52
Rapid Vienna,6872,6,13,11,12,49,41,8,50
Admira Wacke,6872,7,11,8,17,35,59,-24,41
St. Pölten,6872,8,8,11,17,36,59,-23,35
SV Josko Rie,6872,9,9,8,19,30,56,-26,35
Mattersburg,6872,10,9,6,21,36,58,-22,33
FC Salzburg,6873,1,22,7,7,69,30,39,73
SC Rheindorf,6873,2,20,9,7,57,39,18,69
SK Sturm Gra,6873,3,20,6,10,59,35,24,66
Vienna,6873,4,20,5,11,67,56,11,65
Rapid Vienna,6873,5,14,10,12,61,43,18,52
Admira Wacke,6873,6,12,6,18,40,61,-21,42
St. Pölten,6873,7,9,12,15,40,57,-17,39
RZ Pellets W,6873,8,9,7,20,37,60,-23,34
SV Josko Rie,6873,9,9,5,22,33,59,-26,32
Mattersburg,6873,10,7,9,20,34,57,-23,30
FC Salzburg,6874,1,23,6,7,67,28,39,75
SC Rheindorf,6874,2,20,7,9,53,41,12,67
SK Sturm Gra,6874,3,20,5,11,58,36,22,65
Vienna,6874,4,20,4,12,67,48,19,64
Rapid Vienna,6874,5,16,8,12,58,43,15,56
RZ Pellets W,6874,6,12,5,19,43,63,-20,41
Mattersburg,6874,7,11,7,18,41,56,-15,40
Admira Wacke,6874,8,10,8,18,37,62,-25,38
SV Josko Rie,6874,9,8,7,21,36,59,-23,31
St. Pölten,6874,10,7,9,20,40,64,-24,30
FC Salzburg,6875,1,23,6,7,67,35,32,75
Vienna,6875,2,20,4,12,68,51,17,64
SK Sturm Gra,6875,3,19,6,11,55,32,23,63
SC Rheindorf,6875,4,19,6,11,50,39,11,63
Rapid Vienna,6875,5,13,9,14,53,48,5,48
RZ Pellets W,6875,6,11,9,16,46,56,-10,42
Admira Wacke,6875,7,11,8,17,38,55,-17,41
St. Pölten,6875,8,11,8,17,49,71,-22,41
Mattersburg,6875,9,10,8,18,40,51,-11,38
SV Josko Rie,6875,10,9,4,23,32,60,-28,31
SK Sturm Gra,6876,1,24,5,7,71,32,39,77
SC Rheindorf,6876,2,20,8,8,58,41,17,68
FC Salzburg,6876,3,19,10,7,64,31,33,67
Vienna,6876,4,17,7,12,57,58,-1,58
RZ Pellets W,6876,5,14,6,16,53,50,3,48
Rapid Vienna,6876,6,12,9,15,52,48,4,45
SV Josko Rie,6876,7,12,7,17,41,54,-13,43
Admira Wacke,6876,8,10,8,18,33,61,-28,38
St. Pölten,6876,9,9,6,21,42,66,-24,33
Mattersburg,6876,10,6,8,22,35,65,-30,26
FC Salzburg,6877,1,22,9,5,65,29,36,75
SK Sturm Gra,6877,2,19,9,8,62,41,21,66
SC Rheindorf,6877,3,18,10,8,54,39,15,64
Vienna,6877,4,17,9,10,63,47,16,60
Rapid Vienna,6877,5,15,9,12,54,41,13,54
Admira Wacke,6877,6,13,6,17,41,57,-16,45
RZ Pellets W,6877,7,12,7,17,42,55,-13,43
St. Pölten,6877,8,8,8,20,40,61,-21,32
Mattersburg,6877,9,8,7,21,34,55,-21,31
SV Josko Rie,6877,10,9,4,23,33,63,-30,31
FC Salzburg,6878,1,21,8,7,66,31,35,71
SK Sturm Gra,6878,2,18,9,9,58,33,25,63
Vienna,6878,3,18,6,12,59,47,12,60
SC Rheindorf,6878,4,18,5,13,54,51,3,59
Rapid Vienna,6878,5,13,11,12,57,42,15,50
Admira Wacke,6878,6,12,7,17,35,60,-25,43
RZ Pellets W,6878,7,12,6,18,42,56,-14,42
St. Pölten,6878,8,10,10,16,43,59,-16,40
SV Josko Rie,6878,9,10,8,18,33,50,-17,38
Mattersburg,6878,10,8,10,18,40,58,-18,34
FC Salzburg,6879,1,22,6,8,69,29,40,72
SC Rheindorf,6879,2,18,8,10,57,49,8,62
Rapid Vienna,6879,3,16,11,9,62,35,27,59
Vienna,6879,4,17,8,11,68,55,13,59
SK Sturm Gra,6879,5,17,5,14,57,42,15,56
RZ Pellets W,6879,6,12,8,16,46,55,-9,44
St. Pölten,6879,7,12,8,16,46,58,-12,44
Admira Wacke,6879,8,10,7,19,40,69,-29,37
SV Josko Rie,6879,9,10,6,20,42,66,-24,36
Mattersburg,6879,10,8,9,19,31,60,-29,33
FC Salzburg,6880,1,22,8,6,71,34,37,74
SC Rheindorf,6880,2,19,8,9,59,44,15,65
SK Sturm Gra,6880,3,20,4,12,60,36,24,64
Rapid Vienna,6880,4,17,10,9,64,38,26,61
Vienna,6880,5,18,5,13,63,53,10,59
St. Pölten,6880,6,10,8,18,41,61,-20,38
RZ Pellets W,6880,7,11,5,20,37,57,-20,38
SV Josko Rie,6880,7,10,8,18,37,57,-20,38
Mattersburg,6880,9,9,9,18,32,53,-21,36
Admira Wacke,6880,10,10,3,23,32,63,-31,33
FC Salzburg,6881,1,21,7,8,66,29,37,70
SC Rheindorf,6881,2,18,10,8,60,44,16,64
Vienna,6881,3,20,3,13,60,46,14,63
SK Sturm Gra,6881,4,17,8,11,64,44,20,59
RZ Pellets W,6881,5,14,6,16,46,57,-11,48
Rapid Vienna,6881,6,12,10,14,52,48,4,46
St. Pölten,6881,7,13,7,16,51,62,-11,46
Admira Wacke,6881,8,10,9,17,34,62,-28,39
SV Josko Rie,6881,9,10,5,21,39,59,-20,35
Mattersburg,6881,10,9,7,20,38,59,-21,34
Vienna,6882,1,22,5,9,72,44,28,71
FC Salzburg,6882,2,19,9,8,61,26,35,66
SC Rheindorf,6882,3,20,6,10,53,40,13,66
SK Sturm Gra,6882,4,19,5,12,58,31,27,62
Rapid Vienna,6882,5,16,10,10,55,38,17,58
SV Josko Rie,6882,6,13,5,18,41,54,-13,44
RZ Pellets W,6882,7,11,8,17,45,59,-14,41
Admira Wacke,6882,8,10,5,21,32,69,-37,35
St. Pölten,6882,9,8,9,19,37,65,-28,33
Mattersburg,6882,10,7,8,21,37,65,-28,29
FC Salzburg,6883,1,23,5,8,69,29,40,74
SC Rheindorf,6883,2,20,7,9,52,38,14,67
Vienna,6883,3,20,5,11,63,45,18,65
SK Sturm Gra,6883,4,19,6,11,59,36,23,63
Rapid Vienna,6883,5,17,8,11,61,44,17,59
RZ Pellets W,6883,6,12,9,15,48,57,-9,45
Admira Wacke,6883,7,10,7,19,39,68,-29,37
St. Pölten,6883,8,9,8,19,42,64,-22,35
SV Josko Rie,6883,9,9,7,20,29,52,-23,34
Mattersburg,6883,10,5,10,21,30,59,-29,25
FC Salzburg,6884,1,21,8,7,68,34,34,71
Vienna,6884,2,19,8,9,70,52,18,65
SK Sturm Gra,6884,3,17,6,13,56,45,11,57
SC Rheindorf,6884,4,16,8,12,55,50,5,56
Rapid Vienna,6884,5,13,10,13,53,37,16,49
RZ Pellets W,6884,6,12,9,15,44,58,-14,45
SV Josko Rie,6884,7,12,5,19,37,52,-15,41
Admira Wacke,6884,8,11,8,17,38,59,-21,41
Mattersburg,6884,9,11,7,18,42,56,-14,40
St. Pölten,6884,10,9,9,18,43,63,-20,36
FC Salzburg,6885,1,21,6,9,64,34,30,69
SC Rheindorf,6885,2,20,7,9,53,32,21,67
SK Sturm Gra,6885,3,19,8,9,60,38,22,65
Vienna,6885,4,17,6,13,63,55,8,57
Rapid Vienna,6885,5,14,10,12,55,45,10,52
SV Josko Rie,6885,6,13,3,20,41,52,-11,42
St. Pölten,6885,7,11,9,16,40,56,-16,42
RZ Pellets W,6885,8,11,7,18,42,56,-14,40
Admira Wacke,6885,9,10,7,19,33,60,-27,37
Mattersburg,6885,10,8,9,19,37,60,-23,33
FC Salzburg,6886,1,23,6,7,64,24,40,75
SK Sturm Gra,6886,2,22,5,9,66,32,34,71
SC Rheindorf,6886,3,21,5,10,56,39,17,68
Vienna,6886,4,18,4,14,61,60,1,58
Rapid Vienna,6886,5,11,11,14,45,39,6,44
RZ Pellets W,6886,6,12,8,16,42,50,-8,44
Admira Wacke,6886,7,11,8,17,39,57,-18,41
Mattersburg,6886,8,10,7,19,38,58,-20,37
SV Josko Rie,6886,9,9,7,20,31,56,-25,34
St. Pölten,6886,10,7,11,18,38,65,-27,32
FC Salzburg,6887,1,21,7,8,64,28,36,70
SK Sturm Gra,6887,2,19,8,9,51,27,24,65
SC Rheindorf,6887,3,19,8,9,56,40,16,65
Vienna,6887,4,16,4,16,57,56,1,52
RZ Pellets W,6887,5,15,4,17,44,53,-9,49
St. Pölten,6887,6,13,8,15,47,57,-10,47
Admira Wacke,6887,7,12,8,16,35,55,-20,44
SV Josko Rie,6887,8,13,4,19,37,52,-15,43
Rapid Vienna,6887,9,10,11,15,46,45,1,41
Mattersburg,6887,10,7,8,21,35,59,-24,29
FC Salzburg,6888,1,21,8,7,72,33,39,71
SK Sturm Gra,6888,2,21,7,8,59,29,30,70
SC Rheindorf,6888,3,18,6,12,51,43,8,60
Vienna,6888,4,17,6,13,68,53,15,57
Rapid Vienna,6888,5,13,12,11,53,39,14,51
RZ Pellets W,6888,6,11,8,17,42,60,-18,41
St. Pölten,6888,7,11,7,18,44,58,-14,40
SV Josko Rie,6888,8,10,8,18,35,56,-21,38
Admira Wacke,6888,9,11,5,20,36,73,-37,38
Mattersburg,6888,10,8,11,17,40,56,-16,35
SC Rheindorf,6889,1,21,6,9,52,40,12,69
FC Salzburg,6889,2,20,6,10,58,28,30,66
Rapid Vienna,6889,3,17,10,9,67,42,25,61
Vienna,6889,4,18,6,12,61,54,7,60
SK Sturm Gra,6889,5,16,10,10,58,41,17,58
SV Josko Rie,6889,6,13,6,17,38,48,-10,45
Admira Wacke,6889,7,12,8,16,45,57,-12,44
RZ Pellets W,6889,8,12,8,16,43,56,-13,44
St. Pölten,6889,9,7,8,21,37,68,-31,29
Mattersburg,6889,10,7,6,23,38,63,-25,27
FC Salzburg,6890,1,21,8,7,70,29,41,71
SC Rheindorf,6890,2,20,8,8,55,39,16,68
SK Sturm Gra,6890,3,19,7,10,55,34,21,64
Vienna,6890,4,19,5,12,61,51,10,62
Rapid Vienna,6890,5,15,11,10,58,43,15,56
SV Josko Rie,6890,6,13,5,18,33,47,-14,44
Admira Wacke,6890,7,10,7,19,38,63,-25,37
RZ Pellets W,6890,8,9,7,20,45,63,-18,34
St. Pölten,6890,9,7,12,17,42,63,-21,33
Mattersburg,6890,10,7,10,19,36,61,-25,31
FC Salzburg,6891,1,18,11,7,60,31,29,65
SC Rheindorf,6891,2,18,10,8,57,36,21,64
Vienna,6891,3,20,4,12,60,48,12,64
SK Sturm Gra,6891,4,17,7,12,55,40,15,58
RZ Pellets W,6891,5,15,6,15,49,51,-2,51
Admira Wacke,6891,6,12,9,15,39,49,-10,45
Mattersburg,6891,7,11,10,15,41,51,-10,43
St. Pölten,6891,8,11,9,16,45,61,-16,42
Rapid Vienna,6891,9,9,11,16,41,46,-5,38
SV Josko Rie,6891,10,9,3,24,32,66,-34,30
SC Rheindorf,6892,1,19,11,6,58,45,13,68
FC Salzburg,6892,2,19,9,8,59,32,27,66
Vienna,6892,3,20,4,12,69,48,21,64
SK Sturm Gra,6892,4,18,9,9,59,34,25,63
Rapid Vienna,6892,5,13,12,11,59,38,21,51
Admira Wacke,6892,6,12,7,17,41,61,-20,43
SV Josko Rie,6892,7,12,5,19,37,55,-18,41
RZ Pellets W,6892,8,10,8,18,40,64,-24,38
Mattersburg,6892,9,8,9,19,37,53,-16,33
St. Pölten,6892,10,7,10,19,37,66,-29,31
FC Salzburg,6893,1,21,8,7,65,31,34,71
SC Rheindorf,6893,2,22,5,9,61,42,19,71
SK Sturm Gra,6893,3,18,8,10,53,30,23,62
Vienna,6893,4,18,7,11,58,45,13,61
RZ Pellets W,6893,5,15,7,14,47,53,-6,52
Rapid Vienna,6893,6,12,10,14,46,39,7,46
Admira Wacke,6893,7,10,11,15,34,53,-19,41
SV Josko Rie,6893,8,8,8,20,32,53,-21,32
St. Pölten,6893,9,8,8,20,40,65,-25,32
Mattersburg,6893,10,7,10,19,32,57,-25,31
FC Salzburg,6894,1,26,5,5,70,23,47,83
SC Rheindorf,6894,2,20,8,8,54,40,14,68
SK Sturm Gra,6894,3,19,7,10,56,35,21,64
Vienna,6894,4,17,4,15,59,55,4,55
Rapid Vienna,6894,5,14,11,11,53,39,14,53
RZ Pellets W,6894,6,10,9,17,45,61,-16,39
Admira Wacke,6894,7,11,6,19,34,58,-24,39
St. Pölten,6894,8,9,11,16,51,68,-17,38
Mattersburg,6894,9,8,8,20,36,53,-17,32
SV Josko Rie,6894,10,9,5,22,27,53,-26,32
FC Salzburg,6895,1,22,7,7,67,29,38,73
SC Rheindorf,6895,2,21,6,9,56,37,19,69
SK Sturm Gra,6895,3,19,7,10,56,32,24,64
Vienna,6895,4,17,6,13,60,58,2,57
Rapid Vienna,6895,5,15,9,12,59,39,20,54
RZ Pellets W,6895,6,12,6,18,46,61,-15,42
SV Josko Rie,6895,7,13,3,20,39,56,-17,42
Admira Wacke,6895,8,9,9,18,38,65,-27,36
Mattersburg,6895,9,8,10,18,34,54,-20,34
St. Pölten,6895,10,8,9,19,39,63,-24,33
SC Rheindorf,6896,1,22,7,7,55,34,21,73
FC Salzburg,6896,2,21,9,6,68,31,37,72
SK Sturm Gra,6896,3,22,3,11,62,31,31,69
Vienna,6896,4,15,8,13,56,52,4,53
RZ Pellets W,6896,5,15,6,15,41,46,-5,51
Mattersburg,6896,6,10,9,17,39,49,-10,39
Admira Wacke,6896,7,10,9,17,35,61,-26,39
Rapid Vienna,6896,8,8,14,14,48,47,1,38
SV Josko Rie,6896,9,11,4,21,31,50,-19,37
St. Pölten,6896,10,6,11,19,33,67,-34,29
FC Salzburg,6897,1,20,7,9,59,28,31,67
SC Rheindorf,6897,2,19,10,7,50,32,18,67
SK Sturm Gra,6897,3,20,6,10,57,32,25,66
Rapid Vienna,6897,4,18,8,10,57,31,26,62
Vienna,6897,5,18,5,13,59,51,8,59
Admira Wacke,6897,6,15,4,17,36,54,-18,49
RZ Pellets W,6897,7,10,8,18,40,56,-16,38
SV Josko Rie,6897,8,10,5,21,28,53,-25,35
St. Pölten,6897,9,8,9,19,41,63,-22,33
Mattersburg,6897,10,7,8,21,28,55,-27,29
FC Salzburg,6898,1,21,9,6,76,32,44,72
SC Rheindorf,6898,2,19,8,9,54,42,12,65
SK Sturm Gra,6898,3,18,9,9,62,37,25,63
Vienna,6898,4,19,5,12,59,51,8,62
Rapid Vienna,6898,5,17,9,10,60,39,21,60
RZ Pellets W,6898,6,13,7,16,46,63,-17,46
Admira Wacke,6898,7,10,7,19,38,64,-26,37
SV Josko Rie,6898,8,9,7,20,27,51,-24,34
St. Pölten,6898,9,8,8,20,41,63,-22,32
Mattersburg,6898,10,7,9,20,37,58,-21,30
FC Salzburg,6899,1,24,6,6,71,32,39,78
SK Sturm Gra,6899,2,20,9,7,62,30,32,69
Vienna,6899,3,19,5,12,63,49,14,62
SC Rheindorf,6899,4,18,6,12,50,46,4,60
Rapid Vienna,6899,5,16,9,11,58,43,15,57
RZ Pellets W,6899,6,12,8,16,48,60,-12,44
Admira Wacke,6899,7,11,9,16,40,53,-13,42
SV Josko Rie,6899,8,9,6,21,30,54,-24,33
Mattersburg,6899,9,7,8,21,40,64,-24,29
St. Pölten,6899,10,5,12,19,41,72,-31,27
FC Salzburg,6900,1,22,7,7,71,30,41,73
SC Rheindorf,6900,2,18,7,11,48,47,1,61
SK Sturm Gra,6900,3,16,10,10,54,34,20,58
Vienna,6900,4,17,6,13,53,47,6,57
Rapid Vienna,6900,5,14,13,9,61,43,18,55
SV Josko Rie,6900,6,10,12,14,33,46,-13,42
Admira Wacke,6900,7,11,8,17,40,58,-18,41
RZ Pellets W,6900,8,10,10,16,44,57,-13,40
St. Pölten,6900,9,9,9,18,44,63,-19,36
Mattersburg,6900,10,8,8,20,33,56,-23,32
SC Rheindorf,6901,1,20,10,6,57,40,17,70
FC Salzburg,6901,2,20,7,9,60,31,29,67
Vienna,6901,3,18,8,10,60,44,16,62
SK Sturm Gra,6901,4,17,6,13,60,39,21,57
Rapid Vienna,6901,5,14,9,13,51,39,12,51
Admira Wacke,6901,6,12,6,18,40,60,-20,42
SV Josko Rie,6901,7,12,5,19,34,48,-14,41
RZ Pellets W,6901,8,10,9,17,44,59,-15,39
St. Pölten,6901,9,10,9,17,34,57,-23,39
Mattersburg,6901,10,9,7,20,38,61,-23,34
FC Salzburg,6902,1,21,9,6,59,29,30,72
SC Rheindorf,6902,2,21,8,7,66,39,27,71
SK Sturm Gra,6902,3,20,5,11,56,30,26,65
Vienna,6902,4,18,6,12,57,45,12,60
Rapid Vienna,6902,5,11,11,14,52,43,9,44
RZ Pellets W,6902,6,11,10,15,41,52,-11,43
SV Josko Rie,6902,7,11,9,16,34,49,-15,42
Admira Wacke,6902,8,11,6,19,31,59,-28,39
Mattersburg,6902,9,8,10,18,38,55,-17,34
St. Pölten,6902,10,7,8,21,33,66,-33,29
SK Sturm Gra,6903,1,21,6,9,65,34,31,69
FC Salzburg,6903,2,19,9,8,63,30,33,66
SC Rheindorf,6903,3,19,7,10,54,46,8,64
Vienna,6903,4,16,10,10,60,52,8,58
Rapid Vienna,6903,5,14,11,11,61,46,15,53
Admira Wacke,6903,6,13,6,17,41,59,-18,45
RZ Pellets W,6903,7,12,8,16,43,56,-13,44
SV Josko Rie,6903,8,11,5,20,34,51,-17,38
St. Pölten,6903,9,10,8,18,39,61,-22,38
Mattersburg,6903,10,6,8,22,30,55,-25,26
SK Sturm Gra,6904,1,21,6,9,64,34,30,69
Vienna,6904,2,21,5,10,73,46,27,68
FC Salzburg,6904,3,19,7,10,62,31,31,64
SC Rheindorf,6904,4,18,8,10,52,37,15,62
Rapid Vienna,6904,5,15,9,12,59,46,13,54
RZ Pellets W,6904,6,14,5,17,45,54,-9,47
Mattersburg,6904,7,10,10,16,36,52,-16,40
Admira Wacke,6904,8,11,5,20,36,64,-28,38
SV Josko Rie,6904,9,10,5,21,38,66,-28,35
St. Pölten,6904,10,6,10,20,38,73,-35,28
FC Salzburg,6905,1,20,9,7,66,31,35,69
SK Sturm Gra,6905,2,20,7,9,63,37,26,67
SC Rheindorf,6905,3,18,9,9,53,41,12,63
Vienna,6905,4,18,8,10,66,56,10,62
Rapid Vienna,6905,5,12,13,11,55,39,16,49
SV Josko Rie,6905,6,14,5,17,40,48,-8,47
RZ Pellets W,6905,7,9,12,15,40,51,-11,39
Admira Wacke,6905,8,11,5,20,32,58,-26,38
Mattersburg,6905,9,8,12,16,32,50,-18,36
St. Pölten,6905,10,5,10,21,36,72,-36,25
SC Rheindorf,6906,1,22,6,8,59,37,22,72
Vienna,6906,2,22,5,9,74,45,29,71
FC Salzburg,6906,3,19,8,9,63,33,30,65
SK Sturm Gra,6906,4,18,8,10,58,39,19,62
Rapid Vienna,6906,5,16,12,8,59,35,24,60
RZ Pellets W,6906,6,12,6,18,47,66,-19,42
SV Josko Rie,6906,7,11,6,19,32,50,-18,39
Admira Wacke,6906,8,9,9,18,38,64,-26,36
St. Pölten,6906,9,8,7,21,40,69,-29,31
Mattersburg,6906,10,5,9,22,29,61,-32,24
FC Salzburg,6907,1,21,8,7,63,32,31,71
SK Sturm Gra,6907,2,20,8,8,59,26,33,68
Vienna,6907,3,18,5,13,54,51,3,59
SC Rheindorf,6907,4,18,4,14,49,53,-4,58
Rapid Vienna,6907,5,14,12,10,56,39,17,54
Mattersburg,6907,6,10,9,17,40,49,-9,39
RZ Pellets W,6907,7,10,9,17,43,53,-10,39
Admira Wacke,6907,8,10,8,18,31,58,-27,38
SV Josko Rie,6907,9,10,7,19,36,51,-15,37
St. Pölten,6907,10,8,12,16,40,59,-19,36
SK Sturm Gra,6908,1,23,5,8,70,33,37,74
SC Rheindorf,6908,2,20,7,9,57,43,14,67
FC Salzburg,6908,3,20,6,10,60,28,32,66
Vienna,6908,4,16,6,14,57,55,2,54
RZ Pellets W,6908,5,16,5,15,50,52,-2,53
Rapid Vienna,6908,6,12,12,12,51,37,14,48
SV Josko Rie,6908,7,13,5,18,43,57,-14,44
Mattersburg,6908,8,10,8,18,34,51,-17,38
Admira Wacke,6908,9,9,4,23,35,73,-38,31
St. Pölten,6908,10,6,12,18,44,72,-28,30
FC Salzburg,6909,1,24,5,7,64,26,38,77
SC Rheindorf,6909,2,23,5,8,58,42,16,74
SK Sturm Gra,6909,3,20,5,11,63,35,28,65
Rapid Vienna,6909,4,17,9,10,55,37,18,60
Vienna,6909,5,18,3,15,69,57,12,57
RZ Pellets W,6909,6,12,6,18,46,54,-8,42
Admira Wacke,6909,7,12,6,18,37,60,-23,42
St. Pölten,6909,8,8,9,19,36,67,-31,33
Mattersburg,6909,9,7,9,20,34,58,-24,30
SV Josko Rie,6909,10,7,7,22,29,55,-26,28
FC Salzburg,6910,1,22,9,5,67,26,41,75
Vienna,6910,2,18,8,10,63,49,14,62
SC Rheindorf,6910,3,18,8,10,53,42,11,62
SK Sturm Gra,6910,4,18,6,12,56,34,22,60
Mattersburg,6910,5,14,8,14,47,53,-6,50
RZ Pellets W,6910,6,11,11,14,39,48,-9,44
Rapid Vienna,6910,7,11,8,17,50,56,-6,41
Admira Wacke,6910,8,11,5,20,35,63,-28,38
SV Josko Rie,6910,9,10,7,19,31,49,-18,37
St. Pölten,6910,10,7,10,19,38,59,-21,31
FC Salzburg,6911,1,23,7,6,77,31,46,76
SC Rheindorf,6911,2,20,7,9,55,38,17,67
SK Sturm Gra,6911,3,20,5,11,61,36,25,65
Vienna,6911,4,20,5,11,65,57,8,65
Rapid Vienna,6911,5,16,8,12,59,41,18,56
Admira Wacke,6911,6,13,5,18,41,62,-21,44
RZ Pellets W,6911,7,11,5,20,44,57,-13,38
SV Josko Rie,6911,8,9,6,21,31,56,-25,33
St. Pölten,6911,9,8,9,19,38,68,-30,33
Mattersburg,6911,10,8,7,21,36,61,-25,31
SK Sturm Gra,6912,1,23,5,8,66,31,35,74
SC Rheindorf,6912,2,21,8,7,57,38,19,71
FC Salzburg,6912,3,19,9,8,58,30,28,66
Rapid Vienna,6912,4,18,9,9,65,41,24,63
Vienna,6912,5,18,4,14,64,57,7,58
SV Josko Rie,6912,6,14,3,19,38,45,-7,45
RZ Pellets W,6912,7,11,8,17,45,61,-16,41
Admira Wacke,6912,8,10,5,21,36,64,-28,35
St. Pölten,6912,9,6,10,20,35,63,-28,28
Mattersburg,6912,10,6,7,23,30,64,-34,25
FC Salzburg,6913,1,20,10,6,62,26,36,70
SC Rheindorf,6913,2,21,7,8,57,36,21,70
SK Sturm Gra,6913,3,18,9,9,58,32,26,63
Vienna,6913,4,17,5,14,57,51,6,56
Rapid Vienna,6913,5,11,13,12,55,44,11,46
RZ Pellets W,6913,6,11,9,16,43,54,-11,42
Admira Wacke,6913,7,11,9,16,41,59,-18,42
St. Pölten,6913,8,10,9,17,45,66,-21,39
SV Josko Rie,6913,9,11,6,19,34,56,-22,39
Mattersburg,6913,10,7,9,20,34,62,-28,30
FC Salzburg,6914,1,24,6,6,78,27,51,78
Vienna,6914,2,21,4,11,66,50,16,67
SC Rheindorf,6914,3,17,8,11,51,46,5,59
SK Sturm Gra,6914,4,17,6,13,54,43,11,57
Rapid Vienna,6914,5,14,10,12,57,46,11,52
SV Josko Rie,6914,6,14,3,19,38,47,-9,45
RZ Pellets W,6914,7,11,10,15,46,54,-8,43
Admira Wacke,6914,8,10,8,18,32,58,-26,38
St. Pölten,6914,9,8,9,19,34,56,-22,33
Mattersburg,6914,10,9,6,21,35,64,-29,33
FC Salzburg,6915,1,20,7,9,57,32,25,67
Rapid Vienna,6915,2,18,10,8,59,34,25,64
SK Sturm Gra,6915,3,18,7,11,54,29,25,61
Vienna,6915,4,17,6,13,58,52,6,57
SC Rheindorf,6915,5,17,6,13,52,46,6,57
RZ Pellets W,6915,6,13,8,15,47,55,-8,47
Admira Wacke,6915,7,12,7,17,39,55,-16,43
SV Josko Rie,6915,8,12,4,20,37,52,-15,40
Mattersburg,6915,9,9,9,18,35,56,-21,36
St. Pölten,6915,10,9,6,21,40,67,-27,33
FC Salzburg,6916,1,21,6,9,71,39,32,69
Vienna,6916,2,20,5,11,61,47,14,65
SK Sturm Gra,6916,3,18,8,10,59,36,23,62
SC Rheindorf,6916,4,19,5,12,54,46,8,62
Rapid Vienna,6916,5,13,11,12,50,39,11,50
RZ Pellets W,6916,6,13,11,12,47,46,1,50
SV Josko Rie,6916,7,12,4,20,37,57,-20,40
Mattersburg,6916,8,10,8,18,41,55,-14,38
St. Pölten,6916,9,9,8,19,42,63,-21,35
Admira Wacke,6916,10,9,6,21,33,67,-34,33
FC Salzburg,6917,1,23,8,5,70,26,44,77
SC Rheindorf,6917,2,18,10,8,51,38,13,64
SK Sturm Gra,6917,3,17,8,11,51,36,15,59
Vienna,6917,4,17,4,15,62,52,10,55
Rapid Vienna,6917,5,13,11,12,60,44,16,50
RZ Pellets W,6917,6,11,11,14,45,58,-13,44
Admira Wacke,6917,7,12,7,17,37,61,-24,43
SV Josko Rie,6917,8,12,6,18,38,48,-10,42
St. Pölten,6917,9,7,11,18,39,64,-25,32
Mattersburg,6917,10,6,12,18,31,57,-26,30
FC Salzburg,6918,1,21,8,7,62,28,34,71
SC Rheindorf,6918,2,21,5,10,55,39,16,68
SK Sturm Gra,6918,3,20,4,12,56,36,20,64
Vienna,6918,4,17,6,13,58,53,5,57
Rapid Vienna,6918,5,14,11,11,54,40,14,53
Admira Wacke,6918,6,12,9,15,37,52,-15,45
Mattersburg,6918,7,11,8,17,43,53,-10,41
SV Josko Rie,6918,8,12,5,19,34,52,-18,41
RZ Pellets W,6918,9,10,8,18,46,63,-17,38
St. Pölten,6918,10,5,10,21,37,66,-29,25
FC Salzburg,6919,1,22,5,9,65,29,36,71
SC Rheindorf,6919,2,22,5,9,63,36,27,71
Vienna,6919,3,21,4,11,67,49,18,67
Rapid Vienna,6919,4,18,9,9,66,37,29,63
SK Sturm Gra,6919,5,19,5,12,56,37,19,62
Admira Wacke,6919,6,14,3,19,34,62,-28,45
RZ Pellets W,6919,7,12,8,16,42,52,-10,44
Mattersburg,6919,8,8,8,20,36,61,-25,32
SV Josko Rie,6919,9,8,5,23,31,59,-28,29
St. Pölten,6919,10,5,10,21,41,79,-38,25
FC Salzburg,6920,1,19,11,6,69,32,37,68
SK Sturm Gra,6920,2,21,3,12,66,38,28,66
Rapid Vienna,6920,3,15,12,9,54,33,21,57
SC Rheindorf,6920,4,16,9,11,51,47,4,57
Vienna,6920,5,14,12,10,61,57,4,54
RZ Pellets W,6920,6,11,9,16,45,58,-13,42
Admira Wacke,6920,7,11,9,16,38,59,-21,42
Mattersburg,6920,8,11,8,17,41,51,-10,41
St. Pölten,6920,9,10,9,17,45,64,-19,39
SV Josko Rie,6920,10,9,4,23,30,61,-31,31
FC Salzburg,6921,1,20,8,8,70,35,35,68
SK Sturm Gra,6921,2,21,4,11,60,31,29,67
SC Rheindorf,6921,3,19,9,8,49,34,15,66
Vienna,6921,4,17,6,13,57,54,3,57
Rapid Vienna,6921,5,12,12,12,49,42,7,48
Admira Wacke,6921,6,12,7,17,36,54,-18,43
RZ Pellets W,6921,7,11,7,18,42,62,-20,40
SV Josko Rie,6921,8,10,8,18,29,45,-16,38
Mattersburg,6921,9,9,10,17,37,53,-16,37
St. Pölten,6921,10,7,13,16,40,59,-19,34
FC Salzburg,6922,1,19,9,8,67,40,27,66
SC Rheindorf,6922,2,19,9,8,62,42,20,66
SK Sturm Gra,6922,3,20,5,11,61,35,26,65
Vienna,6922,4,16,7,13,61,56,5,55
Rapid Vienna,6922,5,13,9,14,54,44,10,48
SV Josko Rie,6922,6,14,5,17,43,51,-8,47
RZ Pellets W,6922,7,11,8,17,42,56,-14,41
Mattersburg,6922,8,11,7,18,38,54,-16,40
Admira Wacke,6922,9,11,7,18,43,67,-24,40
St. Pölten,6922,10,8,10,18,41,67,-26,34
SK Sturm Gra,6923,1,20,7,9,66,36,30,67
FC Salzburg,6923,2,20,7,9,62,38,24,67
Vienna,6923,3,20,6,10,74,55,19,66
SC Rheindorf,6923,4,19,7,10,60,45,15,64
Rapid Vienna,6923,5,14,9,13,60,46,14,51
Mattersburg,6923,6,11,10,15,46,57,-11,43
RZ Pellets W,6923,7,11,8,17,45,63,-18,41
Admira Wacke,6923,8,12,5,19,46,65,-19,41
SV Josko Rie,6923,9,8,7,21,35,61,-26,31
St. Pölten,6923,10,7,10,19,43,71,-28,31
FC Salzburg,6924,1,20,10,6,70,32,38,70
SK Sturm Gra,6924,2,20,7,9,59,32,27,67
Vienna,6924,3,21,2,13,66,52,14,65
SC Rheindorf,6924,4,18,8,10,48,41,7,62
Rapid Vienna,6924,5,12,12,12,51,45,6,48
RZ Pellets W,6924,6,12,8,16,51,65,-14,44
SV Josko Rie,6924,7,11,6,19,39,52,-13,39
St. Pölten,6924,8,8,13,15,47,63,-16,37
Admira Wacke,6924,9,10,6,20,39,68,-29,36
Mattersburg,6924,10,7,10,19,30,50,-20,31
FC Salzburg,6925,1,22,7,7,63,28,35,73
SC Rheindorf,6925,2,17,10,9,52,47,5,61
Rapid Vienna,6925,3,17,8,11,65,33,32,59
SK Sturm Gra,6925,4,16,9,11,54,41,13,57
RZ Pellets W,6925,5,15,7,14,49,48,1,52
Vienna,6925,6,15,5,16,52,54,-2,50
SV Josko Rie,6925,7,12,6,18,40,50,-10,42
Mattersburg,6925,8,11,7,18,35,50,-15,40
Admira Wacke,6925,9,10,7,19,32,61,-29,37
St. Pölten,6925,10,8,8,20,33,63,-30,32
SC Rheindorf,6926,1,21,8,7,61,39,22,71
FC Salzburg,6926,2,19,10,7,62,32,30,67
SK Sturm Gra,6926,3,17,7,12,58,44,14,58
Rapid Vienna,6926,4,14,13,9,61,39,22,55
Vienna,6926,5,16,4,16,60,59,1,52
Admira Wacke,6926,6,14,6,16,40,57,-17,48
RZ Pellets W,6926,7,12,8,16,45,59,-14,44
Mattersburg,6926,8,7,14,15,41,58,-17,35
St. Pölten,6926,9,7,12,17,45,63,-18,33
SV Josko Rie,6926,10,8,8,20,34,57,-23,32
FC Salzburg,6927,1,23,7,6,69,26,43,76
SK Sturm Gra,6927,2,19,10,7,63,33,30,67
Rapid Vienna,6927,3,16,10,10,58,35,23,58
SC Rheindorf,6927,4,16,9,11,53,49,4,57
Vienna,6927,5,15,6,15,59,65,-6,51
SV Josko Rie,6927,6,14,5,17,38,55,-17,47
RZ Pellets W,6927,7,10,8,18,44,55,-11,38
St. Pölten,6927,8,9,10,17,47,62,-15,37
Mattersburg,6927,9,10,7,19,44,61,-17,37
Admira Wacke,6927,10,9,6,21,30,64,-34,33
FC Salzburg,6928,1,23,6,7,72,38,34,75
SC Rheindorf,6928,2,21,7,8,58,39,19,70
Vienna,6928,3,19,4,13,57,50,7,61
Rapid Vienna,6928,4,17,9,10,65,39,26,60
RZ Pellets W,6928,5,15,7,14,55,54,1,52
SK Sturm Gra,6928,6,14,7,15,50,42,8,49
SV Josko Rie,6928,7,11,6,19,29,48,-19,39
Admira Wacke,6928,8,11,4,21,36,63,-27,37
St. Pölten,6928,9,8,10,18,43,68,-25,34
Mattersburg,6928,10,6,10,20,37,61,-24,28
FC Salzburg,6929,1,21,9,6,66,29,37,72
SK Sturm Gra,6929,2,22,5,9,64,31,33,71
SC Rheindorf,6929,3,18,7,11,57,48,9,61
Vienna,6929,4,17,6,13,65,58,7,57
Rapid Vienna,6929,5,14,12,10,56,40,16,54
RZ Pellets W,6929,6,12,10,14,53,53,0,46
Admira Wacke,6929,7,12,5,19,40,66,-26,41
SV Josko Rie,6929,8,8,9,19,34,54,-20,33
Mattersburg,6929,9,6,14,16,31,53,-22,32
St. Pölten,6929,10,5,13,18,40,74,-34,28
FC Salzburg,6930,1,23,5,8,68,30,38,74
SC Rheindorf,6930,2,20,9,7,55,37,18,69
Vienna,6930,3,20,4,12,64,50,14,64
SK Sturm Gra,6930,4,18,8,10,55,34,21,62
Rapid Vienna,6930,5,13,10,13,57,46,11,49
Mattersburg,6930,6,12,6,18,39,55,-16,42
Admira Wacke,6930,7,12,6,18,36,58,-22,42
RZ Pellets W,6930,8,12,5,19,48,61,-13,41
St. Pölten,6930,9,8,9,19,47,73,-26,33
SV Josko Rie,6930,10,9,4,23,34,59,-25,31
FC Salzburg,6931,1,19,10,7,57,30,27,67
Vienna,6931,2,17,10,9,66,49,17,61
SC Rheindorf,6931,3,17,10,9,52,41,11,61
SK Sturm Gra,6931,4,17,9,10,58,37,21,60
Rapid Vienna,6931,5,12,15,9,53,39,14,51
Mattersburg,6931,6,10,10,16,40,52,-12,40
Admira Wacke,6931,7,10,10,16,40,59,-19,40
St. Pölten,6931,8,9,11,16,41,58,-17,38
SV Josko Rie,6931,9,10,6,20,36,54,-18,36
RZ Pellets W,6931,10,8,11,17,40,64,-24,35
SK Sturm Gra,6932,1,21,7,8,64,33,31,70
SC Rheindorf,6932,2,20,7,9,55,41,14,67
Vienna,6932,3,20,5,11,68,55,13,65
FC Salzburg,6932,4,16,11,9,63,41,22,59
Rapid Vienna,6932,5,13,8,15,61,48,13,47
Admira Wacke,6932,6,13,4,19,43,62,-19,43
Mattersburg,6932,7,11,8,17,46,57,-11,41
SV Josko Rie,6932,8,12,4,20,39,63,-24,40
RZ Pellets W,6932,9,11,6,19,44,61,-17,39
St. Pölten,6932,10,8,10,18,39,61,-22,34
FC Salzburg,6933,1,22,6,8,69,28,41,72
SC Rheindorf,6933,2,21,7,8,54,38,16,70
SK Sturm Gra,6933,3,19,7,10,62,36,26,64
Vienna,6933,4,17,5,14,53,55,-2,56
Rapid Vienna,6933,5,13,12,11,53,39,14,51
RZ Pellets W,6933,6,15,6,15,54,60,-6,51
Mattersburg,6933,7,12,10,14,37,47,-10,46
Admira Wacke,6933,8,10,8,18,37,60,-23,38
SV Josko Rie,6933,9,8,5,23,30,61,-31,29
St. Pölten,6933,10,7,6,23,44,69,-25,27
SK Sturm Gra,6934,1,21,5,10,64,31,33,68
FC Salzburg,6934,2,19,9,8,61,33,28,66
Vienna,6934,3,19,6,11,58,49,9,63
SC Rheindorf,6934,4,17,7,12,54,43,11,58
Rapid Vienna,6934,5,16,9,11,52,37,15,57
Admira Wacke,6934,6,13,10,13,41,49,-8,49
SV Josko Rie,6934,7,13,4,19,33,51,-18,43
RZ Pellets W,6934,8,11,6,19,41,56,-15,39
St. Pölten,6934,9,8,9,19,41,71,-30,33
Mattersburg,6934,10,7,7,22,30,55,-25,28
FC Salzburg,6935,1,23,7,6,70,30,40,76
SK Sturm Gra,6935,2,23,5,8,70,37,33,74
SC Rheindorf,6935,3,18,7,11,50,40,10,61
Rapid Vienna,6935,4,15,9,12,61,44,17,54
Vienna,6935,5,15,6,15,58,62,-4,51
Mattersburg,6935,6,12,9,15,45,55,-10,45
RZ Pellets W,6935,7,11,6,19,47,64,-17,39
Admira Wacke,6935,8,11,5,20,35,59,-24,38
SV Josko Rie,6935,9,9,7,20,31,52,-21,34
St. Pölten,6935,10,8,9,19,39,63,-24,33
SK Sturm Gra,6936,1,20,7,9,56,33,23,67
FC Salzburg,6936,2,18,11,7,61,28,33,65
SC Rheindorf,6936,3,19,8,9,55,44,11,65
Vienna,6936,4,18,4,14,60,53,7,58
Rapid Vienna,6936,5,15,10,11,56,40,16,55
SV Josko Rie,6936,6,16,4,16,45,46,-1,52
RZ Pellets W,6936,7,10,8,18,45,60,-15,38
Admira Wacke,6936,8,10,6,20,31,60,-29,36
St. Pölten,6936,9,8,11,17,40,64,-24,35
Mattersburg,6936,10,7,9,20,32,53,-21,30
FC Salzburg,6937,1,21,7,8,62,37,25,70
SC Rheindorf,6937,2,20,9,7,55,38,17,69
Vienna,6937,3,20,6,10,65,46,19,66
SK Sturm Gra,6937,4,17,10,9,61,37,24,61
Rapid Vienna,6937,5,16,9,11,62,41,21,57
RZ Pellets W,6937,6,12,7,17,47,56,-9,43
Admira Wacke,6937,7,11,6,19,31,58,-27,39
St. Pölten,6937,8,8,10,18,45,67,-22,34
SV Josko Rie,6937,9,8,7,21,32,55,-23,31
Mattersburg,6937,10,7,9,20,34,59,-25,30
SK Sturm Gra,6938,1,22,4,10,62,34,28,70
FC Salzburg,6938,2,21,6,9,69,34,35,69
Vienna,6938,3,19,9,8,67,50,17,66
SC Rheindorf,6938,4,20,6,10,56,41,15,66
RZ Pellets W,6938,5,15,4,17,41,48,-7,49
Rapid Vienna,6938,6,12,11,13,54,49,5,47
Admira Wacke,6938,7,13,8,15,40,53,-13,47
St. Pölten,6938,8,8,10,18,39,62,-23,34
SV Josko Rie,6938,9,8,7,21,35,57,-22,31
Mattersburg,6938,10,6,7,23,32,67,-35,25
SC Rheindorf,6939,1,21,7,8,57,34,23,70
FC Salzburg,6939,2,20,9,7,64,33,31,69
SK Sturm Gra,6939,3,20,7,9,68,33,35,67
Rapid Vienna,6939,4,15,11,10,54,34,20,56
Vienna,6939,5,17,5,14,59,57,2,56
RZ Pellets W,6939,6,13,8,15,46,56,-10,47
Admira Wacke,6939,7,12,8,16,40,54,-14,44
Mattersburg,6939,8,11,6,19,40,63,-23,39
St. Pölten,6939,9,7,9,20,37,69,-32,30
SV Josko Rie,6939,10,7,4,25,28,60,-32,25
SC Rheindorf,6940,1,21,9,6,64,41,23,72
FC Salzburg,6940,2,19,7,10,62,37,25,64
Vienna,6940,3,20,3,13,65,56,9,63
SK Sturm Gra,6940,4,18,7,11,63,34,29,61
Rapid Vienna,6940,5,13,9,14,54,42,12,48
RZ Pellets W,6940,6,13,8,15,52,55,-3,47
SV Josko Rie,6940,7,12,5,19,37,53,-16,41
St. Pölten,6940,8,10,9,17,40,67,-27,39
Admira Wacke,6940,9,10,6,20,29,57,-28,36
Mattersburg,6940,10,9,7,20,40,64,-24,34
SC Rheindorf,6941,1,21,8,7,59,40,19,71
FC Salzburg,6941,2,20,7,9,64,30,34,67
SK Sturm Gra,6941,3,19,5,12,65,41,24,62
Vienna,6941,4,16,8,12,60,54,6,56
Rapid Vienna,6941,5,13,11,12,53,45,8,50
Admira Wacke,6941,6,15,5,16,41,53,-12,50
RZ Pellets W,6941,7,10,10,16,42,54,-12,40
St. Pölten,6941,8,9,11,16,38,59,-21,38
SV Josko Rie,6941,9,10,7,19,34,55,-21,37
Mattersburg,6941,10,4,14,18,34,59,-25,26
FC Salzburg,6942,1,21,9,6,65,29,36,72
SK Sturm Gra,6942,2,19,8,9,60,37,23,65
SC Rheindorf,6942,3,18,11,7,57,44,13,65
Vienna,6942,4,17,6,13,59,54,5,57
Rapid Vienna,6942,5,12,13,11,55,41,14,49
Mattersburg,6942,6,11,10,15,41,53,-12,43
RZ Pellets W,6942,7,10,8,18,43,62,-19,38
Admira Wacke,6942,8,10,7,19,34,55,-21,37
SV Josko Rie,6942,9,10,6,20,36,56,-20,36
St. Pölten,6942,10,8,10,18,43,62,-19,34
SK Sturm Gra,6943,1,22,6,8,61,32,29,72
FC Salzburg,6943,2,20,8,8,63,31,32,68
SC Rheindorf,6943,3,18,8,10,53,42,11,62
Vienna,6943,4,17,5,14,64,56,8,56
Rapid Vienna,6943,5,13,12,11,50,39,11,51
SV Josko Rie,6943,6,13,5,18,38,50,-12,44
RZ Pellets W,6943,7,11,10,15,48,59,-11,43
Admira Wacke,6943,8,10,9,17,36,58,-22,39
St. Pölten,6943,9,9,9,18,43,65,-22,36
Mattersburg,6943,10,7,8,21,34,58,-24,29
FC Salzburg,6944,1,23,8,5,66,31,35,77
SK Sturm Gra,6944,2,20,6,10,60,32,28,66
SC Rheindorf,6944,3,20,6,10,59,45,14,66
Rapid Vienna,6944,4,13,14,9,52,38,14,53
Vienna,6944,5,14,6,16,60,59,1,48
RZ Pellets W,6944,6,13,9,14,51,55,-4,48
Admira Wacke,6944,7,10,8,18,34,59,-25,38
Mattersburg,6944,8,10,6,20,42,60,-18,36
St. Pölten,6944,9,8,10,18,43,65,-22,34
SV Josko Rie,6944,10,9,7,20,39,62,-23,34
FC Salzburg,6945,1,23,6,7,70,28,42,75
Vienna,6945,2,22,4,10,69,47,22,70
SC Rheindorf,6945,3,19,8,9,56,48,8,65
SK Sturm Gra,6945,4,19,6,11,56,38,18,63
Rapid Vienna,6945,5,12,11,13,53,42,11,47
St. Pölten,6945,6,12,11,13,57,61,-4,47
RZ Pellets W,6945,7,10,11,15,42,55,-13,41
Admira Wacke,6945,8,10,6,20,33,60,-27,36
SV Josko Rie,6945,9,10,3,23,36,62,-26,33
Mattersburg,6945,10,7,6,23,34,65,-31,27
FC Salzburg,6946,1,22,6,8,66,32,34,72
SK Sturm Gra,6946,2,21,7,8,61,27,34,70
SC Rheindorf,6946,3,19,6,11,54,43,11,63
Vienna,6946,4,18,4,14,62,53,9,58
Rapid Vienna,6946,5,13,8,15,47,43,4,47
RZ Pellets W,6946,6,12,10,14,46,55,-9,46
Admira Wacke,6946,7,12,7,17,37,52,-15,43
SV Josko Rie,6946,8,11,6,19,33,51,-18,39
St. Pölten,6946,9,8,9,19,36,61,-25,33
Mattersburg,6946,10,7,11,18,37,62,-25,32
FC Salzburg,6947,1,22,7,7,66,28,38,73
SK Sturm Gra,6947,2,19,7,10,57,37,20,64
SC Rheindorf,6947,3,18,8,10,56,44,12,62
Vienna,6947,4,18,5,13,63,53,10,59
Rapid Vienna,6947,5,14,11,11,59,39,20,53
SV Josko Rie,6947,6,13,5,18,37,49,-12,44
St. Pölten,6947,7,11,7,18,40,66,-26,40
RZ Pellets W,6947,8,10,9,17,40,53,-13,39
Admira Wacke,6947,9,11,4,21,36,63,-27,37
Mattersburg,6947,10,9,7,20,37,59,-22,34
SC Rheindorf,6948,1,22,7,7,61,38,23,73
SK Sturm Gra,6948,2,19,9,8,62,36,26,66
FC Salzburg,6948,3,17,10,9,62,39,23,61
Vienna,6948,4,18,5,13,60,52,8,59
Rapid Vienna,6948,5,13,14,9,52,37,15,53
RZ Pellets W,6948,6,13,10,13,50,54,-4,49
St. Pölten,6948,7,11,10,15,45,62,-17,43
Admira Wacke,6948,8,9,10,17,35,53,-18,37
SV Josko Rie,6948,9,6,9,21,28,59,-31,27
Mattersburg,6948,10,6,8,22,34,59,-25,26
SC Rheindorf,6949,1,22,6,8,56,39,17,72
FC Salzburg,6949,2,21,7,8,69,33,36,70
Vienna,6949,3,21,3,12,63,50,13,66
SK Sturm Gra,6949,4,19,5,12,57,35,22,62
Rapid Vienna,6949,5,15,7,14,58,45,13,52
RZ Pellets W,6949,6,15,5,16,56,65,-9,50
St. Pölten,6949,7,9,11,16,42,60,-18,38
SV Josko Rie,6949,8,11,5,20,31,50,-19,38
Admira Wacke,6949,9,10,5,21,41,69,-28,35
Mattersburg,6949,10,7,6,23,30,57,-27,27
FC Salzburg,6950,1,21,9,6,66,25,41,72
Rapid Vienna,6950,2,18,11,7,61,34,27,65
SC Rheindorf,6950,3,20,5,11,53,46,7,65
SK Sturm Gra,6950,4,18,7,11,57,33,24,61
Vienna,6950,5,17,5,14,57,57,0,56
Admira Wacke,6950,6,12,7,17,35,53,-18,43
RZ Pellets W,6950,7,12,6,18,44,58,-14,42
SV Josko Rie,6950,8,11,5,20,32,54,-22,38
St. Pölten,6950,9,9,8,19,38,58,-20,35
Mattersburg,6950,10,7,7,22,34,59,-25,28
FC Salzburg,6951,1,22,6,8,71,32,39,72
SK Sturm Gra,6951,2,18,11,7,63,34,29,65
Vienna,6951,3,20,4,12,61,51,10,64
SC Rheindorf,6951,4,18,7,11,54,41,13,61
Rapid Vienna,6951,5,17,9,10,53,36,17,60
SV Josko Rie,6951,6,13,5,18,40,50,-10,44
Mattersburg,6951,7,10,8,18,36,55,-19,38
RZ Pellets W,6951,8,9,8,19,36,61,-25,35
St. Pölten,6951,9,8,10,18,47,65,-18,34
Admira Wacke,6951,10,9,4,23,28,64,-36,31
FC Salzburg,6952,1,20,9,7,65,30,35,69
SC Rheindorf,6952,2,19,10,7,58,40,18,67
SK Sturm Gra,6952,3,19,5,12,57,32,25,62
Rapid Vienna,6952,4,17,10,9,60,40,20,61
Vienna,6952,5,17,6,13,61,55,6,57
RZ Pellets W,6952,6,10,8,18,43,60,-17,38
Admira Wacke,6952,7,10,8,18,32,57,-25,38
St. Pölten,6952,8,9,10,17,47,65,-18,37
SV Josko Rie,6952,9,10,6,20,31,52,-21,36
Mattersburg,6952,10,9,8,19,41,64,-23,35
FC Salzburg,6953,1,23,7,6,67,27,40,76
SK Sturm Gra,6953,2,20,6,10,62,33,29,66
Vienna,6953,3,19,8,9,67,50,17,65
SC Rheindorf,6953,4,16,8,12,51,46,5,56
Rapid Vienna,6953,5,13,11,12,55,40,15,50
St. Pölten,6953,6,10,11,15,43,60,-17,41
RZ Pellets W,6953,7,11,7,18,42,58,-16,40
Admira Wacke,6953,8,9,10,17,40,63,-23,37
Mattersburg,6953,9,9,9,18,36,57,-21,36
SV Josko Rie,6953,10,9,5,22,36,65,-29,32
FC Salzburg,6954,1,22,7,7,70,27,43,73
SK Sturm Gra,6954,2,20,7,9,62,36,26,67
Vienna,6954,3,20,5,11,62,49,13,65
SC Rheindorf,6954,4,20,5,11,54,48,6,65
Rapid Vienna,6954,5,18,8,10,68,42,26,62
RZ Pellets W,6954,6,14,6,16,53,55,-2,48
Admira Wacke,6954,7,11,6,19,39,64,-25,39
SV Josko Rie,6954,8,9,4,23,30,57,-27,31
St. Pölten,6954,9,7,9,20,35,64,-29,30
Mattersburg,6954,10,6,9,21,36,67,-31,27
FC Salzburg,6955,1,21,9,6,67,27,40,72
SK Sturm Gra,6955,2,22,6,8,67,34,33,72
SC Rheindorf,6955,3,20,7,9,50,35,15,67
Vienna,6955,4,19,6,11,62,50,12,63
Rapid Vienna,6955,5,12,11,13,51,41,10,47
RZ Pellets W,6955,6,12,9,15,44,58,-14,45
SV Josko Rie,6955,7,10,12,14,32,45,-13,42
Admira Wacke,6955,8,10,6,20,40,65,-25,36
St. Pölten,6955,9,5,13,18,36,66,-30,28
Mattersburg,6955,10,6,7,23,30,58,-28,25
FC Salzburg,6956,1,22,6,8,68,31,37,72
SK Sturm Gra,6956,2,18,11,7,53,30,23,65
Vienna,6956,3,19,6,11,62,51,11,63
SC Rheindorf,6956,4,17,8,11,50,49,1,59
Rapid Vienna,6956,5,14,11,11,62,43,19,53
RZ Pellets W,6956,6,15,6,15,49,53,-4,51
SV Josko Rie,6956,7,10,8,18,37,51,-14,38
Mattersburg,6956,8,10,7,19,33,48,-15,37
Admira Wacke,6956,9,9,7,20,31,58,-27,34
St. Pölten,6956,10,6,10,20,31,62,-31,28
SC Rheindorf,6957,1,23,6,7,64,38,26,75
SK Sturm Gra,6957,2,20,7,9,58,29,29,67
Rapid Vienna,6957,3,17,10,9,63,39,24,61
FC Salzburg,6957,4,17,9,10,57,36,21,60
Vienna,6957,5,15,10,11,54,46,8,55
RZ Pellets W,6957,6,10,10,16,37,54,-17,40
SV Josko Rie,6957,7,12,4,20,33,50,-17,40
Admira Wacke,6957,8,10,8,18,30,57,-27,38
St. Pölten,6957,9,8,8,20,42,68,-26,32
Mattersburg,6957,10,7,10,19,32,53,-21,31
FC Salzburg,6958,1,21,8,7,67,34,33,71
Vienna,6958,2,18,6,12,62,53,9,60
SC Rheindorf,6958,3,16,10,10,51,44,7,58
SK Sturm Gra,6958,4,16,8,12,51,35,16,56
Rapid Vienna,6958,5,12,12,12,48,43,5,48
RZ Pellets W,6958,6,13,8,15,41,48,-7,47
Admira Wacke,6958,7,13,8,15,44,53,-9,47
SV Josko Rie,6958,8,11,5,20,39,54,-15,38
Mattersburg,6958,9,8,12,16,41,59,-18,36
St. Pölten,6958,10,7,13,16,37,58,-21,34
FC Salzburg,6959,1,21,6,9,62,34,28,69
SK Sturm Gra,6959,2,20,6,10,58,35,23,66
Rapid Vienna,6959,3,18,10,8,64,36,28,64
SC Rheindorf,6959,4,17,11,8,54,40,14,62
Vienna,6959,5,16,7,13,58,54,4,55
Admira Wacke,6959,6,13,6,17,39,54,-15,45
RZ Pellets W,6959,7,12,8,16,46,55,-9,44
SV Josko Rie,6959,8,13,5,18,35,49,-14,44
Mattersburg,6959,9,9,7,20,40,61,-21,34
St. Pölten,6959,10,4,8,24,32,70,-38,20
FC Salzburg,6960,1,21,9,6,65,31,34,72
SK Sturm Gra,6960,2,19,9,8,60,29,31,66
SC Rheindorf,6960,3,18,9,9,55,39,16,63
Vienna,6960,4,18,8,10,66,48,18,62
Rapid Vienna,6960,5,11,13,12,51,41,10,46
RZ Pellets W,6960,6,12,9,15,42,59,-17,45
Mattersburg,6960,7,10,8,18,38,59,-21,38
Admira Wacke,6960,8,11,5,20,35,63,-28,38
SV Josko Rie,6960,9,10,4,22,35,54,-19,34
St. Pölten,6960,10,8,10,18,42,66,-24,34
SK Sturm Gra,6961,1,21,6,9,64,31,33,69
FC Salzburg,6961,2,20,8,8,64,38,26,68
SC Rheindorf,6961,3,19,6,11,56,46,10,63
Vienna,6961,4,18,3,15,57,53,4,57
Rapid Vienna,6961,5,13,10,13,50,42,8,49
Admira Wacke,6961,6,14,3,19,32,54,-22,45
RZ Pellets W,6961,7,11,10,15,38,51,-13,43
St. Pölten,6961,8,11,9,16,49,55,-6,42
Mattersburg,6961,9,11,8,17,39,52,-13,41
SV Josko Rie,6961,10,7,7,22,30,57,-27,28
SC Rheindorf,6962,1,20,9,7,59,38,21,69
FC Salzburg,6962,2,20,8,8,62,33,29,68
Vienna,6962,3,19,5,12,63,50,13,62
Rapid Vienna,6962,4,16,11,9,62,35,27,59
SK Sturm Gra,6962,5,15,8,13,57,42,15,53
Admira Wacke,6962,6,13,7,16,40,61,-21,46
RZ Pellets W,6962,7,13,5,18,48,63,-15,44
Mattersburg,6962,8,9,10,17,35,54,-19,37
St. Pölten,6962,9,8,8,20,40,64,-24,32
SV Josko Rie,6962,10,7,9,20,31,57,-26,30
FC Salzburg,6963,1,19,8,9,63,37,26,65
SC Rheindorf,6963,2,19,7,10,54,41,13,64
SK Sturm Gra,6963,3,17,8,11,51,31,20,59
Rapid Vienna,6963,4,15,11,10,55,39,16,56
Vienna,6963,5,16,5,15,58,56,2,53
RZ Pellets W,6963,6,13,7,16,42,50,-8,46
Mattersburg,6963,7,9,13,14,40,48,-8,40
SV Josko Rie,6963,8,11,6,19,28,47,-19,39
Admira Wacke,6963,9,10,9,17,41,62,-21,39
St. Pölten,6963,10,10,8,18,39,60,-21,38
SK Sturm Gra,6964,1,22,5,9,66,32,34,71
SC Rheindorf,6964,2,20,6,10,59,47,12,66
Vienna,6964,3,20,2,14,70,53,17,62
FC Salzburg,6964,4,18,6,12,59,38,21,60
Rapid Vienna,6964,5,13,11,12,43,31,12,50
RZ Pellets W,6964,6,14,7,15,45,54,-9,49
Admira Wacke,6964,7,10,9,17,33,55,-22,39
St. Pölten,6964,8,9,10,17,39,63,-24,37
SV Josko Rie,6964,9,9,8,19,31,51,-20,35
Mattersburg,6964,10,8,10,18,35,56,-21,34
SC Rheindorf,6965,1,20,8,8,61,38,23,68
SK Sturm Gra,6965,2,20,5,11,56,38,18,65
FC Salzburg,6965,3,19,7,10,61,37,24,64
Vienna,6965,4,17,4,15,63,51,12,55
Rapid Vienna,6965,5,15,8,13,59,42,17,53
RZ Pellets W,6965,6,15,4,17,50,59,-9,49
Admira Wacke,6965,7,13,5,18,39,55,-16,44
SV Josko Rie,6965,8,12,5,19,38,59,-21,41
St. Pölten,6965,9,9,9,18,41,69,-28,36
Mattersburg,6965,10,9,7,20,42,62,-20,34
SC Rheindorf,6966,1,20,8,8,55,42,13,68
FC Salzburg,6966,2,20,5,11,56,31,25,65
SK Sturm Gra,6966,3,19,7,10,58,31,27,64
Vienna,6966,4,16,6,14,56,54,2,54
Admira Wacke,6966,5,16,5,15,44,51,-7,53
Rapid Vienna,6966,6,12,13,11,55,39,16,49
RZ Pellets W,6966,7,12,5,19,37,52,-15,41
Mattersburg,6966,8,10,10,16,36,54,-18,40
SV Josko Rie,6966,9,11,4,21,37,58,-21,37
St. Pölten,6966,10,7,11,18,41,63,-22,32
SK Sturm Gra,6967,1,23,6,7,75,35,40,75
FC Salzburg,6967,2,23,6,7,72,34,38,75
SC Rheindorf,6967,3,22,4,10,59,43,16,70
Vienna,6967,4,17,5,14,60,60,0,56
Rapid Vienna,6967,5,13,10,13,53,43,10,49
RZ Pellets W,6967,6,12,8,16,46,53,-7,44
SV Josko Rie,6967,7,11,5,20,35,55,-20,38
Admira Wacke,6967,8,10,8,18,35,60,-25,38
Mattersburg,6967,9,9,6,21,33,58,-25,33
St. Pölten,6967,10,6,10,20,38,65,-27,28
SC Rheindorf,6968,1,23,7,6,60,39,21,76
FC Salzburg,6968,2,17,11,8,63,33,30,62
SK Sturm Gra,6968,3,18,8,10,55,31,24,62
Vienna,6968,4,18,5,13,62,53,9,59
Rapid Vienna,6968,5,15,10,11,57,41,16,55
RZ Pellets W,6968,6,13,5,18,42,58,-16,44
Admira Wacke,6968,7,11,7,18,37,66,-29,40
SV Josko Rie,6968,8,11,6,19,41,55,-14,39
Mattersburg,6968,9,9,10,17,38,51,-13,37
St. Pölten,6968,10,6,9,21,37,65,-28,27
FC Salzburg,6969,1,22,7,7,62,29,33,73
SC Rheindorf,6969,2,19,9,8,53,36,17,66
SK Sturm Gra,6969,3,19,8,9,68,39,29,65
Vienna,6969,4,16,7,13,61,58,3,55
Rapid Vienna,6969,5,13,15,8,60,39,21,54
St. Pölten,6969,6,9,13,14,41,56,-15,40
Admira Wacke,6969,7,11,7,18,35,54,-19,40
RZ Pellets W,6969,8,11,6,19,52,71,-19,39
Mattersburg,6969,9,8,11,17,37,54,-17,35
SV Josko Rie,6969,10,7,7,22,22,55,-33,28
SC Rheindorf,6970,1,21,7,8,58,42,16,70
FC Salzburg,6970,2,20,9,7,60,22,38,69
SK Sturm Gra,6970,3,19,5,12,52,37,15,62
Vienna,6970,4,17,5,14,64,58,6,56
Rapid Vienna,6970,5,13,12,11,54,37,17,51
RZ Pellets W,6970,6,13,8,15,43,57,-14,47
Admira Wacke,6970,7,13,5,18,44,64,-20,44
St. Pölten,6970,8,10,9,17,45,59,-14,39
Mattersburg,6970,9,9,9,18,41,52,-11,36
SV Josko Rie,6970,10,7,7,22,31,64,-33,28
FC Salzburg,6971,1,22,7,7,67,33,34,73
SC Rheindorf,6971,2,21,7,8,59,40,19,70
SK Sturm Gra,6971,3,20,7,9,59,32,27,67
Vienna,6971,4,19,7,10,67,47,20,64
RZ Pellets W,6971,5,14,10,12,50,47,3,52
Rapid Vienna,6971,6,13,11,12,55,42,13,50
Mattersburg,6971,7,8,9,19,38,60,-22,33
St. Pölten,6971,8,8,9,19,45,72,-27,33
SV Josko Rie,6971,9,9,4,23,34,69,-35,31
Admira Wacke,6971,10,7,7,22,33,65,-32,28
FC Salzburg,6972,1,22,8,6,68,27,41,74
SK Sturm Gra,6972,2,18,7,11,59,37,22,61
SC Rheindorf,6972,3,18,7,11,55,45,10,61
Vienna,6972,4,18,5,13,61,53,8,59
Rapid Vienna,6972,5,13,12,11,53,39,14,51
RZ Pellets W,6972,6,11,9,16,49,53,-4,42
Mattersburg,6972,7,12,6,18,36,57,-21,42
Admira Wacke,6972,8,11,7,18,33,57,-24,40
SV Josko Rie,6972,9,11,4,21,33,51,-18,37
St. Pölten,6972,10,8,11,17,35,63,-28,35
FC Salzburg,6973,1,22,7,7,69,32,37,73
SC Rheindorf,6973,2,19,8,9,58,44,14,65
SK Sturm Gra,6973,3,18,8,10,64,37,27,62
Vienna,6973,4,17,7,12,64,58,6,58
Rapid Vienna,6973,5,14,12,10,55,42,13,54
Mattersburg,6973,6,12,8,16,42,55,-13,44
SV Josko Rie,6973,7,11,7,18,35,52,-17,40
RZ Pellets W,6973,8,10,9,17,41,54,-13,39
Admira Wacke,6973,9,9,9,18,30,54,-24,36
St. Pölten,6973,10,5,11,20,39,69,-30,26
FC Salzburg,6974,1,21,5,10,72,33,39,68
SK Sturm Gra,6974,2,20,6,10,66,34,32,66
SC Rheindorf,6974,3,19,6,11,56,50,6,63
Vienna,6974,4,17,5,14,60,64,-4,56
Rapid Vienna,6974,5,12,12,12,48,41,7,48
Admira Wacke,6974,6,14,4,18,41,61,-20,46
Mattersburg,6974,7,11,10,15,41,52,-11,43
RZ Pellets W,6974,8,11,8,17,47,53,-6,41
SV Josko Rie,6974,9,11,5,20,35,53,-18,38
St. Pölten,6974,10,9,9,18,42,67,-25,36
SC Rheindorf,6975,1,22,5,9,63,46,17,71
FC Salzburg,6975,2,18,7,11,62,39,23,61
SK Sturm Gra,6975,3,17,8,11,49,29,20,59
Vienna,6975,4,17,7,12,66,50,16,58
Rapid Vienna,6975,5,13,13,10,49,37,12,52
RZ Pellets W,6975,6,14,8,14,48,52,-4,50
Admira Wacke,6975,7,13,5,18,42,65,-23,44
Mattersburg,6975,8,9,10,17,41,56,-15,37
St. Pölten,6975,9,9,10,17,44,62,-18,37
SV Josko Rie,6975,10,9,5,22,30,58,-28,32
FC Salzburg,6976,1,21,7,8,65,32,33,70
SC Rheindorf,6976,2,20,7,9,57,42,15,67
Rapid Vienna,6976,3,18,9,9,65,41,24,63
Vienna,6976,4,19,5,12,65,51,14,62
SK Sturm Gra,6976,5,15,7,14,50,39,11,52
RZ Pellets W,6976,6,13,6,17,49,60,-11,45
SV Josko Rie,6976,7,11,9,16,42,59,-17,42
St. Pölten,6976,8,8,10,18,42,63,-21,34
Admira Wacke,6976,9,8,10,18,30,58,-28,34
Mattersburg,6976,10,6,12,18,35,55,-20,30
SK Sturm Gra,6977,1,21,5,10,63,34,29,68
Vienna,6977,2,20,5,11,63,51,12,65
SC Rheindorf,6977,3,19,7,10,58,46,12,64
FC Salzburg,6977,4,17,7,12,60,34,26,58
Admira Wacke,6977,5,14,6,16,43,57,-14,48
RZ Pellets W,6977,6,13,7,16,45,56,-11,46
Rapid Vienna,6977,7,12,9,15,57,53,4,45
St. Pölten,6977,8,10,11,15,45,59,-14,41
SV Josko Rie,6977,9,9,8,19,38,58,-20,35
Mattersburg,6977,10,8,9,19,45,69,-24,33
FC Salzburg,6978,1,25,4,7,72,28,44,79
SC Rheindorf,6978,2,19,7,10,55,44,11,64
Vienna,6978,3,19,5,12,61,54,7,62
SK Sturm Gra,6978,4,18,4,14,57,38,19,58
Rapid Vienna,6978,5,14,10,12,57,46,11,52
RZ Pellets W,6978,6,11,9,16,45,54,-9,42
Admira Wacke,6978,7,12,6,18,40,61,-21,42
St. Pölten,6978,8,9,10,17,41,59,-18,37
Mattersburg,6978,9,8,10,18,38,60,-22,34
SV Josko Rie,6978,10,8,9,19,33,55,-22,33
SC Rheindorf,6979,1,20,6,10,56,43,13,66
SK Sturm Gra,6979,2,19,7,10,68,33,35,64
FC Salzburg,6979,3,18,9,9,58,33,25,63
Rapid Vienna,6979,4,16,13,7,58,37,21,61
Vienna,6979,5,19,4,13,54,46,8,61
RZ Pellets W,6979,6,13,10,13,50,54,-4,49
Admira Wacke,6979,7,12,6,18,42,66,-24,42
St. Pölten,6979,8,9,10,17,39,62,-23,37
SV Josko Rie,6979,9,7,9,20,29,54,-25,30
Mattersburg,6979,10,6,8,22,33,59,-26,26
FC Salzburg,6980,1,19,13,4,60,27,33,70
SK Sturm Gra,6980,2,19,6,11,59,35,24,63
Rapid Vienna,6980,3,17,11,8,65,38,27,62
SC Rheindorf,6980,4,18,8,10,53,46,7,62
Vienna,6980,5,15,6,15,57,54,3,51
RZ Pellets W,6980,6,14,5,17,50,60,-10,47
SV Josko Rie,6980,7,10,6,20,32,48,-16,36
Admira Wacke,6980,8,9,9,18,34,60,-26,36
St. Pölten,6980,9,8,11,17,44,65,-21,35
Mattersburg,6980,10,8,11,17,31,52,-21,35
FC Salzburg,6981,1,22,7,7,71,40,31,73
SC Rheindorf,6981,2,19,11,6,53,34,19,68
SK Sturm Gra,6981,3,20,6,10,60,37,23,66
Vienna,6981,4,18,5,13,63,51,12,59
Rapid Vienna,6981,5,12,11,13,49,41,8,47
Admira Wacke,6981,6,12,5,19,43,65,-22,41
RZ Pellets W,6981,7,10,8,18,43,55,-12,38
SV Josko Rie,6981,8,11,5,20,35,55,-20,38
Mattersburg,6981,9,10,7,19,40,55,-15,37
St. Pölten,6981,10,9,9,18,37,61,-24,36
FC Salzburg,6982,1,23,7,6,69,28,41,76
SC Rheindorf,6982,2,21,4,11,51,42,9,67
SK Sturm Gra,6982,3,18,6,12,58,39,19,60
Vienna,6982,4,18,5,13,61,54,7,59
Rapid Vienna,6982,5,15,10,11,63,42,21,55
RZ Pellets W,6982,6,12,8,16,39,48,-9,44
SV Josko Rie,6982,7,12,4,20,35,55,-20,40
Admira Wacke,6982,8,11,5,20,30,61,-31,38
St. Pölten,6982,9,8,9,19,43,62,-19,33
Mattersburg,6982,10,6,14,16,35,53,-18,32
FC Salzburg,6983,1,20,10,6,65,29,36,70
SC Rheindorf,6983,2,19,8,9,53,41,12,65
Vienna,6983,3,19,6,11,62,45,17,63
SK Sturm Gra,6983,4,16,8,12,53,41,12,56
Rapid Vienna,6983,5,15,10,11,55,37,18,55
Admira Wacke,6983,6,14,7,15,42,53,-11,49
RZ Pellets W,6983,7,10,10,16,52,63,-11,40
St. Pölten,6983,8,9,9,18,40,63,-23,36
SV Josko Rie,6983,9,10,4,22,31,60,-29,34
Mattersburg,6983,10,7,10,19,36,57,-21,31
FC Salzburg,6984,1,21,7,8,65,35,30,70
SK Sturm Gra,6984,2,19,8,9,55,32,23,65
Vienna,6984,3,19,7,10,68,48,20,64
SC Rheindorf,6984,4,17,10,9,58,49,9,61
Rapid Vienna,6984,5,13,9,14,56,48,8,48
RZ Pellets W,6984,6,13,5,18,45,59,-14,44
Mattersburg,6984,7,10,11,15,40,54,-14,41
Admira Wacke,6984,8,11,6,19,36,59,-23,39
St. Pölten,6984,9,9,9,18,42,60,-18,36
SV Josko Rie,6984,10,11,2,23,37,58,-21,35
FC Salzburg,6985,1,23,6,7,69,27,42,75
SC Rheindorf,6985,2,20,8,8,55,39,16,68
Vienna,6985,3,19,7,10,65,56,9,64
SK Sturm Gra,6985,4,16,9,11,50,34,16,57
Rapid Vienna,6985,5,11,14,11,47,38,9,47
RZ Pellets W,6985,6,11,10,15,46,61,-15,43
Admira Wacke,6985,7,10,9,17,35,56,-21,39
SV Josko Rie,6985,8,9,8,19,29,49,-20,35
Mattersburg,6985,9,8,10,18,41,54,-13,34
St. Pölten,6985,10,7,11,18,38,61,-23,32
FC Salzburg,6986,1,21,9,6,72,28,44,72
Vienna,6986,2,20,7,9,63,45,18,67
SC Rheindorf,6986,3,17,8,11,62,55,7,59
SK Sturm Gra,6986,4,18,4,14,56,39,17,58
Rapid Vienna,6986,5,14,8,14,56,50,6,50
RZ Pellets W,6986,6,11,11,14,50,58,-8,44
SV Josko Rie,6986,7,11,9,16,36,50,-14,42
Admira Wacke,6986,8,12,5,19,36,64,-28,41
Mattersburg,6986,9,9,9,18,37,50,-13,36
St. Pölten,6986,10,8,8,20,42,71,-29,32
SC Rheindorf,6987,1,21,8,7,61,39,22,71
FC Salzburg,6987,2,21,6,9,64,29,35,69
Vienna,6987,3,21,4,11,62,49,13,67
SK Sturm Gra,6987,4,17,8,11,56,41,15,59
Rapid Vienna,6987,5,14,9,13,56,37,19,51
Admira Wacke,6987,6,15,4,17,39,60,-21,49
RZ Pellets W,6987,7,13,6,17,43,52,-9,45
SV Josko Rie,6987,8,9,6,21,36,54,-18,33
St. Pölten,6987,9,8,9,19,36,66,-30,33
Mattersburg,6987,10,7,8,21,34,60,-26,29
SC Rheindorf,6988,1,23,6,7,64,38,26,75
FC Salzburg,6988,2,22,6,8,71,36,35,72
SK Sturm Gra,6988,3,18,7,11,64,40,24,61
Vienna,6988,4,18,5,13,69,55,14,59
Rapid Vienna,6988,5,13,12,11,54,39,15,51
Admira Wacke,6988,6,14,4,18,41,59,-18,46
RZ Pellets W,6988,7,9,10,17,40,67,-27,37
SV Josko Rie,6988,8,9,7,20,32,58,-26,34
Mattersburg,6988,9,6,14,16,37,54,-17,32
St. Pölten,6988,10,7,11,18,41,67,-26,32
SC Rheindorf,6989,1,23,5,8,62,41,21,74
SK Sturm Gra,6989,2,22,5,9,71,41,30,71
Vienna,6989,3,19,5,12,69,55,14,62
FC Salzburg,6989,4,18,7,11,61,36,25,61
Rapid Vienna,6989,5,16,11,9,66,48,18,59
Admira Wacke,6989,6,14,3,19,43,63,-20,45
RZ Pellets W,6989,7,10,10,16,49,63,-14,40
SV Josko Rie,6989,8,10,7,19,40,55,-15,37
St. Pölten,6989,9,7,9,20,44,74,-30,30
Mattersburg,6989,10,6,8,22,31,60,-29,26
FC Salzburg,6990,1,21,7,8,69,31,38,70
Vienna,6990,2,20,5,11,64,50,14,65
SK Sturm Gra,6990,3,19,5,12,58,36,22,62
SC Rheindorf,6990,4,18,8,10,56,49,7,62
Rapid Vienna,6990,5,12,12,12,51,43,8,48
St. Pölten,6990,6,12,10,14,46,57,-11,46
RZ Pellets W,6990,7,13,7,16,45,57,-12,46
Admira Wacke,6990,8,11,8,17,36,53,-17,41
SV Josko Rie,6990,9,11,4,21,34,55,-21,37
Mattersburg,6990,10,6,8,22,31,59,-28,26
SK Sturm Gra,6991,1,23,4,9,64,29,35,73
FC Salzburg,6991,2,21,9,6,60,27,33,72
Vienna,6991,3,20,4,12,59,49,10,64
SC Rheindorf,6991,4,17,8,11,47,43,4,59
Rapid Vienna,6991,5,15,10,11,55,39,16,55
St. Pölten,6991,6,10,9,17,40,57,-17,39
Admira Wacke,6991,7,11,4,21,33,59,-26,37
RZ Pellets W,6991,8,10,6,20,46,58,-12,36
SV Josko Rie,6991,9,9,9,18,29,50,-21,36
Mattersburg,6991,10,8,9,19,32,54,-22,33
SC Rheindorf,6992,1,20,8,8,52,35,17,68
FC Salzburg,6992,2,18,9,9,60,35,25,63
Vienna,6992,3,18,9,9,60,53,7,63
SK Sturm Gra,6992,4,18,7,11,55,31,24,61
RZ Pellets W,6992,5,13,9,14,50,51,-1,48
Rapid Vienna,6992,6,11,13,12,55,44,11,46
Admira Wacke,6992,7,12,6,18,41,62,-21,42
St. Pölten,6992,8,9,12,15,49,65,-16,39
SV Josko Rie,6992,9,10,4,22,38,63,-25,34
Mattersburg,6992,10,8,9,19,40,61,-21,33
SC Rheindorf,6993,1,23,6,7,61,38,23,75
SK Sturm Gra,6993,2,19,8,9,59,33,26,65
FC Salzburg,6993,3,17,12,7,55,29,26,63
Vienna,6993,4,17,5,14,60,53,7,56
Rapid Vienna,6993,5,12,11,13,51,44,7,47
RZ Pellets W,6993,6,12,9,15,45,53,-8,45
Admira Wacke,6993,7,12,8,16,44,60,-16,44
Mattersburg,6993,8,9,9,18,34,51,-17,36
SV Josko Rie,6993,9,9,8,19,30,51,-21,35
St. Pölten,6993,10,6,12,18,32,59,-27,30
FC Salzburg,6994,1,22,5,9,68,32,36,71
SC Rheindorf,6994,2,21,7,8,62,42,20,70
Vienna,6994,3,21,4,11,69,52,17,67
SK Sturm Gra,6994,4,19,9,8,59,30,29,66
Rapid Vienna,6994,5,14,10,12,51,38,13,52
RZ Pellets W,6994,6,12,8,16,47,56,-9,44
Admira Wacke,6994,7,9,11,16,37,60,-23,38
Mattersburg,6994,8,10,6,20,43,59,-16,36
SV Josko Rie,6994,9,10,5,21,39,63,-24,35
St. Pölten,6994,10,5,9,22,34,77,-43,24
FC Salzburg,6995,1,23,8,5,73,29,44,77
SK Sturm Gra,6995,2,20,7,9,67,36,31,67
Vienna,6995,3,17,9,10,68,52,16,60
SC Rheindorf,6995,4,18,6,12,54,53,1,60
Rapid Vienna,6995,5,15,11,10,61,42,19,56
SV Josko Rie,6995,6,11,7,18,35,55,-20,40
St. Pölten,6995,7,11,6,19,45,65,-20,39
Admira Wacke,6995,8,10,9,17,35,58,-23,39
RZ Pellets W,6995,9,8,9,19,37,58,-21,33
Mattersburg,6995,10,8,6,22,34,61,-27,30
FC Salzburg,6996,1,21,9,6,66,25,41,72
SC Rheindorf,6996,2,20,9,7,58,39,19,69
Vienna,6996,3,17,9,10,55,46,9,60
SK Sturm Gra,6996,4,17,7,12,55,37,18,58
Rapid Vienna,6996,5,13,13,10,55,41,14,52
RZ Pellets W,6996,6,15,7,14,50,54,-4,52
Admira Wacke,6996,7,12,8,16,41,53,-12,44
SV Josko Rie,6996,8,12,2,22,30,53,-23,38
St. Pölten,6996,9,7,9,20,37,66,-29,30
Mattersburg,6996,10,5,9,22,33,66,-33,24
SC Rheindorf,6997,1,21,8,7,62,41,21,71
FC Salzburg,6997,2,22,4,10,73,38,35,70
Vienna,6997,3,20,4,12,62,51,11,64
SK Sturm Gra,6997,4,19,5,12,56,40,16,62
Rapid Vienna,6997,5,14,11,11,55,37,18,53
Admira Wacke,6997,6,15,6,15,49,58,-9,51
RZ Pellets W,6997,7,13,6,17,42,53,-11,45
SV Josko Rie,6997,8,9,7,20,33,54,-21,34
Mattersburg,6997,9,8,7,21,36,66,-30,31
St. Pölten,6997,10,6,8,22,35,65,-30,26
FC Salzburg,6998,1,22,9,5,66,31,35,75
SK Sturm Gra,6998,2,20,5,11,63,38,25,65
SC Rheindorf,6998,3,18,8,10,58,41,17,62
Rapid Vienna,6998,4,15,10,11,61,41,20,55
Vienna,6998,5,17,4,15,56,54,2,55
Admira Wacke,6998,6,12,7,17,39,58,-19,43
St. Pölten,6998,7,10,10,16,52,60,-8,40
RZ Pellets W,6998,8,10,10,16,47,61,-14,40
SV Josko Rie,6998,9,10,6,20,31,57,-26,36
Mattersburg,6998,10,7,9,20,32,64,-32,30
FC Salzburg,6999,1,21,6,9,71,33,38,69
SK Sturm Gra,6999,2,21,6,9,58,36,22,69
Rapid Vienna,6999,3,18,8,10,62,35,27,62
SC Rheindorf,6999,4,17,7,12,53,48,5,58
Vienna,6999,5,15,5,16,53,54,-1,50
RZ Pellets W,6999,6,13,7,16,48,57,-9,46
Admira Wacke,6999,7,13,6,17,40,55,-15,45
St. Pölten,6999,8,10,10,16,43,65,-22,40
SV Josko Rie,6999,9,9,8,19,36,55,-19,35
Mattersburg,6999,10,7,9,20,39,65,-26,30
FC Salzburg,7000,1,22,9,5,77,31,46,75
SK Sturm Gra,7000,2,19,6,11,57,36,21,63
SC Rheindorf,7000,3,18,7,11,48,45,3,61
Rapid Vienna,7000,4,16,10,10,59,38,21,58
Vienna,7000,5,16,5,15,55,53,2,53
RZ Pellets W,7000,6,13,7,16,41,51,-10,46
SV Josko Rie,7000,7,13,6,17,42,52,-10,45
Admira Wacke,7000,8,13,5,18,43,63,-20,44
Mattersburg,7000,9,7,9,20,38,60,-22,30
St. Pölten,7000,10,6,10,20,39,70,-31,28
FC Salzburg,7001,1,20,7,9,64,35,29,67
SC Rheindorf,7001,2,18,8,10,52,41,11,62
Vienna,7001,3,18,5,13,59,52,7,59
Rapid Vienna,7001,4,15,12,9,54,35,19,57
SK Sturm Gra,7001,5,16,8,12,57,37,20,56
Admira Wacke,7001,6,13,7,16,38,54,-16,46
RZ Pellets W,7001,7,12,9,15,44,53,-9,45
Mattersburg,7001,8,11,8,17,39,47,-8,41
SV Josko Rie,7001,9,9,7,20,32,57,-25,34
St. Pölten,7001,10,8,9,19,37,65,-28,33
FC Salzburg,7002,1,23,6,7,64,31,33,75
Vienna,7002,2,20,6,10,69,46,23,66
SC Rheindorf,7002,3,19,9,8,63,42,21,66
SK Sturm Gra,7002,4,19,6,11,54,34,20,63
Rapid Vienna,7002,5,14,8,14,54,42,12,50
RZ Pellets W,7002,6,13,7,16,44,55,-11,46
Mattersburg,7002,7,11,8,17,43,58,-15,41
Admira Wacke,7002,8,10,8,18,38,58,-20,38
SV Josko Rie,7002,9,9,6,21,31,53,-22,33
St. Pölten,7002,10,6,8,22,32,73,-41,26
FC Salzburg,7003,1,22,7,7,58,29,29,73
SK Sturm Gra,7003,2,21,6,9,59,26,33,69
SC Rheindorf,7003,3,19,9,8,52,40,12,66
Vienna,7003,4,19,5,12,66,46,20,62
Rapid Vienna,7003,5,12,12,12,51,39,12,48
RZ Pellets W,7003,6,12,8,16,44,59,-15,44
Admira Wacke,7003,7,11,10,15,35,55,-20,43
St. Pölten,7003,8,8,10,18,41,63,-22,34
Mattersburg,7003,9,8,7,21,36,57,-21,31
SV Josko Rie,7003,10,8,6,22,31,59,-28,30
FC Salzburg,7004,1,23,6,7,67,29,38,75
SC Rheindorf,7004,2,19,9,8,55,46,9,66
Vienna,7004,3,20,5,11,76,50,26,65
SK Sturm Gra,7004,4,18,9,9,55,32,23,63
RZ Pellets W,7004,5,15,9,12,52,46,6,54
Rapid Vienna,7004,6,13,13,10,53,37,16,52
Admira Wacke,7004,7,9,8,19,35,60,-25,35
Mattersburg,7004,8,9,6,21,39,65,-26,33
SV Josko Rie,7004,9,9,4,23,30,64,-34,31
St. Pölten,7004,10,6,9,21,34,67,-33,27
FC Salzburg,7005,1,21,5,10,64,35,29,68
SC Rheindorf,7005,2,19,5,12,59,43,16,62
SK Sturm Gra,7005,3,18,7,11,58,39,19,61
Vienna,7005,4,19,3,14,67,51,16,60
Rapid Vienna,7005,5,16,9,11,54,38,16,57
RZ Pellets W,7005,6,13,7,16,39,50,-11,46
Mattersburg,7005,7,11,7,18,39,55,-16,40
Admira Wacke,7005,8,11,6,19,41,62,-21,39
SV Josko Rie,7005,9,12,3,21,30,54,-24,39
St. Pölten,7005,10,10,8,18,37,61,-24,38
FC Salzburg,7006,1,22,5,9,66,32,34,71
SK Sturm Gra,7006,2,17,11,8,54,30,24,62
SC Rheindorf,7006,3,18,8,10,53,40,13,62
Vienna,7006,4,16,8,12,64,57,7,56
Admira Wacke,7006,5,14,8,14,34,49,-15,50
Rapid Vienna,7006,6,12,11,13,48,43,5,47
RZ Pellets W,7006,7,13,7,16,44,54,-10,46
Mattersburg,7006,8,12,9,15,40,43,-3,45
St. Pölten,7006,9,8,9,19,42,67,-25,33
SV Josko Rie,7006,10,8,4,24,30,60,-30,28
FC Salzburg,7007,1,24,4,8,70,28,42,76
SC Rheindorf,7007,2,22,6,8,60,38,22,72
SK Sturm Gra,7007,3,21,6,9,61,35,26,69
Vienna,7007,4,20,4,12,68,54,14,64
Rapid Vienna,7007,5,11,10,15,48,43,5,43
RZ Pellets W,7007,6,12,6,18,46,60,-14,42
Admira Wacke,7007,7,12,6,18,36,57,-21,42
St. Pölten,7007,8,11,8,17,48,65,-17,41
SV Josko Rie,7007,9,9,6,21,30,55,-25,33
Mattersburg,7007,10,5,10,21,33,65,-32,25
FC Salzburg,7008,1,23,6,7,64,32,32,75
SK Sturm Gra,7008,2,20,5,11,53,33,20,65
Rapid Vienna,7008,3,17,9,10,65,38,27,60
SC Rheindorf,7008,4,18,6,12,52,43,9,60
Vienna,7008,5,17,6,13,60,47,13,57
RZ Pellets W,7008,6,12,8,16,48,57,-9,44
Mattersburg,7008,7,11,7,18,34,49,-15,40
St. Pölten,7008,8,10,6,20,40,65,-25,36
SV Josko Rie,7008,9,9,8,19,33,50,-17,35
Admira Wacke,7008,10,9,7,20,29,64,-35,34
FC Salzburg,7009,1,21,7,8,57,30,27,70
SC Rheindorf,7009,2,20,6,10,54,43,11,66
SK Sturm Gra,7009,3,20,5,11,53,31,22,65
Vienna,7009,4,17,7,12,57,50,7,58
Rapid Vienna,7009,5,14,10,12,61,40,21,52
RZ Pellets W,7009,6,14,6,16,51,57,-6,48
Admira Wacke,7009,7,12,5,19,36,57,-21,41
Mattersburg,7009,8,8,11,17,39,54,-15,35
St. Pölten,7009,9,9,8,19,43,68,-25,35
SV Josko Rie,7009,10,9,7,20,30,51,-21,34
FC Salzburg,7010,1,20,9,7,62,30,32,69
SK Sturm Gra,7010,2,19,10,7,61,26,35,67
SC Rheindorf,7010,3,18,8,10,53,41,12,62
Vienna,7010,4,16,8,12,54,51,3,56
Rapid Vienna,7010,5,13,13,10,52,40,12,52
RZ Pellets W,7010,6,12,9,15,43,51,-8,45
Admira Wacke,7010,7,13,6,17,40,55,-15,45
SV Josko Rie,7010,8,11,5,20,36,60,-24,38
Mattersburg,7010,9,9,8,19,44,61,-17,35
St. Pölten,7010,10,7,8,21,41,71,-30,29
FC Salzburg,7011,1,18,10,8,67,39,28,64
SC Rheindorf,7011,2,19,7,10,62,44,18,64
SK Sturm Gra,7011,3,17,9,10,59,35,24,60
Rapid Vienna,7011,4,17,8,11,57,42,15,59
Vienna,7011,5,17,7,12,52,50,2,58
RZ Pellets W,7011,6,11,9,16,42,54,-12,42
St. Pölten,7011,7,11,8,17,47,59,-12,41
SV Josko Rie,7011,8,12,5,19,42,60,-18,41
Mattersburg,7011,9,10,8,18,47,66,-19,38
Admira Wacke,7011,10,9,7,20,35,61,-26,34
FC Salzburg,7012,1,22,7,7,66,28,38,73
SC Rheindorf,7012,2,21,8,7,59,33,26,71
Vienna,7012,3,22,2,12,68,54,14,68
SK Sturm Gra,7012,4,19,4,13,50,37,13,61
Rapid Vienna,7012,5,12,11,13,56,48,8,47
RZ Pellets W,7012,6,12,8,16,47,53,-6,44
Admira Wacke,7012,7,10,8,18,35,59,-24,38
St. Pölten,7012,8,8,12,16,46,68,-22,36
SV Josko Rie,7012,9,9,7,20,35,54,-19,34
Mattersburg,7012,10,7,9,20,28,56,-28,30
Vienna,7013,1,21,5,10,64,48,16,68
FC Salzburg,7013,2,20,7,9,68,36,32,67
SK Sturm Gra,7013,3,20,7,9,59,35,24,67
SC Rheindorf,7013,4,18,9,9,55,43,12,63
Rapid Vienna,7013,5,15,11,10,53,36,17,56
RZ Pellets W,7013,6,11,9,16,47,59,-12,42
St. Pölten,7013,7,9,10,17,43,60,-17,37
Admira Wacke,7013,8,9,8,19,33,61,-28,35
SV Josko Rie,7013,9,9,6,21,31,53,-22,33
Mattersburg,7013,10,8,8,20,33,55,-22,32
SK Sturm Gra,7014,1,21,5,10,65,37,28,68
FC Salzburg,7014,2,19,6,11,62,33,29,63
SC Rheindorf,7014,3,18,8,10,56,52,4,62
Vienna,7014,4,18,7,11,61,47,14,61
Rapid Vienna,7014,5,12,15,9,57,42,15,51
RZ Pellets W,7014,6,13,8,15,45,51,-6,47
Mattersburg,7014,7,11,9,16,37,48,-11,42
Admira Wacke,7014,8,12,4,20,37,69,-32,40
SV Josko Rie,7014,9,10,6,20,40,57,-17,36
St. Pölten,7014,10,6,12,18,40,64,-24,30
FC Salzburg,7015,1,21,8,7,68,30,38,71
SK Sturm Gra,7015,2,22,5,9,60,26,34,71
SC Rheindorf,7015,3,20,7,9,53,41,12,67
Vienna,7015,4,18,6,12,61,49,12,60
Rapid Vienna,7015,5,15,9,12,50,36,14,54
RZ Pellets W,7015,6,15,9,12,49,44,5,54
Admira Wacke,7015,7,10,5,21,40,68,-28,35
SV Josko Rie,7015,8,9,5,22,34,58,-24,32
Mattersburg,7015,9,8,7,21,31,61,-30,31
St. Pölten,7015,10,6,11,19,33,66,-33,29
SK Sturm Gra,7016,1,22,6,8,53,23,30,72
SC Rheindorf,7016,2,19,9,8,56,42,14,66
Vienna,7016,3,19,8,9,59,41,18,65
FC Salzburg,7016,4,18,9,9,62,34,28,63
Admira Wacke,7016,5,12,8,16,43,58,-15,44
RZ Pellets W,7016,6,11,9,16,47,60,-13,42
Rapid Vienna,7016,7,9,13,14,45,45,0,40
SV Josko Rie,7016,8,10,6,20,33,54,-21,36
Mattersburg,7016,9,7,12,17,37,57,-20,33
St. Pölten,7016,10,7,12,17,41,62,-21,33
FC Salzburg,7017,1,22,6,8,64,32,32,72
SC Rheindorf,7017,2,21,4,11,58,40,18,67
SK Sturm Gra,7017,3,18,7,11,61,37,24,61
Rapid Vienna,7017,4,16,8,12,59,38,21,56
Vienna,7017,5,17,5,14,57,53,4,56
RZ Pellets W,7017,6,13,9,14,43,54,-11,48
Admira Wacke,7017,7,13,6,17,36,52,-16,45
St. Pölten,7017,8,9,9,18,45,70,-25,36
SV Josko Rie,7017,9,9,7,20,33,58,-25,34
Mattersburg,7017,10,8,7,21,38,60,-22,31
FC Salzburg,7018,1,21,7,8,65,31,34,70
SC Rheindorf,7018,2,20,8,8,62,44,18,68
SK Sturm Gra,7018,3,21,4,11,64,34,30,67
Vienna,7018,4,20,4,12,62,47,15,64
Rapid Vienna,7018,5,13,10,13,48,40,8,49
RZ Pellets W,7018,6,14,7,15,51,57,-6,49
Admira Wacke,7018,7,11,7,18,40,61,-21,40
SV Josko Rie,7018,8,11,4,21,35,54,-19,37
St. Pölten,7018,9,7,10,19,42,75,-33,31
Mattersburg,7018,10,7,9,20,37,63,-26,30
SK Sturm Gra,7019,1,20,8,8,69,34,35,68
FC Salzburg,7019,2,18,10,8,57,30,27,64
SC Rheindorf,7019,3,18,9,9,59,46,13,63
Vienna,7019,4,19,6,11,61,51,10,63
Rapid Vienna,7019,5,11,14,11,52,42,10,47
RZ Pellets W,7019,6,13,8,15,46,54,-8,47
Admira Wacke,7019,7,12,8,16,38,53,-15,44
SV Josko Rie,7019,8,9,7,20,33,54,-21,34
Mattersburg,7019,9,8,9,19,34,56,-22,33
St. Pölten,7019,10,8,9,19,41,70,-29,33
FC Salzburg,7020,1,22,7,7,61,30,31,73
SK Sturm Gra,7020,2,19,7,10,57,37,20,64
Vienna,7020,3,17,7,12,67,55,12,58
SC Rheindorf,7020,4,16,9,11,48,43,5,57
Rapid Vienna,7020,5,15,9,12,59,46,13,54
RZ Pellets W,7020,6,14,8,14,44,46,-2,50
Admira Wacke,7020,7,13,5,18,37,55,-18,44
SV Josko Rie,7020,8,11,6,19,35,49,-14,39
St. Pölten,7020,9,7,11,18,41,66,-25,32
Mattersburg,7020,10,7,9,20,35,57,-22,30
FC Salzburg,7021,1,20,8,8,65,33,32,68
SC Rheindorf,7021,2,19,7,10,53,41,12,64
Vienna,7021,3,17,8,11,68,55,13,59
SK Sturm Gra,7021,4,17,7,12,55,42,13,58
Rapid Vienna,7021,5,16,9,11,57,40,17,57
Admira Wacke,7021,6,13,7,16,40,54,-14,46
RZ Pellets W,7021,7,12,9,15,45,49,-4,45
St. Pölten,7021,8,11,7,18,42,67,-25,40
SV Josko Rie,7021,9,10,7,19,34,51,-17,37
Mattersburg,7021,10,7,7,22,32,59,-27,28
FC Salzburg,7022,1,23,7,6,80,29,51,76
SC Rheindorf,7022,2,19,10,7,52,39,13,67
SK Sturm Gra,7022,3,20,5,11,63,38,25,65
Vienna,7022,4,16,8,12,53,46,7,56
Rapid Vienna,7022,5,14,8,14,60,45,15,50
RZ Pellets W,7022,6,13,6,17,41,55,-14,45
Mattersburg,7022,7,11,9,16,42,51,-9,42
SV Josko Rie,7022,8,11,7,18,29,46,-17,40
Admira Wacke,7022,9,9,6,21,33,71,-38,33
St. Pölten,7022,10,7,8,21,35,68,-33,29
FC Salzburg,7023,1,20,9,7,64,31,33,69
SK Sturm Gra,7023,2,22,3,11,66,38,28,69
SC Rheindorf,7023,3,19,7,10,57,47,10,64
Vienna,7023,4,20,3,13,67,46,21,63
RZ Pellets W,7023,5,15,6,15,48,52,-4,51
Rapid Vienna,7023,6,13,7,16,50,43,7,46
Mattersburg,7023,7,12,8,16,41,52,-11,44
Admira Wacke,7023,8,10,7,19,37,58,-21,37
St. Pölten,7023,9,9,7,20,46,74,-28,34
SV Josko Rie,7023,10,8,7,21,30,65,-35,31
FC Salzburg,7024,1,21,7,8,61,36,25,70
SK Sturm Gra,7024,2,21,6,9,58,29,29,69
Vienna,7024,3,19,6,11,67,45,22,63
SC Rheindorf,7024,4,17,10,9,52,45,7,61
Rapid Vienna,7024,5,16,8,12,59,43,16,56
RZ Pellets W,7024,6,11,10,15,46,52,-6,43
Admira Wacke,7024,7,11,8,17,42,64,-22,41
SV Josko Rie,7024,8,11,4,21,37,57,-20,37
St. Pölten,7024,9,7,10,19,38,63,-25,31
Mattersburg,7024,10,8,7,21,30,56,-26,31
FC Salzburg,7025,1,21,8,7,66,25,41,71
SK Sturm Gra,7025,2,20,8,8,59,31,28,68
SC Rheindorf,7025,3,18,10,8,56,43,13,64
Vienna,7025,4,19,6,11,61,44,17,63
RZ Pellets W,7025,5,14,9,13,48,48,0,51
Rapid Vienna,7025,6,12,13,11,55,44,11,49
Admira Wacke,7025,7,12,8,16,38,55,-17,44
SV Josko Rie,7025,8,9,6,21,25,52,-27,33
Mattersburg,7025,9,8,7,21,34,58,-24,31
St. Pölten,7025,10,5,9,22,36,78,-42,24
SC Rheindorf,7026,1,20,8,8,56,44,12,68
SK Sturm Gra,7026,2,19,7,10,58,35,23,64
Vienna,7026,3,20,4,12,71,55,16,64
FC Salzburg,7026,4,18,9,9,59,33,26,63
Rapid Vienna,7026,5,14,10,12,59,48,11,52
RZ Pellets W,7026,6,13,7,16,42,53,-11,46
SV Josko Rie,7026,7,10,9,17,35,51,-16,39
Admira Wacke,7026,8,11,6,19,37,55,-18,39
Mattersburg,7026,9,9,8,19,38,58,-20,35
St. Pölten,7026,10,7,10,19,41,64,-23,31
FC Salzburg,7027,1,20,8,8,66,34,32,68
Vienna,7027,2,20,4,12,66,49,17,64
SC Rheindorf,7027,3,17,9,10,51,44,7,60
SK Sturm Gra,7027,4,17,8,11,61,39,22,59
Rapid Vienna,7027,5,15,8,13,58,39,19,53
RZ Pellets W,7027,6,15,5,16,49,55,-6,50
St. Pölten,7027,7,10,12,14,46,57,-11,42
SV Josko Rie,7027,8,9,8,19,30,53,-23,35
Admira Wacke,7027,9,9,8,19,31,66,-35,35
Mattersburg,7027,10,8,10,18,35,57,-22,34
FC Salzburg,7028,1,22,7,7,74,31,43,73
SK Sturm Gra,7028,2,18,8,10,54,32,22,62
SC Rheindorf,7028,3,18,8,10,56,43,13,62
Vienna,7028,4,17,4,15,66,60,6,55
Rapid Vienna,7028,5,14,10,12,52,41,11,52
Admira Wacke,7028,6,14,7,15,44,56,-12,49
RZ Pellets W,7028,7,11,8,17,42,57,-15,41
SV Josko Rie,7028,8,11,8,17,41,62,-21,41
St. Pölten,7028,9,9,10,17,46,64,-18,37
Mattersburg,7028,10,7,8,21,31,60,-29,29
FC Salzburg,7029,1,25,6,5,72,30,42,81
SC Rheindorf,7029,2,23,4,9,62,41,21,73
Vienna,7029,3,19,4,13,58,48,10,61
SK Sturm Gra,7029,4,18,4,14,54,37,17,58
Rapid Vienna,7029,5,15,8,13,66,46,20,53
Admira Wacke,7029,6,13,7,16,40,51,-11,46
RZ Pellets W,7029,7,12,5,19,48,68,-20,41
St. Pölten,7029,8,10,7,19,43,67,-24,37
SV Josko Rie,7029,9,10,5,21,38,62,-24,35
Mattersburg,7029,10,7,6,23,34,65,-31,27
SC Rheindorf,7030,1,18,12,6,55,39,16,66
Vienna,7030,2,20,4,12,66,54,12,64
FC Salzburg,7030,3,18,9,9,61,40,21,63
SK Sturm Gra,7030,4,18,7,11,57,34,23,61
Rapid Vienna,7030,5,14,9,13,61,43,18,51
RZ Pellets W,7030,6,14,8,14,54,58,-4,50
Admira Wacke,7030,7,12,7,17,37,52,-15,43
Mattersburg,7030,8,10,8,18,40,59,-19,38
SV Josko Rie,7030,9,9,5,22,33,57,-24,32
St. Pölten,7030,10,7,11,18,36,64,-28,32
SC Rheindorf,7031,1,22,7,7,58,42,16,73
FC Salzburg,7031,2,18,10,8,60,34,26,64
Vienna,7031,3,17,6,13,71,58,13,57
RZ Pellets W,7031,4,16,8,12,52,51,1,56
Rapid Vienna,7031,5,14,12,10,51,39,12,54
SK Sturm Gra,7031,6,14,6,16,49,40,9,48
Admira Wacke,7031,7,12,5,19,36,59,-23,41
SV Josko Rie,7031,8,11,7,18,35,51,-16,40
St. Pölten,7031,9,8,11,17,37,59,-22,35
Mattersburg,7031,10,8,8,20,43,59,-16,32
FC Salzburg,7032,1,20,6,10,64,33,31,66
Vienna,7032,2,20,5,11,60,45,15,65
SC Rheindorf,7032,3,19,6,11,56,41,15,63
SK Sturm Gra,7032,4,17,7,12,53,36,17,58
Rapid Vienna,7032,5,14,10,12,55,39,16,52
Admira Wacke,7032,6,14,6,16,40,57,-17,48
St. Pölten,7032,7,11,11,14,42,50,-8,44
RZ Pellets W,7032,8,10,7,19,45,62,-17,37
Mattersburg,7032,9,9,10,17,32,53,-21,37
SV Josko Rie,7032,10,9,6,21,29,60,-31,33
FC Salzburg,7033,1,22,8,6,67,26,41,74
SK Sturm Gra,7033,2,20,7,9,63,33,30,67
SC Rheindorf,7033,3,20,5,11,52,43,9,65
Vienna,7033,4,18,4,14,58,54,4,58
Rapid Vienna,7033,5,16,8,12,59,40,19,56
RZ Pellets W,7033,6,16,4,16,46,55,-9,52
Admira Wacke,7033,7,11,7,18,34,56,-22,40
SV Josko Rie,7033,8,10,5,21,30,54,-24,35
St. Pölten,7033,9,7,11,18,39,63,-24,32
Mattersburg,7033,10,7,7,22,34,58,-24,28
SC Rheindorf,7034,1,23,5,8,57,43,14,74
SK Sturm Gra,7034,2,22,5,9,56,29,27,71
FC Salzburg,7034,3,19,10,7,59,26,33,67
Vienna,7034,4,18,6,12,58,52,6,60
RZ Pellets W,7034,5,15,6,15,48,46,2,51
Rapid Vienna,7034,6,13,9,14,53,42,11,48
St. Pölten,7034,7,9,9,18,36,58,-22,36
Admira Wacke,7034,8,9,6,21,29,56,-27,33
Mattersburg,7034,9,7,11,18,37,57,-20,32
SV Josko Rie,7034,10,9,5,22,28,52,-24,32
FC Salzburg,7035,1,22,7,7,69,30,39,73
SC Rheindorf,7035,2,21,7,8,59,41,18,70
SK Sturm Gra,7035,3,18,8,10,60,37,23,62
Vienna,7035,4,17,4,15,60,54,6,55
RZ Pellets W,7035,5,15,9,12,58,60,-2,54
Admira Wacke,7035,6,12,7,17,40,62,-22,43
Rapid Vienna,7035,7,10,12,14,61,52,9,42
Mattersburg,7035,8,11,8,17,43,56,-13,41
St. Pölten,7035,9,6,12,18,37,65,-28,30
SV Josko Rie,7035,10,7,8,21,23,53,-30,29
FC Salzburg,7036,1,22,7,7,65,28,37,73
SC Rheindorf,7036,2,19,9,8,54,38,16,66
Vienna,7036,3,18,5,13,61,51,10,59
SK Sturm Gra,7036,4,17,7,12,51,36,15,58
Rapid Vienna,7036,5,15,10,11,59,42,17,55
Admira Wacke,7036,6,14,6,16,42,56,-14,48
SV Josko Rie,7036,7,14,4,18,38,49,-11,46
RZ Pellets W,7036,8,11,6,19,40,58,-18,39
St. Pölten,7036,9,8,7,21,42,70,-28,31
Mattersburg,7036,10,6,11,19,35,59,-24,29
FC Salzburg,7037,1,20,8,8,65,36,29,68
SK Sturm Gra,7037,2,19,9,8,59,28,31,66
Vienna,7037,3,18,6,12,57,47,10,60
Rapid Vienna,7037,4,15,12,9,55,38,17,57
SC Rheindorf,7037,5,17,6,13,50,47,3,57
Admira Wacke,7037,6,12,9,15,35,52,-17,45
SV Josko Rie,7037,7,11,6,19,37,51,-14,39
RZ Pellets W,7037,8,10,8,18,40,56,-16,38
St. Pölten,7037,9,9,8,19,45,67,-22,35
Mattersburg,7037,10,8,10,18,38,59,-21,34
SC Rheindorf,7038,1,21,7,8,62,44,18,70
SK Sturm Gra,7038,2,19,8,9,58,31,27,65
FC Salzburg,7038,3,17,6,13,56,40,16,57
Vienna,7038,4,17,6,13,57,51,6,57
SV Josko Rie,7038,5,14,6,16,47,48,-1,48
RZ Pellets W,7038,6,13,7,16,39,51,-12,46
Admira Wacke,7038,7,13,5,18,39,57,-18,44
Rapid Vienna,7038,8,10,9,17,47,52,-5,39
St. Pölten,7038,9,8,13,15,46,61,-15,37
Mattersburg,7038,10,8,13,15,35,51,-16,37
FC Salzburg,7039,1,21,8,7,65,31,34,71
Vienna,7039,2,21,6,9,73,53,20,69
SC Rheindorf,7039,3,20,6,10,62,42,20,66
SK Sturm Gra,7039,4,20,4,12,66,46,20,64
Rapid Vienna,7039,5,12,9,15,52,43,9,45
Admira Wacke,7039,6,12,5,19,33,56,-23,41
RZ Pellets W,7039,7,11,7,18,41,59,-18,40
Mattersburg,7039,8,10,8,18,39,62,-23,38
SV Josko Rie,7039,9,11,4,21,34,56,-22,37
St. Pölten,7039,10,9,9,18,44,61,-17,36
FC Salzburg,7040,1,21,8,7,65,30,35,71
Vienna,7040,2,20,6,10,62,48,14,66
SC Rheindorf,7040,3,19,7,10,51,39,12,64
SK Sturm Gra,7040,4,18,9,9,60,32,28,63
RZ Pellets W,7040,5,14,7,15,46,55,-9,49
Rapid Vienna,7040,6,12,11,13,51,44,7,47
SV Josko Rie,7040,7,13,6,17,37,49,-12,45
Mattersburg,7040,8,9,7,20,34,53,-19,34
St. Pölten,7040,9,7,11,18,35,59,-24,32
Admira Wacke,7040,10,9,4,23,34,66,-32,31
FC Salzburg,7041,1,21,9,6,65,28,37,72
SK Sturm Gra,7041,2,19,9,8,63,31,32,66
Vienna,7041,3,20,4,12,66,51,15,64
SC Rheindorf,7041,4,17,7,12,49,46,3,58
Rapid Vienna,7041,5,14,10,12,54,42,12,52
RZ Pellets W,7041,6,13,7,16,41,49,-8,46
Admira Wacke,7041,7,11,9,16,30,52,-22,42
SV Josko Rie,7041,8,10,8,18,29,48,-19,38
Mattersburg,7041,9,9,7,20,35,55,-20,34
St. Pölten,7041,10,7,8,21,33,63,-30,29
SC Rheindorf,7042,1,19,10,7,59,38,21,67
FC Salzburg,7042,2,19,9,8,63,32,31,66
SK Sturm Gra,7042,3,20,6,10,60,38,22,66
Vienna,7042,4,15,9,12,55,51,4,54
RZ Pellets W,7042,5,12,10,14,44,48,-4,46
Rapid Vienna,7042,6,11,9,16,52,46,6,42
Admira Wacke,7042,7,10,10,16,39,59,-20,40
SV Josko Rie,7042,8,11,7,18,34,57,-23,40
Mattersburg,7042,9,9,10,17,32,48,-16,37
St. Pölten,7042,10,9,10,17,38,59,-21,37
FC Salzburg,7043,1,24,8,4,82,26,56,80
SK Sturm Gra,7043,2,20,7,9,60,31,29,67
SC Rheindorf,7043,3,17,9,10,58,46,12,60
Vienna,7043,4,16,6,14,53,63,-10,54
Rapid Vienna,7043,5,12,16,8,50,34,16,52
Admira Wacke,7043,6,13,7,16,31,54,-23,46
RZ Pellets W,7043,7,11,9,16,45,55,-10,42
SV Josko Rie,7043,8,11,4,21,32,55,-23,37
Mattersburg,7043,9,8,8,20,39,55,-16,32
St. Pölten,7043,10,6,10,20,35,66,-31,28
FC Salzburg,7044,1,22,6,8,71,34,37,72
SK Sturm Gra,7044,2,20,7,9,62,34,28,67
SC Rheindorf,7044,3,18,10,8,51,42,9,64
Vienna,7044,4,17,6,13,65,58,7,57
Rapid Vienna,7044,5,11,15,10,55,41,14,48
RZ Pellets W,7044,6,11,10,15,47,61,-14,43
Admira Wacke,7044,7,12,7,17,43,59,-16,43
SV Josko Rie,7044,8,12,5,19,41,59,-18,41
Mattersburg,7044,9,8,11,17,36,50,-14,35
St. Pölten,7044,10,6,9,21,37,70,-33,27
SC Rheindorf,7045,1,20,9,7,61,41,20,69
RZ Pellets W,7045,2,19,6,11,52,41,11,63
Vienna,7045,3,19,4,13,63,57,6,61
FC Salzburg,7045,4,16,9,11,64,44,20,57
Rapid Vienna,7045,5,16,9,11,60,40,20,57
SK Sturm Gra,7045,6,16,8,12,51,36,15,56
Admira Wacke,7045,7,12,5,19,38,63,-25,41
SV Josko Rie,7045,8,11,6,19,38,57,-19,39
St. Pölten,7045,9,8,9,19,39,64,-25,33
Mattersburg,7045,10,6,9,21,34,57,-23,27
SC Rheindorf,7046,1,20,8,8,57,42,15,68
FC Salzburg,7046,2,20,6,10,69,34,35,66
SK Sturm Gra,7046,3,19,7,10,66,38,28,64
Vienna,7046,4,18,4,14,63,55,8,58
Rapid Vienna,7046,5,12,12,12,51,46,5,48
Admira Wacke,7046,6,14,6,16,40,58,-18,48
RZ Pellets W,7046,7,13,8,15,47,58,-11,47
Mattersburg,7046,8,9,8,19,43,61,-18,35
St. Pölten,7046,9,8,11,17,43,66,-23,35
SV Josko Rie,7046,10,10,4,22,32,53,-21,34
FC Salzburg,7047,1,21,6,9,63,30,33,69
SK Sturm Gra,7047,2,19,6,11,54,31,23,63
SC Rheindorf,7047,3,17,10,9,49,41,8,61
Vienna,7047,4,19,3,14,58,57,1,60
RZ Pellets W,7047,5,16,7,13,46,49,-3,55
Rapid Vienna,7047,6,13,10,13,50,37,13,49
Admira Wacke,7047,7,15,4,17,39,51,-12,49
Mattersburg,7047,8,10,6,20,39,56,-17,36
SV Josko Rie,7047,9,10,6,20,34,51,-17,36
St. Pölten,7047,10,6,10,20,35,64,-29,28
SK Sturm Gra,7048,1,21,6,9,62,33,29,69
FC Salzburg,7048,2,19,8,9,63,36,27,65
SC Rheindorf,7048,3,20,5,11,52,43,9,65
Vienna,7048,4,18,5,13,65,54,11,59
Rapid Vienna,7048,5,15,11,10,65,39,26,56
RZ Pellets W,7048,6,11,9,16,44,56,-12,42
SV Josko Rie,7048,7,12,6,18,35,50,-15,42
Admira Wacke,7048,8,10,7,19,31,59,-28,37
Mattersburg,7048,9,9,9,18,39,55,-16,36
St. Pölten,7048,10,7,10,19,36,67,-31,31
FC Salzburg,7049,1,22,7,7,71,29,42,73
SK Sturm Gra,7049,2,22,5,9,56,31,25,71
SC Rheindorf,7049,3,19,7,10,49,39,10,64
Vienna,7049,4,17,4,15,59,59,0,55
Rapid Vienna,7049,5,12,13,11,49,37,12,49
RZ Pellets W,7049,6,14,6,16,47,54,-7,48
Admira Wacke,7049,7,13,5,18,41,57,-16,44
Mattersburg,7049,8,10,7,19,36,57,-21,37
SV Josko Rie,7049,9,10,5,21,32,51,-19,35
St. Pölten,7049,10,8,7,21,40,66,-26,31
SC Rheindorf,7050,1,23,7,6,64,37,27,76
SK Sturm Gra,7050,2,22,3,11,66,37,29,69
FC Salzburg,7050,3,20,5,11,68,39,29,65
Vienna,7050,4,16,6,14,56,54,2,54
Rapid Vienna,7050,5,13,11,12,55,42,13,50
RZ Pellets W,7050,6,11,9,16,38,53,-15,42
SV Josko Rie,7050,7,11,7,18,37,50,-13,40
Admira Wacke,7050,8,10,8,18,36,57,-21,38
St. Pölten,7050,9,9,8,19,43,68,-25,35
Mattersburg,7050,10,9,8,19,32,58,-26,35
FC Salzburg,7051,1,22,9,5,67,27,40,75
SC Rheindorf,7051,2,20,7,9,53,37,16,67
Vienna,7051,3,21,3,12,64,49,15,66
SK Sturm Gra,7051,4,20,5,11,52,30,22,65
Rapid Vienna,7051,5,13,9,14,51,45,6,48
St. Pölten,7051,6,13,6,17,42,60,-18,45
RZ Pellets W,7051,7,12,6,18,44,55,-11,42
Admira Wacke,7051,8,10,6,20,34,60,-26,36
SV Josko Rie,7051,9,9,6,21,29,49,-20,33
Mattersburg,7051,10,8,7,21,36,60,-24,31
FC Salzburg,7052,1,22,6,8,72,29,43,72
Vienna,7052,2,22,5,9,71,50,21,71
SC Rheindorf,7052,3,22,5,9,62,44,18,71
SK Sturm Gra,7052,4,17,4,15,59,51,8,55
Rapid Vienna,7052,5,14,10,12,53,42,11,52
RZ Pellets W,7052,6,12,10,14,43,50,-7,46
Admira Wacke,7052,7,11,6,19,32,58,-26,39
Mattersburg,7052,8,8,10,18,32,50,-18,34
St. Pölten,7052,9,6,13,17,43,68,-25,31
SV Josko Rie,7052,10,8,7,21,33,58,-25,31
FC Salzburg,7053,1,25,5,6,64,23,41,80
SC Rheindorf,7053,2,22,7,7,61,40,21,73
SK Sturm Gra,7053,3,19,5,12,61,38,23,62
Rapid Vienna,7053,4,16,10,10,58,39,19,58
Vienna,7053,5,17,4,15,59,50,9,55
Admira Wacke,7053,6,11,7,18,36,58,-22,40
RZ Pellets W,7053,7,9,12,15,40,55,-15,39
SV Josko Rie,7053,8,10,5,21,29,52,-23,35
Mattersburg,7053,9,8,7,21,37,62,-25,31
St. Pölten,7053,10,7,10,19,40,68,-28,31
Vienna,7054,1,22,4,10,66,51,15,70
FC Salzburg,7054,2,19,10,7,68,32,36,67
SC Rheindorf,7054,3,20,7,9,54,38,16,67
SK Sturm Gra,7054,4,20,4,12,59,37,22,64
Rapid Vienna,7054,5,17,9,10,65,36,29,60
RZ Pellets W,7054,6,12,4,20,45,64,-19,40
Admira Wacke,7054,7,10,6,20,41,65,-24,36
SV Josko Rie,7054,8,9,8,19,32,52,-20,35
St. Pölten,7054,9,9,7,20,37,67,-30,34
Mattersburg,7054,10,8,9,19,33,58,-25,33
FC Salzburg,7055,1,19,10,7,65,32,33,67
SK Sturm Gra,7055,2,18,10,8,56,31,25,64
SC Rheindorf,7055,3,18,9,9,49,38,11,63
Vienna,7055,4,16,9,11,60,51,9,57
Rapid Vienna,7055,5,12,14,10,54,38,16,50
RZ Pellets W,7055,6,11,9,16,42,57,-15,42
Admira Wacke,7055,7,12,6,18,35,59,-24,42
Mattersburg,7055,8,9,9,18,36,53,-17,36
SV Josko Rie,7055,9,10,6,20,39,57,-18,36
St. Pölten,7055,10,8,12,16,41,61,-20,36
SC Rheindorf,7056,1,22,6,8,64,39,25,72
FC Salzburg,7056,2,20,7,9,63,34,29,67
SK Sturm Gra,7056,3,18,8,10,57,31,26,62
Rapid Vienna,7056,4,16,10,10,55,35,20,58
Vienna,7056,5,16,6,14,57,58,-1,54
RZ Pellets W,7056,6,12,5,19,43,59,-16,41
St. Pölten,7056,7,10,9,17,46,65,-19,39
SV Josko Rie,7056,8,10,7,19,34,57,-23,37
Admira Wacke,7056,9,9,10,17,33,56,-23,37
Mattersburg,7056,10,9,8,19,39,57,-18,35
Vienna,7057,1,21,5,10,74,55,19,68
FC Salzburg,7057,2,20,7,9,60,31,29,67
SC Rheindorf,7057,3,17,9,10,50,38,12,60
SK Sturm Gra,7057,4,16,8,12,56,36,20,56
Rapid Vienna,7057,5,14,9,13,58,39,19,51
Admira Wacke,7057,6,15,4,17,44,60,-16,49
RZ Pellets W,7057,7,12,6,18,44,63,-19,42
Mattersburg,7057,8,11,8,17,41,56,-15,41
SV Josko Rie,7057,9,11,7,18,34,53,-19,40
St. Pölten,7057,10,7,9,20,40,70,-30,30
SC Rheindorf,7058,1,22,9,5,63,34,29,75
FC Salzburg,7058,2,19,8,9,56,32,24,65
SK Sturm Gra,7058,3,18,6,12,60,41,19,60
Rapid Vienna,7058,4,17,8,11,59,38,21,59
Vienna,7058,5,18,2,16,60,52,8,56
RZ Pellets W,7058,6,14,6,16,49,52,-3,48
SV Josko Rie,7058,7,12,4,20,33,47,-14,40
Mattersburg,7058,8,10,9,17,39,55,-16,39
Admira Wacke,7058,9,10,5,21,30,65,-35,35
St. Pölten,7058,10,8,7,21,40,73,-33,31
FC Salzburg,7059,1,22,10,4,74,31,43,76
SK Sturm Gra,7059,2,20,7,9,60,34,26,67
SC Rheindorf,7059,3,20,6,10,61,41,20,66
Vienna,7059,4,17,3,16,58,51,7,54
Rapid Vienna,7059,5,12,10,14,47,40,7,46
Admira Wacke,7059,6,13,6,17,34,49,-15,45
St. Pölten,7059,7,10,11,15,44,61,-17,41
SV Josko Rie,7059,8,11,6,19,36,55,-19,39
Mattersburg,7059,9,8,10,18,35,59,-24,34
RZ Pellets W,7059,10,8,9,19,36,64,-28,33
SC Rheindorf,7060,1,20,8,8,57,44,13,68
Vienna,7060,2,20,6,10,68,52,16,66
SK Sturm Gra,7060,3,18,9,9,59,32,27,63
FC Salzburg,7060,4,17,8,11,59,31,28,59
RZ Pellets W,7060,5,14,8,14,48,54,-6,50
Rapid Vienna,7060,6,12,11,13,54,45,9,47
Mattersburg,7060,7,10,9,17,41,54,-13,39
Admira Wacke,7060,8,11,5,20,32,59,-27,38
SV Josko Rie,7060,9,9,8,19,33,55,-22,35
St. Pölten,7060,10,8,10,18,39,64,-25,34
SC Rheindorf,7061,1,21,7,8,63,44,19,70
FC Salzburg,7061,2,19,8,9,65,34,31,65
SK Sturm Gra,7061,3,19,7,10,59,33,26,64
Vienna,7061,4,17,5,14,59,57,2,56
Rapid Vienna,7061,5,10,12,14,45,46,-1,42
Admira Wacke,7061,6,11,9,16,36,59,-23,42
St. Pölten,7061,7,9,14,13,45,54,-9,41
SV Josko Rie,7061,8,11,8,17,32,46,-14,41
Mattersburg,7061,9,9,10,17,33,48,-15,37
RZ Pellets W,7061,10,9,10,17,38,54,-16,37
FC Salzburg,7062,1,24,7,5,70,26,44,79
SK Sturm Gra,7062,2,20,8,8,58,31,27,68
SC Rheindorf,7062,3,18,9,9,58,46,12,63
Admira Wacke,7062,4,14,8,14,45,56,-11,50
Rapid Vienna,7062,5,12,13,11,53,38,15,49
Vienna,7062,6,13,8,15,54,58,-4,47
RZ Pellets W,7062,7,10,10,16,45,61,-16,40
Mattersburg,7062,8,9,8,19,44,63,-19,35
SV Josko Rie,7062,9,8,9,19,29,51,-22,33
St. Pölten,7062,10,7,10,19,43,69,-26,31
FC Salzburg,7063,1,23,6,7,76,31,45,75
Vienna,7063,2,20,6,10,65,48,17,66
SK Sturm Gra,7063,3,19,6,11,60,36,24,63
SC Rheindorf,7063,4,19,6,11,52,42,10,63
Rapid Vienna,7063,5,12,12,12,50,41,9,48
Admira Wacke,7063,6,13,6,17,44,58,-14,45
RZ Pellets W,7063,7,11,7,18,38,57,-19,40
Mattersburg,7063,8,11,6,19,46,61,-15,39
SV Josko Rie,7063,9,10,6,20,39,58,-19,36
St. Pölten,7063,10,6,11,19,35,73,-38,29
FC Salzburg,7064,1,23,6,7,67,26,41,75
SC Rheindorf,7064,2,18,8,10,52,41,11,62
SK Sturm Gra,7064,3,19,3,14,52,34,18,60
Vienna,7064,4,18,4,14,58,54,4,58
Rapid Vienna,7064,5,15,9,12,55,41,14,54
Admira Wacke,7064,6,13,7,16,35,58,-23,46
SV Josko Rie,7064,7,11,9,16,36,46,-10,42
RZ Pellets W,7064,8,11,8,17,43,54,-11,41
Mattersburg,7064,9,8,10,18,36,55,-19,34
St. Pölten,7064,10,7,10,19,38,63,-25,31
FC Salzburg,7065,1,21,8,7,58,30,28,71
SK Sturm Gra,7065,2,22,4,10,69,36,33,70
Vienna,7065,3,19,6,11,62,47,15,63
SC Rheindorf,7065,4,17,8,11,53,45,8,59
Rapid Vienna,7065,5,14,11,11,64,44,20,53
RZ Pellets W,7065,6,15,6,15,55,63,-8,51
SV Josko Rie,7065,7,12,6,18,39,53,-14,42
St. Pölten,7065,8,9,6,21,40,69,-29,33
Mattersburg,7065,9,8,8,20,32,57,-25,32
Admira Wacke,7065,10,9,5,22,41,69,-28,32
SC Rheindorf,7066,1,20,8,8,56,43,13,68
Vienna,7066,2,20,6,10,73,46,27,66
FC Salzburg,7066,3,19,8,9,62,37,25,65
Rapid Vienna,7066,4,17,10,9,64,36,28,61
SK Sturm Gra,7066,5,16,5,15,53,43,10,53
RZ Pellets W,7066,6,13,7,16,47,54,-7,46
Admira Wacke,7066,7,12,6,18,39,62,-23,42
SV Josko Rie,7066,8,11,4,21,38,56,-18,37
Mattersburg,7066,9,8,9,19,38,66,-28,33
St. Pölten,7066,10,7,11,18,37,64,-27,32
FC Salzburg,7067,1,20,10,6,61,28,33,70
SK Sturm Gra,7067,2,20,7,9,60,35,25,67
SC Rheindorf,7067,3,19,7,10,53,41,12,64
Vienna,7067,4,19,5,12,61,49,12,62
Rapid Vienna,7067,5,15,9,12,61,44,17,54
RZ Pellets W,7067,6,13,8,15,44,52,-8,47
Admira Wacke,7067,7,11,6,19,33,53,-20,39
St. Pölten,7067,8,10,9,17,45,66,-21,39
SV Josko Rie,7067,9,10,5,21,40,64,-24,35
Mattersburg,7067,10,5,10,21,36,62,-26,25
SK Sturm Gra,7068,1,22,5,9,68,29,39,71
FC Salzburg,7068,2,21,7,8,67,32,35,70
SC Rheindorf,7068,3,19,9,8,52,36,16,66
Vienna,7068,4,19,4,13,66,57,9,61
Rapid Vienna,7068,5,13,12,11,56,42,14,51
RZ Pellets W,7068,6,14,9,13,55,53,2,51
SV Josko Rie,7068,7,12,4,20,34,56,-22,40
Admira Wacke,7068,8,12,4,20,34,62,-28,40
St. Pölten,7068,9,8,8,20,37,68,-31,32
Mattersburg,7068,10,5,8,23,34,68,-34,23
SC Rheindorf,7069,1,20,9,7,62,42,20,69
FC Salzburg,7069,2,20,8,8,63,36,27,68
SK Sturm Gra,7069,3,17,8,11,53,27,26,59
Vienna,7069,4,17,6,13,64,52,12,57
SV Josko Rie,7069,5,13,7,16,39,46,-7,46
Rapid Vienna,7069,6,10,14,12,51,43,8,44
Admira Wacke,7069,7,11,9,16,40,57,-17,42
RZ Pellets W,7069,8,10,9,17,39,58,-19,39
St. Pölten,7069,9,10,9,17,43,70,-27,39
Mattersburg,7069,10,7,11,18,34,57,-23,32
FC Salzburg,7070,1,23,7,6,70,27,43,76
Vienna,7070,2,21,5,10,69,50,19,68
SC Rheindorf,7070,3,19,9,8,57,43,14,66
SK Sturm Gra,7070,4,19,5,12,55,31,24,62
RZ Pellets W,7070,5,15,6,15,50,55,-5,51
Rapid Vienna,7070,6,12,10,14,51,46,5,46
Mattersburg,7070,7,9,12,15,40,56,-16,39
SV Josko Rie,7070,8,11,5,20,42,61,-19,38
Admira Wacke,7070,9,8,6,22,29,72,-43,30
St. Pölten,7070,10,6,9,21,42,64,-22,27
SC Rheindorf,7071,1,21,8,7,52,34,18,71
SK Sturm Gra,7071,2,20,6,10,52,28,24,66
FC Salzburg,7071,3,19,6,11,67,39,28,63
Vienna,7071,4,19,5,12,59,47,12,62
Rapid Vienna,7071,5,14,12,10,62,43,19,54
RZ Pellets W,7071,6,11,11,14,44,53,-9,44
Admira Wacke,7071,7,10,8,18,34,62,-28,38
SV Josko Rie,7071,8,10,6,20,36,57,-21,36
St. Pölten,7071,9,9,8,19,43,63,-20,35
Mattersburg,7071,10,7,10,19,31,54,-23,31
FC Salzburg,7072,1,24,7,5,72,23,49,79
SC Rheindorf,7072,2,19,7,10,55,43,12,64
Vienna,7072,3,19,4,13,61,50,11,61
SK Sturm Gra,7072,4,17,6,13,56,43,13,57
Rapid Vienna,7072,5,16,8,12,68,47,21,56
St. Pölten,7072,6,13,9,14,45,56,-11,48
RZ Pellets W,7072,7,12,8,16,43,54,-11,44
SV Josko Rie,7072,8,11,5,20,30,48,-18,38
Admira Wacke,7072,9,8,6,22,28,70,-42,30
Mattersburg,7072,10,6,10,20,35,59,-24,28
SC Rheindorf,7073,1,20,10,6,60,40,20,70
Vienna,7073,2,21,5,10,65,48,17,68
FC Salzburg,7073,3,18,8,10,62,35,27,62
SK Sturm Gra,7073,4,15,12,9,53,31,22,57
Rapid Vienna,7073,5,13,10,13,62,51,11,49
RZ Pellets W,7073,6,13,10,13,49,53,-4,49
SV Josko Rie,7073,7,12,5,19,34,54,-20,41
Admira Wacke,7073,8,10,6,20,35,58,-23,36
Mattersburg,7073,9,8,10,18,39,60,-21,34
St. Pölten,7073,10,6,12,18,34,63,-29,30
FC Salzburg,7074,1,22,6,8,70,36,34,72
SC Rheindorf,7074,2,21,5,10,57,39,18,68
Vienna,7074,3,19,7,10,64,50,14,64
SK Sturm Gra,7074,4,18,5,13,58,42,16,59
Rapid Vienna,7074,5,12,13,11,58,43,15,49
RZ Pellets W,7074,6,13,8,15,46,49,-3,47
Admira Wacke,7074,7,12,7,17,40,59,-19,43
SV Josko Rie,7074,8,12,4,20,34,55,-21,40
Mattersburg,7074,9,9,8,19,43,66,-23,35
St. Pölten,7074,10,6,9,21,38,69,-31,27
FC Salzburg,7075,1,22,6,8,67,32,35,72
SK Sturm Gra,7075,2,20,5,11,61,36,25,65
SC Rheindorf,7075,3,19,8,9,52,41,11,65
Vienna,7075,4,16,8,12,62,55,7,56
Rapid Vienna,7075,5,11,13,12,47,36,11,46
RZ Pellets W,7075,6,10,12,14,39,49,-10,42
Admira Wacke,7075,7,10,11,15,35,52,-17,41
St. Pölten,7075,8,9,12,15,42,59,-17,39
SV Josko Rie,7075,9,9,8,19,34,58,-24,35
Mattersburg,7075,10,6,13,17,34,55,-21,31
FC Salzburg,7076,1,20,9,7,68,29,39,69
SC Rheindorf,7076,2,19,9,8,54,43,11,66
SK Sturm Gra,7076,3,20,5,11,61,33,28,65
Vienna,7076,4,16,6,14,56,58,-2,54
Rapid Vienna,7076,5,15,8,13,57,46,11,53
St. Pölten,7076,6,13,7,16,46,57,-11,46
RZ Pellets W,7076,7,13,7,16,42,54,-12,46
Admira Wacke,7076,8,13,6,17,44,61,-17,45
SV Josko Rie,7076,9,9,6,21,30,52,-22,33
Mattersburg,7076,10,6,9,21,33,58,-25,27
SK Sturm Gra,7077,1,20,7,9,60,31,29,67
FC Salzburg,7077,2,19,8,9,62,32,30,65
SC Rheindorf,7077,3,19,8,9,56,40,16,65
Rapid Vienna,7077,4,16,9,11,63,41,22,57
Vienna,7077,5,15,8,13,51,48,3,53
Admira Wacke,7077,6,16,4,16,41,57,-16,52
RZ Pellets W,7077,7,12,7,17,41,60,-19,43
Mattersburg,7077,8,11,6,19,44,61,-17,39
St. Pölten,7077,9,8,9,19,43,65,-22,33
SV Josko Rie,7077,10,8,6,22,30,56,-26,30
FC Salzburg,7078,1,23,7,6,64,23,41,76
SC Rheindorf,7078,2,21,6,9,56,38,18,69
SK Sturm Gra,7078,3,20,5,11,58,32,26,65
Vienna,7078,4,20,4,12,62,49,13,64
Rapid Vienna,7078,5,15,11,10,54,39,15,56
RZ Pellets W,7078,6,13,9,14,53,57,-4,48
Mattersburg,7078,7,8,8,20,37,54,-17,32
SV Josko Rie,7078,8,8,8,20,31,54,-23,32
Admira Wacke,7078,9,8,7,21,30,64,-34,31
St. Pölten,7078,10,7,9,20,37,72,-35,30
FC Salzburg,7079,1,20,11,5,63,30,33,71
SC Rheindorf,7079,2,20,8,8,54,40,14,68
SK Sturm Gra,7079,3,16,11,9,58,37,21,59
Rapid Vienna,7079,4,15,10,11,60,40,20,55
Vienna,7079,5,15,7,14,59,57,2,52
RZ Pellets W,7079,6,10,10,16,47,57,-10,40
Mattersburg,7079,7,10,9,17,38,51,-13,39
SV Josko Rie,7079,8,11,6,19,38,53,-15,39
Admira Wacke,7079,9,11,6,19,38,64,-26,39
St. Pölten,7079,10,8,10,18,47,73,-26,34
Vienna,7080,1,23,6,7,69,42,27,75
FC Salzburg,7080,2,20,7,9,62,32,30,67
SK Sturm Gra,7080,3,18,6,12,61,39,22,60
SC Rheindorf,7080,4,17,8,11,49,46,3,59
Rapid Vienna,7080,5,12,12,12,55,45,10,48
Mattersburg,7080,6,13,8,15,43,52,-9,47
Admira Wacke,7080,7,11,7,18,35,58,-23,40
St. Pölten,7080,8,10,8,18,43,63,-20,38
RZ Pellets W,7080,9,11,5,20,40,60,-20,38
SV Josko Rie,7080,10,9,5,22,34,54,-20,32
FC Salzburg,7081,1,22,6,8,66,27,39,72
SC Rheindorf,7081,2,22,5,9,66,45,21,71
SK Sturm Gra,7081,3,19,6,11,61,38,23,63
Vienna,7081,4,19,5,12,63,56,7,62
Rapid Vienna,7081,5,12,10,14,49,44,5,46
SV Josko Rie,7081,6,11,6,19,36,57,-21,39
Mattersburg,7081,7,10,8,18,39,54,-15,38
RZ Pellets W,7081,8,8,13,15,38,55,-17,37
St. Pölten,7081,9,8,12,16,48,62,-14,36
Admira Wacke,7081,10,9,9,18,32,60,-28,36
FC Salzburg,7082,1,23,4,9,71,31,40,73
SC Rheindorf,7082,2,20,8,8,54,39,15,68
SK Sturm Gra,7082,3,20,7,9,55,29,26,67
Vienna,7082,4,19,6,11,64,52,12,63
SV Josko Rie,7082,5,13,4,19,39,57,-18,43
RZ Pellets W,7082,6,11,9,16,44,56,-12,42
Rapid Vienna,7082,7,9,14,13,45,42,3,41
Admira Wacke,7082,8,11,5,20,36,59,-23,38
Mattersburg,7082,9,9,8,19,38,58,-20,35
St. Pölten,7082,10,7,11,18,41,64,-23,32
SC Rheindorf,7083,1,22,7,7,63,37,26,73
Vienna,7083,2,22,3,11,70,50,20,69
SK Sturm Gra,7083,3,21,5,10,66,36,30,68
FC Salzburg,7083,4,18,6,12,61,37,24,60
Rapid Vienna,7083,5,12,12,12,53,42,11,48
RZ Pellets W,7083,6,11,11,14,44,51,-7,44
Admira Wacke,7083,7,11,7,18,31,57,-26,40
SV Josko Rie,7083,8,10,5,21,33,56,-23,35
St. Pölten,7083,9,9,8,19,37,68,-31,35
Mattersburg,7083,10,7,10,19,36,60,-24,31
SC Rheindorf,7084,1,21,7,8,52,37,15,70
FC Salzburg,7084,2,18,10,8,62,31,31,64
Vienna,7084,3,19,7,10,64,47,17,64
Rapid Vienna,7084,4,14,11,11,54,40,14,53
SK Sturm Gra,7084,5,13,11,12,52,39,13,50
SV Josko Rie,7084,6,13,4,19,34,49,-15,43
Admira Wacke,7084,7,11,8,17,33,56,-23,41
RZ Pellets W,7084,8,10,10,16,41,56,-15,40
St. Pölten,7084,9,10,10,16,47,66,-19,40
Mattersburg,7084,10,8,8,20,35,53,-18,32
FC Salzburg,7085,1,21,6,9,63,33,30,69
SK Sturm Gra,7085,2,20,6,10,59,32,27,66
Rapid Vienna,7085,3,17,9,10,58,42,16,60
SC Rheindorf,7085,4,17,8,11,53,45,8,59
Vienna,7085,5,14,10,12,53,50,3,52
Admira Wacke,7085,6,12,7,17,39,61,-22,43
St. Pölten,7085,7,11,9,16,41,59,-18,42
RZ Pellets W,7085,8,10,9,17,42,51,-9,39
Mattersburg,7085,9,10,8,18,41,51,-10,38
SV Josko Rie,7085,10,9,6,21,29,54,-25,33
FC Salzburg,7086,1,22,7,7,73,30,43,73
SK Sturm Gra,7086,2,21,6,9,59,35,24,69
SC Rheindorf,7086,3,21,5,10,56,35,21,68
Vienna,7086,4,19,3,14,58,50,8,60
RZ Pellets W,7086,5,17,5,14,52,54,-2,56
Admira Wacke,7086,6,14,6,16,42,55,-13,48
Rapid Vienna,7086,7,12,9,15,54,51,3,45
SV Josko Rie,7086,8,12,4,20,39,54,-15,40
St. Pölten,7086,9,8,6,22,34,68,-34,30
Mattersburg,7086,10,5,7,24,37,72,-35,22
SK Sturm Gra,7087,1,21,6,9,64,32,32,69
FC Salzburg,7087,2,18,10,8,62,34,28,64
SC Rheindorf,7087,3,17,13,6,59,45,14,64
Vienna,7087,4,18,4,14,64,55,9,58
Rapid Vienna,7087,5,13,12,11,56,45,11,51
SV Josko Rie,7087,6,12,7,17,36,50,-14,43
RZ Pellets W,7087,7,10,10,16,42,51,-9,40
Admira Wacke,7087,8,11,7,18,34,62,-28,40
St. Pölten,7087,9,8,11,17,44,69,-25,35
Mattersburg,7087,10,7,10,19,34,52,-18,31
SC Rheindorf,7088,1,20,10,6,63,41,22,70
FC Salzburg,7088,2,20,8,8,68,33,35,68
SK Sturm Gra,7088,3,18,5,13,64,36,28,59
Rapid Vienna,7088,4,16,10,10,57,38,19,58
Vienna,7088,5,17,6,13,62,62,0,57
RZ Pellets W,7088,6,15,6,15,45,54,-9,51
St. Pölten,7088,7,11,8,17,42,58,-16,41
SV Josko Rie,7088,8,11,3,22,36,64,-28,36
Admira Wacke,7088,9,10,6,20,33,63,-30,36
Mattersburg,7088,10,6,10,20,42,63,-21,28
SC Rheindorf,7089,1,22,6,8,60,41,19,72
FC Salzburg,7089,2,19,9,8,69,30,39,66
SK Sturm Gra,7089,3,20,6,10,57,32,25,66
Rapid Vienna,7089,4,18,8,10,61,41,20,62
Vienna,7089,5,17,8,11,61,46,15,59
RZ Pellets W,7089,6,12,9,15,47,52,-5,45
Admira Wacke,7089,7,11,7,18,36,60,-24,40
SV Josko Rie,7089,8,9,9,18,38,59,-21,36
St. Pölten,7089,9,8,10,18,42,62,-20,34
Mattersburg,7089,10,5,6,25,29,77,-48,21
FC Salzburg,7090,1,21,6,9,73,41,32,69
SC Rheindorf,7090,2,19,8,9,55,50,5,65
SK Sturm Gra,7090,3,18,7,11,59,35,24,61
Vienna,7090,4,18,3,15,63,57,6,57
SV Josko Rie,7090,5,13,7,16,41,51,-10,46
Mattersburg,7090,6,12,9,15,52,60,-8,45
Rapid Vienna,7090,7,10,12,14,52,45,7,42
Admira Wacke,7090,8,11,9,16,37,56,-19,42
St. Pölten,7090,9,9,10,17,42,63,-21,37
RZ Pellets W,7090,10,9,9,18,51,67,-16,36
FC Salzburg,7091,1,21,6,9,67,34,33,69
SK Sturm Gra,7091,2,20,5,11,62,38,24,65
Vienna,7091,3,19,6,11,64,54,10,63
SC Rheindorf,7091,4,17,7,12,52,45,7,58
Rapid Vienna,7091,5,13,10,13,62,53,9,49
St. Pölten,7091,6,10,12,14,48,59,-11,42
RZ Pellets W,7091,7,11,9,16,41,54,-13,42
Admira Wacke,7091,8,11,7,18,41,60,-19,40
SV Josko Rie,7091,9,10,9,17,36,52,-16,39
Mattersburg,7091,10,8,9,19,35,59,-24,33
FC Salzburg,7092,1,22,7,7,73,31,42,73
Vienna,7092,2,20,4,12,63,52,11,64
SC Rheindorf,7092,3,17,9,10,53,48,5,60
Rapid Vienna,7092,4,15,10,11,63,48,15,55
SK Sturm Gra,7092,5,15,9,12,51,37,14,54
RZ Pellets W,7092,6,13,7,16,49,56,-7,46
SV Josko Rie,7092,7,11,8,17,41,52,-11,41
Admira Wacke,7092,8,10,9,17,34,58,-24,39
Mattersburg,7092,9,8,10,18,35,57,-22,34
St. Pölten,7092,10,7,11,18,40,63,-23,32
FC Salzburg,7093,1,23,7,6,73,28,45,76
SK Sturm Gra,7093,2,21,8,7,60,29,31,71
SC Rheindorf,7093,3,19,9,8,58,49,9,66
Vienna,7093,4,15,10,11,67,61,6,55
Rapid Vienna,7093,5,15,9,12,58,42,16,54
RZ Pellets W,7093,6,10,12,14,44,53,-9,42
SV Josko Rie,7093,7,11,6,19,35,50,-15,39
Admira Wacke,7093,8,9,6,21,35,65,-30,33
Mattersburg,7093,9,7,9,20,36,58,-22,30
St. Pölten,7093,10,5,14,17,39,70,-31,29
FC Salzburg,7094,1,20,8,8,63,32,31,68
SK Sturm Gra,7094,2,20,8,8,59,32,27,68
SC Rheindorf,7094,3,21,4,11,56,42,14,67
Vienna,7094,4,19,5,12,72,50,22,62
Rapid Vienna,7094,5,13,12,11,55,43,12,51
SV Josko Rie,7094,6,15,4,17,37,47,-10,49
Admira Wacke,7094,7,11,8,17,40,58,-18,41
RZ Pellets W,7094,8,11,7,18,38,54,-16,40
Mattersburg,7094,9,8,8,20,38,65,-27,32
St. Pölten,7094,10,6,8,22,35,70,-35,26
FC Salzburg,7095,1,19,12,5,71,28,43,69
SC Rheindorf,7095,2,18,11,7,61,46,15,65
SK Sturm Gra,7095,3,18,7,11,59,45,14,61
Vienna,7095,4,16,6,14,60,60,0,54
Rapid Vienna,7095,5,13,14,9,60,42,18,53
Admira Wacke,7095,6,15,6,15,42,55,-13,51
RZ Pellets W,7095,7,10,9,17,46,66,-20,39
SV Josko Rie,7095,8,10,6,20,35,51,-16,36
Mattersburg,7095,9,8,9,19,32,51,-19,33
St. Pölten,7095,10,7,12,17,38,60,-22,33
FC Salzburg,7096,1,23,7,6,70,27,43,76
SC Rheindorf,7096,2,20,9,7,61,39,22,69
SK Sturm Gra,7096,3,19,5,12,58,36,22,62
Vienna,7096,4,18,6,12,60,51,9,60
SV Josko Rie,7096,5,15,5,16,41,48,-7,50
Rapid Vienna,7096,6,12,9,15,49,48,1,45
RZ Pellets W,7096,7,11,9,16,45,55,-10,42
Admira Wacke,7096,8,12,5,19,38,63,-25,41
Mattersburg,7096,9,8,8,20,36,56,-20,32
St. Pölten,7096,10,6,9,21,38,73,-35,27
FC Salzburg,7097,1,23,7,6,66,29,37,76
SK Sturm Gra,7097,2,20,6,10,65,39,26,66
SC Rheindorf,7097,3,16,8,12,55,48,7,56
Vienna,7097,4,17,5,14,64,61,3,56
Rapid Vienna,7097,5,15,10,11,59,41,18,55
St. Pölten,7097,6,11,9,16,46,57,-11,42
SV Josko Rie,7097,7,13,3,20,38,54,-16,42
RZ Pellets W,7097,8,12,6,18,43,61,-18,42
Admira Wacke,7097,9,11,5,20,36,60,-24,38
Mattersburg,7097,10,9,7,20,42,64,-22,34
SK Sturm Gra,7098,1,22,5,9,62,33,29,71
Vienna,7098,2,20,7,9,68,47,21,67
SC Rheindorf,7098,3,18,8,10,53,49,4,62
FC Salzburg,7098,4,17,9,10,58,36,22,60
Rapid Vienna,7098,5,14,10,12,64,47,17,52
Admira Wacke,7098,6,13,7,16,38,54,-16,46
RZ Pellets W,7098,7,13,5,18,43,49,-6,44
Mattersburg,7098,8,9,8,19,42,61,-19,35
SV Josko Rie,7098,9,10,5,21,33,58,-25,35
St. Pölten,7098,10,8,8,20,48,75,-27,32
SK Sturm Gra,7099,1,20,9,7,61,26,35,69
FC Salzburg,7099,2,20,7,9,64,33,31,67
SC Rheindorf,7099,3,19,9,8,53,43,10,66
Vienna,7099,4,18,4,14,65,57,8,58
Rapid Vienna,7099,5,12,13,11,61,44,17,49
Mattersburg,7099,6,11,7,18,38,56,-18,40
RZ Pellets W,7099,7,12,4,20,46,65,-19,40
Admira Wacke,7099,8,11,7,18,40,64,-24,40
SV Josko Rie,7099,9,11,5,20,36,52,-16,38
St. Pölten,7099,10,9,9,18,46,70,-24,36
FC Salzburg,7100,1,23,5,8,77,31,46,74
SC Rheindorf,7100,2,21,5,10,57,44,13,68
Vienna,7100,3,20,5,11,65,48,17,65
Rapid Vienna,7100,4,18,9,9,60,33,27,63
SK Sturm Gra,7100,5,19,6,11,61,35,26,63
RZ Pellets W,7100,6,13,4,19,44,64,-20,43
St. Pölten,7100,7,11,7,18,39,67,-28,40
Mattersburg,7100,8,8,9,19,36,62,-26,33
SV Josko Rie,7100,9,9,5,22,36,61,-25,32
Admira Wacke,7100,10,8,5,23,38,68,-30,29
FC Salzburg,7101,1,23,5,8,67,33,34,74
SK Sturm Gra,7101,2,20,7,9,72,35,37,67
SC Rheindorf,7101,3,19,7,10,55,44,11,64
Vienna,7101,4,17,7,12,57,50,7,58
Rapid Vienna,7101,5,16,9,11,58,42,16,57
RZ Pellets W,7101,6,13,7,16,45,50,-5,46
Admira Wacke,7101,7,11,7,18,33,57,-24,40
SV Josko Rie,7101,8,12,2,22,34,58,-24,38
St. Pölten,7101,9,8,9,19,41,68,-27,33
Mattersburg,7101,10,7,8,21,38,63,-25,29
FC Salzburg,7102,1,22,8,6,64,28,36,74
SK Sturm Gra,7102,2,21,7,8,60,28,32,70
SC Rheindorf,7102,3,20,7,9,59,40,19,67
Vienna,7102,4,17,5,14,59,53,6,56
Rapid Vienna,7102,5,11,12,13,52,45,7,45
RZ Pellets W,7102,6,11,12,13,48,57,-9,45
SV Josko Rie,7102,7,12,4,20,38,56,-18,40
Admira Wacke,7102,8,10,7,19,39,70,-31,37
Mattersburg,7102,9,7,14,15,35,53,-18,35
St. Pölten,7102,10,6,10,20,40,64,-24,28
FC Salzburg,7103,1,22,8,6,72,33,39,74
SK Sturm Gra,7103,2,19,8,9,61,32,29,65
SC Rheindorf,7103,3,18,8,10,53,38,15,62
Vienna,7103,4,18,5,13,59,52,7,59
Rapid Vienna,7103,5,13,13,10,54,43,11,52
RZ Pellets W,7103,6,13,9,14,52,58,-6,48
Admira Wacke,7103,7,11,7,18,40,63,-23,40
SV Josko Rie,7103,8,10,9,17,33,48,-15,39
Mattersburg,7103,9,7,8,21,35,60,-25,29
St. Pölten,7103,10,6,11,19,35,67,-32,29
FC Salzburg,7104,1,21,7,8,64,28,36,70
Vienna,7104,2,21,5,10,69,51,18,68
SK Sturm Gra,7104,3,17,7,12,60,43,17,58
SC Rheindorf,7104,4,17,7,12,53,47,6,58
Rapid Vienna,7104,5,14,13,9,56,40,16,55
Admira Wacke,7104,6,13,7,16,43,57,-14,46
RZ Pellets W,7104,7,12,8,16,45,57,-12,44
SV Josko Rie,7104,8,11,5,20,39,59,-20,38
St. Pölten,7104,9,7,11,18,39,61,-22,32
Mattersburg,7104,10,8,8,20,34,59,-25,32
FC Salzburg,7105,1,23,6,7,63,25,38,75
SK Sturm Gra,7105,2,20,4,12,58,38,20,64
SC Rheindorf,7105,3,18,9,9,50,37,13,63
Vienna,7105,4,19,5,12,65,54,11,62
RZ Pellets W,7105,5,15,4,17,49,58,-9,49
Rapid Vienna,7105,6,11,13,12,52,43,9,46
Admira Wacke,7105,7,13,5,18,44,59,-15,44
SV Josko Rie,7105,8,12,6,18,34,57,-23,42
Mattersburg,7105,9,9,7,20,41,58,-17,34
St. Pölten,7105,10,6,9,21,41,68,-27,27
FC Salzburg,7106,1,22,8,6,69,33,36,74
SK Sturm Gra,7106,2,22,6,8,64,32,32,72
SC Rheindorf,7106,3,19,8,9,61,46,15,65
Vienna,7106,4,20,3,13,65,50,15,63
Rapid Vienna,7106,5,14,12,10,60,39,21,54
RZ Pellets W,7106,6,10,9,17,40,56,-16,39
St. Pölten,7106,7,10,9,17,50,70,-20,39
Admira Wacke,7106,8,10,7,19,36,57,-21,37
SV Josko Rie,7106,9,10,4,22,33,61,-28,34
Mattersburg,7106,10,7,6,23,31,65,-34,27
FC Salzburg,7107,1,22,7,7,68,31,37,73
SK Sturm Gra,7107,2,20,5,11,65,39,26,65
SC Rheindorf,7107,3,19,8,9,57,43,14,65
Vienna,7107,4,17,6,13,59,57,2,57
Rapid Vienna,7107,5,13,10,13,51,36,15,49
RZ Pellets W,7107,6,13,8,15,55,60,-5,47
Admira Wacke,7107,7,12,6,18,37,61,-24,42
SV Josko Rie,7107,8,10,7,19,35,56,-21,37
Mattersburg,7107,9,9,9,18,38,56,-18,36
St. Pölten,7107,10,8,8,20,46,72,-26,32
FC Salzburg,7108,1,20,8,8,67,32,35,68
SC Rheindorf,7108,2,19,9,8,61,46,15,66
Vienna,7108,3,19,5,12,61,50,11,62
SK Sturm Gra,7108,4,18,7,11,54,39,15,61
Rapid Vienna,7108,5,15,13,8,63,39,24,58
RZ Pellets W,7108,6,13,6,17,46,57,-11,45
Admira Wacke,7108,7,11,7,18,33,60,-27,40
SV Josko Rie,7108,8,10,6,20,33,57,-24,36
St. Pölten,7108,9,8,10,18,40,63,-23,34
Mattersburg,7108,10,8,7,21,44,59,-15,31
FC Salzburg,7109,1,23,6,7,67,25,42,75
SC Rheindorf,7109,2,21,6,9,59,42,17,69
SK Sturm Gra,7109,3,20,7,9,60,35,25,67
Vienna,7109,4,19,5,12,64,52,12,62
Rapid Vienna,7109,5,11,12,13,47,45,2,45
RZ Pellets W,7109,6,13,5,18,46,61,-15,44
Admira Wacke,7109,7,12,6,18,30,53,-23,42
SV Josko Rie,7109,8,12,4,20,32,45,-13,40
Mattersburg,7109,9,9,7,20,36,58,-22,34
St. Pölten,7109,10,7,8,21,44,69,-25,29
FC Salzburg,7110,1,21,8,7,70,31,39,71
SK Sturm Gra,7110,2,22,5,9,66,31,35,71
SC Rheindorf,7110,3,20,7,9,56,39,17,67
Vienna,7110,4,20,5,11,69,56,13,65
Rapid Vienna,7110,5,15,8,13,54,47,7,53
RZ Pellets W,7110,6,15,6,15,51,54,-3,51
St. Pölten,7110,7,9,7,20,39,67,-28,34
SV Josko Rie,7110,8,10,3,23,34,61,-27,33
Admira Wacke,7110,9,8,9,19,32,62,-30,33
Mattersburg,7110,10,8,6,22,35,58,-23,30
FC Salzburg,7111,1,22,8,6,63,22,41,74
Vienna,7111,2,20,4,12,65,48,17,64
SC Rheindorf,7111,3,17,12,7,54,38,16,63
SK Sturm Gra,7111,4,18,6,12,58,39,19,60
Rapid Vienna,7111,5,10,14,12,49,41,8,44
Admira Wacke,7111,6,12,8,16,39,55,-16,44
RZ Pellets W,7111,7,11,8,17,39,53,-14,41
SV Josko Rie,7111,8,11,7,18,32,45,-13,40
St. Pölten,7111,9,9,10,17,40,63,-23,37
Mattersburg,7111,10,7,9,20,34,69,-35,30
FC Salzburg,7112,1,23,6,7,70,29,41,75
Vienna,7112,2,22,6,8,69,48,21,72
SK Sturm Gra,7112,3,19,7,10,51,29,22,64
SC Rheindorf,7112,4,18,7,11,45,37,8,61
Rapid Vienna,7112,5,15,12,9,57,37,20,57
RZ Pellets W,7112,6,12,8,16,45,51,-6,44
SV Josko Rie,7112,7,12,3,21,32,50,-18,39
Admira Wacke,7112,8,11,4,21,37,65,-28,37
St. Pölten,7112,9,7,9,20,38,69,-31,30
Mattersburg,7112,10,5,10,21,31,60,-29,25
FC Salzburg,7113,1,20,6,10,60,33,27,66
SK Sturm Gra,7113,2,19,8,9,56,30,26,65
SC Rheindorf,7113,3,16,11,9,56,47,9,59
Rapid Vienna,7113,4,15,11,10,62,42,20,56
Vienna,7113,5,16,7,13,53,48,5,55
St. Pölten,7113,6,13,10,13,50,55,-5,49
Mattersburg,7113,7,10,10,16,35,53,-18,40
SV Josko Rie,7113,8,10,7,19,35,52,-17,37
RZ Pellets W,7113,9,9,8,19,37,58,-21,35
Admira Wacke,7113,10,8,10,18,31,57,-26,34
FC Salzburg,7114,1,21,9,6,71,31,40,72
SK Sturm Gra,7114,2,21,6,9,57,33,24,69
SC Rheindorf,7114,3,19,6,11,55,44,11,63
Vienna,7114,4,19,5,12,65,51,14,62
Rapid Vienna,7114,5,15,12,9,59,34,25,57
RZ Pellets W,7114,6,12,9,15,41,57,-16,45
SV Josko Rie,7114,7,12,4,20,31,51,-20,40
Admira Wacke,7114,8,9,7,20,30,56,-26,34
St. Pölten,7114,9,7,9,20,35,63,-28,30
Mattersburg,7114,10,6,11,19,38,62,-24,29
FC Salzburg,7115,1,22,7,7,68,31,37,73
SC Rheindorf,7115,2,20,6,10,50,38,12,66
Vienna,7115,3,20,5,11,60,47,13,65
SK Sturm Gra,7115,4,18,5,13,54,32,22,59
Rapid Vienna,7115,5,13,12,11,52,41,11,51
RZ Pellets W,7115,6,12,9,15,48,53,-5,45
Admira Wacke,7115,7,11,6,19,32,55,-23,39
SV Josko Rie,7115,8,10,7,19,33,50,-17,37
St. Pölten,7115,9,8,10,18,36,59,-23,34
Mattersburg,7115,10,8,9,19,34,61,-27,33
FC Salzburg,7116,1,24,5,7,75,30,45,77
SK Sturm Gra,7116,2,19,7,10,56,31,25,64
SC Rheindorf,7116,3,18,7,11,48,46,2,61
Vienna,7116,4,16,7,13,60,55,5,55
Rapid Vienna,7116,5,13,12,11,57,39,18,51
RZ Pellets W,7116,6,14,5,17,46,59,-13,47
St. Pölten,7116,7,10,12,14,41,58,-17,42
Mattersburg,7116,8,9,9,18,38,55,-17,36
SV Josko Rie,7116,9,11,3,22,35,56,-21,36
Admira Wacke,7116,10,9,7,20,34,61,-27,34
FC Salzburg,7117,1,23,5,8,73,31,42,74
SK Sturm Gra,7117,2,18,9,9,58,34,24,63
Vienna,7117,3,18,7,11,60,53,7,61
SC Rheindorf,7117,4,18,7,11,51,52,-1,61
Rapid Vienna,7117,5,14,10,12,58,46,12,52
Admira Wacke,7117,6,15,6,15,49,54,-5,51
RZ Pellets W,7117,7,12,10,14,48,51,-3,46
St. Pölten,7117,8,9,7,20,40,65,-25,34
SV Josko Rie,7117,9,9,5,22,32,58,-26,32
Mattersburg,7117,10,7,8,21,40,65,-25,29
FC Salzburg,7118,1,22,7,7,61,25,36,73
SK Sturm Gra,7118,2,21,6,9,59,33,26,69
SC Rheindorf,7118,3,19,8,9,55,46,9,65
Vienna,7118,4,17,7,12,65,52,13,58
Rapid Vienna,7118,5,12,10,14,50,41,9,46
SV Josko Rie,7118,6,13,4,19,38,50,-12,43
RZ Pellets W,7118,7,10,11,15,42,54,-12,41
Admira Wacke,7118,8,11,6,19,33,57,-24,39
Mattersburg,7118,9,10,6,20,39,58,-19,36
St. Pölten,7118,10,8,9,19,43,69,-26,33
FC Salzburg,7119,1,20,9,7,67,31,36,69
Vienna,7119,2,19,7,10,58,41,17,64
SK Sturm Gra,7119,3,19,5,12,63,44,19,62
SC Rheindorf,7119,4,16,11,9,53,46,7,59
RZ Pellets W,7119,5,15,8,13,54,53,1,53
Rapid Vienna,7119,6,11,13,12,50,45,5,46
Admira Wacke,7119,7,13,5,18,38,56,-18,44
SV Josko Rie,7119,8,11,5,20,30,49,-19,38
St. Pölten,7119,9,9,9,18,45,64,-19,36
Mattersburg,7119,10,6,10,20,33,62,-29,28
SK Sturm Gra,7120,1,23,6,7,66,33,33,75
FC Salzburg,7120,2,23,5,8,69,32,37,74
SC Rheindorf,7120,3,19,6,11,52,45,7,63
Vienna,7120,4,18,4,14,67,56,11,58
Rapid Vienna,7120,5,13,12,11,53,39,14,51
RZ Pellets W,7120,6,14,8,14,51,54,-3,50
St. Pölten,7120,7,11,9,16,41,58,-17,42
Mattersburg,7120,8,8,7,21,33,58,-25,31
SV Josko Rie,7120,9,9,4,23,32,60,-28,31
Admira Wacke,7120,10,8,7,21,31,60,-29,31
FC Salzburg,7121,1,22,7,7,68,32,36,73
SK Sturm Gra,7121,2,18,9,9,54,33,21,63
SC Rheindorf,7121,3,17,9,10,50,39,11,60
Vienna,7121,4,17,7,12,66,58,8,58
SV Josko Rie,7121,5,15,4,17,37,49,-12,49
Rapid Vienna,7121,6,11,10,15,53,46,7,43
Admira Wacke,7121,7,12,6,18,35,56,-21,42
RZ Pellets W,7121,8,11,6,19,43,56,-13,39
Mattersburg,7121,9,8,12,16,39,56,-17,36
St. Pölten,7121,10,7,14,15,43,63,-20,35
SK Sturm Gra,7122,1,19,10,7,63,34,29,67
FC Salzburg,7122,2,18,10,8,58,33,25,64
SC Rheindorf,7122,3,17,11,8,59,49,10,62
Vienna,7122,4,18,6,12,61,51,10,60
Rapid Vienna,7122,5,14,10,12,57,43,14,52
SV Josko Rie,7122,6,12,5,19,38,50,-12,41
RZ Pellets W,7122,7,10,9,17,48,62,-14,39
Admira Wacke,7122,8,10,8,18,32,57,-25,38
St. Pölten,7122,9,8,13,15,40,57,-17,37
Mattersburg,7122,10,7,12,17,39,59,-20,33
FC Salzburg,7123,1,21,6,9,73,34,39,69
SC Rheindorf,7123,2,20,9,7,54,37,17,69
Vienna,7123,3,19,6,11,61,49,12,63
SK Sturm Gra,7123,4,19,5,12,58,38,20,62
Rapid Vienna,7123,5,14,10,12,63,46,17,52
St. Pölten,7123,6,11,11,14,46,57,-11,44
RZ Pellets W,7123,7,12,7,17,46,57,-11,43
Admira Wacke,7123,8,11,5,20,42,75,-33,38
Mattersburg,7123,9,8,10,18,38,56,-18,34
SV Josko Rie,7123,10,9,3,24,36,68,-32,30
FC Salzburg,7124,1,21,6,9,63,33,30,69
SC Rheindorf,7124,2,20,8,8,59,39,20,68
SK Sturm Gra,7124,3,17,8,11,52,36,16,59
Vienna,7124,4,17,7,12,61,56,5,58
Rapid Vienna,7124,5,14,10,12,52,36,16,52
RZ Pellets W,7124,6,13,7,16,44,50,-6,46
SV Josko Rie,7124,7,11,9,16,33,49,-16,42
Admira Wacke,7124,8,9,11,16,37,61,-24,38
Mattersburg,7124,9,10,7,19,38,53,-15,37
St. Pölten,7124,10,5,13,18,40,66,-26,28
FC Salzburg,7125,1,21,8,7,69,37,32,71
SK Sturm Gra,7125,2,19,7,10,62,36,26,64
SC Rheindorf,7125,3,18,6,12,54,47,7,60
Vienna,7125,4,17,5,14,65,59,6,56
Rapid Vienna,7125,5,14,9,13,57,40,17,51
Admira Wacke,7125,6,13,9,14,38,50,-12,48
RZ Pellets W,7125,7,13,8,15,49,55,-6,47
SV Josko Rie,7125,8,12,7,17,32,48,-16,43
Mattersburg,7125,9,8,10,18,40,60,-20,34
St. Pölten,7125,10,6,9,21,38,72,-34,27
FC Salzburg,7126,1,20,9,7,63,28,35,69
SC Rheindorf,7126,2,19,9,8,57,43,14,66
SK Sturm Gra,7126,3,19,6,11,64,39,25,63
Vienna,7126,4,17,7,12,63,51,12,58
Rapid Vienna,7126,5,13,10,13,54,44,10,49
Admira Wacke,7126,6,14,6,16,45,55,-10,48
RZ Pellets W,7126,7,12,9,15,43,53,-10,45
Mattersburg,7126,8,9,9,18,36,58,-22,36
SV Josko Rie,7126,9,10,5,21,34,59,-25,35
St. Pölten,7126,10,7,10,19,40,69,-29,31
FC Salzburg,7127,1,21,6,9,70,34,36,69
SC Rheindorf,7127,2,19,10,7,54,38,16,67
Rapid Vienna,7127,3,18,10,8,59,33,26,64
Vienna,7127,4,17,5,14,66,58,8,56
SK Sturm Gra,7127,5,15,8,13,53,46,7,53
RZ Pellets W,7127,6,13,6,17,47,55,-8,45
SV Josko Rie,7127,7,12,8,16,30,42,-12,44
Admira Wacke,7127,8,10,9,17,34,56,-22,39
St. Pölten,7127,9,7,11,18,41,66,-25,32
Mattersburg,7127,10,7,9,20,35,61,-26,30
SC Rheindorf,7128,1,21,7,8,53,37,16,70
SK Sturm Gra,7128,2,20,7,9,58,28,30,67
FC Salzburg,7128,3,18,8,10,57,30,27,62
Vienna,7128,4,18,6,12,57,47,10,60
Rapid Vienna,7128,5,13,10,13,58,47,11,49
Mattersburg,7128,6,10,13,13,39,49,-10,43
RZ Pellets W,7128,7,12,6,18,39,53,-14,42
Admira Wacke,7128,8,12,4,20,37,60,-23,40
SV Josko Rie,7128,9,9,9,18,32,50,-18,36
St. Pölten,7128,10,7,10,19,42,71,-29,31
FC Salzburg,7129,1,23,5,8,69,30,39,74
SC Rheindorf,7129,2,18,7,11,50,37,13,61
SK Sturm Gra,7129,3,17,7,12,60,38,22,58
Rapid Vienna,7129,4,14,11,11,54,41,13,53
Vienna,7129,5,16,4,16,61,63,-2,52
SV Josko Rie,7129,6,15,5,16,40,47,-7,50
RZ Pellets W,7129,7,12,10,14,50,60,-10,46
Admira Wacke,7129,8,12,5,19,38,61,-23,41
Mattersburg,7129,9,9,8,19,42,61,-19,35
St. Pölten,7129,10,8,10,18,41,67,-26,34
SC Rheindorf,7130,1,22,6,8,63,47,16,72
FC Salzburg,7130,2,22,4,10,73,38,35,70
SK Sturm Gra,7130,3,20,4,12,53,36,17,64
Vienna,7130,4,16,7,13,51,46,5,55
Rapid Vienna,7130,5,14,9,13,56,48,8,51
Admira Wacke,7130,6,13,5,18,38,54,-16,44
Mattersburg,7130,7,12,6,18,47,56,-9,42
SV Josko Rie,7130,8,12,5,19,37,51,-14,41
RZ Pellets W,7130,9,10,7,19,37,54,-17,37
St. Pölten,7130,10,7,11,18,37,62,-25,32
FC Salzburg,7131,1,22,7,7,66,28,38,73
SC Rheindorf,7131,2,21,8,7,56,38,18,71
SK Sturm Gra,7131,3,21,3,12,61,40,21,66
Vienna,7131,4,16,10,10,55,47,8,58
RZ Pellets W,7131,5,14,9,13,45,45,0,51
Rapid Vienna,7131,6,12,12,12,53,46,7,48
Admira Wacke,7131,7,10,8,18,40,62,-22,38
SV Josko Rie,7131,8,10,5,21,35,56,-21,35
Mattersburg,7131,9,9,6,21,40,60,-20,33
St. Pölten,7131,10,6,10,20,38,67,-29,28
SK Sturm Gra,7132,1,22,4,10,68,39,29,70
SC Rheindorf,7132,2,21,5,10,62,44,18,68
FC Salzburg,7132,3,19,8,9,61,35,26,65
Rapid Vienna,7132,4,18,8,10,70,41,29,62
Vienna,7132,5,17,6,13,67,58,9,57
SV Josko Rie,7132,6,14,4,18,46,52,-6,46
RZ Pellets W,7132,7,11,9,16,48,62,-14,42
Admira Wacke,7132,8,12,4,20,32,55,-23,40
Mattersburg,7132,9,8,9,19,39,60,-21,33
St. Pölten,7132,10,5,9,22,39,86,-47,24
SC Rheindorf,7133,1,20,6,10,50,43,7,66
Vienna,7133,2,19,6,11,65,52,13,63
FC Salzburg,7133,3,17,10,9,62,36,26,61
SK Sturm Gra,7133,4,17,6,13,53,39,14,57
Rapid Vienna,7133,5,15,11,10,62,42,20,56
RZ Pellets W,7133,6,12,8,16,47,51,-4,44
Mattersburg,7133,7,10,12,14,40,48,-8,42
Admira Wacke,7133,8,11,7,18,43,66,-23,40
SV Josko Rie,7133,9,11,5,20,42,58,-16,38
St. Pölten,7133,10,8,9,19,41,70,-29,33
SK Sturm Gra,7134,1,21,5,10,60,32,28,68
SC Rheindorf,7134,2,19,9,8,55,39,16,66
FC Salzburg,7134,3,17,10,9,60,34,26,61
Rapid Vienna,7134,4,16,10,10,58,40,18,58
Vienna,7134,5,18,4,14,59,61,-2,58
RZ Pellets W,7134,6,12,6,18,44,60,-16,42
Admira Wacke,7134,7,10,10,16,40,59,-19,40
SV Josko Rie,7134,8,10,8,18,46,61,-15,38
Mattersburg,7134,9,7,13,16,40,52,-12,34
St. Pölten,7134,10,8,9,19,43,67,-24,33
FC Salzburg,7135,1,21,8,7,71,35,36,71
SC Rheindorf,7135,2,19,7,10,57,46,11,64
Rapid Vienna,7135,3,18,8,10,75,43,32,62
Vienna,7135,4,19,5,12,60,49,11,62
SK Sturm Gra,7135,5,18,6,12,57,42,15,60
RZ Pellets W,7135,6,13,8,15,51,59,-8,47
Admira Wacke,7135,7,11,5,20,33,60,-27,38
SV Josko Rie,7135,8,10,7,19,38,56,-18,37
Mattersburg,7135,9,7,11,18,40,57,-17,32
St. Pölten,7135,10,7,9,20,39,74,-35,30
FC Salzburg,7136,1,23,9,4,67,26,41,78
SK Sturm Gra,7136,2,19,6,11,59,34,25,63
SC Rheindorf,7136,3,17,8,11,55,45,10,59
Vienna,7136,4,18,3,15,61,59,2,57
Rapid Vienna,7136,5,13,14,9,52,38,14,53
RZ Pellets W,7136,6,13,8,15,46,54,-8,47
SV Josko Rie,7136,7,13,4,19,40,55,-15,43
Admira Wacke,7136,8,10,5,21,38,64,-26,35
Mattersburg,7136,9,8,9,19,38,54,-16,33
St. Pölten,7136,10,7,12,17,42,69,-27,33
SK Sturm Gra,7137,1,21,8,7,64,31,33,71
FC Salzburg,7137,2,21,6,9,63,28,35,69
SC Rheindorf,7137,3,18,7,11,54,46,8,61
Vienna,7137,4,18,3,15,61,57,4,57
Rapid Vienna,7137,5,15,9,12,62,43,19,54
Mattersburg,7137,6,13,5,18,44,56,-12,44
Admira Wacke,7137,7,11,9,16,39,56,-17,42
RZ Pellets W,7137,8,10,11,15,49,60,-11,41
St. Pölten,7137,9,7,11,18,40,68,-28,32
SV Josko Rie,7137,10,9,5,22,30,61,-31,32
FC Salzburg,7138,1,21,9,6,71,31,40,72
SK Sturm Gra,7138,2,18,9,9,56,32,24,63
Vienna,7138,3,19,6,11,67,56,11,63
SC Rheindorf,7138,4,18,7,11,58,50,8,61
Rapid Vienna,7138,5,16,11,9,61,36,25,59
St. Pölten,7138,6,12,9,15,46,60,-14,45
Mattersburg,7138,7,10,10,16,48,58,-10,40
Admira Wacke,7138,8,9,7,20,38,71,-33,34
RZ Pellets W,7138,9,8,8,20,44,67,-23,32
SV Josko Rie,7138,10,7,8,21,34,62,-28,29
SC Rheindorf,7139,1,21,7,8,54,37,17,70
FC Salzburg,7139,2,20,9,7,65,33,32,69
Vienna,7139,3,21,6,9,68,47,21,69
SK Sturm Gra,7139,4,18,6,12,52,36,16,60
Rapid Vienna,7139,5,13,10,13,51,41,10,49
RZ Pellets W,7139,6,14,5,17,48,54,-6,47
St. Pölten,7139,7,10,10,16,43,61,-18,40
Admira Wacke,7139,8,10,5,21,33,60,-27,35
SV Josko Rie,7139,9,9,6,21,35,56,-21,33
Mattersburg,7139,10,7,10,19,34,58,-24,31
SK Sturm Gra,7140,1,20,8,8,63,31,32,68
FC Salzburg,7140,2,19,10,7,63,30,33,67
SC Rheindorf,7140,3,20,6,10,57,46,11,66
Vienna,7140,4,18,6,12,62,56,6,60
RZ Pellets W,7140,5,14,6,16,47,53,-6,48
Rapid Vienna,7140,6,12,11,13,55,47,8,47
Admira Wacke,7140,7,10,11,15,40,57,-17,41
Mattersburg,7140,8,10,9,17,39,52,-13,39
SV Josko Rie,7140,9,9,6,21,29,54,-25,33
St. Pölten,7140,10,8,7,21,36,65,-29,31
FC Salzburg,7141,1,22,6,8,68,30,38,72
SC Rheindorf,7141,2,21,6,9,61,39,22,69
SK Sturm Gra,7141,3,21,5,10,59,27,32,68
Vienna,7141,4,19,5,12,61,48,13,62
Rapid Vienna,7141,5,14,12,10,52,39,13,54
St. Pölten,7141,6,10,10,16,38,60,-22,40
SV Josko Rie,7141,7,11,5,20,31,50,-19,38
RZ Pellets W,7141,8,9,10,17,40,59,-19,37
Mattersburg,7141,9,10,6,20,42,56,-14,36
Admira Wacke,7141,10,9,3,24,30,74,-44,30
FC Salzburg,7142,1,22,8,6,74,28,46,74
SC Rheindorf,7142,2,21,7,8,60,42,18,70
SK Sturm Gra,7142,3,19,6,11,59,35,24,63
Rapid Vienna,7142,4,14,11,11,51,36,15,53
RZ Pellets W,7142,5,14,6,16,44,49,-5,48
Vienna,7142,6,15,3,18,55,62,-7,48
SV Josko Rie,7142,7,12,4,20,39,58,-19,40
Admira Wacke,7142,8,11,7,18,37,60,-23,40
St. Pölten,7142,9,9,12,15,41,58,-17,39
Mattersburg,7142,10,7,8,21,35,67,-32,29
SC Rheindorf,7143,1,20,7,9,53,40,13,67
FC Salzburg,7143,2,20,6,10,66,30,36,66
Vienna,7143,3,19,6,11,67,47,20,63
Rapid Vienna,7143,4,17,9,10,61,41,20,60
SK Sturm Gra,7143,5,18,6,12,53,38,15,60
Mattersburg,7143,6,12,7,17,42,49,-7,43
RZ Pellets W,7143,7,11,9,16,42,55,-13,42
Admira Wacke,7143,8,11,6,19,32,54,-22,39
SV Josko Rie,7143,9,10,4,22,33,65,-32,34
St. Pölten,7143,10,7,10,19,38,68,-30,31
SC Rheindorf,7144,1,21,10,5,59,35,24,73
Vienna,7144,2,19,5,12,61,48,13,62
Rapid Vienna,7144,3,17,10,9,57,35,22,61
SK Sturm Gra,7144,4,17,9,10,58,36,22,60
FC Salzburg,7144,5,15,10,11,57,39,18,55
Admira Wacke,7144,6,13,7,16,37,53,-16,46
RZ Pellets W,7144,7,10,8,18,42,56,-14,38
SV Josko Rie,7144,8,9,8,19,31,56,-25,35
Mattersburg,7144,9,8,9,19,38,56,-18,33
St. Pölten,7144,10,7,12,17,40,66,-26,33
SC Rheindorf,7145,1,20,8,8,57,41,16,68
FC Salzburg,7145,2,20,7,9,68,39,29,67
SK Sturm Gra,7145,3,19,8,9,65,34,31,65
Vienna,7145,4,19,4,13,62,54,8,61
Rapid Vienna,7145,5,14,12,10,70,49,21,54
Admira Wacke,7145,6,13,4,19,42,61,-19,43
Mattersburg,7145,7,9,11,16,41,55,-14,38
RZ Pellets W,7145,8,10,7,19,42,63,-21,37
SV Josko Rie,7145,9,10,7,19,37,58,-21,37
St. Pölten,7145,10,7,10,19,47,77,-30,31
FC Salzburg,7146,1,23,7,6,68,31,37,76
SC Rheindorf,7146,2,20,8,8,57,42,15,68
SK Sturm Gra,7146,3,18,8,10,60,39,21,62
Vienna,7146,4,17,4,15,58,50,8,55
Rapid Vienna,7146,5,12,12,12,58,44,14,48
Mattersburg,7146,6,12,9,15,43,48,-5,45
RZ Pellets W,7146,7,10,8,18,38,55,-17,38
SV Josko Rie,7146,8,10,8,18,35,52,-17,38
Admira Wacke,7146,9,10,8,18,29,57,-28,38
St. Pölten,7146,10,7,10,19,41,69,-28,31
FC Salzburg,7147,1,19,9,8,60,30,30,66
SC Rheindorf,7147,2,18,10,8,53,40,13,64
SK Sturm Gra,7147,3,19,6,11,56,34,22,63
Vienna,7147,4,17,6,13,61,59,2,57
Rapid Vienna,7147,5,13,13,10,61,40,21,52
St. Pölten,7147,6,11,11,14,50,61,-11,44
Admira Wacke,7147,7,12,7,17,41,60,-19,43
Mattersburg,7147,8,11,7,18,41,55,-14,40
RZ Pellets W,7147,9,11,7,18,42,59,-17,40
SV Josko Rie,7147,10,8,6,22,36,63,-27,30
FC Salzburg,7148,1,22,7,7,64,29,35,73
SK Sturm Gra,7148,2,21,6,9,72,30,42,69
Vienna,7148,3,19,8,9,65,46,19,65
SC Rheindorf,7148,4,18,6,12,53,44,9,60
Rapid Vienna,7148,5,15,11,10,56,40,16,56
RZ Pellets W,7148,6,13,8,15,44,53,-9,47
Admira Wacke,7148,7,8,11,17,34,57,-23,35
SV Josko Rie,7148,8,10,5,21,28,53,-25,35
Mattersburg,7148,9,7,9,20,35,63,-28,30
St. Pölten,7148,10,7,9,20,42,78,-36,30
SK Sturm Gra,7149,1,20,10,6,59,26,33,70
SC Rheindorf,7149,2,18,8,10,53,43,10,62
FC Salzburg,7149,3,17,9,10,62,31,31,60
Rapid Vienna,7149,4,15,12,9,60,39,21,57
Vienna,7149,5,17,6,13,58,52,6,57
RZ Pellets W,7149,6,12,12,12,50,51,-1,48
Admira Wacke,7149,7,11,6,19,36,63,-27,39
SV Josko Rie,7149,8,9,10,17,30,51,-21,37
St. Pölten,7149,9,7,14,15,44,68,-24,35
Mattersburg,7149,10,6,9,21,47,75,-28,27
SC Rheindorf,7150,1,19,6,11,53,44,9,63
FC Salzburg,7150,2,18,8,10,61,36,25,62
Vienna,7150,3,18,6,12,61,50,11,60
SK Sturm Gra,7150,4,17,8,11,58,41,17,59
RZ Pellets W,7150,5,14,8,14,51,49,2,50
Rapid Vienna,7150,6,12,12,12,52,44,8,48
Admira Wacke,7150,7,14,6,16,47,56,-9,48
SV Josko Rie,7150,8,13,4,19,38,49,-11,43
St. Pölten,7150,9,9,10,17,38,60,-22,37
Mattersburg,7150,10,7,10,19,35,65,-30,31
FC Salzburg,7151,1,18,10,8,61,30,31,64
SK Sturm Gra,7151,2,19,5,12,60,38,22,62
Vienna,7151,3,16,9,11,66,56,10,57
SC Rheindorf,7151,4,15,10,11,52,49,3,55
RZ Pellets W,7151,5,14,7,15,47,55,-8,49
Rapid Vienna,7151,6,12,11,13,55,46,9,47
Admira Wacke,7151,7,13,5,18,42,60,-18,44
St. Pölten,7151,8,10,12,14,47,60,-13,42
SV Josko Rie,7151,9,11,8,17,35,52,-17,41
Mattersburg,7151,10,9,9,18,32,51,-19,36
SC Rheindorf,7152,1,22,5,9,60,42,18,71
FC Salzburg,7152,2,19,8,9,71,39,32,65
SK Sturm Gra,7152,3,18,8,10,58,34,24,62
Rapid Vienna,7152,4,16,9,11,65,42,23,57
Vienna,7152,5,16,5,15,64,62,2,53
RZ Pellets W,7152,6,14,7,15,49,60,-11,49
Admira Wacke,7152,7,14,4,18,45,60,-15,46
Mattersburg,7152,8,11,9,16,40,52,-12,42
SV Josko Rie,7152,9,11,4,21,35,60,-25,37
St. Pölten,7152,10,4,11,21,33,69,-36,23
FC Salzburg,7153,1,20,8,8,66,35,31,68
SC Rheindorf,7153,2,20,6,10,50,39,11,66
SK Sturm Gra,7153,3,19,5,12,56,34,22,62
Vienna,7153,4,16,8,12,59,54,5,56
Rapid Vienna,7153,5,12,13,11,55,41,14,49
RZ Pellets W,7153,6,12,9,15,42,51,-9,45
SV Josko Rie,7153,7,11,10,15,33,44,-11,43
Admira Wacke,7153,8,11,9,16,35,52,-17,42
St. Pölten,7153,9,8,11,17,34,58,-24,35
Mattersburg,7153,10,7,9,20,35,57,-22,30
FC Salzburg,7154,1,20,11,5,63,26,37,71
SK Sturm Gra,7154,2,21,8,7,67,31,36,71
Vienna,7154,3,17,5,14,61,48,13,56
SC Rheindorf,7154,4,16,7,13,47,47,0,55
Rapid Vienna,7154,5,13,10,13,51,39,12,49
RZ Pellets W,7154,6,14,7,15,46,51,-5,49
SV Josko Rie,7154,7,14,5,17,42,56,-14,47
Admira Wacke,7154,8,12,4,20,35,58,-23,40
Mattersburg,7154,9,6,13,17,33,56,-23,31
St. Pölten,7154,10,7,10,19,37,70,-33,31
FC Salzburg,7155,1,20,10,6,73,35,38,70
SK Sturm Gra,7155,2,18,6,12,55,34,21,60
SC Rheindorf,7155,3,17,9,10,52,45,7,60
Rapid Vienna,7155,4,15,11,10,54,36,18,56
Vienna,7155,5,16,7,13,57,54,3,55
SV Josko Rie,7155,6,15,4,17,42,50,-8,49
Admira Wacke,7155,7,14,5,17,39,56,-17,47
RZ Pellets W,7155,8,11,6,19,43,63,-20,39
Mattersburg,7155,9,9,11,16,40,51,-11,38
St. Pölten,7155,10,6,9,21,39,70,-31,27
SK Sturm Gra,7156,1,22,5,9,64,35,29,71
FC Salzburg,7156,2,20,7,9,64,35,29,67
SC Rheindorf,7156,3,18,7,11,53,41,12,61
Vienna,7156,4,16,6,14,58,52,6,54
Rapid Vienna,7156,5,12,11,13,59,48,11,47
RZ Pellets W,7156,6,13,6,17,44,56,-12,45
SV Josko Rie,7156,7,12,7,17,40,56,-16,43
Mattersburg,7156,8,11,9,16,46,55,-9,42
Admira Wacke,7156,9,10,10,16,34,59,-25,40
St. Pölten,7156,10,7,10,19,36,61,-25,31
FC Salzburg,7157,1,25,5,6,73,30,43,80
Vienna,7157,2,19,4,13,60,46,14,61
SC Rheindorf,7157,3,17,10,9,52,40,12,61
SK Sturm Gra,7157,4,17,6,13,48,37,11,57
Rapid Vienna,7157,5,13,13,10,50,35,15,52
RZ Pellets W,7157,6,11,8,17,42,55,-13,41
Mattersburg,7157,7,11,8,17,38,56,-18,41
SV Josko Rie,7157,8,11,5,20,40,59,-19,38
St. Pölten,7157,9,8,12,16,41,59,-18,36
Admira Wacke,7157,10,7,11,18,29,56,-27,32
FC Salzburg,7158,1,21,10,5,60,25,35,73
SK Sturm Gra,7158,2,19,6,11,58,34,24,63
SC Rheindorf,7158,3,17,9,10,51,43,8,60
Vienna,7158,4,17,5,14,54,51,3,56
RZ Pellets W,7158,5,16,5,15,47,49,-2,53
Rapid Vienna,7158,6,14,9,13,54,43,11,51
Admira Wacke,7158,7,11,7,18,37,58,-21,40
St. Pölten,7158,8,9,11,16,44,60,-16,38
SV Josko Rie,7158,9,9,9,18,28,48,-20,36
Mattersburg,7158,10,6,11,19,32,54,-22,29
SC Rheindorf,7159,1,21,10,5,68,37,31,73
FC Salzburg,7159,2,21,6,9,72,42,30,69
SK Sturm Gra,7159,3,16,9,11,61,37,24,57
Rapid Vienna,7159,4,15,11,10,63,47,16,56
Vienna,7159,5,17,5,14,58,52,6,56
RZ Pellets W,7159,6,14,6,16,55,66,-11,48
SV Josko Rie,7159,7,11,7,18,35,53,-18,40
Mattersburg,7159,8,9,8,19,40,64,-24,35
St. Pölten,7159,9,7,13,16,47,69,-22,34
Admira Wacke,7159,10,8,7,21,33,65,-32,31
SC Rheindorf,7160,1,22,7,7,55,32,23,73
SK Sturm Gra,7160,2,20,7,9,57,28,29,67
FC Salzburg,7160,3,19,8,9,54,31,23,65
Vienna,7160,4,19,7,10,66,48,18,64
Rapid Vienna,7160,5,13,11,12,57,42,15,50
RZ Pellets W,7160,6,12,10,14,43,51,-8,46
Admira Wacke,7160,7,11,6,19,41,63,-22,39
SV Josko Rie,7160,8,10,3,23,35,63,-28,33
Mattersburg,7160,9,7,11,18,39,58,-19,32
St. Pölten,7160,10,7,10,19,38,69,-31,31
FC Salzburg,7161,1,24,5,7,68,31,37,77
SK Sturm Gra,7161,2,18,9,9,60,32,28,63
Vienna,7161,3,19,5,12,63,46,17,62
SC Rheindorf,7161,4,17,8,11,56,43,13,59
Rapid Vienna,7161,5,15,10,11,53,37,16,55
St. Pölten,7161,6,13,9,14,46,58,-12,48
Mattersburg,7161,7,10,10,16,40,51,-11,40
SV Josko Rie,7161,8,10,4,22,31,55,-24,34
RZ Pellets W,7161,9,8,10,18,36,63,-27,34
Admira Wacke,7161,10,8,6,22,28,65,-37,30
SC Rheindorf,7162,1,23,8,5,60,35,25,77
FC Salzburg,7162,2,21,7,8,63,30,33,70
SK Sturm Gra,7162,3,20,7,9,57,27,30,67
Rapid Vienna,7162,4,14,11,11,47,36,11,53
Vienna,7162,5,16,4,16,51,52,-1,52
St. Pölten,7162,6,12,7,17,44,63,-19,43
RZ Pellets W,7162,7,10,8,18,41,58,-17,38
Admira Wacke,7162,8,9,9,18,37,61,-24,36
Mattersburg,7162,9,8,9,19,37,52,-15,33
SV Josko Rie,7162,10,9,6,21,37,60,-23,33
FC Salzburg,7163,1,21,6,9,67,32,35,69
Vienna,7163,2,20,6,10,71,49,22,66
SC Rheindorf,7163,3,20,6,10,58,46,12,66
SK Sturm Gra,7163,4,16,11,9,56,38,18,59
Rapid Vienna,7163,5,14,10,12,54,38,16,52
SV Josko Rie,7163,6,15,3,18,38,52,-14,48
RZ Pellets W,7163,7,13,7,16,47,59,-12,46
Mattersburg,7163,8,11,6,19,42,60,-18,39
Admira Wacke,7163,9,9,6,21,33,62,-29,33
St. Pölten,7163,10,6,9,21,38,68,-30,27
SK Sturm Gra,7164,1,24,5,7,66,28,38,77
FC Salzburg,7164,2,22,5,9,67,31,36,71
SC Rheindorf,7164,3,19,5,12,61,47,14,62
Vienna,7164,4,19,3,14,65,56,9,60
RZ Pellets W,7164,5,15,6,15,48,50,-2,51
Rapid Vienna,7164,6,13,10,13,51,42,9,49
Admira Wacke,7164,7,12,6,18,39,64,-25,42
SV Josko Rie,7164,8,11,4,21,35,56,-21,37
St. Pölten,7164,9,8,8,20,41,73,-32,32
Mattersburg,7164,10,8,6,22,34,60,-26,30
FC Salzburg,7165,1,21,7,8,70,34,36,70
Vienna,7165,2,22,2,12,69,52,17,68
SC Rheindorf,7165,3,20,8,8,53,38,15,68
Rapid Vienna,7165,4,16,10,10,52,34,18,58
SK Sturm Gra,7165,5,16,9,11,56,34,22,57
RZ Pellets W,7165,6,14,6,16,50,57,-7,48
Admira Wacke,7165,7,11,7,18,35,55,-20,40
St. Pölten,7165,8,9,10,17,41,60,-19,37
SV Josko Rie,7165,9,8,6,22,35,66,-31,30
Mattersburg,7165,10,6,9,21,37,68,-31,27
FC Salzburg,7166,1,24,6,6,67,27,40,78
SC Rheindorf,7166,2,23,5,8,58,38,20,74
SK Sturm Gra,7166,3,20,6,10,62,37,25,66
Vienna,7166,4,15,5,16,62,59,3,50
Rapid Vienna,7166,5,11,12,13,45,39,6,45
Admira Wacke,7166,6,12,7,17,35,55,-20,43
RZ Pellets W,7166,7,11,9,16,53,61,-8,42
SV Josko Rie,7166,8,13,3,20,38,55,-17,42
St. Pölten,7166,9,9,9,18,41,62,-21,36
Mattersburg,7166,10,7,8,21,33,61,-28,29
FC Salzburg,7167,1,22,6,8,70,37,33,72
Vienna,7167,2,21,6,9,67,45,22,69
SK Sturm Gra,7167,3,20,5,11,60,39,21,65
SC Rheindorf,7167,4,17,9,10,58,52,6,60
Rapid Vienna,7167,5,15,11,10,59,37,22,56
Admira Wacke,7167,6,12,7,17,40,56,-16,43
SV Josko Rie,7167,7,11,6,19,36,54,-18,39
St. Pölten,7167,8,8,13,15,47,66,-19,37
RZ Pellets W,7167,9,9,7,20,39,55,-16,34
Mattersburg,7167,10,7,6,23,38,73,-35,27
FC Salzburg,7168,1,23,5,8,66,32,34,74
SC Rheindorf,7168,2,21,5,10,66,38,28,68
SK Sturm Gra,7168,3,19,6,11,56,36,20,63
Vienna,7168,4,17,6,13,57,53,4,57
Rapid Vienna,7168,5,13,10,13,52,46,6,49
RZ Pellets W,7168,6,13,5,18,43,55,-12,44
SV Josko Rie,7168,7,13,2,21,36,55,-19,41
St. Pölten,7168,8,10,11,15,44,66,-22,41
Mattersburg,7168,9,11,7,18,40,53,-13,40
Admira Wacke,7168,10,10,3,23,42,68,-26,33
FC Salzburg,7169,1,21,6,9,65,31,34,69
SC Rheindorf,7169,2,19,8,9,59,44,15,65
Vienna,7169,3,20,3,13,60,52,8,63
SK Sturm Gra,7169,4,17,9,10,61,38,23,60
Rapid Vienna,7169,5,16,8,12,57,40,17,56
RZ Pellets W,7169,6,13,7,16,47,57,-10,46
Mattersburg,7169,7,11,8,17,37,49,-12,41
SV Josko Rie,7169,8,11,6,19,43,57,-14,39
Admira Wacke,7169,9,10,8,18,38,64,-26,38
St. Pölten,7169,10,6,9,21,36,71,-35,27
FC Salzburg,7170,1,20,10,6,68,31,37,70
SC Rheindorf,7170,2,20,8,8,62,42,20,68
SK Sturm Gra,7170,3,19,5,12,55,36,19,62
Vienna,7170,4,16,7,13,57,58,-1,55
Rapid Vienna,7170,5,14,10,12,63,42,21,52
Admira Wacke,7170,6,15,7,14,41,47,-6,52
RZ Pellets W,7170,7,11,7,18,38,58,-20,40
St. Pölten,7170,8,9,9,18,38,63,-25,36
Mattersburg,7170,9,8,9,19,38,58,-20,33
SV Josko Rie,7170,10,9,6,21,32,57,-25,33
SC Rheindorf,7171,1,21,9,6,65,42,23,72
FC Salzburg,7171,2,21,7,8,68,34,34,70
SK Sturm Gra,7171,3,20,8,8,66,34,32,68
Vienna,7171,4,20,6,10,61,45,16,66
RZ Pellets W,7171,5,14,7,15,53,55,-2,49
Rapid Vienna,7171,6,12,12,12,54,46,8,48
Admira Wacke,7171,7,10,7,19,37,67,-30,37
St. Pölten,7171,8,6,12,18,42,65,-23,30
Mattersburg,7171,9,7,9,20,32,61,-29,30
SV Josko Rie,7171,10,7,7,22,27,56,-29,28
FC Salzburg,7172,1,22,7,7,62,26,36,73
SK Sturm Gra,7172,2,21,5,10,59,30,29,68
Vienna,7172,3,20,5,11,70,53,17,65
SC Rheindorf,7172,4,18,8,10,52,44,8,62
RZ Pellets W,7172,5,14,8,14,52,55,-3,50
Rapid Vienna,7172,6,11,12,13,49,46,3,45
St. Pölten,7172,7,11,9,16,43,58,-15,42
SV Josko Rie,7172,8,11,5,20,34,54,-20,38
Admira Wacke,7172,9,9,6,21,37,63,-26,33
Mattersburg,7172,10,6,9,21,34,63,-29,27
FC Salzburg,7173,1,20,11,5,71,29,42,71
Vienna,7173,2,18,6,12,64,50,14,60
SK Sturm Gra,7173,3,16,9,11,56,41,15,57
SC Rheindorf,7173,4,15,12,9,55,51,4,57
RZ Pellets W,7173,5,14,6,16,47,52,-5,48
Rapid Vienna,7173,6,12,10,14,49,44,5,46
Admira Wacke,7173,7,13,6,17,40,55,-15,45
Mattersburg,7173,8,11,11,14,39,51,-12,44
St. Pölten,7173,9,7,13,16,42,63,-21,34
SV Josko Rie,7173,10,8,8,20,32,59,-27,32
FC Salzburg,7174,1,24,6,6,72,30,42,78
SC Rheindorf,7174,2,19,9,8,57,42,15,66
SK Sturm Gra,7174,3,18,8,10,65,42,23,62
Vienna,7174,4,18,5,13,60,51,9,59
Rapid Vienna,7174,5,15,9,12,56,42,14,54
RZ Pellets W,7174,6,15,6,15,47,46,1,51
St. Pölten,7174,7,9,11,16,32,57,-25,38
Mattersburg,7174,8,10,5,21,39,63,-24,35
Admira Wacke,7174,9,9,7,20,32,60,-28,34
SV Josko Rie,7174,10,8,4,24,31,58,-27,28
SK Sturm Gra,7175,1,20,6,10,58,33,25,66
SC Rheindorf,7175,2,20,6,10,54,44,10,66
FC Salzburg,7175,3,18,11,7,60,32,28,65
Rapid Vienna,7175,4,15,10,11,56,42,14,55
Admira Wacke,7175,5,16,7,13,44,52,-8,55
Vienna,7175,6,16,5,15,61,57,4,53
RZ Pellets W,7175,7,13,8,15,52,59,-7,47
SV Josko Rie,7175,8,11,5,20,33,51,-18,38
St. Pölten,7175,9,8,9,19,39,60,-21,33
Mattersburg,7175,10,6,7,23,31,58,-27,25
FC Salzburg,7176,1,24,6,6,67,21,46,78
SC Rheindorf,7176,2,19,7,10,54,42,12,64
SK Sturm Gra,7176,3,18,6,12,52,33,19,60
Vienna,7176,4,18,4,14,64,54,10,58
Rapid Vienna,7176,5,14,13,9,51,35,16,55
RZ Pellets W,7176,6,12,8,16,40,52,-12,44
Mattersburg,7176,7,10,8,18,33,53,-20,38
Admira Wacke,7176,8,10,8,18,29,50,-21,38
St. Pölten,7176,9,9,9,18,35,57,-22,36
SV Josko Rie,7176,10,9,5,22,33,61,-28,32
FC Salzburg,7177,1,24,6,6,66,28,38,78
SK Sturm Gra,7177,2,21,6,9,66,35,31,69
SC Rheindorf,7177,3,17,11,8,55,42,13,62
Vienna,7177,4,17,8,11,61,51,10,59
Rapid Vienna,7177,5,14,11,11,50,40,10,53
RZ Pellets W,7177,6,15,6,15,51,52,-1,51
Admira Wacke,7177,7,10,6,20,32,58,-26,36
St. Pölten,7177,8,8,9,19,39,69,-30,33
Mattersburg,7177,9,8,8,20,39,59,-20,32
SV Josko Rie,7177,10,8,5,23,29,54,-25,29
FC Salzburg,7178,1,21,9,6,66,34,32,72
SC Rheindorf,7178,2,19,8,9,53,40,13,65
SK Sturm Gra,7178,3,18,6,12,57,41,16,60
RZ Pellets W,7178,4,16,7,13,56,49,7,55
Vienna,7178,5,15,6,15,58,57,1,51
Rapid Vienna,7178,6,11,13,12,53,46,7,46
Admira Wacke,7178,7,13,7,16,39,53,-14,46
SV Josko Rie,7178,8,11,5,20,33,49,-16,38
St. Pölten,7178,9,9,11,16,38,59,-21,38
Mattersburg,7178,10,7,8,21,32,57,-25,29
Vienna,7179,1,22,7,7,70,40,30,73
FC Salzburg,7179,2,21,5,10,66,38,28,68
SC Rheindorf,7179,3,19,11,6,55,37,18,68
SK Sturm Gra,7179,4,19,6,11,55,31,24,63
Rapid Vienna,7179,5,15,9,12,54,44,10,54
RZ Pellets W,7179,6,13,9,14,48,52,-4,48
SV Josko Rie,7179,7,9,7,20,33,55,-22,34
Mattersburg,7179,8,8,9,19,39,56,-17,33
Admira Wacke,7179,9,9,4,23,30,69,-39,31
St. Pölten,7179,10,7,9,20,38,66,-28,30
FC Salzburg,7180,1,18,9,9,67,38,29,63
SC Rheindorf,7180,2,18,9,9,53,45,8,63
SK Sturm Gra,7180,3,18,8,10,54,30,24,62
Vienna,7180,4,17,5,14,59,54,5,56
Rapid Vienna,7180,5,12,13,11,58,41,17,49
Admira Wacke,7180,6,14,7,15,40,55,-15,49
RZ Pellets W,7180,7,13,7,16,50,61,-11,46
SV Josko Rie,7180,8,13,6,17,39,49,-10,45
Mattersburg,7180,9,9,8,19,39,58,-19,35
St. Pölten,7180,10,6,12,18,38,66,-28,30
FC Salzburg,7181,1,21,6,9,66,31,35,69
SC Rheindorf,7181,2,18,9,9,60,48,12,63
Vienna,7181,3,18,6,12,57,51,6,60
SK Sturm Gra,7181,4,17,8,11,55,35,20,59
Rapid Vienna,7181,5,14,10,12,50,36,14,52
SV Josko Rie,7181,6,14,4,18,39,52,-13,46
RZ Pellets W,7181,7,13,6,17,42,48,-6,45
St. Pölten,7181,8,10,9,17,38,62,-24,39
Mattersburg,7181,9,8,11,17,38,57,-19,35
Admira Wacke,7181,10,9,7,20,32,57,-25,34
FC Salzburg,7182,1,22,7,7,64,28,36,73
SK Sturm Gra,7182,2,20,5,11,57,37,20,65
SC Rheindorf,7182,3,18,5,13,53,48,5,59
Vienna,7182,4,18,3,15,66,60,6,57
Rapid Vienna,7182,5,16,7,13,55,39,16,55
RZ Pellets W,7182,6,15,6,15,55,54,1,51
Admira Wacke,7182,7,13,4,19,42,63,-21,43
SV Josko Rie,7182,8,12,3,21,34,53,-19,39
St. Pölten,7182,9,10,8,18,39,60,-21,38
Mattersburg,7182,10,9,6,21,32,55,-23,33
FC Salzburg,7183,1,22,8,6,71,27,44,74
SC Rheindorf,7183,2,21,10,5,55,33,22,73
SK Sturm Gra,7183,3,18,7,11,53,35,18,61
Vienna,7183,4,17,5,14,68,54,14,56
Rapid Vienna,7183,5,13,12,11,57,43,14,51
RZ Pellets W,7183,6,15,5,16,48,56,-8,50
Admira Wacke,7183,7,9,11,16,35,57,-22,38
SV Josko Rie,7183,8,10,6,20,32,61,-29,36
St. Pölten,7183,9,8,10,18,43,67,-24,34
Mattersburg,7183,10,5,10,21,36,65,-29,25
Vienna,7184,1,22,4,10,68,46,22,70
SC Rheindorf,7184,2,19,10,7,56,39,17,67
FC Salzburg,7184,3,18,8,10,59,30,29,62
SK Sturm Gra,7184,4,17,9,10,54,35,19,60
Rapid Vienna,7184,5,16,10,10,57,37,20,58
SV Josko Rie,7184,6,13,5,18,32,46,-14,44
RZ Pellets W,7184,7,12,7,17,50,57,-7,43
Admira Wacke,7184,8,11,6,19,35,63,-28,39
St. Pölten,7184,9,7,11,18,41,65,-24,32
Mattersburg,7184,10,6,8,22,30,64,-34,26
FC Salzburg,7185,1,19,9,8,62,32,30,66
SK Sturm Gra,7185,2,19,7,10,63,36,27,64
SC Rheindorf,7185,3,18,9,9,53,42,11,63
Vienna,7185,4,17,6,13,57,49,8,57
Admira Wacke,7185,5,15,6,15,39,51,-12,51
Rapid Vienna,7185,6,13,11,12,51,41,10,50
RZ Pellets W,7185,7,13,5,18,42,58,-16,44
Mattersburg,7185,8,11,8,17,46,57,-11,41
SV Josko Rie,7185,9,10,4,22,34,57,-23,34
St. Pölten,7185,10,7,11,18,33,57,-24,32
FC Salzburg,7186,1,20,9,7,71,36,35,69
SK Sturm Gra,7186,2,18,10,8,60,35,25,64
SC Rheindorf,7186,3,18,8,10,58,42,16,62
Vienna,7186,4,16,7,13,55,46,9,55
Rapid Vienna,7186,5,14,10,12,63,48,15,52
RZ Pellets W,7186,6,14,7,15,48,57,-9,49
Admira Wacke,7186,7,11,9,16,40,62,-22,42
St. Pölten,7186,8,9,10,17,44,67,-23,37
Mattersburg,7186,9,8,9,19,37,59,-22,33
SV Josko Rie,7186,10,8,9,19,34,58,-24,33
SC Rheindorf,7187,1,20,10,6,60,34,26,70
SK Sturm Gra,7187,2,19,8,9,61,36,25,65
Vienna,7187,3,19,8,9,64,46,18,65
FC Salzburg,7187,4,19,7,10,62,36,26,64
Rapid Vienna,7187,5,13,13,10,51,34,17,52
RZ Pellets W,7187,6,13,9,14,43,48,-5,48
Admira Wacke,7187,7,13,5,18,36,55,-19,44
St. Pölten,7187,8,8,9,19,36,68,-32,33
Mattersburg,7187,9,7,8,21,38,64,-26,29
SV Josko Rie,7187,10,8,5,23,28,58,-30,29
FC Salzburg,7188,1,21,6,9,60,27,33,69
SC Rheindorf,7188,2,19,8,9,52,38,14,65
Vienna,7188,3,19,7,10,62,46,16,64
SK Sturm Gra,7188,4,19,5,12,58,35,23,62
Rapid Vienna,7188,5,14,10,12,51,40,11,52
RZ Pellets W,7188,6,13,8,15,50,55,-5,47
Admira Wacke,7188,7,13,5,18,35,57,-22,44
SV Josko Rie,7188,8,12,3,21,33,52,-19,39
Mattersburg,7188,9,8,9,19,36,57,-21,33
St. Pölten,7188,10,8,7,21,34,64,-30,31
SC Rheindorf,7189,1,21,8,7,59,38,21,71
FC Salzburg,7189,2,19,8,9,65,40,25,65
SK Sturm Gra,7189,3,19,6,11,54,28,26,63
Vienna,7189,4,19,4,13,59,45,14,61
Admira Wacke,7189,5,14,8,14,42,50,-8,50
Rapid Vienna,7189,6,11,14,11,50,42,8,47
RZ Pellets W,7189,7,9,11,16,42,59,-17,38
Mattersburg,7189,8,8,11,17,41,61,-20,35
SV Josko Rie,7189,9,10,5,21,30,58,-28,35
St. Pölten,7189,10,7,11,18,41,62,-21,32
FC Salzburg,7190,1,25,6,5,68,27,41,81
Vienna,7190,2,18,6,12,65,54,11,60
SK Sturm Gra,7190,3,18,5,13,54,36,18,59
SC Rheindorf,7190,4,15,10,11,50,46,4,55
Rapid Vienna,7190,5,14,9,13,58,43,15,51
RZ Pellets W,7190,6,15,4,17,45,55,-10,49
Mattersburg,7190,7,12,8,16,44,54,-10,44
Admira Wacke,7190,8,12,5,19,41,64,-23,41
St. Pölten,7190,9,10,10,16,42,57,-15,40
SV Josko Rie,7190,10,7,5,24,33,64,-31,26
SC Rheindorf,7191,1,21,6,9,58,47,11,69
SK Sturm Gra,7191,2,19,7,10,65,39,26,64
FC Salzburg,7191,3,17,10,9,61,37,24,61
Vienna,7191,4,17,5,14,59,54,5,56
Rapid Vienna,7191,5,14,12,10,54,43,11,54
Admira Wacke,7191,6,12,8,16,45,58,-13,44
SV Josko Rie,7191,7,11,7,18,36,53,-17,40
St. Pölten,7191,8,8,13,15,50,65,-15,37
RZ Pellets W,7191,9,9,10,17,43,59,-16,37
Mattersburg,7191,10,9,8,19,43,59,-16,35
SK Sturm Gra,7192,1,21,6,9,61,33,28,69
FC Salzburg,7192,2,20,8,8,59,27,32,68
SC Rheindorf,7192,3,19,10,7,57,43,14,67
Vienna,7192,4,19,3,14,69,58,11,60
Rapid Vienna,7192,5,14,12,10,52,39,13,54
Admira Wacke,7192,6,12,9,15,41,56,-15,45
RZ Pellets W,7192,7,12,7,17,51,58,-7,43
SV Josko Rie,7192,8,9,7,20,35,57,-22,34
St. Pölten,7192,9,7,13,16,36,63,-27,34
Mattersburg,7192,10,5,9,22,36,63,-27,24
FC Salzburg,7193,1,22,9,5,69,29,40,75
SK Sturm Gra,7193,2,19,8,9,64,35,29,65
SC Rheindorf,7193,3,18,8,10,49,40,9,62
Vienna,7193,4,16,6,14,55,50,5,54
Rapid Vienna,7193,5,13,12,11,61,42,19,51
RZ Pellets W,7193,6,13,8,15,46,57,-11,47
Admira Wacke,7193,7,12,7,17,32,56,-24,43
St. Pölten,7193,8,10,6,20,45,66,-21,36
SV Josko Rie,7193,9,9,7,20,31,51,-20,34
Mattersburg,7193,10,9,7,20,41,67,-26,34
FC Salzburg,7194,1,20,8,8,62,30,32,68
SC Rheindorf,7194,2,20,8,8,56,35,21,68
Rapid Vienna,7194,3,18,9,9,61,35,26,63
Vienna,7194,4,18,7,11,63,50,13,61
SK Sturm Gra,7194,5,16,11,9,50,30,20,59
SV Josko Rie,7194,6,13,5,18,37,50,-13,44
RZ Pellets W,7194,7,11,4,21,41,65,-24,37
Mattersburg,7194,8,9,9,18,34,48,-14,36
St. Pölten,7194,9,9,7,20,40,70,-30,34
Admira Wacke,7194,10,9,6,21,33,64,-31,33
SC Rheindorf,7195,1,23,6,7,69,35,34,75
FC Salzburg,7195,2,20,5,11,61,41,20,65
SK Sturm Gra,7195,3,18,7,11,56,33,23,61
Vienna,7195,4,18,5,13,59,55,4,59
Rapid Vienna,7195,5,16,9,11,61,41,20,57
Admira Wacke,7195,6,15,7,14,46,53,-7,52
RZ Pellets W,7195,7,10,8,18,39,56,-17,38
St. Pölten,7195,8,8,11,17,41,64,-23,35
SV Josko Rie,7195,9,9,6,21,31,54,-23,33
Mattersburg,7195,10,7,8,21,34,65,-31,29
FC Salzburg,7196,1,22,6,8,68,32,36,72
SC Rheindorf,7196,2,21,6,9,58,40,18,69
SK Sturm Gra,7196,3,18,8,10,58,35,23,62
Vienna,7196,4,16,9,11,66,52,14,57
Rapid Vienna,7196,5,15,11,10,53,36,17,56
RZ Pellets W,7196,6,13,8,15,53,55,-2,47
Admira Wacke,7196,7,11,7,18,36,63,-27,40
Mattersburg,7196,8,10,8,18,37,52,-15,38
St. Pölten,7196,9,8,10,18,42,67,-25,34
SV Josko Rie,7196,10,7,5,24,26,65,-39,26
SC Rheindorf,7197,1,22,4,10,61,50,11,70
FC Salzburg,7197,2,19,9,8,60,34,26,66
Vienna,7197,3,20,5,11,58,44,14,65
SK Sturm Gra,7197,4,19,5,12,58,35,23,62
Rapid Vienna,7197,5,16,9,11,56,37,19,57
RZ Pellets W,7197,6,10,12,14,44,51,-7,42
Admira Wacke,7197,7,12,5,19,39,56,-17,41
SV Josko Rie,7197,8,10,5,21,32,54,-22,35
St. Pölten,7197,9,8,9,19,46,70,-24,33
Mattersburg,7197,10,7,11,18,36,59,-23,32
FC Salzburg,7198,1,21,5,10,66,33,33,68
SC Rheindorf,7198,2,20,6,10,55,45,10,66
Vienna,7198,3,19,6,11,61,53,8,63
SK Sturm Gra,7198,4,18,6,12,55,33,22,60
Rapid Vienna,7198,5,15,11,10,60,37,23,56
RZ Pellets W,7198,6,12,8,16,43,50,-7,44
Admira Wacke,7198,7,12,8,16,38,59,-21,44
St. Pölten,7198,8,9,9,18,40,70,-30,36
Mattersburg,7198,9,8,10,18,42,54,-12,34
SV Josko Rie,7198,10,8,7,21,30,56,-26,31
FC Salzburg,7199,1,23,4,9,65,32,33,73
SK Sturm Gra,7199,2,19,8,9,64,39,25,65
SC Rheindorf,7199,3,19,8,9,52,41,11,65
Vienna,7199,4,18,5,13,62,52,10,59
Rapid Vienna,7199,5,14,13,9,61,39,22,55
Admira Wacke,7199,6,14,8,14,43,48,-5,50
RZ Pellets W,7199,7,13,8,15,44,61,-17,47
SV Josko Rie,7199,8,10,4,22,34,59,-25,34
St. Pölten,7199,9,6,11,19,39,66,-27,29
Mattersburg,7199,10,5,9,22,34,61,-27,24
SC Rheindorf,7200,1,22,6,8,59,40,19,72
FC Salzburg,7200,2,20,5,11,63,40,23,65
Vienna,7200,3,19,5,12,67,51,16,62
SK Sturm Gra,7200,4,17,7,12,62,40,22,58
Rapid Vienna,7200,5,15,11,10,53,34,19,56
RZ Pellets W,7200,6,12,7,17,44,61,-17,43
SV Josko Rie,7200,7,12,6,18,38,50,-12,42
St. Pölten,7200,8,10,9,17,43,62,-19,39
Admira Wacke,7200,9,9,10,17,33,57,-24,37
Mattersburg,7200,10,7,8,21,40,67,-27,29
FC Salzburg,7201,1,23,8,5,70,26,44,77
SC Rheindorf,7201,2,20,6,10,59,46,13,66
SK Sturm Gra,7201,3,18,6,12,66,41,25,60
Rapid Vienna,7201,4,16,11,9,56,37,19,59
Vienna,7201,5,17,5,14,65,62,3,56
RZ Pellets W,7201,6,13,7,16,46,55,-9,46
St. Pölten,7201,7,10,11,15,49,62,-13,41
Admira Wacke,7201,8,9,10,17,31,64,-33,37
SV Josko Rie,7201,9,9,3,24,35,59,-24,30
Mattersburg,7201,10,7,9,20,35,60,-25,30
FC Salzburg,7202,1,20,7,9,62,35,27,67
SK Sturm Gra,7202,2,19,7,10,55,31,24,64
SC Rheindorf,7202,3,18,7,11,52,50,2,61
Vienna,7202,4,18,6,12,65,57,8,60
Rapid Vienna,7202,5,15,11,10,57,37,20,56
RZ Pellets W,7202,6,14,9,13,54,50,4,51
Admira Wacke,7202,7,12,5,19,40,64,-24,41
Mattersburg,7202,8,10,9,17,39,55,-16,39
SV Josko Rie,7202,9,8,8,20,33,54,-21,32
St. Pölten,7202,10,6,11,19,37,61,-24,29
FC Salzburg,7203,1,19,8,9,68,42,26,65
SC Rheindorf,7203,2,19,8,9,53,41,12,65
SK Sturm Gra,7203,3,19,6,11,59,35,24,63
Vienna,7203,4,18,8,10,70,52,18,62
Rapid Vienna,7203,5,14,10,12,54,39,15,52
RZ Pellets W,7203,6,12,8,16,47,52,-5,44
St. Pölten,7203,7,12,8,16,48,62,-14,44
SV Josko Rie,7203,8,11,6,19,34,56,-22,39
Admira Wacke,7203,9,10,4,22,33,63,-30,34
Mattersburg,7203,10,7,12,17,34,58,-24,33
SC Rheindorf,7204,1,21,8,7,61,33,28,71
SK Sturm Gra,7204,2,19,10,7,53,22,31,67
FC Salzburg,7204,3,16,11,9,59,40,19,59
Vienna,7204,4,17,3,16,62,56,6,54
Rapid Vienna,7204,5,12,14,10,53,37,16,50
RZ Pellets W,7204,6,13,10,13,47,48,-1,49
Admira Wacke,7204,7,13,7,16,37,59,-22,46
St. Pölten,7204,8,10,12,14,41,54,-13,42
SV Josko Rie,7204,9,9,7,20,27,50,-23,34
Mattersburg,7204,10,5,8,23,33,74,-41,23
SK Sturm Gra,7205,1,22,5,9,67,31,36,71
FC Salzburg,7205,2,20,7,9,62,36,26,67
SC Rheindorf,7205,3,20,5,11,54,41,13,65
Rapid Vienna,7205,4,15,10,11,57,46,11,55
Vienna,7205,5,16,6,14,55,50,5,54
RZ Pellets W,7205,6,12,10,14,46,56,-10,46
Mattersburg,7205,7,9,10,17,42,58,-16,37
SV Josko Rie,7205,8,10,7,19,35,53,-18,37
St. Pölten,7205,9,9,9,18,41,61,-20,36
Admira Wacke,7205,10,10,5,21,34,61,-27,35
FC Salzburg,7206,1,22,9,5,63,25,38,75
SK Sturm Gra,7206,2,21,6,9,58,30,28,69
Vienna,7206,3,21,4,11,65,51,14,67
SC Rheindorf,7206,4,16,12,8,50,42,8,60
Rapid Vienna,7206,5,15,12,9,61,35,26,57
SV Josko Rie,7206,6,10,9,17,34,49,-15,39
Admira Wacke,7206,7,9,6,21,38,69,-31,33
RZ Pellets W,7206,8,8,8,20,44,66,-22,32
St. Pölten,7206,9,7,11,18,41,65,-24,32
Mattersburg,7206,10,6,13,17,33,55,-22,31
SK Sturm Gra,7207,1,23,5,8,65,33,32,74
FC Salzburg,7207,2,19,9,8,61,34,27,66
SC Rheindorf,7207,3,19,9,8,59,41,18,66
Vienna,7207,4,18,8,10,62,51,11,62
Rapid Vienna,7207,5,15,10,11,66,46,20,55
Admira Wacke,7207,6,11,7,18,34,58,-24,40
RZ Pellets W,7207,7,10,9,17,40,55,-15,39
SV Josko Rie,7207,8,10,5,21,38,65,-27,35
St. Pölten,7207,9,7,13,16,48,63,-15,34
Mattersburg,7207,10,6,9,21,27,54,-27,27
SK Sturm Gra,7208,1,22,8,6,64,29,35,74
SC Rheindorf,7208,2,21,7,8,52,37,15,70
FC Salzburg,7208,3,17,7,12,55,40,15,58
Vienna,7208,4,16,6,14,55,54,1,54
Admira Wacke,7208,5,16,4,16,45,57,-12,52
Rapid Vienna,7208,6,10,14,12,48,40,8,44
RZ Pellets W,7208,7,11,11,14,42,50,-8,44
SV Josko Rie,7208,8,11,5,20,39,54,-15,38
Mattersburg,7208,9,8,9,19,31,49,-18,33
St. Pölten,7208,10,7,11,18,35,56,-21,32
FC Salzburg,7209,1,23,7,6,75,31,44,76
Vienna,7209,2,21,5,10,68,52,16,68
SK Sturm Gra,7209,3,19,5,12,61,39,22,62
SC Rheindorf,7209,4,18,8,10,54,40,14,62
Rapid Vienna,7209,5,14,9,13,57,46,11,51
RZ Pellets W,7209,6,14,6,16,51,57,-6,48
St. Pölten,7209,7,8,11,17,41,63,-22,35
SV Josko Rie,7209,8,10,5,21,34,56,-22,35
Mattersburg,7209,9,9,8,19,37,62,-25,35
Admira Wacke,7209,10,9,6,21,32,64,-32,33
SK Sturm Gra,7210,1,21,6,9,64,37,27,69
FC Salzburg,7210,2,18,10,8,65,34,31,64
Vienna,7210,3,18,6,12,67,56,11,60
SC Rheindorf,7210,4,16,10,10,51,47,4,58
Rapid Vienna,7210,5,14,10,12,56,41,15,52
RZ Pellets W,7210,6,14,7,15,47,55,-8,49
Admira Wacke,7210,7,13,8,15,41,53,-12,47
Mattersburg,7210,8,11,5,20,43,66,-23,38
St. Pölten,7210,9,8,9,19,41,62,-21,33
SV Josko Rie,7210,10,9,5,22,34,58,-24,32
FC Salzburg,7211,1,20,9,7,66,31,35,69
Vienna,7211,2,21,4,11,58,43,15,67
SC Rheindorf,7211,3,20,4,12,52,41,11,64
SK Sturm Gra,7211,4,19,5,12,57,35,22,62
Rapid Vienna,7211,5,16,9,11,68,37,31,57
RZ Pellets W,7211,6,14,8,14,41,47,-6,50
Admira Wacke,7211,7,13,4,19,36,57,-21,43
Mattersburg,7211,8,8,11,17,40,54,-14,35
St. Pölten,7211,9,9,6,21,32,70,-38,33
SV Josko Rie,7211,10,7,6,23,24,59,-35,27
FC Salzburg,7212,1,21,9,6,63,25,38,72
Vienna,7212,2,20,8,8,67,40,27,68
SK Sturm Gra,7212,3,17,9,10,54,36,18,60
SC Rheindorf,7212,4,14,14,8,47,39,8,56
Rapid Vienna,7212,5,14,10,12,61,42,19,52
RZ Pellets W,7212,6,13,6,17,40,56,-16,45
Mattersburg,7212,7,10,10,16,41,54,-13,40
St. Pölten,7212,8,9,11,16,45,62,-17,38
SV Josko Rie,7212,9,8,8,20,34,61,-27,32
Admira Wacke,7212,10,8,7,21,27,64,-37,31
FC Salzburg,7213,1,22,7,7,65,30,35,73
Vienna,7213,2,21,5,10,72,51,21,68
SK Sturm Gra,7213,3,19,4,13,64,42,22,61
SC Rheindorf,7213,4,18,7,11,55,44,11,61
Rapid Vienna,7213,5,12,11,13,53,44,9,47
RZ Pellets W,7213,6,12,6,18,46,63,-17,42
Mattersburg,7213,7,9,12,15,34,48,-14,39
St. Pölten,7213,8,10,8,18,42,57,-15,38
SV Josko Rie,7213,9,11,5,20,36,60,-24,38
Admira Wacke,7213,10,10,7,19,32,60,-28,37
FC Salzburg,7214,1,22,6,8,67,28,39,72
SC Rheindorf,7214,2,22,6,8,65,42,23,72
SK Sturm Gra,7214,3,19,7,10,59,33,26,64
Vienna,7214,4,17,4,15,51,50,1,55
Rapid Vienna,7214,5,14,12,10,56,41,15,54
Admira Wacke,7214,6,12,6,18,40,69,-29,42
St. Pölten,7214,7,9,10,17,42,60,-18,37
SV Josko Rie,7214,8,9,9,18,35,52,-17,36
RZ Pellets W,7214,9,9,9,18,43,62,-19,36
Mattersburg,7214,10,9,7,20,37,58,-21,34
SC Rheindorf,7215,1,21,9,6,60,41,19,72
FC Salzburg,7215,2,19,9,8,63,36,27,66
Vienna,7215,3,20,6,10,67,48,19,66
SK Sturm Gra,7215,4,17,9,10,58,34,24,60
RZ Pellets W,7215,5,12,8,16,46,49,-3,44
Admira Wacke,7215,6,13,5,18,36,53,-17,44
Rapid Vienna,7215,7,11,10,15,50,51,-1,43
St. Pölten,7215,8,10,12,14,44,57,-13,42
SV Josko Rie,7215,9,10,3,23,33,58,-25,33
Mattersburg,7215,10,7,9,20,38,68,-30,30
FC Salzburg,7216,1,24,7,5,70,24,46,79
SK Sturm Gra,7216,2,18,11,7,57,31,26,65
SC Rheindorf,7216,3,18,8,10,56,49,7,62
Vienna,7216,4,18,6,12,65,50,15,60
Rapid Vienna,7216,5,15,9,12,53,38,15,54
RZ Pellets W,7216,6,14,4,18,47,61,-14,46
Admira Wacke,7216,7,13,4,19,42,61,-19,43
SV Josko Rie,7216,8,9,6,21,34,61,-27,33
St. Pölten,7216,9,8,8,20,40,69,-29,32
Mattersburg,7216,10,7,9,20,34,54,-20,30
SK Sturm Gra,7217,1,21,6,9,67,34,33,69
FC Salzburg,7217,2,19,11,6,62,29,33,68
SC Rheindorf,7217,3,19,8,9,51,35,16,65
Vienna,7217,4,16,7,13,64,53,11,55
Rapid Vienna,7217,5,12,15,9,47,35,12,51
Admira Wacke,7217,6,14,8,14,39,54,-15,50
RZ Pellets W,7217,7,11,7,18,43,68,-25,40
St. Pölten,7217,8,8,10,18,40,59,-19,34
Mattersburg,7217,9,7,11,18,39,62,-23,32
SV Josko Rie,7217,10,8,7,21,30,53,-23,31
FC Salzburg,7218,1,21,7,8,63,30,33,70
SC Rheindorf,7218,2,19,7,10,55,43,12,64
Vienna,7218,3,19,6,11,68,54,14,63
SK Sturm Gra,7218,4,17,6,13,58,38,20,57
Rapid Vienna,7218,5,16,8,12,56,43,13,56
RZ Pellets W,7218,6,12,7,17,45,52,-7,43
Mattersburg,7218,7,11,9,16,39,50,-11,42
St. Pölten,7218,8,10,8,18,40,64,-24,38
Admira Wacke,7218,9,11,5,20,36,61,-25,38
SV Josko Rie,7218,10,10,5,21,35,60,-25,35
FC Salzburg,7219,1,22,8,6,67,29,38,74
SK Sturm Gra,7219,2,20,8,8,63,38,25,68
Vienna,7219,3,20,5,11,62,44,18,65
SC Rheindorf,7219,4,15,11,10,51,49,2,56
Rapid Vienna,7219,5,14,10,12,55,43,12,52
Admira Wacke,7219,6,13,7,16,37,53,-16,46
RZ Pellets W,7219,7,11,7,18,44,62,-18,40
St. Pölten,7219,8,9,10,17,46,63,-17,37
SV Josko Rie,7219,9,10,5,21,34,55,-21,35
Mattersburg,7219,10,6,9,21,32,55,-23,27
FC Salzburg,7220,1,22,6,8,65,29,36,72
SC Rheindorf,7220,2,20,8,8,55,40,15,68
Vienna,7220,3,19,6,11,68,55,13,63
SK Sturm Gra,7220,4,18,7,11,61,41,20,61
Rapid Vienna,7220,5,14,10,12,52,40,12,52
RZ Pellets W,7220,6,14,5,17,51,59,-8,47
Admira Wacke,7220,7,13,8,15,40,54,-14,47
SV Josko Rie,7220,8,11,4,21,37,58,-21,37
Mattersburg,7220,9,8,11,17,38,53,-15,35
St. Pölten,7220,10,5,7,24,37,75,-38,22
FC Salzburg,7221,1,22,8,6,63,26,37,74
SC Rheindorf,7221,2,22,5,9,59,37,22,71
SK Sturm Gra,7221,3,18,5,13,60,39,21,59
Vienna,7221,4,17,5,14,61,57,4,56
Rapid Vienna,7221,5,15,9,12,60,42,18,54
Admira Wacke,7221,6,14,5,17,49,63,-14,47
RZ Pellets W,7221,7,13,8,15,46,60,-14,47
Mattersburg,7221,8,9,8,19,38,58,-20,35
SV Josko Rie,7221,9,10,4,22,33,59,-26,34
St. Pölten,7221,10,8,7,21,44,72,-28,31
FC Salzburg,7222,1,21,6,9,63,32,31,69
Vienna,7222,2,19,6,11,61,50,11,63
Rapid Vienna,7222,3,16,10,10,54,38,16,58
RZ Pellets W,7222,4,16,7,13,55,49,6,55
SK Sturm Gra,7222,5,15,8,13,56,40,16,53
SC Rheindorf,7222,6,15,8,13,49,44,5,53
Admira Wacke,7222,7,13,6,17,41,60,-19,45
SV Josko Rie,7222,8,12,5,19,36,55,-19,41
St. Pölten,7222,9,8,10,18,34,57,-23,34
Mattersburg,7222,10,6,12,18,35,59,-24,30
FC Salzburg,7223,1,21,9,6,65,31,34,72
SC Rheindorf,7223,2,20,8,8,56,39,17,68
SK Sturm Gra,7223,3,18,5,13,60,39,21,59
Vienna,7223,4,17,7,12,58,51,7,58
Rapid Vienna,7223,5,15,10,11,58,37,21,55
RZ Pellets W,7223,6,13,8,15,42,48,-6,47
Admira Wacke,7223,7,12,6,18,38,66,-28,42
Mattersburg,7223,8,10,8,18,42,54,-12,38
St. Pölten,7223,9,8,9,19,42,73,-31,33
SV Josko Rie,7223,10,8,6,22,32,55,-23,30
FC Salzburg,7224,1,23,6,7,73,28,45,75
SC Rheindorf,7224,2,21,7,8,55,41,14,70
Rapid Vienna,7224,3,19,8,9,60,38,22,65
SK Sturm Gra,7224,4,18,7,11,58,34,24,61
Vienna,7224,5,15,8,13,55,57,-2,53
RZ Pellets W,7224,6,12,8,16,46,55,-9,44
Mattersburg,7224,7,10,7,19,39,55,-16,37
St. Pölten,7224,8,10,7,19,42,65,-23,37
Admira Wacke,7224,9,8,8,20,36,60,-24,32
SV Josko Rie,7224,10,9,4,23,28,59,-31,31
FC Salzburg,7225,1,18,11,7,61,34,27,65
Vienna,7225,2,18,9,9,65,53,12,63
SC Rheindorf,7225,3,17,11,8,53,40,13,62
SK Sturm Gra,7225,4,16,9,11,51,34,17,57
Rapid Vienna,7225,5,14,12,10,56,39,17,54
Admira Wacke,7225,6,12,6,18,37,61,-24,42
SV Josko Rie,7225,7,11,6,19,36,49,-13,39
St. Pölten,7225,8,10,9,17,40,56,-16,39
RZ Pellets W,7225,9,10,8,18,41,57,-16,38
Mattersburg,7225,10,9,9,18,41,58,-17,36
FC Salzburg,7226,1,20,10,6,68,33,35,70
SK Sturm Gra,7226,2,21,7,8,60,32,28,70
SC Rheindorf,7226,3,21,7,8,64,39,25,70
Vienna,7226,4,20,5,11,64,53,11,65
Rapid Vienna,7226,5,11,12,13,55,47,8,45
Admira Wacke,7226,6,12,8,16,38,57,-19,44
RZ Pellets W,7226,7,12,7,17,47,57,-10,43
SV Josko Rie,7226,8,11,6,19,37,56,-19,39
St. Pölten,7226,9,9,9,18,41,58,-17,36
Mattersburg,7226,10,4,7,25,31,73,-42,19
Vienna,7227,1,21,6,9,63,39,24,69
SC Rheindorf,7227,2,20,8,8,50,44,6,68
FC Salzburg,7227,3,19,8,9,68,34,34,65
SK Sturm Gra,7227,4,18,9,9,54,31,23,63
Rapid Vienna,7227,5,11,14,11,45,36,9,47
RZ Pellets W,7227,6,13,8,15,47,55,-8,47
St. Pölten,7227,7,11,7,18,49,63,-14,40
Admira Wacke,7227,8,10,6,20,36,64,-28,36
Mattersburg,7227,9,8,9,19,39,58,-19,33
SV Josko Rie,7227,10,8,7,21,29,56,-27,31
SK Sturm Gra,7228,1,21,5,10,64,36,28,68
FC Salzburg,7228,2,19,7,10,60,39,21,64
Vienna,7228,3,17,6,13,57,52,5,57
SC Rheindorf,7228,4,17,6,13,49,47,2,57
Rapid Vienna,7228,5,13,12,11,53,42,11,51
SV Josko Rie,7228,6,14,5,17,36,46,-10,47
Admira Wacke,7228,7,13,6,17,45,54,-9,45
RZ Pellets W,7228,8,11,7,18,46,56,-10,40
Mattersburg,7228,9,11,7,18,39,54,-15,40
St. Pölten,7228,10,8,11,17,43,66,-23,35
SC Rheindorf,7229,1,20,10,6,54,39,15,70
FC Salzburg,7229,2,21,6,9,68,37,31,69
Vienna,7229,3,20,5,11,68,46,22,65
SK Sturm Gra,7229,4,17,9,10,55,34,21,60
RZ Pellets W,7229,5,14,10,12,50,51,-1,52
SV Josko Rie,7229,6,15,5,16,39,48,-9,50
Rapid Vienna,7229,7,12,8,16,60,50,10,44
Admira Wacke,7229,8,10,8,18,35,59,-24,38
Mattersburg,7229,9,6,9,21,36,66,-30,27
St. Pölten,7229,10,5,10,21,34,69,-35,25
SK Sturm Gra,7230,1,20,7,9,63,36,27,67
FC Salzburg,7230,2,19,6,11,53,33,20,63
Rapid Vienna,7230,3,18,8,10,58,37,21,62
SC Rheindorf,7230,4,18,8,10,56,44,12,62
Vienna,7230,5,19,4,13,57,48,9,61
RZ Pellets W,7230,6,12,7,17,48,58,-10,43
Admira Wacke,7230,7,12,7,17,40,57,-17,43
St. Pölten,7230,8,9,11,16,47,60,-13,38
Mattersburg,7230,9,8,9,19,35,59,-24,33
SV Josko Rie,7230,10,8,7,21,30,55,-25,31
FC Salzburg,7231,1,23,7,6,65,31,34,76
Vienna,7231,2,22,5,9,73,44,29,71
SC Rheindorf,7231,3,18,6,12,53,47,6,60
SK Sturm Gra,7231,4,18,4,14,52,40,12,58
RZ Pellets W,7231,5,14,8,14,49,49,0,50
Rapid Vienna,7231,6,12,10,14,49,45,4,46
Mattersburg,7231,7,9,10,17,41,55,-14,37
Admira Wacke,7231,8,9,10,17,33,54,-21,37
SV Josko Rie,7231,9,10,6,20,34,56,-22,36
St. Pölten,7231,10,7,10,19,38,66,-28,31
FC Salzburg,7232,1,21,8,7,63,29,34,71
Vienna,7232,2,19,7,10,65,47,18,64
SK Sturm Gra,7232,3,18,8,10,54,34,20,62
SC Rheindorf,7232,4,16,11,9,50,43,7,59
RZ Pellets W,7232,5,15,9,12,53,47,6,54
Rapid Vienna,7232,6,12,10,14,53,44,9,46
Admira Wacke,7232,7,10,9,17,36,61,-25,39
SV Josko Rie,7232,8,11,5,20,32,53,-21,38
St. Pölten,7232,9,9,8,19,39,67,-28,35
Mattersburg,7232,10,7,9,20,39,59,-20,30
FC Salzburg,7233,1,22,8,6,69,25,44,74
SC Rheindorf,7233,2,21,4,11,60,44,16,67
SK Sturm Gra,7233,3,20,6,10,58,32,26,66
Vienna,7233,4,18,4,14,55,51,4,58
Rapid Vienna,7233,5,12,13,11,62,44,18,49
RZ Pellets W,7233,6,11,10,15,44,58,-14,43
Admira Wacke,7233,7,11,8,17,36,62,-26,41
Mattersburg,7233,8,9,9,18,40,59,-19,36
St. Pölten,7233,9,8,10,18,46,70,-24,34
SV Josko Rie,7233,10,9,6,21,39,64,-25,33
FC Salzburg,7234,1,20,8,8,65,34,31,68
SC Rheindorf,7234,2,18,8,10,59,43,16,62
Vienna,7234,3,18,8,10,65,50,15,62
SK Sturm Gra,7234,4,18,7,11,54,37,17,61
Rapid Vienna,7234,5,14,11,11,56,38,18,53
Admira Wacke,7234,6,13,8,15,41,57,-16,47
RZ Pellets W,7234,7,11,8,17,45,56,-11,41
Mattersburg,7234,8,9,8,19,34,57,-23,35
SV Josko Rie,7234,8,9,8,19,34,57,-23,35
St. Pölten,7234,10,8,10,18,41,65,-24,34
FC Salzburg,7235,1,21,9,6,66,30,36,72
SK Sturm Gra,7235,2,21,7,8,70,40,30,70
SC Rheindorf,7235,3,17,11,8,59,42,17,62
Vienna,7235,4,18,7,11,67,56,11,61
Rapid Vienna,7235,5,15,11,10,58,43,15,56
RZ Pellets W,7235,6,10,11,15,50,63,-13,41
Admira Wacke,7235,7,11,7,18,40,65,-25,40
SV Josko Rie,7235,8,10,6,20,30,51,-21,36
St. Pölten,7235,9,8,8,20,40,63,-23,32
Mattersburg,7235,10,7,7,22,33,60,-27,28
FC Salzburg,7236,1,21,9,6,65,28,37,72
SK Sturm Gra,7236,2,20,7,9,56,33,23,67
SC Rheindorf,7236,3,20,5,11,51,39,12,65
Vienna,7236,4,19,4,13,64,52,12,61
Rapid Vienna,7236,5,16,10,10,62,38,24,58
SV Josko Rie,7236,6,12,4,20,42,61,-19,40
Admira Wacke,7236,7,12,4,20,42,70,-28,40
RZ Pellets W,7236,8,10,8,18,47,60,-13,38
St. Pölten,7236,9,9,8,19,38,62,-24,35
Mattersburg,7236,10,8,7,21,36,60,-24,31
FC Salzburg,7237,1,20,7,9,59,28,31,67
SK Sturm Gra,7237,2,20,6,10,54,28,26,66
SC Rheindorf,7237,3,19,4,13,52,45,7,61
Vienna,7237,4,17,4,15,60,57,3,55
Rapid Vienna,7237,5,14,9,13,55,41,14,51
Admira Wacke,7237,6,16,3,17,39,57,-18,51
St. Pölten,7237,7,11,8,17,43,55,-12,41
RZ Pellets W,7237,8,11,8,17,38,55,-17,41
SV Josko Rie,7237,9,11,6,19,32,48,-16,39
Mattersburg,7237,10,9,9,18,32,50,-18,36
FC Salzburg,7238,1,23,7,6,70,27,43,76
SC Rheindorf,7238,2,18,6,12,54,49,5,60
SK Sturm Gra,7238,3,18,5,13,55,39,16,59
Rapid Vienna,7238,4,15,10,11,59,40,19,55
Vienna,7238,5,16,6,14,62,53,9,54
RZ Pellets W,7238,6,12,9,15,42,48,-6,45
SV Josko Rie,7238,7,12,5,19,36,53,-17,41
St. Pölten,7238,8,10,11,15,39,58,-19,41
Admira Wacke,7238,9,11,6,19,38,58,-20,39
Mattersburg,7238,10,9,7,20,31,61,-30,34
SC Rheindorf,7239,1,21,6,9,54,40,14,69
Vienna,7239,2,19,8,9,71,47,24,65
SK Sturm Gra,7239,3,19,4,13,59,42,17,61
FC Salzburg,7239,4,17,8,11,60,38,22,59
Rapid Vienna,7239,5,14,10,12,54,39,15,52
Admira Wacke,7239,6,13,7,16,38,55,-17,46
RZ Pellets W,7239,7,11,8,17,48,59,-11,41
SV Josko Rie,7239,8,12,5,19,38,54,-16,41
Mattersburg,7239,9,9,8,19,35,56,-21,35
St. Pölten,7239,10,9,8,19,35,62,-27,35
FC Salzburg,7240,1,23,7,6,74,29,45,76
SK Sturm Gra,7240,2,21,7,8,61,31,30,70
SC Rheindorf,7240,3,20,7,9,58,42,16,67
Vienna,7240,4,19,3,14,61,55,6,60
Rapid Vienna,7240,5,13,12,11,54,42,12,51
RZ Pellets W,7240,6,12,8,16,50,62,-12,44
SV Josko Rie,7240,7,12,4,20,31,48,-17,40
Admira Wacke,7240,8,11,4,21,38,66,-28,37
Mattersburg,7240,9,9,9,18,40,56,-16,36
St. Pölten,7240,10,5,9,22,38,74,-36,24
SK Sturm Gra,7241,1,21,6,9,63,32,31,69
SC Rheindorf,7241,2,21,5,10,58,40,18,68
FC Salzburg,7241,3,19,6,11,64,39,25,63
Vienna,7241,4,20,3,13,62,53,9,63
Admira Wacke,7241,5,16,6,14,44,52,-8,54
Rapid Vienna,7241,6,14,10,12,57,45,12,52
RZ Pellets W,7241,7,11,7,18,46,63,-17,40
SV Josko Rie,7241,8,10,7,19,35,51,-16,37
St. Pölten,7241,9,8,9,19,42,62,-20,33
Mattersburg,7241,10,7,7,22,36,70,-34,28
SK Sturm Gra,7242,1,21,6,9,68,40,28,69
SC Rheindorf,7242,2,19,8,9,60,46,14,65
Vienna,7242,3,20,4,12,66,47,19,64
FC Salzburg,7242,4,18,8,10,71,46,25,62
Rapid Vienna,7242,5,14,12,10,55,39,16,54
Admira Wacke,7242,6,13,6,17,42,58,-16,45
SV Josko Rie,7242,7,10,8,18,34,51,-17,38
RZ Pellets W,7242,8,9,10,17,44,65,-21,37
St. Pölten,7242,9,9,9,18,51,74,-23,36
Mattersburg,7242,10,7,9,20,38,63,-25,30
SC Rheindorf,7243,1,21,8,7,63,42,21,71
SK Sturm Gra,7243,2,22,4,10,61,32,29,70
FC Salzburg,7243,3,20,7,9,67,35,32,67
Vienna,7243,4,20,6,10,67,49,18,66
Rapid Vienna,7243,5,13,10,13,59,48,11,49
SV Josko Rie,7243,6,13,6,17,39,50,-11,45
Admira Wacke,7243,7,12,6,18,41,59,-18,42
RZ Pellets W,7243,8,11,8,17,45,60,-15,41
Mattersburg,7243,9,8,8,20,35,60,-25,32
St. Pölten,7243,10,4,9,23,38,80,-42,21
FC Salzburg,7244,1,21,4,11,70,33,37,67
SC Rheindorf,7244,2,19,6,11,62,48,14,63
Vienna,7244,3,19,5,12,67,56,11,62
SK Sturm Gra,7244,4,17,8,11,61,42,19,59
Rapid Vienna,7244,5,15,11,10,59,35,24,56
SV Josko Rie,7244,6,14,5,17,42,53,-11,47
RZ Pellets W,7244,7,12,9,15,43,54,-11,45
St. Pölten,7244,8,10,11,15,41,60,-19,41
Admira Wacke,7244,9,9,8,19,33,63,-30,35
Mattersburg,7244,10,6,9,21,35,69,-34,27
FC Salzburg,7245,1,20,6,10,68,29,39,66
SC Rheindorf,7245,2,20,6,10,56,42,14,66
SK Sturm Gra,7245,3,20,5,11,62,34,28,65
Vienna,7245,4,18,6,12,64,51,13,60
Rapid Vienna,7245,5,16,9,11,60,40,20,57
RZ Pellets W,7245,6,14,5,17,45,55,-10,47
Admira Wacke,7245,7,13,7,16,36,55,-19,46
Mattersburg,7245,8,10,7,19,35,54,-19,37
SV Josko Rie,7245,9,10,6,20,27,51,-24,36
St. Pölten,7245,10,6,9,21,33,75,-42,27
FC Salzburg,7246,1,22,9,5,69,27,42,75
SC Rheindorf,7246,2,21,6,9,52,37,15,69
Rapid Vienna,7246,3,16,10,10,69,47,22,58
Vienna,7246,4,17,6,13,51,47,4,57
SK Sturm Gra,7246,5,14,9,13,57,43,14,51
RZ Pellets W,7246,6,14,8,14,48,56,-8,50
Admira Wacke,7246,7,12,9,15,50,62,-12,45
SV Josko Rie,7246,8,9,7,20,31,48,-17,34
St. Pölten,7246,9,8,8,20,35,65,-30,32
Mattersburg,7246,10,7,8,21,38,68,-30,29
SC Rheindorf,7247,1,22,8,6,56,33,23,74
FC Salzburg,7247,2,20,7,9,63,31,32,67
SK Sturm Gra,7247,3,17,9,10,52,34,18,60
Vienna,7247,4,17,5,14,60,59,1,56
Rapid Vienna,7247,5,13,11,12,58,45,13,50
RZ Pellets W,7247,6,13,7,16,44,52,-8,46
Admira Wacke,7247,7,12,5,19,38,60,-22,41
SV Josko Rie,7247,8,11,5,20,37,57,-20,38
Mattersburg,7247,9,8,10,18,40,58,-18,34
St. Pölten,7247,10,7,13,16,41,60,-19,34
FC Salzburg,7248,1,23,7,6,70,27,43,76
SK Sturm Gra,7248,2,21,6,9,58,33,25,69
SC Rheindorf,7248,3,17,8,11,57,49,8,59
Rapid Vienna,7248,4,15,10,11,56,41,15,55
Vienna,7248,5,15,4,17,56,63,-7,49
RZ Pellets W,7248,6,13,7,16,53,57,-4,46
Admira Wacke,7248,7,14,3,19,39,57,-18,45
SV Josko Rie,7248,8,11,5,20,41,56,-15,38
St. Pölten,7248,9,10,8,18,44,62,-18,38
Mattersburg,7248,10,8,8,20,36,65,-29,32
FC Salzburg,7249,1,24,6,6,72,26,46,78
SK Sturm Gra,7249,2,19,7,10,55,31,24,64
Vienna,7249,3,18,5,13,66,49,17,59
Rapid Vienna,7249,4,14,12,10,57,38,19,54
SC Rheindorf,7249,5,15,8,13,50,54,-4,53
SV Josko Rie,7249,6,15,3,18,39,49,-10,48
RZ Pellets W,7249,7,13,8,15,46,57,-11,47
Admira Wacke,7249,8,11,5,20,33,61,-28,38
Mattersburg,7249,9,10,7,19,39,59,-20,37
St. Pölten,7249,10,6,9,21,39,72,-33,27
FC Salzburg,7250,1,20,7,9,72,36,36,67
SK Sturm Gra,7250,2,20,6,10,58,32,26,66
Vienna,7250,3,19,5,12,58,44,14,62
SC Rheindorf,7250,4,18,7,11,56,48,8,61
Rapid Vienna,7250,5,16,11,9,53,34,19,59
SV Josko Rie,7250,6,13,5,18,44,55,-11,44
Mattersburg,7250,7,11,10,15,39,47,-8,43
RZ Pellets W,7250,8,11,5,20,41,61,-20,38
Admira Wacke,7250,9,9,6,21,34,67,-33,33
St. Pölten,7250,10,8,8,20,39,70,-31,32
FC Salzburg,7251,1,20,9,7,64,30,34,69
SC Rheindorf,7251,2,20,7,9,56,45,11,67
SK Sturm Gra,7251,3,18,8,10,61,35,26,62
Vienna,7251,4,19,5,12,67,53,14,62
Rapid Vienna,7251,5,13,13,10,56,44,12,52
RZ Pellets W,7251,6,13,7,16,46,51,-5,46
Admira Wacke,7251,7,9,12,15,41,61,-20,39
SV Josko Rie,7251,8,10,6,20,35,57,-22,36
St. Pölten,7251,9,8,10,18,41,62,-21,34
Mattersburg,7251,10,7,9,20,31,60,-29,30
FC Salzburg,7252,1,21,8,7,69,28,41,71
SC Rheindorf,7252,2,20,7,9,55,41,14,67
SK Sturm Gra,7252,3,18,7,11,60,36,24,61
Vienna,7252,4,18,6,12,57,50,7,60
Rapid Vienna,7252,5,14,10,12,54,42,12,52
RZ Pellets W,7252,6,12,8,16,46,55,-9,44
Admira Wacke,7252,7,12,8,16,44,60,-16,44
SV Josko Rie,7252,8,10,5,21,31,53,-22,35
St. Pölten,7252,9,9,8,19,44,69,-25,35
Mattersburg,7252,10,9,7,20,33,59,-26,34
FC Salzburg,7253,1,19,9,8,62,30,32,66
SC Rheindorf,7253,2,19,9,8,57,44,13,66
SK Sturm Gra,7253,3,19,6,11,58,35,23,63
Vienna,7253,4,19,5,12,62,47,15,62
Rapid Vienna,7253,5,14,9,13,53,45,8,51
Admira Wacke,7253,6,13,6,17,42,54,-12,45
RZ Pellets W,7253,7,12,8,16,42,54,-12,44
SV Josko Rie,7253,8,11,7,18,35,52,-17,40
St. Pölten,7253,9,8,11,17,43,68,-25,35
Mattersburg,7253,10,7,8,21,39,64,-25,29
FC Salzburg,7254,1,23,7,6,68,34,34,76
SC Rheindorf,7254,2,22,7,7,59,38,21,73
Vienna,7254,3,19,5,12,59,49,10,62
SK Sturm Gra,7254,4,18,5,13,56,37,19,59
Rapid Vienna,7254,5,14,11,11,57,41,16,53
Mattersburg,7254,6,12,6,18,41,55,-14,42
RZ Pellets W,7254,7,10,9,17,42,55,-13,39
Admira Wacke,7254,8,9,10,17,35,61,-26,37
St. Pölten,7254,9,7,10,19,46,69,-23,31
SV Josko Rie,7254,10,8,6,22,33,57,-24,30
FC Salzburg,7255,1,20,7,9,67,35,32,67
SC Rheindorf,7255,2,17,10,9,52,43,9,61
Rapid Vienna,7255,3,16,11,9,58,36,22,59
SK Sturm Gra,7255,4,17,7,12,52,33,19,58
Vienna,7255,5,17,7,12,58,51,7,58
Admira Wacke,7255,6,12,8,16,39,54,-15,44
RZ Pellets W,7255,7,10,8,18,42,58,-16,38
SV Josko Rie,7255,8,9,10,17,36,52,-16,37
St. Pölten,7255,9,8,13,15,42,65,-23,37
Mattersburg,7255,10,8,11,17,41,60,-19,35
FC Salzburg,7256,1,23,8,5,72,27,45,77
SC Rheindorf,7256,2,18,10,8,49,35,14,64
SK Sturm Gra,7256,3,16,13,7,52,30,22,61
Vienna,7256,4,18,5,13,56,49,7,59
Rapid Vienna,7256,5,13,12,11,59,41,18,51
RZ Pellets W,7256,6,14,8,14,47,52,-5,50
SV Josko Rie,7256,7,10,6,20,34,58,-24,36
Admira Wacke,7256,8,10,6,20,32,61,-29,36
St. Pölten,7256,9,7,13,16,45,69,-24,34
Mattersburg,7256,10,6,9,21,38,62,-24,27
Vienna,7257,1,19,6,11,63,51,12,63
FC Salzburg,7257,2,18,8,10,58,37,21,62
SK Sturm Gra,7257,3,17,10,9,55,35,20,61
SC Rheindorf,7257,4,17,7,12,47,43,4,58
Rapid Vienna,7257,5,13,8,15,53,42,11,47
RZ Pellets W,7257,6,13,8,15,48,55,-7,47
Admira Wacke,7257,7,13,6,17,38,52,-14,45
Mattersburg,7257,8,11,9,16,46,56,-10,42
St. Pölten,7257,9,11,9,16,41,60,-19,42
SV Josko Rie,7257,10,10,5,21,34,52,-18,35
SK Sturm Gra,7258,1,20,7,9,65,34,31,67
FC Salzburg,7258,2,20,6,10,63,31,32,66
SC Rheindorf,7258,3,19,7,10,52,45,7,64
Vienna,7258,4,18,5,13,61,54,7,59
RZ Pellets W,7258,5,15,9,12,54,48,6,54
SV Josko Rie,7258,6,11,8,17,33,44,-11,41
Rapid Vienna,7258,7,9,13,14,48,43,5,40
Admira Wacke,7258,8,10,9,17,37,62,-25,39
Mattersburg,7258,9,9,8,19,35,60,-25,35
St. Pölten,7258,10,8,10,18,36,63,-27,34
FC Salzburg,7259,1,21,8,7,61,29,32,71
SC Rheindorf,7259,2,19,8,9,54,42,12,65
SK Sturm Gra,7259,3,20,4,12,61,35,26,64
Vienna,7259,4,19,5,12,59,52,7,62
Admira Wacke,7259,5,13,10,13,44,52,-8,49
Rapid Vienna,7259,6,11,12,13,52,43,9,45
RZ Pellets W,7259,7,11,7,18,49,64,-15,40
Mattersburg,7259,8,8,11,17,40,57,-17,35
St. Pölten,7259,9,7,12,17,46,68,-22,33
SV Josko Rie,7259,10,8,9,19,30,54,-24,33
FC Salzburg,7260,1,22,9,5,71,27,44,75
SC Rheindorf,7260,2,20,6,10,61,49,12,66
Rapid Vienna,7260,3,17,9,10,55,40,15,60
Vienna,7260,4,18,5,13,58,52,6,59
SK Sturm Gra,7260,5,15,7,14,50,37,13,52
RZ Pellets W,7260,6,14,5,17,41,54,-13,47
Admira Wacke,7260,7,12,6,18,39,60,-21,42
SV Josko Rie,7260,8,12,4,20,35,50,-15,40
St. Pölten,7260,9,9,8,19,44,62,-18,35
Mattersburg,7260,10,6,11,19,33,56,-23,29
FC Salzburg,7261,1,22,8,6,68,34,34,74
SK Sturm Gra,7261,2,20,7,9,59,34,25,67
SC Rheindorf,7261,3,17,10,9,54,41,13,61
Vienna,7261,4,17,6,13,65,63,2,57
Rapid Vienna,7261,5,15,10,11,56,39,17,55
RZ Pellets W,7261,6,12,8,16,42,55,-13,44
Admira Wacke,7261,7,11,8,17,50,58,-8,41
St. Pölten,7261,8,9,10,17,46,64,-18,37
Mattersburg,7261,9,7,12,17,42,58,-16,33
SV Josko Rie,7261,10,7,7,22,29,65,-36,28
FC Salzburg,7262,1,24,7,5,68,29,39,79
SC Rheindorf,7262,2,23,8,5,69,36,33,77
SK Sturm Gra,7262,3,22,7,7,62,35,27,73
Vienna,7262,4,15,4,17,58,60,-2,49
Rapid Vienna,7262,5,10,12,14,49,45,4,42
RZ Pellets W,7262,6,11,8,17,42,53,-11,41
St. Pölten,7262,7,10,10,16,38,55,-17,40
SV Josko Rie,7262,8,11,3,22,32,57,-25,36
Mattersburg,7262,9,8,9,19,42,57,-15,33
Admira Wacke,7262,10,9,6,21,31,64,-33,33
SC Rheindorf,7263,1,21,8,7,54,36,18,71
FC Salzburg,7263,2,21,5,10,64,32,32,68
SK Sturm Gra,7263,3,19,6,11,67,35,32,63
Vienna,7263,4,18,7,11,60,51,9,61
Rapid Vienna,7263,5,12,11,13,53,48,5,47
Admira Wacke,7263,6,13,6,17,42,61,-19,45
RZ Pellets W,7263,7,11,8,17,39,56,-17,41
St. Pölten,7263,8,11,7,18,43,62,-19,40
SV Josko Rie,7263,9,12,3,21,41,59,-18,39
Mattersburg,7263,10,6,11,19,40,63,-23,29
SC Rheindorf,7264,1,22,7,7,65,41,24,73
FC Salzburg,7264,2,19,9,8,65,32,33,66
SK Sturm Gra,7264,3,17,11,8,55,32,23,62
Vienna,7264,4,17,7,12,62,54,8,58
Rapid Vienna,7264,5,12,15,9,49,37,12,51
RZ Pellets W,7264,6,13,8,15,45,48,-3,47
Admira Wacke,7264,7,13,7,16,40,57,-17,46
SV Josko Rie,7264,8,10,7,19,37,54,-17,37
Mattersburg,7264,9,7,9,20,29,52,-23,30
St. Pölten,7264,10,5,10,21,32,72,-40,25
FC Salzburg,7265,1,23,7,6,74,31,43,76
SC Rheindorf,7265,2,22,5,9,62,42,20,71
SK Sturm Gra,7265,3,19,5,12,54,33,21,62
Rapid Vienna,7265,4,14,12,10,56,35,21,54
Vienna,7265,5,15,6,15,56,56,0,51
RZ Pellets W,7265,6,14,8,14,57,55,2,50
Admira Wacke,7265,7,13,6,17,34,58,-24,45
SV Josko Rie,7265,8,12,5,19,38,56,-18,41
Mattersburg,7265,9,6,9,21,36,65,-29,27
St. Pölten,7265,10,6,9,21,36,72,-36,27
FC Salzburg,7266,1,21,8,7,67,30,37,71
SK Sturm Gra,7266,2,20,6,10,57,31,26,66
SC Rheindorf,7266,3,19,8,9,57,39,18,65
Vienna,7266,4,18,3,15,62,58,4,57
Rapid Vienna,7266,5,14,9,13,53,38,15,51
St. Pölten,7266,6,12,9,15,45,59,-14,45
RZ Pellets W,7266,7,12,8,16,42,57,-15,44
SV Josko Rie,7266,8,10,5,21,36,55,-19,35
Mattersburg,7266,9,9,8,19,38,63,-25,35
Admira Wacke,7266,10,9,8,19,33,60,-27,35
SC Rheindorf,7267,1,22,5,9,63,44,19,71
FC Salzburg,7267,2,21,5,10,67,38,29,68
SK Sturm Gra,7267,3,18,9,9,61,30,31,63
Rapid Vienna,7267,4,17,10,9,60,37,23,61
Vienna,7267,5,18,5,13,65,59,6,59
RZ Pellets W,7267,6,12,7,17,43,57,-14,43
Admira Wacke,7267,7,11,7,18,34,57,-23,40
St. Pölten,7267,8,10,8,18,41,56,-15,38
SV Josko Rie,7267,9,10,4,22,30,57,-27,34
Mattersburg,7267,10,7,8,21,30,59,-29,29
FC Salzburg,7268,1,21,9,6,70,27,43,72
SC Rheindorf,7268,2,19,5,12,55,48,7,62
SK Sturm Gra,7268,3,18,7,11,55,35,20,61
Vienna,7268,4,19,3,14,60,58,2,60
Rapid Vienna,7268,5,14,10,12,59,43,16,52
SV Josko Rie,7268,6,14,8,14,42,47,-5,50
RZ Pellets W,7268,7,13,5,18,48,52,-4,44
St. Pölten,7268,8,9,13,14,47,65,-18,40
Admira Wacke,7268,9,8,8,20,35,68,-33,32
Mattersburg,7268,10,6,10,20,38,66,-28,28
FC Salzburg,7269,1,21,7,8,68,36,32,70
Vienna,7269,2,21,5,10,78,50,28,68
SC Rheindorf,7269,3,18,9,9,53,42,11,63
SK Sturm Gra,7269,4,17,11,8,59,32,27,62
Rapid Vienna,7269,5,10,15,11,49,41,8,45
Admira Wacke,7269,6,12,7,17,39,65,-26,43
SV Josko Rie,7269,7,11,5,20,33,53,-20,38
RZ Pellets W,7269,8,9,10,17,41,59,-18,37
Mattersburg,7269,9,9,9,18,39,56,-17,36
St. Pölten,7269,10,7,12,17,36,61,-25,33
FC Salzburg,7270,1,19,8,9,69,39,30,65
SC Rheindorf,7270,2,19,8,9,55,43,12,65
SK Sturm Gra,7270,3,19,6,11,54,38,16,63
Vienna,7270,4,17,4,15,58,55,3,55
Rapid Vienna,7270,5,13,9,14,52,44,8,48
Admira Wacke,7270,6,14,6,16,46,49,-3,48
Mattersburg,7270,7,13,9,14,45,48,-3,48
RZ Pellets W,7270,8,12,6,18,47,58,-11,42
SV Josko Rie,7270,9,10,7,19,36,57,-21,37
St. Pölten,7270,10,8,9,19,39,70,-31,33
FC Salzburg,7271,1,21,5,10,64,35,29,68
SC Rheindorf,7271,2,20,7,9,57,43,14,67
SK Sturm Gra,7271,3,20,6,10,57,32,25,66
Vienna,7271,4,18,3,15,55,48,7,57
Rapid Vienna,7271,5,14,13,9,57,40,17,55
RZ Pellets W,7271,6,15,6,15,50,55,-5,51
St. Pölten,7271,7,10,10,16,54,62,-8,40
Admira Wacke,7271,8,9,8,19,33,60,-27,35
SV Josko Rie,7271,9,9,6,21,34,64,-30,33
Mattersburg,7271,10,8,8,20,32,54,-22,32
SC Rheindorf,7272,1,21,9,6,52,33,19,72
FC Salzburg,7272,2,21,6,9,67,29,38,69
SK Sturm Gra,7272,3,21,6,9,59,33,26,69
Vienna,7272,4,19,4,13,63,57,6,61
Rapid Vienna,7272,5,13,12,11,54,36,18,51
RZ Pellets W,7272,6,12,8,16,42,54,-12,44
SV Josko Rie,7272,7,11,4,21,33,55,-22,37
St. Pölten,7272,8,8,11,17,43,64,-21,35
Admira Wacke,7272,9,10,5,21,33,60,-27,35
Mattersburg,7272,10,8,7,21,32,57,-25,31
FC Salzburg,7273,1,21,6,9,74,35,39,69
SK Sturm Gra,7273,2,20,6,10,65,37,28,66
SC Rheindorf,7273,3,18,10,8,55,42,13,64
Vienna,7273,4,19,6,11,63,51,12,63
Rapid Vienna,7273,5,12,13,11,56,45,11,49
Mattersburg,7273,6,12,7,17,48,54,-6,43
RZ Pellets W,7273,7,11,8,17,42,58,-16,41
Admira Wacke,7273,8,11,6,19,35,58,-23,39
SV Josko Rie,7273,9,11,5,20,40,58,-18,38
St. Pölten,7273,10,7,9,20,40,80,-40,30
FC Salzburg,7274,1,21,8,7,68,30,38,71
SK Sturm Gra,7274,2,20,7,9,64,35,29,67
SC Rheindorf,7274,3,18,10,8,54,41,13,64
Rapid Vienna,7274,4,15,10,11,54,40,14,55
Vienna,7274,5,15,8,13,59,53,6,53
RZ Pellets W,7274,6,12,9,15,40,50,-10,45
Admira Wacke,7274,7,13,6,17,36,50,-14,45
SV Josko Rie,7274,8,11,4,21,38,58,-20,37
Mattersburg,7274,9,9,9,18,39,64,-25,36
St. Pölten,7274,10,6,9,21,39,70,-31,27
FC Salzburg,7275,1,24,5,7,65,24,41,77
SK Sturm Gra,7275,2,19,7,10,57,38,19,64
SC Rheindorf,7275,3,19,7,10,55,37,18,64
Vienna,7275,4,18,5,13,64,55,9,59
Rapid Vienna,7275,5,13,11,12,64,47,17,50
RZ Pellets W,7275,6,14,7,15,53,56,-3,49
Admira Wacke,7275,7,11,6,19,45,74,-29,39
Mattersburg,7275,8,9,9,18,36,54,-18,36
SV Josko Rie,7275,9,10,5,21,33,60,-27,35
St. Pölten,7275,10,8,8,20,42,69,-27,32
FC Salzburg,7276,1,22,9,5,73,27,46,75
SC Rheindorf,7276,2,19,8,9,55,43,12,65
SK Sturm Gra,7276,3,18,9,9,59,36,23,63
Rapid Vienna,7276,4,17,7,12,60,41,19,58
Vienna,7276,5,15,8,13,61,53,8,53
RZ Pellets W,7276,6,14,9,13,55,56,-1,51
SV Josko Rie,7276,7,11,6,19,33,56,-23,39
Admira Wacke,7276,8,10,8,18,35,70,-35,38
St. Pölten,7276,9,8,9,19,36,58,-22,33
Mattersburg,7276,10,7,5,24,37,64,-27,26
FC Salzburg,7277,1,23,5,8,66,30,36,74
SC Rheindorf,7277,2,22,6,8,59,49,10,72
Rapid Vienna,7277,3,18,10,8,60,33,27,64
SK Sturm Gra,7277,4,17,5,14,50,35,15,56
Vienna,7277,5,15,6,15,57,59,-2,51
Admira Wacke,7277,6,12,7,17,35,54,-19,43
SV Josko Rie,7277,7,12,4,20,35,50,-15,40
RZ Pellets W,7277,8,10,9,17,44,58,-14,39
St. Pölten,7277,9,10,8,18,46,62,-16,38
Mattersburg,7277,10,8,6,22,33,55,-22,30
FC Salzburg,7278,1,20,5,11,59,31,28,65
Vienna,7278,2,19,6,11,67,54,13,63
SK Sturm Gra,7278,3,18,8,10,58,36,22,62
SC Rheindorf,7278,4,18,7,11,60,50,10,61
Rapid Vienna,7278,5,11,15,10,50,42,8,48
RZ Pellets W,7278,6,12,8,16,47,52,-5,44
Admira Wacke,7278,7,12,8,16,37,50,-13,44
SV Josko Rie,7278,8,13,2,21,36,58,-22,41
St. Pölten,7278,9,9,10,17,45,69,-24,37
Mattersburg,7278,10,8,11,17,39,56,-17,35
SC Rheindorf,7279,1,23,8,5,57,34,23,77
SK Sturm Gra,7279,2,20,6,10,60,37,23,66
FC Salzburg,7279,3,19,7,10,61,38,23,64
Rapid Vienna,7279,4,17,10,9,61,36,25,61
Vienna,7279,5,17,7,12,58,46,12,58
RZ Pellets W,7279,6,11,7,18,42,58,-16,40
Admira Wacke,7279,7,11,4,21,36,55,-19,37
St. Pölten,7279,8,9,9,18,40,58,-18,36
SV Josko Rie,7279,9,10,6,20,34,61,-27,36
Mattersburg,7279,10,7,8,21,36,62,-26,29
FC Salzburg,7280,1,22,6,8,66,32,34,72
SK Sturm Gra,7280,2,21,6,9,58,30,28,69
SC Rheindorf,7280,3,20,7,9,57,38,19,67
Vienna,7280,4,17,6,13,59,51,8,57
Rapid Vienna,7280,5,11,13,12,52,43,9,46
St. Pölten,7280,6,11,8,17,45,64,-19,41
SV Josko Rie,7280,7,11,6,19,38,56,-18,39
RZ Pellets W,7280,8,10,7,19,41,55,-14,37
Admira Wacke,7280,9,9,10,17,37,62,-25,37
Mattersburg,7280,10,8,11,17,36,58,-22,35
FC Salzburg,7281,1,21,8,7,63,30,33,71
SK Sturm Gra,7281,2,20,8,8,55,26,29,68
Vienna,7281,3,20,6,10,64,45,19,66
SC Rheindorf,7281,4,17,10,9,52,37,15,61
Rapid Vienna,7281,5,15,9,12,57,38,19,54
RZ Pellets W,7281,6,11,9,16,46,57,-11,42
Admira Wacke,7281,7,11,7,18,33,65,-32,40
Mattersburg,7281,8,10,8,18,43,61,-18,38
SV Josko Rie,7281,9,9,7,20,37,64,-27,34
St. Pölten,7281,10,5,10,21,36,63,-27,25
FC Salzburg,7282,1,23,7,6,64,26,38,76
SC Rheindorf,7282,2,19,8,9,54,38,16,65
SK Sturm Gra,7282,3,17,7,12,52,32,20,58
Vienna,7282,4,17,7,12,58,54,4,58
Rapid Vienna,7282,5,14,11,11,53,35,18,53
RZ Pellets W,7282,6,14,8,14,45,51,-6,50
SV Josko Rie,7282,7,11,7,18,38,53,-15,40
Admira Wacke,7282,8,10,6,20,34,60,-26,36
St. Pölten,7282,9,9,8,19,43,66,-23,35
Mattersburg,7282,10,7,9,20,36,62,-26,30
SK Sturm Gra,7283,1,22,5,9,60,30,30,71
FC Salzburg,7283,2,18,9,9,59,35,24,63
SC Rheindorf,7283,3,19,5,12,59,46,13,62
Rapid Vienna,7283,4,15,11,10,56,33,23,56
Vienna,7283,5,15,8,13,56,54,2,53
RZ Pellets W,7283,6,15,8,13,50,51,-1,53
SV Josko Rie,7283,7,11,5,20,37,54,-17,38
Admira Wacke,7283,8,10,8,18,33,59,-26,38
Mattersburg,7283,9,10,7,19,40,60,-20,37
St. Pölten,7283,10,8,8,20,38,66,-28,32
FC Salzburg,7284,1,22,6,8,74,32,42,72
SK Sturm Gra,7284,2,20,8,8,55,32,23,68
SC Rheindorf,7284,3,19,7,10,59,42,17,64
Vienna,7284,4,16,4,16,60,55,5,52
Rapid Vienna,7284,5,13,12,11,52,39,13,51
RZ Pellets W,7284,6,12,9,15,44,53,-9,45
SV Josko Rie,7284,7,13,5,18,39,51,-12,44
St. Pölten,7284,8,10,9,17,42,65,-23,39
Mattersburg,7284,9,10,5,21,34,57,-23,35
Admira Wacke,7284,10,8,9,19,37,70,-33,33
FC Salzburg,7285,1,22,8,6,65,27,38,74
Vienna,7285,2,21,4,11,62,50,12,67
SK Sturm Gra,7285,3,19,6,11,54,34,20,63
SC Rheindorf,7285,4,18,8,10,60,47,13,62
Rapid Vienna,7285,5,16,9,11,62,41,21,57
RZ Pellets W,7285,6,15,5,16,46,53,-7,50
Admira Wacke,7285,7,11,8,17,33,54,-21,41
SV Josko Rie,7285,8,9,6,21,31,57,-26,33
St. Pölten,7285,9,6,11,19,37,65,-28,29
Mattersburg,7285,10,6,9,21,38,60,-22,27
SK Sturm Gra,7286,1,21,6,9,54,29,25,69
FC Salzburg,7286,2,18,10,8,65,37,28,64
Vienna,7286,3,18,7,11,66,50,16,61
SC Rheindorf,7286,4,17,9,10,57,48,9,60
Rapid Vienna,7286,5,16,9,11,61,42,19,57
RZ Pellets W,7286,6,13,8,15,54,60,-6,47
Admira Wacke,7286,7,12,5,19,38,65,-27,41
Mattersburg,7286,8,9,9,18,38,59,-21,36
SV Josko Rie,7286,9,9,7,20,38,57,-19,34
St. Pölten,7286,10,7,10,19,37,61,-24,31
SC Rheindorf,7287,1,21,6,9,63,45,18,69
FC Salzburg,7287,2,19,9,8,60,33,27,66
Vienna,7287,3,18,5,13,59,49,10,59
RZ Pellets W,7287,4,16,9,11,54,49,5,57
SK Sturm Gra,7287,5,17,5,14,57,44,13,56
Rapid Vienna,7287,6,15,9,12,61,49,12,54
SV Josko Rie,7287,7,12,6,18,40,50,-10,42
Admira Wacke,7287,8,11,7,18,33,57,-24,40
Mattersburg,7287,9,8,8,20,38,62,-24,32
St. Pölten,7287,10,7,8,21,41,68,-27,29
FC Salzburg,7288,1,19,8,9,64,33,31,65
SK Sturm Gra,7288,2,19,5,12,51,36,15,62
Vienna,7288,3,19,5,12,67,56,11,62
Rapid Vienna,7288,4,17,10,9,58,38,20,61
SC Rheindorf,7288,5,18,7,11,65,53,12,61
Admira Wacke,7288,6,12,9,15,37,53,-16,45
RZ Pellets W,7288,7,11,7,18,46,60,-14,40
St. Pölten,7288,8,8,12,16,40,57,-17,36
SV Josko Rie,7288,9,9,9,18,36,56,-20,36
Mattersburg,7288,10,7,10,19,41,63,-22,31
SK Sturm Gra,7289,1,24,4,8,65,33,32,76
FC Salzburg,7289,2,21,5,10,67,29,38,68
Vienna,7289,3,21,3,12,65,51,14,66
SC Rheindorf,7289,4,16,9,11,50,45,5,57
Rapid Vienna,7289,5,16,8,12,56,40,16,56
SV Josko Rie,7289,6,13,5,18,33,52,-19,44
RZ Pellets W,7289,7,11,9,16,46,55,-9,42
St. Pölten,7289,8,10,7,19,41,64,-23,37
Admira Wacke,7289,9,11,4,21,35,62,-27,37
Mattersburg,7289,10,6,8,22,36,63,-27,26
SC Rheindorf,7290,1,23,6,7,61,39,22,75
FC Salzburg,7290,2,20,7,9,63,28,35,67
Vienna,7290,3,21,4,11,69,46,23,67
SK Sturm Gra,7290,4,20,5,11,62,36,26,65
Rapid Vienna,7290,5,13,13,10,56,44,12,52
RZ Pellets W,7290,6,11,8,17,45,57,-12,41
Admira Wacke,7290,7,11,5,20,36,67,-31,38
Mattersburg,7290,8,10,7,19,35,52,-17,37
SV Josko Rie,7290,9,11,3,22,33,58,-25,36
St. Pölten,7290,10,7,8,21,41,74,-33,29
FC Salzburg,7291,1,20,6,10,62,32,30,66
Vienna,7291,2,20,6,10,71,49,22,66
SC Rheindorf,7291,3,19,8,9,58,46,12,65
SK Sturm Gra,7291,4,17,7,12,53,37,16,58
Rapid Vienna,7291,5,16,9,11,58,39,19,57
Admira Wacke,7291,6,13,5,18,37,55,-18,44
Mattersburg,7291,7,10,8,18,41,58,-17,38
SV Josko Rie,7291,8,11,5,20,40,64,-24,38
St. Pölten,7291,9,9,10,17,37,61,-24,37
RZ Pellets W,7291,10,9,8,19,43,59,-16,35
SC Rheindorf,7292,1,22,5,9,67,39,28,71
SK Sturm Gra,7292,2,21,6,9,65,42,23,69
FC Salzburg,7292,3,20,6,10,61,32,29,66
Vienna,7292,4,20,2,14,72,59,13,62
Rapid Vienna,7292,5,15,10,11,53,38,15,55
RZ Pellets W,7292,6,14,5,17,52,55,-3,47
Admira Wacke,7292,7,13,4,19,41,64,-23,43
SV Josko Rie,7292,8,11,4,21,32,54,-22,37
Mattersburg,7292,9,10,5,21,34,59,-25,35
St. Pölten,7292,10,7,7,22,33,68,-35,28
FC Salzburg,7293,1,22,7,7,75,38,37,73
SC Rheindorf,7293,2,21,7,8,63,45,18,70
Rapid Vienna,7293,3,17,9,10,69,41,28,60
Vienna,7293,4,18,4,14,60,54,6,58
SK Sturm Gra,7293,5,17,6,13,59,41,18,57
RZ Pellets W,7293,6,12,7,17,44,58,-14,43
Admira Wacke,7293,7,11,5,20,37,63,-26,38
Mattersburg,7293,8,9,10,17,43,57,-14,37
St. Pölten,7293,9,9,8,19,46,73,-27,35
SV Josko Rie,7293,10,9,7,20,33,59,-26,34
SK Sturm Gra,7294,1,23,3,10,64,30,34,72
FC Salzburg,7294,2,21,8,7,65,31,34,71
SC Rheindorf,7294,3,21,8,7,56,36,20,71
Vienna,7294,4,16,9,11,56,49,7,57
RZ Pellets W,7294,5,12,7,17,43,57,-14,43
St. Pölten,7294,6,11,9,16,46,60,-14,42
Mattersburg,7294,7,10,10,16,40,53,-13,40
Rapid Vienna,7294,8,10,9,17,49,51,-2,39
Admira Wacke,7294,9,10,6,20,33,62,-29,36
SV Josko Rie,7294,10,8,7,21,32,55,-23,31
FC Salzburg,7295,1,23,7,6,64,24,40,76
SK Sturm Gra,7295,2,18,7,11,54,37,17,61
Rapid Vienna,7295,3,16,9,11,63,38,25,57
Vienna,7295,4,18,3,15,62,51,11,57
SC Rheindorf,7295,5,16,8,12,47,43,4,56
RZ Pellets W,7295,6,13,8,15,48,63,-15,47
Admira Wacke,7295,7,14,5,17,35,51,-16,47
St. Pölten,7295,8,9,9,18,46,63,-17,36
SV Josko Rie,7295,9,10,6,20,35,58,-23,36
Mattersburg,7295,10,8,8,20,33,59,-26,32
FC Salzburg,7296,1,23,8,5,69,28,41,77
SC Rheindorf,7296,2,20,8,8,56,37,19,68
SK Sturm Gra,7296,3,18,6,12,58,39,19,60
Vienna,7296,4,17,4,15,58,52,6,55
Rapid Vienna,7296,5,13,11,12,59,41,18,50
RZ Pellets W,7296,6,12,8,16,46,53,-7,44
SV Josko Rie,7296,7,11,7,18,32,48,-16,40
St. Pölten,7296,8,10,8,18,42,68,-26,38
Admira Wacke,7296,9,11,4,21,33,60,-27,37
Mattersburg,7296,10,10,6,20,39,66,-27,36
SK Sturm Gra,7297,1,21,7,8,59,26,33,70
FC Salzburg,7297,2,20,7,9,72,34,38,67
Vienna,7297,3,20,6,10,65,45,20,66
SC Rheindorf,7297,4,17,10,9,52,48,4,61
Rapid Vienna,7297,5,16,11,9,60,40,20,59
RZ Pellets W,7297,6,14,5,17,44,47,-3,47
SV Josko Rie,7297,7,11,3,22,42,62,-20,36
Admira Wacke,7297,8,10,6,20,36,69,-33,36
Mattersburg,7297,9,8,8,20,34,59,-25,32
St. Pölten,7297,10,8,7,21,41,75,-34,31
SK Sturm Gra,7298,1,23,5,8,74,29,45,74
FC Salzburg,7298,2,22,6,8,74,39,35,72
SC Rheindorf,7298,3,20,6,10,54,44,10,66
Vienna,7298,4,16,5,15,56,53,3,53
Admira Wacke,7298,5,15,8,13,42,52,-10,53
Rapid Vienna,7298,6,13,10,13,51,45,6,49
St. Pölten,7298,7,10,11,15,38,57,-19,41
RZ Pellets W,7298,8,11,7,18,46,64,-18,40
SV Josko Rie,7298,9,8,6,22,34,57,-23,30
Mattersburg,7298,10,6,8,22,41,70,-29,26
SC Rheindorf,7299,1,22,6,8,58,37,21,72
FC Salzburg,7299,2,20,9,7,65,30,35,69
SK Sturm Gra,7299,3,20,8,8,65,32,33,68
Vienna,7299,4,19,4,13,62,54,8,61
Rapid Vienna,7299,5,13,11,12,51,40,11,50
RZ Pellets W,7299,6,10,10,16,47,59,-12,40
St. Pölten,7299,7,9,12,15,42,55,-13,39
Admira Wacke,7299,8,11,5,20,33,62,-29,38
SV Josko Rie,7299,9,9,5,22,28,56,-28,32
Mattersburg,7299,10,7,10,19,38,64,-26,31
SK Sturm Gra,7300,1,22,6,8,62,29,33,72
FC Salzburg,7300,2,19,8,9,67,32,35,65
SC Rheindorf,7300,3,19,8,9,54,42,12,65
Vienna,7300,4,17,6,13,60,51,9,57
Rapid Vienna,7300,5,13,10,13,54,47,7,49
Admira Wacke,7300,6,13,7,16,42,65,-23,46
RZ Pellets W,7300,7,12,9,15,43,50,-7,45
St. Pölten,7300,8,9,13,14,38,53,-15,40
SV Josko Rie,7300,9,10,5,21,29,49,-20,35
Mattersburg,7300,10,7,6,23,36,67,-31,27
SC Rheindorf,7301,1,22,9,5,57,33,24,75
SK Sturm Gra,7301,2,19,9,8,61,30,31,66
FC Salzburg,7301,3,19,9,8,63,33,30,66
Vienna,7301,4,18,7,11,69,52,17,61
Rapid Vienna,7301,5,15,13,8,61,35,26,58
Admira Wacke,7301,6,12,9,15,40,51,-11,45
RZ Pellets W,7301,7,10,7,19,37,60,-23,37
SV Josko Rie,7301,8,9,5,22,32,66,-34,32
Mattersburg,7301,9,6,11,19,32,54,-22,29
St. Pölten,7301,10,5,11,20,32,70,-38,26
SK Sturm Gra,7302,1,24,3,9,62,31,31,75
FC Salzburg,7302,2,20,7,9,66,31,35,67
SC Rheindorf,7302,3,19,7,10,54,47,7,64
Vienna,7302,4,20,3,13,59,46,13,63
Rapid Vienna,7302,5,14,9,13,51,42,9,51
RZ Pellets W,7302,6,13,7,16,52,51,1,46
Admira Wacke,7302,7,12,4,20,36,56,-20,40
SV Josko Rie,7302,8,10,8,18,33,48,-15,38
Mattersburg,7302,9,8,9,19,38,60,-22,33
St. Pölten,7302,10,8,7,21,38,77,-39,31
FC Salzburg,7303,1,23,5,8,69,33,36,74
SC Rheindorf,7303,2,20,8,8,55,43,12,68
SK Sturm Gra,7303,3,20,7,9,59,32,27,67
Vienna,7303,4,15,7,14,64,54,10,52
Rapid Vienna,7303,5,13,10,13,51,39,12,49
SV Josko Rie,7303,6,12,6,18,32,50,-18,42
Mattersburg,7303,7,10,9,17,42,55,-13,39
RZ Pellets W,7303,8,11,6,19,43,59,-16,39
St. Pölten,7303,9,10,7,19,38,62,-24,37
Admira Wacke,7303,10,9,9,18,35,61,-26,36
SC Rheindorf,7304,1,22,8,6,63,32,31,74
SK Sturm Gra,7304,2,20,6,10,56,32,24,66
FC Salzburg,7304,3,18,9,9,62,30,32,63
Vienna,7304,4,16,4,16,61,66,-5,52
SV Josko Rie,7304,5,14,7,15,41,51,-10,49
Rapid Vienna,7304,6,12,10,14,49,47,2,46
RZ Pellets W,7304,7,12,7,17,44,55,-11,43
Mattersburg,7304,8,10,11,15,41,48,-7,41
Admira Wacke,7304,9,11,5,20,35,63,-28,38
St. Pölten,7304,10,7,9,20,38,66,-28,30
FC Salzburg,7305,1,25,5,6,77,27,50,80
SC Rheindorf,7305,2,18,9,9,47,36,11,63
SK Sturm Gra,7305,3,16,12,8,53,30,23,60
Vienna,7305,4,17,5,14,61,57,4,56
Rapid Vienna,7305,5,13,12,11,54,42,12,51
SV Josko Rie,7305,6,13,5,18,43,56,-13,44
Admira Wacke,7305,7,11,6,19,40,61,-21,39
RZ Pellets W,7305,8,9,10,17,45,63,-18,37
St. Pölten,7305,9,8,10,18,46,69,-23,34
Mattersburg,7305,10,8,10,18,41,66,-25,34
SC Rheindorf,7306,1,20,8,8,64,42,22,68
SK Sturm Gra,7306,2,21,4,11,59,38,21,67
FC Salzburg,7306,3,19,8,9,70,38,32,65
Vienna,7306,4,18,6,12,65,52,13,60
Rapid Vienna,7306,5,15,11,10,57,43,14,56
SV Josko Rie,7306,6,13,7,16,32,45,-13,46
RZ Pellets W,7306,7,12,9,15,50,55,-5,45
Admira Wacke,7306,8,10,9,17,35,60,-25,39
Mattersburg,7306,9,7,10,19,33,59,-26,31
St. Pölten,7306,10,5,8,23,37,70,-33,23
FC Salzburg,7307,1,21,9,6,67,26,41,72
SK Sturm Gra,7307,2,21,6,9,64,31,33,69
SC Rheindorf,7307,3,19,8,9,55,43,12,65
Rapid Vienna,7307,4,15,10,11,59,42,17,55
Vienna,7307,5,16,5,15,55,50,5,53
Admira Wacke,7307,6,11,8,17,36,60,-24,41
SV Josko Rie,7307,7,11,6,19,37,58,-21,39
RZ Pellets W,7307,8,11,5,20,41,58,-17,38
St. Pölten,7307,9,10,8,18,40,64,-24,38
Mattersburg,7307,10,9,7,20,38,60,-22,34
FC Salzburg,7308,1,19,10,7,65,33,32,67
SC Rheindorf,7308,2,19,7,10,55,38,17,64
SK Sturm Gra,7308,3,19,6,11,61,36,25,63
Vienna,7308,4,18,8,10,63,49,14,62
Rapid Vienna,7308,5,13,10,13,51,40,11,49
RZ Pellets W,7308,6,14,6,16,44,55,-11,48
SV Josko Rie,7308,7,12,4,20,35,57,-22,40
Mattersburg,7308,8,10,8,18,38,58,-20,38
St. Pölten,7308,9,10,8,18,49,70,-21,38
Admira Wacke,7308,10,10,5,21,39,64,-25,35
SC Rheindorf,7309,1,21,6,9,64,45,19,69
SK Sturm Gra,7309,2,20,7,9,62,35,27,67
FC Salzburg,7309,3,19,7,10,63,34,29,64
Vienna,7309,4,16,9,11,54,44,10,57
Rapid Vienna,7309,5,14,12,10,55,38,17,54
Admira Wacke,7309,6,13,9,14,38,49,-11,48
RZ Pellets W,7309,7,11,8,17,45,61,-16,41
SV Josko Rie,7309,8,9,7,20,31,58,-27,34
St. Pölten,7309,9,8,9,19,40,66,-26,33
Mattersburg,7309,10,6,12,18,34,56,-22,30
FC Salzburg,7310,1,22,7,7,65,33,32,73
SK Sturm Gra,7310,2,20,7,9,59,36,23,67
SC Rheindorf,7310,3,17,10,9,52,42,10,61
Vienna,7310,4,17,4,15,57,52,5,55
RZ Pellets W,7310,5,13,8,15,50,55,-5,47
Rapid Vienna,7310,6,11,10,15,47,43,4,43
St. Pölten,7310,7,11,10,15,46,56,-10,43
SV Josko Rie,7310,8,11,7,18,31,45,-14,40
Admira Wacke,7310,9,10,8,18,33,58,-25,38
Mattersburg,7310,10,8,9,19,33,53,-20,33
SC Rheindorf,7311,1,22,6,8,54,37,17,72
FC Salzburg,7311,2,20,9,7,62,29,33,69
SK Sturm Gra,7311,3,20,5,11,59,35,24,65
Vienna,7311,4,16,6,14,56,50,6,54
Admira Wacke,7311,5,16,5,15,43,52,-9,53
Rapid Vienna,7311,6,11,11,14,50,42,8,44
SV Josko Rie,7311,7,10,8,18,31,52,-21,38
RZ Pellets W,7311,8,9,10,17,37,56,-19,37
Mattersburg,7311,9,9,9,18,36,51,-15,36
St. Pölten,7311,10,8,9,19,42,66,-24,33
FC Salzburg,7312,1,25,6,5,85,33,52,81
SC Rheindorf,7312,2,19,6,11,57,46,11,63
Vienna,7312,3,20,3,13,66,56,10,63
SK Sturm Gra,7312,4,19,4,13,55,37,18,61
Admira Wacke,7312,5,13,7,16,37,56,-19,46
Rapid Vienna,7312,6,12,8,16,47,47,0,44
RZ Pellets W,7312,7,11,7,18,42,53,-11,40
St. Pölten,7312,8,11,7,18,37,60,-23,40
Mattersburg,7312,9,9,10,17,41,52,-11,37
SV Josko Rie,7312,10,10,4,22,33,60,-27,34
FC Salzburg,7313,1,23,6,7,70,28,42,75
SK Sturm Gra,7313,2,21,7,8,63,34,29,70
SC Rheindorf,7313,3,20,8,8,60,40,20,68
Vienna,7313,4,19,5,12,64,58,6,62
RZ Pellets W,7313,5,13,8,15,48,53,-5,47
Rapid Vienna,7313,6,11,13,12,56,46,10,46
SV Josko Rie,7313,7,9,7,20,30,60,-30,34
Mattersburg,7313,8,8,9,19,35,58,-23,33
St. Pölten,7313,9,7,11,18,47,65,-18,32
Admira Wacke,7313,10,8,8,20,35,66,-31,32
FC Salzburg,7314,1,20,7,9,63,32,31,67
Vienna,7314,2,20,5,11,68,53,15,65
SC Rheindorf,7314,3,18,9,9,51,39,12,63
SK Sturm Gra,7314,4,17,7,12,60,40,20,58
Rapid Vienna,7314,5,15,10,11,55,41,14,55
RZ Pellets W,7314,6,15,6,15,52,53,-1,51
SV Josko Rie,7314,7,12,6,18,41,52,-11,42
Admira Wacke,7314,8,10,10,16,38,62,-24,40
St. Pölten,7314,9,6,12,18,37,64,-27,30
Mattersburg,7314,10,7,8,21,36,65,-29,29
Vienna,7315,1,23,4,9,76,52,24,73
FC Salzburg,7315,2,21,7,8,73,41,32,70
SK Sturm Gra,7315,3,19,5,12,59,35,24,62
SC Rheindorf,7315,4,17,10,9,53,43,10,61
Rapid Vienna,7315,5,10,14,12,60,55,5,44
RZ Pellets W,7315,6,12,8,16,49,58,-9,44
SV Josko Rie,7315,7,12,6,18,37,50,-13,42
Admira Wacke,7315,8,10,7,19,39,63,-24,37
St. Pölten,7315,9,9,8,19,42,70,-28,35
Mattersburg,7315,10,8,9,19,30,51,-21,33
FC Salzburg,7316,1,23,4,9,71,35,36,73
SC Rheindorf,7316,2,22,5,9,60,39,21,71
SK Sturm Gra,7316,3,20,5,11,58,36,22,65
Rapid Vienna,7316,4,16,9,11,58,40,18,57
Vienna,7316,5,15,6,15,54,53,1,51
Admira Wacke,7316,6,14,7,15,42,56,-14,49
RZ Pellets W,7316,7,13,6,17,44,59,-15,45
Mattersburg,7316,8,11,5,20,43,58,-15,38
St. Pölten,7316,9,8,8,20,38,60,-22,32
SV Josko Rie,7316,10,9,3,24,31,63,-32,30
FC Salzburg,7317,1,21,7,8,67,34,33,70
SC Rheindorf,7317,2,20,8,8,56,36,20,68
SK Sturm Gra,7317,3,20,6,10,60,35,25,66
Vienna,7317,4,18,7,11,70,51,19,61
Rapid Vienna,7317,5,14,10,12,53,43,10,52
Admira Wacke,7317,6,13,5,18,41,57,-16,44
RZ Pellets W,7317,7,11,7,18,43,59,-16,40
SV Josko Rie,7317,8,11,4,21,32,55,-23,37
Mattersburg,7317,9,9,8,19,36,58,-22,35
St. Pölten,7317,10,8,8,20,34,64,-30,32
FC Salzburg,7318,1,21,8,7,62,27,35,71
SC Rheindorf,7318,2,21,8,7,60,38,22,71
SK Sturm Gra,7318,3,19,5,12,61,39,22,62
Vienna,7318,4,19,4,13,69,65,4,61
Rapid Vienna,7318,5,13,9,14,52,45,7,48
RZ Pellets W,7318,6,13,7,16,46,54,-8,46
Mattersburg,7318,7,12,7,17,44,49,-5,43
Admira Wacke,7318,8,11,5,20,35,57,-22,38
SV Josko Rie,7318,9,12,2,22,33,58,-25,38
St. Pölten,7318,10,7,9,20,37,67,-30,30
SK Sturm Gra,7319,1,20,7,9,64,37,27,67
SC Rheindorf,7319,2,19,8,9,53,44,9,65
FC Salzburg,7319,3,18,10,8,61,34,27,64
Vienna,7319,4,18,8,10,70,50,20,62
Rapid Vienna,7319,5,15,8,13,57,41,16,53
RZ Pellets W,7319,6,13,5,18,46,59,-13,44
Admira Wacke,7319,7,12,6,18,45,60,-15,42
SV Josko Rie,7319,8,11,5,20,39,56,-17,38
Mattersburg,7319,9,8,10,18,34,58,-24,34
St. Pölten,7319,10,9,7,20,40,70,-30,34
Vienna,7320,1,20,6,10,70,48,22,66
SC Rheindorf,7320,2,19,5,12,56,52,4,62
SK Sturm Gra,7320,3,18,7,11,56,40,16,61
FC Salzburg,7320,4,17,8,11,56,41,15,59
Rapid Vienna,7320,5,15,11,10,60,37,23,56
Admira Wacke,7320,6,14,7,15,40,52,-12,49
RZ Pellets W,7320,7,12,7,17,46,62,-16,43
St. Pölten,7320,8,11,8,17,49,59,-10,41
SV Josko Rie,7320,9,11,7,18,37,54,-17,40
Mattersburg,7320,10,7,6,23,35,60,-25,27
SC Rheindorf,7321,1,23,6,7,64,41,23,75
SK Sturm Gra,7321,2,19,7,10,60,35,25,64
FC Salzburg,7321,3,17,11,8,55,29,26,62
Vienna,7321,4,19,5,12,62,45,17,62
Rapid Vienna,7321,5,16,10,10,59,43,16,58
RZ Pellets W,7321,6,11,9,16,44,58,-14,42
SV Josko Rie,7321,7,12,4,20,37,58,-21,40
St. Pölten,7321,8,10,7,19,39,65,-26,37
Admira Wacke,7321,9,9,8,19,36,61,-25,35
Mattersburg,7321,10,5,11,20,37,58,-21,26
FC Salzburg,7322,1,20,9,7,65,33,32,69
SK Sturm Gra,7322,2,19,7,10,63,36,27,64
SC Rheindorf,7322,3,17,8,11,56,48,8,59
Vienna,7322,4,17,6,13,66,55,11,57
RZ Pellets W,7322,5,15,8,13,51,48,3,53
Rapid Vienna,7322,6,13,11,12,59,46,13,50
Mattersburg,7322,7,12,9,15,42,51,-9,45
SV Josko Rie,7322,8,13,3,20,40,59,-19,42
Admira Wacke,7322,9,9,7,20,34,62,-28,34
St. Pölten,7322,10,6,10,20,39,77,-38,28
FC Salzburg,7323,1,21,6,9,67,31,36,69
Vienna,7323,2,18,8,10,67,54,13,62
SC Rheindorf,7323,3,18,8,10,51,45,6,62
SK Sturm Gra,7323,4,18,7,11,61,37,24,61
Rapid Vienna,7323,5,15,9,12,57,41,16,54
RZ Pellets W,7323,6,13,9,14,57,58,-1,48
SV Josko Rie,7323,7,13,5,18,37,52,-15,44
Admira Wacke,7323,8,10,7,19,37,69,-32,37
St. Pölten,7323,9,7,12,17,47,66,-19,33
Mattersburg,7323,10,7,9,20,37,65,-28,30
SC Rheindorf,7324,1,21,9,6,62,39,23,72
FC Salzburg,7324,2,21,7,8,60,30,30,70
Vienna,7324,3,18,6,12,57,53,4,60
SK Sturm Gra,7324,4,18,5,13,55,33,22,59
Rapid Vienna,7324,5,16,10,10,63,39,24,58
Admira Wacke,7324,6,14,4,18,38,55,-17,46
RZ Pellets W,7324,7,10,10,16,43,57,-14,40
SV Josko Rie,7324,8,10,5,21,33,56,-23,35
Mattersburg,7324,9,9,7,20,38,56,-18,34
St. Pölten,7324,10,7,9,20,34,65,-31,30
FC Salzburg,7325,1,21,7,8,67,32,35,70
SC Rheindorf,7325,2,21,5,10,63,43,20,68
SK Sturm Gra,7325,3,19,6,11,67,41,26,63
Rapid Vienna,7325,4,15,11,10,59,37,22,56
Vienna,7325,5,16,5,15,57,57,0,53
RZ Pellets W,7325,6,13,8,15,40,50,-10,47
Admira Wacke,7325,7,13,5,18,41,65,-24,44
SV Josko Rie,7325,8,11,9,16,40,50,-10,42
St. Pölten,7325,9,9,9,18,50,69,-19,36
Mattersburg,7325,10,5,9,22,32,72,-40,24
SC Rheindorf,7326,1,22,5,9,58,40,18,71
FC Salzburg,7326,2,19,7,10,58,28,30,64
Vienna,7326,3,20,3,13,61,47,14,63
SK Sturm Gra,7326,4,18,5,13,58,43,15,59
Rapid Vienna,7326,5,14,9,13,55,44,11,51
RZ Pellets W,7326,6,14,8,14,47,50,-3,50
SV Josko Rie,7326,7,14,3,19,35,52,-17,45
Admira Wacke,7326,8,11,5,20,37,58,-21,38
St. Pölten,7326,9,9,9,18,39,60,-21,36
Mattersburg,7326,10,8,8,20,33,59,-26,32
FC Salzburg,7327,1,23,6,7,74,36,38,75
SC Rheindorf,7327,2,20,9,7,54,38,16,69
SK Sturm Gra,7327,3,19,8,9,62,33,29,65
Vienna,7327,4,18,6,12,56,50,6,60
Rapid Vienna,7327,5,12,10,14,56,48,8,46
SV Josko Rie,7327,6,13,5,18,41,57,-16,44
RZ Pellets W,7327,7,11,10,15,46,54,-8,43
St. Pölten,7327,8,9,10,17,44,61,-17,37
Admira Wacke,7327,9,9,6,21,32,61,-29,33
Mattersburg,7327,10,6,10,20,34,61,-27,28
SC Rheindorf,7328,1,19,7,10,52,42,10,64
FC Salzburg,7328,2,18,9,9,62,33,29,63
Vienna,7328,3,20,3,13,59,51,8,63
Rapid Vienna,7328,4,17,11,8,71,37,34,62
SK Sturm Gra,7328,5,18,6,12,53,35,18,60
RZ Pellets W,7328,6,13,8,15,43,49,-6,47
St. Pölten,7328,7,11,7,18,45,69,-24,40
Admira Wacke,7328,8,11,7,18,32,59,-27,40
SV Josko Rie,7328,9,10,7,19,35,52,-17,37
Mattersburg,7328,10,7,7,22,35,60,-25,28
SC Rheindorf,7329,1,21,6,9,61,42,19,69
SK Sturm Gra,7329,2,20,4,12,60,43,17,64
FC Salzburg,7329,3,17,9,10,55,35,20,60
Vienna,7329,4,18,6,12,67,55,12,60
Rapid Vienna,7329,5,15,11,10,60,41,19,56
Admira Wacke,7329,6,14,6,16,42,57,-15,48
RZ Pellets W,7329,7,11,11,14,48,56,-8,44
SV Josko Rie,7329,8,11,5,20,41,59,-18,38
St. Pölten,7329,9,9,7,20,43,67,-24,34
Mattersburg,7329,10,7,9,20,33,55,-22,30
FC Salzburg,7330,1,22,7,7,58,25,33,73
SC Rheindorf,7330,2,21,9,6,60,38,22,72
SK Sturm Gra,7330,3,20,5,11,66,37,29,65
Vienna,7330,4,18,7,11,59,48,11,61
Rapid Vienna,7330,5,12,11,13,53,45,8,47
Admira Wacke,7330,6,11,8,17,40,55,-15,41
St. Pölten,7330,7,11,8,17,43,66,-23,41
RZ Pellets W,7330,8,9,11,16,37,58,-21,38
SV Josko Rie,7330,9,8,7,21,39,59,-20,31
Mattersburg,7330,10,8,7,21,33,57,-24,31
FC Salzburg,7331,1,24,7,5,73,27,46,79
SK Sturm Gra,7331,2,20,7,9,63,35,28,67
SC Rheindorf,7331,3,20,7,9,59,45,14,67
Vienna,7331,4,18,5,13,59,51,8,59
Rapid Vienna,7331,5,12,11,13,52,42,10,47
St. Pölten,7331,6,11,11,14,39,53,-14,44
Admira Wacke,7331,7,12,4,20,38,59,-21,40
SV Josko Rie,7331,8,10,7,19,31,55,-24,37
RZ Pellets W,7331,9,9,5,22,41,63,-22,32
Mattersburg,7331,10,8,8,20,36,61,-25,32
FC Salzburg,7332,1,23,7,6,65,29,36,76
SC Rheindorf,7332,2,19,7,10,55,45,10,64
Vienna,7332,3,18,6,12,66,54,12,60
SK Sturm Gra,7332,4,17,7,12,54,35,19,58
Rapid Vienna,7332,5,12,15,9,51,35,16,51
Admira Wacke,7332,6,12,10,14,45,61,-16,46
RZ Pellets W,7332,7,11,8,17,46,58,-12,41
Mattersburg,7332,8,10,6,20,32,53,-21,36
SV Josko Rie,7332,9,9,7,20,31,51,-20,34
St. Pölten,7332,10,8,9,19,37,61,-24,33
SC Rheindorf,7333,1,23,7,6,61,39,22,76
FC Salzburg,7333,2,22,7,7,63,29,34,73
Vienna,7333,3,18,8,10,62,45,17,62
SK Sturm Gra,7333,4,18,5,13,54,39,15,59
Rapid Vienna,7333,5,13,12,11,58,41,17,51
Admira Wacke,7333,6,10,10,16,31,51,-20,40
Mattersburg,7333,7,10,8,18,40,55,-15,38
St. Pölten,7333,8,8,11,17,40,60,-20,35
SV Josko Rie,7333,9,9,6,21,36,58,-22,33
RZ Pellets W,7333,10,9,6,21,36,64,-28,33
SC Rheindorf,7334,1,20,8,8,55,43,12,68
FC Salzburg,7334,2,18,10,8,57,30,27,64
SK Sturm Gra,7334,3,18,6,12,59,36,23,60
Vienna,7334,4,19,3,14,58,52,6,60
Rapid Vienna,7334,5,14,10,12,57,39,18,52
Admira Wacke,7334,6,15,7,14,45,53,-8,52
RZ Pellets W,7334,7,13,7,16,43,56,-13,46
Mattersburg,7334,8,10,7,19,35,50,-15,37
SV Josko Rie,7334,9,9,5,22,30,55,-25,32
St. Pölten,7334,10,6,13,17,37,62,-25,31
SC Rheindorf,7335,1,20,10,6,63,42,21,70
FC Salzburg,7335,2,18,11,7,65,34,31,65
Rapid Vienna,7335,3,16,13,7,64,39,25,61
SK Sturm Gra,7335,4,18,7,11,57,34,23,61
Vienna,7335,5,17,9,10,59,48,11,60
SV Josko Rie,7335,6,12,4,20,32,50,-18,40
Admira Wacke,7335,7,10,8,18,37,61,-24,38
RZ Pellets W,7335,8,10,7,19,42,62,-20,37
St. Pölten,7335,9,9,7,20,47,71,-24,34
Mattersburg,7335,10,6,12,18,36,61,-25,30
FC Salzburg,7336,1,19,9,8,64,35,29,66
SC Rheindorf,7336,2,18,8,10,57,46,11,62
RZ Pellets W,7336,3,18,6,12,56,48,8,60
SK Sturm Gra,7336,4,15,10,11,55,37,18,55
Rapid Vienna,7336,5,15,10,11,58,41,17,55
Vienna,7336,6,15,9,12,54,50,4,54
St. Pölten,7336,7,10,9,17,43,62,-19,39
Admira Wacke,7336,8,10,9,17,38,58,-20,39
SV Josko Rie,7336,9,9,8,19,33,52,-19,35
Mattersburg,7336,10,8,8,20,35,64,-29,32
FC Salzburg,7337,1,21,6,9,67,39,28,69
SK Sturm Gra,7337,2,20,7,9,55,27,28,67
Vienna,7337,3,18,5,13,70,53,17,59
SC Rheindorf,7337,4,16,9,11,55,47,8,57
RZ Pellets W,7337,5,16,6,14,44,50,-6,54
Rapid Vienna,7337,6,11,14,11,49,44,5,47
Admira Wacke,7337,7,12,8,16,44,63,-19,44
SV Josko Rie,7337,8,11,7,18,39,59,-20,40
St. Pölten,7337,9,7,11,18,47,68,-21,32
Mattersburg,7337,10,8,7,21,38,58,-20,31
FC Salzburg,7338,1,21,8,7,65,30,35,71
Vienna,7338,2,22,4,10,65,45,20,70
SC Rheindorf,7338,3,18,8,10,48,38,10,62
SK Sturm Gra,7338,4,17,8,11,58,34,24,59
Rapid Vienna,7338,5,15,8,13,54,41,13,53
Admira Wacke,7338,6,13,7,16,36,51,-15,46
RZ Pellets W,7338,7,12,4,20,42,62,-20,40
St. Pölten,7338,8,8,11,17,38,61,-23,35
SV Josko Rie,7338,9,9,7,20,36,58,-22,34
Mattersburg,7338,10,9,7,20,33,55,-22,34
FC Salzburg,7339,1,22,7,7,62,29,33,73
SC Rheindorf,7339,2,21,8,7,57,35,22,71
SK Sturm Gra,7339,3,19,6,11,63,36,27,63
Vienna,7339,4,19,6,11,63,45,18,63
Rapid Vienna,7339,5,13,12,11,51,40,11,51
RZ Pellets W,7339,6,15,4,17,43,57,-14,49
Mattersburg,7339,7,9,8,19,31,51,-20,35
Admira Wacke,7339,8,9,8,19,35,62,-27,35
St. Pölten,7339,9,8,10,18,45,68,-23,34
SV Josko Rie,7339,10,8,5,23,34,61,-27,29
FC Salzburg,7340,1,18,13,5,57,26,31,67
SC Rheindorf,7340,2,18,11,7,57,38,19,65
SK Sturm Gra,7340,3,19,7,10,60,33,27,64
Vienna,7340,4,19,6,11,64,54,10,63
Rapid Vienna,7340,5,13,12,11,47,38,9,51
RZ Pellets W,7340,6,11,13,12,49,52,-3,46
Admira Wacke,7340,7,11,8,17,33,57,-24,41
SV Josko Rie,7340,8,10,8,18,36,54,-18,38
Mattersburg,7340,9,8,10,18,39,51,-12,34
St. Pölten,7340,10,5,8,23,34,73,-39,23
FC Salzburg,7341,1,24,5,7,74,25,49,77
SK Sturm Gra,7341,2,18,9,9,61,32,29,63
SC Rheindorf,7341,3,18,8,10,48,44,4,62
Vienna,7341,4,17,5,14,63,51,12,56
Rapid Vienna,7341,5,14,11,11,55,39,16,53
RZ Pellets W,7341,6,13,7,16,43,56,-13,46
SV Josko Rie,7341,7,13,5,18,40,57,-17,44
Admira Wacke,7341,8,10,6,20,34,63,-29,36
Mattersburg,7341,9,7,12,17,34,53,-19,33
St. Pölten,7341,10,8,8,20,32,64,-32,32
SK Sturm Gra,7342,1,21,6,9,59,30,29,69
FC Salzburg,7342,2,20,7,9,64,33,31,67
SC Rheindorf,7342,3,20,7,9,60,41,19,67
Vienna,7342,4,20,4,12,63,50,13,64
Rapid Vienna,7342,5,13,10,13,55,42,13,49
RZ Pellets W,7342,6,14,7,15,44,50,-6,49
Admira Wacke,7342,7,13,4,19,42,68,-26,43
St. Pölten,7342,8,8,11,17,45,66,-21,35
Mattersburg,7342,9,8,8,20,38,59,-21,32
SV Josko Rie,7342,10,9,4,23,30,61,-31,31
FC Salzburg,7343,1,23,7,6,61,27,34,76
SC Rheindorf,7343,2,19,7,10,57,42,15,64
Vienna,7343,3,19,6,11,60,50,10,63
SK Sturm Gra,7343,4,18,7,11,53,35,18,61
Rapid Vienna,7343,5,13,10,13,58,47,11,49
St. Pölten,7343,6,11,10,15,47,58,-11,43
SV Josko Rie,7343,7,12,6,18,39,53,-14,42
RZ Pellets W,7343,8,10,9,17,44,60,-16,39
Mattersburg,7343,9,8,9,19,35,55,-20,33
Admira Wacke,7343,10,10,3,23,39,66,-27,33
SK Sturm Gra,7344,1,21,5,10,60,32,28,68
FC Salzburg,7344,2,20,7,9,60,33,27,67
SC Rheindorf,7344,3,18,8,10,54,44,10,62
Vienna,7344,4,17,9,10,57,41,16,60
Rapid Vienna,7344,5,16,9,11,64,46,18,57
Admira Wacke,7344,6,13,7,16,43,58,-15,46
RZ Pellets W,7344,7,12,6,18,42,57,-15,42
SV Josko Rie,7344,8,11,7,18,37,52,-15,40
St. Pölten,7344,9,6,12,18,37,64,-27,30
Mattersburg,7344,10,7,8,21,31,58,-27,29
FC Salzburg,7345,1,18,12,6,62,32,30,66
SC Rheindorf,7345,2,18,11,7,54,37,17,65
SK Sturm Gra,7345,3,18,8,10,55,32,23,62
Vienna,7345,4,16,8,12,57,55,2,56
Rapid Vienna,7345,5,12,12,12,53,44,9,48
Mattersburg,7345,6,13,6,17,37,48,-11,45
RZ Pellets W,7345,7,11,10,15,43,53,-10,43
Admira Wacke,7345,8,11,10,15,35,51,-16,43
SV Josko Rie,7345,9,9,8,19,37,55,-18,35
St. Pölten,7345,10,5,13,18,43,69,-26,28
FC Salzburg,7346,1,23,6,7,60,23,37,75
SK Sturm Gra,7346,2,21,6,9,65,35,30,69
Vienna,7346,3,21,6,9,63,50,13,69
SC Rheindorf,7346,4,19,6,11,51,41,10,63
Rapid Vienna,7346,5,14,9,13,54,42,12,51
Mattersburg,7346,6,11,7,18,39,51,-12,40
SV Josko Rie,7346,7,10,7,19,36,50,-14,37
Admira Wacke,7346,8,10,7,19,37,60,-23,37
RZ Pellets W,7346,9,9,7,20,40,69,-29,34
St. Pölten,7346,10,7,9,20,39,63,-24,30
SC Rheindorf,7347,1,19,10,7,57,41,16,67
Vienna,7347,2,20,5,11,67,52,15,65
Rapid Vienna,7347,3,18,9,9,60,33,27,63
FC Salzburg,7347,4,18,6,12,64,35,29,60
SK Sturm Gra,7347,5,18,6,12,59,36,23,60
RZ Pellets W,7347,6,16,6,14,50,53,-3,54
SV Josko Rie,7347,7,14,3,19,39,55,-16,45
Admira Wacke,7347,8,9,4,23,31,69,-38,31
Mattersburg,7347,9,6,12,18,33,56,-23,30
St. Pölten,7347,10,7,9,20,38,68,-30,30
FC Salzburg,7348,1,18,11,7,68,40,28,65
SK Sturm Gra,7348,2,18,8,10,57,32,25,62
Vienna,7348,3,17,8,11,71,49,22,59
SC Rheindorf,7348,4,15,10,11,47,48,-1,55
Rapid Vienna,7348,5,13,11,12,59,42,17,50
RZ Pellets W,7348,6,13,7,16,48,66,-18,46
Admira Wacke,7348,7,13,7,16,41,59,-18,46
St. Pölten,7348,8,9,12,15,48,60,-12,39
Mattersburg,7348,9,10,8,18,45,59,-14,38
SV Josko Rie,7348,10,10,6,20,32,61,-29,36
SC Rheindorf,7349,1,21,6,9,54,41,13,69
FC Salzburg,7349,2,19,10,7,62,30,32,67
Vienna,7349,3,18,7,11,61,51,10,61
SK Sturm Gra,7349,4,17,7,12,55,38,17,58
Rapid Vienna,7349,5,16,9,11,66,39,27,57
RZ Pellets W,7349,6,14,9,13,56,57,-1,51
Admira Wacke,7349,7,12,7,17,44,63,-19,43
Mattersburg,7349,8,9,8,19,37,58,-21,35
SV Josko Rie,7349,9,8,8,20,35,55,-20,32
St. Pölten,7349,10,6,9,21,38,76,-38,27
FC Salzburg,7350,1,21,7,8,68,30,38,70
SC Rheindorf,7350,2,20,8,8,59,42,17,68
SK Sturm Gra,7350,3,18,3,15,51,41,10,57
Vienna,7350,4,15,8,13,63,61,2,53
Admira Wacke,7350,5,15,7,14,47,61,-14,52
Rapid Vienna,7350,6,12,10,14,56,45,11,46
Mattersburg,7350,7,11,10,15,41,50,-9,43
St. Pölten,7350,8,12,7,17,49,67,-18,43
RZ Pellets W,7350,9,11,9,16,48,55,-7,42
SV Josko Rie,7350,10,8,5,23,33,63,-30,29
FC Salzburg,7351,1,24,6,6,71,25,46,78
SC Rheindorf,7351,2,19,9,8,59,45,14,66
SK Sturm Gra,7351,3,17,7,12,55,37,18,58
Vienna,7351,4,16,7,13,63,54,9,55
RZ Pellets W,7351,5,14,8,14,57,65,-8,50
Rapid Vienna,7351,6,12,11,13,50,46,4,47
Admira Wacke,7351,7,12,6,18,40,61,-21,42
St. Pölten,7351,8,8,13,15,38,59,-21,37
Mattersburg,7351,9,9,9,18,36,52,-16,36
SV Josko Rie,7351,10,7,8,21,30,55,-25,29
SK Sturm Gra,7352,1,21,6,9,58,31,27,69
FC Salzburg,7352,2,19,10,7,62,30,32,67
SC Rheindorf,7352,3,20,7,9,46,33,13,67
Vienna,7352,4,18,7,11,63,47,16,61
Admira Wacke,7352,5,14,6,16,42,57,-15,48
Rapid Vienna,7352,6,10,10,16,45,46,-1,40
RZ Pellets W,7352,7,11,7,18,43,59,-16,40
Mattersburg,7352,8,10,8,18,40,56,-16,38
St. Pölten,7352,9,10,8,18,37,56,-19,38
SV Josko Rie,7352,10,9,7,20,27,48,-21,34
FC Salzburg,7353,1,23,8,5,74,32,42,77
SC Rheindorf,7353,2,21,6,9,58,43,15,69
Vienna,7353,3,18,3,15,63,55,8,57
SK Sturm Gra,7353,4,17,5,14,54,41,13,56
RZ Pellets W,7353,5,15,6,15,51,58,-7,51
Rapid Vienna,7353,6,14,8,14,58,48,10,50
Mattersburg,7353,7,11,10,15,46,52,-6,43
Admira Wacke,7353,8,11,5,20,33,55,-22,38
SV Josko Rie,7353,9,11,4,21,39,63,-24,37
St. Pölten,7353,10,8,7,21,47,76,-29,31
SK Sturm Gra,7354,1,20,8,8,70,32,38,68
FC Salzburg,7354,2,19,10,7,69,35,34,67
SC Rheindorf,7354,3,18,8,10,60,49,11,62
Vienna,7354,4,17,7,12,60,57,3,58
Rapid Vienna,7354,5,14,11,11,58,42,16,53
RZ Pellets W,7354,6,13,7,16,52,61,-9,46
Mattersburg,7354,7,11,6,19,42,64,-22,39
Admira Wacke,7354,8,10,9,17,40,67,-27,39
SV Josko Rie,7354,9,9,7,20,32,50,-18,34
St. Pölten,7354,10,8,9,19,44,70,-26,33
Vienna,7355,1,21,5,10,69,46,23,68
SC Rheindorf,7355,2,20,7,9,57,38,19,67
FC Salzburg,7355,3,19,8,9,67,40,27,65
SK Sturm Gra,7355,4,17,8,11,57,39,18,59
RZ Pellets W,7355,5,15,8,13,52,53,-1,53
Rapid Vienna,7355,6,14,9,13,55,46,9,51
Admira Wacke,7355,7,13,5,18,38,55,-17,44
St. Pölten,7355,8,9,10,17,40,62,-22,37
Mattersburg,7355,9,8,7,21,36,62,-26,31
SV Josko Rie,7355,10,9,3,24,33,63,-30,30
FC Salzburg,7356,1,22,4,10,69,36,33,70
SK Sturm Gra,7356,2,20,5,11,60,40,20,65
SC Rheindorf,7356,3,19,7,10,57,40,17,64
Vienna,7356,4,18,4,14,61,50,11,58
Rapid Vienna,7356,5,15,10,11,54,41,13,55
RZ Pellets W,7356,6,12,8,16,49,60,-11,44
SV Josko Rie,7356,7,13,4,19,34,49,-15,43
Mattersburg,7356,8,10,7,19,39,54,-15,37
Admira Wacke,7356,9,10,7,19,39,65,-26,37
St. Pölten,7356,10,8,10,18,41,68,-27,34
FC Salzburg,7357,1,19,11,6,69,37,32,68
SC Rheindorf,7357,2,20,6,10,55,40,15,66
SK Sturm Gra,7357,3,19,8,9,59,35,24,65
Vienna,7357,4,18,4,14,61,54,7,58
Rapid Vienna,7357,5,15,11,10,56,41,15,56
RZ Pellets W,7357,6,13,5,18,45,53,-8,44
SV Josko Rie,7357,7,12,5,19,34,54,-20,41
Admira Wacke,7357,8,10,7,19,37,61,-24,37
St. Pölten,7357,9,9,9,18,36,60,-24,36
Mattersburg,7357,10,7,10,19,39,56,-17,31
FC Salzburg,7358,1,21,10,5,60,23,37,73
SK Sturm Gra,7358,2,19,10,7,55,28,27,67
SC Rheindorf,7358,3,17,10,9,51,41,10,61
Vienna,7358,4,18,5,13,60,47,13,59
Rapid Vienna,7358,5,13,10,13,50,40,10,49
RZ Pellets W,7358,6,13,10,13,47,49,-2,49
Admira Wacke,7358,7,12,7,17,37,56,-19,43
St. Pölten,7358,8,9,9,18,40,65,-25,36
SV Josko Rie,7358,9,9,7,20,35,56,-21,34
Mattersburg,7358,10,7,6,23,32,62,-30,27
SC Rheindorf,7359,1,23,6,7,65,39,26,75
FC Salzburg,7359,2,21,9,6,68,27,41,72
SK Sturm Gra,7359,3,21,7,8,60,31,29,70
Rapid Vienna,7359,4,16,11,9,60,37,23,59
Vienna,7359,5,15,4,17,59,64,-5,49
SV Josko Rie,7359,6,11,5,20,35,54,-19,38
Admira Wacke,7359,7,11,5,20,39,66,-27,38
Mattersburg,7359,8,9,9,18,39,57,-18,36
RZ Pellets W,7359,9,9,9,18,36,56,-20,36
St. Pölten,7359,10,7,9,20,40,70,-30,30
SK Sturm Gra,7360,1,19,8,9,58,34,24,65
SC Rheindorf,7360,2,18,11,7,56,44,12,65
FC Salzburg,7360,3,18,10,8,64,39,25,64
Vienna,7360,4,19,3,14,58,45,13,60
Rapid Vienna,7360,5,13,12,11,56,42,14,51
RZ Pellets W,7360,6,14,5,17,44,51,-7,47
Admira Wacke,7360,7,13,8,15,37,54,-17,47
SV Josko Rie,7360,8,10,7,19,32,47,-15,37
St. Pölten,7360,9,10,7,19,38,59,-21,37
Mattersburg,7360,10,6,9,21,34,62,-28,27
FC Salzburg,7361,1,24,6,6,73,32,41,78
SC Rheindorf,7361,2,20,8,8,56,39,17,68
SK Sturm Gra,7361,3,18,9,9,55,32,23,63
Vienna,7361,4,17,8,11,64,50,14,59
Rapid Vienna,7361,5,13,13,10,52,35,17,52
Admira Wacke,7361,6,11,6,19,39,63,-24,39
RZ Pellets W,7361,7,10,8,18,41,61,-20,38
Mattersburg,7361,8,10,7,19,33,51,-18,37
SV Josko Rie,7361,9,9,7,20,31,55,-24,34
St. Pölten,7361,10,6,12,18,37,63,-26,30
FC Salzburg,7362,1,23,6,7,71,28,43,75
SK Sturm Gra,7362,2,20,5,11,62,37,25,65
SC Rheindorf,7362,3,18,9,9,52,40,12,63
Vienna,7362,4,17,7,12,64,54,10,58
Rapid Vienna,7362,5,14,9,13,54,45,9,51
RZ Pellets W,7362,6,11,13,12,49,51,-2,46
Admira Wacke,7362,7,11,6,19,40,61,-21,39
St. Pölten,7362,8,8,12,16,42,61,-19,36
SV Josko Rie,7362,9,10,6,20,29,56,-27,36
Mattersburg,7362,10,7,9,20,36,66,-30,30
FC Salzburg,7363,1,21,7,8,68,37,31,70
Vienna,7363,2,21,3,12,67,55,12,66
SC Rheindorf,7363,3,19,7,10,56,44,12,64
SK Sturm Gra,7363,4,18,5,13,54,37,17,59
Rapid Vienna,7363,5,15,11,10,56,41,15,56
Admira Wacke,7363,6,14,5,17,46,59,-13,47
RZ Pellets W,7363,7,11,6,19,44,56,-12,39
SV Josko Rie,7363,8,11,5,20,39,55,-16,38
St. Pölten,7363,9,9,9,18,41,66,-25,36
Mattersburg,7363,10,7,10,19,36,57,-21,31
FC Salzburg,7364,1,20,8,8,68,36,32,68
SK Sturm Gra,7364,2,20,7,9,56,30,26,67
SC Rheindorf,7364,3,18,8,10,52,45,7,62
Vienna,7364,4,18,7,11,67,52,15,61
Rapid Vienna,7364,5,12,13,11,54,43,11,49
St. Pölten,7364,6,10,11,15,46,61,-15,41
RZ Pellets W,7364,7,10,10,16,42,56,-14,40
Mattersburg,7364,8,9,10,17,42,58,-16,37
SV Josko Rie,7364,9,11,4,21,39,55,-16,37
Admira Wacke,7364,10,10,6,20,35,65,-30,36
SK Sturm Gra,7365,1,20,6,10,64,40,24,66
Rapid Vienna,7365,2,19,8,9,64,38,26,65
FC Salzburg,7365,3,19,6,11,65,34,31,63
SC Rheindorf,7365,4,19,5,12,57,50,7,62
Vienna,7365,5,18,6,12,63,52,11,60
Admira Wacke,7365,6,13,6,17,40,60,-20,45
RZ Pellets W,7365,7,11,9,16,41,54,-13,42
Mattersburg,7365,8,10,9,17,47,58,-11,39
SV Josko Rie,7365,9,9,7,20,32,52,-20,34
St. Pölten,7365,10,6,10,20,42,77,-35,28
FC Salzburg,7366,1,19,11,6,61,30,31,68
Vienna,7366,2,20,6,10,65,45,20,66
SK Sturm Gra,7366,3,18,8,10,56,33,23,62
SC Rheindorf,7366,4,15,11,10,50,45,5,56
Rapid Vienna,7366,5,14,10,12,51,37,14,52
RZ Pellets W,7366,6,11,10,15,51,60,-9,43
SV Josko Rie,7366,7,11,7,18,33,51,-18,40
Mattersburg,7366,8,10,8,18,32,52,-20,38
Admira Wacke,7366,9,9,9,18,34,60,-26,36
St. Pölten,7366,10,7,12,17,45,65,-20,33
SC Rheindorf,7367,1,21,10,5,57,36,21,73
FC Salzburg,7367,2,19,10,7,58,27,31,67
Vienna,7367,3,19,4,13,60,49,11,61
SK Sturm Gra,7367,4,16,7,13,61,44,17,55
Rapid Vienna,7367,5,13,15,8,53,35,18,54
RZ Pellets W,7367,6,12,9,15,38,48,-10,45
St. Pölten,7367,7,10,8,18,44,67,-23,38
Admira Wacke,7367,8,9,8,19,30,56,-26,35
Mattersburg,7367,9,8,10,18,41,60,-19,34
SV Josko Rie,7367,10,8,9,19,32,52,-20,33
FC Salzburg,7368,1,20,9,7,72,38,34,69
SC Rheindorf,7368,2,20,8,8,57,39,18,68
SK Sturm Gra,7368,3,19,9,8,58,31,27,66
Rapid Vienna,7368,4,17,10,9,62,39,23,61
Vienna,7368,5,17,5,14,61,53,8,56
RZ Pellets W,7368,6,13,7,16,43,51,-8,46
SV Josko Rie,7368,7,10,7,19,38,56,-18,37
St. Pölten,7368,8,8,12,16,36,65,-29,36
Admira Wacke,7368,9,9,5,22,34,66,-32,32
Mattersburg,7368,10,7,8,21,40,63,-23,29
SK Sturm Gra,7369,1,21,5,10,62,34,28,68
Vienna,7369,2,20,7,9,65,50,15,67
FC Salzburg,7369,3,17,9,10,62,35,27,60
SC Rheindorf,7369,4,18,6,12,52,47,5,60
Rapid Vienna,7369,5,14,12,10,55,40,15,54
Admira Wacke,7369,6,13,6,17,40,57,-17,45
RZ Pellets W,7369,7,11,8,17,44,57,-13,41
St. Pölten,7369,8,10,9,17,39,62,-23,39
SV Josko Rie,7369,9,10,6,20,31,51,-20,36
Mattersburg,7369,10,7,10,19,41,58,-17,31
FC Salzburg,7370,1,23,6,7,62,26,36,75
SC Rheindorf,7370,2,19,8,9,55,40,15,65
SK Sturm Gra,7370,3,19,5,12,56,37,19,62
Vienna,7370,4,19,5,12,62,46,16,62
Rapid Vienna,7370,5,13,10,13,49,38,11,49
Admira Wacke,7370,6,13,7,16,41,56,-15,46
RZ Pellets W,7370,7,11,8,17,41,56,-15,41
St. Pölten,7370,8,10,9,17,42,67,-25,39
SV Josko Rie,7370,9,7,12,17,33,53,-20,33
Mattersburg,7370,10,6,10,20,36,58,-22,28
FC Salzburg,7371,1,21,8,7,66,33,33,71
Vienna,7371,2,21,4,11,64,51,13,67
SC Rheindorf,7371,3,18,10,8,56,42,14,64
Rapid Vienna,7371,4,16,11,9,55,35,20,59
SK Sturm Gra,7371,5,17,6,13,59,42,17,57
RZ Pellets W,7371,6,12,9,15,49,51,-2,45
SV Josko Rie,7371,7,11,4,21,30,49,-19,37
Admira Wacke,7371,8,10,7,19,35,61,-26,37
Mattersburg,7371,9,8,9,19,32,54,-22,33
St. Pölten,7371,10,7,10,19,34,62,-28,31
SK Sturm Gra,7372,1,23,5,8,62,31,31,74
FC Salzburg,7372,2,22,5,9,73,34,39,71
SC Rheindorf,7372,3,21,7,8,57,36,21,70
Vienna,7372,4,21,3,12,66,55,11,66
Rapid Vienna,7372,5,14,10,12,53,41,12,52
RZ Pellets W,7372,6,12,7,17,43,54,-11,43
Admira Wacke,7372,7,12,4,20,42,62,-20,40
St. Pölten,7372,8,9,7,20,36,60,-24,34
SV Josko Rie,7372,9,9,5,22,34,62,-28,32
Mattersburg,7372,10,7,7,22,33,64,-31,28
FC Salzburg,7373,1,20,10,6,65,32,33,70
SC Rheindorf,7373,2,19,9,8,55,41,14,66
Vienna,7373,3,19,3,14,70,56,14,60
SK Sturm Gra,7373,4,17,6,13,56,35,21,57
Rapid Vienna,7373,5,15,12,9,54,38,16,57
RZ Pellets W,7373,6,12,9,15,46,54,-8,45
Admira Wacke,7373,7,12,9,15,42,59,-17,45
Mattersburg,7373,8,9,10,17,40,53,-13,37
St. Pölten,7373,9,7,10,19,41,67,-26,31
SV Josko Rie,7373,10,8,6,22,34,68,-34,30
FC Salzburg,7374,1,22,7,7,58,25,33,73
Vienna,7374,2,21,2,13,61,44,17,65
SC Rheindorf,7374,3,19,7,10,55,44,11,64
SK Sturm Gra,7374,4,19,4,13,56,36,20,61
Rapid Vienna,7374,5,16,10,10,58,38,20,58
RZ Pellets W,7374,6,15,5,16,49,57,-8,50
Admira Wacke,7374,7,10,7,19,36,61,-25,37
SV Josko Rie,7374,8,10,6,20,32,55,-23,36
St. Pölten,7374,9,8,9,19,43,66,-23,33
Mattersburg,7374,10,7,9,20,39,61,-22,30
FC Salzburg,7375,1,22,6,8,61,30,31,72
SC Rheindorf,7375,2,21,6,9,59,34,25,69
SK Sturm Gra,7375,3,18,8,10,56,35,21,62
Rapid Vienna,7375,4,14,13,9,56,35,21,55
Vienna,7375,5,16,7,13,57,54,3,55
RZ Pellets W,7375,6,11,8,17,42,58,-16,41
Admira Wacke,7375,7,11,8,17,34,61,-27,41
SV Josko Rie,7375,8,11,5,20,36,52,-16,38
Mattersburg,7375,9,9,9,18,38,53,-15,36
St. Pölten,7375,10,7,10,19,36,63,-27,31
FC Salzburg,7376,1,25,7,4,72,25,47,82
SC Rheindorf,7376,2,18,9,9,55,41,14,63
Vienna,7376,3,19,6,11,62,54,8,63
SK Sturm Gra,7376,4,17,7,12,52,32,20,58
Rapid Vienna,7376,5,14,10,12,59,38,21,52
RZ Pellets W,7376,6,15,6,15,49,57,-8,51
SV Josko Rie,7376,7,10,8,18,30,48,-18,38
Admira Wacke,7376,8,11,3,22,34,64,-30,36
Mattersburg,7376,9,8,8,20,37,58,-21,32
St. Pölten,7376,10,7,8,21,38,71,-33,29
SC Rheindorf,7377,1,20,10,6,55,37,18,70
SK Sturm Gra,7377,2,20,8,8,60,32,28,68
FC Salzburg,7377,3,19,8,9,62,33,29,65
Vienna,7377,4,18,6,12,59,50,9,60
Admira Wacke,7377,5,13,8,15,37,52,-15,47
Rapid Vienna,7377,6,11,12,13,50,44,6,45
RZ Pellets W,7377,7,12,9,15,49,60,-11,45
Mattersburg,7377,8,11,8,17,40,47,-7,41
SV Josko Rie,7377,9,11,3,22,33,55,-22,36
St. Pölten,7377,10,5,8,23,31,66,-35,23
SC Rheindorf,7378,1,21,7,8,57,39,18,70
SK Sturm Gra,7378,2,19,10,7,53,27,26,67
Vienna,7378,3,18,6,12,61,52,9,60
FC Salzburg,7378,4,17,8,11,66,38,28,59
Rapid Vienna,7378,5,13,13,10,53,40,13,52
RZ Pellets W,7378,6,10,12,14,44,53,-9,42
Admira Wacke,7378,7,12,6,18,36,60,-24,42
SV Josko Rie,7378,8,10,6,20,30,48,-18,36
Mattersburg,7378,9,8,11,17,38,56,-18,35
St. Pölten,7378,10,6,13,17,41,66,-25,31
FC Salzburg,7379,1,19,10,7,61,32,29,67
SK Sturm Gra,7379,2,19,8,9,56,28,28,65
SC Rheindorf,7379,3,20,5,11,60,48,12,65
Vienna,7379,4,17,9,10,63,53,10,60
Rapid Vienna,7379,5,15,12,9,53,37,16,57
SV Josko Rie,7379,6,11,8,17,36,53,-17,41
Admira Wacke,7379,7,11,7,18,32,52,-20,40
RZ Pellets W,7379,8,10,8,18,47,58,-11,38
St. Pölten,7379,9,9,7,20,37,64,-27,34
Mattersburg,7379,10,8,8,20,33,53,-20,32
SC Rheindorf,7380,1,19,11,6,50,36,14,68
FC Salzburg,7380,2,18,9,9,59,30,29,63
SK Sturm Gra,7380,3,18,7,11,61,37,24,61
Vienna,7380,4,17,8,11,60,50,10,59
Rapid Vienna,7380,5,16,10,10,59,38,21,58
SV Josko Rie,7380,6,14,7,15,36,46,-10,49
Admira Wacke,7380,7,12,8,16,36,52,-16,44
RZ Pellets W,7380,8,12,6,18,44,62,-18,42
St. Pölten,7380,9,7,8,21,31,59,-28,29
Mattersburg,7380,10,7,6,23,31,57,-26,27
FC Salzburg,7381,1,19,10,7,67,35,32,67
SK Sturm Gra,7381,2,19,7,10,63,38,25,64
SC Rheindorf,7381,3,17,10,9,53,42,11,61
Vienna,7381,4,17,5,14,59,56,3,56
Rapid Vienna,7381,5,15,8,13,59,46,13,53
RZ Pellets W,7381,6,14,8,14,53,52,1,50
Admira Wacke,7381,7,13,6,17,37,60,-23,45
SV Josko Rie,7381,8,11,5,20,32,52,-20,38
St. Pölten,7381,9,9,9,18,43,65,-22,36
Mattersburg,7381,10,9,6,21,41,61,-20,33
FC Salzburg,7382,1,20,7,9,64,31,33,67
SC Rheindorf,7382,2,20,5,11,55,48,7,65
Vienna,7382,3,20,3,13,65,54,11,63
SK Sturm Gra,7382,4,17,11,8,61,33,28,62
Rapid Vienna,7382,5,15,12,9,63,39,24,57
St. Pölten,7382,6,11,9,16,46,62,-16,42
Mattersburg,7382,7,9,11,16,43,60,-17,38
RZ Pellets W,7382,8,10,8,18,46,66,-20,38
SV Josko Rie,7382,9,11,4,21,37,55,-18,37
Admira Wacke,7382,10,10,4,22,31,63,-32,34
FC Salzburg,7383,1,17,11,8,55,36,19,62
SC Rheindorf,7383,2,18,8,10,52,48,4,62
Vienna,7383,3,18,6,12,69,54,15,60
SK Sturm Gra,7383,4,16,7,13,61,47,14,55
Rapid Vienna,7383,5,12,13,11,50,39,11,49
RZ Pellets W,7383,6,12,9,15,51,57,-6,45
Admira Wacke,7383,7,13,5,18,41,57,-16,44
Mattersburg,7383,8,11,8,17,40,51,-11,41
St. Pölten,7383,9,10,11,15,43,56,-13,41
SV Josko Rie,7383,10,11,6,19,35,52,-17,39
FC Salzburg,7384,1,23,8,5,79,32,47,77
SK Sturm Gra,7384,2,24,4,8,65,30,35,76
SC Rheindorf,7384,3,19,8,9,57,41,16,65
Vienna,7384,4,16,3,17,58,61,-3,51
Rapid Vienna,7384,5,12,12,12,55,41,14,48
St. Pölten,7384,6,12,9,15,46,56,-10,45
Admira Wacke,7384,7,12,4,20,36,61,-25,40
SV Josko Rie,7384,8,11,6,19,34,53,-19,39
RZ Pellets W,7384,9,11,6,19,46,71,-25,39
Mattersburg,7384,10,7,6,23,33,63,-30,27
FC Salzburg,7385,1,21,7,8,59,28,31,70
SK Sturm Gra,7385,2,21,6,9,55,27,28,69
SC Rheindorf,7385,3,18,10,8,55,42,13,64
Vienna,7385,4,18,7,11,65,50,15,61
Rapid Vienna,7385,5,12,11,13,53,44,9,47
RZ Pellets W,7385,6,12,8,16,45,56,-11,44
Admira Wacke,7385,7,12,5,19,32,56,-24,41
St. Pölten,7385,8,8,13,15,46,65,-19,37
SV Josko Rie,7385,9,10,6,20,37,57,-20,36
Mattersburg,7385,10,8,7,21,36,58,-22,31
FC Salzburg,7386,1,22,6,8,61,25,36,72
SC Rheindorf,7386,2,20,9,7,60,41,19,69
SK Sturm Gra,7386,3,19,8,9,62,35,27,65
Rapid Vienna,7386,4,16,10,10,64,37,27,58
Vienna,7386,5,17,5,14,61,54,7,56
RZ Pellets W,7386,6,14,6,16,50,60,-10,48
Admira Wacke,7386,7,11,9,16,38,59,-21,42
SV Josko Rie,7386,8,9,6,21,35,62,-27,33
Mattersburg,7386,9,8,7,21,35,61,-26,31
St. Pölten,7386,10,6,10,20,37,69,-32,28
FC Salzburg,7387,1,21,9,6,62,23,39,72
SC Rheindorf,7387,2,19,6,11,56,46,10,63
Vienna,7387,3,19,5,12,63,53,10,62
SK Sturm Gra,7387,4,18,6,12,52,32,20,60
Rapid Vienna,7387,5,16,9,11,54,37,17,57
RZ Pellets W,7387,6,13,10,13,46,50,-4,49
Admira Wacke,7387,7,11,8,17,36,55,-19,41
St. Pölten,7387,8,9,10,17,36,58,-22,37
SV Josko Rie,7387,9,9,8,19,33,56,-23,35
Mattersburg,7387,10,5,9,22,32,60,-28,24
SK Sturm Gra,7388,1,21,6,9,65,31,34,69
Vienna,7388,2,20,4,12,68,49,19,64
SC Rheindorf,7388,3,19,7,10,49,39,10,64
FC Salzburg,7388,4,18,8,10,63,42,21,62
Rapid Vienna,7388,5,12,12,12,56,48,8,48
Admira Wacke,7388,6,14,4,18,43,63,-20,46
RZ Pellets W,7388,7,13,6,17,43,60,-17,45
St. Pölten,7388,8,10,11,15,45,55,-10,41
SV Josko Rie,7388,9,10,5,21,32,51,-19,35
Mattersburg,7388,10,8,7,21,38,64,-26,31
FC Salzburg,7389,1,22,7,7,75,27,48,73
SK Sturm Gra,7389,2,20,8,8,64,35,29,68
Vienna,7389,3,19,6,11,68,53,15,63
SC Rheindorf,7389,4,17,9,10,51,44,7,60
Rapid Vienna,7389,5,12,10,14,54,42,12,46
Mattersburg,7389,6,13,7,16,41,49,-8,46
RZ Pellets W,7389,7,12,7,17,45,60,-15,43
Admira Wacke,7389,8,10,6,20,32,64,-32,36
St. Pölten,7389,9,9,8,19,39,69,-30,35
SV Josko Rie,7389,10,10,4,22,36,62,-26,34
SC Rheindorf,7390,1,23,5,8,64,43,21,74
FC Salzburg,7390,2,21,7,8,68,34,34,70
SK Sturm Gra,7390,3,20,6,10,59,30,29,66
Vienna,7390,4,19,3,14,64,51,13,60
RZ Pellets W,7390,5,15,8,13,52,51,1,53
Rapid Vienna,7390,6,12,11,13,49,37,12,47
Admira Wacke,7390,7,11,6,19,32,62,-30,39
Mattersburg,7390,8,8,10,18,36,58,-22,34
SV Josko Rie,7390,9,8,7,21,31,64,-33,31
St. Pölten,7390,10,7,9,20,40,65,-25,30
FC Salzburg,7391,1,20,10,6,67,32,35,70
SK Sturm Gra,7391,2,20,5,11,59,37,22,65
SC Rheindorf,7391,3,18,8,10,46,39,7,62
Rapid Vienna,7391,4,16,9,11,52,38,14,57
Vienna,7391,5,16,7,13,58,55,3,55
Mattersburg,7391,6,11,9,16,40,50,-10,42
RZ Pellets W,7391,7,11,8,17,44,57,-13,41
Admira Wacke,7391,8,10,9,17,39,59,-20,39
SV Josko Rie,7391,9,10,5,21,36,55,-19,35
St. Pölten,7391,10,7,12,17,41,60,-19,33
SK Sturm Gra,7392,1,22,7,7,63,28,35,73
FC Salzburg,7392,2,22,6,8,66,28,38,72
SC Rheindorf,7392,3,16,9,11,56,43,13,57
Rapid Vienna,7392,4,13,14,9,57,42,15,53
Vienna,7392,5,15,8,13,53,54,-1,53
RZ Pellets W,7392,6,14,7,15,49,56,-7,49
Admira Wacke,7392,7,11,7,18,28,51,-23,40
SV Josko Rie,7392,8,11,4,21,33,54,-21,37
Mattersburg,7392,9,9,9,18,41,60,-19,36
St. Pölten,7392,10,7,9,20,39,69,-30,30
FC Salzburg,7393,1,21,7,8,63,31,32,70
Vienna,7393,2,20,7,9,65,44,21,67
SK Sturm Gra,7393,3,18,8,10,59,36,23,62
SC Rheindorf,7393,4,17,8,11,52,44,8,59
Rapid Vienna,7393,5,14,10,12,51,40,11,52
RZ Pellets W,7393,6,14,8,14,47,53,-6,50
Admira Wacke,7393,7,11,8,17,36,55,-19,41
St. Pölten,7393,8,11,8,17,41,61,-20,41
SV Josko Rie,7393,9,10,4,22,34,55,-21,34
Mattersburg,7393,10,6,8,22,26,55,-29,26
FC Salzburg,7394,1,21,7,8,66,30,36,70
SK Sturm Gra,7394,2,17,10,9,59,36,23,61
SC Rheindorf,7394,3,17,9,10,55,48,7,60
Rapid Vienna,7394,4,13,12,11,55,38,17,51
Vienna,7394,5,14,9,13,53,55,-2,51
RZ Pellets W,7394,6,14,7,15,49,54,-5,49
Admira Wacke,7394,7,12,6,18,40,64,-24,42
St. Pölten,7394,8,10,10,16,41,58,-17,40
SV Josko Rie,7394,9,12,4,20,38,56,-18,40
Mattersburg,7394,10,9,8,19,40,57,-17,35
FC Salzburg,7395,1,21,9,6,66,31,35,72
SC Rheindorf,7395,2,19,10,7,55,44,11,67
SK Sturm Gra,7395,3,18,8,10,64,33,31,62
Vienna,7395,4,18,6,12,59,52,7,60
Rapid Vienna,7395,5,12,12,12,58,49,9,48
Admira Wacke,7395,6,13,7,16,47,53,-6,46
RZ Pellets W,7395,7,10,8,18,44,65,-21,38
SV Josko Rie,7395,8,11,5,20,34,55,-21,38
St. Pölten,7395,9,8,10,18,36,62,-26,34
Mattersburg,7395,10,7,11,18,35,54,-19,32
FC Salzburg,7396,1,21,7,8,67,31,36,70
SK Sturm Gra,7396,2,20,6,10,58,35,23,66
Vienna,7396,3,20,2,14,58,51,7,62
Rapid Vienna,7396,4,17,9,10,63,36,27,60
SC Rheindorf,7396,5,18,6,12,50,45,5,60
Admira Wacke,7396,6,12,6,18,42,62,-20,42
Mattersburg,7396,7,12,5,19,43,54,-11,41
RZ Pellets W,7396,8,11,6,19,41,59,-18,39
SV Josko Rie,7396,9,10,6,20,31,53,-22,36
St. Pölten,7396,10,9,7,20,41,68,-27,34
SC Rheindorf,7397,1,21,8,7,60,39,21,71
SK Sturm Gra,7397,2,20,8,8,66,34,32,68
FC Salzburg,7397,3,19,6,11,65,37,28,63
Vienna,7397,4,18,4,14,59,61,-2,58
RZ Pellets W,7397,5,15,7,14,48,49,-1,52
Rapid Vienna,7397,6,13,10,13,69,56,13,49
Admira Wacke,7397,7,11,6,19,37,60,-23,39
SV Josko Rie,7397,8,11,4,21,37,58,-21,37
St. Pölten,7397,9,9,8,19,40,65,-25,35
Mattersburg,7397,10,7,11,18,34,56,-22,32
FC Salzburg,7398,1,21,6,9,62,36,26,69
SK Sturm Gra,7398,2,21,5,10,56,30,26,68
Vienna,7398,3,20,3,13,59,48,11,63
SC Rheindorf,7398,4,19,6,11,54,45,9,63
Rapid Vienna,7398,5,13,9,14,57,46,11,48
Admira Wacke,7398,6,13,7,16,42,56,-14,46
RZ Pellets W,7398,7,12,7,17,46,57,-11,43
SV Josko Rie,7398,8,11,6,19,36,53,-17,39
St. Pölten,7398,9,9,8,19,41,64,-23,35
Mattersburg,7398,10,9,7,20,44,62,-18,34
SK Sturm Gra,7399,1,21,6,9,64,32,32,69
FC Salzburg,7399,2,18,8,10,56,34,22,62
Vienna,7399,3,19,4,13,73,54,19,61
SC Rheindorf,7399,4,18,7,11,57,49,8,61
Rapid Vienna,7399,5,12,11,13,56,45,11,47
Mattersburg,7399,6,13,8,15,44,52,-8,47
RZ Pellets W,7399,7,12,9,15,50,60,-10,45
St. Pölten,7399,8,12,8,16,44,57,-13,44
SV Josko Rie,7399,9,11,4,21,33,59,-26,37
Admira Wacke,7399,10,10,3,23,27,62,-35,33
SK Sturm Gra,7400,1,22,6,8,61,32,29,72
SC Rheindorf,7400,2,21,7,8,56,40,16,70
FC Salzburg,7400,3,21,6,9,61,28,33,69
Vienna,7400,4,18,4,14,67,52,15,58
Rapid Vienna,7400,5,12,11,13,52,45,7,47
Mattersburg,7400,6,11,8,17,41,52,-11,41
RZ Pellets W,7400,7,11,8,17,47,63,-16,41
Admira Wacke,7400,8,11,6,19,31,60,-29,39
SV Josko Rie,7400,9,9,7,20,35,57,-22,34
St. Pölten,7400,10,8,9,19,39,61,-22,33
SC Rheindorf,7401,1,19,10,7,56,42,14,67
FC Salzburg,7401,2,19,9,8,62,30,32,66
Vienna,7401,3,20,5,11,68,48,20,65
SK Sturm Gra,7401,4,18,8,10,64,41,23,62
Rapid Vienna,7401,5,13,15,8,56,37,19,54
RZ Pellets W,7401,6,11,8,17,46,62,-16,41
St. Pölten,7401,7,9,12,15,45,64,-19,39
Admira Wacke,7401,8,11,6,19,40,72,-32,39
SV Josko Rie,7401,9,11,5,20,40,54,-14,38
Mattersburg,7401,10,6,8,22,32,59,-27,26
SC Rheindorf,7402,1,21,6,9,54,39,15,69
SK Sturm Gra,7402,2,19,8,9,53,24,29,65
Vienna,7402,3,20,4,12,61,49,12,64
FC Salzburg,7402,4,18,8,10,61,33,28,62
Rapid Vienna,7402,5,16,10,10,56,37,19,58
RZ Pellets W,7402,6,13,7,16,44,53,-9,46
Admira Wacke,7402,7,12,6,18,35,56,-21,42
SV Josko Rie,7402,8,11,5,20,34,59,-25,38
St. Pölten,7402,9,7,10,19,41,66,-25,31
Mattersburg,7402,10,7,8,21,36,59,-23,29
SC Rheindorf,7403,1,21,9,6,59,39,20,72
FC Salzburg,7403,2,22,5,9,68,30,38,71
Rapid Vienna,7403,3,18,9,9,57,33,24,63
SK Sturm Gra,7403,4,17,9,10,56,33,23,60
Vienna,7403,5,17,6,13,54,50,4,57
RZ Pellets W,7403,6,14,8,14,49,56,-7,50
SV Josko Rie,7403,7,11,5,20,34,50,-16,38
Admira Wacke,7403,8,10,5,21,29,65,-36,35
Mattersburg,7403,9,9,7,20,36,53,-17,34
St. Pölten,7403,10,6,7,23,36,69,-33,25
FC Salzburg,7404,1,22,8,6,62,28,34,74
SK Sturm Gra,7404,2,20,9,7,65,36,29,69
Vienna,7404,3,19,8,9,63,48,15,65
SC Rheindorf,7404,4,15,9,12,47,42,5,54
RZ Pellets W,7404,5,13,9,14,48,48,0,48
Rapid Vienna,7404,6,12,11,13,50,45,5,47
SV Josko Rie,7404,7,12,7,17,39,46,-7,43
Admira Wacke,7404,8,9,8,19,33,60,-27,35
Mattersburg,7404,9,7,10,19,36,57,-21,31
St. Pölten,7404,10,6,11,19,39,72,-33,29
FC Salzburg,7405,1,22,8,6,69,31,38,74
SC Rheindorf,7405,2,18,9,9,49,36,13,63
SK Sturm Gra,7405,3,16,10,10,55,35,20,58
Vienna,7405,4,16,7,13,66,52,14,55
Rapid Vienna,7405,5,13,11,12,55,48,7,50
RZ Pellets W,7405,6,11,9,16,46,57,-11,42
SV Josko Rie,7405,7,12,5,19,37,55,-18,41
St. Pölten,7405,8,10,11,15,44,63,-19,41
Mattersburg,7405,9,10,7,19,46,60,-14,37
Admira Wacke,7405,10,9,9,18,33,63,-30,36
FC Salzburg,7406,1,22,7,7,68,30,38,73
SK Sturm Gra,7406,2,23,4,9,68,34,34,73
Vienna,7406,3,18,7,11,58,46,12,61
Rapid Vienna,7406,4,17,9,10,59,38,21,60
SC Rheindorf,7406,5,16,8,12,47,45,2,56
Admira Wacke,7406,6,11,8,17,38,56,-18,41
RZ Pellets W,7406,7,9,10,17,40,57,-17,37
St. Pölten,7406,8,8,11,17,40,60,-20,35
SV Josko Rie,7406,9,10,5,21,33,59,-26,35
Mattersburg,7406,10,8,7,21,37,63,-26,31
SC Rheindorf,7407,1,22,8,6,66,38,28,74
FC Salzburg,7407,2,20,8,8,67,44,23,68
SK Sturm Gra,7407,3,20,7,9,64,38,26,67
RZ Pellets W,7407,4,18,4,14,53,49,4,58
Vienna,7407,5,17,5,14,61,57,4,56
Admira Wacke,7407,6,13,5,18,46,62,-16,44
Rapid Vienna,7407,7,11,10,15,46,46,0,43
Mattersburg,7407,8,9,9,18,37,54,-17,36
St. Pölten,7407,9,8,8,20,41,67,-26,32
SV Josko Rie,7407,10,8,4,24,37,63,-26,28
FC Salzburg,7408,1,22,8,6,65,32,33,74
SC Rheindorf,7408,2,21,6,9,56,39,17,69
Rapid Vienna,7408,3,17,9,10,61,35,26,60
SK Sturm Gra,7408,4,16,8,12,54,35,19,56
Vienna,7408,5,17,5,14,67,58,9,56
SV Josko Rie,7408,6,14,4,18,42,52,-10,46
RZ Pellets W,7408,7,12,7,17,46,58,-12,43
Admira Wacke,7408,8,12,5,19,35,58,-23,41
St. Pölten,7408,9,8,10,18,41,64,-23,34
Mattersburg,7408,10,7,6,23,34,70,-36,27
FC Salzburg,7409,1,21,9,6,63,30,33,72
SC Rheindorf,7409,2,20,7,9,57,45,12,67
SK Sturm Gra,7409,3,19,7,10,61,38,23,64
Vienna,7409,4,19,4,13,60,52,8,61
Rapid Vienna,7409,5,11,14,11,55,41,14,47
RZ Pellets W,7409,6,13,7,16,43,50,-7,46
Admira Wacke,7409,7,11,8,17,35,54,-19,41
SV Josko Rie,7409,8,11,4,21,38,58,-20,37
St. Pölten,7409,9,8,10,18,38,63,-25,34
Mattersburg,7409,10,7,10,19,34,53,-19,31
SK Sturm Gra,7410,1,21,7,8,63,29,34,70
SC Rheindorf,7410,2,21,6,9,62,40,22,69
FC Salzburg,7410,3,20,6,10,62,37,25,66
Rapid Vienna,7410,4,18,9,9,64,36,28,63
Vienna,7410,5,18,3,15,59,63,-4,57
RZ Pellets W,7410,6,10,8,18,38,60,-22,38
Mattersburg,7410,7,10,7,19,41,57,-16,37
St. Pölten,7410,8,9,9,18,43,63,-20,36
Admira Wacke,7410,9,9,9,18,37,64,-27,36
SV Josko Rie,7410,10,11,2,23,38,58,-20,35
SK Sturm Gra,7411,1,23,3,10,75,32,43,72
FC Salzburg,7411,2,20,6,10,68,39,29,66
Rapid Vienna,7411,3,17,9,10,60,37,23,60
Vienna,7411,4,18,6,12,60,52,8,60
SC Rheindorf,7411,5,17,8,11,58,44,14,59
Admira Wacke,7411,6,12,7,17,43,57,-14,43
Mattersburg,7411,7,10,8,18,46,69,-23,38
RZ Pellets W,7411,8,10,7,19,47,70,-23,37
St. Pölten,7411,9,8,11,17,37,63,-26,35
SV Josko Rie,7411,10,10,5,21,27,58,-31,35
FC Salzburg,7412,1,19,9,8,58,27,31,66
SK Sturm Gra,7412,2,19,8,9,56,33,23,65
Vienna,7412,3,19,6,11,68,51,17,63
SC Rheindorf,7412,4,16,8,12,49,42,7,56
Rapid Vienna,7412,5,15,9,12,56,41,15,54
Admira Wacke,7412,6,12,8,16,39,53,-14,44
Mattersburg,7412,7,10,9,17,40,53,-13,39
SV Josko Rie,7412,8,11,6,19,32,54,-22,39
RZ Pellets W,7412,9,10,8,18,43,62,-19,38
St. Pölten,7412,10,9,9,18,44,69,-25,36
FC Salzburg,7413,1,20,8,8,62,28,34,68
SC Rheindorf,7413,2,19,10,7,53,35,18,67
SK Sturm Gra,7413,3,17,7,12,52,34,18,58
Rapid Vienna,7413,4,15,12,9,51,35,16,57
Vienna,7413,5,15,5,16,57,61,-4,50
St. Pölten,7413,6,11,10,15,46,60,-14,43
Admira Wacke,7413,7,12,6,18,39,61,-22,42
Mattersburg,7413,8,11,7,18,43,54,-11,40
RZ Pellets W,7413,9,10,10,16,43,57,-14,40
SV Josko Rie,7413,10,10,5,21,36,57,-21,35
SK Sturm Gra,7414,1,22,5,9,63,35,28,71
SC Rheindorf,7414,2,20,7,9,62,44,18,67
FC Salzburg,7414,3,20,6,10,64,41,23,66
Vienna,7414,4,18,6,12,60,48,12,60
Rapid Vienna,7414,5,12,12,12,51,44,7,48
SV Josko Rie,7414,6,12,7,17,40,51,-11,43
Admira Wacke,7414,7,12,7,17,38,58,-20,43
RZ Pellets W,7414,8,8,12,16,42,56,-14,36
Mattersburg,7414,9,9,8,19,40,59,-19,35
St. Pölten,7414,10,7,10,19,42,66,-24,31
SK Sturm Gra,7415,1,21,8,7,62,26,36,71
FC Salzburg,7415,2,20,9,7,67,30,37,69
SC Rheindorf,7415,3,19,7,10,62,47,15,64
Vienna,7415,4,17,7,12,56,51,5,58
RZ Pellets W,7415,5,15,8,13,53,51,2,53
Rapid Vienna,7415,6,13,10,13,54,44,10,49
Admira Wacke,7415,7,12,5,19,39,58,-19,41
St. Pölten,7415,8,9,7,20,42,67,-25,34
Mattersburg,7415,9,9,7,20,36,61,-25,34
SV Josko Rie,7415,10,8,6,22,31,67,-36,30
FC Salzburg,7416,1,21,9,6,66,28,38,72
SC Rheindorf,7416,2,20,7,9,55,43,12,67
SK Sturm Gra,7416,3,18,7,11,56,34,22,61
Vienna,7416,4,17,5,14,58,52,6,56
Rapid Vienna,7416,5,15,9,12,59,40,19,54
Mattersburg,7416,6,11,8,17,36,53,-17,41
RZ Pellets W,7416,7,11,6,19,42,58,-16,39
SV Josko Rie,7416,8,11,6,19,33,52,-19,39
St. Pölten,7416,9,10,8,18,37,60,-23,38
Admira Wacke,7416,10,10,7,19,38,60,-22,37
SC Rheindorf,7417,1,21,8,7,54,34,20,71
Vienna,7417,2,21,5,10,63,45,18,68
SK Sturm Gra,7417,3,18,7,11,48,32,16,61
FC Salzburg,7417,4,17,7,12,57,39,18,58
Rapid Vienna,7417,5,15,11,10,60,41,19,56
Admira Wacke,7417,6,14,6,16,44,51,-7,48
Mattersburg,7417,7,11,8,17,40,55,-15,41
St. Pölten,7417,8,9,8,19,38,65,-27,35
SV Josko Rie,7417,9,9,7,20,39,57,-18,34
RZ Pellets W,7417,10,9,5,22,35,59,-24,32
FC Salzburg,7418,1,22,7,7,67,28,39,73
Vienna,7418,2,21,5,10,67,48,19,68
SC Rheindorf,7418,3,21,5,10,60,47,13,68
SK Sturm Gra,7418,4,19,5,12,62,37,25,62
RZ Pellets W,7418,5,14,5,17,47,57,-10,47
Admira Wacke,7418,6,13,3,20,37,65,-28,42
Rapid Vienna,7418,7,10,11,15,55,46,9,41
SV Josko Rie,7418,8,11,6,19,36,52,-16,39
St. Pölten,7418,9,10,8,18,40,63,-23,38
Mattersburg,7418,10,7,9,20,35,63,-28,30
FC Salzburg,7419,1,20,7,9,70,33,37,67
SC Rheindorf,7419,2,19,8,9,55,41,14,65
SK Sturm Gra,7419,3,19,7,10,55,33,22,64
Vienna,7419,4,19,7,10,71,51,20,64
Rapid Vienna,7419,5,14,11,11,61,43,18,53
RZ Pellets W,7419,6,13,8,15,50,60,-10,47
SV Josko Rie,7419,7,12,4,20,39,58,-19,40
Admira Wacke,7419,8,10,8,18,38,63,-25,38
St. Pölten,7419,9,8,13,15,45,68,-23,37
Mattersburg,7419,10,5,9,22,31,65,-34,24
SK Sturm Gra,7420,1,18,8,10,61,37,24,62
FC Salzburg,7420,2,18,8,10,59,36,23,62
SC Rheindorf,7420,3,18,8,10,58,50,8,62
Vienna,7420,4,17,4,15,55,53,2,55
Rapid Vienna,7420,5,15,9,12,52,39,13,54
RZ Pellets W,7420,6,15,8,13,62,54,8,53
SV Josko Rie,7420,7,12,6,18,44,58,-14,42
Mattersburg,7420,8,11,8,17,47,61,-14,41
Admira Wacke,7420,9,11,7,18,40,63,-23,40
St. Pölten,7420,10,7,10,19,42,69,-27,31
SC Rheindorf,7421,1,21,7,8,58,40,18,70
FC Salzburg,7421,2,19,5,12,62,35,27,62
SK Sturm Gra,7421,3,18,8,10,61,36,25,62
Vienna,7421,4,18,4,14,67,54,13,58
Rapid Vienna,7421,5,15,10,11,53,39,14,55
RZ Pellets W,7421,6,12,10,14,48,52,-4,46
SV Josko Rie,7421,7,12,6,18,40,54,-14,42
Mattersburg,7421,8,10,8,18,42,61,-19,38
Admira Wacke,7421,9,11,4,21,35,67,-32,37
St. Pölten,7421,10,8,10,18,37,65,-28,34
SK Sturm Gra,7422,1,23,4,9,74,32,42,73
FC Salzburg,7422,2,22,7,7,67,29,38,73
Vienna,7422,3,22,3,11,69,49,20,69
SC Rheindorf,7422,4,19,8,9,56,48,8,65
Rapid Vienna,7422,5,15,8,13,59,52,7,53
RZ Pellets W,7422,6,12,6,18,44,54,-10,42
Admira Wacke,7422,7,11,6,19,34,61,-27,39
SV Josko Rie,7422,8,9,8,19,32,54,-22,35
St. Pölten,7422,9,7,10,19,37,62,-25,31
Mattersburg,7422,10,5,10,21,32,63,-31,25
SK Sturm Gra,7423,1,20,8,8,67,35,32,68
FC Salzburg,7423,2,20,8,8,63,33,30,68
SC Rheindorf,7423,3,16,10,10,52,46,6,58
Vienna,7423,4,16,7,13,60,51,9,55
Rapid Vienna,7423,5,14,10,12,55,40,15,52
SV Josko Rie,7423,6,12,7,17,42,53,-11,43
RZ Pellets W,7423,7,11,8,17,43,55,-12,41
Mattersburg,7423,8,9,11,16,36,56,-20,38
Admira Wacke,7423,9,10,8,18,31,58,-27,38
St. Pölten,7423,10,7,13,16,39,61,-22,34
FC Salzburg,7424,1,25,6,5,75,26,49,81
Rapid Vienna,7424,2,18,9,9,60,41,19,63
SK Sturm Gra,7424,3,17,7,12,55,38,17,58
SC Rheindorf,7424,4,16,9,11,52,49,3,57
Vienna,7424,5,17,4,15,58,49,9,55
RZ Pellets W,7424,6,13,7,16,49,59,-10,46
SV Josko Rie,7424,7,12,8,16,45,54,-9,44
St. Pölten,7424,8,9,10,17,44,64,-20,37
Admira Wacke,7424,9,10,7,19,34,62,-28,37
Mattersburg,7424,10,6,7,23,33,63,-30,25
FC Salzburg,7425,1,24,6,6,74,30,44,78
SC Rheindorf,7425,2,23,5,8,61,42,19,74
SK Sturm Gra,7425,3,17,8,11,57,41,16,59
Vienna,7425,4,18,2,16,59,56,3,56
Rapid Vienna,7425,5,14,10,12,59,47,12,52
RZ Pellets W,7425,6,11,11,14,42,52,-10,44
Admira Wacke,7425,7,13,5,18,42,55,-13,44
St. Pölten,7425,8,9,11,16,43,61,-18,38
SV Josko Rie,7425,9,9,7,20,38,62,-24,34
Mattersburg,7425,10,5,9,22,33,62,-29,24
SK Sturm Gra,7426,1,19,9,8,57,32,25,66
SC Rheindorf,7426,2,19,8,9,57,41,16,65
FC Salzburg,7426,3,17,10,9,55,30,25,61
Vienna,7426,4,18,4,14,59,49,10,58
Rapid Vienna,7426,5,13,14,9,50,34,16,53
SV Josko Rie,7426,6,12,7,17,39,52,-13,43
RZ Pellets W,7426,7,11,9,16,47,57,-10,42
Admira Wacke,7426,8,10,8,18,37,61,-24,38
St. Pölten,7426,9,8,11,17,46,68,-22,35
Mattersburg,7426,10,8,10,18,36,59,-23,34
SK Sturm Gra,7427,1,21,6,9,72,37,35,69
FC Salzburg,7427,2,20,8,8,63,35,28,68
SC Rheindorf,7427,3,19,6,11,49,39,10,63
Rapid Vienna,7427,4,16,11,9,58,34,24,59
Vienna,7427,5,16,4,16,59,57,2,52
RZ Pellets W,7427,6,14,7,15,49,55,-6,49
St. Pölten,7427,7,9,12,15,40,65,-25,39
Admira Wacke,7427,8,10,7,19,31,54,-23,37
SV Josko Rie,7427,9,10,6,20,34,58,-24,36
Mattersburg,7427,10,7,9,20,37,58,-21,30
FC Salzburg,7428,1,20,10,6,64,30,34,70
SK Sturm Gra,7428,2,21,6,9,62,31,31,69
Vienna,7428,3,20,5,11,69,54,15,65
SC Rheindorf,7428,4,17,11,8,58,39,19,62
SV Josko Rie,7428,5,14,3,19,48,59,-11,45
Rapid Vienna,7428,6,10,13,13,45,44,1,43
Mattersburg,7428,7,11,9,16,42,54,-12,42
Admira Wacke,7428,8,10,7,19,43,67,-24,37
RZ Pellets W,7428,9,9,8,19,46,68,-22,35
St. Pölten,7428,10,7,10,19,42,73,-31,31
FC Salzburg,7429,1,22,6,8,70,42,28,72
SK Sturm Gra,7429,2,22,5,9,67,32,35,71
SC Rheindorf,7429,3,20,5,11,58,53,5,65
Rapid Vienna,7429,4,16,10,10,65,43,22,58
Vienna,7429,5,16,7,13,63,53,10,55
St. Pölten,7429,6,12,7,17,45,60,-15,43
RZ Pellets W,7429,7,12,6,18,45,60,-15,42
Admira Wacke,7429,8,11,5,20,38,63,-25,38
Mattersburg,7429,9,7,12,17,33,51,-18,33
SV Josko Rie,7429,10,8,5,23,33,60,-27,29
FC Salzburg,7430,1,23,4,9,67,32,35,73
SK Sturm Gra,7430,2,21,8,7,60,25,35,71
SC Rheindorf,7430,3,20,9,7,60,38,22,69
Rapid Vienna,7430,4,13,11,12,51,41,10,50
Vienna,7430,5,14,8,14,57,57,0,50
RZ Pellets W,7430,6,13,7,16,45,53,-8,46
Admira Wacke,7430,7,11,8,17,33,56,-23,41
Mattersburg,7430,8,10,7,19,38,58,-20,37
SV Josko Rie,7430,9,9,6,21,33,57,-24,33
St. Pölten,7430,10,8,8,20,38,65,-27,32
FC Salzburg,7431,1,18,9,9,60,33,27,63
SC Rheindorf,7431,2,18,9,9,56,45,11,63
SK Sturm Gra,7431,3,17,9,10,57,40,17,60
Vienna,7431,4,18,3,15,65,62,3,57
RZ Pellets W,7431,5,15,7,14,49,55,-6,52
Rapid Vienna,7431,6,13,11,12,54,39,15,50
SV Josko Rie,7431,7,14,5,17,35,43,-8,47
Admira Wacke,7431,8,13,5,18,42,61,-19,44
St. Pölten,7431,9,7,12,17,37,57,-20,33
Mattersburg,7431,10,8,8,20,36,56,-20,32
FC Salzburg,7432,1,22,7,7,74,30,44,73
SC Rheindorf,7432,2,20,9,7,59,37,22,69
SK Sturm Gra,7432,3,20,5,11,59,34,25,65
Vienna,7432,4,18,6,12,63,57,6,60
Rapid Vienna,7432,5,15,11,10,62,45,17,56
RZ Pellets W,7432,6,11,9,16,44,56,-12,42
Mattersburg,7432,7,8,11,17,47,68,-21,35
Admira Wacke,7432,8,10,5,21,34,58,-24,35
SV Josko Rie,7432,9,8,8,20,34,62,-28,32
St. Pölten,7432,10,6,13,17,40,69,-29,31
FC Salzburg,7433,1,22,7,7,66,24,42,73
Vienna,7433,2,21,5,10,64,42,22,68
SC Rheindorf,7433,3,17,9,10,52,46,6,60
SK Sturm Gra,7433,4,14,10,12,49,37,12,52
Rapid Vienna,7433,5,14,9,13,62,42,20,51
Admira Wacke,7433,6,14,5,17,39,58,-19,47
RZ Pellets W,7433,7,13,7,16,40,53,-13,46
SV Josko Rie,7433,8,11,7,18,35,53,-18,40
St. Pölten,7433,9,8,10,18,39,62,-23,34
Mattersburg,7433,10,7,9,20,39,68,-29,30
FC Salzburg,7434,1,21,7,8,68,34,34,70
SC Rheindorf,7434,2,20,6,10,59,50,9,66
SK Sturm Gra,7434,3,20,4,12,59,33,26,64
Vienna,7434,4,17,4,15,61,57,4,55
Rapid Vienna,7434,5,14,11,11,59,43,16,53
Admira Wacke,7434,6,13,6,17,37,59,-22,45
RZ Pellets W,7434,7,12,8,16,44,55,-11,44
St. Pölten,7434,8,10,8,18,46,66,-20,38
Mattersburg,7434,9,9,8,19,36,57,-21,35
SV Josko Rie,7434,10,8,10,18,36,51,-15,34
SC Rheindorf,7435,1,21,8,7,64,39,25,71
FC Salzburg,7435,2,18,10,8,58,34,24,64
Vienna,7435,3,19,4,13,66,59,7,61
SK Sturm Gra,7435,4,18,5,13,58,41,17,59
Admira Wacke,7435,5,15,9,12,45,50,-5,54
Rapid Vienna,7435,6,14,11,11,54,40,14,53
RZ Pellets W,7435,7,11,8,17,43,58,-15,41
SV Josko Rie,7435,8,8,9,19,33,55,-22,33
St. Pölten,7435,9,7,11,18,47,66,-19,32
Mattersburg,7435,10,8,7,21,34,60,-26,31
SK Sturm Gra,7436,1,19,10,7,67,34,33,67
FC Salzburg,7436,2,19,7,10,65,45,20,64
Vienna,7436,3,19,6,11,62,49,13,63
SC Rheindorf,7436,4,17,10,9,56,45,11,61
Rapid Vienna,7436,5,16,10,10,58,34,24,58
RZ Pellets W,7436,6,12,9,15,48,54,-6,45
SV Josko Rie,7436,7,13,6,17,35,49,-14,45
Mattersburg,7436,8,7,11,18,35,57,-22,32
Admira Wacke,7436,9,9,5,22,37,69,-32,32
St. Pölten,7436,10,7,10,19,39,66,-27,31
SC Rheindorf,7437,1,23,7,6,58,34,24,76
FC Salzburg,7437,2,23,4,9,61,29,32,73
SK Sturm Gra,7437,3,18,7,11,60,32,28,61
Vienna,7437,4,17,7,12,55,48,7,58
Rapid Vienna,7437,5,13,9,14,61,49,12,48
Admira Wacke,7437,6,13,4,19,39,62,-23,43
SV Josko Rie,7437,7,13,3,20,36,53,-17,42
RZ Pellets W,7437,8,10,9,17,42,59,-17,39
St. Pölten,7437,9,9,8,19,40,66,-26,35
Mattersburg,7437,10,7,10,19,38,58,-20,31
FC Salzburg,7438,1,24,6,6,74,29,45,78
SC Rheindorf,7438,2,22,8,6,67,42,25,74
SK Sturm Gra,7438,3,19,6,11,68,41,27,63
Vienna,7438,4,17,8,11,67,54,13,59
St. Pölten,7438,5,12,9,15,50,68,-18,45
Rapid Vienna,7438,6,11,11,14,49,43,6,44
RZ Pellets W,7438,7,8,13,15,43,60,-17,37
Admira Wacke,7438,8,10,6,20,36,68,-32,36
SV Josko Rie,7438,9,10,4,22,34,59,-25,34
Mattersburg,7438,10,7,9,20,38,62,-24,30
FC Salzburg,7439,1,20,9,7,62,29,33,69
SK Sturm Gra,7439,2,19,8,9,59,33,26,65
SC Rheindorf,7439,3,19,7,10,56,44,12,64
Rapid Vienna,7439,4,17,11,8,58,33,25,62
Vienna,7439,5,16,7,13,58,54,4,55
RZ Pellets W,7439,6,11,9,16,43,51,-8,42
SV Josko Rie,7439,7,11,5,20,39,55,-16,38
Admira Wacke,7439,8,10,8,18,28,55,-27,38
Mattersburg,7439,9,8,10,18,31,49,-18,34
St. Pölten,7439,10,7,10,19,37,68,-31,31
FC Salzburg,7440,1,18,10,8,63,30,33,64
Vienna,7440,2,19,6,11,63,49,14,63
SK Sturm Gra,7440,3,17,7,12,55,41,14,58
Rapid Vienna,7440,4,15,12,9,64,43,21,57
SC Rheindorf,7440,5,17,6,13,52,46,6,57
Admira Wacke,7440,6,16,7,13,47,52,-5,55
RZ Pellets W,7440,7,12,8,16,54,62,-8,44
SV Josko Rie,7440,8,11,7,18,39,54,-15,40
St. Pölten,7440,9,9,8,19,45,74,-29,35
Mattersburg,7440,10,6,9,21,34,65,-31,27
FC Salzburg,7441,1,23,5,8,66,29,37,74
SC Rheindorf,7441,2,20,7,9,54,38,16,67
SK Sturm Gra,7441,3,17,9,10,60,40,20,60
Vienna,7441,4,18,3,15,67,59,8,57
Rapid Vienna,7441,5,14,14,8,52,32,20,56
St. Pölten,7441,6,10,10,16,50,68,-18,40
Admira Wacke,7441,7,12,4,20,38,60,-22,40
RZ Pellets W,7441,8,11,6,19,43,61,-18,39
SV Josko Rie,7441,9,12,3,21,39,59,-20,39
Mattersburg,7441,10,9,7,20,37,60,-23,34
SK Sturm Gra,7442,1,22,4,10,63,37,26,70
FC Salzburg,7442,2,20,8,8,62,34,28,68
Vienna,7442,3,19,7,10,68,47,21,64
SC Rheindorf,7442,4,18,8,10,53,43,10,62
Rapid Vienna,7442,5,16,10,10,55,38,17,58
RZ Pellets W,7442,6,13,7,16,46,57,-11,46
SV Josko Rie,7442,7,11,7,18,36,51,-15,40
Mattersburg,7442,8,8,8,20,38,61,-23,32
St. Pölten,7442,9,7,10,19,39,64,-25,31
Admira Wacke,7442,10,7,9,20,32,60,-28,30
FC Salzburg,7443,1,21,9,6,66,33,33,72
SK Sturm Gra,7443,2,20,8,8,59,32,27,68
SC Rheindorf,7443,3,18,8,10,53,47,6,62
Vienna,7443,4,16,5,15,58,52,6,53
Rapid Vienna,7443,5,13,12,11,60,39,21,51
St. Pölten,7443,6,12,9,15,48,57,-9,45
Admira Wacke,7443,7,9,13,14,34,53,-19,40
RZ Pellets W,7443,8,10,9,17,46,63,-17,39
SV Josko Rie,7443,9,9,6,21,37,60,-23,33
Mattersburg,7443,10,8,9,19,34,59,-25,33
FC Salzburg,7444,1,22,8,6,72,25,47,74
SC Rheindorf,7444,2,21,8,7,58,35,23,71
SK Sturm Gra,7444,3,22,4,10,65,40,25,70
Vienna,7444,4,16,9,11,62,53,9,57
Rapid Vienna,7444,5,13,12,11,54,42,12,51
RZ Pellets W,7444,6,12,8,16,46,58,-12,44
SV Josko Rie,7444,7,12,6,18,46,58,-12,42
Admira Wacke,7444,8,10,6,20,43,66,-23,36
Mattersburg,7444,9,8,8,20,41,66,-25,32
St. Pölten,7444,10,6,7,23,39,83,-44,25
FC Salzburg,7445,1,21,7,8,63,31,32,70
SC Rheindorf,7445,2,19,8,9,63,46,17,65
Vienna,7445,3,19,3,14,66,55,11,60
SK Sturm Gra,7445,4,17,8,11,65,43,22,59
Rapid Vienna,7445,5,12,12,12,54,46,8,48
RZ Pellets W,7445,6,13,6,17,45,49,-4,45
Admira Wacke,7445,7,13,5,18,38,63,-25,44
Mattersburg,7445,8,11,6,19,34,57,-23,39
SV Josko Rie,7445,9,10,8,18,34,49,-15,38
St. Pölten,7445,10,7,13,16,40,63,-23,34
FC Salzburg,7446,1,20,11,5,61,24,37,71
SC Rheindorf,7446,2,20,8,8,57,39,18,68
SK Sturm Gra,7446,3,17,9,10,53,31,22,60
Vienna,7446,4,18,4,14,59,49,10,58
Rapid Vienna,7446,5,14,12,10,55,40,15,54
Admira Wacke,7446,6,12,8,16,37,56,-19,44
SV Josko Rie,7446,7,11,8,17,37,49,-12,41
St. Pölten,7446,8,7,13,16,37,61,-24,34
Mattersburg,7446,9,7,12,17,41,57,-16,33
RZ Pellets W,7446,10,8,7,21,35,66,-31,31
FC Salzburg,7447,1,22,5,9,74,35,39,71
SC Rheindorf,7447,2,20,7,9,59,45,14,67
SK Sturm Gra,7447,3,16,11,9,60,40,20,59
Vienna,7447,4,17,7,12,59,54,5,58
Rapid Vienna,7447,5,13,10,13,55,46,9,49
Admira Wacke,7447,6,13,6,17,38,57,-19,45
RZ Pellets W,7447,7,12,8,16,44,53,-9,44
SV Josko Rie,7447,8,11,6,19,32,50,-18,39
St. Pölten,7447,9,8,11,17,42,65,-23,35
Mattersburg,7447,10,9,7,20,35,53,-18,34
SC Rheindorf,7448,1,24,5,7,68,42,26,77
FC Salzburg,7448,2,20,6,10,64,34,30,66
Rapid Vienna,7448,3,18,9,9,63,36,27,63
Vienna,7448,4,19,5,12,61,51,10,62
SK Sturm Gra,7448,5,18,4,14,61,41,20,58
RZ Pellets W,7448,6,12,6,18,47,61,-14,42
Admira Wacke,7448,7,11,7,18,36,58,-22,40
Mattersburg,7448,8,10,6,20,39,64,-25,36
SV Josko Rie,7448,9,9,7,20,33,58,-25,34
St. Pölten,7448,10,7,9,20,40,67,-27,30
FC Salzburg,7449,1,21,7,8,61,26,35,70
SK Sturm Gra,7449,2,20,5,11,62,34,28,65
Vienna,7449,3,20,5,11,68,53,15,65
SC Rheindorf,7449,4,18,8,10,51,45,6,62
Rapid Vienna,7449,5,14,13,9,52,37,15,55
RZ Pellets W,7449,6,14,7,15,48,52,-4,49
SV Josko Rie,7449,7,11,5,20,35,54,-19,38
St. Pölten,7449,8,8,10,18,40,62,-22,34
Admira Wacke,7449,9,9,7,20,31,63,-32,34
Mattersburg,7449,10,9,5,22,35,57,-22,32
SC Rheindorf,7450,1,22,6,8,64,37,27,72
FC Salzburg,7450,2,21,8,7,63,28,35,71
SK Sturm Gra,7450,3,18,10,8,53,31,22,64
Vienna,7450,4,17,6,13,59,54,5,57
Rapid Vienna,7450,5,13,11,12,63,45,18,50
SV Josko Rie,7450,6,13,5,18,38,48,-10,44
RZ Pellets W,7450,7,11,10,15,43,59,-16,43
Admira Wacke,7450,8,11,6,19,36,63,-27,39
St. Pölten,7450,9,9,10,17,41,58,-17,37
Mattersburg,7450,10,4,10,22,29,66,-37,22
FC Salzburg,7451,1,22,8,6,65,30,35,74
SK Sturm Gra,7451,2,21,6,9,60,30,30,69
SC Rheindorf,7451,3,21,6,9,56,37,19,69
Vienna,7451,4,19,5,12,66,52,14,62
Rapid Vienna,7451,5,12,12,12,54,46,8,48
Admira Wacke,7451,6,11,9,16,40,56,-16,42
SV Josko Rie,7451,7,11,6,19,35,50,-15,39
RZ Pellets W,7451,8,11,6,19,42,58,-16,39
St. Pölten,7451,9,8,9,19,42,64,-22,33
Mattersburg,7451,10,7,7,22,31,68,-37,28
FC Salzburg,7452,1,22,6,8,65,32,33,72
SK Sturm Gra,7452,2,19,7,10,66,36,30,64
SC Rheindorf,7452,3,18,9,9,51,40,11,63
Vienna,7452,4,19,5,12,63,52,11,62
RZ Pellets W,7452,5,14,6,16,48,59,-11,48
Rapid Vienna,7452,6,11,13,12,51,42,9,46
SV Josko Rie,7452,7,12,5,19,38,50,-12,41
St. Pölten,7452,8,10,8,18,42,68,-26,38
Admira Wacke,7452,9,9,8,19,36,59,-23,35
Mattersburg,7452,10,7,11,18,32,54,-22,32
SC Rheindorf,7453,1,22,8,6,60,34,26,74
FC Salzburg,7453,2,19,7,10,63,34,29,64
Rapid Vienna,7453,3,16,11,9,53,33,20,59
Vienna,7453,4,18,5,13,64,52,12,59
SK Sturm Gra,7453,5,16,10,10,55,36,19,58
RZ Pellets W,7453,6,16,6,14,51,51,0,54
SV Josko Rie,7453,7,11,6,19,42,55,-13,39
Admira Wacke,7453,8,10,7,19,35,59,-24,37
St. Pölten,7453,9,8,8,20,37,70,-33,32
Mattersburg,7453,10,7,6,23,35,71,-36,27
FC Salzburg,7454,1,21,9,6,65,33,32,72
SC Rheindorf,7454,2,19,8,9,50,41,9,65
SK Sturm Gra,7454,3,18,6,12,58,34,24,60
Vienna,7454,4,17,5,14,52,50,2,56
Rapid Vienna,7454,5,13,14,9,53,37,16,53
RZ Pellets W,7454,6,12,8,16,40,49,-9,44
Admira Wacke,7454,7,11,7,18,40,64,-24,40
St. Pölten,7454,8,9,11,16,45,61,-16,38
Mattersburg,7454,9,9,10,17,42,54,-12,37
SV Josko Rie,7454,10,7,10,19,30,52,-22,31
SC Rheindorf,7455,1,23,7,6,65,36,29,76
FC Salzburg,7455,2,21,9,6,64,28,36,72
SK Sturm Gra,7455,3,20,6,10,65,37,28,66
Vienna,7455,4,18,5,13,59,49,10,59
Rapid Vienna,7455,5,13,11,12,55,48,7,50
Admira Wacke,7455,6,14,4,18,43,64,-21,46
Mattersburg,7455,7,10,9,17,40,52,-12,39
RZ Pellets W,7455,8,11,4,21,40,58,-18,37
St. Pölten,7455,9,9,8,19,41,70,-29,35
SV Josko Rie,7455,10,7,5,24,30,60,-30,26
FC Salzburg,7456,1,23,7,6,67,28,39,76
Vienna,7456,2,23,3,10,71,47,24,72
SK Sturm Gra,7456,3,20,5,11,55,30,25,65
SC Rheindorf,7456,4,17,6,13,48,45,3,57
Mattersburg,7456,5,13,7,16,42,53,-11,46
Rapid Vienna,7456,6,12,9,15,50,46,4,45
RZ Pellets W,7456,7,11,7,18,44,56,-12,40
Admira Wacke,7456,8,11,5,20,36,63,-27,38
SV Josko Rie,7456,9,11,4,21,38,53,-15,37
St. Pölten,7456,10,8,9,19,44,74,-30,33
FC Salzburg,7457,1,23,7,6,68,28,40,76
SK Sturm Gra,7457,2,20,8,8,56,25,31,68
SC Rheindorf,7457,3,20,5,11,60,43,17,65
Vienna,7457,4,17,7,12,60,57,3,58
Rapid Vienna,7457,5,13,12,11,55,39,16,51
RZ Pellets W,7457,6,13,7,16,46,51,-5,46
SV Josko Rie,7457,7,12,4,20,34,53,-19,40
Admira Wacke,7457,8,12,4,20,35,61,-26,40
St. Pölten,7457,9,8,8,20,40,71,-31,32
Mattersburg,7457,10,7,8,21,35,61,-26,29
Vienna,7458,1,19,8,9,66,53,13,65
FC Salzburg,7458,2,18,10,8,66,38,28,64
SK Sturm Gra,7458,3,19,6,11,64,43,21,63
SC Rheindorf,7458,4,19,6,11,58,49,9,63
RZ Pellets W,7458,5,15,7,14,52,55,-3,52
Rapid Vienna,7458,6,14,9,13,58,40,18,51
St. Pölten,7458,7,9,10,17,42,62,-20,37
Admira Wacke,7458,8,10,7,19,33,61,-28,37
Mattersburg,7458,9,10,6,20,39,55,-16,36
SV Josko Rie,7458,10,10,5,21,38,60,-22,35
SC Rheindorf,7459,1,20,8,8,59,39,20,68
FC Salzburg,7459,2,19,9,8,57,28,29,66
SK Sturm Gra,7459,3,19,7,10,61,38,23,64
Vienna,7459,4,18,5,13,60,55,5,59
RZ Pellets W,7459,5,15,8,13,52,52,0,53
Rapid Vienna,7459,6,13,10,13,49,45,4,49
SV Josko Rie,7459,7,13,5,18,45,55,-10,44
Admira Wacke,7459,8,11,7,18,38,57,-19,40
St. Pölten,7459,9,8,9,19,40,62,-22,33
Mattersburg,7459,10,5,10,21,30,60,-30,25
FC Salzburg,7460,1,21,7,8,68,32,36,70
SK Sturm Gra,7460,2,18,9,9,58,34,24,63
SC Rheindorf,7460,3,18,6,12,50,45,5,60
Rapid Vienna,7460,4,16,10,10,56,37,19,58
Vienna,7460,5,17,5,14,59,49,10,56
RZ Pellets W,7460,6,15,7,14,50,56,-6,52
Admira Wacke,7460,7,12,7,17,35,57,-22,43
SV Josko Rie,7460,8,11,7,18,37,52,-15,40
Mattersburg,7460,9,8,10,18,42,62,-20,34
St. Pölten,7460,10,5,10,21,32,63,-31,25
FC Salzburg,7461,1,22,6,8,69,33,36,72
SC Rheindorf,7461,2,21,8,7,59,36,23,71
SK Sturm Gra,7461,3,19,6,11,57,36,21,63
Vienna,7461,4,19,5,12,65,50,15,62
Rapid Vienna,7461,5,13,11,12,58,48,10,50
RZ Pellets W,7461,6,12,6,18,50,63,-13,42
Admira Wacke,7461,7,12,5,19,35,64,-29,41
SV Josko Rie,7461,8,10,6,20,33,55,-22,36
St. Pölten,7461,9,9,8,19,45,69,-24,35
Mattersburg,7461,10,8,9,19,45,62,-17,33
SC Rheindorf,7462,1,20,8,8,57,39,18,68
FC Salzburg,7462,2,19,9,8,62,31,31,66
SK Sturm Gra,7462,3,18,7,11,54,33,21,61
Vienna,7462,4,18,5,13,65,51,14,59
Rapid Vienna,7462,5,16,8,12,55,37,18,56
SV Josko Rie,7462,6,13,6,17,38,52,-14,45
RZ Pellets W,7462,7,11,9,16,43,54,-11,42
Admira Wacke,7462,8,11,6,19,40,67,-27,39
St. Pölten,7462,9,9,11,16,40,61,-21,38
Mattersburg,7462,10,6,9,21,36,65,-29,27
SC Rheindorf,7463,1,22,6,8,61,38,23,72
FC Salzburg,7463,2,22,4,10,71,32,39,70
SK Sturm Gra,7463,3,19,8,9,68,43,25,65
Vienna,7463,4,19,2,15,68,62,6,59
Rapid Vienna,7463,5,13,8,15,52,51,1,47
St. Pölten,7463,6,12,10,14,47,58,-11,46
SV Josko Rie,7463,7,12,6,18,46,53,-7,42
RZ Pellets W,7463,8,12,6,18,43,52,-9,42
Admira Wacke,7463,9,11,5,20,31,67,-36,38
Mattersburg,7463,10,6,9,21,28,59,-31,27
FC Salzburg,7464,1,21,8,7,60,26,34,71
SK Sturm Gra,7464,2,19,8,9,62,33,29,65
SC Rheindorf,7464,3,18,10,8,52,39,13,64
Rapid Vienna,7464,4,16,10,10,59,37,22,58
Vienna,7464,5,17,7,12,55,47,8,58
RZ Pellets W,7464,6,11,7,18,46,65,-19,40
Admira Wacke,7464,7,10,10,16,36,56,-20,40
St. Pölten,7464,8,9,9,18,36,62,-26,36
SV Josko Rie,7464,9,9,6,21,40,60,-20,33
Mattersburg,7464,10,8,9,19,32,53,-21,33
SC Rheindorf,7465,1,22,6,8,62,41,21,72
FC Salzburg,7465,2,19,9,8,61,34,27,66
Vienna,7465,3,18,5,13,65,50,15,59
SK Sturm Gra,7465,4,17,6,13,58,41,17,57
Rapid Vienna,7465,5,14,12,10,52,37,15,54
RZ Pellets W,7465,6,15,7,14,47,49,-2,52
Admira Wacke,7465,7,10,9,17,35,58,-23,39
SV Josko Rie,7465,8,11,5,20,33,58,-25,38
Mattersburg,7465,9,8,9,19,37,56,-19,33
St. Pölten,7465,10,8,8,20,36,62,-26,32
FC Salzburg,7466,1,21,10,5,70,29,41,73
SC Rheindorf,7466,2,20,9,7,55,38,17,69
SK Sturm Gra,7466,3,17,6,13,57,37,20,57
Vienna,7466,4,16,8,12,58,52,6,56
Rapid Vienna,7466,5,11,12,13,50,42,8,45
RZ Pellets W,7466,6,12,9,15,37,49,-12,45
Admira Wacke,7466,7,10,11,15,37,57,-20,41
Mattersburg,7466,8,10,9,17,41,56,-15,39
SV Josko Rie,7466,9,9,11,16,32,49,-17,38
St. Pölten,7466,10,7,9,20,37,65,-28,30
FC Salzburg,7467,1,21,9,6,61,25,36,72
SK Sturm Gra,7467,2,22,4,10,63,33,30,70
Vienna,7467,3,20,7,9,68,47,21,67
SC Rheindorf,7467,4,19,7,10,56,40,16,64
Rapid Vienna,7467,5,11,12,13,51,44,7,45
Admira Wacke,7467,6,12,6,18,39,61,-22,42
RZ Pellets W,7467,7,11,8,17,42,56,-14,41
St. Pölten,7467,8,7,13,16,41,64,-23,34
SV Josko Rie,7467,9,10,4,22,30,55,-25,34
Mattersburg,7467,10,8,8,20,36,62,-26,32
FC Salzburg,7468,1,21,7,8,62,33,29,70
SC Rheindorf,7468,2,20,5,11,59,45,14,65
SK Sturm Gra,7468,3,19,7,10,64,40,24,64
Vienna,7468,4,20,4,12,68,51,17,64
Rapid Vienna,7468,5,14,9,13,54,40,14,51
SV Josko Rie,7468,6,14,2,20,40,55,-15,44
Admira Wacke,7468,7,12,6,18,38,55,-17,42
RZ Pellets W,7468,8,12,6,18,43,61,-18,42
Mattersburg,7468,9,11,6,19,38,52,-14,39
St. Pölten,7468,10,7,8,21,41,75,-34,29
FC Salzburg,7469,1,23,6,7,70,26,44,75
SC Rheindorf,7469,2,22,5,9,65,41,24,71
Vienna,7469,3,19,5,12,60,49,11,62
SK Sturm Gra,7469,4,16,6,14,49,37,12,54
Rapid Vienna,7469,5,13,10,13,49,41,8,49
Admira Wacke,7469,6,12,10,14,41,55,-14,46
RZ Pellets W,7469,7,10,10,16,41,54,-13,40
Mattersburg,7469,8,10,9,17,42,59,-17,39
St. Pölten,7469,9,8,9,19,39,64,-25,33
SV Josko Rie,7469,10,8,8,20,28,58,-30,32
FC Salzburg,7470,1,22,6,8,62,27,35,72
Vienna,7470,2,21,4,11,67,53,14,67
SK Sturm Gra,7470,3,20,6,10,62,30,32,66
SC Rheindorf,7470,4,20,6,10,53,39,14,66
Rapid Vienna,7470,5,15,11,10,54,36,18,56
SV Josko Rie,7470,6,15,3,18,34,49,-15,48
RZ Pellets W,7470,7,10,7,19,41,60,-19,37
Admira Wacke,7470,8,9,10,17,36,57,-21,37
St. Pölten,7470,9,7,8,21,43,72,-29,29
Mattersburg,7470,10,7,7,22,34,63,-29,28
SK Sturm Gra,7471,1,22,5,9,61,27,34,71
SC Rheindorf,7471,2,20,7,9,68,45,23,67
FC Salzburg,7471,3,17,11,8,58,33,25,62
Vienna,7471,4,15,8,13,57,51,6,53
RZ Pellets W,7471,5,13,10,13,48,52,-4,49
Rapid Vienna,7471,6,11,12,13,50,45,5,45
SV Josko Rie,7471,7,12,7,17,39,54,-15,43
Mattersburg,7471,8,9,11,16,41,59,-18,38
Admira Wacke,7471,9,9,9,18,39,63,-24,36
St. Pölten,7471,10,8,8,20,36,68,-32,32
FC Salzburg,7472,1,21,7,8,62,35,27,70
SC Rheindorf,7472,2,20,8,8,51,35,16,68
SK Sturm Gra,7472,3,19,9,8,60,33,27,66
Vienna,7472,4,20,5,11,61,49,12,65
Rapid Vienna,7472,5,12,14,10,48,33,15,50
Admira Wacke,7472,6,10,11,15,37,53,-16,41
RZ Pellets W,7472,7,10,10,16,43,55,-12,40
Mattersburg,7472,8,9,7,20,37,57,-20,34
St. Pölten,7472,9,8,8,20,36,63,-27,32
SV Josko Rie,7472,10,7,9,20,27,49,-22,30
FC Salzburg,7473,1,20,8,8,63,28,35,68
Vienna,7473,2,19,8,9,62,50,12,65
SK Sturm Gra,7473,3,19,7,10,61,38,23,64
SC Rheindorf,7473,4,16,10,10,49,48,1,58
Rapid Vienna,7473,5,14,12,10,60,40,20,54
SV Josko Rie,7473,6,12,9,15,33,43,-10,45
RZ Pellets W,7473,7,12,8,16,45,49,-4,44
Admira Wacke,7473,8,9,12,15,37,56,-19,39
St. Pölten,7473,9,5,13,18,35,63,-28,28
Mattersburg,7473,10,5,11,20,29,59,-30,26
FC Salzburg,7474,1,24,5,7,69,29,40,77
Rapid Vienna,7474,2,19,8,9,65,37,28,65
SC Rheindorf,7474,3,19,7,10,55,47,8,64
Vienna,7474,4,18,7,11,67,53,14,61
SK Sturm Gra,7474,5,17,7,12,63,41,22,58
RZ Pellets W,7474,6,11,6,19,41,61,-20,39
Admira Wacke,7474,7,11,6,19,39,61,-22,39
SV Josko Rie,7474,8,10,5,21,37,60,-23,35
St. Pölten,7474,9,9,8,19,43,68,-25,35
Mattersburg,7474,10,9,7,20,37,59,-22,34
FC Salzburg,7475,1,24,6,6,67,25,42,78
SK Sturm Gra,7475,2,19,8,9,59,36,23,65
SC Rheindorf,7475,3,17,9,10,52,41,11,60
Vienna,7475,4,16,6,14,63,58,5,54
RZ Pellets W,7475,5,13,8,15,43,53,-10,47
Rapid Vienna,7475,6,12,9,15,49,47,2,45
Admira Wacke,7475,7,12,5,19,35,66,-31,41
SV Josko Rie,7475,8,11,6,19,34,45,-11,39
St. Pölten,7475,9,8,13,15,43,54,-11,37
Mattersburg,7475,10,9,8,19,35,55,-20,35
FC Salzburg,7476,1,20,8,8,62,28,34,68
SK Sturm Gra,7476,2,18,9,9,59,36,23,63
Vienna,7476,3,19,5,12,63,45,18,62
SC Rheindorf,7476,4,17,9,10,48,41,7,60
Rapid Vienna,7476,5,15,8,13,51,38,13,53
RZ Pellets W,7476,6,13,9,14,47,52,-5,48
St. Pölten,7476,7,10,11,15,45,58,-13,41
SV Josko Rie,7476,8,11,3,22,28,54,-26,36
Admira Wacke,7476,9,10,6,20,36,64,-28,36
Mattersburg,7476,10,9,8,19,34,57,-23,35
SC Rheindorf,7477,1,21,7,8,57,34,23,70
FC Salzburg,7477,2,19,8,9,64,40,24,65
Vienna,7477,3,20,3,13,67,54,13,63
SK Sturm Gra,7477,4,19,5,12,62,37,25,62
Rapid Vienna,7477,5,14,11,11,58,41,17,53
RZ Pellets W,7477,6,15,4,17,45,49,-4,49
SV Josko Rie,7477,7,12,6,18,35,54,-19,42
St. Pölten,7477,8,10,9,17,45,65,-20,39
Mattersburg,7477,9,10,6,20,43,60,-17,36
Admira Wacke,7477,10,8,5,23,33,75,-42,29
SK Sturm Gra,7478,1,20,7,9,56,30,26,67
Vienna,7478,2,19,5,12,68,55,13,62
FC Salzburg,7478,3,18,7,11,60,38,22,61
SC Rheindorf,7478,4,18,7,11,54,46,8,61
Rapid Vienna,7478,5,16,12,8,54,34,20,60
RZ Pellets W,7478,6,12,10,14,41,48,-7,46
Mattersburg,7478,7,10,8,18,39,53,-14,38
Admira Wacke,7478,8,10,7,19,37,58,-21,37
SV Josko Rie,7478,9,10,5,21,36,60,-24,35
St. Pölten,7478,10,7,12,17,41,64,-23,33
SC Rheindorf,7479,1,25,4,7,62,40,22,79
FC Salzburg,7479,2,21,7,8,61,30,31,70
Vienna,7479,3,20,3,13,62,43,19,63
SK Sturm Gra,7479,4,18,6,12,59,37,22,60
Rapid Vienna,7479,5,15,9,12,61,45,16,54
SV Josko Rie,7479,6,11,6,19,36,52,-16,39
Mattersburg,7479,7,10,9,17,41,59,-18,39
RZ Pellets W,7479,8,11,5,20,45,63,-18,38
Admira Wacke,7479,9,10,5,21,34,64,-30,35
St. Pölten,7479,10,8,8,20,34,62,-28,32
FC Salzburg,7480,1,21,9,6,71,35,36,72
SC Rheindorf,7480,2,17,13,6,51,36,15,64
SK Sturm Gra,7480,3,15,11,10,53,37,16,56
Vienna,7480,4,16,8,12,68,55,13,56
Rapid Vienna,7480,5,15,9,12,62,44,18,54
RZ Pellets W,7480,6,12,8,16,50,58,-8,44
St. Pölten,7480,7,10,11,15,43,64,-21,41
SV Josko Rie,7480,8,11,5,20,32,51,-19,38
Admira Wacke,7480,9,9,9,18,33,63,-30,36
Mattersburg,7480,10,8,9,19,40,60,-20,33
SC Rheindorf,7481,1,22,5,9,60,40,20,71
FC Salzburg,7481,2,21,7,8,67,29,38,70
Vienna,7481,3,21,5,10,56,45,11,68
SK Sturm Gra,7481,4,18,7,11,50,28,22,61
Rapid Vienna,7481,5,15,10,11,52,36,16,55
RZ Pellets W,7481,6,12,8,16,43,54,-11,44
Admira Wacke,7481,7,10,6,20,32,60,-28,36
Mattersburg,7481,8,9,7,20,42,61,-19,34
St. Pölten,7481,9,7,12,17,38,61,-23,33
SV Josko Rie,7481,10,9,5,22,28,54,-26,32
SC Rheindorf,7482,1,22,6,8,58,41,17,72
SK Sturm Gra,7482,2,20,9,7,63,31,32,69
FC Salzburg,7482,3,19,7,10,68,43,25,64
Rapid Vienna,7482,4,14,12,10,63,39,24,54
Vienna,7482,5,15,7,14,53,53,0,52
RZ Pellets W,7482,6,13,7,16,46,58,-12,46
Admira Wacke,7482,7,13,7,16,33,49,-16,46
Mattersburg,7482,8,9,8,19,42,64,-22,35
St. Pölten,7482,9,8,8,20,44,67,-23,32
SV Josko Rie,7482,10,9,5,22,31,56,-25,32
FC Salzburg,7483,1,23,6,7,69,31,38,75
SK Sturm Gra,7483,2,21,7,8,73,38,35,70
SC Rheindorf,7483,3,18,8,10,56,48,8,62
Rapid Vienna,7483,4,16,9,11,59,40,19,57
Vienna,7483,5,17,6,13,65,55,10,57
Admira Wacke,7483,6,13,8,15,39,52,-13,47
SV Josko Rie,7483,7,13,4,19,40,55,-15,43
RZ Pellets W,7483,8,9,8,19,41,62,-21,35
St. Pölten,7483,9,8,9,19,43,71,-28,33
Mattersburg,7483,10,6,7,23,31,64,-33,25
SC Rheindorf,7484,1,20,9,7,55,38,17,69
FC Salzburg,7484,2,19,10,7,67,28,39,67
SK Sturm Gra,7484,3,17,10,9,57,33,24,61
Vienna,7484,4,18,5,13,58,54,4,59
Rapid Vienna,7484,5,16,10,10,57,38,19,58
RZ Pellets W,7484,6,11,8,17,47,60,-13,41
Admira Wacke,7484,7,11,6,19,41,64,-23,39
SV Josko Rie,7484,8,11,6,19,31,56,-25,39
St. Pölten,7484,9,8,10,18,33,57,-24,34
Mattersburg,7484,10,8,8,20,39,57,-18,32
FC Salzburg,7485,1,21,8,7,68,33,35,71
SC Rheindorf,7485,2,21,7,8,55,39,16,70
Rapid Vienna,7485,3,17,12,7,62,33,29,63
Vienna,7485,4,20,3,13,69,54,15,63
SK Sturm Gra,7485,5,19,5,12,61,40,21,62
Admira Wacke,7485,6,13,4,19,43,60,-17,43
RZ Pellets W,7485,7,10,7,19,42,70,-28,37
St. Pölten,7485,8,8,11,17,37,60,-23,35
SV Josko Rie,7485,9,10,3,23,33,59,-26,33
Mattersburg,7485,10,7,8,21,40,62,-22,29
FC Salzburg,7486,1,23,6,7,70,30,40,75
SK Sturm Gra,7486,2,20,6,10,64,37,27,66
SC Rheindorf,7486,3,17,11,8,51,40,11,62
Vienna,7486,4,18,6,12,62,52,10,60
Rapid Vienna,7486,5,11,15,10,55,43,12,48
Admira Wacke,7486,6,11,9,16,43,60,-17,42
RZ Pellets W,7486,7,11,7,18,42,58,-16,40
SV Josko Rie,7486,8,10,6,20,35,54,-19,36
Mattersburg,7486,9,8,11,17,30,55,-25,35
St. Pölten,7486,10,6,13,17,38,61,-23,31
FC Salzburg,7487,1,22,8,6,69,29,40,74
SC Rheindorf,7487,2,21,7,8,52,34,18,70
SK Sturm Gra,7487,3,18,8,10,58,37,21,62
Rapid Vienna,7487,4,15,13,8,57,40,17,58
Vienna,7487,5,17,5,14,60,52,8,56
RZ Pellets W,7487,6,13,8,15,49,55,-6,47
Admira Wacke,7487,7,11,9,16,45,66,-21,42
Mattersburg,7487,8,9,7,20,37,61,-24,34
SV Josko Rie,7487,9,9,6,21,32,54,-22,33
St. Pölten,7487,10,6,7,23,41,72,-31,25
FC Salzburg,7488,1,22,7,7,74,31,43,73
SK Sturm Gra,7488,2,19,9,8,62,33,29,66
Vienna,7488,3,20,6,10,67,54,13,66
SC Rheindorf,7488,4,18,8,10,53,47,6,62
Rapid Vienna,7488,5,11,13,12,52,45,7,46
Mattersburg,7488,6,11,8,17,50,59,-9,41
RZ Pellets W,7488,7,11,8,17,45,55,-10,41
SV Josko Rie,7488,8,11,4,21,35,62,-27,37
Admira Wacke,7488,9,10,5,21,37,64,-27,35
St. Pölten,7488,10,8,10,18,48,73,-25,34
SC Rheindorf,7489,1,23,5,8,57,34,23,74
FC Salzburg,7489,2,18,11,7,66,37,29,65
SK Sturm Gra,7489,3,18,5,13,63,41,22,59
Vienna,7489,4,18,5,13,61,50,11,59
RZ Pellets W,7489,5,14,8,14,54,57,-3,50
Rapid Vienna,7489,6,13,10,13,50,42,8,49
SV Josko Rie,7489,7,13,6,17,39,51,-12,45
Admira Wacke,7489,8,11,4,21,34,64,-30,37
St. Pölten,7489,9,7,12,17,43,69,-26,33
Mattersburg,7489,10,7,10,19,31,53,-22,31
FC Salzburg,7490,1,20,10,6,64,32,32,70
SK Sturm Gra,7490,2,20,7,9,63,34,29,67
Vienna,7490,3,20,5,11,66,50,16,65
SC Rheindorf,7490,4,18,7,11,58,47,11,61
RZ Pellets W,7490,5,15,6,15,50,57,-7,51
Rapid Vienna,7490,6,12,14,10,55,37,18,50
SV Josko Rie,7490,7,11,7,18,36,52,-16,40
Mattersburg,7490,8,9,9,18,35,55,-20,36
St. Pölten,7490,9,6,11,19,40,69,-29,29
Admira Wacke,7490,10,7,8,21,32,66,-34,29
FC Salzburg,7491,1,25,6,5,69,28,41,81
SK Sturm Gra,7491,2,20,6,10,60,33,27,66
SC Rheindorf,7491,3,17,11,8,53,38,15,62
Vienna,7491,4,18,3,15,60,55,5,57
Rapid Vienna,7491,5,11,10,15,53,47,6,43
RZ Pellets W,7491,6,11,8,17,42,55,-13,41
Mattersburg,7491,7,11,8,17,36,50,-14,41
Admira Wacke,7491,8,12,5,19,39,63,-24,41
SV Josko Rie,7491,9,11,7,18,31,49,-18,40
St. Pölten,7491,10,7,10,19,41,66,-25,31
FC Salzburg,7492,1,23,7,6,67,29,38,76
SK Sturm Gra,7492,2,21,4,11,57,31,26,67
SC Rheindorf,7492,3,20,7,9,53,41,12,67
Vienna,7492,4,19,4,13,61,53,8,61
Rapid Vienna,7492,5,15,9,12,47,37,10,54
RZ Pellets W,7492,6,12,8,16,50,61,-11,44
Admira Wacke,7492,7,11,6,19,37,54,-17,39
St. Pölten,7492,8,8,10,18,38,60,-22,34
Mattersburg,7492,9,9,6,21,29,49,-20,33
SV Josko Rie,7492,10,8,7,21,36,60,-24,31
FC Salzburg,7493,1,20,7,9,63,29,34,67
SC Rheindorf,7493,2,18,10,8,53,40,13,64
Vienna,7493,3,18,6,12,60,49,11,60
SK Sturm Gra,7493,4,17,6,13,58,43,15,57
Rapid Vienna,7493,5,13,12,11,54,38,16,51
Admira Wacke,7493,6,12,7,17,36,54,-18,43
RZ Pellets W,7493,7,11,7,18,44,58,-14,40
SV Josko Rie,7493,8,11,7,18,36,57,-21,40
St. Pölten,7493,9,11,7,18,42,64,-22,40
Mattersburg,7493,10,10,9,17,39,53,-14,39
SC Rheindorf,7494,1,23,9,4,62,33,29,78
SK Sturm Gra,7494,2,21,5,10,55,31,24,68
FC Salzburg,7494,3,20,7,9,66,36,30,67
Vienna,7494,4,21,2,13,67,50,17,65
Rapid Vienna,7494,5,13,12,11,60,44,16,51
Admira Wacke,7494,6,12,5,19,37,59,-22,41
Mattersburg,7494,7,10,9,17,36,56,-20,39
RZ Pellets W,7494,8,10,7,19,42,61,-19,37
SV Josko Rie,7494,9,8,7,21,34,57,-23,31
St. Pölten,7494,10,5,11,20,38,70,-32,26
FC Salzburg,7495,1,22,7,7,60,27,33,73
SC Rheindorf,7495,2,22,5,9,56,42,14,71
SK Sturm Gra,7495,3,21,5,10,58,30,28,68
Vienna,7495,4,18,7,11,61,45,16,61
RZ Pellets W,7495,5,12,9,15,43,51,-8,45
Rapid Vienna,7495,6,12,7,17,50,45,5,43
Admira Wacke,7495,7,11,8,17,34,53,-19,41
Mattersburg,7495,8,10,8,18,41,58,-17,38
SV Josko Rie,7495,9,10,5,21,31,58,-27,35
St. Pölten,7495,10,6,11,19,43,68,-25,29
FC Salzburg,7496,1,24,6,6,71,26,45,78
SC Rheindorf,7496,2,22,7,7,53,40,13,73
SK Sturm Gra,7496,3,19,8,9,60,34,26,65
Vienna,7496,4,18,7,11,60,46,14,61
Rapid Vienna,7496,5,11,11,14,47,39,8,44
Admira Wacke,7496,6,12,7,17,35,54,-19,43
RZ Pellets W,7496,7,11,6,19,42,57,-15,39
SV Josko Rie,7496,8,9,6,21,33,58,-25,33
St. Pölten,7496,9,6,14,16,43,65,-22,32
Mattersburg,7496,10,7,10,19,33,58,-25,31
FC Salzburg,7497,1,22,8,6,76,33,43,74
SK Sturm Gra,7497,2,21,5,10,65,34,31,68
SC Rheindorf,7497,3,20,7,9,61,44,17,67
Vienna,7497,4,19,4,13,67,60,7,61
Rapid Vienna,7497,5,16,9,11,67,41,26,57
RZ Pellets W,7497,6,13,8,15,54,58,-4,47
SV Josko Rie,7497,7,11,6,19,39,56,-17,39
Admira Wacke,7497,8,9,7,20,35,67,-32,34
St. Pölten,7497,9,7,9,20,36,68,-32,30
Mattersburg,7497,10,7,7,22,33,72,-39,28
FC Salzburg,7498,1,21,7,8,68,36,32,70
SK Sturm Gra,7498,2,19,6,11,61,38,23,63
SC Rheindorf,7498,3,17,10,9,53,42,11,61
Vienna,7498,4,18,5,13,57,50,7,59
Rapid Vienna,7498,5,15,11,10,56,40,16,56
RZ Pellets W,7498,6,14,7,15,48,49,-1,49
Admira Wacke,7498,7,13,6,17,42,60,-18,45
St. Pölten,7498,8,9,8,19,39,59,-20,35
Mattersburg,7498,9,8,9,19,36,60,-24,33
SV Josko Rie,7498,10,8,7,21,29,55,-26,31
SC Rheindorf,7499,1,22,7,7,58,38,20,73
FC Salzburg,7499,2,20,9,7,68,34,34,69
SK Sturm Gra,7499,3,19,7,10,68,41,27,64
Vienna,7499,4,18,7,11,57,41,16,61
Rapid Vienna,7499,5,16,10,10,61,42,19,58
RZ Pellets W,7499,6,13,6,17,54,61,-7,45
Admira Wacke,7499,7,11,5,20,33,64,-31,38
St. Pölten,7499,8,9,8,19,43,66,-23,35
Mattersburg,7499,9,8,7,21,35,62,-27,31
SV Josko Rie,7499,10,8,6,22,28,56,-28,30
SC Rheindorf,7500,1,18,11,7,53,41,12,65
Vienna,7500,2,19,5,12,63,56,7,62
FC Salzburg,7500,3,17,10,9,65,38,27,61
Rapid Vienna,7500,4,16,11,9,62,38,24,59
SK Sturm Gra,7500,5,15,10,11,57,39,18,55
RZ Pellets W,7500,6,14,8,14,48,55,-7,50
Mattersburg,7500,7,10,9,17,42,53,-11,39
St. Pölten,7500,8,7,14,15,42,60,-18,35
SV Josko Rie,7500,9,9,7,20,33,56,-23,34
Admira Wacke,7500,10,9,7,20,34,63,-29,34
SC Rheindorf,7501,1,21,8,7,64,42,22,71
FC Salzburg,7501,2,20,10,6,63,26,37,70
SK Sturm Gra,7501,3,20,5,11,70,36,34,65
Vienna,7501,4,15,7,14,59,59,0,52
RZ Pellets W,7501,5,15,7,14,51,54,-3,52
Rapid Vienna,7501,6,12,13,11,59,41,18,49
Admira Wacke,7501,7,13,5,18,42,62,-20,44
SV Josko Rie,7501,8,11,7,18,30,46,-16,40
Mattersburg,7501,9,9,7,20,36,67,-31,34
St. Pölten,7501,10,6,7,23,36,77,-41,25
FC Salzburg,7502,1,23,8,5,64,27,37,77
SK Sturm Gra,7502,2,18,9,9,59,34,25,63
Vienna,7502,3,19,6,11,55,47,8,63
SC Rheindorf,7502,4,18,8,10,52,44,8,62
RZ Pellets W,7502,5,13,7,16,47,53,-6,46
Rapid Vienna,7502,6,12,9,15,61,50,11,45
SV Josko Rie,7502,7,12,5,19,33,53,-20,41
Admira Wacke,7502,8,11,7,18,37,54,-17,40
St. Pölten,7502,9,9,8,19,44,68,-24,35
Mattersburg,7502,10,8,7,21,35,57,-22,31
FC Salzburg,7503,1,22,6,8,66,31,35,72
SK Sturm Gra,7503,2,20,5,11,62,34,28,65
SC Rheindorf,7503,3,19,7,10,56,46,10,64
Vienna,7503,4,19,4,13,70,48,22,61
Rapid Vienna,7503,5,14,11,11,53,37,16,53
Admira Wacke,7503,6,12,8,16,38,59,-21,44
Mattersburg,7503,7,12,5,19,35,55,-20,41
RZ Pellets W,7503,8,11,6,19,46,63,-17,39
SV Josko Rie,7503,9,11,5,20,39,62,-23,38
St. Pölten,7503,10,8,7,21,38,68,-30,31
FC Salzburg,7504,1,23,8,5,66,26,40,77
SC Rheindorf,7504,2,23,4,9,61,44,17,73
SK Sturm Gra,7504,3,19,5,12,59,37,22,62
Vienna,7504,4,19,4,13,62,53,9,61
Rapid Vienna,7504,5,15,10,11,61,41,20,55
Admira Wacke,7504,6,13,4,19,39,59,-20,43
RZ Pellets W,7504,7,9,9,18,40,66,-26,36
SV Josko Rie,7504,8,10,5,21,30,51,-21,35
St. Pölten,7504,9,8,9,19,45,70,-25,33
Mattersburg,7504,10,8,8,20,38,54,-16,32
SC Rheindorf,7505,1,20,8,8,58,37,21,68
FC Salzburg,7505,2,18,8,10,70,43,27,62
SK Sturm Gra,7505,3,19,5,12,57,39,18,62
Vienna,7505,4,19,4,13,65,55,10,61
Rapid Vienna,7505,5,13,11,12,49,40,9,50
Admira Wacke,7505,6,14,8,14,41,50,-9,50
St. Pölten,7505,7,10,13,13,47,54,-7,43
RZ Pellets W,7505,8,12,6,18,48,63,-15,42
Mattersburg,7505,9,7,11,18,37,63,-26,32
SV Josko Rie,7505,10,9,4,23,32,60,-28,31
SK Sturm Gra,7506,1,19,9,8,55,31,24,66
FC Salzburg,7506,2,19,8,9,60,35,25,65
Vienna,7506,3,20,5,11,70,50,20,65
SC Rheindorf,7506,4,18,5,13,52,41,11,59
Rapid Vienna,7506,5,14,11,11,60,44,16,53
RZ Pellets W,7506,6,13,7,16,47,54,-7,46
Mattersburg,7506,7,11,9,16,41,55,-14,42
St. Pölten,7506,8,10,10,16,43,59,-16,40
Admira Wacke,7506,9,11,5,20,38,68,-30,38
SV Josko Rie,7506,10,8,5,23,29,58,-29,29
FC Salzburg,7507,1,21,7,8,65,31,34,70
SK Sturm Gra,7507,2,21,5,10,60,34,26,68
SC Rheindorf,7507,3,19,6,11,56,42,14,63
Rapid Vienna,7507,4,17,10,9,63,40,23,61
Vienna,7507,5,18,6,12,72,58,14,60
RZ Pellets W,7507,6,14,8,14,51,55,-4,50
Admira Wacke,7507,7,11,8,17,37,63,-26,41
St. Pölten,7507,8,7,11,18,37,64,-27,32
SV Josko Rie,7507,9,9,5,22,39,67,-28,32
Mattersburg,7507,10,6,8,22,33,59,-26,26
SC Rheindorf,7508,1,22,5,9,62,47,15,71
Vienna,7508,2,21,5,10,75,51,24,68
SK Sturm Gra,7508,3,19,8,9,62,40,22,65
FC Salzburg,7508,4,18,7,11,62,39,23,61
Rapid Vienna,7508,5,14,11,11,50,35,15,53
RZ Pellets W,7508,6,12,8,16,40,53,-13,44
Admira Wacke,7508,7,11,6,19,39,62,-23,39
Mattersburg,7508,8,9,9,18,38,54,-16,36
St. Pölten,7508,9,9,8,19,36,56,-20,35
SV Josko Rie,7508,10,8,7,21,35,62,-27,31
FC Salzburg,7509,1,20,10,6,62,28,34,70
Rapid Vienna,7509,2,18,10,8,65,40,25,64
SC Rheindorf,7509,3,17,12,7,53,38,15,63
SK Sturm Gra,7509,4,18,8,10,55,36,19,62
Vienna,7509,5,18,6,12,65,52,13,60
Admira Wacke,7509,6,12,4,20,42,62,-20,40
SV Josko Rie,7509,7,10,6,20,37,58,-21,36
St. Pölten,7509,8,8,11,17,36,57,-21,35
Mattersburg,7509,9,8,10,18,38,62,-24,34
RZ Pellets W,7509,10,8,9,19,41,61,-20,33
SK Sturm Gra,7510,1,22,5,9,68,33,35,71
SC Rheindorf,7510,2,21,7,8,62,42,20,70
FC Salzburg,7510,3,21,6,9,71,37,34,69
Vienna,7510,4,18,4,14,62,58,4,58
Rapid Vienna,7510,5,15,11,10,64,49,15,56
RZ Pellets W,7510,6,12,7,17,47,62,-15,43
SV Josko Rie,7510,7,11,6,19,44,59,-15,39
Mattersburg,7510,8,9,7,20,42,57,-15,34
Admira Wacke,7510,9,9,7,20,36,72,-36,34
St. Pölten,7510,10,8,8,20,43,70,-27,32
SC Rheindorf,7511,1,23,6,7,61,39,22,75
FC Salzburg,7511,2,22,7,7,74,36,38,73
SK Sturm Gra,7511,3,21,7,8,63,30,33,70
Vienna,7511,4,16,5,15,60,64,-4,53
Rapid Vienna,7511,5,13,11,12,58,42,16,50
RZ Pellets W,7511,6,13,7,16,46,49,-3,46
Admira Wacke,7511,7,13,7,16,40,62,-22,46
Mattersburg,7511,8,8,8,20,34,55,-21,32
St. Pölten,7511,9,7,10,19,37,63,-26,31
SV Josko Rie,7511,10,7,6,23,28,61,-33,27
SC Rheindorf,7512,1,21,5,10,69,44,25,68
FC Salzburg,7512,2,20,7,9,65,30,35,67
Vienna,7512,3,20,6,10,64,47,17,66
RZ Pellets W,7512,4,16,8,12,49,49,0,56
SK Sturm Gra,7512,5,15,6,15,52,44,8,51
Rapid Vienna,7512,6,12,12,12,55,46,9,48
Admira Wacke,7512,7,14,4,18,41,63,-22,46
SV Josko Rie,7512,8,12,5,19,37,55,-18,41
Mattersburg,7512,9,9,9,18,35,53,-18,36
St. Pölten,7512,10,5,10,21,34,70,-36,25
FC Salzburg,7513,1,22,7,7,73,37,36,73
SC Rheindorf,7513,2,20,7,9,58,35,23,67
SK Sturm Gra,7513,3,19,7,10,58,32,26,64
Vienna,7513,4,17,4,15,64,57,7,55
RZ Pellets W,7513,5,15,7,14,51,59,-8,52
Rapid Vienna,7513,6,12,9,15,54,47,7,45
Admira Wacke,7513,7,11,9,16,41,62,-21,42
Mattersburg,7513,8,10,8,18,38,57,-19,38
SV Josko Rie,7513,9,11,3,22,32,59,-27,36
St. Pölten,7513,10,6,13,17,34,58,-24,31
SC Rheindorf,7514,1,23,5,8,68,42,26,74
FC Salzburg,7514,2,22,6,8,67,33,34,72
SK Sturm Gra,7514,3,20,4,12,69,33,36,64
Rapid Vienna,7514,4,16,11,9,57,39,18,59
Vienna,7514,5,18,3,15,63,57,6,57
RZ Pellets W,7514,6,11,7,18,54,70,-16,40
Admira Wacke,7514,7,11,6,19,32,55,-23,39
Mattersburg,7514,8,10,8,18,34,57,-23,38
SV Josko Rie,7514,9,11,3,22,34,60,-26,36
St. Pölten,7514,10,6,11,19,41,73,-32,29
FC Salzburg,7515,1,23,6,7,60,25,35,75
SC Rheindorf,7515,2,19,8,9,59,38,21,65
Vienna,7515,3,18,7,11,61,46,15,61
SK Sturm Gra,7515,4,17,6,13,52,38,14,57
Rapid Vienna,7515,5,15,11,10,57,39,18,56
Admira Wacke,7515,6,13,4,19,37,60,-23,43
RZ Pellets W,7515,7,11,7,18,42,55,-13,40
Mattersburg,7515,8,9,9,18,36,57,-21,36
St. Pölten,7515,8,9,9,18,36,57,-21,36
SV Josko Rie,7515,10,9,7,20,28,53,-25,34
SC Rheindorf,7516,1,23,7,6,68,39,29,76
FC Salzburg,7516,2,20,5,11,61,32,29,65
SK Sturm Gra,7516,3,19,5,12,58,34,24,62
Vienna,7516,4,17,8,11,57,50,7,59
Rapid Vienna,7516,5,16,8,12,54,42,12,56
RZ Pellets W,7516,6,13,6,17,43,59,-16,45
SV Josko Rie,7516,7,11,6,19,38,53,-15,39
Mattersburg,7516,8,10,7,19,43,61,-18,37
Admira Wacke,7516,9,9,7,20,31,59,-28,34
St. Pölten,7516,10,7,11,18,39,63,-24,32
FC Salzburg,7517,1,20,9,7,63,28,35,69
SC Rheindorf,7517,2,20,7,9,56,41,15,67
Vienna,7517,3,19,7,10,64,48,16,64
SK Sturm Gra,7517,4,17,8,11,57,36,21,59
Rapid Vienna,7517,5,13,11,12,52,42,10,50
SV Josko Rie,7517,6,12,5,19,31,51,-20,41
Admira Wacke,7517,7,11,8,17,41,64,-23,41
RZ Pellets W,7517,8,11,7,18,43,56,-13,40
St. Pölten,7517,9,9,9,18,41,61,-20,36
Mattersburg,7517,10,7,11,18,34,55,-21,32
SC Rheindorf,7518,1,21,6,9,57,41,16,69
Vienna,7518,2,21,4,11,57,43,14,67
FC Salzburg,7518,3,17,10,9,59,35,24,61
SK Sturm Gra,7518,4,17,6,13,56,36,20,57
RZ Pellets W,7518,5,14,5,17,51,63,-12,47
Admira Wacke,7518,6,12,7,17,39,59,-20,43
Rapid Vienna,7518,7,10,12,14,57,48,9,42
St. Pölten,7518,8,10,12,14,44,53,-9,42
Mattersburg,7518,9,10,10,16,46,61,-15,40
SV Josko Rie,7518,10,10,4,22,37,64,-27,34
FC Salzburg,7519,1,22,8,6,64,25,39,74
Vienna,7519,2,20,3,13,65,54,11,63
SK Sturm Gra,7519,3,19,5,12,56,39,17,62
SC Rheindorf,7519,4,18,7,11,57,47,10,61
RZ Pellets W,7519,5,14,7,15,52,59,-7,49
Rapid Vienna,7519,6,13,9,14,53,42,11,48
Admira Wacke,7519,7,12,5,19,40,61,-21,41
St. Pölten,7519,8,9,10,17,49,67,-18,37
SV Josko Rie,7519,9,10,6,20,34,58,-24,36
Mattersburg,7519,10,9,8,19,39,57,-18,35
FC Salzburg,7520,1,23,7,6,76,31,45,76
SC Rheindorf,7520,2,20,7,9,59,46,13,67
SK Sturm Gra,7520,3,18,8,10,59,35,24,62
Rapid Vienna,7520,4,15,11,10,64,42,22,56
Vienna,7520,5,15,5,16,56,61,-5,50
RZ Pellets W,7520,6,12,8,16,49,61,-12,44
Admira Wacke,7520,7,12,7,17,44,63,-19,43
SV Josko Rie,7520,8,10,8,18,41,61,-20,38
St. Pölten,7520,9,8,10,18,40,64,-24,34
Mattersburg,7520,10,7,9,20,40,64,-24,30
FC Salzburg,7521,1,24,5,7,66,30,36,77
SC Rheindorf,7521,2,19,10,7,60,38,22,67
SK Sturm Gra,7521,3,19,7,10,61,40,21,64
Vienna,7521,4,17,5,14,59,49,10,56
Rapid Vienna,7521,5,14,11,11,55,39,16,53
RZ Pellets W,7521,6,12,8,16,43,52,-9,44
Admira Wacke,7521,7,10,8,18,32,58,-26,38
SV Josko Rie,7521,8,10,6,20,35,53,-18,36
St. Pölten,7521,9,8,10,18,37,62,-25,34
Mattersburg,7521,10,9,6,21,34,61,-27,33
SK Sturm Gra,7522,1,19,6,11,57,33,24,63
SC Rheindorf,7522,2,18,8,10,50,48,2,62
FC Salzburg,7522,3,18,7,11,63,36,27,61
Vienna,7522,4,16,8,12,61,50,11,56
Admira Wacke,7522,5,14,8,14,40,52,-12,50
Rapid Vienna,7522,6,12,13,11,59,48,11,49
RZ Pellets W,7522,7,14,7,15,48,52,-4,49
St. Pölten,7522,8,11,8,17,51,67,-16,41
SV Josko Rie,7522,9,9,8,19,32,52,-20,35
Mattersburg,7522,10,8,9,19,39,62,-23,33
SK Sturm Gra,7523,1,22,5,9,61,34,27,71
SC Rheindorf,7523,2,20,9,7,55,41,14,69
FC Salzburg,7523,3,20,6,10,62,29,33,66
Vienna,7523,4,19,4,13,65,56,9,61
Admira Wacke,7523,5,15,6,15,51,61,-10,51
Rapid Vienna,7523,6,12,7,17,54,41,13,43
RZ Pellets W,7523,7,12,7,17,49,58,-9,43
Mattersburg,7523,8,10,7,19,39,65,-26,37
SV Josko Rie,7523,9,10,5,21,37,58,-21,35
St. Pölten,7523,10,8,8,20,37,67,-30,32
FC Salzburg,7524,1,22,8,6,74,34,40,74
SC Rheindorf,7524,2,20,9,7,53,43,10,69
SK Sturm Gra,7524,3,18,9,9,52,31,21,63
Vienna,7524,4,18,6,12,62,51,11,60
Rapid Vienna,7524,5,14,10,12,63,39,24,52
RZ Pellets W,7524,6,13,9,14,50,51,-1,48
St. Pölten,7524,7,9,9,18,49,70,-21,36
Admira Wacke,7524,8,10,5,21,34,73,-39,35
SV Josko Rie,7524,9,9,6,21,30,52,-22,33
Mattersburg,7524,10,7,9,20,33,56,-23,30
FC Salzburg,7525,1,21,7,8,66,32,34,70
SK Sturm Gra,7525,2,20,9,7,61,33,28,69
Vienna,7525,3,19,5,12,68,57,11,62
SC Rheindorf,7525,4,18,7,11,58,48,10,61
Rapid Vienna,7525,5,14,9,13,64,48,16,51
RZ Pellets W,7525,6,11,9,16,43,53,-10,42
Admira Wacke,7525,7,12,6,18,43,65,-22,42
St. Pölten,7525,8,9,11,16,47,71,-24,38
Mattersburg,7525,9,8,9,19,38,57,-19,33
SV Josko Rie,7525,10,8,8,20,33,57,-24,32
FC Salzburg,7526,1,21,8,7,63,25,38,71
SK Sturm Gra,7526,2,21,7,8,57,31,26,70
SC Rheindorf,7526,3,19,6,11,59,46,13,63
Vienna,7526,4,16,11,9,63,52,11,59
Rapid Vienna,7526,5,14,11,11,57,40,17,53
RZ Pellets W,7526,6,13,8,15,48,54,-6,47
St. Pölten,7526,7,10,10,16,44,58,-14,40
Admira Wacke,7526,8,11,5,20,35,63,-28,38
SV Josko Rie,7526,9,9,4,23,34,58,-24,31
Mattersburg,7526,10,7,8,21,30,63,-33,29
SK Sturm Gra,7527,1,23,6,7,61,24,37,75
FC Salzburg,7527,2,19,9,8,65,34,31,66
SC Rheindorf,7527,3,19,9,8,51,38,13,66
Vienna,7527,4,19,3,14,69,51,18,60
Rapid Vienna,7527,5,10,15,11,52,46,6,45
SV Josko Rie,7527,6,12,7,17,33,45,-12,43
RZ Pellets W,7527,7,11,10,15,40,54,-14,43
St. Pölten,7527,8,8,12,16,40,61,-21,36
Admira Wacke,7527,9,8,8,20,27,61,-34,32
Mattersburg,7527,10,7,9,20,34,58,-24,30
FC Salzburg,7528,1,20,8,8,70,35,35,68
SK Sturm Gra,7528,2,20,4,12,61,36,25,64
SC Rheindorf,7528,3,19,6,11,53,38,15,63
Rapid Vienna,7528,4,17,10,9,64,37,27,61
Vienna,7528,5,17,8,11,68,58,10,59
Admira Wacke,7528,6,14,5,17,42,57,-15,47
RZ Pellets W,7528,7,11,8,17,43,62,-19,41
St. Pölten,7528,8,10,8,18,37,60,-23,38
Mattersburg,7528,9,8,8,20,32,58,-26,32
SV Josko Rie,7528,10,8,7,21,30,59,-29,31
SK Sturm Gra,7529,1,21,6,9,61,33,28,69
SC Rheindorf,7529,2,19,7,10,56,43,13,64
FC Salzburg,7529,3,17,8,11,60,36,24,59
Rapid Vienna,7529,4,15,12,9,63,40,23,57
Vienna,7529,5,16,5,15,57,55,2,53
RZ Pellets W,7529,6,12,9,15,42,56,-14,45
St. Pölten,7529,7,10,11,15,47,60,-13,41
Admira Wacke,7529,8,11,8,17,37,63,-26,41
SV Josko Rie,7529,9,11,6,19,39,56,-17,39
Mattersburg,7529,10,7,10,19,36,56,-20,31
SC Rheindorf,7530,1,21,9,6,59,35,24,72
FC Salzburg,7530,2,21,8,7,55,22,33,71
Vienna,7530,3,18,7,11,62,47,15,61
SK Sturm Gra,7530,4,17,9,10,55,35,20,60
Rapid Vienna,7530,5,15,10,11,51,35,16,55
SV Josko Rie,7530,6,12,7,17,34,49,-15,43
Admira Wacke,7530,7,11,6,19,36,61,-25,39
St. Pölten,7530,8,9,10,17,40,60,-20,37
RZ Pellets W,7530,9,10,6,20,38,60,-22,36
Mattersburg,7530,10,5,10,21,28,54,-26,25
FC Salzburg,7531,1,19,9,8,61,30,31,66
Vienna,7531,2,19,7,10,68,50,18,64
SC Rheindorf,7531,3,18,7,11,50,43,7,61
SK Sturm Gra,7531,4,18,6,12,60,38,22,60
RZ Pellets W,7531,5,15,7,14,49,52,-3,52
Rapid Vienna,7531,6,13,12,11,52,42,10,51
Admira Wacke,7531,7,13,8,15,41,53,-12,47
St. Pölten,7531,8,9,8,19,40,63,-23,35
Mattersburg,7531,9,8,9,19,35,58,-23,33
SV Josko Rie,7531,10,8,7,21,32,59,-27,31
SC Rheindorf,7532,1,23,6,7,70,36,34,75
FC Salzburg,7532,2,21,5,10,64,31,33,68
Vienna,7532,3,18,5,13,57,52,5,59
SK Sturm Gra,7532,4,17,7,12,52,36,16,58
Rapid Vienna,7532,5,14,11,11,51,38,13,53
SV Josko Rie,7532,6,14,4,18,41,52,-11,46
St. Pölten,7532,7,11,8,17,51,65,-14,41
RZ Pellets W,7532,8,9,9,18,40,61,-21,36
Admira Wacke,7532,9,10,6,20,33,62,-29,36
Mattersburg,7532,10,7,11,18,36,62,-26,32
FC Salzburg,7533,1,21,7,8,68,34,34,70
SK Sturm Gra,7533,2,19,9,8,62,32,30,66
SC Rheindorf,7533,3,17,12,7,62,42,20,63
Vienna,7533,4,19,6,11,65,49,16,63
Rapid Vienna,7533,5,14,14,8,56,36,20,56
RZ Pellets W,7533,6,11,5,20,43,60,-17,38
SV Josko Rie,7533,7,10,8,18,38,57,-19,38
Admira Wacke,7533,8,10,7,19,36,65,-29,37
Mattersburg,7533,9,9,8,19,40,62,-22,35
St. Pölten,7533,10,8,8,20,36,69,-33,32
SC Rheindorf,7534,1,23,7,6,69,34,35,76
FC Salzburg,7534,2,23,5,8,64,31,33,74
Vienna,7534,3,20,5,11,61,49,12,65
SK Sturm Gra,7534,4,20,4,12,62,37,25,64
Rapid Vienna,7534,5,14,10,12,58,41,17,52
RZ Pellets W,7534,6,11,7,18,43,56,-13,40
Mattersburg,7534,7,9,9,18,35,52,-17,36
Admira Wacke,7534,8,10,6,20,39,71,-32,36
SV Josko Rie,7534,9,9,5,22,27,56,-29,32
St. Pölten,7534,10,5,14,17,37,68,-31,29
SK Sturm Gra,7535,1,23,3,10,70,33,37,72
FC Salzburg,7535,2,20,8,8,69,30,39,68
SC Rheindorf,7535,3,21,5,10,54,45,9,68
Vienna,7535,4,20,4,12,64,45,19,64
Rapid Vienna,7535,5,14,8,14,58,50,8,50
St. Pölten,7535,6,12,7,17,44,59,-15,43
RZ Pellets W,7535,7,11,7,18,46,58,-12,40
Mattersburg,7535,8,10,8,18,44,61,-17,38
Admira Wacke,7535,9,9,6,21,37,70,-33,33
SV Josko Rie,7535,10,8,8,20,32,67,-35,32
FC Salzburg,7536,1,20,8,8,64,30,34,68
SC Rheindorf,7536,2,18,7,11,56,44,12,61
SK Sturm Gra,7536,3,17,7,12,56,36,20,58
SV Josko Rie,7536,4,17,3,16,54,46,8,54
Rapid Vienna,7536,5,14,9,13,57,47,10,51
Vienna,7536,6,15,6,15,59,62,-3,51
RZ Pellets W,7536,7,15,6,15,48,57,-9,51
Admira Wacke,7536,8,14,5,17,40,60,-20,47
Mattersburg,7536,9,10,9,17,43,59,-16,39
St. Pölten,7536,10,6,8,22,37,73,-36,26
FC Salzburg,7537,1,24,5,7,60,27,33,77
SK Sturm Gra,7537,2,19,8,9,65,33,32,65
SC Rheindorf,7537,3,19,8,9,57,46,11,65
Vienna,7537,4,18,6,12,64,52,12,60
Rapid Vienna,7537,5,12,13,11,54,43,11,49
SV Josko Rie,7537,6,14,3,19,39,46,-7,45
RZ Pellets W,7537,7,11,8,17,41,55,-14,41
Admira Wacke,7537,8,9,9,18,31,55,-24,36
St. Pölten,7537,9,8,10,18,37,61,-24,34
Mattersburg,7537,10,8,6,22,30,60,-30,30
Vienna,7538,1,21,3,12,64,48,16,66
SC Rheindorf,7538,2,18,11,7,56,36,20,65
FC Salzburg,7538,3,18,9,9,60,36,24,63
SK Sturm Gra,7538,4,17,7,12,58,40,18,58
RZ Pellets W,7538,5,13,9,14,51,59,-8,48
Rapid Vienna,7538,6,12,11,13,58,51,7,47
SV Josko Rie,7538,7,14,4,18,39,53,-14,46
Mattersburg,7538,8,11,9,16,46,54,-8,42
Admira Wacke,7538,9,10,6,20,36,62,-26,36
St. Pölten,7538,10,7,9,20,37,66,-29,30
Vienna,7539,1,23,4,9,63,39,24,73
FC Salzburg,7539,2,20,6,10,63,31,32,66
SC Rheindorf,7539,3,19,8,9,52,36,16,65
SK Sturm Gra,7539,4,17,9,10,50,29,21,60
Rapid Vienna,7539,5,15,9,12,58,39,19,54
RZ Pellets W,7539,6,13,6,17,47,56,-9,45
SV Josko Rie,7539,7,12,5,19,37,57,-20,41
Admira Wacke,7539,8,11,6,19,36,66,-30,39
St. Pölten,7539,9,9,10,17,39,60,-21,37
Mattersburg,7539,10,4,11,21,32,64,-32,23
FC Salzburg,7540,1,23,4,9,65,34,31,73
Vienna,7540,2,22,3,11,75,50,25,69
SK Sturm Gra,7540,3,20,8,8,61,33,28,68
SC Rheindorf,7540,4,17,5,14,50,46,4,56
Rapid Vienna,7540,5,15,9,12,57,42,15,54
RZ Pellets W,7540,6,13,6,17,50,65,-15,45
Mattersburg,7540,7,11,9,16,45,57,-12,42
Admira Wacke,7540,8,11,5,20,36,59,-23,38
SV Josko Rie,7540,9,11,4,21,37,55,-18,37
St. Pölten,7540,10,6,9,21,40,75,-35,27
FC Salzburg,7541,1,20,10,6,66,29,37,70
SK Sturm Gra,7541,2,20,6,10,60,32,28,66
SC Rheindorf,7541,3,19,8,9,54,43,11,65
Vienna,7541,4,20,4,12,67,48,19,64
Rapid Vienna,7541,5,17,11,8,59,32,27,62
RZ Pellets W,7541,6,11,7,18,40,60,-20,40
SV Josko Rie,7541,7,11,5,20,30,50,-20,38
Admira Wacke,7541,8,10,6,20,30,56,-26,36
Mattersburg,7541,9,8,10,18,35,57,-22,34
St. Pölten,7541,10,7,7,22,39,73,-34,28
SK Sturm Gra,7542,1,22,6,8,66,35,31,72
FC Salzburg,7542,2,18,10,8,70,38,32,64
SC Rheindorf,7542,3,19,6,11,60,41,19,63
Vienna,7542,4,18,5,13,62,56,6,59
Rapid Vienna,7542,5,14,10,12,55,42,13,52
RZ Pellets W,7542,6,11,11,14,42,51,-9,44
Admira Wacke,7542,7,12,7,17,35,56,-21,43
SV Josko Rie,7542,8,11,5,20,35,52,-17,38
Mattersburg,7542,9,10,7,19,36,58,-22,37
St. Pölten,7542,10,7,9,20,38,70,-32,30
FC Salzburg,7543,1,24,4,8,72,33,39,76
SK Sturm Gra,7543,2,20,7,9,64,35,29,67
SC Rheindorf,7543,3,19,10,7,56,42,14,67
Vienna,7543,4,17,3,16,60,64,-4,54
Admira Wacke,7543,5,12,8,16,42,61,-19,44
Rapid Vienna,7543,6,10,11,15,57,52,5,41
RZ Pellets W,7543,7,11,7,18,48,59,-11,40
Mattersburg,7543,8,10,9,17,43,56,-13,39
SV Josko Rie,7543,9,12,3,21,37,57,-20,39
St. Pölten,7543,10,9,10,17,41,61,-20,37
FC Salzburg,7544,1,23,6,7,70,24,46,75
SK Sturm Gra,7544,2,23,5,8,70,35,35,74
SC Rheindorf,7544,3,20,4,12,62,51,11,64
Vienna,7544,4,19,4,13,62,52,10,61
RZ Pellets W,7544,5,15,7,14,49,51,-2,52
Rapid Vienna,7544,6,12,12,12,55,48,7,48
St. Pölten,7544,7,9,8,19,41,68,-27,35
Admira Wacke,7544,8,9,7,20,37,67,-30,34
SV Josko Rie,7544,9,8,8,20,33,60,-27,32
Mattersburg,7544,10,8,7,21,37,60,-23,31
FC Salzburg,7545,1,20,10,6,60,28,32,70
SC Rheindorf,7545,2,21,4,11,53,37,16,67
Vienna,7545,3,20,5,11,63,46,17,65
SK Sturm Gra,7545,4,19,4,13,51,36,15,61
Rapid Vienna,7545,5,13,13,10,50,38,12,52
St. Pölten,7545,6,10,11,15,42,56,-14,41
Admira Wacke,7545,7,12,5,19,31,53,-22,41
SV Josko Rie,7545,8,11,4,21,28,52,-24,37
RZ Pellets W,7545,9,10,6,20,41,56,-15,36
Mattersburg,7545,10,9,8,19,32,49,-17,35
FC Salzburg,7546,1,21,8,7,64,30,34,71
SK Sturm Gra,7546,2,19,8,9,55,31,24,65
Vienna,7546,3,20,4,12,63,47,16,64
SC Rheindorf,7546,4,18,9,9,51,43,8,63
Rapid Vienna,7546,5,16,11,9,62,41,21,59
RZ Pellets W,7546,6,14,5,17,45,53,-8,47
St. Pölten,7546,7,9,10,17,41,60,-19,37
Admira Wacke,7546,8,9,8,19,32,60,-28,35
SV Josko Rie,7546,9,9,6,21,31,55,-24,33
Mattersburg,7546,10,7,7,22,30,54,-24,28
SC Rheindorf,7547,1,22,6,8,59,41,18,72
SK Sturm Gra,7547,2,21,6,9,60,31,29,69
Vienna,7547,3,21,3,12,70,52,18,66
FC Salzburg,7547,4,19,7,10,68,33,35,64
Rapid Vienna,7547,5,15,12,9,62,43,19,57
Admira Wacke,7547,6,14,6,16,40,53,-13,48
RZ Pellets W,7547,7,11,8,17,43,57,-14,41
SV Josko Rie,7547,8,9,4,23,26,58,-32,31
Mattersburg,7547,9,7,8,21,33,59,-26,29
St. Pölten,7547,10,7,8,21,37,71,-34,29
FC Salzburg,7548,1,21,10,5,70,29,41,73
SC Rheindorf,7548,2,21,7,8,60,42,18,70
SK Sturm Gra,7548,3,19,9,8,63,31,32,66
Rapid Vienna,7548,4,14,13,9,62,40,22,55
Vienna,7548,5,16,7,13,59,56,3,55
Admira Wacke,7548,6,12,8,16,39,60,-21,44
RZ Pellets W,7548,7,10,11,15,43,59,-16,41
SV Josko Rie,7548,8,9,5,22,35,62,-27,32
St. Pölten,7548,9,7,10,19,39,65,-26,31
Mattersburg,7548,10,6,10,20,42,68,-26,28
SC Rheindorf,7549,1,21,7,8,66,44,22,70
SK Sturm Gra,7549,2,20,7,9,60,32,28,67
FC Salzburg,7549,3,19,8,9,67,40,27,65
Vienna,7549,4,18,7,11,60,47,13,61
Rapid Vienna,7549,5,12,10,14,50,44,6,46
Admira Wacke,7549,6,11,9,16,38,56,-18,42
SV Josko Rie,7549,7,11,8,17,36,47,-11,41
St. Pölten,7549,8,11,8,17,42,65,-23,41
RZ Pellets W,7549,9,11,6,19,42,59,-17,39
Mattersburg,7549,10,7,8,21,32,59,-27,29
SC Rheindorf,7550,1,22,8,6,61,36,25,74
FC Salzburg,7550,2,21,8,7,63,33,30,71
Vienna,7550,3,20,5,11,69,49,20,65
SK Sturm Gra,7550,4,17,5,14,59,40,19,56
Rapid Vienna,7550,5,14,10,12,55,42,13,52
RZ Pellets W,7550,6,12,8,16,45,58,-13,44
Admira Wacke,7550,7,13,5,18,37,57,-20,44
St. Pölten,7550,8,9,9,18,40,61,-21,36
Mattersburg,7550,9,7,11,18,40,58,-18,32
SV Josko Rie,7550,10,7,7,22,32,67,-35,28
SC Rheindorf,7551,1,21,7,8,54,37,17,70
Vienna,7551,2,22,3,11,68,50,18,69
FC Salzburg,7551,3,19,6,11,63,33,30,63
SK Sturm Gra,7551,4,17,7,12,60,40,20,58
Rapid Vienna,7551,5,15,12,9,63,36,27,57
Admira Wacke,7551,6,13,4,19,34,63,-29,43
St. Pölten,7551,7,11,8,17,46,61,-15,41
SV Josko Rie,7551,8,12,5,19,37,54,-17,41
RZ Pellets W,7551,9,11,5,20,37,64,-27,38
Mattersburg,7551,10,6,9,21,36,60,-24,27
FC Salzburg,7552,1,23,7,6,71,29,42,76
SK Sturm Gra,7552,2,24,4,8,64,27,37,76
SC Rheindorf,7552,3,24,4,8,63,36,27,76
Vienna,7552,4,17,4,15,55,57,-2,55
Rapid Vienna,7552,5,15,8,13,52,40,12,53
RZ Pellets W,7552,6,13,6,17,47,53,-6,45
Admira Wacke,7552,7,11,5,20,38,62,-24,38
St. Pölten,7552,8,7,10,19,40,73,-33,31
Mattersburg,7552,9,6,11,19,33,58,-25,29
SV Josko Rie,7552,10,8,5,23,33,61,-28,29
SC Rheindorf,7553,1,21,8,7,61,40,21,71
FC Salzburg,7553,2,21,7,8,60,33,27,70
Vienna,7553,3,20,4,12,72,50,22,64
SK Sturm Gra,7553,4,18,6,12,58,43,15,60
Rapid Vienna,7553,5,12,16,8,60,41,19,52
RZ Pellets W,7553,6,13,7,16,50,59,-9,46
Admira Wacke,7553,7,11,7,18,36,62,-26,40
St. Pölten,7553,8,9,12,15,45,58,-13,39
SV Josko Rie,7553,9,7,9,20,28,54,-26,30
Mattersburg,7553,10,7,6,23,34,64,-30,27
SC Rheindorf,7554,1,23,6,7,66,41,25,75
FC Salzburg,7554,2,20,8,8,67,35,32,68
SK Sturm Gra,7554,3,16,6,14,54,44,10,54
RZ Pellets W,7554,4,15,8,13,54,54,0,53
Vienna,7554,5,16,5,15,59,60,-1,53
Rapid Vienna,7554,6,12,13,11,62,47,15,49
Admira Wacke,7554,7,13,5,18,39,56,-17,44
St. Pölten,7554,8,9,11,16,44,65,-21,38
SV Josko Rie,7554,9,11,5,20,34,56,-22,38
Mattersburg,7554,10,8,7,21,38,59,-21,31
Vienna,7555,1,22,5,9,63,44,19,71
FC Salzburg,7555,2,20,7,9,69,33,36,67
SK Sturm Gra,7555,3,20,6,10,62,35,27,66
SC Rheindorf,7555,4,16,8,12,53,50,3,56
Rapid Vienna,7555,5,14,12,10,57,37,20,54
RZ Pellets W,7555,6,12,11,13,48,53,-5,47
Admira Wacke,7555,7,10,6,20,33,65,-32,36
SV Josko Rie,7555,8,9,8,19,32,51,-19,35
Mattersburg,7555,9,8,10,18,34,57,-23,34
St. Pölten,7555,10,7,11,18,40,66,-26,32
SC Rheindorf,7556,1,22,8,6,58,35,23,74
FC Salzburg,7556,2,22,7,7,69,26,43,73
Vienna,7556,3,20,7,9,64,46,18,67
SK Sturm Gra,7556,4,20,6,10,54,30,24,66
Rapid Vienna,7556,5,16,11,9,63,38,25,59
RZ Pellets W,7556,6,11,6,19,49,64,-15,39
Admira Wacke,7556,7,11,5,20,35,63,-28,38
Mattersburg,7556,8,6,12,18,40,63,-23,30
SV Josko Rie,7556,9,8,5,23,28,52,-24,29
St. Pölten,7556,10,6,9,21,35,78,-43,27
FC Salzburg,7557,1,20,9,7,61,28,33,69
SK Sturm Gra,7557,2,18,8,10,63,42,21,62
SC Rheindorf,7557,3,17,10,9,60,46,14,61
Vienna,7557,4,17,5,14,61,57,4,56
Rapid Vienna,7557,5,15,10,11,64,39,25,55
RZ Pellets W,7557,6,14,5,17,53,66,-13,47
Mattersburg,7557,7,12,6,18,38,57,-19,42
St. Pölten,7557,8,9,11,16,42,64,-22,38
Admira Wacke,7557,9,10,7,19,37,61,-24,37
SV Josko Rie,7557,10,10,5,21,32,51,-19,35
FC Salzburg,7558,1,20,8,8,65,36,29,68
SC Rheindorf,7558,2,20,7,9,57,38,19,67
SK Sturm Gra,7558,3,20,6,10,58,30,28,66
Vienna,7558,4,17,10,9,57,42,15,61
Rapid Vienna,7558,5,12,13,11,48,40,8,49
RZ Pellets W,7558,6,10,12,14,42,53,-11,42
SV Josko Rie,7558,7,10,7,19,33,52,-19,37
Mattersburg,7558,8,9,9,18,40,60,-20,36
St. Pölten,7558,9,9,8,19,41,61,-20,35
Admira Wacke,7558,10,9,8,19,31,60,-29,35
FC Salzburg,7559,1,22,7,7,66,27,39,73
Vienna,7559,2,19,6,11,58,44,14,63
SC Rheindorf,7559,3,19,5,12,51,46,5,62
Rapid Vienna,7559,4,14,12,10,55,40,15,54
RZ Pellets W,7559,5,15,7,14,50,52,-2,52
SK Sturm Gra,7559,6,14,7,15,54,44,10,49
Admira Wacke,7559,7,10,10,16,34,58,-24,40
Mattersburg,7559,8,10,9,17,38,49,-11,39
SV Josko Rie,7559,9,11,4,21,37,59,-22,37
St. Pölten,7559,10,7,11,18,37,61,-24,32
Vienna,7560,1,23,4,9,72,46,26,73
FC Salzburg,7560,2,21,9,6,64,31,33,72
SC Rheindorf,7560,3,20,6,10,52,43,9,66
SK Sturm Gra,7560,4,16,5,15,56,41,15,53
Rapid Vienna,7560,5,14,10,12,50,34,16,52
RZ Pellets W,7560,6,15,6,15,49,50,-1,51
St. Pölten,7560,7,10,9,17,37,60,-23,39
Admira Wacke,7560,8,10,6,20,34,60,-26,36
SV Josko Rie,7560,9,9,6,21,29,52,-23,33
Mattersburg,7560,10,9,5,22,32,58,-26,32
SK Sturm Gra,7561,1,21,8,7,62,31,31,71
SC Rheindorf,7561,2,21,7,8,59,43,16,70
FC Salzburg,7561,3,19,6,11,58,35,23,63
Vienna,7561,4,16,6,14,58,54,4,54
Admira Wacke,7561,5,16,5,15,40,50,-10,53
Rapid Vienna,7561,6,11,13,12,47,40,7,46
SV Josko Rie,7561,7,12,4,20,31,48,-17,40
RZ Pellets W,7561,8,9,12,15,45,57,-12,39
Mattersburg,7561,9,9,8,19,39,50,-11,35
St. Pölten,7561,10,7,9,20,36,67,-31,30
SK Sturm Gra,7562,1,22,6,8,59,30,29,72
FC Salzburg,7562,2,21,7,8,64,32,32,70
SC Rheindorf,7562,3,20,8,8,57,43,14,68
Vienna,7562,4,16,9,11,56,46,10,57
Rapid Vienna,7562,5,15,10,11,55,37,18,55
RZ Pellets W,7562,6,11,11,14,40,47,-7,44
SV Josko Rie,7562,7,10,8,18,37,52,-15,38
Admira Wacke,7562,8,9,8,19,34,61,-27,35
Mattersburg,7562,9,7,9,20,33,59,-26,30
St. Pölten,7562,10,6,10,20,37,65,-28,28
FC Salzburg,7563,1,25,5,6,76,27,49,80
SK Sturm Gra,7563,2,22,7,7,65,29,36,73
Vienna,7563,3,19,3,14,63,59,4,60
Rapid Vienna,7563,4,15,10,11,60,40,20,55
SC Rheindorf,7563,5,14,9,13,41,45,-4,51
RZ Pellets W,7563,6,11,9,16,41,58,-17,42
Admira Wacke,7563,7,10,8,18,36,60,-24,38
St. Pölten,7563,8,8,12,16,44,63,-19,36
Mattersburg,7563,9,7,12,17,35,51,-16,33
SV Josko Rie,7563,10,8,7,21,34,63,-29,31
SK Sturm Gra,7564,1,20,8,8,60,33,27,68
FC Salzburg,7564,2,19,9,8,60,30,30,66
SC Rheindorf,7564,3,19,6,11,50,42,8,63
Rapid Vienna,7564,4,17,9,10,62,36,26,60
Vienna,7564,5,18,5,13,66,50,16,59
RZ Pellets W,7564,6,12,7,17,42,51,-9,43
Admira Wacke,7564,7,12,5,19,35,54,-19,41
St. Pölten,7564,8,11,8,17,38,58,-20,41
SV Josko Rie,7564,9,12,3,21,32,56,-24,39
Mattersburg,7564,10,5,10,21,28,63,-35,25
FC Salzburg,7565,1,22,6,8,67,32,35,72
Vienna,7565,2,21,6,9,69,52,17,69
SK Sturm Gra,7565,3,18,7,11,59,36,23,61
SC Rheindorf,7565,4,18,7,11,51,47,4,61
Rapid Vienna,7565,5,15,13,8,56,33,23,58
SV Josko Rie,7565,6,13,5,18,42,52,-10,44
RZ Pellets W,7565,7,12,5,19,48,60,-12,41
St. Pölten,7565,8,10,8,18,42,60,-18,38
Mattersburg,7565,9,8,9,19,39,61,-22,33
Admira Wacke,7565,10,8,4,24,30,70,-40,28
FC Salzburg,7566,1,23,4,9,70,35,35,73
Vienna,7566,2,19,6,11,70,54,16,63
SC Rheindorf,7566,3,19,5,12,57,48,9,62
SK Sturm Gra,7566,4,18,7,11,56,38,18,61
Rapid Vienna,7566,5,15,12,9,55,35,20,57
RZ Pellets W,7566,6,11,7,18,43,58,-15,40
Admira Wacke,7566,7,11,7,18,38,59,-21,40
SV Josko Rie,7566,8,11,5,20,35,55,-20,38
Mattersburg,7566,9,9,9,18,47,61,-14,36
St. Pölten,7566,10,9,8,19,39,67,-28,35
FC Salzburg,7567,1,25,6,5,72,24,48,81
SK Sturm Gra,7567,2,21,6,9,64,33,31,69
Vienna,7567,3,21,4,11,64,49,15,67
SC Rheindorf,7567,4,17,8,11,48,36,12,59
Rapid Vienna,7567,5,15,7,14,59,48,11,52
Admira Wacke,7567,6,12,5,19,37,62,-25,41
RZ Pellets W,7567,7,9,9,18,44,59,-15,36
SV Josko Rie,7567,8,10,5,21,36,63,-27,35
Mattersburg,7567,9,8,9,19,34,57,-23,33
St. Pölten,7567,10,7,11,18,44,71,-27,32
SC Rheindorf,7568,1,24,8,4,64,32,32,80
SK Sturm Gra,7568,2,20,4,12,62,38,24,64
Vienna,7568,3,19,7,10,56,44,12,64
FC Salzburg,7568,4,17,8,11,63,39,24,59
Rapid Vienna,7568,5,14,9,13,51,46,5,51
RZ Pellets W,7568,6,14,7,15,49,49,0,49
Admira Wacke,7568,7,12,7,17,38,52,-14,43
St. Pölten,7568,8,9,7,20,38,59,-21,34
Mattersburg,7568,9,7,10,19,34,62,-28,31
SV Josko Rie,7568,10,9,3,24,27,61,-34,30
SC Rheindorf,7569,1,22,6,8,66,42,24,72
SK Sturm Gra,7569,2,21,5,10,63,35,28,68
FC Salzburg,7569,3,18,10,8,56,31,25,64
Vienna,7569,4,19,6,11,63,48,15,63
Rapid Vienna,7569,5,15,10,11,52,40,12,55
Admira Wacke,7569,6,11,5,20,38,62,-24,38
Mattersburg,7569,7,9,10,17,47,59,-12,37
SV Josko Rie,7569,8,10,7,19,37,60,-23,37
RZ Pellets W,7569,9,8,12,16,45,65,-20,36
St. Pölten,7569,10,6,11,19,38,63,-25,29
SC Rheindorf,7570,1,20,9,7,62,40,22,69
FC Salzburg,7570,2,20,7,9,69,38,31,67
Vienna,7570,3,21,3,12,62,47,15,66
SK Sturm Gra,7570,4,19,7,10,59,32,27,64
Rapid Vienna,7570,5,13,12,11,65,48,17,51
RZ Pellets W,7570,6,11,10,15,47,58,-11,43
SV Josko Rie,7570,7,11,6,19,43,64,-21,39
Admira Wacke,7570,8,9,8,19,36,64,-28,35
Mattersburg,7570,9,9,7,20,41,64,-23,34
St. Pölten,7570,10,7,11,18,38,67,-29,32
SK Sturm Gra,7571,1,23,3,10,65,29,36,72
SC Rheindorf,7571,2,21,8,7,59,36,23,71
FC Salzburg,7571,3,21,7,8,62,29,33,70
Rapid Vienna,7571,4,17,9,10,60,32,28,60
Vienna,7571,5,17,3,16,60,62,-2,54
RZ Pellets W,7571,6,10,10,16,40,51,-11,40
St. Pölten,7571,7,10,10,16,39,61,-22,40
SV Josko Rie,7571,8,9,7,20,32,56,-24,34
Admira Wacke,7571,9,8,8,20,31,65,-34,32
Mattersburg,7571,10,8,7,21,37,64,-27,31
FC Salzburg,7572,1,22,6,8,75,35,40,72
Vienna,7572,2,19,5,12,65,50,15,62
Rapid Vienna,7572,3,16,13,7,58,34,24,61
SK Sturm Gra,7572,4,18,7,11,54,34,20,61
SC Rheindorf,7572,5,15,11,10,55,48,7,56
RZ Pellets W,7572,6,13,8,15,42,50,-8,47
SV Josko Rie,7572,7,11,6,19,35,58,-23,39
St. Pölten,7572,8,9,10,17,37,57,-20,37
Admira Wacke,7572,9,9,9,18,29,60,-31,36
Mattersburg,7572,10,6,9,21,33,57,-24,27
FC Salzburg,7573,1,23,6,7,60,25,35,75
SC Rheindorf,7573,2,21,9,6,58,39,19,72
SK Sturm Gra,7573,3,19,5,12,59,35,24,62
Vienna,7573,4,18,6,12,55,45,10,60
Rapid Vienna,7573,5,15,10,11,56,45,11,55
RZ Pellets W,7573,6,14,8,14,41,43,-2,50
Admira Wacke,7573,7,9,9,18,34,57,-23,36
SV Josko Rie,7573,8,9,6,21,32,52,-20,33
Mattersburg,7573,9,6,13,17,37,57,-20,31
St. Pölten,7573,10,5,10,21,29,63,-34,25
FC Salzburg,7574,1,21,7,8,66,30,36,70
Vienna,7574,2,20,6,10,67,50,17,66
SC Rheindorf,7574,3,20,6,10,52,45,7,66
SK Sturm Gra,7574,4,16,9,11,61,39,22,57
Rapid Vienna,7574,5,12,13,11,56,43,13,49
RZ Pellets W,7574,6,13,8,15,41,50,-9,47
SV Josko Rie,7574,7,12,3,21,35,59,-24,39
St. Pölten,7574,8,10,8,18,49,59,-10,38
Mattersburg,7574,9,10,6,20,41,63,-22,36
Admira Wacke,7574,10,10,6,20,39,69,-30,36
SC Rheindorf,7575,1,22,6,8,54,34,20,72
FC Salzburg,7575,2,21,7,8,70,36,34,70
SK Sturm Gra,7575,3,18,7,11,55,33,22,61
Rapid Vienna,7575,4,16,9,11,57,37,20,57
Vienna,7575,5,16,9,11,66,56,10,57
RZ Pellets W,7575,6,15,7,14,50,53,-3,52
Admira Wacke,7575,7,11,7,18,40,60,-20,40
St. Pölten,7575,8,9,7,20,41,65,-24,34
SV Josko Rie,7575,9,8,8,20,29,58,-29,32
Mattersburg,7575,10,6,9,21,29,59,-30,27
FC Salzburg,7576,1,19,11,6,59,27,32,68
SC Rheindorf,7576,2,19,9,8,53,43,10,66
Vienna,7576,3,18,4,14,58,51,7,58
RZ Pellets W,7576,4,16,9,11,50,47,3,57
SK Sturm Gra,7576,5,15,8,13,50,35,15,53
Rapid Vienna,7576,6,12,13,11,66,55,11,49
Admira Wacke,7576,7,9,11,16,33,54,-21,38
Mattersburg,7576,8,9,10,17,50,65,-15,37
St. Pölten,7576,9,8,13,15,43,63,-20,37
SV Josko Rie,7576,10,9,4,23,28,50,-22,31
FC Salzburg,7577,1,21,8,7,62,26,36,71
SK Sturm Gra,7577,2,21,7,8,64,33,31,70
Vienna,7577,3,22,4,10,64,45,19,70
SC Rheindorf,7577,4,18,7,11,50,48,2,61
Rapid Vienna,7577,5,14,10,12,59,43,16,52
RZ Pellets W,7577,6,12,7,17,45,54,-9,43
Mattersburg,7577,7,10,7,19,38,61,-23,37
Admira Wacke,7577,8,9,9,18,38,57,-19,36
SV Josko Rie,7577,9,10,5,21,38,62,-24,35
St. Pölten,7577,10,6,10,20,39,68,-29,28
SC Rheindorf,7578,1,21,7,8,63,40,23,70
SK Sturm Gra,7578,2,20,9,7,61,27,34,69
FC Salzburg,7578,3,20,6,10,59,30,29,66
Vienna,7578,4,19,5,12,68,55,13,62
Rapid Vienna,7578,5,12,11,13,55,47,8,47
Mattersburg,7578,6,13,6,17,45,52,-7,45
Admira Wacke,7578,7,13,5,18,38,62,-24,44
RZ Pellets W,7578,8,10,9,17,45,62,-17,39
SV Josko Rie,7578,9,9,7,20,31,56,-25,34
St. Pölten,7578,10,6,9,21,35,69,-34,27
SK Sturm Gra,7579,1,23,7,6,65,27,38,76
SC Rheindorf,7579,2,22,6,8,57,36,21,72
FC Salzburg,7579,3,20,9,7,63,28,35,69
Vienna,7579,4,21,2,13,72,52,20,65
Rapid Vienna,7579,5,11,13,12,51,43,8,46
Admira Wacke,7579,6,10,7,19,32,59,-27,37
RZ Pellets W,7579,7,10,6,20,40,59,-19,36
St. Pölten,7579,8,9,8,19,44,67,-23,35
Mattersburg,7579,9,9,8,19,37,60,-23,35
SV Josko Rie,7579,10,11,2,23,37,67,-30,35
FC Salzburg,7580,1,22,7,7,80,34,46,73
SC Rheindorf,7580,2,22,7,7,61,39,22,73
SK Sturm Gra,7580,3,18,8,10,56,35,21,62
Vienna,7580,4,19,5,12,61,52,9,62
Rapid Vienna,7580,5,15,10,11,64,42,22,55
RZ Pellets W,7580,6,11,10,15,45,57,-12,43
Admira Wacke,7580,7,12,6,18,40,59,-19,42
SV Josko Rie,7580,8,10,6,20,32,59,-27,36
Mattersburg,7580,9,6,10,20,33,61,-28,28
St. Pölten,7580,10,6,9,21,34,68,-34,27
FC Salzburg,7581,1,21,9,6,67,29,38,72
SC Rheindorf,7581,2,20,8,8,53,36,17,68
Vienna,7581,3,21,4,11,68,51,17,67
SK Sturm Gra,7581,4,16,9,11,53,36,17,57
Rapid Vienna,7581,5,13,12,11,53,42,11,51
RZ Pellets W,7581,6,12,7,17,44,60,-16,43
Admira Wacke,7581,7,9,11,16,35,57,-22,38
SV Josko Rie,7581,8,9,8,19,32,48,-16,35
Mattersburg,7581,9,9,8,19,39,59,-20,35
St. Pölten,7581,10,6,12,18,41,67,-26,30
FC Salzburg,7582,1,22,7,7,63,29,34,73
SC Rheindorf,7582,2,20,9,7,53,37,16,69
SK Sturm Gra,7582,3,20,5,11,61,40,21,65
Vienna,7582,4,18,6,12,56,48,8,60
RZ Pellets W,7582,5,16,8,12,48,50,-2,56
SV Josko Rie,7582,6,12,7,17,40,48,-8,43
Rapid Vienna,7582,7,10,11,15,47,42,5,41
Admira Wacke,7582,8,11,6,19,40,59,-19,39
Mattersburg,7582,9,7,8,21,34,60,-26,29
St. Pölten,7582,10,6,9,21,40,69,-29,27
FC Salzburg,7583,1,23,5,8,68,27,41,74
SK Sturm Gra,7583,2,23,4,9,64,32,32,73
SC Rheindorf,7583,3,19,8,9,52,40,12,65
Vienna,7583,4,17,3,16,53,54,-1,54
RZ Pellets W,7583,5,15,8,13,47,50,-3,53
Rapid Vienna,7583,6,12,11,13,46,38,8,47
SV Josko Rie,7583,7,11,7,18,36,52,-16,40
Mattersburg,7583,8,10,9,17,38,53,-15,39
Admira Wacke,7583,9,10,5,21,33,61,-28,35
St. Pölten,7583,10,6,8,22,33,63,-30,26
FC Salzburg,7584,1,21,9,6,68,29,39,72
Vienna,7584,2,21,2,13,66,51,15,65
SC Rheindorf,7584,3,18,6,12,51,43,8,60
SK Sturm Gra,7584,4,16,7,13,51,35,16,55
Rapid Vienna,7584,5,13,11,12,55,42,13,50
SV Josko Rie,7584,6,14,6,16,35,47,-12,48
RZ Pellets W,7584,7,13,6,17,40,48,-8,45
Admira Wacke,7584,8,13,6,17,41,60,-19,45
St. Pölten,7584,9,8,10,18,41,66,-25,34
Mattersburg,7584,10,8,7,21,39,66,-27,31
SK Sturm Gra,7585,1,23,4,9,73,35,38,73
FC Salzburg,7585,2,22,7,7,63,28,35,73
SC Rheindorf,7585,3,20,6,10,56,43,13,66
Vienna,7585,4,18,6,12,63,56,7,60
Rapid Vienna,7585,5,13,12,11,53,37,16,51
RZ Pellets W,7585,6,9,14,13,44,52,-8,41
St. Pölten,7585,7,10,9,17,45,67,-22,39
Admira Wacke,7585,8,9,7,20,39,69,-30,34
SV Josko Rie,7585,9,10,3,23,36,62,-26,33
Mattersburg,7585,10,8,8,20,36,59,-23,32
FC Salzburg,7586,1,24,7,5,67,23,44,79
SC Rheindorf,7586,2,20,6,10,60,41,19,66
Vienna,7586,3,18,4,14,63,56,7,58
SK Sturm Gra,7586,4,15,8,13,50,41,9,53
Rapid Vienna,7586,5,12,12,12,47,36,11,48
RZ Pellets W,7586,6,11,10,15,41,52,-11,43
St. Pölten,7586,7,11,10,15,44,60,-16,43
Admira Wacke,7586,8,11,9,16,36,60,-24,42
SV Josko Rie,7586,9,9,8,19,31,48,-17,35
Mattersburg,7586,10,7,10,19,37,59,-22,31
SC Rheindorf,7587,1,21,9,6,54,36,18,72
SK Sturm Gra,7587,2,21,7,8,55,29,26,70
FC Salzburg,7587,3,18,10,8,58,30,28,64
Vienna,7587,4,18,5,13,57,50,7,59
Rapid Vienna,7587,5,13,12,11,48,37,11,51
RZ Pellets W,7587,6,12,9,15,45,49,-4,45
Admira Wacke,7587,7,11,6,19,37,57,-20,39
SV Josko Rie,7587,8,9,8,19,36,56,-20,35
St. Pölten,7587,9,8,8,20,44,67,-23,32
Mattersburg,7587,10,8,8,20,32,55,-23,32
SC Rheindorf,7588,1,22,7,7,63,36,27,73
FC Salzburg,7588,2,19,9,8,64,33,31,66
Vienna,7588,3,19,6,11,66,51,15,63
SK Sturm Gra,7588,4,16,6,14,50,39,11,54
RZ Pellets W,7588,5,14,8,14,50,45,5,50
Rapid Vienna,7588,6,12,11,13,46,37,9,47
Admira Wacke,7588,7,13,5,18,35,61,-26,44
SV Josko Rie,7588,8,10,8,18,37,56,-19,38
St. Pölten,7588,9,9,8,19,37,58,-21,35
Mattersburg,7588,10,9,6,21,33,65,-32,33
FC Salzburg,7589,1,24,6,6,62,26,36,78
SK Sturm Gra,7589,2,20,7,9,60,34,26,67
SC Rheindorf,7589,3,19,5,12,53,43,10,62
Vienna,7589,4,16,5,15,59,58,1,53
RZ Pellets W,7589,5,14,5,17,58,63,-5,47
Rapid Vienna,7589,6,11,13,12,50,43,7,46
Mattersburg,7589,7,11,8,17,42,54,-12,41
St. Pölten,7589,8,9,10,17,38,58,-20,37
Admira Wacke,7589,9,10,7,19,38,62,-24,37
SV Josko Rie,7589,10,10,6,20,38,57,-19,36
FC Salzburg,7590,1,20,8,8,69,34,35,68
SK Sturm Gra,7590,2,20,8,8,60,27,33,68
Vienna,7590,3,20,5,11,68,56,12,65
SC Rheindorf,7590,4,19,6,11,61,46,15,63
Rapid Vienna,7590,5,14,10,12,54,41,13,52
RZ Pellets W,7590,6,14,7,15,44,52,-8,49
Admira Wacke,7590,7,12,5,19,41,66,-25,41
SV Josko Rie,7590,8,10,5,21,40,62,-22,35
St. Pölten,7590,9,8,10,18,40,66,-26,34
Mattersburg,7590,10,7,8,21,34,61,-27,29
FC Salzburg,7591,1,23,6,7,67,30,37,75
SK Sturm Gra,7591,2,21,8,7,59,29,30,71
SC Rheindorf,7591,3,21,8,7,59,40,19,71
Vienna,7591,4,16,7,13,64,55,9,55
Rapid Vienna,7591,5,14,9,13,54,36,18,51
RZ Pellets W,7591,6,11,10,15,42,53,-11,43
SV Josko Rie,7591,7,11,2,23,34,51,-17,35
Admira Wacke,7591,8,9,8,19,33,63,-30,35
Mattersburg,7591,9,8,10,18,41,65,-24,34
St. Pölten,7591,10,7,10,19,40,71,-31,31
SK Sturm Gra,7592,1,22,5,9,63,34,29,71
SC Rheindorf,7592,2,18,10,8,56,43,13,64
FC Salzburg,7592,3,18,5,13,59,39,20,59
Vienna,7592,4,18,4,14,59,49,10,58
Rapid Vienna,7592,5,15,10,11,64,41,23,55
SV Josko Rie,7592,6,12,7,17,38,55,-17,43
Admira Wacke,7592,7,12,6,18,42,60,-18,42
Mattersburg,7592,8,10,10,16,41,56,-15,40
St. Pölten,7592,9,10,9,17,41,65,-24,39
RZ Pellets W,7592,10,8,8,20,40,61,-21,32
FC Salzburg,7593,1,21,8,7,62,31,31,71
Vienna,7593,2,21,4,11,69,52,17,67
SK Sturm Gra,7593,3,20,6,10,57,33,24,66
SC Rheindorf,7593,4,19,9,8,58,42,16,66
Rapid Vienna,7593,5,11,12,13,55,44,11,45
RZ Pellets W,7593,6,11,9,16,45,53,-8,42
SV Josko Rie,7593,7,12,6,18,41,51,-10,42
Admira Wacke,7593,8,11,6,19,37,62,-25,39
St. Pölten,7593,9,8,10,18,38,63,-25,34
Mattersburg,7593,10,7,8,21,36,67,-31,29
FC Salzburg,7594,1,21,6,9,66,28,38,69
SK Sturm Gra,7594,2,19,7,10,55,34,21,64
Rapid Vienna,7594,3,17,9,10,58,36,22,60
SC Rheindorf,7594,4,17,8,11,53,45,8,59
Vienna,7594,5,18,5,13,61,56,5,59
Admira Wacke,7594,6,12,8,16,33,48,-15,44
SV Josko Rie,7594,7,12,6,18,38,50,-12,42
RZ Pellets W,7594,8,11,7,18,43,64,-21,40
St. Pölten,7594,9,9,8,19,40,64,-24,35
Mattersburg,7594,10,7,10,19,35,57,-22,31
SK Sturm Gra,7595,1,21,6,9,69,36,33,69
Vienna,7595,2,20,5,11,62,49,13,65
SC Rheindorf,7595,3,20,5,11,56,47,9,65
FC Salzburg,7595,4,18,7,11,59,36,23,61
Rapid Vienna,7595,5,14,9,13,53,43,10,51
Admira Wacke,7595,6,12,11,13,37,46,-9,47
SV Josko Rie,7595,7,12,5,19,33,48,-15,41
RZ Pellets W,7595,8,11,7,18,45,59,-14,40
St. Pölten,7595,9,9,9,18,44,62,-18,36
Mattersburg,7595,10,7,8,21,31,63,-32,29
SC Rheindorf,7596,1,21,8,7,63,41,22,71
FC Salzburg,7596,2,20,9,7,66,30,36,69
SK Sturm Gra,7596,3,20,8,8,62,30,32,68
Vienna,7596,4,19,6,11,63,44,19,63
Rapid Vienna,7596,5,11,16,9,57,43,14,49
RZ Pellets W,7596,6,11,11,14,46,54,-8,44
SV Josko Rie,7596,7,11,6,19,42,59,-17,39
Admira Wacke,7596,8,11,4,21,31,65,-34,37
Mattersburg,7596,9,6,11,19,31,60,-29,29
St. Pölten,7596,10,4,13,19,37,72,-35,25
SC Rheindorf,7597,1,25,6,5,64,33,31,81
FC Salzburg,7597,2,17,10,9,59,35,24,61
Vienna,7597,3,19,3,14,67,51,16,60
SK Sturm Gra,7597,4,16,5,15,57,40,17,53
Rapid Vienna,7597,5,14,9,13,50,46,4,51
RZ Pellets W,7597,6,15,6,15,52,57,-5,51
Mattersburg,7597,7,10,12,14,41,50,-9,42
Admira Wacke,7597,8,12,5,19,36,62,-26,41
SV Josko Rie,7597,9,10,5,21,34,53,-19,35
St. Pölten,7597,10,7,9,20,37,70,-33,30
FC Salzburg,7598,1,19,8,9,65,39,26,65
Vienna,7598,2,19,6,11,67,53,14,63
SK Sturm Gra,7598,3,19,5,12,54,38,16,62
SC Rheindorf,7598,4,18,8,10,54,46,8,62
Rapid Vienna,7598,5,15,11,10,63,45,18,56
RZ Pellets W,7598,6,14,6,16,51,53,-2,48
Admira Wacke,7598,7,12,8,16,43,57,-14,44
SV Josko Rie,7598,8,12,3,21,33,52,-19,39
St. Pölten,7598,9,9,8,19,37,61,-24,35
Mattersburg,7598,10,7,9,20,42,65,-23,30
SC Rheindorf,7599,1,25,5,6,61,38,23,80
FC Salzburg,7599,2,21,7,8,68,27,41,70
SK Sturm Gra,7599,3,18,6,12,60,39,21,60
Vienna,7599,4,17,8,11,65,52,13,59
Rapid Vienna,7599,5,14,11,11,50,41,9,53
Admira Wacke,7599,6,14,5,17,46,59,-13,47
RZ Pellets W,7599,7,11,6,19,39,64,-25,39
SV Josko Rie,7599,8,9,8,19,37,58,-21,35
St. Pölten,7599,9,9,7,20,44,62,-18,34
Mattersburg,7599,10,8,5,23,37,67,-30,29
SC Rheindorf,7600,1,17,11,8,49,42,7,62
SK Sturm Gra,7600,2,18,6,12,55,33,22,60
FC Salzburg,7600,3,15,14,7,57,31,26,59
Rapid Vienna,7600,4,13,12,11,57,40,17,51
RZ Pellets W,7600,5,14,7,15,43,51,-8,49
Admira Wacke,7600,6,12,11,13,37,53,-16,47
Vienna,7600,7,13,7,16,60,61,-1,46
St. Pölten,7600,8,12,10,14,50,56,-6,46
SV Josko Rie,7600,9,10,9,17,36,54,-18,39
Mattersburg,7600,10,8,9,19,36,59,-23,33
Vienna,7601,1,23,2,11,75,57,18,71
SK Sturm Gra,7601,2,22,4,10,68,36,32,70
FC Salzburg,7601,3,18,8,10,61,34,27,62
SC Rheindorf,7601,4,19,4,13,57,44,13,61
Rapid Vienna,7601,5,15,10,11,54,39,15,55
RZ Pellets W,7601,6,14,8,14,52,57,-5,50
SV Josko Rie,7601,7,12,3,21,45,64,-19,39
Admira Wacke,7601,8,11,5,20,34,70,-36,38
Mattersburg,7601,9,10,5,21,42,58,-16,35
St. Pölten,7601,10,7,9,20,45,74,-29,30
SC Rheindorf,7602,1,21,9,6,61,40,21,72
FC Salzburg,7602,2,21,6,9,58,27,31,69
SK Sturm Gra,7602,3,17,5,14,64,47,17,56
Vienna,7602,4,17,5,14,58,51,7,56
Rapid Vienna,7602,5,15,10,11,52,38,14,55
Admira Wacke,7602,6,13,5,18,38,61,-23,44
RZ Pellets W,7602,7,12,6,18,45,60,-15,42
SV Josko Rie,7602,8,11,7,18,32,49,-17,40
St. Pölten,7602,9,9,11,16,44,57,-13,38
Mattersburg,7602,10,8,8,20,34,56,-22,32
FC Salzburg,7603,1,23,6,7,63,24,39,75
SC Rheindorf,7603,2,18,10,8,54,44,10,64
Vienna,7603,3,19,5,12,57,46,11,62
SK Sturm Gra,7603,4,17,7,12,57,36,21,58
Admira Wacke,7603,5,14,6,16,45,53,-8,48
Rapid Vienna,7603,6,12,11,13,51,45,6,47
St. Pölten,7603,7,11,9,16,46,59,-13,42
Mattersburg,7603,8,9,9,18,33,53,-20,36
SV Josko Rie,7603,9,10,6,20,34,58,-24,36
RZ Pellets W,7603,10,10,5,21,37,59,-22,35
FC Salzburg,7604,1,22,7,7,63,22,41,73
SC Rheindorf,7604,2,20,9,7,54,37,17,69
SK Sturm Gra,7604,3,19,5,12,52,35,17,62
Rapid Vienna,7604,4,16,10,10,60,33,27,58
Vienna,7604,5,16,5,15,59,58,1,53
RZ Pellets W,7604,6,13,9,14,44,51,-7,48
Admira Wacke,7604,7,13,6,17,39,58,-19,45
SV Josko Rie,7604,8,10,5,21,29,53,-24,35
St. Pölten,7604,9,8,9,19,34,59,-25,33
Mattersburg,7604,10,8,5,23,31,59,-28,29
FC Salzburg,7605,1,19,9,8,57,29,28,66
SC Rheindorf,7605,2,19,8,9,62,41,21,65
Vienna,7605,3,19,7,10,62,44,18,64
SK Sturm Gra,7605,4,17,9,10,57,35,22,60
RZ Pellets W,7605,5,15,7,14,45,48,-3,52
Rapid Vienna,7605,6,13,11,12,51,41,10,50
Admira Wacke,7605,7,10,8,18,32,57,-25,38
SV Josko Rie,7605,8,11,4,21,35,62,-27,37
St. Pölten,7605,9,8,12,16,50,75,-25,36
Mattersburg,7605,10,8,7,21,43,62,-19,31
FC Salzburg,7606,1,21,6,9,63,32,31,69
SC Rheindorf,7606,2,17,12,7,47,38,9,63
Vienna,7606,3,17,6,13,54,52,2,57
SK Sturm Gra,7606,4,15,9,12,52,34,18,54
Rapid Vienna,7606,5,13,13,10,52,36,16,52
Mattersburg,7606,6,11,12,13,48,52,-4,45
RZ Pellets W,7606,7,12,6,18,50,57,-7,42
SV Josko Rie,7606,8,10,8,18,35,52,-17,38
Admira Wacke,7606,9,10,8,18,37,60,-23,38
St. Pölten,7606,10,8,12,16,35,60,-25,36
FC Salzburg,7607,1,22,9,5,69,32,37,75
SC Rheindorf,7607,2,21,8,7,62,37,25,71
SK Sturm Gra,7607,3,19,7,10,58,32,26,64
Vienna,7607,4,19,5,12,60,53,7,62
Rapid Vienna,7607,5,15,7,14,50,40,10,52
Mattersburg,7607,6,11,7,18,38,60,-22,40
SV Josko Rie,7607,7,11,6,19,46,58,-12,39
Admira Wacke,7607,8,10,8,18,35,59,-24,38
RZ Pellets W,7607,9,10,6,20,43,61,-18,36
St. Pölten,7607,10,7,7,22,45,74,-29,28
SK Sturm Gra,7608,1,23,5,8,64,27,37,74
FC Salzburg,7608,2,21,6,9,67,35,32,69
SC Rheindorf,7608,3,20,6,10,53,40,13,66
Rapid Vienna,7608,4,14,10,12,56,44,12,52
Vienna,7608,5,15,6,15,60,59,1,51
SV Josko Rie,7608,6,14,4,18,42,50,-8,46
RZ Pellets W,7608,7,13,5,18,46,57,-11,44
Admira Wacke,7608,8,12,5,19,39,62,-23,41
St. Pölten,7608,9,9,10,17,40,57,-17,37
Mattersburg,7608,10,7,7,22,30,66,-36,28
FC Salzburg,7609,1,20,8,8,66,28,38,68
SC Rheindorf,7609,2,20,8,8,52,40,12,68
Vienna,7609,3,17,8,11,60,51,9,59
SK Sturm Gra,7609,4,15,9,12,51,39,12,54
Admira Wacke,7609,5,14,6,16,38,53,-15,48
RZ Pellets W,7609,6,12,11,13,45,50,-5,47
Rapid Vienna,7609,7,12,10,14,51,38,13,46
SV Josko Rie,7609,8,11,6,19,34,52,-18,39
St. Pölten,7609,9,10,9,17,38,57,-19,39
Mattersburg,7609,10,7,9,20,33,60,-27,30
Vienna,7610,1,20,6,10,59,50,9,66
FC Salzburg,7610,2,18,6,12,63,36,27,60
SK Sturm Gra,7610,3,18,6,12,57,34,23,60
SC Rheindorf,7610,4,17,7,12,48,46,2,58
Rapid Vienna,7610,5,14,12,10,50,36,14,54
RZ Pellets W,7610,6,15,5,16,57,57,0,50
Mattersburg,7610,7,12,6,18,46,61,-15,42
Admira Wacke,7610,8,11,8,17,33,52,-19,41
St. Pölten,7610,9,9,11,16,42,60,-18,38
SV Josko Rie,7610,10,9,7,20,34,57,-23,34
FC Salzburg,7611,1,21,7,8,61,32,29,70
SK Sturm Gra,7611,2,18,6,12,56,38,18,60
Vienna,7611,3,18,5,13,62,52,10,59
SC Rheindorf,7611,4,17,7,12,52,51,1,58
Admira Wacke,7611,5,15,4,17,40,52,-12,49
RZ Pellets W,7611,6,13,7,16,47,53,-6,46
Mattersburg,7611,7,13,7,16,41,49,-8,46
Rapid Vienna,7611,8,10,15,11,52,42,10,45
SV Josko Rie,7611,9,13,4,19,44,51,-7,43
St. Pölten,7611,10,5,12,19,36,71,-35,27
FC Salzburg,7612,1,19,9,8,62,29,33,66
SC Rheindorf,7612,2,19,6,11,54,43,11,63
Vienna,7612,3,19,4,13,58,55,3,61
SK Sturm Gra,7612,4,18,5,13,55,36,19,59
Rapid Vienna,7612,5,15,12,9,52,33,19,57
RZ Pellets W,7612,6,14,7,15,46,53,-7,49
SV Josko Rie,7612,7,13,5,18,39,50,-11,44
St. Pölten,7612,8,11,9,16,42,55,-13,42
Admira Wacke,7612,9,9,8,19,33,61,-28,35
Mattersburg,7612,10,7,7,22,34,60,-26,28
FC Salzburg,7613,1,22,7,7,63,30,33,73
SC Rheindorf,7613,2,20,6,10,53,41,12,66
SK Sturm Gra,7613,3,19,7,10,62,31,31,64
Vienna,7613,4,19,6,11,60,46,14,63
Rapid Vienna,7613,5,13,10,13,60,45,15,49
RZ Pellets W,7613,6,12,8,16,49,57,-8,44
Admira Wacke,7613,7,11,7,18,44,64,-20,40
Mattersburg,7613,8,10,8,18,38,60,-22,38
St. Pölten,7613,9,9,8,19,46,77,-31,35
SV Josko Rie,7613,10,8,7,21,35,59,-24,31
FC Salzburg,7614,1,18,11,7,63,36,27,65
SK Sturm Gra,7614,2,19,5,12,63,39,24,62
SC Rheindorf,7614,3,18,8,10,58,44,14,62
Vienna,7614,4,17,7,12,61,59,2,58
Rapid Vienna,7614,5,13,11,12,55,46,9,50
RZ Pellets W,7614,6,14,5,17,52,54,-2,47
Admira Wacke,7614,7,12,7,17,39,57,-18,43
St. Pölten,7614,8,10,11,15,44,55,-11,41
Mattersburg,7614,9,10,9,17,39,51,-12,39
SV Josko Rie,7614,10,10,4,22,26,59,-33,34
FC Salzburg,7615,1,19,12,5,64,29,35,69
SC Rheindorf,7615,2,20,8,8,53,38,15,68
SK Sturm Gra,7615,3,20,7,9,56,28,28,67
Rapid Vienna,7615,4,16,11,9,63,42,21,59
Vienna,7615,5,17,5,14,64,58,6,56
Admira Wacke,7615,6,14,6,16,41,55,-14,48
St. Pölten,7615,7,9,11,16,44,59,-15,38
RZ Pellets W,7615,8,8,10,18,36,58,-22,34
SV Josko Rie,7615,9,8,7,21,29,55,-26,31
Mattersburg,7615,10,6,9,21,31,59,-28,27
FC Salzburg,7616,1,19,8,9,69,39,30,65
SK Sturm Gra,7616,2,18,8,10,56,33,23,62
SC Rheindorf,7616,3,17,10,9,58,44,14,61
Vienna,7616,4,17,5,14,62,60,2,56
Rapid Vienna,7616,5,13,12,11,54,44,10,51
Admira Wacke,7616,6,14,6,16,47,57,-10,48
St. Pölten,7616,7,12,8,16,47,66,-19,44
SV Josko Rie,7616,8,10,8,18,47,65,-18,38
RZ Pellets W,7616,9,9,10,17,40,55,-15,37
Mattersburg,7616,10,9,9,18,48,65,-17,36
SC Rheindorf,7617,1,19,10,7,52,36,16,67
SK Sturm Gra,7617,2,21,3,12,52,28,24,66
FC Salzburg,7617,3,20,5,11,62,38,24,65
Vienna,7617,4,19,7,10,59,42,17,64
Rapid Vienna,7617,5,15,10,11,57,40,17,55
Admira Wacke,7617,6,13,6,17,38,56,-18,45
RZ Pellets W,7617,7,12,7,17,37,51,-14,43
SV Josko Rie,7617,8,10,4,22,27,47,-20,34
Mattersburg,7617,9,9,7,20,36,57,-21,34
St. Pölten,7617,10,8,9,19,41,66,-25,33
SC Rheindorf,7618,1,20,8,8,58,42,16,68
SK Sturm Gra,7618,2,20,7,9,57,35,22,67
FC Salzburg,7618,3,19,9,8,68,34,34,66
Vienna,7618,4,18,5,13,62,53,9,59
Rapid Vienna,7618,5,15,11,10,54,39,15,56
RZ Pellets W,7618,6,12,8,16,42,54,-12,44
Admira Wacke,7618,7,13,5,18,36,55,-19,44
St. Pölten,7618,8,9,10,17,43,59,-16,37
Mattersburg,7618,9,7,10,19,33,55,-22,31
SV Josko Rie,7618,10,9,3,24,33,60,-27,30
SC Rheindorf,7619,1,22,7,7,61,39,22,73
SK Sturm Gra,7619,2,21,5,10,62,36,26,68
FC Salzburg,7619,3,20,6,10,58,28,30,66
Vienna,7619,4,18,7,11,58,51,7,61
RZ Pellets W,7619,5,17,7,12,54,48,6,58
Rapid Vienna,7619,6,13,10,13,53,46,7,49
SV Josko Rie,7619,7,10,6,20,37,48,-11,36
Admira Wacke,7619,8,9,9,18,39,64,-25,36
St. Pölten,7619,9,7,9,20,38,64,-26,30
Mattersburg,7619,10,6,8,22,34,70,-36,26
SK Sturm Gra,7620,1,21,5,10,67,43,24,68
FC Salzburg,7620,2,20,7,9,66,32,34,67
SC Rheindorf,7620,3,18,7,11,53,49,4,61
Vienna,7620,4,18,3,15,64,53,11,57
Admira Wacke,7620,5,16,4,16,41,56,-15,52
Rapid Vienna,7620,6,13,12,11,53,37,16,51
SV Josko Rie,7620,7,12,4,20,36,53,-17,40
Mattersburg,7620,8,10,8,18,38,58,-20,38
RZ Pellets W,7620,9,10,7,19,43,60,-17,37
St. Pölten,7620,10,10,7,19,39,59,-20,37
FC Salzburg,7621,1,21,8,7,62,27,35,71
SK Sturm Gra,7621,2,21,7,8,63,30,33,70
Vienna,7621,3,18,8,10,65,50,15,62
SC Rheindorf,7621,4,17,10,9,48,38,10,61
Rapid Vienna,7621,5,14,12,10,58,37,21,54
RZ Pellets W,7621,6,12,6,18,45,61,-16,42
Mattersburg,7621,7,10,9,17,34,47,-13,39
Admira Wacke,7621,8,11,5,20,36,62,-26,38
SV Josko Rie,7621,9,10,5,21,31,56,-25,35
St. Pölten,7621,10,7,8,21,39,73,-34,29
SK Sturm Gra,7622,1,19,9,8,56,30,26,66
Vienna,7622,2,19,8,9,70,41,29,65
FC Salzburg,7622,3,18,11,7,59,33,26,65
SC Rheindorf,7622,4,17,8,11,49,42,7,59
Rapid Vienna,7622,5,13,15,8,51,34,17,54
RZ Pellets W,7622,6,12,5,19,43,57,-14,41
St. Pölten,7622,7,10,9,17,45,66,-21,39
Admira Wacke,7622,8,11,6,19,36,62,-26,39
Mattersburg,7622,9,9,10,17,40,54,-14,37
SV Josko Rie,7622,10,8,7,21,29,59,-30,31
SK Sturm Gra,7623,1,21,7,8,64,31,33,70
Vienna,7623,2,22,4,10,71,45,26,70
SC Rheindorf,7623,3,21,5,10,62,51,11,68
FC Salzburg,7623,4,19,9,8,72,34,38,66
Rapid Vienna,7623,5,13,10,13,51,47,4,49
RZ Pellets W,7623,6,12,11,13,43,49,-6,47
Admira Wacke,7623,7,11,6,19,33,62,-29,39
SV Josko Rie,7623,8,10,6,20,35,55,-20,36
Mattersburg,7623,9,8,6,22,37,57,-20,30
St. Pölten,7623,10,7,8,21,38,75,-37,29
FC Salzburg,7624,1,24,6,6,71,26,45,78
SC Rheindorf,7624,2,20,7,9,59,47,12,67
SK Sturm Gra,7624,3,17,6,13,55,34,21,57
Rapid Vienna,7624,4,15,10,11,57,39,18,55
Vienna,7624,5,16,7,13,57,50,7,55
RZ Pellets W,7624,6,13,7,16,47,57,-10,46
Admira Wacke,7624,7,13,3,20,32,61,-29,42
SV Josko Rie,7624,8,11,7,18,37,53,-16,40
Mattersburg,7624,9,10,5,21,37,62,-25,35
St. Pölten,7624,10,8,8,20,39,62,-23,32
SK Sturm Gra,7625,1,23,6,7,61,33,28,75
FC Salzburg,7625,2,21,10,5,64,27,37,73
SC Rheindorf,7625,3,20,6,10,53,39,14,66
Vienna,7625,4,19,6,11,61,49,12,63
Rapid Vienna,7625,5,12,9,15,50,39,11,45
RZ Pellets W,7625,6,11,10,15,42,52,-10,43
SV Josko Rie,7625,7,10,6,20,30,48,-18,36
Admira Wacke,7625,8,10,6,20,33,59,-26,36
Mattersburg,7625,9,8,9,19,37,59,-22,33
St. Pölten,7625,10,8,8,20,36,62,-26,32
SK Sturm Gra,7626,1,19,9,8,61,34,27,66
SC Rheindorf,7626,2,20,6,10,62,51,11,66
Vienna,7626,3,19,5,12,66,50,16,62
Rapid Vienna,7626,4,16,13,7,54,35,19,61
FC Salzburg,7626,5,16,9,11,60,39,21,57
RZ Pellets W,7626,6,11,11,14,49,53,-4,44
Admira Wacke,7626,7,11,10,15,39,55,-16,43
St. Pölten,7626,8,7,12,17,46,65,-19,33
SV Josko Rie,7626,9,10,3,23,36,67,-31,33
Mattersburg,7626,10,7,10,19,37,61,-24,31
FC Salzburg,7627,1,22,6,8,66,32,34,72
Vienna,7627,2,20,3,13,64,49,15,63
SK Sturm Gra,7627,3,19,5,12,59,37,22,62
SC Rheindorf,7627,4,16,10,10,49,42,7,58
RZ Pellets W,7627,5,14,8,14,48,49,-1,50
Rapid Vienna,7627,6,11,13,12,46,38,8,46
Admira Wacke,7627,7,13,7,16,42,56,-14,46
SV Josko Rie,7627,8,10,6,20,36,56,-20,36
Mattersburg,7627,9,9,9,18,40,65,-25,36
St. Pölten,7627,10,7,11,18,39,65,-26,32
FC Salzburg,7628,1,20,8,8,63,31,32,68
SC Rheindorf,7628,2,19,9,8,53,42,11,66
Vienna,7628,3,21,2,13,63,53,10,65
SK Sturm Gra,7628,4,18,7,11,58,35,23,61
Rapid Vienna,7628,5,16,9,11,54,33,21,57
Admira Wacke,7628,6,12,6,18,38,57,-19,42
RZ Pellets W,7628,7,11,8,17,41,55,-14,41
SV Josko Rie,7628,8,10,7,19,33,53,-20,37
Mattersburg,7628,9,9,7,20,39,58,-19,34
St. Pölten,7628,10,9,7,20,38,63,-25,34
SC Rheindorf,7629,1,22,7,7,59,38,21,73
FC Salzburg,7629,2,21,8,7,68,32,36,71
SK Sturm Gra,7629,3,18,5,13,54,37,17,59
Rapid Vienna,7629,4,16,9,11,52,34,18,57
Vienna,7629,5,18,3,15,72,61,11,57
RZ Pellets W,7629,6,14,6,16,49,56,-7,48
Admira Wacke,7629,7,12,8,16,43,60,-17,44
SV Josko Rie,7629,8,11,4,21,35,56,-21,37
St. Pölten,7629,9,7,10,19,42,71,-29,31
Mattersburg,7629,10,5,12,19,33,62,-29,27
FC Salzburg,7630,1,23,6,7,72,28,44,75
SK Sturm Gra,7630,2,19,8,9,64,32,32,65
Vienna,7630,3,19,7,10,65,50,15,64
SC Rheindorf,7630,4,16,9,11,53,50,3,57
Rapid Vienna,7630,5,14,11,11,55,39,16,53
SV Josko Rie,7630,6,13,5,18,39,48,-9,44
Admira Wacke,7630,7,12,6,18,37,60,-23,42
St. Pölten,7630,8,10,9,17,49,65,-16,39
RZ Pellets W,7630,9,10,7,19,44,71,-27,37
Mattersburg,7630,10,6,8,22,27,62,-35,26
Vienna,7631,1,20,5,11,64,47,17,65
FC Salzburg,7631,2,18,10,8,57,31,26,64
SK Sturm Gra,7631,3,19,7,10,63,42,21,64
SC Rheindorf,7631,4,19,7,10,61,49,12,64
Rapid Vienna,7631,5,16,12,8,63,39,24,60
St. Pölten,7631,6,11,9,16,44,61,-17,42
RZ Pellets W,7631,7,11,8,17,42,59,-17,41
SV Josko Rie,7631,8,11,5,20,34,52,-18,38
Admira Wacke,7631,9,9,7,20,32,57,-25,34
Mattersburg,7631,10,7,8,21,36,59,-23,29
FC Salzburg,7632,1,21,6,9,60,34,26,69
SC Rheindorf,7632,2,18,11,7,61,40,21,65
Vienna,7632,3,20,4,12,68,52,16,64
Rapid Vienna,7632,4,18,9,9,67,37,30,63
SK Sturm Gra,7632,5,17,6,13,58,40,18,57
RZ Pellets W,7632,6,13,8,15,44,53,-9,47
Admira Wacke,7632,7,11,6,19,35,68,-33,39
SV Josko Rie,7632,8,10,5,21,31,50,-19,35
St. Pölten,7632,9,7,11,18,41,74,-33,32
Mattersburg,7632,10,7,10,19,41,58,-17,31
SC Rheindorf,7633,1,23,7,6,59,30,29,76
FC Salzburg,7633,2,21,5,10,64,31,33,68
Vienna,7633,3,22,2,12,61,47,14,68
SK Sturm Gra,7633,4,18,8,10,54,30,24,62
Rapid Vienna,7633,5,13,10,13,50,38,12,49
RZ Pellets W,7633,6,14,4,18,51,58,-7,46
Admira Wacke,7633,7,11,7,18,36,57,-21,40
SV Josko Rie,7633,8,9,6,21,28,52,-24,33
St. Pölten,7633,9,8,9,19,34,68,-34,33
Mattersburg,7633,10,8,8,20,30,56,-26,32
FC Salzburg,7634,1,19,8,9,57,30,27,65
SK Sturm Gra,7634,2,18,10,8,52,27,25,64
Vienna,7634,3,19,5,12,61,46,15,62
SC Rheindorf,7634,4,18,8,10,56,41,15,62
Rapid Vienna,7634,5,15,11,10,55,37,18,56
Admira Wacke,7634,6,14,6,16,41,58,-17,48
St. Pölten,7634,7,11,10,15,45,55,-10,43
Mattersburg,7634,8,9,10,17,37,55,-18,37
RZ Pellets W,7634,9,10,6,20,39,60,-21,36
SV Josko Rie,7634,10,7,6,23,30,64,-34,27
SC Rheindorf,7635,1,19,9,8,54,41,13,66
Vienna,7635,2,20,5,11,68,46,22,65
SK Sturm Gra,7635,3,19,5,12,58,36,22,62
FC Salzburg,7635,4,18,7,11,60,37,23,61
Rapid Vienna,7635,5,14,12,10,54,36,18,54
St. Pölten,7635,6,13,7,16,50,58,-8,46
RZ Pellets W,7635,7,13,7,16,41,55,-14,46
SV Josko Rie,7635,8,10,8,18,37,53,-16,38
Admira Wacke,7635,9,9,7,20,29,65,-36,34
Mattersburg,7635,10,7,9,20,34,58,-24,30
FC Salzburg,7636,1,20,7,9,64,34,30,67
SC Rheindorf,7636,2,20,6,10,56,40,16,66
SK Sturm Gra,7636,3,18,10,8,56,36,20,64
Vienna,7636,4,17,6,13,60,49,11,57
Rapid Vienna,7636,5,12,12,12,58,41,17,48
Admira Wacke,7636,6,13,7,16,39,53,-14,46
RZ Pellets W,7636,7,11,10,15,42,53,-11,43
St. Pölten,7636,8,10,10,16,44,58,-14,40
SV Josko Rie,7636,9,11,3,22,30,60,-30,36
Mattersburg,7636,10,7,11,18,35,60,-25,32
FC Salzburg,7637,1,23,6,7,74,30,44,75
SK Sturm Gra,7637,2,21,5,10,64,34,30,68
Vienna,7637,3,18,7,11,66,60,6,61
SC Rheindorf,7637,4,16,11,9,48,36,12,59
Rapid Vienna,7637,5,12,10,14,48,46,2,46
RZ Pellets W,7637,6,11,10,15,50,56,-6,43
Admira Wacke,7637,7,12,6,18,36,61,-25,42
St. Pölten,7637,8,10,9,17,48,64,-16,39
SV Josko Rie,7637,9,10,6,20,31,51,-20,36
Mattersburg,7637,10,7,10,19,33,60,-27,31
FC Salzburg,7638,1,19,10,7,63,29,34,67
SK Sturm Gra,7638,2,20,7,9,57,33,24,67
Vienna,7638,3,19,6,11,62,46,16,63
SC Rheindorf,7638,4,17,7,12,51,40,11,58
Rapid Vienna,7638,5,12,13,11,53,40,13,49
Admira Wacke,7638,6,12,8,16,35,54,-19,44
RZ Pellets W,7638,7,10,9,17,44,61,-17,39
Mattersburg,7638,8,10,9,17,40,58,-18,39
St. Pölten,7638,9,9,9,18,42,64,-22,36
SV Josko Rie,7638,10,10,6,20,35,57,-22,36
SC Rheindorf,7639,1,22,6,8,56,39,17,72
FC Salzburg,7639,2,21,6,9,64,31,33,69
SK Sturm Gra,7639,3,17,9,10,55,30,25,60
Vienna,7639,4,18,5,13,56,48,8,59
Rapid Vienna,7639,5,14,10,12,55,41,14,52
RZ Pellets W,7639,6,12,8,16,46,57,-11,44
SV Josko Rie,7639,7,12,5,19,35,47,-12,41
St. Pölten,7639,8,10,9,17,40,56,-16,39
Admira Wacke,7639,9,9,7,20,28,63,-35,34
Mattersburg,7639,10,7,11,18,36,59,-23,32
SC Rheindorf,7640,1,20,10,6,55,35,20,70
FC Salzburg,7640,2,20,6,10,62,34,28,66
SK Sturm Gra,7640,3,16,8,12,56,39,17,56
Vienna,7640,4,15,7,14,55,56,-1,52
Rapid Vienna,7640,5,11,14,11,50,42,8,47
SV Josko Rie,7640,6,13,8,15,37,44,-7,47
RZ Pellets W,7640,7,12,7,17,40,51,-11,43
Admira Wacke,7640,8,12,6,18,37,59,-22,42
Mattersburg,7640,9,9,10,17,38,52,-14,37
St. Pölten,7640,10,9,10,17,40,58,-18,37
SK Sturm Gra,7641,1,21,7,8,62,28,34,70
FC Salzburg,7641,2,16,13,7,66,37,29,61
Vienna,7641,3,19,3,14,61,51,10,60
Rapid Vienna,7641,4,15,11,10,58,39,19,56
SC Rheindorf,7641,5,16,7,13,44,44,0,55
Admira Wacke,7641,6,13,7,16,41,60,-19,46
Mattersburg,7641,7,12,8,16,37,50,-13,44
RZ Pellets W,7641,8,9,11,16,37,54,-17,38
SV Josko Rie,7641,9,10,7,19,36,52,-16,37
St. Pölten,7641,10,6,12,18,37,64,-27,30
FC Salzburg,7642,1,24,6,6,77,27,50,78
SC Rheindorf,7642,2,21,9,6,57,38,19,72
SK Sturm Gra,7642,3,20,6,10,61,36,25,66
Vienna,7642,4,19,5,12,67,54,13,62
Rapid Vienna,7642,5,14,8,14,58,47,11,50
Admira Wacke,7642,6,13,6,17,42,60,-18,45
SV Josko Rie,7642,7,11,4,21,36,56,-20,37
RZ Pellets W,7642,8,10,7,19,40,63,-23,37
Mattersburg,7642,9,8,9,19,36,60,-24,33
St. Pölten,7642,10,5,10,21,37,70,-33,25
FC Salzburg,7643,1,22,8,6,75,25,50,74
SC Rheindorf,7643,2,20,7,9,53,40,13,67
SK Sturm Gra,7643,3,20,5,11,59,42,17,65
Vienna,7643,4,20,5,11,66,50,16,65
Rapid Vienna,7643,5,12,11,13,48,45,3,47
Admira Wacke,7643,6,14,5,17,42,57,-15,47
RZ Pellets W,7643,7,12,9,15,40,48,-8,45
St. Pölten,7643,8,9,7,20,43,67,-24,34
Mattersburg,7643,9,9,6,21,34,60,-26,33
SV Josko Rie,7643,10,8,5,23,31,57,-26,29
SC Rheindorf,7644,1,22,7,7,60,36,24,73
FC Salzburg,7644,2,21,6,9,62,30,32,69
Vienna,7644,3,20,5,11,65,51,14,65
SK Sturm Gra,7644,4,15,9,12,55,42,13,54
Rapid Vienna,7644,5,13,12,11,54,40,14,51
RZ Pellets W,7644,6,12,5,19,39,60,-21,41
Admira Wacke,7644,7,11,8,17,34,55,-21,41
SV Josko Rie,7644,8,12,4,20,40,53,-13,40
St. Pölten,7644,9,7,13,16,43,64,-21,34
Mattersburg,7644,10,9,7,20,39,60,-21,34
Vienna,7645,1,22,6,8,75,51,24,72
FC Salzburg,7645,2,21,6,9,66,34,32,69
SC Rheindorf,7645,3,19,7,10,53,41,12,64
SK Sturm Gra,7645,4,17,8,11,51,38,13,59
Rapid Vienna,7645,5,13,12,11,57,44,13,51
RZ Pellets W,7645,6,11,9,16,44,51,-7,42
SV Josko Rie,7645,7,12,6,18,36,49,-13,42
Admira Wacke,7645,8,11,5,20,37,62,-25,38
Mattersburg,7645,9,8,10,18,35,57,-22,34
St. Pölten,7645,10,6,11,19,39,66,-27,29
SC Rheindorf,7646,1,19,8,9,59,42,17,65
SK Sturm Gra,7646,2,19,6,11,60,42,18,63
FC Salzburg,7646,3,17,11,8,55,29,26,62
Rapid Vienna,7646,4,15,7,14,56,45,11,52
Vienna,7646,5,15,7,14,55,51,4,52
RZ Pellets W,7646,6,15,7,14,53,50,3,52
St. Pölten,7646,7,13,8,15,45,54,-9,47
Admira Wacke,7646,8,13,6,17,41,64,-23,45
SV Josko Rie,7646,9,9,9,18,36,55,-19,36
Mattersburg,7646,10,6,9,21,34,62,-28,27
SK Sturm Gra,7647,1,22,7,7,65,26,39,73
SC Rheindorf,7647,2,20,7,9,54,40,14,67
FC Salzburg,7647,3,18,12,6,60,28,32,66
Rapid Vienna,7647,4,15,12,9,59,37,22,57
Vienna,7647,5,16,6,14,60,56,4,54
Admira Wacke,7647,6,12,7,17,42,61,-19,43
SV Josko Rie,7647,7,12,5,19,39,58,-19,41
RZ Pellets W,7647,8,9,7,20,40,63,-23,34
Mattersburg,7647,9,8,9,19,33,60,-27,33
St. Pölten,7647,10,6,12,18,36,59,-23,30
SC Rheindorf,7648,1,21,10,5,57,33,24,73
FC Salzburg,7648,2,19,7,10,58,38,20,64
SK Sturm Gra,7648,3,19,4,13,54,34,20,61
Vienna,7648,4,19,4,13,68,55,13,61
Rapid Vienna,7648,5,15,9,12,52,39,13,54
RZ Pellets W,7648,6,15,7,14,50,51,-1,52
SV Josko Rie,7648,7,11,5,20,31,53,-22,38
St. Pölten,7648,8,9,9,18,38,58,-20,36
Mattersburg,7648,9,9,7,20,37,54,-17,34
Admira Wacke,7648,10,9,6,21,30,60,-30,33
FC Salzburg,7649,1,22,8,6,69,29,40,74
SC Rheindorf,7649,2,20,7,9,51,42,9,67
Vienna,7649,3,18,6,12,71,48,23,60
SK Sturm Gra,7649,4,16,10,10,59,40,19,58
Rapid Vienna,7649,5,12,14,10,57,42,15,50
RZ Pellets W,7649,6,14,7,15,46,54,-8,49
Admira Wacke,7649,7,11,7,18,41,71,-30,40
SV Josko Rie,7649,8,11,6,19,32,51,-19,39
St. Pölten,7649,9,8,9,19,35,62,-27,33
Mattersburg,7649,10,6,10,20,35,57,-22,28
SC Rheindorf,7650,1,21,8,7,61,36,25,71
SK Sturm Gra,7650,2,19,7,10,60,32,28,64
FC Salzburg,7650,3,18,9,9,63,31,32,63
Vienna,7650,4,17,7,12,59,46,13,58
Rapid Vienna,7650,5,13,10,13,55,49,6,49
RZ Pellets W,7650,6,13,8,15,43,54,-11,47
Admira Wacke,7650,7,12,6,18,32,61,-29,42
SV Josko Rie,7650,8,11,7,18,36,49,-13,40
St. Pölten,7650,9,8,9,19,43,68,-25,33
Mattersburg,7650,10,8,9,19,36,62,-26,33
Vienna,7651,1,21,6,9,64,44,20,69
FC Salzburg,7651,2,19,10,7,62,31,31,67
SK Sturm Gra,7651,3,16,8,12,63,43,20,56
SC Rheindorf,7651,4,16,8,12,56,49,7,56
Admira Wacke,7651,5,17,3,16,44,57,-13,54
Rapid Vienna,7651,6,14,11,11,61,45,16,53
Mattersburg,7651,7,13,7,16,42,51,-9,46
RZ Pellets W,7651,8,11,7,18,41,58,-17,40
St. Pölten,7651,9,7,12,17,37,60,-23,33
SV Josko Rie,7651,10,7,6,23,28,60,-32,27
SC Rheindorf,7652,1,22,5,9,57,41,16,71
SK Sturm Gra,7652,2,18,9,9,59,38,21,63
FC Salzburg,7652,3,17,11,8,65,36,29,62
Vienna,7652,4,16,5,15,61,55,6,53
Rapid Vienna,7652,5,13,12,11,65,47,18,51
Admira Wacke,7652,6,14,5,17,37,56,-19,47
RZ Pellets W,7652,7,13,7,16,51,59,-8,46
SV Josko Rie,7652,8,12,6,18,36,52,-16,42
St. Pölten,7652,9,8,10,18,40,66,-26,34
Mattersburg,7652,10,7,10,19,34,55,-21,31
FC Salzburg,7653,1,19,9,8,63,35,28,66
SK Sturm Gra,7653,2,20,6,10,60,33,27,66
Vienna,7653,3,18,6,12,66,53,13,60
SC Rheindorf,7653,4,17,7,12,49,43,6,58
Rapid Vienna,7653,5,14,11,11,55,39,16,53
RZ Pellets W,7653,6,13,9,14,46,53,-7,48
SV Josko Rie,7653,7,13,4,19,38,56,-18,43
Admira Wacke,7653,8,11,7,18,33,57,-24,40
Mattersburg,7653,9,9,8,19,35,54,-19,35
St. Pölten,7653,10,7,11,18,42,64,-22,32
FC Salzburg,7654,1,24,6,6,74,28,46,78
SC Rheindorf,7654,2,21,6,9,63,45,18,69
Vienna,7654,3,19,7,10,64,50,14,64
SK Sturm Gra,7654,4,18,5,13,53,38,15,59
Rapid Vienna,7654,5,14,10,12,59,48,11,52
SV Josko Rie,7654,6,11,7,18,42,55,-13,40
Admira Wacke,7654,7,12,4,20,36,57,-21,40
RZ Pellets W,7654,8,11,6,19,39,58,-19,39
St. Pölten,7654,9,8,9,19,43,67,-24,33
Mattersburg,7654,10,8,8,20,39,66,-27,32
SC Rheindorf,7655,1,19,11,6,61,40,21,68
FC Salzburg,7655,2,20,6,10,64,34,30,66
SK Sturm Gra,7655,3,18,7,11,56,32,24,61
Vienna,7655,4,18,5,13,59,53,6,59
RZ Pellets W,7655,5,14,8,14,46,52,-6,50
Admira Wacke,7655,6,14,5,17,40,54,-14,47
Rapid Vienna,7655,7,12,9,15,47,42,5,45
St. Pölten,7655,8,10,9,17,38,58,-20,39
SV Josko Rie,7655,9,10,6,20,36,58,-22,36
Mattersburg,7655,10,8,8,20,33,57,-24,32
SC Rheindorf,7656,1,20,10,6,61,38,23,70
FC Salzburg,7656,2,19,11,6,58,29,29,68
Rapid Vienna,7656,3,16,12,8,59,34,25,60
Vienna,7656,4,17,7,12,56,49,7,58
SK Sturm Gra,7656,5,15,10,11,55,39,16,55
Admira Wacke,7656,6,13,8,15,40,53,-13,47
Mattersburg,7656,7,11,7,18,43,58,-15,40
RZ Pellets W,7656,8,10,8,18,46,60,-14,38
SV Josko Rie,7656,9,9,5,22,34,65,-31,32
St. Pölten,7656,10,7,8,21,36,63,-27,29
SC Rheindorf,7657,1,23,6,7,62,33,29,75
FC Salzburg,7657,2,22,5,9,67,29,38,71
Vienna,7657,3,21,3,12,63,55,8,66
SK Sturm Gra,7657,4,19,5,12,57,38,19,62
Rapid Vienna,7657,5,11,13,12,51,44,7,46
RZ Pellets W,7657,6,13,6,17,46,52,-6,45
Admira Wacke,7657,7,13,6,17,42,58,-16,45
St. Pölten,7657,8,9,8,19,35,61,-26,35
Mattersburg,7657,9,8,8,20,37,62,-25,32
SV Josko Rie,7657,10,8,6,22,35,63,-28,30
FC Salzburg,7658,1,21,8,7,73,29,44,71
SC Rheindorf,7658,2,21,7,8,58,40,18,70
SK Sturm Gra,7658,3,19,6,11,62,37,25,63
Rapid Vienna,7658,4,17,9,10,56,37,19,60
Vienna,7658,5,14,6,16,52,63,-11,48
SV Josko Rie,7658,6,12,4,20,42,56,-14,40
RZ Pellets W,7658,7,11,7,18,44,59,-15,40
Admira Wacke,7658,8,11,6,19,40,67,-27,39
Mattersburg,7658,9,10,8,18,37,55,-18,38
St. Pölten,7658,10,10,7,19,43,64,-21,37
FC Salzburg,7659,1,21,6,9,68,32,36,69
SK Sturm Gra,7659,2,19,5,12,53,36,17,62
Rapid Vienna,7659,3,16,9,11,60,45,15,57
Vienna,7659,4,16,8,12,60,54,6,56
SC Rheindorf,7659,5,16,8,12,50,51,-1,56
RZ Pellets W,7659,6,14,8,14,49,49,0,50
SV Josko Rie,7659,7,14,7,15,40,42,-2,49
Admira Wacke,7659,8,11,4,21,29,58,-29,37
Mattersburg,7659,9,9,8,19,38,55,-17,35
St. Pölten,7659,10,8,9,19,46,71,-25,33
FC Salzburg,7660,1,22,7,7,67,32,35,73
SC Rheindorf,7660,2,19,9,8,64,42,22,66
SK Sturm Gra,7660,3,18,6,12,65,40,25,60
Rapid Vienna,7660,4,16,11,9,58,39,19,59
Vienna,7660,5,18,4,14,65,55,10,58
RZ Pellets W,7660,6,14,7,15,50,57,-7,49
Admira Wacke,7660,7,14,5,17,46,60,-14,47
SV Josko Rie,7660,8,10,4,22,34,65,-31,34
Mattersburg,7660,9,7,10,19,34,56,-22,31
St. Pölten,7660,10,7,7,22,40,77,-37,28
SK Sturm Gra,7661,1,20,5,11,65,36,29,65
FC Salzburg,7661,2,19,6,11,57,34,23,63
SC Rheindorf,7661,3,17,11,8,50,38,12,62
Rapid Vienna,7661,4,15,12,9,58,38,20,57
Vienna,7661,5,15,6,15,54,50,4,51
Admira Wacke,7661,6,14,8,14,38,47,-9,50
RZ Pellets W,7661,7,12,7,17,45,64,-19,43
SV Josko Rie,7661,8,11,5,20,36,57,-21,38
St. Pölten,7661,9,9,9,18,48,67,-19,36
Mattersburg,7661,10,8,11,17,38,58,-20,35
FC Salzburg,7662,1,21,7,8,66,30,36,70
SK Sturm Gra,7662,2,21,4,11,61,37,24,67
SC Rheindorf,7662,3,20,6,10,54,39,15,66
Vienna,7662,4,18,3,15,63,55,8,57
Admira Wacke,7662,5,16,6,14,44,48,-4,54
Rapid Vienna,7662,6,13,11,12,55,45,10,50
SV Josko Rie,7662,7,10,7,19,31,49,-18,37
St. Pölten,7662,8,8,12,16,41,62,-21,36
RZ Pellets W,7662,9,9,7,20,38,63,-25,34
Mattersburg,7662,10,7,11,18,33,58,-25,32
FC Salzburg,7663,1,23,8,5,67,24,43,77
SK Sturm Gra,7663,2,20,7,9,62,31,31,67
SC Rheindorf,7663,3,20,7,9,50,35,15,67
Vienna,7663,4,19,6,11,60,47,13,63
Rapid Vienna,7663,5,13,10,13,49,40,9,49
RZ Pellets W,7663,6,13,7,16,46,51,-5,46
Admira Wacke,7663,7,12,7,17,37,53,-16,43
St. Pölten,7663,8,7,10,19,39,64,-25,31
Mattersburg,7663,9,7,9,20,31,60,-29,30
SV Josko Rie,7663,10,7,7,22,28,64,-36,28
SC Rheindorf,7664,1,21,7,8,67,48,19,70
FC Salzburg,7664,2,20,9,7,70,38,32,69
SK Sturm Gra,7664,3,20,7,9,62,31,31,67
Vienna,7664,4,20,5,11,66,51,15,65
Rapid Vienna,7664,5,14,11,11,56,40,16,53
Admira Wacke,7664,6,12,6,18,42,66,-24,42
RZ Pellets W,7664,7,11,7,18,45,53,-8,40
St. Pölten,7664,8,10,8,18,45,67,-22,38
SV Josko Rie,7664,9,11,3,22,32,56,-24,36
Mattersburg,7664,10,7,5,24,32,67,-35,26
Vienna,7665,1,23,4,9,63,40,23,73
FC Salzburg,7665,2,22,5,9,66,30,36,71
SK Sturm Gra,7665,3,20,8,8,65,34,31,68
SC Rheindorf,7665,4,20,6,10,52,44,8,66
Rapid Vienna,7665,5,13,10,13,51,42,9,49
Mattersburg,7665,6,11,6,19,38,53,-15,39
Admira Wacke,7665,7,11,6,19,32,55,-23,39
RZ Pellets W,7665,8,10,6,20,40,62,-22,36
St. Pölten,7665,9,9,8,19,37,60,-23,35
SV Josko Rie,7665,10,9,5,22,30,54,-24,32
SK Sturm Gra,7666,1,20,7,9,63,32,31,67
Vienna,7666,2,21,4,11,67,45,22,67
FC Salzburg,7666,3,20,5,11,58,36,22,65
SC Rheindorf,7666,4,17,8,11,48,43,5,59
Rapid Vienna,7666,5,15,11,10,58,51,7,56
Admira Wacke,7666,6,13,5,18,35,60,-25,44
RZ Pellets W,7666,7,11,10,15,49,56,-7,43
SV Josko Rie,7666,8,11,7,18,40,49,-9,40
Mattersburg,7666,9,7,10,19,38,58,-20,31
St. Pölten,7666,10,7,9,20,36,62,-26,30
Vienna,7667,1,23,3,10,62,46,16,72
FC Salzburg,7667,2,21,8,7,66,32,34,71
SC Rheindorf,7667,3,20,8,8,56,34,22,68
SK Sturm Gra,7667,4,20,6,10,60,31,29,66
Rapid Vienna,7667,5,16,11,9,57,35,22,59
RZ Pellets W,7667,6,11,9,16,42,56,-14,42
SV Josko Rie,7667,7,11,5,20,32,50,-18,38
Admira Wacke,7667,8,9,6,21,34,65,-31,33
Mattersburg,7667,9,6,10,20,31,56,-25,28
St. Pölten,7667,10,5,10,21,30,65,-35,25
FC Salzburg,7668,1,20,8,8,63,30,33,68
SK Sturm Gra,7668,2,19,8,9,59,33,26,65
SC Rheindorf,7668,3,17,11,8,59,42,17,62
Vienna,7668,4,18,5,13,61,54,7,59
Rapid Vienna,7668,5,15,11,10,55,38,17,56
RZ Pellets W,7668,6,14,9,13,49,50,-1,51
Admira Wacke,7668,7,10,5,21,38,67,-29,35
Mattersburg,7668,8,8,10,18,38,58,-20,34
SV Josko Rie,7668,9,9,7,20,30,54,-24,34
St. Pölten,7668,10,8,10,18,37,63,-26,34
FC Salzburg,7669,1,21,9,6,69,28,41,72
SC Rheindorf,7669,2,21,9,6,57,38,19,72
SK Sturm Gra,7669,3,18,7,11,62,40,22,61
Vienna,7669,4,19,3,14,68,56,12,60
Rapid Vienna,7669,5,15,10,11,58,43,15,55
Admira Wacke,7669,6,16,4,16,49,57,-8,52
RZ Pellets W,7669,7,14,5,17,47,55,-8,47
Mattersburg,7669,8,8,7,21,38,61,-23,31
SV Josko Rie,7669,9,8,7,21,28,57,-29,31
St. Pölten,7669,10,5,9,22,32,73,-41,24
SK Sturm Gra,7670,1,22,5,9,61,30,31,71
FC Salzburg,7670,2,20,10,6,69,26,43,70
SC Rheindorf,7670,3,19,9,8,57,43,14,66
Vienna,7670,4,17,6,13,59,56,3,57
Rapid Vienna,7670,5,13,11,12,60,43,17,50
Admira Wacke,7670,6,14,7,15,44,59,-15,49
RZ Pellets W,7670,7,9,11,16,43,60,-17,38
St. Pölten,7670,8,8,10,18,35,66,-31,34
SV Josko Rie,7670,9,9,6,21,32,53,-21,33
Mattersburg,7670,10,7,9,20,32,56,-24,30
FC Salzburg,7671,1,23,6,7,73,29,44,75
SK Sturm Gra,7671,2,21,4,11,63,36,27,67
SC Rheindorf,7671,3,20,5,11,60,42,18,65
Vienna,7671,4,17,5,14,64,61,3,56
Rapid Vienna,7671,5,11,15,10,52,44,8,48
RZ Pellets W,7671,6,14,6,16,49,54,-5,48
Admira Wacke,7671,7,13,6,17,43,63,-20,45
SV Josko Rie,7671,8,12,4,20,34,53,-19,40
Mattersburg,7671,9,9,9,18,39,55,-16,36
St. Pölten,7671,10,5,10,21,30,70,-40,25
SC Rheindorf,7672,1,20,7,9,53,43,10,67
FC Salzburg,7672,2,20,6,10,71,32,39,66
Rapid Vienna,7672,3,18,10,8,64,32,32,64
Vienna,7672,4,19,4,13,67,59,8,61
SK Sturm Gra,7672,5,16,8,12,62,38,24,56
Admira Wacke,7672,6,13,4,19,39,67,-28,43
SV Josko Rie,7672,7,12,3,21,36,55,-19,39
RZ Pellets W,7672,8,10,8,18,43,60,-17,38
Mattersburg,7672,9,10,8,18,35,57,-22,38
St. Pölten,7672,10,9,8,19,40,67,-27,35
FC Salzburg,7673,1,20,8,8,63,33,30,68
SC Rheindorf,7673,2,20,7,9,57,45,12,67
Vienna,7673,3,19,6,11,74,55,19,63
SK Sturm Gra,7673,4,17,7,12,61,40,21,58
Rapid Vienna,7673,5,15,10,11,59,37,22,55
RZ Pellets W,7673,6,12,9,15,48,55,-7,45
St. Pölten,7673,7,9,14,13,47,55,-8,41
Admira Wacke,7673,8,10,5,21,39,76,-37,35
Mattersburg,7673,9,8,10,18,34,58,-24,34
SV Josko Rie,7673,10,9,6,21,33,61,-28,33
SC Rheindorf,7674,1,24,6,6,67,39,28,78
FC Salzburg,7674,2,18,7,11,61,37,24,61
SK Sturm Gra,7674,3,18,4,14,58,51,7,58
Vienna,7674,4,17,4,15,63,60,3,55
RZ Pellets W,7674,5,15,7,14,53,58,-5,52
Rapid Vienna,7674,6,12,13,11,55,41,14,49
SV Josko Rie,7674,7,15,4,17,40,50,-10,49
Admira Wacke,7674,8,13,7,16,46,58,-12,46
Mattersburg,7674,9,9,5,22,39,60,-21,32
St. Pölten,7674,10,6,9,21,35,63,-28,27
SC Rheindorf,7675,1,21,10,5,56,33,23,73
SK Sturm Gra,7675,2,20,6,10,67,41,26,66
FC Salzburg,7675,3,19,8,9,64,34,30,65
Vienna,7675,4,16,5,15,55,55,0,53
Rapid Vienna,7675,5,13,12,11,59,36,23,51
RZ Pellets W,7675,6,14,5,17,48,56,-8,47
St. Pölten,7675,7,12,8,16,44,57,-13,44
Admira Wacke,7675,8,10,8,18,32,56,-24,38
Mattersburg,7675,9,9,7,20,37,69,-32,34
SV Josko Rie,7675,10,7,9,20,33,58,-25,30
SC Rheindorf,7676,1,24,6,6,61,36,25,78
FC Salzburg,7676,2,19,9,8,69,37,32,66
SK Sturm Gra,7676,3,20,6,10,69,40,29,66
Rapid Vienna,7676,4,14,13,9,50,35,15,55
Vienna,7676,5,17,4,15,63,58,5,55
RZ Pellets W,7676,6,11,8,17,45,60,-15,41
Admira Wacke,7676,7,12,5,19,43,65,-22,41
Mattersburg,7676,8,9,8,19,50,62,-12,35
SV Josko Rie,7676,9,10,5,21,31,60,-29,35
St. Pölten,7676,10,7,10,19,39,67,-28,31
SC Rheindorf,7677,1,22,6,8,57,39,18,72
FC Salzburg,7677,2,21,6,9,66,31,35,69
Rapid Vienna,7677,3,19,9,8,62,33,29,66
SK Sturm Gra,7677,4,17,8,11,57,41,16,59
Vienna,7677,5,18,5,13,68,57,11,59
RZ Pellets W,7677,6,12,10,14,46,51,-5,46
SV Josko Rie,7677,7,11,5,20,35,53,-18,38
St. Pölten,7677,8,9,7,20,45,65,-20,34
Admira Wacke,7677,9,9,5,22,29,67,-38,32
Mattersburg,7677,10,7,9,20,37,65,-28,30
SK Sturm Gra,7678,1,21,7,8,64,37,27,70
SC Rheindorf,7678,2,21,6,9,61,39,22,69
FC Salzburg,7678,3,19,9,8,63,33,30,66
Vienna,7678,4,16,4,16,58,58,0,52
RZ Pellets W,7678,5,13,9,14,52,56,-4,48
Rapid Vienna,7678,6,12,10,14,53,46,7,46
St. Pölten,7678,7,9,13,14,41,58,-17,40
Admira Wacke,7678,8,10,8,18,41,63,-22,38
SV Josko Rie,7678,9,11,4,21,40,61,-21,37
Mattersburg,7678,10,8,10,18,38,60,-22,34
FC Salzburg,7679,1,23,6,7,63,24,39,75
SC Rheindorf,7679,2,20,9,7,56,41,15,69
Vienna,7679,3,17,7,12,62,52,10,58
SK Sturm Gra,7679,4,17,4,15,54,38,16,55
Rapid Vienna,7679,5,12,12,12,53,40,13,48
RZ Pellets W,7679,6,12,8,16,43,52,-9,44
Admira Wacke,7679,7,11,9,16,42,57,-15,42
St. Pölten,7679,8,10,11,15,39,55,-16,41
Mattersburg,7679,9,9,8,19,31,56,-25,35
SV Josko Rie,7679,10,10,4,22,31,59,-28,34
FC Salzburg,7680,1,21,9,6,68,28,40,72
SK Sturm Gra,7680,2,20,8,8,56,28,28,68
SC Rheindorf,7680,3,18,10,8,51,38,13,64
Vienna,7680,4,19,5,12,63,54,9,62
Rapid Vienna,7680,5,12,13,11,55,39,16,49
RZ Pellets W,7680,6,13,8,15,48,55,-7,47
Mattersburg,7680,7,9,8,19,42,63,-21,35
St. Pölten,7680,8,8,11,17,38,62,-24,35
Admira Wacke,7680,9,8,10,18,39,64,-25,34
SV Josko Rie,7680,10,9,4,23,33,62,-29,31
FC Salzburg,7681,1,23,6,7,66,30,36,75
SC Rheindorf,7681,2,23,5,8,61,39,22,74
Vienna,7681,3,17,8,11,59,50,9,59
SK Sturm Gra,7681,4,16,7,13,54,39,15,55
RZ Pellets W,7681,5,14,5,17,44,48,-4,47
Rapid Vienna,7681,6,12,9,15,53,53,0,45
Admira Wacke,7681,7,11,7,18,39,58,-19,40
SV Josko Rie,7681,8,11,5,20,35,53,-18,38
Mattersburg,7681,9,9,10,17,34,53,-19,37
St. Pölten,7681,10,9,8,19,42,64,-22,35
FC Salzburg,7682,1,22,8,6,65,29,36,74
Vienna,7682,2,20,5,11,65,41,24,65
SC Rheindorf,7682,3,18,8,10,57,49,8,62
Rapid Vienna,7682,4,16,11,9,62,40,22,59
SK Sturm Gra,7682,5,17,7,12,53,38,15,58
RZ Pellets W,7682,6,14,5,17,46,56,-10,47
Admira Wacke,7682,7,11,7,18,34,56,-22,40
SV Josko Rie,7682,8,10,4,22,32,60,-28,34
St. Pölten,7682,9,8,9,19,39,59,-20,33
Mattersburg,7682,10,8,8,20,37,62,-25,32
SC Rheindorf,7683,1,21,8,7,53,35,18,71
FC Salzburg,7683,2,19,6,11,71,33,38,63
SK Sturm Gra,7683,3,18,6,12,53,36,17,60
Vienna,7683,4,17,5,14,56,51,5,56
Rapid Vienna,7683,5,15,10,11,65,41,24,55
RZ Pellets W,7683,6,14,6,16,49,55,-6,48
Admira Wacke,7683,7,13,6,17,37,53,-16,45
SV Josko Rie,7683,8,10,7,19,34,57,-23,37
St. Pölten,7683,9,9,10,17,37,63,-26,37
Mattersburg,7683,10,8,8,20,33,64,-31,32
FC Salzburg,7684,1,22,7,7,70,34,36,73
SC Rheindorf,7684,2,20,7,9,61,41,20,67
SK Sturm Gra,7684,3,20,5,11,64,40,24,65
Vienna,7684,4,17,9,10,66,53,13,60
Rapid Vienna,7684,5,16,7,13,65,44,21,55
RZ Pellets W,7684,6,13,6,17,47,65,-18,45
SV Josko Rie,7684,7,12,7,17,43,54,-11,43
Admira Wacke,7684,8,9,8,19,36,63,-27,35
St. Pölten,7684,9,7,10,19,47,75,-28,31
Mattersburg,7684,10,8,6,22,35,65,-30,30
FC Salzburg,7685,1,20,10,6,64,31,33,70
Vienna,7685,2,21,4,11,64,43,21,67
SK Sturm Gra,7685,3,20,4,12,61,39,22,64
SC Rheindorf,7685,4,18,9,9,58,47,11,63
Rapid Vienna,7685,5,15,13,8,59,40,19,58
RZ Pellets W,7685,6,11,10,15,38,50,-12,43
Admira Wacke,7685,7,8,10,18,34,65,-31,34
SV Josko Rie,7685,8,9,6,21,33,64,-31,33
Mattersburg,7685,9,8,8,20,44,58,-14,32
St. Pölten,7685,10,6,14,16,45,63,-18,32
FC Salzburg,7686,1,21,9,6,67,31,36,72
SC Rheindorf,7686,2,22,5,9,66,45,21,71
Vienna,7686,3,20,7,9,77,49,28,67
SK Sturm Gra,7686,4,19,8,9,59,35,24,65
Rapid Vienna,7686,5,12,13,11,50,42,8,49
RZ Pellets W,7686,6,11,10,15,43,54,-11,43
SV Josko Rie,7686,7,9,8,19,31,53,-22,35
Admira Wacke,7686,8,9,8,19,34,60,-26,35
St. Pölten,7686,9,8,8,20,41,68,-27,32
Mattersburg,7686,10,7,8,21,31,62,-31,29
FC Salzburg,7687,1,23,5,8,70,29,41,74
SC Rheindorf,7687,2,20,8,8,54,42,12,68
Rapid Vienna,7687,3,17,8,11,55,38,17,59
Vienna,7687,4,16,7,13,62,54,8,55
SK Sturm Gra,7687,5,16,4,16,52,38,14,52
RZ Pellets W,7687,6,13,8,15,48,54,-6,47
Admira Wacke,7687,7,13,6,17,35,53,-18,45
SV Josko Rie,7687,8,11,5,20,39,61,-22,38
St. Pölten,7687,9,9,8,19,48,73,-25,35
Mattersburg,7687,10,8,9,19,35,56,-21,33
FC Salzburg,7688,1,20,8,8,72,41,31,68
SK Sturm Gra,7688,2,18,9,9,63,36,27,63
SC Rheindorf,7688,3,17,8,11,52,49,3,59
Vienna,7688,4,17,7,12,65,56,9,58
RZ Pellets W,7688,5,14,7,15,45,54,-9,49
Rapid Vienna,7688,6,12,12,12,49,36,13,48
Admira Wacke,7688,7,14,5,17,40,59,-19,47
SV Josko Rie,7688,8,12,6,18,43,57,-14,42
St. Pölten,7688,9,8,9,19,41,63,-22,33
Mattersburg,7688,10,7,11,18,33,52,-19,32
FC Salzburg,7689,1,22,7,7,61,26,35,73
SK Sturm Gra,7689,2,20,6,10,67,33,34,66
SC Rheindorf,7689,3,18,10,8,52,40,12,64
Vienna,7689,4,18,7,11,60,51,9,61
Rapid Vienna,7689,5,17,7,12,60,46,14,58
RZ Pellets W,7689,6,12,9,15,47,54,-7,45
Admira Wacke,7689,7,10,8,18,43,66,-23,38
Mattersburg,7689,8,8,10,18,34,51,-17,34
SV Josko Rie,7689,9,9,5,22,33,63,-30,32
St. Pölten,7689,10,7,9,20,34,61,-27,30
FC Salzburg,7690,1,20,8,8,67,29,38,68
Rapid Vienna,7690,2,20,8,8,69,35,34,68
Vienna,7690,3,19,5,12,63,53,10,62
SC Rheindorf,7690,4,18,5,13,48,46,2,59
SK Sturm Gra,7690,5,17,7,12,59,42,17,58
St. Pölten,7690,6,11,10,15,40,55,-15,43
Admira Wacke,7690,7,11,8,17,34,58,-24,41
RZ Pellets W,7690,8,11,6,19,37,50,-13,39
SV Josko Rie,7690,9,11,2,23,27,53,-26,35
Mattersburg,7690,10,9,7,20,30,53,-23,34
FC Salzburg,7691,1,21,11,4,68,26,42,74
Vienna,7691,2,19,5,12,64,51,13,62
SC Rheindorf,7691,3,18,8,10,54,43,11,62
SK Sturm Gra,7691,4,18,7,11,56,41,15,61
Rapid Vienna,7691,5,13,10,13,56,45,11,49
St. Pölten,7691,6,12,10,14,47,54,-7,46
RZ Pellets W,7691,7,10,8,18,46,60,-14,38
Mattersburg,7691,8,9,10,17,42,64,-22,37
Admira Wacke,7691,9,10,7,19,35,61,-26,37
SV Josko Rie,7691,10,9,6,21,33,56,-23,33
FC Salzburg,7692,1,19,9,8,65,38,27,66
Vienna,7692,2,20,6,10,68,45,23,66
SC Rheindorf,7692,3,18,12,6,51,33,18,66
SK Sturm Gra,7692,4,16,9,11,55,35,20,57
Rapid Vienna,7692,5,12,13,11,58,44,14,49
RZ Pellets W,7692,6,13,10,13,51,54,-3,49
Admira Wacke,7692,7,11,7,18,41,65,-24,40
SV Josko Rie,7692,8,10,8,18,29,50,-21,38
Mattersburg,7692,9,9,6,21,38,62,-24,33
St. Pölten,7692,10,5,14,17,38,68,-30,29
SK Sturm Gra,7693,1,19,10,7,58,30,28,67
FC Salzburg,7693,2,19,7,10,63,38,25,64
Vienna,7693,3,19,7,10,67,49,18,64
Rapid Vienna,7693,4,17,9,10,60,36,24,60
SC Rheindorf,7693,5,17,8,11,60,53,7,59
Admira Wacke,7693,6,14,5,17,45,57,-12,47
RZ Pellets W,7693,7,11,9,16,51,60,-9,42
St. Pölten,7693,8,8,10,18,41,67,-26,34
SV Josko Rie,7693,9,9,7,20,35,62,-27,34
Mattersburg,7693,10,7,8,21,39,67,-28,29
SC Rheindorf,7694,1,19,9,8,55,39,16,66
FC Salzburg,7694,2,18,7,11,66,41,25,61
SK Sturm Gra,7694,3,18,7,11,53,32,21,61
Rapid Vienna,7694,4,17,8,11,56,40,16,59
Vienna,7694,5,17,4,15,58,56,2,55
Admira Wacke,7694,6,15,8,13,41,50,-9,53
RZ Pellets W,7694,7,12,8,16,51,61,-10,44
SV Josko Rie,7694,8,12,4,20,35,54,-19,40
Mattersburg,7694,9,8,9,19,46,65,-19,33
St. Pölten,7694,10,6,12,18,45,68,-23,30
SC Rheindorf,7695,1,22,8,6,64,37,27,74
FC Salzburg,7695,2,20,9,7,69,34,35,69
Vienna,7695,3,20,6,10,69,50,19,66
SK Sturm Gra,7695,4,18,9,9,60,39,21,63
Rapid Vienna,7695,5,12,13,11,50,40,10,49
Admira Wacke,7695,6,13,4,19,43,61,-18,43
RZ Pellets W,7695,7,9,10,17,41,59,-18,37
St. Pölten,7695,8,9,10,17,40,65,-25,37
SV Josko Rie,7695,9,8,8,20,28,53,-25,32
Mattersburg,7695,10,5,11,20,30,56,-26,26
FC Salzburg,7696,1,20,7,9,65,30,35,67
SC Rheindorf,7696,2,19,6,11,52,40,12,63
SK Sturm Gra,7696,3,18,7,11,54,35,19,61
Vienna,7696,4,19,4,13,66,61,5,61
Rapid Vienna,7696,5,16,9,11,59,42,17,57
Admira Wacke,7696,6,16,5,15,52,56,-4,53
RZ Pellets W,7696,7,13,7,16,54,61,-7,46
SV Josko Rie,7696,8,14,3,19,40,58,-18,45
Mattersburg,7696,9,6,9,21,40,63,-23,27
St. Pölten,7696,10,6,9,21,38,74,-36,27
FC Salzburg,7697,1,22,8,6,71,31,40,74
SK Sturm Gra,7697,2,19,5,12,60,36,24,62
Vienna,7697,3,18,8,10,57,48,9,62
SC Rheindorf,7697,4,17,9,10,50,47,3,60
Rapid Vienna,7697,5,12,11,13,51,43,8,47
RZ Pellets W,7697,6,13,8,15,52,58,-6,47
SV Josko Rie,7697,7,12,5,19,41,52,-11,41
St. Pölten,7697,8,10,11,15,42,61,-19,41
Admira Wacke,7697,9,10,6,20,37,63,-26,36
Mattersburg,7697,10,8,7,21,35,57,-22,31
FC Salzburg,7698,1,22,7,7,68,30,38,73
SK Sturm Gra,7698,2,21,7,8,60,30,30,70
Vienna,7698,3,19,6,11,58,42,16,63
SC Rheindorf,7698,4,17,9,10,48,42,6,60
Rapid Vienna,7698,5,12,13,11,52,39,13,49
RZ Pellets W,7698,6,13,8,15,40,50,-10,47
Admira Wacke,7698,7,10,8,18,34,58,-24,38
SV Josko Rie,7698,8,8,10,18,33,51,-18,34
St. Pölten,7698,9,8,10,18,37,64,-27,34
Mattersburg,7698,10,6,10,20,34,58,-24,28
SC Rheindorf,7699,1,24,6,6,63,32,31,78
FC Salzburg,7699,2,19,6,11,69,33,36,63
Vienna,7699,3,19,4,13,57,49,8,61
RZ Pellets W,7699,4,17,4,15,51,52,-1,55
Rapid Vienna,7699,5,14,12,10,58,43,15,54
SK Sturm Gra,7699,6,15,8,13,51,39,12,53
Admira Wacke,7699,7,12,6,18,36,60,-24,42
Mattersburg,7699,8,9,8,19,37,58,-21,35
SV Josko Rie,7699,9,9,7,20,30,57,-27,34
St. Pölten,7699,10,7,9,20,41,70,-29,30
SK Sturm Gra,7700,1,22,6,8,67,28,39,72
FC Salzburg,7700,2,20,9,7,62,29,33,69
Vienna,7700,3,21,5,10,63,43,20,68
SC Rheindorf,7700,4,18,9,9,53,46,7,63
Rapid Vienna,7700,5,14,10,12,63,41,22,52
RZ Pellets W,7700,6,13,6,17,42,61,-19,45
Admira Wacke,7700,7,11,7,18,38,63,-25,40
St. Pölten,7700,8,9,9,18,39,58,-19,36
SV Josko Rie,7700,9,8,5,23,29,56,-27,29
Mattersburg,7700,10,7,8,21,32,63,-31,29
FC Salzburg,7701,1,21,8,7,71,34,37,71
SK Sturm Gra,7701,2,21,5,10,60,32,28,68
SC Rheindorf,7701,3,18,6,12,55,45,10,60
Vienna,7701,4,17,6,13,54,48,6,57
Rapid Vienna,7701,5,11,15,10,54,44,10,48
RZ Pellets W,7701,6,13,9,14,49,53,-4,48
SV Josko Rie,7701,7,13,6,17,37,50,-13,45
St. Pölten,7701,8,9,9,18,39,64,-25,36
Mattersburg,7701,9,9,8,19,40,55,-15,35
Admira Wacke,7701,10,9,6,21,30,64,-34,33
FC Salzburg,7702,1,18,8,10,55,31,24,62
SC Rheindorf,7702,2,18,8,10,56,44,12,62
Rapid Vienna,7702,3,16,11,9,60,39,21,59
SK Sturm Gra,7702,4,18,4,14,56,42,14,58
Vienna,7702,5,17,4,15,53,51,2,55
Admira Wacke,7702,6,14,5,17,36,52,-16,47
Mattersburg,7702,7,12,9,15,44,52,-8,45
SV Josko Rie,7702,8,12,5,19,30,46,-16,41
RZ Pellets W,7702,9,11,6,19,43,57,-14,39
St. Pölten,7702,10,8,12,16,40,59,-19,36
FC Salzburg,7703,1,21,8,7,65,25,40,71
SC Rheindorf,7703,2,21,5,10,60,44,16,68
SK Sturm Gra,7703,3,20,6,10,61,38,23,66
Vienna,7703,4,19,4,13,73,58,15,61
Rapid Vienna,7703,5,14,10,12,58,41,17,52
RZ Pellets W,7703,6,11,9,16,41,55,-14,42
St. Pölten,7703,7,9,11,16,38,60,-22,38
SV Josko Rie,7703,8,9,10,17,32,50,-18,37
Admira Wacke,7703,9,8,9,19,30,62,-32,33
Mattersburg,7703,10,7,10,19,34,59,-25,31
FC Salzburg,7704,1,20,9,7,66,36,30,69
SC Rheindorf,7704,2,20,8,8,54,36,18,68
SK Sturm Gra,7704,3,18,7,11,56,36,20,61
Vienna,7704,4,18,7,11,61,51,10,61
Rapid Vienna,7704,5,15,9,12,64,53,11,54
St. Pölten,7704,6,11,7,18,51,63,-12,40
RZ Pellets W,7704,7,11,7,18,49,62,-13,40
Admira Wacke,7704,8,11,6,19,35,60,-25,39
Mattersburg,7704,9,10,6,20,39,58,-19,36
SV Josko Rie,7704,10,10,6,20,34,54,-20,36
SC Rheindorf,7705,1,21,6,9,61,42,19,69
Rapid Vienna,7705,2,18,10,8,62,33,29,64
FC Salzburg,7705,3,19,7,10,58,33,25,64
SK Sturm Gra,7705,4,17,10,9,58,27,31,61
Vienna,7705,5,18,7,11,64,48,16,61
RZ Pellets W,7705,6,13,6,17,39,53,-14,45
Admira Wacke,7705,7,11,10,15,35,58,-23,43
St. Pölten,7705,8,10,9,17,43,67,-24,39
SV Josko Rie,7705,9,8,6,22,28,54,-26,30
Mattersburg,7705,10,6,7,23,32,65,-33,25
FC Salzburg,7706,1,22,6,8,71,34,37,72
SC Rheindorf,7706,2,21,6,9,50,37,13,69
Vienna,7706,3,20,3,13,65,46,19,63
SK Sturm Gra,7706,4,19,6,11,52,36,16,63
Rapid Vienna,7706,5,15,8,13,59,43,16,53
SV Josko Rie,7706,6,14,4,18,36,51,-15,46
Admira Wacke,7706,7,14,4,18,39,56,-17,46
RZ Pellets W,7706,8,11,6,19,48,63,-15,39
Mattersburg,7706,9,8,8,20,44,69,-25,32
St. Pölten,7706,10,6,9,21,40,69,-29,27
FC Salzburg,7707,1,23,5,8,60,25,35,74
SC Rheindorf,7707,2,21,9,6,64,33,31,72
SK Sturm Gra,7707,3,19,7,10,62,36,26,64
Vienna,7707,4,18,5,13,64,54,10,59
Rapid Vienna,7707,5,12,10,14,48,42,6,46
RZ Pellets W,7707,6,13,7,16,51,58,-7,46
Admira Wacke,7707,7,12,7,17,37,59,-22,43
SV Josko Rie,7707,8,11,5,20,41,66,-25,38
Mattersburg,7707,9,9,10,17,45,61,-16,37
St. Pölten,7707,10,5,9,22,37,75,-38,24
FC Salzburg,7708,1,21,6,9,62,34,28,69
SC Rheindorf,7708,2,20,9,7,56,40,16,69
Vienna,7708,3,18,3,15,63,54,9,57
SK Sturm Gra,7708,4,16,6,14,55,44,11,54
Rapid Vienna,7708,5,14,10,12,55,40,15,52
RZ Pellets W,7708,6,13,8,15,47,54,-7,47
Admira Wacke,7708,7,13,7,16,43,56,-13,46
SV Josko Rie,7708,8,11,8,17,38,55,-17,41
Mattersburg,7708,9,9,8,19,41,61,-20,35
St. Pölten,7708,10,7,11,18,38,60,-22,32
FC Salzburg,7709,1,25,5,6,67,27,40,80
SC Rheindorf,7709,2,20,6,10,57,43,14,66
SK Sturm Gra,7709,3,18,9,9,66,43,23,63
RZ Pellets W,7709,4,16,6,14,53,56,-3,54
Vienna,7709,5,16,2,18,65,66,-1,50
Rapid Vienna,7709,6,13,10,13,50,39,11,49
St. Pölten,7709,7,11,7,18,43,61,-18,40
Admira Wacke,7709,8,11,6,19,36,61,-25,39
SV Josko Rie,7709,9,12,2,22,30,51,-21,38
Mattersburg,7709,10,8,7,21,40,60,-20,31
SC Rheindorf,7710,1,20,7,9,52,36,16,67
FC Salzburg,7710,2,19,7,10,58,32,26,64
SK Sturm Gra,7710,3,18,9,9,54,30,24,63
Rapid Vienna,7710,4,15,12,9,58,34,24,57
Vienna,7710,5,17,6,13,55,46,9,57
Admira Wacke,7710,6,12,7,17,44,60,-16,43
RZ Pellets W,7710,7,11,8,17,47,62,-15,41
SV Josko Rie,7710,8,12,4,20,35,54,-19,40
St. Pölten,7710,9,9,8,19,41,64,-23,35
Mattersburg,7710,10,9,8,19,36,62,-26,35
SC Rheindorf,7711,1,21,8,7,56,36,20,71
FC Salzburg,7711,2,21,7,8,74,33,41,70
SK Sturm Gra,7711,3,18,8,10,58,37,21,62
Vienna,7711,4,17,4,15,59,56,3,55
Rapid Vienna,7711,5,14,10,12,59,42,17,52
RZ Pellets W,7711,6,12,8,16,47,57,-10,44
Admira Wacke,7711,7,12,8,16,40,56,-16,44
SV Josko Rie,7711,8,10,6,20,28,48,-20,36
St. Pölten,7711,9,8,10,18,40,71,-31,34
Mattersburg,7711,10,8,9,19,34,59,-25,33
SC Rheindorf,7712,1,21,9,6,64,43,21,72
FC Salzburg,7712,2,20,8,8,61,27,34,68
Vienna,7712,3,20,6,10,72,50,22,66
SK Sturm Gra,7712,4,20,5,11,63,37,26,65
Rapid Vienna,7712,5,13,10,13,53,45,8,49
RZ Pellets W,7712,6,12,9,15,49,53,-4,45
Admira Wacke,7712,7,11,8,17,38,62,-24,41
St. Pölten,7712,8,10,7,19,42,70,-28,37
SV Josko Rie,7712,9,9,6,21,28,55,-27,33
Mattersburg,7712,10,7,6,23,35,63,-28,27
SK Sturm Gra,7713,1,22,6,8,61,30,31,72
SC Rheindorf,7713,2,21,7,8,67,47,20,70
FC Salzburg,7713,3,18,10,8,59,33,26,64
Rapid Vienna,7713,4,17,7,12,53,35,18,58
Vienna,7713,5,16,6,14,62,56,6,54
RZ Pellets W,7713,6,11,9,16,48,60,-12,42
Admira Wacke,7713,7,9,11,16,32,56,-24,38
SV Josko Rie,7713,8,10,5,21,33,53,-20,35
St. Pölten,7713,9,8,11,17,44,65,-21,35
Mattersburg,7713,10,8,8,20,40,64,-24,32
FC Salzburg,7714,1,22,7,7,66,26,40,73
SK Sturm Gra,7714,2,21,6,9,67,34,33,69
SC Rheindorf,7714,3,16,8,12,52,54,-2,56
Rapid Vienna,7714,4,15,9,12,62,40,22,54
Vienna,7714,5,14,6,16,54,61,-7,48
RZ Pellets W,7714,6,13,7,16,50,54,-4,46
SV Josko Rie,7714,7,13,4,19,40,53,-13,43
Admira Wacke,7714,8,11,8,17,37,60,-23,41
St. Pölten,7714,9,10,10,16,41,64,-23,40
Mattersburg,7714,10,8,9,19,35,58,-23,33
SK Sturm Gra,7715,1,21,8,7,59,27,32,71
SC Rheindorf,7715,2,20,8,8,55,43,12,68
FC Salzburg,7715,3,19,8,9,62,32,30,65
Vienna,7715,4,16,7,13,58,51,7,55
Rapid Vienna,7715,5,13,14,9,61,43,18,53
RZ Pellets W,7715,6,14,7,15,51,57,-6,49
Admira Wacke,7715,7,13,3,20,37,60,-23,42
SV Josko Rie,7715,8,11,5,20,32,52,-20,38
Mattersburg,7715,9,9,7,20,36,55,-19,34
St. Pölten,7715,10,6,9,21,37,68,-31,27
FC Salzburg,7716,1,19,8,9,59,30,29,65
Vienna,7716,2,20,4,12,63,45,18,64
SC Rheindorf,7716,3,17,10,9,48,43,5,61
SK Sturm Gra,7716,4,17,8,11,60,40,20,59
Rapid Vienna,7716,5,15,9,12,52,36,16,54
RZ Pellets W,7716,6,13,7,16,45,52,-7,46
SV Josko Rie,7716,7,13,5,18,35,48,-13,44
Admira Wacke,7716,8,13,5,18,38,61,-23,44
St. Pölten,7716,9,8,10,18,43,67,-24,34
Mattersburg,7716,10,6,12,18,33,54,-21,30
SC Rheindorf,7717,1,21,6,9,55,34,21,69
FC Salzburg,7717,2,18,9,9,67,31,36,63
SK Sturm Gra,7717,3,18,8,10,59,35,24,62
Vienna,7717,4,18,5,13,65,51,14,59
RZ Pellets W,7717,5,17,5,14,47,47,0,56
Rapid Vienna,7717,6,12,11,13,49,43,6,47
Admira Wacke,7717,7,14,4,18,39,65,-26,46
St. Pölten,7717,8,9,10,17,41,64,-23,37
Mattersburg,7717,9,8,10,18,37,53,-16,34
SV Josko Rie,7717,10,8,6,22,31,67,-36,30
SC Rheindorf,7718,1,20,7,9,60,46,14,67
FC Salzburg,7718,2,19,8,9,66,36,30,65
Vienna,7718,3,19,6,11,67,51,16,63
Rapid Vienna,7718,4,15,12,9,50,35,15,57
SK Sturm Gra,7718,5,17,5,14,51,35,16,56
RZ Pellets W,7718,6,13,10,13,53,56,-3,49
Admira Wacke,7718,7,12,9,15,38,54,-16,45
St. Pölten,7718,8,8,10,18,42,65,-23,34
Mattersburg,7718,9,7,12,17,41,57,-16,33
SV Josko Rie,7718,10,8,5,23,33,66,-33,29
FC Salzburg,7719,1,21,8,7,69,30,39,71
SK Sturm Gra,7719,2,20,7,9,64,36,28,67
SC Rheindorf,7719,3,19,7,10,58,46,12,64
Vienna,7719,4,18,4,14,58,52,6,58
Rapid Vienna,7719,5,14,8,14,54,43,11,50
Mattersburg,7719,6,12,6,18,48,58,-10,42
RZ Pellets W,7719,7,10,11,15,44,57,-13,41
Admira Wacke,7719,8,11,7,18,31,55,-24,40
SV Josko Rie,7719,9,11,5,20,40,61,-21,38
St. Pölten,7719,10,7,11,18,36,64,-28,32
FC Salzburg,7720,1,22,8,6,71,30,41,74
SK Sturm Gra,7720,2,22,4,10,62,34,28,70
SC Rheindorf,7720,3,17,10,9,53,44,9,61
Vienna,7720,4,14,8,14,54,54,0,50
Rapid Vienna,7720,5,12,11,13,50,40,10,47
RZ Pellets W,7720,6,12,8,16,48,52,-4,44
Admira Wacke,7720,7,11,10,15,37,54,-17,43
SV Josko Rie,7720,8,12,6,18,41,60,-19,42
St. Pölten,7720,9,8,10,18,39,67,-28,34
Mattersburg,7720,10,7,11,18,40,60,-20,32
Vienna,7721,1,21,6,9,66,42,24,69
SC Rheindorf,7721,2,19,9,8,57,45,12,66
FC Salzburg,7721,3,18,10,8,55,31,24,64
Rapid Vienna,7721,4,17,9,10,63,35,28,60
SK Sturm Gra,7721,5,17,7,12,52,34,18,58
Admira Wacke,7721,6,12,8,16,32,50,-18,44
RZ Pellets W,7721,7,11,7,18,43,62,-19,40
SV Josko Rie,7721,8,11,5,20,38,52,-14,38
St. Pölten,7721,9,8,8,20,41,70,-29,32
Mattersburg,7721,10,7,9,20,32,58,-26,30
FC Salzburg,7722,1,23,5,8,69,27,42,74
SK Sturm Gra,7722,2,21,6,9,61,32,29,69
Vienna,7722,3,20,4,12,73,54,19,64
SC Rheindorf,7722,4,17,8,11,50,40,10,59
Rapid Vienna,7722,5,14,9,13,53,46,7,51
St. Pölten,7722,6,11,10,15,43,59,-16,43
RZ Pellets W,7722,7,12,6,18,43,60,-17,42
SV Josko Rie,7722,8,13,3,20,41,61,-20,42
Admira Wacke,7722,9,11,4,21,35,60,-25,37
Mattersburg,7722,10,6,9,21,33,62,-29,27
FC Salzburg,7723,1,23,8,5,69,30,39,77
SC Rheindorf,7723,2,22,8,6,54,29,25,74
SK Sturm Gra,7723,3,18,8,10,61,36,25,62
Vienna,7723,4,17,6,13,65,54,11,57
Rapid Vienna,7723,5,14,9,13,55,39,16,51
RZ Pellets W,7723,6,12,8,16,44,58,-14,44
Admira Wacke,7723,7,11,5,20,37,68,-31,38
St. Pölten,7723,8,8,10,18,45,68,-23,34
Mattersburg,7723,9,9,7,20,31,54,-23,34
SV Josko Rie,7723,10,9,5,22,27,52,-25,32
FC Salzburg,7724,1,22,7,7,70,28,42,73
SK Sturm Gra,7724,2,21,5,10,69,36,33,68
SC Rheindorf,7724,3,20,6,10,55,42,13,66
Rapid Vienna,7724,4,15,10,11,56,41,15,55
Vienna,7724,5,17,4,15,56,50,6,55
RZ Pellets W,7724,6,14,8,14,44,51,-7,50
Mattersburg,7724,7,12,7,17,44,58,-14,43
SV Josko Rie,7724,8,10,6,20,37,59,-22,36
Admira Wacke,7724,9,9,5,22,34,73,-39,32
St. Pölten,7724,10,7,8,21,38,65,-27,29
SK Sturm Gra,7725,1,21,7,8,64,34,30,70
FC Salzburg,7725,2,21,5,10,71,31,40,68
SC Rheindorf,7725,3,18,11,7,49,32,17,65
Rapid Vienna,7725,4,17,10,9,56,35,21,61
Vienna,7725,5,17,4,15,57,58,-1,55
RZ Pellets W,7725,6,12,6,18,43,53,-10,42
SV Josko Rie,7725,7,12,6,18,35,50,-15,42
Mattersburg,7725,8,10,7,19,38,55,-17,37
St. Pölten,7725,9,9,9,18,39,59,-20,36
Admira Wacke,7725,10,8,5,23,28,73,-45,29
FC Salzburg,7726,1,23,6,7,62,23,39,75
SK Sturm Gra,7726,2,18,6,12,55,35,20,60
Vienna,7726,3,18,5,13,60,53,7,59
SC Rheindorf,7726,4,17,8,11,47,42,5,59
Rapid Vienna,7726,5,14,14,8,59,40,19,56
Admira Wacke,7726,6,16,3,17,45,56,-11,51
Mattersburg,7726,7,10,9,17,37,47,-10,39
RZ Pellets W,7726,8,10,8,18,39,58,-19,38
SV Josko Rie,7726,9,10,4,22,26,49,-23,34
St. Pölten,7726,10,8,9,19,36,63,-27,33
FC Salzburg,7727,1,22,5,9,75,38,37,71
SK Sturm Gra,7727,2,20,7,9,63,35,28,67
Vienna,7727,3,19,6,11,63,45,18,63
SC Rheindorf,7727,4,17,9,10,45,44,1,60
RZ Pellets W,7727,5,14,7,15,50,50,0,49
Admira Wacke,7727,6,13,6,17,39,59,-20,45
St. Pölten,7727,7,11,9,16,45,55,-10,42
Rapid Vienna,7727,8,11,8,17,52,54,-2,41
Mattersburg,7727,9,8,10,18,36,56,-20,34
SV Josko Rie,7727,10,9,5,22,28,60,-32,32
Vienna,7728,1,22,4,10,71,52,19,70
FC Salzburg,7728,2,18,10,8,65,37,28,64
SC Rheindorf,7728,3,19,7,10,58,48,10,64
SK Sturm Gra,7728,4,18,5,13,54,36,18,59
Rapid Vienna,7728,5,15,11,10,62,41,21,56
RZ Pellets W,7728,6,12,6,18,46,61,-15,42
Admira Wacke,7728,7,12,6,18,48,71,-23,42
SV Josko Rie,7728,8,11,6,19,41,54,-13,39
Mattersburg,7728,9,7,13,16,35,53,-18,34
St. Pölten,7728,10,7,10,19,40,67,-27,31
FC Salzburg,7729,1,25,5,6,69,28,41,80
SC Rheindorf,7729,2,21,6,9,57,41,16,69
SK Sturm Gra,7729,3,20,4,12,55,35,20,64
Vienna,7729,4,19,4,13,59,54,5,61
Rapid Vienna,7729,5,14,11,11,52,37,15,53
RZ Pellets W,7729,6,11,8,17,37,49,-12,41
Mattersburg,7729,7,11,6,19,39,54,-15,39
Admira Wacke,7729,8,10,9,17,33,56,-23,39
SV Josko Rie,7729,9,9,4,23,34,57,-23,31
St. Pölten,7729,10,8,7,21,38,62,-24,31
FC Salzburg,7730,1,22,7,7,67,33,34,73
Vienna,7730,2,21,5,10,68,45,23,68
SK Sturm Gra,7730,3,19,6,11,61,38,23,63
Rapid Vienna,7730,4,17,8,11,63,41,22,59
SC Rheindorf,7730,5,17,8,11,53,44,9,59
RZ Pellets W,7730,6,12,6,18,53,66,-13,42
Admira Wacke,7730,7,12,6,18,42,67,-25,42
SV Josko Rie,7730,8,12,5,19,35,56,-21,41
St. Pölten,7730,9,8,9,19,37,60,-23,33
Mattersburg,7730,10,4,12,20,33,62,-29,24
SC Rheindorf,7731,1,25,4,7,66,45,21,79
FC Salzburg,7731,2,21,7,8,65,26,39,70
SK Sturm Gra,7731,3,21,5,10,64,35,29,68
Vienna,7731,4,16,5,15,62,64,-2,53
RZ Pellets W,7731,5,12,7,17,48,50,-2,43
Admira Wacke,7731,6,11,10,15,42,61,-19,43
Rapid Vienna,7731,7,10,12,14,46,47,-1,42
SV Josko Rie,7731,8,10,6,20,36,56,-20,36
St. Pölten,7731,9,9,8,19,42,67,-25,35
Mattersburg,7731,10,7,12,17,35,55,-20,33
FC Salzburg,7732,1,20,8,8,60,31,29,68
SK Sturm Gra,7732,2,18,7,11,59,40,19,61
Vienna,7732,3,18,7,11,67,52,15,61
SC Rheindorf,7732,4,17,8,11,57,49,8,59
Rapid Vienna,7732,5,16,10,10,58,33,25,58
Admira Wacke,7732,6,15,7,14,42,55,-13,52
RZ Pellets W,7732,7,11,7,18,42,59,-17,40
Mattersburg,7732,8,11,6,19,41,52,-11,39
SV Josko Rie,7732,9,10,5,21,37,61,-24,35
St. Pölten,7732,10,5,13,18,31,62,-31,28
FC Salzburg,7733,1,21,7,8,67,32,35,70
SK Sturm Gra,7733,2,20,5,11,54,33,21,65
SC Rheindorf,7733,3,19,5,12,60,45,15,62
Vienna,7733,4,17,7,12,59,56,3,58
Rapid Vienna,7733,5,14,9,13,59,50,9,51
SV Josko Rie,7733,6,15,3,18,43,52,-9,48
RZ Pellets W,7733,7,14,5,17,48,58,-10,47
Admira Wacke,7733,8,12,5,19,40,58,-18,41
Mattersburg,7733,9,9,7,20,38,56,-18,34
St. Pölten,7733,10,8,9,19,38,66,-28,33
FC Salzburg,7734,1,21,9,6,69,32,37,72
SK Sturm Gra,7734,2,20,6,10,60,30,30,66
SC Rheindorf,7734,3,19,8,9,52,36,16,65
Vienna,7734,4,17,5,14,58,54,4,56
Rapid Vienna,7734,5,13,11,12,47,39,8,50
Admira Wacke,7734,6,14,5,17,44,62,-18,47
RZ Pellets W,7734,7,10,12,14,42,51,-9,42
St. Pölten,7734,8,9,9,18,36,61,-25,36
Mattersburg,7734,9,8,11,17,43,55,-12,35
SV Josko Rie,7734,10,9,4,23,32,63,-31,31
SC Rheindorf,7735,1,19,9,8,54,38,16,66
FC Salzburg,7735,2,19,7,10,58,28,30,64
SK Sturm Gra,7735,3,19,7,10,50,27,23,64
Vienna,7735,4,19,5,12,60,44,16,62
Rapid Vienna,7735,5,13,10,13,49,39,10,49
St. Pölten,7735,6,13,9,14,44,54,-10,48
Admira Wacke,7735,7,12,6,18,40,66,-26,42
RZ Pellets W,7735,8,9,10,17,40,57,-17,37
Mattersburg,7735,9,8,10,18,31,49,-18,34
SV Josko Rie,7735,10,9,7,20,33,57,-24,34
SK Sturm Gra,7736,1,20,7,9,65,34,31,67
FC Salzburg,7736,2,20,7,9,65,36,29,67
SC Rheindorf,7736,3,19,7,10,53,44,9,64
Rapid Vienna,7736,4,18,9,9,72,41,31,63
Vienna,7736,5,17,6,13,63,63,0,57
RZ Pellets W,7736,6,13,5,18,46,55,-9,44
Admira Wacke,7736,7,12,7,17,40,61,-21,43
SV Josko Rie,7736,8,12,4,20,33,48,-15,40
St. Pölten,7736,9,7,10,19,43,73,-30,31
Mattersburg,7736,10,7,8,21,36,61,-25,29
SC Rheindorf,7737,1,21,10,5,56,32,24,73
FC Salzburg,7737,2,20,8,8,69,33,36,68
SK Sturm Gra,7737,3,19,5,12,60,43,17,62
Vienna,7737,4,17,8,11,60,51,9,59
RZ Pellets W,7737,5,12,12,12,46,51,-5,48
Rapid Vienna,7737,6,11,13,12,55,41,14,46
SV Josko Rie,7737,7,12,6,18,37,49,-12,42
Admira Wacke,7737,8,12,5,19,40,67,-27,41
Mattersburg,7737,9,8,7,21,35,60,-25,31
St. Pölten,7737,10,7,8,21,39,70,-31,29
SK Sturm Gra,7738,1,23,7,6,69,29,40,76
SC Rheindorf,7738,2,19,8,9,55,40,15,65
Rapid Vienna,7738,3,17,11,8,66,40,26,62
FC Salzburg,7738,4,19,5,12,60,42,18,62
Vienna,7738,5,18,7,11,61,46,15,61
Admira Wacke,7738,6,12,7,17,40,59,-19,43
Mattersburg,7738,7,9,10,17,46,60,-14,37
SV Josko Rie,7738,8,9,8,19,35,51,-16,35
RZ Pellets W,7738,9,10,5,21,44,70,-26,35
St. Pölten,7738,10,6,8,22,37,76,-39,26
FC Salzburg,7739,1,22,5,9,63,31,32,71
SK Sturm Gra,7739,2,19,6,11,60,31,29,63
Vienna,7739,3,18,5,13,64,55,9,59
Rapid Vienna,7739,4,16,10,10,62,39,23,58
SC Rheindorf,7739,5,16,8,12,57,53,4,56
Mattersburg,7739,6,14,5,17,44,51,-7,47
SV Josko Rie,7739,7,14,4,18,42,54,-12,46
RZ Pellets W,7739,8,12,7,17,47,59,-12,43
St. Pölten,7739,9,7,11,18,36,64,-28,32
Admira Wacke,7739,10,8,7,21,29,67,-38,31
FC Salzburg,7740,1,21,9,6,63,32,31,72
SC Rheindorf,7740,2,22,6,8,57,43,14,72
SK Sturm Gra,7740,3,21,5,10,59,28,31,68
Vienna,7740,4,19,3,14,62,52,10,60
Rapid Vienna,7740,5,16,9,11,61,42,19,57
RZ Pellets W,7740,6,13,7,16,47,54,-7,46
SV Josko Rie,7740,7,11,3,22,32,51,-19,36
St. Pölten,7740,8,8,9,19,38,60,-22,33
Mattersburg,7740,9,9,6,21,37,60,-23,33
Admira Wacke,7740,10,8,7,21,29,63,-34,31
Vienna,7741,1,21,6,9,72,43,29,69
FC Salzburg,7741,2,21,5,10,65,29,36,68
SC Rheindorf,7741,3,21,5,10,58,42,16,68
SK Sturm Gra,7741,4,18,7,11,54,34,20,61
Rapid Vienna,7741,5,15,9,12,54,44,10,54
RZ Pellets W,7741,6,12,10,14,48,51,-3,46
SV Josko Rie,7741,7,11,4,21,37,62,-25,37
St. Pölten,7741,8,8,11,17,41,64,-23,35
Admira Wacke,7741,9,9,8,19,29,61,-32,35
Mattersburg,7741,10,7,9,20,34,62,-28,30
SK Sturm Gra,7742,1,22,7,7,70,31,39,73
FC Salzburg,7742,2,21,7,8,59,31,28,70
SC Rheindorf,7742,3,20,7,9,55,44,11,67
Vienna,7742,4,19,4,13,67,49,18,61
Rapid Vienna,7742,5,17,9,10,57,36,21,60
RZ Pellets W,7742,6,11,7,18,42,62,-20,40
Admira Wacke,7742,7,10,5,21,33,62,-29,35
SV Josko Rie,7742,8,9,7,20,34,57,-23,34
St. Pölten,7742,9,9,7,20,39,68,-29,34
Mattersburg,7742,10,8,8,20,39,55,-16,32
FC Salzburg,7743,1,21,7,8,66,29,37,70
SC Rheindorf,7743,2,20,10,6,56,38,18,70
SK Sturm Gra,7743,3,19,6,11,56,30,26,63
Vienna,7743,4,16,9,11,53,50,3,57
Rapid Vienna,7743,5,12,12,12,56,47,9,48
RZ Pellets W,7743,6,11,10,15,44,56,-12,43
St. Pölten,7743,7,9,12,15,40,54,-14,39
Admira Wacke,7743,8,10,9,17,32,58,-26,39
SV Josko Rie,7743,9,8,8,20,27,47,-20,32
Mattersburg,7743,10,7,11,18,36,57,-21,32
SC Rheindorf,7744,1,22,8,6,65,37,28,74
FC Salzburg,7744,2,20,8,8,63,34,29,68
SK Sturm Gra,7744,3,17,7,12,53,45,8,58
Vienna,7744,4,18,3,15,62,50,12,57
Rapid Vienna,7744,5,13,12,11,52,39,13,51
RZ Pellets W,7744,6,14,7,15,51,58,-7,49
Admira Wacke,7744,7,12,7,17,37,56,-19,43
St. Pölten,7744,8,10,11,15,44,61,-17,41
Mattersburg,7744,9,7,10,19,36,55,-19,31
SV Josko Rie,7744,10,9,3,24,31,59,-28,30
Vienna,7745,1,21,6,9,70,45,25,69
SC Rheindorf,7745,2,20,9,7,55,38,17,69
FC Salzburg,7745,3,20,6,10,63,30,33,66
SK Sturm Gra,7745,4,20,5,11,59,34,25,65
Rapid Vienna,7745,5,14,9,13,54,45,9,51
RZ Pellets W,7745,6,12,6,18,51,63,-12,42
Admira Wacke,7745,7,11,7,18,32,57,-25,40
SV Josko Rie,7745,8,11,4,21,30,57,-27,37
Mattersburg,7745,9,8,9,19,35,55,-20,33
St. Pölten,7745,10,6,13,17,40,65,-25,31
SK Sturm Gra,7746,1,22,6,8,61,28,33,72
SC Rheindorf,7746,2,21,6,9,51,36,15,69
FC Salzburg,7746,3,20,8,8,69,34,35,68
Rapid Vienna,7746,4,17,10,9,55,34,21,61
Vienna,7746,5,17,7,12,56,50,6,58
RZ Pellets W,7746,6,15,5,16,49,53,-4,50
SV Josko Rie,7746,7,11,5,20,31,53,-22,38
Admira Wacke,7746,8,10,6,20,44,66,-22,36
Mattersburg,7746,9,7,8,21,34,63,-29,29
St. Pölten,7746,10,5,9,22,34,67,-33,24
SK Sturm Gra,7747,1,21,7,8,62,30,32,70
FC Salzburg,7747,2,21,7,8,65,35,30,70
Vienna,7747,3,19,5,12,70,55,15,62
SC Rheindorf,7747,4,17,9,10,53,42,11,60
Admira Wacke,7747,5,14,7,15,43,56,-13,49
Rapid Vienna,7747,6,13,8,15,51,45,6,47
RZ Pellets W,7747,7,13,6,17,48,61,-13,45
SV Josko Rie,7747,8,12,3,21,36,51,-15,39
Mattersburg,7747,9,9,9,18,36,54,-18,36
St. Pölten,7747,10,6,9,21,34,69,-35,27
SC Rheindorf,7748,1,22,5,9,58,39,19,71
FC Salzburg,7748,2,21,7,8,67,33,34,70
Rapid Vienna,7748,3,17,9,10,59,37,22,60
SK Sturm Gra,7748,4,18,5,13,56,38,18,59
Vienna,7748,5,18,5,13,63,54,9,59
SV Josko Rie,7748,6,12,5,19,36,53,-17,41
RZ Pellets W,7748,7,11,7,18,47,68,-21,40
Admira Wacke,7748,8,11,6,19,35,59,-24,39
St. Pölten,7748,9,9,8,19,43,64,-21,35
Mattersburg,7748,10,8,9,19,39,58,-19,33
SK Sturm Gra,7749,1,21,5,10,60,35,25,68
SC Rheindorf,7749,2,20,7,9,57,40,17,67
FC Salzburg,7749,3,18,11,7,57,28,29,65
Vienna,7749,4,19,7,10,66,44,22,64
Admira Wacke,7749,5,14,6,16,40,52,-12,48
Rapid Vienna,7749,6,12,11,13,48,39,9,47
Mattersburg,7749,7,11,7,18,41,56,-15,40
RZ Pellets W,7749,8,11,7,18,48,70,-22,40
SV Josko Rie,7749,9,11,5,20,32,55,-23,38
St. Pölten,7749,10,6,8,22,39,69,-30,26
FC Salzburg,7750,1,22,8,6,65,30,35,74
SC Rheindorf,7750,2,20,7,9,63,39,24,67
SK Sturm Gra,7750,3,20,5,11,60,36,24,65
Vienna,7750,4,19,5,12,68,52,16,62
Rapid Vienna,7750,5,15,9,12,61,37,24,54
RZ Pellets W,7750,6,13,7,16,47,54,-7,46
Admira Wacke,7750,7,11,7,18,37,65,-28,40
Mattersburg,7750,8,10,7,19,34,53,-19,37
SV Josko Rie,7750,9,9,4,23,31,63,-32,31
St. Pölten,7750,10,7,9,20,39,76,-37,30
FC Salzburg,7751,1,21,8,7,69,31,38,71
Vienna,7751,2,20,5,11,66,49,17,65
SC Rheindorf,7751,3,19,6,11,62,47,15,63
SK Sturm Gra,7751,4,15,11,10,55,42,13,56
RZ Pellets W,7751,5,12,11,13,51,53,-2,47
Rapid Vienna,7751,6,10,15,11,50,42,8,45
SV Josko Rie,7751,7,13,6,17,39,51,-12,45
Admira Wacke,7751,8,10,8,18,39,68,-29,38
Mattersburg,7751,9,9,10,17,35,49,-14,37
St. Pölten,7751,10,5,12,19,38,72,-34,27
FC Salzburg,7752,1,22,7,7,69,28,41,73
SK Sturm Gra,7752,2,21,6,9,65,27,38,69
SC Rheindorf,7752,3,18,12,6,56,40,16,66
Vienna,7752,4,15,5,16,54,57,-3,50
Rapid Vienna,7752,5,12,12,12,52,45,7,48
Admira Wacke,7752,6,14,3,19,38,59,-21,45
RZ Pellets W,7752,7,11,9,16,43,52,-9,42
SV Josko Rie,7752,8,11,6,19,37,57,-20,39
St. Pölten,7752,9,10,8,18,40,67,-27,38
Mattersburg,7752,10,6,12,18,35,57,-22,30
FC Salzburg,7753,1,26,5,5,75,27,48,83
SK Sturm Gra,7753,2,22,6,8,69,33,36,72
SC Rheindorf,7753,3,20,6,10,60,44,16,66
Vienna,7753,4,16,6,14,57,57,0,54
Rapid Vienna,7753,5,12,11,13,51,43,8,47
RZ Pellets W,7753,6,12,7,17,44,55,-11,43
Mattersburg,7753,7,10,9,17,37,57,-20,39
Admira Wacke,7753,8,10,5,21,34,64,-30,35
SV Josko Rie,7753,9,8,9,19,31,52,-21,33
St. Pölten,7753,10,5,14,17,38,64,-26,29
FC Salzburg,7754,1,19,10,7,64,30,34,67
SC Rheindorf,7754,2,20,7,9,60,44,16,67
Vienna,7754,3,20,6,10,73,53,20,66
SK Sturm Gra,7754,4,17,10,9,55,31,24,61
Rapid Vienna,7754,5,13,10,13,58,43,15,49
Admira Wacke,7754,6,12,8,16,42,62,-20,44
St. Pölten,7754,7,12,6,18,41,62,-21,42
RZ Pellets W,7754,8,10,8,18,42,60,-18,38
SV Josko Rie,7754,9,9,7,20,36,58,-22,34
Mattersburg,7754,10,8,8,20,31,59,-28,32
FC Salzburg,7755,1,22,7,7,66,31,35,73
SC Rheindorf,7755,2,21,9,6,57,34,23,72
SK Sturm Gra,7755,3,21,6,9,59,31,28,69
Vienna,7755,4,16,8,12,57,51,6,56
Rapid Vienna,7755,5,15,8,13,55,49,6,53
RZ Pellets W,7755,6,12,9,15,40,48,-8,45
Admira Wacke,7755,7,10,9,17,39,58,-19,39
St. Pölten,7755,8,8,9,19,46,67,-21,33
SV Josko Rie,7755,9,9,5,22,32,55,-23,32
Mattersburg,7755,10,7,8,21,31,58,-27,29
FC Salzburg,7756,1,21,8,7,73,32,41,71
SK Sturm Gra,7756,2,22,4,10,63,36,27,70
SC Rheindorf,7756,3,18,8,10,58,43,15,62
Rapid Vienna,7756,4,17,10,9,64,39,25,61
Vienna,7756,5,17,4,15,58,55,3,55
Admira Wacke,7756,6,13,3,20,37,62,-25,42
St. Pölten,7756,7,10,10,16,42,63,-21,40
RZ Pellets W,7756,8,10,6,20,39,62,-23,36
Mattersburg,7756,9,8,11,17,40,57,-17,35
SV Josko Rie,7756,10,10,4,22,35,60,-25,34
SC Rheindorf,7757,1,20,9,7,55,37,18,69
FC Salzburg,7757,2,20,6,10,62,34,28,66
SK Sturm Gra,7757,3,19,5,12,50,30,20,62
Vienna,7757,4,18,5,13,64,53,11,59
Rapid Vienna,7757,5,15,11,10,54,32,22,56
RZ Pellets W,7757,6,14,7,15,46,52,-6,49
SV Josko Rie,7757,7,11,7,18,34,50,-16,40
St. Pölten,7757,8,9,9,18,43,62,-19,36
Admira Wacke,7757,9,10,5,21,35,64,-29,35
Mattersburg,7757,10,7,10,19,31,60,-29,31
FC Salzburg,7758,1,20,8,8,63,30,33,68
SK Sturm Gra,7758,2,19,7,10,56,33,23,64
Vienna,7758,3,19,6,11,66,52,14,63
SC Rheindorf,7758,4,17,11,8,55,45,10,62
Rapid Vienna,7758,5,14,12,10,55,35,20,54
SV Josko Rie,7758,6,13,6,17,44,53,-9,45
Admira Wacke,7758,7,10,10,16,35,59,-24,40
RZ Pellets W,7758,8,9,11,16,40,58,-18,38
St. Pölten,7758,9,8,8,20,38,65,-27,32
Mattersburg,7758,10,8,7,21,37,59,-22,31
FC Salzburg,7759,1,19,8,9,65,32,33,65
Vienna,7759,2,20,5,11,65,54,11,65
SK Sturm Gra,7759,3,19,5,12,55,32,23,62
SC Rheindorf,7759,4,18,8,10,50,45,5,62
Rapid Vienna,7759,5,16,10,10,63,43,20,58
RZ Pellets W,7759,6,15,5,16,50,54,-4,50
SV Josko Rie,7759,7,10,10,16,39,53,-14,40
Admira Wacke,7759,8,10,8,18,35,60,-25,38
St. Pölten,7759,9,8,11,17,40,61,-21,35
Mattersburg,7759,10,6,8,22,35,63,-28,26
SK Sturm Gra,7760,1,19,8,9,56,32,24,65
FC Salzburg,7760,2,19,7,10,56,34,22,64
SC Rheindorf,7760,3,18,8,10,56,49,7,62
Vienna,7760,4,18,6,12,64,53,11,60
Rapid Vienna,7760,5,16,8,12,60,37,23,56
RZ Pellets W,7760,6,13,7,16,50,55,-5,46
Admira Wacke,7760,7,12,6,18,35,57,-22,42
SV Josko Rie,7760,8,12,4,20,36,53,-17,40
St. Pölten,7760,9,9,9,18,43,60,-17,36
Mattersburg,7760,10,8,9,19,30,56,-26,33
FC Salzburg,7761,1,24,7,5,70,29,41,79
SC Rheindorf,7761,2,18,10,8,55,43,12,64
SK Sturm Gra,7761,3,17,9,10,57,35,22,60
Vienna,7761,4,16,8,12,63,53,10,56
Rapid Vienna,7761,5,14,11,11,56,41,15,53
RZ Pellets W,7761,6,11,11,14,44,51,-7,44
Admira Wacke,7761,7,12,8,16,36,56,-20,44
SV Josko Rie,7761,8,10,6,20,41,61,-20,36
Mattersburg,7761,9,8,7,21,35,61,-26,31
St. Pölten,7761,10,6,11,19,36,63,-27,29
FC Salzburg,7762,1,22,8,6,67,27,40,74
SC Rheindorf,7762,2,19,9,8,52,38,14,66
SK Sturm Gra,7762,3,19,7,10,57,31,26,64
Rapid Vienna,7762,4,15,10,11,63,42,21,55
RZ Pellets W,7762,5,16,6,14,50,47,3,54
Vienna,7762,6,15,7,14,54,54,0,52
SV Josko Rie,7762,7,10,7,19,37,56,-19,37
Admira Wacke,7762,8,10,7,19,32,66,-34,37
Mattersburg,7762,9,8,8,20,33,52,-19,32
St. Pölten,7762,10,8,7,21,37,69,-32,31
SK Sturm Gra,7763,1,19,8,9,63,32,31,65
FC Salzburg,7763,2,19,7,10,63,31,32,64
SC Rheindorf,7763,3,19,6,11,49,52,-3,63
Vienna,7763,4,18,6,12,57,44,13,60
Rapid Vienna,7763,5,16,10,10,60,38,22,58
RZ Pellets W,7763,6,12,6,18,49,64,-15,42
SV Josko Rie,7763,7,13,3,20,32,51,-19,42
Admira Wacke,7763,8,11,7,18,39,61,-22,40
Mattersburg,7763,9,10,6,20,39,59,-20,36
St. Pölten,7763,10,8,11,17,39,58,-19,35
SC Rheindorf,7764,1,22,7,7,60,39,21,73
FC Salzburg,7764,2,21,8,7,71,32,39,71
Vienna,7764,3,21,4,11,73,46,27,67
SK Sturm Gra,7764,4,17,6,13,54,43,11,57
Rapid Vienna,7764,5,13,11,12,59,49,10,50
RZ Pellets W,7764,6,11,10,15,53,58,-5,43
Mattersburg,7764,7,11,9,16,44,59,-15,42
Admira Wacke,7764,8,10,7,19,37,62,-25,37
SV Josko Rie,7764,9,10,6,20,34,56,-22,36
St. Pölten,7764,10,6,8,22,34,75,-41,26
FC Salzburg,7765,1,24,5,7,75,34,41,77
SK Sturm Gra,7765,2,19,6,11,56,34,22,63
SC Rheindorf,7765,3,18,8,10,59,45,14,62
Vienna,7765,4,18,5,13,62,47,15,59
Rapid Vienna,7765,5,15,10,11,61,43,18,55
Admira Wacke,7765,6,13,4,19,37,55,-18,43
RZ Pellets W,7765,7,12,6,18,50,66,-16,42
St. Pölten,7765,8,10,9,17,46,71,-25,39
SV Josko Rie,7765,9,10,8,18,31,48,-17,38
Mattersburg,7765,10,7,7,22,31,65,-34,28
FC Salzburg,7766,1,20,10,6,67,33,34,70
Vienna,7766,2,22,4,10,73,52,21,70
SC Rheindorf,7766,3,20,9,7,61,38,23,69
SK Sturm Gra,7766,4,15,6,15,59,47,12,51
Rapid Vienna,7766,5,13,12,11,53,44,9,51
RZ Pellets W,7766,6,13,7,16,54,62,-8,46
Mattersburg,7766,7,11,6,19,40,57,-17,39
Admira Wacke,7766,8,10,9,17,39,62,-23,39
St. Pölten,7766,9,10,8,18,53,73,-20,38
SV Josko Rie,7766,10,7,7,22,31,62,-31,28
FC Salzburg,7767,1,22,7,7,71,34,37,73
SC Rheindorf,7767,2,19,9,8,57,42,15,66
SK Sturm Gra,7767,3,19,7,10,56,33,23,64
Vienna,7767,4,17,6,13,65,51,14,57
Rapid Vienna,7767,5,13,12,11,58,44,14,51
RZ Pellets W,7767,6,13,6,17,43,54,-11,45
Admira Wacke,7767,7,11,8,17,36,56,-20,41
SV Josko Rie,7767,8,12,3,21,37,58,-21,39
Mattersburg,7767,9,10,6,20,44,62,-18,36
St. Pölten,7767,10,7,10,19,37,70,-33,31
SC Rheindorf,7768,1,23,5,8,69,48,21,74
SK Sturm Gra,7768,2,22,5,9,65,33,32,71
FC Salzburg,7768,3,17,12,7,61,32,29,63
Vienna,7768,4,18,4,14,60,56,4,58
Rapid Vienna,7768,5,14,10,12,61,45,16,52
RZ Pellets W,7768,6,11,9,16,45,57,-12,42
Admira Wacke,7768,7,10,8,18,39,62,-23,38
SV Josko Rie,7768,8,10,7,19,41,62,-21,37
Mattersburg,7768,9,8,10,18,34,55,-21,34
St. Pölten,7768,10,7,10,19,38,63,-25,31
FC Salzburg,7769,1,21,7,8,61,27,34,70
Vienna,7769,2,19,7,10,61,47,14,64
SC Rheindorf,7769,3,18,10,8,54,45,9,64
SK Sturm Gra,7769,4,16,8,12,51,35,16,56
Rapid Vienna,7769,5,15,8,13,55,40,15,53
RZ Pellets W,7769,6,12,10,14,39,47,-8,46
SV Josko Rie,7769,7,11,8,17,38,52,-14,41
Mattersburg,7769,8,11,7,18,39,50,-11,40
Admira Wacke,7769,9,10,7,19,34,58,-24,37
St. Pölten,7769,10,6,10,20,36,67,-31,28
FC Salzburg,7770,1,25,7,4,72,26,46,82
SC Rheindorf,7770,2,20,6,10,54,45,9,66
SK Sturm Gra,7770,3,18,7,11,60,35,25,61
Rapid Vienna,7770,4,15,10,11,60,43,17,55
Vienna,7770,5,15,4,17,62,65,-3,49
RZ Pellets W,7770,6,13,8,15,48,53,-5,47
SV Josko Rie,7770,7,12,8,16,40,52,-12,44
St. Pölten,7770,8,9,9,18,41,63,-22,36
Admira Wacke,7770,9,9,9,18,33,59,-26,36
Mattersburg,7770,10,6,8,22,29,58,-29,26
FC Salzburg,7771,1,20,8,8,63,35,28,68
SC Rheindorf,7771,2,19,8,9,58,39,19,65
Vienna,7771,3,18,7,11,64,57,7,61
SK Sturm Gra,7771,4,15,11,10,59,37,22,56
Rapid Vienna,7771,5,14,10,12,52,40,12,52
RZ Pellets W,7771,6,12,7,17,44,56,-12,43
Admira Wacke,7771,7,11,9,16,37,57,-20,42
SV Josko Rie,7771,8,11,5,20,39,53,-14,38
Mattersburg,7771,9,10,8,18,34,50,-16,38
St. Pölten,7771,10,8,11,17,38,64,-26,35
FC Salzburg,7772,1,21,8,7,68,32,36,71
SK Sturm Gra,7772,2,21,5,10,64,38,26,68
Vienna,7772,3,19,5,12,63,54,9,62
SC Rheindorf,7772,4,17,9,10,50,41,9,60
Mattersburg,7772,5,12,10,14,44,52,-8,46
Rapid Vienna,7772,6,11,12,13,57,46,11,45
St. Pölten,7772,7,11,9,16,48,65,-17,42
RZ Pellets W,7772,8,9,9,18,42,58,-16,36
Admira Wacke,7772,9,10,6,20,34,61,-27,36
SV Josko Rie,7772,10,10,5,21,38,61,-23,35
SC Rheindorf,7773,1,19,10,7,57,41,16,67
FC Salzburg,7773,2,19,9,8,60,36,24,66
Vienna,7773,3,20,5,11,65,46,19,65
SK Sturm Gra,7773,4,19,7,10,56,33,23,64
Rapid Vienna,7773,5,14,12,10,55,37,18,54
Mattersburg,7773,6,11,10,15,40,50,-10,43
RZ Pellets W,7773,7,10,8,18,45,62,-17,38
St. Pölten,7773,8,9,10,17,44,60,-16,37
SV Josko Rie,7773,9,9,6,21,39,63,-24,33
Admira Wacke,7773,10,9,5,22,33,66,-33,32
FC Salzburg,7774,1,20,9,7,73,34,39,69
SK Sturm Gra,7774,2,18,9,9,61,38,23,63
Vienna,7774,3,19,6,11,60,49,11,63
SC Rheindorf,7774,4,19,6,11,51,40,11,63
Rapid Vienna,7774,5,14,14,8,56,38,18,56
RZ Pellets W,7774,6,11,9,16,42,55,-13,42
Admira Wacke,7774,7,12,6,18,45,61,-16,42
Mattersburg,7774,8,8,9,19,38,60,-22,33
St. Pölten,7774,9,7,12,17,35,60,-25,33
SV Josko Rie,7774,10,9,6,21,28,54,-26,33
FC Salzburg,7775,1,23,7,6,72,30,42,76
SC Rheindorf,7775,2,22,9,5,59,34,25,75
Vienna,7775,3,20,5,11,67,47,20,65
SK Sturm Gra,7775,4,17,9,10,62,41,21,60
Rapid Vienna,7775,5,12,11,13,52,46,6,47
Admira Wacke,7775,6,11,9,16,36,57,-21,42
RZ Pellets W,7775,7,11,8,17,49,66,-17,41
St. Pölten,7775,8,8,9,19,47,67,-20,33
SV Josko Rie,7775,9,9,5,22,34,61,-27,32
Mattersburg,7775,10,8,6,22,40,69,-29,30
SC Rheindorf,7776,1,23,9,4,68,35,33,78
SK Sturm Gra,7776,2,20,9,7,60,30,30,69
FC Salzburg,7776,3,20,6,10,57,32,25,66
Vienna,7776,4,20,5,11,65,51,14,65
Rapid Vienna,7776,5,15,9,12,49,36,13,54
RZ Pellets W,7776,6,11,7,18,43,56,-13,40
Mattersburg,7776,7,9,8,19,33,51,-18,35
SV Josko Rie,7776,8,9,6,21,34,56,-22,33
Admira Wacke,7776,9,8,8,20,25,58,-33,32
St. Pölten,7776,10,8,7,21,39,68,-29,31
FC Salzburg,7777,1,24,6,6,71,28,43,78
SK Sturm Gra,7777,2,18,7,11,58,37,21,61
SC Rheindorf,7777,3,18,6,12,58,50,8,60
Rapid Vienna,7777,4,15,12,9,63,41,22,57
Vienna,7777,5,16,7,13,59,57,2,55
RZ Pellets W,7777,6,13,5,18,48,62,-14,44
Admira Wacke,7777,7,12,6,18,44,60,-16,42
SV Josko Rie,7777,8,12,4,20,37,53,-16,40
St. Pölten,7777,9,8,10,18,39,65,-26,34
Mattersburg,7777,10,8,9,19,40,64,-24,33
SC Rheindorf,7778,1,24,6,6,70,37,33,78
FC Salzburg,7778,2,21,10,5,68,29,39,73
Vienna,7778,3,19,5,12,66,53,13,62
SK Sturm Gra,7778,4,15,8,13,55,45,10,53
Admira Wacke,7778,5,14,5,17,40,53,-13,47
Rapid Vienna,7778,6,11,12,13,52,45,7,45
RZ Pellets W,7778,7,11,7,18,41,59,-18,40
Mattersburg,7778,8,9,8,19,35,59,-24,35
St. Pölten,7778,9,8,10,18,44,65,-21,34
SV Josko Rie,7778,10,9,7,20,29,55,-26,34
SK Sturm Gra,7779,1,22,3,11,56,37,19,69
SC Rheindorf,7779,2,20,6,10,53,40,13,66
FC Salzburg,7779,3,19,6,11,58,33,25,63
Admira Wacke,7779,4,16,5,15,48,51,-3,53
Vienna,7779,5,16,3,17,51,53,-2,51
Rapid Vienna,7779,6,13,10,13,54,45,9,49
St. Pölten,7779,7,12,8,16,51,60,-9,44
SV Josko Rie,7779,8,12,6,18,38,53,-15,42
RZ Pellets W,7779,9,11,7,18,50,61,-11,40
Mattersburg,7779,10,9,6,21,42,68,-26,33
FC Salzburg,7780,1,21,6,9,57,29,28,69
SC Rheindorf,7780,2,20,9,7,60,42,18,69
Vienna,7780,3,20,4,12,66,52,14,64
SK Sturm Gra,7780,4,18,8,10,59,34,25,62
RZ Pellets W,7780,5,17,5,14,47,47,0,56
Rapid Vienna,7780,6,13,11,12,55,42,13,50
SV Josko Rie,7780,7,11,5,20,40,58,-18,38
Admira Wacke,7780,8,11,5,20,39,62,-23,38
Mattersburg,7780,9,7,9,20,35,60,-25,30
St. Pölten,7780,10,6,10,20,32,64,-32,28
FC Salzburg,7781,1,21,7,8,65,33,32,70
SC Rheindorf,7781,2,19,9,8,56,44,12,66
SK Sturm Gra,7781,3,17,6,13,57,44,13,57
Vienna,7781,4,17,6,13,61,51,10,57
Rapid Vienna,7781,5,13,10,13,53,45,8,49
SV Josko Rie,7781,6,12,7,17,37,51,-14,43
Admira Wacke,7781,7,12,7,17,39,58,-19,43
RZ Pellets W,7781,8,11,8,17,52,58,-6,41
St. Pölten,7781,9,9,10,17,40,62,-22,37
Mattersburg,7781,10,8,12,16,39,53,-14,36
FC Salzburg,7782,1,19,10,7,66,30,36,67
SK Sturm Gra,7782,2,19,8,9,58,30,28,65
SC Rheindorf,7782,3,17,10,9,55,49,6,61
Vienna,7782,4,18,6,12,56,46,10,60
Rapid Vienna,7782,5,13,14,9,54,37,17,53
RZ Pellets W,7782,6,11,11,14,47,54,-7,44
St. Pölten,7782,7,10,12,14,47,60,-13,42
Admira Wacke,7782,8,10,7,19,35,70,-35,37
SV Josko Rie,7782,9,9,6,21,32,54,-22,33
Mattersburg,7782,10,7,10,19,38,58,-20,31
FC Salzburg,7783,1,22,10,4,69,26,43,76
SC Rheindorf,7783,2,19,7,10,55,45,10,64
SK Sturm Gra,7783,3,18,9,9,60,32,28,63
Vienna,7783,4,17,6,13,63,53,10,57
Rapid Vienna,7783,5,16,7,13,60,40,20,55
Admira Wacke,7783,6,12,7,17,38,60,-22,43
RZ Pellets W,7783,7,10,8,18,43,65,-22,38
SV Josko Rie,7783,8,11,4,21,35,54,-19,37
St. Pölten,7783,9,8,12,16,43,61,-18,36
Mattersburg,7783,10,8,8,20,37,67,-30,32
FC Salzburg,7784,1,21,6,9,66,35,31,69
SC Rheindorf,7784,2,21,5,10,55,39,16,68
SK Sturm Gra,7784,3,20,6,10,65,36,29,66
Vienna,7784,4,18,4,14,64,54,10,58
Rapid Vienna,7784,5,14,11,11,58,44,14,53
Mattersburg,7784,6,11,9,16,38,52,-14,42
St. Pölten,7784,7,11,7,18,43,67,-24,40
Admira Wacke,7784,8,10,9,17,39,58,-19,39
RZ Pellets W,7784,9,10,6,20,39,62,-23,36
SV Josko Rie,7784,10,10,5,21,30,50,-20,35
SC Rheindorf,7785,1,20,8,8,63,44,19,68
FC Salzburg,7785,2,17,11,8,58,35,23,62
SK Sturm Gra,7785,3,18,8,10,52,35,17,62
Vienna,7785,4,19,4,13,62,53,9,61
RZ Pellets W,7785,5,13,8,15,44,49,-5,47
Rapid Vienna,7785,6,12,10,14,60,42,18,46
Admira Wacke,7785,7,13,6,17,45,63,-18,45
St. Pölten,7785,8,9,12,15,38,57,-19,39
SV Josko Rie,7785,9,11,5,20,30,51,-21,38
Mattersburg,7785,10,9,6,21,39,62,-23,33
FC Salzburg,7786,1,23,6,7,65,31,34,75
SC Rheindorf,7786,2,22,5,9,64,39,25,71
Vienna,7786,3,20,6,10,68,50,18,66
SK Sturm Gra,7786,4,18,8,10,59,38,21,62
Rapid Vienna,7786,5,14,11,11,53,40,13,53
RZ Pellets W,7786,6,15,6,15,56,57,-1,51
Admira Wacke,7786,7,12,5,19,37,56,-19,41
SV Josko Rie,7786,8,11,3,22,37,62,-25,36
St. Pölten,7786,9,7,9,20,41,70,-29,30
Mattersburg,7786,10,5,7,24,28,65,-37,22
FC Salzburg,7787,1,23,5,8,65,29,36,74
SC Rheindorf,7787,2,19,11,6,58,41,17,68
SK Sturm Gra,7787,3,18,8,10,58,36,22,62
Vienna,7787,4,17,7,12,55,49,6,58
Rapid Vienna,7787,5,16,8,12,55,40,15,56
SV Josko Rie,7787,6,12,5,19,31,47,-16,41
RZ Pellets W,7787,7,10,8,18,38,51,-13,38
St. Pölten,7787,8,9,11,16,42,59,-17,38
Admira Wacke,7787,9,11,5,20,39,63,-24,38
Mattersburg,7787,10,7,8,21,35,61,-26,29
Vienna,7788,1,20,7,9,65,46,19,67
Rapid Vienna,7788,2,18,10,8,61,34,27,64
SK Sturm Gra,7788,3,19,6,11,56,34,22,63
FC Salzburg,7788,4,18,8,10,61,36,25,62
SC Rheindorf,7788,5,18,8,10,54,45,9,62
RZ Pellets W,7788,6,11,10,15,48,58,-10,43
Admira Wacke,7788,7,13,4,19,46,60,-14,43
SV Josko Rie,7788,8,12,4,20,37,55,-18,40
St. Pölten,7788,9,6,11,19,40,69,-29,29
Mattersburg,7788,10,7,8,21,36,67,-31,29
FC Salzburg,7789,1,24,4,8,70,34,36,76
SC Rheindorf,7789,2,22,5,9,65,41,24,71
Vienna,7789,3,19,4,13,62,49,13,61
SK Sturm Gra,7789,4,16,8,12,52,43,9,56
Rapid Vienna,7789,5,14,10,12,54,37,17,52
RZ Pellets W,7789,6,13,8,15,47,55,-8,47
Mattersburg,7789,7,10,9,17,33,43,-10,39
SV Josko Rie,7789,8,11,6,19,36,53,-17,39
St. Pölten,7789,9,8,10,18,48,76,-28,34
Admira Wacke,7789,10,8,6,22,29,65,-36,30
FC Salzburg,7790,1,23,6,7,70,32,38,75
SK Sturm Gra,7790,2,20,6,10,54,31,23,66
SC Rheindorf,7790,3,19,7,10,48,37,11,64
Vienna,7790,4,16,6,14,56,53,3,54
RZ Pellets W,7790,5,16,6,14,51,54,-3,54
Rapid Vienna,7790,6,10,13,13,49,43,6,43
Admira Wacke,7790,7,12,6,18,41,55,-14,42
SV Josko Rie,7790,8,12,6,18,36,53,-17,42
Mattersburg,7790,9,8,8,20,36,55,-19,32
St. Pölten,7790,10,8,8,20,41,69,-28,32
FC Salzburg,7791,1,22,7,7,71,31,40,73
SK Sturm Gra,7791,2,20,5,11,70,44,26,65
Rapid Vienna,7791,3,18,8,10,69,42,27,62
SC Rheindorf,7791,4,17,9,10,54,43,11,60
Vienna,7791,5,17,6,13,63,57,6,57
Admira Wacke,7791,6,13,6,17,37,56,-19,45
RZ Pellets W,7791,7,12,7,17,46,58,-12,43
SV Josko Rie,7791,8,9,8,19,33,59,-26,35
St. Pölten,7791,9,8,10,18,43,70,-27,34
Mattersburg,7791,10,7,8,21,38,64,-26,29
Vienna,7792,1,26,2,8,69,36,33,80
Rapid Vienna,7792,2,18,9,9,56,34,22,63
SK Sturm Gra,7792,3,18,8,10,53,32,21,62
FC Salzburg,7792,4,18,6,12,58,31,27,60
SC Rheindorf,7792,5,16,8,12,49,49,0,56
SV Josko Rie,7792,6,13,3,20,34,52,-18,42
RZ Pellets W,7792,7,10,8,18,36,56,-20,38
Admira Wacke,7792,8,10,8,18,36,60,-24,38
St. Pölten,7792,9,9,9,18,45,68,-23,36
Mattersburg,7792,10,8,7,21,35,53,-18,31
SC Rheindorf,7793,1,22,7,7,57,37,20,73
SK Sturm Gra,7793,2,19,7,10,62,33,29,64
FC Salzburg,7793,3,18,8,10,57,32,25,62
Rapid Vienna,7793,4,16,11,9,59,37,22,59
Vienna,7793,5,16,6,14,61,59,2,54
RZ Pellets W,7793,6,15,6,15,45,53,-8,51
SV Josko Rie,7793,7,12,6,18,42,59,-17,42
Admira Wacke,7793,8,10,5,21,36,58,-22,35
Mattersburg,7793,9,9,7,20,37,60,-23,34
St. Pölten,7793,10,6,11,19,35,63,-28,29
FC Salzburg,7794,1,21,8,7,57,25,32,71
SK Sturm Gra,7794,2,20,7,9,68,35,33,67
SC Rheindorf,7794,3,19,8,9,55,36,19,65
Vienna,7794,4,15,8,13,56,53,3,53
Rapid Vienna,7794,5,13,10,13,49,44,5,49
SV Josko Rie,7794,6,13,4,19,35,55,-20,43
Mattersburg,7794,7,11,8,17,36,49,-13,41
Admira Wacke,7794,8,11,6,19,33,62,-29,39
RZ Pellets W,7794,9,10,8,18,44,53,-9,38
St. Pölten,7794,10,9,9,18,41,62,-21,36
FC Salzburg,7795,1,23,7,6,70,28,42,76
SC Rheindorf,7795,2,19,7,10,55,43,12,64
Vienna,7795,3,19,4,13,68,57,11,61
SK Sturm Gra,7795,4,18,6,12,56,32,24,60
Rapid Vienna,7795,5,14,9,13,49,40,9,51
Admira Wacke,7795,6,13,7,16,42,59,-17,46
St. Pölten,7795,7,11,8,17,43,61,-18,41
RZ Pellets W,7795,8,11,5,20,42,65,-23,38
SV Josko Rie,7795,9,11,4,21,36,52,-16,37
Mattersburg,7795,10,10,5,21,41,65,-24,35
FC Salzburg,7796,1,19,11,6,64,33,31,68
SK Sturm Gra,7796,2,18,9,9,60,35,25,63
SC Rheindorf,7796,3,18,8,10,50,45,5,62
Vienna,7796,4,19,4,13,58,49,9,61
Rapid Vienna,7796,5,16,10,10,56,39,17,58
SV Josko Rie,7796,6,12,7,17,34,45,-11,43
Admira Wacke,7796,7,12,4,20,37,59,-22,40
RZ Pellets W,7796,8,10,9,17,44,57,-13,39
St. Pölten,7796,9,8,10,18,39,61,-22,34
Mattersburg,7796,10,6,12,18,36,55,-19,30
FC Salzburg,7797,1,22,6,8,74,33,41,72
SC Rheindorf,7797,2,18,10,8,51,37,14,64
Vienna,7797,3,17,6,13,55,52,3,57
SK Sturm Gra,7797,4,17,4,15,56,42,14,55
RZ Pellets W,7797,5,14,8,14,45,52,-7,50
Rapid Vienna,7797,6,12,13,11,56,45,11,49
SV Josko Rie,7797,7,11,8,17,32,52,-20,41
Mattersburg,7797,8,10,10,16,42,52,-10,40
Admira Wacke,7797,9,11,4,21,34,63,-29,37
St. Pölten,7797,10,9,9,18,43,60,-17,36
SC Rheindorf,7798,1,24,4,8,58,36,22,76
FC Salzburg,7798,2,19,8,9,57,30,27,65
SK Sturm Gra,7798,3,17,9,10,54,35,19,60
Vienna,7798,4,16,6,14,56,49,7,54
Rapid Vienna,7798,5,13,12,11,56,40,16,51
St. Pölten,7798,6,11,10,15,48,57,-9,43
RZ Pellets W,7798,7,12,7,17,43,57,-14,43
Admira Wacke,7798,8,12,6,18,39,57,-18,42
Mattersburg,7798,9,10,6,20,37,55,-18,36
SV Josko Rie,7798,10,8,8,20,33,65,-32,32
FC Salzburg,7799,1,22,8,6,70,30,40,74
SC Rheindorf,7799,2,20,7,9,67,52,15,67
Vienna,7799,3,18,6,12,64,52,12,60
SK Sturm Gra,7799,4,17,8,11,54,36,18,59
Rapid Vienna,7799,5,13,11,12,55,42,13,50
RZ Pellets W,7799,6,12,9,15,40,47,-7,45
Admira Wacke,7799,7,11,7,18,32,55,-23,40
SV Josko Rie,7799,8,11,5,20,40,54,-14,38
Mattersburg,7799,9,8,9,19,37,64,-27,33
St. Pölten,7799,10,6,14,16,39,66,-27,32
FC Salzburg,7800,1,20,7,9,64,32,32,67
Vienna,7800,2,19,8,9,66,46,20,65
SC Rheindorf,7800,3,17,8,11,59,47,12,59
Rapid Vienna,7800,4,16,10,10,57,38,19,58
SK Sturm Gra,7800,5,15,8,13,55,49,6,53
RZ Pellets W,7800,6,12,8,16,46,54,-8,44
Admira Wacke,7800,7,12,8,16,38,57,-19,44
St. Pölten,7800,8,11,8,17,50,64,-14,41
SV Josko Rie,7800,9,12,5,19,38,57,-19,41
Mattersburg,7800,10,7,8,21,31,60,-29,29
SK Sturm Gra,7801,1,21,6,9,61,35,26,69
SC Rheindorf,7801,2,20,9,7,56,38,18,69
FC Salzburg,7801,3,19,8,9,60,34,26,65
Vienna,7801,4,17,6,13,61,53,8,57
Rapid Vienna,7801,5,13,10,13,49,39,10,49
Admira Wacke,7801,6,13,4,19,41,58,-17,43
Mattersburg,7801,7,12,6,18,41,51,-10,42
RZ Pellets W,7801,8,10,9,17,43,57,-14,39
SV Josko Rie,7801,9,11,4,21,33,57,-24,37
St. Pölten,7801,10,8,10,18,38,61,-23,34
FC Salzburg,7802,1,22,8,6,67,29,38,74
Rapid Vienna,7802,2,18,9,9,60,35,25,63
Vienna,7802,3,19,4,13,61,52,9,61
SC Rheindorf,7802,4,17,9,10,51,40,11,60
SK Sturm Gra,7802,5,17,6,13,57,37,20,57
RZ Pellets W,7802,6,12,8,16,43,52,-9,44
Admira Wacke,7802,7,12,7,17,37,59,-22,43
SV Josko Rie,7802,8,11,4,21,38,58,-20,37
St. Pölten,7802,9,7,11,18,40,66,-26,32
Mattersburg,7802,10,7,10,19,33,59,-26,31
FC Salzburg,7803,1,23,5,8,73,28,45,74
SC Rheindorf,7803,2,20,6,10,60,43,17,66
SK Sturm Gra,7803,3,19,8,9,60,34,26,65
Rapid Vienna,7803,4,15,11,10,58,41,17,56
Vienna,7803,5,16,6,14,63,55,8,54
RZ Pellets W,7803,6,13,6,17,44,59,-15,45
Admira Wacke,7803,7,13,5,18,39,55,-16,44
St. Pölten,7803,8,9,9,18,48,72,-24,36
Mattersburg,7803,9,9,8,19,36,60,-24,35
SV Josko Rie,7803,10,8,6,22,30,64,-34,30
FC Salzburg,7804,1,20,9,7,64,25,39,69
Vienna,7804,2,22,3,11,71,50,21,69
SC Rheindorf,7804,3,20,7,9,54,42,12,67
SK Sturm Gra,7804,4,17,9,10,54,35,19,60
Rapid Vienna,7804,5,15,10,11,58,38,20,55
RZ Pellets W,7804,6,12,9,15,48,58,-10,45
SV Josko Rie,7804,7,11,6,19,34,57,-23,39
Admira Wacke,7804,8,10,7,19,36,60,-24,37
St. Pölten,7804,9,8,9,19,37,58,-21,33
Mattersburg,7804,10,6,9,21,36,69,-33,27
FC Salzburg,7805,1,22,6,8,61,30,31,72
SC Rheindorf,7805,2,19,9,8,65,43,22,66
SK Sturm Gra,7805,3,19,6,11,61,36,25,63
Vienna,7805,4,19,4,13,67,59,8,61
Rapid Vienna,7805,5,15,11,10,56,37,19,56
Admira Wacke,7805,6,14,4,18,43,63,-20,46
RZ Pellets W,7805,7,12,6,18,41,52,-11,42
St. Pölten,7805,8,9,10,17,42,64,-22,37
SV Josko Rie,7805,9,10,3,23,36,69,-33,33
Mattersburg,7805,10,7,9,20,34,53,-19,30
FC Salzburg,7806,1,22,7,7,67,29,38,73
SC Rheindorf,7806,2,20,9,7,54,36,18,69
SK Sturm Gra,7806,3,19,7,10,58,35,23,64
Vienna,7806,4,18,6,12,64,52,12,60
Rapid Vienna,7806,5,14,11,11,53,37,16,53
Admira Wacke,7806,6,11,10,15,34,53,-19,43
RZ Pellets W,7806,7,10,6,20,38,57,-19,36
St. Pölten,7806,8,9,9,18,38,62,-24,36
SV Josko Rie,7806,9,9,8,19,31,50,-19,35
Mattersburg,7806,10,7,9,20,33,59,-26,30
FC Salzburg,7807,1,22,8,6,68,29,39,74
SC Rheindorf,7807,2,21,5,10,60,40,20,68
SK Sturm Gra,7807,3,20,6,10,63,32,31,66
Vienna,7807,4,18,4,14,61,56,5,58
Rapid Vienna,7807,5,14,11,11,58,45,13,53
RZ Pellets W,7807,6,12,7,17,43,54,-11,43
Admira Wacke,7807,7,11,7,18,40,67,-27,40
SV Josko Rie,7807,8,10,9,17,33,51,-18,39
Mattersburg,7807,9,9,9,18,37,55,-18,36
St. Pölten,7807,10,5,10,21,34,68,-34,25
FC Salzburg,7808,1,21,9,6,73,31,42,72
SC Rheindorf,7808,2,20,7,9,51,37,14,67
SK Sturm Gra,7808,3,19,6,11,61,41,20,63
Vienna,7808,4,16,4,16,62,62,0,52
Rapid Vienna,7808,5,13,12,11,58,43,15,51
SV Josko Rie,7808,6,13,6,17,37,51,-14,45
RZ Pellets W,7808,7,10,10,16,44,58,-14,40
St. Pölten,7808,8,10,9,17,40,56,-16,39
Admira Wacke,7808,9,11,6,19,37,66,-29,39
Mattersburg,7808,10,7,11,18,33,51,-18,32
FC Salzburg,7809,1,22,9,5,69,31,38,75
SC Rheindorf,7809,2,23,5,8,63,40,23,74
SK Sturm Gra,7809,3,20,8,8,71,39,32,68
Vienna,7809,4,19,2,15,65,60,5,59
RZ Pellets W,7809,5,14,9,13,50,48,2,51
Rapid Vienna,7809,6,12,12,12,48,43,5,48
SV Josko Rie,7809,7,9,7,20,37,61,-24,34
Admira Wacke,7809,8,8,7,21,39,67,-28,31
Mattersburg,7809,9,7,9,20,40,63,-23,30
St. Pölten,7809,10,6,12,18,42,72,-30,30
FC Salzburg,7810,1,24,6,6,68,29,39,78
SK Sturm Gra,7810,2,19,7,10,64,37,27,64
SC Rheindorf,7810,3,19,7,10,49,41,8,64
Vienna,7810,4,19,4,13,62,53,9,61
RZ Pellets W,7810,5,15,5,16,46,50,-4,50
Rapid Vienna,7810,6,11,11,14,51,43,8,44
Admira Wacke,7810,7,13,4,19,41,60,-19,43
SV Josko Rie,7810,8,12,3,21,33,53,-20,39
Mattersburg,7810,9,10,6,20,36,56,-20,36
St. Pölten,7810,10,6,11,19,37,65,-28,29
FC Salzburg,7811,1,21,7,8,66,36,30,70
SC Rheindorf,7811,2,19,8,9,57,43,14,65
SK Sturm Gra,7811,3,18,8,10,59,38,21,62
Rapid Vienna,7811,4,17,9,10,53,33,20,60
Vienna,7811,5,16,7,13,61,55,6,55
SV Josko Rie,7811,6,13,5,18,35,46,-11,44
RZ Pellets W,7811,7,10,11,15,42,56,-14,41
St. Pölten,7811,8,10,9,17,49,64,-15,39
Admira Wacke,7811,9,9,6,21,31,57,-26,33
Mattersburg,7811,10,8,8,20,32,57,-25,32
SC Rheindorf,7812,1,23,6,7,59,38,21,75
SK Sturm Gra,7812,2,19,4,13,57,38,19,61
FC Salzburg,7812,3,18,6,12,59,32,27,60
Vienna,7812,4,16,8,12,59,50,9,56
Rapid Vienna,7812,5,14,12,10,58,40,18,54
Admira Wacke,7812,6,14,6,16,39,55,-16,48
RZ Pellets W,7812,7,12,6,18,43,59,-16,42
Mattersburg,7812,8,11,6,19,40,57,-17,39
SV Josko Rie,7812,9,10,7,19,35,56,-21,37
St. Pölten,7812,10,8,9,19,48,72,-24,33
FC Salzburg,7813,1,21,7,8,70,31,39,70
Vienna,7813,2,22,4,10,66,45,21,70
SC Rheindorf,7813,3,20,9,7,54,36,18,69
SK Sturm Gra,7813,4,18,6,12,56,41,15,60
Rapid Vienna,7813,5,12,14,10,54,42,12,50
RZ Pellets W,7813,6,14,8,14,48,52,-4,50
Admira Wacke,7813,7,10,7,19,34,60,-26,37
Mattersburg,7813,8,9,8,19,39,57,-18,35
St. Pölten,7813,9,7,10,19,42,70,-28,31
SV Josko Rie,7813,10,8,5,23,33,62,-29,29
FC Salzburg,7814,1,21,8,7,64,32,32,71
SC Rheindorf,7814,2,20,5,11,52,39,13,65
SK Sturm Gra,7814,3,19,7,10,52,33,19,64
Vienna,7814,4,18,6,12,57,56,1,60
RZ Pellets W,7814,5,14,8,14,52,49,3,50
Rapid Vienna,7814,6,12,10,14,61,47,14,46
St. Pölten,7814,7,11,8,17,42,61,-19,41
Admira Wacke,7814,8,11,6,19,36,58,-22,39
SV Josko Rie,7814,9,10,6,20,36,56,-20,36
Mattersburg,7814,10,7,10,19,38,59,-21,31
Vienna,7815,1,19,7,10,56,47,9,64
SC Rheindorf,7815,2,18,8,10,55,45,10,62
SK Sturm Gra,7815,3,19,4,13,62,34,28,61
FC Salzburg,7815,4,18,7,11,60,39,21,61
Rapid Vienna,7815,5,13,11,12,58,48,10,50
RZ Pellets W,7815,6,13,7,16,45,52,-7,46
Mattersburg,7815,7,13,6,17,43,54,-11,45
SV Josko Rie,7815,8,13,5,18,35,50,-15,44
Admira Wacke,7815,9,12,6,18,38,62,-24,42
St. Pölten,7815,10,6,11,19,39,60,-21,29
FC Salzburg,7816,1,22,8,6,65,26,39,74
SC Rheindorf,7816,2,19,8,9,53,38,15,65
SK Sturm Gra,7816,3,18,7,11,58,35,23,61
Vienna,7816,4,18,6,12,63,49,14,60
Rapid Vienna,7816,5,13,12,11,54,45,9,51
St. Pölten,7816,6,11,10,15,47,60,-13,43
SV Josko Rie,7816,7,12,6,18,38,52,-14,42
Admira Wacke,7816,8,9,11,16,34,59,-25,38
RZ Pellets W,7816,9,9,7,20,39,64,-25,34
Mattersburg,7816,10,7,9,20,39,62,-23,30
FC Salzburg,7817,1,21,8,7,62,32,30,71
SK Sturm Gra,7817,2,21,4,11,63,32,31,67
SC Rheindorf,7817,3,19,7,10,57,44,13,64
Vienna,7817,4,19,3,14,63,47,16,60
RZ Pellets W,7817,5,14,6,16,42,55,-13,48
Rapid Vienna,7817,6,12,11,13,50,43,7,47
Mattersburg,7817,7,11,8,17,37,54,-17,41
SV Josko Rie,7817,8,11,5,20,39,63,-24,38
Admira Wacke,7817,9,10,6,20,32,58,-26,36
St. Pölten,7817,10,9,8,19,45,62,-17,35
FC Salzburg,7818,1,21,9,6,67,26,41,72
SK Sturm Gra,7818,2,20,7,9,57,33,24,67
SC Rheindorf,7818,3,19,8,9,52,44,8,65
Vienna,7818,4,19,7,10,65,46,19,64
Rapid Vienna,7818,5,14,9,13,57,41,16,51
RZ Pellets W,7818,6,12,7,17,51,62,-11,43
SV Josko Rie,7818,7,11,4,21,36,57,-21,37
St. Pölten,7818,8,10,7,19,42,67,-25,37
Admira Wacke,7818,9,10,5,21,29,61,-32,35
Mattersburg,7818,10,9,7,20,39,58,-19,34
FC Salzburg,7819,1,20,7,9,64,33,31,67
SC Rheindorf,7819,2,19,9,8,57,40,17,66
SK Sturm Gra,7819,3,18,9,9,63,36,27,63
Vienna,7819,4,18,4,14,64,58,6,58
Rapid Vienna,7819,5,13,9,14,51,43,8,48
RZ Pellets W,7819,6,12,9,15,42,56,-14,45
SV Josko Rie,7819,7,12,7,17,38,48,-10,43
Admira Wacke,7819,8,12,7,17,35,58,-23,43
St. Pölten,7819,9,10,9,17,41,59,-18,39
Mattersburg,7819,10,7,8,21,33,57,-24,29
SK Sturm Gra,7820,1,21,5,10,62,35,27,68
SC Rheindorf,7820,2,18,10,8,55,43,12,64
FC Salzburg,7820,3,18,8,10,64,35,29,62
Rapid Vienna,7820,4,17,9,10,67,43,24,60
Vienna,7820,5,18,5,13,62,55,7,59
Admira Wacke,7820,6,14,5,17,40,55,-15,47
St. Pölten,7820,7,10,10,16,39,61,-22,40
SV Josko Rie,7820,8,10,5,21,36,57,-21,35
RZ Pellets W,7820,9,9,8,19,37,60,-23,35
Mattersburg,7820,10,9,7,20,33,51,-18,34
FC Salzburg,7821,1,21,9,6,60,24,36,72
SC Rheindorf,7821,2,17,11,8,52,39,13,62
SK Sturm Gra,7821,3,16,8,12,52,35,17,56
Rapid Vienna,7821,4,14,11,11,51,38,13,53
Vienna,7821,5,16,5,15,52,49,3,53
RZ Pellets W,7821,6,12,12,12,45,49,-4,48
Admira Wacke,7821,7,12,8,16,36,54,-18,44
Mattersburg,7821,8,8,13,15,36,48,-12,37
SV Josko Rie,7821,9,9,7,20,34,55,-21,34
St. Pölten,7821,10,8,10,18,38,65,-27,34
SK Sturm Gra,7822,1,20,6,10,56,32,24,66
SC Rheindorf,7822,2,17,13,6,55,38,17,64
Vienna,7822,3,18,7,11,59,47,12,61
FC Salzburg,7822,4,17,9,10,53,30,23,60
RZ Pellets W,7822,5,15,8,13,50,52,-2,53
Rapid Vienna,7822,6,12,12,12,56,49,7,48
St. Pölten,7822,7,11,8,17,43,60,-17,41
SV Josko Rie,7822,8,11,7,18,36,49,-13,40
Admira Wacke,7822,9,10,5,21,32,58,-26,35
Mattersburg,7822,10,7,9,20,37,62,-25,30
FC Salzburg,7823,1,20,8,8,64,30,34,68
SC Rheindorf,7823,2,20,6,10,60,42,18,66
SK Sturm Gra,7823,3,18,7,11,56,34,22,61
Vienna,7823,4,17,6,13,58,52,6,57
RZ Pellets W,7823,5,14,10,12,46,47,-1,52
Rapid Vienna,7823,6,13,12,11,57,43,14,51
Admira Wacke,7823,7,11,6,19,35,58,-23,39
SV Josko Rie,7823,8,10,8,18,35,52,-17,38
St. Pölten,7823,9,8,11,17,41,67,-26,35
Mattersburg,7823,10,5,14,17,31,58,-27,29
FC Salzburg,7824,1,20,11,5,65,30,35,71
SC Rheindorf,7824,2,19,8,9,54,41,13,65
Vienna,7824,3,19,6,11,61,49,12,63
SK Sturm Gra,7824,4,16,8,12,55,36,19,56
Rapid Vienna,7824,5,13,12,11,59,45,14,51
Admira Wacke,7824,6,14,6,16,43,56,-13,48
SV Josko Rie,7824,7,11,8,17,34,50,-16,41
RZ Pellets W,7824,8,10,7,19,41,61,-20,37
Mattersburg,7824,9,9,9,18,34,55,-21,36
St. Pölten,7824,10,8,7,21,37,60,-23,31
FC Salzburg,7825,1,23,6,7,65,30,35,75
SK Sturm Gra,7825,2,18,9,9,61,38,23,63
Vienna,7825,3,19,5,12,70,55,15,62
SC Rheindorf,7825,4,18,8,10,47,37,10,62
Rapid Vienna,7825,5,12,9,15,54,47,7,45
St. Pölten,7825,6,12,9,15,49,60,-11,45
RZ Pellets W,7825,7,11,11,14,43,54,-11,44
SV Josko Rie,7825,8,12,6,18,35,49,-14,42
Admira Wacke,7825,9,10,7,19,37,62,-25,37
Mattersburg,7825,10,5,10,21,31,60,-29,25
Vienna,7826,1,25,2,9,70,44,26,77
FC Salzburg,7826,2,21,7,8,65,30,35,70
SK Sturm Gra,7826,3,21,6,9,71,31,40,69
SC Rheindorf,7826,4,17,8,11,57,49,8,59
Rapid Vienna,7826,5,12,10,14,56,48,8,46
RZ Pellets W,7826,6,12,8,16,39,54,-15,44
SV Josko Rie,7826,7,10,6,20,34,63,-29,36
St. Pölten,7826,8,9,8,19,46,68,-22,35
Mattersburg,7826,9,10,5,21,38,60,-22,35
Admira Wacke,7826,10,9,8,19,32,61,-29,35
SC Rheindorf,7827,1,23,6,7,59,36,23,75
FC Salzburg,7827,2,23,5,8,67,33,34,74
SK Sturm Gra,7827,3,18,6,12,55,34,21,60
Vienna,7827,4,16,8,12,58,49,9,56
Rapid Vienna,7827,5,15,10,11,61,41,20,55
RZ Pellets W,7827,6,14,7,15,44,53,-9,49
St. Pölten,7827,7,9,8,19,42,65,-23,35
Admira Wacke,7827,8,9,8,19,32,59,-27,35
SV Josko Rie,7827,9,9,7,20,27,50,-23,34
Mattersburg,7827,10,7,9,20,31,56,-25,30
FC Salzburg,7828,1,20,10,6,68,27,41,70
SK Sturm Gra,7828,2,20,8,8,60,32,28,68
SC Rheindorf,7828,3,20,8,8,56,42,14,68
RZ Pellets W,7828,4,14,11,11,46,48,-2,53
Rapid Vienna,7828,5,13,13,10,51,34,17,52
Vienna,7828,6,15,6,15,58,57,1,51
St. Pölten,7828,7,10,10,16,44,57,-13,40
Admira Wacke,7828,8,10,5,21,34,64,-30,35
SV Josko Rie,7828,9,8,6,22,31,63,-32,30
Mattersburg,7828,10,6,11,19,38,62,-24,29
FC Salzburg,7829,1,21,6,9,64,32,32,69
SK Sturm Gra,7829,2,19,9,8,63,38,25,66
SC Rheindorf,7829,3,17,9,10,59,46,13,60
Vienna,7829,4,17,8,11,68,61,7,59
Admira Wacke,7829,5,14,7,15,43,53,-10,49
Rapid Vienna,7829,6,11,13,12,53,47,6,46
RZ Pellets W,7829,7,12,10,14,44,48,-4,46
St. Pölten,7829,8,9,9,18,49,75,-26,36
SV Josko Rie,7829,9,8,9,19,36,55,-19,33
Mattersburg,7829,10,8,8,20,37,61,-24,32
SK Sturm Gra,7830,1,23,5,8,61,27,34,74
FC Salzburg,7830,2,20,10,6,62,26,36,70
Vienna,7830,3,22,4,10,69,42,27,70
SC Rheindorf,7830,4,17,9,10,50,44,6,60
Rapid Vienna,7830,5,13,12,11,50,43,7,51
RZ Pellets W,7830,6,14,5,17,48,56,-8,47
Admira Wacke,7830,7,11,7,18,40,58,-18,40
St. Pölten,7830,8,8,9,19,37,64,-27,33
SV Josko Rie,7830,9,9,4,23,33,63,-30,31
Mattersburg,7830,10,5,11,20,32,59,-27,26
SC Rheindorf,7831,1,20,9,7,64,43,21,69
FC Salzburg,7831,2,18,8,10,61,36,25,62
SK Sturm Gra,7831,3,19,5,12,58,34,24,62
Rapid Vienna,7831,4,17,9,10,64,35,29,60
Vienna,7831,5,15,9,12,59,65,-6,54
RZ Pellets W,7831,6,13,10,13,50,52,-2,49
Admira Wacke,7831,7,11,8,17,38,62,-24,41
Mattersburg,7831,8,8,10,18,36,55,-19,34
SV Josko Rie,7831,9,9,7,20,33,58,-25,34
St. Pölten,7831,10,7,11,18,42,65,-23,32
FC Salzburg,7832,1,18,9,9,57,34,23,63
Vienna,7832,2,18,8,10,62,51,11,62
SC Rheindorf,7832,3,17,9,10,49,45,4,60
SK Sturm Gra,7832,4,17,7,12,57,35,22,58
Rapid Vienna,7832,5,16,9,11,60,42,18,57
Admira Wacke,7832,6,13,8,15,42,56,-14,47
RZ Pellets W,7832,7,10,10,16,42,53,-11,40
Mattersburg,7832,8,10,10,16,37,49,-12,40
SV Josko Rie,7832,9,11,5,20,31,49,-18,38
St. Pölten,7832,10,9,7,20,38,61,-23,34
FC Salzburg,7833,1,23,7,6,66,29,37,76
SC Rheindorf,7833,2,20,9,7,64,41,23,69
Vienna,7833,3,19,7,10,63,48,15,64
SK Sturm Gra,7833,4,18,6,12,62,42,20,60
RZ Pellets W,7833,5,14,7,15,47,56,-9,49
Rapid Vienna,7833,6,12,7,17,57,53,4,43
Admira Wacke,7833,7,12,3,21,38,61,-23,39
Mattersburg,7833,8,10,7,19,46,64,-18,37
St. Pölten,7833,9,10,7,19,45,68,-23,37
SV Josko Rie,7833,10,10,4,22,41,67,-26,34
FC Salzburg,7834,1,23,6,7,63,27,36,75
Vienna,7834,2,19,5,12,56,47,9,62
SK Sturm Gra,7834,3,16,9,11,50,30,20,57
SC Rheindorf,7834,4,16,9,11,53,46,7,57
Rapid Vienna,7834,5,13,14,9,49,36,13,53
RZ Pellets W,7834,6,12,7,17,43,55,-12,43
Admira Wacke,7834,7,12,7,17,36,58,-22,43
Mattersburg,7834,8,11,7,18,33,47,-14,40
SV Josko Rie,7834,9,11,4,21,32,49,-17,37
St. Pölten,7834,10,9,8,19,37,57,-20,35
FC Salzburg,7835,1,23,6,7,66,27,39,75
SC Rheindorf,7835,2,20,8,8,55,41,14,68
Vienna,7835,3,19,8,9,66,48,18,65
SK Sturm Gra,7835,4,18,5,13,53,34,19,59
Rapid Vienna,7835,5,16,9,11,56,41,15,57
RZ Pellets W,7835,6,13,8,15,45,57,-12,47
Admira Wacke,7835,7,11,6,19,44,58,-14,39
St. Pölten,7835,8,9,9,18,41,64,-23,36
SV Josko Rie,7835,9,9,6,21,32,58,-26,33
Mattersburg,7835,10,5,9,22,33,63,-30,24
FC Salzburg,7836,1,19,10,7,67,34,33,67
SC Rheindorf,7836,2,20,7,9,54,40,14,67
Vienna,7836,3,20,6,10,72,48,24,66
SK Sturm Gra,7836,4,20,6,10,63,40,23,66
Rapid Vienna,7836,5,14,9,13,55,42,13,51
Admira Wacke,7836,6,14,4,18,37,63,-26,46
St. Pölten,7836,7,9,9,18,48,64,-16,36
SV Josko Rie,7836,8,10,6,20,33,52,-19,36
RZ Pellets W,7836,9,9,9,18,37,60,-23,36
Mattersburg,7836,10,8,8,20,36,59,-23,32
SC Rheindorf,7837,1,23,4,9,59,39,20,73
SK Sturm Gra,7837,2,19,9,8,57,29,28,66
Vienna,7837,3,20,6,10,65,47,18,66
FC Salzburg,7837,4,19,8,9,58,28,30,65
Rapid Vienna,7837,5,14,12,10,57,40,17,54
RZ Pellets W,7837,6,15,7,14,46,47,-1,52
Admira Wacke,7837,7,12,3,21,41,62,-21,39
St. Pölten,7837,8,8,10,18,45,70,-25,34
Mattersburg,7837,9,7,9,20,31,58,-27,30
SV Josko Rie,7837,10,6,6,24,31,70,-39,24
FC Salzburg,7838,1,23,6,7,68,30,38,75
SC Rheindorf,7838,2,21,7,8,61,41,20,70
SK Sturm Gra,7838,3,20,6,10,71,36,35,66
Vienna,7838,4,20,4,12,62,52,10,64
Rapid Vienna,7838,5,12,11,13,54,51,3,47
St. Pölten,7838,6,11,10,15,44,58,-14,43
RZ Pellets W,7838,7,10,8,18,44,56,-12,38
Admira Wacke,7838,8,10,8,18,33,63,-30,38
SV Josko Rie,7838,9,9,6,21,27,51,-24,33
Mattersburg,7838,10,7,8,21,33,59,-26,29
FC Salzburg,7839,1,23,6,7,71,34,37,75
SC Rheindorf,7839,2,19,12,5,58,37,21,69
SK Sturm Gra,7839,3,18,9,9,60,34,26,63
Rapid Vienna,7839,4,13,9,14,48,41,7,48
Vienna,7839,5,14,4,18,55,61,-6,46
RZ Pellets W,7839,6,11,12,13,46,51,-5,45
Mattersburg,7839,7,11,9,16,41,56,-15,42
SV Josko Rie,7839,8,10,8,18,39,55,-16,38
Admira Wacke,7839,9,10,7,19,34,61,-27,37
St. Pölten,7839,10,7,12,17,44,66,-22,33
SC Rheindorf,7840,1,23,6,7,61,42,19,75
FC Salzburg,7840,2,21,8,7,66,31,35,71
Vienna,7840,3,20,5,11,64,50,14,65
SK Sturm Gra,7840,4,17,8,11,56,36,20,59
Rapid Vienna,7840,5,11,14,11,46,39,7,47
RZ Pellets W,7840,6,12,6,18,53,57,-4,42
Admira Wacke,7840,7,11,9,16,36,60,-24,42
St. Pölten,7840,8,9,9,18,44,64,-20,36
SV Josko Rie,7840,9,9,5,22,33,54,-21,32
Mattersburg,7840,10,7,10,19,34,60,-26,31
FC Salzburg,7841,1,23,8,5,69,24,45,77
SK Sturm Gra,7841,2,22,7,7,62,25,37,73
SC Rheindorf,7841,3,18,9,9,57,39,18,63
Vienna,7841,4,17,6,13,61,56,5,57
Rapid Vienna,7841,5,12,11,13,51,44,7,47
RZ Pellets W,7841,6,11,9,16,47,62,-15,42
SV Josko Rie,7841,7,10,8,18,35,51,-16,38
St. Pölten,7841,8,9,10,17,45,68,-23,37
Admira Wacke,7841,9,10,7,19,35,63,-28,37
Mattersburg,7841,10,6,9,21,37,67,-30,27
SC Rheindorf,7842,1,19,12,5,60,39,21,69
SK Sturm Gra,7842,2,19,7,10,58,36,22,64
FC Salzburg,7842,3,17,9,10,60,31,29,60
Rapid Vienna,7842,4,17,8,11,56,37,19,59
Vienna,7842,5,17,8,11,67,58,9,59
Admira Wacke,7842,6,12,6,18,38,58,-20,42
St. Pölten,7842,7,9,12,15,49,62,-13,39
RZ Pellets W,7842,8,11,6,19,41,63,-22,39
SV Josko Rie,7842,9,10,8,18,37,54,-17,38
Mattersburg,7842,10,7,8,21,37,65,-28,29
FC Salzburg,7843,1,22,9,5,70,29,41,75
SK Sturm Gra,7843,2,22,3,11,57,36,21,69
SC Rheindorf,7843,3,18,11,7,52,37,15,65
Vienna,7843,4,17,5,14,61,52,9,56
Rapid Vienna,7843,5,14,10,12,56,41,15,52
RZ Pellets W,7843,6,12,9,15,43,49,-6,45
St. Pölten,7843,7,9,10,17,43,63,-20,37
Admira Wacke,7843,8,11,4,21,35,70,-35,37
Mattersburg,7843,9,9,8,19,38,53,-15,35
SV Josko Rie,7843,10,9,5,22,32,57,-25,32
SK Sturm Gra,7844,1,22,6,8,67,35,32,72
FC Salzburg,7844,2,19,11,6,58,29,29,68
Vienna,7844,3,20,5,11,69,54,15,65
SC Rheindorf,7844,4,18,9,9,55,43,12,63
Rapid Vienna,7844,5,14,11,11,53,38,15,53
RZ Pellets W,7844,6,11,10,15,45,57,-12,43
Admira Wacke,7844,7,11,8,17,35,53,-18,41
SV Josko Rie,7844,8,8,9,19,28,51,-23,33
St. Pölten,7844,9,5,14,17,45,71,-26,29
Mattersburg,7844,10,6,9,21,36,60,-24,27
FC Salzburg,7845,1,23,4,9,72,32,40,73
SC Rheindorf,7845,2,20,8,8,57,42,15,68
SK Sturm Gra,7845,3,19,8,9,62,39,23,65
Admira Wacke,7845,4,16,5,15,41,56,-15,53
Vienna,7845,5,15,4,17,54,51,3,49
Rapid Vienna,7845,6,12,11,13,57,45,12,47
RZ Pellets W,7845,7,13,5,18,44,56,-12,44
SV Josko Rie,7845,8,13,4,19,36,48,-12,43
St. Pölten,7845,9,8,11,17,35,58,-23,35
Mattersburg,7845,10,7,8,21,35,66,-31,29
SK Sturm Gra,7846,1,22,7,7,64,29,35,73
SC Rheindorf,7846,2,20,10,6,53,33,20,70
FC Salzburg,7846,3,18,10,8,60,32,28,64
Rapid Vienna,7846,4,18,9,9,60,34,26,63
Vienna,7846,5,16,8,12,53,50,3,56
RZ Pellets W,7846,6,10,12,14,45,54,-9,42
SV Josko Rie,7846,7,11,7,18,37,51,-14,40
Admira Wacke,7846,8,8,7,21,31,61,-30,31
Mattersburg,7846,9,7,8,21,30,61,-31,29
St. Pölten,7846,10,4,14,18,38,66,-28,26
Vienna,7847,1,20,6,10,63,48,15,66
SC Rheindorf,7847,2,19,9,8,59,44,15,66
FC Salzburg,7847,3,18,11,7,62,34,28,65
SK Sturm Gra,7847,4,19,7,10,61,32,29,64
Rapid Vienna,7847,5,11,13,12,58,42,16,46
RZ Pellets W,7847,6,12,10,14,46,52,-6,46
Admira Wacke,7847,7,11,8,17,38,59,-21,41
St. Pölten,7847,8,10,8,18,43,76,-33,38
SV Josko Rie,7847,9,9,6,21,29,52,-23,33
Mattersburg,7847,10,7,10,19,36,56,-20,31
FC Salzburg,7848,1,22,8,6,65,24,41,74
SK Sturm Gra,7848,2,19,9,8,66,34,32,66
SC Rheindorf,7848,3,19,7,10,55,42,13,64
Rapid Vienna,7848,4,14,12,10,55,40,15,54
Vienna,7848,5,15,8,13,61,53,8,53
Admira Wacke,7848,6,10,11,15,35,55,-20,41
RZ Pellets W,7848,7,10,10,16,48,59,-11,40
SV Josko Rie,7848,8,11,7,18,34,48,-14,40
Mattersburg,7848,9,7,10,19,29,57,-28,31
St. Pölten,7848,10,7,10,19,34,70,-36,31
FC Salzburg,7849,1,19,9,8,58,30,28,66
SC Rheindorf,7849,2,18,10,8,64,43,21,64
Vienna,7849,3,19,6,11,67,53,14,63
SK Sturm Gra,7849,4,16,10,10,51,35,16,58
Rapid Vienna,7849,5,14,12,10,58,40,18,54
Admira Wacke,7849,6,12,7,17,35,52,-17,43
RZ Pellets W,7849,7,10,10,16,43,55,-12,40
St. Pölten,7849,8,10,8,18,36,63,-27,38
Mattersburg,7849,9,8,11,17,40,59,-19,35
SV Josko Rie,7849,10,10,5,21,31,53,-22,35
Vienna,7850,1,21,6,9,57,40,17,69
SK Sturm Gra,7850,2,19,8,9,63,33,30,65
FC Salzburg,7850,3,19,6,11,65,37,28,63
SC Rheindorf,7850,4,17,11,8,51,38,13,62
Rapid Vienna,7850,5,14,11,11,58,45,13,53
RZ Pellets W,7850,6,15,6,15,45,53,-8,51
SV Josko Rie,7850,7,12,6,18,39,53,-14,42
Admira Wacke,7850,8,10,5,21,35,67,-32,35
Mattersburg,7850,9,8,7,21,36,59,-23,31
St. Pölten,7850,10,7,10,19,40,64,-24,31
FC Salzburg,7851,1,22,6,8,63,32,31,72
SK Sturm Gra,7851,2,20,6,10,72,40,32,66
SC Rheindorf,7851,3,19,7,10,53,48,5,64
Rapid Vienna,7851,4,14,11,11,62,50,12,53
Vienna,7851,5,16,5,15,60,58,2,53
Admira Wacke,7851,6,12,8,16,36,55,-19,44
Mattersburg,7851,7,11,7,18,46,47,-1,40
SV Josko Rie,7851,8,12,4,20,38,54,-16,40
St. Pölten,7851,9,10,10,16,44,63,-19,40
RZ Pellets W,7851,10,10,4,22,38,65,-27,34
FC Salzburg,7852,1,22,7,7,63,26,37,73
SK Sturm Gra,7852,2,21,6,9,71,33,38,69
Vienna,7852,3,20,5,11,62,47,15,65
SC Rheindorf,7852,4,19,8,9,52,40,12,65
Rapid Vienna,7852,5,12,9,15,50,43,7,45
RZ Pellets W,7852,6,11,10,15,50,63,-13,43
SV Josko Rie,7852,7,10,8,18,34,54,-20,38
Admira Wacke,7852,8,10,6,20,38,61,-23,36
St. Pölten,7852,9,9,8,19,36,61,-25,35
Mattersburg,7852,10,9,7,20,32,60,-28,34
SK Sturm Gra,7853,1,22,4,10,61,35,26,70
FC Salzburg,7853,2,19,10,7,61,33,28,67
SC Rheindorf,7853,3,20,7,9,53,38,15,67
Vienna,7853,4,20,5,11,66,54,12,65
Rapid Vienna,7853,5,14,9,13,57,42,15,51
RZ Pellets W,7853,6,10,10,16,40,56,-16,40
St. Pölten,7853,7,10,9,17,45,58,-13,39
Admira Wacke,7853,8,10,8,18,38,59,-21,38
Mattersburg,7853,9,8,9,19,40,57,-17,33
SV Josko Rie,7853,10,8,7,21,32,61,-29,31
SK Sturm Gra,7854,1,21,6,9,66,38,28,69
Vienna,7854,2,21,2,13,69,54,15,65
FC Salzburg,7854,3,17,10,9,60,34,26,61
SC Rheindorf,7854,4,17,9,10,57,45,12,60
Rapid Vienna,7854,5,14,12,10,58,39,19,54
St. Pölten,7854,6,12,11,13,50,60,-10,47
RZ Pellets W,7854,7,12,10,14,49,56,-7,46
SV Josko Rie,7854,8,13,3,20,36,59,-23,42
Admira Wacke,7854,9,10,5,21,35,65,-30,35
Mattersburg,7854,10,5,8,23,36,66,-30,23
FC Salzburg,7855,1,22,8,6,76,29,47,74
SK Sturm Gra,7855,2,19,6,11,55,35,20,63
Vienna,7855,3,18,5,13,65,57,8,59
SC Rheindorf,7855,4,17,8,11,53,46,7,59
Rapid Vienna,7855,5,13,11,12,60,48,12,50
RZ Pellets W,7855,6,13,8,15,44,49,-5,47
St. Pölten,7855,7,11,9,16,42,62,-20,42
Admira Wacke,7855,8,11,8,17,45,67,-22,41
Mattersburg,7855,9,8,9,19,36,58,-22,33
SV Josko Rie,7855,10,8,8,20,31,56,-25,32
FC Salzburg,7856,1,23,7,6,67,32,35,76
SK Sturm Gra,7856,2,19,9,8,60,33,27,66
SC Rheindorf,7856,3,19,8,9,55,44,11,65
Vienna,7856,4,19,5,12,64,44,20,62
Rapid Vienna,7856,5,11,15,10,50,37,13,48
SV Josko Rie,7856,6,12,7,17,34,45,-11,43
RZ Pellets W,7856,7,9,11,16,35,58,-23,38
Admira Wacke,7856,8,10,7,19,35,59,-24,37
St. Pölten,7856,9,8,11,17,45,66,-21,35
Mattersburg,7856,10,5,10,21,33,60,-27,25
FC Salzburg,7857,1,22,7,7,64,31,33,73
Vienna,7857,2,22,3,11,70,45,25,69
SC Rheindorf,7857,3,18,8,10,54,42,12,62
SK Sturm Gra,7857,4,17,6,13,58,42,16,57
Rapid Vienna,7857,5,15,11,10,62,43,19,56
SV Josko Rie,7857,6,14,4,18,44,50,-6,46
RZ Pellets W,7857,7,10,10,16,44,60,-16,40
Admira Wacke,7857,8,12,4,20,38,60,-22,40
St. Pölten,7857,9,8,8,20,41,75,-34,32
Mattersburg,7857,10,7,9,20,42,69,-27,30
SC Rheindorf,7858,1,22,8,6,55,28,27,74
FC Salzburg,7858,2,19,7,10,70,33,37,64
Vienna,7858,3,19,5,12,61,55,6,62
SK Sturm Gra,7858,4,17,7,12,55,35,20,58
Rapid Vienna,7858,5,14,10,12,52,41,11,52
RZ Pellets W,7858,6,13,6,17,48,59,-11,45
Admira Wacke,7858,7,12,7,17,35,60,-25,43
Mattersburg,7858,8,9,10,17,39,56,-17,37
SV Josko Rie,7858,9,10,5,21,28,53,-25,35
St. Pölten,7858,10,8,9,19,40,63,-23,33
FC Salzburg,7859,1,21,7,8,62,31,31,70
SK Sturm Gra,7859,2,21,6,9,59,30,29,69
SC Rheindorf,7859,3,20,7,9,58,40,18,67
Rapid Vienna,7859,4,16,10,10,58,40,18,58
Vienna,7859,5,15,6,15,59,55,4,51
RZ Pellets W,7859,6,12,8,16,42,51,-9,44
SV Josko Rie,7859,7,13,5,18,40,57,-17,44
St. Pölten,7859,8,8,10,18,39,63,-24,34
Admira Wacke,7859,9,8,9,19,28,55,-27,33
Mattersburg,7859,10,8,8,20,40,63,-23,32
FC Salzburg,7860,1,20,8,8,61,31,30,68
SK Sturm Gra,7860,2,20,5,11,61,33,28,65
SC Rheindorf,7860,3,18,7,11,54,45,9,61
Vienna,7860,4,18,5,13,63,54,9,59
Rapid Vienna,7860,5,13,12,11,55,45,10,51
RZ Pellets W,7860,6,12,7,17,43,56,-13,43
Admira Wacke,7860,7,12,6,18,41,60,-19,42
SV Josko Rie,7860,8,12,5,19,39,57,-18,41
Mattersburg,7860,9,9,10,17,41,57,-16,37
St. Pölten,7860,10,8,11,17,36,56,-20,35
SK Sturm Gra,7861,1,23,6,7,67,29,38,75
FC Salzburg,7861,2,19,8,9,58,29,29,65
Rapid Vienna,7861,3,17,11,8,56,32,24,62
Vienna,7861,4,18,7,11,60,48,12,61
SC Rheindorf,7861,5,16,9,11,42,41,1,57
Mattersburg,7861,6,11,7,18,37,51,-14,40
SV Josko Rie,7861,7,11,7,18,31,45,-14,40
Admira Wacke,7861,8,11,6,19,34,56,-22,39
RZ Pellets W,7861,9,10,6,20,36,57,-21,36
St. Pölten,7861,10,6,9,21,35,68,-33,27
FC Salzburg,7862,1,21,9,6,66,28,38,72
SC Rheindorf,7862,2,20,7,9,53,41,12,67
SK Sturm Gra,7862,3,20,4,12,64,34,30,64
Vienna,7862,4,17,6,13,63,52,11,57
Rapid Vienna,7862,5,14,11,11,59,41,18,53
RZ Pellets W,7862,6,14,7,15,50,52,-2,49
Admira Wacke,7862,7,10,9,17,37,62,-25,39
Mattersburg,7862,8,9,8,19,34,64,-30,35
St. Pölten,7862,9,9,7,20,39,63,-24,34
SV Josko Rie,7862,10,9,6,21,34,62,-28,33
SC Rheindorf,7863,1,20,7,9,61,52,9,67
Vienna,7863,2,19,6,11,60,53,7,63
FC Salzburg,7863,3,17,10,9,66,40,26,61
SK Sturm Gra,7863,4,17,6,13,56,40,16,57
Rapid Vienna,7863,5,15,9,12,60,39,21,54
RZ Pellets W,7863,6,14,7,15,56,54,2,49
Admira Wacke,7863,7,12,6,18,32,50,-18,42
SV Josko Rie,7863,8,10,7,19,35,55,-20,37
Mattersburg,7863,9,10,7,19,35,56,-21,37
St. Pölten,7863,10,9,9,18,43,65,-22,36
FC Salzburg,7864,1,22,7,7,65,29,36,73
SK Sturm Gra,7864,2,20,7,9,61,31,30,67
Vienna,7864,3,20,5,11,67,49,18,65
SC Rheindorf,7864,4,16,12,8,50,38,12,60
Rapid Vienna,7864,5,13,11,12,53,39,14,50
Admira Wacke,7864,6,13,9,14,39,52,-13,48
Mattersburg,7864,7,10,9,17,39,53,-14,39
RZ Pellets W,7864,8,9,10,17,41,58,-17,37
St. Pölten,7864,9,8,10,18,38,66,-28,34
SV Josko Rie,7864,10,7,4,25,27,65,-38,25
SK Sturm Gra,7865,1,20,5,11,61,33,28,65
SC Rheindorf,7865,2,19,8,9,54,45,9,65
FC Salzburg,7865,3,19,6,11,59,34,25,63
Vienna,7865,4,16,3,17,59,56,3,51
Admira Wacke,7865,5,15,5,16,46,59,-13,50
Rapid Vienna,7865,6,13,10,13,53,42,11,49
RZ Pellets W,7865,7,13,7,16,44,58,-14,46
St. Pölten,7865,8,10,11,15,41,54,-13,41
SV Josko Rie,7865,9,12,4,20,34,54,-20,40
Mattersburg,7865,10,9,9,18,37,53,-16,36
FC Salzburg,7866,1,23,9,4,70,24,46,78
SK Sturm Gra,7866,2,22,6,8,55,27,28,72
SC Rheindorf,7866,3,19,9,8,54,42,12,66
Vienna,7866,4,17,9,10,61,51,10,60
Rapid Vienna,7866,5,12,11,13,54,41,13,47
Admira Wacke,7866,6,13,5,18,42,56,-14,44
RZ Pellets W,7866,7,10,8,18,40,58,-18,38
Mattersburg,7866,8,10,6,20,40,59,-19,36
SV Josko Rie,7866,9,8,6,22,28,56,-28,30
St. Pölten,7866,10,7,9,20,39,69,-30,30
SK Sturm Gra,7867,1,22,6,8,61,26,35,72
SC Rheindorf,7867,2,19,9,8,58,44,14,66
FC Salzburg,7867,3,18,10,8,58,32,26,64
Rapid Vienna,7867,4,17,9,10,56,33,23,60
Vienna,7867,5,18,4,14,64,57,7,58
RZ Pellets W,7867,6,11,7,18,44,56,-12,40
Admira Wacke,7867,7,11,6,19,38,67,-29,39
SV Josko Rie,7867,8,11,4,21,37,54,-17,37
St. Pölten,7867,9,8,10,18,38,66,-28,34
Mattersburg,7867,10,8,9,19,40,59,-19,33
FC Salzburg,7868,1,19,11,6,64,32,32,68
SC Rheindorf,7868,2,20,5,11,65,52,13,65
SK Sturm Gra,7868,3,18,9,9,65,40,25,63
Vienna,7868,4,17,5,14,59,55,4,56
Rapid Vienna,7868,5,14,12,10,55,39,16,54
RZ Pellets W,7868,6,15,7,14,56,53,3,52
Admira Wacke,7868,7,11,7,18,39,66,-27,40
Mattersburg,7868,8,8,11,17,41,57,-16,35
SV Josko Rie,7868,9,9,8,19,32,53,-21,35
St. Pölten,7868,10,7,9,20,39,68,-29,30
Vienna,7869,1,21,6,9,66,41,25,69
FC Salzburg,7869,2,18,12,6,64,27,37,66
SC Rheindorf,7869,3,19,8,9,53,42,11,65
SK Sturm Gra,7869,4,16,8,12,50,36,14,56
Rapid Vienna,7869,5,13,10,13,59,40,19,49
SV Josko Rie,7869,6,12,6,18,43,54,-11,42
Mattersburg,7869,7,11,8,17,40,64,-24,41
Admira Wacke,7869,8,11,8,17,36,62,-26,41
RZ Pellets W,7869,9,9,9,18,40,60,-20,36
St. Pölten,7869,10,8,9,19,40,65,-25,33
FC Salzburg,7870,1,22,6,8,70,30,40,72
SC Rheindorf,7870,2,19,8,9,55,43,12,65
SK Sturm Gra,7870,3,18,7,11,53,34,19,61
Vienna,7870,4,18,6,12,60,54,6,60
Rapid Vienna,7870,5,13,10,13,49,38,11,49
RZ Pellets W,7870,6,13,7,16,42,50,-8,46
Admira Wacke,7870,7,12,6,18,34,54,-20,42
Mattersburg,7870,8,9,11,16,35,52,-17,38
SV Josko Rie,7870,9,9,7,20,34,55,-21,34
St. Pölten,7870,10,7,12,17,36,58,-22,33
FC Salzburg,7871,1,25,6,5,73,25,48,81
SK Sturm Gra,7871,2,21,8,7,65,32,33,71
SC Rheindorf,7871,3,18,8,10,50,47,3,62
Vienna,7871,4,15,7,14,65,63,2,52
Admira Wacke,7871,5,13,9,14,40,55,-15,48
RZ Pellets W,7871,6,12,7,17,44,54,-10,43
Rapid Vienna,7871,7,10,12,14,48,48,0,42
SV Josko Rie,7871,8,10,8,18,34,51,-17,38
Mattersburg,7871,9,8,8,20,36,54,-18,32
St. Pölten,7871,10,6,11,19,34,60,-26,29
SK Sturm Gra,7872,1,22,6,8,63,33,30,72
SC Rheindorf,7872,2,21,8,7,61,41,20,71
FC Salzburg,7872,3,18,10,8,65,35,30,64
Rapid Vienna,7872,4,13,12,11,55,45,10,51
Vienna,7872,5,14,9,13,57,55,2,51
Admira Wacke,7872,6,13,4,19,42,56,-14,43
RZ Pellets W,7872,7,12,6,18,43,56,-13,42
St. Pölten,7872,8,11,9,16,43,57,-14,42
Mattersburg,7872,9,7,11,18,33,55,-22,32
SV Josko Rie,7872,10,9,5,22,27,56,-29,32
SC Rheindorf,7873,1,22,6,8,60,35,25,72
SK Sturm Gra,7873,2,20,5,11,61,37,24,65
FC Salzburg,7873,3,19,7,10,63,38,25,64
Vienna,7873,4,19,5,12,61,53,8,62
Rapid Vienna,7873,5,16,10,10,58,41,17,58
RZ Pellets W,7873,6,14,5,17,50,56,-6,47
Admira Wacke,7873,7,12,7,17,38,60,-22,43
SV Josko Rie,7873,8,10,6,20,30,54,-24,36
Mattersburg,7873,9,8,7,21,41,60,-19,31
St. Pölten,7873,10,7,8,21,40,68,-28,29
SK Sturm Gra,7874,1,22,5,9,68,36,32,71
FC Salzburg,7874,2,20,6,10,69,37,32,66
Rapid Vienna,7874,3,18,9,9,70,42,28,63
SC Rheindorf,7874,4,18,9,9,56,41,15,63
Vienna,7874,5,19,5,12,60,47,13,62
RZ Pellets W,7874,6,12,7,17,42,57,-15,43
St. Pölten,7874,7,12,6,18,42,60,-18,42
SV Josko Rie,7874,8,10,6,20,37,60,-23,36
Admira Wacke,7874,9,9,6,21,29,62,-33,33
Mattersburg,7874,10,7,7,22,33,64,-31,28
FC Salzburg,7875,1,23,8,5,66,26,40,77
SK Sturm Gra,7875,2,19,7,10,63,32,31,64
SC Rheindorf,7875,3,18,9,9,54,43,11,63
Vienna,7875,4,18,8,10,63,47,16,62
RZ Pellets W,7875,5,14,7,15,47,47,0,49
Rapid Vienna,7875,6,11,13,12,52,47,5,46
St. Pölten,7875,7,9,11,16,43,65,-22,38
Mattersburg,7875,8,8,9,19,37,60,-23,33
SV Josko Rie,7875,9,9,6,21,29,57,-28,33
Admira Wacke,7875,10,9,6,21,35,65,-30,33
FC Salzburg,7876,1,21,7,8,68,32,36,70
SK Sturm Gra,7876,2,21,4,11,61,38,23,67
Vienna,7876,3,19,6,11,67,56,11,63
SC Rheindorf,7876,4,16,9,11,51,42,9,57
Rapid Vienna,7876,5,14,9,13,54,43,11,51
St. Pölten,7876,6,12,11,13,51,59,-8,47
RZ Pellets W,7876,7,12,7,17,50,64,-14,43
Mattersburg,7876,8,10,7,19,38,51,-13,37
Admira Wacke,7876,9,10,6,20,34,60,-26,36
SV Josko Rie,7876,10,9,6,21,31,60,-29,33
FC Salzburg,7877,1,20,9,7,60,30,30,69
Vienna,7877,2,21,5,10,70,49,21,68
SK Sturm Gra,7877,3,18,8,10,53,36,17,62
SC Rheindorf,7877,4,16,11,9,50,40,10,59
Rapid Vienna,7877,5,15,11,10,53,35,18,56
RZ Pellets W,7877,6,10,10,16,49,61,-12,40
SV Josko Rie,7877,7,10,8,18,36,53,-17,38
Admira Wacke,7877,8,10,7,19,38,58,-20,37
Mattersburg,7877,9,8,10,18,33,55,-22,34
St. Pölten,7877,10,6,13,17,39,64,-25,31
SC Rheindorf,7878,1,21,10,5,56,32,24,73
FC Salzburg,7878,2,20,8,8,65,35,30,68
Vienna,7878,3,18,5,13,60,49,11,59
Rapid Vienna,7878,4,15,10,11,53,40,13,55
SK Sturm Gra,7878,5,16,7,13,50,39,11,55
RZ Pellets W,7878,6,16,6,14,52,53,-1,54
Admira Wacke,7878,7,12,6,18,40,60,-20,42
SV Josko Rie,7878,8,9,8,19,36,51,-15,35
St. Pölten,7878,9,9,7,20,36,61,-25,34
Mattersburg,7878,10,7,7,22,34,62,-28,28
FC Salzburg,7879,1,21,5,10,65,33,32,68
SC Rheindorf,7879,2,20,7,9,57,42,15,67
SK Sturm Gra,7879,3,20,6,10,60,30,30,66
Rapid Vienna,7879,4,18,9,9,64,42,22,63
Vienna,7879,5,18,7,11,58,51,7,61
Mattersburg,7879,6,12,8,16,40,51,-11,44
RZ Pellets W,7879,7,11,5,20,39,64,-25,38
Admira Wacke,7879,8,11,5,20,30,56,-26,38
St. Pölten,7879,9,9,8,19,42,61,-19,35
SV Josko Rie,7879,10,7,6,23,36,61,-25,27
SK Sturm Gra,7880,1,20,4,12,59,34,25,64
Vienna,7880,2,19,7,10,66,48,18,64
SC Rheindorf,7880,3,18,8,10,54,45,9,62
FC Salzburg,7880,4,17,10,9,57,32,25,61
Rapid Vienna,7880,5,13,12,11,55,40,15,51
RZ Pellets W,7880,6,14,6,16,41,53,-12,48
SV Josko Rie,7880,7,13,4,19,37,53,-16,43
St. Pölten,7880,8,10,10,16,36,53,-17,40
Mattersburg,7880,9,9,8,19,35,54,-19,35
Admira Wacke,7880,10,10,5,21,33,61,-28,35
FC Salzburg,7881,1,22,8,6,79,33,46,74
SK Sturm Gra,7881,2,20,8,8,64,36,28,68
SC Rheindorf,7881,3,18,10,8,57,43,14,64
Vienna,7881,4,17,6,13,63,57,6,57
Rapid Vienna,7881,5,12,15,9,57,43,14,51
RZ Pellets W,7881,6,13,8,15,52,55,-3,47
Admira Wacke,7881,7,11,7,18,38,60,-22,40
SV Josko Rie,7881,8,10,9,17,36,57,-21,39
Mattersburg,7881,9,6,10,20,37,66,-29,28
St. Pölten,7881,10,5,11,20,32,65,-33,26
FC Salzburg,7882,1,23,5,8,72,36,36,74
SK Sturm Gra,7882,2,19,7,10,60,39,21,64
SC Rheindorf,7882,3,17,11,8,54,43,11,62
Vienna,7882,4,16,5,15,57,57,0,53
Rapid Vienna,7882,5,13,12,11,61,49,12,51
RZ Pellets W,7882,6,13,8,15,47,50,-3,47
Admira Wacke,7882,7,13,8,15,38,49,-11,47
SV Josko Rie,7882,8,13,6,17,36,54,-18,45
Mattersburg,7882,9,7,9,20,40,62,-22,30
St. Pölten,7882,10,7,7,22,42,68,-26,28
FC Salzburg,7883,1,23,4,9,70,34,36,73
SC Rheindorf,7883,2,20,6,10,55,43,12,66
Vienna,7883,3,20,3,13,65,54,11,63
SK Sturm Gra,7883,4,19,5,12,58,37,21,62
Rapid Vienna,7883,5,16,9,11,56,41,15,57
RZ Pellets W,7883,6,11,8,17,51,62,-11,41
Admira Wacke,7883,7,11,7,18,40,62,-22,40
SV Josko Rie,7883,8,11,5,20,35,53,-18,38
Mattersburg,7883,9,10,6,20,47,64,-17,36
St. Pölten,7883,10,9,7,20,43,70,-27,34
SC Rheindorf,7884,1,20,8,8,56,36,20,68
SK Sturm Gra,7884,2,19,7,10,61,34,27,64
Vienna,7884,3,19,5,12,59,49,10,62
FC Salzburg,7884,4,16,12,8,60,32,28,60
Rapid Vienna,7884,5,13,11,12,59,45,14,50
RZ Pellets W,7884,6,12,10,14,45,50,-5,46
Admira Wacke,7884,7,12,4,20,37,59,-22,40
St. Pölten,7884,8,10,9,17,41,63,-22,39
Mattersburg,7884,9,10,7,19,33,57,-24,37
SV Josko Rie,7884,10,9,7,20,30,56,-26,34
FC Salzburg,7885,1,21,8,7,68,33,35,71
SK Sturm Gra,7885,2,21,8,7,67,36,31,71
Vienna,7885,3,20,5,11,68,52,16,65
SC Rheindorf,7885,4,18,10,8,56,48,8,64
Rapid Vienna,7885,5,13,9,14,53,44,9,48
Admira Wacke,7885,6,13,7,16,39,59,-20,46
SV Josko Rie,7885,7,11,3,22,37,53,-16,36
RZ Pellets W,7885,8,9,8,19,41,59,-18,35
Mattersburg,7885,9,9,7,20,40,62,-22,34
St. Pölten,7885,10,7,11,18,37,60,-23,32
FC Salzburg,7886,1,22,5,9,70,37,33,71
Vienna,7886,2,21,2,13,67,52,15,65
SC Rheindorf,7886,3,19,7,10,50,42,8,64
SK Sturm Gra,7886,4,19,6,11,56,35,21,63
Rapid Vienna,7886,5,15,11,10,65,42,23,56
RZ Pellets W,7886,6,14,6,16,52,63,-11,48
St. Pölten,7886,7,12,8,16,49,57,-8,44
Admira Wacke,7886,8,10,6,20,37,66,-29,36
SV Josko Rie,7886,9,10,2,24,37,63,-26,32
Mattersburg,7886,10,8,7,21,40,66,-26,31
SK Sturm Gra,7887,1,22,5,9,71,37,34,71
SC Rheindorf,7887,2,20,9,7,58,41,17,69
FC Salzburg,7887,3,19,10,7,68,31,37,67
Vienna,7887,4,16,6,14,62,55,7,54
Rapid Vienna,7887,5,11,14,11,56,47,9,47
RZ Pellets W,7887,6,12,7,17,42,56,-14,43
Admira Wacke,7887,7,12,7,17,43,65,-22,43
SV Josko Rie,7887,8,10,8,18,36,54,-18,38
Mattersburg,7887,9,9,7,20,35,63,-28,34
St. Pölten,7887,10,6,13,17,40,62,-22,31
FC Salzburg,7888,1,20,9,7,60,29,31,69
SC Rheindorf,7888,2,19,7,10,55,43,12,64
SK Sturm Gra,7888,3,17,10,9,63,41,22,61
Vienna,7888,4,18,7,11,66,53,13,61
Rapid Vienna,7888,5,13,10,13,57,51,6,49
SV Josko Rie,7888,6,12,7,17,35,47,-12,43
RZ Pellets W,7888,7,11,8,17,48,61,-13,41
St. Pölten,7888,8,8,14,14,48,61,-13,38
Admira Wacke,7888,9,9,10,17,36,59,-23,37
Mattersburg,7888,10,8,8,20,44,67,-23,32
FC Salzburg,7889,1,22,6,8,65,29,36,72
SK Sturm Gra,7889,2,19,9,8,55,30,25,66
SC Rheindorf,7889,3,18,9,9,63,47,16,63
Vienna,7889,4,17,7,12,68,55,13,58
Rapid Vienna,7889,5,14,11,11,56,37,19,53
RZ Pellets W,7889,6,13,11,12,54,54,0,50
Admira Wacke,7889,7,13,8,15,42,59,-17,47
SV Josko Rie,7889,8,11,4,21,34,61,-27,37
Mattersburg,7889,9,7,8,21,28,54,-26,29
St. Pölten,7889,10,5,9,22,36,75,-39,24
SC Rheindorf,7890,1,20,8,8,65,46,19,68
FC Salzburg,7890,2,17,10,9,59,37,22,61
SK Sturm Gra,7890,3,17,8,11,59,38,21,59
Vienna,7890,4,17,6,13,68,56,12,57
Rapid Vienna,7890,5,13,14,9,53,37,16,53
Admira Wacke,7890,6,14,6,16,34,49,-15,48
RZ Pellets W,7890,7,11,9,16,40,54,-14,42
Mattersburg,7890,8,10,10,16,41,54,-13,40
SV Josko Rie,7890,9,10,5,21,37,59,-22,35
St. Pölten,7890,10,7,12,17,41,67,-26,33
FC Salzburg,7891,1,22,9,5,68,27,41,75
SC Rheindorf,7891,2,21,7,8,55,37,18,70
SK Sturm Gra,7891,3,19,6,11,56,34,22,63
Vienna,7891,4,17,5,14,58,51,7,56
Rapid Vienna,7891,5,13,9,14,52,41,11,48
St. Pölten,7891,6,10,10,16,42,59,-17,40
RZ Pellets W,7891,7,11,6,19,40,57,-17,39
SV Josko Rie,7891,8,12,3,21,35,54,-19,39
Admira Wacke,7891,9,10,8,18,38,63,-25,38
Mattersburg,7891,10,9,9,18,38,59,-21,36
FC Salzburg,7892,1,24,6,6,69,34,35,78
SC Rheindorf,7892,2,20,9,7,60,39,21,69
SK Sturm Gra,7892,3,17,6,13,55,36,19,57
Rapid Vienna,7892,4,14,10,12,60,47,13,52
Vienna,7892,5,16,4,16,54,57,-3,52
RZ Pellets W,7892,6,14,5,17,41,53,-12,47
Admira Wacke,7892,7,12,6,18,34,52,-18,42
Mattersburg,7892,8,10,9,17,45,55,-10,39
St. Pölten,7892,9,9,9,18,36,61,-25,36
SV Josko Rie,7892,10,9,6,21,30,50,-20,33
SK Sturm Gra,7893,1,22,6,8,61,31,30,72
FC Salzburg,7893,2,20,10,6,64,29,35,70
Vienna,7893,3,21,3,12,71,52,19,66
SC Rheindorf,7893,4,18,9,9,56,44,12,63
Rapid Vienna,7893,5,16,8,12,59,41,18,56
Admira Wacke,7893,6,12,6,18,39,57,-18,42
RZ Pellets W,7893,7,10,10,16,42,59,-17,40
SV Josko Rie,7893,8,9,8,19,34,55,-21,35
St. Pölten,7893,9,7,10,19,37,67,-30,31
Mattersburg,7893,10,5,10,21,37,65,-28,25
SC Rheindorf,7894,1,19,10,7,53,38,15,67
FC Salzburg,7894,2,19,9,8,59,30,29,66
Vienna,7894,3,19,6,11,68,48,20,63
SK Sturm Gra,7894,4,17,9,10,53,35,18,60
Rapid Vienna,7894,5,14,13,9,60,39,21,55
RZ Pellets W,7894,6,9,13,14,46,66,-20,40
Admira Wacke,7894,7,10,9,17,47,70,-23,39
Mattersburg,7894,8,8,10,18,37,55,-18,34
St. Pölten,7894,9,8,10,18,44,64,-20,34
SV Josko Rie,7894,10,9,7,20,34,56,-22,34
SC Rheindorf,7895,1,21,7,8,61,45,16,70
FC Salzburg,7895,2,19,8,9,66,31,35,65
Vienna,7895,3,18,8,10,64,47,17,62
SK Sturm Gra,7895,4,17,6,13,56,39,17,57
Rapid Vienna,7895,5,11,15,10,61,41,20,48
RZ Pellets W,7895,6,13,8,15,48,57,-9,47
St. Pölten,7895,7,10,11,15,48,62,-14,41
Admira Wacke,7895,8,11,6,19,35,66,-31,39
SV Josko Rie,7895,9,9,11,16,32,51,-19,38
Mattersburg,7895,10,6,10,20,33,65,-32,28
SK Sturm Gra,7896,1,19,9,8,57,31,26,66
SC Rheindorf,7896,2,19,8,9,56,41,15,65
FC Salzburg,7896,3,18,9,9,61,36,25,63
Vienna,7896,4,17,9,10,66,50,16,60
Rapid Vienna,7896,5,12,12,12,54,43,11,48
RZ Pellets W,7896,6,12,9,15,43,50,-7,45
Admira Wacke,7896,7,13,5,18,37,53,-16,44
St. Pölten,7896,8,8,12,16,41,59,-18,36
SV Josko Rie,7896,9,10,6,20,31,58,-27,36
Mattersburg,7896,10,9,7,20,37,62,-25,34
FC Salzburg,7897,1,22,8,6,66,30,36,74
SC Rheindorf,7897,2,19,7,10,56,45,11,64
SK Sturm Gra,7897,3,17,9,10,57,36,21,60
Vienna,7897,4,18,5,13,54,47,7,59
Rapid Vienna,7897,5,12,13,11,48,35,13,49
RZ Pellets W,7897,6,11,11,14,44,52,-8,44
Admira Wacke,7897,7,12,8,16,43,58,-15,44
SV Josko Rie,7897,8,12,4,20,38,56,-18,40
Mattersburg,7897,9,8,9,19,35,52,-17,33
St. Pölten,7897,10,8,8,20,36,66,-30,32
SK Sturm Gra,7898,1,22,6,8,67,27,40,72
SC Rheindorf,7898,2,22,5,9,56,39,17,71
FC Salzburg,7898,3,19,8,9,55,29,26,65
Vienna,7898,4,21,2,13,59,49,10,65
Rapid Vienna,7898,5,15,9,12,56,36,20,54
RZ Pellets W,7898,6,12,8,16,41,54,-13,44
SV Josko Rie,7898,7,12,5,19,38,54,-16,41
Admira Wacke,7898,8,11,7,18,36,56,-20,40
St. Pölten,7898,9,7,9,20,35,70,-35,30
Mattersburg,7898,10,5,9,22,32,61,-29,24
SK Sturm Gra,7899,1,22,6,8,66,31,35,72
FC Salzburg,7899,2,20,8,8,66,29,37,68
Rapid Vienna,7899,3,17,12,7,61,33,28,63
SC Rheindorf,7899,4,17,9,10,52,50,2,60
Vienna,7899,5,15,7,14,53,52,1,52
RZ Pellets W,7899,6,12,9,15,45,54,-9,45
Mattersburg,7899,7,10,8,18,36,53,-17,38
SV Josko Rie,7899,8,10,6,20,39,58,-19,36
Admira Wacke,7899,9,10,6,20,33,63,-30,36
St. Pölten,7899,10,6,11,19,34,62,-28,29
FC Salzburg,7900,1,19,8,9,60,31,29,65
SC Rheindorf,7900,2,19,8,9,59,40,19,65
Vienna,7900,3,18,10,8,58,38,20,64
SK Sturm Gra,7900,4,18,7,11,53,33,20,61
Rapid Vienna,7900,5,15,12,9,59,36,23,57
RZ Pellets W,7900,6,13,7,16,44,54,-10,46
SV Josko Rie,7900,7,13,5,18,40,48,-8,44
Admira Wacke,7900,8,11,8,17,36,60,-24,41
Mattersburg,7900,9,7,9,20,36,69,-33,30
St. Pölten,7900,10,6,8,22,34,70,-36,26
SK Sturm Gra,7901,1,22,5,9,61,29,32,71
FC Salzburg,7901,2,21,7,8,64,25,39,70
SC Rheindorf,7901,3,17,9,10,53,40,13,60
Vienna,7901,4,17,5,14,53,50,3,56
Rapid Vienna,7901,5,12,14,10,47,39,8,50
SV Josko Rie,7901,6,14,8,14,38,42,-4,50
RZ Pellets W,7901,7,12,8,16,45,55,-10,44
Admira Wacke,7901,8,11,4,21,31,60,-29,37
Mattersburg,7901,9,6,12,18,33,58,-25,30
St. Pölten,7901,10,6,12,18,32,59,-27,30
FC Salzburg,7902,1,23,8,5,72,26,46,77
SK Sturm Gra,7902,2,20,8,8,66,36,30,68
SC Rheindorf,7902,3,19,6,11,53,45,8,63
Vienna,7902,4,19,3,14,59,52,7,60
Rapid Vienna,7902,5,15,11,10,56,40,16,56
RZ Pellets W,7902,6,14,5,17,47,51,-4,47
Admira Wacke,7902,7,9,8,19,37,61,-24,35
St. Pölten,7902,8,8,10,18,39,65,-26,34
SV Josko Rie,7902,9,9,6,21,30,61,-31,33
Mattersburg,7902,10,7,9,20,31,53,-22,30
SC Rheindorf,7903,1,22,8,6,60,37,23,74
SK Sturm Gra,7903,2,21,7,8,62,28,34,70
Vienna,7903,3,18,8,10,62,49,13,62
FC Salzburg,7903,4,17,8,11,57,35,22,59
Rapid Vienna,7903,5,12,13,11,51,40,11,49
Admira Wacke,7903,6,11,8,17,36,56,-20,41
SV Josko Rie,7903,7,12,5,19,31,52,-21,41
RZ Pellets W,7903,8,10,10,16,38,52,-14,40
Mattersburg,7903,9,8,9,19,33,53,-20,33
St. Pölten,7903,10,7,8,21,38,66,-28,29
FC Salzburg,7904,1,23,8,5,67,26,41,77
SC Rheindorf,7904,2,18,8,10,50,37,13,62
SK Sturm Gra,7904,3,18,7,11,58,32,26,61
Vienna,7904,4,17,7,12,64,55,9,58
Rapid Vienna,7904,5,13,11,12,55,42,13,50
RZ Pellets W,7904,6,13,8,15,48,52,-4,47
St. Pölten,7904,7,10,9,17,39,67,-28,39
Admira Wacke,7904,8,9,11,16,34,60,-26,38
SV Josko Rie,7904,9,10,5,21,32,52,-20,35
Mattersburg,7904,10,7,10,19,37,61,-24,31
FC Salzburg,7905,1,21,9,6,69,27,42,72
Vienna,7905,2,22,3,11,69,47,22,69
SC Rheindorf,7905,3,18,10,8,55,42,13,64
SK Sturm Gra,7905,4,19,6,11,61,43,18,63
Rapid Vienna,7905,5,13,11,12,55,42,13,50
RZ Pellets W,7905,6,12,9,15,48,52,-4,45
Admira Wacke,7905,7,10,8,18,31,54,-23,38
Mattersburg,7905,8,7,12,17,38,59,-21,33
SV Josko Rie,7905,9,8,8,20,27,50,-23,32
St. Pölten,7905,10,8,8,20,37,74,-37,32
SC Rheindorf,7906,1,21,8,7,58,38,20,71
Vienna,7906,2,21,3,12,70,53,17,66
SK Sturm Gra,7906,3,20,4,12,64,35,29,64
FC Salzburg,7906,4,18,8,10,60,37,23,62
Rapid Vienna,7906,5,12,11,13,53,43,10,47
SV Josko Rie,7906,6,13,5,18,35,56,-21,44
St. Pölten,7906,7,10,11,15,49,66,-17,41
Admira Wacke,7906,8,11,7,18,39,61,-22,40
RZ Pellets W,7906,9,10,8,18,44,61,-17,38
Mattersburg,7906,10,6,11,19,37,59,-22,29
Vienna,7907,1,20,8,8,68,50,18,68
SK Sturm Gra,7907,2,19,6,11,62,36,26,63
SC Rheindorf,7907,3,18,9,9,54,41,13,63
FC Salzburg,7907,4,17,8,11,66,40,26,59
Rapid Vienna,7907,5,16,9,11,62,42,20,57
RZ Pellets W,7907,6,13,10,13,47,51,-4,49
Admira Wacke,7907,7,13,6,17,40,62,-22,45
Mattersburg,7907,8,11,7,18,33,48,-15,40
St. Pölten,7907,9,7,9,20,35,66,-31,30
SV Josko Rie,7907,10,8,4,24,31,62,-31,28
FC Salzburg,7908,1,20,9,7,69,33,36,69
SK Sturm Gra,7908,2,19,9,8,58,31,27,66
SC Rheindorf,7908,3,17,10,9,53,42,11,61
Vienna,7908,4,16,7,13,54,49,5,55
SV Josko Rie,7908,5,15,4,17,44,46,-2,49
Admira Wacke,7908,6,15,3,18,39,60,-21,48
Rapid Vienna,7908,7,12,10,14,48,41,7,46
RZ Pellets W,7908,8,12,8,16,46,54,-8,44
Mattersburg,7908,9,10,6,20,40,66,-26,36
St. Pölten,7908,10,7,8,21,33,62,-29,29
SC Rheindorf,7909,1,24,6,6,67,38,29,78
FC Salzburg,7909,2,21,6,9,64,30,34,69
SK Sturm Gra,7909,3,18,6,12,53,36,17,60
Vienna,7909,4,18,5,13,63,55,8,59
Rapid Vienna,7909,5,12,13,11,55,42,13,49
RZ Pellets W,7909,6,12,6,18,38,52,-14,42
SV Josko Rie,7909,7,10,8,18,36,51,-15,38
St. Pölten,7909,8,9,11,16,43,62,-19,38
Admira Wacke,7909,9,10,7,19,31,57,-26,37
Mattersburg,7909,10,7,10,19,36,63,-27,31
FC Salzburg,7910,1,23,5,8,74,34,40,74
SC Rheindorf,7910,2,21,8,7,57,34,23,71
SK Sturm Gra,7910,3,19,6,11,59,39,20,63
Vienna,7910,4,16,3,17,58,64,-6,51
Mattersburg,7910,5,13,6,17,46,55,-9,45
Admira Wacke,7910,6,13,6,17,43,56,-13,45
Rapid Vienna,7910,7,11,11,14,51,45,6,44
RZ Pellets W,7910,8,11,9,16,45,56,-11,42
SV Josko Rie,7910,9,12,5,19,34,55,-21,41
St. Pölten,7910,10,8,7,21,37,66,-29,31
SK Sturm Gra,7911,1,20,7,9,58,34,24,67
Vienna,7911,2,18,7,11,66,48,18,61
FC Salzburg,7911,3,17,9,10,57,38,19,60
SC Rheindorf,7911,4,17,8,11,55,44,11,59
Rapid Vienna,7911,5,14,10,12,56,39,17,52
RZ Pellets W,7911,6,12,10,14,51,56,-5,46
SV Josko Rie,7911,7,12,7,17,31,45,-14,43
Admira Wacke,7911,8,12,6,18,36,56,-20,42
Mattersburg,7911,9,9,10,17,36,58,-22,37
St. Pölten,7911,10,7,10,19,36,64,-28,31
SC Rheindorf,7912,1,21,8,7,60,38,22,71
FC Salzburg,7912,2,21,7,8,65,30,35,70
Vienna,7912,3,19,6,11,61,53,8,63
SK Sturm Gra,7912,4,18,7,11,52,33,19,61
Rapid Vienna,7912,5,14,11,11,56,40,16,53
Admira Wacke,7912,6,10,10,16,39,57,-18,40
RZ Pellets W,7912,7,10,8,18,42,61,-19,38
Mattersburg,7912,8,9,10,17,38,51,-13,37
St. Pölten,7912,9,8,10,18,39,59,-20,34
SV Josko Rie,7912,10,10,3,23,34,64,-30,33
SC Rheindorf,7913,1,21,8,7,61,38,23,71
FC Salzburg,7913,2,21,6,9,69,30,39,69
SK Sturm Gra,7913,3,20,7,9,53,32,21,67
Vienna,7913,4,18,6,12,64,54,10,60
Rapid Vienna,7913,5,15,11,10,58,40,18,56
Admira Wacke,7913,6,14,5,17,41,57,-16,47
RZ Pellets W,7913,7,12,10,14,45,57,-12,46
St. Pölten,7913,8,6,11,19,33,62,-29,29
Mattersburg,7913,9,6,10,20,34,60,-26,28
SV Josko Rie,7913,10,7,6,23,28,56,-28,27
FC Salzburg,7914,1,22,6,8,67,29,38,72
SK Sturm Gra,7914,2,18,7,11,59,38,21,61
Vienna,7914,3,18,5,13,65,55,10,59
SC Rheindorf,7914,4,17,8,11,52,47,5,59
SV Josko Rie,7914,5,15,3,18,40,51,-11,48
Rapid Vienna,7914,6,11,13,12,49,42,7,46
RZ Pellets W,7914,7,12,9,15,45,60,-15,45
Admira Wacke,7914,8,13,6,17,36,55,-19,45
St. Pölten,7914,9,11,7,18,41,58,-17,40
Mattersburg,7914,10,7,8,21,39,58,-19,29
SC Rheindorf,7915,1,19,10,7,60,47,13,67
SK Sturm Gra,7915,2,19,6,11,60,38,22,63
Rapid Vienna,7915,3,17,10,9,63,41,22,61
FC Salzburg,7915,4,16,9,11,59,39,20,57
Vienna,7915,5,17,5,14,71,64,7,56
RZ Pellets W,7915,6,12,9,15,43,54,-11,45
SV Josko Rie,7915,7,10,8,18,35,51,-16,38
Mattersburg,7915,8,9,10,17,37,50,-13,37
St. Pölten,7915,9,9,10,17,44,60,-16,37
Admira Wacke,7915,10,8,11,17,34,62,-28,35
SK Sturm Gra,7916,1,24,6,6,67,29,38,78
FC Salzburg,7916,2,20,7,9,63,38,25,67
Vienna,7916,3,20,6,10,63,44,19,66
SC Rheindorf,7916,4,18,9,9,53,39,14,63
Rapid Vienna,7916,5,11,15,10,50,39,11,48
RZ Pellets W,7916,6,13,9,14,51,52,-1,48
SV Josko Rie,7916,7,12,5,19,37,57,-20,41
Mattersburg,7916,8,8,8,20,37,58,-21,32
Admira Wacke,7916,9,9,4,23,36,68,-32,31
St. Pölten,7916,10,6,9,21,38,71,-33,27
FC Salzburg,7917,1,23,6,7,72,31,41,75
SK Sturm Gra,7917,2,19,9,8,65,37,28,66
Vienna,7917,3,18,6,12,71,64,7,60
SC Rheindorf,7917,4,18,6,12,52,49,3,60
Rapid Vienna,7917,5,13,10,13,52,42,10,49
Admira Wacke,7917,6,13,6,17,40,55,-15,45
SV Josko Rie,7917,7,12,6,18,42,56,-14,42
RZ Pellets W,7917,8,11,8,17,41,53,-12,41
St. Pölten,7917,9,9,11,16,44,58,-14,38
Mattersburg,7917,10,5,10,21,33,67,-34,25
FC Salzburg,7918,1,19,9,8,59,34,25,66
SK Sturm Gra,7918,2,19,8,9,62,35,27,65
Vienna,7918,3,19,7,10,65,48,17,64
SC Rheindorf,7918,4,18,7,11,53,44,9,61
Rapid Vienna,7918,5,14,10,12,55,38,17,52
Mattersburg,7918,6,13,8,15,48,51,-3,47
RZ Pellets W,7918,7,11,9,16,41,53,-12,42
Admira Wacke,7918,8,10,8,18,37,66,-29,38
St. Pölten,7918,9,6,13,17,43,68,-25,31
SV Josko Rie,7918,10,8,7,21,30,56,-26,31
SC Rheindorf,7919,1,21,6,9,60,43,17,69
SK Sturm Gra,7919,2,19,6,11,55,39,16,63
FC Salzburg,7919,3,17,9,10,60,34,26,60
Vienna,7919,4,18,6,12,60,54,6,60
Rapid Vienna,7919,5,15,9,12,56,46,10,54
Admira Wacke,7919,6,12,11,13,41,49,-8,47
RZ Pellets W,7919,7,10,11,15,45,50,-5,41
SV Josko Rie,7919,8,11,5,20,36,58,-22,38
Mattersburg,7919,9,9,9,18,43,61,-18,36
St. Pölten,7919,10,8,8,20,42,64,-22,32
Vienna,7920,1,23,4,9,71,45,26,73
FC Salzburg,7920,2,21,5,10,64,35,29,68
SC Rheindorf,7920,3,17,8,11,51,45,6,59
SK Sturm Gra,7920,4,16,5,15,58,40,18,53
Rapid Vienna,7920,5,13,11,12,58,42,16,50
St. Pölten,7920,6,14,6,16,48,61,-13,48
Admira Wacke,7920,7,13,6,17,35,54,-19,45
RZ Pellets W,7920,8,11,7,18,45,62,-17,40
SV Josko Rie,7920,9,11,5,20,34,57,-23,38
Mattersburg,7920,10,9,7,20,39,62,-23,34
SC Rheindorf,7921,1,24,6,6,70,39,31,78
FC Salzburg,7921,2,20,5,11,66,40,26,65
SK Sturm Gra,7921,3,18,9,9,58,33,25,63
Vienna,7921,4,19,6,11,59,45,14,63
Rapid Vienna,7921,5,12,11,13,53,48,5,47
RZ Pellets W,7921,6,12,11,13,50,55,-5,47
Admira Wacke,7921,7,13,6,17,37,55,-18,45
Mattersburg,7921,8,11,7,18,41,60,-19,40
St. Pölten,7921,9,8,8,20,37,63,-26,32
SV Josko Rie,7921,10,7,3,26,31,64,-33,24
FC Salzburg,7922,1,24,6,6,69,28,41,78
SK Sturm Gra,7922,2,19,7,10,57,33,24,64
SC Rheindorf,7922,3,19,7,10,60,48,12,64
Vienna,7922,4,19,6,11,67,48,19,63
Rapid Vienna,7922,5,15,8,13,54,41,13,53
SV Josko Rie,7922,6,13,5,18,42,56,-14,44
Admira Wacke,7922,7,12,6,18,35,56,-21,42
RZ Pellets W,7922,8,10,8,18,43,60,-17,38
St. Pölten,7922,9,7,9,20,38,66,-28,30
Mattersburg,7922,10,7,8,21,38,67,-29,29
FC Salzburg,7923,1,21,7,8,66,33,33,70
SC Rheindorf,7923,2,20,8,8,52,39,13,68
Vienna,7923,3,19,7,10,65,41,24,64
SK Sturm Gra,7923,4,18,6,12,58,48,10,60
Rapid Vienna,7923,5,16,10,10,72,44,28,58
Admira Wacke,7923,6,11,9,16,36,52,-16,42
RZ Pellets W,7923,7,10,9,17,42,66,-24,39
Mattersburg,7923,8,9,9,18,40,59,-19,36
SV Josko Rie,7923,9,9,5,22,32,57,-25,32
St. Pölten,7923,10,6,12,18,43,67,-24,30
FC Salzburg,7924,1,20,9,7,66,35,31,69
SC Rheindorf,7924,2,21,6,9,61,42,19,69
SK Sturm Gra,7924,3,20,6,10,60,35,25,66
Vienna,7924,4,20,6,10,68,51,17,66
Rapid Vienna,7924,5,11,11,14,50,43,7,44
Mattersburg,7924,6,12,8,16,36,48,-12,44
SV Josko Rie,7924,7,11,6,19,32,50,-18,39
RZ Pellets W,7924,8,10,8,18,39,52,-13,38
Admira Wacke,7924,9,9,7,20,33,66,-33,34
St. Pölten,7924,10,7,11,18,35,58,-23,32
SK Sturm Gra,7925,1,25,4,7,69,31,38,79
FC Salzburg,7925,2,23,5,8,68,28,40,74
SC Rheindorf,7925,3,22,4,10,59,39,20,70
Rapid Vienna,7925,4,17,9,10,60,37,23,60
Vienna,7925,5,17,5,14,57,55,2,56
RZ Pellets W,7925,6,9,10,17,45,59,-14,37
Admira Wacke,7925,7,10,6,20,31,62,-31,36
Mattersburg,7925,8,8,11,17,41,59,-18,35
St. Pölten,7925,9,5,13,18,33,63,-30,28
SV Josko Rie,7925,10,7,7,22,30,60,-30,28
FC Salzburg,7926,1,23,8,5,69,23,46,77
SC Rheindorf,7926,2,22,7,7,64,40,24,73
SK Sturm Gra,7926,3,20,6,10,65,33,32,66
Rapid Vienna,7926,4,12,13,11,51,42,9,49
Vienna,7926,5,13,9,14,52,57,-5,48
RZ Pellets W,7926,6,12,7,17,45,64,-19,43
St. Pölten,7926,7,10,9,17,42,64,-22,39
Admira Wacke,7926,8,11,6,19,37,59,-22,39
SV Josko Rie,7926,9,9,6,21,34,58,-24,33
Mattersburg,7926,10,7,11,18,40,59,-19,32
SC Rheindorf,7927,1,21,8,7,61,42,19,71
FC Salzburg,7927,2,17,7,12,63,43,20,58
SK Sturm Gra,7927,3,16,9,11,51,35,16,57
Vienna,7927,4,16,8,12,60,51,9,56
Rapid Vienna,7927,5,15,10,11,57,40,17,55
St. Pölten,7927,6,14,7,15,50,55,-5,49
Admira Wacke,7927,7,12,6,18,39,58,-19,42
RZ Pellets W,7927,8,11,8,17,46,64,-18,41
Mattersburg,7927,9,9,9,18,39,54,-15,36
SV Josko Rie,7927,10,9,8,19,34,58,-24,35
FC Salzburg,7928,1,21,7,8,65,31,34,70
Vienna,7928,2,20,6,10,66,44,22,66
SC Rheindorf,7928,3,20,5,11,56,41,15,65
Rapid Vienna,7928,4,18,8,10,62,34,28,62
SK Sturm Gra,7928,5,19,5,12,57,43,14,62
Admira Wacke,7928,6,13,5,18,36,56,-20,44
RZ Pellets W,7928,7,9,8,19,39,58,-19,35
SV Josko Rie,7928,8,9,8,19,33,57,-24,35
Mattersburg,7928,9,9,7,20,37,59,-22,34
St. Pölten,7928,10,7,11,18,37,65,-28,32
FC Salzburg,7929,1,23,9,4,70,27,43,78
Vienna,7929,2,21,5,10,71,53,18,68
SK Sturm Gra,7929,3,19,8,9,62,36,26,65
SC Rheindorf,7929,4,19,7,10,63,48,15,64
Rapid Vienna,7929,5,13,11,12,57,47,10,50
Admira Wacke,7929,6,11,8,17,36,60,-24,41
St. Pölten,7929,7,8,11,17,40,64,-24,35
RZ Pellets W,7929,8,8,10,18,43,62,-19,34
Mattersburg,7929,9,8,9,19,45,61,-16,33
SV Josko Rie,7929,10,7,8,21,31,60,-29,29
FC Salzburg,7930,1,18,11,7,56,29,27,65
SK Sturm Gra,7930,2,18,9,9,61,35,26,63
SC Rheindorf,7930,3,18,7,11,56,46,10,61
Rapid Vienna,7930,4,16,10,10,56,37,19,58
RZ Pellets W,7930,5,16,6,14,52,50,2,54
Vienna,7930,6,15,5,16,57,57,0,50
Admira Wacke,7930,7,15,5,16,43,54,-11,50
SV Josko Rie,7930,8,12,6,18,36,50,-14,42
St. Pölten,7930,9,6,12,18,39,70,-31,30
Mattersburg,7930,10,6,9,21,30,58,-28,27
SC Rheindorf,7931,1,20,8,8,64,43,21,68
SK Sturm Gra,7931,2,20,7,9,59,32,27,67
FC Salzburg,7931,3,19,8,9,59,32,27,65
Vienna,7931,4,20,4,12,63,54,9,64
Rapid Vienna,7931,5,17,9,10,61,43,18,60
St. Pölten,7931,6,10,11,15,48,57,-9,41
Admira Wacke,7931,7,11,7,18,30,55,-25,40
RZ Pellets W,7931,8,11,5,20,44,60,-16,38
SV Josko Rie,7931,9,8,8,20,23,48,-25,32
Mattersburg,7931,10,7,7,22,35,62,-27,28
FC Salzburg,7932,1,22,7,7,66,31,35,73
SC Rheindorf,7932,2,19,9,8,51,35,16,66
SK Sturm Gra,7932,3,19,8,9,58,34,24,65
Vienna,7932,4,17,7,12,59,50,9,58
Rapid Vienna,7932,5,15,11,10,56,35,21,56
Admira Wacke,7932,6,14,5,17,41,53,-12,47
RZ Pellets W,7932,7,12,6,18,45,57,-12,42
SV Josko Rie,7932,8,9,7,20,32,57,-25,34
Mattersburg,7932,9,7,10,19,34,56,-22,31
St. Pölten,7932,10,5,12,19,41,75,-34,27
SC Rheindorf,7933,1,20,7,9,55,41,14,67
FC Salzburg,7933,2,18,8,10,62,40,22,62
Vienna,7933,3,18,7,11,63,55,8,61
SK Sturm Gra,7933,4,17,8,11,52,32,20,59
Admira Wacke,7933,5,16,4,16,44,54,-10,52
Rapid Vienna,7933,6,13,10,13,51,44,7,49
SV Josko Rie,7933,7,14,4,18,43,48,-5,46
RZ Pellets W,7933,8,12,8,16,47,56,-9,44
Mattersburg,7933,9,7,13,16,43,56,-13,34
St. Pölten,7933,10,5,11,20,36,70,-34,26
SC Rheindorf,7934,1,21,6,9,54,39,15,69
FC Salzburg,7934,2,18,9,9,62,33,29,63
SK Sturm Gra,7934,3,18,7,11,62,37,25,61
Vienna,7934,4,18,6,12,65,57,8,60
Rapid Vienna,7934,5,13,12,11,58,47,11,51
Admira Wacke,7934,6,13,6,17,38,56,-18,45
Mattersburg,7934,7,10,9,17,41,51,-10,39
RZ Pellets W,7934,8,10,9,17,48,62,-14,39
SV Josko Rie,7934,9,10,6,20,36,61,-25,36
St. Pölten,7934,10,7,14,15,41,62,-21,35
FC Salzburg,7935,1,21,9,6,62,29,33,72
SK Sturm Gra,7935,2,20,6,10,59,33,26,66
SC Rheindorf,7935,3,19,8,9,61,50,11,65
Vienna,7935,4,19,5,12,60,44,16,62
Rapid Vienna,7935,5,18,7,11,64,38,26,61
Admira Wacke,7935,6,11,7,18,38,58,-20,40
SV Josko Rie,7935,7,10,7,19,34,50,-16,37
RZ Pellets W,7935,8,10,7,19,40,63,-23,37
St. Pölten,7935,9,8,10,18,45,74,-29,34
Mattersburg,7935,10,7,8,21,33,57,-24,29
FC Salzburg,7936,1,22,7,7,66,29,37,73
Vienna,7936,2,22,6,8,66,44,22,72
SK Sturm Gra,7936,3,20,6,10,64,37,27,66
SC Rheindorf,7936,4,16,10,10,53,45,8,58
Rapid Vienna,7936,5,14,11,11,53,39,14,53
RZ Pellets W,7936,6,12,7,17,41,58,-17,43
SV Josko Rie,7936,7,11,5,20,38,56,-18,38
St. Pölten,7936,8,8,10,18,42,57,-15,34
Admira Wacke,7936,9,10,4,22,34,70,-36,34
Mattersburg,7936,10,7,10,19,42,64,-22,31
FC Salzburg,7937,1,20,9,7,68,33,35,69
SK Sturm Gra,7937,2,19,6,11,56,35,21,63
Vienna,7937,3,19,6,11,65,52,13,63
SC Rheindorf,7937,4,19,6,11,57,48,9,63
Rapid Vienna,7937,5,15,10,11,59,39,20,55
RZ Pellets W,7937,6,13,4,19,48,57,-9,43
Admira Wacke,7937,7,13,4,19,38,61,-23,43
SV Josko Rie,7937,8,11,4,21,36,59,-23,37
St. Pölten,7937,9,9,9,18,39,62,-23,36
Mattersburg,7937,10,9,8,19,35,55,-20,35
FC Salzburg,7938,1,21,7,8,70,34,36,70
SC Rheindorf,7938,2,19,7,10,57,48,9,64
SK Sturm Gra,7938,3,18,8,10,58,38,20,62
Rapid Vienna,7938,4,17,9,10,58,37,21,60
Admira Wacke,7938,5,17,5,14,44,49,-5,56
Vienna,7938,6,17,3,16,65,62,3,54
RZ Pellets W,7938,7,12,8,16,42,58,-16,44
St. Pölten,7938,8,9,9,18,45,62,-17,36
SV Josko Rie,7938,9,11,3,22,34,59,-25,36
Mattersburg,7938,10,6,7,23,33,59,-26,25
FC Salzburg,7939,1,23,5,8,70,29,41,74
SK Sturm Gra,7939,2,20,6,10,63,33,30,66
SC Rheindorf,7939,3,19,9,8,54,46,8,66
Vienna,7939,4,20,3,13,64,51,13,63
RZ Pellets W,7939,5,15,5,16,49,59,-10,50
Rapid Vienna,7939,6,12,10,14,60,42,18,46
SV Josko Rie,7939,7,13,5,18,37,54,-17,44
Mattersburg,7939,8,9,10,17,41,55,-14,37
St. Pölten,7939,9,7,10,19,34,71,-37,31
Admira Wacke,7939,10,8,5,23,29,61,-32,29
FC Salzburg,7940,1,23,7,6,71,28,43,76
SK Sturm Gra,7940,2,19,7,10,61,34,27,64
Vienna,7940,3,18,7,11,59,50,9,61
SC Rheindorf,7940,4,16,9,11,48,43,5,57
RZ Pellets W,7940,5,15,7,14,52,53,-1,52
Rapid Vienna,7940,6,13,10,13,50,40,10,49
Admira Wacke,7940,7,11,6,19,38,64,-26,39
SV Josko Rie,7940,8,11,4,21,29,59,-30,37
Mattersburg,7940,9,8,10,18,36,51,-15,34
St. Pölten,7940,10,7,11,18,38,60,-22,32
FC Salzburg,7941,1,22,8,6,63,26,37,74
Vienna,7941,2,19,5,12,62,48,14,62
SK Sturm Gra,7941,3,18,7,11,59,34,25,61
SC Rheindorf,7941,4,17,8,11,50,48,2,59
Rapid Vienna,7941,5,14,10,12,47,37,10,52
RZ Pellets W,7941,6,13,7,16,44,48,-4,46
SV Josko Rie,7941,7,13,6,17,42,52,-10,45
Admira Wacke,7941,8,11,8,17,34,55,-21,41
St. Pölten,7941,9,10,7,19,42,69,-27,37
Mattersburg,7941,10,6,8,22,32,58,-26,26
SC Rheindorf,7942,1,19,11,6,57,40,17,68
FC Salzburg,7942,2,19,9,8,60,33,27,66
Rapid Vienna,7942,3,18,10,8,62,34,28,64
SK Sturm Gra,7942,4,18,7,11,57,34,23,61
Vienna,7942,5,17,6,13,59,52,7,57
SV Josko Rie,7942,6,12,7,17,37,51,-14,43
Admira Wacke,7942,7,10,9,17,38,59,-21,39
Mattersburg,7942,8,10,7,19,40,56,-16,37
RZ Pellets W,7942,9,9,5,22,41,63,-22,32
St. Pölten,7942,10,7,11,18,40,69,-29,32
FC Salzburg,7943,1,24,6,6,67,24,43,78
SC Rheindorf,7943,2,22,5,9,59,41,18,71
SK Sturm Gra,7943,3,20,8,8,61,31,30,68
Vienna,7943,4,20,3,13,61,51,10,63
Rapid Vienna,7943,5,14,10,12,54,38,16,52
RZ Pellets W,7943,6,11,8,17,42,57,-15,41
Admira Wacke,7943,7,10,9,17,36,59,-23,39
SV Josko Rie,7943,8,11,5,20,36,54,-18,38
Mattersburg,7943,9,7,6,23,36,65,-29,27
St. Pölten,7943,10,5,12,19,33,65,-32,27
FC Salzburg,7944,1,23,8,5,72,26,46,77
Vienna,7944,2,20,4,12,65,51,14,64
SK Sturm Gra,7944,3,18,7,11,58,34,24,61
SC Rheindorf,7944,4,17,7,12,52,48,4,58
RZ Pellets W,7944,5,14,8,14,49,55,-6,50
Rapid Vienna,7944,6,11,16,9,53,42,11,49
SV Josko Rie,7944,7,13,5,18,46,60,-14,44
Admira Wacke,7944,8,9,7,20,35,65,-30,34
Mattersburg,7944,9,6,12,18,33,56,-23,30
St. Pölten,7944,10,6,12,18,45,71,-26,30
FC Salzburg,7945,1,24,7,5,77,32,45,79
SK Sturm Gra,7945,2,19,6,11,66,43,23,63
SC Rheindorf,7945,3,17,10,9,57,48,9,61
Vienna,7945,4,17,4,15,61,57,4,55
Rapid Vienna,7945,5,12,12,12,50,41,9,48
RZ Pellets W,7945,6,13,8,15,49,52,-3,47
Mattersburg,7945,7,11,11,14,46,54,-8,44
SV Josko Rie,7945,8,10,7,19,33,56,-23,37
Admira Wacke,7945,9,10,7,19,32,59,-27,37
St. Pölten,7945,10,6,10,20,46,75,-29,28
FC Salzburg,7946,1,21,8,7,70,32,38,71
SC Rheindorf,7946,2,22,5,9,64,43,21,71
SK Sturm Gra,7946,3,20,7,9,64,32,32,67
Vienna,7946,4,17,7,12,59,52,7,58
Rapid Vienna,7946,5,12,11,13,55,47,8,47
RZ Pellets W,7946,6,11,8,17,43,58,-15,41
Admira Wacke,7946,7,11,7,18,34,62,-28,40
Mattersburg,7946,8,11,6,19,38,56,-18,39
St. Pölten,7946,9,9,9,18,43,62,-19,36
SV Josko Rie,7946,10,10,4,22,33,59,-26,34
SK Sturm Gra,7947,1,22,4,10,64,32,32,70
Vienna,7947,2,21,5,10,68,56,12,68
FC Salzburg,7947,3,18,8,10,64,35,29,62
Rapid Vienna,7947,4,14,12,10,59,41,18,54
SC Rheindorf,7947,5,15,8,13,44,46,-2,53
Mattersburg,7947,6,11,10,15,48,57,-9,43
St. Pölten,7947,7,10,11,15,44,57,-13,41
RZ Pellets W,7947,8,11,7,18,45,58,-13,40
SV Josko Rie,7947,9,11,5,20,30,48,-18,38
Admira Wacke,7947,10,10,4,22,36,72,-36,34
FC Salzburg,7948,1,25,5,6,70,29,41,80
Vienna,7948,2,21,3,12,64,49,15,66
SC Rheindorf,7948,3,19,8,9,57,43,14,65
SK Sturm Gra,7948,4,17,6,13,58,38,20,57
Rapid Vienna,7948,5,14,11,11,60,44,16,53
RZ Pellets W,7948,6,14,8,14,43,53,-10,50
St. Pölten,7948,7,9,11,16,47,65,-18,38
Mattersburg,7948,8,10,8,18,36,58,-22,38
SV Josko Rie,7948,9,9,4,23,30,51,-21,31
Admira Wacke,7948,10,8,4,24,28,63,-35,28
FC Salzburg,7949,1,19,11,6,67,29,38,68
SK Sturm Gra,7949,2,20,6,10,59,35,24,66
SC Rheindorf,7949,3,19,7,10,56,45,11,64
Vienna,7949,4,17,7,12,61,52,9,58
Rapid Vienna,7949,5,14,13,9,61,40,21,55
RZ Pellets W,7949,6,12,9,15,44,56,-12,45
SV Josko Rie,7949,7,11,6,19,29,51,-22,39
Mattersburg,7949,8,10,8,18,43,53,-10,38
Admira Wacke,7949,9,10,7,19,38,64,-26,37
St. Pölten,7949,10,7,8,21,38,71,-33,29
SK Sturm Gra,7950,1,20,8,8,59,30,29,68
FC Salzburg,7950,2,20,7,9,68,36,32,67
Vienna,7950,3,19,4,13,60,50,10,61
SC Rheindorf,7950,4,16,12,8,50,40,10,60
Admira Wacke,7950,5,12,8,16,34,50,-16,44
Rapid Vienna,7950,6,11,10,15,52,52,0,43
Mattersburg,7950,7,12,7,17,43,52,-9,43
RZ Pellets W,7950,8,11,7,18,43,53,-10,40
SV Josko Rie,7950,9,12,4,20,37,57,-20,40
St. Pölten,7950,10,10,7,19,43,69,-26,37
SK Sturm Gra,7951,1,23,5,8,76,33,43,74
FC Salzburg,7951,2,21,8,7,65,32,33,71
SC Rheindorf,7951,3,19,8,9,58,44,14,65
Vienna,7951,4,19,6,11,69,59,10,63
St. Pölten,7951,5,14,8,14,52,62,-10,50
Rapid Vienna,7951,6,11,9,16,48,44,4,42
SV Josko Rie,7951,7,12,4,20,36,51,-15,40
RZ Pellets W,7951,8,10,7,19,45,67,-22,37
Admira Wacke,7951,9,10,6,20,38,68,-30,36
Mattersburg,7951,10,7,7,22,36,63,-27,28
FC Salzburg,7952,1,20,8,8,62,35,27,68
Vienna,7952,2,21,4,11,66,50,16,67
SC Rheindorf,7952,3,19,9,8,57,39,18,66
SK Sturm Gra,7952,4,18,8,10,58,32,26,62
Rapid Vienna,7952,5,12,13,11,54,41,13,49
Admira Wacke,7952,6,11,10,15,38,53,-15,43
SV Josko Rie,7952,7,12,4,20,32,56,-24,40
RZ Pellets W,7952,8,10,7,19,35,55,-20,37
Mattersburg,7952,9,8,11,17,36,50,-14,35
St. Pölten,7952,10,7,10,19,39,66,-27,31
FC Salzburg,7953,1,22,7,7,67,33,34,73
Vienna,7953,2,19,7,10,58,44,14,64
SK Sturm Gra,7953,3,19,5,12,56,36,20,62
SC Rheindorf,7953,4,17,6,13,51,45,6,57
Rapid Vienna,7953,5,13,11,12,55,39,16,50
RZ Pellets W,7953,6,12,10,14,44,51,-7,46
St. Pölten,7953,7,10,11,15,41,55,-14,41
Mattersburg,7953,8,10,10,16,40,53,-13,40
Admira Wacke,7953,9,12,4,20,36,63,-27,40
SV Josko Rie,7953,10,8,5,23,27,56,-29,29
FC Salzburg,7954,1,23,4,9,76,30,46,73
SK Sturm Gra,7954,2,20,6,10,65,37,28,66
Vienna,7954,3,20,5,11,65,50,15,65
Rapid Vienna,7954,4,15,11,10,61,44,17,56
SC Rheindorf,7954,5,15,11,10,54,51,3,56
RZ Pellets W,7954,6,13,10,13,51,55,-4,49
St. Pölten,7954,7,10,7,19,40,61,-21,37
Mattersburg,7954,8,8,10,18,38,59,-21,34
Admira Wacke,7954,9,10,4,22,37,66,-29,34
SV Josko Rie,7954,10,8,8,20,26,60,-34,32
SK Sturm Gra,7955,1,21,7,8,59,37,22,70
FC Salzburg,7955,2,20,9,7,65,29,36,69
SC Rheindorf,7955,3,16,11,9,59,47,12,59
Vienna,7955,4,16,11,9,58,48,10,59
Rapid Vienna,7955,5,14,11,11,58,40,18,53
RZ Pellets W,7955,6,15,8,13,48,53,-5,53
St. Pölten,7955,7,10,8,18,43,62,-19,38
Admira Wacke,7955,8,9,7,20,37,64,-27,34
SV Josko Rie,7955,9,6,11,19,28,54,-26,29
Mattersburg,7955,10,5,13,18,36,57,-21,28
SK Sturm Gra,7956,1,21,7,8,63,33,30,70
FC Salzburg,7956,2,19,8,9,60,33,27,65
SC Rheindorf,7956,3,17,8,11,55,49,6,59
Rapid Vienna,7956,4,15,10,11,55,37,18,55
Vienna,7956,5,14,7,15,57,58,-1,49
SV Josko Rie,7956,6,14,5,17,38,53,-15,47
Admira Wacke,7956,7,12,7,17,35,52,-17,43
RZ Pellets W,7956,8,11,7,18,45,56,-11,40
Mattersburg,7956,9,10,9,17,35,48,-13,39
St. Pölten,7956,10,7,12,17,38,62,-24,33
FC Salzburg,7957,1,22,7,7,62,25,37,73
SK Sturm Gra,7957,2,20,7,9,58,32,26,67
Vienna,7957,3,19,3,14,63,50,13,60
SC Rheindorf,7957,4,17,8,11,51,47,4,59
Rapid Vienna,7957,5,14,12,10,58,40,18,54
Admira Wacke,7957,6,12,6,18,39,61,-22,42
RZ Pellets W,7957,7,10,9,17,44,59,-15,39
Mattersburg,7957,8,11,6,19,35,53,-18,39
SV Josko Rie,7957,9,10,6,20,33,52,-19,36
St. Pölten,7957,10,8,10,18,43,67,-24,34
SK Sturm Gra,7958,1,21,7,8,59,31,28,70
FC Salzburg,7958,2,20,7,9,68,35,33,67
Vienna,7958,3,20,5,11,65,45,20,65
Rapid Vienna,7958,4,18,9,9,62,39,23,63
SC Rheindorf,7958,5,18,8,10,54,41,13,62
RZ Pellets W,7958,6,9,10,17,38,56,-18,37
SV Josko Rie,7958,7,11,4,21,32,52,-20,37
Mattersburg,7958,8,9,9,18,35,59,-24,36
St. Pölten,7958,9,9,8,19,40,61,-21,35
Admira Wacke,7958,10,9,5,22,34,68,-34,32
FC Salzburg,7959,1,22,6,8,67,30,37,72
SK Sturm Gra,7959,2,22,5,9,67,32,35,71
SC Rheindorf,7959,3,18,9,9,57,50,7,63
Vienna,7959,4,15,10,11,63,56,7,55
Rapid Vienna,7959,5,15,9,12,55,42,13,54
RZ Pellets W,7959,6,13,8,15,44,53,-9,47
Admira Wacke,7959,7,11,7,18,33,60,-27,40
SV Josko Rie,7959,8,10,6,20,35,54,-19,36
St. Pölten,7959,9,7,11,18,36,61,-25,32
Mattersburg,7959,10,7,9,20,33,52,-19,30
FC Salzburg,7960,1,24,7,5,73,28,45,79
SK Sturm Gra,7960,2,21,8,7,62,27,35,71
SC Rheindorf,7960,3,19,8,9,56,36,20,65
Vienna,7960,4,18,5,13,63,53,10,59
RZ Pellets W,7960,5,15,7,14,47,56,-9,52
Rapid Vienna,7960,6,11,11,14,48,44,4,44
SV Josko Rie,7960,7,10,7,19,35,54,-19,37
Admira Wacke,7960,8,10,4,22,34,70,-36,34
St. Pölten,7960,9,8,8,20,45,74,-29,32
Mattersburg,7960,10,8,7,21,38,59,-21,31
FC Salzburg,7961,1,26,6,4,69,21,48,84
Vienna,7961,2,19,6,11,61,44,17,63
SK Sturm Gra,7961,3,18,8,10,68,35,33,62
SC Rheindorf,7961,4,18,8,10,57,45,12,62
Rapid Vienna,7961,5,13,11,12,60,44,16,50
RZ Pellets W,7961,6,12,9,15,39,51,-12,45
SV Josko Rie,7961,7,9,8,19,30,56,-26,35
Mattersburg,7961,8,9,7,20,36,67,-31,34
Admira Wacke,7961,9,9,7,20,35,68,-33,34
St. Pölten,7961,10,6,12,18,37,61,-24,30
SC Rheindorf,7962,1,23,4,9,60,39,21,73
FC Salzburg,7962,2,19,7,10,67,33,34,64
Vienna,7962,3,19,5,12,57,46,11,62
SK Sturm Gra,7962,4,19,4,13,55,38,17,61
Rapid Vienna,7962,5,14,10,12,52,41,11,52
Admira Wacke,7962,6,14,6,16,40,51,-11,48
RZ Pellets W,7962,7,11,8,17,53,67,-14,41
St. Pölten,7962,8,10,8,18,41,68,-27,38
Mattersburg,7962,9,9,8,19,43,59,-16,35
SV Josko Rie,7962,10,10,4,22,30,56,-26,34
FC Salzburg,7963,1,21,6,9,66,31,35,69
SK Sturm Gra,7963,2,20,8,8,62,29,33,68
SC Rheindorf,7963,3,19,8,9,59,43,16,65
Vienna,7963,4,20,4,12,59,46,13,64
Rapid Vienna,7963,5,14,11,11,49,36,13,53
RZ Pellets W,7963,6,13,6,17,48,57,-9,45
Admira Wacke,7963,7,13,5,18,39,68,-29,44
St. Pölten,7963,8,10,9,17,46,63,-17,39
SV Josko Rie,7963,9,8,6,22,31,60,-29,30
Mattersburg,7963,10,6,9,21,32,58,-26,27
FC Salzburg,7964,1,21,7,8,63,30,33,70
SC Rheindorf,7964,2,20,6,10,52,40,12,66
SK Sturm Gra,7964,3,19,8,9,54,28,26,65
Vienna,7964,4,19,4,13,58,52,6,61
Rapid Vienna,7964,5,14,11,11,52,36,16,53
Admira Wacke,7964,6,13,4,19,43,61,-18,43
RZ Pellets W,7964,7,11,8,17,42,53,-11,41
Mattersburg,7964,8,11,7,18,36,52,-16,40
SV Josko Rie,7964,9,10,4,22,28,51,-23,34
St. Pölten,7964,10,7,11,18,34,59,-25,32
FC Salzburg,7965,1,22,7,7,67,27,40,73
SC Rheindorf,7965,2,20,8,8,59,41,18,68
SK Sturm Gra,7965,3,20,6,10,60,33,27,66
Vienna,7965,4,18,4,14,60,55,5,58
Rapid Vienna,7965,5,13,12,11,54,38,16,51
RZ Pellets W,7965,6,13,7,16,47,55,-8,46
Admira Wacke,7965,7,12,6,18,34,57,-23,42
SV Josko Rie,7965,8,11,4,21,34,61,-27,37
St. Pölten,7965,9,9,8,19,40,61,-21,35
Mattersburg,7965,10,7,8,21,39,66,-27,29
FC Salzburg,7966,1,21,9,6,64,25,39,72
SK Sturm Gra,7966,2,21,7,8,57,25,32,70
SC Rheindorf,7966,3,17,12,7,50,38,12,63
Vienna,7966,4,18,5,13,63,56,7,59
Rapid Vienna,7966,5,14,12,10,54,39,15,54
RZ Pellets W,7966,6,16,5,15,55,52,3,53
Admira Wacke,7966,7,10,6,20,33,63,-30,36
SV Josko Rie,7966,8,9,7,20,35,59,-24,34
Mattersburg,7966,9,7,9,20,34,59,-25,30
St. Pölten,7966,10,7,8,21,34,63,-29,29
FC Salzburg,7967,1,20,8,8,62,34,28,68
Vienna,7967,2,21,3,12,69,47,22,66
SC Rheindorf,7967,3,19,8,9,48,43,5,65
SK Sturm Gra,7967,4,18,8,10,59,35,24,62
Rapid Vienna,7967,5,16,11,9,65,37,28,59
RZ Pellets W,7967,6,12,8,16,46,52,-6,44
Admira Wacke,7967,7,11,6,19,37,64,-27,39
Mattersburg,7967,8,8,10,18,42,60,-18,34
St. Pölten,7967,9,8,9,19,38,60,-22,33
SV Josko Rie,7967,10,9,5,22,30,64,-34,32
FC Salzburg,7968,1,23,7,6,67,27,40,76
SC Rheindorf,7968,2,21,8,7,61,39,22,71
SK Sturm Gra,7968,3,21,6,9,70,37,33,69
Vienna,7968,4,21,4,11,61,42,19,67
Rapid Vienna,7968,5,12,11,13,55,49,6,47
Admira Wacke,7968,6,11,7,18,35,57,-22,40
RZ Pellets W,7968,7,11,6,19,38,59,-21,39
St. Pölten,7968,8,8,10,18,38,65,-27,34
SV Josko Rie,7968,9,9,4,23,35,59,-24,31
Mattersburg,7968,10,8,7,21,41,67,-26,31
FC Salzburg,7969,1,23,7,6,72,28,44,76
SC Rheindorf,7969,2,19,8,9,57,40,17,65
SK Sturm Gra,7969,3,19,7,10,54,30,24,64
Vienna,7969,4,18,6,12,62,53,9,60
Rapid Vienna,7969,5,12,12,12,58,44,14,48
Admira Wacke,7969,6,12,9,15,38,59,-21,45
RZ Pellets W,7969,7,11,7,18,43,59,-16,40
St. Pölten,7969,8,9,10,17,41,64,-23,37
SV Josko Rie,7969,9,9,7,20,34,61,-27,34
Mattersburg,7969,10,7,9,20,38,59,-21,30
SC Rheindorf,7970,1,20,8,8,61,43,18,68
SK Sturm Gra,7970,2,19,9,8,59,37,22,66
FC Salzburg,7970,3,19,6,11,61,36,25,63
Vienna,7970,4,17,5,14,60,55,5,56
Rapid Vienna,7970,5,14,11,11,55,42,13,53
RZ Pellets W,7970,6,13,12,11,59,55,4,51
SV Josko Rie,7970,7,11,7,18,36,48,-12,40
St. Pölten,7970,8,8,11,17,40,61,-21,35
Admira Wacke,7970,9,9,8,19,35,61,-26,35
Mattersburg,7970,10,8,7,21,36,64,-28,31
FC Salzburg,7971,1,22,7,7,73,33,40,73
SC Rheindorf,7971,2,20,9,7,58,43,15,69
Vienna,7971,3,17,7,12,61,48,13,58
SK Sturm Gra,7971,4,17,6,13,52,38,14,57
Rapid Vienna,7971,5,15,8,13,53,39,14,53
RZ Pellets W,7971,6,11,9,16,45,56,-11,42
Mattersburg,7971,7,10,9,17,39,51,-12,39
SV Josko Rie,7971,8,11,6,19,35,55,-20,39
Admira Wacke,7971,9,10,7,19,31,62,-31,37
St. Pölten,7971,10,8,10,18,40,62,-22,34
Vienna,7972,1,21,4,11,62,51,11,67
SK Sturm Gra,7972,2,19,8,9,61,30,31,65
FC Salzburg,7972,3,19,7,10,61,31,30,64
SC Rheindorf,7972,4,17,10,9,58,46,12,61
Rapid Vienna,7972,5,13,12,11,53,44,9,51
RZ Pellets W,7972,6,13,7,16,47,56,-9,46
Admira Wacke,7972,7,12,8,16,38,57,-19,44
SV Josko Rie,7972,8,12,6,18,37,53,-16,42
St. Pölten,7972,9,9,8,19,45,66,-21,35
Mattersburg,7972,10,5,10,21,36,64,-28,25
FC Salzburg,7973,1,21,8,7,68,28,40,71
SK Sturm Gra,7973,2,20,6,10,62,35,27,66
Vienna,7973,3,19,5,12,60,47,13,62
SC Rheindorf,7973,4,17,7,12,52,48,4,58
Rapid Vienna,7973,5,15,9,12,53,42,11,54
RZ Pellets W,7973,6,14,7,15,48,50,-2,49
Admira Wacke,7973,7,14,3,19,37,61,-24,45
Mattersburg,7973,8,11,8,17,39,52,-13,41
SV Josko Rie,7973,9,10,4,22,34,57,-23,34
St. Pölten,7973,10,6,9,21,40,73,-33,27
Vienna,7974,1,21,4,11,62,47,15,67
FC Salzburg,7974,2,20,6,10,68,37,31,66
SC Rheindorf,7974,3,19,6,11,56,43,13,63
SK Sturm Gra,7974,4,18,6,12,55,34,21,60
Rapid Vienna,7974,5,14,11,11,58,42,16,53
RZ Pellets W,7974,6,13,6,17,41,50,-9,45
Admira Wacke,7974,7,13,4,19,35,59,-24,43
Mattersburg,7974,8,10,8,18,42,57,-15,38
SV Josko Rie,7974,9,11,5,20,36,60,-24,38
St. Pölten,7974,10,9,8,19,43,67,-24,35
SC Rheindorf,7975,1,21,8,7,64,39,25,71
Vienna,7975,2,20,5,11,66,53,13,65
FC Salzburg,7975,3,18,9,9,58,30,28,63
SK Sturm Gra,7975,4,19,6,11,57,37,20,63
Rapid Vienna,7975,5,12,11,13,52,41,11,47
RZ Pellets W,7975,6,12,8,16,45,54,-9,44
Admira Wacke,7975,7,12,8,16,45,63,-18,44
SV Josko Rie,7975,8,11,7,18,34,50,-16,40
Mattersburg,7975,9,8,8,20,42,59,-17,32
St. Pölten,7975,10,7,10,19,37,74,-37,31
Vienna,7976,1,19,8,9,70,52,18,65
SC Rheindorf,7976,2,19,8,9,59,46,13,65
FC Salzburg,7976,3,18,10,8,60,33,27,64
SK Sturm Gra,7976,4,20,4,12,58,35,23,64
Rapid Vienna,7976,5,15,10,11,62,41,21,55
RZ Pellets W,7976,6,13,7,16,49,60,-11,46
Mattersburg,7976,7,10,9,17,46,55,-9,39
SV Josko Rie,7976,8,11,6,19,38,54,-16,39
Admira Wacke,7976,9,10,6,20,39,71,-32,36
St. Pölten,7976,10,5,12,19,39,73,-34,27
FC Salzburg,7977,1,19,10,7,61,32,29,67
Vienna,7977,2,20,6,10,70,48,22,66
SK Sturm Gra,7977,3,17,11,8,63,35,28,62
SC Rheindorf,7977,4,16,10,10,53,49,4,58
Admira Wacke,7977,5,15,4,17,39,55,-16,49
Rapid Vienna,7977,6,12,12,12,59,43,16,48
SV Josko Rie,7977,7,12,6,18,42,55,-13,42
RZ Pellets W,7977,8,10,11,15,43,57,-14,41
St. Pölten,7977,9,8,10,18,45,66,-21,34
Mattersburg,7977,10,7,8,21,33,68,-35,29
SC Rheindorf,7978,1,20,7,9,57,46,11,67
Vienna,7978,2,21,3,12,68,51,17,66
SK Sturm Gra,7978,3,19,8,9,55,28,27,65
FC Salzburg,7978,4,19,7,10,56,35,21,64
Rapid Vienna,7978,5,14,10,12,52,40,12,52
Admira Wacke,7978,6,14,4,18,36,57,-21,46
RZ Pellets W,7978,7,12,6,18,43,55,-12,42
Mattersburg,7978,8,10,8,18,38,52,-14,38
St. Pölten,7978,9,8,9,19,43,63,-20,33
SV Josko Rie,7978,10,9,6,21,32,53,-21,33
SC Rheindorf,7979,1,20,8,8,53,35,18,68
FC Salzburg,7979,2,20,7,9,61,30,31,67
SK Sturm Gra,7979,3,18,10,8,58,30,28,64
Rapid Vienna,7979,4,16,9,11,54,40,14,57
Vienna,7979,5,17,6,13,54,49,5,57
Mattersburg,7979,6,11,9,16,43,55,-12,42
RZ Pellets W,7979,7,11,8,17,45,56,-11,41
Admira Wacke,7979,8,11,4,21,28,54,-26,37
St. Pölten,7979,9,9,9,18,41,66,-25,36
SV Josko Rie,7979,10,10,4,22,35,57,-22,34
SC Rheindorf,7980,1,20,7,9,56,42,14,67
FC Salzburg,7980,2,18,9,9,67,38,29,63
SK Sturm Gra,7980,3,18,7,11,57,35,22,61
Vienna,7980,4,17,5,14,72,67,5,56
Rapid Vienna,7980,5,14,13,9,58,41,17,55
RZ Pellets W,7980,6,14,8,14,45,49,-4,50
Admira Wacke,7980,7,12,6,18,41,59,-18,42
Mattersburg,7980,8,10,11,15,42,55,-13,41
SV Josko Rie,7980,9,10,8,18,33,52,-19,38
St. Pölten,7980,10,5,10,21,37,70,-33,25
FC Salzburg,7981,1,20,9,7,66,36,30,69
SC Rheindorf,7981,2,20,9,7,63,46,17,69
SK Sturm Gra,7981,3,17,8,11,63,40,23,59
Vienna,7981,4,16,6,14,60,60,0,54
Admira Wacke,7981,5,15,7,14,43,51,-8,52
Rapid Vienna,7981,6,13,12,11,56,42,14,51
RZ Pellets W,7981,7,11,8,17,45,54,-9,41
Mattersburg,7981,8,12,5,19,33,49,-16,41
SV Josko Rie,7981,9,11,5,20,38,53,-15,38
St. Pölten,7981,10,5,11,20,39,75,-36,26
SC Rheindorf,7982,1,20,9,7,56,40,16,69
FC Salzburg,7982,2,20,7,9,63,30,33,67
Vienna,7982,3,19,7,10,60,50,10,64
SK Sturm Gra,7982,4,19,4,13,62,39,23,61
Rapid Vienna,7982,5,12,11,13,54,45,9,47
Mattersburg,7982,6,11,9,16,39,49,-10,42
RZ Pellets W,7982,7,12,6,18,44,59,-15,42
Admira Wacke,7982,8,9,9,18,30,54,-24,36
SV Josko Rie,7982,9,8,11,17,32,53,-21,35
St. Pölten,7982,10,7,13,16,50,71,-21,34
FC Salzburg,7983,1,23,6,7,63,26,37,75
SC Rheindorf,7983,2,20,6,10,59,44,15,66
Vienna,7983,3,19,5,12,63,56,7,62
SK Sturm Gra,7983,4,17,5,14,55,36,19,56
Rapid Vienna,7983,5,14,11,11,51,33,18,53
RZ Pellets W,7983,6,12,7,17,47,59,-12,43
Admira Wacke,7983,7,12,6,18,37,58,-21,42
SV Josko Rie,7983,8,11,6,19,31,50,-19,39
Mattersburg,7983,9,9,9,18,40,60,-20,36
St. Pölten,7983,10,7,11,18,37,61,-24,32
FC Salzburg,7984,1,20,10,6,66,27,39,70
SK Sturm Gra,7984,2,18,10,8,56,30,26,64
Vienna,7984,3,19,5,12,62,52,10,62
SC Rheindorf,7984,4,16,8,12,54,46,8,56
Rapid Vienna,7984,5,15,9,12,58,41,17,54
RZ Pellets W,7984,6,15,7,14,48,50,-2,52
Mattersburg,7984,7,11,7,18,35,58,-23,40
Admira Wacke,7984,8,11,7,18,37,62,-25,40
SV Josko Rie,7984,9,9,6,21,32,55,-23,33
St. Pölten,7984,10,7,9,20,32,59,-27,30
FC Salzburg,7985,1,21,8,7,67,36,31,71
SK Sturm Gra,7985,2,20,7,9,61,33,28,67
SC Rheindorf,7985,3,19,8,9,55,42,13,65
Vienna,7985,4,18,7,11,64,50,14,61
Rapid Vienna,7985,5,11,13,12,55,43,12,46
RZ Pellets W,7985,6,10,12,14,42,55,-13,42
St. Pölten,7985,7,9,9,18,42,61,-19,36
Mattersburg,7985,8,9,9,18,36,56,-20,36
Admira Wacke,7985,9,9,9,18,35,58,-23,36
SV Josko Rie,7985,9,10,6,20,35,58,-23,36
SK Sturm Gra,7986,1,20,7,9,64,33,31,67
FC Salzburg,7986,2,19,9,8,58,29,29,66
SC Rheindorf,7986,3,19,7,10,53,44,9,64
Vienna,7986,4,18,7,11,64,55,9,61
Rapid Vienna,7986,5,14,11,11,54,42,12,53
SV Josko Rie,7986,6,11,8,17,34,49,-15,41
RZ Pellets W,7986,7,10,9,17,48,59,-11,39
Admira Wacke,7986,8,11,6,19,37,57,-20,39
St. Pölten,7986,9,9,10,17,43,65,-22,37
Mattersburg,7986,10,8,8,20,33,55,-22,32
FC Salzburg,7987,1,21,6,9,69,36,33,69
SC Rheindorf,7987,2,20,9,7,55,42,13,69
SK Sturm Gra,7987,3,19,9,8,68,30,38,66
Vienna,7987,4,18,6,12,65,48,17,60
Rapid Vienna,7987,5,14,11,11,62,49,13,53
RZ Pellets W,7987,6,13,8,15,46,56,-10,47
Admira Wacke,7987,7,12,8,16,34,56,-22,44
Mattersburg,7987,8,8,8,20,33,54,-21,32
SV Josko Rie,7987,9,9,5,22,31,62,-31,32
St. Pölten,7987,10,7,8,21,41,71,-30,29
FC Salzburg,7988,1,24,6,6,73,29,44,78
SK Sturm Gra,7988,2,20,8,8,57,30,27,68
SC Rheindorf,7988,3,18,10,8,55,45,10,64
Vienna,7988,4,17,7,12,63,55,8,58
Rapid Vienna,7988,5,11,14,11,50,38,12,47
SV Josko Rie,7988,6,11,11,14,41,49,-8,44
Admira Wacke,7988,7,13,4,19,37,58,-21,43
RZ Pellets W,7988,8,9,7,20,39,60,-21,34
St. Pölten,7988,9,8,8,20,41,69,-28,32
Mattersburg,7988,10,7,9,20,37,60,-23,30
SK Sturm Gra,7989,1,22,6,8,75,37,38,72
FC Salzburg,7989,2,20,9,7,69,35,34,69
SC Rheindorf,7989,3,20,6,10,57,45,12,66
Rapid Vienna,7989,4,17,10,9,59,39,20,61
Vienna,7989,5,17,7,12,62,54,8,58
Admira Wacke,7989,6,11,9,16,41,61,-20,42
RZ Pellets W,7989,7,10,10,16,48,60,-12,40
SV Josko Rie,7989,8,9,5,22,30,59,-29,32
St. Pölten,7989,9,7,9,20,42,68,-26,30
Mattersburg,7989,10,6,11,19,36,61,-25,29
Vienna,7990,1,23,3,10,65,43,22,72
FC Salzburg,7990,2,20,7,9,65,35,30,67
SC Rheindorf,7990,3,19,6,11,54,46,8,63
SK Sturm Gra,7990,4,17,10,9,58,33,25,61
Rapid Vienna,7990,5,13,12,11,55,40,15,51
RZ Pellets W,7990,6,13,8,15,44,54,-10,47
Admira Wacke,7990,7,12,8,16,37,55,-18,44
Mattersburg,7990,8,7,13,16,40,57,-17,34
St. Pölten,7990,9,8,8,20,36,62,-26,32
SV Josko Rie,7990,10,8,5,23,32,61,-29,29
SC Rheindorf,7991,1,21,8,7,60,45,15,71
FC Salzburg,7991,2,19,9,8,62,35,27,66
SK Sturm Gra,7991,3,19,6,11,60,38,22,63
Vienna,7991,4,19,4,13,66,54,12,61
Rapid Vienna,7991,5,14,10,12,55,46,9,52
Admira Wacke,7991,6,13,5,18,46,64,-18,44
RZ Pellets W,7991,7,12,7,17,49,55,-6,43
Mattersburg,7991,8,9,10,17,37,50,-13,37
St. Pölten,7991,9,7,12,17,42,67,-25,33
SV Josko Rie,7991,10,8,7,21,32,55,-23,31
FC Salzburg,7992,1,22,5,9,72,32,40,71
SK Sturm Gra,7992,2,19,8,9,56,28,28,65
SC Rheindorf,7992,3,19,8,9,51,44,7,65
Vienna,7992,4,19,6,11,63,47,16,63
Rapid Vienna,7992,5,16,10,10,56,35,21,58
Admira Wacke,7992,6,11,8,17,39,56,-17,41
RZ Pellets W,7992,7,11,8,17,39,57,-18,41
St. Pölten,7992,8,9,9,18,36,61,-25,36
SV Josko Rie,7992,9,8,8,20,35,60,-25,32
Mattersburg,7992,10,6,10,20,32,59,-27,28
FC Salzburg,7993,1,20,9,7,62,27,35,69
Vienna,7993,2,20,5,11,67,44,23,65
SK Sturm Gra,7993,3,20,5,11,58,38,20,65
SC Rheindorf,7993,4,19,6,11,53,48,5,63
Rapid Vienna,7993,5,12,11,13,53,45,8,47
SV Josko Rie,7993,6,11,9,16,35,49,-14,42
St. Pölten,7993,7,10,11,15,47,65,-18,41
Admira Wacke,7993,8,11,8,17,35,57,-22,41
RZ Pellets W,7993,9,11,5,20,47,60,-13,38
Mattersburg,7993,10,8,7,21,34,58,-24,31
FC Salzburg,7994,1,25,7,4,73,27,46,82
SC Rheindorf,7994,2,19,9,8,53,40,13,66
Vienna,7994,3,20,5,11,65,44,21,65
SK Sturm Gra,7994,4,18,5,13,58,43,15,59
Rapid Vienna,7994,5,13,10,13,50,40,10,49
RZ Pellets W,7994,6,13,8,15,47,52,-5,47
Admira Wacke,7994,7,12,6,18,38,63,-25,42
Mattersburg,7994,8,9,7,20,34,53,-19,34
St. Pölten,7994,9,7,11,18,41,63,-22,32
SV Josko Rie,7994,10,7,6,23,30,64,-34,27
FC Salzburg,7995,1,20,8,8,62,30,32,68
SK Sturm Gra,7995,2,20,6,10,55,34,21,66
SC Rheindorf,7995,3,18,8,10,53,42,11,62
Vienna,7995,4,17,6,13,58,51,7,57
Rapid Vienna,7995,5,12,14,10,54,44,10,50
RZ Pellets W,7995,6,13,9,14,47,50,-3,48
Admira Wacke,7995,7,13,8,15,37,54,-17,47
St. Pölten,7995,8,9,9,18,46,66,-20,36
SV Josko Rie,7995,9,9,8,19,36,54,-18,35
Mattersburg,7995,10,7,8,21,30,53,-23,29
FC Salzburg,7996,1,19,12,5,64,27,37,69
SC Rheindorf,7996,2,20,8,8,57,40,17,68
SK Sturm Gra,7996,3,19,7,10,58,35,23,64
Vienna,7996,4,16,8,12,52,51,1,56
Rapid Vienna,7996,5,12,13,11,53,39,14,49
RZ Pellets W,7996,6,13,5,18,48,55,-7,44
St. Pölten,7996,7,10,10,16,48,64,-16,40
Admira Wacke,7996,8,11,7,18,39,62,-23,40
SV Josko Rie,7996,9,10,7,19,36,57,-21,37
Mattersburg,7996,10,8,7,21,34,59,-25,31
FC Salzburg,7997,1,21,8,7,73,29,44,71
Vienna,7997,2,20,5,11,61,46,15,65
SK Sturm Gra,7997,3,18,8,10,57,32,25,62
SC Rheindorf,7997,4,16,8,12,49,50,-1,56
RZ Pellets W,7997,5,13,10,13,50,52,-2,49
Rapid Vienna,7997,6,11,12,13,50,42,8,45
SV Josko Rie,7997,7,13,6,17,37,48,-11,45
Admira Wacke,7997,8,10,8,18,34,64,-30,38
St. Pölten,7997,9,9,10,17,40,59,-19,37
Mattersburg,7997,10,7,9,20,35,64,-29,30
FC Salzburg,7998,1,22,7,7,65,26,39,73
Vienna,7998,2,22,5,9,67,47,20,71
SK Sturm Gra,7998,3,19,4,13,59,36,23,61
SC Rheindorf,7998,4,19,4,13,50,43,7,61
Rapid Vienna,7998,5,14,12,10,57,38,19,54
Mattersburg,7998,6,12,9,15,41,48,-7,45
Admira Wacke,7998,7,12,6,18,32,59,-27,42
RZ Pellets W,7998,8,9,10,17,37,56,-19,37
SV Josko Rie,7998,9,10,3,23,30,61,-31,33
St. Pölten,7998,10,6,10,20,34,58,-24,28
SK Sturm Gra,7999,1,22,6,8,66,34,32,72
FC Salzburg,7999,2,21,6,9,70,33,37,69
SC Rheindorf,7999,3,19,7,10,56,46,10,64
Vienna,7999,4,16,8,12,58,55,3,56
Rapid Vienna,7999,5,15,10,11,65,39,26,55
Mattersburg,7999,6,11,8,17,41,55,-14,41
RZ Pellets W,7999,7,10,8,18,37,61,-24,38
SV Josko Rie,7999,8,10,7,19,39,57,-18,37
St. Pölten,7999,9,8,12,16,45,67,-22,36
Admira Wacke,7999,10,9,6,21,30,60,-30,33
FC Salzburg,8000,1,21,7,8,68,32,36,70
SC Rheindorf,8000,2,19,7,10,56,41,15,64
SK Sturm Gra,8000,3,18,8,10,55,34,21,62
Rapid Vienna,8000,4,16,10,10,58,38,20,58
Vienna,8000,5,16,6,14,57,61,-4,54
RZ Pellets W,8000,6,15,6,15,51,53,-2,51
Admira Wacke,8000,7,14,5,17,36,51,-15,47
SV Josko Rie,8000,8,11,6,19,40,55,-15,39
St. Pölten,8000,9,9,11,16,48,64,-16,38
Mattersburg,8000,10,5,6,25,25,65,-40,21
FC Salzburg,8001,1,23,6,7,62,26,36,75
SC Rheindorf,8001,2,18,10,8,52,40,12,64
SK Sturm Gra,8001,3,18,8,10,58,38,20,62
Vienna,8001,4,17,8,11,67,58,9,59
Rapid Vienna,8001,5,15,11,10,56,35,21,56
RZ Pellets W,8001,6,12,8,16,50,62,-12,44
Admira Wacke,8001,7,10,7,19,37,60,-23,37
Mattersburg,8001,8,9,8,19,44,62,-18,35
SV Josko Rie,8001,9,9,7,20,33,54,-21,34
St. Pölten,8001,10,8,9,19,41,65,-24,33
FC Salzburg,8002,1,24,5,7,73,29,44,77
SK Sturm Gra,8002,2,20,8,8,58,32,26,68
SC Rheindorf,8002,3,18,11,7,58,46,12,65
Vienna,8002,4,19,5,12,65,47,18,62
Rapid Vienna,8002,5,12,9,15,53,48,5,45
St. Pölten,8002,6,11,9,16,47,60,-13,42
Admira Wacke,8002,7,11,8,17,40,61,-21,41
RZ Pellets W,8002,8,9,12,15,44,59,-15,39
SV Josko Rie,8002,9,8,8,20,33,59,-26,32
Mattersburg,8002,10,5,11,20,43,73,-30,26
SK Sturm Gra,8003,1,23,7,6,72,35,37,76
SC Rheindorf,8003,2,22,5,9,62,45,17,71
FC Salzburg,8003,3,19,9,8,64,33,31,66
Vienna,8003,4,18,6,12,63,55,8,60
RZ Pellets W,8003,5,16,5,15,50,51,-1,53
Admira Wacke,8003,6,12,7,17,31,51,-20,43
Rapid Vienna,8003,7,10,11,15,43,42,1,41
SV Josko Rie,8003,8,10,5,21,30,52,-22,35
Mattersburg,8003,9,7,9,20,32,56,-24,30
St. Pölten,8003,10,7,8,21,39,66,-27,29
FC Salzburg,8004,1,24,7,5,66,24,42,79
SC Rheindorf,8004,2,20,6,10,53,38,15,66
SK Sturm Gra,8004,3,18,5,13,56,36,20,59
Vienna,8004,4,16,7,13,60,52,8,55
Rapid Vienna,8004,5,11,13,12,54,43,11,46
Mattersburg,8004,6,12,9,15,36,48,-12,45
RZ Pellets W,8004,7,11,9,16,42,57,-15,42
Admira Wacke,8004,8,11,7,18,32,54,-22,40
St. Pölten,8004,9,9,11,16,44,63,-19,38
SV Josko Rie,8004,10,8,6,22,29,57,-28,30
SC Rheindorf,8005,1,23,5,8,62,46,16,74
FC Salzburg,8005,2,22,5,9,71,30,41,71
SK Sturm Gra,8005,3,22,5,9,57,30,27,71
Vienna,8005,4,18,5,13,66,51,15,59
Rapid Vienna,8005,5,13,11,12,50,41,9,50
RZ Pellets W,8005,6,11,8,17,43,57,-14,41
Admira Wacke,8005,7,10,7,19,36,60,-24,37
St. Pölten,8005,8,9,9,18,43,60,-17,36
Mattersburg,8005,9,10,5,21,35,60,-25,35
SV Josko Rie,8005,10,10,4,22,34,62,-28,34
SC Rheindorf,8006,1,22,8,6,62,37,25,74
SK Sturm Gra,8006,2,19,8,9,62,34,28,65
FC Salzburg,8006,3,17,9,10,57,36,21,60
Vienna,8006,4,16,7,13,59,52,7,55
Rapid Vienna,8006,5,13,11,12,59,48,11,50
RZ Pellets W,8006,6,11,10,15,47,54,-7,43
SV Josko Rie,8006,7,11,5,20,37,57,-20,38
Admira Wacke,8006,8,10,8,18,43,64,-21,38
St. Pölten,8006,9,9,11,16,44,67,-23,38
Mattersburg,8006,10,10,7,19,40,61,-21,37
FC Salzburg,8007,1,20,7,9,67,36,31,67
Vienna,8007,2,20,6,10,64,50,14,66
SK Sturm Gra,8007,3,18,9,9,57,31,26,63
SC Rheindorf,8007,4,18,9,9,49,35,14,63
Rapid Vienna,8007,5,14,13,9,63,40,23,55
RZ Pellets W,8007,6,12,8,16,46,60,-14,44
SV Josko Rie,8007,7,12,5,19,38,53,-15,41
Mattersburg,8007,8,9,7,20,36,56,-20,34
St. Pölten,8007,9,8,10,18,37,67,-30,34
Admira Wacke,8007,10,9,6,21,32,61,-29,33
SC Rheindorf,8008,1,19,8,9,54,43,11,65
SK Sturm Gra,8008,2,18,9,9,58,32,26,63
FC Salzburg,8008,3,18,8,10,60,37,23,62
Vienna,8008,4,17,6,13,65,50,15,57
Rapid Vienna,8008,5,15,10,11,59,43,16,55
RZ Pellets W,8008,6,15,9,12,54,48,6,54
Admira Wacke,8008,7,11,8,17,41,66,-25,41
Mattersburg,8008,8,10,8,18,34,50,-16,38
SV Josko Rie,8008,9,11,5,20,31,54,-23,38
St. Pölten,8008,10,5,11,20,39,72,-33,26
SC Rheindorf,8009,1,22,6,8,58,41,17,72
FC Salzburg,8009,2,20,7,9,58,31,27,67
SK Sturm Gra,8009,3,18,7,11,56,38,18,61
Vienna,8009,4,17,6,13,59,50,9,57
Rapid Vienna,8009,5,13,12,11,53,40,13,51
SV Josko Rie,8009,6,15,2,19,40,51,-11,47
RZ Pellets W,8009,7,13,6,17,49,60,-11,45
Admira Wacke,8009,8,10,8,18,34,57,-23,38
Mattersburg,8009,9,9,8,19,40,55,-15,35
St. Pölten,8009,10,8,8,20,46,70,-24,32
FC Salzburg,8010,1,22,8,6,69,30,39,74
SC Rheindorf,8010,2,19,9,8,62,47,15,66
Vienna,8010,3,20,5,11,61,50,11,65
SK Sturm Gra,8010,4,18,8,10,60,36,24,62
Rapid Vienna,8010,5,13,10,13,50,39,11,49
St. Pölten,8010,6,10,10,16,44,60,-16,40
Mattersburg,8010,7,10,8,18,41,55,-14,38
Admira Wacke,8010,8,11,5,20,31,61,-30,38
RZ Pellets W,8010,9,10,6,20,41,60,-19,36
SV Josko Rie,8010,10,9,7,20,31,52,-21,34
FC Salzburg,8011,1,21,8,7,63,28,35,71
SC Rheindorf,8011,2,21,6,9,61,41,20,69
SK Sturm Gra,8011,3,21,4,11,62,31,31,67
Vienna,8011,4,21,4,11,68,50,18,67
Rapid Vienna,8011,5,12,9,15,55,45,10,45
SV Josko Rie,8011,6,12,6,18,37,58,-21,42
RZ Pellets W,8011,7,10,10,16,41,56,-15,40
Admira Wacke,8011,8,11,7,18,35,56,-21,40
St. Pölten,8011,9,8,10,18,34,62,-28,34
Mattersburg,8011,10,8,6,22,32,61,-29,30
FC Salzburg,8012,1,21,7,8,65,31,34,70
Vienna,8012,2,21,5,10,69,52,17,68
SK Sturm Gra,8012,3,18,9,9,53,28,25,63
SC Rheindorf,8012,4,15,8,13,54,51,3,53
Rapid Vienna,8012,5,12,11,13,52,46,6,47
RZ Pellets W,8012,6,12,10,14,51,56,-5,46
Admira Wacke,8012,7,12,9,15,39,53,-14,45
Mattersburg,8012,8,11,8,17,44,60,-16,41
SV Josko Rie,8012,9,10,6,20,32,52,-20,36
St. Pölten,8012,10,8,7,21,36,66,-30,31
FC Salzburg,8013,1,23,5,8,67,31,36,74
SK Sturm Gra,8013,2,19,7,10,60,40,20,64
SC Rheindorf,8013,3,19,5,12,57,50,7,62
Vienna,8013,4,18,4,14,66,53,13,58
Rapid Vienna,8013,5,14,12,10,60,44,16,54
Admira Wacke,8013,6,16,4,16,43,55,-12,52
RZ Pellets W,8013,7,13,9,14,47,53,-6,48
St. Pölten,8013,8,10,10,16,48,68,-20,40
SV Josko Rie,8013,9,9,4,23,28,53,-25,31
Mattersburg,8013,10,5,8,23,32,61,-29,23
FC Salzburg,8014,1,19,10,7,57,30,27,67
Vienna,8014,2,18,7,11,58,50,8,61
SC Rheindorf,8014,3,16,11,9,45,39,6,59
SK Sturm Gra,8014,4,17,5,14,56,41,15,56
Rapid Vienna,8014,5,14,12,10,55,36,19,54
RZ Pellets W,8014,6,14,7,15,49,56,-7,49
Admira Wacke,8014,7,14,5,17,42,56,-14,47
St. Pölten,8014,8,9,11,16,42,54,-12,38
SV Josko Rie,8014,9,10,8,18,36,57,-21,38
Mattersburg,8014,10,8,6,22,36,57,-21,30
FC Salzburg,8015,1,22,9,5,64,23,41,75
SC Rheindorf,8015,2,21,7,8,58,39,19,70
Vienna,8015,3,21,6,9,65,45,20,69
SK Sturm Gra,8015,4,19,6,11,65,42,23,63
Rapid Vienna,8015,5,14,10,12,54,40,14,52
Mattersburg,8015,6,10,8,18,41,56,-15,38
RZ Pellets W,8015,7,10,7,19,46,57,-11,37
SV Josko Rie,8015,8,11,4,21,34,55,-21,37
Admira Wacke,8015,9,9,6,21,29,67,-38,33
St. Pölten,8015,10,6,11,19,35,67,-32,29
SC Rheindorf,8016,1,23,5,8,64,36,28,74
FC Salzburg,8016,2,23,4,9,61,29,32,73
SK Sturm Gra,8016,3,17,5,14,56,38,18,56
Vienna,8016,4,17,5,14,61,56,5,56
Rapid Vienna,8016,5,13,8,15,56,44,12,47
RZ Pellets W,8016,6,13,8,15,44,52,-8,47
Mattersburg,8016,7,13,6,17,44,53,-9,45
Admira Wacke,8016,8,12,7,17,35,53,-18,43
St. Pölten,8016,9,10,6,20,45,81,-36,36
SV Josko Rie,8016,10,11,2,23,32,56,-24,35
FC Salzburg,8017,1,19,9,8,58,31,27,66
SC Rheindorf,8017,2,19,8,9,59,43,16,65
SK Sturm Gra,8017,3,19,7,10,57,34,23,64
Vienna,8017,4,17,5,14,61,56,5,56
RZ Pellets W,8017,5,14,7,15,44,47,-3,49
Rapid Vienna,8017,6,10,14,12,46,39,7,44
Admira Wacke,8017,7,12,7,17,37,60,-23,43
SV Josko Rie,8017,8,12,6,18,36,52,-16,42
Mattersburg,8017,9,11,7,18,40,47,-7,40
St. Pölten,8017,10,8,8,20,36,65,-29,32
SC Rheindorf,8018,1,21,7,8,50,35,15,70
FC Salzburg,8018,2,20,8,8,64,31,33,68
SK Sturm Gra,8018,3,19,6,11,56,34,22,63
Vienna,8018,4,16,7,13,56,52,4,55
Rapid Vienna,8018,5,13,9,14,54,45,9,48
RZ Pellets W,8018,6,12,9,15,41,51,-10,45
Admira Wacke,8018,7,12,7,17,39,52,-13,43
Mattersburg,8018,8,11,8,17,43,54,-11,41
SV Josko Rie,8018,9,11,5,20,35,57,-22,38
St. Pölten,8018,10,8,8,20,45,72,-27,32
FC Salzburg,8019,1,21,10,5,66,27,39,73
Vienna,8019,2,19,10,7,63,43,20,67
SK Sturm Gra,8019,3,19,9,8,60,29,31,66
SC Rheindorf,8019,4,19,6,11,58,48,10,63
RZ Pellets W,8019,5,13,10,13,48,52,-4,49
Rapid Vienna,8019,6,11,11,14,54,47,7,44
Admira Wacke,8019,7,12,5,19,37,64,-27,41
SV Josko Rie,8019,8,9,7,20,33,57,-24,34
Mattersburg,8019,9,7,10,19,35,62,-27,31
St. Pölten,8019,10,7,8,21,38,63,-25,29
FC Salzburg,8020,1,21,8,7,65,28,37,71
SC Rheindorf,8020,2,21,8,7,58,36,22,71
SK Sturm Gra,8020,3,21,5,10,65,34,31,68
Rapid Vienna,8020,4,16,10,10,53,36,17,58
Vienna,8020,5,18,3,15,60,55,5,57
RZ Pellets W,8020,6,13,4,19,45,61,-16,43
SV Josko Rie,8020,7,12,4,20,39,53,-14,40
St. Pölten,8020,8,9,8,19,45,70,-25,35
Admira Wacke,8020,9,9,6,21,31,68,-37,33
Mattersburg,8020,10,7,10,19,36,56,-20,31
FC Salzburg,8021,1,22,7,7,59,27,32,73
SK Sturm Gra,8021,2,20,7,9,59,30,29,67
SC Rheindorf,8021,3,19,8,9,57,43,14,65
Vienna,8021,4,18,5,13,69,57,12,59
Rapid Vienna,8021,5,14,12,10,61,39,22,54
Admira Wacke,8021,6,12,9,15,33,49,-16,45
RZ Pellets W,8021,7,11,7,18,42,54,-12,40
St. Pölten,8021,8,8,11,17,37,67,-30,35
SV Josko Rie,8021,9,9,7,20,28,54,-26,34
Mattersburg,8021,10,6,9,21,35,60,-25,27
FC Salzburg,8022,1,21,10,5,69,31,38,73
SC Rheindorf,8022,2,18,8,10,55,43,12,62
Vienna,8022,3,18,6,12,64,55,9,60
SK Sturm Gra,8022,4,18,5,13,58,39,19,59
Rapid Vienna,8022,5,14,13,9,58,36,22,55
RZ Pellets W,8022,6,13,8,15,45,53,-8,47
St. Pölten,8022,7,11,10,15,40,55,-15,43
SV Josko Rie,8022,8,10,6,20,37,58,-21,36
Mattersburg,8022,9,8,10,18,33,57,-24,34
Admira Wacke,8022,10,7,8,21,24,56,-32,29
FC Salzburg,8023,1,22,8,6,71,34,37,74
SC Rheindorf,8023,2,20,8,8,58,41,17,68
Vienna,8023,3,19,4,13,67,56,11,61
SK Sturm Gra,8023,4,18,5,13,54,39,15,59
Rapid Vienna,8023,5,15,10,11,57,42,15,55
RZ Pellets W,8023,6,15,6,15,54,54,0,51
SV Josko Rie,8023,7,12,5,19,38,50,-12,41
Admira Wacke,8023,8,9,7,20,34,67,-33,34
St. Pölten,8023,9,7,11,18,42,67,-25,32
Mattersburg,8023,10,7,8,21,36,61,-25,29
SC Rheindorf,8024,1,20,8,8,59,38,21,68
FC Salzburg,8024,2,17,9,10,58,34,24,60
SK Sturm Gra,8024,3,17,8,11,56,36,20,59
Vienna,8024,4,17,7,12,60,50,10,58
Rapid Vienna,8024,5,15,9,12,60,42,18,54
St. Pölten,8024,6,11,10,15,45,63,-18,43
Admira Wacke,8024,7,12,7,17,34,53,-19,43
SV Josko Rie,8024,8,12,6,18,34,49,-15,42
RZ Pellets W,8024,9,11,9,16,46,62,-16,42
Mattersburg,8024,10,8,7,21,40,65,-25,31
FC Salzburg,8025,1,21,7,8,63,33,30,70
SC Rheindorf,8025,2,18,9,9,55,41,14,63
SK Sturm Gra,8025,3,17,7,12,55,36,19,58
Vienna,8025,4,15,7,14,57,56,1,52
Rapid Vienna,8025,5,13,12,11,52,35,17,51
RZ Pellets W,8025,6,14,9,13,46,53,-7,51
Admira Wacke,8025,7,13,5,18,37,57,-20,44
St. Pölten,8025,8,10,10,16,39,56,-17,40
Mattersburg,8025,9,10,6,20,38,55,-17,36
SV Josko Rie,8025,10,10,6,20,36,56,-20,36
SC Rheindorf,8026,1,20,9,7,62,41,21,69
FC Salzburg,8026,2,19,11,6,65,29,36,68
SK Sturm Gra,8026,3,19,7,10,60,35,25,64
Rapid Vienna,8026,4,16,10,10,63,38,25,58
Vienna,8026,5,17,5,14,68,58,10,56
Admira Wacke,8026,6,12,5,19,38,65,-27,41
St. Pölten,8026,7,10,10,16,44,58,-14,40
SV Josko Rie,8026,8,11,7,18,38,56,-18,40
RZ Pellets W,8026,9,10,9,17,44,65,-21,39
Mattersburg,8026,10,5,9,22,32,69,-37,24
SC Rheindorf,8027,1,22,6,8,58,37,21,72
FC Salzburg,8027,2,21,5,10,64,32,32,68
Vienna,8027,3,20,6,10,60,45,15,66
SK Sturm Gra,8027,4,18,7,11,56,34,22,61
Rapid Vienna,8027,5,12,12,12,52,43,9,48
St. Pölten,8027,6,13,7,16,46,60,-14,46
RZ Pellets W,8027,7,12,6,18,44,55,-11,42
Admira Wacke,8027,8,11,5,20,32,58,-26,38
SV Josko Rie,8027,9,11,4,21,30,53,-23,37
Mattersburg,8027,10,7,8,21,36,61,-25,29
FC Salzburg,8028,1,22,5,9,68,30,38,71
SK Sturm Gra,8028,2,21,5,10,61,30,31,68
SC Rheindorf,8028,3,18,9,9,55,46,9,63
Vienna,8028,4,18,4,14,63,56,7,58
RZ Pellets W,8028,5,16,6,14,54,50,4,54
Rapid Vienna,8028,6,13,11,12,53,43,10,50
Admira Wacke,8028,7,11,6,19,42,68,-26,39
Mattersburg,8028,8,10,7,19,39,62,-23,37
SV Josko Rie,8028,9,9,6,21,29,50,-21,33
St. Pölten,8028,10,8,9,19,34,63,-29,33
SC Rheindorf,8029,1,20,8,8,53,38,15,68
SK Sturm Gra,8029,2,20,4,12,64,35,29,64
Vienna,8029,3,19,6,11,69,56,13,63
FC Salzburg,8029,4,19,5,12,61,38,23,62
Rapid Vienna,8029,5,15,10,11,55,43,12,55
SV Josko Rie,8029,6,13,5,18,38,53,-15,44
Admira Wacke,8029,7,12,6,18,42,61,-19,42
RZ Pellets W,8029,8,10,7,19,39,57,-18,37
Mattersburg,8029,9,10,6,20,48,63,-15,36
St. Pölten,8029,10,8,11,17,43,68,-25,35
SC Rheindorf,8030,1,21,9,6,60,40,20,72
Vienna,8030,2,22,4,10,67,46,21,70
SK Sturm Gra,8030,3,20,6,10,58,35,23,66
FC Salzburg,8030,4,18,6,12,54,36,18,60
Rapid Vienna,8030,5,13,8,15,55,47,8,47
Admira Wacke,8030,6,12,8,16,31,50,-19,44
RZ Pellets W,8030,7,12,7,17,48,57,-9,43
St. Pölten,8030,8,11,8,17,46,59,-13,41
SV Josko Rie,8030,9,9,5,22,29,51,-22,32
Mattersburg,8030,10,8,7,21,36,63,-27,31
FC Salzburg,8031,1,18,8,10,57,33,24,62
SC Rheindorf,8031,2,18,8,10,51,43,8,62
SK Sturm Gra,8031,3,17,7,12,61,40,21,58
Vienna,8031,4,17,7,12,57,48,9,58
RZ Pellets W,8031,5,15,7,14,51,55,-4,52
Rapid Vienna,8031,6,12,13,11,57,47,10,49
St. Pölten,8031,7,11,9,16,42,55,-13,42
Admira Wacke,8031,8,11,8,17,33,53,-20,41
SV Josko Rie,8031,9,11,7,18,37,54,-17,40
Mattersburg,8031,10,8,10,18,34,52,-18,34
SK Sturm Gra,8032,1,22,5,9,61,32,29,71
SC Rheindorf,8032,2,21,6,9,63,44,19,69
FC Salzburg,8032,3,20,8,8,66,35,31,68
Vienna,8032,4,18,6,12,67,53,14,60
Rapid Vienna,8032,5,16,8,12,54,42,12,56
SV Josko Rie,8032,6,14,3,19,44,53,-9,45
St. Pölten,8032,7,11,6,19,35,60,-25,39
RZ Pellets W,8032,8,10,7,19,45,65,-20,37
Admira Wacke,8032,9,10,4,22,44,69,-25,34
Mattersburg,8032,10,8,7,21,38,64,-26,31
FC Salzburg,8033,1,21,7,8,71,31,40,70
SC Rheindorf,8033,2,20,8,8,59,47,12,68
Vienna,8033,3,20,5,11,63,48,15,65
SK Sturm Gra,8033,4,16,6,14,57,42,15,54
Rapid Vienna,8033,5,14,12,10,58,44,14,54
RZ Pellets W,8033,6,13,11,12,46,47,-1,50
SV Josko Rie,8033,7,12,3,21,30,51,-21,39
Admira Wacke,8033,8,10,7,19,32,59,-27,37
Mattersburg,8033,9,9,8,19,43,61,-18,35
St. Pölten,8033,10,7,9,20,40,69,-29,30
FC Salzburg,8034,1,22,6,8,65,28,37,72
SK Sturm Gra,8034,2,22,6,8,67,33,34,72
SC Rheindorf,8034,3,18,6,12,55,44,11,60
Vienna,8034,4,17,6,13,57,50,7,57
Rapid Vienna,8034,5,12,11,13,49,41,8,47
RZ Pellets W,8034,6,12,10,14,42,52,-10,46
SV Josko Rie,8034,7,14,4,18,39,54,-15,46
St. Pölten,8034,8,10,7,19,42,60,-18,37
Mattersburg,8034,9,8,10,18,29,48,-19,34
Admira Wacke,8034,10,9,6,21,31,66,-35,33
FC Salzburg,8035,1,24,5,7,69,28,41,77
SC Rheindorf,8035,2,19,7,10,48,41,7,64
SK Sturm Gra,8035,3,18,6,12,55,39,16,60
Rapid Vienna,8035,4,14,12,10,58,39,19,54
Vienna,8035,5,15,4,17,52,53,-1,49
Admira Wacke,8035,6,12,10,14,41,55,-14,46
RZ Pellets W,8035,7,13,6,17,51,53,-2,45
SV Josko Rie,8035,8,12,4,20,32,55,-23,40
St. Pölten,8035,9,9,10,17,39,58,-19,37
Mattersburg,8035,10,8,8,20,34,58,-24,32
FC Salzburg,8036,1,22,7,7,73,31,42,73
SC Rheindorf,8036,2,20,7,9,55,42,13,67
SK Sturm Gra,8036,3,18,8,10,48,27,21,62
Rapid Vienna,8036,4,16,9,11,59,39,20,57
RZ Pellets W,8036,5,17,6,13,46,47,-1,57
Vienna,8036,6,17,5,14,58,51,7,56
St. Pölten,8036,7,11,9,16,41,58,-17,42
Admira Wacke,8036,8,9,10,17,37,55,-18,37
SV Josko Rie,8036,9,8,6,22,32,57,-25,30
Mattersburg,8036,10,5,7,24,31,73,-42,22
FC Salzburg,8037,1,22,9,5,65,29,36,75
SK Sturm Gra,8037,2,19,9,8,55,28,27,66
SC Rheindorf,8037,3,19,8,9,51,39,12,65
Vienna,8037,4,19,5,12,67,50,17,62
RZ Pellets W,8037,5,14,8,14,54,54,0,50
Rapid Vienna,8037,6,12,12,12,54,45,9,48
SV Josko Rie,8037,7,11,6,19,43,56,-13,39
Admira Wacke,8037,8,11,4,21,37,70,-33,37
Mattersburg,8037,9,9,7,20,35,54,-19,34
St. Pölten,8037,10,6,8,22,34,70,-36,26
SC Rheindorf,8038,1,21,7,8,54,38,16,70
FC Salzburg,8038,2,20,8,8,65,32,33,68
SK Sturm Gra,8038,3,17,9,10,61,36,25,60
Vienna,8038,4,17,8,11,65,50,15,59
RZ Pellets W,8038,5,13,10,13,49,50,-1,49
Admira Wacke,8038,6,13,9,14,40,51,-11,48
Rapid Vienna,8038,7,10,16,10,50,42,8,46
St. Pölten,8038,8,10,8,18,43,66,-23,38
SV Josko Rie,8038,9,10,5,21,35,60,-25,35
Mattersburg,8038,10,6,6,24,30,67,-37,24
FC Salzburg,8039,1,21,4,11,66,29,37,67
SC Rheindorf,8039,2,19,10,7,49,34,15,67
SK Sturm Gra,8039,3,18,9,9,59,34,25,63
Vienna,8039,4,18,7,11,59,49,10,61
Rapid Vienna,8039,5,11,14,11,49,37,12,47
RZ Pellets W,8039,6,13,8,15,38,49,-11,47
Mattersburg,8039,7,10,8,18,44,57,-13,38
Admira Wacke,8039,8,11,5,20,35,64,-29,38
SV Josko Rie,8039,9,9,8,19,29,52,-23,35
St. Pölten,8039,10,7,13,16,38,61,-23,34
Vienna,8040,1,21,6,9,68,46,22,69
FC Salzburg,8040,2,19,10,7,59,29,30,67
SC Rheindorf,8040,3,19,9,8,55,41,14,66
SK Sturm Gra,8040,4,17,8,11,56,37,19,59
Rapid Vienna,8040,5,13,11,12,56,41,15,50
RZ Pellets W,8040,6,11,12,13,43,54,-11,45
SV Josko Rie,8040,7,13,4,19,41,55,-14,43
Admira Wacke,8040,8,11,4,21,38,65,-27,37
Mattersburg,8040,9,9,7,20,38,56,-18,34
St. Pölten,8040,10,7,9,20,39,69,-30,30
FC Salzburg,8041,1,22,8,6,70,26,44,74
SK Sturm Gra,8041,2,20,7,9,67,31,36,67
SC Rheindorf,8041,3,20,7,9,59,47,12,67
Vienna,8041,4,18,3,15,55,53,2,57
Rapid Vienna,8041,5,13,13,10,56,39,17,52
RZ Pellets W,8041,6,14,9,13,54,55,-1,51
Admira Wacke,8041,7,11,7,18,36,65,-29,40
SV Josko Rie,8041,8,11,6,19,33,49,-16,39
St. Pölten,8041,9,7,11,18,38,62,-24,32
Mattersburg,8041,10,5,7,24,30,71,-41,22
FC Salzburg,8042,1,20,8,8,73,38,35,68
Rapid Vienna,8042,2,18,10,8,73,42,31,64
SC Rheindorf,8042,3,18,9,9,54,40,14,63
Vienna,8042,4,18,7,11,63,53,10,61
SK Sturm Gra,8042,5,17,7,12,57,40,17,58
RZ Pellets W,8042,6,12,7,17,44,63,-19,43
SV Josko Rie,8042,7,13,3,20,41,58,-17,42
Admira Wacke,8042,8,12,6,18,37,60,-23,42
St. Pölten,8042,9,8,11,17,40,60,-20,35
Mattersburg,8042,10,6,8,22,35,63,-28,26
FC Salzburg,8043,1,22,8,6,62,25,37,74
SC Rheindorf,8043,2,20,7,9,55,34,21,67
SK Sturm Gra,8043,3,20,5,11,59,38,21,65
Vienna,8043,4,16,7,13,56,54,2,55
Rapid Vienna,8043,5,13,12,11,53,39,14,51
Admira Wacke,8043,6,11,7,18,36,62,-26,40
RZ Pellets W,8043,7,10,9,17,42,57,-15,39
St. Pölten,8043,8,10,9,17,48,67,-19,39
SV Josko Rie,8043,9,10,6,20,34,54,-20,36
Mattersburg,8043,10,9,8,19,31,46,-15,35
Vienna,8044,1,23,5,8,70,46,24,74
FC Salzburg,8044,2,19,8,9,60,35,25,65
SK Sturm Gra,8044,3,20,4,12,55,31,24,64
SC Rheindorf,8044,4,19,5,12,57,46,11,62
Rapid Vienna,8044,5,14,12,10,52,37,15,54
RZ Pellets W,8044,6,12,7,17,43,55,-12,43
Mattersburg,8044,7,10,8,18,42,53,-11,38
Admira Wacke,8044,8,10,7,19,35,62,-27,37
St. Pölten,8044,9,8,10,18,37,60,-23,34
SV Josko Rie,8044,10,9,6,21,27,53,-26,33
SC Rheindorf,8045,1,23,6,7,60,40,20,75
FC Salzburg,8045,2,19,9,8,66,34,32,66
SK Sturm Gra,8045,3,20,4,12,61,37,24,64
Vienna,8045,4,17,6,13,64,56,8,57
Rapid Vienna,8045,5,13,12,11,49,36,13,51
RZ Pellets W,8045,6,13,7,16,50,60,-10,46
Admira Wacke,8045,7,11,7,18,38,56,-18,40
SV Josko Rie,8045,8,11,6,19,39,57,-18,39
St. Pölten,8045,9,6,14,16,42,67,-25,32
Mattersburg,8045,10,7,9,20,34,60,-26,30
FC Salzburg,8046,1,23,5,8,70,31,39,74
SC Rheindorf,8046,2,21,7,8,63,43,20,70
Vienna,8046,3,17,7,12,58,53,5,58
SK Sturm Gra,8046,4,16,8,12,55,39,16,56
Rapid Vienna,8046,5,15,10,11,61,35,26,55
RZ Pellets W,8046,6,15,7,14,52,50,2,52
St. Pölten,8046,7,9,10,17,36,62,-26,37
SV Josko Rie,8046,8,8,11,17,35,55,-20,35
Admira Wacke,8046,9,10,5,21,32,65,-33,35
Mattersburg,8046,10,6,10,20,36,65,-29,28
FC Salzburg,8047,1,21,8,7,62,25,37,71
Vienna,8047,2,17,9,10,58,47,11,60
SK Sturm Gra,8047,3,17,6,13,53,39,14,57
RZ Pellets W,8047,4,17,6,13,52,47,5,57
SC Rheindorf,8047,5,17,6,13,51,49,2,57
Rapid Vienna,8047,6,15,10,11,58,40,18,55
SV Josko Rie,8047,7,13,3,20,35,48,-13,42
St. Pölten,8047,8,10,9,17,42,67,-25,39
Admira Wacke,8047,9,9,9,18,32,57,-25,36
Mattersburg,8047,10,7,8,21,35,59,-24,29
FC Salzburg,8048,1,21,7,8,66,34,32,70
Vienna,8048,2,18,10,8,62,45,17,64
SC Rheindorf,8048,3,18,9,9,53,50,3,63
SK Sturm Gra,8048,4,18,8,10,62,36,26,62
Rapid Vienna,8048,5,12,12,12,60,55,5,48
RZ Pellets W,8048,6,12,8,16,48,54,-6,44
St. Pölten,8048,7,10,13,13,54,63,-9,43
Admira Wacke,8048,8,9,8,19,34,59,-25,35
SV Josko Rie,8048,9,8,8,20,32,54,-22,32
Mattersburg,8048,10,6,13,17,40,61,-21,31
FC Salzburg,8049,1,22,7,7,62,26,36,73
SK Sturm Gra,8049,2,19,7,10,61,39,22,64
SC Rheindorf,8049,3,18,9,9,50,41,9,63
Vienna,8049,4,18,4,14,62,57,5,58
Rapid Vienna,8049,5,15,11,10,50,31,19,56
RZ Pellets W,8049,6,13,7,16,45,57,-12,46
Admira Wacke,8049,7,11,7,18,37,56,-19,40
SV Josko Rie,8049,8,10,6,20,31,51,-20,36
St. Pölten,8049,9,9,8,19,45,64,-19,35
Mattersburg,8049,10,8,8,20,38,59,-21,32
FC Salzburg,8050,1,24,7,5,71,32,39,79
Vienna,8050,2,22,3,11,70,54,16,69
SC Rheindorf,8050,3,20,8,8,55,36,19,68
Rapid Vienna,8050,4,17,9,10,57,37,20,60
SK Sturm Gra,8050,5,17,8,11,64,39,25,59
RZ Pellets W,8050,6,12,7,17,46,59,-13,43
Mattersburg,8050,7,8,9,19,36,56,-20,33
Admira Wacke,8050,8,8,9,19,33,58,-25,33
SV Josko Rie,8050,9,9,5,22,34,62,-28,32
St. Pölten,8050,10,6,9,21,36,69,-33,27
FC Salzburg,8051,1,22,7,7,71,33,38,73
SC Rheindorf,8051,2,20,7,9,59,43,16,67
SK Sturm Gra,8051,3,19,8,9,58,33,25,65
Rapid Vienna,8051,4,16,11,9,58,38,20,59
Vienna,8051,5,16,6,14,57,49,8,54
Admira Wacke,8051,6,10,10,16,35,58,-23,40
Mattersburg,8051,7,11,6,19,41,61,-20,39
SV Josko Rie,8051,8,10,6,20,38,56,-18,36
RZ Pellets W,8051,9,9,8,19,34,53,-19,35
St. Pölten,8051,10,7,11,18,36,63,-27,32
FC Salzburg,8052,1,22,7,7,69,32,37,73
Vienna,8052,2,20,7,9,64,41,23,67
SK Sturm Gra,8052,3,19,7,10,54,32,22,64
SC Rheindorf,8052,4,16,7,13,50,45,5,55
RZ Pellets W,8052,5,15,5,16,54,59,-5,50
Rapid Vienna,8052,6,12,10,14,54,45,9,46
Admira Wacke,8052,7,12,8,16,39,61,-22,44
St. Pölten,8052,8,11,9,16,42,66,-24,42
SV Josko Rie,8052,9,10,4,22,32,54,-22,34
Mattersburg,8052,10,7,8,21,33,56,-23,29
FC Salzburg,8053,1,22,8,6,69,29,40,74
SK Sturm Gra,8053,2,23,4,9,68,35,33,73
SC Rheindorf,8053,3,20,5,11,61,44,17,65
Vienna,8053,4,19,4,13,66,55,11,61
Rapid Vienna,8053,5,14,12,10,55,37,18,54
RZ Pellets W,8053,6,13,6,17,43,56,-13,45
Admira Wacke,8053,7,13,5,18,42,59,-17,44
SV Josko Rie,8053,8,9,5,22,32,54,-22,32
St. Pölten,8053,9,7,9,20,34,69,-35,30
Mattersburg,8053,10,7,8,21,37,69,-32,29
FC Salzburg,8054,1,22,6,8,67,31,36,72
SC Rheindorf,8054,2,20,7,9,56,40,16,67
SK Sturm Gra,8054,3,20,6,10,60,32,28,66
Vienna,8054,4,17,6,13,60,55,5,57
Rapid Vienna,8054,5,14,10,12,56,43,13,52
RZ Pellets W,8054,6,12,7,17,49,62,-13,43
Mattersburg,8054,7,11,8,17,44,54,-10,41
SV Josko Rie,8054,8,11,7,18,32,49,-17,40
Admira Wacke,8054,9,10,8,18,37,60,-23,38
St. Pölten,8054,10,5,11,20,33,68,-35,26
FC Salzburg,8055,1,22,7,7,71,34,37,73
SC Rheindorf,8055,2,22,5,9,58,42,16,71
Vienna,8055,3,19,3,14,70,60,10,60
Rapid Vienna,8055,4,15,12,9,60,40,20,57
SK Sturm Gra,8055,5,16,9,11,55,37,18,57
RZ Pellets W,8055,6,13,8,15,47,54,-7,47
Admira Wacke,8055,7,11,8,17,37,54,-17,41
SV Josko Rie,8055,8,11,3,22,36,57,-21,36
St. Pölten,8055,9,8,8,20,40,69,-29,32
Mattersburg,8055,10,8,7,21,37,64,-27,31
FC Salzburg,8056,1,22,9,5,61,27,34,75
SK Sturm Gra,8056,2,22,5,9,63,33,30,71
SC Rheindorf,8056,3,18,8,10,50,40,10,62
Rapid Vienna,8056,4,16,9,11,63,41,22,57
Vienna,8056,5,18,3,15,54,48,6,57
RZ Pellets W,8056,6,14,8,14,45,52,-7,50
Admira Wacke,8056,7,10,7,19,32,57,-25,37
Mattersburg,8056,8,8,9,19,39,56,-17,33
St. Pölten,8056,9,6,12,18,39,66,-27,30
SV Josko Rie,8056,10,7,8,21,25,51,-26,29
FC Salzburg,8057,1,23,5,8,74,35,39,74
SC Rheindorf,8057,2,21,6,9,64,47,17,69
Vienna,8057,3,21,3,12,72,54,18,66
SK Sturm Gra,8057,4,18,4,14,65,47,18,58
Rapid Vienna,8057,5,15,10,11,63,45,18,55
RZ Pellets W,8057,6,14,7,15,44,51,-7,49
Admira Wacke,8057,7,12,4,20,39,62,-23,40
Mattersburg,8057,8,10,8,18,39,65,-26,38
SV Josko Rie,8057,9,9,6,21,39,61,-22,33
St. Pölten,8057,10,5,11,20,38,70,-32,26
FC Salzburg,8058,1,20,8,8,68,38,30,68
Vienna,8058,2,21,5,10,60,44,16,68
SK Sturm Gra,8058,3,18,7,11,51,34,17,61
SC Rheindorf,8058,4,18,7,11,58,49,9,61
Rapid Vienna,8058,5,14,12,10,56,37,19,54
RZ Pellets W,8058,6,11,7,18,43,56,-13,40
Mattersburg,8058,7,10,9,17,45,64,-19,39
Admira Wacke,8058,8,9,11,16,37,57,-20,38
St. Pölten,8058,9,9,10,17,40,59,-19,37
SV Josko Rie,8058,10,10,4,22,41,61,-20,34
FC Salzburg,8059,1,20,7,9,57,31,26,67
SC Rheindorf,8059,2,18,10,8,52,42,10,64
SK Sturm Gra,8059,3,18,7,11,59,36,23,61
Vienna,8059,4,16,5,15,64,58,6,53
Rapid Vienna,8059,5,13,11,12,56,45,11,50
Admira Wacke,8059,6,14,5,17,44,60,-16,47
SV Josko Rie,8059,7,14,4,18,40,53,-13,46
RZ Pellets W,8059,8,12,6,18,45,63,-18,42
Mattersburg,8059,9,11,7,18,42,51,-9,40
St. Pölten,8059,10,10,6,20,46,66,-20,36
FC Salzburg,8060,1,23,6,7,71,32,39,75
SK Sturm Gra,8060,2,20,5,11,62,39,23,65
SC Rheindorf,8060,3,18,9,9,52,40,12,63
Vienna,8060,4,19,6,11,63,53,10,63
Rapid Vienna,8060,5,14,8,14,55,40,15,50
RZ Pellets W,8060,6,12,8,16,43,55,-12,44
SV Josko Rie,8060,7,10,11,15,28,41,-13,41
Admira Wacke,8060,8,11,5,20,35,56,-21,38
Mattersburg,8060,9,8,9,19,35,56,-21,33
St. Pölten,8060,10,7,9,20,42,74,-32,30
FC Salzburg,8061,1,21,8,7,68,32,36,71
SC Rheindorf,8061,2,20,8,8,61,39,22,68
Vienna,8061,3,21,4,11,62,47,15,67
SK Sturm Gra,8061,4,16,9,11,55,33,22,57
Rapid Vienna,8061,5,12,15,9,56,39,17,51
Admira Wacke,8061,6,11,6,19,37,61,-24,39
RZ Pellets W,8061,7,9,10,17,40,61,-21,37
St. Pölten,8061,8,9,10,17,36,57,-21,37
Mattersburg,8061,9,8,11,17,36,58,-22,35
SV Josko Rie,8061,10,9,7,20,38,62,-24,34
FC Salzburg,8062,1,21,10,5,67,25,42,73
SK Sturm Gra,8062,2,20,5,11,54,32,22,65
SC Rheindorf,8062,3,19,7,10,53,42,11,64
Vienna,8062,4,16,5,15,58,54,4,53
Rapid Vienna,8062,5,13,11,12,58,46,12,50
Admira Wacke,8062,6,15,5,16,35,49,-14,50
RZ Pellets W,8062,7,12,8,16,50,62,-12,44
SV Josko Rie,8062,8,11,7,18,37,52,-15,40
Mattersburg,8062,9,7,10,19,34,54,-20,31
St. Pölten,8062,10,7,10,19,42,72,-30,31
FC Salzburg,8063,1,21,10,5,70,30,40,73
SC Rheindorf,8063,2,20,8,8,54,35,19,68
SK Sturm Gra,8063,3,20,4,12,58,33,25,64
Vienna,8063,4,16,6,14,54,48,6,54
Rapid Vienna,8063,5,13,9,14,53,48,5,48
RZ Pellets W,8063,6,14,5,17,48,57,-9,47
SV Josko Rie,8063,7,12,9,15,33,45,-12,45
Mattersburg,8063,8,9,10,17,37,53,-16,37
Admira Wacke,8063,9,10,5,21,32,63,-31,35
St. Pölten,8063,10,8,8,20,40,67,-27,32
Vienna,8064,1,24,3,9,77,47,30,75
SC Rheindorf,8064,2,22,6,8,67,39,28,72
SK Sturm Gra,8064,3,19,4,13,62,43,19,61
Rapid Vienna,8064,4,16,11,9,59,38,21,59
FC Salzburg,8064,5,16,7,13,52,40,12,55
Admira Wacke,8064,6,12,6,18,47,62,-15,42
RZ Pellets W,8064,7,10,8,18,45,66,-21,38
Mattersburg,8064,8,9,8,19,41,61,-20,35
SV Josko Rie,8064,9,10,5,21,37,60,-23,35
St. Pölten,8064,10,9,8,19,38,69,-31,35
SK Sturm Gra,8065,1,22,7,7,64,29,35,73
FC Salzburg,8065,2,19,9,8,58,31,27,66
SC Rheindorf,8065,3,19,5,12,53,41,12,62
Vienna,8065,4,17,9,10,64,54,10,60
Rapid Vienna,8065,5,15,13,8,62,38,24,58
RZ Pellets W,8065,6,12,9,15,45,55,-10,45
SV Josko Rie,8065,7,10,6,20,29,50,-21,36
St. Pölten,8065,8,8,10,18,36,61,-25,34
Admira Wacke,8065,9,9,6,21,35,65,-30,33
Mattersburg,8065,10,7,10,19,30,52,-22,31
FC Salzburg,8066,1,22,6,8,69,33,36,72
SK Sturm Gra,8066,2,22,4,10,62,27,35,70
SC Rheindorf,8066,3,20,7,9,58,44,14,67
Vienna,8066,4,18,6,12,60,46,14,60
Rapid Vienna,8066,5,14,11,11,49,35,14,53
RZ Pellets W,8066,6,11,10,15,38,51,-13,43
St. Pölten,8066,7,10,9,17,40,65,-25,39
Admira Wacke,8066,8,8,10,18,35,63,-28,34
SV Josko Rie,8066,9,10,3,23,37,58,-21,33
Mattersburg,8066,10,8,8,20,35,61,-26,32
FC Salzburg,8067,1,22,8,6,73,31,42,74
Vienna,8067,2,20,4,12,59,48,11,64
SC Rheindorf,8067,3,18,10,8,54,43,11,64
SK Sturm Gra,8067,4,17,8,11,55,36,19,59
Rapid Vienna,8067,5,11,15,10,56,42,14,48
RZ Pellets W,8067,6,12,8,16,41,49,-8,44
SV Josko Rie,8067,7,11,8,17,36,52,-16,41
Admira Wacke,8067,8,11,5,20,34,58,-24,38
St. Pölten,8067,9,8,11,17,40,61,-21,35
Mattersburg,8067,10,6,11,19,32,60,-28,29
SC Rheindorf,8068,1,23,5,8,61,38,23,74
FC Salzburg,8068,2,22,6,8,67,31,36,72
SK Sturm Gra,8068,3,20,4,12,66,35,31,64
Vienna,8068,4,17,3,16,57,60,-3,54
Rapid Vienna,8068,5,13,12,11,57,44,13,51
RZ Pellets W,8068,6,14,9,13,44,50,-6,51
Mattersburg,8068,7,10,7,19,43,59,-16,37
Admira Wacke,8068,8,10,7,19,36,63,-27,37
SV Josko Rie,8068,9,11,4,21,30,57,-27,37
St. Pölten,8068,10,7,9,20,40,64,-24,30
FC Salzburg,8069,1,25,5,6,68,24,44,80
Vienna,8069,2,22,4,10,67,49,18,70
SK Sturm Gra,8069,3,19,8,9,66,39,27,65
SC Rheindorf,8069,4,17,8,11,48,44,4,59
Rapid Vienna,8069,5,13,13,10,51,38,13,52
St. Pölten,8069,6,11,7,18,47,62,-15,40
RZ Pellets W,8069,7,10,7,19,43,62,-19,37
Admira Wacke,8069,8,10,5,21,34,62,-28,35
Mattersburg,8069,9,7,12,17,30,54,-24,33
SV Josko Rie,8069,10,9,5,22,37,57,-20,32
FC Salzburg,8070,1,23,7,6,67,24,43,76
SK Sturm Gra,8070,2,22,4,10,63,33,30,70
SC Rheindorf,8070,3,17,9,10,53,45,8,60
Vienna,8070,4,17,7,12,65,57,8,58
Rapid Vienna,8070,5,13,10,13,53,37,16,49
St. Pölten,8070,6,10,12,14,47,60,-13,42
RZ Pellets W,8070,7,10,9,17,41,63,-22,39
SV Josko Rie,8070,8,11,5,20,37,56,-19,38
Admira Wacke,8070,9,10,5,21,34,65,-31,35
Mattersburg,8070,10,8,10,18,37,57,-20,34
Vienna,8071,1,22,7,7,70,42,28,73
FC Salzburg,8071,2,21,6,9,69,30,39,69
SK Sturm Gra,8071,3,20,6,10,57,33,24,66
SC Rheindorf,8071,4,18,8,10,55,42,13,62
Rapid Vienna,8071,5,14,12,10,59,40,19,54
RZ Pellets W,8071,6,10,8,18,38,56,-18,38
SV Josko Rie,8071,7,10,8,18,29,49,-20,38
St. Pölten,8071,8,8,11,17,37,62,-25,35
Mattersburg,8071,9,8,9,19,33,61,-28,33
Admira Wacke,8071,10,9,5,22,34,66,-32,32
FC Salzburg,8072,1,22,7,7,61,25,36,73
SC Rheindorf,8072,2,18,10,8,56,42,14,64
Vienna,8072,3,19,6,11,68,48,20,63
SK Sturm Gra,8072,4,18,6,12,59,42,17,60
Rapid Vienna,8072,5,13,12,11,56,39,17,51
RZ Pellets W,8072,6,10,12,14,53,62,-9,42
SV Josko Rie,8072,7,12,5,19,35,53,-18,41
St. Pölten,8072,8,10,9,17,46,68,-22,39
Admira Wacke,8072,9,9,7,20,35,68,-33,34
Mattersburg,8072,10,8,8,20,36,58,-22,32
SC Rheindorf,8073,1,20,12,4,56,33,23,72
FC Salzburg,8073,2,20,8,8,63,33,30,68
SK Sturm Gra,8073,3,18,8,10,57,36,21,62
Rapid Vienna,8073,4,15,11,10,54,36,18,56
Vienna,8073,5,16,7,13,59,50,9,55
RZ Pellets W,8073,6,11,9,16,43,55,-12,42
Mattersburg,8073,7,11,8,17,44,51,-7,41
Admira Wacke,8073,8,11,7,18,38,62,-24,40
St. Pölten,8073,9,6,13,17,39,64,-25,31
SV Josko Rie,8073,10,8,5,23,31,64,-33,29
FC Salzburg,8074,1,25,7,4,66,20,46,82
SC Rheindorf,8074,2,19,9,8,56,39,17,66
Vienna,8074,3,17,7,12,55,44,11,58
Rapid Vienna,8074,4,15,9,12,50,39,11,54
SK Sturm Gra,8074,5,15,7,14,48,37,11,52
RZ Pellets W,8074,6,14,7,15,45,52,-7,49
Admira Wacke,8074,7,11,8,17,33,54,-21,41
SV Josko Rie,8074,8,10,6,20,35,53,-18,36
St. Pölten,8074,9,9,8,19,38,58,-20,35
Mattersburg,8074,10,6,10,20,30,60,-30,28
FC Salzburg,8075,1,22,9,5,67,25,42,75
SK Sturm Gra,8075,2,22,6,8,59,29,30,72
Vienna,8075,3,18,8,10,58,45,13,62
SC Rheindorf,8075,4,17,8,11,55,44,11,59
Rapid Vienna,8075,5,13,10,13,55,44,11,49
RZ Pellets W,8075,6,12,7,17,49,61,-12,43
Mattersburg,8075,7,11,7,18,41,53,-12,40
SV Josko Rie,8075,8,9,7,20,34,57,-23,34
Admira Wacke,8075,9,9,7,20,36,70,-34,34
St. Pölten,8075,10,8,9,19,49,75,-26,33
SC Rheindorf,8076,1,22,8,6,57,40,17,74
SK Sturm Gra,8076,2,19,8,9,58,30,28,65
FC Salzburg,8076,3,19,6,11,67,38,29,63
Vienna,8076,4,16,8,12,55,51,4,56
Admira Wacke,8076,5,15,6,15,46,52,-6,51
Rapid Vienna,8076,6,12,8,16,48,49,-1,44
RZ Pellets W,8076,7,11,7,18,47,58,-11,40
SV Josko Rie,8076,8,11,7,18,33,52,-19,40
St. Pölten,8076,9,9,9,18,43,64,-21,36
Mattersburg,8076,10,9,7,20,43,63,-20,34
FC Salzburg,8077,1,22,7,7,72,34,38,73
SC Rheindorf,8077,2,21,6,9,53,39,14,69
SK Sturm Gra,8077,3,18,7,11,59,38,21,61
Rapid Vienna,8077,4,17,9,10,64,40,24,60
Vienna,8077,5,17,4,15,56,55,1,55
RZ Pellets W,8077,6,11,8,17,42,55,-13,41
St. Pölten,8077,7,11,7,18,43,61,-18,40
Admira Wacke,8077,8,11,6,19,35,60,-25,39
Mattersburg,8077,9,9,9,18,34,51,-17,36
SV Josko Rie,8077,10,7,9,20,29,54,-25,30
SC Rheindorf,8078,1,21,7,8,55,38,17,70
FC Salzburg,8078,2,20,8,8,61,29,32,68
SK Sturm Gra,8078,3,19,9,8,61,29,32,66
Vienna,8078,4,19,6,11,71,51,20,63
Rapid Vienna,8078,5,15,10,11,52,40,12,55
RZ Pellets W,8078,6,12,10,14,44,50,-6,46
Admira Wacke,8078,7,10,6,20,36,62,-26,36
SV Josko Rie,8078,8,10,5,21,28,51,-23,35
St. Pölten,8078,9,9,7,20,38,65,-27,34
Mattersburg,8078,10,6,10,20,30,61,-31,28
SK Sturm Gra,8079,1,22,7,7,61,27,34,73
FC Salzburg,8079,2,22,6,8,72,32,40,72
Vienna,8079,3,18,6,12,58,48,10,60
SC Rheindorf,8079,4,14,11,11,41,38,3,53
RZ Pellets W,8079,5,14,7,15,49,55,-6,49
Rapid Vienna,8079,6,13,9,14,47,37,10,48
Admira Wacke,8079,7,13,7,16,40,57,-17,46
SV Josko Rie,8079,8,11,5,20,29,52,-23,38
Mattersburg,8079,9,7,11,18,33,58,-25,32
St. Pölten,8079,10,5,13,18,35,61,-26,28
SC Rheindorf,8080,1,21,7,8,58,37,21,70
FC Salzburg,8080,2,19,9,8,64,29,35,66
Vienna,8080,3,18,6,12,62,54,8,60
SK Sturm Gra,8080,4,16,7,13,55,38,17,55
Rapid Vienna,8080,5,15,7,14,54,41,13,52
RZ Pellets W,8080,6,14,6,16,47,53,-6,48
Admira Wacke,8080,7,13,8,15,37,52,-15,47
SV Josko Rie,8080,8,12,6,18,38,52,-14,42
St. Pölten,8080,9,8,10,18,40,72,-32,34
Mattersburg,8080,10,7,8,21,34,61,-27,29
FC Salzburg,8081,1,21,9,6,72,34,38,72
SK Sturm Gra,8081,2,21,6,9,69,36,33,69
SC Rheindorf,8081,3,20,6,10,51,39,12,66
Vienna,8081,4,19,7,10,76,49,27,64
Rapid Vienna,8081,5,12,12,12,55,44,11,48
Admira Wacke,8081,6,14,6,16,40,59,-19,48
RZ Pellets W,8081,7,10,7,19,36,64,-28,37
SV Josko Rie,8081,8,9,7,20,34,57,-23,34
St. Pölten,8081,9,8,10,18,43,68,-25,34
Mattersburg,8081,10,6,10,20,41,67,-26,28
FC Salzburg,8082,1,20,10,6,62,27,35,70
SK Sturm Gra,8082,2,17,10,9,56,33,23,61
Vienna,8082,3,19,4,13,69,54,15,61
SC Rheindorf,8082,4,16,7,13,52,48,4,55
Rapid Vienna,8082,5,12,13,11,52,42,10,49
Admira Wacke,8082,6,12,8,16,35,58,-23,44
RZ Pellets W,8082,7,12,7,17,48,58,-10,43
SV Josko Rie,8082,8,11,8,17,34,47,-13,41
Mattersburg,8082,9,9,9,18,39,57,-18,36
St. Pölten,8082,10,8,12,16,39,62,-23,36
FC Salzburg,8083,1,20,8,8,64,34,30,68
SK Sturm Gra,8083,2,20,8,8,59,31,28,68
SC Rheindorf,8083,3,18,9,9,54,42,12,63
Vienna,8083,4,17,6,13,55,52,3,57
Rapid Vienna,8083,5,15,11,10,63,39,24,56
RZ Pellets W,8083,6,12,9,15,42,51,-9,45
Admira Wacke,8083,7,10,8,18,34,60,-26,38
SV Josko Rie,8083,8,11,4,21,39,62,-23,37
Mattersburg,8083,9,10,6,20,42,56,-14,36
St. Pölten,8083,10,7,11,18,40,65,-25,32
FC Salzburg,8084,1,20,9,7,61,30,31,69
SK Sturm Gra,8084,2,20,5,11,57,32,25,65
Vienna,8084,3,18,7,11,61,47,14,61
SC Rheindorf,8084,4,17,9,10,50,44,6,60
Rapid Vienna,8084,5,13,11,12,52,42,10,50
Admira Wacke,8084,6,11,10,15,36,52,-16,43
St. Pölten,8084,7,10,10,16,49,62,-13,40
RZ Pellets W,8084,8,10,8,18,41,59,-18,38
SV Josko Rie,8084,9,10,8,18,39,58,-19,38
Mattersburg,8084,10,7,11,18,34,54,-20,32
FC Salzburg,8085,1,23,7,6,73,28,45,76
SC Rheindorf,8085,2,22,8,6,65,37,28,74
SK Sturm Gra,8085,3,18,8,10,58,36,22,62
Rapid Vienna,8085,4,13,11,12,53,46,7,50
Vienna,8085,5,14,6,16,53,58,-5,48
RZ Pellets W,8085,6,12,8,16,43,56,-13,44
Admira Wacke,8085,7,10,10,16,34,52,-18,40
Mattersburg,8085,8,10,9,17,36,50,-14,39
SV Josko Rie,8085,9,11,4,21,31,55,-24,37
St. Pölten,8085,10,6,11,19,32,60,-28,29
SK Sturm Gra,8086,1,20,7,9,62,40,22,67
Vienna,8086,2,21,3,12,72,61,11,66
FC Salzburg,8086,3,19,6,11,62,35,27,63
SC Rheindorf,8086,4,18,5,13,56,50,6,59
Rapid Vienna,8086,5,13,13,10,55,34,21,52
RZ Pellets W,8086,6,15,6,15,48,53,-5,51
St. Pölten,8086,7,10,9,17,44,61,-17,39
Mattersburg,8086,8,9,10,17,41,52,-11,37
Admira Wacke,8086,9,11,4,21,35,61,-26,37
SV Josko Rie,8086,10,11,3,22,34,62,-28,36
SC Rheindorf,8087,1,24,6,6,62,37,25,78
FC Salzburg,8087,2,21,6,9,64,28,36,69
Vienna,8087,3,21,5,10,65,46,19,68
Admira Wacke,8087,4,15,5,16,42,58,-16,50
SK Sturm Gra,8087,5,14,7,15,53,43,10,49
Rapid Vienna,8087,6,10,12,14,49,44,5,42
SV Josko Rie,8087,7,13,3,20,35,53,-18,42
RZ Pellets W,8087,8,10,11,15,49,57,-8,41
St. Pölten,8087,9,8,11,17,40,64,-24,35
Mattersburg,8087,10,5,12,19,38,67,-29,27
FC Salzburg,8088,1,20,7,9,57,32,25,67
SC Rheindorf,8088,2,18,8,10,52,40,12,62
SK Sturm Gra,8088,3,18,7,11,54,33,21,61
Rapid Vienna,8088,4,16,11,9,53,31,22,59
Vienna,8088,5,18,4,14,58,49,9,58
RZ Pellets W,8088,6,15,5,16,50,55,-5,50
Admira Wacke,8088,7,13,7,16,40,52,-12,46
St. Pölten,8088,8,7,13,16,37,56,-19,34
Mattersburg,8088,9,9,7,20,37,57,-20,34
SV Josko Rie,8088,10,9,5,22,26,59,-33,32
FC Salzburg,8089,1,22,6,8,67,32,35,72
SC Rheindorf,8089,2,18,10,8,48,36,12,64
SK Sturm Gra,8089,3,17,9,10,51,29,22,60
Vienna,8089,4,16,5,15,53,50,3,53
Rapid Vienna,8089,5,12,12,12,53,42,11,48
RZ Pellets W,8089,6,13,7,16,44,54,-10,46
Admira Wacke,8089,7,11,10,15,39,55,-16,43
Mattersburg,8089,8,10,11,15,36,50,-14,41
St. Pölten,8089,9,9,11,16,43,61,-18,38
SV Josko Rie,8089,10,8,7,21,26,51,-25,31
SC Rheindorf,8090,1,24,6,6,62,36,26,78
FC Salzburg,8090,2,22,7,7,61,27,34,73
SK Sturm Gra,8090,3,20,6,10,60,29,31,66
Vienna,8090,4,15,6,15,59,62,-3,51
RZ Pellets W,8090,5,15,6,15,51,56,-5,51
Rapid Vienna,8090,6,12,11,13,52,41,11,47
Admira Wacke,8090,7,12,5,19,39,58,-19,41
SV Josko Rie,8090,8,11,4,21,40,60,-20,37
Mattersburg,8090,9,9,8,19,41,58,-17,35
St. Pölten,8090,10,6,9,21,32,70,-38,27
FC Salzburg,8091,1,21,6,9,73,37,36,69
SK Sturm Gra,8091,2,19,7,10,63,37,26,64
Vienna,8091,3,19,6,11,66,54,12,63
SC Rheindorf,8091,4,18,9,9,53,46,7,63
Rapid Vienna,8091,5,13,11,12,52,40,12,50
RZ Pellets W,8091,6,13,8,15,47,51,-4,47
SV Josko Rie,8091,7,12,7,17,35,47,-12,43
Admira Wacke,8091,8,12,7,17,38,55,-17,43
Mattersburg,8091,9,8,6,22,36,63,-27,30
St. Pölten,8091,10,6,11,19,40,73,-33,29
FC Salzburg,8092,1,21,6,9,64,33,31,69
SC Rheindorf,8092,2,21,5,10,66,50,16,68
Vienna,8092,3,21,4,11,73,53,20,67
SK Sturm Gra,8092,4,17,6,13,56,37,19,57
Rapid Vienna,8092,5,13,9,14,55,46,9,48
RZ Pellets W,8092,6,12,8,16,49,58,-9,44
Admira Wacke,8092,7,11,8,17,40,65,-25,41
Mattersburg,8092,8,11,6,19,40,58,-18,39
SV Josko Rie,8092,9,11,5,20,39,59,-20,38
St. Pölten,8092,10,9,9,18,40,63,-23,36
FC Salzburg,8093,1,22,8,6,61,30,31,74
SC Rheindorf,8093,2,21,9,6,60,36,24,72
Vienna,8093,3,19,7,10,71,48,23,64
SK Sturm Gra,8093,4,17,7,12,54,39,15,58
Rapid Vienna,8093,5,14,10,12,58,39,19,52
RZ Pellets W,8093,6,13,6,17,48,58,-10,45
Admira Wacke,8093,7,11,8,17,40,62,-22,41
Mattersburg,8093,8,9,6,21,31,58,-27,33
SV Josko Rie,8093,9,9,5,22,38,63,-25,32
St. Pölten,8093,10,8,8,20,41,69,-28,32
SC Rheindorf,8094,1,20,8,8,55,45,10,68
Vienna,8094,2,21,4,11,66,49,17,67
SK Sturm Gra,8094,3,19,8,9,58,31,27,65
FC Salzburg,8094,4,18,8,10,66,38,28,62
Rapid Vienna,8094,5,14,13,9,55,35,20,55
Mattersburg,8094,6,11,8,17,39,55,-16,41
RZ Pellets W,8094,7,11,5,20,42,63,-21,38
Admira Wacke,8094,8,9,9,18,31,56,-25,36
SV Josko Rie,8094,9,10,5,21,39,57,-18,35
St. Pölten,8094,10,8,10,18,39,61,-22,34
FC Salzburg,8095,1,22,8,6,70,30,40,74
SK Sturm Gra,8095,2,19,7,10,57,35,22,64
Vienna,8095,3,18,8,10,61,50,11,62
SC Rheindorf,8095,4,18,6,12,58,47,11,60
Rapid Vienna,8095,5,14,12,10,56,43,13,54
RZ Pellets W,8095,6,14,6,16,48,57,-9,48
Admira Wacke,8095,7,13,6,17,42,60,-18,45
SV Josko Rie,8095,8,12,5,19,40,55,-15,41
St. Pölten,8095,9,6,10,20,38,65,-27,28
Mattersburg,8095,10,6,8,22,31,59,-28,26
FC Salzburg,8096,1,22,7,7,74,31,43,73
Vienna,8096,2,21,4,11,64,50,14,67
SC Rheindorf,8096,3,19,9,8,52,40,12,66
SK Sturm Gra,8096,4,20,4,12,64,39,25,64
Rapid Vienna,8096,5,15,12,9,56,38,18,57
RZ Pellets W,8096,6,15,7,14,48,50,-2,52
Admira Wacke,8096,7,11,6,19,35,57,-22,39
St. Pölten,8096,8,8,9,19,43,67,-24,33
Mattersburg,8096,9,6,8,22,29,57,-28,26
SV Josko Rie,8096,10,6,8,22,23,59,-36,26
FC Salzburg,8097,1,21,9,6,72,30,42,72
SK Sturm Gra,8097,2,20,5,11,55,35,20,65
Vienna,8097,3,20,5,11,64,49,15,65
SC Rheindorf,8097,4,17,6,13,48,44,4,57
Rapid Vienna,8097,5,11,13,12,48,40,8,46
RZ Pellets W,8097,6,11,10,15,46,53,-7,43
SV Josko Rie,8097,7,12,5,19,37,55,-18,41
Admira Wacke,8097,8,11,6,19,32,59,-27,39
Mattersburg,8097,9,9,10,17,43,61,-18,37
St. Pölten,8097,10,8,11,17,38,57,-19,35
SC Rheindorf,8098,1,20,9,7,58,40,18,69
FC Salzburg,8098,2,17,10,9,64,36,28,61
SK Sturm Gra,8098,3,18,6,12,56,43,13,60
Rapid Vienna,8098,4,15,11,10,62,42,20,56
Vienna,8098,5,17,5,14,64,59,5,56
RZ Pellets W,8098,6,13,8,15,48,52,-4,47
Admira Wacke,8098,7,12,10,14,44,58,-14,46
SV Josko Rie,8098,8,10,7,19,31,51,-20,37
Mattersburg,8098,9,7,13,16,41,59,-18,34
St. Pölten,8098,10,5,13,18,36,64,-28,28
SC Rheindorf,8099,1,22,8,6,58,35,23,74
FC Salzburg,8099,2,19,7,10,59,26,33,64
Vienna,8099,3,19,4,13,58,52,6,61
SK Sturm Gra,8099,4,17,9,10,57,36,21,60
Rapid Vienna,8099,5,13,12,11,53,42,11,51
Admira Wacke,8099,6,12,8,16,36,53,-17,44
St. Pölten,8099,7,11,7,18,47,60,-13,40
SV Josko Rie,8099,8,10,7,19,32,50,-18,37
Mattersburg,8099,9,9,8,19,39,61,-22,35
RZ Pellets W,8099,10,9,8,19,39,63,-24,35
SK Sturm Gra,8100,1,22,6,8,68,29,39,72
FC Salzburg,8100,2,21,7,8,69,37,32,70
SC Rheindorf,8100,3,18,8,10,51,41,10,62
Rapid Vienna,8100,4,16,8,12,59,47,12,56
Vienna,8100,5,16,5,15,61,59,2,53
Admira Wacke,8100,6,12,7,17,41,62,-21,43
RZ Pellets W,8100,7,11,9,16,47,57,-10,42
SV Josko Rie,8100,8,10,7,19,36,53,-17,37
Mattersburg,8100,9,9,9,18,43,59,-16,36
St. Pölten,8100,10,6,12,18,34,65,-31,30
SC Rheindorf,8101,1,21,6,9,54,38,16,69
FC Salzburg,8101,2,20,6,10,64,34,30,66
Vienna,8101,3,18,5,13,62,53,9,59
SK Sturm Gra,8101,4,16,7,13,60,40,20,55
Rapid Vienna,8101,5,14,12,10,56,40,16,54
RZ Pellets W,8101,6,13,9,14,46,57,-11,48
Admira Wacke,8101,7,12,5,19,37,59,-22,41
SV Josko Rie,8101,8,11,6,19,33,52,-19,39
St. Pölten,8101,9,9,10,17,43,59,-16,37
Mattersburg,8101,10,9,8,19,35,58,-23,35
FC Salzburg,8102,1,22,9,5,80,35,45,75
SC Rheindorf,8102,2,22,5,9,57,44,13,71
Vienna,8102,3,19,6,11,67,48,19,63
SK Sturm Gra,8102,4,17,8,11,56,36,20,59
Rapid Vienna,8102,5,14,11,11,66,44,22,53
RZ Pellets W,8102,6,10,10,16,47,64,-17,40
Mattersburg,8102,7,8,13,15,40,59,-19,37
Admira Wacke,8102,8,10,7,19,35,63,-28,37
SV Josko Rie,8102,9,10,5,21,39,59,-20,35
St. Pölten,8102,10,6,10,20,33,68,-35,28
FC Salzburg,8103,1,24,5,7,71,25,46,77
SC Rheindorf,8103,2,20,7,9,66,53,13,67
SK Sturm Gra,8103,3,17,8,11,59,42,17,59
Rapid Vienna,8103,4,15,10,11,55,43,12,55
Vienna,8103,5,16,6,14,59,60,-1,54
RZ Pellets W,8103,6,16,6,14,48,52,-4,54
Admira Wacke,8103,7,13,7,16,42,55,-13,46
Mattersburg,8103,8,9,8,19,37,54,-17,35
SV Josko Rie,8103,9,8,6,22,31,55,-24,30
St. Pölten,8103,10,5,11,20,39,68,-29,26
FC Salzburg,8104,1,23,6,7,69,27,42,75
SC Rheindorf,8104,2,20,7,9,49,42,7,67
SK Sturm Gra,8104,3,20,6,10,62,39,23,66
Rapid Vienna,8104,4,15,11,10,59,39,20,56
Vienna,8104,5,16,6,14,55,59,-4,54
Admira Wacke,8104,6,14,5,17,38,58,-20,47
Mattersburg,8104,7,10,9,17,39,49,-10,39
RZ Pellets W,8104,8,9,11,16,40,51,-11,38
St. Pölten,8104,9,8,9,19,42,63,-21,33
SV Josko Rie,8104,10,7,6,23,26,52,-26,27
FC Salzburg,8105,1,19,9,8,66,32,34,66
SC Rheindorf,8105,2,19,7,10,53,38,15,64
Rapid Vienna,8105,3,15,12,9,59,37,22,57
SK Sturm Gra,8105,4,16,7,13,55,44,11,55
Vienna,8105,5,15,8,13,52,49,3,53
Admira Wacke,8105,6,13,8,15,51,67,-16,47
RZ Pellets W,8105,7,12,8,16,51,60,-9,44
St. Pölten,8105,8,11,10,15,43,59,-16,43
SV Josko Rie,8105,9,11,7,18,33,52,-19,40
Mattersburg,8105,10,7,8,21,39,64,-25,29
FC Salzburg,8106,1,23,6,7,75,37,38,75
SC Rheindorf,8106,2,23,4,9,65,38,27,73
SK Sturm Gra,8106,3,22,5,9,66,26,40,71
Vienna,8106,4,18,7,11,59,52,7,61
Rapid Vienna,8106,5,12,12,12,59,48,11,48
RZ Pellets W,8106,6,12,7,17,47,60,-13,43
SV Josko Rie,8106,7,10,6,20,36,61,-25,36
St. Pölten,8106,8,8,12,16,37,63,-26,36
Admira Wacke,8106,9,9,5,22,30,64,-34,32
Mattersburg,8106,10,7,8,21,35,60,-25,29
FC Salzburg,8107,1,20,6,10,69,34,35,66
SC Rheindorf,8107,2,18,9,9,49,40,9,63
SK Sturm Gra,8107,3,18,7,11,58,35,23,61
Vienna,8107,4,18,6,12,65,55,10,60
Rapid Vienna,8107,5,15,9,12,55,40,15,54
RZ Pellets W,8107,6,15,5,16,41,50,-9,50
Admira Wacke,8107,7,12,7,17,36,52,-16,43
SV Josko Rie,8107,8,11,8,17,32,50,-18,41
Mattersburg,8107,9,9,7,20,40,61,-21,34
St. Pölten,8107,10,9,6,21,34,62,-28,33
Vienna,8108,1,23,3,10,69,43,26,72
FC Salzburg,8108,2,20,7,9,63,31,32,67
SC Rheindorf,8108,3,20,6,10,52,40,12,66
Rapid Vienna,8108,4,15,11,10,53,37,16,56
SK Sturm Gra,8108,5,15,6,15,47,37,10,51
Admira Wacke,8108,6,14,8,14,36,50,-14,50
RZ Pellets W,8108,7,12,6,18,40,56,-16,42
SV Josko Rie,8108,8,11,5,20,31,48,-17,38
Mattersburg,8108,9,8,8,20,36,58,-22,32
St. Pölten,8108,10,7,10,19,36,63,-27,31
FC Salzburg,8109,1,20,8,8,63,28,35,68
SC Rheindorf,8109,2,20,6,10,56,41,15,66
SK Sturm Gra,8109,3,17,6,13,52,35,17,57
Vienna,8109,4,17,6,13,63,57,6,57
Rapid Vienna,8109,5,13,12,11,53,39,14,51
SV Josko Rie,8109,6,15,5,16,43,49,-6,50
RZ Pellets W,8109,7,11,10,15,42,58,-16,43
St. Pölten,8109,8,10,11,15,38,54,-16,41
Admira Wacke,8109,9,11,8,17,37,56,-19,41
Mattersburg,8109,10,6,8,22,34,64,-30,26
FC Salzburg,8110,1,21,8,7,74,36,38,71
SC Rheindorf,8110,2,19,9,8,58,46,12,66
Vienna,8110,3,20,5,11,65,47,18,65
SK Sturm Gra,8110,4,19,5,12,61,40,21,62
RZ Pellets W,8110,5,16,7,13,55,51,4,55
Rapid Vienna,8110,6,12,11,13,56,48,8,47
Admira Wacke,8110,7,11,6,19,32,56,-24,39
SV Josko Rie,8110,8,11,5,20,32,56,-24,38
St. Pölten,8110,9,8,10,18,43,70,-27,34
Mattersburg,8110,10,6,8,22,36,62,-26,26
FC Salzburg,8111,1,21,7,8,71,34,37,70
SK Sturm Gra,8111,2,20,6,10,53,29,24,66
Vienna,8111,3,20,5,11,64,52,12,65
Rapid Vienna,8111,4,16,11,9,58,35,23,59
SC Rheindorf,8111,5,16,7,13,48,48,0,55
RZ Pellets W,8111,6,13,5,18,44,54,-10,44
Mattersburg,8111,7,10,9,17,43,58,-15,39
Admira Wacke,8111,8,11,5,20,39,68,-29,38
St. Pölten,8111,9,8,11,17,44,59,-15,35
SV Josko Rie,8111,10,10,4,22,29,56,-27,34
SK Sturm Gra,8112,1,23,5,8,66,30,36,74
FC Salzburg,8112,2,20,10,6,61,31,30,70
Vienna,8112,3,19,7,10,67,52,15,64
SC Rheindorf,8112,4,18,7,11,57,48,9,61
Rapid Vienna,8112,5,13,10,13,55,48,7,49
RZ Pellets W,8112,6,13,8,15,43,54,-11,47
Admira Wacke,8112,7,13,5,18,39,53,-14,44
St. Pölten,8112,8,8,8,20,40,61,-21,32
SV Josko Rie,8112,9,9,5,22,36,60,-24,32
Mattersburg,8112,10,8,7,21,38,65,-27,31
Vienna,8113,1,21,4,11,72,48,24,67
FC Salzburg,8113,2,18,11,7,62,33,29,65
SK Sturm Gra,8113,3,18,8,10,63,38,25,62
SC Rheindorf,8113,4,17,6,13,49,44,5,57
Rapid Vienna,8113,5,13,11,12,57,39,18,50
RZ Pellets W,8113,6,12,10,14,42,53,-11,46
Mattersburg,8113,7,11,8,17,38,58,-20,41
Admira Wacke,8113,8,11,8,17,33,53,-20,41
SV Josko Rie,8113,9,9,10,17,24,47,-23,37
St. Pölten,8113,10,7,10,19,41,68,-27,31
FC Salzburg,8114,1,22,7,7,71,29,42,73
SK Sturm Gra,8114,2,21,6,9,57,28,29,69
SC Rheindorf,8114,3,19,9,8,55,41,14,66
Vienna,8114,4,17,7,12,57,48,9,58
RZ Pellets W,8114,5,14,9,13,48,50,-2,51
Rapid Vienna,8114,6,13,9,14,52,43,9,48
Admira Wacke,8114,7,13,5,18,37,59,-22,44
SV Josko Rie,8114,8,12,4,20,38,61,-23,40
St. Pölten,8114,9,6,9,21,35,63,-28,27
Mattersburg,8114,10,6,9,21,33,61,-28,27
Vienna,8115,1,23,2,11,70,48,22,71
FC Salzburg,8115,2,22,4,10,65,29,36,70
SC Rheindorf,8115,3,21,7,8,54,41,13,70
SK Sturm Gra,8115,4,16,8,12,52,41,11,56
Rapid Vienna,8115,5,14,11,11,59,44,15,53
RZ Pellets W,8115,6,14,7,15,50,53,-3,49
Admira Wacke,8115,7,12,6,18,40,60,-20,42
SV Josko Rie,8115,8,9,8,19,32,55,-23,35
St. Pölten,8115,9,7,9,20,38,65,-27,30
Mattersburg,8115,10,6,10,20,35,59,-24,28
FC Salzburg,8116,1,22,5,9,70,33,37,71
SK Sturm Gra,8116,2,19,7,10,56,34,22,64
SC Rheindorf,8116,3,18,10,8,48,42,6,64
Vienna,8116,4,16,8,12,51,44,7,56
RZ Pellets W,8116,5,16,8,12,54,49,5,56
Rapid Vienna,8116,6,14,10,12,62,48,14,52
Admira Wacke,8116,7,11,7,18,33,57,-24,40
St. Pölten,8116,8,8,12,16,45,69,-24,36
SV Josko Rie,8116,9,8,9,19,36,53,-17,33
Mattersburg,8116,10,4,12,20,28,54,-26,24
FC Salzburg,8117,1,20,6,10,64,36,28,66
SC Rheindorf,8117,2,19,8,9,53,44,9,65
SK Sturm Gra,8117,3,19,6,11,66,38,28,63
Vienna,8117,4,19,6,11,65,43,22,63
Rapid Vienna,8117,5,15,9,12,60,40,20,54
Admira Wacke,8117,6,13,8,15,39,59,-20,47
RZ Pellets W,8117,7,11,8,17,43,57,-14,41
Mattersburg,8117,8,8,11,17,40,60,-20,35
St. Pölten,8117,9,9,8,19,43,68,-25,35
SV Josko Rie,8117,10,10,4,22,30,58,-28,34
FC Salzburg,8118,1,20,8,8,67,35,32,68
SK Sturm Gra,8118,2,20,5,11,55,32,23,65
Vienna,8118,3,20,4,12,67,51,16,64
Rapid Vienna,8118,4,18,7,11,58,39,19,61
SC Rheindorf,8118,5,14,10,12,48,45,3,52
Admira Wacke,8118,6,13,6,17,40,56,-16,45
Mattersburg,8118,7,12,7,17,45,57,-12,43
RZ Pellets W,8118,8,11,7,18,40,54,-14,40
SV Josko Rie,8118,9,10,7,19,35,61,-26,37
St. Pölten,8118,10,5,13,18,31,56,-25,28
SC Rheindorf,8119,1,21,9,6,61,34,27,72
FC Salzburg,8119,2,19,10,7,70,31,39,67
SK Sturm Gra,8119,3,19,5,12,54,40,14,62
Vienna,8119,4,19,4,13,57,52,5,61
Admira Wacke,8119,5,14,7,15,48,59,-11,49
Rapid Vienna,8119,6,11,12,13,50,43,7,45
RZ Pellets W,8119,7,12,9,15,47,58,-11,45
SV Josko Rie,8119,8,12,4,20,37,55,-18,40
St. Pölten,8119,9,8,8,20,42,69,-27,32
Mattersburg,8119,10,7,8,21,37,62,-25,29
FC Salzburg,8120,1,18,10,8,57,33,24,64
SK Sturm Gra,8120,2,18,7,11,51,31,20,61
Vienna,8120,3,18,7,11,66,48,18,61
RZ Pellets W,8120,4,16,7,13,51,51,0,55
Rapid Vienna,8120,5,14,12,10,56,42,14,54
SC Rheindorf,8120,6,16,6,14,51,50,1,54
St. Pölten,8120,7,11,10,15,44,55,-11,43
Admira Wacke,8120,8,12,6,18,33,52,-19,42
Mattersburg,8120,9,8,10,18,34,52,-18,34
SV Josko Rie,8120,10,8,7,21,28,57,-29,31
SC Rheindorf,8121,1,21,8,7,61,42,19,71
FC Salzburg,8121,2,18,8,10,63,37,26,62
Rapid Vienna,8121,3,16,12,8,58,38,20,60
Vienna,8121,4,17,5,14,57,55,2,56
SK Sturm Gra,8121,5,16,7,13,54,39,15,55
RZ Pellets W,8121,6,11,12,13,42,47,-5,45
Admira Wacke,8121,7,12,7,17,39,54,-15,43
Mattersburg,8121,8,11,7,18,39,56,-17,40
SV Josko Rie,8121,9,9,6,21,31,55,-24,33
St. Pölten,8121,10,6,14,16,39,60,-21,32
FC Salzburg,8122,1,20,8,8,64,34,30,68
SC Rheindorf,8122,2,20,8,8,62,44,18,68
Vienna,8122,3,20,4,12,66,47,19,64
SK Sturm Gra,8122,4,19,4,13,58,42,16,61
Rapid Vienna,8122,5,15,10,11,51,34,17,55
RZ Pellets W,8122,6,14,6,16,52,57,-5,48
Admira Wacke,8122,7,13,4,19,38,57,-19,43
SV Josko Rie,8122,8,11,5,20,33,58,-25,38
St. Pölten,8122,9,9,9,18,46,64,-18,36
Mattersburg,8122,10,7,6,23,30,63,-33,27
FC Salzburg,8123,1,21,7,8,60,30,30,70
SK Sturm Gra,8123,2,20,7,9,56,34,22,67
Vienna,8123,3,17,7,12,63,54,9,58
Rapid Vienna,8123,4,14,14,8,58,36,22,56
SC Rheindorf,8123,5,15,6,15,46,46,0,51
RZ Pellets W,8123,6,13,8,15,45,53,-8,47
SV Josko Rie,8123,7,12,6,18,41,50,-9,42
Admira Wacke,8123,8,12,5,19,37,61,-24,41
Mattersburg,8123,9,10,8,18,35,50,-15,38
St. Pölten,8123,10,6,12,18,30,57,-27,30
FC Salzburg,8124,1,21,8,7,63,31,32,71
SC Rheindorf,8124,2,20,8,8,57,41,16,68
Vienna,8124,3,21,4,11,67,51,16,67
Rapid Vienna,8124,4,16,10,10,65,39,26,58
RZ Pellets W,8124,5,14,9,13,50,48,2,51
SK Sturm Gra,8124,6,15,4,17,52,48,4,49
Admira Wacke,8124,7,11,6,19,41,62,-21,39
SV Josko Rie,8124,8,10,7,19,36,58,-22,37
St. Pölten,8124,9,8,8,20,39,65,-26,32
Mattersburg,8124,10,8,8,20,36,63,-27,32
SC Rheindorf,8125,1,21,8,7,53,33,20,71
FC Salzburg,8125,2,20,7,9,63,34,29,67
Vienna,8125,3,20,6,10,61,47,14,66
SK Sturm Gra,8125,4,18,8,10,59,32,27,62
Rapid Vienna,8125,5,14,11,11,59,46,13,53
RZ Pellets W,8125,6,14,9,13,46,54,-8,51
Admira Wacke,8125,7,11,5,20,39,58,-19,38
St. Pölten,8125,8,10,8,18,45,66,-21,38
SV Josko Rie,8125,9,8,5,23,28,56,-28,29
Mattersburg,8125,10,7,7,22,35,62,-27,28
FC Salzburg,8126,1,22,6,8,65,35,30,72
Vienna,8126,2,21,3,12,72,54,18,66
SK Sturm Gra,8126,3,19,7,10,59,37,22,64
SC Rheindorf,8126,4,17,6,13,48,46,2,57
Rapid Vienna,8126,5,14,10,12,50,38,12,52
RZ Pellets W,8126,6,13,7,16,46,54,-8,46
Admira Wacke,8126,7,12,7,17,36,51,-15,43
St. Pölten,8126,8,9,11,16,43,61,-18,38
SV Josko Rie,8126,9,10,6,20,33,55,-22,36
Mattersburg,8126,10,7,9,20,36,57,-21,30
FC Salzburg,8127,1,20,8,8,66,36,30,68
SC Rheindorf,8127,2,20,5,11,54,44,10,65
SK Sturm Gra,8127,3,19,6,11,57,34,23,63
Vienna,8127,4,19,4,13,61,49,12,61
Rapid Vienna,8127,5,15,9,12,51,39,12,54
Admira Wacke,8127,6,15,5,16,45,56,-11,50
RZ Pellets W,8127,7,13,7,16,47,52,-5,46
SV Josko Rie,8127,8,12,5,19,35,54,-19,41
St. Pölten,8127,9,7,10,19,41,67,-26,31
Mattersburg,8127,10,7,7,22,37,63,-26,28
SC Rheindorf,8128,1,21,5,10,56,41,15,68
FC Salzburg,8128,2,19,7,10,66,40,26,64
SK Sturm Gra,8128,3,19,5,12,61,42,19,62
Vienna,8128,4,19,5,12,63,53,10,62
Rapid Vienna,8128,5,15,10,11,53,35,18,55
RZ Pellets W,8128,6,16,7,13,52,51,1,55
St. Pölten,8128,7,9,9,18,40,66,-26,36
Admira Wacke,8128,8,10,6,20,30,56,-26,36
Mattersburg,8128,9,9,8,19,38,55,-17,35
SV Josko Rie,8128,10,10,4,22,39,59,-20,34
FC Salzburg,8129,1,20,7,9,68,40,28,67
SK Sturm Gra,8129,2,21,4,11,58,33,25,67
SC Rheindorf,8129,3,20,5,11,55,40,15,65
Vienna,8129,4,19,4,13,57,49,8,61
RZ Pellets W,8129,5,12,10,14,51,57,-6,46
Rapid Vienna,8129,6,11,11,14,54,49,5,44
Admira Wacke,8129,7,11,8,17,45,65,-20,41
SV Josko Rie,8129,8,11,6,19,40,57,-17,39
St. Pölten,8129,9,9,10,17,38,58,-20,37
Mattersburg,8129,10,9,9,18,36,54,-18,36
SC Rheindorf,8130,1,20,9,7,58,40,18,69
FC Salzburg,8130,2,19,9,8,65,38,27,66
Vienna,8130,3,19,6,11,66,54,12,63
SK Sturm Gra,8130,4,18,7,11,57,35,22,61
Rapid Vienna,8130,5,12,13,11,56,43,13,49
SV Josko Rie,8130,6,13,7,16,44,52,-8,46
RZ Pellets W,8130,7,10,8,18,44,59,-15,38
Admira Wacke,8130,8,10,7,19,37,65,-28,37
Mattersburg,8130,9,8,11,17,39,56,-17,35
St. Pölten,8130,10,6,13,17,34,58,-24,31
Vienna,8131,1,20,8,8,66,41,25,68
FC Salzburg,8131,2,20,6,10,64,32,32,66
SK Sturm Gra,8131,3,17,10,9,57,30,27,61
SC Rheindorf,8131,4,17,10,9,51,44,7,61
Rapid Vienna,8131,5,14,12,10,55,41,14,54
RZ Pellets W,8131,6,11,10,15,47,52,-5,43
Admira Wacke,8131,7,11,6,19,34,63,-29,39
Mattersburg,8131,8,8,11,17,33,52,-19,35
St. Pölten,8131,9,7,12,17,36,58,-22,33
SV Josko Rie,8131,10,8,9,19,31,61,-30,33
SK Sturm Gra,8132,1,23,3,10,67,34,33,72
SC Rheindorf,8132,2,22,6,8,62,47,15,72
FC Salzburg,8132,3,21,6,9,71,35,36,69
Vienna,8132,4,17,5,14,62,51,11,56
Rapid Vienna,8132,5,14,11,11,58,40,18,53
SV Josko Rie,8132,6,14,3,19,39,51,-12,45
Admira Wacke,8132,7,13,6,17,42,66,-24,45
RZ Pellets W,8132,8,10,6,20,40,64,-24,36
St. Pölten,8132,9,7,10,19,44,69,-25,31
Mattersburg,8132,10,8,6,22,40,68,-28,30
FC Salzburg,8133,1,20,11,5,61,21,40,71
SC Rheindorf,8133,2,20,9,7,65,37,28,69
Vienna,8133,3,17,8,11,58,51,7,59
SK Sturm Gra,8133,4,16,6,14,51,37,14,54
Rapid Vienna,8133,5,13,11,12,61,46,15,50
RZ Pellets W,8133,6,13,7,16,45,59,-14,46
SV Josko Rie,8133,7,12,7,17,32,46,-14,43
Admira Wacke,8133,8,13,4,19,41,65,-24,43
St. Pölten,8133,9,9,8,19,43,71,-28,35
Mattersburg,8133,10,7,9,20,40,64,-24,30
SC Rheindorf,8134,1,23,6,7,63,39,24,75
FC Salzburg,8134,2,20,8,8,63,33,30,68
Vienna,8134,3,20,6,10,68,50,18,66
Rapid Vienna,8134,4,18,10,8,59,33,26,64
SK Sturm Gra,8134,5,16,6,14,50,37,13,54
Admira Wacke,8134,6,12,6,18,34,57,-23,42
Mattersburg,8134,7,11,5,20,38,55,-17,38
SV Josko Rie,8134,8,11,2,23,36,56,-20,35
St. Pölten,8134,9,9,8,19,38,66,-28,35
RZ Pellets W,8134,10,9,5,22,39,62,-23,32
FC Salzburg,8135,1,22,7,7,63,27,36,73
SK Sturm Gra,8135,2,22,5,9,71,31,40,71
SC Rheindorf,8135,3,19,7,10,53,47,6,64
Vienna,8135,4,18,4,14,60,46,14,58
SV Josko Rie,8135,5,16,4,16,40,45,-5,52
Mattersburg,8135,6,11,7,18,39,51,-12,40
RZ Pellets W,8135,7,11,7,18,41,57,-16,40
Rapid Vienna,8135,8,9,10,17,51,53,-2,37
St. Pölten,8135,9,10,7,19,44,72,-28,37
Admira Wacke,8135,10,11,4,21,37,70,-33,37
FC Salzburg,8136,1,22,7,7,67,28,39,73
Vienna,8136,2,22,5,9,67,45,22,71
SC Rheindorf,8136,3,20,5,11,55,39,16,65
SK Sturm Gra,8136,4,18,6,12,57,36,21,60
Rapid Vienna,8136,5,13,11,12,52,45,7,50
Admira Wacke,8136,6,13,6,17,37,60,-23,45
RZ Pellets W,8136,7,11,10,15,42,47,-5,43
St. Pölten,8136,8,9,10,17,43,64,-21,37
SV Josko Rie,8136,9,10,2,24,34,65,-31,32
Mattersburg,8136,10,8,6,22,31,56,-25,30
FC Salzburg,8137,1,23,7,6,77,34,43,76
Vienna,8137,2,18,6,12,73,55,18,60
SK Sturm Gra,8137,3,17,7,12,52,33,19,58
SC Rheindorf,8137,4,17,6,13,55,55,0,57
RZ Pellets W,8137,5,16,6,14,49,56,-7,54
Rapid Vienna,8137,6,13,13,10,58,45,13,52
Admira Wacke,8137,7,12,10,14,40,55,-15,46
St. Pölten,8137,8,10,8,18,44,65,-21,38
SV Josko Rie,8137,9,9,6,21,35,59,-24,33
Mattersburg,8137,10,6,9,21,37,63,-26,27
FC Salzburg,8138,1,22,8,6,55,21,34,74
SC Rheindorf,8138,2,19,9,8,53,37,16,66
Vienna,8138,3,18,8,10,58,46,12,62
Rapid Vienna,8138,4,13,13,10,55,39,16,52
SK Sturm Gra,8138,5,15,7,14,53,40,13,52
SV Josko Rie,8138,6,13,7,16,35,43,-8,46
RZ Pellets W,8138,7,12,6,18,50,59,-9,42
Admira Wacke,8138,8,12,5,19,36,58,-22,41
Mattersburg,8138,9,7,11,18,38,59,-21,32
St. Pölten,8138,10,7,10,19,35,66,-31,31
FC Salzburg,8139,1,22,6,8,70,36,34,72
SK Sturm Gra,8139,2,19,7,10,54,36,18,64
Vienna,8139,3,19,5,12,71,55,16,62
SC Rheindorf,8139,4,17,9,10,56,43,13,60
Rapid Vienna,8139,5,12,13,11,51,38,13,49
Admira Wacke,8139,6,15,4,17,46,61,-15,49
SV Josko Rie,8139,7,12,5,19,36,51,-15,41
RZ Pellets W,8139,8,12,5,19,46,65,-19,41
St. Pölten,8139,9,9,10,17,41,63,-22,37
Mattersburg,8139,10,6,10,20,38,61,-23,28
FC Salzburg,8140,1,22,8,6,73,28,45,74
SK Sturm Gra,8140,2,21,6,9,65,32,33,69
SC Rheindorf,8140,3,19,8,9,52,34,18,65
Vienna,8140,4,18,4,14,68,56,12,58
Rapid Vienna,8140,5,15,11,10,53,39,14,56
SV Josko Rie,8140,6,14,4,18,38,46,-8,46
RZ Pellets W,8140,7,11,9,16,40,58,-18,42
Mattersburg,8140,8,9,6,21,35,58,-23,33
Admira Wacke,8140,9,9,6,21,32,77,-45,33
St. Pölten,8140,10,7,8,21,36,64,-28,29
FC Salzburg,8141,1,21,8,7,72,34,38,71
SK Sturm Gra,8141,2,21,5,10,61,35,26,68
SC Rheindorf,8141,3,19,8,9,61,43,18,65
Vienna,8141,4,19,6,11,62,49,13,63
Rapid Vienna,8141,5,15,12,9,61,40,21,57
RZ Pellets W,8141,6,10,8,18,45,58,-13,38
SV Josko Rie,8141,7,9,10,17,36,52,-16,37
Admira Wacke,8141,8,10,7,19,38,75,-37,37
Mattersburg,8141,9,6,12,18,37,59,-22,30
St. Pölten,8141,10,6,12,18,41,69,-28,30
FC Salzburg,8142,1,22,5,9,67,30,37,71
SC Rheindorf,8142,2,22,5,9,56,38,18,71
Vienna,8142,3,19,5,12,63,55,8,62
SK Sturm Gra,8142,4,16,8,12,52,36,16,56
Rapid Vienna,8142,5,15,10,11,55,37,18,55
Admira Wacke,8142,6,12,7,17,37,55,-18,43
RZ Pellets W,8142,7,12,6,18,45,59,-14,42
Mattersburg,8142,8,8,11,17,35,54,-19,35
St. Pölten,8142,9,8,11,17,38,58,-20,35
SV Josko Rie,8142,10,11,2,23,32,58,-26,35
FC Salzburg,8143,1,20,10,6,63,25,38,70
SK Sturm Gra,8143,2,19,11,6,59,29,30,68
SC Rheindorf,8143,3,20,7,9,55,37,18,67
Vienna,8143,4,19,8,9,70,49,21,65
Rapid Vienna,8143,5,12,12,12,51,47,4,48
RZ Pellets W,8143,6,11,8,17,49,61,-12,41
Admira Wacke,8143,7,10,8,18,32,61,-29,38
SV Josko Rie,8143,8,9,8,19,38,56,-18,35
Mattersburg,8143,9,8,11,17,39,58,-19,35
St. Pölten,8143,10,6,9,21,42,75,-33,27
FC Salzburg,8144,1,20,9,7,66,33,33,69
SK Sturm Gra,8144,2,19,6,11,62,38,24,63
SC Rheindorf,8144,3,19,6,11,53,48,5,63
Vienna,8144,4,17,5,14,65,56,9,56
Rapid Vienna,8144,5,13,11,12,55,42,13,50
RZ Pellets W,8144,6,12,8,16,45,54,-9,44
St. Pölten,8144,7,12,8,16,48,58,-10,44
Admira Wacke,8144,8,11,7,18,41,64,-23,40
SV Josko Rie,8144,9,12,3,21,37,60,-23,39
Mattersburg,8144,10,9,9,18,35,54,-19,36
FC Salzburg,8145,1,19,12,5,66,31,35,69
SK Sturm Gra,8145,2,18,7,11,64,35,29,61
Vienna,8145,3,18,6,12,61,50,11,60
SC Rheindorf,8145,4,15,13,8,49,39,10,58
RZ Pellets W,8145,5,13,8,15,39,52,-13,47
Rapid Vienna,8145,6,11,13,12,54,43,11,46
SV Josko Rie,8145,7,12,6,18,31,44,-13,42
St. Pölten,8145,8,9,11,16,41,60,-19,38
Mattersburg,8145,9,9,11,16,30,50,-20,38
Admira Wacke,8145,10,8,9,19,33,64,-31,33
FC Salzburg,8146,1,20,9,7,61,29,32,69
SC Rheindorf,8146,2,19,10,7,58,43,15,67
SK Sturm Gra,8146,3,20,6,10,58,31,27,66
Rapid Vienna,8146,4,15,9,12,60,39,21,54
Vienna,8146,5,16,5,15,55,53,2,53
RZ Pellets W,8146,6,15,5,16,49,58,-9,50
SV Josko Rie,8146,7,13,6,17,37,46,-9,45
Admira Wacke,8146,8,13,5,18,38,56,-18,44
St. Pölten,8146,9,8,9,19,42,65,-23,33
Mattersburg,8146,10,6,6,24,32,70,-38,24
SC Rheindorf,8147,1,23,7,6,66,41,25,76
FC Salzburg,8147,2,20,7,9,62,32,30,67
SK Sturm Gra,8147,3,19,7,10,57,33,24,64
Vienna,8147,4,18,6,12,63,57,6,60
Rapid Vienna,8147,5,15,9,12,55,41,14,54
RZ Pellets W,8147,6,13,8,15,53,55,-2,47
SV Josko Rie,8147,7,11,8,17,37,51,-14,41
Admira Wacke,8147,8,7,10,19,38,72,-34,31
St. Pölten,8147,9,7,9,20,40,65,-25,30
Mattersburg,8147,10,6,11,19,30,54,-24,29
FC Salzburg,8148,1,20,9,7,69,37,32,69
SK Sturm Gra,8148,2,20,8,8,60,36,24,68
SC Rheindorf,8148,3,19,6,11,53,44,9,63
Vienna,8148,4,18,5,13,62,55,7,59
RZ Pellets W,8148,5,12,11,13,50,52,-2,47
SV Josko Rie,8148,6,13,6,17,38,44,-6,45
Rapid Vienna,8148,7,10,13,13,53,52,1,43
St. Pölten,8148,8,10,9,17,45,60,-15,39
Admira Wacke,8148,9,10,8,18,36,58,-22,38
Mattersburg,8148,10,6,9,21,34,62,-28,27
SC Rheindorf,8149,1,20,11,5,54,35,19,71
FC Salzburg,8149,2,19,11,6,67,32,35,68
SK Sturm Gra,8149,3,20,7,9,65,34,31,67
Vienna,8149,4,19,3,14,66,53,13,60
Rapid Vienna,8149,5,13,10,13,54,44,10,49
RZ Pellets W,8149,6,13,7,16,51,59,-8,46
Admira Wacke,8149,7,11,7,18,35,59,-24,40
Mattersburg,8149,8,7,12,17,37,56,-19,33
St. Pölten,8149,9,7,11,18,35,63,-28,32
SV Josko Rie,8149,10,7,9,20,32,61,-29,30
FC Salzburg,8150,1,23,6,7,71,35,36,75
Vienna,8150,2,22,4,10,71,50,21,70
SK Sturm Gra,8150,3,19,6,11,61,33,28,63
SC Rheindorf,8150,4,16,11,9,51,41,10,59
RZ Pellets W,8150,5,14,7,15,45,55,-10,49
Admira Wacke,8150,6,14,6,16,43,57,-14,48
Rapid Vienna,8150,7,12,9,15,59,46,13,45
SV Josko Rie,8150,8,10,4,22,31,64,-33,34
Mattersburg,8150,9,8,9,19,36,58,-22,33
St. Pölten,8150,10,7,8,21,44,73,-29,29
FC Salzburg,8151,1,20,9,7,62,26,36,69
SC Rheindorf,8151,2,20,9,7,59,35,24,69
SK Sturm Gra,8151,3,20,5,11,67,41,26,65
Vienna,8151,4,16,8,12,56,51,5,56
Rapid Vienna,8151,5,13,11,12,48,41,7,50
Admira Wacke,8151,6,13,6,17,44,58,-14,45
RZ Pellets W,8151,7,10,8,18,43,62,-19,38
Mattersburg,8151,8,9,10,17,44,63,-19,37
St. Pölten,8151,9,8,12,16,37,59,-22,36
SV Josko Rie,8151,10,10,4,22,38,62,-24,34
FC Salzburg,8152,1,22,8,6,68,28,40,74
SK Sturm Gra,8152,2,19,7,10,52,34,18,64
SC Rheindorf,8152,3,18,7,11,61,54,7,61
RZ Pellets W,8152,4,17,6,13,49,44,5,57
Rapid Vienna,8152,5,13,10,13,53,40,13,49
Vienna,8152,6,14,7,15,60,57,3,49
Admira Wacke,8152,7,13,6,17,43,67,-24,45
Mattersburg,8152,8,9,9,18,45,60,-15,36
SV Josko Rie,8152,9,9,8,19,29,51,-22,35
St. Pölten,8152,10,7,10,19,41,66,-25,31
SK Sturm Gra,8153,1,20,7,9,60,31,29,67
Vienna,8153,2,19,7,10,63,45,18,64
FC Salzburg,8153,3,18,9,9,54,31,23,63
SC Rheindorf,8153,4,17,8,11,54,45,9,59
Rapid Vienna,8153,5,15,10,11,57,41,16,55
RZ Pellets W,8153,6,13,7,16,44,53,-9,46
Mattersburg,8153,7,13,7,16,44,56,-12,46
Admira Wacke,8153,8,10,10,16,33,50,-17,40
SV Josko Rie,8153,9,9,5,22,31,55,-24,32
St. Pölten,8153,10,7,8,21,39,72,-33,29
SC Rheindorf,8154,1,22,8,6,63,40,23,74
SK Sturm Gra,8154,2,18,10,8,61,33,28,64
FC Salzburg,8154,3,18,6,12,62,41,21,60
Rapid Vienna,8154,4,16,10,10,72,46,26,58
Vienna,8154,5,16,6,14,56,62,-6,54
RZ Pellets W,8154,6,16,5,15,50,59,-9,53
SV Josko Rie,8154,7,11,8,17,45,55,-10,41
Admira Wacke,8154,8,10,6,20,40,66,-26,36
Mattersburg,8154,9,8,9,19,39,62,-23,33
St. Pölten,8154,10,6,10,20,39,63,-24,28
FC Salzburg,8155,1,21,7,8,62,26,36,70
SC Rheindorf,8155,2,18,9,9,48,38,10,63
SK Sturm Gra,8155,3,17,10,9,62,36,26,61
Vienna,8155,4,18,2,16,59,53,6,56
RZ Pellets W,8155,5,16,6,14,52,50,2,54
Rapid Vienna,8155,6,11,12,13,51,46,5,45
SV Josko Rie,8155,7,12,9,15,37,43,-6,45
Admira Wacke,8155,8,11,6,19,33,59,-26,39
Mattersburg,8155,9,9,9,18,45,63,-18,36
St. Pölten,8155,10,7,10,19,40,75,-35,31
SC Rheindorf,8156,1,23,6,7,62,34,28,75
SK Sturm Gra,8156,2,20,6,10,58,34,24,66
FC Salzburg,8156,3,17,9,10,62,39,23,60
Vienna,8156,4,18,4,14,61,56,5,58
Rapid Vienna,8156,5,15,9,12,55,38,17,54
Admira Wacke,8156,6,15,4,17,40,56,-16,49
RZ Pellets W,8156,7,12,7,17,43,54,-11,43
Mattersburg,8156,8,10,7,19,33,56,-23,37
St. Pölten,8156,9,8,9,19,38,65,-27,33
SV Josko Rie,8156,10,9,5,22,34,54,-20,32
SC Rheindorf,8157,1,19,10,7,56,41,15,67
FC Salzburg,8157,2,17,10,9,58,32,26,61
SK Sturm Gra,8157,3,18,6,12,61,42,19,60
Vienna,8157,4,15,11,10,59,50,9,56
Rapid Vienna,8157,5,14,11,11,59,43,16,53
RZ Pellets W,8157,6,12,9,15,44,53,-9,45
SV Josko Rie,8157,7,13,5,18,38,51,-13,44
Mattersburg,8157,8,11,8,17,44,56,-12,41
Admira Wacke,8157,9,11,5,20,34,62,-28,38
St. Pölten,8157,10,8,9,19,40,63,-23,33
FC Salzburg,8158,1,23,7,6,79,32,47,76
SK Sturm Gra,8158,2,18,9,9,61,36,25,63
SC Rheindorf,8158,3,17,9,10,50,44,6,60
Vienna,8158,4,18,4,14,67,59,8,58
Rapid Vienna,8158,5,13,13,10,50,40,10,52
RZ Pellets W,8158,6,13,12,11,48,47,1,51
Mattersburg,8158,7,8,11,17,35,54,-19,35
SV Josko Rie,8158,8,9,8,19,31,58,-27,35
Admira Wacke,8158,9,8,10,18,39,65,-26,34
St. Pölten,8158,10,6,11,19,36,61,-25,29
FC Salzburg,8159,1,22,8,6,73,32,41,74
SC Rheindorf,8159,2,17,11,8,57,42,15,62
SK Sturm Gra,8159,3,18,7,11,58,37,21,61
Vienna,8159,4,17,8,11,60,53,7,59
Rapid Vienna,8159,5,14,11,11,59,46,13,53
RZ Pellets W,8159,6,10,9,17,43,59,-16,39
SV Josko Rie,8159,7,11,5,20,33,54,-21,38
Admira Wacke,8159,8,9,11,16,36,58,-22,38
St. Pölten,8159,9,8,11,17,43,64,-21,35
Mattersburg,8159,10,7,13,16,39,56,-17,34
SK Sturm Gra,8160,1,24,4,8,66,31,35,76
SC Rheindorf,8160,2,21,5,10,51,38,13,68
FC Salzburg,8160,3,19,6,11,64,37,27,63
Vienna,8160,4,18,5,13,57,49,8,59
Rapid Vienna,8160,5,14,12,10,53,38,15,54
RZ Pellets W,8160,6,15,7,14,56,50,6,52
Admira Wacke,8160,7,13,6,17,38,55,-17,45
Mattersburg,8160,8,6,11,19,38,63,-25,29
St. Pölten,8160,9,6,11,19,41,72,-31,29
SV Josko Rie,8160,10,8,5,23,28,59,-31,29
SK Sturm Gra,8161,1,22,4,10,62,35,27,70
SC Rheindorf,8161,2,19,9,8,58,42,16,66
FC Salzburg,8161,3,18,9,9,56,34,22,63
Vienna,8161,4,17,7,12,59,55,4,58
Rapid Vienna,8161,5,14,10,12,60,38,22,52
RZ Pellets W,8161,6,13,9,14,49,52,-3,48
SV Josko Rie,8161,7,11,5,20,42,53,-11,38
St. Pölten,8161,8,9,9,18,36,56,-20,36
Admira Wacke,8161,9,10,6,20,36,70,-34,36
Mattersburg,8161,10,8,10,18,30,53,-23,34
SK Sturm Gra,8162,1,22,6,8,66,31,35,72
FC Salzburg,8162,2,20,11,5,67,31,36,71
SC Rheindorf,8162,3,19,7,10,53,39,14,64
Vienna,8162,4,18,6,12,63,55,8,60
RZ Pellets W,8162,5,14,8,14,53,53,0,50
Rapid Vienna,8162,6,12,13,11,52,40,12,49
Admira Wacke,8162,7,11,5,20,35,64,-29,38
SV Josko Rie,8162,8,9,6,21,26,49,-23,33
St. Pölten,8162,9,7,12,17,41,65,-24,33
Mattersburg,8162,10,7,8,21,34,63,-29,29
SK Sturm Gra,8163,1,21,7,8,64,28,36,70
FC Salzburg,8163,2,19,9,8,57,27,30,66
SC Rheindorf,8163,3,19,7,10,56,45,11,64
Vienna,8163,4,19,4,13,64,50,14,61
Rapid Vienna,8163,5,12,15,9,49,34,15,51
Admira Wacke,8163,6,12,6,18,35,57,-22,42
RZ Pellets W,8163,7,12,5,19,41,58,-17,41
St. Pölten,8163,8,9,12,15,39,56,-17,39
SV Josko Rie,8163,9,9,8,19,33,54,-21,35
Mattersburg,8163,10,7,9,20,27,56,-29,30
FC Salzburg,8164,1,20,8,8,66,38,28,68
Vienna,8164,2,20,7,9,71,46,25,67
SC Rheindorf,8164,3,19,10,7,58,41,17,67
SK Sturm Gra,8164,4,17,7,12,58,40,18,58
Rapid Vienna,8164,5,13,12,11,53,43,10,51
RZ Pellets W,8164,6,11,8,17,45,55,-10,41
Mattersburg,8164,7,11,8,17,36,54,-18,41
Admira Wacke,8164,8,10,9,17,38,57,-19,39
SV Josko Rie,8164,9,8,11,17,39,59,-20,35
St. Pölten,8164,10,5,12,19,32,63,-31,27
SC Rheindorf,8165,1,22,5,9,59,43,16,71
FC Salzburg,8165,2,20,10,6,63,29,34,70
SK Sturm Gra,8165,3,18,8,10,55,33,22,62
Vienna,8165,4,17,3,16,63,57,6,54
Rapid Vienna,8165,5,12,9,15,65,53,12,45
RZ Pellets W,8165,6,12,9,15,48,58,-10,45
Mattersburg,8165,7,11,9,16,42,51,-9,42
SV Josko Rie,8165,8,11,8,17,37,54,-17,41
Admira Wacke,8165,9,11,6,19,34,60,-26,39
St. Pölten,8165,10,8,9,19,38,66,-28,33
Vienna,8166,1,22,4,10,71,51,20,70
SC Rheindorf,8166,2,17,11,8,48,41,7,62
FC Salzburg,8166,3,17,10,9,63,35,28,61
Rapid Vienna,8166,4,16,9,11,56,42,14,57
SK Sturm Gra,8166,5,15,11,10,58,35,23,56
SV Josko Rie,8166,6,14,4,18,40,50,-10,46
RZ Pellets W,8166,7,10,11,15,48,61,-13,41
Admira Wacke,8166,8,12,5,19,39,60,-21,41
Mattersburg,8166,9,9,8,19,32,49,-17,35
St. Pölten,8166,10,6,11,19,36,67,-31,29
SC Rheindorf,8167,1,20,7,9,59,41,18,67
FC Salzburg,8167,2,19,8,9,61,32,29,65
SK Sturm Gra,8167,3,18,9,9,60,40,20,63
Rapid Vienna,8167,4,15,12,9,59,35,24,57
Vienna,8167,5,16,6,14,56,51,5,54
RZ Pellets W,8167,6,13,9,14,49,56,-7,48
SV Josko Rie,8167,7,13,5,18,37,52,-15,44
Mattersburg,8167,8,9,10,17,39,57,-18,37
Admira Wacke,8167,9,9,10,17,31,57,-26,37
St. Pölten,8167,10,5,10,21,37,67,-30,25
SK Sturm Gra,8168,1,22,6,8,66,33,33,72
SC Rheindorf,8168,2,19,9,8,52,39,13,66
FC Salzburg,8168,3,20,5,11,73,34,39,65
Rapid Vienna,8168,4,16,9,11,64,45,19,57
Vienna,8168,5,16,7,13,57,62,-5,55
Admira Wacke,8168,6,15,6,15,44,58,-14,51
RZ Pellets W,8168,7,11,6,19,38,55,-17,39
Mattersburg,8168,8,9,9,18,36,54,-18,36
SV Josko Rie,8168,9,10,5,21,33,52,-19,35
St. Pölten,8168,10,7,8,21,43,74,-31,29
Vienna,8169,1,20,6,10,63,45,18,66
FC Salzburg,8169,2,17,10,9,66,34,32,61
SK Sturm Gra,8169,3,16,9,11,54,33,21,57
SC Rheindorf,8169,4,15,12,9,50,42,8,57
Rapid Vienna,8169,5,15,11,10,57,38,19,56
RZ Pellets W,8169,6,12,9,15,46,58,-12,45
Admira Wacke,8169,7,13,5,18,35,62,-27,44
SV Josko Rie,8169,8,11,5,20,37,53,-16,38
St. Pölten,8169,9,9,10,17,41,59,-18,37
Mattersburg,8169,10,9,9,18,34,59,-25,36
FC Salzburg,8170,1,23,4,9,64,30,34,73
SK Sturm Gra,8170,2,21,7,8,67,35,32,70
SC Rheindorf,8170,3,17,7,12,53,46,7,58
Vienna,8170,4,17,5,14,60,56,4,56
Rapid Vienna,8170,5,12,11,13,52,44,8,47
RZ Pellets W,8170,6,12,9,15,48,55,-7,45
Admira Wacke,8170,7,12,9,15,41,59,-18,45
St. Pölten,8170,8,10,10,16,45,62,-17,40
Mattersburg,8170,9,11,7,18,38,56,-18,40
SV Josko Rie,8170,10,7,7,22,31,56,-25,28
FC Salzburg,8171,1,21,9,6,65,28,37,72
SC Rheindorf,8171,2,19,9,8,55,40,15,66
Vienna,8171,3,18,9,9,68,49,19,63
SK Sturm Gra,8171,4,19,5,12,56,39,17,62
Admira Wacke,8171,5,13,6,17,41,58,-17,45
SV Josko Rie,8171,6,12,6,18,35,47,-12,42
Rapid Vienna,8171,7,10,11,15,42,40,2,41
RZ Pellets W,8171,8,11,8,17,41,52,-11,41
St. Pölten,8171,9,9,8,19,41,61,-20,35
Mattersburg,8171,10,8,9,19,33,63,-30,33
SC Rheindorf,8172,1,18,9,9,52,40,12,63
Vienna,8172,2,18,8,10,64,51,13,62
FC Salzburg,8172,3,17,10,9,61,34,27,61
SK Sturm Gra,8172,4,17,8,11,56,39,17,59
Rapid Vienna,8172,5,15,12,9,57,39,18,57
Admira Wacke,8172,6,13,7,16,42,56,-14,46
RZ Pellets W,8172,7,10,11,15,44,55,-11,41
Mattersburg,8172,8,9,11,16,40,54,-14,38
SV Josko Rie,8172,9,9,8,19,28,55,-27,35
St. Pölten,8172,10,7,10,19,43,64,-21,31
FC Salzburg,8173,1,20,7,9,64,34,30,67
SC Rheindorf,8173,2,19,8,9,53,43,10,65
SK Sturm Gra,8173,3,17,7,12,51,34,17,58
RZ Pellets W,8173,4,17,5,14,53,50,3,56
Rapid Vienna,8173,5,15,8,13,56,42,14,53
Vienna,8173,6,15,6,15,55,49,6,51
Admira Wacke,8173,7,13,4,19,42,56,-14,43
St. Pölten,8173,8,11,8,17,45,63,-18,41
SV Josko Rie,8173,9,10,8,18,36,58,-22,38
Mattersburg,8173,10,8,9,19,36,62,-26,33
SK Sturm Gra,8174,1,23,6,7,67,26,41,75
FC Salzburg,8174,2,21,7,8,70,29,41,70
Vienna,8174,3,19,8,9,63,48,15,65
Rapid Vienna,8174,4,16,11,9,59,44,15,59
SC Rheindorf,8174,5,15,9,12,45,46,-1,54
RZ Pellets W,8174,6,11,9,16,41,53,-12,42
St. Pölten,8174,7,9,10,17,45,65,-20,37
Mattersburg,8174,8,8,10,18,31,54,-23,34
SV Josko Rie,8174,9,8,8,20,27,49,-22,32
Admira Wacke,8174,10,8,6,22,35,69,-34,30
FC Salzburg,8175,1,23,6,7,70,27,43,75
SC Rheindorf,8175,2,22,7,7,64,38,26,73
SK Sturm Gra,8175,3,22,4,10,66,35,31,70
Vienna,8175,4,20,7,9,65,49,16,67
Rapid Vienna,8175,5,11,11,14,51,47,4,44
RZ Pellets W,8175,6,11,10,15,39,48,-9,43
SV Josko Rie,8175,7,10,7,19,36,62,-26,37
Admira Wacke,8175,8,9,6,21,36,60,-24,33
Mattersburg,8175,9,7,11,18,34,59,-25,32
St. Pölten,8175,10,6,9,21,36,72,-36,27
FC Salzburg,8176,1,22,8,6,68,28,40,74
SK Sturm Gra,8176,2,20,6,10,60,33,27,66
SC Rheindorf,8176,3,19,8,9,51,35,16,65
Vienna,8176,4,18,7,11,60,51,9,61
RZ Pellets W,8176,5,13,7,16,52,60,-8,46
Rapid Vienna,8176,6,10,11,15,47,49,-2,41
SV Josko Rie,8176,7,12,5,19,34,50,-16,41
Mattersburg,8176,8,9,11,16,42,61,-19,38
St. Pölten,8176,9,9,9,18,41,60,-19,36
Admira Wacke,8176,10,9,6,21,33,61,-28,33
FC Salzburg,8177,1,22,8,6,61,27,34,74
SC Rheindorf,8177,2,19,9,8,54,39,15,66
SK Sturm Gra,8177,3,18,7,11,59,40,19,61
Vienna,8177,4,17,7,12,60,54,6,58
Rapid Vienna,8177,5,14,10,12,56,38,18,52
Admira Wacke,8177,6,16,4,16,41,52,-11,52
St. Pölten,8177,7,10,9,17,49,68,-19,39
RZ Pellets W,8177,8,11,5,20,47,63,-16,38
SV Josko Rie,8177,9,10,6,20,31,51,-20,36
Mattersburg,8177,10,6,9,21,33,59,-26,27
SK Sturm Gra,8178,1,19,6,11,57,38,19,63
Vienna,8178,2,18,9,9,58,45,13,63
FC Salzburg,8178,3,18,7,11,57,28,29,61
SC Rheindorf,8178,4,18,7,11,54,44,10,61
Rapid Vienna,8178,5,14,13,9,50,36,14,55
RZ Pellets W,8178,6,12,11,13,50,51,-1,47
St. Pölten,8178,7,9,10,17,42,61,-19,37
Mattersburg,8178,8,7,15,14,43,56,-13,36
Admira Wacke,8178,9,9,9,18,38,60,-22,36
SV Josko Rie,8178,10,9,7,20,29,59,-30,34
FC Salzburg,8179,1,20,10,6,64,29,35,70
Vienna,8179,2,19,5,12,59,48,11,62
SC Rheindorf,8179,3,18,8,10,58,47,11,62
SK Sturm Gra,8179,4,18,5,13,61,45,16,59
Rapid Vienna,8179,5,16,9,11,58,36,22,57
RZ Pellets W,8179,6,13,7,16,42,54,-12,46
Admira Wacke,8179,7,10,8,18,29,53,-24,38
SV Josko Rie,8179,8,10,7,19,28,46,-18,37
Mattersburg,8179,9,9,9,18,42,60,-18,36
St. Pölten,8179,10,9,8,19,36,59,-23,35
SC Rheindorf,8180,1,22,6,8,66,43,23,72
SK Sturm Gra,8180,2,22,5,9,69,35,34,71
FC Salzburg,8180,3,21,6,9,68,36,32,69
Rapid Vienna,8180,4,16,8,12,60,43,17,56
Vienna,8180,5,16,5,15,57,62,-5,53
RZ Pellets W,8180,6,14,5,17,53,58,-5,47
SV Josko Rie,8180,7,14,4,18,40,52,-12,46
Admira Wacke,8180,8,9,7,20,34,63,-29,34
St. Pölten,8180,9,8,9,19,39,66,-27,33
Mattersburg,8180,10,6,9,21,37,65,-28,27
FC Salzburg,8181,1,22,8,6,59,25,34,74
SC Rheindorf,8181,2,21,9,6,53,36,17,72
SK Sturm Gra,8181,3,17,5,14,55,42,13,56
RZ Pellets W,8181,4,15,8,13,51,48,3,53
Vienna,8181,5,15,5,16,53,53,0,50
Rapid Vienna,8181,6,12,13,11,58,42,16,49
Admira Wacke,8181,7,13,5,18,40,59,-19,44
Mattersburg,8181,8,9,9,18,36,55,-19,36
SV Josko Rie,8181,9,10,5,21,34,56,-22,35
St. Pölten,8181,10,8,9,19,42,65,-23,33
FC Salzburg,8182,1,20,8,8,58,30,28,68
SC Rheindorf,8182,2,19,7,10,51,35,16,64
SK Sturm Gra,8182,3,19,6,11,55,36,19,63
Vienna,8182,4,19,5,12,60,49,11,62
Rapid Vienna,8182,5,14,9,13,63,43,20,51
RZ Pellets W,8182,6,12,9,15,41,55,-14,45
Admira Wacke,8182,7,11,11,14,46,52,-6,44
Mattersburg,8182,8,11,6,19,36,57,-21,39
St. Pölten,8182,9,9,9,18,39,67,-28,36
SV Josko Rie,8182,10,7,8,21,31,56,-25,29
FC Salzburg,8183,1,21,8,7,62,29,33,71
SK Sturm Gra,8183,2,20,5,11,61,32,29,65
Vienna,8183,3,20,3,13,69,62,7,63
SC Rheindorf,8183,4,17,11,8,54,42,12,62
Rapid Vienna,8183,5,13,10,13,57,42,15,49
Admira Wacke,8183,6,12,8,16,41,60,-19,44
RZ Pellets W,8183,7,11,10,15,44,55,-11,43
SV Josko Rie,8183,8,12,6,18,30,46,-16,42
St. Pölten,8183,9,9,9,18,45,66,-21,36
Mattersburg,8183,10,7,6,23,30,59,-29,27
SC Rheindorf,8184,1,19,11,6,53,31,22,68
SK Sturm Gra,8184,2,19,8,9,71,38,33,65
FC Salzburg,8184,3,18,10,8,59,30,29,64
Vienna,8184,4,18,6,12,61,49,12,60
Rapid Vienna,8184,5,16,10,10,60,38,22,58
RZ Pellets W,8184,6,10,12,14,41,48,-7,42
SV Josko Rie,8184,7,11,8,17,33,50,-17,41
Admira Wacke,8184,8,9,9,18,27,60,-33,36
St. Pölten,8184,9,7,11,18,40,65,-25,32
Mattersburg,8184,10,6,9,21,33,69,-36,27
FC Salzburg,8185,1,24,6,6,75,29,46,78
SK Sturm Gra,8185,2,20,7,9,60,33,27,67
Vienna,8185,3,20,3,13,65,49,16,63
SC Rheindorf,8185,4,19,6,11,54,42,12,63
Rapid Vienna,8185,5,14,10,12,59,44,15,52
RZ Pellets W,8185,6,10,11,15,43,55,-12,41
Mattersburg,8185,7,10,9,17,42,56,-14,39
Admira Wacke,8185,8,10,7,19,41,67,-26,37
SV Josko Rie,8185,9,11,4,21,33,62,-29,37
St. Pölten,8185,10,5,11,20,35,70,-35,26
SK Sturm Gra,8186,1,24,4,8,59,28,31,76
FC Salzburg,8186,2,23,6,7,66,31,35,75
Vienna,8186,3,19,5,12,59,48,11,62
SC Rheindorf,8186,4,18,6,12,54,48,6,60
Rapid Vienna,8186,5,11,10,15,45,46,-1,43
Mattersburg,8186,6,12,7,17,44,52,-8,43
RZ Pellets W,8186,7,12,7,17,45,57,-12,43
St. Pölten,8186,8,10,8,18,41,59,-18,38
Admira Wacke,8186,9,10,6,20,37,57,-20,36
SV Josko Rie,8186,10,9,5,22,34,58,-24,32
SC Rheindorf,8187,1,19,7,10,57,44,13,64
FC Salzburg,8187,2,17,10,9,59,37,22,61
SK Sturm Gra,8187,3,16,9,11,54,37,17,57
Vienna,8187,4,16,9,11,63,56,7,57
Rapid Vienna,8187,5,11,13,12,57,47,10,46
Mattersburg,8187,6,12,9,15,43,55,-12,45
RZ Pellets W,8187,7,12,8,16,45,51,-6,44
Admira Wacke,8187,8,11,10,15,38,59,-21,43
SV Josko Rie,8187,9,11,8,17,36,48,-12,41
St. Pölten,8187,10,10,7,19,42,60,-18,37
FC Salzburg,8188,1,21,5,10,67,36,31,68
SK Sturm Gra,8188,2,20,6,10,62,38,24,66
Vienna,8188,3,19,6,11,62,53,9,63
SC Rheindorf,8188,4,18,9,9,52,43,9,63
Rapid Vienna,8188,5,11,13,12,55,45,10,46
RZ Pellets W,8188,6,12,10,14,39,50,-11,46
Admira Wacke,8188,7,11,9,16,39,58,-19,42
SV Josko Rie,8188,8,11,8,17,40,52,-12,41
Mattersburg,8188,9,9,6,21,32,55,-23,33
St. Pölten,8188,10,8,8,20,39,57,-18,32
SK Sturm Gra,8189,1,20,9,7,55,27,28,69
SC Rheindorf,8189,2,18,7,11,61,49,12,61
Vienna,8189,3,19,3,14,60,54,6,60
FC Salzburg,8189,4,17,6,13,57,39,18,57
Rapid Vienna,8189,5,12,12,12,51,41,10,48
Admira Wacke,8189,6,12,10,14,32,46,-14,46
RZ Pellets W,8189,7,13,6,17,44,52,-8,45
SV Josko Rie,8189,8,12,6,18,32,49,-17,42
Mattersburg,8189,9,11,8,17,41,53,-12,41
St. Pölten,8189,10,8,9,19,39,62,-23,33
FC Salzburg,8190,1,23,6,7,62,23,39,75
SC Rheindorf,8190,2,19,9,8,52,39,13,66
SK Sturm Gra,8190,3,19,5,12,54,34,20,62
Vienna,8190,4,16,9,11,61,49,12,57
Rapid Vienna,8190,5,14,12,10,56,37,19,54
RZ Pellets W,8190,6,13,7,16,40,50,-10,46
St. Pölten,8190,7,13,7,16,48,61,-13,46
Admira Wacke,8190,8,9,9,18,29,56,-27,36
SV Josko Rie,8190,9,8,7,21,29,53,-24,31
Mattersburg,8190,10,5,11,20,30,59,-29,26
SK Sturm Gra,8191,1,21,7,8,62,33,29,70
FC Salzburg,8191,2,19,9,8,63,33,30,66
SC Rheindorf,8191,3,18,7,11,55,47,8,61
Vienna,8191,4,18,5,13,58,55,3,59
Rapid Vienna,8191,5,13,11,12,56,40,16,50
Admira Wacke,8191,6,12,8,16,36,53,-17,44
RZ Pellets W,8191,7,12,7,17,45,55,-10,43
Mattersburg,8191,8,11,9,16,41,52,-11,42
SV Josko Rie,8191,9,12,4,20,35,54,-19,40
St. Pölten,8191,10,6,9,21,38,67,-29,27
FC Salzburg,8192,1,21,8,7,64,27,37,71
SC Rheindorf,8192,2,21,6,9,56,40,16,69
SK Sturm Gra,8192,3,19,6,11,65,35,30,63
Vienna,8192,4,19,4,13,57,53,4,61
Rapid Vienna,8192,5,14,10,12,57,43,14,52
RZ Pellets W,8192,6,14,6,16,49,51,-2,48
Admira Wacke,8192,7,11,7,18,35,61,-26,40
St. Pölten,8192,8,10,7,19,46,64,-18,37
SV Josko Rie,8192,9,11,3,22,32,59,-27,36
Mattersburg,8192,10,7,9,20,34,62,-28,30
FC Salzburg,8193,1,21,8,7,68,31,37,71
Vienna,8193,2,21,3,12,69,53,16,66
SK Sturm Gra,8193,3,20,4,12,69,39,30,64
SC Rheindorf,8193,4,19,5,12,60,53,7,62
Rapid Vienna,8193,5,16,8,12,56,40,16,56
Admira Wacke,8193,6,13,5,18,40,65,-25,44
RZ Pellets W,8193,7,11,6,19,43,60,-17,39
Mattersburg,8193,8,10,8,18,41,58,-17,38
St. Pölten,8193,9,10,7,19,38,59,-21,37
SV Josko Rie,8193,10,10,4,22,33,59,-26,34
FC Salzburg,8194,1,21,7,8,73,37,36,70
SC Rheindorf,8194,2,21,6,9,57,40,17,69
Vienna,8194,3,17,10,9,72,52,20,61
SK Sturm Gra,8194,4,16,11,9,52,36,16,59
Rapid Vienna,8194,5,10,15,11,57,47,10,45
RZ Pellets W,8194,6,12,9,15,56,60,-4,45
Admira Wacke,8194,7,11,8,17,37,60,-23,41
SV Josko Rie,8194,8,10,8,18,32,54,-22,38
St. Pölten,8194,9,8,10,18,42,67,-25,34
Mattersburg,8194,10,7,10,19,33,58,-25,31
Vienna,8195,1,24,4,8,73,44,29,76
FC Salzburg,8195,2,21,8,7,64,31,33,71
SK Sturm Gra,8195,3,20,3,13,63,38,25,63
SC Rheindorf,8195,4,16,8,12,44,49,-5,56
RZ Pellets W,8195,5,15,4,17,49,59,-10,49
SV Josko Rie,8195,6,14,5,17,37,43,-6,47
Rapid Vienna,8195,7,10,12,14,45,41,4,42
Admira Wacke,8195,8,12,5,19,40,60,-20,41
Mattersburg,8195,9,11,5,20,39,58,-19,38
St. Pölten,8195,10,6,8,22,33,64,-31,26
SC Rheindorf,8196,1,23,5,8,56,38,18,74
SK Sturm Gra,8196,2,22,5,9,62,28,34,71
FC Salzburg,8196,3,20,7,9,60,31,29,67
Vienna,8196,4,18,7,11,63,48,15,61
Rapid Vienna,8196,5,12,12,12,54,49,5,48
Mattersburg,8196,6,14,6,16,40,46,-6,48
RZ Pellets W,8196,7,12,8,16,47,54,-7,44
SV Josko Rie,8196,8,12,3,21,32,52,-20,39
Admira Wacke,8196,9,8,6,22,28,63,-35,30
St. Pölten,8196,10,5,9,22,32,65,-33,24
SK Sturm Gra,8197,1,20,5,11,62,38,24,65
SC Rheindorf,8197,2,19,8,9,54,39,15,65
FC Salzburg,8197,3,19,6,11,70,36,34,63
Vienna,8197,4,19,5,12,61,50,11,62
Rapid Vienna,8197,5,17,10,9,57,37,20,61
Admira Wacke,8197,6,12,7,17,37,61,-24,43
RZ Pellets W,8197,7,11,9,16,45,58,-13,42
SV Josko Rie,8197,8,10,6,20,34,50,-16,36
St. Pölten,8197,9,8,9,19,37,61,-24,33
Mattersburg,8197,10,8,9,19,34,61,-27,33
FC Salzburg,8198,1,23,8,5,66,26,40,77
SK Sturm Gra,8198,2,20,8,8,58,29,29,68
Vienna,8198,3,19,5,12,67,51,16,62
SC Rheindorf,8198,4,18,7,11,52,47,5,61
Rapid Vienna,8198,5,13,9,14,55,44,11,48
RZ Pellets W,8198,6,11,10,15,40,54,-14,43
SV Josko Rie,8198,7,11,8,17,37,47,-10,41
Admira Wacke,8198,8,10,8,18,35,63,-28,38
St. Pölten,8198,9,8,11,17,41,59,-18,35
Mattersburg,8198,10,7,6,23,29,60,-31,27
FC Salzburg,8199,1,20,7,9,62,31,31,67
SC Rheindorf,8199,2,19,8,9,60,45,15,65
Vienna,8199,3,18,7,11,62,58,4,61
RZ Pellets W,8199,4,15,7,14,51,44,7,52
SK Sturm Gra,8199,5,15,6,15,50,41,9,51
Rapid Vienna,8199,6,13,11,12,52,40,12,50
St. Pölten,8199,7,13,8,15,47,60,-13,47
Admira Wacke,8199,8,11,8,17,39,57,-18,41
SV Josko Rie,8199,9,11,5,20,38,54,-16,38
Mattersburg,8199,10,8,7,21,32,63,-31,31
FC Salzburg,8200,1,24,6,6,71,28,43,78
SK Sturm Gra,8200,2,21,5,10,57,31,26,68
SC Rheindorf,8200,3,18,9,9,54,39,15,63
Vienna,8200,4,17,5,14,61,61,0,56
RZ Pellets W,8200,5,14,10,12,49,46,3,52
Rapid Vienna,8200,6,10,13,13,46,44,2,43
Admira Wacke,8200,7,13,4,19,41,59,-18,43
SV Josko Rie,8200,8,10,5,21,28,56,-28,35
Mattersburg,8200,9,7,11,18,39,59,-20,32
St. Pölten,8200,10,7,10,19,39,62,-23,31
FC Salzburg,8201,1,21,8,7,70,29,41,71
SC Rheindorf,8201,2,20,6,10,58,40,18,66
Vienna,8201,3,20,2,14,68,57,11,62
SK Sturm Gra,8201,4,18,6,12,61,43,18,60
Rapid Vienna,8201,5,12,12,12,50,44,6,48
Admira Wacke,8201,6,13,6,17,35,60,-25,45
RZ Pellets W,8201,7,11,10,15,40,53,-13,43
SV Josko Rie,8201,8,10,7,19,35,51,-16,37
St. Pölten,8201,9,8,11,17,41,67,-26,35
Mattersburg,8201,10,8,10,18,40,54,-14,34
SC Rheindorf,8202,1,22,7,7,63,36,27,73
SK Sturm Gra,8202,2,19,9,8,58,36,22,66
FC Salzburg,8202,3,18,9,9,69,36,33,63
Vienna,8202,4,19,5,12,62,48,14,62
Rapid Vienna,8202,5,14,11,11,54,38,16,53
RZ Pellets W,8202,6,13,6,17,47,58,-11,45
Admira Wacke,8202,7,10,8,18,33,60,-27,38
SV Josko Rie,8202,8,9,7,20,28,49,-21,34
Mattersburg,8202,9,9,7,20,33,58,-25,34
St. Pölten,8202,10,7,11,18,36,64,-28,32
FC Salzburg,8203,1,22,7,7,66,27,39,73
SK Sturm Gra,8203,2,20,6,10,57,30,27,66
SC Rheindorf,8203,3,18,7,11,45,41,4,61
Vienna,8203,4,17,7,12,62,52,10,58
Rapid Vienna,8203,5,13,12,11,51,40,11,51
SV Josko Rie,8203,6,12,6,18,35,52,-17,42
RZ Pellets W,8203,7,11,8,17,42,53,-11,41
Admira Wacke,8203,8,12,4,20,41,59,-18,40
St. Pölten,8203,9,10,9,17,41,64,-23,39
Mattersburg,8203,10,8,8,20,34,56,-22,32
FC Salzburg,8204,1,22,5,9,69,29,40,71
SK Sturm Gra,8204,2,21,8,7,64,30,34,71
Vienna,8204,3,20,5,11,67,52,15,65
SC Rheindorf,8204,4,16,8,12,49,51,-2,56
Rapid Vienna,8204,5,14,11,11,57,40,17,53
RZ Pellets W,8204,6,14,7,15,55,54,1,49
Admira Wacke,8204,7,11,7,18,31,58,-27,40
SV Josko Rie,8204,8,11,3,22,31,54,-23,36
St. Pölten,8204,9,9,8,19,39,68,-29,35
Mattersburg,8204,10,6,10,20,38,64,-26,28
SC Rheindorf,8205,1,21,7,8,57,37,20,70
SK Sturm Gra,8205,2,19,7,10,54,34,20,64
FC Salzburg,8205,3,17,9,10,66,37,29,60
Vienna,8205,4,18,5,13,57,49,8,59
Admira Wacke,8205,5,15,6,15,42,55,-13,51
Rapid Vienna,8205,6,11,14,11,46,33,13,47
Mattersburg,8205,7,11,12,13,44,49,-5,45
RZ Pellets W,8205,8,10,8,18,43,59,-16,38
St. Pölten,8205,9,7,11,18,34,63,-29,32
SV Josko Rie,8205,10,8,7,21,31,58,-27,31
FC Salzburg,8206,1,21,9,6,78,35,43,72
Vienna,8206,2,18,10,8,61,49,12,64
SK Sturm Gra,8206,3,19,6,11,59,33,26,63
SC Rheindorf,8206,4,19,6,11,56,46,10,63
Rapid Vienna,8206,5,14,12,10,57,40,17,54
RZ Pellets W,8206,6,10,12,14,43,53,-10,42
SV Josko Rie,8206,7,12,5,19,41,62,-21,41
St. Pölten,8206,8,8,11,17,33,54,-21,35
Admira Wacke,8206,9,9,8,19,34,58,-24,35
Mattersburg,8206,10,5,11,20,28,60,-32,26
Vienna,8207,1,25,3,8,68,38,30,78
FC Salzburg,8207,2,19,6,11,60,30,30,63
SC Rheindorf,8207,3,17,9,10,51,47,4,60
Rapid Vienna,8207,4,15,13,8,57,35,22,58
SK Sturm Gra,8207,5,15,8,13,49,46,3,53
RZ Pellets W,8207,6,13,7,16,49,56,-7,46
St. Pölten,8207,7,9,13,14,43,57,-14,40
Mattersburg,8207,8,8,10,18,35,54,-19,34
Admira Wacke,8207,9,8,10,18,31,55,-24,34
SV Josko Rie,8207,10,9,5,22,32,57,-25,32
SK Sturm Gra,8208,1,20,5,11,68,42,26,65
FC Salzburg,8208,2,19,6,11,64,42,22,63
Vienna,8208,3,19,6,11,67,50,17,63
SC Rheindorf,8208,4,18,9,9,60,51,9,63
Rapid Vienna,8208,5,14,9,13,57,45,12,51
RZ Pellets W,8208,6,14,6,16,46,61,-15,48
Admira Wacke,8208,7,13,6,17,39,53,-14,45
St. Pölten,8208,8,9,10,17,44,66,-22,37
Mattersburg,8208,9,10,6,20,44,62,-18,36
SV Josko Rie,8208,10,10,5,21,40,57,-17,35
FC Salzburg,8209,1,22,6,8,66,31,35,72
SK Sturm Gra,8209,2,19,9,8,58,32,26,66
Vienna,8209,3,20,6,10,62,42,20,66
SC Rheindorf,8209,4,19,9,8,60,42,18,66
Rapid Vienna,8209,5,15,10,11,49,37,12,55
RZ Pellets W,8209,6,11,10,15,52,54,-2,43
Admira Wacke,8209,7,12,5,19,37,62,-25,41
St. Pölten,8209,8,8,9,19,45,67,-22,33
SV Josko Rie,8209,9,9,4,23,33,70,-37,31
Mattersburg,8209,10,6,10,20,37,62,-25,28
FC Salzburg,8210,1,21,7,8,62,32,30,70
SC Rheindorf,8210,2,20,8,8,55,38,17,68
SK Sturm Gra,8210,3,19,4,13,63,37,26,61
Vienna,8210,4,18,5,13,67,66,1,59
Rapid Vienna,8210,5,15,12,9,56,35,21,57
SV Josko Rie,8210,6,14,4,18,37,46,-9,46
Admira Wacke,8210,7,10,8,18,34,55,-21,38
RZ Pellets W,8210,8,9,10,17,44,59,-15,37
St. Pölten,8210,9,8,10,18,37,69,-32,34
Mattersburg,8210,10,8,8,20,34,52,-18,32
FC Salzburg,8211,1,20,9,7,65,31,34,69
Vienna,8211,2,19,7,10,70,53,17,64
SC Rheindorf,8211,3,18,9,9,50,42,8,63
SK Sturm Gra,8211,4,18,5,13,59,37,22,59
Rapid Vienna,8211,5,14,10,12,51,38,13,52
St. Pölten,8211,6,12,11,13,46,58,-12,47
RZ Pellets W,8211,7,11,9,16,46,54,-8,42
Admira Wacke,8211,8,10,7,19,33,65,-32,37
Mattersburg,8211,9,8,12,16,35,53,-18,36
SV Josko Rie,8211,10,8,5,23,35,59,-24,29
FC Salzburg,8212,1,21,10,5,70,29,41,73
SK Sturm Gra,8212,2,22,4,10,60,31,29,70
Vienna,8212,3,19,5,12,65,54,11,62
SC Rheindorf,8212,4,17,7,12,56,48,8,58
Admira Wacke,8212,5,13,9,14,42,52,-10,48
St. Pölten,8212,6,10,11,15,40,56,-16,41
Rapid Vienna,8212,7,9,11,16,45,52,-7,38
SV Josko Rie,8212,8,9,10,17,31,50,-19,37
Mattersburg,8212,9,9,9,18,37,59,-22,36
RZ Pellets W,8212,10,9,8,19,48,63,-15,35
SC Rheindorf,8213,1,20,9,7,61,44,17,69
SK Sturm Gra,8213,2,19,9,8,64,34,30,66
FC Salzburg,8213,3,19,8,9,64,33,31,65
Vienna,8213,4,18,6,12,75,60,15,60
Rapid Vienna,8213,5,13,11,12,61,45,16,50
RZ Pellets W,8213,6,14,6,16,52,60,-8,48
St. Pölten,8213,7,11,7,18,51,64,-13,40
Admira Wacke,8213,8,11,7,18,37,69,-32,40
Mattersburg,8213,9,8,9,19,37,58,-21,33
SV Josko Rie,8213,10,8,6,22,31,66,-35,30
FC Salzburg,8214,1,19,9,8,66,34,32,66
SK Sturm Gra,8214,2,19,8,9,55,29,26,65
SC Rheindorf,8214,3,18,6,12,54,49,5,60
RZ Pellets W,8214,4,17,7,12,54,46,8,58
Rapid Vienna,8214,5,15,10,11,60,41,19,55
Vienna,8214,6,16,7,13,58,55,3,55
SV Josko Rie,8214,7,12,5,19,30,52,-22,41
Admira Wacke,8214,8,12,5,19,37,60,-23,41
St. Pölten,8214,9,9,8,19,44,66,-22,35
Mattersburg,8214,10,7,7,22,33,59,-26,28
FC Salzburg,8215,1,24,6,6,71,27,44,78
SK Sturm Gra,8215,2,18,6,12,54,35,19,60
SC Rheindorf,8215,3,17,9,10,53,48,5,60
Vienna,8215,4,17,6,13,56,47,9,57
Rapid Vienna,8215,5,13,11,12,55,43,12,50
RZ Pellets W,8215,6,11,11,14,45,53,-8,44
St. Pölten,8215,7,11,8,17,46,68,-22,41
Admira Wacke,8215,8,11,6,19,34,60,-26,39
Mattersburg,8215,9,8,11,17,37,50,-13,35
SV Josko Rie,8215,10,9,8,19,28,48,-20,35
FC Salzburg,8216,1,20,10,6,65,32,33,70
SK Sturm Gra,8216,2,21,6,9,65,32,33,69
SC Rheindorf,8216,3,19,8,9,54,43,11,65
Vienna,8216,4,18,6,12,68,56,12,60
Rapid Vienna,8216,5,16,9,11,62,43,19,57
Admira Wacke,8216,6,12,8,16,34,56,-22,44
RZ Pellets W,8216,7,12,6,18,44,58,-14,42
St. Pölten,8216,8,8,10,18,46,67,-21,34
Mattersburg,8216,9,8,9,19,37,57,-20,33
SV Josko Rie,8216,10,8,4,24,29,60,-31,28
SC Rheindorf,8217,1,21,8,7,59,39,20,71
FC Salzburg,8217,2,20,9,7,59,30,29,69
SK Sturm Gra,8217,3,20,5,11,56,31,25,65
Vienna,8217,4,17,4,15,58,56,2,55
Rapid Vienna,8217,5,15,9,12,51,37,14,54
RZ Pellets W,8217,6,13,9,14,47,50,-3,48
SV Josko Rie,8217,7,10,7,19,38,55,-17,37
Admira Wacke,8217,8,10,6,20,36,60,-24,36
Mattersburg,8217,9,9,8,19,40,59,-19,35
St. Pölten,8217,10,7,11,18,38,65,-27,32
SC Rheindorf,8218,1,24,6,6,60,34,26,78
FC Salzburg,8218,2,22,7,7,63,25,38,73
SK Sturm Gra,8218,3,20,7,9,65,37,28,67
Rapid Vienna,8218,4,16,8,12,59,42,17,56
Vienna,8218,5,17,5,14,58,56,2,56
RZ Pellets W,8218,6,12,8,16,47,53,-6,44
St. Pölten,8218,7,9,10,17,40,62,-22,37
Admira Wacke,8218,8,9,7,20,33,65,-32,34
SV Josko Rie,8218,9,7,8,21,27,52,-25,29
Mattersburg,8218,10,7,8,21,31,57,-26,29
FC Salzburg,8219,1,23,6,7,63,27,36,75
SC Rheindorf,8219,2,21,7,8,57,39,18,70
Vienna,8219,3,21,3,12,62,49,13,66
SK Sturm Gra,8219,4,18,5,13,59,35,24,59
Rapid Vienna,8219,5,12,12,12,49,43,6,48
RZ Pellets W,8219,6,13,8,15,48,50,-2,47
SV Josko Rie,8219,7,9,9,18,31,49,-18,36
Admira Wacke,8219,8,10,5,21,28,58,-30,35
St. Pölten,8219,9,8,10,18,43,66,-23,34
Mattersburg,8219,10,8,9,19,36,60,-24,33
FC Salzburg,8220,1,22,9,5,71,28,43,75
SK Sturm Gra,8220,2,20,7,9,59,31,28,67
Vienna,8220,3,20,4,12,71,55,16,64
SC Rheindorf,8220,4,17,10,9,51,42,9,61
Admira Wacke,8220,5,13,8,15,41,59,-18,47
Rapid Vienna,8220,6,10,12,14,59,54,5,42
RZ Pellets W,8220,7,9,11,16,41,56,-15,38
St. Pölten,8220,8,8,12,16,45,63,-18,36
Mattersburg,8220,9,7,13,16,39,55,-16,34
SV Josko Rie,8220,10,8,6,22,37,71,-34,30
FC Salzburg,8221,1,21,9,6,60,29,31,72
SK Sturm Gra,8221,2,18,9,9,66,37,29,63
Vienna,8221,3,19,6,11,69,57,12,63
SC Rheindorf,8221,4,17,10,9,51,41,10,61
Rapid Vienna,8221,5,15,12,9,65,37,28,57
RZ Pellets W,8221,6,11,8,17,43,55,-12,41
Admira Wacke,8221,7,11,8,17,36,62,-26,41
St. Pölten,8221,8,8,12,16,37,58,-21,36
Mattersburg,8221,9,8,8,20,41,62,-21,32
SV Josko Rie,8221,10,8,6,22,31,61,-30,30
SC Rheindorf,8222,1,23,6,7,64,37,27,75
SK Sturm Gra,8222,2,22,5,9,70,31,39,71
FC Salzburg,8222,3,21,6,9,61,32,29,69
Vienna,8222,4,16,8,12,54,54,0,56
RZ Pellets W,8222,5,16,7,13,50,46,4,55
Rapid Vienna,8222,6,13,12,11,53,40,13,51
Admira Wacke,8222,7,10,7,19,30,57,-27,37
SV Josko Rie,8222,8,11,3,22,31,53,-22,36
Mattersburg,8222,9,7,7,22,30,59,-29,28
St. Pölten,8222,10,6,9,21,35,69,-34,27
FC Salzburg,8223,1,25,6,5,72,29,43,81
SC Rheindorf,8223,2,21,6,9,59,43,16,69
SK Sturm Gra,8223,3,19,6,11,56,32,24,63
Vienna,8223,4,17,6,13,62,53,9,57
Rapid Vienna,8223,5,16,8,12,56,39,17,56
RZ Pellets W,8223,6,11,9,16,44,56,-12,42
Mattersburg,8223,7,10,8,18,48,62,-14,38
SV Josko Rie,8223,8,10,5,21,37,60,-23,35
Admira Wacke,8223,9,9,8,19,32,62,-30,35
St. Pölten,8223,10,5,12,19,39,69,-30,27
SC Rheindorf,8224,1,25,5,6,67,38,29,80
FC Salzburg,8224,2,19,6,11,64,40,24,63
SK Sturm Gra,8224,3,19,5,12,58,38,20,62
Vienna,8224,4,17,2,17,58,59,-1,53
Admira Wacke,8224,5,15,3,18,38,56,-18,48
Rapid Vienna,8224,6,12,10,14,60,48,12,46
St. Pölten,8224,7,10,10,16,44,59,-15,40
RZ Pellets W,8224,8,11,6,19,46,61,-15,39
SV Josko Rie,8224,9,11,6,19,38,55,-17,39
Mattersburg,8224,10,9,11,16,31,50,-19,38
FC Salzburg,8225,1,22,8,6,67,27,40,74
SC Rheindorf,8225,2,21,7,8,58,41,17,70
Vienna,8225,3,17,8,11,63,51,12,59
Rapid Vienna,8225,4,16,10,10,61,44,17,58
SK Sturm Gra,8225,5,17,6,13,58,44,14,57
RZ Pellets W,8225,6,13,7,16,51,63,-12,46
SV Josko Rie,8225,7,12,6,18,43,51,-8,42
Admira Wacke,8225,8,11,6,19,37,62,-25,39
St. Pölten,8225,9,7,9,20,44,68,-24,30
Mattersburg,8225,10,6,9,21,34,65,-31,27
FC Salzburg,8226,1,21,6,9,70,35,35,69
SK Sturm Gra,8226,2,21,6,9,57,31,26,69
SC Rheindorf,8226,3,20,5,11,53,41,12,65
Vienna,8226,4,19,5,12,66,50,16,62
Rapid Vienna,8226,5,15,11,10,60,43,17,56
RZ Pellets W,8226,6,12,9,15,53,57,-4,45
Admira Wacke,8226,7,11,5,20,37,63,-26,38
SV Josko Rie,8226,8,10,6,20,42,61,-19,36
Mattersburg,8226,9,7,11,18,38,66,-28,32
St. Pölten,8226,10,8,8,20,41,70,-29,32
FC Salzburg,8227,1,24,7,5,74,26,48,79
SK Sturm Gra,8227,2,19,8,9,61,33,28,65
SC Rheindorf,8227,3,18,10,8,57,41,16,64
Vienna,8227,4,18,5,13,60,55,5,59
Rapid Vienna,8227,5,14,10,12,60,45,15,52
RZ Pellets W,8227,6,12,7,17,43,57,-14,43
Admira Wacke,8227,7,11,7,18,36,61,-25,40
SV Josko Rie,8227,8,10,9,17,33,52,-19,39
Mattersburg,8227,9,10,7,19,40,58,-18,37
St. Pölten,8227,10,4,10,22,31,67,-36,22
SC Rheindorf,8228,1,22,6,8,58,46,12,72
FC Salzburg,8228,2,21,7,8,65,36,29,70
Vienna,8228,3,20,4,12,72,49,23,64
SK Sturm Gra,8228,4,16,8,12,62,44,18,56
Rapid Vienna,8228,5,14,8,14,54,40,14,50
SV Josko Rie,8228,6,13,2,21,38,55,-17,41
RZ Pellets W,8228,7,11,7,18,43,59,-16,40
Admira Wacke,8228,8,12,4,20,39,63,-24,40
St. Pölten,8228,9,10,8,18,35,61,-26,38
Mattersburg,8228,10,9,10,17,39,52,-13,37
FC Salzburg,8229,1,23,8,5,69,29,40,77
SK Sturm Gra,8229,2,19,7,10,62,36,26,64
SC Rheindorf,8229,3,19,6,11,56,43,13,63
Vienna,8229,4,18,7,11,65,56,9,61
Rapid Vienna,8229,5,14,11,11,56,44,12,53
Admira Wacke,8229,6,11,9,16,38,54,-16,42
RZ Pellets W,8229,7,11,8,17,46,56,-10,41
St. Pölten,8229,8,8,13,15,41,63,-22,37
SV Josko Rie,8229,9,9,9,18,35,54,-19,36
Mattersburg,8229,10,5,8,23,32,65,-33,23
FC Salzburg,8230,1,21,6,9,71,30,41,69
SK Sturm Gra,8230,2,20,6,10,56,35,21,66
SC Rheindorf,8230,3,19,7,10,53,44,9,64
Vienna,8230,4,17,4,15,59,58,1,55
Rapid Vienna,8230,5,14,12,10,57,41,16,54
RZ Pellets W,8230,6,15,7,14,51,56,-5,52
SV Josko Rie,8230,7,12,5,19,36,55,-19,41
St. Pölten,8230,8,8,12,16,41,59,-18,36
Admira Wacke,8230,9,10,6,20,40,60,-20,36
Mattersburg,8230,10,7,9,20,31,57,-26,30
SC Rheindorf,8231,1,22,6,8,61,46,15,72
FC Salzburg,8231,2,19,10,7,66,34,32,67
SK Sturm Gra,8231,3,20,6,10,61,36,25,66
Vienna,8231,4,18,5,13,66,54,12,59
Rapid Vienna,8231,5,15,11,10,62,43,19,56
Mattersburg,8231,6,11,8,17,42,55,-13,41
RZ Pellets W,8231,7,10,7,19,42,62,-20,37
Admira Wacke,8231,8,10,7,19,32,57,-25,37
SV Josko Rie,8231,9,10,6,20,36,53,-17,36
St. Pölten,8231,10,7,10,19,38,66,-28,31
FC Salzburg,8232,1,22,7,7,62,26,36,73
SK Sturm Gra,8232,2,21,5,10,59,31,28,68
Vienna,8232,3,20,5,11,55,38,17,65
SC Rheindorf,8232,4,16,9,11,52,44,8,57
Rapid Vienna,8232,5,14,9,13,58,50,8,51
RZ Pellets W,8232,6,13,8,15,46,49,-3,47
St. Pölten,8232,7,9,10,17,38,65,-27,37
SV Josko Rie,8232,8,10,6,20,28,50,-22,36
Admira Wacke,8232,9,10,6,20,36,65,-29,36
Mattersburg,8232,10,8,9,19,39,55,-16,33
FC Salzburg,8233,1,22,7,7,65,31,34,73
SC Rheindorf,8233,2,21,7,8,60,38,22,70
Vienna,8233,3,20,6,10,64,48,16,66
SK Sturm Gra,8233,4,17,8,11,56,40,16,59
Rapid Vienna,8233,5,13,11,12,54,39,15,50
Admira Wacke,8233,6,13,7,16,31,50,-19,46
RZ Pellets W,8233,7,12,9,15,48,60,-12,45
St. Pölten,8233,8,7,11,18,41,60,-19,32
SV Josko Rie,8233,9,9,5,22,31,53,-22,32
Mattersburg,8233,10,6,9,21,35,66,-31,27
SC Rheindorf,8234,1,21,6,9,60,40,20,69
FC Salzburg,8234,2,19,8,9,63,30,33,65
Vienna,8234,3,18,8,10,64,54,10,62
SK Sturm Gra,8234,4,17,7,12,54,37,17,58
Rapid Vienna,8234,5,16,8,12,59,36,23,56
RZ Pellets W,8234,6,13,4,19,44,63,-19,43
Admira Wacke,8234,7,11,7,18,42,64,-22,40
SV Josko Rie,8234,8,10,8,18,33,54,-21,38
St. Pölten,8234,9,9,9,18,44,66,-22,36
Mattersburg,8234,10,8,11,17,33,52,-19,35
SK Sturm Gra,8235,1,23,6,7,60,31,29,75
SC Rheindorf,8235,2,21,9,6,57,32,25,72
FC Salzburg,8235,3,18,6,12,59,30,29,60
Rapid Vienna,8235,4,16,11,9,58,37,21,59
Vienna,8235,5,17,4,15,60,61,-1,55
Admira Wacke,8235,6,13,6,17,40,55,-15,45
RZ Pellets W,8235,7,11,7,18,43,57,-14,40
Mattersburg,8235,8,9,10,17,35,54,-19,37
SV Josko Rie,8235,9,9,4,23,33,62,-29,31
St. Pölten,8235,10,5,13,18,36,62,-26,28
FC Salzburg,8236,1,21,10,5,65,30,35,73
SK Sturm Gra,8236,2,19,8,9,54,30,24,65
Vienna,8236,3,19,6,11,69,50,19,63
SC Rheindorf,8236,4,18,7,11,49,46,3,61
Rapid Vienna,8236,5,12,11,13,56,47,9,47
RZ Pellets W,8236,6,12,10,14,49,53,-4,46
SV Josko Rie,8236,7,11,4,21,41,61,-20,37
Admira Wacke,8236,8,10,7,19,38,64,-26,37
Mattersburg,8236,9,8,12,16,37,55,-18,36
St. Pölten,8236,10,8,9,19,47,69,-22,33
FC Salzburg,8237,1,21,8,7,68,31,37,71
SC Rheindorf,8237,2,21,8,7,53,34,19,71
Vienna,8237,3,20,4,12,65,52,13,64
SK Sturm Gra,8237,4,18,5,13,59,45,14,59
Rapid Vienna,8237,5,12,11,13,51,40,11,47
Admira Wacke,8237,6,11,8,17,38,61,-23,41
RZ Pellets W,8237,7,10,9,17,41,55,-14,39
SV Josko Rie,8237,8,11,5,20,36,58,-22,38
Mattersburg,8237,9,8,11,17,37,52,-15,35
St. Pölten,8237,10,8,11,17,42,62,-20,35
FC Salzburg,8238,1,23,6,7,66,26,40,75
SC Rheindorf,8238,2,19,10,7,57,38,19,67
SK Sturm Gra,8238,3,18,9,9,59,36,23,63
Vienna,8238,4,19,5,12,63,54,9,62
RZ Pellets W,8238,5,13,9,14,51,52,-1,48
Rapid Vienna,8238,6,12,10,14,55,43,12,46
Mattersburg,8238,7,10,8,18,36,54,-18,38
Admira Wacke,8238,8,9,7,20,33,61,-28,34
SV Josko Rie,8238,9,8,9,19,24,49,-25,33
St. Pölten,8238,10,7,11,18,37,68,-31,32
SK Sturm Gra,8239,1,19,9,8,62,31,31,66
Vienna,8239,2,20,6,10,73,53,20,66
FC Salzburg,8239,3,19,8,9,69,41,28,65
SC Rheindorf,8239,4,17,6,13,60,54,6,57
Rapid Vienna,8239,5,13,12,11,54,42,12,51
RZ Pellets W,8239,6,15,6,15,44,52,-8,51
Admira Wacke,8239,7,10,8,18,39,61,-22,38
Mattersburg,8239,8,9,9,18,42,62,-20,36
St. Pölten,8239,9,8,11,17,42,63,-21,35
SV Josko Rie,8239,10,10,5,21,34,60,-26,35
FC Salzburg,8240,1,22,8,6,76,31,45,74
SK Sturm Gra,8240,2,20,4,12,57,38,19,64
SC Rheindorf,8240,3,17,8,11,51,49,2,59
Vienna,8240,4,17,6,13,63,58,5,57
Rapid Vienna,8240,5,14,12,10,57,45,12,54
RZ Pellets W,8240,6,15,5,16,55,48,7,50
SV Josko Rie,8240,7,12,5,19,42,59,-17,41
St. Pölten,8240,8,10,9,17,45,65,-20,39
Admira Wacke,8240,9,10,6,20,36,64,-28,36
Mattersburg,8240,10,6,11,19,30,55,-25,29
FC Salzburg,8241,1,23,8,5,69,27,42,77
SK Sturm Gra,8241,2,19,4,13,62,41,21,61
SC Rheindorf,8241,3,18,7,11,56,47,9,61
Vienna,8241,4,17,5,14,56,51,5,56
Rapid Vienna,8241,5,13,13,10,50,39,11,52
Admira Wacke,8241,6,13,9,14,36,46,-10,48
RZ Pellets W,8241,7,12,6,18,38,50,-12,42
Mattersburg,8241,8,11,9,16,40,54,-14,42
SV Josko Rie,8241,9,10,6,20,38,58,-20,36
St. Pölten,8241,10,7,7,22,37,69,-32,28
FC Salzburg,8242,1,21,7,8,64,35,29,70
SK Sturm Gra,8242,2,19,8,9,67,36,31,65
SC Rheindorf,8242,3,19,7,10,53,45,8,64
Vienna,8242,4,19,6,11,65,54,11,63
RZ Pellets W,8242,5,14,9,13,54,57,-3,51
Rapid Vienna,8242,6,11,11,14,56,52,4,44
SV Josko Rie,8242,7,13,4,19,41,50,-9,43
Admira Wacke,8242,8,11,6,19,40,66,-26,39
St. Pölten,8242,9,9,10,17,45,65,-20,37
Mattersburg,8242,10,7,6,23,33,58,-25,27
FC Salzburg,8243,1,23,7,6,67,29,38,76
SC Rheindorf,8243,2,19,8,9,54,38,16,65
SK Sturm Gra,8243,3,18,7,11,58,33,25,61
Vienna,8243,4,17,4,15,55,60,-5,55
Rapid Vienna,8243,5,13,11,12,55,38,17,50
RZ Pellets W,8243,6,12,12,12,46,50,-4,48
Admira Wacke,8243,7,9,11,16,35,58,-23,38
SV Josko Rie,8243,8,11,5,20,35,59,-24,38
Mattersburg,8243,9,9,8,19,34,57,-23,35
St. Pölten,8243,10,8,9,19,42,59,-17,33
SK Sturm Gra,8244,1,21,6,9,70,35,35,69
FC Salzburg,8244,2,20,6,10,60,33,27,66
SC Rheindorf,8244,3,19,7,10,60,45,15,64
Vienna,8244,4,18,5,13,70,59,11,59
Rapid Vienna,8244,5,16,9,11,64,44,20,57
Admira Wacke,8244,6,14,8,14,42,54,-12,50
RZ Pellets W,8244,7,11,7,18,40,61,-21,40
St. Pölten,8244,8,10,7,19,40,68,-28,37
SV Josko Rie,8244,9,10,4,22,34,57,-23,34
Mattersburg,8244,10,9,5,22,38,62,-24,32
FC Salzburg,8245,1,21,9,6,58,24,34,72
SK Sturm Gra,8245,2,20,8,8,60,33,27,68
SC Rheindorf,8245,3,20,8,8,53,39,14,68
Vienna,8245,4,20,4,12,68,52,16,64
Rapid Vienna,8245,5,12,10,14,49,43,6,46
Admira Wacke,8245,6,11,12,13,42,55,-13,45
RZ Pellets W,8245,7,11,7,18,47,64,-17,40
Mattersburg,8245,8,9,7,20,38,62,-24,34
St. Pölten,8245,9,8,9,19,37,57,-20,33
SV Josko Rie,8245,10,9,4,23,34,57,-23,31
FC Salzburg,8246,1,21,8,7,67,27,40,71
SC Rheindorf,8246,2,19,8,9,48,42,6,65
SK Sturm Gra,8246,3,19,7,10,57,36,21,64
Vienna,8246,4,17,9,10,55,44,11,60
Rapid Vienna,8246,5,15,11,10,57,38,19,56
RZ Pellets W,8246,6,12,9,15,47,56,-9,45
SV Josko Rie,8246,7,9,8,19,33,53,-20,35
Mattersburg,8246,8,8,10,18,39,57,-18,34
Admira Wacke,8246,9,9,7,20,29,56,-27,34
St. Pölten,8246,10,7,11,18,38,61,-23,32
SK Sturm Gra,8247,1,22,5,9,70,32,38,71
FC Salzburg,8247,2,20,8,8,64,30,34,68
Vienna,8247,3,18,7,11,64,54,10,61
SC Rheindorf,8247,4,17,7,12,50,42,8,58
Rapid Vienna,8247,5,15,9,12,60,47,13,54
RZ Pellets W,8247,6,14,6,16,44,53,-9,48
Admira Wacke,8247,7,11,6,19,34,62,-28,39
St. Pölten,8247,8,10,7,19,45,68,-23,37
SV Josko Rie,8247,9,11,3,22,33,54,-21,36
Mattersburg,8247,10,8,10,18,37,59,-22,34
FC Salzburg,8248,1,22,7,7,71,33,38,73
Vienna,8248,2,22,2,12,60,48,12,68
SC Rheindorf,8248,3,18,9,9,51,40,11,63
SK Sturm Gra,8248,4,18,5,13,57,35,22,59
Rapid Vienna,8248,5,12,11,13,46,38,8,47
RZ Pellets W,8248,6,12,10,14,47,48,-1,46
Admira Wacke,8248,7,13,5,18,39,62,-23,44
Mattersburg,8248,8,10,9,17,38,54,-16,39
St. Pölten,8248,9,6,15,15,35,57,-22,33
SV Josko Rie,8248,10,8,5,23,26,55,-29,29
FC Salzburg,8249,1,22,7,7,69,29,40,73
SC Rheindorf,8249,2,20,8,8,49,35,14,68
Vienna,8249,3,19,5,12,61,50,11,62
Rapid Vienna,8249,4,16,10,10,61,43,18,58
SK Sturm Gra,8249,5,15,7,14,51,45,6,52
Admira Wacke,8249,6,13,8,15,45,53,-8,47
RZ Pellets W,8249,7,11,8,17,43,55,-12,41
SV Josko Rie,8249,8,12,5,19,34,52,-18,41
St. Pölten,8249,9,8,8,20,38,67,-29,32
Mattersburg,8249,10,7,8,21,37,59,-22,29
FC Salzburg,8250,1,22,7,7,78,35,43,73
SK Sturm Gra,8250,2,18,8,10,57,38,19,62
Vienna,8250,3,18,4,14,72,64,8,58
SC Rheindorf,8250,4,15,10,11,50,47,3,55
Rapid Vienna,8250,5,14,12,10,70,47,23,54
RZ Pellets W,8250,6,14,6,16,51,61,-10,48
Admira Wacke,8250,7,12,7,17,45,62,-17,43
SV Josko Rie,8250,8,12,4,20,33,52,-19,40
St. Pölten,8250,9,10,7,19,43,70,-27,37
Mattersburg,8250,10,8,9,19,39,62,-23,33
SC Rheindorf,8251,1,22,5,9,60,37,23,71
FC Salzburg,8251,2,20,6,10,72,41,31,66
SK Sturm Gra,8251,3,19,5,12,62,45,17,62
Rapid Vienna,8251,4,17,9,10,62,37,25,60
Vienna,8251,5,17,5,14,62,55,7,56
SV Josko Rie,8251,6,15,3,18,39,49,-10,48
RZ Pellets W,8251,7,12,9,15,44,54,-10,45
Admira Wacke,8251,8,12,5,19,33,60,-27,41
St. Pölten,8251,9,8,8,20,39,64,-25,32
Mattersburg,8251,10,7,7,22,34,65,-31,28
FC Salzburg,8252,1,20,9,7,72,29,43,69
SK Sturm Gra,8252,2,19,8,9,56,32,24,65
SC Rheindorf,8252,3,17,10,9,56,44,12,61
Vienna,8252,4,17,5,14,61,59,2,56
Rapid Vienna,8252,5,14,12,10,58,44,14,54
RZ Pellets W,8252,6,14,7,15,56,57,-1,49
Mattersburg,8252,7,11,8,17,47,59,-12,41
St. Pölten,8252,8,9,11,16,44,68,-24,38
SV Josko Rie,8252,9,10,5,21,33,59,-26,35
Admira Wacke,8252,10,8,7,21,29,61,-32,31
FC Salzburg,8253,1,22,7,7,73,35,38,73
SC Rheindorf,8253,2,20,6,10,62,45,17,66
SK Sturm Gra,8253,3,20,4,12,59,40,19,64
Vienna,8253,4,20,2,14,63,49,14,62
Rapid Vienna,8253,5,15,10,11,55,40,15,55
RZ Pellets W,8253,6,13,6,17,48,56,-8,45
Admira Wacke,8253,7,12,4,20,33,62,-29,40
Mattersburg,8253,8,9,9,18,37,54,-17,36
St. Pölten,8253,9,8,11,17,44,60,-16,35
SV Josko Rie,8253,10,10,3,23,27,60,-33,33
SK Sturm Gra,8254,1,22,6,8,59,30,29,72
Vienna,8254,2,22,4,10,79,55,24,70
FC Salzburg,8254,3,19,10,7,66,31,35,67
SC Rheindorf,8254,4,20,5,11,51,44,7,65
Rapid Vienna,8254,5,14,13,9,59,38,21,55
Admira Wacke,8254,6,11,8,17,37,59,-22,41
RZ Pellets W,8254,7,10,9,17,40,60,-20,39
Mattersburg,8254,8,8,9,19,40,57,-17,33
SV Josko Rie,8254,9,8,7,21,31,57,-26,31
St. Pölten,8254,10,5,11,20,39,70,-31,26
FC Salzburg,8255,1,22,8,6,69,29,40,74
Vienna,8255,2,19,7,10,66,49,17,64
SC Rheindorf,8255,3,19,7,10,51,39,12,64
SK Sturm Gra,8255,4,17,9,10,54,30,24,60
Rapid Vienna,8255,5,14,9,13,56,42,14,51
Mattersburg,8255,6,11,10,15,45,56,-11,43
RZ Pellets W,8255,7,12,7,17,40,57,-17,43
Admira Wacke,8255,8,11,6,19,36,62,-26,39
SV Josko Rie,8255,9,11,3,22,38,57,-19,36
St. Pölten,8255,10,6,10,20,37,71,-34,28
FC Salzburg,8256,1,21,8,7,73,35,38,71
SC Rheindorf,8256,2,21,6,9,59,39,20,69
SK Sturm Gra,8256,3,18,6,12,57,37,20,60
Vienna,8256,4,16,8,12,65,56,9,56
RZ Pellets W,8256,5,13,8,15,46,54,-8,47
Rapid Vienna,8256,6,12,10,14,57,50,7,46
Admira Wacke,8256,7,13,7,16,44,62,-18,46
Mattersburg,8256,8,11,7,18,33,50,-17,40
SV Josko Rie,8256,9,10,5,21,32,58,-26,35
St. Pölten,8256,10,8,9,19,39,64,-25,33
SC Rheindorf,8257,1,21,8,7,58,35,23,71
FC Salzburg,8257,2,18,10,8,57,35,22,64
SK Sturm Gra,8257,3,18,7,11,54,31,23,61
Vienna,8257,4,16,6,14,60,56,4,54
Admira Wacke,8257,5,14,8,14,44,55,-11,50
Rapid Vienna,8257,6,12,11,13,58,46,12,47
RZ Pellets W,8257,7,12,8,16,40,47,-7,44
St. Pölten,8257,8,11,8,17,48,67,-19,41
SV Josko Rie,8257,9,8,11,17,36,56,-20,35
Mattersburg,8257,10,8,7,21,39,66,-27,31
SK Sturm Gra,8258,1,22,4,10,60,31,29,70
SC Rheindorf,8258,2,19,8,9,49,40,9,65
FC Salzburg,8258,3,18,9,9,57,33,24,63
Vienna,8258,4,18,5,13,63,49,14,59
Rapid Vienna,8258,5,14,13,9,58,36,22,55
RZ Pellets W,8258,6,11,9,16,39,51,-12,42
Admira Wacke,8258,7,11,8,17,35,56,-21,41
Mattersburg,8258,8,10,8,18,39,52,-13,38
SV Josko Rie,8258,9,10,6,20,31,55,-24,36
St. Pölten,8258,10,6,12,18,41,69,-28,30
SC Rheindorf,8259,1,24,5,7,61,33,28,77
FC Salzburg,8259,2,22,7,7,71,36,35,73
SK Sturm Gra,8259,3,18,6,12,58,43,15,60
Vienna,8259,4,17,4,15,63,56,7,55
Admira Wacke,8259,5,13,7,16,41,57,-16,46
RZ Pellets W,8259,6,12,9,15,48,56,-8,45
Rapid Vienna,8259,7,10,12,14,54,51,3,42
Mattersburg,8259,8,10,8,18,47,58,-11,38
St. Pölten,8259,9,10,7,19,47,67,-20,37
SV Josko Rie,8259,10,10,3,23,34,67,-33,33
SC Rheindorf,8260,1,22,7,7,62,38,24,73
FC Salzburg,8260,2,21,7,8,55,30,25,70
SK Sturm Gra,8260,3,18,7,11,59,39,20,61
Rapid Vienna,8260,4,15,11,10,62,41,21,56
Vienna,8260,5,16,6,14,55,52,3,54
RZ Pellets W,8260,6,14,5,17,46,54,-8,47
St. Pölten,8260,7,9,11,16,43,61,-18,38
Mattersburg,8260,8,9,9,18,35,54,-19,36
Admira Wacke,8260,9,10,6,20,33,55,-22,36
SV Josko Rie,8260,10,8,7,21,34,60,-26,31
FC Salzburg,8261,1,21,10,5,61,24,37,73
SK Sturm Gra,8261,2,20,6,10,68,39,29,66
Vienna,8261,3,21,3,12,71,55,16,66
SC Rheindorf,8261,4,17,8,11,50,47,3,59
Rapid Vienna,8261,5,12,13,11,56,47,9,49
RZ Pellets W,8261,6,12,8,16,55,65,-10,44
Admira Wacke,8261,7,13,5,18,36,53,-17,44
Mattersburg,8261,8,9,10,17,40,56,-16,37
SV Josko Rie,8261,9,9,5,22,35,58,-23,32
St. Pölten,8261,10,7,10,19,39,67,-28,31
FC Salzburg,8262,1,24,6,6,64,22,42,78
SC Rheindorf,8262,2,19,5,12,54,46,8,62
SK Sturm Gra,8262,3,18,6,12,56,44,12,60
Rapid Vienna,8262,4,15,10,11,58,38,20,55
Vienna,8262,5,15,5,16,57,56,1,50
RZ Pellets W,8262,6,13,8,15,47,49,-2,47
SV Josko Rie,8262,7,11,7,18,41,54,-13,40
St. Pölten,8262,8,10,9,17,43,64,-21,39
Admira Wacke,8262,9,10,7,19,33,60,-27,37
Mattersburg,8262,10,8,11,17,35,55,-20,35
FC Salzburg,8263,1,22,5,9,68,33,35,71
SC Rheindorf,8263,2,18,10,8,56,43,13,64
SK Sturm Gra,8263,3,19,6,11,56,35,21,63
Vienna,8263,4,16,3,17,59,60,-1,51
RZ Pellets W,8263,5,15,6,15,47,54,-7,51
Rapid Vienna,8263,6,13,9,14,54,43,11,48
SV Josko Rie,8263,7,13,6,17,34,45,-11,45
Mattersburg,8263,8,10,8,18,42,53,-11,38
St. Pölten,8263,9,10,8,18,37,62,-25,38
Admira Wacke,8263,10,11,5,20,31,56,-25,38
SC Rheindorf,8264,1,21,7,8,61,42,19,70
SK Sturm Gra,8264,2,20,8,8,60,30,30,68
FC Salzburg,8264,3,20,5,11,58,34,24,65
Vienna,8264,4,17,4,15,57,56,1,55
RZ Pellets W,8264,5,13,8,15,45,55,-10,47
Rapid Vienna,8264,6,12,10,14,58,43,15,46
Admira Wacke,8264,7,12,8,16,41,56,-15,44
SV Josko Rie,8264,8,11,5,20,32,51,-19,38
St. Pölten,8264,9,10,8,18,45,74,-29,38
Mattersburg,8264,10,8,9,19,41,57,-16,33
SK Sturm Gra,8265,1,20,6,10,60,30,30,66
FC Salzburg,8265,2,20,5,11,68,41,27,65
SC Rheindorf,8265,3,19,6,11,62,49,13,63
Vienna,8265,4,19,4,13,61,48,13,61
Rapid Vienna,8265,5,16,10,10,56,40,16,58
Mattersburg,8265,6,12,8,16,48,62,-14,44
SV Josko Rie,8265,7,13,3,20,36,52,-16,42
St. Pölten,8265,8,10,9,17,44,62,-18,39
RZ Pellets W,8265,9,10,7,19,47,59,-12,37
Admira Wacke,8265,10,9,6,21,29,68,-39,33
SC Rheindorf,8266,1,22,5,9,65,49,16,71
FC Salzburg,8266,2,20,8,8,65,30,35,68
SK Sturm Gra,8266,3,20,6,10,64,37,27,66
Rapid Vienna,8266,4,14,14,8,57,36,21,56
Vienna,8266,5,17,5,14,62,60,2,56
RZ Pellets W,8266,6,14,7,15,53,53,0,49
SV Josko Rie,8266,7,11,5,20,35,52,-17,38
Admira Wacke,8266,8,11,4,21,36,65,-29,37
Mattersburg,8266,9,8,9,19,38,60,-22,33
St. Pölten,8266,10,6,11,19,40,73,-33,29
SC Rheindorf,8267,1,22,6,8,64,43,21,72
FC Salzburg,8267,2,18,9,9,60,32,28,63
SK Sturm Gra,8267,3,17,8,11,58,35,23,59
Vienna,8267,4,18,5,13,59,48,11,59
Rapid Vienna,8267,5,12,12,12,53,43,10,48
Admira Wacke,8267,6,14,6,16,33,48,-15,48
RZ Pellets W,8267,7,14,5,17,50,60,-10,47
St. Pölten,8267,8,11,8,17,45,63,-18,41
SV Josko Rie,8267,9,11,5,20,32,52,-20,38
Mattersburg,8267,10,8,6,22,35,65,-30,30
FC Salzburg,8268,1,22,5,9,67,37,30,71
SC Rheindorf,8268,2,19,9,8,57,44,13,66
SK Sturm Gra,8268,3,18,6,12,58,29,29,60
Vienna,8268,4,18,6,12,59,52,7,60
Rapid Vienna,8268,5,14,9,13,56,42,14,51
Admira Wacke,8268,6,15,5,16,45,59,-14,50
RZ Pellets W,8268,7,12,9,15,48,55,-7,45
SV Josko Rie,8268,8,13,3,20,35,54,-19,42
St. Pölten,8268,9,7,9,20,39,65,-26,30
Mattersburg,8268,10,7,9,20,27,54,-27,30
FC Salzburg,8269,1,23,6,7,64,29,35,75
SK Sturm Gra,8269,2,20,5,11,56,35,21,65
Vienna,8269,3,19,6,11,61,47,14,63
Rapid Vienna,8269,4,17,11,8,58,34,24,62
SC Rheindorf,8269,5,17,9,10,51,42,9,60
RZ Pellets W,8269,6,14,7,15,52,59,-7,49
SV Josko Rie,8269,7,12,5,19,39,55,-16,41
Admira Wacke,8269,8,8,8,20,33,64,-31,32
St. Pölten,8269,9,8,7,21,36,62,-26,31
Mattersburg,8269,10,6,8,22,35,58,-23,26
FC Salzburg,8270,1,25,7,4,77,29,48,82
SC Rheindorf,8270,2,19,8,9,56,42,14,65
Vienna,8270,3,19,5,12,60,48,12,62
SK Sturm Gra,8270,4,18,6,12,57,44,13,60
Rapid Vienna,8270,5,15,10,11,60,40,20,55
RZ Pellets W,8270,6,13,6,17,47,54,-7,45
St. Pölten,8270,7,9,11,16,44,62,-18,38
Admira Wacke,8270,8,11,5,20,36,60,-24,38
SV Josko Rie,8270,9,10,5,21,30,54,-24,35
Mattersburg,8270,10,6,7,23,29,63,-34,25
SC Rheindorf,8271,1,21,7,8,57,36,21,70
SK Sturm Gra,8271,2,20,4,12,60,33,27,64
FC Salzburg,8271,3,18,8,10,58,32,26,62
Rapid Vienna,8271,4,18,8,10,61,36,25,62
Vienna,8271,5,17,5,14,56,54,2,56
SV Josko Rie,8271,6,13,4,19,35,50,-15,43
Mattersburg,8271,7,11,7,18,37,55,-18,40
RZ Pellets W,8271,8,9,10,17,38,55,-17,37
Admira Wacke,8271,9,10,7,19,30,61,-31,37
St. Pölten,8271,10,7,12,17,41,61,-20,33
FC Salzburg,8272,1,21,7,8,59,32,27,70
SC Rheindorf,8272,2,21,5,10,57,47,10,68
Vienna,8272,3,21,4,11,77,52,25,67
SK Sturm Gra,8272,4,17,9,10,57,36,21,60
Admira Wacke,8272,5,16,6,14,50,50,0,54
Rapid Vienna,8272,6,11,13,12,53,46,7,46
RZ Pellets W,8272,7,12,7,17,45,56,-11,43
SV Josko Rie,8272,8,10,5,21,32,57,-25,35
Mattersburg,8272,9,6,12,18,35,59,-24,30
St. Pölten,8272,10,7,8,21,38,68,-30,29
FC Salzburg,8273,1,27,4,5,72,23,49,85
SC Rheindorf,8273,2,19,7,10,60,42,18,64
Vienna,8273,3,19,5,12,74,56,18,62
SK Sturm Gra,8273,4,18,5,13,63,45,18,59
Rapid Vienna,8273,5,12,11,13,53,45,8,47
St. Pölten,8273,6,11,9,16,40,62,-22,42
SV Josko Rie,8273,7,12,5,19,39,56,-17,41
RZ Pellets W,8273,8,11,7,18,44,58,-14,40
Mattersburg,8273,9,8,9,19,38,62,-24,33
Admira Wacke,8273,10,9,6,21,29,63,-34,33
FC Salzburg,8274,1,20,9,7,74,32,42,69
SC Rheindorf,8274,2,20,9,7,61,39,22,69
SK Sturm Gra,8274,3,19,7,10,57,32,25,64
Vienna,8274,4,19,7,10,64,52,12,64
Rapid Vienna,8274,5,12,14,10,54,41,13,50
Admira Wacke,8274,6,13,4,19,40,61,-21,43
RZ Pellets W,8274,7,11,6,19,43,60,-17,39
SV Josko Rie,8274,8,11,6,19,33,50,-17,39
St. Pölten,8274,9,7,10,19,38,79,-41,31
Mattersburg,8274,10,6,12,18,38,56,-18,30
FC Salzburg,8275,1,18,11,7,62,33,29,65
Vienna,8275,2,18,8,10,66,47,19,62
SK Sturm Gra,8275,3,16,11,9,53,33,20,59
SC Rheindorf,8275,4,16,11,9,57,52,5,59
Rapid Vienna,8275,5,14,13,9,63,43,20,55
RZ Pellets W,8275,6,12,10,14,46,52,-6,46
Admira Wacke,8275,7,10,10,16,41,62,-21,40
SV Josko Rie,8275,8,10,8,18,42,64,-22,38
Mattersburg,8275,9,7,11,18,37,58,-21,32
St. Pölten,8275,10,7,11,18,46,69,-23,32
SC Rheindorf,8276,1,21,7,8,59,38,21,70
FC Salzburg,8276,2,18,11,7,59,29,30,65
SK Sturm Gra,8276,3,20,4,12,56,35,21,64
Vienna,8276,4,17,8,11,60,51,9,59
Rapid Vienna,8276,5,14,13,9,49,36,13,55
Admira Wacke,8276,6,13,5,18,43,61,-18,44
RZ Pellets W,8276,7,11,9,16,40,52,-12,42
St. Pölten,8276,8,8,11,17,43,59,-16,35
Mattersburg,8276,9,8,11,17,42,61,-19,35
SV Josko Rie,8276,10,8,5,23,30,59,-29,29
SK Sturm Gra,8277,1,24,5,7,68,28,40,77
SC Rheindorf,8277,2,20,8,8,62,39,23,68
Vienna,8277,3,19,7,10,64,49,15,64
FC Salzburg,8277,4,16,12,8,55,32,23,60
Rapid Vienna,8277,5,14,9,13,53,44,9,51
RZ Pellets W,8277,6,13,6,17,46,59,-13,45
Admira Wacke,8277,7,12,5,19,41,58,-17,41
Mattersburg,8277,8,9,8,19,34,56,-22,35
SV Josko Rie,8277,9,9,6,21,31,59,-28,33
St. Pölten,8277,10,8,6,22,42,72,-30,30
SC Rheindorf,8278,1,20,8,8,60,42,18,68
SK Sturm Gra,8278,2,19,9,8,61,38,23,66
Vienna,8278,3,19,6,11,67,51,16,63
FC Salzburg,8278,4,16,9,11,60,42,18,57
Rapid Vienna,8278,5,15,10,11,58,41,17,55
RZ Pellets W,8278,6,15,5,16,54,58,-4,50
SV Josko Rie,8278,7,13,2,21,40,61,-21,41
Admira Wacke,8278,8,9,10,17,34,54,-20,37
St. Pölten,8278,9,8,9,19,44,70,-26,33
Mattersburg,8278,10,8,8,20,39,60,-21,32
FC Salzburg,8279,1,23,9,4,70,27,43,78
SC Rheindorf,8279,2,20,6,10,60,42,18,66
Vienna,8279,3,19,7,10,62,48,14,64
Rapid Vienna,8279,4,17,11,8,58,31,27,62
SK Sturm Gra,8279,5,17,9,10,61,37,24,60
RZ Pellets W,8279,6,10,8,18,39,57,-18,38
Admira Wacke,8279,7,9,8,19,37,66,-29,35
St. Pölten,8279,8,7,11,18,47,69,-22,32
SV Josko Rie,8279,9,8,8,20,30,58,-28,32
Mattersburg,8279,10,6,11,19,34,63,-29,29
FC Salzburg,8280,1,21,6,9,65,37,28,69
Rapid Vienna,8280,2,18,10,8,69,32,37,64
SC Rheindorf,8280,3,18,9,9,55,43,12,63
Vienna,8280,4,19,6,11,62,52,10,63
SK Sturm Gra,8280,5,18,8,10,57,39,18,62
RZ Pellets W,8280,6,12,8,16,45,61,-16,44
Admira Wacke,8280,7,10,7,19,36,59,-23,37
Mattersburg,8280,8,9,7,20,40,60,-20,34
SV Josko Rie,8280,9,8,9,19,34,56,-22,33
St. Pölten,8280,10,6,12,18,42,66,-24,30
SC Rheindorf,8281,1,22,7,7,55,34,21,73
SK Sturm Gra,8281,2,20,5,11,63,32,31,65
FC Salzburg,8281,3,19,6,11,68,46,22,63
Rapid Vienna,8281,4,17,11,8,58,34,24,62
Vienna,8281,5,19,4,13,64,51,13,61
RZ Pellets W,8281,6,12,7,17,48,59,-11,43
SV Josko Rie,8281,7,12,6,18,35,46,-11,42
St. Pölten,8281,8,9,10,17,34,60,-26,37
Admira Wacke,8281,9,9,4,23,31,70,-39,31
Mattersburg,8281,10,7,8,21,33,57,-24,29
FC Salzburg,8282,1,21,7,8,64,30,34,70
SC Rheindorf,8282,2,21,6,9,58,35,23,69
SK Sturm Gra,8282,3,19,10,7,62,35,27,67
Vienna,8282,4,20,4,12,59,51,8,64
Rapid Vienna,8282,5,13,11,12,53,36,17,50
RZ Pellets W,8282,6,12,6,18,46,61,-15,42
SV Josko Rie,8282,7,12,4,20,30,49,-19,40
Admira Wacke,8282,8,8,12,16,28,52,-24,36
Mattersburg,8282,9,8,10,18,33,59,-26,34
St. Pölten,8282,10,6,10,20,38,63,-25,28
SC Rheindorf,8283,1,23,7,6,61,35,26,76
FC Salzburg,8283,2,20,9,7,70,36,34,69
SK Sturm Gra,8283,3,18,7,11,61,38,23,61
Vienna,8283,4,18,3,15,56,51,5,57
Rapid Vienna,8283,5,16,8,12,54,40,14,56
RZ Pellets W,8283,6,13,7,16,42,51,-9,46
SV Josko Rie,8283,7,13,4,19,39,54,-15,43
Admira Wacke,8283,8,9,9,18,41,64,-23,36
Mattersburg,8283,9,8,9,19,36,58,-22,33
St. Pölten,8283,10,7,7,22,33,66,-33,28
FC Salzburg,8284,1,22,6,8,67,28,39,72
SK Sturm Gra,8284,2,22,6,8,65,35,30,72
SC Rheindorf,8284,3,21,8,7,57,38,19,71
Vienna,8284,4,20,5,11,63,47,16,65
Admira Wacke,8284,5,13,8,15,42,49,-7,47
RZ Pellets W,8284,6,12,7,17,38,52,-14,43
Rapid Vienna,8284,7,11,9,16,47,45,2,42
SV Josko Rie,8284,8,10,4,22,32,59,-27,34
St. Pölten,8284,9,8,9,19,41,68,-27,33
Mattersburg,8284,10,6,8,22,31,62,-31,26
FC Salzburg,8285,1,22,10,4,68,28,40,76
SC Rheindorf,8285,2,23,6,7,62,37,25,75
Vienna,8285,3,19,5,12,66,50,16,62
SK Sturm Gra,8285,4,17,5,14,50,38,12,56
Rapid Vienna,8285,5,12,11,13,49,39,10,47
RZ Pellets W,8285,6,12,10,14,42,47,-5,46
Admira Wacke,8285,7,12,6,18,39,55,-16,42
St. Pölten,8285,8,9,10,17,38,63,-25,37
Mattersburg,8285,9,8,11,17,36,56,-20,35
SV Josko Rie,8285,10,7,4,25,28,65,-37,25
FC Salzburg,8286,1,23,7,6,72,32,40,76
SC Rheindorf,8286,2,20,6,10,57,42,15,66
Vienna,8286,3,20,3,13,62,47,15,63
Rapid Vienna,8286,4,15,10,11,61,41,20,55
SK Sturm Gra,8286,5,16,7,13,57,42,15,55
Admira Wacke,8286,6,13,7,16,43,63,-20,46
RZ Pellets W,8286,7,12,9,15,50,60,-10,45
St. Pölten,8286,8,10,9,17,44,62,-18,39
Mattersburg,8286,9,8,7,21,36,62,-26,31
SV Josko Rie,8286,10,9,3,24,30,61,-31,30
FC Salzburg,8287,1,22,7,7,65,30,35,73
SK Sturm Gra,8287,2,20,4,12,57,38,19,64
SC Rheindorf,8287,3,18,9,9,56,44,12,63
Rapid Vienna,8287,4,16,7,13,63,39,24,55
St. Pölten,8287,5,13,8,15,46,59,-13,47
Vienna,8287,6,14,4,18,54,54,0,46
SV Josko Rie,8287,7,14,4,18,34,52,-18,46
RZ Pellets W,8287,8,11,8,17,45,56,-11,41
Admira Wacke,8287,9,11,5,20,33,63,-30,38
Mattersburg,8287,10,8,10,18,33,51,-18,34
FC Salzburg,8288,1,23,6,7,75,34,41,75
SK Sturm Gra,8288,2,22,4,10,67,35,32,70
SC Rheindorf,8288,3,19,7,10,59,48,11,64
Vienna,8288,4,18,6,12,62,52,10,60
Rapid Vienna,8288,5,12,10,14,57,47,10,46
RZ Pellets W,8288,6,10,9,17,44,57,-13,39
SV Josko Rie,8288,7,10,8,18,41,57,-16,38
Admira Wacke,8288,8,10,8,18,33,63,-30,38
St. Pölten,8288,9,9,10,17,42,61,-19,37
Mattersburg,8288,10,9,8,19,32,58,-26,35
FC Salzburg,8289,1,20,9,7,69,27,42,69
SC Rheindorf,8289,2,19,8,9,51,37,14,65
SK Sturm Gra,8289,3,17,10,9,57,35,22,61
Vienna,8289,4,17,5,14,56,50,6,56
Rapid Vienna,8289,5,13,12,11,46,34,12,51
SV Josko Rie,8289,6,13,8,15,43,55,-12,47
RZ Pellets W,8289,7,12,9,15,49,58,-9,45
Admira Wacke,8289,8,12,6,18,35,54,-19,42
Mattersburg,8289,9,9,6,21,34,58,-24,33
St. Pölten,8289,10,6,11,19,38,70,-32,29
SC Rheindorf,8290,1,22,7,7,68,43,25,73
Vienna,8290,2,19,8,9,66,51,15,65
FC Salzburg,8290,3,19,7,10,61,37,24,64
SK Sturm Gra,8290,4,17,5,14,58,45,13,56
RZ Pellets W,8290,5,15,6,15,45,55,-10,51
Rapid Vienna,8290,6,14,8,14,56,42,14,50
SV Josko Rie,8290,7,12,6,18,37,49,-12,42
Mattersburg,8290,8,10,10,16,43,51,-8,40
Admira Wacke,8290,9,10,5,21,38,68,-30,35
St. Pölten,8290,10,6,10,20,43,74,-31,28
FC Salzburg,8291,1,20,9,7,62,31,31,69
SK Sturm Gra,8291,2,21,6,9,66,37,29,69
SC Rheindorf,8291,3,20,8,8,54,35,19,68
Vienna,8291,4,17,8,11,62,49,13,59
RZ Pellets W,8291,5,15,7,14,49,54,-5,52
Rapid Vienna,8291,6,11,11,14,45,44,1,44
Admira Wacke,8291,7,10,8,18,36,61,-25,38
Mattersburg,8291,8,10,7,19,40,54,-14,37
St. Pölten,8291,9,8,9,19,41,66,-25,33
SV Josko Rie,8291,10,9,5,22,36,60,-24,32
SK Sturm Gra,8292,1,19,10,7,57,28,29,67
Vienna,8292,2,20,5,11,63,51,12,65
SC Rheindorf,8292,3,19,8,9,50,41,9,65
FC Salzburg,8292,4,18,10,8,64,31,33,64
Rapid Vienna,8292,5,14,9,13,54,41,13,51
SV Josko Rie,8292,6,12,5,19,42,56,-14,41
Mattersburg,8292,7,11,8,17,35,52,-17,41
RZ Pellets W,8292,8,10,9,17,36,49,-13,39
Admira Wacke,8292,9,9,9,18,34,55,-21,36
St. Pölten,8292,10,7,9,20,39,70,-31,30
FC Salzburg,8293,1,21,6,9,64,34,30,69
SC Rheindorf,8293,2,20,8,8,62,45,17,68
SK Sturm Gra,8293,3,20,5,11,53,32,21,65
Vienna,8293,4,19,4,13,64,52,12,61
Rapid Vienna,8293,5,15,9,12,58,45,13,54
RZ Pellets W,8293,6,13,8,15,52,53,-1,47
Admira Wacke,8293,7,13,7,16,37,49,-12,46
SV Josko Rie,8293,8,11,6,19,30,54,-24,39
St. Pölten,8293,9,7,10,19,41,67,-26,31
Mattersburg,8293,10,5,9,22,34,64,-30,24
FC Salzburg,8294,1,18,14,4,61,26,35,68
Vienna,8294,2,21,5,10,66,45,21,68
SC Rheindorf,8294,3,20,8,8,60,40,20,68
SK Sturm Gra,8294,4,18,5,13,49,41,8,59
Rapid Vienna,8294,5,14,12,10,63,38,25,54
RZ Pellets W,8294,6,14,7,15,42,55,-13,49
SV Josko Rie,8294,7,10,7,19,32,51,-19,37
Mattersburg,8294,8,9,8,19,42,58,-16,35
Admira Wacke,8294,9,8,8,20,30,60,-30,32
St. Pölten,8294,10,7,8,21,32,63,-31,29
FC Salzburg,8295,1,21,7,8,65,32,33,70
SC Rheindorf,8295,2,18,8,10,48,36,12,62
SK Sturm Gra,8295,3,17,9,10,53,32,21,60
Vienna,8295,4,18,5,13,58,54,4,59
Rapid Vienna,8295,5,12,9,15,56,44,12,45
St. Pölten,8295,6,11,12,13,49,58,-9,45
RZ Pellets W,8295,7,12,8,16,42,54,-12,44
SV Josko Rie,8295,8,13,4,19,33,50,-17,43
Mattersburg,8295,9,10,8,18,38,54,-16,38
Admira Wacke,8295,10,10,6,20,31,59,-28,36
SC Rheindorf,8296,1,21,8,7,65,43,22,71
Vienna,8296,2,21,4,11,74,56,18,67
SK Sturm Gra,8296,3,19,7,10,57,38,19,64
FC Salzburg,8296,4,16,10,10,55,29,26,58
Rapid Vienna,8296,5,13,10,13,48,37,11,49
Admira Wacke,8296,6,12,9,15,41,54,-13,45
RZ Pellets W,8296,7,11,8,17,42,56,-14,41
St. Pölten,8296,8,10,9,17,38,60,-22,39
SV Josko Rie,8296,9,11,4,21,35,56,-21,37
Mattersburg,8296,10,7,9,20,27,53,-26,30
SC Rheindorf,8297,1,21,9,6,57,36,21,72
FC Salzburg,8297,2,20,8,8,66,29,37,68
Vienna,8297,3,20,8,8,65,49,16,68
SK Sturm Gra,8297,4,17,7,12,60,41,19,58
Rapid Vienna,8297,5,13,8,15,50,43,7,47
RZ Pellets W,8297,6,12,9,15,39,54,-15,45
Admira Wacke,8297,7,11,6,19,37,59,-22,39
Mattersburg,8297,8,9,9,18,42,54,-12,36
SV Josko Rie,8297,9,9,7,20,31,57,-26,34
St. Pölten,8297,10,8,9,19,37,62,-25,33
FC Salzburg,8298,1,22,10,4,71,29,42,76
SC Rheindorf,8298,2,20,8,8,57,37,20,68
Vienna,8298,3,20,4,12,61,50,11,64
SK Sturm Gra,8298,4,17,6,13,51,35,16,57
Rapid Vienna,8298,5,14,13,9,54,36,18,55
RZ Pellets W,8298,6,13,5,18,48,57,-9,44
St. Pölten,8298,7,9,9,18,41,62,-21,36
SV Josko Rie,8298,8,10,6,20,30,56,-26,36
Mattersburg,8298,9,9,8,19,38,58,-20,35
Admira Wacke,8298,10,8,7,21,29,60,-31,31
FC Salzburg,8299,1,21,6,9,65,35,30,69
SC Rheindorf,8299,2,21,5,10,66,44,22,68
Vienna,8299,3,20,3,13,68,47,21,63
SK Sturm Gra,8299,4,18,5,13,58,42,16,59
RZ Pellets W,8299,5,16,6,14,55,54,1,54
Rapid Vienna,8299,6,13,11,12,56,44,12,50
Mattersburg,8299,7,10,8,18,43,65,-22,38
SV Josko Rie,8299,8,11,5,20,37,59,-22,38
Admira Wacke,8299,9,9,8,19,34,56,-22,35
St. Pölten,8299,10,8,9,19,42,78,-36,33
FC Salzburg,8300,1,23,6,7,67,29,38,75
SK Sturm Gra,8300,2,22,5,9,65,30,35,71
SC Rheindorf,8300,3,21,6,9,55,44,11,69
Vienna,8300,4,19,5,12,66,48,18,62
Rapid Vienna,8300,5,14,9,13,51,41,10,51
RZ Pellets W,8300,6,12,9,15,44,56,-12,45
Admira Wacke,8300,7,13,5,18,35,53,-18,44
SV Josko Rie,8300,8,10,6,20,38,57,-19,36
St. Pölten,8300,9,6,10,20,33,62,-29,28
Mattersburg,8300,10,7,5,24,32,66,-34,26
FC Salzburg,8301,1,23,8,5,68,26,42,77
SK Sturm Gra,8301,2,21,7,8,66,29,37,70
Vienna,8301,3,22,4,10,72,51,21,70
SC Rheindorf,8301,4,19,7,10,54,44,10,64
Rapid Vienna,8301,5,13,10,13,52,39,13,49
RZ Pellets W,8301,6,12,7,17,40,56,-16,43
SV Josko Rie,8301,7,10,7,19,33,51,-18,37
Admira Wacke,8301,8,10,6,20,33,66,-33,36
St. Pölten,8301,9,7,9,20,38,63,-25,30
Mattersburg,8301,10,7,7,22,31,62,-31,28
FC Salzburg,8302,1,20,8,8,62,29,33,68
SK Sturm Gra,8302,2,20,7,9,56,32,24,67
SC Rheindorf,8302,3,19,6,11,68,44,24,63
RZ Pellets W,8302,4,14,8,14,51,49,2,50
Vienna,8302,5,15,5,16,52,57,-5,50
Rapid Vienna,8302,6,12,13,11,55,39,16,49
Mattersburg,8302,7,13,5,18,37,53,-16,44
SV Josko Rie,8302,8,11,6,19,38,55,-17,39
Admira Wacke,8302,9,10,9,17,33,59,-26,39
St. Pölten,8302,10,8,9,19,38,73,-35,33
FC Salzburg,8303,1,22,6,8,66,28,38,72
SC Rheindorf,8303,2,21,6,9,53,43,10,69
Vienna,8303,3,21,5,10,67,46,21,68
SK Sturm Gra,8303,4,19,7,10,62,38,24,64
Rapid Vienna,8303,5,12,12,12,53,42,11,48
RZ Pellets W,8303,6,11,7,18,43,58,-15,40
Mattersburg,8303,7,10,8,18,46,62,-16,38
St. Pölten,8303,8,9,9,18,39,62,-23,36
Admira Wacke,8303,9,10,5,21,36,63,-27,35
SV Josko Rie,8303,10,9,7,20,33,56,-23,34
FC Salzburg,8304,1,21,10,5,65,30,35,73
SC Rheindorf,8304,2,21,6,9,56,45,11,69
Rapid Vienna,8304,3,18,11,7,65,34,31,65
SK Sturm Gra,8304,4,18,8,10,61,34,27,62
Vienna,8304,5,17,8,11,64,52,12,59
Admira Wacke,8304,6,11,6,19,35,60,-25,39
SV Josko Rie,8304,7,11,2,23,36,51,-15,35
St. Pölten,8304,8,9,8,19,38,62,-24,35
Mattersburg,8304,9,9,6,21,33,58,-25,33
RZ Pellets W,8304,10,8,9,19,36,63,-27,33
SK Sturm Gra,8305,1,21,7,8,63,30,33,70
FC Salzburg,8305,2,21,6,9,60,29,31,69
Vienna,8305,3,19,6,11,64,46,18,63
SC Rheindorf,8305,4,17,6,13,49,45,4,57
Rapid Vienna,8305,5,14,10,12,56,44,12,52
RZ Pellets W,8305,6,14,7,15,56,58,-2,49
SV Josko Rie,8305,7,14,5,17,35,43,-8,47
Admira Wacke,8305,8,12,4,20,35,65,-30,40
Mattersburg,8305,9,7,10,19,33,57,-24,31
St. Pölten,8305,10,6,9,21,37,71,-34,27
FC Salzburg,8306,1,20,9,7,60,29,31,69
SK Sturm Gra,8306,2,20,7,9,67,31,36,67
SC Rheindorf,8306,3,20,7,9,54,41,13,67
Rapid Vienna,8306,4,16,9,11,58,37,21,57
Vienna,8306,5,18,2,16,62,55,7,56
RZ Pellets W,8306,6,14,6,16,51,57,-6,48
Admira Wacke,8306,7,12,5,19,31,59,-28,41
SV Josko Rie,8306,8,10,9,17,37,54,-17,39
Mattersburg,8306,9,7,10,19,34,55,-21,31
St. Pölten,8306,10,7,8,21,41,77,-36,29
FC Salzburg,8307,1,21,5,10,66,35,31,68
SC Rheindorf,8307,2,17,11,8,54,45,9,62
Vienna,8307,3,17,7,12,69,56,13,58
SK Sturm Gra,8307,4,16,7,13,51,37,14,55
Rapid Vienna,8307,5,14,12,10,51,40,11,54
RZ Pellets W,8307,6,14,6,16,53,53,0,48
SV Josko Rie,8307,7,14,4,18,41,58,-17,46
Mattersburg,8307,8,11,8,17,39,50,-11,41
Admira Wacke,8307,9,9,9,18,33,55,-22,36
St. Pölten,8307,10,8,9,19,36,64,-28,33
FC Salzburg,8308,1,21,7,8,71,33,38,70
SC Rheindorf,8308,2,20,7,9,56,38,18,67
Vienna,8308,3,21,3,12,67,51,16,66
SK Sturm Gra,8308,4,17,8,11,57,39,18,59
Rapid Vienna,8308,5,14,9,13,56,45,11,51
RZ Pellets W,8308,6,13,6,17,53,56,-3,45
SV Josko Rie,8308,7,12,4,20,33,50,-17,40
Admira Wacke,8308,8,11,5,20,37,65,-28,38
St. Pölten,8308,9,10,7,19,46,73,-27,37
Mattersburg,8308,10,10,6,20,40,66,-26,36
SC Rheindorf,8309,1,22,6,8,64,41,23,72
FC Salzburg,8309,2,20,9,7,67,34,33,69
SK Sturm Gra,8309,3,19,9,8,61,32,29,66
Rapid Vienna,8309,4,15,12,9,59,36,23,57
Vienna,8309,5,14,10,12,58,54,4,52
RZ Pellets W,8309,6,13,10,13,46,47,-1,49
Admira Wacke,8309,7,11,7,18,37,58,-21,40
SV Josko Rie,8309,8,9,9,18,31,52,-21,36
Mattersburg,8309,9,6,9,21,34,69,-35,27
St. Pölten,8309,10,5,11,20,34,68,-34,26
FC Salzburg,8310,1,23,6,7,68,24,44,75
SK Sturm Gra,8310,2,21,7,8,66,35,31,70
SC Rheindorf,8310,3,20,6,10,49,40,9,66
Rapid Vienna,8310,4,17,10,9,60,38,22,61
Vienna,8310,5,17,5,14,55,53,2,56
RZ Pellets W,8310,6,11,9,16,46,54,-8,42
Mattersburg,8310,7,11,6,19,34,50,-16,39
Admira Wacke,8310,8,9,6,21,36,66,-30,33
St. Pölten,8310,9,7,11,18,39,66,-27,32
SV Josko Rie,8310,10,8,6,22,32,59,-27,30
FC Salzburg,8311,1,23,9,4,69,28,41,78
SC Rheindorf,8311,2,21,6,9,58,37,21,69
Vienna,8311,3,20,4,12,67,49,18,64
SK Sturm Gra,8311,4,18,8,10,59,37,22,62
RZ Pellets W,8311,5,12,9,15,44,50,-6,45
Admira Wacke,8311,6,10,9,17,36,64,-28,39
Mattersburg,8311,7,10,7,19,41,63,-22,37
Rapid Vienna,8311,8,7,15,14,44,44,0,36
SV Josko Rie,8311,9,10,5,21,39,60,-21,35
St. Pölten,8311,10,7,12,17,38,63,-25,33
FC Salzburg,8312,1,22,8,6,65,30,35,74
SK Sturm Gra,8312,2,20,6,10,62,37,25,66
Vienna,8312,3,18,7,11,65,54,11,61
SC Rheindorf,8312,4,17,7,12,52,50,2,58
Rapid Vienna,8312,5,14,9,13,55,41,14,51
RZ Pellets W,8312,6,13,7,16,50,55,-5,46
St. Pölten,8312,7,12,8,16,45,57,-12,44
Mattersburg,8312,8,10,7,19,33,51,-18,37
SV Josko Rie,8312,9,10,5,21,35,55,-20,35
Admira Wacke,8312,10,10,4,22,30,62,-32,34
SK Sturm Gra,8313,1,22,4,10,64,33,31,70
SC Rheindorf,8313,2,19,10,7,52,37,15,67
FC Salzburg,8313,3,19,9,8,67,33,34,66
Vienna,8313,4,20,3,13,63,54,9,63
Rapid Vienna,8313,5,16,11,9,60,38,22,59
RZ Pellets W,8313,6,11,8,17,47,63,-16,41
St. Pölten,8313,7,10,8,18,44,57,-13,38
Admira Wacke,8313,8,9,8,19,35,61,-26,35
SV Josko Rie,8313,9,10,4,22,32,57,-25,34
Mattersburg,8313,10,6,11,19,31,62,-31,29
FC Salzburg,8314,1,20,6,10,64,34,30,66
Vienna,8314,2,21,3,12,66,49,17,66
Rapid Vienna,8314,3,17,10,9,53,32,21,61
SK Sturm Gra,8314,4,17,7,12,56,34,22,58
SC Rheindorf,8314,5,16,10,10,50,44,6,58
RZ Pellets W,8314,6,14,5,17,46,55,-9,47
St. Pölten,8314,7,10,12,14,42,59,-17,42
Admira Wacke,8314,8,11,7,18,41,62,-21,40
SV Josko Rie,8314,9,11,7,18,34,57,-23,40
Mattersburg,8314,10,5,9,22,29,55,-26,24
FC Salzburg,8315,1,23,7,6,69,27,42,76
SC Rheindorf,8315,2,19,8,9,58,51,7,65
SK Sturm Gra,8315,3,19,6,11,58,38,20,63
Vienna,8315,4,19,5,12,66,53,13,62
RZ Pellets W,8315,5,15,6,15,45,49,-4,51
Rapid Vienna,8315,6,12,10,14,54,40,14,46
SV Josko Rie,8315,7,13,3,20,31,55,-24,42
St. Pölten,8315,8,8,10,18,46,63,-17,34
Admira Wacke,8315,9,9,7,20,33,61,-28,34
Mattersburg,8315,10,8,8,20,35,58,-23,32
SC Rheindorf,8316,1,20,8,8,63,41,22,68
FC Salzburg,8316,2,19,7,10,69,36,33,64
SK Sturm Gra,8316,3,19,7,10,58,35,23,64
Vienna,8316,4,19,5,12,62,52,10,62
Rapid Vienna,8316,5,16,10,10,60,40,20,58
RZ Pellets W,8316,6,12,8,16,45,60,-15,44
SV Josko Rie,8316,7,13,3,20,39,51,-12,42
Mattersburg,8316,8,10,6,20,35,56,-21,36
Admira Wacke,8316,9,10,6,20,35,63,-28,36
St. Pölten,8316,10,8,8,20,40,72,-32,32
FC Salzburg,8317,1,22,6,8,71,31,40,72
SC Rheindorf,8317,2,22,6,8,51,35,16,72
Vienna,8317,3,18,5,13,60,52,8,59
SK Sturm Gra,8317,4,18,4,14,59,39,20,58
Rapid Vienna,8317,5,11,12,13,47,44,3,45
RZ Pellets W,8317,6,12,9,15,45,57,-12,45
SV Josko Rie,8317,7,13,4,19,40,49,-9,43
Admira Wacke,8317,8,10,8,18,39,61,-22,38
St. Pölten,8317,9,9,10,17,40,65,-25,37
Mattersburg,8317,10,9,8,19,38,57,-19,35
SC Rheindorf,8318,1,19,10,7,54,40,14,67
SK Sturm Gra,8318,2,20,6,10,60,35,25,66
FC Salzburg,8318,3,19,6,11,61,30,31,63
Vienna,8318,4,18,9,9,71,49,22,63
Rapid Vienna,8318,5,11,12,13,46,42,4,45
RZ Pellets W,8318,6,11,10,15,42,50,-8,43
St. Pölten,8318,7,11,10,15,43,60,-17,43
Admira Wacke,8318,8,11,7,18,34,61,-27,40
Mattersburg,8318,9,8,10,18,37,58,-21,34
SV Josko Rie,8318,10,8,8,20,30,53,-23,32
FC Salzburg,8319,1,21,9,6,68,32,36,72
SC Rheindorf,8319,2,20,6,10,52,39,13,66
Vienna,8319,3,16,9,11,58,46,12,57
RZ Pellets W,8319,4,16,6,14,57,54,3,54
Rapid Vienna,8319,5,14,10,12,52,41,11,52
SK Sturm Gra,8319,6,15,7,14,52,43,9,52
Admira Wacke,8319,7,12,8,16,36,50,-14,44
Mattersburg,8319,8,9,9,18,38,58,-20,36
St. Pölten,8319,9,9,8,19,45,61,-16,35
SV Josko Rie,8319,10,9,6,21,28,62,-34,33
SC Rheindorf,8320,1,21,10,5,65,40,25,73
FC Salzburg,8320,2,20,9,7,65,30,35,69
SK Sturm Gra,8320,3,20,6,10,66,38,28,66
Vienna,8320,4,19,5,12,70,61,9,62
Rapid Vienna,8320,5,13,12,11,52,36,16,51
Admira Wacke,8320,6,12,8,16,40,60,-20,44
SV Josko Rie,8320,7,13,3,20,39,53,-14,42
RZ Pellets W,8320,8,9,9,18,41,65,-24,36
Mattersburg,8320,9,7,9,20,33,59,-26,30
St. Pölten,8320,10,6,9,21,41,70,-29,27
SC Rheindorf,8321,1,21,8,7,52,37,15,71
FC Salzburg,8321,2,21,6,9,72,29,43,69
Vienna,8321,3,19,6,11,63,50,13,63
SK Sturm Gra,8321,4,18,6,12,55,36,19,60
Rapid Vienna,8321,5,14,10,12,51,36,15,52
Admira Wacke,8321,6,14,5,17,30,50,-20,47
RZ Pellets W,8321,7,11,6,19,41,60,-19,39
SV Josko Rie,8321,8,10,6,20,34,61,-27,36
St. Pölten,8321,9,8,11,17,43,59,-16,35
Mattersburg,8321,10,7,10,19,33,56,-23,31
FC Salzburg,8322,1,21,6,9,66,33,33,69
SK Sturm Gra,8322,2,20,6,10,57,32,25,66
SC Rheindorf,8322,3,17,10,9,55,43,12,61
Rapid Vienna,8322,4,15,12,9,63,39,24,57
Vienna,8322,5,16,6,14,52,52,0,54
RZ Pellets W,8322,6,15,6,15,47,55,-8,51
SV Josko Rie,8322,7,14,5,17,36,47,-11,47
Mattersburg,8322,8,11,7,18,38,53,-15,40
Admira Wacke,8322,9,9,7,20,34,61,-27,34
St. Pölten,8322,10,5,9,22,27,60,-33,24
FC Salzburg,8323,1,22,9,5,63,28,35,75
SC Rheindorf,8323,2,22,6,8,60,41,19,72
SK Sturm Gra,8323,3,21,5,10,66,34,32,68
Vienna,8323,4,19,4,13,60,44,16,61
Rapid Vienna,8323,5,15,12,9,53,35,18,57
RZ Pellets W,8323,6,11,8,17,41,54,-13,41
SV Josko Rie,8323,7,11,5,20,33,50,-17,38
Admira Wacke,8323,8,9,9,18,34,62,-28,36
Mattersburg,8323,9,7,8,21,29,56,-27,29
St. Pölten,8323,10,5,10,21,33,68,-35,25
SK Sturm Gra,8324,1,22,7,7,65,29,36,73
SC Rheindorf,8324,2,21,6,9,55,40,15,69
FC Salzburg,8324,3,20,7,9,64,33,31,67
Vienna,8324,4,19,5,12,65,51,14,62
Rapid Vienna,8324,5,12,12,12,56,44,12,48
RZ Pellets W,8324,6,13,5,18,50,63,-13,44
Admira Wacke,8324,7,11,6,19,39,62,-23,39
St. Pölten,8324,8,7,13,16,41,59,-18,34
SV Josko Rie,8324,9,8,9,19,33,56,-23,33
Mattersburg,8324,10,7,10,19,37,68,-31,31
SK Sturm Gra,8325,1,21,5,10,57,31,26,68
FC Salzburg,8325,2,20,7,9,67,34,33,67
SC Rheindorf,8325,3,20,7,9,51,35,16,67
Vienna,8325,4,19,7,10,56,45,11,64
Rapid Vienna,8325,5,17,10,9,66,42,24,61
RZ Pellets W,8325,6,10,8,18,42,59,-17,38
Admira Wacke,8325,7,10,7,19,35,62,-27,37
Mattersburg,8325,8,9,9,18,37,53,-16,36
St. Pölten,8325,9,8,9,19,39,65,-26,33
SV Josko Rie,8325,10,9,5,22,33,57,-24,32
Vienna,8326,1,21,7,8,76,50,26,70
SC Rheindorf,8326,2,18,12,6,59,40,19,66
FC Salzburg,8326,3,18,9,9,56,31,25,63
SK Sturm Gra,8326,4,18,8,10,66,37,29,62
Rapid Vienna,8326,5,13,12,11,55,42,13,51
SV Josko Rie,8326,6,12,11,13,44,49,-5,47
Admira Wacke,8326,7,10,8,18,40,63,-23,38
RZ Pellets W,8326,8,9,7,20,43,67,-24,34
St. Pölten,8326,9,8,9,19,41,73,-32,33
Mattersburg,8326,10,6,11,19,33,61,-28,29
SC Rheindorf,8327,1,19,10,7,57,41,16,67
FC Salzburg,8327,2,18,9,9,58,33,25,63
Vienna,8327,3,19,4,13,68,59,9,61
SK Sturm Gra,8327,4,17,9,10,64,39,25,60
Rapid Vienna,8327,5,16,9,11,62,45,17,57
RZ Pellets W,8327,6,12,6,18,49,58,-9,42
St. Pölten,8327,7,11,7,18,46,66,-20,40
Admira Wacke,8327,8,11,7,18,41,64,-23,40
Mattersburg,8327,9,9,10,17,41,52,-11,37
SV Josko Rie,8327,10,10,5,21,30,59,-29,35
FC Salzburg,8328,1,20,9,7,64,30,34,69
Vienna,8328,2,20,4,12,68,46,22,64
SC Rheindorf,8328,3,19,6,11,50,42,8,63
SK Sturm Gra,8328,4,19,5,12,66,41,25,62
Rapid Vienna,8328,5,16,12,8,51,30,21,60
RZ Pellets W,8328,6,13,8,15,41,51,-10,47
Admira Wacke,8328,7,11,6,19,39,65,-26,39
SV Josko Rie,8328,8,9,8,19,28,50,-22,35
St. Pölten,8328,9,9,8,19,40,65,-25,35
Mattersburg,8328,10,6,10,20,30,57,-27,28
SC Rheindorf,8329,1,23,7,6,62,39,23,76
FC Salzburg,8329,2,20,5,11,64,38,26,65
Rapid Vienna,8329,3,15,11,10,61,42,19,56
SK Sturm Gra,8329,4,16,8,12,57,42,15,56
Vienna,8329,5,18,2,16,61,49,12,56
RZ Pellets W,8329,6,14,9,13,46,51,-5,51
Mattersburg,8329,7,11,5,20,40,56,-16,38
Admira Wacke,8329,8,11,5,20,38,68,-30,38
SV Josko Rie,8329,9,11,4,21,31,55,-24,37
St. Pölten,8329,10,7,12,17,45,65,-20,33
FC Salzburg,8330,1,23,5,8,68,29,39,74
SC Rheindorf,8330,2,20,8,8,52,40,12,68
SK Sturm Gra,8330,3,19,6,11,60,36,24,63
Vienna,8330,4,18,5,13,63,52,11,59
Rapid Vienna,8330,5,14,9,13,51,37,14,51
RZ Pellets W,8330,6,12,7,17,38,51,-13,43
Admira Wacke,8330,7,12,7,17,32,51,-19,43
SV Josko Rie,8330,8,11,7,18,39,60,-21,40
St. Pölten,8330,9,8,9,19,45,69,-24,33
Mattersburg,8330,10,7,9,20,39,62,-23,30
SC Rheindorf,8331,1,22,6,8,64,34,30,72
FC Salzburg,8331,2,21,7,8,68,27,41,70
SK Sturm Gra,8331,3,20,6,10,63,38,25,66
Admira Wacke,8331,4,15,9,12,46,51,-5,54
Vienna,8331,5,15,4,17,55,69,-14,49
Rapid Vienna,8331,6,11,14,11,48,39,9,47
RZ Pellets W,8331,7,12,8,16,44,57,-13,44
SV Josko Rie,8331,8,10,8,18,31,56,-25,38
St. Pölten,8331,9,7,12,17,47,64,-17,33
Mattersburg,8331,10,6,8,22,35,66,-31,26
FC Salzburg,8332,1,22,6,8,73,35,38,72
SK Sturm Gra,8332,2,21,6,9,57,32,25,69
SC Rheindorf,8332,3,19,8,9,56,45,11,65
Vienna,8332,4,18,6,12,63,52,11,60
Rapid Vienna,8332,5,14,10,12,52,43,9,52
Admira Wacke,8332,6,13,6,17,38,55,-17,45
RZ Pellets W,8332,7,12,5,19,48,59,-11,41
St. Pölten,8332,8,11,8,17,45,62,-17,41
Mattersburg,8332,9,9,7,20,36,56,-20,34
SV Josko Rie,8332,10,8,4,24,34,63,-29,28
FC Salzburg,8333,1,23,5,8,64,30,34,74
Vienna,8333,2,21,4,11,63,47,16,67
SK Sturm Gra,8333,3,19,9,8,66,37,29,66
SC Rheindorf,8333,4,18,8,10,52,47,5,62
Rapid Vienna,8333,5,13,11,12,60,44,16,50
RZ Pellets W,8333,6,14,7,15,45,55,-10,49
Admira Wacke,8333,7,11,7,18,37,56,-19,40
Mattersburg,8333,8,9,7,20,39,55,-16,34
St. Pölten,8333,9,7,11,18,38,63,-25,32
SV Josko Rie,8333,10,8,5,23,27,57,-30,29
FC Salzburg,8334,1,21,6,9,63,33,30,69
SC Rheindorf,8334,2,21,6,9,55,44,11,69
SK Sturm Gra,8334,3,19,4,13,56,34,22,61
Vienna,8334,4,15,8,13,48,44,4,53
Rapid Vienna,8334,5,13,10,13,56,44,12,49
Admira Wacke,8334,6,15,4,17,38,52,-14,49
RZ Pellets W,8334,7,14,4,18,48,63,-15,46
Mattersburg,8334,8,10,8,18,40,53,-13,38
St. Pölten,8334,9,9,11,16,43,58,-15,38
SV Josko Rie,8334,10,10,5,21,33,55,-22,35
FC Salzburg,8335,1,21,8,7,67,29,38,71
SC Rheindorf,8335,2,19,10,7,61,40,21,67
Vienna,8335,3,20,6,10,65,51,14,66
SK Sturm Gra,8335,4,19,6,11,60,35,25,63
Rapid Vienna,8335,5,13,12,11,56,43,13,51
RZ Pellets W,8335,6,12,8,16,47,58,-11,44
SV Josko Rie,8335,7,11,6,19,40,57,-17,39
Admira Wacke,8335,8,10,8,18,34,65,-31,38
Mattersburg,8335,9,8,8,20,44,60,-16,32
St. Pölten,8335,10,7,8,21,37,73,-36,29
FC Salzburg,8336,1,22,8,6,67,29,38,74
SC Rheindorf,8336,2,20,10,6,55,37,18,70
Vienna,8336,3,20,5,11,72,47,25,65
Rapid Vienna,8336,4,13,11,12,50,42,8,50
SK Sturm Gra,8336,5,14,8,14,45,37,8,50
RZ Pellets W,8336,6,13,8,15,53,63,-10,47
Admira Wacke,8336,7,10,10,16,35,59,-24,40
St. Pölten,8336,8,8,12,16,42,57,-15,36
SV Josko Rie,8336,9,9,8,19,34,57,-23,35
Mattersburg,8336,10,7,8,21,29,54,-25,29
FC Salzburg,8337,1,20,9,7,69,33,36,69
SC Rheindorf,8337,2,19,8,9,49,41,8,65
SK Sturm Gra,8337,3,19,6,11,56,33,23,63
Vienna,8337,4,19,4,13,57,51,6,61
Rapid Vienna,8337,5,14,8,14,60,50,10,50
SV Josko Rie,8337,6,13,7,16,39,49,-10,46
RZ Pellets W,8337,7,13,6,17,48,55,-7,45
Admira Wacke,8337,8,10,7,19,37,61,-24,37
Mattersburg,8337,9,9,7,20,42,60,-18,34
St. Pölten,8337,10,8,10,18,40,64,-24,34
FC Salzburg,8338,1,23,4,9,72,31,41,73
SC Rheindorf,8338,2,21,7,8,60,39,21,70
Vienna,8338,3,20,5,11,65,49,16,65
SK Sturm Gra,8338,4,17,7,12,62,45,17,58
Rapid Vienna,8338,5,13,9,14,55,43,12,48
RZ Pellets W,8338,6,14,6,16,51,61,-10,48
Mattersburg,8338,7,12,7,17,42,52,-10,43
St. Pölten,8338,8,10,8,18,39,63,-24,38
Admira Wacke,8338,9,10,5,21,36,68,-32,35
SV Josko Rie,8338,10,9,4,23,31,62,-31,31
FC Salzburg,8339,1,18,8,10,62,35,27,62
Vienna,8339,2,18,8,10,69,55,14,62
SK Sturm Gra,8339,3,17,10,9,59,38,21,61
SC Rheindorf,8339,4,17,8,11,50,49,1,59
Rapid Vienna,8339,5,14,9,13,57,40,17,51
Admira Wacke,8339,6,13,7,16,40,55,-15,46
Mattersburg,8339,7,10,10,16,43,56,-13,40
RZ Pellets W,8339,8,11,7,18,38,54,-16,40
St. Pölten,8339,9,9,12,15,42,59,-17,39
SV Josko Rie,8339,10,10,7,19,33,52,-19,37
SK Sturm Gra,8340,1,19,9,8,59,34,25,66
FC Salzburg,8340,2,19,8,9,60,29,31,65
SC Rheindorf,8340,3,17,11,8,49,37,12,62
Vienna,8340,4,16,9,11,59,45,14,57
Rapid Vienna,8340,5,14,11,11,57,46,11,53
RZ Pellets W,8340,6,13,8,15,44,51,-7,47
Admira Wacke,8340,7,12,5,19,41,60,-19,41
SV Josko Rie,8340,8,12,5,19,37,59,-22,41
St. Pölten,8340,9,8,12,16,41,58,-17,36
Mattersburg,8340,10,6,10,20,30,58,-28,28
SC Rheindorf,8341,1,22,7,7,61,39,22,73
FC Salzburg,8341,2,21,5,10,64,34,30,68
Vienna,8341,3,20,3,13,72,56,16,63
SK Sturm Gra,8341,4,17,7,12,48,35,13,58
Rapid Vienna,8341,5,12,11,13,57,44,13,47
RZ Pellets W,8341,6,13,7,16,48,57,-9,46
Admira Wacke,8341,7,13,7,16,46,58,-12,46
SV Josko Rie,8341,8,11,7,18,30,47,-17,40
St. Pölten,8341,9,7,13,16,41,68,-27,34
Mattersburg,8341,10,6,9,21,33,62,-29,27
SC Rheindorf,8342,1,21,8,7,63,37,26,71
FC Salzburg,8342,2,20,7,9,63,38,25,67
SK Sturm Gra,8342,3,19,6,11,57,36,21,63
Rapid Vienna,8342,4,14,13,9,53,33,20,55
Vienna,8342,5,16,3,17,59,60,-1,51
Admira Wacke,8342,6,12,7,17,35,56,-21,43
Mattersburg,8342,7,10,11,15,43,52,-9,41
RZ Pellets W,8342,8,11,7,18,40,58,-18,40
St. Pölten,8342,9,10,7,19,42,65,-23,37
SV Josko Rie,8342,10,10,5,21,36,56,-20,35
FC Salzburg,8343,1,22,8,6,63,28,35,74
SK Sturm Gra,8343,2,20,7,9,60,29,31,67
SC Rheindorf,8343,3,19,9,8,55,40,15,66
Vienna,8343,4,17,6,13,57,48,9,57
Rapid Vienna,8343,5,14,10,12,54,38,16,52
RZ Pellets W,8343,6,13,9,14,43,47,-4,48
Admira Wacke,8343,7,10,8,18,36,60,-24,38
Mattersburg,8343,8,9,8,19,34,58,-24,35
St. Pölten,8343,9,9,7,20,50,75,-25,34
SV Josko Rie,8343,10,9,4,23,31,60,-29,31
SC Rheindorf,8344,1,21,8,7,70,40,30,71
FC Salzburg,8344,2,21,6,9,61,30,31,69
Vienna,8344,3,21,3,12,63,47,16,66
SK Sturm Gra,8344,4,19,7,10,59,37,22,64
Rapid Vienna,8344,5,15,12,9,58,41,17,57
Mattersburg,8344,6,9,10,17,43,62,-19,37
St. Pölten,8344,7,10,7,19,48,68,-20,37
SV Josko Rie,8344,8,11,3,22,35,62,-27,36
RZ Pellets W,8344,9,8,10,18,40,59,-19,34
Admira Wacke,8344,10,9,6,21,35,66,-31,33
SK Sturm Gra,8345,1,21,4,11,66,39,27,67
FC Salzburg,8345,2,18,11,7,68,39,29,65
Vienna,8345,3,19,6,11,63,58,5,63
SC Rheindorf,8345,4,18,8,10,56,46,10,62
Rapid Vienna,8345,5,14,11,11,58,38,20,53
Admira Wacke,8345,6,13,7,16,34,53,-19,46
RZ Pellets W,8345,7,11,8,17,45,56,-11,41
Mattersburg,8345,8,10,9,17,42,55,-13,39
SV Josko Rie,8345,9,8,9,19,31,52,-21,33
St. Pölten,8345,10,6,11,19,41,68,-27,29
FC Salzburg,8346,1,21,10,5,63,23,40,73
SK Sturm Gra,8346,2,22,6,8,58,28,30,72
Vienna,8346,3,15,8,13,63,58,5,53
Rapid Vienna,8346,4,13,13,10,58,41,17,52
SC Rheindorf,8346,5,13,10,13,46,58,-12,49
RZ Pellets W,8346,6,12,9,15,51,59,-8,45
Mattersburg,8346,7,11,8,17,49,54,-5,41
Admira Wacke,8346,8,11,7,18,38,58,-20,40
SV Josko Rie,8346,9,10,8,18,35,54,-19,38
St. Pölten,8346,10,9,7,20,41,69,-28,34
FC Salzburg,8347,1,22,4,10,73,34,39,70
Vienna,8347,2,22,4,10,69,51,18,70
SK Sturm Gra,8347,3,20,8,8,65,33,32,68
SC Rheindorf,8347,4,17,8,11,56,49,7,59
Rapid Vienna,8347,5,13,11,12,54,46,8,50
RZ Pellets W,8347,6,13,9,14,47,51,-4,48
St. Pölten,8347,7,9,11,16,42,60,-18,38
Mattersburg,8347,8,9,9,18,35,52,-17,36
Admira Wacke,8347,9,10,6,20,34,64,-30,36
SV Josko Rie,8347,10,8,4,24,32,67,-35,28
SC Rheindorf,8348,1,20,7,9,66,43,23,67
FC Salzburg,8348,2,18,8,10,58,38,20,62
Vienna,8348,3,18,6,12,63,51,12,60
SK Sturm Gra,8348,4,17,8,11,52,32,20,59
Rapid Vienna,8348,5,14,11,11,55,42,13,53
Admira Wacke,8348,6,14,7,15,40,57,-17,49
RZ Pellets W,8348,7,13,9,14,49,53,-4,48
SV Josko Rie,8348,8,11,6,19,34,55,-21,39
Mattersburg,8348,9,7,11,18,40,59,-19,32
St. Pölten,8348,10,7,9,20,37,64,-27,30
SC Rheindorf,8349,1,21,7,8,50,34,16,70
Vienna,8349,2,22,3,11,74,54,20,69
FC Salzburg,8349,3,17,9,10,58,34,24,60
Rapid Vienna,8349,4,16,10,10,57,39,18,58
SK Sturm Gra,8349,5,17,6,13,58,43,15,57
Admira Wacke,8349,6,13,5,18,42,56,-14,44
RZ Pellets W,8349,7,12,7,17,47,58,-11,43
SV Josko Rie,8349,8,9,9,18,38,62,-24,36
Mattersburg,8349,9,7,11,18,35,54,-19,32
St. Pölten,8349,10,7,11,18,36,61,-25,32
FC Salzburg,8350,1,25,5,6,70,24,46,80
SK Sturm Gra,8350,2,22,3,11,60,34,26,69
SC Rheindorf,8350,3,19,7,10,57,41,16,64
Vienna,8350,4,19,5,12,61,55,6,62
Rapid Vienna,8350,5,13,10,13,53,46,7,49
Admira Wacke,8350,6,13,4,19,39,65,-26,43
RZ Pellets W,8350,7,11,9,16,44,53,-9,42
SV Josko Rie,8350,8,11,4,21,36,52,-16,37
Mattersburg,8350,9,8,7,21,31,52,-21,31
St. Pölten,8350,10,7,10,19,33,62,-29,31
FC Salzburg,8351,1,21,8,7,67,35,32,71
SK Sturm Gra,8351,2,19,6,11,59,37,22,63
SC Rheindorf,8351,3,17,10,9,58,44,14,61
Vienna,8351,4,18,7,11,61,49,12,61
Rapid Vienna,8351,5,12,12,12,50,38,12,48
SV Josko Rie,8351,6,13,6,17,41,52,-11,45
Admira Wacke,8351,7,12,8,16,31,52,-21,44
St. Pölten,8351,8,11,7,18,44,62,-18,40
Mattersburg,8351,9,8,10,18,33,50,-17,34
RZ Pellets W,8351,10,8,8,20,41,66,-25,32
FC Salzburg,8352,1,21,9,6,66,28,38,72
SK Sturm Gra,8352,2,21,9,6,65,27,38,72
Vienna,8352,3,18,6,12,59,47,12,60
SC Rheindorf,8352,4,17,7,12,49,48,1,58
Rapid Vienna,8352,5,15,9,12,56,39,17,54
RZ Pellets W,8352,6,13,9,14,45,49,-4,48
SV Josko Rie,8352,7,12,4,20,33,54,-21,40
Admira Wacke,8352,8,11,4,21,35,61,-26,37
Mattersburg,8352,9,8,8,20,39,65,-26,32
St. Pölten,8352,10,6,11,19,38,67,-29,29
FC Salzburg,8353,1,20,7,9,60,32,28,67
SC Rheindorf,8353,2,19,7,10,53,43,10,64
SK Sturm Gra,8353,3,18,8,10,56,32,24,62
Vienna,8353,4,18,7,11,61,44,17,61
Rapid Vienna,8353,5,13,11,12,50,40,10,50
Admira Wacke,8353,6,12,9,15,42,55,-13,45
St. Pölten,8353,7,10,11,15,39,55,-16,41
RZ Pellets W,8353,8,11,7,18,42,56,-14,40
Mattersburg,8353,9,9,8,19,35,55,-20,35
SV Josko Rie,8353,10,8,9,19,28,54,-26,33
SK Sturm Gra,8354,1,22,6,8,66,36,30,72
FC Salzburg,8354,2,19,8,9,61,32,29,65
SC Rheindorf,8354,3,18,6,12,54,45,9,60
Vienna,8354,4,17,5,14,65,57,8,56
Rapid Vienna,8354,5,15,10,11,59,38,21,55
SV Josko Rie,8354,6,14,6,16,41,49,-8,48
RZ Pellets W,8354,7,10,10,16,44,56,-12,40
St. Pölten,8354,8,10,8,18,45,63,-18,38
Admira Wacke,8354,9,9,8,19,36,69,-33,35
Mattersburg,8354,10,8,9,19,33,59,-26,33
SC Rheindorf,8355,1,20,10,6,53,32,21,70
FC Salzburg,8355,2,17,12,7,59,29,30,63
Vienna,8355,3,18,6,12,58,51,7,60
SK Sturm Gra,8355,4,16,8,12,55,38,17,56
Rapid Vienna,8355,5,12,11,13,51,41,10,47
RZ Pellets W,8355,6,11,9,16,46,53,-7,42
Admira Wacke,8355,7,11,9,16,40,59,-19,42
Mattersburg,8355,8,10,10,16,40,53,-13,40
SV Josko Rie,8355,9,10,7,19,34,56,-22,37
St. Pölten,8355,10,9,10,17,39,63,-24,37
FC Salzburg,8356,1,23,6,7,66,28,38,75
SC Rheindorf,8356,2,21,7,8,62,39,23,70
Vienna,8356,3,21,3,12,71,51,20,66
SK Sturm Gra,8356,4,17,5,14,65,45,20,56
Rapid Vienna,8356,5,15,9,12,54,45,9,54
Admira Wacke,8356,6,15,4,17,41,56,-15,49
SV Josko Rie,8356,7,13,4,19,42,53,-11,43
RZ Pellets W,8356,8,12,6,18,42,56,-14,42
St. Pölten,8356,9,7,7,22,35,80,-45,28
Mattersburg,8356,10,6,9,21,37,62,-25,27
SK Sturm Gra,8357,1,20,7,9,60,33,27,67
FC Salzburg,8357,2,19,9,8,62,30,32,66
SC Rheindorf,8357,3,19,8,9,62,42,20,65
Vienna,8357,4,19,7,10,65,53,12,64
Rapid Vienna,8357,5,15,10,11,54,37,17,55
Mattersburg,8357,6,9,11,16,43,58,-15,38
Admira Wacke,8357,7,10,8,18,36,63,-27,38
RZ Pellets W,8357,8,9,10,17,40,59,-19,37
SV Josko Rie,8357,9,9,6,21,35,55,-20,33
St. Pölten,8357,10,7,12,17,44,71,-27,33
FC Salzburg,8358,1,25,7,4,78,30,48,82
Vienna,8358,2,18,6,12,64,55,9,60
SC Rheindorf,8358,3,16,10,10,53,44,9,58
Rapid Vienna,8358,4,15,12,9,59,41,18,57
SK Sturm Gra,8358,5,17,5,14,58,40,18,56
RZ Pellets W,8358,6,12,8,16,53,62,-9,44
Admira Wacke,8358,7,13,4,19,42,65,-23,43
Mattersburg,8358,8,11,8,17,39,53,-14,41
SV Josko Rie,8358,9,11,4,21,41,62,-21,37
St. Pölten,8358,10,5,10,21,38,73,-35,25
FC Salzburg,8359,1,22,6,8,62,28,34,72
SK Sturm Gra,8359,2,21,4,11,55,32,23,67
Vienna,8359,3,19,5,12,59,46,13,62
SC Rheindorf,8359,4,17,6,13,51,43,8,57
RZ Pellets W,8359,5,16,7,13,61,53,8,55
Rapid Vienna,8359,6,15,9,12,53,37,16,54
Admira Wacke,8359,7,12,6,18,33,56,-23,42
SV Josko Rie,8359,8,10,6,20,30,52,-22,36
St. Pölten,8359,9,8,8,20,33,63,-30,32
Mattersburg,8359,10,8,7,21,34,61,-27,31
FC Salzburg,8360,1,22,6,8,68,34,34,72
SC Rheindorf,8360,2,20,7,9,54,37,17,67
Vienna,8360,3,19,3,14,64,53,11,60
SK Sturm Gra,8360,4,15,11,10,47,35,12,56
Rapid Vienna,8360,5,14,13,9,70,46,24,55
RZ Pellets W,8360,6,11,11,14,47,55,-8,44
St. Pölten,8360,7,9,12,15,46,59,-13,39
Admira Wacke,8360,8,10,7,19,37,65,-28,37
Mattersburg,8360,9,9,7,20,43,64,-21,34
SV Josko Rie,8360,10,9,7,20,30,58,-28,34
SC Rheindorf,8361,1,22,7,7,64,40,24,73
FC Salzburg,8361,2,21,8,7,69,31,38,71
SK Sturm Gra,8361,3,20,8,8,60,32,28,68
Vienna,8361,4,19,5,12,55,52,3,62
Rapid Vienna,8361,5,13,12,11,54,40,14,51
RZ Pellets W,8361,6,12,6,18,44,57,-13,42
Admira Wacke,8361,7,11,7,18,36,54,-18,40
SV Josko Rie,8361,8,11,6,19,36,51,-15,39
St. Pölten,8361,9,7,11,18,37,66,-29,32
Mattersburg,8361,10,5,8,23,38,70,-32,23
SC Rheindorf,8362,1,21,11,4,59,34,25,74
FC Salzburg,8362,2,21,8,7,69,41,28,71
Vienna,8362,3,19,6,11,60,49,11,63
SK Sturm Gra,8362,4,17,6,13,59,41,18,57
Rapid Vienna,8362,5,13,12,11,58,40,18,51
SV Josko Rie,8362,6,12,6,18,43,55,-12,42
RZ Pellets W,8362,7,10,10,16,39,51,-12,40
Mattersburg,8362,8,10,6,20,35,56,-21,36
St. Pölten,8362,9,7,12,17,35,57,-22,33
Admira Wacke,8362,10,9,5,22,33,66,-33,32
SC Rheindorf,8363,1,23,6,7,57,40,17,75
FC Salzburg,8363,2,20,8,8,73,40,33,68
Vienna,8363,3,16,6,14,57,53,4,54
Rapid Vienna,8363,4,15,8,13,58,45,13,53
RZ Pellets W,8363,5,16,4,16,51,50,1,52
SK Sturm Gra,8363,6,15,6,15,51,46,5,51
SV Josko Rie,8363,7,15,3,18,41,50,-9,48
Admira Wacke,8363,8,12,3,21,38,60,-22,39
St. Pölten,8363,9,10,8,18,46,66,-20,38
Mattersburg,8363,10,8,8,20,40,62,-22,32
SK Sturm Gra,8364,1,20,8,8,64,36,28,68
FC Salzburg,8364,2,20,6,10,62,36,26,66
SC Rheindorf,8364,3,18,10,8,56,42,14,64
Vienna,8364,4,18,5,13,70,53,17,59
Rapid Vienna,8364,5,15,11,10,56,41,15,56
Admira Wacke,8364,6,14,3,19,44,67,-23,45
RZ Pellets W,8364,7,11,10,15,51,55,-4,43
St. Pölten,8364,8,11,8,17,45,62,-17,41
Mattersburg,8364,9,8,9,19,31,57,-26,33
SV Josko Rie,8364,10,8,4,24,32,62,-30,28
SK Sturm Gra,8365,1,22,4,10,56,31,25,70
FC Salzburg,8365,2,18,11,7,65,31,34,65
Rapid Vienna,8365,3,16,11,9,64,41,23,59
SC Rheindorf,8365,4,17,8,11,50,42,8,59
Vienna,8365,5,16,5,15,54,58,-4,53
RZ Pellets W,8365,6,15,4,17,52,52,0,49
Admira Wacke,8365,7,13,4,19,45,66,-21,43
SV Josko Rie,8365,8,12,5,19,26,49,-23,41
St. Pölten,8365,9,9,9,18,44,67,-23,36
Mattersburg,8365,10,7,9,20,36,55,-19,30
FC Salzburg,8366,1,20,8,8,63,31,32,68
Vienna,8366,2,18,6,12,61,52,9,60
SK Sturm Gra,8366,3,17,7,12,51,34,17,58
SC Rheindorf,8366,4,17,7,12,50,46,4,58
Rapid Vienna,8366,5,14,10,12,55,41,14,52
SV Josko Rie,8366,6,15,3,18,40,51,-11,48
RZ Pellets W,8366,7,12,8,16,45,57,-12,44
Mattersburg,8366,8,12,6,18,40,48,-8,42
Admira Wacke,8366,9,12,6,18,48,65,-17,42
St. Pölten,8366,10,7,11,18,37,65,-28,32
SC Rheindorf,8367,1,20,6,10,55,40,15,66
FC Salzburg,8367,2,19,8,9,64,38,26,65
SK Sturm Gra,8367,3,17,7,12,54,38,16,58
Vienna,8367,4,16,6,14,65,56,9,54
Rapid Vienna,8367,5,13,14,9,56,42,14,53
SV Josko Rie,8367,6,13,7,16,40,53,-13,46
Admira Wacke,8367,7,13,7,16,40,54,-14,46
RZ Pellets W,8367,8,12,8,16,41,54,-13,44
St. Pölten,8367,9,9,10,17,44,60,-16,37
Mattersburg,8367,10,7,9,20,32,56,-24,30
SC Rheindorf,8368,1,19,10,7,57,39,18,67
FC Salzburg,8368,2,18,9,9,65,36,29,63
SK Sturm Gra,8368,3,18,7,11,58,41,17,61
Rapid Vienna,8368,4,16,12,8,64,37,27,60
Vienna,8368,5,17,8,11,55,47,8,59
RZ Pellets W,8368,6,11,11,14,49,59,-10,44
Admira Wacke,8368,7,12,8,16,45,64,-19,44
SV Josko Rie,8368,8,11,7,18,38,50,-12,40
St. Pölten,8368,9,7,9,20,34,62,-28,30
Mattersburg,8368,10,7,7,22,34,64,-30,28
SC Rheindorf,8369,1,21,10,5,68,40,28,73
FC Salzburg,8369,2,19,7,10,59,33,26,64
Vienna,8369,3,20,4,12,70,53,17,64
SK Sturm Gra,8369,4,19,6,11,57,36,21,63
Rapid Vienna,8369,5,12,12,12,60,44,16,48
St. Pölten,8369,6,11,10,15,45,64,-19,43
RZ Pellets W,8369,7,11,8,17,43,57,-14,41
Admira Wacke,8369,8,11,7,18,34,57,-23,40
SV Josko Rie,8369,9,10,6,20,33,54,-21,36
Mattersburg,8369,10,7,8,21,35,66,-31,29
FC Salzburg,8370,1,20,8,8,67,30,37,68
SK Sturm Gra,8370,2,19,7,10,57,32,25,64
Vienna,8370,3,18,7,11,58,46,12,61
SC Rheindorf,8370,4,17,8,11,52,42,10,59
Rapid Vienna,8370,5,13,13,10,53,42,11,52
RZ Pellets W,8370,6,12,11,13,46,53,-7,47
St. Pölten,8370,7,11,9,16,43,60,-17,42
SV Josko Rie,8370,8,11,5,20,38,59,-21,38
Mattersburg,8370,9,8,9,19,35,55,-20,33
Admira Wacke,8370,10,8,9,19,27,57,-30,33
FC Salzburg,8371,1,21,6,9,67,35,32,69
Vienna,8371,2,20,5,11,66,55,11,65
SC Rheindorf,8371,3,16,13,7,50,42,8,61
SK Sturm Gra,8371,4,17,7,12,56,35,21,58
Rapid Vienna,8371,5,13,13,10,50,35,15,52
RZ Pellets W,8371,6,14,6,16,52,58,-6,48
Mattersburg,8371,7,11,8,17,43,58,-15,41
Admira Wacke,8371,8,10,8,18,33,52,-19,38
SV Josko Rie,8371,9,10,7,19,31,49,-18,37
St. Pölten,8371,10,7,9,20,39,68,-29,30
FC Salzburg,8372,1,21,8,7,62,32,30,71
SK Sturm Gra,8372,2,20,5,11,62,37,25,65
Vienna,8372,3,17,6,13,67,57,10,57
SC Rheindorf,8372,4,17,6,13,51,45,6,57
Rapid Vienna,8372,5,14,10,12,59,45,14,52
RZ Pellets W,8372,6,13,7,16,45,57,-12,46
Admira Wacke,8372,7,13,7,16,42,60,-18,46
SV Josko Rie,8372,8,13,4,19,41,56,-15,43
Mattersburg,8372,9,10,8,18,42,57,-15,38
St. Pölten,8372,10,8,7,21,44,69,-25,31
Vienna,8373,1,23,4,9,68,45,23,73
FC Salzburg,8373,2,21,6,9,62,29,33,69
SK Sturm Gra,8373,3,21,5,10,60,32,28,68
SC Rheindorf,8373,4,17,8,11,46,41,5,59
Rapid Vienna,8373,5,15,9,12,57,39,18,54
RZ Pellets W,8373,6,13,8,15,48,59,-11,47
Admira Wacke,8373,7,11,7,18,39,57,-18,40
SV Josko Rie,8373,8,8,8,20,27,48,-21,32
Mattersburg,8373,9,7,10,19,32,60,-28,31
St. Pölten,8373,10,6,11,19,36,65,-29,29
Vienna,8374,1,21,6,9,69,51,18,69
SC Rheindorf,8374,2,20,5,11,60,47,13,65
SK Sturm Gra,8374,3,19,5,12,56,36,20,62
FC Salzburg,8374,4,18,7,11,70,46,24,61
Rapid Vienna,8374,5,14,10,12,56,46,10,52
Admira Wacke,8374,6,13,6,17,35,55,-20,45
RZ Pellets W,8374,7,12,6,18,47,59,-12,42
St. Pölten,8374,8,11,8,17,47,59,-12,41
SV Josko Rie,8374,9,10,6,20,35,56,-21,36
Mattersburg,8374,10,9,7,20,41,61,-20,34
SK Sturm Gra,8375,1,23,4,9,65,29,36,73
SC Rheindorf,8375,2,20,9,7,61,42,19,69
FC Salzburg,8375,3,18,8,10,66,40,26,62
Vienna,8375,4,17,5,14,57,56,1,56
Rapid Vienna,8375,5,12,12,12,54,40,14,48
RZ Pellets W,8375,6,13,7,16,40,51,-11,46
Admira Wacke,8375,7,13,6,17,45,59,-14,45
Mattersburg,8375,8,10,8,18,42,61,-19,38
SV Josko Rie,8375,9,11,5,20,35,57,-22,38
St. Pölten,8375,10,7,8,21,38,68,-30,29
SK Sturm Gra,8376,1,21,8,7,59,32,27,71
FC Salzburg,8376,2,20,10,6,62,30,32,70
Vienna,8376,3,20,3,13,70,53,17,63
SC Rheindorf,8376,4,18,8,10,52,42,10,62
RZ Pellets W,8376,5,14,6,16,49,53,-4,48
Rapid Vienna,8376,6,12,11,13,50,42,8,47
SV Josko Rie,8376,7,11,9,16,39,51,-12,42
Admira Wacke,8376,8,11,6,19,38,65,-27,39
Mattersburg,8376,9,9,10,17,38,52,-14,37
St. Pölten,8376,10,4,9,23,31,68,-37,21
SK Sturm Gra,8377,1,21,7,8,58,30,28,70
Vienna,8377,2,20,4,12,67,52,15,64
FC Salzburg,8377,3,17,8,11,57,41,16,59
SC Rheindorf,8377,4,16,9,11,53,42,11,57
Rapid Vienna,8377,5,15,10,11,53,39,14,55
RZ Pellets W,8377,6,13,7,16,49,51,-2,46
Admira Wacke,8377,7,14,4,18,39,55,-16,46
SV Josko Rie,8377,8,10,8,18,31,49,-18,38
Mattersburg,8377,9,9,8,19,35,56,-21,35
St. Pölten,8377,10,8,9,19,42,69,-27,33
FC Salzburg,8378,1,22,8,6,61,25,36,74
SK Sturm Gra,8378,2,23,5,8,68,35,33,74
Vienna,8378,3,18,4,14,61,51,10,58
SC Rheindorf,8378,4,16,9,11,53,45,8,57
Admira Wacke,8378,5,12,10,14,37,53,-16,46
Rapid Vienna,8378,6,10,14,12,49,39,10,44
Mattersburg,8378,7,10,10,16,33,51,-18,40
SV Josko Rie,8378,8,10,8,18,38,53,-15,38
St. Pölten,8378,9,8,12,16,43,63,-20,36
RZ Pellets W,8378,10,7,8,21,33,61,-28,29
FC Salzburg,8379,1,22,9,5,69,31,38,75
SC Rheindorf,8379,2,19,10,7,52,35,17,67
SK Sturm Gra,8379,3,18,9,9,56,31,25,63
Vienna,8379,4,18,6,12,60,51,9,60
Rapid Vienna,8379,5,13,11,12,52,43,9,50
RZ Pellets W,8379,6,14,6,16,48,52,-4,48
Admira Wacke,8379,7,11,6,19,34,52,-18,39
St. Pölten,8379,8,9,9,18,43,60,-17,36
SV Josko Rie,8379,9,10,6,20,28,49,-21,36
Mattersburg,8379,10,5,10,21,32,70,-38,25
FC Salzburg,8380,1,20,9,7,58,22,36,69
SK Sturm Gra,8380,2,20,5,11,58,33,25,65
SC Rheindorf,8380,3,18,6,12,52,43,9,60
Vienna,8380,4,16,6,14,57,52,5,54
Rapid Vienna,8380,5,14,9,13,48,37,11,51
RZ Pellets W,8380,6,15,4,17,45,54,-9,49
Admira Wacke,8380,7,14,5,17,39,58,-19,47
SV Josko Rie,8380,8,12,6,18,36,53,-17,42
St. Pölten,8380,9,10,8,18,46,64,-18,38
Mattersburg,8380,10,8,8,20,35,58,-23,32
SC Rheindorf,8381,1,24,5,7,56,36,20,77
FC Salzburg,8381,2,21,8,7,76,34,42,71
SK Sturm Gra,8381,3,19,5,12,59,38,21,62
Vienna,8381,4,18,6,12,60,53,7,60
Rapid Vienna,8381,5,15,9,12,59,44,15,54
Admira Wacke,8381,6,13,7,16,46,58,-12,46
RZ Pellets W,8381,7,10,8,18,52,68,-16,38
Mattersburg,8381,8,8,9,19,42,62,-20,33
SV Josko Rie,8381,9,9,6,21,34,62,-28,33
St. Pölten,8381,10,6,11,19,38,67,-29,29
FC Salzburg,8382,1,20,7,9,65,33,32,67
Vienna,8382,2,20,6,10,66,43,23,66
SC Rheindorf,8382,3,18,10,8,51,38,13,64
SK Sturm Gra,8382,4,17,9,10,59,36,23,60
Admira Wacke,8382,5,16,6,14,39,53,-14,54
RZ Pellets W,8382,6,13,6,17,50,56,-6,45
Rapid Vienna,8382,7,9,14,13,48,46,2,41
St. Pölten,8382,8,10,9,17,45,65,-20,39
SV Josko Rie,8382,9,10,5,21,27,54,-27,35
Mattersburg,8382,10,6,10,20,33,59,-26,28
FC Salzburg,8383,1,20,9,7,64,30,34,69
SC Rheindorf,8383,2,21,6,9,55,41,14,69
SK Sturm Gra,8383,3,20,6,10,64,35,29,66
Vienna,8383,4,17,8,11,61,51,10,59
RZ Pellets W,8383,5,14,9,13,48,48,0,51
Rapid Vienna,8383,6,13,10,13,45,39,6,49
SV Josko Rie,8383,7,11,9,16,36,50,-14,42
Admira Wacke,8383,8,10,6,20,38,59,-21,36
Mattersburg,8383,9,8,7,21,35,65,-30,31
St. Pölten,8383,10,7,8,21,39,67,-28,29
FC Salzburg,8384,1,23,4,9,71,35,36,73
SC Rheindorf,8384,2,19,6,11,55,41,14,63
SK Sturm Gra,8384,3,19,5,12,66,44,22,62
Vienna,8384,4,18,5,13,63,57,6,59
Rapid Vienna,8384,5,16,10,10,61,40,21,58
RZ Pellets W,8384,6,12,9,15,46,57,-11,45
St. Pölten,8384,7,9,12,15,50,57,-7,39
Mattersburg,8384,8,10,7,19,35,60,-25,37
SV Josko Rie,8384,9,9,7,20,31,55,-24,34
Admira Wacke,8384,10,9,7,20,28,60,-32,34
SC Rheindorf,8385,1,20,8,8,50,35,15,68
FC Salzburg,8385,2,18,9,9,59,32,27,63
SK Sturm Gra,8385,3,18,9,9,51,30,21,63
Vienna,8385,4,17,10,9,65,51,14,61
Rapid Vienna,8385,5,11,13,12,50,40,10,46
SV Josko Rie,8385,6,13,7,16,41,50,-9,46
RZ Pellets W,8385,7,11,10,15,50,58,-8,43
Admira Wacke,8385,8,10,8,18,31,52,-21,38
Mattersburg,8385,9,9,7,20,40,62,-22,34
St. Pölten,8385,10,6,13,17,34,61,-27,31
FC Salzburg,8386,1,22,5,9,61,30,31,71
SK Sturm Gra,8386,2,20,7,9,61,31,30,67
SC Rheindorf,8386,3,19,9,8,62,45,17,66
Vienna,8386,4,18,5,13,67,57,10,59
Rapid Vienna,8386,5,11,13,12,50,40,10,46
Admira Wacke,8386,6,13,7,16,40,58,-18,46
RZ Pellets W,8386,7,12,4,20,43,69,-26,40
SV Josko Rie,8386,8,11,6,19,42,60,-18,39
St. Pölten,8386,9,9,10,17,49,64,-15,37
Mattersburg,8386,10,9,6,21,42,63,-21,33
Vienna,8387,1,20,5,11,69,57,12,65
FC Salzburg,8387,2,19,5,12,61,36,25,62
SK Sturm Gra,8387,3,18,7,11,61,37,24,61
Rapid Vienna,8387,4,17,8,11,63,39,24,59
SC Rheindorf,8387,5,16,11,9,57,50,7,59
RZ Pellets W,8387,6,14,8,14,48,47,1,50
SV Josko Rie,8387,7,11,6,19,37,54,-17,39
St. Pölten,8387,8,10,9,17,44,70,-26,39
Admira Wacke,8387,9,9,9,18,35,63,-28,36
Mattersburg,8387,10,6,12,18,34,56,-22,30
SK Sturm Gra,8388,1,22,6,8,66,32,34,72
FC Salzburg,8388,2,19,11,6,65,30,35,68
SC Rheindorf,8388,3,19,8,9,55,41,14,65
Vienna,8388,4,18,4,14,58,51,7,58
Rapid Vienna,8388,5,15,8,13,62,39,23,53
Admira Wacke,8388,6,14,6,16,36,51,-15,48
RZ Pellets W,8388,7,12,8,16,38,53,-15,44
St. Pölten,8388,8,9,8,19,36,67,-31,35
Mattersburg,8388,9,7,10,19,31,56,-25,31
SV Josko Rie,8388,10,8,5,23,32,59,-27,29
FC Salzburg,8389,1,25,5,6,74,32,42,80
SK Sturm Gra,8389,2,21,6,9,67,35,32,69
SC Rheindorf,8389,3,20,7,9,58,40,18,67
Vienna,8389,4,15,9,12,56,53,3,54
Rapid Vienna,8389,5,12,12,12,56,45,11,48
Admira Wacke,8389,6,13,6,17,42,59,-17,45
Mattersburg,8389,7,11,9,16,54,63,-9,42
St. Pölten,8389,8,9,8,19,42,70,-28,35
RZ Pellets W,8389,9,9,6,21,44,67,-23,33
SV Josko Rie,8389,10,9,4,23,35,64,-29,31
FC Salzburg,8390,1,21,7,8,62,31,31,70
SC Rheindorf,8390,2,20,9,7,60,41,19,69
SK Sturm Gra,8390,3,20,7,9,62,32,30,67
Vienna,8390,4,17,5,14,60,56,4,56
Rapid Vienna,8390,5,13,9,14,55,43,12,48
St. Pölten,8390,6,12,8,16,44,63,-19,44
Admira Wacke,8390,7,13,5,18,38,59,-21,44
Mattersburg,8390,8,11,6,19,39,53,-14,39
RZ Pellets W,8390,9,11,6,19,48,65,-17,39
SV Josko Rie,8390,10,8,6,22,27,52,-25,30
FC Salzburg,8391,1,19,9,8,60,30,30,66
Vienna,8391,2,20,6,10,61,47,14,66
SK Sturm Gra,8391,3,18,7,11,53,32,21,61
SC Rheindorf,8391,4,17,7,12,52,45,7,58
Rapid Vienna,8391,5,15,12,9,56,39,17,57
RZ Pellets W,8391,6,14,4,18,47,52,-5,46
Admira Wacke,8391,7,12,9,15,38,54,-16,45
SV Josko Rie,8391,8,10,7,19,38,56,-18,37
St. Pölten,8391,9,9,8,19,37,60,-23,35
Mattersburg,8391,10,7,9,20,33,60,-27,30
SC Rheindorf,8392,1,22,5,9,59,41,18,71
FC Salzburg,8392,2,19,9,8,57,28,29,66
SK Sturm Gra,8392,3,18,8,10,55,31,24,62
Vienna,8392,4,19,5,12,68,51,17,62
Rapid Vienna,8392,5,16,11,9,57,33,24,59
Admira Wacke,8392,6,13,6,17,44,56,-12,45
RZ Pellets W,8392,7,12,8,16,40,55,-15,44
Mattersburg,8392,8,9,7,20,36,54,-18,34
SV Josko Rie,8392,9,9,6,21,37,69,-32,33
St. Pölten,8392,10,6,9,21,33,68,-35,27
FC Salzburg,8393,1,23,8,5,74,29,45,77
SK Sturm Gra,8393,2,22,4,10,68,36,32,70
Vienna,8393,3,21,5,10,68,50,18,68
SC Rheindorf,8393,4,16,8,12,54,49,5,56
Rapid Vienna,8393,5,13,10,13,52,39,13,49
St. Pölten,8393,6,11,8,17,39,59,-20,41
Admira Wacke,8393,7,11,7,18,37,57,-20,40
Mattersburg,8393,8,8,12,16,33,51,-18,36
SV Josko Rie,8393,9,10,5,21,36,61,-25,35
RZ Pellets W,8393,10,7,9,20,39,69,-30,30
FC Salzburg,8394,1,21,7,8,61,29,32,70
SK Sturm Gra,8394,2,20,6,10,56,30,26,66
Vienna,8394,3,17,6,13,56,47,9,57
SC Rheindorf,8394,4,16,8,12,48,45,3,56
Rapid Vienna,8394,5,12,11,13,49,42,7,47
SV Josko Rie,8394,6,14,5,17,35,47,-12,47
RZ Pellets W,8394,7,10,10,16,46,56,-10,40
St. Pölten,8394,8,10,10,16,36,53,-17,40
Mattersburg,8394,9,9,11,16,41,54,-13,38
Admira Wacke,8394,10,10,8,18,33,58,-25,38
FC Salzburg,8395,1,23,8,5,64,24,40,77
SK Sturm Gra,8395,2,20,8,8,61,30,31,68
SC Rheindorf,8395,3,18,7,11,51,48,3,61
Rapid Vienna,8395,4,15,10,11,59,41,18,55
Vienna,8395,5,16,5,15,60,51,9,53
RZ Pellets W,8395,6,11,10,15,41,55,-14,43
SV Josko Rie,8395,7,12,2,22,43,61,-18,38
Admira Wacke,8395,8,11,5,20,35,61,-26,38
Mattersburg,8395,9,10,7,19,36,55,-19,37
St. Pölten,8395,10,9,8,19,40,64,-24,35
SC Rheindorf,8396,1,19,10,7,61,40,21,67
SK Sturm Gra,8396,2,20,5,11,60,38,22,65
FC Salzburg,8396,3,19,7,10,65,39,26,64
Vienna,8396,4,18,7,11,60,48,12,61
Rapid Vienna,8396,5,13,12,11,54,37,17,51
Mattersburg,8396,6,9,12,15,36,49,-13,39
SV Josko Rie,8396,7,11,6,19,37,53,-16,39
St. Pölten,8396,8,9,12,15,44,62,-18,39
RZ Pellets W,8396,9,9,9,18,42,63,-21,36
Admira Wacke,8396,10,10,6,20,36,66,-30,36
FC Salzburg,8397,1,23,6,7,65,32,33,75
SK Sturm Gra,8397,2,19,9,8,58,31,27,66
Vienna,8397,3,19,8,9,64,48,16,65
SC Rheindorf,8397,4,19,5,12,58,48,10,62
Rapid Vienna,8397,5,16,10,10,60,37,23,58
Admira Wacke,8397,6,12,7,17,35,57,-22,43
RZ Pellets W,8397,7,10,8,18,47,60,-13,38
St. Pölten,8397,8,9,9,18,40,60,-20,36
Mattersburg,8397,9,9,8,19,39,59,-20,35
SV Josko Rie,8397,10,7,4,25,26,60,-34,25
FC Salzburg,8398,1,23,9,4,74,27,47,78
SK Sturm Gra,8398,2,20,6,10,61,38,23,66
SC Rheindorf,8398,3,20,6,10,49,39,10,66
Vienna,8398,4,17,3,16,50,53,-3,54
RZ Pellets W,8398,5,13,10,13,50,52,-2,49
Rapid Vienna,8398,6,12,10,14,55,42,13,46
Mattersburg,8398,7,11,8,17,43,55,-12,41
Admira Wacke,8398,8,10,8,18,38,62,-24,38
St. Pölten,8398,9,9,9,18,43,65,-22,36
SV Josko Rie,8398,10,9,3,24,30,60,-30,30
FC Salzburg,8399,1,23,6,7,72,32,40,75
Vienna,8399,2,21,3,12,66,47,19,66
SK Sturm Gra,8399,3,19,8,9,64,39,25,65
SC Rheindorf,8399,4,16,10,10,50,39,11,58
Rapid Vienna,8399,5,16,9,11,58,39,19,57
Admira Wacke,8399,6,14,6,16,37,52,-15,48
RZ Pellets W,8399,7,10,9,17,40,65,-25,39
SV Josko Rie,8399,8,9,7,20,32,58,-26,34
St. Pölten,8399,9,7,10,19,43,67,-24,31
Mattersburg,8399,10,7,8,21,38,62,-24,29
FC Salzburg,8400,1,21,8,7,65,31,34,71
SC Rheindorf,8400,2,19,8,9,52,39,13,65
SK Sturm Gra,8400,3,18,9,9,54,33,21,63
Vienna,8400,4,19,5,12,65,49,16,62
Rapid Vienna,8400,5,13,12,11,49,36,13,51
Admira Wacke,8400,6,12,7,17,34,54,-20,43
RZ Pellets W,8400,7,11,6,19,40,57,-17,39
Mattersburg,8400,8,9,10,17,35,50,-15,37
SV Josko Rie,8400,9,10,7,19,32,53,-21,37
St. Pölten,8400,10,7,10,19,35,59,-24,31
FC Salzburg,8401,1,22,6,8,65,34,31,72
SC Rheindorf,8401,2,20,6,10,57,42,15,66
SK Sturm Gra,8401,3,18,8,10,61,38,23,62
Vienna,8401,4,18,6,12,61,51,10,60
Rapid Vienna,8401,5,16,9,11,59,38,21,57
RZ Pellets W,8401,6,12,8,16,45,53,-8,44
Admira Wacke,8401,7,11,8,17,33,55,-22,41
SV Josko Rie,8401,8,11,6,19,35,50,-15,39
St. Pölten,8401,9,8,9,19,44,68,-24,33
Mattersburg,8401,10,7,8,21,29,60,-31,29
Rapid Vienna,8402,1,20,9,7,61,31,30,69
SC Rheindorf,8402,2,19,10,7,57,33,24,67
SK Sturm Gra,8402,3,18,7,11,55,33,22,61
FC Salzburg,8402,4,18,6,12,55,38,17,60
Vienna,8402,5,16,7,13,61,59,2,55
RZ Pellets W,8402,6,14,7,15,54,55,-1,49
St. Pölten,8402,7,10,10,16,46,60,-14,40
SV Josko Rie,8402,8,10,6,20,33,54,-21,36
Admira Wacke,8402,9,9,8,19,31,59,-28,35
Mattersburg,8402,10,6,10,20,29,60,-31,28
SC Rheindorf,8403,1,22,7,7,61,37,24,73
SK Sturm Gra,8403,2,21,6,9,64,36,28,69
FC Salzburg,8403,3,20,7,9,68,41,27,67
Vienna,8403,4,17,7,12,68,49,19,58
Rapid Vienna,8403,5,12,10,14,52,47,5,46
Admira Wacke,8403,6,14,4,18,40,61,-21,46
RZ Pellets W,8403,7,12,8,16,40,53,-13,44
St. Pölten,8403,8,10,10,16,40,62,-22,40
Mattersburg,8403,9,8,8,20,32,54,-22,32
SV Josko Rie,8403,10,9,3,24,34,59,-25,30
FC Salzburg,8404,1,22,8,6,68,30,38,74
SK Sturm Gra,8404,2,20,6,10,58,33,25,66
SC Rheindorf,8404,3,19,8,9,55,38,17,65
Vienna,8404,4,19,7,10,65,52,13,64
Rapid Vienna,8404,5,15,9,12,58,41,17,54
Admira Wacke,8404,6,12,6,18,36,54,-18,42
Mattersburg,8404,7,10,8,18,35,52,-17,38
RZ Pellets W,8404,8,11,5,20,41,60,-19,38
St. Pölten,8404,9,8,10,18,42,68,-26,34
SV Josko Rie,8404,10,8,5,23,36,66,-30,29
FC Salzburg,8405,1,22,6,8,74,40,34,72
SC Rheindorf,8405,2,20,10,6,61,40,21,70
SK Sturm Gra,8405,3,21,5,10,70,39,31,68
Vienna,8405,4,17,6,13,60,54,6,57
Rapid Vienna,8405,5,15,11,10,59,39,20,56
SV Josko Rie,8405,6,13,5,18,40,49,-9,44
RZ Pellets W,8405,7,12,7,17,44,58,-14,43
Admira Wacke,8405,8,10,7,19,37,66,-29,37
Mattersburg,8405,9,7,8,21,33,63,-30,29
St. Pölten,8405,10,5,11,20,35,65,-30,26
SC Rheindorf,8406,1,21,7,8,61,40,21,70
FC Salzburg,8406,2,20,7,9,59,32,27,67
SK Sturm Gra,8406,3,19,4,13,57,34,23,61
Vienna,8406,4,18,6,12,64,49,15,60
RZ Pellets W,8406,5,14,8,14,50,54,-4,50
SV Josko Rie,8406,6,12,6,18,39,57,-18,42
Admira Wacke,8406,7,12,5,19,40,64,-24,41
Mattersburg,8406,8,9,12,15,41,53,-12,39
Rapid Vienna,8406,9,8,14,14,49,49,0,38
St. Pölten,8406,10,8,9,19,40,68,-28,33
FC Salzburg,8407,1,21,7,8,64,30,34,70
SK Sturm Gra,8407,2,19,6,11,56,34,22,63
SC Rheindorf,8407,3,19,5,12,54,38,16,62
Rapid Vienna,8407,4,15,12,9,57,38,19,57
RZ Pellets W,8407,5,17,5,14,53,54,-1,56
Vienna,8407,6,17,4,15,65,50,15,55
Mattersburg,8407,7,11,9,16,44,54,-10,42
Admira Wacke,8407,8,12,6,18,35,61,-26,42
SV Josko Rie,8407,9,9,6,21,35,58,-23,33
St. Pölten,8407,10,6,8,22,33,79,-46,26
FC Salzburg,8408,1,21,7,8,65,30,35,70
SC Rheindorf,8408,2,20,6,10,59,45,14,66
Vienna,8408,3,19,7,10,70,49,21,64
SK Sturm Gra,8408,4,17,8,11,58,38,20,59
Rapid Vienna,8408,5,14,13,9,54,38,16,55
RZ Pellets W,8408,6,13,7,16,48,56,-8,46
SV Josko Rie,8408,7,11,6,19,35,50,-15,39
Admira Wacke,8408,8,10,8,18,33,62,-29,38
St. Pölten,8408,9,8,9,19,37,62,-25,33
Mattersburg,8408,10,9,5,22,38,67,-29,32
FC Salzburg,8409,1,20,9,7,66,31,35,69
SK Sturm Gra,8409,2,19,8,9,59,35,24,65
Vienna,8409,3,17,9,10,59,49,10,60
SC Rheindorf,8409,4,18,6,12,50,45,5,60
Rapid Vienna,8409,5,16,10,10,58,39,19,58
RZ Pellets W,8409,6,16,6,14,51,50,1,54
SV Josko Rie,8409,7,13,7,16,36,46,-10,46
Admira Wacke,8409,8,9,6,21,38,65,-27,33
St. Pölten,8409,9,8,8,20,39,65,-26,32
Mattersburg,8409,10,5,9,22,34,65,-31,24
FC Salzburg,8410,1,20,8,8,64,35,29,68
Vienna,8410,2,21,4,11,63,44,19,67
SC Rheindorf,8410,3,19,5,12,59,48,11,62
SK Sturm Gra,8410,4,16,7,13,55,42,13,55
Rapid Vienna,8410,5,13,13,10,55,45,10,52
RZ Pellets W,8410,6,13,9,14,47,51,-4,48
Admira Wacke,8410,7,10,9,17,38,63,-25,39
SV Josko Rie,8410,8,10,8,18,33,51,-18,38
St. Pölten,8410,9,9,10,17,49,61,-12,37
Mattersburg,8410,10,9,7,20,41,64,-23,34
SK Sturm Gra,8411,1,23,5,8,74,34,40,74
FC Salzburg,8411,2,22,7,7,75,27,48,73
Vienna,8411,3,19,6,11,70,59,11,63
SC Rheindorf,8411,4,16,11,9,53,45,8,59
Rapid Vienna,8411,5,14,11,11,54,41,13,53
RZ Pellets W,8411,6,12,8,16,47,60,-13,44
Admira Wacke,8411,7,11,6,19,40,65,-25,39
Mattersburg,8411,8,10,7,19,40,60,-20,37
SV Josko Rie,8411,9,9,7,20,36,59,-23,34
St. Pölten,8411,10,6,8,22,34,73,-39,26
SK Sturm Gra,8412,1,22,5,9,59,34,25,71
FC Salzburg,8412,2,21,7,8,62,28,34,70
SC Rheindorf,8412,3,20,8,8,54,35,19,68
Vienna,8412,4,17,9,10,59,48,11,60
Rapid Vienna,8412,5,14,10,12,59,46,13,52
RZ Pellets W,8412,6,13,5,18,44,54,-10,44
Admira Wacke,8412,7,13,5,18,43,59,-16,44
Mattersburg,8412,8,10,8,18,41,58,-17,38
St. Pölten,8412,9,8,7,21,40,71,-31,31
SV Josko Rie,8412,10,7,6,23,38,66,-28,27
SC Rheindorf,8413,1,21,7,8,60,39,21,70
Vienna,8413,2,20,6,10,65,48,17,66
FC Salzburg,8413,3,18,11,7,59,31,28,65
SK Sturm Gra,8413,4,18,7,11,52,29,23,61
Rapid Vienna,8413,5,11,12,13,52,45,7,45
RZ Pellets W,8413,6,12,8,16,45,55,-10,44
Admira Wacke,8413,7,12,7,17,37,61,-24,43
SV Josko Rie,8413,8,11,8,17,38,47,-9,41
Mattersburg,8413,9,9,6,21,37,61,-24,33
St. Pölten,8413,10,8,8,20,37,66,-29,32
SC Rheindorf,8414,1,20,8,8,57,42,15,68
Vienna,8414,2,20,6,10,71,53,18,66
SK Sturm Gra,8414,3,19,8,9,65,38,27,65
FC Salzburg,8414,4,19,6,11,66,32,34,63
Rapid Vienna,8414,5,14,12,10,58,39,19,54
Admira Wacke,8414,6,13,8,15,36,55,-19,47
St. Pölten,8414,7,9,11,16,45,60,-15,38
RZ Pellets W,8414,8,10,8,18,46,65,-19,38
SV Josko Rie,8414,9,11,4,21,34,57,-23,37
Mattersburg,8414,10,4,11,21,30,67,-37,23
SK Sturm Gra,8415,1,24,6,6,66,29,37,78
FC Salzburg,8415,2,22,7,7,67,32,35,73
SC Rheindorf,8415,3,19,8,9,61,43,18,65
Vienna,8415,4,20,4,12,65,55,10,64
RZ Pellets W,8415,5,14,4,18,47,56,-9,46
Rapid Vienna,8415,6,12,9,15,52,43,9,45
Admira Wacke,8415,7,11,5,20,34,63,-29,38
St. Pölten,8415,8,9,10,17,38,60,-22,37
SV Josko Rie,8415,9,8,8,20,31,54,-23,32
Mattersburg,8415,10,8,5,23,30,56,-26,29
FC Salzburg,8416,1,26,5,5,70,22,48,83
SC Rheindorf,8416,2,19,9,8,57,46,11,66
SK Sturm Gra,8416,3,16,11,9,57,38,19,59
Vienna,8416,4,17,4,15,54,53,1,55
Rapid Vienna,8416,5,13,13,10,59,43,16,52
RZ Pellets W,8416,6,14,6,16,46,53,-7,48
Admira Wacke,8416,7,10,11,15,30,50,-20,41
St. Pölten,8416,8,9,7,20,38,60,-22,34
Mattersburg,8416,9,8,8,20,36,58,-22,32
SV Josko Rie,8416,10,8,6,22,27,51,-24,30
FC Salzburg,8417,1,21,8,7,67,27,40,71
Vienna,8417,2,22,3,11,63,47,16,69
SK Sturm Gra,8417,3,20,5,11,61,36,25,65
SC Rheindorf,8417,4,19,7,10,54,44,10,64
Rapid Vienna,8417,5,15,9,12,62,42,20,54
Admira Wacke,8417,6,12,6,18,38,61,-23,42
RZ Pellets W,8417,7,10,9,17,44,60,-16,39
St. Pölten,8417,8,8,11,17,44,65,-21,35
Mattersburg,8417,9,9,8,19,41,64,-23,35
SV Josko Rie,8417,10,8,6,22,33,61,-28,30
FC Salzburg,8418,1,20,10,6,71,31,40,70
SC Rheindorf,8418,2,19,6,11,51,41,10,63
SK Sturm Gra,8418,3,18,7,11,56,40,16,61
Rapid Vienna,8418,4,15,10,11,55,37,18,55
Vienna,8418,5,15,8,13,62,60,2,53
Admira Wacke,8418,6,12,7,17,37,61,-24,43
RZ Pellets W,8418,7,11,9,16,43,55,-12,42
SV Josko Rie,8418,8,10,9,17,36,51,-15,39
Mattersburg,8418,9,9,9,18,42,56,-14,36
St. Pölten,8418,10,7,13,16,41,62,-21,34
FC Salzburg,8419,1,22,6,8,63,31,32,72
SK Sturm Gra,8419,2,22,4,10,61,32,29,70
Vienna,8419,3,21,3,12,64,50,14,66
Rapid Vienna,8419,4,17,10,9,64,38,26,61
SC Rheindorf,8419,5,18,7,11,51,40,11,61
RZ Pellets W,8419,6,12,6,18,42,54,-12,42
Admira Wacke,8419,7,11,5,20,32,58,-26,38
SV Josko Rie,8419,8,10,5,21,31,50,-19,35
St. Pölten,8419,9,9,8,19,33,64,-31,35
Mattersburg,8419,10,8,6,22,35,59,-24,30
FC Salzburg,8420,1,20,9,7,66,32,34,69
SK Sturm Gra,8420,2,20,7,9,61,34,27,67
Vienna,8420,3,20,6,10,79,53,26,66
SC Rheindorf,8420,4,17,8,11,54,48,6,59
Rapid Vienna,8420,5,14,11,11,58,40,18,53
Admira Wacke,8420,6,14,5,17,44,62,-18,47
RZ Pellets W,8420,7,10,10,16,44,57,-13,40
SV Josko Rie,8420,8,12,4,20,37,61,-24,40
St. Pölten,8420,9,8,8,20,38,71,-33,32
Mattersburg,8420,10,7,8,21,39,62,-23,29
FC Salzburg,8421,1,21,6,9,63,35,28,69
Vienna,8421,2,20,3,13,65,49,16,63
SK Sturm Gra,8421,3,18,6,12,62,34,28,60
SC Rheindorf,8421,4,16,11,9,50,40,10,59
Admira Wacke,8421,5,14,7,15,37,50,-13,49
Rapid Vienna,8421,6,13,9,14,50,44,6,48
St. Pölten,8421,7,11,9,16,40,54,-14,42
SV Josko Rie,8421,8,11,6,19,32,52,-20,39
RZ Pellets W,8421,9,10,7,19,47,66,-19,37
Mattersburg,8421,10,9,10,17,33,55,-22,37
SK Sturm Gra,8422,1,21,7,8,64,30,34,70
SC Rheindorf,8422,2,18,9,9,51,42,9,63
FC Salzburg,8422,3,17,8,11,63,40,23,59
Rapid Vienna,8422,4,16,9,11,64,43,21,57
Vienna,8422,5,14,7,15,54,56,-2,49
Admira Wacke,8422,6,14,6,16,37,58,-21,48
RZ Pellets W,8422,7,12,9,15,44,50,-6,45
SV Josko Rie,8422,8,11,7,18,37,48,-11,40
Mattersburg,8422,9,10,6,20,35,60,-25,36
St. Pölten,8422,10,8,10,18,44,66,-22,34
SC Rheindorf,8423,1,21,7,8,55,37,18,70
FC Salzburg,8423,2,21,5,10,65,33,32,68
Vienna,8423,3,18,5,13,61,58,3,59
SK Sturm Gra,8423,4,16,9,11,55,35,20,57
RZ Pellets W,8423,5,17,5,14,55,52,3,56
Rapid Vienna,8423,6,13,10,13,60,47,13,49
Admira Wacke,8423,7,13,5,18,42,56,-14,44
Mattersburg,8423,8,10,9,17,40,57,-17,39
SV Josko Rie,8423,9,11,5,20,33,53,-20,38
St. Pölten,8423,10,6,8,22,36,74,-38,26
SK Sturm Gra,8424,1,22,6,8,59,27,32,72
FC Salzburg,8424,2,19,10,7,66,33,33,67
SC Rheindorf,8424,3,18,11,7,52,40,12,65
Vienna,8424,4,19,7,10,64,51,13,64
RZ Pellets W,8424,5,16,7,13,49,44,5,55
Rapid Vienna,8424,6,13,10,13,53,40,13,49
Admira Wacke,8424,7,10,8,18,33,62,-29,38
SV Josko Rie,8424,8,9,5,22,30,54,-24,32
St. Pölten,8424,9,6,11,19,38,66,-28,29
Mattersburg,8424,10,6,9,21,39,66,-27,27
SC Rheindorf,8425,1,24,6,6,64,36,28,78
FC Salzburg,8425,2,21,9,6,68,30,38,72
Vienna,8425,3,20,5,11,73,57,16,65
SK Sturm Gra,8425,4,18,7,11,58,32,26,61
Rapid Vienna,8425,5,12,11,13,50,48,2,47
Admira Wacke,8425,6,12,7,17,39,56,-17,43
RZ Pellets W,8425,7,12,6,18,43,58,-15,42
SV Josko Rie,8425,8,11,6,19,37,59,-22,39
St. Pölten,8425,9,6,10,20,39,64,-25,28
Mattersburg,8425,10,6,9,21,27,58,-31,27
FC Salzburg,8426,1,21,8,7,69,29,40,71
SK Sturm Gra,8426,2,22,4,10,63,32,31,70
Vienna,8426,3,17,5,14,63,54,9,56
Rapid Vienna,8426,4,15,10,11,58,36,22,55
SC Rheindorf,8426,5,16,6,14,50,55,-5,54
Admira Wacke,8426,6,12,7,17,42,60,-18,43
RZ Pellets W,8426,7,12,6,18,41,53,-12,42
SV Josko Rie,8426,8,13,3,20,39,64,-25,42
Mattersburg,8426,9,12,5,19,38,55,-17,41
St. Pölten,8426,10,8,10,18,35,60,-25,34
FC Salzburg,8427,1,25,5,6,68,24,44,80
Vienna,8427,2,19,6,11,67,50,17,63
SK Sturm Gra,8427,3,19,5,12,60,33,27,62
SC Rheindorf,8427,4,18,6,12,53,41,12,60
RZ Pellets W,8427,5,15,9,12,50,50,0,54
Rapid Vienna,8427,6,11,13,12,55,49,6,46
SV Josko Rie,8427,7,11,7,18,35,52,-17,40
St. Pölten,8427,8,7,11,18,39,70,-31,32
Admira Wacke,8427,9,8,8,20,35,69,-34,32
Mattersburg,8427,10,7,10,19,33,57,-24,31
FC Salzburg,8428,1,22,6,8,64,29,35,72
SK Sturm Gra,8428,2,21,6,9,58,30,28,69
SC Rheindorf,8428,3,18,6,12,49,42,7,60
Vienna,8428,4,17,6,13,56,55,1,57
RZ Pellets W,8428,5,14,9,13,45,50,-5,51
Rapid Vienna,8428,6,13,10,13,55,46,9,49
Admira Wacke,8428,7,14,5,17,38,51,-13,47
St. Pölten,8428,8,9,9,18,44,61,-17,36
Mattersburg,8428,9,7,10,19,34,56,-22,31
SV Josko Rie,8428,10,7,9,20,27,50,-23,30
Vienna,8429,1,22,4,10,66,45,21,70
FC Salzburg,8429,2,19,8,9,64,30,34,65
SK Sturm Gra,8429,3,19,8,9,58,31,27,65
SC Rheindorf,8429,4,18,5,13,54,50,4,59
Rapid Vienna,8429,5,14,11,11,56,43,13,53
RZ Pellets W,8429,6,14,9,13,50,51,-1,51
St. Pölten,8429,7,11,7,18,45,66,-21,40
Admira Wacke,8429,8,12,3,21,35,61,-26,39
SV Josko Rie,8429,9,11,4,21,34,61,-27,37
Mattersburg,8429,10,6,9,21,34,58,-24,27
FC Salzburg,8430,1,23,6,7,68,24,44,75
SC Rheindorf,8430,2,22,6,8,56,40,16,72
SK Sturm Gra,8430,3,19,7,10,63,37,26,64
Vienna,8430,4,18,5,13,66,55,11,59
Rapid Vienna,8430,5,15,7,14,52,45,7,52
SV Josko Rie,8430,6,12,7,17,39,55,-16,43
Admira Wacke,8430,7,13,4,19,36,56,-20,43
RZ Pellets W,8430,8,12,5,19,43,56,-13,41
St. Pölten,8430,9,7,12,17,37,60,-23,33
Mattersburg,8430,10,5,9,22,26,58,-32,24
FC Salzburg,8431,1,20,9,7,62,32,30,69
SK Sturm Gra,8431,2,20,5,11,58,36,22,65
Vienna,8431,3,20,4,12,69,53,16,64
SC Rheindorf,8431,4,17,8,11,57,49,8,59
Rapid Vienna,8431,5,14,12,10,62,37,25,54
RZ Pellets W,8431,6,12,10,14,51,59,-8,46
Admira Wacke,8431,7,13,6,17,38,55,-17,45
St. Pölten,8431,8,8,10,18,43,64,-21,34
SV Josko Rie,8431,9,9,7,20,37,63,-26,34
Mattersburg,8431,10,8,7,21,36,65,-29,31
Vienna,8432,1,21,5,10,66,43,23,68
SK Sturm Gra,8432,2,21,4,11,62,35,27,67
FC Salzburg,8432,3,19,9,8,58,33,25,66
SC Rheindorf,8432,4,18,5,13,49,41,8,59
Rapid Vienna,8432,5,15,9,12,52,40,12,54
Admira Wacke,8432,6,14,5,17,37,50,-13,47
RZ Pellets W,8432,7,10,11,15,40,54,-14,41
SV Josko Rie,8432,8,11,7,18,34,52,-18,40
Mattersburg,8432,9,8,9,19,37,55,-18,33
St. Pölten,8432,10,7,8,21,31,63,-32,29
SK Sturm Gra,8433,1,22,5,9,67,37,30,71
SC Rheindorf,8433,2,18,8,10,50,42,8,62
FC Salzburg,8433,3,19,4,13,58,36,22,61
Rapid Vienna,8433,4,16,9,11,65,44,21,57
Vienna,8433,5,17,5,14,61,52,9,56
Admira Wacke,8433,6,13,7,16,43,53,-10,46
RZ Pellets W,8433,7,12,8,16,42,55,-13,44
SV Josko Rie,8433,8,13,3,20,45,63,-18,42
St. Pölten,8433,9,9,9,18,41,69,-28,36
Mattersburg,8433,10,8,8,20,37,58,-21,32
SK Sturm Gra,8434,1,21,5,10,60,39,21,68
FC Salzburg,8434,2,19,9,8,60,32,28,66
SC Rheindorf,8434,3,14,15,7,51,43,8,57
Vienna,8434,4,15,8,13,59,52,7,53
Rapid Vienna,8434,5,12,13,11,57,42,15,49
RZ Pellets W,8434,6,14,7,15,53,58,-5,49
St. Pölten,8434,7,11,8,17,41,62,-21,41
SV Josko Rie,8434,8,11,6,19,40,53,-13,39
Admira Wacke,8434,9,10,9,17,46,67,-21,39
Mattersburg,8434,10,8,10,18,33,52,-19,34
FC Salzburg,8435,1,22,6,8,70,31,39,72
SC Rheindorf,8435,2,17,11,8,54,43,11,62
Vienna,8435,3,19,5,12,65,57,8,62
SK Sturm Gra,8435,4,17,7,12,53,38,15,58
Rapid Vienna,8435,5,13,10,13,50,40,10,49
RZ Pellets W,8435,6,12,8,16,54,64,-10,44
Mattersburg,8435,7,12,7,17,41,51,-10,43
Admira Wacke,8435,8,12,6,18,43,58,-15,42
SV Josko Rie,8435,9,9,8,19,31,53,-22,35
St. Pölten,8435,10,8,10,18,40,66,-26,34
Vienna,8436,1,22,4,10,65,48,17,70
SK Sturm Gra,8436,2,21,6,9,65,31,34,69
FC Salzburg,8436,3,19,7,10,62,36,26,64
SC Rheindorf,8436,4,18,9,9,56,48,8,63
Admira Wacke,8436,5,15,7,14,42,51,-9,52
Rapid Vienna,8436,6,10,13,13,54,43,11,43
SV Josko Rie,8436,7,12,4,20,39,48,-9,40
RZ Pellets W,8436,8,9,9,18,39,58,-19,36
Mattersburg,8436,9,8,10,18,38,65,-27,34
St. Pölten,8436,10,6,11,19,41,73,-32,29
FC Salzburg,8437,1,23,5,8,77,30,47,74
SK Sturm Gra,8437,2,21,7,8,58,32,26,70
Vienna,8437,3,20,3,13,66,50,16,63
SC Rheindorf,8437,4,19,6,11,51,42,9,63
RZ Pellets W,8437,5,14,7,15,45,51,-6,49
Rapid Vienna,8437,6,13,8,15,59,51,8,47
SV Josko Rie,8437,7,12,5,19,40,54,-14,41
St. Pölten,8437,8,10,7,19,41,68,-27,37
Admira Wacke,8437,9,10,6,20,31,63,-32,36
Mattersburg,8437,10,7,8,21,28,55,-27,29
FC Salzburg,8438,1,20,7,9,61,36,25,67
SK Sturm Gra,8438,2,19,7,10,55,29,26,64
SC Rheindorf,8438,3,18,7,11,57,48,9,61
Vienna,8438,4,16,6,14,66,59,7,54
Rapid Vienna,8438,5,14,11,11,58,40,18,53
Admira Wacke,8438,6,15,5,16,45,52,-7,50
SV Josko Rie,8438,7,11,10,15,44,53,-9,43
RZ Pellets W,8438,8,11,7,18,41,63,-22,40
Mattersburg,8438,9,9,9,18,37,59,-22,36
St. Pölten,8438,10,7,11,18,35,60,-25,32
SK Sturm Gra,8439,1,21,7,8,61,33,28,70
SC Rheindorf,8439,2,20,8,8,54,41,13,68
FC Salzburg,8439,3,19,10,7,63,33,30,67
Vienna,8439,4,17,6,13,58,52,6,57
Rapid Vienna,8439,5,12,13,11,50,36,14,49
RZ Pellets W,8439,6,13,8,15,46,52,-6,47
Admira Wacke,8439,7,12,7,17,38,56,-18,43
SV Josko Rie,8439,8,11,7,18,42,52,-10,40
St. Pölten,8439,9,7,8,21,36,65,-29,29
Mattersburg,8439,10,6,10,20,31,59,-28,28
FC Salzburg,8440,1,21,8,7,65,32,33,71
SK Sturm Gra,8440,2,22,5,9,65,34,31,71
SC Rheindorf,8440,3,20,9,7,56,43,13,69
Vienna,8440,4,18,6,12,61,49,12,60
Rapid Vienna,8440,5,12,13,11,50,37,13,49
RZ Pellets W,8440,6,10,11,15,45,58,-13,41
Admira Wacke,8440,7,11,7,18,41,62,-21,40
SV Josko Rie,8440,8,11,6,19,37,53,-16,39
St. Pölten,8440,9,8,8,20,34,59,-25,32
Mattersburg,8440,10,6,9,21,29,56,-27,27
FC Salzburg,8441,1,22,9,5,64,27,37,75
SK Sturm Gra,8441,2,21,6,9,62,30,32,69
Rapid Vienna,8441,3,17,9,10,57,36,21,60
Vienna,8441,4,17,7,12,60,54,6,58
SC Rheindorf,8441,5,16,8,12,52,44,8,56
RZ Pellets W,8441,6,11,11,14,48,55,-7,44
Admira Wacke,8441,7,12,7,17,37,53,-16,43
Mattersburg,8441,8,8,10,18,34,58,-24,34
SV Josko Rie,8441,9,8,7,21,31,56,-25,31
St. Pölten,8441,10,6,10,20,39,71,-32,28
FC Salzburg,8442,1,20,8,8,65,36,29,68
SK Sturm Gra,8442,2,18,8,10,58,40,18,62
SC Rheindorf,8442,3,17,8,11,57,48,9,59
Vienna,8442,4,17,6,13,55,47,8,57
Rapid Vienna,8442,5,14,11,11,54,38,16,53
RZ Pellets W,8442,6,15,6,15,52,54,-2,51
Admira Wacke,8442,7,12,5,19,35,55,-20,41
Mattersburg,8442,8,11,7,18,40,54,-14,40
SV Josko Rie,8442,9,12,4,20,31,53,-22,40
St. Pölten,8442,10,8,9,19,40,62,-22,33
FC Salzburg,8443,1,21,7,8,67,28,39,70
SK Sturm Gra,8443,2,21,7,8,58,32,26,70
SC Rheindorf,8443,3,20,7,9,56,43,13,67
Vienna,8443,4,20,5,11,68,53,15,65
RZ Pellets W,8443,5,14,8,14,49,55,-6,50
Rapid Vienna,8443,6,10,11,15,49,46,3,41
St. Pölten,8443,7,9,11,16,45,61,-16,38
Admira Wacke,8443,8,11,5,20,41,65,-24,38
Mattersburg,8443,9,9,6,21,39,62,-23,33
SV Josko Rie,8443,10,8,7,21,32,59,-27,31
FC Salzburg,8444,1,24,6,6,76,29,47,78
SK Sturm Gra,8444,2,21,6,9,63,35,28,69
SC Rheindorf,8444,3,18,9,9,59,42,17,63
Vienna,8444,4,18,5,13,59,53,6,59
Rapid Vienna,8444,5,14,8,14,57,49,8,50
Admira Wacke,8444,6,15,3,18,39,61,-22,48
RZ Pellets W,8444,7,13,7,16,45,49,-4,46
St. Pölten,8444,8,7,11,18,42,67,-25,32
Mattersburg,8444,9,8,7,21,35,59,-24,31
SV Josko Rie,8444,10,9,4,23,27,58,-31,31
FC Salzburg,8445,1,19,10,7,63,34,29,67
Vienna,8445,2,19,7,10,59,45,14,64
SK Sturm Gra,8445,3,19,6,11,62,44,18,63
SC Rheindorf,8445,4,18,8,10,58,40,18,62
Rapid Vienna,8445,5,12,15,9,57,41,16,51
RZ Pellets W,8445,6,11,8,17,47,57,-10,41
Mattersburg,8445,7,11,8,17,45,64,-19,41
Admira Wacke,8445,8,11,8,17,38,62,-24,41
SV Josko Rie,8445,9,9,7,20,31,49,-18,34
St. Pölten,8445,10,8,9,19,39,63,-24,33
SK Sturm Gra,8446,1,21,7,8,64,36,28,70
FC Salzburg,8446,2,19,9,8,64,37,27,66
SC Rheindorf,8446,3,19,7,10,55,43,12,64
Vienna,8446,4,18,3,15,62,53,9,57
Rapid Vienna,8446,5,16,7,13,59,46,13,55
SV Josko Rie,8446,6,13,5,18,41,53,-12,44
Mattersburg,8446,7,10,9,17,44,55,-11,39
Admira Wacke,8446,8,11,6,19,43,70,-27,39
RZ Pellets W,8446,9,10,8,18,46,63,-17,38
St. Pölten,8446,10,8,9,19,44,66,-22,33
FC Salzburg,8447,1,22,6,8,68,32,36,72
SC Rheindorf,8447,2,20,7,9,58,44,14,67
SK Sturm Gra,8447,3,20,5,11,64,38,26,65
Vienna,8447,4,18,3,15,62,60,2,57
RZ Pellets W,8447,5,15,8,13,46,48,-2,53
Rapid Vienna,8447,6,13,13,10,56,47,9,52
SV Josko Rie,8447,7,11,6,19,40,58,-18,39
Mattersburg,8447,8,10,7,19,43,60,-17,37
Admira Wacke,8447,9,8,7,21,36,59,-23,31
St. Pölten,8447,10,7,10,19,35,62,-27,31
SC Rheindorf,8448,1,21,7,8,56,39,17,70
FC Salzburg,8448,2,19,10,7,62,29,33,67
SK Sturm Gra,8448,3,18,7,11,54,36,18,61
Vienna,8448,4,16,6,14,56,52,4,54
Rapid Vienna,8448,5,13,13,10,58,39,19,52
RZ Pellets W,8448,6,15,4,17,50,58,-8,49
Admira Wacke,8448,7,12,6,18,42,59,-17,42
SV Josko Rie,8448,8,12,5,19,32,49,-17,41
St. Pölten,8448,9,9,9,18,37,64,-27,36
Mattersburg,8448,10,8,7,21,32,54,-22,31
FC Salzburg,8449,1,21,8,7,67,34,33,71
SK Sturm Gra,8449,2,20,7,9,59,31,28,67
Vienna,8449,3,17,7,12,61,54,7,58
SC Rheindorf,8449,4,17,7,12,48,41,7,58
Mattersburg,8449,5,13,7,16,41,47,-6,46
St. Pölten,8449,6,11,9,16,38,52,-14,42
Rapid Vienna,8449,7,10,11,15,49,44,5,41
RZ Pellets W,8449,8,11,8,17,47,62,-15,41
Admira Wacke,8449,9,11,7,18,35,59,-24,40
SV Josko Rie,8449,10,11,5,20,36,57,-21,38
FC Salzburg,8450,1,22,7,7,73,27,46,73
SC Rheindorf,8450,2,19,10,7,53,36,17,67
SK Sturm Gra,8450,3,17,9,10,63,36,27,60
Vienna,8450,4,16,7,13,58,50,8,55
Rapid Vienna,8450,5,14,11,11,56,42,14,53
RZ Pellets W,8450,6,15,7,14,48,58,-10,52
SV Josko Rie,8450,7,13,4,19,33,53,-20,43
Admira Wacke,8450,8,10,7,19,38,64,-26,37
St. Pölten,8450,9,8,10,18,42,67,-25,34
Mattersburg,8450,10,7,6,23,32,63,-31,27
SC Rheindorf,8451,1,21,6,9,62,44,18,69
FC Salzburg,8451,2,20,7,9,65,30,35,67
SK Sturm Gra,8451,3,20,5,11,69,42,27,65
Rapid Vienna,8451,4,17,11,8,58,36,22,62
Vienna,8451,5,16,6,14,59,61,-2,54
RZ Pellets W,8451,6,12,9,15,50,56,-6,45
Admira Wacke,8451,7,12,6,18,37,57,-20,42
SV Josko Rie,8451,8,9,8,19,34,50,-16,35
St. Pölten,8451,9,8,10,18,39,62,-23,34
Mattersburg,8451,10,6,10,20,34,69,-35,28
FC Salzburg,8452,1,20,10,6,70,34,36,70
SC Rheindorf,8452,2,19,9,8,59,45,14,66
SK Sturm Gra,8452,3,17,8,11,58,35,23,59
RZ Pellets W,8452,4,17,6,13,53,52,1,57
Vienna,8452,5,14,7,15,54,52,2,49
Rapid Vienna,8452,6,11,14,11,52,43,9,47
SV Josko Rie,8452,7,11,7,18,34,54,-20,40
Admira Wacke,8452,8,9,10,17,32,57,-25,37
St. Pölten,8452,9,8,12,16,42,59,-17,36
Mattersburg,8452,10,8,9,19,39,62,-23,33
SC Rheindorf,8453,1,22,7,7,66,43,23,73
SK Sturm Gra,8453,2,21,6,9,62,29,33,69
Vienna,8453,3,20,5,11,67,50,17,65
FC Salzburg,8453,4,18,8,10,58,38,20,62
Rapid Vienna,8453,5,14,9,13,58,39,19,51
Admira Wacke,8453,6,14,4,18,44,60,-16,46
RZ Pellets W,8453,7,12,5,19,46,63,-17,41
SV Josko Rie,8453,8,11,5,20,39,61,-22,38
Mattersburg,8453,9,8,9,19,38,57,-19,33
St. Pölten,8453,10,7,8,21,39,77,-38,29
FC Salzburg,8454,1,20,7,9,67,31,36,67
SK Sturm Gra,8454,2,20,5,11,60,37,23,65
SC Rheindorf,8454,3,18,10,8,51,41,10,64
Vienna,8454,4,17,5,14,59,52,7,56
Rapid Vienna,8454,5,15,8,13,59,45,14,53
RZ Pellets W,8454,6,13,6,17,42,59,-17,45
Mattersburg,8454,7,12,8,16,44,52,-8,44
SV Josko Rie,8454,8,13,5,18,36,54,-18,44
Admira Wacke,8454,9,10,7,19,33,58,-25,37
St. Pölten,8454,10,7,9,20,41,63,-22,30
FC Salzburg,8455,1,24,6,6,72,27,45,78
SK Sturm Gra,8455,2,21,5,10,63,36,27,68
Vienna,8455,3,20,4,12,70,48,22,64
SC Rheindorf,8455,4,19,5,12,56,52,4,62
Rapid Vienna,8455,5,14,10,12,54,40,14,52
RZ Pellets W,8455,6,14,5,17,49,59,-10,47
SV Josko Rie,8455,7,11,7,18,37,52,-15,40
Admira Wacke,8455,8,11,5,20,34,66,-32,38
Mattersburg,8455,9,9,6,21,37,56,-19,33
St. Pölten,8455,10,6,9,21,36,72,-36,27
FC Salzburg,8456,1,21,7,8,64,31,33,70
SK Sturm Gra,8456,2,21,5,10,67,34,33,68
SC Rheindorf,8456,3,20,7,9,55,38,17,67
Rapid Vienna,8456,4,17,10,9,63,38,25,61
Vienna,8456,5,17,6,13,52,52,0,57
RZ Pellets W,8456,6,13,10,13,53,54,-1,49
SV Josko Rie,8456,7,9,7,20,36,57,-21,34
Mattersburg,8456,8,8,9,19,34,58,-24,33
Admira Wacke,8456,9,8,8,20,32,68,-36,32
St. Pölten,8456,10,6,11,19,37,63,-26,29
SK Sturm Gra,8457,1,24,4,8,66,32,34,76
SC Rheindorf,8457,2,19,9,8,50,39,11,66
FC Salzburg,8457,3,18,11,7,61,34,27,65
Vienna,8457,4,19,5,12,61,50,11,62
Rapid Vienna,8457,5,12,10,14,51,44,7,46
RZ Pellets W,8457,6,13,7,16,55,55,0,46
Admira Wacke,8457,7,10,7,19,43,67,-24,37
SV Josko Rie,8457,8,10,6,20,29,54,-25,36
St. Pölten,8457,9,8,11,17,42,67,-25,35
Mattersburg,8457,10,8,8,20,37,53,-16,32
SC Rheindorf,8458,1,20,9,7,60,37,23,69
FC Salzburg,8458,2,20,7,9,66,37,29,67
SK Sturm Gra,8458,3,19,9,8,56,26,30,66
Vienna,8458,4,16,6,14,54,56,-2,54
Admira Wacke,8458,5,15,7,14,48,50,-2,52
Rapid Vienna,8458,6,13,11,12,47,43,4,50
RZ Pellets W,8458,7,11,8,17,44,57,-13,41
SV Josko Rie,8458,8,12,3,21,34,58,-24,39
Mattersburg,8458,9,9,7,20,46,62,-16,34
St. Pölten,8458,10,7,9,20,38,67,-29,30
SC Rheindorf,8459,1,21,9,6,58,40,18,72
FC Salzburg,8459,2,18,10,8,65,35,30,64
SK Sturm Gra,8459,3,19,5,12,59,33,26,62
Rapid Vienna,8459,4,17,9,10,53,36,17,60
Vienna,8459,5,18,4,14,63,56,7,58
RZ Pellets W,8459,6,12,9,15,49,56,-7,45
St. Pölten,8459,7,10,10,16,41,57,-16,40
SV Josko Rie,8459,8,9,7,20,38,58,-20,34
Mattersburg,8459,9,7,12,17,34,55,-21,33
Admira Wacke,8459,10,9,5,22,32,66,-34,32
FC Salzburg,8460,1,23,5,8,78,29,49,74
SK Sturm Gra,8460,2,22,5,9,64,30,34,71
Vienna,8460,3,21,6,9,66,52,14,69
SC Rheindorf,8460,4,19,8,9,53,43,10,65
Rapid Vienna,8460,5,14,11,11,55,43,12,53
RZ Pellets W,8460,6,12,7,17,46,56,-10,43
SV Josko Rie,8460,7,10,8,18,37,59,-22,38
Admira Wacke,8460,8,9,6,21,39,72,-33,33
Mattersburg,8460,9,7,9,20,45,68,-23,30
St. Pölten,8460,10,6,9,21,39,70,-31,27
FC Salzburg,8461,1,19,9,8,62,33,29,66
SK Sturm Gra,8461,2,19,9,8,60,37,23,66
SC Rheindorf,8461,3,18,6,12,52,43,9,60
Vienna,8461,4,18,4,14,66,55,11,58
Rapid Vienna,8461,5,14,11,11,50,36,14,53
RZ Pellets W,8461,6,14,10,12,47,44,3,52
Admira Wacke,8461,7,12,5,19,39,66,-27,41
SV Josko Rie,8461,8,11,7,18,38,52,-14,40
St. Pölten,8461,9,8,9,19,37,62,-25,33
Mattersburg,8461,10,7,10,19,30,53,-23,31
FC Salzburg,8462,1,19,10,7,63,36,27,67
Vienna,8462,2,19,6,11,64,51,13,63
SK Sturm Gra,8462,3,18,8,10,60,35,25,62
SC Rheindorf,8462,4,18,6,12,52,43,9,60
Rapid Vienna,8462,5,14,14,8,54,36,18,56
RZ Pellets W,8462,6,13,9,14,48,55,-7,48
Admira Wacke,8462,7,12,8,16,44,56,-12,44
SV Josko Rie,8462,8,13,5,18,37,51,-14,44
St. Pölten,8462,9,7,11,18,44,70,-26,32
Mattersburg,8462,10,5,7,24,37,70,-33,22
FC Salzburg,8463,1,22,6,8,69,32,37,72
SC Rheindorf,8463,2,19,10,7,57,43,14,67
SK Sturm Gra,8463,3,19,8,9,58,28,30,65
Vienna,8463,4,17,4,15,64,59,5,55
Rapid Vienna,8463,5,14,12,10,54,35,19,54
RZ Pellets W,8463,6,13,8,15,48,58,-10,47
Mattersburg,8463,7,11,8,17,40,55,-15,41
Admira Wacke,8463,8,10,6,20,37,67,-30,36
St. Pölten,8463,9,8,9,19,38,61,-23,33
SV Josko Rie,8463,10,9,5,22,28,55,-27,32
Vienna,8464,1,22,4,10,73,46,27,70
FC Salzburg,8464,2,19,8,9,65,42,23,65
SK Sturm Gra,8464,3,19,6,11,60,34,26,63
SC Rheindorf,8464,4,18,7,11,48,41,7,61
Rapid Vienna,8464,5,16,12,8,58,35,23,60
RZ Pellets W,8464,6,12,7,17,47,60,-13,43
SV Josko Rie,8464,7,12,5,19,37,51,-14,41
Mattersburg,8464,8,10,9,17,46,54,-8,39
Admira Wacke,8464,9,10,5,21,31,68,-37,35
St. Pölten,8464,10,6,9,21,37,71,-34,27
FC Salzburg,8465,1,20,10,6,62,27,35,70
SK Sturm Gra,8465,2,21,7,8,64,31,33,70
Vienna,8465,3,22,3,11,67,50,17,69
SC Rheindorf,8465,4,18,8,10,58,42,16,62
RZ Pellets W,8465,5,14,7,15,43,52,-9,49
Rapid Vienna,8465,6,12,12,12,52,38,14,48
SV Josko Rie,8465,7,9,7,20,34,52,-18,34
St. Pölten,8465,8,8,10,18,33,59,-26,34
Admira Wacke,8465,9,9,7,20,30,59,-29,34
Mattersburg,8465,10,7,9,20,32,65,-33,30
FC Salzburg,8466,1,21,8,7,68,35,33,71
SK Sturm Gra,8466,2,21,6,9,60,31,29,69
SC Rheindorf,8466,3,21,4,11,61,40,21,67
Vienna,8466,4,19,3,14,58,55,3,60
Rapid Vienna,8466,5,12,9,15,58,51,7,45
RZ Pellets W,8466,6,12,7,17,50,65,-15,43
Admira Wacke,8466,7,11,9,16,37,60,-23,42
St. Pölten,8466,8,11,7,18,50,60,-10,40
SV Josko Rie,8466,9,11,5,20,38,60,-22,38
Mattersburg,8466,10,7,10,19,36,59,-23,31
SC Rheindorf,8467,1,21,7,8,59,44,15,70
FC Salzburg,8467,2,19,11,6,69,38,31,68
SK Sturm Gra,8467,3,19,9,8,55,26,29,66
Vienna,8467,4,19,5,12,62,50,12,62
Rapid Vienna,8467,5,12,15,9,60,45,15,51
RZ Pellets W,8467,6,13,10,13,45,51,-6,49
Admira Wacke,8467,7,11,7,18,42,62,-20,40
Mattersburg,8467,8,9,6,21,35,57,-22,33
St. Pölten,8467,9,8,8,20,41,66,-25,32
SV Josko Rie,8467,10,8,4,24,33,62,-29,28
FC Salzburg,8468,1,21,8,7,62,27,35,71
SC Rheindorf,8468,2,19,9,8,56,40,16,66
SK Sturm Gra,8468,3,16,7,13,59,41,18,55
Rapid Vienna,8468,4,15,9,12,58,46,12,54
Admira Wacke,8468,5,15,8,13,38,49,-11,53
Vienna,8468,6,13,7,16,54,57,-3,46
SV Josko Rie,8468,7,12,7,17,36,47,-11,43
RZ Pellets W,8468,8,11,9,16,50,58,-8,42
Mattersburg,8468,9,10,10,16,37,49,-12,40
St. Pölten,8468,10,5,12,19,34,70,-36,27
SK Sturm Gra,8469,1,22,4,10,59,29,30,70
FC Salzburg,8469,2,20,8,8,61,34,27,68
SC Rheindorf,8469,3,18,8,10,52,38,14,62
Vienna,8469,4,18,6,12,64,49,15,60
Rapid Vienna,8469,5,15,11,10,61,42,19,56
RZ Pellets W,8469,6,13,6,17,44,52,-8,45
SV Josko Rie,8469,7,12,7,17,39,55,-16,43
St. Pölten,8469,8,10,8,18,41,67,-26,38
Mattersburg,8469,9,7,10,19,37,57,-20,31
Admira Wacke,8469,10,8,6,22,30,65,-35,30
FC Salzburg,8470,1,21,6,9,64,30,34,69
SC Rheindorf,8470,2,19,9,8,59,42,17,66
SK Sturm Gra,8470,3,18,6,12,58,35,23,60
Rapid Vienna,8470,4,16,11,9,55,38,17,59
Vienna,8470,5,15,9,12,55,49,6,54
RZ Pellets W,8470,6,12,7,17,46,51,-5,43
SV Josko Rie,8470,7,12,7,17,34,48,-14,43
Admira Wacke,8470,8,12,6,18,35,62,-27,42
St. Pölten,8470,9,8,9,19,39,69,-30,33
Mattersburg,8470,10,8,8,20,37,58,-21,32
FC Salzburg,8471,1,22,8,6,67,31,36,74
SK Sturm Gra,8471,2,21,6,9,65,32,33,69
SC Rheindorf,8471,3,20,4,12,61,49,12,64
Vienna,8471,4,17,5,14,56,55,1,56
Rapid Vienna,8471,5,12,12,12,57,44,13,48
RZ Pellets W,8471,6,13,9,14,47,59,-12,48
SV Josko Rie,8471,7,13,6,17,40,47,-7,45
Admira Wacke,8471,8,9,8,19,40,67,-27,35
St. Pölten,8471,9,8,9,19,40,65,-25,33
Mattersburg,8471,10,6,11,19,37,61,-24,29
FC Salzburg,8472,1,20,9,7,70,33,37,69
SK Sturm Gra,8472,2,19,7,10,59,35,24,64
SC Rheindorf,8472,3,18,9,9,53,41,12,63
Vienna,8472,4,18,5,13,67,48,19,59
Rapid Vienna,8472,5,15,10,11,52,39,13,55
RZ Pellets W,8472,6,14,7,15,46,53,-7,49
Admira Wacke,8472,7,11,7,18,33,60,-27,40
SV Josko Rie,8472,8,11,3,22,37,55,-18,36
Mattersburg,8472,9,8,10,18,34,56,-22,34
St. Pölten,8472,10,8,9,19,38,69,-31,33
FC Salzburg,8473,1,23,4,9,65,32,33,73
SC Rheindorf,8473,2,22,7,7,60,38,22,73
SK Sturm Gra,8473,3,19,6,11,58,33,25,63
Vienna,8473,4,16,5,15,63,57,6,53
Rapid Vienna,8473,5,13,11,12,51,38,13,50
Admira Wacke,8473,6,14,7,15,36,59,-23,49
RZ Pellets W,8473,7,14,6,16,44,56,-12,48
SV Josko Rie,8473,8,10,4,22,32,52,-20,34
St. Pölten,8473,9,7,12,17,45,65,-20,33
Mattersburg,8473,10,7,8,21,35,59,-24,29
SC Rheindorf,8474,1,21,8,7,58,35,23,71
Vienna,8474,2,22,2,12,66,49,17,68
FC Salzburg,8474,3,18,11,7,60,32,28,65
SK Sturm Gra,8474,4,19,4,13,55,40,15,61
Rapid Vienna,8474,5,14,11,11,60,37,23,53
Mattersburg,8474,6,12,8,16,46,54,-8,44
RZ Pellets W,8474,7,10,10,16,42,59,-17,40
Admira Wacke,8474,8,10,9,17,38,62,-24,39
St. Pölten,8474,9,7,10,19,38,67,-29,31
SV Josko Rie,8474,10,8,5,23,34,62,-28,29
FC Salzburg,8475,1,22,8,6,63,24,39,74
SK Sturm Gra,8475,2,19,8,9,65,41,24,65
SC Rheindorf,8475,3,18,9,9,49,42,7,63
Vienna,8475,4,18,5,13,71,60,11,59
Rapid Vienna,8475,5,14,11,11,58,41,17,53
SV Josko Rie,8475,6,14,5,17,44,51,-7,47
Mattersburg,8475,7,11,7,18,39,51,-12,40
RZ Pellets W,8475,8,9,8,19,43,64,-21,35
Admira Wacke,8475,9,9,8,19,37,67,-30,35
St. Pölten,8475,10,8,7,21,43,71,-28,31
SC Rheindorf,8476,1,21,6,9,51,35,16,69
FC Salzburg,8476,2,20,7,9,67,33,34,67
SK Sturm Gra,8476,3,19,7,10,61,33,28,64
Rapid Vienna,8476,4,14,13,9,56,39,17,55
RZ Pellets W,8476,5,15,9,12,45,45,0,54
Vienna,8476,6,14,7,15,53,54,-1,49
SV Josko Rie,8476,7,11,9,16,35,48,-13,42
Admira Wacke,8476,8,10,7,19,34,61,-27,37
St. Pölten,8476,9,8,9,19,39,65,-26,33
Mattersburg,8476,10,7,8,21,36,64,-28,29
FC Salzburg,8477,1,21,7,8,61,31,30,70
SC Rheindorf,8477,2,18,9,9,54,45,9,63
SK Sturm Gra,8477,3,19,5,12,71,45,26,62
Vienna,8477,4,18,6,12,68,55,13,60
Admira Wacke,8477,5,15,7,14,41,56,-15,52
Rapid Vienna,8477,6,12,13,11,53,39,14,49
RZ Pellets W,8477,7,13,8,15,49,52,-3,47
SV Josko Rie,8477,8,11,4,21,35,52,-17,37
Mattersburg,8477,9,9,9,18,40,58,-18,36
St. Pölten,8477,10,6,8,22,30,69,-39,26
SC Rheindorf,8478,1,21,9,6,59,40,19,72
SK Sturm Gra,8478,2,19,6,11,59,36,23,63
FC Salzburg,8478,3,17,10,9,61,36,25,61
Rapid Vienna,8478,4,16,12,8,52,31,21,60
Vienna,8478,5,16,4,16,56,54,2,52
Admira Wacke,8478,6,14,4,18,41,59,-18,46
RZ Pellets W,8478,7,12,8,16,42,52,-10,44
SV Josko Rie,8478,8,12,3,21,38,56,-18,39
Mattersburg,8478,9,9,8,19,39,58,-19,35
St. Pölten,8478,10,7,10,19,42,67,-25,31
FC Salzburg,8479,1,22,6,8,68,31,37,72
SC Rheindorf,8479,2,22,4,10,59,39,20,70
SK Sturm Gra,8479,3,19,4,13,61,39,22,61
Rapid Vienna,8479,4,14,10,12,57,46,11,52
Vienna,8479,5,15,7,14,59,55,4,52
RZ Pellets W,8479,6,14,9,13,42,45,-3,51
Admira Wacke,8479,7,13,6,17,43,61,-18,45
St. Pölten,8479,8,9,8,19,42,73,-31,35
SV Josko Rie,8479,9,9,7,20,36,58,-22,34
Mattersburg,8479,10,8,9,19,36,56,-20,33
FC Salzburg,8480,1,24,8,4,69,28,41,80
SK Sturm Gra,8480,2,19,7,10,58,36,22,64
SC Rheindorf,8480,3,17,11,8,59,48,11,62
Vienna,8480,4,15,9,12,60,53,7,54
Rapid Vienna,8480,5,12,15,9,51,39,12,51
Admira Wacke,8480,6,14,7,15,39,47,-8,49
Mattersburg,8480,7,9,9,18,42,60,-18,36
RZ Pellets W,8480,8,9,8,19,34,49,-15,35
SV Josko Rie,8480,9,8,9,19,31,58,-27,33
St. Pölten,8480,10,6,11,19,39,64,-25,29
FC Salzburg,8481,1,21,7,8,68,31,37,70
SK Sturm Gra,8481,2,19,7,10,59,35,24,64
SC Rheindorf,8481,3,17,10,9,52,43,9,61
Rapid Vienna,8481,4,16,10,10,64,40,24,58
Vienna,8481,5,16,7,13,66,56,10,55
Admira Wacke,8481,6,15,4,17,38,59,-21,49
RZ Pellets W,8481,7,11,8,17,41,55,-14,41
Mattersburg,8481,8,10,10,16,37,52,-15,40
SV Josko Rie,8481,9,10,5,21,30,50,-20,35
St. Pölten,8481,10,5,12,19,36,70,-34,27
FC Salzburg,8482,1,20,8,8,59,28,31,68
Vienna,8482,2,21,5,10,68,49,19,68
SC Rheindorf,8482,3,18,8,10,48,37,11,62
SK Sturm Gra,8482,4,16,9,11,54,34,20,57
Admira Wacke,8482,5,14,8,14,40,50,-10,50
Rapid Vienna,8482,6,12,13,11,51,40,11,49
RZ Pellets W,8482,7,11,9,16,42,51,-9,42
Mattersburg,8482,8,10,8,18,39,54,-15,38
SV Josko Rie,8482,9,11,4,21,34,55,-21,37
St. Pölten,8482,10,6,10,20,35,72,-37,28
SK Sturm Gra,8483,1,20,5,11,71,42,29,65
SC Rheindorf,8483,2,19,7,10,58,41,17,64
Vienna,8483,3,20,4,12,62,50,12,64
FC Salzburg,8483,4,18,8,10,59,35,24,62
Rapid Vienna,8483,5,14,10,12,51,38,13,52
RZ Pellets W,8483,6,11,11,14,46,55,-9,44
SV Josko Rie,8483,7,12,5,19,34,56,-22,41
Admira Wacke,8483,8,10,7,19,33,57,-24,37
St. Pölten,8483,9,9,10,17,45,72,-27,37
Mattersburg,8483,10,9,9,18,36,49,-13,36
FC Salzburg,8484,1,21,9,6,69,31,38,72
SK Sturm Gra,8484,2,19,9,8,59,31,28,66
SC Rheindorf,8484,3,18,7,11,55,47,8,61
Vienna,8484,4,18,6,12,64,55,9,60
Rapid Vienna,8484,5,13,9,14,56,47,9,48
RZ Pellets W,8484,6,14,6,16,50,58,-8,48
Mattersburg,8484,7,11,8,17,41,51,-10,41
Admira Wacke,8484,8,11,6,19,42,58,-16,39
St. Pölten,8484,9,9,10,17,39,65,-26,37
SV Josko Rie,8484,10,8,6,22,31,63,-32,30
SC Rheindorf,8485,1,22,7,7,66,39,27,73
FC Salzburg,8485,2,21,7,8,67,31,36,70
Vienna,8485,3,17,7,12,67,55,12,58
Rapid Vienna,8485,4,15,11,10,62,43,19,56
SK Sturm Gra,8485,5,16,8,12,51,37,14,56
RZ Pellets W,8485,6,12,8,16,48,57,-9,44
SV Josko Rie,8485,7,10,10,16,37,54,-17,40
Admira Wacke,8485,8,10,9,17,36,56,-20,39
St. Pölten,8485,9,9,8,19,38,74,-36,35
Mattersburg,8485,10,6,9,21,34,60,-26,27
FC Salzburg,8486,1,20,9,7,70,31,39,69
SC Rheindorf,8486,2,20,8,8,54,41,13,68
SK Sturm Gra,8486,3,20,7,9,61,33,28,67
Vienna,8486,4,19,6,11,62,52,10,63
Rapid Vienna,8486,5,13,10,13,58,46,12,49
Mattersburg,8486,6,12,9,15,38,51,-13,45
Admira Wacke,8486,7,11,8,17,34,57,-23,41
RZ Pellets W,8486,8,10,8,18,51,62,-11,38
SV Josko Rie,8486,9,9,5,22,30,56,-26,32
St. Pölten,8486,10,6,10,20,39,68,-29,28
SC Rheindorf,8487,1,21,8,7,55,36,19,71
FC Salzburg,8487,2,19,10,7,65,32,33,67
SK Sturm Gra,8487,3,18,9,9,60,35,25,63
Vienna,8487,4,18,7,11,66,48,18,61
Rapid Vienna,8487,5,16,10,10,62,42,20,58
RZ Pellets W,8487,6,12,9,15,43,52,-9,45
St. Pölten,8487,7,9,10,17,50,66,-16,37
Admira Wacke,8487,8,9,8,19,29,59,-30,35
SV Josko Rie,8487,9,9,5,22,31,63,-32,32
Mattersburg,8487,10,7,8,21,35,63,-28,29
SC Rheindorf,8488,1,25,5,6,68,36,32,80
FC Salzburg,8488,2,19,8,9,66,34,32,65
SK Sturm Gra,8488,3,18,8,10,56,37,19,62
Vienna,8488,4,18,4,14,65,54,11,58
Rapid Vienna,8488,5,15,9,12,57,38,19,54
RZ Pellets W,8488,6,14,6,16,39,51,-12,48
SV Josko Rie,8488,7,11,5,20,31,53,-22,38
Mattersburg,8488,8,9,9,18,39,57,-18,36
Admira Wacke,8488,9,9,7,20,31,62,-31,34
St. Pölten,8488,10,8,7,21,39,69,-30,31
FC Salzburg,8489,1,24,6,6,69,28,41,78
SK Sturm Gra,8489,2,21,6,9,61,32,29,69
Vienna,8489,3,18,5,13,65,53,12,59
SC Rheindorf,8489,4,18,4,14,52,47,5,58
RZ Pellets W,8489,5,14,7,15,47,54,-7,49
Rapid Vienna,8489,6,12,10,14,59,51,8,46
Admira Wacke,8489,7,12,6,18,35,60,-25,42
SV Josko Rie,8489,8,12,4,20,34,54,-20,40
Mattersburg,8489,9,10,8,18,36,52,-16,38
St. Pölten,8489,10,6,10,20,38,65,-27,28
FC Salzburg,8490,1,21,9,6,73,32,41,72
SC Rheindorf,8490,2,20,9,7,59,35,24,69
Vienna,8490,3,19,4,13,67,53,14,61
SK Sturm Gra,8490,4,16,8,12,57,34,23,56
Rapid Vienna,8490,5,14,10,12,60,44,16,52
Admira Wacke,8490,6,13,4,19,40,66,-26,43
RZ Pellets W,8490,7,10,10,16,43,57,-14,40
St. Pölten,8490,8,8,12,16,36,65,-29,36
Mattersburg,8490,9,7,13,16,38,58,-20,34
SV Josko Rie,8490,10,9,7,20,36,65,-29,34
FC Salzburg,8491,1,21,8,7,67,34,33,71
SC Rheindorf,8491,2,20,8,8,55,40,15,68
SK Sturm Gra,8491,3,20,7,9,63,36,27,67
Vienna,8491,4,16,7,13,56,49,7,55
RZ Pellets W,8491,5,13,7,16,46,54,-8,46
Rapid Vienna,8491,6,11,11,14,49,45,4,44
Mattersburg,8491,7,10,12,14,45,53,-8,42
Admira Wacke,8491,8,11,6,19,36,63,-27,39
SV Josko Rie,8491,9,11,2,23,38,59,-21,35
St. Pölten,8491,10,8,10,18,39,61,-22,34
FC Salzburg,8492,1,25,6,5,67,26,41,81
SC Rheindorf,8492,2,23,7,6,60,35,25,76
SK Sturm Gra,8492,3,18,7,11,53,32,21,61
Rapid Vienna,8492,4,16,9,11,62,38,24,57
Vienna,8492,5,16,5,15,58,52,6,53
RZ Pellets W,8492,6,13,6,17,39,52,-13,45
Admira Wacke,8492,7,11,6,19,38,59,-21,39
SV Josko Rie,8492,8,10,5,21,29,51,-22,35
St. Pölten,8492,9,7,12,17,43,64,-21,33
Mattersburg,8492,10,6,7,23,30,70,-40,25
FC Salzburg,8493,1,22,6,8,70,30,40,72
SC Rheindorf,8493,2,21,4,11,54,47,7,67
SK Sturm Gra,8493,3,20,6,10,61,33,28,66
Vienna,8493,4,19,4,13,67,56,11,61
Rapid Vienna,8493,5,15,11,10,56,43,13,56
RZ Pellets W,8493,6,14,6,16,45,54,-9,48
Admira Wacke,8493,7,9,9,18,37,65,-28,36
St. Pölten,8493,8,9,8,19,40,62,-22,35
Mattersburg,8493,9,8,9,19,36,51,-15,33
SV Josko Rie,8493,10,9,5,22,32,57,-25,32
FC Salzburg,8494,1,22,6,8,74,39,35,72
Vienna,8494,2,21,6,9,64,45,19,69
SK Sturm Gra,8494,3,21,5,10,66,30,36,68
SC Rheindorf,8494,4,19,6,11,53,46,7,63
Admira Wacke,8494,5,13,7,16,44,60,-16,46
St. Pölten,8494,6,11,10,15,46,59,-13,43
RZ Pellets W,8494,7,12,7,17,43,59,-16,43
Rapid Vienna,8494,8,10,11,15,53,55,-2,41
Mattersburg,8494,9,8,10,18,40,58,-18,34
SV Josko Rie,8494,10,7,4,25,28,60,-32,25
Vienna,8495,1,22,4,10,62,41,21,70
FC Salzburg,8495,2,20,8,8,63,26,37,68
SK Sturm Gra,8495,3,19,6,11,58,34,24,63
SC Rheindorf,8495,4,16,9,11,50,46,4,57
Rapid Vienna,8495,5,13,11,12,54,42,12,50
RZ Pellets W,8495,6,14,6,16,47,54,-7,48
St. Pölten,8495,7,12,9,15,44,58,-14,45
Admira Wacke,8495,8,12,7,17,35,53,-18,43
SV Josko Rie,8495,9,9,5,22,31,60,-29,32
Mattersburg,8495,10,7,7,22,35,65,-30,28
FC Salzburg,8496,1,19,8,9,67,35,32,65
SK Sturm Gra,8496,2,18,8,10,56,32,24,62
SC Rheindorf,8496,3,17,11,8,52,41,11,62
Vienna,8496,4,15,9,12,62,59,3,54
Rapid Vienna,8496,5,12,10,14,44,40,4,46
Admira Wacke,8496,6,13,6,17,43,65,-22,45
St. Pölten,8496,7,11,10,15,44,53,-9,43
RZ Pellets W,8496,8,11,9,16,48,58,-10,42
SV Josko Rie,8496,9,11,7,18,39,54,-15,40
Mattersburg,8496,10,10,8,18,40,58,-18,38
FC Salzburg,8497,1,22,5,9,70,33,37,71
SC Rheindorf,8497,2,20,9,7,56,37,19,69
Vienna,8497,3,20,6,10,60,44,16,66
SK Sturm Gra,8497,4,17,10,9,57,36,21,61
Rapid Vienna,8497,5,13,11,12,57,45,12,50
RZ Pellets W,8497,6,13,5,18,47,60,-13,44
Mattersburg,8497,7,10,9,17,36,49,-13,39
Admira Wacke,8497,8,10,6,20,30,58,-28,36
St. Pölten,8497,9,9,8,19,41,61,-20,35
SV Josko Rie,8497,10,10,3,23,27,58,-31,33
FC Salzburg,8498,1,20,7,9,61,30,31,67
SC Rheindorf,8498,2,18,10,8,54,37,17,64
SK Sturm Gra,8498,3,18,6,12,61,43,18,60
Rapid Vienna,8498,4,15,11,10,59,39,20,56
Vienna,8498,5,16,6,14,59,56,3,54
SV Josko Rie,8498,6,13,4,19,40,50,-10,43
RZ Pellets W,8498,7,11,9,16,42,57,-15,42
Mattersburg,8498,8,11,8,17,37,50,-13,41
St. Pölten,8498,9,10,8,18,41,65,-24,38
Admira Wacke,8498,10,10,7,19,30,57,-27,37
SK Sturm Gra,8499,1,21,6,9,67,34,33,69
FC Salzburg,8499,2,20,6,10,63,32,31,66
SC Rheindorf,8499,3,20,6,10,64,45,19,66
Vienna,8499,4,21,3,12,63,46,17,66
Rapid Vienna,8499,5,16,9,11,53,32,21,57
RZ Pellets W,8499,6,13,6,17,46,59,-13,45
SV Josko Rie,8499,7,13,4,19,35,52,-17,43
Admira Wacke,8499,8,11,6,19,35,58,-23,39
Mattersburg,8499,9,9,9,18,38,59,-21,36
St. Pölten,8499,10,5,7,24,33,80,-47,22
SK Sturm Gra,8500,1,22,4,10,57,29,28,70
FC Salzburg,8500,2,20,8,8,61,31,30,68
SC Rheindorf,8500,3,20,8,8,55,41,14,68
Vienna,8500,4,17,4,15,60,52,8,55
Rapid Vienna,8500,5,14,10,12,52,39,13,52
Admira Wacke,8500,6,12,6,18,41,55,-14,42
St. Pölten,8500,7,11,8,17,42,59,-17,41
RZ Pellets W,8500,8,10,9,17,42,51,-9,39
Mattersburg,8500,9,10,7,19,33,55,-22,37
SV Josko Rie,8500,10,11,2,23,29,60,-31,35
Vienna,8501,1,22,6,8,67,42,25,72
FC Salzburg,8501,2,20,10,6,62,30,32,70
SC Rheindorf,8501,3,20,6,10,60,44,16,66
SK Sturm Gra,8501,4,19,7,10,62,39,23,64
Rapid Vienna,8501,5,16,8,12,60,41,19,56
RZ Pellets W,8501,6,12,8,16,45,58,-13,44
St. Pölten,8501,7,8,12,16,45,64,-19,36
Admira Wacke,8501,8,8,8,20,31,64,-33,32
Mattersburg,8501,9,8,7,21,38,58,-20,31
SV Josko Rie,8501,10,8,6,22,32,62,-30,30
FC Salzburg,8502,1,23,8,5,77,27,50,77
SC Rheindorf,8502,2,20,6,10,58,45,13,66
SK Sturm Gra,8502,3,19,6,11,64,37,27,63
Vienna,8502,4,19,4,13,66,51,15,61
Rapid Vienna,8502,5,14,10,12,52,45,7,52
RZ Pellets W,8502,6,14,8,14,50,57,-7,50
Admira Wacke,8502,7,11,5,20,36,65,-29,38
SV Josko Rie,8502,8,10,6,20,32,56,-24,36
St. Pölten,8502,9,7,12,17,37,63,-26,33
Mattersburg,8502,10,6,9,21,40,66,-26,27
FC Salzburg,8503,1,20,8,8,63,31,32,68
SC Rheindorf,8503,2,18,10,8,57,44,13,64
SK Sturm Gra,8503,3,19,6,11,59,36,23,63
Vienna,8503,4,19,6,11,58,43,15,63
Rapid Vienna,8503,5,14,10,12,61,47,14,52
St. Pölten,8503,6,10,12,14,39,54,-15,42
RZ Pellets W,8503,7,11,8,17,50,58,-8,41
SV Josko Rie,8503,8,9,9,18,32,54,-22,36
Mattersburg,8503,9,8,10,18,34,56,-22,34
Admira Wacke,8503,10,8,9,19,27,57,-30,33
SC Rheindorf,8504,1,23,8,5,57,33,24,77
SK Sturm Gra,8504,2,23,3,10,64,30,34,72
FC Salzburg,8504,3,20,7,9,65,32,33,67
Vienna,8504,4,18,3,15,66,58,8,57
Rapid Vienna,8504,5,14,10,12,52,45,7,52
Admira Wacke,8504,6,14,4,18,38,59,-21,46
RZ Pellets W,8504,7,12,6,18,45,59,-14,42
Mattersburg,8504,8,7,12,17,32,49,-17,33
SV Josko Rie,8504,9,9,5,22,29,54,-25,32
St. Pölten,8504,10,7,8,21,42,71,-29,29
SC Rheindorf,8505,1,22,7,7,55,34,21,73
SK Sturm Gra,8505,2,20,6,10,56,30,26,66
FC Salzburg,8505,3,18,8,10,58,29,29,62
Rapid Vienna,8505,4,17,9,10,61,43,18,60
Vienna,8505,5,17,7,12,66,54,12,58
RZ Pellets W,8505,6,12,8,16,45,56,-11,44
SV Josko Rie,8505,7,11,7,18,39,54,-15,40
St. Pölten,8505,8,8,11,17,42,65,-23,35
Mattersburg,8505,9,8,8,20,36,56,-20,32
Admira Wacke,8505,10,7,9,20,33,70,-37,30
FC Salzburg,8506,1,25,4,7,74,32,42,79
SK Sturm Gra,8506,2,19,8,9,59,34,25,65
SC Rheindorf,8506,3,17,9,10,51,44,7,60
Rapid Vienna,8506,4,15,11,10,61,36,25,56
Vienna,8506,5,15,6,15,52,54,-2,51
RZ Pellets W,8506,6,11,10,15,46,55,-9,43
Mattersburg,8506,7,9,11,16,38,54,-16,38
SV Josko Rie,8506,8,10,8,18,31,52,-21,38
Admira Wacke,8506,9,10,6,20,35,59,-24,36
St. Pölten,8506,10,5,15,16,41,68,-27,30
SK Sturm Gra,8507,1,23,4,9,61,31,30,73
FC Salzburg,8507,2,22,6,8,70,38,32,72
Vienna,8507,3,19,5,12,71,52,19,62
Rapid Vienna,8507,4,17,10,9,68,39,29,61
SC Rheindorf,8507,5,18,5,13,57,46,11,59
SV Josko Rie,8507,6,14,4,18,37,53,-16,46
RZ Pellets W,8507,7,11,6,19,44,67,-23,39
Admira Wacke,8507,8,10,6,20,42,70,-28,36
St. Pölten,8507,9,8,8,20,42,68,-26,32
Mattersburg,8507,10,7,8,21,32,60,-28,29
FC Salzburg,8508,1,20,9,7,65,32,33,69
SK Sturm Gra,8508,2,18,11,7,59,35,24,65
SC Rheindorf,8508,3,19,7,10,57,44,13,64
Vienna,8508,4,18,7,11,67,51,16,61
Rapid Vienna,8508,5,16,10,10,61,39,22,58
SV Josko Rie,8508,6,12,4,20,36,50,-14,40
Mattersburg,8508,7,10,10,16,41,57,-16,40
RZ Pellets W,8508,8,10,8,18,41,60,-19,38
Admira Wacke,8508,9,10,5,21,34,67,-33,35
St. Pölten,8508,10,6,11,19,37,63,-26,29
Vienna,8509,1,22,5,9,70,41,29,71
FC Salzburg,8509,2,18,12,6,61,29,32,66
SK Sturm Gra,8509,3,19,8,9,54,28,26,65
SC Rheindorf,8509,4,18,11,7,51,40,11,65
Rapid Vienna,8509,5,15,11,10,54,36,18,56
Admira Wacke,8509,6,9,10,17,38,71,-33,37
RZ Pellets W,8509,7,8,11,17,41,62,-21,35
Mattersburg,8509,8,8,10,18,45,61,-16,34
St. Pölten,8509,9,7,12,17,44,67,-23,33
SV Josko Rie,8509,10,9,4,23,34,57,-23,31
FC Salzburg,8510,1,21,7,8,62,28,34,70
SK Sturm Gra,8510,2,18,9,9,62,34,28,63
SC Rheindorf,8510,3,18,9,9,57,40,17,63
Vienna,8510,4,20,3,13,60,51,9,63
Rapid Vienna,8510,5,16,11,9,58,40,18,59
Admira Wacke,8510,6,14,4,18,35,53,-18,46
Mattersburg,8510,7,10,8,18,39,56,-17,38
RZ Pellets W,8510,8,10,7,19,44,61,-17,37
SV Josko Rie,8510,9,10,4,22,30,58,-28,34
St. Pölten,8510,10,7,10,19,41,67,-26,31
SK Sturm Gra,8511,1,22,5,9,59,31,28,71
SC Rheindorf,8511,2,19,10,7,58,40,18,67
FC Salzburg,8511,3,19,9,8,64,36,28,66
Rapid Vienna,8511,4,17,11,8,64,36,28,62
Vienna,8511,5,17,11,8,67,52,15,62
SV Josko Rie,8511,6,10,8,18,39,57,-18,38
RZ Pellets W,8511,7,10,7,19,44,62,-18,37
Admira Wacke,8511,8,11,4,21,37,64,-27,37
St. Pölten,8511,9,8,8,20,41,67,-26,32
Mattersburg,8511,10,7,7,22,30,58,-28,28
FC Salzburg,8512,1,24,7,5,68,25,43,79
SK Sturm Gra,8512,2,22,4,10,61,37,24,70
Vienna,8512,3,18,8,10,67,47,20,62
SC Rheindorf,8512,4,18,8,10,55,47,8,62
Rapid Vienna,8512,5,13,11,12,57,41,16,50
RZ Pellets W,8512,6,10,9,17,43,59,-16,39
St. Pölten,8512,7,9,11,16,49,66,-17,38
Admira Wacke,8512,8,10,7,19,39,67,-28,37
SV Josko Rie,8512,9,9,7,20,32,54,-22,34
Mattersburg,8512,10,6,10,20,39,67,-28,28
SK Sturm Gra,8513,1,22,5,9,65,29,36,71
FC Salzburg,8513,2,21,5,10,67,31,36,68
SC Rheindorf,8513,3,18,7,11,52,46,6,61
Vienna,8513,4,17,6,13,61,50,11,57
Rapid Vienna,8513,5,13,11,12,56,44,12,50
St. Pölten,8513,6,12,12,12,57,59,-2,48
RZ Pellets W,8513,7,14,6,16,50,59,-9,48
Admira Wacke,8513,8,13,5,18,40,69,-29,44
SV Josko Rie,8513,9,10,5,21,31,59,-28,35
Mattersburg,8513,10,5,8,23,29,62,-33,23
FC Salzburg,8514,1,19,10,7,65,32,33,67
SC Rheindorf,8514,2,19,9,8,58,44,14,66
SK Sturm Gra,8514,3,19,8,9,62,34,28,65
Vienna,8514,4,19,5,12,62,58,4,62
Rapid Vienna,8514,5,14,11,11,57,44,13,53
RZ Pellets W,8514,6,12,9,15,44,53,-9,45
SV Josko Rie,8514,7,11,8,17,36,45,-9,41
St. Pölten,8514,8,9,8,19,43,67,-24,35
Admira Wacke,8514,9,9,6,21,34,62,-28,33
Mattersburg,8514,10,6,12,18,34,56,-22,30
SC Rheindorf,8515,1,22,7,7,64,39,25,73
SK Sturm Gra,8515,2,22,6,8,58,28,30,72
FC Salzburg,8515,3,17,10,9,62,37,25,61
Vienna,8515,4,16,9,11,60,54,6,57
RZ Pellets W,8515,5,16,7,13,51,49,2,55
Admira Wacke,8515,6,13,6,17,41,50,-9,45
SV Josko Rie,8515,7,10,8,18,36,54,-18,38
Mattersburg,8515,8,9,8,19,34,54,-20,35
Rapid Vienna,8515,9,8,10,18,45,53,-8,34
St. Pölten,8515,10,7,9,20,38,71,-33,30
FC Salzburg,8516,1,22,8,6,66,29,37,74
SK Sturm Gra,8516,2,21,4,11,65,39,26,67
SC Rheindorf,8516,3,19,9,8,56,36,20,66
Vienna,8516,4,18,8,10,64,50,14,62
Admira Wacke,8516,5,14,6,16,48,56,-8,48
Rapid Vienna,8516,6,11,14,11,55,46,9,47
RZ Pellets W,8516,7,10,12,14,45,55,-10,42
SV Josko Rie,8516,8,10,4,22,35,62,-27,34
Mattersburg,8516,9,7,10,19,33,57,-24,31
St. Pölten,8516,10,5,11,20,37,74,-37,26
SC Rheindorf,8517,1,20,9,7,62,40,22,69
FC Salzburg,8517,2,20,8,8,69,33,36,68
SK Sturm Gra,8517,3,19,7,10,62,41,21,64
Vienna,8517,4,17,7,12,65,55,10,58
Rapid Vienna,8517,5,15,12,9,64,43,21,57
RZ Pellets W,8517,6,12,7,17,48,59,-11,43
SV Josko Rie,8517,7,11,7,18,40,56,-16,40
Admira Wacke,8517,8,11,5,20,38,66,-28,38
St. Pölten,8517,9,6,13,17,45,70,-25,31
Mattersburg,8517,10,7,9,20,38,68,-30,30
SC Rheindorf,8518,1,20,10,6,60,42,18,70
FC Salzburg,8518,2,20,9,7,57,25,32,69
SK Sturm Gra,8518,3,21,5,10,64,30,34,68
Rapid Vienna,8518,4,16,9,11,61,39,22,57
Vienna,8518,5,16,9,11,53,46,7,57
St. Pölten,8518,6,10,9,17,38,57,-19,39
Mattersburg,8518,7,9,9,18,34,48,-14,36
RZ Pellets W,8518,8,9,9,18,41,65,-24,36
Admira Wacke,8518,9,10,6,20,41,67,-26,36
SV Josko Rie,8518,10,8,7,21,30,60,-30,31
FC Salzburg,8519,1,22,7,7,61,28,33,73
Vienna,8519,2,20,7,9,68,40,28,67
SK Sturm Gra,8519,3,19,10,7,57,31,26,67
SC Rheindorf,8519,4,16,7,13,47,42,5,55
Rapid Vienna,8519,5,13,10,13,58,47,11,49
SV Josko Rie,8519,6,13,5,18,42,53,-11,44
Admira Wacke,8519,7,12,6,18,37,64,-27,42
Mattersburg,8519,8,11,6,19,41,59,-18,39
St. Pölten,8519,9,8,9,19,37,58,-21,33
RZ Pellets W,8519,10,8,9,19,35,61,-26,33
FC Salzburg,8520,1,23,7,6,65,28,37,76
SK Sturm Gra,8520,2,21,7,8,57,29,28,70
Vienna,8520,3,20,5,11,63,47,16,65
SC Rheindorf,8520,4,16,10,10,50,47,3,58
Rapid Vienna,8520,5,12,9,15,49,42,7,45
RZ Pellets W,8520,6,13,6,17,48,60,-12,45
St. Pölten,8520,7,10,11,15,44,55,-11,41
SV Josko Rie,8520,8,10,8,18,38,51,-13,38
Admira Wacke,8520,9,9,7,20,34,63,-29,34
Mattersburg,8520,10,6,10,20,35,61,-26,28
FC Salzburg,8521,1,22,7,7,63,28,35,73
SC Rheindorf,8521,2,21,7,8,59,38,21,70
SK Sturm Gra,8521,3,19,6,11,53,34,19,63
RZ Pellets W,8521,4,17,4,15,50,49,1,55
Vienna,8521,5,17,4,15,58,60,-2,55
SV Josko Rie,8521,6,13,6,17,43,56,-13,45
Admira Wacke,8521,7,12,6,18,44,64,-20,42
Rapid Vienna,8521,8,9,12,15,48,45,3,39
St. Pölten,8521,9,10,9,17,42,60,-18,39
Mattersburg,8521,10,5,9,22,33,59,-26,24
FC Salzburg,8522,1,23,7,6,61,25,36,76
SK Sturm Gra,8522,2,18,11,7,64,33,31,65
Vienna,8522,3,19,4,13,69,51,18,61
SC Rheindorf,8522,4,18,7,11,53,45,8,61
RZ Pellets W,8522,5,14,7,15,48,55,-7,49
Rapid Vienna,8522,6,13,9,14,49,40,9,48
SV Josko Rie,8522,7,14,4,18,40,57,-17,46
Admira Wacke,8522,8,11,8,17,37,58,-21,41
St. Pölten,8522,9,6,11,19,36,63,-27,29
Mattersburg,8522,10,7,6,23,33,63,-30,27
FC Salzburg,8523,1,25,7,4,71,26,45,82
SK Sturm Gra,8523,2,21,5,10,65,38,27,68
Rapid Vienna,8523,3,17,9,10,64,42,22,60
Vienna,8523,4,18,6,12,70,53,17,60
SC Rheindorf,8523,5,16,7,13,49,52,-3,55
RZ Pellets W,8523,6,13,4,19,45,59,-14,43
SV Josko Rie,8523,7,11,7,18,38,53,-15,40
Mattersburg,8523,8,9,9,18,38,58,-20,36
Admira Wacke,8523,9,10,4,22,38,68,-30,34
St. Pölten,8523,10,8,6,22,38,67,-29,30
SC Rheindorf,8524,1,21,8,7,66,38,28,71
FC Salzburg,8524,2,19,11,6,64,31,33,68
SK Sturm Gra,8524,3,21,5,10,65,35,30,68
Rapid Vienna,8524,4,17,9,10,59,40,19,60
Vienna,8524,5,14,7,15,52,64,-12,49
Admira Wacke,8524,6,14,6,16,42,50,-8,48
RZ Pellets W,8524,7,10,8,18,40,61,-21,38
Mattersburg,8524,8,8,12,16,38,56,-18,36
St. Pölten,8524,9,8,9,19,44,66,-22,33
SV Josko Rie,8524,10,8,5,23,29,58,-29,29
FC Salzburg,8525,1,21,7,8,64,28,36,70
SC Rheindorf,8525,2,19,11,6,54,38,16,68
SK Sturm Gra,8525,3,19,8,9,61,43,18,65
Vienna,8525,4,17,7,12,65,53,12,58
Rapid Vienna,8525,5,12,13,11,55,42,13,49
RZ Pellets W,8525,6,11,8,17,47,57,-10,41
Admira Wacke,8525,7,10,9,17,37,57,-20,39
Mattersburg,8525,8,10,7,19,38,54,-16,37
St. Pölten,8525,9,10,7,19,42,64,-22,37
SV Josko Rie,8525,10,10,5,21,33,60,-27,35
SK Sturm Gra,8526,1,20,8,8,60,31,29,68
Vienna,8526,2,19,6,11,69,53,16,63
FC Salzburg,8526,3,17,10,9,60,35,25,61
SC Rheindorf,8526,4,16,12,8,52,43,9,60
Rapid Vienna,8526,5,14,12,10,52,40,12,54
Mattersburg,8526,6,14,5,17,45,54,-9,47
SV Josko Rie,8526,7,12,6,18,41,59,-18,42
RZ Pellets W,8526,8,9,10,17,41,52,-11,37
Admira Wacke,8526,9,9,8,19,38,61,-23,35
St. Pölten,8526,10,6,11,19,39,69,-30,29
SC Rheindorf,8527,1,24,7,5,58,33,25,79
SK Sturm Gra,8527,2,19,6,11,58,31,27,63
Vienna,8527,3,19,4,13,65,53,12,61
FC Salzburg,8527,4,18,5,13,57,36,21,59
Rapid Vienna,8527,5,16,9,11,58,35,23,57
RZ Pellets W,8527,6,15,7,14,45,47,-2,52
SV Josko Rie,8527,7,12,4,20,33,61,-28,40
Admira Wacke,8527,8,9,7,20,30,59,-29,34
St. Pölten,8527,9,8,8,20,39,67,-28,32
Mattersburg,8527,10,7,9,20,38,59,-21,30
FC Salzburg,8528,1,21,9,6,62,29,33,72
SK Sturm Gra,8528,2,19,6,11,56,31,25,63
Vienna,8528,3,18,7,11,67,52,15,61
SC Rheindorf,8528,4,16,8,12,52,44,8,56
Rapid Vienna,8528,5,14,11,11,54,41,13,53
SV Josko Rie,8528,6,15,5,16,39,45,-6,50
RZ Pellets W,8528,7,13,7,16,48,60,-12,46
Admira Wacke,8528,8,10,10,16,36,55,-19,40
St. Pölten,8528,9,7,11,18,42,63,-21,32
Mattersburg,8528,10,6,8,22,30,66,-36,26
Vienna,8529,1,20,6,10,66,49,17,66
SC Rheindorf,8529,2,20,6,10,57,42,15,66
FC Salzburg,8529,3,18,11,7,63,31,32,65
SK Sturm Gra,8529,4,19,6,11,62,41,21,63
Rapid Vienna,8529,5,13,10,13,50,41,9,49
Admira Wacke,8529,6,13,5,18,39,60,-21,44
RZ Pellets W,8529,7,11,10,15,42,51,-9,43
SV Josko Rie,8529,8,12,4,20,33,50,-17,40
Mattersburg,8529,9,8,10,18,37,54,-17,34
St. Pölten,8529,10,7,10,19,36,66,-30,31
SC Rheindorf,8530,1,20,10,6,53,32,21,70
FC Salzburg,8530,2,19,9,8,59,26,33,66
SK Sturm Gra,8530,3,19,7,10,60,38,22,64
Vienna,8530,4,17,4,15,65,59,6,55
Admira Wacke,8530,5,15,7,14,48,53,-5,52
Rapid Vienna,8530,6,12,11,13,55,48,7,47
RZ Pellets W,8530,7,10,10,16,48,66,-18,40
SV Josko Rie,8530,8,10,6,20,31,50,-19,36
St. Pölten,8530,9,8,11,17,48,69,-21,35
Mattersburg,8530,10,8,9,19,37,63,-26,33
FC Salzburg,8531,1,24,7,5,68,24,44,79
SC Rheindorf,8531,2,20,5,11,56,42,14,65
SK Sturm Gra,8531,3,19,7,10,60,33,27,64
Vienna,8531,4,17,6,13,56,51,5,57
Rapid Vienna,8531,5,12,12,12,51,42,9,48
RZ Pellets W,8531,6,13,8,15,52,57,-5,47
Admira Wacke,8531,7,12,6,18,35,55,-20,42
Mattersburg,8531,8,10,7,19,39,55,-16,37
SV Josko Rie,8531,9,10,5,21,36,60,-24,35
St. Pölten,8531,10,8,7,21,35,69,-34,31
FC Salzburg,8532,1,22,7,7,67,32,35,73
SC Rheindorf,8532,2,20,9,7,63,40,23,69
SK Sturm Gra,8532,3,20,7,9,67,28,39,67
Vienna,8532,4,18,5,13,59,54,5,59
Rapid Vienna,8532,5,13,12,11,55,41,14,51
SV Josko Rie,8532,6,13,5,18,41,50,-9,44
RZ Pellets W,8532,7,11,8,17,45,51,-6,41
Admira Wacke,8532,8,10,5,21,29,65,-36,35
Mattersburg,8532,9,8,8,20,29,61,-32,32
St. Pölten,8532,10,7,10,19,39,72,-33,31
FC Salzburg,8533,1,22,5,9,71,32,39,71
SC Rheindorf,8533,2,22,5,9,65,41,24,71
SK Sturm Gra,8533,3,21,5,10,61,33,28,68
Rapid Vienna,8533,4,14,9,13,58,44,14,51
RZ Pellets W,8533,5,14,6,16,46,55,-9,48
Vienna,8533,6,13,7,16,48,65,-17,46
SV Josko Rie,8533,7,14,3,19,43,58,-15,45
Mattersburg,8533,8,11,9,16,46,56,-10,42
Admira Wacke,8533,9,11,6,19,36,55,-19,39
St. Pölten,8533,10,6,9,21,37,72,-35,27
SK Sturm Gra,8534,1,22,6,8,64,31,33,72
FC Salzburg,8534,2,21,6,9,66,33,33,69
Vienna,8534,3,18,7,11,62,49,13,61
SC Rheindorf,8534,4,18,7,11,56,48,8,61
RZ Pellets W,8534,5,15,9,12,56,53,3,54
Rapid Vienna,8534,6,12,13,11,56,47,9,49
SV Josko Rie,8534,7,11,6,19,32,57,-25,39
Admira Wacke,8534,8,11,5,20,36,61,-25,38
St. Pölten,8534,9,7,10,19,36,64,-28,31
Mattersburg,8534,10,5,11,20,44,65,-21,26
FC Salzburg,8535,1,21,9,6,63,28,35,72
SK Sturm Gra,8535,2,20,9,7,61,30,31,69
SC Rheindorf,8535,3,18,8,10,53,39,14,62
Vienna,8535,4,19,4,13,56,49,7,61
RZ Pellets W,8535,5,13,8,15,51,56,-5,47
Admira Wacke,8535,6,12,9,15,36,51,-15,45
Rapid Vienna,8535,7,10,12,14,52,46,6,42
Mattersburg,8535,8,9,9,18,34,56,-22,36
SV Josko Rie,8535,9,9,7,20,32,56,-24,34
St. Pölten,8535,10,6,11,19,38,65,-27,29
FC Salzburg,8536,1,24,8,4,71,23,48,80
SC Rheindorf,8536,2,20,9,7,58,42,16,69
SK Sturm Gra,8536,3,18,7,11,63,35,28,61
Vienna,8536,4,16,6,14,55,54,1,54
Rapid Vienna,8536,5,13,12,11,59,45,14,51
Admira Wacke,8536,6,14,7,15,45,57,-12,49
RZ Pellets W,8536,7,12,6,18,43,59,-16,42
SV Josko Rie,8536,8,9,6,21,33,60,-27,33
St. Pölten,8536,9,7,10,19,41,70,-29,31
Mattersburg,8536,10,6,11,19,36,59,-23,29
SK Sturm Gra,8537,1,23,5,8,62,28,34,74
Vienna,8537,2,21,4,11,59,42,17,67
FC Salzburg,8537,3,19,7,10,69,44,25,64
SC Rheindorf,8537,4,18,7,11,54,43,11,61
Rapid Vienna,8537,5,16,8,12,58,40,18,56
Admira Wacke,8537,6,12,8,16,40,55,-15,44
Mattersburg,8537,7,11,7,18,43,59,-16,40
RZ Pellets W,8537,8,10,9,17,45,61,-16,39
SV Josko Rie,8537,9,10,5,21,33,56,-23,35
St. Pölten,8537,10,6,8,22,30,65,-35,26
FC Salzburg,8538,1,21,8,7,67,33,34,71
Vienna,8538,2,21,4,11,65,44,21,67
SC Rheindorf,8538,3,20,7,9,58,47,11,67
SK Sturm Gra,8538,4,18,8,10,55,32,23,62
Rapid Vienna,8538,5,16,11,9,58,35,23,59
RZ Pellets W,8538,6,12,8,16,50,61,-11,44
Admira Wacke,8538,7,11,6,19,34,59,-25,39
SV Josko Rie,8538,8,9,7,20,28,52,-24,34
Mattersburg,8538,9,7,10,19,32,56,-24,31
St. Pölten,8538,10,7,7,22,36,64,-28,28
FC Salzburg,8539,1,21,8,7,63,30,33,71
SC Rheindorf,8539,2,20,7,9,56,40,16,67
Vienna,8539,3,21,3,12,70,45,25,66
SK Sturm Gra,8539,4,19,5,12,61,44,17,62
Rapid Vienna,8539,5,14,12,10,56,38,18,54
RZ Pellets W,8539,6,13,8,15,46,54,-8,47
SV Josko Rie,8539,7,10,8,18,39,53,-14,38
Admira Wacke,8539,8,10,6,20,34,61,-27,36
St. Pölten,8539,9,8,10,18,35,64,-29,34
Mattersburg,8539,10,6,9,21,27,58,-31,27
FC Salzburg,8540,1,20,7,9,67,35,32,67
Rapid Vienna,8540,2,18,8,10,65,39,26,62
SK Sturm Gra,8540,3,19,5,12,62,37,25,62
Vienna,8540,4,19,5,12,69,59,10,62
SC Rheindorf,8540,5,18,7,11,55,47,8,61
SV Josko Rie,8540,6,14,4,18,36,54,-18,46
Admira Wacke,8540,7,12,7,17,50,67,-17,43
RZ Pellets W,8540,8,11,7,18,45,63,-18,40
Mattersburg,8540,9,10,6,20,45,61,-16,36
St. Pölten,8540,10,7,8,21,40,72,-32,29
FC Salzburg,8541,1,20,8,8,66,35,31,68
Vienna,8541,2,20,5,11,71,53,18,65
SK Sturm Gra,8541,3,19,7,10,58,35,23,64
SC Rheindorf,8541,4,18,7,11,56,46,10,61
RZ Pellets W,8541,5,13,9,14,50,58,-8,48
Rapid Vienna,8541,6,12,11,13,56,46,10,47
St. Pölten,8541,7,10,8,18,44,67,-23,38
Admira Wacke,8541,8,10,8,18,37,62,-25,38
SV Josko Rie,8541,9,10,7,19,37,54,-17,37
Mattersburg,8541,10,10,6,20,32,51,-19,36
FC Salzburg,8542,1,20,7,9,62,35,27,67
Vienna,8542,2,19,7,10,67,52,15,64
SK Sturm Gra,8542,3,17,8,11,51,37,14,59
SC Rheindorf,8542,4,16,11,9,50,48,2,59
Rapid Vienna,8542,5,14,10,12,62,42,20,52
Admira Wacke,8542,6,13,7,16,42,55,-13,46
RZ Pellets W,8542,7,12,7,17,50,62,-12,43
SV Josko Rie,8542,8,11,7,18,34,48,-14,40
Mattersburg,8542,9,9,10,17,43,54,-11,37
St. Pölten,8542,10,7,10,19,38,66,-28,31
FC Salzburg,8543,1,22,7,7,78,34,44,73
SC Rheindorf,8543,2,19,9,8,54,42,12,66
SK Sturm Gra,8543,3,18,6,12,57,36,21,60
Rapid Vienna,8543,4,17,7,12,59,42,17,58
Vienna,8543,5,17,5,14,55,58,-3,56
Admira Wacke,8543,6,13,6,17,37,53,-16,45
RZ Pellets W,8543,7,12,6,18,42,54,-12,42
St. Pölten,8543,8,11,6,19,44,65,-21,39
Mattersburg,8543,9,9,9,18,39,55,-16,36
SV Josko Rie,8543,10,9,5,22,36,62,-26,32
FC Salzburg,8544,1,21,8,7,70,32,38,71
SC Rheindorf,8544,2,19,10,7,58,40,18,67
SK Sturm Gra,8544,3,17,11,8,66,40,26,62
Vienna,8544,4,19,5,12,66,48,18,62
Rapid Vienna,8544,5,13,14,9,53,39,14,53
Admira Wacke,8544,6,13,5,18,46,69,-23,44
RZ Pellets W,8544,7,12,7,17,43,52,-9,43
St. Pölten,8544,8,8,11,17,44,62,-18,35
SV Josko Rie,8544,9,9,7,20,36,62,-26,34
Mattersburg,8544,10,5,10,21,33,71,-38,25
FC Salzburg,8545,1,25,7,4,63,21,42,82
SK Sturm Gra,8545,2,20,7,9,63,38,25,67
Vienna,8545,3,18,6,12,60,48,12,60
SC Rheindorf,8545,4,15,11,10,45,42,3,56
Rapid Vienna,8545,5,13,9,14,51,41,10,48
RZ Pellets W,8545,6,13,7,16,47,50,-3,46
Mattersburg,8545,7,12,9,15,43,52,-9,45
Admira Wacke,8545,8,11,5,20,33,58,-25,38
SV Josko Rie,8545,9,9,5,22,33,58,-25,32
St. Pölten,8545,10,5,12,19,37,67,-30,27
SK Sturm Gra,8546,1,21,6,9,65,32,33,69
SC Rheindorf,8546,2,18,10,8,51,39,12,64
Vienna,8546,3,18,7,11,60,44,16,61
FC Salzburg,8546,4,17,9,10,55,33,22,60
Rapid Vienna,8546,5,15,12,9,61,41,20,57
RZ Pellets W,8546,6,12,9,15,42,54,-12,45
SV Josko Rie,8546,7,10,7,19,26,45,-19,37
St. Pölten,8546,8,9,9,18,39,65,-26,36
Mattersburg,8546,9,8,10,18,43,64,-21,34
Admira Wacke,8546,10,8,9,19,32,57,-25,33
SK Sturm Gra,8547,1,22,5,9,66,34,32,71
FC Salzburg,8547,2,21,6,9,63,28,35,69
SC Rheindorf,8547,3,20,4,12,57,42,15,64
Vienna,8547,4,17,5,14,58,53,5,56
Rapid Vienna,8547,5,15,10,11,49,37,12,55
RZ Pellets W,8547,6,14,7,15,46,55,-9,49
SV Josko Rie,8547,7,12,4,20,42,58,-16,40
Admira Wacke,8547,8,11,6,19,36,62,-26,39
Mattersburg,8547,9,9,9,18,40,57,-17,36
St. Pölten,8547,10,7,8,21,39,70,-31,29
FC Salzburg,8548,1,21,8,7,63,32,31,71
SK Sturm Gra,8548,2,20,7,9,61,30,31,67
SC Rheindorf,8548,3,19,9,8,58,43,15,66
Vienna,8548,4,17,3,16,58,61,-3,54
Rapid Vienna,8548,5,13,9,14,58,45,13,48
RZ Pellets W,8548,6,11,11,14,48,61,-13,44
SV Josko Rie,8548,7,10,11,15,36,45,-9,41
St. Pölten,8548,8,9,11,16,45,64,-19,38
Admira Wacke,8548,9,10,7,19,37,59,-22,37
Mattersburg,8548,10,7,10,19,43,67,-24,31
SK Sturm Gra,8549,1,21,7,8,60,29,31,70
Vienna,8549,2,22,3,11,63,43,20,69
SC Rheindorf,8549,3,18,8,10,58,46,12,62
FC Salzburg,8549,4,17,8,11,59,38,21,59
Rapid Vienna,8549,5,16,11,9,58,41,17,59
RZ Pellets W,8549,6,14,7,15,42,52,-10,49
SV Josko Rie,8549,7,12,5,19,34,53,-19,41
Admira Wacke,8549,8,11,4,21,37,59,-22,37
St. Pölten,8549,9,8,7,21,38,67,-29,31
Mattersburg,8549,10,8,6,22,38,59,-21,30
FC Salzburg,8550,1,19,8,9,64,35,29,65
Vienna,8550,2,19,6,11,69,49,20,63
SK Sturm Gra,8550,3,19,4,13,58,38,20,61
SC Rheindorf,8550,4,17,9,10,52,45,7,60
RZ Pellets W,8550,5,14,9,13,47,51,-4,51
Rapid Vienna,8550,6,13,10,13,53,43,10,49
SV Josko Rie,8550,7,13,5,18,41,54,-13,44
Admira Wacke,8550,8,11,6,19,35,63,-28,39
Mattersburg,8550,9,10,7,19,44,57,-13,37
St. Pölten,8550,10,8,10,18,43,71,-28,34
FC Salzburg,8551,1,22,6,8,68,34,34,72
SK Sturm Gra,8551,2,18,7,11,57,34,23,61
SC Rheindorf,8551,3,18,7,11,57,46,11,61
Rapid Vienna,8551,4,15,10,11,60,42,18,55
Vienna,8551,5,15,6,15,55,57,-2,51
SV Josko Rie,8551,6,13,6,17,41,52,-11,45
Mattersburg,8551,7,12,8,16,43,55,-12,44
Admira Wacke,8551,8,12,4,20,41,62,-21,40
RZ Pellets W,8551,9,10,8,18,42,57,-15,38
St. Pölten,8551,10,10,8,18,41,66,-25,38
FC Salzburg,8552,1,26,5,5,69,22,47,83
SK Sturm Gra,8552,2,21,5,10,54,29,25,68
SC Rheindorf,8552,3,21,5,10,57,40,17,68
Rapid Vienna,8552,4,14,8,14,52,44,8,50
Vienna,8552,5,15,4,17,50,57,-7,49
RZ Pellets W,8552,6,13,5,18,48,59,-11,44
Admira Wacke,8552,7,13,4,19,40,52,-12,43
Mattersburg,8552,8,12,6,18,40,52,-12,42
St. Pölten,8552,9,8,10,18,42,68,-26,34
SV Josko Rie,8552,10,9,4,23,27,56,-29,31
FC Salzburg,8553,1,23,5,8,81,37,44,74
SK Sturm Gra,8553,2,20,5,11,63,36,27,65
Vienna,8553,3,17,6,13,63,57,6,57
SC Rheindorf,8553,4,15,10,11,49,44,5,55
Rapid Vienna,8553,5,14,10,12,55,42,13,52
RZ Pellets W,8553,6,15,6,15,55,58,-3,51
SV Josko Rie,8553,7,15,5,16,43,51,-8,50
Admira Wacke,8553,8,12,4,20,44,68,-24,40
Mattersburg,8553,9,9,7,20,35,61,-26,34
St. Pölten,8553,10,6,10,20,44,78,-34,28
FC Salzburg,8554,1,25,5,6,74,27,47,80
SC Rheindorf,8554,2,21,7,8,56,39,17,70
SK Sturm Gra,8554,3,16,10,10,57,38,19,58
Vienna,8554,4,17,5,14,62,54,8,56
Rapid Vienna,8554,5,14,10,12,48,37,11,52
RZ Pellets W,8554,6,12,8,16,50,56,-6,44
Admira Wacke,8554,7,12,8,16,39,57,-18,44
SV Josko Rie,8554,8,11,4,21,30,52,-22,37
St. Pölten,8554,9,7,10,19,34,64,-30,31
Mattersburg,8554,10,7,9,20,31,57,-26,30
FC Salzburg,8555,1,23,8,5,71,30,41,77
SC Rheindorf,8555,2,18,9,9,54,45,9,63
SK Sturm Gra,8555,3,18,8,10,63,38,25,62
Vienna,8555,4,19,5,12,66,50,16,62
Rapid Vienna,8555,5,16,9,11,58,45,13,57
RZ Pellets W,8555,6,15,7,14,50,54,-4,52
Admira Wacke,8555,7,9,10,17,34,53,-19,37
St. Pölten,8555,8,9,9,18,46,65,-19,36
SV Josko Rie,8555,9,7,8,21,32,60,-28,29
Mattersburg,8555,10,5,9,22,32,66,-34,24
SK Sturm Gra,8556,1,21,6,9,64,35,29,69
FC Salzburg,8556,2,20,7,9,62,32,30,67
Rapid Vienna,8556,3,19,8,9,69,38,31,65
SC Rheindorf,8556,4,18,8,10,52,40,12,62
Vienna,8556,5,19,3,14,59,53,6,60
RZ Pellets W,8556,6,12,7,17,47,56,-9,43
Admira Wacke,8556,7,12,7,17,35,59,-24,43
SV Josko Rie,8556,8,9,7,20,29,52,-23,34
St. Pölten,8556,9,8,9,19,45,67,-22,33
Mattersburg,8556,10,8,6,22,29,59,-30,30
FC Salzburg,8557,1,22,4,10,61,30,31,70
Vienna,8557,2,21,7,8,69,42,27,70
SK Sturm Gra,8557,3,20,7,9,56,31,25,67
SC Rheindorf,8557,4,17,9,10,48,45,3,60
Rapid Vienna,8557,5,11,11,14,49,43,6,44
Admira Wacke,8557,6,12,7,17,41,61,-20,43
Mattersburg,8557,7,10,8,18,38,49,-11,38
RZ Pellets W,8557,8,9,11,16,41,57,-16,38
St. Pölten,8557,9,9,9,18,42,63,-21,36
SV Josko Rie,8557,10,10,5,21,33,57,-24,35
SK Sturm Gra,8558,1,23,5,8,69,37,32,74
FC Salzburg,8558,2,22,7,7,67,31,36,73
SC Rheindorf,8558,3,18,8,10,61,52,9,62
Vienna,8558,4,17,5,14,63,59,4,56
Rapid Vienna,8558,5,14,11,11,59,42,17,53
RZ Pellets W,8558,6,10,9,17,41,59,-18,39
Mattersburg,8558,7,9,11,16,39,51,-12,38
St. Pölten,8558,8,8,12,16,49,63,-14,36
SV Josko Rie,8558,9,9,7,20,37,56,-19,34
Admira Wacke,8558,10,9,7,20,34,69,-35,34
FC Salzburg,8559,1,21,5,10,68,35,33,68
SC Rheindorf,8559,2,18,9,9,50,41,9,63
SK Sturm Gra,8559,3,18,6,12,59,40,19,60
Vienna,8559,4,18,4,14,65,55,10,58
Rapid Vienna,8559,5,14,11,11,47,34,13,53
RZ Pellets W,8559,6,14,7,15,43,53,-10,49
SV Josko Rie,8559,7,12,5,19,41,55,-14,41
St. Pölten,8559,8,10,10,16,44,63,-19,40
Admira Wacke,8559,9,11,7,18,37,60,-23,40
Mattersburg,8559,10,9,6,21,38,56,-18,33
SC Rheindorf,8560,1,22,6,8,67,38,29,72
FC Salzburg,8560,2,21,7,8,63,33,30,70
Vienna,8560,3,18,4,14,61,54,7,58
SK Sturm Gra,8560,4,14,10,12,52,35,17,52
Rapid Vienna,8560,5,13,12,11,55,44,11,51
RZ Pellets W,8560,6,13,8,15,51,57,-6,47
Admira Wacke,8560,7,12,6,18,37,58,-21,42
SV Josko Rie,8560,8,11,6,19,36,53,-17,39
St. Pölten,8560,9,9,9,18,42,68,-26,36
Mattersburg,8560,10,8,10,18,37,61,-24,34
SK Sturm Gra,8561,1,21,5,10,61,36,25,68
FC Salzburg,8561,2,19,9,8,61,33,28,66
SC Rheindorf,8561,3,19,8,9,57,43,14,65
Vienna,8561,4,17,7,12,58,48,10,58
RZ Pellets W,8561,5,13,8,15,53,60,-7,47
Rapid Vienna,8561,6,11,13,12,53,45,8,46
Admira Wacke,8561,7,13,7,16,37,56,-19,46
Mattersburg,8561,8,7,15,14,40,51,-11,36
SV Josko Rie,8561,9,10,6,20,37,56,-19,36
St. Pölten,8561,10,6,10,20,41,70,-29,28
FC Salzburg,8562,1,24,6,6,75,28,47,78
SC Rheindorf,8562,2,18,8,10,52,42,10,62
SK Sturm Gra,8562,3,17,10,9,55,36,19,61
Vienna,8562,4,17,5,14,57,56,1,56
Rapid Vienna,8562,5,15,9,12,59,44,15,54
RZ Pellets W,8562,6,13,9,14,45,49,-4,48
St. Pölten,8562,7,11,8,17,43,57,-14,41
SV Josko Rie,8562,8,11,4,21,30,52,-22,37
Admira Wacke,8562,9,9,7,20,36,63,-27,34
Mattersburg,8562,10,7,10,19,30,55,-25,31
FC Salzburg,8563,1,21,9,6,61,25,36,72
SK Sturm Gra,8563,2,21,7,8,59,33,26,70
SC Rheindorf,8563,3,20,5,11,56,41,15,65
Vienna,8563,4,19,4,13,62,53,9,61
Rapid Vienna,8563,5,11,11,14,48,40,8,44
Admira Wacke,8563,6,12,7,17,39,59,-20,43
Mattersburg,8563,7,11,9,16,41,49,-8,42
RZ Pellets W,8563,8,11,6,19,41,58,-17,39
SV Josko Rie,8563,9,9,7,20,37,58,-21,34
St. Pölten,8563,10,7,11,18,41,69,-28,32
FC Salzburg,8564,1,19,10,7,71,31,40,67
SK Sturm Gra,8564,2,19,7,10,60,37,23,64
SC Rheindorf,8564,3,18,9,9,54,41,13,63
Vienna,8564,4,16,8,12,65,59,6,56
Rapid Vienna,8564,5,12,14,10,54,42,12,50
RZ Pellets W,8564,6,11,11,14,42,51,-9,44
Admira Wacke,8564,7,11,8,17,45,66,-21,41
SV Josko Rie,8564,8,11,6,19,33,53,-20,39
Mattersburg,8564,9,8,11,17,41,64,-23,35
St. Pölten,8564,10,7,12,17,41,62,-21,33
FC Salzburg,8565,1,24,7,5,68,26,42,79
SC Rheindorf,8565,2,19,8,9,54,40,14,65
Vienna,8565,3,18,6,12,66,60,6,60
SK Sturm Gra,8565,4,16,9,11,62,40,22,57
RZ Pellets W,8565,5,12,10,14,46,54,-8,46
Rapid Vienna,8565,6,11,11,14,54,41,13,44
Admira Wacke,8565,7,11,8,17,39,57,-18,41
St. Pölten,8565,8,11,8,17,41,65,-24,41
Mattersburg,8565,9,11,6,19,39,53,-14,39
SV Josko Rie,8565,10,7,7,22,33,66,-33,28
SC Rheindorf,8566,1,19,11,6,57,41,16,68
FC Salzburg,8566,2,19,9,8,64,32,32,66
SK Sturm Gra,8566,3,18,7,11,61,44,17,61
Vienna,8566,4,19,4,13,70,57,13,61
Rapid Vienna,8566,5,16,11,9,59,32,27,59
RZ Pellets W,8566,6,13,9,14,53,60,-7,48
Admira Wacke,8566,7,12,8,16,42,56,-14,44
Mattersburg,8566,8,9,6,21,48,69,-21,33
SV Josko Rie,8566,9,8,8,20,34,60,-26,32
St. Pölten,8566,10,6,9,21,33,70,-37,27
SK Sturm Gra,8567,1,20,10,6,61,29,32,70
SC Rheindorf,8567,2,20,7,9,54,42,12,67
FC Salzburg,8567,3,19,6,11,58,37,21,63
Vienna,8567,4,18,7,11,61,49,12,61
Rapid Vienna,8567,5,15,9,12,59,39,20,54
RZ Pellets W,8567,6,14,5,17,48,55,-7,47
Mattersburg,8567,7,11,7,18,42,53,-11,40
Admira Wacke,8567,8,11,7,18,43,70,-27,40
SV Josko Rie,8567,9,10,3,23,30,57,-27,33
St. Pölten,8567,10,8,7,21,36,61,-25,31
FC Salzburg,8568,1,20,11,5,64,27,37,71
SC Rheindorf,8568,2,21,7,8,62,38,24,70
Rapid Vienna,8568,3,16,12,8,59,34,25,60
SK Sturm Gra,8568,4,18,5,13,55,38,17,59
Vienna,8568,5,15,6,15,56,53,3,51
RZ Pellets W,8568,6,13,5,18,48,59,-11,44
Admira Wacke,8568,7,10,10,16,35,53,-18,40
SV Josko Rie,8568,8,10,7,19,29,52,-23,37
Mattersburg,8568,9,9,8,19,36,61,-25,35
St. Pölten,8568,10,8,9,19,41,70,-29,33
FC Salzburg,8569,1,20,9,7,63,31,32,69
SK Sturm Gra,8569,2,20,6,10,68,33,35,66
SC Rheindorf,8569,3,18,8,10,55,43,12,62
Vienna,8569,4,19,4,13,64,51,13,61
Rapid Vienna,8569,5,11,14,11,53,41,12,47
Admira Wacke,8569,6,13,6,17,33,56,-23,45
RZ Pellets W,8569,7,12,6,18,41,61,-20,42
SV Josko Rie,8569,8,10,7,19,30,48,-18,37
St. Pölten,8569,9,8,12,16,42,64,-22,36
Mattersburg,8569,10,8,10,18,40,61,-21,34
FC Salzburg,8570,1,20,10,6,66,29,37,70
SC Rheindorf,8570,2,19,7,10,52,37,15,64
Vienna,8570,3,19,6,11,67,51,16,63
SK Sturm Gra,8570,4,17,7,12,50,31,19,58
RZ Pellets W,8570,5,14,9,13,43,45,-2,51
Admira Wacke,8570,6,13,8,15,38,54,-16,47
Rapid Vienna,8570,7,10,10,16,45,47,-2,40
Mattersburg,8570,8,10,9,17,41,52,-11,39
St. Pölten,8570,9,10,6,20,41,68,-27,36
SV Josko Rie,8570,10,9,6,21,34,63,-29,33
FC Salzburg,8571,1,23,6,7,73,36,37,75
SC Rheindorf,8571,2,17,8,11,50,47,3,59
SK Sturm Gra,8571,3,17,7,12,62,45,17,58
Rapid Vienna,8571,4,16,9,11,57,43,14,57
Vienna,8571,5,16,7,13,66,56,10,55
RZ Pellets W,8571,6,14,9,13,50,54,-4,51
St. Pölten,8571,7,11,10,15,49,60,-11,43
Mattersburg,8571,8,10,9,17,41,53,-12,39
Admira Wacke,8571,9,9,9,18,39,65,-26,36
SV Josko Rie,8571,10,6,8,22,33,61,-28,26
FC Salzburg,8572,1,22,5,9,66,36,30,71
SC Rheindorf,8572,2,22,5,9,56,37,19,71
SK Sturm Gra,8572,3,19,4,13,53,32,21,61
Rapid Vienna,8572,4,15,11,10,55,36,19,56
Vienna,8572,5,17,5,14,67,59,8,56
RZ Pellets W,8572,6,15,7,14,48,51,-3,52
SV Josko Rie,8572,7,12,3,21,39,62,-23,39
Admira Wacke,8572,8,9,11,16,35,55,-20,38
Mattersburg,8572,9,9,8,19,34,55,-21,35
St. Pölten,8572,10,6,9,21,36,66,-30,27
FC Salzburg,8573,1,19,10,7,69,33,36,67
Vienna,8573,2,20,5,11,67,53,14,65
SK Sturm Gra,8573,3,18,9,9,61,35,26,63
SC Rheindorf,8573,4,19,6,11,56,45,11,63
Admira Wacke,8573,5,14,7,15,39,53,-14,49
Rapid Vienna,8573,6,11,11,14,58,53,5,44
RZ Pellets W,8573,7,12,7,17,43,53,-10,43
SV Josko Rie,8573,8,11,5,20,33,55,-22,38
St. Pölten,8573,9,9,8,19,40,66,-26,35
Mattersburg,8573,10,6,14,16,38,58,-20,32
SC Rheindorf,8574,1,20,8,8,54,42,12,68
FC Salzburg,8574,2,18,10,8,59,31,28,64
SK Sturm Gra,8574,3,18,8,10,60,37,23,62
Vienna,8574,4,17,5,14,65,54,11,56
Rapid Vienna,8574,5,14,10,12,52,43,9,52
RZ Pellets W,8574,6,12,8,16,48,58,-10,44
Admira Wacke,8574,7,11,8,17,38,61,-23,41
Mattersburg,8574,8,10,10,16,42,55,-13,40
St. Pölten,8574,9,8,12,16,35,58,-23,36
SV Josko Rie,8574,10,9,7,20,37,51,-14,34
SK Sturm Gra,8575,1,21,7,8,60,27,33,70
FC Salzburg,8575,2,18,9,9,63,36,27,63
SC Rheindorf,8575,3,19,6,11,48,38,10,63
RZ Pellets W,8575,4,15,8,13,51,51,0,53
Vienna,8575,5,16,5,15,53,54,-1,53
Rapid Vienna,8575,6,13,11,12,53,43,10,50
SV Josko Rie,8575,7,13,6,17,42,50,-8,45
Admira Wacke,8575,8,12,8,16,37,55,-18,44
St. Pölten,8575,9,8,7,21,40,72,-32,31
Mattersburg,8575,10,7,9,20,35,56,-21,30
FC Salzburg,8576,1,20,7,9,62,32,30,67
SK Sturm Gra,8576,2,20,6,10,56,28,28,66
SC Rheindorf,8576,3,20,5,11,53,43,10,65
Vienna,8576,4,20,3,13,61,50,11,63
RZ Pellets W,8576,5,16,7,13,52,48,4,55
Rapid Vienna,8576,6,12,10,14,47,45,2,46
Admira Wacke,8576,7,11,7,18,34,54,-20,40
St. Pölten,8576,8,10,7,19,40,65,-25,37
SV Josko Rie,8576,9,10,5,21,31,50,-19,35
Mattersburg,8576,10,8,9,19,31,52,-21,33
SC Rheindorf,8577,1,23,5,8,61,38,23,74
FC Salzburg,8577,2,21,8,7,70,32,38,71
SK Sturm Gra,8577,3,18,6,12,53,34,19,60
Vienna,8577,4,18,6,12,64,57,7,60
Admira Wacke,8577,5,15,5,16,42,56,-14,50
Rapid Vienna,8577,6,12,11,13,44,39,5,47
RZ Pellets W,8577,7,12,8,16,42,48,-6,44
St. Pölten,8577,8,9,12,15,41,58,-17,39
SV Josko Rie,8577,9,8,6,22,28,52,-24,30
Mattersburg,8577,10,7,7,22,31,62,-31,28
SC Rheindorf,8578,1,21,9,6,57,35,22,72
SK Sturm Gra,8578,2,20,7,9,56,31,25,67
FC Salzburg,8578,3,19,7,10,72,42,30,64
Vienna,8578,4,20,4,12,61,52,9,64
Rapid Vienna,8578,5,17,9,10,61,38,23,60
RZ Pellets W,8578,6,11,7,18,40,55,-15,40
Admira Wacke,8578,7,11,6,19,35,64,-29,39
SV Josko Rie,8578,8,11,3,22,32,50,-18,36
St. Pölten,8578,9,7,11,18,38,62,-24,32
Mattersburg,8578,10,8,7,21,39,62,-23,31
FC Salzburg,8579,1,21,6,9,70,30,40,69
SC Rheindorf,8579,2,21,5,10,55,37,18,68
SK Sturm Gra,8579,3,20,6,10,68,42,26,66
Vienna,8579,4,20,5,11,67,53,14,65
Rapid Vienna,8579,5,13,10,13,59,47,12,49
RZ Pellets W,8579,6,12,10,14,55,61,-6,46
SV Josko Rie,8579,7,12,7,17,39,52,-13,43
Admira Wacke,8579,8,10,6,20,29,59,-30,36
St. Pölten,8579,9,8,9,19,42,74,-32,33
Mattersburg,8579,10,7,8,21,38,67,-29,29
SK Sturm Gra,8580,1,20,8,8,68,35,33,68
SC Rheindorf,8580,2,20,8,8,61,43,18,68
FC Salzburg,8580,3,19,7,10,60,33,27,64
Vienna,8580,4,16,5,15,60,63,-3,53
RZ Pellets W,8580,5,13,8,15,48,61,-13,47
Rapid Vienna,8580,6,12,10,14,51,49,2,46
Admira Wacke,8580,7,13,7,16,44,56,-12,46
Mattersburg,8580,8,11,8,17,46,55,-9,41
St. Pölten,8580,9,8,12,16,40,66,-26,36
SV Josko Rie,8580,10,8,7,21,30,47,-17,31
FC Salzburg,8581,1,22,9,5,62,26,36,75
SC Rheindorf,8581,2,17,9,10,48,44,4,60
SK Sturm Gra,8581,3,17,8,11,56,34,22,59
Vienna,8581,4,15,9,12,52,46,6,54
RZ Pellets W,8581,5,14,8,14,50,53,-3,50
Rapid Vienna,8581,6,11,15,10,57,43,14,48
Admira Wacke,8581,7,12,8,16,38,57,-19,44
SV Josko Rie,8581,8,11,6,19,33,48,-15,39
St. Pölten,8581,9,8,9,19,40,63,-23,33
Mattersburg,8581,10,7,11,18,36,58,-22,32
FC Salzburg,8582,1,20,10,6,60,26,34,70
SC Rheindorf,8582,2,18,12,6,56,40,16,66
Vienna,8582,3,19,7,10,67,49,18,64
Rapid Vienna,8582,4,15,11,10,55,39,16,56
SK Sturm Gra,8582,5,15,7,14,56,42,14,52
Admira Wacke,8582,6,13,5,18,40,66,-26,44
RZ Pellets W,8582,7,11,6,19,48,59,-11,39
SV Josko Rie,8582,8,9,9,18,36,52,-16,36
Mattersburg,8582,9,9,9,18,41,58,-17,36
St. Pölten,8582,10,8,10,18,38,66,-28,34
SC Rheindorf,8583,1,21,6,9,59,43,16,69
FC Salzburg,8583,2,20,5,11,59,36,23,65
SK Sturm Gra,8583,3,19,5,12,67,45,22,62
Vienna,8583,4,18,7,11,60,44,16,61
RZ Pellets W,8583,5,15,7,14,55,54,1,52
Rapid Vienna,8583,6,11,13,12,60,45,15,46
Admira Wacke,8583,7,11,8,17,35,57,-22,41
Mattersburg,8583,8,9,13,14,36,51,-15,40
SV Josko Rie,8583,9,10,5,21,35,59,-24,35
St. Pölten,8583,10,6,11,19,43,75,-32,29
Vienna,8584,1,21,6,9,73,48,25,69
SC Rheindorf,8584,2,21,5,10,56,42,14,68
SK Sturm Gra,8584,3,20,6,10,62,35,27,66
FC Salzburg,8584,4,20,6,10,57,34,23,66
RZ Pellets W,8584,5,14,9,13,54,57,-3,51
Rapid Vienna,8584,6,13,9,14,53,43,10,48
Admira Wacke,8584,7,11,8,17,36,61,-25,41
St. Pölten,8584,8,9,9,18,45,63,-18,36
SV Josko Rie,8584,9,10,6,20,37,58,-21,36
Mattersburg,8584,10,5,8,23,34,66,-32,23
FC Salzburg,8585,1,22,7,7,73,34,39,73
Vienna,8585,2,21,5,10,64,46,18,68
SC Rheindorf,8585,3,19,6,11,53,49,4,63
SK Sturm Gra,8585,4,17,8,11,54,36,18,59
Rapid Vienna,8585,5,13,12,11,55,40,15,51
RZ Pellets W,8585,6,14,7,15,49,51,-2,49
Admira Wacke,8585,7,9,9,18,31,60,-29,36
SV Josko Rie,8585,8,10,5,21,38,63,-25,35
Mattersburg,8585,9,8,9,19,38,56,-18,33
St. Pölten,8585,10,7,12,17,47,67,-20,33
SC Rheindorf,8586,1,22,7,7,63,40,23,73
FC Salzburg,8586,2,22,6,8,72,32,40,72
Vienna,8586,3,20,4,12,67,54,13,64
SK Sturm Gra,8586,4,20,3,13,60,45,15,63
Rapid Vienna,8586,5,14,10,12,52,40,12,52
RZ Pellets W,8586,6,12,7,17,46,58,-12,43
Admira Wacke,8586,7,12,6,18,48,61,-13,42
SV Josko Rie,8586,8,10,8,18,35,55,-20,38
St. Pölten,8586,9,7,9,20,42,77,-35,30
Mattersburg,8586,10,7,8,21,37,60,-23,29
SK Sturm Gra,8587,1,21,5,10,64,29,35,68
FC Salzburg,8587,2,20,8,8,63,29,34,68
Vienna,8587,3,17,12,7,63,45,18,63
SC Rheindorf,8587,4,18,8,10,55,44,11,62
Rapid Vienna,8587,5,12,13,11,58,41,17,49
RZ Pellets W,8587,6,13,10,13,41,49,-8,49
St. Pölten,8587,7,9,11,16,45,66,-21,38
Admira Wacke,8587,8,10,8,18,38,64,-26,38
SV Josko Rie,8587,9,9,6,21,31,62,-31,33
Mattersburg,8587,10,6,9,21,32,61,-29,27
FC Salzburg,8588,1,21,10,5,68,31,37,73
SK Sturm Gra,8588,2,22,7,7,65,31,34,73
SC Rheindorf,8588,3,17,8,11,56,52,4,59
Vienna,8588,4,16,7,13,62,61,1,55
Rapid Vienna,8588,5,14,9,13,48,40,8,51
RZ Pellets W,8588,6,13,7,16,52,53,-1,46
SV Josko Rie,8588,7,12,7,17,42,52,-10,43
St. Pölten,8588,8,7,13,16,36,59,-23,34
Admira Wacke,8588,9,9,7,20,33,56,-23,34
Mattersburg,8588,10,6,11,19,32,59,-27,29
SK Sturm Gra,8589,1,23,4,9,60,33,27,73
SC Rheindorf,8589,2,20,8,8,59,42,17,68
Vienna,8589,3,20,4,12,71,50,21,64
FC Salzburg,8589,4,18,8,10,66,35,31,62
Rapid Vienna,8589,5,14,11,11,62,45,17,53
Admira Wacke,8589,6,12,7,17,42,66,-24,43
RZ Pellets W,8589,7,12,6,18,50,57,-7,42
Mattersburg,8589,8,10,6,20,43,67,-24,36
SV Josko Rie,8589,9,10,5,21,30,58,-28,35
St. Pölten,8589,10,8,7,21,40,70,-30,31
FC Salzburg,8590,1,24,6,6,76,31,45,78
SK Sturm Gra,8590,2,20,6,10,57,37,20,66
SC Rheindorf,8590,3,19,8,9,55,40,15,65
Vienna,8590,4,19,4,13,63,54,9,61
Rapid Vienna,8590,5,15,12,9,54,39,15,57
Admira Wacke,8590,6,14,4,18,36,55,-19,46
St. Pölten,8590,7,11,6,19,45,62,-17,39
RZ Pellets W,8590,8,11,5,20,37,54,-17,38
SV Josko Rie,8590,9,9,5,22,28,53,-25,32
Mattersburg,8590,10,6,8,22,35,61,-26,26
FC Salzburg,8591,1,22,7,7,72,37,35,73
Vienna,8591,2,21,2,13,63,51,12,65
Rapid Vienna,8591,3,18,10,8,61,34,27,64
SK Sturm Gra,8591,4,20,4,12,54,31,23,64
SC Rheindorf,8591,5,18,6,12,58,52,6,60
Admira Wacke,8591,6,12,7,17,39,58,-19,43
St. Pölten,8591,7,10,10,16,42,58,-16,40
SV Josko Rie,8591,8,12,4,20,40,56,-16,40
RZ Pellets W,8591,9,9,8,19,38,60,-22,35
Mattersburg,8591,10,5,8,23,30,60,-30,23
FC Salzburg,8592,1,21,6,9,62,33,29,69
SC Rheindorf,8592,2,20,7,9,59,38,21,67
SK Sturm Gra,8592,3,19,5,12,61,39,22,62
Rapid Vienna,8592,4,16,9,11,60,37,23,57
Vienna,8592,5,17,5,14,64,58,6,56
Admira Wacke,8592,6,13,4,19,37,68,-31,43
RZ Pellets W,8592,7,11,8,17,49,61,-12,41
St. Pölten,8592,8,9,11,16,48,63,-15,38
SV Josko Rie,8592,9,10,6,20,38,59,-21,36
Mattersburg,8592,10,9,9,18,37,59,-22,36
SC Rheindorf,8593,1,23,4,9,57,37,20,73
SK Sturm Gra,8593,2,21,7,8,63,33,30,70
FC Salzburg,8593,3,20,7,9,57,30,27,67
Vienna,8593,4,16,6,14,55,53,2,54
Rapid Vienna,8593,5,12,11,13,58,47,11,47
RZ Pellets W,8593,6,11,12,13,46,53,-7,45
St. Pölten,8593,7,11,9,16,46,58,-12,42
Admira Wacke,8593,8,11,6,19,39,69,-30,39
Mattersburg,8593,9,9,9,18,38,51,-13,36
SV Josko Rie,8593,10,8,5,23,26,54,-28,29
SK Sturm Gra,8594,1,21,4,11,54,30,24,67
FC Salzburg,8594,2,19,7,10,63,35,28,64
Vienna,8594,3,19,6,11,67,48,19,63
SC Rheindorf,8594,4,17,8,11,55,46,9,59
Rapid Vienna,8594,5,13,10,13,66,48,18,49
Admira Wacke,8594,6,11,11,14,34,50,-16,44
SV Josko Rie,8594,7,11,7,18,38,52,-14,40
Mattersburg,8594,8,11,7,18,43,63,-20,40
St. Pölten,8594,9,10,9,17,44,65,-21,39
RZ Pellets W,8594,10,11,5,20,44,71,-27,38
FC Salzburg,8595,1,20,8,8,62,31,31,68
Vienna,8595,2,21,3,12,70,49,21,66
SC Rheindorf,8595,3,20,5,11,60,43,17,65
SK Sturm Gra,8595,4,20,4,12,62,40,22,64
Rapid Vienna,8595,5,12,11,13,47,41,6,47
RZ Pellets W,8595,6,12,8,16,43,59,-16,44
Mattersburg,8595,7,12,7,17,41,50,-9,43
SV Josko Rie,8595,8,12,5,19,35,53,-18,41
Admira Wacke,8595,9,12,5,19,38,58,-20,41
St. Pölten,8595,10,7,8,21,37,71,-34,29
FC Salzburg,8596,1,20,10,6,65,34,31,70
SK Sturm Gra,8596,2,19,9,8,54,31,23,66
Rapid Vienna,8596,3,16,12,8,57,36,21,60
Vienna,8596,4,18,6,12,56,48,8,60
SC Rheindorf,8596,5,17,8,11,48,41,7,59
SV Josko Rie,8596,6,12,8,16,36,46,-10,44
RZ Pellets W,8596,7,10,10,16,40,51,-11,40
Admira Wacke,8596,8,9,10,17,41,59,-18,37
Mattersburg,8596,9,6,10,20,32,56,-24,28
St. Pölten,8596,10,4,15,17,32,59,-27,27
FC Salzburg,8597,1,21,8,7,69,31,38,71
SC Rheindorf,8597,2,21,6,9,53,35,18,69
SK Sturm Gra,8597,3,19,7,10,50,33,17,64
Vienna,8597,4,19,6,11,62,45,17,63
Rapid Vienna,8597,5,14,11,11,53,38,15,53
Admira Wacke,8597,6,13,6,17,40,54,-14,45
Mattersburg,8597,7,11,9,16,33,43,-10,42
RZ Pellets W,8597,8,11,7,18,40,58,-18,40
SV Josko Rie,8597,9,10,3,23,28,55,-27,33
St. Pölten,8597,10,6,7,23,36,72,-36,25
FC Salzburg,8598,1,23,7,6,75,28,47,76
SK Sturm Gra,8598,2,21,6,9,65,37,28,69
SC Rheindorf,8598,3,18,8,10,52,49,3,62
Vienna,8598,4,17,5,14,67,61,6,56
RZ Pellets W,8598,5,13,10,13,48,51,-3,49
Rapid Vienna,8598,6,11,12,13,51,47,4,45
Admira Wacke,8598,7,11,7,18,35,59,-24,40
SV Josko Rie,8598,8,9,7,20,35,55,-20,34
St. Pölten,8598,9,8,10,18,43,64,-21,34
Mattersburg,8598,10,6,14,16,37,57,-20,32
SK Sturm Gra,8599,1,20,7,9,53,32,21,67
Vienna,8599,2,19,9,8,67,47,20,66
FC Salzburg,8599,3,18,8,10,62,32,30,62
SC Rheindorf,8599,4,16,10,10,47,40,7,58
Rapid Vienna,8599,5,13,10,13,56,46,10,49
St. Pölten,8599,6,12,8,16,46,58,-12,44
RZ Pellets W,8599,7,11,8,17,46,58,-12,41
Admira Wacke,8599,8,10,8,18,33,55,-22,38
Mattersburg,8599,9,9,10,17,38,54,-16,37
SV Josko Rie,8599,10,11,4,21,38,64,-26,37
FC Salzburg,8600,1,24,5,7,71,25,46,77
Vienna,8600,2,20,6,10,73,55,18,66
SC Rheindorf,8600,3,19,9,8,57,43,14,66
SK Sturm Gra,8600,4,18,7,11,60,45,15,61
Rapid Vienna,8600,5,14,13,9,57,38,19,55
RZ Pellets W,8600,6,10,12,14,44,58,-14,42
St. Pölten,8600,7,8,11,17,35,55,-20,35
Mattersburg,8600,8,8,9,19,38,61,-23,33
Admira Wacke,8600,9,8,9,19,35,66,-31,33
SV Josko Rie,8600,10,8,5,23,24,48,-24,29
FC Salzburg,8601,1,20,8,8,69,32,37,68
Vienna,8601,2,18,9,9,61,47,14,63
SK Sturm Gra,8601,3,18,5,13,59,40,19,59
Rapid Vienna,8601,4,16,11,9,54,37,17,59
SC Rheindorf,8601,5,17,8,11,50,43,7,59
RZ Pellets W,8601,6,11,7,18,40,59,-19,40
Admira Wacke,8601,7,12,4,20,37,62,-25,40
Mattersburg,8601,8,9,12,15,38,53,-15,39
SV Josko Rie,8601,9,10,8,18,41,54,-13,38
St. Pölten,8601,10,7,12,17,36,58,-22,33
FC Salzburg,8602,1,21,9,6,70,23,47,72
SK Sturm Gra,8602,2,18,8,10,56,37,19,62
Vienna,8602,3,18,8,10,61,46,15,62
SC Rheindorf,8602,4,18,8,10,51,42,9,62
Rapid Vienna,8602,5,12,15,9,51,41,10,51
RZ Pellets W,8602,6,12,10,14,49,53,-4,46
St. Pölten,8602,7,11,10,15,39,55,-16,43
Admira Wacke,8602,8,12,6,18,34,55,-21,42
SV Josko Rie,8602,9,8,6,22,28,57,-29,30
Mattersburg,8602,10,6,8,22,28,58,-30,26
FC Salzburg,8603,1,24,4,8,67,25,42,76
SC Rheindorf,8603,2,21,5,10,51,44,7,68
Vienna,8603,3,20,4,12,66,52,14,64
SK Sturm Gra,8603,4,18,6,12,57,36,21,60
Rapid Vienna,8603,5,16,10,10,57,41,16,58
SV Josko Rie,8603,6,13,3,20,33,46,-13,42
RZ Pellets W,8603,7,12,6,18,39,56,-17,42
St. Pölten,8603,8,9,8,19,43,64,-21,35
Mattersburg,8603,9,9,6,21,37,55,-18,33
Admira Wacke,8603,10,8,8,20,35,66,-31,32
FC Salzburg,8604,1,20,9,7,64,32,32,69
SK Sturm Gra,8604,2,20,8,8,57,32,25,68
SC Rheindorf,8604,3,20,6,10,57,45,12,66
Vienna,8604,4,19,5,12,63,48,15,62
Rapid Vienna,8604,5,15,12,9,61,41,20,57
Admira Wacke,8604,6,11,7,18,31,56,-25,40
St. Pölten,8604,7,9,11,16,40,57,-17,38
RZ Pellets W,8604,8,10,7,19,43,60,-17,37
SV Josko Rie,8604,9,10,5,21,35,56,-21,35
Mattersburg,8604,10,7,8,21,35,59,-24,29
SK Sturm Gra,8605,1,22,7,7,61,24,37,73
FC Salzburg,8605,2,18,10,8,57,26,31,64
SC Rheindorf,8605,3,18,9,9,50,41,9,63
Vienna,8605,4,18,8,10,55,45,10,62
Rapid Vienna,8605,5,14,13,9,49,33,16,55
Mattersburg,8605,6,10,9,17,38,49,-11,39
SV Josko Rie,8605,7,11,6,19,33,50,-17,39
RZ Pellets W,8605,8,8,11,17,34,53,-19,35
Admira Wacke,8605,9,9,7,20,31,61,-30,34
St. Pölten,8605,10,8,8,20,37,63,-26,32
Vienna,8606,1,22,5,9,67,51,16,71
SK Sturm Gra,8606,2,19,5,12,55,35,20,62
FC Salzburg,8606,3,17,9,10,58,33,25,60
SC Rheindorf,8606,4,17,7,12,53,49,4,58
Rapid Vienna,8606,5,15,9,12,58,39,19,54
RZ Pellets W,8606,6,11,10,15,41,49,-8,43
Mattersburg,8606,7,11,9,16,40,53,-13,42
Admira Wacke,8606,8,12,5,19,37,61,-24,41
SV Josko Rie,8606,9,10,6,20,35,52,-17,36
St. Pölten,8606,10,9,9,18,37,59,-22,36
FC Salzburg,8607,1,21,7,8,70,30,40,70
SC Rheindorf,8607,2,20,10,6,54,32,22,70
Vienna,8607,3,18,6,12,63,55,8,60
SK Sturm Gra,8607,4,16,8,12,54,41,13,56
RZ Pellets W,8607,5,16,5,15,54,53,1,53
Rapid Vienna,8607,6,12,12,12,46,35,11,48
SV Josko Rie,8607,7,11,8,17,33,51,-18,41
Mattersburg,8607,8,9,8,19,36,56,-20,35
Admira Wacke,8607,9,9,7,20,32,60,-28,34
St. Pölten,8607,10,6,13,17,39,68,-29,31
SK Sturm Gra,8608,1,24,5,7,71,39,32,77
FC Salzburg,8608,2,18,11,7,62,34,28,65
SC Rheindorf,8608,3,19,7,10,49,36,13,64
Vienna,8608,4,18,5,13,62,54,8,59
Rapid Vienna,8608,5,15,9,12,59,42,17,54
RZ Pellets W,8608,6,13,7,16,47,51,-4,46
St. Pölten,8608,7,10,10,16,41,63,-22,40
Admira Wacke,8608,8,9,7,20,38,67,-29,34
Mattersburg,8608,9,8,9,19,38,58,-20,33
SV Josko Rie,8608,10,9,4,23,32,55,-23,31
FC Salzburg,8609,1,21,8,7,71,28,43,71
SC Rheindorf,8609,2,20,10,6,57,39,18,70
SK Sturm Gra,8609,3,18,8,10,54,35,19,62
Vienna,8609,4,18,8,10,62,48,14,62
Rapid Vienna,8609,5,14,10,12,54,43,11,52
SV Josko Rie,8609,6,13,5,18,39,55,-16,44
Admira Wacke,8609,7,12,7,17,36,53,-17,43
RZ Pellets W,8609,8,10,10,16,46,58,-12,40
Mattersburg,8609,9,9,7,20,34,53,-19,34
St. Pölten,8609,10,4,9,23,30,71,-41,21
FC Salzburg,8610,1,21,8,7,66,31,35,71
SC Rheindorf,8610,2,20,9,7,59,41,18,69
SK Sturm Gra,8610,3,17,7,12,58,36,22,58
Vienna,8610,4,18,4,14,63,63,0,58
Rapid Vienna,8610,5,13,12,11,61,40,21,51
RZ Pellets W,8610,6,12,9,15,58,61,-3,45
St. Pölten,8610,7,10,10,16,43,60,-17,40
Admira Wacke,8610,8,11,6,19,39,72,-33,39
SV Josko Rie,8610,9,11,5,20,38,54,-16,38
Mattersburg,8610,10,7,10,19,37,64,-27,31
FC Salzburg,8611,1,23,6,7,65,27,38,75
SC Rheindorf,8611,2,21,5,10,61,46,15,68
SK Sturm Gra,8611,3,21,4,11,61,33,28,67
Vienna,8611,4,19,5,12,58,46,12,62
Rapid Vienna,8611,5,15,9,12,53,44,9,54
SV Josko Rie,8611,6,12,4,20,37,52,-15,40
St. Pölten,8611,7,9,11,16,50,64,-14,38
RZ Pellets W,8611,8,9,7,20,39,56,-17,34
Admira Wacke,8611,9,8,10,18,29,57,-28,34
Mattersburg,8611,10,8,9,19,34,62,-28,33
SK Sturm Gra,8612,1,22,6,8,61,32,29,72
FC Salzburg,8612,2,19,11,6,62,28,34,68
SC Rheindorf,8612,3,19,9,8,56,40,16,66
Vienna,8612,4,14,8,14,56,53,3,50
Admira Wacke,8612,5,13,8,15,44,56,-12,47
RZ Pellets W,8612,6,11,12,13,45,49,-4,45
Rapid Vienna,8612,7,10,13,13,45,40,5,43
SV Josko Rie,8612,8,13,4,19,41,58,-17,43
St. Pölten,8612,9,9,8,19,43,68,-25,35
Mattersburg,8612,10,6,9,21,28,57,-29,27
SC Rheindorf,8613,1,22,6,8,59,39,20,72
SK Sturm Gra,8613,2,17,9,10,59,40,19,60
FC Salzburg,8613,3,17,7,12,55,35,20,58
Vienna,8613,4,17,3,16,56,56,0,54
Rapid Vienna,8613,5,13,13,10,56,41,15,52
RZ Pellets W,8613,6,15,7,14,47,47,0,52
Admira Wacke,8613,7,14,8,14,35,45,-10,50
Mattersburg,8613,8,9,9,18,39,57,-18,36
SV Josko Rie,8613,9,10,5,21,34,58,-24,35
St. Pölten,8613,10,7,11,18,43,65,-22,32
SC Rheindorf,8614,1,22,8,6,60,38,22,74
FC Salzburg,8614,2,21,9,6,63,28,35,72
SK Sturm Gra,8614,3,18,7,11,51,35,16,61
Vienna,8614,4,17,5,14,58,53,5,56
Admira Wacke,8614,5,13,7,16,42,58,-16,46
Rapid Vienna,8614,6,11,11,14,53,41,12,44
RZ Pellets W,8614,7,13,5,18,40,53,-13,44
St. Pölten,8614,8,10,8,18,39,58,-19,38
SV Josko Rie,8614,9,9,7,20,35,55,-20,34
Mattersburg,8614,10,8,9,19,33,55,-22,33
FC Salzburg,8615,1,21,8,7,62,26,36,71
SC Rheindorf,8615,2,19,9,8,54,37,17,66
SK Sturm Gra,8615,3,19,6,11,59,29,30,63
Vienna,8615,4,16,7,13,58,56,2,55
Rapid Vienna,8615,5,13,11,12,52,42,10,50
RZ Pellets W,8615,6,11,10,15,47,55,-8,43
St. Pölten,8615,7,11,9,16,47,66,-19,42
Mattersburg,8615,8,11,7,18,40,54,-14,40
Admira Wacke,8615,9,11,5,20,37,69,-32,38
SV Josko Rie,8615,10,8,8,20,34,56,-22,32
FC Salzburg,8616,1,22,8,6,64,31,33,74
SK Sturm Gra,8616,2,20,6,10,58,35,23,66
SC Rheindorf,8616,3,19,5,12,62,49,13,62
Vienna,8616,4,18,7,11,64,49,15,61
Rapid Vienna,8616,5,14,9,13,57,45,12,51
RZ Pellets W,8616,6,14,6,16,48,58,-10,48
SV Josko Rie,8616,7,11,7,18,38,54,-16,40
Admira Wacke,8616,8,11,7,18,42,60,-18,40
Mattersburg,8616,9,9,6,21,34,58,-24,33
St. Pölten,8616,10,7,9,20,38,66,-28,30
SK Sturm Gra,8617,1,25,4,7,63,23,40,79
SC Rheindorf,8617,2,21,6,9,59,33,26,69
FC Salzburg,8617,3,19,7,10,59,30,29,64
Vienna,8617,4,16,4,16,52,57,-5,52
Rapid Vienna,8617,5,12,11,13,48,40,8,47
RZ Pellets W,8617,6,12,8,16,45,59,-14,44
Admira Wacke,8617,7,12,7,17,32,55,-23,43
SV Josko Rie,8617,8,11,5,20,31,51,-20,38
Mattersburg,8617,9,9,9,18,39,56,-17,36
St. Pölten,8617,10,7,11,18,40,64,-24,32
FC Salzburg,8618,1,23,5,8,72,34,38,74
SC Rheindorf,8618,2,21,5,10,66,44,22,68
Vienna,8618,3,20,5,11,58,44,14,65
SK Sturm Gra,8618,4,20,4,12,62,36,26,64
RZ Pellets W,8618,5,16,7,13,50,49,1,55
Rapid Vienna,8618,6,12,10,14,50,39,11,46
Admira Wacke,8618,7,10,8,18,38,71,-33,38
Mattersburg,8618,8,9,9,18,36,57,-21,36
SV Josko Rie,8618,9,9,4,23,32,63,-31,31
St. Pölten,8618,10,6,11,19,42,69,-27,29
SK Sturm Gra,8619,1,22,5,9,64,33,31,71
FC Salzburg,8619,2,20,8,8,63,31,32,68
Vienna,8619,3,18,5,13,63,51,12,59
SC Rheindorf,8619,4,16,11,9,51,41,10,59
Rapid Vienna,8619,5,14,9,13,57,44,13,51
St. Pölten,8619,6,13,7,16,46,62,-16,46
Admira Wacke,8619,7,12,7,17,40,59,-19,43
RZ Pellets W,8619,8,11,7,18,42,61,-19,40
Mattersburg,8619,9,9,8,19,39,58,-19,35
SV Josko Rie,8619,10,9,5,22,35,60,-25,32
FC Salzburg,8620,1,24,6,6,72,28,44,78
SK Sturm Gra,8620,2,21,4,11,70,34,36,67
Rapid Vienna,8620,3,16,9,11,57,39,18,57
SC Rheindorf,8620,4,17,5,14,53,56,-3,56
Vienna,8620,5,17,4,15,62,57,5,55
RZ Pellets W,8620,6,15,7,14,50,58,-8,52
SV Josko Rie,8620,7,12,4,20,33,50,-17,40
Mattersburg,8620,8,10,8,18,44,52,-8,38
Admira Wacke,8620,9,11,4,21,36,73,-37,37
St. Pölten,8620,10,8,7,21,38,68,-30,31
FC Salzburg,8621,1,20,10,6,63,27,36,70
SC Rheindorf,8621,2,18,9,9,52,40,12,63
SK Sturm Gra,8621,3,16,10,10,58,39,19,58
Rapid Vienna,8621,4,15,12,9,57,34,23,57
Vienna,8621,5,17,5,14,61,57,4,56
RZ Pellets W,8621,6,15,6,15,54,57,-3,51
SV Josko Rie,8621,7,12,8,16,35,48,-13,44
Admira Wacke,8621,8,10,9,17,33,55,-22,39
St. Pölten,8621,9,9,10,17,38,59,-21,37
Mattersburg,8621,10,4,9,23,31,66,-35,21
FC Salzburg,8622,1,21,5,10,73,37,36,68
SK Sturm Gra,8622,2,20,5,11,60,39,21,65
SC Rheindorf,8622,3,19,6,11,55,43,12,63
Rapid Vienna,8622,4,17,9,10,60,38,22,60
Vienna,8622,5,17,5,14,63,59,4,56
RZ Pellets W,8622,6,15,5,16,48,54,-6,50
Admira Wacke,8622,7,14,5,17,43,55,-12,47
Mattersburg,8622,8,9,8,19,34,56,-22,35
St. Pölten,8622,9,8,10,18,38,65,-27,34
SV Josko Rie,8622,10,9,4,23,30,58,-28,31
FC Salzburg,8623,1,22,6,8,62,34,28,72
Vienna,8623,2,20,5,11,65,49,16,65
SK Sturm Gra,8623,3,19,7,10,72,42,30,64
SC Rheindorf,8623,4,17,7,12,59,49,10,58
Rapid Vienna,8623,5,13,11,12,54,42,12,50
RZ Pellets W,8623,6,13,8,15,52,57,-5,47
SV Josko Rie,8623,7,13,6,17,40,54,-14,45
Admira Wacke,8623,8,9,9,18,36,64,-28,36
St. Pölten,8623,9,6,14,16,37,62,-25,32
Mattersburg,8623,10,7,9,20,33,57,-24,30
SC Rheindorf,8624,1,22,6,8,58,38,20,72
FC Salzburg,8624,2,21,8,7,68,31,37,71
SK Sturm Gra,8624,3,20,7,9,56,30,26,67
RZ Pellets W,8624,4,18,4,14,47,44,3,58
Vienna,8624,5,16,6,14,52,51,1,54
Admira Wacke,8624,6,12,7,17,38,54,-16,43
Rapid Vienna,8624,7,10,10,16,40,42,-2,40
SV Josko Rie,8624,8,11,5,20,38,55,-17,38
Mattersburg,8624,9,8,8,20,35,58,-23,32
St. Pölten,8624,10,7,9,20,35,64,-29,30
FC Salzburg,8625,1,20,9,7,57,30,27,69
Vienna,8625,2,21,4,11,63,41,22,67
SK Sturm Gra,8625,3,20,6,10,57,33,24,66
SC Rheindorf,8625,4,19,8,9,53,42,11,65
Rapid Vienna,8625,5,11,11,14,50,44,6,44
RZ Pellets W,8625,6,12,8,16,47,57,-10,44
St. Pölten,8625,7,10,10,16,45,65,-20,40
SV Josko Rie,8625,8,11,4,21,33,48,-15,37
Admira Wacke,8625,9,10,7,19,31,55,-24,37
Mattersburg,8625,10,9,7,20,32,53,-21,34
SC Rheindorf,8626,1,21,6,9,62,42,20,69
FC Salzburg,8626,2,20,6,10,66,33,33,66
SK Sturm Gra,8626,3,19,7,10,54,30,24,64
Vienna,8626,4,19,4,13,63,53,10,61
Rapid Vienna,8626,5,15,10,11,60,39,21,55
RZ Pellets W,8626,6,12,6,18,42,64,-22,42
St. Pölten,8626,7,10,11,15,42,61,-19,41
Mattersburg,8626,8,10,8,18,39,52,-13,38
Admira Wacke,8626,9,10,8,18,35,60,-25,38
SV Josko Rie,8626,10,8,6,22,33,62,-29,30
Vienna,8627,1,21,4,11,69,52,17,67
SC Rheindorf,8627,2,20,7,9,57,42,15,67
FC Salzburg,8627,3,19,9,8,61,31,30,66
SK Sturm Gra,8627,4,17,8,11,61,40,21,59
Rapid Vienna,8627,5,14,14,8,59,38,21,56
RZ Pellets W,8627,6,15,8,13,49,48,1,53
St. Pölten,8627,7,8,12,16,40,58,-18,36
SV Josko Rie,8627,8,10,5,21,36,60,-24,35
Mattersburg,8627,9,9,6,21,39,60,-21,33
Admira Wacke,8627,10,7,7,22,28,70,-42,28
SC Rheindorf,8628,1,21,8,7,57,34,23,71
FC Salzburg,8628,2,21,5,10,66,33,33,68
SK Sturm Gra,8628,3,19,4,13,55,41,14,61
Vienna,8628,4,19,4,13,63,52,11,61
Rapid Vienna,8628,5,14,8,14,55,48,7,50
RZ Pellets W,8628,6,14,6,16,48,49,-1,48
Admira Wacke,8628,7,13,7,16,49,58,-9,46
SV Josko Rie,8628,8,12,5,19,40,57,-17,41
St. Pölten,8628,9,6,13,17,39,65,-26,31
Mattersburg,8628,10,7,8,21,28,63,-35,29
SK Sturm Gra,8629,1,20,8,8,60,25,35,68
SC Rheindorf,8629,2,21,4,11,52,43,9,67
FC Salzburg,8629,3,18,10,8,60,28,32,64
Vienna,8629,4,16,9,11,63,53,10,57
Rapid Vienna,8629,5,14,11,11,46,34,12,53
Admira Wacke,8629,6,13,4,19,34,53,-19,43
RZ Pellets W,8629,7,10,10,16,43,53,-10,40
St. Pölten,8629,8,10,10,16,39,57,-18,40
SV Josko Rie,8629,9,9,7,20,31,56,-25,34
Mattersburg,8629,10,8,9,19,29,55,-26,33
SC Rheindorf,8630,1,22,5,9,62,48,14,71
FC Salzburg,8630,2,17,11,8,62,35,27,62
Vienna,8630,3,17,10,9,62,46,16,61
SK Sturm Gra,8630,4,18,6,12,65,41,24,60
Rapid Vienna,8630,5,15,11,10,57,40,17,56
Mattersburg,8630,6,12,9,15,41,47,-6,45
Admira Wacke,8630,7,12,5,19,33,54,-21,41
RZ Pellets W,8630,8,10,8,18,36,58,-22,38
St. Pölten,8630,9,8,9,19,45,74,-29,33
SV Josko Rie,8630,10,8,8,20,31,51,-20,32
FC Salzburg,8631,1,22,6,8,66,33,33,72
SK Sturm Gra,8631,2,22,5,9,71,36,35,71
Vienna,8631,3,21,3,12,66,49,17,66
SC Rheindorf,8631,4,16,6,14,44,45,-1,54
Rapid Vienna,8631,5,15,8,13,60,48,12,53
Mattersburg,8631,6,14,5,17,47,53,-6,47
Admira Wacke,8631,7,13,5,18,37,54,-17,44
RZ Pellets W,8631,8,11,8,17,45,65,-20,41
SV Josko Rie,8631,9,10,4,22,31,50,-19,34
St. Pölten,8631,10,7,8,21,36,70,-34,29
FC Salzburg,8632,1,20,8,8,60,31,29,68
SK Sturm Gra,8632,2,19,4,13,54,43,11,61
SC Rheindorf,8632,3,17,8,11,52,46,6,59
Vienna,8632,4,16,10,10,63,52,11,58
Rapid Vienna,8632,5,14,11,11,51,40,11,53
RZ Pellets W,8632,6,12,10,14,50,52,-2,46
St. Pölten,8632,7,10,11,15,51,64,-13,41
Mattersburg,8632,8,10,9,17,38,49,-11,39
SV Josko Rie,8632,9,10,6,20,38,58,-20,36
Admira Wacke,8632,10,9,9,18,34,56,-22,36
FC Salzburg,8633,1,24,5,7,73,30,43,77
SC Rheindorf,8633,2,19,8,9,58,46,12,65
SK Sturm Gra,8633,3,17,7,12,56,40,16,58
Vienna,8633,4,17,6,13,61,56,5,57
Rapid Vienna,8633,5,13,12,11,50,39,11,51
Admira Wacke,8633,6,12,6,18,40,59,-19,42
RZ Pellets W,8633,7,11,8,17,46,60,-14,41
St. Pölten,8633,8,9,11,16,46,58,-12,38
Mattersburg,8633,9,10,7,19,39,58,-19,37
SV Josko Rie,8633,10,9,8,19,29,52,-23,35
SC Rheindorf,8634,1,24,7,5,67,38,29,79
FC Salzburg,8634,2,21,9,6,72,33,39,72
Vienna,8634,3,20,4,12,63,59,4,64
SK Sturm Gra,8634,4,17,7,12,56,40,16,58
RZ Pellets W,8634,5,15,8,13,54,52,2,53
Admira Wacke,8634,6,11,7,18,45,66,-21,40
SV Josko Rie,8634,7,12,2,22,38,56,-18,38
Mattersburg,8634,8,9,7,20,41,58,-17,34
St. Pölten,8634,9,8,10,18,37,64,-27,34
Rapid Vienna,8634,10,7,11,18,47,54,-7,32
FC Salzburg,8635,1,22,7,7,64,30,34,73
SK Sturm Gra,8635,2,20,6,10,59,33,26,66
SC Rheindorf,8635,3,19,8,9,53,42,11,65
Vienna,8635,4,16,9,11,56,46,10,57
Rapid Vienna,8635,5,13,11,12,52,39,13,50
Admira Wacke,8635,6,13,7,16,42,56,-14,46
RZ Pellets W,8635,7,10,11,15,43,54,-11,41
SV Josko Rie,8635,8,11,8,17,32,51,-19,41
Mattersburg,8635,9,8,10,18,39,58,-19,34
St. Pölten,8635,10,5,9,22,43,74,-31,24
SC Rheindorf,8636,1,22,6,8,62,38,24,72
SK Sturm Gra,8636,2,22,5,9,65,31,34,71
FC Salzburg,8636,3,18,9,9,55,30,25,63
Vienna,8636,4,17,5,14,53,46,7,56
RZ Pellets W,8636,5,15,7,14,46,51,-5,52
Admira Wacke,8636,6,13,7,16,35,51,-16,46
Rapid Vienna,8636,7,10,12,14,49,44,5,42
SV Josko Rie,8636,8,11,5,20,36,56,-20,38
Mattersburg,8636,9,9,9,18,37,54,-17,36
St. Pölten,8636,10,6,9,21,37,74,-37,27
FC Salzburg,8637,1,22,7,7,69,31,38,73
SK Sturm Gra,8637,2,22,5,9,67,36,31,71
SC Rheindorf,8637,3,20,8,8,61,44,17,68
Vienna,8637,4,19,3,14,62,55,7,60
Rapid Vienna,8637,5,12,11,13,53,40,13,47
RZ Pellets W,8637,6,13,5,18,45,53,-8,44
SV Josko Rie,8637,7,13,3,20,34,51,-17,42
Admira Wacke,8637,8,12,4,20,34,62,-28,40
Mattersburg,8637,9,9,7,20,37,56,-19,34
St. Pölten,8637,10,7,9,20,29,63,-34,30
FC Salzburg,8638,1,22,8,6,64,26,38,74
SC Rheindorf,8638,2,21,7,8,63,41,22,70
SK Sturm Gra,8638,3,20,5,11,58,32,26,65
Vienna,8638,4,20,5,11,66,49,17,65
Rapid Vienna,8638,5,16,9,11,58,45,13,57
RZ Pellets W,8638,6,14,4,18,46,58,-12,46
SV Josko Rie,8638,7,12,6,18,36,55,-19,42
Mattersburg,8638,8,7,10,19,31,51,-20,31
Admira Wacke,8638,9,8,5,23,31,67,-36,29
St. Pölten,8638,10,7,7,22,42,71,-29,28
SK Sturm Gra,8639,1,23,5,8,67,31,36,74
SC Rheindorf,8639,2,22,7,7,60,39,21,73
FC Salzburg,8639,3,20,6,10,62,36,26,66
Rapid Vienna,8639,4,13,12,11,51,42,9,51
Vienna,8639,5,15,4,17,53,51,2,49
SV Josko Rie,8639,6,14,4,18,41,50,-9,46
RZ Pellets W,8639,7,11,9,16,46,54,-8,42
Admira Wacke,8639,8,9,11,16,33,54,-21,38
Mattersburg,8639,9,8,9,19,34,58,-24,33
St. Pölten,8639,10,6,11,19,38,70,-32,29
SK Sturm Gra,8640,1,20,8,8,63,35,28,68
Vienna,8640,2,21,3,12,68,51,17,66
FC Salzburg,8640,3,19,7,10,61,34,27,64
Rapid Vienna,8640,4,16,12,8,58,39,19,60
SC Rheindorf,8640,5,16,10,10,53,48,5,58
St. Pölten,8640,6,11,7,18,48,65,-17,40
SV Josko Rie,8640,7,11,6,19,40,55,-15,39
Admira Wacke,8640,8,10,7,19,33,61,-28,37
Mattersburg,8640,9,9,9,18,42,56,-14,36
RZ Pellets W,8640,10,9,7,20,41,63,-22,34
SC Rheindorf,8641,1,19,8,9,52,48,4,65
FC Salzburg,8641,2,19,6,11,68,39,29,63
Vienna,8641,3,19,6,11,65,49,16,63
SK Sturm Gra,8641,4,18,7,11,56,35,21,61
Rapid Vienna,8641,5,15,11,10,60,45,15,56
St. Pölten,8641,6,11,11,14,47,55,-8,44
RZ Pellets W,8641,7,11,10,15,43,55,-12,43
SV Josko Rie,8641,8,12,4,20,38,54,-16,40
Admira Wacke,8641,9,10,7,19,31,56,-25,37
Mattersburg,8641,10,7,8,21,34,58,-24,29
FC Salzburg,8642,1,21,7,8,70,38,32,70
SC Rheindorf,8642,2,19,8,9,59,51,8,65
Vienna,8642,3,19,5,12,70,64,6,62
SK Sturm Gra,8642,4,17,8,11,57,35,22,59
Rapid Vienna,8642,5,13,14,9,54,37,17,53
RZ Pellets W,8642,6,15,8,13,56,56,0,53
SV Josko Rie,8642,7,12,4,20,45,57,-12,40
Admira Wacke,8642,8,9,8,19,36,60,-24,35
Mattersburg,8642,9,9,7,20,37,59,-22,34
St. Pölten,8642,10,6,11,19,35,62,-27,29
FC Salzburg,8643,1,23,7,6,69,32,37,76
SC Rheindorf,8643,2,21,5,10,58,46,12,68
SK Sturm Gra,8643,3,19,7,10,62,37,25,64
Vienna,8643,4,19,5,12,72,53,19,62
Rapid Vienna,8643,5,11,10,15,46,43,3,43
Admira Wacke,8643,6,12,7,17,41,56,-15,43
St. Pölten,8643,7,11,10,15,45,61,-16,43
RZ Pellets W,8643,8,10,9,17,40,57,-17,39
Mattersburg,8643,9,10,7,19,37,50,-13,37
SV Josko Rie,8643,10,7,7,22,31,66,-35,28
FC Salzburg,8644,1,21,9,6,68,30,38,72
SC Rheindorf,8644,2,20,8,8,58,43,15,68
SK Sturm Gra,8644,3,19,9,8,60,30,30,66
Rapid Vienna,8644,4,15,11,10,55,36,19,56
Vienna,8644,5,17,4,15,64,56,8,55
SV Josko Rie,8644,6,13,4,19,35,51,-16,43
RZ Pellets W,8644,7,11,7,18,44,62,-18,40
Admira Wacke,8644,8,11,7,18,37,55,-18,40
St. Pölten,8644,9,8,9,19,42,72,-30,33
Mattersburg,8644,10,8,6,22,32,60,-28,30
SC Rheindorf,8645,1,24,4,8,62,47,15,76
FC Salzburg,8645,2,20,6,10,66,35,31,66
SK Sturm Gra,8645,3,20,6,10,64,36,28,66
Vienna,8645,4,19,4,13,67,56,11,61
RZ Pellets W,8645,5,14,6,16,49,55,-6,48
Rapid Vienna,8645,6,12,11,13,52,46,6,47
Mattersburg,8645,7,12,8,16,48,57,-9,44
Admira Wacke,8645,8,12,5,19,37,59,-22,41
St. Pölten,8645,9,8,9,19,40,64,-24,33
SV Josko Rie,8645,10,6,7,23,24,54,-30,25
FC Salzburg,8646,1,23,5,8,67,32,35,74
SK Sturm Gra,8646,2,19,7,10,65,35,30,64
SC Rheindorf,8646,3,19,7,10,51,41,10,64
Vienna,8646,4,18,5,13,61,50,11,59
RZ Pellets W,8646,5,16,5,15,58,56,2,53
Rapid Vienna,8646,6,12,10,14,49,43,6,46
Admira Wacke,8646,7,13,6,17,35,56,-21,45
Mattersburg,8646,8,11,8,17,41,63,-22,41
SV Josko Rie,8646,9,9,6,21,27,47,-20,33
St. Pölten,8646,10,5,11,20,37,68,-31,26
SK Sturm Gra,8647,1,21,5,10,57,35,22,68
FC Salzburg,8647,2,19,8,9,63,38,25,65
SC Rheindorf,8647,3,16,14,6,53,39,14,62
Vienna,8647,4,18,6,12,63,52,11,60
Rapid Vienna,8647,5,15,11,10,58,40,18,56
RZ Pellets W,8647,6,11,8,17,41,56,-15,41
Admira Wacke,8647,7,11,8,17,43,64,-21,41
SV Josko Rie,8647,8,11,7,18,43,53,-10,40
St. Pölten,8647,9,7,11,18,49,69,-20,32
Mattersburg,8647,10,8,8,20,37,61,-24,32
SK Sturm Gra,8648,1,21,4,11,62,35,27,67
SC Rheindorf,8648,2,18,9,9,56,41,15,63
FC Salzburg,8648,3,16,9,11,61,41,20,57
Rapid Vienna,8648,4,14,12,10,57,38,19,54
Vienna,8648,5,16,6,14,58,52,6,54
RZ Pellets W,8648,6,13,7,16,47,59,-12,46
St. Pölten,8648,7,12,8,16,48,64,-16,44
Admira Wacke,8648,8,11,7,18,36,63,-27,40
SV Josko Rie,8648,9,11,6,19,35,53,-18,39
Mattersburg,8648,10,9,10,17,49,63,-14,37
SC Rheindorf,8649,1,21,8,7,52,34,18,71
FC Salzburg,8649,2,20,8,8,64,31,33,68
Vienna,8649,3,16,5,15,56,52,4,53
SK Sturm Gra,8649,4,15,7,14,55,50,5,52
Rapid Vienna,8649,5,12,13,11,56,43,13,49
Admira Wacke,8649,6,14,6,16,49,63,-14,48
St. Pölten,8649,7,10,11,15,52,68,-16,41
RZ Pellets W,8649,8,10,9,17,48,61,-13,39
SV Josko Rie,8649,9,10,9,17,35,48,-13,39
Mattersburg,8649,10,9,10,17,37,54,-17,37
SC Rheindorf,8650,1,20,9,7,51,38,13,69
FC Salzburg,8650,2,19,9,8,61,31,30,66
Vienna,8650,3,20,6,10,70,51,19,66
SK Sturm Gra,8650,4,19,7,10,59,33,26,64
Rapid Vienna,8650,5,13,11,12,51,36,15,50
RZ Pellets W,8650,6,11,9,16,42,51,-9,42
Admira Wacke,8650,7,11,7,18,36,60,-24,40
St. Pölten,8650,8,10,7,19,34,61,-27,37
Mattersburg,8650,9,8,9,19,39,58,-19,33
SV Josko Rie,8650,10,9,6,21,35,59,-24,33
FC Salzburg,8651,1,24,6,6,72,28,44,78
Vienna,8651,2,19,5,12,62,51,11,62
SC Rheindorf,8651,3,17,9,10,59,51,8,60
Rapid Vienna,8651,4,16,10,10,64,38,26,58
SK Sturm Gra,8651,5,16,7,13,52,41,11,55
RZ Pellets W,8651,6,13,7,16,42,55,-13,46
SV Josko Rie,8651,7,12,5,19,41,59,-18,41
Admira Wacke,8651,8,12,4,20,41,62,-21,40
Mattersburg,8651,9,8,9,19,41,60,-19,33
St. Pölten,8651,10,7,10,19,38,67,-29,31
FC Salzburg,8652,1,23,5,8,68,27,41,74
SK Sturm Gra,8652,2,19,7,10,66,40,26,64
Rapid Vienna,8652,3,17,10,9,58,34,24,61
Vienna,8652,4,18,6,12,66,58,8,60
SC Rheindorf,8652,5,18,5,13,50,42,8,59
RZ Pellets W,8652,6,11,8,17,51,65,-14,41
Admira Wacke,8652,7,11,6,19,42,69,-27,39
St. Pölten,8652,8,9,10,17,41,62,-21,37
SV Josko Rie,8652,9,10,6,20,32,57,-25,36
Mattersburg,8652,10,10,5,21,40,60,-20,35
FC Salzburg,8653,1,23,7,6,76,34,42,76
SK Sturm Gra,8653,2,18,7,11,61,41,20,61
SC Rheindorf,8653,3,16,11,9,55,47,8,59
Vienna,8653,4,15,8,13,61,61,0,53
Rapid Vienna,8653,5,11,13,12,51,40,11,46
RZ Pellets W,8653,6,12,8,16,44,56,-12,44
St. Pölten,8653,7,10,11,15,43,60,-17,41
SV Josko Rie,8653,8,10,9,17,34,49,-15,39
Admira Wacke,8653,9,9,10,17,32,54,-22,37
Mattersburg,8653,10,8,12,16,38,53,-15,36
FC Salzburg,8654,1,19,9,8,63,31,32,66
Vienna,8654,2,20,6,10,63,50,13,66
SK Sturm Gra,8654,3,19,8,9,61,35,26,65
SC Rheindorf,8654,4,18,7,11,56,48,8,61
Rapid Vienna,8654,5,11,14,11,49,43,6,47
RZ Pellets W,8654,6,13,7,16,45,52,-7,46
Mattersburg,8654,7,11,8,17,38,51,-13,41
SV Josko Rie,8654,8,11,4,21,40,59,-19,37
Admira Wacke,8654,9,10,7,19,36,58,-22,37
St. Pölten,8654,10,9,8,19,39,63,-24,35
SC Rheindorf,8655,1,23,8,5,64,37,27,77
FC Salzburg,8655,2,21,6,9,70,39,31,69
SK Sturm Gra,8655,3,19,5,12,68,43,25,62
Vienna,8655,4,18,3,15,58,50,8,57
RZ Pellets W,8655,5,15,7,14,52,62,-10,52
Rapid Vienna,8655,6,13,12,11,58,47,11,51
Admira Wacke,8655,7,12,4,20,33,59,-26,40
SV Josko Rie,8655,8,9,8,19,35,55,-20,35
St. Pölten,8655,9,8,9,19,43,65,-22,33
Mattersburg,8655,10,6,10,20,33,57,-24,28
FC Salzburg,8656,1,22,6,8,58,24,34,72
SC Rheindorf,8656,2,19,9,8,54,41,13,66
Vienna,8656,3,18,4,14,68,63,5,58
SK Sturm Gra,8656,4,17,6,13,61,38,23,57
RZ Pellets W,8656,5,15,5,16,56,57,-1,50
Rapid Vienna,8656,6,13,10,13,59,47,12,49
SV Josko Rie,8656,7,12,4,20,32,50,-18,40
Admira Wacke,8656,8,9,11,16,39,64,-25,38
St. Pölten,8656,9,10,8,18,36,61,-25,38
Mattersburg,8656,10,9,9,18,36,54,-18,36
FC Salzburg,8657,1,20,9,7,62,26,36,69
SC Rheindorf,8657,2,19,11,6,53,40,13,68
SK Sturm Gra,8657,3,19,8,9,54,33,21,65
Vienna,8657,4,19,7,10,62,46,16,64
Rapid Vienna,8657,5,13,9,14,52,43,9,48
RZ Pellets W,8657,6,14,5,17,45,56,-11,47
Admira Wacke,8657,7,11,8,17,38,56,-18,41
Mattersburg,8657,8,9,11,16,37,49,-12,38
SV Josko Rie,8657,9,9,7,20,31,56,-25,34
St. Pölten,8657,10,5,9,22,36,65,-29,24
FC Salzburg,8658,1,23,6,7,74,32,42,75
SC Rheindorf,8658,2,21,5,10,61,42,19,68
Vienna,8658,3,20,4,12,63,53,10,64
Rapid Vienna,8658,4,17,9,10,58,37,21,60
SK Sturm Gra,8658,5,17,7,12,61,39,22,58
RZ Pellets W,8658,6,12,8,16,47,55,-8,44
SV Josko Rie,8658,7,12,5,19,38,58,-20,41
Admira Wacke,8658,8,9,9,18,36,61,-25,36
Mattersburg,8658,9,7,8,21,31,61,-30,29
St. Pölten,8658,10,6,11,19,38,69,-31,29
FC Salzburg,8659,1,21,7,8,68,33,35,70
SK Sturm Gra,8659,2,21,6,9,72,32,40,69
Vienna,8659,3,20,5,11,63,53,10,65
SC Rheindorf,8659,4,17,9,10,56,48,8,60
Rapid Vienna,8659,5,14,10,12,56,41,15,52
Admira Wacke,8659,6,13,5,18,41,60,-19,44
Mattersburg,8659,7,8,13,15,40,57,-17,37
RZ Pellets W,8659,8,10,6,20,48,70,-22,36
St. Pölten,8659,9,8,12,16,41,69,-28,36
SV Josko Rie,8659,10,8,7,21,41,63,-22,31
FC Salzburg,8660,1,25,7,4,71,23,48,82
SK Sturm Gra,8660,2,20,8,8,58,30,28,68
SC Rheindorf,8660,3,20,8,8,56,42,14,68
Vienna,8660,4,19,5,12,68,55,13,62
Rapid Vienna,8660,5,12,12,12,50,45,5,48
RZ Pellets W,8660,6,12,9,15,45,51,-6,45
SV Josko Rie,8660,7,10,7,19,37,50,-13,37
St. Pölten,8660,8,7,12,17,40,60,-20,33
Admira Wacke,8660,9,7,9,20,32,66,-34,30
Mattersburg,8660,10,4,11,21,28,63,-35,23
FC Salzburg,8661,1,21,8,7,65,32,33,71
SK Sturm Gra,8661,2,22,5,9,63,36,27,71
SC Rheindorf,8661,3,16,6,14,44,43,1,54
Vienna,8661,4,16,4,16,56,58,-2,52
Rapid Vienna,8661,5,13,11,12,50,39,11,50
RZ Pellets W,8661,6,13,8,15,55,54,1,47
St. Pölten,8661,7,13,8,15,45,55,-10,47
SV Josko Rie,8661,8,13,5,18,34,46,-12,44
Mattersburg,8661,9,9,8,19,35,56,-21,35
Admira Wacke,8661,10,10,5,21,33,61,-28,35
FC Salzburg,8662,1,21,6,9,68,37,31,69
SC Rheindorf,8662,2,18,10,8,51,40,11,64
Vienna,8662,3,19,6,11,64,52,12,63
SK Sturm Gra,8662,4,16,7,13,52,39,13,55
Rapid Vienna,8662,5,13,12,11,53,41,12,51
Mattersburg,8662,6,12,9,15,45,53,-8,45
SV Josko Rie,8662,7,13,5,18,46,53,-7,44
Admira Wacke,8662,8,11,7,18,42,61,-19,40
RZ Pellets W,8662,9,10,9,17,42,61,-19,39
St. Pölten,8662,10,7,9,20,45,71,-26,30
SK Sturm Gra,8663,1,22,5,9,60,30,30,71
FC Salzburg,8663,2,20,10,6,72,29,43,70
Vienna,8663,3,22,4,10,70,50,20,70
SC Rheindorf,8663,4,19,7,10,51,38,13,64
Rapid Vienna,8663,5,14,8,14,54,49,5,50
St. Pölten,8663,6,9,11,16,42,59,-17,38
RZ Pellets W,8663,7,10,8,18,39,56,-17,38
SV Josko Rie,8663,8,10,7,19,38,59,-21,37
Admira Wacke,8663,9,10,7,19,41,65,-24,37
Mattersburg,8663,10,6,9,21,28,60,-32,27
SC Rheindorf,8664,1,23,5,8,59,40,19,74
FC Salzburg,8664,2,19,7,10,66,37,29,64
Vienna,8664,3,19,4,13,57,47,10,61
SK Sturm Gra,8664,4,18,5,13,60,38,22,59
Rapid Vienna,8664,5,14,10,12,56,44,12,52
SV Josko Rie,8664,6,15,3,18,43,51,-8,48
Admira Wacke,8664,7,14,6,16,42,58,-16,48
RZ Pellets W,8664,8,13,7,16,41,50,-9,46
Mattersburg,8664,9,8,6,22,33,60,-27,30
St. Pölten,8664,10,5,11,20,38,70,-32,26
FC Salzburg,8665,1,24,5,7,74,30,44,77
SK Sturm Gra,8665,2,17,10,9,57,35,22,61
Rapid Vienna,8665,3,14,12,10,55,42,13,54
Vienna,8665,4,15,6,15,59,61,-2,51
SC Rheindorf,8665,5,14,9,13,48,51,-3,51
RZ Pellets W,8665,6,13,9,14,51,55,-4,48
Admira Wacke,8665,7,13,6,17,40,65,-25,45
Mattersburg,8665,8,10,8,18,39,49,-10,38
SV Josko Rie,8665,9,11,5,20,44,62,-18,38
St. Pölten,8665,10,8,12,16,41,58,-17,36
FC Salzburg,8666,1,23,7,6,70,33,37,76
SK Sturm Gra,8666,2,17,9,10,56,35,21,60
Vienna,8666,3,18,5,13,61,52,9,59
SC Rheindorf,8666,4,17,8,11,50,42,8,59
Rapid Vienna,8666,5,15,11,10,58,44,14,56
RZ Pellets W,8666,6,13,7,16,40,51,-11,46
Admira Wacke,8666,7,13,5,18,34,53,-19,44
Mattersburg,8666,8,9,9,18,37,54,-17,36
St. Pölten,8666,9,8,11,17,47,63,-16,35
SV Josko Rie,8666,10,9,4,23,31,57,-26,31
FC Salzburg,8667,1,20,9,7,70,34,36,69
SC Rheindorf,8667,2,19,7,10,55,43,12,64
Vienna,8667,3,18,5,13,61,55,6,59
SK Sturm Gra,8667,4,17,6,13,51,42,9,57
RZ Pellets W,8667,5,14,7,15,48,52,-4,49
Admira Wacke,8667,6,14,6,16,51,58,-7,48
Rapid Vienna,8667,7,11,11,14,50,45,5,44
SV Josko Rie,8667,8,10,8,18,32,54,-22,38
Mattersburg,8667,9,8,12,16,41,54,-13,36
St. Pölten,8667,10,8,11,17,40,62,-22,35
FC Salzburg,8668,1,21,8,7,62,32,30,71
SK Sturm Gra,8668,2,20,5,11,64,38,26,65
SC Rheindorf,8668,3,17,11,8,56,43,13,62
Vienna,8668,4,18,5,13,69,64,5,59
Rapid Vienna,8668,5,15,7,14,55,41,14,52
St. Pölten,8668,6,12,10,14,45,55,-10,46
RZ Pellets W,8668,7,13,6,17,46,58,-12,45
Admira Wacke,8668,8,13,5,18,38,59,-21,44
SV Josko Rie,8668,9,8,7,21,42,61,-19,31
Mattersburg,8668,10,7,8,21,32,58,-26,29
FC Salzburg,8669,1,22,9,5,67,27,40,75
SC Rheindorf,8669,2,18,10,8,50,35,15,64
SK Sturm Gra,8669,3,18,7,11,52,33,19,61
Rapid Vienna,8669,4,15,12,9,64,41,23,57
Vienna,8669,5,17,5,14,54,53,1,56
SV Josko Rie,8669,6,12,7,17,39,53,-14,43
RZ Pellets W,8669,7,10,11,15,44,55,-11,41
Admira Wacke,8669,8,9,10,17,39,63,-24,37
St. Pölten,8669,9,8,12,16,41,58,-17,36
Mattersburg,8669,10,5,9,22,30,62,-32,24
SK Sturm Gra,8670,1,22,6,8,65,34,31,72
SC Rheindorf,8670,2,20,9,7,57,38,19,69
FC Salzburg,8670,3,17,8,11,60,39,21,59
Rapid Vienna,8670,4,16,10,10,58,36,22,58
Vienna,8670,5,18,3,15,62,53,9,57
Admira Wacke,8670,6,14,4,18,41,59,-18,46
Mattersburg,8670,7,12,6,18,40,55,-15,42
RZ Pellets W,8670,8,11,7,18,46,59,-13,40
St. Pölten,8670,9,8,10,18,42,63,-21,34
SV Josko Rie,8670,10,9,3,24,30,65,-35,30
FC Salzburg,8671,1,20,9,7,63,29,34,69
SC Rheindorf,8671,2,20,8,8,54,38,16,68
SK Sturm Gra,8671,3,19,5,12,59,41,18,62
Vienna,8671,4,18,6,12,61,51,10,60
Rapid Vienna,8671,5,13,10,13,58,47,11,49
RZ Pellets W,8671,6,14,6,16,50,53,-3,48
Mattersburg,8671,7,11,7,18,38,57,-19,40
Admira Wacke,8671,8,11,5,20,37,58,-21,38
SV Josko Rie,8671,9,11,4,21,34,58,-24,37
St. Pölten,8671,10,8,10,18,40,62,-22,34
FC Salzburg,8672,1,21,6,9,63,27,36,69
Vienna,8672,2,20,5,11,70,53,17,65
SK Sturm Gra,8672,3,19,7,10,61,39,22,64
SC Rheindorf,8672,4,18,6,12,59,53,6,60
Rapid Vienna,8672,5,16,10,10,57,40,17,58
Admira Wacke,8672,6,13,6,17,37,56,-19,45
St. Pölten,8672,7,10,9,17,41,59,-18,39
Mattersburg,8672,8,9,9,18,38,51,-13,36
SV Josko Rie,8672,9,10,6,20,37,58,-21,36
RZ Pellets W,8672,10,8,8,20,44,71,-27,32
FC Salzburg,8673,1,22,6,8,67,31,36,72
SK Sturm Gra,8673,2,18,8,10,59,37,22,62
SC Rheindorf,8673,3,17,10,9,56,45,11,61
Vienna,8673,4,18,5,13,65,56,9,59
Rapid Vienna,8673,5,13,12,11,50,36,14,51
RZ Pellets W,8673,6,11,11,14,44,51,-7,44
SV Josko Rie,8673,7,12,8,16,34,47,-13,44
Admira Wacke,8673,8,9,9,18,34,59,-25,36
Mattersburg,8673,9,8,11,17,41,60,-19,35
St. Pölten,8673,10,5,14,17,34,62,-28,29
FC Salzburg,8674,1,21,7,8,68,31,37,70
SC Rheindorf,8674,2,20,8,8,58,37,21,68
SK Sturm Gra,8674,3,20,6,10,57,31,26,66
Vienna,8674,4,18,6,12,60,47,13,60
Rapid Vienna,8674,5,15,10,11,60,44,16,55
Admira Wacke,8674,6,13,4,19,40,63,-23,43
St. Pölten,8674,7,11,8,17,40,59,-19,41
Mattersburg,8674,8,9,9,18,38,57,-19,36
RZ Pellets W,8674,9,9,6,21,43,66,-23,33
SV Josko Rie,8674,10,9,6,21,30,59,-29,33
FC Salzburg,8675,1,23,6,7,68,27,41,75
SC Rheindorf,8675,2,17,12,7,57,41,16,63
SK Sturm Gra,8675,3,18,6,12,57,45,12,60
Vienna,8675,4,17,6,13,58,50,8,57
Rapid Vienna,8675,5,12,11,13,49,45,4,47
RZ Pellets W,8675,6,12,9,15,46,55,-9,45
Admira Wacke,8675,7,12,7,17,45,65,-20,43
St. Pölten,8675,8,10,11,15,42,61,-19,41
SV Josko Rie,8675,9,12,4,20,37,48,-11,40
Mattersburg,8675,10,7,8,21,34,56,-22,29
FC Salzburg,8676,1,21,8,7,62,27,35,71
SC Rheindorf,8676,2,20,7,9,55,40,15,67
SK Sturm Gra,8676,3,18,7,11,60,35,25,61
Vienna,8676,4,18,6,12,59,50,9,60
Rapid Vienna,8676,5,13,12,11,55,40,15,51
RZ Pellets W,8676,6,12,8,16,44,49,-5,44
Mattersburg,8676,7,11,9,16,38,52,-14,42
SV Josko Rie,8676,8,12,6,18,37,54,-17,42
Admira Wacke,8676,9,10,5,21,31,62,-31,35
St. Pölten,8676,10,7,8,21,38,70,-32,29
FC Salzburg,8677,1,21,7,8,64,29,35,70
SK Sturm Gra,8677,2,20,6,10,58,34,24,66
SC Rheindorf,8677,3,18,9,9,59,47,12,63
Rapid Vienna,8677,4,17,7,12,56,39,17,58
Vienna,8677,5,18,4,14,64,53,11,58
RZ Pellets W,8677,6,11,9,16,49,58,-9,42
Admira Wacke,8677,7,11,7,18,40,61,-21,40
St. Pölten,8677,8,9,11,16,48,72,-24,38
SV Josko Rie,8677,9,10,6,20,36,56,-20,36
Mattersburg,8677,10,8,8,20,37,62,-25,32
FC Salzburg,8678,1,19,9,8,62,33,29,66
Vienna,8678,2,18,7,11,68,56,12,61
SK Sturm Gra,8678,3,16,9,11,60,41,19,57
SC Rheindorf,8678,4,15,12,9,51,46,5,57
Rapid Vienna,8678,5,13,12,11,54,40,14,51
RZ Pellets W,8678,6,13,9,14,53,55,-2,48
Admira Wacke,8678,7,12,6,18,40,58,-18,42
SV Josko Rie,8678,8,12,4,20,35,55,-20,40
St. Pölten,8678,9,9,10,17,42,63,-21,37
Mattersburg,8678,10,8,12,16,39,57,-18,36
FC Salzburg,8679,1,21,9,6,69,24,45,72
SC Rheindorf,8679,2,20,8,8,57,42,15,68
Vienna,8679,3,19,6,11,65,49,16,63
SK Sturm Gra,8679,4,15,9,12,56,47,9,54
Rapid Vienna,8679,5,14,9,13,59,40,19,51
RZ Pellets W,8679,6,13,10,13,49,55,-6,49
Admira Wacke,8679,7,13,5,18,37,61,-24,44
Mattersburg,8679,8,9,10,17,34,51,-17,37
St. Pölten,8679,9,9,9,18,45,68,-23,36
SV Josko Rie,8679,10,7,5,24,31,65,-34,26
SC Rheindorf,8680,1,23,5,8,62,35,27,74
FC Salzburg,8680,2,20,6,10,61,34,27,66
SK Sturm Gra,8680,3,19,6,11,53,30,23,63
Vienna,8680,4,17,5,14,58,56,2,56
Rapid Vienna,8680,5,15,9,12,50,36,14,54
SV Josko Rie,8680,6,15,4,17,42,52,-10,49
RZ Pellets W,8680,7,12,7,17,42,53,-11,43
Admira Wacke,8680,8,12,6,18,40,62,-22,42
Mattersburg,8680,9,9,6,21,38,62,-24,33
St. Pölten,8680,10,6,10,20,39,65,-26,28
SC Rheindorf,8681,1,20,10,6,59,41,18,70
FC Salzburg,8681,2,19,8,9,66,35,31,65
SK Sturm Gra,8681,3,19,5,12,63,46,17,62
Vienna,8681,4,18,5,13,64,51,13,59
Rapid Vienna,8681,5,14,11,11,56,42,14,53
RZ Pellets W,8681,6,12,8,16,45,58,-13,44
Admira Wacke,8681,7,12,6,18,41,61,-20,42
Mattersburg,8681,8,10,9,17,38,48,-10,39
St. Pölten,8681,9,9,10,17,45,59,-14,37
SV Josko Rie,8681,10,9,4,23,33,69,-36,31
Vienna,8682,1,21,5,10,62,49,13,68
FC Salzburg,8682,2,20,7,9,68,36,32,67
SC Rheindorf,8682,3,20,7,9,50,37,13,67
SK Sturm Gra,8682,4,19,7,10,65,35,30,64
Rapid Vienna,8682,5,15,9,12,62,39,23,54
RZ Pellets W,8682,6,13,6,17,44,54,-10,45
Admira Wacke,8682,7,12,4,20,39,62,-23,40
Mattersburg,8682,8,11,6,19,39,57,-18,39
St. Pölten,8682,9,9,9,18,41,67,-26,36
SV Josko Rie,8682,10,8,4,24,29,63,-34,28
FC Salzburg,8683,1,18,11,7,59,29,30,65
SC Rheindorf,8683,2,18,9,9,53,43,10,63
Vienna,8683,3,19,5,12,64,51,13,62
SK Sturm Gra,8683,4,17,7,12,54,33,21,58
Rapid Vienna,8683,5,15,10,11,54,36,18,55
Admira Wacke,8683,6,13,6,17,36,57,-21,45
RZ Pellets W,8683,7,11,9,16,43,56,-13,42
SV Josko Rie,8683,8,11,6,19,34,54,-20,39
Mattersburg,8683,9,9,9,18,31,47,-16,36
St. Pölten,8683,10,8,10,18,42,64,-22,34
FC Salzburg,8684,1,22,8,6,68,35,33,74
SK Sturm Gra,8684,2,20,6,10,62,34,28,66
SC Rheindorf,8684,3,19,8,9,51,39,12,65
Rapid Vienna,8684,4,16,11,9,55,35,20,59
Vienna,8684,5,16,7,13,55,52,3,55
SV Josko Rie,8684,6,12,5,19,42,50,-8,41
Admira Wacke,8684,7,10,8,18,34,60,-26,38
RZ Pellets W,8684,8,9,10,17,40,53,-13,37
Mattersburg,8684,9,7,11,18,34,59,-25,32
St. Pölten,8684,10,6,12,18,37,61,-24,30
SC Rheindorf,8685,1,23,7,6,58,34,24,76
FC Salzburg,8685,2,19,8,9,59,34,25,65
Rapid Vienna,8685,3,16,11,9,59,35,24,59
SK Sturm Gra,8685,4,17,8,11,62,39,23,59
Vienna,8685,5,18,4,14,62,56,6,58
RZ Pellets W,8685,6,13,9,14,53,59,-6,48
Admira Wacke,8685,7,13,5,18,40,62,-22,44
SV Josko Rie,8685,8,11,5,20,39,54,-15,38
Mattersburg,8685,9,7,8,21,42,59,-17,29
St. Pölten,8685,10,6,9,21,37,79,-42,27
FC Salzburg,8686,1,26,4,6,70,30,40,82
SK Sturm Gra,8686,2,21,5,10,66,37,29,68
SC Rheindorf,8686,3,21,4,11,63,46,17,67
Vienna,8686,4,17,2,17,64,64,0,53
RZ Pellets W,8686,5,16,4,16,54,56,-2,52
SV Josko Rie,8686,6,14,3,19,44,53,-9,45
Rapid Vienna,8686,7,12,8,16,53,50,3,44
Admira Wacke,8686,8,10,8,18,38,63,-25,38
Mattersburg,8686,9,9,6,21,39,62,-23,33
St. Pölten,8686,10,8,8,20,37,67,-30,32
SC Rheindorf,8687,1,20,9,7,61,36,25,69
FC Salzburg,8687,2,19,8,9,62,32,30,65
SK Sturm Gra,8687,3,18,7,11,59,37,22,61
Vienna,8687,4,18,6,12,53,49,4,60
Rapid Vienna,8687,5,15,7,14,55,40,15,52
RZ Pellets W,8687,6,14,8,14,47,52,-5,50
Admira Wacke,8687,7,12,9,15,33,52,-19,45
St. Pölten,8687,8,9,9,18,44,67,-23,36
Mattersburg,8687,9,8,9,19,37,60,-23,33
SV Josko Rie,8687,10,9,4,23,30,56,-26,31
FC Salzburg,8688,1,24,8,4,72,26,46,80
SC Rheindorf,8688,2,19,10,7,66,47,19,67
SK Sturm Gra,8688,3,17,8,11,53,35,18,59
Vienna,8688,4,16,5,15,53,60,-7,53
Rapid Vienna,8688,5,13,13,10,55,39,16,52
RZ Pellets W,8688,6,13,8,15,43,46,-3,47
Admira Wacke,8688,7,14,5,17,37,54,-17,47
SV Josko Rie,8688,8,10,6,20,31,53,-22,36
Mattersburg,8688,9,8,7,21,36,61,-25,31
St. Pölten,8688,10,7,8,21,36,61,-25,29
SC Rheindorf,8689,1,18,11,7,54,37,17,65
FC Salzburg,8689,2,18,10,8,62,33,29,64
SK Sturm Gra,8689,3,19,7,10,58,34,24,64
Vienna,8689,4,19,6,11,59,40,19,63
Rapid Vienna,8689,5,15,10,11,55,38,17,55
Mattersburg,8689,6,11,7,18,46,63,-17,40
RZ Pellets W,8689,7,11,7,18,37,59,-22,40
Admira Wacke,8689,8,10,10,16,37,61,-24,40
SV Josko Rie,8689,9,11,5,20,33,52,-19,38
St. Pölten,8689,10,6,11,19,42,66,-24,29
FC Salzburg,8690,1,22,8,6,70,33,37,74
SK Sturm Gra,8690,2,19,9,8,58,30,28,66
Rapid Vienna,8690,3,17,12,7,59,32,27,63
SC Rheindorf,8690,4,17,7,12,48,42,6,58
Vienna,8690,5,18,4,14,64,59,5,58
RZ Pellets W,8690,6,14,6,16,48,58,-10,48
Admira Wacke,8690,7,10,7,19,34,61,-27,37
Mattersburg,8690,8,9,6,21,34,54,-20,33
St. Pölten,8690,9,8,9,19,37,59,-22,33
SV Josko Rie,8690,10,9,6,21,29,53,-24,33
FC Salzburg,8691,1,20,9,7,61,28,33,69
Vienna,8691,2,21,6,9,71,44,27,69
SK Sturm Gra,8691,3,20,6,10,69,35,34,66
Rapid Vienna,8691,4,18,8,10,61,33,28,62
SC Rheindorf,8691,5,15,8,13,48,52,-4,53
RZ Pellets W,8691,6,13,9,14,48,52,-4,48
SV Josko Rie,8691,7,12,4,20,38,53,-15,40
Admira Wacke,8691,8,10,6,20,33,71,-38,36
Mattersburg,8691,9,7,10,19,32,59,-27,31
St. Pölten,8691,10,6,10,20,36,70,-34,28
FC Salzburg,8692,1,22,6,8,72,34,38,72
Vienna,8692,2,22,5,9,72,47,25,71
SK Sturm Gra,8692,3,18,9,9,58,35,23,63
SC Rheindorf,8692,4,18,8,10,52,47,5,62
Rapid Vienna,8692,5,12,12,12,54,46,8,48
RZ Pellets W,8692,6,10,10,16,49,59,-10,40
SV Josko Rie,8692,7,11,6,19,36,52,-16,39
Admira Wacke,8692,8,10,8,18,32,59,-27,38
Mattersburg,8692,9,9,8,19,39,59,-20,35
St. Pölten,8692,10,7,10,19,39,65,-26,31
FC Salzburg,8693,1,23,7,6,65,23,42,76
SK Sturm Gra,8693,2,22,6,8,67,32,35,72
SC Rheindorf,8693,3,20,6,10,58,46,12,66
Vienna,8693,4,20,5,11,67,50,17,65
Rapid Vienna,8693,5,13,9,14,51,43,8,48
RZ Pellets W,8693,6,14,5,17,49,56,-7,47
Admira Wacke,8693,7,12,6,18,38,55,-17,42
SV Josko Rie,8693,8,11,3,22,30,56,-26,36
Mattersburg,8693,9,8,7,21,31,56,-25,31
St. Pölten,8693,10,6,8,22,38,77,-39,26
FC Salzburg,8694,1,21,7,8,64,33,31,70
SK Sturm Gra,8694,2,20,8,8,63,31,32,68
Vienna,8694,3,20,4,12,70,55,15,64
SC Rheindorf,8694,4,17,8,11,49,46,3,59
Rapid Vienna,8694,5,14,10,12,53,36,17,52
RZ Pellets W,8694,6,14,6,16,54,58,-4,48
SV Josko Rie,8694,7,12,5,19,37,52,-15,41
St. Pölten,8694,8,10,9,17,43,61,-18,39
Admira Wacke,8694,9,10,6,20,38,67,-29,36
Mattersburg,8694,10,7,7,22,37,69,-32,28
Vienna,8695,1,20,6,10,64,45,19,66
SK Sturm Gra,8695,2,19,7,10,60,29,31,64
FC Salzburg,8695,3,19,7,10,61,33,28,64
SC Rheindorf,8695,4,19,7,10,54,41,13,64
Rapid Vienna,8695,5,15,10,11,58,41,17,55
RZ Pellets W,8695,6,12,12,12,43,47,-4,48
SV Josko Rie,8695,7,13,4,19,37,57,-20,43
Mattersburg,8695,8,9,9,18,40,61,-21,36
Admira Wacke,8695,9,9,5,22,30,67,-37,32
St. Pölten,8695,10,8,7,21,40,66,-26,31
FC Salzburg,8696,1,20,10,6,69,29,40,70
SK Sturm Gra,8696,2,20,5,11,60,38,22,65
Vienna,8696,3,20,5,11,66,51,15,65
SC Rheindorf,8696,4,18,5,13,55,45,10,59
Rapid Vienna,8696,5,13,12,11,59,44,15,51
SV Josko Rie,8696,6,12,8,16,34,47,-13,44
Admira Wacke,8696,7,12,7,17,34,55,-21,43
St. Pölten,8696,8,10,9,17,47,65,-18,39
RZ Pellets W,8696,9,11,5,20,44,65,-21,38
Mattersburg,8696,10,7,8,21,33,62,-29,29
SC Rheindorf,8697,1,21,5,10,60,44,16,68
Vienna,8697,2,20,5,11,63,51,12,65
FC Salzburg,8697,3,18,9,9,71,40,31,63
SK Sturm Gra,8697,4,18,6,12,63,42,21,60
Rapid Vienna,8697,5,16,11,9,61,38,23,59
Admira Wacke,8697,6,13,7,16,44,55,-11,46
RZ Pellets W,8697,7,13,7,16,49,64,-15,46
St. Pölten,8697,8,11,8,17,51,66,-15,41
SV Josko Rie,8697,9,9,4,23,32,59,-27,31
Mattersburg,8697,10,7,6,23,34,69,-35,27
FC Salzburg,8698,1,21,7,8,70,35,35,70
SC Rheindorf,8698,2,21,4,11,54,43,11,67
SK Sturm Gra,8698,3,20,6,10,57,36,21,66
Vienna,8698,4,20,3,13,66,47,19,63
RZ Pellets W,8698,5,14,5,17,42,57,-15,47
Mattersburg,8698,6,10,10,16,37,51,-14,40
Admira Wacke,8698,7,10,10,16,35,58,-23,40
Rapid Vienna,8698,8,9,11,16,45,44,1,38
St. Pölten,8698,9,9,11,16,48,54,-6,38
SV Josko Rie,8698,10,9,7,20,25,54,-29,34
FC Salzburg,8699,1,22,8,6,63,31,32,74
SC Rheindorf,8699,2,21,9,6,54,36,18,72
SK Sturm Gra,8699,3,18,5,13,60,36,24,59
Rapid Vienna,8699,4,14,13,9,59,33,26,55
Vienna,8699,5,16,6,14,61,57,4,54
RZ Pellets W,8699,6,14,8,14,52,52,0,50
SV Josko Rie,8699,7,10,8,18,30,50,-20,38
St. Pölten,8699,8,9,7,20,41,70,-29,34
Mattersburg,8699,9,8,9,19,42,64,-22,33
Admira Wacke,8699,10,9,5,22,28,61,-33,32
SC Rheindorf,8700,1,20,10,6,56,40,16,70
FC Salzburg,8700,2,19,9,8,65,36,29,66
SK Sturm Gra,8700,3,17,12,7,63,36,27,63
Vienna,8700,4,17,6,13,60,52,8,57
Rapid Vienna,8700,5,15,9,12,61,44,17,54
RZ Pellets W,8700,6,11,10,15,47,62,-15,43
Admira Wacke,8700,7,12,6,18,37,55,-18,42
St. Pölten,8700,8,9,13,14,45,58,-13,40
SV Josko Rie,8700,9,9,7,20,36,61,-25,34
Mattersburg,8700,10,6,8,22,37,63,-26,26
SC Rheindorf,8701,1,22,7,7,56,36,20,73
FC Salzburg,8701,2,21,7,8,69,34,35,70
Vienna,8701,3,19,6,11,65,49,16,63
SK Sturm Gra,8701,4,16,10,10,58,38,20,58
Rapid Vienna,8701,5,12,12,12,62,46,16,48
RZ Pellets W,8701,6,13,7,16,53,56,-3,46
Admira Wacke,8701,7,11,7,18,32,58,-26,40
St. Pölten,8701,8,9,10,17,42,64,-22,37
SV Josko Rie,8701,9,11,2,23,35,59,-24,35
Mattersburg,8701,10,9,6,21,32,64,-32,33
SK Sturm Gra,8702,1,23,5,8,70,32,38,74
FC Salzburg,8702,2,21,8,7,64,32,32,71
SC Rheindorf,8702,3,19,10,7,58,39,19,67
Vienna,8702,4,16,5,15,63,55,8,53
RZ Pellets W,8702,5,13,8,15,46,50,-4,47
Rapid Vienna,8702,6,11,11,14,55,46,9,44
SV Josko Rie,8702,7,12,5,19,34,51,-17,41
Admira Wacke,8702,8,10,7,19,32,69,-37,37
St. Pölten,8702,9,9,8,19,37,59,-22,35
Mattersburg,8702,10,8,9,19,37,63,-26,33
SC Rheindorf,8703,1,21,6,9,65,43,22,69
Vienna,8703,2,22,3,11,67,50,17,69
FC Salzburg,8703,3,19,9,8,61,35,26,66
SK Sturm Gra,8703,4,20,4,12,63,36,27,64
Rapid Vienna,8703,5,14,11,11,62,50,12,53
RZ Pellets W,8703,6,13,7,16,51,60,-9,46
Admira Wacke,8703,7,13,6,17,42,58,-16,45
St. Pölten,8703,8,8,11,17,47,65,-18,35
SV Josko Rie,8703,9,8,7,21,30,56,-26,31
Mattersburg,8703,10,6,8,22,34,69,-35,26
SC Rheindorf,8704,1,22,5,9,56,40,16,71
FC Salzburg,8704,2,21,7,8,64,30,34,70
Vienna,8704,3,21,5,10,63,44,19,68
Rapid Vienna,8704,4,14,12,10,58,43,15,54
SK Sturm Gra,8704,5,16,5,15,51,40,11,53
RZ Pellets W,8704,6,14,6,16,43,53,-10,48
Mattersburg,8704,7,10,8,18,38,52,-14,38
Admira Wacke,8704,8,11,4,21,30,57,-27,37
St. Pölten,8704,9,9,7,20,46,68,-22,34
SV Josko Rie,8704,10,9,7,20,30,52,-22,34
SC Rheindorf,8705,1,21,9,6,54,33,21,72
Vienna,8705,2,20,6,10,64,49,15,66
FC Salzburg,8705,3,18,10,8,66,35,31,64
Rapid Vienna,8705,4,16,11,9,58,37,21,59
SK Sturm Gra,8705,5,16,8,12,51,33,18,56
RZ Pellets W,8705,6,12,8,16,41,53,-12,44
St. Pölten,8705,7,9,11,16,44,63,-19,38
Admira Wacke,8705,8,10,5,21,33,61,-28,35
SV Josko Rie,8705,9,10,4,22,28,52,-24,34
Mattersburg,8705,10,8,8,20,35,58,-23,32
SC Rheindorf,8706,1,21,5,10,55,43,12,68
SK Sturm Gra,8706,2,21,4,11,58,36,22,67
FC Salzburg,8706,3,19,7,10,64,38,26,64
Vienna,8706,4,19,6,11,66,48,18,63
Rapid Vienna,8706,5,12,11,13,50,40,10,47
RZ Pellets W,8706,6,12,7,17,47,57,-10,43
SV Josko Rie,8706,7,12,6,18,29,44,-15,42
Admira Wacke,8706,8,13,3,20,38,63,-25,42
Mattersburg,8706,9,11,8,17,39,50,-11,41
St. Pölten,8706,10,7,9,20,42,69,-27,30
FC Salzburg,8707,1,22,7,7,71,34,37,73
SC Rheindorf,8707,2,20,7,9,53,41,12,67
SK Sturm Gra,8707,3,18,7,11,51,33,18,61
Vienna,8707,4,19,4,13,63,50,13,61
Rapid Vienna,8707,5,13,12,11,54,41,13,51
Admira Wacke,8707,6,13,5,18,40,59,-19,44
St. Pölten,8707,7,10,12,14,44,55,-11,42
SV Josko Rie,8707,8,12,3,21,35,56,-21,39
Mattersburg,8707,9,9,8,19,34,53,-19,35
RZ Pellets W,8707,10,7,9,20,33,56,-23,30
FC Salzburg,8708,1,21,8,7,70,30,40,71
SK Sturm Gra,8708,2,18,7,11,56,35,21,61
SC Rheindorf,8708,3,17,6,13,51,45,6,57
Vienna,8708,4,17,4,15,56,55,1,55
Rapid Vienna,8708,5,14,9,13,60,47,13,51
Admira Wacke,8708,6,14,8,14,36,49,-13,50
RZ Pellets W,8708,7,13,8,15,46,53,-7,47
Mattersburg,8708,8,10,11,15,42,52,-10,41
St. Pölten,8708,9,8,10,18,43,63,-20,34
SV Josko Rie,8708,10,9,7,20,32,63,-31,34
SK Sturm Gra,8709,1,23,6,7,64,29,35,75
FC Salzburg,8709,2,21,5,10,68,30,38,68
SC Rheindorf,8709,3,20,7,9,58,42,16,67
RZ Pellets W,8709,4,18,6,12,57,50,7,60
Vienna,8709,5,18,3,15,59,47,12,57
Rapid Vienna,8709,6,13,9,14,52,51,1,48
Admira Wacke,8709,7,10,7,19,35,69,-34,37
Mattersburg,8709,8,9,8,19,39,55,-16,35
SV Josko Rie,8709,9,8,6,22,27,56,-29,30
St. Pölten,8709,10,6,11,19,35,65,-30,29
SK Sturm Gra,8710,1,23,5,8,65,27,38,74
FC Salzburg,8710,2,22,6,8,71,31,40,72
Rapid Vienna,8710,3,19,7,10,57,35,22,64
SC Rheindorf,8710,4,17,9,10,45,40,5,60
Vienna,8710,5,16,6,14,57,51,6,54
RZ Pellets W,8710,6,11,8,17,40,52,-12,41
SV Josko Rie,8710,7,10,8,18,37,54,-17,38
Admira Wacke,8710,8,11,5,20,34,58,-24,38
St. Pölten,8710,9,9,8,19,35,69,-34,35
Mattersburg,8710,10,8,6,22,35,59,-24,30
FC Salzburg,8711,1,21,9,6,60,24,36,72
SK Sturm Gra,8711,2,20,5,11,64,36,28,65
SC Rheindorf,8711,3,17,10,9,50,39,11,61
Vienna,8711,4,17,6,13,64,58,6,57
Rapid Vienna,8711,5,15,11,10,62,42,20,56
RZ Pellets W,8711,6,14,7,15,48,51,-3,49
Mattersburg,8711,7,9,10,17,43,58,-15,37
Admira Wacke,8711,8,9,9,18,35,61,-26,36
St. Pölten,8711,9,9,8,19,38,65,-27,35
SV Josko Rie,8711,10,8,7,21,32,62,-30,31
SC Rheindorf,8712,1,23,7,6,65,38,27,76
FC Salzburg,8712,2,21,8,7,66,34,32,71
Vienna,8712,3,17,7,12,66,53,13,58
SK Sturm Gra,8712,4,16,8,12,55,38,17,56
Rapid Vienna,8712,5,15,10,11,56,37,19,55
RZ Pellets W,8712,6,12,7,17,44,55,-11,43
Admira Wacke,8712,7,11,8,17,35,55,-20,41
SV Josko Rie,8712,8,10,9,17,31,52,-21,39
Mattersburg,8712,9,10,5,21,40,63,-23,35
St. Pölten,8712,10,6,9,21,34,67,-33,27
FC Salzburg,8713,1,21,7,8,62,34,28,70
SK Sturm Gra,8713,2,21,7,8,65,38,27,70
SC Rheindorf,8713,3,19,8,9,54,38,16,65
Vienna,8713,4,17,7,12,58,49,9,58
Rapid Vienna,8713,5,15,10,11,53,38,15,55
RZ Pellets W,8713,6,12,8,16,45,58,-13,44
Admira Wacke,8713,7,11,7,18,38,55,-17,40
St. Pölten,8713,8,8,10,18,42,63,-21,34
Mattersburg,8713,9,9,7,20,38,59,-21,34
SV Josko Rie,8713,10,9,5,22,34,57,-23,32
FC Salzburg,8714,1,24,8,4,77,32,45,80
SK Sturm Gra,8714,2,23,3,10,67,34,33,72
Vienna,8714,3,19,4,13,60,49,11,61
SC Rheindorf,8714,4,17,8,11,53,50,3,59
Rapid Vienna,8714,5,14,10,12,58,41,17,52
SV Josko Rie,8714,6,12,7,17,35,52,-17,43
RZ Pellets W,8714,7,10,9,17,42,59,-17,39
Admira Wacke,8714,8,11,5,20,34,58,-24,38
St. Pölten,8714,9,8,11,17,42,64,-22,35
Mattersburg,8714,10,5,9,22,33,62,-29,24
SK Sturm Gra,8715,1,24,4,8,69,29,40,76
FC Salzburg,8715,2,21,8,7,64,28,36,71
SC Rheindorf,8715,3,21,8,7,67,39,28,71
Vienna,8715,4,17,5,14,59,47,12,56
Rapid Vienna,8715,5,14,10,12,55,38,17,52
RZ Pellets W,8715,6,14,7,15,46,55,-9,49
Mattersburg,8715,7,8,9,19,36,64,-28,33
St. Pölten,8715,8,8,9,19,34,67,-33,33
SV Josko Rie,8715,9,8,8,20,34,59,-25,32
Admira Wacke,8715,10,8,6,22,25,63,-38,30
FC Salzburg,8716,1,20,7,9,73,38,35,67
SC Rheindorf,8716,2,17,8,11,52,47,5,59
Vienna,8716,3,17,7,12,62,55,7,58
SK Sturm Gra,8716,4,17,6,13,55,38,17,57
Rapid Vienna,8716,5,13,12,11,51,40,11,51
RZ Pellets W,8716,6,14,7,15,44,52,-8,49
Admira Wacke,8716,7,12,7,17,41,62,-21,43
SV Josko Rie,8716,8,11,7,18,44,56,-12,40
St. Pölten,8716,9,8,13,15,44,61,-17,37
Mattersburg,8716,10,9,10,17,35,52,-17,37
FC Salzburg,8717,1,20,9,7,66,34,32,69
SC Rheindorf,8717,2,20,6,10,56,43,13,66
Vienna,8717,3,18,7,11,69,53,16,61
SK Sturm Gra,8717,4,16,7,13,53,39,14,55
Rapid Vienna,8717,5,13,11,12,46,37,9,50
SV Josko Rie,8717,6,14,2,20,38,53,-15,44
Admira Wacke,8717,7,11,7,18,42,59,-17,40
St. Pölten,8717,8,9,12,15,45,64,-19,39
RZ Pellets W,8717,9,10,9,17,38,58,-20,39
Mattersburg,8717,10,10,8,18,38,51,-13,38
FC Salzburg,8718,1,23,5,8,64,32,32,74
Vienna,8718,2,21,4,11,66,50,16,67
SK Sturm Gra,8718,3,18,10,8,52,29,23,64
SC Rheindorf,8718,4,18,6,12,51,41,10,60
Rapid Vienna,8718,5,14,11,11,53,39,14,53
Admira Wacke,8718,6,13,6,17,39,58,-19,45
RZ Pellets W,8718,7,9,10,17,39,55,-16,37
Mattersburg,8718,8,9,8,19,46,61,-15,35
SV Josko Rie,8718,9,10,5,21,39,60,-21,35
St. Pölten,8718,10,8,9,19,41,65,-24,33
FC Salzburg,8719,1,24,5,7,69,25,44,77
SK Sturm Gra,8719,2,21,6,9,66,31,35,69
SC Rheindorf,8719,3,20,8,8,56,42,14,68
Vienna,8719,4,17,7,12,57,51,6,58
Rapid Vienna,8719,5,15,10,11,59,44,15,55
RZ Pellets W,8719,6,11,8,17,41,51,-10,41
SV Josko Rie,8719,7,10,9,17,33,48,-15,39
Admira Wacke,8719,8,11,4,21,42,64,-22,37
St. Pölten,8719,9,9,10,17,42,68,-26,37
Mattersburg,8719,10,5,7,24,29,70,-41,22
FC Salzburg,8720,1,19,9,8,67,35,32,66
SK Sturm Gra,8720,2,19,6,11,58,33,25,63
SC Rheindorf,8720,3,17,11,8,57,54,3,62
Vienna,8720,4,18,7,11,68,54,14,61
Rapid Vienna,8720,5,12,14,10,51,35,16,50
RZ Pellets W,8720,6,13,8,15,44,54,-10,47
SV Josko Rie,8720,7,11,8,17,39,53,-14,41
St. Pölten,8720,8,8,13,15,46,62,-16,37
Admira Wacke,8720,9,11,4,21,31,57,-26,37
Mattersburg,8720,10,8,8,20,39,63,-24,32
FC Salzburg,8721,1,21,8,7,69,29,40,71
SK Sturm Gra,8721,2,20,5,11,66,32,34,65
SC Rheindorf,8721,3,17,10,9,54,49,5,61
Vienna,8721,4,17,7,12,61,52,9,58
Rapid Vienna,8721,5,14,11,11,62,41,21,53
RZ Pellets W,8721,6,12,6,18,50,62,-12,42
Admira Wacke,8721,7,12,6,18,41,66,-25,42
SV Josko Rie,8721,8,12,5,19,40,61,-21,41
Mattersburg,8721,9,8,12,16,34,55,-21,36
St. Pölten,8721,10,6,12,18,43,73,-30,30
SK Sturm Gra,8722,1,20,7,9,65,36,29,67
Vienna,8722,2,20,6,10,64,49,15,66
FC Salzburg,8722,3,19,7,10,70,37,33,64
SC Rheindorf,8722,4,18,7,11,58,44,14,61
RZ Pellets W,8722,5,15,6,15,51,49,2,51
Rapid Vienna,8722,6,13,11,12,54,43,11,50
SV Josko Rie,8722,7,14,5,17,41,59,-18,47
Admira Wacke,8722,8,9,8,19,34,69,-35,35
St. Pölten,8722,9,7,12,17,38,60,-22,33
Mattersburg,8722,10,5,11,20,30,59,-29,26
FC Salzburg,8723,1,21,7,8,69,36,33,70
SK Sturm Gra,8723,2,21,7,8,58,30,28,70
SC Rheindorf,8723,3,20,8,8,55,40,15,68
Vienna,8723,4,16,7,13,59,52,7,55
Rapid Vienna,8723,5,13,12,11,55,39,16,51
RZ Pellets W,8723,6,11,12,13,47,54,-7,45
Admira Wacke,8723,7,12,7,17,42,61,-19,43
SV Josko Rie,8723,8,11,4,21,34,56,-22,37
Mattersburg,8723,9,8,7,21,37,61,-24,31
St. Pölten,8723,10,7,9,20,37,64,-27,30
SK Sturm Gra,8724,1,21,7,8,61,33,28,70
Vienna,8724,2,21,4,11,70,43,27,67
SC Rheindorf,8724,3,19,8,9,56,44,12,65
FC Salzburg,8724,4,18,8,10,60,39,21,62
Rapid Vienna,8724,5,13,11,12,58,45,13,50
SV Josko Rie,8724,6,12,8,16,38,50,-12,44
Admira Wacke,8724,7,11,7,18,41,63,-22,40
RZ Pellets W,8724,8,10,8,18,45,64,-19,38
Mattersburg,8724,9,8,9,19,38,58,-20,33
St. Pölten,8724,10,7,10,19,35,63,-28,31
FC Salzburg,8725,1,21,7,8,61,29,32,70
SK Sturm Gra,8725,2,19,8,9,60,35,25,65
SC Rheindorf,8725,3,20,5,11,58,41,17,65
Vienna,8725,4,20,5,11,61,53,8,65
Rapid Vienna,8725,5,15,10,11,58,42,16,55
RZ Pellets W,8725,6,13,6,17,48,59,-11,45
Admira Wacke,8725,7,12,8,16,35,54,-19,44
St. Pölten,8725,8,8,10,18,45,70,-25,34
SV Josko Rie,8725,9,10,3,23,36,59,-23,33
Mattersburg,8725,10,7,8,21,37,57,-20,29
SC Rheindorf,8726,1,20,9,7,57,40,17,69
FC Salzburg,8726,2,18,11,7,63,33,30,65
SK Sturm Gra,8726,3,19,8,9,58,37,21,65
Vienna,8726,4,18,5,13,60,50,10,59
RZ Pellets W,8726,5,17,6,13,50,48,2,57
Rapid Vienna,8726,6,12,10,14,53,46,7,46
SV Josko Rie,8726,7,13,5,18,41,53,-12,44
St. Pölten,8726,8,7,13,16,41,62,-21,34
Admira Wacke,8726,9,9,6,21,36,62,-26,33
Mattersburg,8726,10,6,9,21,34,62,-28,27
FC Salzburg,8727,1,23,8,5,77,34,43,77
SC Rheindorf,8727,2,19,7,10,59,50,9,64
Vienna,8727,3,19,6,11,66,50,16,63
SK Sturm Gra,8727,4,19,5,12,73,47,26,62
Rapid Vienna,8727,5,12,11,13,56,47,9,47
SV Josko Rie,8727,6,12,6,18,38,55,-17,42
Admira Wacke,8727,7,10,9,17,34,55,-21,39
Mattersburg,8727,8,9,10,17,44,61,-17,37
St. Pölten,8727,9,8,11,17,45,62,-17,35
RZ Pellets W,8727,10,9,7,20,44,75,-31,34
FC Salzburg,8728,1,23,6,7,72,33,39,75
SC Rheindorf,8728,2,19,8,9,55,41,14,65
SK Sturm Gra,8728,3,18,5,13,54,34,20,59
Vienna,8728,4,17,7,12,65,61,4,58
Rapid Vienna,8728,5,14,11,11,56,42,14,53
RZ Pellets W,8728,6,12,7,17,43,53,-10,43
Admira Wacke,8728,7,13,4,19,42,57,-15,43
St. Pölten,8728,8,9,11,16,38,62,-24,38
SV Josko Rie,8728,9,11,3,22,32,55,-23,36
Mattersburg,8728,10,8,10,18,38,57,-19,34
SC Rheindorf,8729,1,23,7,6,62,34,28,76
FC Salzburg,8729,2,20,9,7,65,32,33,69
SK Sturm Gra,8729,3,21,6,9,61,32,29,69
Vienna,8729,4,16,5,15,54,55,-1,53
Rapid Vienna,8729,5,14,10,12,57,39,18,52
RZ Pellets W,8729,6,13,4,19,45,55,-10,43
St. Pölten,8729,7,9,12,15,46,66,-20,39
Mattersburg,8729,8,10,6,20,39,58,-19,36
SV Josko Rie,8729,9,10,5,21,34,55,-21,35
Admira Wacke,8729,10,9,6,21,32,69,-37,33
SK Sturm Gra,8730,1,22,5,9,68,34,34,71
SC Rheindorf,8730,2,19,9,8,57,42,15,66
FC Salzburg,8730,3,18,9,9,66,37,29,63
Vienna,8730,4,18,4,14,57,57,0,58
Rapid Vienna,8730,5,16,9,11,71,42,29,57
RZ Pellets W,8730,6,11,9,16,45,56,-11,42
Admira Wacke,8730,7,12,5,19,39,64,-25,41
St. Pölten,8730,8,9,12,15,46,62,-16,39
SV Josko Rie,8730,9,9,6,21,31,58,-27,33
Mattersburg,8730,10,8,8,20,36,64,-28,32
FC Salzburg,8731,1,20,10,6,62,28,34,70
SK Sturm Gra,8731,2,19,6,11,67,38,29,63
Vienna,8731,3,19,5,12,64,50,14,62
SC Rheindorf,8731,4,16,7,13,52,52,0,55
Admira Wacke,8731,5,14,8,14,38,50,-12,50
Rapid Vienna,8731,6,11,13,12,48,40,8,46
Mattersburg,8731,7,12,8,16,39,49,-10,44
SV Josko Rie,8731,8,13,5,18,33,47,-14,44
RZ Pellets W,8731,9,10,6,20,46,66,-20,36
St. Pölten,8731,10,8,8,20,39,68,-29,32
SC Rheindorf,8732,1,20,8,8,55,38,17,68
SK Sturm Gra,8732,2,20,4,12,58,36,22,64
FC Salzburg,8732,3,18,9,9,63,34,29,63
Vienna,8732,4,19,4,13,69,58,11,61
Rapid Vienna,8732,5,14,10,12,57,40,17,52
RZ Pellets W,8732,6,14,8,14,49,57,-8,50
St. Pölten,8732,7,10,9,17,43,65,-22,39
Admira Wacke,8732,8,11,5,20,36,64,-28,38
Mattersburg,8732,9,9,10,17,38,51,-13,37
SV Josko Rie,8732,10,8,7,21,33,58,-25,31
SK Sturm Gra,8733,1,22,3,11,63,36,27,69
Vienna,8733,2,22,3,11,68,50,18,69
SC Rheindorf,8733,3,20,7,9,55,38,17,67
Rapid Vienna,8733,4,17,10,9,62,33,29,61
FC Salzburg,8733,5,16,6,14,57,42,15,54
SV Josko Rie,8733,6,14,3,19,43,50,-7,45
Admira Wacke,8733,7,12,6,18,39,58,-19,42
RZ Pellets W,8733,8,11,6,19,39,65,-26,39
Mattersburg,8733,9,8,8,20,36,59,-23,32
St. Pölten,8733,10,8,8,20,36,67,-31,32
FC Salzburg,8734,1,20,9,7,63,28,35,69
SC Rheindorf,8734,2,18,10,8,55,47,8,64
SK Sturm Gra,8734,3,19,6,11,53,33,20,63
Vienna,8734,4,18,8,10,68,52,16,62
Rapid Vienna,8734,5,15,10,11,53,36,17,55
RZ Pellets W,8734,6,11,8,17,43,55,-12,41
SV Josko Rie,8734,7,9,10,17,36,54,-18,37
Mattersburg,8734,8,8,12,16,41,55,-14,36
Admira Wacke,8734,9,9,7,20,36,64,-28,34
St. Pölten,8734,10,7,12,17,41,65,-24,33
FC Salzburg,8735,1,20,8,8,65,34,31,68
Vienna,8735,2,20,6,10,62,45,17,66
SC Rheindorf,8735,3,17,7,12,55,46,9,58
SK Sturm Gra,8735,4,17,6,13,50,34,16,57
Rapid Vienna,8735,5,14,10,12,58,43,15,52
Admira Wacke,8735,6,13,8,15,37,50,-13,47
RZ Pellets W,8735,7,13,7,16,44,56,-12,46
SV Josko Rie,8735,8,14,2,20,41,53,-12,44
St. Pölten,8735,9,10,6,20,36,70,-34,36
Mattersburg,8735,10,8,8,20,42,59,-17,32
FC Salzburg,8736,1,21,8,7,65,34,31,71
SC Rheindorf,8736,2,20,7,9,57,44,13,67
Rapid Vienna,8736,3,18,9,9,62,34,28,63
Vienna,8736,4,19,6,11,69,46,23,63
SK Sturm Gra,8736,5,17,6,13,53,36,17,57
RZ Pellets W,8736,6,12,10,14,40,51,-11,46
Mattersburg,8736,7,9,10,17,37,53,-16,37
SV Josko Rie,8736,8,9,7,20,33,52,-19,34
Admira Wacke,8736,9,9,6,21,35,65,-30,33
St. Pölten,8736,10,6,11,19,35,71,-36,29
FC Salzburg,8737,1,22,8,6,71,30,41,74
SC Rheindorf,8737,2,20,9,7,64,40,24,69
SK Sturm Gra,8737,3,19,7,10,55,31,24,64
Rapid Vienna,8737,4,15,10,11,61,42,19,55
Vienna,8737,5,16,6,14,54,53,1,54
RZ Pellets W,8737,6,12,9,15,44,48,-4,45
Mattersburg,8737,7,10,8,18,44,62,-18,38
Admira Wacke,8737,8,10,6,20,32,62,-30,36
SV Josko Rie,8737,9,10,5,21,32,63,-31,35
St. Pölten,8737,10,6,12,18,33,59,-26,30
FC Salzburg,8738,1,23,7,6,70,31,39,76
Rapid Vienna,8738,2,19,7,10,64,37,27,64
SC Rheindorf,8738,3,19,7,10,56,41,15,64
SK Sturm Gra,8738,4,17,8,11,56,41,15,59
Vienna,8738,5,18,3,15,62,52,10,57
RZ Pellets W,8738,6,13,6,17,44,53,-9,45
Admira Wacke,8738,7,11,8,17,32,58,-26,41
St. Pölten,8738,8,9,10,17,43,59,-16,37
SV Josko Rie,8738,9,10,4,22,37,62,-25,34
Mattersburg,8738,10,7,8,21,38,68,-30,29
FC Salzburg,8739,1,25,6,5,82,25,57,81
SK Sturm Gra,8739,2,19,7,10,65,40,25,64
Vienna,8739,3,20,4,12,66,55,11,64
SC Rheindorf,8739,4,18,5,13,56,47,9,59
Rapid Vienna,8739,5,12,8,16,53,53,0,44
RZ Pellets W,8739,6,12,8,16,46,58,-12,44
Mattersburg,8739,7,11,6,19,37,56,-19,39
Admira Wacke,8739,8,11,6,19,36,62,-26,39
SV Josko Rie,8739,9,10,7,19,33,51,-18,37
St. Pölten,8739,10,9,9,18,43,70,-27,36
FC Salzburg,8740,1,21,9,6,67,30,37,72
Vienna,8740,2,20,5,11,71,51,20,65
SK Sturm Gra,8740,3,19,7,10,57,36,21,64
SC Rheindorf,8740,4,19,6,11,57,44,13,63
St. Pölten,8740,5,12,8,16,42,57,-15,44
Rapid Vienna,8740,6,10,13,13,46,40,6,43
RZ Pellets W,8740,7,11,10,15,42,50,-8,43
SV Josko Rie,8740,8,11,8,17,34,48,-14,41
Admira Wacke,8740,9,10,8,18,33,64,-31,38
Mattersburg,8740,10,5,10,21,33,62,-29,25
FC Salzburg,8741,1,21,6,9,65,34,31,69
SC Rheindorf,8741,2,18,11,7,60,39,21,65
SK Sturm Gra,8741,3,16,12,8,54,31,23,60
Rapid Vienna,8741,4,16,11,9,54,38,16,59
Vienna,8741,5,14,11,11,61,58,3,53
Admira Wacke,8741,6,13,5,18,40,59,-19,44
RZ Pellets W,8741,7,12,7,17,48,61,-13,43
Mattersburg,8741,8,9,10,17,41,53,-12,37
St. Pölten,8741,9,8,9,19,41,64,-23,33
SV Josko Rie,8741,10,9,6,21,30,57,-27,33
FC Salzburg,8742,1,23,6,7,69,31,38,75
SK Sturm Gra,8742,2,21,4,11,62,35,27,67
Vienna,8742,3,19,5,12,67,55,12,62
SC Rheindorf,8742,4,17,6,13,62,50,12,57
Rapid Vienna,8742,5,15,8,13,56,36,20,53
RZ Pellets W,8742,6,15,5,16,49,54,-5,50
SV Josko Rie,8742,7,12,8,16,34,49,-15,44
St. Pölten,8742,8,9,11,16,43,67,-24,38
Admira Wacke,8742,9,9,6,21,33,66,-33,33
Mattersburg,8742,10,7,7,22,33,65,-32,28
SC Rheindorf,8743,1,21,9,6,58,35,23,72
FC Salzburg,8743,2,21,7,8,68,31,37,70
SK Sturm Gra,8743,3,21,6,9,64,35,29,69
Vienna,8743,4,19,5,12,59,49,10,62
Rapid Vienna,8743,5,13,12,11,57,47,10,51
RZ Pellets W,8743,6,13,7,16,45,52,-7,46
Mattersburg,8743,7,11,6,19,42,60,-18,39
SV Josko Rie,8743,8,9,7,20,31,55,-24,34
Admira Wacke,8743,9,9,7,20,31,58,-27,34
St. Pölten,8743,10,4,12,20,32,65,-33,24
FC Salzburg,8744,1,20,6,10,65,35,30,66
Vienna,8744,2,20,5,11,62,56,6,65
SK Sturm Gra,8744,3,18,7,11,55,37,18,61
SC Rheindorf,8744,4,17,9,10,53,46,7,60
Rapid Vienna,8744,5,14,9,13,61,43,18,51
RZ Pellets W,8744,6,14,8,14,45,47,-2,50
St. Pölten,8744,7,11,9,16,40,51,-11,42
SV Josko Rie,8744,8,12,6,18,38,49,-11,42
Admira Wacke,8744,9,10,6,20,32,63,-31,36
Mattersburg,8744,10,6,11,19,32,56,-24,29
SC Rheindorf,8745,1,20,9,7,56,36,20,69
FC Salzburg,8745,2,20,8,8,66,33,33,68
SK Sturm Gra,8745,3,18,11,7,60,33,27,65
Vienna,8745,4,17,6,13,56,59,-3,57
Rapid Vienna,8745,5,14,11,11,62,45,17,53
RZ Pellets W,8745,6,11,10,15,40,48,-8,43
Admira Wacke,8745,7,10,9,17,37,61,-24,39
SV Josko Rie,8745,8,9,8,19,31,47,-16,35
St. Pölten,8745,9,7,11,18,37,59,-22,32
Mattersburg,8745,10,7,11,18,40,64,-24,32
FC Salzburg,8746,1,22,6,8,58,26,32,72
Vienna,8746,2,20,6,10,68,49,19,66
SC Rheindorf,8746,3,19,6,11,59,51,8,63
SK Sturm Gra,8746,4,18,6,12,61,34,27,60
RZ Pellets W,8746,5,14,6,16,50,60,-10,48
Rapid Vienna,8746,6,12,11,13,54,48,6,47
Admira Wacke,8746,7,11,9,16,38,57,-19,42
St. Pölten,8746,8,10,8,18,43,61,-18,38
Mattersburg,8746,9,10,7,19,37,57,-20,37
SV Josko Rie,8746,10,9,5,22,30,55,-25,32
FC Salzburg,8747,1,22,6,8,64,30,34,72
SK Sturm Gra,8747,2,18,8,10,60,39,21,62
SC Rheindorf,8747,3,17,8,11,52,48,4,59
Rapid Vienna,8747,4,15,13,8,59,38,21,58
Vienna,8747,5,17,4,15,61,56,5,55
SV Josko Rie,8747,6,14,6,16,44,50,-6,48
RZ Pellets W,8747,7,11,10,15,46,53,-7,43
St. Pölten,8747,8,10,9,17,46,68,-22,39
Mattersburg,8747,9,8,9,19,34,56,-22,33
Admira Wacke,8747,10,8,7,21,31,59,-28,31
SC Rheindorf,8748,1,22,4,10,58,39,19,70
Vienna,8748,2,21,5,10,61,41,20,68
FC Salzburg,8748,3,19,8,9,60,33,27,65
Rapid Vienna,8748,4,15,11,10,61,40,21,56
SK Sturm Gra,8748,5,17,5,14,48,35,13,56
RZ Pellets W,8748,6,12,8,16,47,57,-10,44
SV Josko Rie,8748,7,13,3,20,36,50,-14,42
St. Pölten,8748,8,10,8,18,41,63,-22,38
Admira Wacke,8748,9,11,4,21,37,63,-26,37
Mattersburg,8748,10,8,8,20,36,64,-28,32
FC Salzburg,8749,1,19,7,10,66,39,27,64
SC Rheindorf,8749,2,18,9,9,47,38,9,63
Vienna,8749,3,17,8,11,59,51,8,59
Rapid Vienna,8749,4,15,10,11,58,40,18,55
SK Sturm Gra,8749,5,15,9,12,55,44,11,54
RZ Pellets W,8749,6,11,13,12,48,53,-5,46
SV Josko Rie,8749,7,12,6,18,38,48,-10,42
St. Pölten,8749,8,10,10,16,49,66,-17,40
Admira Wacke,8749,9,10,10,16,39,58,-19,40
Mattersburg,8749,10,6,12,18,41,63,-22,30
FC Salzburg,8750,1,20,8,8,67,35,32,68
SC Rheindorf,8750,2,18,11,7,61,45,16,65
SK Sturm Gra,8750,3,17,10,9,61,39,22,61
Vienna,8750,4,16,10,10,60,49,11,58
Rapid Vienna,8750,5,12,12,12,55,40,15,48
Admira Wacke,8750,6,14,4,18,44,64,-20,46
RZ Pellets W,8750,7,12,8,16,39,52,-13,44
SV Josko Rie,8750,8,10,8,18,34,51,-17,38
St. Pölten,8750,9,9,8,19,41,63,-22,35
Mattersburg,8750,10,8,9,19,36,60,-24,33
FC Salzburg,8751,1,21,6,9,63,35,28,69
SK Sturm Gra,8751,2,21,5,10,62,33,29,68
SC Rheindorf,8751,3,21,4,11,56,42,14,67
Rapid Vienna,8751,4,17,9,10,63,40,23,60
Vienna,8751,5,19,3,14,58,49,9,60
RZ Pellets W,8751,6,14,6,16,49,58,-9,48
SV Josko Rie,8751,7,11,6,19,38,50,-12,39
Admira Wacke,8751,8,11,5,20,31,58,-27,38
Mattersburg,8751,9,7,9,20,36,60,-24,30
St. Pölten,8751,10,7,9,20,44,75,-31,30
FC Salzburg,8752,1,21,7,8,61,27,34,70
SK Sturm Gra,8752,2,20,9,7,63,30,33,69
Vienna,8752,3,19,7,10,65,46,19,64
SC Rheindorf,8752,4,16,8,12,49,49,0,56
Rapid Vienna,8752,5,14,11,11,59,39,20,53
RZ Pellets W,8752,6,14,6,16,50,57,-7,48
Mattersburg,8752,7,9,11,16,40,53,-13,38
SV Josko Rie,8752,8,11,4,21,30,58,-28,37
Admira Wacke,8752,9,9,8,19,30,61,-31,35
St. Pölten,8752,10,6,11,19,36,63,-27,29
FC Salzburg,8753,1,22,7,7,65,32,33,73
Vienna,8753,2,20,5,11,69,49,20,65
SK Sturm Gra,8753,3,18,6,12,57,42,15,60
SC Rheindorf,8753,4,18,6,12,50,52,-2,60
Rapid Vienna,8753,5,16,9,11,57,36,21,57
SV Josko Rie,8753,6,11,8,17,42,53,-11,41
RZ Pellets W,8753,7,10,10,16,51,56,-5,40
St. Pölten,8753,8,9,11,16,44,60,-16,38
Admira Wacke,8753,9,9,7,20,40,73,-33,34
Mattersburg,8753,10,8,9,19,35,57,-22,33
FC Salzburg,8754,1,22,6,8,63,30,33,72
SC Rheindorf,8754,2,21,5,10,51,42,9,68
Vienna,8754,3,20,5,11,69,49,20,65
SK Sturm Gra,8754,4,20,5,11,53,35,18,65
Rapid Vienna,8754,5,13,12,11,57,42,15,51
Admira Wacke,8754,6,12,8,16,38,51,-13,44
RZ Pellets W,8754,7,11,8,17,38,57,-19,41
Mattersburg,8754,8,10,7,19,45,60,-15,37
SV Josko Rie,8754,9,9,5,22,31,57,-26,32
St. Pölten,8754,10,8,7,21,44,66,-22,31
FC Salzburg,8755,1,24,4,8,69,32,37,76
SC Rheindorf,8755,2,19,7,10,54,45,9,64
SK Sturm Gra,8755,3,18,4,14,57,41,16,58
Rapid Vienna,8755,4,15,10,11,59,42,17,55
Vienna,8755,5,16,6,14,61,52,9,54
St. Pölten,8755,6,12,9,15,49,61,-12,45
RZ Pellets W,8755,7,12,7,17,44,56,-12,43
SV Josko Rie,8755,8,13,2,21,36,57,-21,41
Admira Wacke,8755,9,11,6,19,38,62,-24,39
Mattersburg,8755,10,9,7,20,43,62,-19,34
Vienna,8756,1,21,6,9,66,48,18,69
FC Salzburg,8756,2,20,5,11,63,37,26,65
SK Sturm Gra,8756,2,19,8,9,63,37,26,65
SC Rheindorf,8756,4,19,6,11,55,46,9,63
Rapid Vienna,8756,5,14,10,12,60,44,16,52
Mattersburg,8756,6,10,12,14,41,50,-9,42
Admira Wacke,8756,7,12,4,20,37,61,-24,40
SV Josko Rie,8756,8,11,6,19,37,56,-19,39
RZ Pellets W,8756,9,10,8,18,47,61,-14,38
St. Pölten,8756,10,6,11,19,41,70,-29,29
Vienna,8757,1,21,5,10,67,45,22,68
SC Rheindorf,8757,2,19,10,7,57,39,18,67
FC Salzburg,8757,3,19,7,10,59,34,25,64
SK Sturm Gra,8757,4,19,7,10,60,37,23,64
Rapid Vienna,8757,5,14,14,8,53,32,21,56
RZ Pellets W,8757,6,12,7,17,45,59,-14,43
Admira Wacke,8757,7,11,6,19,35,58,-23,39
SV Josko Rie,8757,8,9,7,20,31,54,-23,34
Mattersburg,8757,9,7,12,17,35,55,-20,33
St. Pölten,8757,10,7,9,20,38,67,-29,30
FC Salzburg,8758,1,24,5,7,75,31,44,77
SC Rheindorf,8758,2,20,7,9,55,47,8,67
Rapid Vienna,8758,3,18,10,8,59,36,23,64
SK Sturm Gra,8758,4,19,6,11,57,37,20,63
Vienna,8758,5,16,5,15,63,60,3,53
RZ Pellets W,8758,6,15,6,15,50,49,1,51
Admira Wacke,8758,7,10,9,17,33,52,-19,39
SV Josko Rie,8758,8,9,8,19,37,55,-18,35
Mattersburg,8758,9,6,10,20,37,65,-28,28
St. Pölten,8758,10,5,10,21,38,72,-34,25
FC Salzburg,8759,1,22,5,9,62,31,31,71
SC Rheindorf,8759,2,20,6,10,60,41,19,66
SK Sturm Gra,8759,3,18,9,9,60,36,24,63
Vienna,8759,4,19,5,12,67,50,17,62
Rapid Vienna,8759,5,17,8,11,63,38,25,59
RZ Pellets W,8759,6,14,8,14,52,52,0,50
Admira Wacke,8759,7,12,7,17,44,69,-25,43
St. Pölten,8759,8,9,6,21,43,77,-34,33
SV Josko Rie,8759,9,8,6,22,25,52,-27,30
Mattersburg,8759,10,7,8,21,30,60,-30,29
SC Rheindorf,8760,1,22,7,7,58,39,19,73
FC Salzburg,8760,2,18,8,10,60,33,27,62
SK Sturm Gra,8760,3,16,10,10,60,37,23,58
Vienna,8760,4,16,8,12,60,54,6,56
Rapid Vienna,8760,5,15,9,12,52,37,15,54
Admira Wacke,8760,6,15,8,13,42,51,-9,53
RZ Pellets W,8760,7,13,7,16,46,56,-10,46
St. Pölten,8760,8,9,9,18,42,62,-20,36
SV Josko Rie,8760,9,9,7,20,31,57,-26,34
Mattersburg,8760,10,7,7,22,35,60,-25,28
SK Sturm Gra,8761,1,22,8,6,64,30,34,74
FC Salzburg,8761,2,23,4,9,68,33,35,73
Vienna,8761,3,18,6,12,58,47,11,60
Rapid Vienna,8761,4,17,8,11,61,37,24,59
SC Rheindorf,8761,5,16,10,10,58,53,5,58
SV Josko Rie,8761,6,12,5,19,38,57,-19,41
RZ Pellets W,8761,7,11,7,18,41,58,-17,40
St. Pölten,8761,8,10,9,17,46,61,-15,39
Mattersburg,8761,9,6,11,19,37,62,-25,29
Admira Wacke,8761,10,7,8,21,32,65,-33,29
FC Salzburg,8762,1,24,4,8,67,25,42,76
SC Rheindorf,8762,2,18,7,11,52,42,10,61
SK Sturm Gra,8762,3,17,7,12,54,38,16,58
Rapid Vienna,8762,4,16,9,11,55,42,13,57
Vienna,8762,5,17,4,15,59,57,2,55
RZ Pellets W,8762,6,13,9,14,46,49,-3,48
Admira Wacke,8762,7,12,8,16,39,56,-17,44
St. Pölten,8762,8,10,10,16,43,60,-17,40
SV Josko Rie,8762,9,9,9,18,33,53,-20,36
Mattersburg,8762,10,7,7,22,33,59,-26,28
SC Rheindorf,8763,1,23,6,7,57,34,23,75
FC Salzburg,8763,2,20,10,6,59,25,34,70
SK Sturm Gra,8763,3,20,8,8,61,33,28,68
Rapid Vienna,8763,4,16,11,9,54,34,20,59
Vienna,8763,5,16,7,13,58,50,8,55
RZ Pellets W,8763,6,11,8,17,42,61,-19,41
Admira Wacke,8763,7,10,8,18,35,59,-24,38
St. Pölten,8763,8,9,9,18,34,57,-23,36
SV Josko Rie,8763,9,8,7,21,33,53,-20,31
Mattersburg,8763,10,5,10,21,32,59,-27,25
FC Salzburg,8764,1,21,8,7,62,29,33,71
SK Sturm Gra,8764,2,20,7,9,61,28,33,67
Vienna,8764,3,17,9,10,60,51,9,60
SC Rheindorf,8764,4,17,9,10,58,49,9,60
Rapid Vienna,8764,5,14,13,9,58,37,21,55
RZ Pellets W,8764,6,15,6,15,46,51,-5,51
SV Josko Rie,8764,7,12,5,19,38,57,-19,41
Mattersburg,8764,8,8,11,17,37,52,-15,35
Admira Wacke,8764,9,9,6,21,36,64,-28,33
St. Pölten,8764,10,7,6,23,37,75,-38,27
SK Sturm Gra,8765,1,20,8,8,66,37,29,68
SC Rheindorf,8765,2,20,8,8,63,47,16,68
FC Salzburg,8765,3,19,9,8,68,37,31,66
Vienna,8765,4,19,5,12,66,45,21,62
Rapid Vienna,8765,5,16,10,10,56,36,20,58
Admira Wacke,8765,6,13,4,19,43,65,-22,43
Mattersburg,8765,7,11,7,18,46,56,-10,40
RZ Pellets W,8765,8,10,7,19,41,69,-28,37
St. Pölten,8765,9,9,8,19,47,72,-25,35
SV Josko Rie,8765,10,8,4,24,25,57,-32,28
FC Salzburg,8766,1,21,8,7,71,33,38,71
SC Rheindorf,8766,2,21,8,7,60,43,17,71
Vienna,8766,3,19,7,10,70,52,18,64
Rapid Vienna,8766,4,16,8,12,55,37,18,56
SK Sturm Gra,8766,5,15,8,13,54,42,12,53
RZ Pellets W,8766,6,12,9,15,44,52,-8,45
SV Josko Rie,8766,7,11,6,19,33,51,-18,39
Admira Wacke,8766,8,9,8,19,41,69,-28,35
St. Pölten,8766,9,7,12,17,40,63,-23,33
Mattersburg,8766,10,8,8,20,33,59,-26,32
FC Salzburg,8767,1,21,7,8,65,30,35,70
SK Sturm Gra,8767,2,19,8,9,52,28,24,65
Vienna,8767,3,19,8,9,66,48,18,65
SC Rheindorf,8767,4,19,8,9,53,36,17,65
Rapid Vienna,8767,5,14,11,11,60,43,17,53
Admira Wacke,8767,6,11,8,17,34,56,-22,41
Mattersburg,8767,7,9,11,16,42,50,-8,38
SV Josko Rie,8767,8,10,6,20,33,52,-19,36
RZ Pellets W,8767,9,8,11,17,37,62,-25,35
St. Pölten,8767,10,6,10,20,33,70,-37,28
FC Salzburg,8768,1,21,7,8,66,33,33,70
SC Rheindorf,8768,2,19,8,9,54,37,17,65
SK Sturm Gra,8768,3,18,7,11,55,32,23,61
Vienna,8768,4,18,6,12,62,47,15,60
Rapid Vienna,8768,5,15,12,9,59,33,26,57
RZ Pellets W,8768,6,11,8,17,42,59,-17,41
SV Josko Rie,8768,7,11,8,17,36,54,-18,41
Admira Wacke,8768,8,10,7,19,33,64,-31,37
Mattersburg,8768,9,9,8,19,38,57,-19,35
St. Pölten,8768,10,8,9,19,38,67,-29,33
SK Sturm Gra,8769,1,21,6,9,59,29,30,69
Vienna,8769,2,22,3,11,64,51,13,69
FC Salzburg,8769,3,19,11,6,65,29,36,68
SC Rheindorf,8769,4,17,8,11,50,43,7,59
Rapid Vienna,8769,5,14,12,10,57,37,20,54
St. Pölten,8769,6,10,10,16,42,59,-17,40
RZ Pellets W,8769,7,10,8,18,42,57,-15,38
SV Josko Rie,8769,8,10,6,20,32,50,-18,36
Admira Wacke,8769,9,10,6,20,32,66,-34,36
Mattersburg,8769,10,8,8,20,32,54,-22,32
FC Salzburg,8770,1,22,9,5,67,25,42,75
SC Rheindorf,8770,2,21,10,5,66,34,32,73
SK Sturm Gra,8770,3,20,8,8,57,27,30,68
Vienna,8770,4,16,7,13,53,51,2,55
Rapid Vienna,8770,5,12,13,11,50,44,6,49
RZ Pellets W,8770,6,12,9,15,44,52,-8,45
Admira Wacke,8770,7,10,5,21,32,63,-31,35
Mattersburg,8770,8,9,7,20,40,61,-21,34
St. Pölten,8770,9,7,12,17,44,68,-24,33
SV Josko Rie,8770,10,7,8,21,26,54,-28,29
FC Salzburg,8771,1,23,7,6,70,28,42,76
SC Rheindorf,8771,2,19,10,7,55,36,19,67
SK Sturm Gra,8771,3,16,11,9,57,34,23,59
Vienna,8771,4,18,4,14,63,56,7,58
Rapid Vienna,8771,5,15,10,11,67,47,20,55
SV Josko Rie,8771,6,13,6,17,43,57,-14,45
RZ Pellets W,8771,7,13,6,17,45,63,-18,45
Admira Wacke,8771,8,9,9,18,37,65,-28,36
St. Pölten,8771,9,8,9,19,38,63,-25,33
Mattersburg,8771,10,6,8,22,37,63,-26,26
FC Salzburg,8772,1,23,8,5,67,27,40,77
SC Rheindorf,8772,2,19,9,8,56,42,14,66
SK Sturm Gra,8772,3,20,5,11,56,30,26,65
Vienna,8772,4,19,3,14,64,55,9,60
Rapid Vienna,8772,5,13,12,11,64,42,22,51
SV Josko Rie,8772,6,12,6,18,36,49,-13,42
Admira Wacke,8772,7,10,9,17,38,63,-25,39
St. Pölten,8772,8,8,11,17,39,64,-25,35
RZ Pellets W,8772,9,9,7,20,40,63,-23,34
Mattersburg,8772,10,9,6,21,39,64,-25,33
SC Rheindorf,8773,1,22,7,7,67,38,29,73
FC Salzburg,8773,2,19,8,9,64,40,24,65
Vienna,8773,3,19,3,14,64,52,12,60
SK Sturm Gra,8773,4,16,8,12,59,54,5,56
Rapid Vienna,8773,5,14,11,11,59,47,12,53
Admira Wacke,8773,6,16,4,16,47,56,-9,52
RZ Pellets W,8773,7,13,7,16,53,61,-8,46
St. Pölten,8773,8,9,10,17,44,61,-17,37
SV Josko Rie,8773,9,10,5,21,34,56,-22,35
Mattersburg,8773,10,7,7,22,36,62,-26,28
FC Salzburg,8774,1,23,7,6,71,31,40,76
SC Rheindorf,8774,2,19,9,8,66,45,21,66
SK Sturm Gra,8774,3,19,5,12,55,33,22,62
Vienna,8774,4,18,6,12,62,55,7,60
Rapid Vienna,8774,5,13,13,10,55,41,14,52
SV Josko Rie,8774,6,13,5,18,42,57,-15,44
St. Pölten,8774,7,10,8,18,43,63,-20,38
Admira Wacke,8774,8,10,8,18,39,62,-23,38
RZ Pellets W,8774,9,10,7,19,43,62,-19,37
Mattersburg,8774,10,6,10,20,33,60,-27,28
SK Sturm Gra,8775,1,21,6,9,68,34,34,69
FC Salzburg,8775,2,20,7,9,61,29,32,67
Vienna,8775,3,21,4,11,61,51,10,67
Rapid Vienna,8775,4,17,9,10,57,38,19,60
SC Rheindorf,8775,5,18,6,12,55,46,9,60
RZ Pellets W,8775,6,14,6,16,43,53,-10,48
Admira Wacke,8775,7,10,7,19,36,60,-24,37
SV Josko Rie,8775,8,9,7,20,29,48,-19,34
Mattersburg,8775,9,9,6,21,37,60,-23,33
St. Pölten,8775,10,8,8,20,38,66,-28,32
SK Sturm Gra,8776,1,22,4,10,68,34,34,70
Vienna,8776,2,22,2,12,72,51,21,68
SC Rheindorf,8776,3,20,7,9,53,39,14,67
FC Salzburg,8776,4,19,6,11,67,39,28,63
RZ Pellets W,8776,5,15,5,16,51,51,0,50
Rapid Vienna,8776,6,12,9,15,52,46,6,45
Admira Wacke,8776,7,12,7,17,37,59,-22,43
St. Pölten,8776,8,9,10,17,43,67,-24,37
SV Josko Rie,8776,9,10,4,22,32,59,-27,34
Mattersburg,8776,10,8,8,20,36,66,-30,32
SC Rheindorf,8777,1,22,5,9,58,45,13,71
FC Salzburg,8777,2,21,7,8,63,29,34,70
Vienna,8777,3,20,5,11,64,51,13,65
SK Sturm Gra,8777,4,18,7,11,57,34,23,61
Rapid Vienna,8777,5,11,12,13,57,46,11,45
SV Josko Rie,8777,6,14,3,19,39,51,-12,45
Admira Wacke,8777,7,10,9,17,33,54,-21,39
RZ Pellets W,8777,8,10,8,18,50,59,-9,38
St. Pölten,8777,9,8,11,17,36,58,-22,35
Mattersburg,8777,10,8,9,19,32,62,-30,33
FC Salzburg,8778,1,23,6,7,67,28,39,75
SK Sturm Gra,8778,2,21,4,11,59,32,27,67
Vienna,8778,3,19,6,11,68,53,15,63
SC Rheindorf,8778,4,15,9,12,53,50,3,54
Rapid Vienna,8778,5,12,12,12,52,43,9,48
RZ Pellets W,8778,6,14,5,17,44,55,-11,47
Admira Wacke,8778,7,13,7,16,35,52,-17,46
SV Josko Rie,8778,8,12,4,20,40,63,-23,40
Mattersburg,8778,9,7,11,18,32,51,-19,32
St. Pölten,8778,10,8,8,20,40,63,-23,32
FC Salzburg,8779,1,21,8,7,73,33,40,71
SC Rheindorf,8779,2,20,8,8,63,40,23,68
SK Sturm Gra,8779,3,20,7,9,60,34,26,67
Rapid Vienna,8779,4,16,11,9,60,43,17,59
Vienna,8779,5,16,3,17,54,55,-1,51
RZ Pellets W,8779,6,14,9,13,46,48,-2,51
SV Josko Rie,8779,7,13,4,19,39,49,-10,43
Mattersburg,8779,8,9,7,20,33,59,-26,34
Admira Wacke,8779,9,10,4,22,34,67,-33,34
St. Pölten,8779,10,6,9,21,36,70,-34,27
SK Sturm Gra,8780,1,21,7,8,66,31,35,70
FC Salzburg,8780,2,21,6,9,70,35,35,69
SC Rheindorf,8780,3,21,5,10,54,41,13,68
Vienna,8780,4,17,3,16,60,63,-3,54
Rapid Vienna,8780,5,14,10,12,61,44,17,52
RZ Pellets W,8780,6,13,6,17,54,64,-10,45
SV Josko Rie,8780,7,13,3,20,40,56,-16,42
Admira Wacke,8780,8,12,6,18,40,62,-22,42
Mattersburg,8780,9,10,5,21,40,63,-23,35
St. Pölten,8780,10,8,9,19,45,71,-26,33
SC Rheindorf,8781,1,20,10,6,60,36,24,70
FC Salzburg,8781,2,20,7,9,58,30,28,67
SK Sturm Gra,8781,3,19,7,10,67,45,22,64
Vienna,8781,4,19,5,12,64,55,9,62
Rapid Vienna,8781,5,13,10,13,59,43,16,49
St. Pölten,8781,6,12,10,14,40,58,-18,46
Mattersburg,8781,7,12,6,18,43,56,-13,42
RZ Pellets W,8781,8,11,6,19,38,54,-16,39
Admira Wacke,8781,9,10,5,21,37,63,-26,35
SV Josko Rie,8781,10,9,4,23,29,55,-26,31
FC Salzburg,8782,1,22,10,4,73,29,44,76
SK Sturm Gra,8782,2,21,5,10,63,32,31,68
Vienna,8782,3,19,6,11,66,51,15,63
SC Rheindorf,8782,4,17,11,8,55,44,11,62
Rapid Vienna,8782,5,11,14,11,58,47,11,47
Admira Wacke,8782,6,12,6,18,37,59,-22,42
RZ Pellets W,8782,7,11,6,19,44,63,-19,39
St. Pölten,8782,8,8,12,16,50,67,-17,36
SV Josko Rie,8782,9,10,4,22,34,61,-27,34
Mattersburg,8782,10,7,10,19,37,64,-27,31
SC Rheindorf,8783,1,20,8,8,55,41,14,68
Vienna,8783,2,20,5,11,62,52,10,65
FC Salzburg,8783,3,18,9,9,61,35,26,63
SK Sturm Gra,8783,4,19,5,12,58,40,18,62
RZ Pellets W,8783,5,15,7,14,55,53,2,52
Rapid Vienna,8783,6,12,13,11,51,38,13,49
Admira Wacke,8783,7,13,4,19,39,61,-22,43
St. Pölten,8783,8,9,9,18,45,62,-17,36
SV Josko Rie,8783,9,9,7,20,33,52,-19,34
Mattersburg,8783,10,8,7,21,33,58,-25,31
FC Salzburg,8784,1,21,6,9,58,27,31,69
SC Rheindorf,8784,2,18,8,10,53,50,3,62
Vienna,8784,3,19,4,13,63,52,11,61
SK Sturm Gra,8784,4,16,10,10,58,36,22,58
Rapid Vienna,8784,5,13,12,11,57,42,15,51
RZ Pellets W,8784,6,10,12,14,42,52,-10,42
St. Pölten,8784,7,10,11,15,44,61,-17,41
Admira Wacke,8784,8,11,8,17,35,54,-19,41
SV Josko Rie,8784,9,10,8,18,35,52,-17,38
Mattersburg,8784,10,8,9,19,37,56,-19,33
FC Salzburg,8785,1,21,9,6,66,28,38,72
SC Rheindorf,8785,2,22,6,8,57,36,21,72
SK Sturm Gra,8785,3,20,7,9,67,38,29,67
Vienna,8785,4,20,5,11,75,58,17,65
Rapid Vienna,8785,5,13,11,12,50,38,12,50
RZ Pellets W,8785,6,11,8,17,47,61,-14,41
Admira Wacke,8785,7,10,7,19,37,63,-26,37
SV Josko Rie,8785,8,10,4,22,34,60,-26,34
St. Pölten,8785,9,7,11,18,35,64,-29,32
Mattersburg,8785,10,6,12,18,36,58,-22,30
FC Salzburg,8786,1,22,7,7,66,26,40,73
SC Rheindorf,8786,2,22,7,7,57,35,22,73
SK Sturm Gra,8786,3,20,5,11,58,30,28,65
Vienna,8786,4,20,5,11,61,52,9,65
Rapid Vienna,8786,5,13,12,11,55,39,16,51
RZ Pellets W,8786,6,10,11,15,43,54,-11,41
Mattersburg,8786,7,8,11,17,36,57,-21,35
SV Josko Rie,8786,8,9,6,21,30,52,-22,33
Admira Wacke,8786,9,9,6,21,32,69,-37,33
St. Pölten,8786,10,6,12,18,40,64,-24,30
SC Rheindorf,8787,1,20,8,8,55,38,17,68
SK Sturm Gra,8787,2,19,9,8,58,28,30,66
FC Salzburg,8787,3,17,11,8,60,31,29,62
Vienna,8787,4,17,5,14,60,48,12,56
Admira Wacke,8787,5,15,8,13,40,49,-9,53
Rapid Vienna,8787,6,11,12,13,48,44,4,45
RZ Pellets W,8787,7,10,11,15,40,53,-13,41
SV Josko Rie,8787,8,12,5,19,38,55,-17,41
St. Pölten,8787,9,8,11,17,37,60,-23,35
Mattersburg,8787,10,6,10,20,37,67,-30,28
FC Salzburg,8788,1,19,10,7,57,27,30,67
Vienna,8788,2,18,9,9,69,49,20,63
SC Rheindorf,8788,3,17,11,8,55,42,13,62
SK Sturm Gra,8788,4,17,10,9,56,34,22,61
RZ Pellets W,8788,5,14,6,16,48,57,-9,48
Admira Wacke,8788,6,11,10,15,40,54,-14,43
Rapid Vienna,8788,7,9,15,12,54,48,6,42
St. Pölten,8788,8,10,10,16,45,65,-20,40
SV Josko Rie,8788,9,9,7,20,34,57,-23,34
Mattersburg,8788,10,8,8,20,35,60,-25,32
FC Salzburg,8789,1,23,8,5,75,29,46,77
SK Sturm Gra,8789,2,19,6,11,61,34,27,63
Vienna,8789,3,18,4,14,65,60,5,58
SC Rheindorf,8789,4,15,9,12,53,53,0,54
Admira Wacke,8789,5,13,6,17,42,59,-17,45
Rapid Vienna,8789,6,10,14,12,44,42,2,44
RZ Pellets W,8789,7,11,8,17,40,58,-18,41
Mattersburg,8789,8,10,10,16,51,61,-10,40
SV Josko Rie,8789,9,11,7,18,37,58,-21,40
St. Pölten,8789,10,9,10,17,46,60,-14,37
SK Sturm Gra,8790,1,22,7,7,67,34,33,73
FC Salzburg,8790,2,20,10,6,66,35,31,70
Vienna,8790,3,22,4,10,71,45,26,70
SC Rheindorf,8790,4,16,5,15,49,50,-1,53
Rapid Vienna,8790,5,13,11,12,60,47,13,50
RZ Pellets W,8790,6,12,8,16,50,62,-12,44
Admira Wacke,8790,7,12,5,19,38,59,-21,41
SV Josko Rie,8790,8,11,5,20,33,51,-18,38
Mattersburg,8790,9,9,10,17,36,57,-21,37
St. Pölten,8790,10,6,9,21,33,63,-30,27
SC Rheindorf,8791,1,21,7,8,69,43,26,70
SK Sturm Gra,8791,2,20,6,10,55,31,24,66
FC Salzburg,8791,3,18,7,11,57,30,27,61
Vienna,8791,4,16,8,12,57,53,4,56
Rapid Vienna,8791,5,14,11,11,58,38,20,53
RZ Pellets W,8791,6,12,7,17,46,60,-14,43
Mattersburg,8791,7,11,9,16,39,53,-14,42
SV Josko Rie,8791,8,11,5,20,30,51,-21,38
Admira Wacke,8791,9,11,5,20,31,62,-31,38
St. Pölten,8791,10,8,11,17,43,64,-21,35
SC Rheindorf,8792,1,19,8,9,54,41,13,65
FC Salzburg,8792,2,19,7,10,66,34,32,64
Vienna,8792,3,19,7,10,64,45,19,64
SK Sturm Gra,8792,4,18,7,11,63,43,20,61
Rapid Vienna,8792,5,15,13,8,61,38,23,58
RZ Pellets W,8792,6,15,6,15,48,57,-9,51
Admira Wacke,8792,7,11,5,20,37,66,-29,38
SV Josko Rie,8792,8,10,7,19,34,52,-18,37
St. Pölten,8792,9,8,10,18,40,63,-23,34
Mattersburg,8792,10,6,10,20,34,62,-28,28
FC Salzburg,8793,1,21,8,7,74,27,47,71
SK Sturm Gra,8793,2,21,7,8,58,31,27,70
Vienna,8793,3,20,3,13,67,50,17,63
Rapid Vienna,8793,4,15,10,11,59,42,17,55
SC Rheindorf,8793,5,15,10,11,51,45,6,55
RZ Pellets W,8793,6,12,9,15,45,55,-10,45
Admira Wacke,8793,7,13,5,18,37,62,-25,44
SV Josko Rie,8793,8,12,3,21,41,60,-19,39
Mattersburg,8793,9,9,7,20,38,61,-23,34
St. Pölten,8793,10,7,8,21,36,73,-37,29
FC Salzburg,8794,1,23,6,7,65,29,36,75
SC Rheindorf,8794,2,21,7,8,57,35,22,70
SK Sturm Gra,8794,3,17,8,11,53,32,21,59
Rapid Vienna,8794,4,16,9,11,57,41,16,57
Vienna,8794,5,16,6,14,56,50,6,54
Mattersburg,8794,6,12,10,14,39,48,-9,46
Admira Wacke,8794,7,11,7,18,35,60,-25,40
RZ Pellets W,8794,8,10,9,17,41,54,-13,39
SV Josko Rie,8794,9,10,4,22,31,54,-23,34
St. Pölten,8794,10,7,8,21,34,65,-31,29
FC Salzburg,8795,1,24,6,6,75,28,47,78
SC Rheindorf,8795,2,17,11,8,50,41,9,62
SK Sturm Gra,8795,3,18,6,12,54,38,16,60
Rapid Vienna,8795,4,15,12,9,57,35,22,57
RZ Pellets W,8795,5,17,6,13,52,52,0,57
Vienna,8795,6,15,5,16,56,57,-1,50
Admira Wacke,8795,7,11,7,18,38,57,-19,40
SV Josko Rie,8795,8,10,7,19,38,61,-23,37
St. Pölten,8795,9,6,11,19,37,62,-25,29
Mattersburg,8795,10,5,13,18,33,59,-26,28
FC Salzburg,8796,1,19,10,7,59,26,33,67
SC Rheindorf,8796,2,18,8,10,51,40,11,62
Vienna,8796,3,18,7,11,58,49,9,61
SK Sturm Gra,8796,4,18,6,12,61,36,25,60
Rapid Vienna,8796,5,15,10,11,58,37,21,55
Admira Wacke,8796,6,12,8,16,36,55,-19,44
RZ Pellets W,8796,7,12,7,17,42,59,-17,43
SV Josko Rie,8796,8,11,5,20,33,54,-21,38
St. Pölten,8796,9,9,9,18,42,62,-20,36
Mattersburg,8796,10,8,10,18,32,54,-22,34
FC Salzburg,8797,1,21,8,7,66,31,35,71
SK Sturm Gra,8797,2,19,9,8,59,32,27,66
SC Rheindorf,8797,3,19,6,11,61,45,16,63
Vienna,8797,4,19,4,13,74,59,15,61
RZ Pellets W,8797,5,14,8,14,57,60,-3,50
Rapid Vienna,8797,6,12,9,15,51,48,3,45
SV Josko Rie,8797,7,11,7,18,32,51,-19,40
Mattersburg,8797,8,9,10,17,41,60,-19,37
St. Pölten,8797,9,8,11,17,43,69,-26,35
Admira Wacke,8797,10,10,4,22,37,66,-29,34
FC Salzburg,8798,1,21,9,6,70,27,43,72
Rapid Vienna,8798,2,19,10,7,63,30,33,67
Vienna,8798,3,20,3,13,67,52,15,63
SC Rheindorf,8798,4,17,9,10,48,42,6,60
SK Sturm Gra,8798,5,14,9,13,48,40,8,51
RZ Pellets W,8798,6,14,7,15,45,53,-8,49
SV Josko Rie,8798,7,12,5,19,36,50,-14,41
Admira Wacke,8798,8,10,7,19,33,58,-25,37
Mattersburg,8798,9,9,6,21,30,55,-25,33
St. Pölten,8798,10,6,11,19,35,68,-33,29
SK Sturm Gra,8799,1,24,3,9,63,30,33,75
FC Salzburg,8799,2,20,8,8,65,36,29,68
Rapid Vienna,8799,3,17,9,10,65,41,24,60
SC Rheindorf,8799,4,17,9,10,49,40,9,60
Vienna,8799,5,19,3,14,62,56,6,60
RZ Pellets W,8799,6,13,7,16,45,52,-7,46
Admira Wacke,8799,7,11,5,20,35,59,-24,38
SV Josko Rie,8799,8,9,8,19,35,56,-21,35
St. Pölten,8799,9,8,9,19,38,65,-27,33
Mattersburg,8799,10,6,11,19,40,62,-22,29
SC Rheindorf,8800,1,22,7,7,60,38,22,73
FC Salzburg,8800,2,21,8,7,64,28,36,71
SK Sturm Gra,8800,3,19,6,11,65,42,23,63
Vienna,8800,4,16,8,12,64,55,9,56
Rapid Vienna,8800,5,14,9,13,61,45,16,51
RZ Pellets W,8800,6,14,8,14,54,54,0,50
SV Josko Rie,8800,7,11,6,19,37,56,-19,39
Admira Wacke,8800,8,11,6,19,38,68,-30,39
St. Pölten,8800,9,9,8,19,45,74,-29,35
Mattersburg,8800,10,6,8,22,37,65,-28,26
FC Salzburg,8801,1,20,8,8,64,38,26,68
SC Rheindorf,8801,2,20,6,10,62,40,22,66
Vienna,8801,3,18,7,11,62,48,14,61
Rapid Vienna,8801,4,16,12,8,69,40,29,60
SK Sturm Gra,8801,5,18,5,13,50,35,15,59
Admira Wacke,8801,6,13,8,15,35,52,-17,47
SV Josko Rie,8801,7,13,4,19,41,54,-13,43
RZ Pellets W,8801,8,12,6,18,41,61,-20,42
Mattersburg,8801,9,8,7,21,36,59,-23,31
St. Pölten,8801,10,6,9,21,33,66,-33,27
FC Salzburg,8802,1,19,9,8,63,33,30,66
SC Rheindorf,8802,2,19,9,8,54,43,11,66
Vienna,8802,3,20,3,13,65,53,12,63
SK Sturm Gra,8802,4,17,8,11,53,34,19,59
Admira Wacke,8802,5,14,7,15,49,60,-11,49
Rapid Vienna,8802,6,12,12,12,55,45,10,48
Mattersburg,8802,7,12,8,16,45,50,-5,44
RZ Pellets W,8802,8,10,9,17,48,62,-14,39
St. Pölten,8802,9,8,9,19,39,65,-26,33
SV Josko Rie,8802,10,8,8,20,31,57,-26,32
Vienna,8803,1,21,5,10,68,48,20,68
SK Sturm Gra,8803,2,20,7,9,56,27,29,67
FC Salzburg,8803,3,19,8,9,69,30,39,65
SC Rheindorf,8803,4,18,9,9,51,42,9,63
Rapid Vienna,8803,5,17,11,8,64,34,30,62
SV Josko Rie,8803,6,11,8,17,34,47,-13,41
Admira Wacke,8803,7,10,9,17,36,65,-29,39
RZ Pellets W,8803,8,10,8,18,43,61,-18,38
St. Pölten,8803,9,6,11,19,38,67,-29,29
Mattersburg,8803,10,6,8,22,28,66,-38,26
FC Salzburg,8804,1,22,6,8,65,29,36,72
SC Rheindorf,8804,2,19,11,6,60,37,23,68
SK Sturm Gra,8804,3,21,4,11,58,38,20,67
Rapid Vienna,8804,4,13,13,10,63,45,18,52
Vienna,8804,5,15,5,16,63,64,-1,50
Admira Wacke,8804,6,15,5,16,47,62,-15,50
RZ Pellets W,8804,7,13,6,17,49,58,-9,45
Mattersburg,8804,8,9,9,18,48,62,-14,36
SV Josko Rie,8804,9,10,6,20,37,54,-17,36
St. Pölten,8804,10,7,7,22,36,77,-41,28
SK Sturm Gra,8805,1,21,8,7,58,25,33,71
SC Rheindorf,8805,2,20,6,10,55,41,14,66
FC Salzburg,8805,3,18,9,9,58,33,25,63
Rapid Vienna,8805,4,16,12,8,57,34,23,60
Vienna,8805,5,18,4,14,63,56,7,58
RZ Pellets W,8805,6,12,10,14,47,50,-3,46
Admira Wacke,8805,7,12,5,19,35,59,-24,41
Mattersburg,8805,8,9,8,19,37,57,-20,35
SV Josko Rie,8805,9,10,4,22,37,61,-24,34
St. Pölten,8805,10,7,8,21,35,66,-31,29
Vienna,8806,1,19,8,9,67,54,13,65
SK Sturm Gra,8806,2,18,7,11,55,36,19,61
SC Rheindorf,8806,3,17,9,10,55,50,5,60
FC Salzburg,8806,4,16,9,11,63,43,20,57
Rapid Vienna,8806,5,13,13,10,57,43,14,52
RZ Pellets W,8806,6,14,6,16,45,51,-6,48
SV Josko Rie,8806,7,13,5,18,35,47,-12,44
Admira Wacke,8806,8,12,6,18,38,58,-20,42
St. Pölten,8806,9,10,7,19,44,61,-17,37
Mattersburg,8806,10,8,10,18,41,57,-16,34
FC Salzburg,8807,1,20,10,6,65,30,35,70
SC Rheindorf,8807,2,18,8,10,50,39,11,62
Vienna,8807,3,18,7,11,58,49,9,61
SK Sturm Gra,8807,4,18,6,12,59,33,26,60
Rapid Vienna,8807,5,15,12,9,59,36,23,57
RZ Pellets W,8807,6,12,8,16,46,56,-10,44
Admira Wacke,8807,7,11,8,17,41,63,-22,41
St. Pölten,8807,8,10,10,16,40,60,-20,40
SV Josko Rie,8807,9,9,7,20,34,58,-24,34
Mattersburg,8807,10,6,10,20,37,65,-28,28
FC Salzburg,8808,1,20,6,10,67,34,33,66
SK Sturm Gra,8808,2,20,6,10,64,39,25,66
Vienna,8808,3,19,6,11,61,46,15,63
SC Rheindorf,8808,4,18,7,11,52,45,7,61
Rapid Vienna,8808,5,14,12,10,58,45,13,54
St. Pölten,8808,6,11,9,16,47,58,-11,42
Admira Wacke,8808,7,11,8,17,40,61,-21,41
RZ Pellets W,8808,8,10,7,19,43,63,-20,37
Mattersburg,8808,9,8,12,16,36,52,-16,36
SV Josko Rie,8808,10,10,5,21,33,58,-25,35
FC Salzburg,8809,1,23,6,7,64,28,36,75
SK Sturm Gra,8809,2,23,6,7,59,25,34,75
SC Rheindorf,8809,3,19,7,10,49,41,8,64
Vienna,8809,4,18,4,14,62,53,9,58
SV Josko Rie,8809,5,15,5,16,42,51,-9,50
Rapid Vienna,8809,6,11,12,13,50,42,8,45
RZ Pellets W,8809,7,12,7,17,41,54,-13,43
Mattersburg,8809,8,9,8,19,40,52,-12,35
St. Pölten,8809,9,8,7,21,34,59,-25,31
Admira Wacke,8809,10,9,4,23,36,72,-36,31
FC Salzburg,8810,1,21,8,7,69,32,37,71
SK Sturm Gra,8810,2,19,8,9,53,29,24,65
Vienna,8810,3,19,3,14,58,53,5,60
SC Rheindorf,8810,4,18,4,14,50,47,3,58
Rapid Vienna,8810,5,14,11,11,56,40,16,53
RZ Pellets W,8810,6,15,5,16,55,58,-3,50
St. Pölten,8810,7,11,9,16,52,63,-11,42
SV Josko Rie,8810,8,12,6,18,39,55,-16,42
Admira Wacke,8810,9,10,6,20,35,59,-24,36
Mattersburg,8810,10,5,12,19,37,68,-31,27
Vienna,8811,1,23,3,10,71,46,25,72
FC Salzburg,8811,2,20,8,8,68,32,36,68
SC Rheindorf,8811,3,20,7,9,55,42,13,67
SK Sturm Gra,8811,4,19,5,12,55,34,21,62
Rapid Vienna,8811,5,14,10,12,58,42,16,52
RZ Pellets W,8811,6,14,7,15,43,50,-7,49
Admira Wacke,8811,7,11,4,21,38,68,-30,37
Mattersburg,8811,8,9,9,18,42,57,-15,36
SV Josko Rie,8811,9,9,5,22,32,59,-27,32
St. Pölten,8811,10,8,8,20,39,71,-32,32
SC Rheindorf,8812,1,21,5,10,57,43,14,68
Vienna,8812,2,21,3,12,66,54,12,66
FC Salzburg,8812,3,19,8,9,63,33,30,65
SK Sturm Gra,8812,4,19,5,12,59,32,27,62
Rapid Vienna,8812,5,17,10,9,61,40,21,61
RZ Pellets W,8812,6,13,8,15,46,53,-7,47
Admira Wacke,8812,7,12,4,20,39,61,-22,40
SV Josko Rie,8812,8,9,7,20,36,62,-26,34
Mattersburg,8812,9,8,8,20,41,59,-18,32
St. Pölten,8812,10,7,10,19,43,74,-31,31
FC Salzburg,8813,1,22,6,8,68,33,35,72
SC Rheindorf,8813,2,18,7,11,53,45,8,61
Vienna,8813,3,18,6,12,63,56,7,60
SK Sturm Gra,8813,4,18,5,13,58,35,23,59
Rapid Vienna,8813,5,15,10,11,59,39,20,55
RZ Pellets W,8813,6,15,6,15,56,56,0,51
Admira Wacke,8813,7,11,9,16,36,60,-24,42
Mattersburg,8813,8,8,12,16,35,53,-18,36
St. Pölten,8813,9,9,7,20,43,64,-21,34
SV Josko Rie,8813,10,8,8,20,29,59,-30,32
FC Salzburg,8814,1,22,9,5,71,31,40,75
SC Rheindorf,8814,2,18,10,8,56,43,13,64
SK Sturm Gra,8814,3,19,6,11,63,37,26,63
Vienna,8814,4,18,5,13,66,52,14,59
Rapid Vienna,8814,5,13,12,11,51,39,12,51
Admira Wacke,8814,6,11,10,15,42,60,-18,43
SV Josko Rie,8814,7,10,8,18,34,52,-18,38
RZ Pellets W,8814,8,9,10,17,41,60,-19,37
St. Pölten,8814,9,8,11,17,41,68,-27,35
Mattersburg,8814,10,7,9,20,35,58,-23,30
FC Salzburg,8815,1,20,8,8,68,34,34,68
SC Rheindorf,8815,2,20,8,8,54,42,12,68
Vienna,8815,3,20,7,9,57,43,14,67
SK Sturm Gra,8815,4,18,7,11,54,35,19,61
Rapid Vienna,8815,5,11,12,13,59,45,14,45
SV Josko Rie,8815,6,11,9,16,37,48,-11,42
RZ Pellets W,8815,7,11,8,17,44,58,-14,41
Admira Wacke,8815,8,10,9,17,33,56,-23,39
St. Pölten,8815,9,9,8,19,46,68,-22,35
Mattersburg,8815,10,8,8,20,40,63,-23,32
SK Sturm Gra,8816,1,21,6,9,61,34,27,69
FC Salzburg,8816,2,18,12,6,62,32,30,66
SC Rheindorf,8816,3,18,10,8,52,40,12,64
Rapid Vienna,8816,4,18,8,10,69,39,30,62
Vienna,8816,5,19,5,12,65,48,17,62
RZ Pellets W,8816,6,11,7,18,38,58,-20,40
Mattersburg,8816,7,9,9,18,36,55,-19,36
St. Pölten,8816,8,10,6,20,39,63,-24,36
Admira Wacke,8816,9,9,7,20,32,60,-28,34
SV Josko Rie,8816,10,9,6,21,33,58,-25,33
FC Salzburg,8817,1,23,6,7,64,31,33,75
SC Rheindorf,8817,2,22,6,8,71,42,29,72
SK Sturm Gra,8817,3,21,5,10,66,39,27,68
Vienna,8817,4,20,3,13,63,51,12,63
RZ Pellets W,8817,5,14,4,18,49,56,-7,46
Rapid Vienna,8817,6,11,12,13,53,48,5,45
Admira Wacke,8817,7,12,3,21,41,68,-27,39
Mattersburg,8817,8,8,11,17,38,52,-14,35
St. Pölten,8817,9,7,12,17,36,67,-31,33
SV Josko Rie,8817,10,8,6,22,30,57,-27,30
SC Rheindorf,8818,1,21,5,10,60,40,20,68
Vienna,8818,2,21,5,10,64,45,19,68
Rapid Vienna,8818,3,18,9,9,62,38,24,63
FC Salzburg,8818,4,17,10,9,59,38,21,61
SK Sturm Gra,8818,5,18,6,12,58,40,18,60
St. Pölten,8818,6,13,8,15,53,59,-6,47
Admira Wacke,8818,7,11,7,18,37,58,-21,40
RZ Pellets W,8818,8,10,6,20,41,66,-25,36
SV Josko Rie,8818,9,8,7,21,30,55,-25,31
Mattersburg,8818,10,6,11,19,37,62,-25,29
Vienna,8819,1,25,2,9,81,40,41,77
SK Sturm Gra,8819,2,20,6,10,56,37,19,66
SC Rheindorf,8819,3,20,6,10,51,39,12,66
FC Salzburg,8819,4,18,9,9,63,32,31,63
Rapid Vienna,8819,5,14,9,13,59,46,13,51
SV Josko Rie,8819,6,13,3,20,33,55,-22,42
RZ Pellets W,8819,7,12,5,19,50,61,-11,41
Mattersburg,8819,8,9,8,19,31,55,-24,35
Admira Wacke,8819,9,9,7,20,37,65,-28,34
St. Pölten,8819,10,8,9,19,37,68,-31,33
SK Sturm Gra,8820,1,22,5,9,64,31,33,71
FC Salzburg,8820,2,20,8,8,65,30,35,68
SC Rheindorf,8820,3,19,10,7,54,38,16,67
Rapid Vienna,8820,4,13,13,10,51,37,14,52
SV Josko Rie,8820,5,13,8,15,45,48,-3,47
Vienna,8820,6,14,4,18,50,65,-15,46
RZ Pellets W,8820,7,13,6,17,44,52,-8,45
Admira Wacke,8820,8,12,5,19,38,54,-16,41
Mattersburg,8820,9,8,9,19,36,59,-23,33
St. Pölten,8820,10,7,10,19,37,70,-33,31
FC Salzburg,8821,1,20,8,8,67,34,33,68
Vienna,8821,2,21,4,11,66,47,19,67
SK Sturm Gra,8821,3,18,5,13,60,38,22,59
SC Rheindorf,8821,4,17,8,11,48,44,4,59
Rapid Vienna,8821,5,15,12,9,57,39,18,57
Admira Wacke,8821,6,16,4,16,43,56,-13,52
RZ Pellets W,8821,7,14,7,15,49,49,0,49
SV Josko Rie,8821,8,10,7,19,31,51,-20,37
St. Pölten,8821,9,7,8,21,34,67,-33,29
Mattersburg,8821,10,7,7,22,33,63,-30,28
SC Rheindorf,8822,1,20,5,11,61,43,18,65
Vienna,8822,2,19,7,10,65,52,13,64
FC Salzburg,8822,3,18,8,10,55,29,26,62
SK Sturm Gra,8822,4,18,7,11,55,35,20,61
Rapid Vienna,8822,5,13,12,11,52,39,13,51
Admira Wacke,8822,6,12,10,14,41,54,-13,46
RZ Pellets W,8822,7,12,7,17,45,60,-15,43
St. Pölten,8822,8,10,9,17,42,59,-17,39
Mattersburg,8822,9,10,8,18,40,56,-16,38
SV Josko Rie,8822,10,8,7,21,30,59,-29,31
FC Salzburg,8823,1,20,8,8,58,28,30,68
SK Sturm Gra,8823,2,20,6,10,60,38,22,66
Vienna,8823,3,18,4,14,56,49,7,58
SC Rheindorf,8823,4,15,9,12,47,43,4,54
Rapid Vienna,8823,5,12,13,11,56,43,13,49
RZ Pellets W,8823,6,14,6,16,51,55,-4,48
SV Josko Rie,8823,7,14,6,16,40,46,-6,48
Admira Wacke,8823,8,11,6,19,40,64,-24,39
Mattersburg,8823,9,8,12,16,41,55,-14,36
St. Pölten,8823,10,8,10,18,45,73,-28,34
SC Rheindorf,8824,1,23,6,7,57,34,23,75
SK Sturm Gra,8824,2,20,6,10,64,34,30,66
FC Salzburg,8824,3,18,10,8,59,28,31,64
Rapid Vienna,8824,4,17,8,11,56,45,11,59
Vienna,8824,5,16,6,14,53,57,-4,54
Admira Wacke,8824,6,12,7,17,44,58,-14,43
RZ Pellets W,8824,7,12,6,18,43,58,-15,42
SV Josko Rie,8824,8,11,5,20,40,55,-15,38
Mattersburg,8824,9,9,7,20,34,53,-19,34
St. Pölten,8824,10,7,9,20,39,67,-28,30
SC Rheindorf,8825,1,22,8,6,65,35,30,74
FC Salzburg,8825,2,19,9,8,71,33,38,66
Rapid Vienna,8825,3,14,13,9,55,36,19,55
SK Sturm Gra,8825,4,16,7,13,54,44,10,55
Vienna,8825,5,17,4,15,61,57,4,55
Admira Wacke,8825,6,14,9,13,41,52,-11,51
St. Pölten,8825,7,10,8,18,44,60,-16,38
RZ Pellets W,8825,8,10,8,18,39,61,-22,38
Mattersburg,8825,9,9,8,19,34,58,-24,35
SV Josko Rie,8825,10,9,6,21,36,64,-28,33
FC Salzburg,8826,1,23,4,9,81,36,45,73
SC Rheindorf,8826,2,22,6,8,61,40,21,72
Vienna,8826,3,21,6,9,72,50,22,69
SK Sturm Gra,8826,4,20,6,10,64,38,26,66
Rapid Vienna,8826,5,16,9,11,59,42,17,57
RZ Pellets W,8826,6,13,10,13,48,50,-2,49
St. Pölten,8826,7,7,11,18,39,66,-27,32
Mattersburg,8826,8,7,9,20,36,60,-24,30
SV Josko Rie,8826,9,6,9,21,29,62,-33,27
Admira Wacke,8826,10,7,6,23,27,72,-45,27
FC Salzburg,8827,1,21,8,7,66,30,36,71
SC Rheindorf,8827,2,18,9,9,56,41,15,63
SK Sturm Gra,8827,3,18,8,10,60,41,19,62
Rapid Vienna,8827,4,16,11,9,60,37,23,59
Vienna,8827,5,16,5,15,67,65,2,53
RZ Pellets W,8827,6,12,6,18,44,64,-20,42
Admira Wacke,8827,7,11,8,17,43,60,-17,41
St. Pölten,8827,8,10,8,18,47,61,-14,38
SV Josko Rie,8827,9,11,4,21,37,57,-20,37
Mattersburg,8827,10,8,11,17,33,57,-24,35
SC Rheindorf,8828,1,22,7,7,62,43,19,73
Vienna,8828,2,20,7,9,65,48,17,67
FC Salzburg,8828,3,17,9,10,57,32,25,60
SK Sturm Gra,8828,4,17,8,11,61,41,20,59
Rapid Vienna,8828,5,14,10,12,56,45,11,52
RZ Pellets W,8828,6,13,9,14,48,53,-5,48
Admira Wacke,8828,7,10,9,17,33,52,-19,39
St. Pölten,8828,8,9,9,18,42,62,-20,36
SV Josko Rie,8828,9,10,4,22,28,56,-28,34
Mattersburg,8828,10,7,10,19,37,57,-20,31
FC Salzburg,8829,1,21,10,5,73,26,47,73
SK Sturm Gra,8829,2,19,7,10,53,35,18,64
SC Rheindorf,8829,3,20,4,12,58,49,9,64
Vienna,8829,4,18,6,12,63,53,10,60
Rapid Vienna,8829,5,16,10,10,61,41,20,58
RZ Pellets W,8829,6,13,6,17,54,59,-5,45
St. Pölten,8829,7,10,10,16,44,61,-17,40
Admira Wacke,8829,8,11,5,20,40,66,-26,38
SV Josko Rie,8829,9,9,7,20,26,52,-26,34
Mattersburg,8829,10,6,9,21,33,63,-30,27
SC Rheindorf,8830,1,23,7,6,62,36,26,76
FC Salzburg,8830,2,22,5,9,74,32,42,71
Vienna,8830,3,20,6,10,70,45,25,66
SK Sturm Gra,8830,4,19,4,13,54,41,13,61
St. Pölten,8830,5,14,8,14,42,54,-12,50
Rapid Vienna,8830,6,13,9,14,54,47,7,48
RZ Pellets W,8830,7,13,8,15,51,58,-7,47
Mattersburg,8830,8,8,9,19,43,62,-19,33
Admira Wacke,8830,9,7,8,21,27,67,-40,29
SV Josko Rie,8830,10,7,4,25,32,67,-35,25
FC Salzburg,8831,1,22,8,6,71,33,38,74
Vienna,8831,2,21,5,10,68,46,22,68
SC Rheindorf,8831,3,19,8,9,64,50,14,65
SK Sturm Gra,8831,4,18,7,11,57,37,20,61
Rapid Vienna,8831,5,16,8,12,57,43,14,56
RZ Pellets W,8831,6,12,5,19,42,59,-17,41
Admira Wacke,8831,7,12,4,20,43,65,-22,40
SV Josko Rie,8831,8,11,4,21,36,56,-20,37
Mattersburg,8831,9,9,8,19,41,60,-19,35
St. Pölten,8831,10,6,11,19,42,72,-30,29
SC Rheindorf,8832,1,21,9,6,63,38,25,72
SK Sturm Gra,8832,2,20,6,10,63,37,26,66
FC Salzburg,8832,3,18,11,7,67,33,34,65
Vienna,8832,4,21,2,13,73,59,14,65
Rapid Vienna,8832,5,14,11,11,53,39,14,53
RZ Pellets W,8832,6,12,7,17,44,54,-10,43
SV Josko Rie,8832,7,11,5,20,40,57,-17,38
Mattersburg,8832,8,10,8,18,36,54,-18,38
Admira Wacke,8832,9,10,7,19,35,63,-28,37
St. Pölten,8832,10,6,8,22,31,71,-40,26
FC Salzburg,8833,1,20,10,6,62,27,35,70
SC Rheindorf,8833,2,19,10,7,55,37,18,67
SK Sturm Gra,8833,3,18,9,9,59,33,26,63
Rapid Vienna,8833,4,13,12,11,60,42,18,51
Vienna,8833,5,14,6,16,55,59,-4,48
RZ Pellets W,8833,6,12,8,16,47,58,-11,44
St. Pölten,8833,7,11,8,17,45,65,-20,41
Admira Wacke,8833,8,11,8,17,38,60,-22,41
SV Josko Rie,8833,9,11,6,19,39,56,-17,39
Mattersburg,8833,10,7,11,18,35,58,-23,32
SK Sturm Gra,8834,1,21,8,7,63,32,31,71
FC Salzburg,8834,2,20,9,7,65,34,31,69
SC Rheindorf,8834,3,20,8,8,60,39,21,68
Vienna,8834,4,20,5,11,63,51,12,65
Rapid Vienna,8834,5,10,15,11,48,42,6,45
RZ Pellets W,8834,6,10,9,17,41,57,-16,39
Admira Wacke,8834,7,10,8,18,36,56,-20,38
SV Josko Rie,8834,8,9,9,18,31,50,-19,36
St. Pölten,8834,9,9,9,18,36,62,-26,36
Mattersburg,8834,10,6,10,20,33,53,-20,28
FC Salzburg,8835,1,22,8,6,69,32,37,74
SC Rheindorf,8835,2,21,6,9,61,44,17,69
SK Sturm Gra,8835,3,19,9,8,59,32,27,66
Vienna,8835,4,15,8,13,60,56,4,53
Rapid Vienna,8835,5,13,10,13,51,44,7,49
Admira Wacke,8835,6,12,7,17,34,54,-20,43
RZ Pellets W,8835,7,11,9,16,40,54,-14,42
SV Josko Rie,8835,8,9,11,16,34,48,-14,38
St. Pölten,8835,9,9,9,18,46,68,-22,36
Mattersburg,8835,10,7,7,22,33,55,-22,28
FC Salzburg,8836,1,26,6,4,73,24,49,84
SK Sturm Gra,8836,2,20,6,10,60,35,25,66
SC Rheindorf,8836,3,17,9,10,56,43,13,60
Vienna,8836,4,16,6,14,58,53,5,54
Rapid Vienna,8836,5,13,12,11,56,42,14,51
SV Josko Rie,8836,6,12,6,18,34,53,-19,42
RZ Pellets W,8836,7,10,9,17,40,57,-17,39
Admira Wacke,8836,8,10,7,19,40,63,-23,37
Mattersburg,8836,9,9,8,19,37,58,-21,35
St. Pölten,8836,10,8,9,19,38,64,-26,33
FC Salzburg,8837,1,21,8,7,67,31,36,71
SC Rheindorf,8837,2,19,10,7,58,39,19,67
SK Sturm Gra,8837,3,19,8,9,60,36,24,65
Vienna,8837,4,18,6,12,57,50,7,60
Rapid Vienna,8837,5,15,12,9,57,37,20,57
RZ Pellets W,8837,6,12,6,18,43,57,-14,42
SV Josko Rie,8837,7,11,8,17,28,45,-17,41
Admira Wacke,8837,8,10,6,20,35,64,-29,36
St. Pölten,8837,9,7,11,18,39,62,-23,32
Mattersburg,8837,10,6,9,21,32,55,-23,27
SC Rheindorf,8838,1,23,7,6,61,37,24,76
SK Sturm Gra,8838,2,20,6,10,64,37,27,66
Vienna,8838,3,18,4,14,60,56,4,58
FC Salzburg,8838,4,16,9,11,55,34,21,57
Rapid Vienna,8838,5,13,11,12,55,41,14,50
RZ Pellets W,8838,6,14,5,17,44,57,-13,47
St. Pölten,8838,7,10,12,14,52,60,-8,42
SV Josko Rie,8838,8,12,5,19,41,56,-15,41
Mattersburg,8838,9,9,7,20,36,58,-22,34
Admira Wacke,8838,10,8,8,20,33,65,-32,32
FC Salzburg,8839,1,20,8,8,65,31,34,68
Vienna,8839,2,21,4,11,66,49,17,67
SK Sturm Gra,8839,3,20,5,11,67,37,30,65
SC Rheindorf,8839,4,19,8,9,55,44,11,65
Rapid Vienna,8839,5,14,12,10,52,39,13,54
RZ Pellets W,8839,6,12,9,15,38,49,-11,45
Admira Wacke,8839,7,10,8,18,32,56,-24,38
St. Pölten,8839,8,8,10,18,38,60,-22,34
SV Josko Rie,8839,9,8,8,20,34,61,-27,32
Mattersburg,8839,10,6,12,18,38,59,-21,30
FC Salzburg,8840,1,22,6,8,75,36,39,72
SK Sturm Gra,8840,2,21,7,8,62,30,32,70
SC Rheindorf,8840,3,19,6,11,60,46,14,63
Vienna,8840,4,19,3,14,65,56,9,60
Rapid Vienna,8840,5,15,9,12,58,45,13,54
RZ Pellets W,8840,6,12,8,16,46,55,-9,44
St. Pölten,8840,7,11,9,16,50,67,-17,42
Admira Wacke,8840,8,9,8,19,34,68,-34,35
Mattersburg,8840,9,8,9,19,39,60,-21,33
SV Josko Rie,8840,10,9,5,22,30,56,-26,32
FC Salzburg,8841,1,23,6,7,66,29,37,75
SC Rheindorf,8841,2,18,10,8,64,49,15,64
SK Sturm Gra,8841,3,18,9,9,59,37,22,63
Vienna,8841,4,19,6,11,59,48,11,63
Rapid Vienna,8841,5,15,8,13,59,41,18,53
RZ Pellets W,8841,6,12,7,17,46,52,-6,43
Admira Wacke,8841,7,12,7,17,49,65,-16,43
Mattersburg,8841,8,8,10,18,35,59,-24,34
SV Josko Rie,8841,9,10,4,22,31,57,-26,34
St. Pölten,8841,10,8,7,21,37,68,-31,31
SK Sturm Gra,8842,1,22,4,10,71,36,35,70
FC Salzburg,8842,2,21,6,9,60,31,29,69
SC Rheindorf,8842,3,19,8,9,61,43,18,65
Vienna,8842,4,18,6,12,69,62,7,60
Rapid Vienna,8842,5,14,9,13,56,43,13,51
Admira Wacke,8842,6,13,5,18,43,63,-20,44
St. Pölten,8842,7,12,6,18,44,63,-19,42
RZ Pellets W,8842,8,11,5,20,46,67,-21,38
Mattersburg,8842,9,9,8,19,35,54,-19,35
SV Josko Rie,8842,10,10,5,21,30,53,-23,35
SC Rheindorf,8843,1,21,7,8,62,42,20,70
FC Salzburg,8843,2,20,9,7,68,35,33,69
SK Sturm Gra,8843,3,20,5,11,54,34,20,65
Vienna,8843,4,17,5,14,60,52,8,56
Rapid Vienna,8843,5,15,10,11,54,38,16,55
RZ Pellets W,8843,6,12,6,18,49,57,-8,42
Admira Wacke,8843,7,11,7,18,42,65,-23,40
SV Josko Rie,8843,8,12,4,20,39,62,-23,40
St. Pölten,8843,9,9,8,19,42,67,-25,35
Mattersburg,8843,10,9,7,20,39,57,-18,34
SK Sturm Gra,8844,1,22,6,8,65,35,30,72
Vienna,8844,2,21,3,12,69,54,15,66
FC Salzburg,8844,3,19,7,10,59,31,28,64
SC Rheindorf,8844,4,17,11,8,57,44,13,62
Rapid Vienna,8844,5,15,11,10,62,39,23,56
RZ Pellets W,8844,6,12,5,19,44,60,-16,41
SV Josko Rie,8844,7,12,4,20,32,49,-17,40
Admira Wacke,8844,8,11,5,20,40,62,-22,38
Mattersburg,8844,9,9,7,20,39,59,-20,34
St. Pölten,8844,10,8,9,19,34,68,-34,33
SC Rheindorf,8845,1,22,8,6,56,33,23,74
FC Salzburg,8845,2,21,8,7,63,27,36,71
SK Sturm Gra,8845,3,21,5,10,65,37,28,68
Vienna,8845,4,15,8,13,48,44,4,53
Rapid Vienna,8845,5,11,13,12,53,48,5,46
RZ Pellets W,8845,6,13,6,17,48,59,-11,45
Admira Wacke,8845,7,12,6,18,40,60,-20,42
SV Josko Rie,8845,8,10,7,19,33,51,-18,37
Mattersburg,8845,9,8,9,19,34,56,-22,33
St. Pölten,8845,10,7,10,19,41,66,-25,31
FC Salzburg,8846,1,21,9,6,61,29,32,72
SC Rheindorf,8846,2,19,9,8,55,39,16,66
SK Sturm Gra,8846,3,17,10,9,55,33,22,61
Vienna,8846,4,17,4,15,54,52,2,55
Rapid Vienna,8846,5,14,11,11,55,37,18,53
SV Josko Rie,8846,6,13,4,19,43,55,-12,43
RZ Pellets W,8846,7,11,9,16,37,51,-14,42
Mattersburg,8846,8,10,9,17,39,55,-16,39
Admira Wacke,8846,9,10,7,19,31,56,-25,37
St. Pölten,8846,10,7,10,19,35,58,-23,31
FC Salzburg,8847,1,18,11,7,62,32,30,65
SK Sturm Gra,8847,2,19,7,10,57,34,23,64
Vienna,8847,3,18,8,10,64,52,12,62
Rapid Vienna,8847,4,16,13,7,56,31,25,61
SC Rheindorf,8847,5,17,7,12,48,39,9,58
SV Josko Rie,8847,6,11,9,16,38,49,-11,42
RZ Pellets W,8847,7,11,8,17,45,57,-12,41
St. Pölten,8847,8,10,8,18,45,68,-23,38
Admira Wacke,8847,9,8,10,18,34,61,-27,34
Mattersburg,8847,10,8,7,21,32,58,-26,31
FC Salzburg,8848,1,21,5,10,69,35,34,68
SC Rheindorf,8848,2,21,4,11,58,41,17,67
Vienna,8848,3,20,5,11,62,50,12,65
SK Sturm Gra,8848,4,19,7,10,61,38,23,64
Rapid Vienna,8848,5,13,10,13,54,44,10,49
Admira Wacke,8848,6,12,9,15,36,52,-16,45
RZ Pellets W,8848,7,10,10,16,45,54,-9,40
SV Josko Rie,8848,8,11,4,21,38,62,-24,37
St. Pölten,8848,9,9,8,19,40,69,-29,35
Mattersburg,8848,10,8,10,18,42,60,-18,34
Vienna,8849,1,19,9,8,61,43,18,66
SC Rheindorf,8849,2,20,6,10,57,46,11,66
FC Salzburg,8849,3,19,8,9,61,31,30,65
SK Sturm Gra,8849,4,20,5,11,65,36,29,65
Rapid Vienna,8849,5,16,12,8,56,33,23,60
RZ Pellets W,8849,6,11,11,14,44,51,-7,44
Admira Wacke,8849,7,10,6,20,33,61,-28,36
SV Josko Rie,8849,8,9,7,20,35,58,-23,34
St. Pölten,8849,9,8,9,19,41,69,-28,33
Mattersburg,8849,10,6,11,19,28,53,-25,29
FC Salzburg,8850,1,21,8,7,67,31,36,71
SK Sturm Gra,8850,2,20,8,8,71,34,37,68
SC Rheindorf,8850,3,19,7,10,58,48,10,64
Vienna,8850,4,17,7,12,71,59,12,58
Rapid Vienna,8850,5,14,11,11,52,38,14,53
RZ Pellets W,8850,6,13,10,13,43,53,-10,49
St. Pölten,8850,7,9,12,15,39,60,-21,39
Admira Wacke,8850,8,10,6,20,36,60,-24,36
Mattersburg,8850,9,8,11,17,42,56,-14,35
SV Josko Rie,8850,10,7,4,25,30,70,-40,25
FC Salzburg,8851,1,20,11,5,54,24,30,71
SK Sturm Gra,8851,2,20,6,10,62,33,29,66
SC Rheindorf,8851,3,17,9,10,48,39,9,60
Rapid Vienna,8851,4,13,12,11,58,40,18,51
RZ Pellets W,8851,5,13,10,13,46,49,-3,49
Vienna,8851,6,14,7,15,49,55,-6,49
Admira Wacke,8851,7,11,10,15,42,55,-13,43
SV Josko Rie,8851,8,10,9,17,34,54,-20,39
Mattersburg,8851,9,9,8,19,33,54,-21,35
St. Pölten,8851,10,7,10,19,40,63,-23,31
SC Rheindorf,8852,1,21,8,7,59,37,22,71
FC Salzburg,8852,2,21,7,8,66,31,35,70
Vienna,8852,3,20,6,10,68,49,19,66
SK Sturm Gra,8852,4,20,5,11,55,35,20,65
RZ Pellets W,8852,5,14,5,17,45,54,-9,47
Rapid Vienna,8852,6,11,12,13,51,38,13,45
Mattersburg,8852,7,10,8,18,37,57,-20,38
Admira Wacke,8852,8,11,5,20,34,67,-33,38
SV Josko Rie,8852,9,11,4,21,36,54,-18,37
St. Pölten,8852,10,6,10,20,38,67,-29,28
SC Rheindorf,8853,1,21,9,6,56,37,19,72
FC Salzburg,8853,2,21,6,9,66,34,32,69
Vienna,8853,3,20,3,13,63,46,17,63
SK Sturm Gra,8853,4,18,7,11,59,39,20,61
Rapid Vienna,8853,5,15,8,13,59,43,16,53
RZ Pellets W,8853,6,14,7,15,47,56,-9,49
Admira Wacke,8853,7,12,6,18,37,54,-17,42
SV Josko Rie,8853,8,11,5,20,35,58,-23,38
St. Pölten,8853,9,5,14,17,37,66,-29,29
Mattersburg,8853,10,7,7,22,39,65,-26,28
FC Salzburg,8854,1,20,5,11,59,38,21,65
SC Rheindorf,8854,2,20,5,11,57,42,15,65
SK Sturm Gra,8854,3,19,7,10,75,38,37,64
Vienna,8854,4,19,3,14,63,61,2,60
Rapid Vienna,8854,5,14,12,10,52,37,15,54
SV Josko Rie,8854,6,13,4,19,36,53,-17,43
Mattersburg,8854,7,11,8,17,46,56,-10,41
RZ Pellets W,8854,8,10,9,17,48,61,-13,39
St. Pölten,8854,9,10,9,17,43,71,-28,39
Admira Wacke,8854,10,10,6,20,38,60,-22,36
FC Salzburg,8855,1,23,7,6,75,31,44,76
SK Sturm Gra,8855,2,19,5,12,60,42,18,62
Rapid Vienna,8855,3,16,10,10,62,41,21,58
Vienna,8855,4,18,3,15,54,52,2,57
SC Rheindorf,8855,5,15,9,12,46,46,0,54
RZ Pellets W,8855,6,14,5,17,50,52,-2,47
Admira Wacke,8855,7,13,6,17,41,64,-23,45
SV Josko Rie,8855,8,10,8,18,32,52,-20,38
Mattersburg,8855,9,8,11,17,35,52,-17,35
St. Pölten,8855,10,7,10,19,43,66,-23,31
FC Salzburg,8856,1,20,9,7,65,29,36,69
SC Rheindorf,8856,2,19,8,9,57,43,14,65
SK Sturm Gra,8856,3,19,7,10,54,33,21,64
Rapid Vienna,8856,4,16,10,10,63,36,27,58
Vienna,8856,5,17,5,14,57,54,3,56
RZ Pellets W,8856,6,14,8,14,57,61,-4,50
Admira Wacke,8856,7,12,6,18,34,57,-23,42
SV Josko Rie,8856,8,10,6,20,29,51,-22,36
St. Pölten,8856,9,6,13,17,38,60,-22,31
Mattersburg,8856,10,7,8,21,31,61,-30,29
SC Rheindorf,8857,1,21,7,8,61,43,18,70
FC Salzburg,8857,2,20,7,9,64,33,31,67
SK Sturm Gra,8857,3,18,8,10,55,36,19,62
Vienna,8857,4,19,5,12,69,55,14,62
Rapid Vienna,8857,5,16,10,10,63,36,27,58
RZ Pellets W,8857,6,10,11,15,43,54,-11,41
Admira Wacke,8857,7,11,8,17,36,56,-20,41
Mattersburg,8857,8,9,8,19,38,59,-21,35
SV Josko Rie,8857,9,8,8,20,35,62,-27,32
St. Pölten,8857,10,7,10,19,32,62,-30,31
FC Salzburg,8858,1,22,5,9,59,30,29,71
SC Rheindorf,8858,2,20,8,8,55,36,19,68
Vienna,8858,3,18,8,10,60,50,10,62
SK Sturm Gra,8858,4,17,8,11,58,39,19,59
RZ Pellets W,8858,5,13,8,15,48,54,-6,47
Rapid Vienna,8858,6,12,10,14,54,45,9,46
St. Pölten,8858,7,11,9,16,47,62,-15,42
SV Josko Rie,8858,8,10,7,19,38,54,-16,37
Admira Wacke,8858,9,9,8,19,32,58,-26,35
Mattersburg,8858,10,8,9,19,35,58,-23,33
Vienna,8859,1,22,4,10,72,48,24,70
SC Rheindorf,8859,2,18,11,7,65,47,18,65
FC Salzburg,8859,3,19,7,10,65,37,28,64
SK Sturm Gra,8859,4,17,10,9,52,33,19,61
Rapid Vienna,8859,5,14,12,10,60,41,19,54
RZ Pellets W,8859,6,10,11,15,42,52,-10,41
SV Josko Rie,8859,7,12,4,20,31,51,-20,40
Admira Wacke,8859,8,10,8,18,40,66,-26,38
Mattersburg,8859,9,10,7,19,36,59,-23,37
St. Pölten,8859,10,7,8,21,39,68,-29,29
SC Rheindorf,8860,1,22,6,8,63,36,27,72
SK Sturm Gra,8860,2,20,5,11,58,28,30,65
Vienna,8860,3,18,6,12,57,49,8,60
FC Salzburg,8860,4,16,11,9,61,37,24,59
Rapid Vienna,8860,5,9,18,9,49,41,8,45
RZ Pellets W,8860,6,12,8,16,41,55,-14,44
St. Pölten,8860,7,10,11,15,45,63,-18,41
Admira Wacke,8860,8,10,10,16,36,64,-28,40
SV Josko Rie,8860,9,10,7,19,32,48,-16,37
Mattersburg,8860,10,6,12,18,37,58,-21,30
SK Sturm Gra,8861,1,21,6,9,63,36,27,69
FC Salzburg,8861,2,20,8,8,58,26,32,68
Vienna,8861,3,21,5,10,71,51,20,68
SC Rheindorf,8861,4,18,7,11,55,42,13,61
Admira Wacke,8861,5,17,5,14,45,50,-5,56
Rapid Vienna,8861,6,9,13,14,46,51,-5,40
SV Josko Rie,8861,7,11,5,20,39,63,-24,38
Mattersburg,8861,8,9,9,18,34,52,-18,36
RZ Pellets W,8861,9,9,8,19,43,59,-16,35
St. Pölten,8861,10,8,8,20,46,70,-24,32
FC Salzburg,8862,1,22,6,8,64,26,38,72
SC Rheindorf,8862,2,21,6,9,53,35,18,69
Vienna,8862,3,19,3,14,65,55,10,60
SK Sturm Gra,8862,4,17,8,11,61,41,20,59
Rapid Vienna,8862,5,14,10,12,50,38,12,52
RZ Pellets W,8862,6,12,7,17,45,58,-13,43
Admira Wacke,8862,7,11,7,18,32,56,-24,40
St. Pölten,8862,8,8,13,15,39,59,-20,37
Mattersburg,8862,9,8,11,17,42,58,-16,35
SV Josko Rie,8862,10,10,5,21,31,56,-25,35
FC Salzburg,8863,1,21,10,5,60,24,36,73
SK Sturm Gra,8863,2,22,5,9,63,33,30,71
SC Rheindorf,8863,3,21,5,10,57,46,11,68
Vienna,8863,4,18,4,14,58,51,7,58
Rapid Vienna,8863,5,15,9,12,59,43,16,54
SV Josko Rie,8863,6,12,5,19,38,51,-13,41
Admira Wacke,8863,7,11,7,18,40,55,-15,40
RZ Pellets W,8863,8,10,8,18,45,62,-17,38
Mattersburg,8863,9,10,8,18,38,58,-20,38
St. Pölten,8863,10,6,7,23,35,70,-35,25
FC Salzburg,8864,1,21,8,7,70,26,44,71
SK Sturm Gra,8864,2,20,8,8,63,34,29,68
SC Rheindorf,8864,3,20,5,11,51,48,3,65
Vienna,8864,4,17,6,13,64,58,6,57
Rapid Vienna,8864,5,14,11,11,57,42,15,53
Admira Wacke,8864,6,12,6,18,42,63,-21,42
SV Josko Rie,8864,7,12,4,20,42,59,-17,40
Mattersburg,8864,8,11,5,20,41,62,-21,38
RZ Pellets W,8864,9,10,6,20,39,57,-18,36
St. Pölten,8864,10,9,9,18,43,63,-20,36
FC Salzburg,8865,1,23,6,7,59,26,33,75
SK Sturm Gra,8865,2,23,4,9,67,33,34,73
SC Rheindorf,8865,3,19,6,11,53,47,6,63
Rapid Vienna,8865,4,16,9,11,55,36,19,57
Vienna,8865,5,17,2,17,56,56,0,53
RZ Pellets W,8865,6,11,8,17,44,57,-13,41
Mattersburg,8865,7,11,8,17,39,52,-13,41
Admira Wacke,8865,8,11,7,18,36,54,-18,40
SV Josko Rie,8865,9,10,5,21,26,47,-21,35
St. Pölten,8865,10,8,7,21,35,62,-27,31
SK Sturm Gra,8866,1,19,7,10,61,34,27,64
Vienna,8866,2,19,7,10,71,47,24,64
FC Salzburg,8866,3,18,9,9,62,41,21,63
SC Rheindorf,8866,4,18,9,9,53,45,8,63
Rapid Vienna,8866,5,13,11,12,50,44,6,50
SV Josko Rie,8866,6,14,4,18,40,51,-11,46
Mattersburg,8866,7,11,7,18,40,49,-9,40
Admira Wacke,8866,8,11,6,19,39,60,-21,39
RZ Pellets W,8866,9,11,6,19,37,58,-21,39
St. Pölten,8866,10,7,12,17,42,66,-24,33
FC Salzburg,8867,1,23,7,6,73,33,40,76
SK Sturm Gra,8867,2,20,5,11,62,31,31,65
Vienna,8867,3,18,6,12,66,53,13,60
SC Rheindorf,8867,4,17,6,13,50,43,7,57
Rapid Vienna,8867,5,14,10,12,62,42,20,52
RZ Pellets W,8867,6,15,6,15,48,57,-9,51
SV Josko Rie,8867,7,12,8,16,34,49,-15,44
St. Pölten,8867,8,9,8,19,37,60,-23,35
Admira Wacke,8867,9,10,5,21,34,72,-38,35
Mattersburg,8867,10,7,9,20,30,56,-26,30
Vienna,8868,1,21,4,11,74,53,21,67
SC Rheindorf,8868,2,20,7,9,61,40,21,67
SK Sturm Gra,8868,3,20,4,12,57,37,20,64
FC Salzburg,8868,4,17,6,13,64,44,20,57
Rapid Vienna,8868,5,14,10,12,62,40,22,52
Admira Wacke,8868,6,13,7,16,39,58,-19,46
RZ Pellets W,8868,7,12,5,19,42,58,-16,41
Mattersburg,8868,8,10,9,17,34,53,-19,39
St. Pölten,8868,9,10,9,17,36,62,-26,39
SV Josko Rie,8868,10,10,5,21,35,59,-24,35
FC Salzburg,8869,1,24,6,6,72,28,44,78
SC Rheindorf,8869,2,22,6,8,58,35,23,72
SK Sturm Gra,8869,3,21,6,9,58,32,26,69
Vienna,8869,4,18,5,13,64,59,5,59
Rapid Vienna,8869,5,10,12,14,56,50,6,42
RZ Pellets W,8869,6,11,8,17,44,57,-13,41
Admira Wacke,8869,7,12,4,20,39,64,-25,40
SV Josko Rie,8869,8,10,5,21,34,53,-19,35
Mattersburg,8869,9,9,8,19,41,63,-22,35
St. Pölten,8869,10,9,8,19,40,65,-25,35
FC Salzburg,8870,1,20,8,8,66,31,35,68
SK Sturm Gra,8870,2,20,6,10,64,40,24,66
SC Rheindorf,8870,3,18,9,9,56,43,13,63
Vienna,8870,4,18,6,12,59,51,8,60
Rapid Vienna,8870,5,15,10,11,58,43,15,55
RZ Pellets W,8870,6,12,7,17,42,57,-15,43
SV Josko Rie,8870,7,12,5,19,33,48,-15,41
Admira Wacke,8870,8,12,5,19,41,58,-17,41
St. Pölten,8870,9,9,8,19,37,59,-22,35
Mattersburg,8870,10,8,8,20,38,64,-26,32
FC Salzburg,8871,1,23,8,5,82,34,48,77
SC Rheindorf,8871,2,19,8,9,54,40,14,65
Vienna,8871,3,20,4,12,73,50,23,64
SK Sturm Gra,8871,4,18,5,13,50,42,8,59
Rapid Vienna,8871,5,15,10,11,60,43,17,55
Admira Wacke,8871,6,14,4,18,43,63,-20,46
SV Josko Rie,8871,7,12,4,20,36,59,-23,40
RZ Pellets W,8871,8,9,9,18,41,57,-16,36
St. Pölten,8871,9,7,11,18,38,65,-27,32
Mattersburg,8871,10,7,9,20,34,58,-24,30
FC Salzburg,8872,1,23,4,9,68,36,32,73
SK Sturm Gra,8872,2,20,6,10,62,33,29,66
SC Rheindorf,8872,3,19,9,8,58,37,21,66
Vienna,8872,4,17,6,13,66,62,4,57
Rapid Vienna,8872,5,13,12,11,58,43,15,51
Admira Wacke,8872,6,12,8,16,37,53,-16,44
RZ Pellets W,8872,7,11,7,18,48,63,-15,40
Mattersburg,8872,8,10,9,17,42,62,-20,39
St. Pölten,8872,9,9,8,19,41,64,-23,35
SV Josko Rie,8872,10,9,5,22,33,60,-27,32
FC Salzburg,8873,1,23,7,6,68,29,39,76
SC Rheindorf,8873,2,18,7,11,58,49,9,61
Vienna,8873,3,18,5,13,62,54,8,59
Rapid Vienna,8873,4,13,13,10,55,36,19,52
SK Sturm Gra,8873,5,14,10,12,52,36,16,52
RZ Pellets W,8873,6,13,7,16,47,59,-12,46
SV Josko Rie,8873,7,12,6,18,37,49,-12,42
Admira Wacke,8873,8,12,5,19,35,61,-26,41
Mattersburg,8873,9,10,9,17,40,55,-15,39
St. Pölten,8873,10,8,9,19,41,67,-26,33
FC Salzburg,8874,1,21,9,6,66,28,38,72
SK Sturm Gra,8874,2,21,5,10,65,37,28,68
SC Rheindorf,8874,3,19,9,8,56,44,12,66
Rapid Vienna,8874,4,17,10,9,62,37,25,61
Vienna,8874,5,14,7,15,55,61,-6,49
Admira Wacke,8874,6,12,4,20,38,66,-28,40
RZ Pellets W,8874,7,10,9,17,42,54,-12,39
SV Josko Rie,8874,8,10,8,18,34,50,-16,38
St. Pölten,8874,9,9,8,19,40,60,-20,35
Mattersburg,8874,10,7,11,18,38,59,-21,32
SC Rheindorf,8875,1,22,8,6,60,35,25,74
FC Salzburg,8875,2,21,6,9,58,28,30,69
SK Sturm Gra,8875,3,19,5,12,57,34,23,62
Vienna,8875,4,17,5,14,59,55,4,56
Rapid Vienna,8875,5,15,9,12,58,39,19,54
RZ Pellets W,8875,6,15,8,13,47,49,-2,53
Mattersburg,8875,7,10,10,16,34,52,-18,40
Admira Wacke,8875,8,10,5,21,30,54,-24,35
SV Josko Rie,8875,9,9,6,21,27,52,-25,33
St. Pölten,8875,10,7,8,21,32,64,-32,29
SC Rheindorf,8876,1,21,10,5,59,37,22,73
SK Sturm Gra,8876,2,21,8,7,56,29,27,71
FC Salzburg,8876,3,18,9,9,62,37,25,63
Vienna,8876,4,18,6,12,64,44,20,60
Rapid Vienna,8876,5,13,11,12,49,42,7,50
RZ Pellets W,8876,6,11,11,14,47,50,-3,44
Admira Wacke,8876,7,11,9,16,38,55,-17,42
St. Pölten,8876,8,7,11,18,41,69,-28,32
SV Josko Rie,8876,9,7,9,20,34,57,-23,30
Mattersburg,8876,10,6,10,20,31,61,-30,28
FC Salzburg,8877,1,25,6,5,73,23,50,81
SC Rheindorf,8877,2,21,5,10,53,38,15,68
Vienna,8877,3,19,4,13,60,52,8,61
SK Sturm Gra,8877,4,17,6,13,53,34,19,57
Rapid Vienna,8877,5,12,11,13,54,44,10,47
RZ Pellets W,8877,6,12,11,13,50,52,-2,47
Admira Wacke,8877,7,10,9,17,37,60,-23,39
SV Josko Rie,8877,8,10,6,20,39,63,-24,36
St. Pölten,8877,9,8,10,18,45,71,-26,34
Mattersburg,8877,10,7,10,19,35,62,-27,31
FC Salzburg,8878,1,22,7,7,69,29,40,73
SK Sturm Gra,8878,2,21,6,9,61,36,25,69
SC Rheindorf,8878,3,20,8,8,53,38,15,68
Vienna,8878,4,17,7,12,61,53,8,58
Rapid Vienna,8878,5,16,8,12,60,44,16,56
RZ Pellets W,8878,6,13,6,17,47,57,-10,45
St. Pölten,8878,7,9,9,18,40,58,-18,36
Mattersburg,8878,8,9,7,20,34,56,-22,34
Admira Wacke,8878,9,9,7,20,30,61,-31,34
SV Josko Rie,8878,10,10,3,23,36,59,-23,33
SC Rheindorf,8879,1,22,8,6,57,30,27,74
FC Salzburg,8879,2,18,8,10,56,32,24,62
SK Sturm Gra,8879,3,18,7,11,55,39,16,61
Vienna,8879,4,18,5,13,54,53,1,59
Rapid Vienna,8879,5,13,8,15,51,45,6,47
SV Josko Rie,8879,6,12,7,17,33,44,-11,43
RZ Pellets W,8879,7,11,9,16,45,52,-7,42
Mattersburg,8879,8,10,12,14,36,43,-7,42
Admira Wacke,8879,9,10,9,17,38,57,-19,39
St. Pölten,8879,10,7,9,20,39,69,-30,30
FC Salzburg,8880,1,24,7,5,68,25,43,79
SC Rheindorf,8880,2,18,8,10,52,39,13,62
SK Sturm Gra,8880,3,19,4,13,55,37,18,61
Rapid Vienna,8880,4,16,10,10,57,37,20,58
Vienna,8880,5,16,7,13,56,51,5,55
RZ Pellets W,8880,6,12,8,16,43,52,-9,44
Admira Wacke,8880,7,12,8,16,39,54,-15,44
SV Josko Rie,8880,8,10,7,19,30,55,-25,37
St. Pölten,8880,9,9,7,20,39,65,-26,34
Mattersburg,8880,10,7,8,21,39,63,-24,29
FC Salzburg,8881,1,23,6,7,72,32,40,75
SC Rheindorf,8881,2,19,8,9,53,37,16,65
Vienna,8881,3,19,6,11,63,51,12,63
Rapid Vienna,8881,4,17,9,10,65,39,26,60
SK Sturm Gra,8881,5,18,6,12,64,38,26,60
St. Pölten,8881,6,12,9,15,48,58,-10,45
Admira Wacke,8881,7,12,6,18,37,59,-22,42
RZ Pellets W,8881,8,11,7,18,40,60,-20,40
Mattersburg,8881,9,7,8,21,35,71,-36,29
SV Josko Rie,8881,10,8,3,25,30,62,-32,27
SK Sturm Gra,8882,1,20,8,8,59,35,24,68
FC Salzburg,8882,2,19,8,9,60,32,28,65
SC Rheindorf,8882,3,18,8,10,48,37,11,62
Vienna,8882,4,18,6,12,61,50,11,60
Rapid Vienna,8882,5,15,10,11,63,42,21,55
SV Josko Rie,8882,6,11,7,18,33,48,-15,40
Admira Wacke,8882,7,10,8,18,40,67,-27,38
RZ Pellets W,8882,8,9,10,17,35,53,-18,37
St. Pölten,8882,9,8,12,16,45,63,-18,36
Mattersburg,8882,10,8,11,17,36,53,-17,35
FC Salzburg,8883,1,25,6,5,70,24,46,81
SC Rheindorf,8883,2,20,7,9,62,41,21,67
SK Sturm Gra,8883,3,19,5,12,57,38,19,62
Vienna,8883,4,18,4,14,62,56,6,58
RZ Pellets W,8883,5,13,7,16,43,57,-14,46
Rapid Vienna,8883,6,11,11,14,54,50,4,44
St. Pölten,8883,7,9,12,15,37,58,-21,39
Mattersburg,8883,8,9,10,17,39,52,-13,37
Admira Wacke,8883,9,10,7,19,33,57,-24,37
SV Josko Rie,8883,10,8,7,21,35,59,-24,31
FC Salzburg,8884,1,24,6,6,71,26,45,78
Vienna,8884,2,19,4,13,62,49,13,61
Rapid Vienna,8884,3,16,12,8,53,32,21,60
SK Sturm Gra,8884,4,18,6,12,50,33,17,60
SC Rheindorf,8884,5,16,10,10,53,46,7,58
RZ Pellets W,8884,6,13,6,17,49,57,-8,45
SV Josko Rie,8884,7,12,6,18,48,56,-8,42
Admira Wacke,8884,8,10,6,20,32,59,-27,36
Mattersburg,8884,9,9,6,21,39,64,-25,33
St. Pölten,8884,10,7,10,19,33,68,-35,31
FC Salzburg,8885,1,24,6,6,66,25,41,78
SC Rheindorf,8885,2,20,5,11,52,42,10,65
SK Sturm Gra,8885,3,16,7,13,48,38,10,55
Vienna,8885,4,16,6,14,58,52,6,54
Rapid Vienna,8885,5,14,11,11,55,39,16,53
RZ Pellets W,8885,6,15,8,13,50,46,4,53
Admira Wacke,8885,7,13,7,16,38,53,-15,46
SV Josko Rie,8885,8,12,4,20,35,55,-20,40
St. Pölten,8885,9,7,11,18,40,60,-20,32
Mattersburg,8885,10,7,7,22,28,60,-32,28
FC Salzburg,8886,1,21,8,7,60,32,28,71
SK Sturm Gra,8886,2,21,6,9,58,30,28,69
SC Rheindorf,8886,3,21,5,10,54,38,16,68
Vienna,8886,4,20,4,12,59,50,9,64
Rapid Vienna,8886,5,15,9,12,54,36,18,54
RZ Pellets W,8886,6,12,10,14,43,52,-9,46
Admira Wacke,8886,7,13,7,16,42,54,-12,46
St. Pölten,8886,8,8,10,18,42,61,-19,34
SV Josko Rie,8886,9,9,2,25,32,61,-29,29
Mattersburg,8886,10,6,7,23,33,63,-30,25
FC Salzburg,8887,1,23,8,5,68,28,40,77
SC Rheindorf,8887,2,21,8,7,56,36,20,71
SK Sturm Gra,8887,3,21,5,10,56,31,25,68
Vienna,8887,4,16,6,14,55,54,1,54
St. Pölten,8887,5,12,9,15,46,59,-13,45
RZ Pellets W,8887,6,11,9,16,47,57,-10,42
Rapid Vienna,8887,7,10,11,15,53,44,9,41
SV Josko Rie,8887,8,11,6,19,37,52,-15,39
Mattersburg,8887,9,8,9,19,37,60,-23,33
Admira Wacke,8887,10,8,7,21,29,63,-34,31
SC Rheindorf,8888,1,22,7,7,66,41,25,73
FC Salzburg,8888,2,19,9,8,67,36,31,66
Vienna,8888,3,20,4,12,72,53,19,64
SK Sturm Gra,8888,4,19,3,14,58,47,11,60
Rapid Vienna,8888,5,14,11,11,62,47,15,53
Admira Wacke,8888,6,15,5,16,47,61,-14,50
RZ Pellets W,8888,7,11,8,17,49,64,-15,41
Mattersburg,8888,8,9,7,20,44,63,-19,34
SV Josko Rie,8888,9,9,6,21,38,61,-23,33
St. Pölten,8888,10,9,6,21,42,72,-30,33
FC Salzburg,8889,1,26,6,4,78,29,49,84
SK Sturm Gra,8889,2,20,6,10,61,33,28,66
SC Rheindorf,8889,3,19,6,11,66,51,15,63
Vienna,8889,4,17,4,15,65,55,10,55
RZ Pellets W,8889,5,14,8,14,48,50,-2,50
Rapid Vienna,8889,6,13,8,15,51,48,3,47
SV Josko Rie,8889,7,13,5,18,35,52,-17,44
Admira Wacke,8889,8,12,6,18,33,58,-25,42
St. Pölten,8889,9,7,8,21,37,70,-33,29
Mattersburg,8889,10,7,7,22,35,63,-28,28
FC Salzburg,8890,1,20,6,10,64,32,32,66
SC Rheindorf,8890,2,19,8,9,53,39,14,65
SK Sturm Gra,8890,3,19,6,11,63,40,23,63
Vienna,8890,4,18,5,13,64,55,9,59
Admira Wacke,8890,5,17,5,14,53,54,-1,56
Rapid Vienna,8890,6,14,12,10,55,41,14,54
SV Josko Rie,8890,7,11,6,19,37,54,-17,39
RZ Pellets W,8890,8,10,8,18,40,60,-20,38
Mattersburg,8890,9,9,8,19,39,61,-22,35
St. Pölten,8890,10,7,8,21,32,64,-32,29
Vienna,8891,1,23,3,10,70,43,27,72
FC Salzburg,8891,2,21,6,9,60,26,34,69
SC Rheindorf,8891,3,21,6,9,57,45,12,69
SK Sturm Gra,8891,4,18,5,13,56,36,20,59
Rapid Vienna,8891,5,13,10,13,51,42,9,49
RZ Pellets W,8891,6,12,8,16,43,56,-13,44
Admira Wacke,8891,7,10,9,17,33,57,-24,39
SV Josko Rie,8891,8,11,5,20,35,56,-21,38
Mattersburg,8891,9,7,12,17,31,50,-19,33
St. Pölten,8891,10,8,8,20,34,59,-25,32
Vienna,8892,1,21,5,10,65,54,11,68
FC Salzburg,8892,2,20,7,9,69,33,36,67
SC Rheindorf,8892,3,19,9,8,61,45,16,66
SK Sturm Gra,8892,4,19,7,10,60,35,25,64
Rapid Vienna,8892,5,17,8,11,61,41,20,59
RZ Pellets W,8892,6,11,8,17,44,60,-16,41
SV Josko Rie,8892,7,12,4,20,39,54,-15,40
Admira Wacke,8892,8,11,4,21,37,61,-24,37
Mattersburg,8892,9,7,11,18,40,65,-25,32
St. Pölten,8892,10,7,9,20,42,70,-28,30
FC Salzburg,8893,1,24,6,6,75,30,45,78
SK Sturm Gra,8893,2,22,6,8,68,35,33,72
SC Rheindorf,8893,3,22,6,8,60,37,23,72
Vienna,8893,4,16,7,13,57,56,1,55
RZ Pellets W,8893,5,14,7,15,57,54,3,49
Rapid Vienna,8893,6,12,10,14,53,49,4,46
Admira Wacke,8893,7,11,6,19,38,63,-25,39
SV Josko Rie,8893,8,10,5,21,39,62,-23,35
Mattersburg,8893,9,8,7,21,34,60,-26,31
St. Pölten,8893,10,6,10,20,34,69,-35,28
FC Salzburg,8894,1,22,8,6,68,27,41,74
SC Rheindorf,8894,2,20,8,8,60,42,18,68
SK Sturm Gra,8894,3,17,8,11,60,39,21,59
Vienna,8894,4,17,7,12,63,56,7,58
Rapid Vienna,8894,5,14,11,11,56,43,13,53
RZ Pellets W,8894,6,13,6,17,45,58,-13,45
Admira Wacke,8894,7,11,7,18,36,59,-23,40
St. Pölten,8894,8,8,11,17,40,63,-23,35
SV Josko Rie,8894,9,9,7,20,36,55,-19,34
Mattersburg,8894,10,7,11,18,35,57,-22,32
SK Sturm Gra,8895,1,22,6,8,64,27,37,72
SC Rheindorf,8895,2,21,9,6,60,39,21,72
FC Salzburg,8895,3,20,5,11,61,31,30,65
Vienna,8895,4,16,7,13,57,55,2,55
RZ Pellets W,8895,5,12,10,14,46,53,-7,46
Rapid Vienna,8895,6,11,11,14,45,43,2,44
SV Josko Rie,8895,7,13,5,18,40,52,-12,44
Admira Wacke,8895,8,11,5,20,32,57,-25,38
Mattersburg,8895,9,9,8,19,30,52,-22,35
St. Pölten,8895,10,5,14,17,38,64,-26,29
SK Sturm Gra,8896,1,22,5,9,60,31,29,71
SC Rheindorf,8896,2,21,6,9,53,35,18,69
Vienna,8896,3,20,4,12,66,51,15,64
Rapid Vienna,8896,4,16,11,9,54,35,19,59
FC Salzburg,8896,5,17,7,12,60,40,20,58
RZ Pellets W,8896,6,12,6,18,43,53,-10,42
Mattersburg,8896,7,10,7,19,38,58,-20,37
St. Pölten,8896,8,8,12,16,38,57,-19,36
Admira Wacke,8896,9,10,6,20,39,65,-26,36
SV Josko Rie,8896,10,9,6,21,34,60,-26,33
SK Sturm Gra,8897,1,21,8,7,65,31,34,71
Vienna,8897,2,20,7,9,62,45,17,67
FC Salzburg,8897,3,19,9,8,63,36,27,66
SC Rheindorf,8897,4,19,8,9,57,42,15,65
Rapid Vienna,8897,5,12,11,13,51,46,5,47
RZ Pellets W,8897,6,11,11,14,43,51,-8,44
Admira Wacke,8897,7,10,7,19,39,64,-25,37
St. Pölten,8897,8,8,10,18,43,64,-21,34
Mattersburg,8897,9,7,12,17,35,57,-22,33
SV Josko Rie,8897,10,8,7,21,35,57,-22,31
SK Sturm Gra,8898,1,22,6,8,64,31,33,72
FC Salzburg,8898,2,22,6,8,61,28,33,72
SC Rheindorf,8898,3,22,5,9,52,39,13,71
Vienna,8898,4,19,3,14,63,50,13,60
Rapid Vienna,8898,5,16,11,9,56,31,25,59
RZ Pellets W,8898,6,12,8,16,51,55,-4,44
Admira Wacke,8898,7,11,6,19,34,59,-25,39
Mattersburg,8898,8,8,7,21,34,61,-27,31
St. Pölten,8898,9,8,7,21,35,65,-30,31
SV Josko Rie,8898,10,8,5,23,29,60,-31,29
FC Salzburg,8899,1,21,8,7,65,24,41,71
SK Sturm Gra,8899,2,21,6,9,62,28,34,69
SC Rheindorf,8899,3,20,9,7,51,35,16,69
Vienna,8899,4,18,3,15,54,49,5,57
Rapid Vienna,8899,5,14,13,9,54,36,18,55
RZ Pellets W,8899,6,13,7,16,41,50,-9,46
St. Pölten,8899,7,10,9,17,45,63,-18,39
SV Josko Rie,8899,8,10,7,19,31,53,-22,37
Mattersburg,8899,9,8,8,20,31,52,-21,32
Admira Wacke,8899,10,7,6,23,22,66,-44,27
SC Rheindorf,8900,1,24,5,7,67,37,30,77
FC Salzburg,8900,2,21,9,6,72,27,45,72
Vienna,8900,3,20,3,13,59,51,8,63
SK Sturm Gra,8900,4,17,7,12,54,37,17,58
Rapid Vienna,8900,5,13,13,10,56,38,18,52
RZ Pellets W,8900,6,13,6,17,49,57,-8,45
St. Pölten,8900,7,10,10,16,45,63,-18,40
Admira Wacke,8900,8,9,7,20,34,73,-39,34
SV Josko Rie,8900,9,10,3,23,31,54,-23,33
Mattersburg,8900,10,8,7,21,38,68,-30,31
Vienna,8901,1,21,6,9,70,47,23,69
SK Sturm Gra,8901,2,19,7,10,58,33,25,64
FC Salzburg,8901,3,18,9,9,65,41,24,63
SC Rheindorf,8901,4,18,7,11,47,38,9,61
Admira Wacke,8901,5,16,6,14,44,55,-11,54
Rapid Vienna,8901,6,12,10,14,56,49,7,46
RZ Pellets W,8901,7,12,7,17,43,55,-12,43
SV Josko Rie,8901,8,10,6,20,34,56,-22,36
St. Pölten,8901,9,8,10,18,41,62,-21,34
Mattersburg,8901,10,7,10,19,30,52,-22,31
FC Salzburg,8902,1,20,7,9,68,33,35,67
Vienna,8902,2,20,6,10,68,51,17,66
SC Rheindorf,8902,3,20,5,11,58,44,14,65
Rapid Vienna,8902,4,16,11,9,56,36,20,59
SK Sturm Gra,8902,5,17,5,14,55,41,14,56
Admira Wacke,8902,6,13,7,16,40,55,-15,46
RZ Pellets W,8902,7,13,5,18,44,61,-17,44
SV Josko Rie,8902,8,11,5,20,42,56,-14,38
St. Pölten,8902,9,8,9,19,36,65,-29,33
Mattersburg,8902,10,7,10,19,33,58,-25,31
SC Rheindorf,8903,1,21,6,9,62,41,21,69
FC Salzburg,8903,2,20,7,9,70,39,31,67
SK Sturm Gra,8903,3,20,3,13,57,36,21,63
Vienna,8903,4,20,3,13,65,55,10,63
Rapid Vienna,8903,5,16,10,10,54,35,19,58
RZ Pellets W,8903,6,13,5,18,42,55,-13,44
Admira Wacke,8903,7,12,8,16,45,61,-16,44
SV Josko Rie,8903,8,10,7,19,35,54,-19,37
St. Pölten,8903,9,9,8,19,37,60,-23,35
Mattersburg,8903,10,7,7,22,34,65,-31,28
Vienna,8904,1,21,4,11,59,46,13,67
FC Salzburg,8904,2,19,9,8,68,39,29,66
SC Rheindorf,8904,3,19,8,9,56,40,16,65
SK Sturm Gra,8904,4,19,5,12,55,36,19,62
Rapid Vienna,8904,5,13,10,13,57,45,12,49
Admira Wacke,8904,6,13,8,15,40,53,-13,47
St. Pölten,8904,7,10,10,16,53,69,-16,40
RZ Pellets W,8904,8,11,6,19,43,61,-18,39
SV Josko Rie,8904,9,11,4,21,32,52,-20,37
Mattersburg,8904,10,8,8,20,38,60,-22,32
FC Salzburg,8905,1,22,7,7,68,28,40,73
Vienna,8905,2,19,8,9,67,46,21,65
SC Rheindorf,8905,3,17,9,10,48,42,6,60
SK Sturm Gra,8905,4,15,11,10,52,36,16,56
Admira Wacke,8905,5,14,6,16,44,57,-13,48
RZ Pellets W,8905,6,11,12,13,45,52,-7,45
Rapid Vienna,8905,7,10,14,12,52,45,7,44
SV Josko Rie,8905,8,12,6,18,35,50,-15,42
St. Pölten,8905,9,7,11,18,41,62,-21,32
Mattersburg,8905,10,7,8,21,37,71,-34,29
FC Salzburg,8906,1,21,7,8,65,30,35,70
SK Sturm Gra,8906,2,21,5,10,62,30,32,68
SC Rheindorf,8906,3,19,7,10,50,40,10,64
Vienna,8906,4,17,5,14,54,52,2,56
Rapid Vienna,8906,5,12,14,10,54,43,11,50
RZ Pellets W,8906,6,12,10,14,39,45,-6,46
SV Josko Rie,8906,7,13,5,18,34,47,-13,44
Admira Wacke,8906,8,12,6,18,36,59,-23,42
St. Pölten,8906,9,6,12,18,39,64,-25,30
Mattersburg,8906,10,6,11,19,30,53,-23,29
SK Sturm Gra,8907,1,22,4,10,64,31,33,70
FC Salzburg,8907,2,20,9,7,60,29,31,69
SC Rheindorf,8907,3,17,10,9,52,39,13,61
Vienna,8907,4,17,9,10,52,45,7,60
Rapid Vienna,8907,5,15,10,11,56,38,18,55
RZ Pellets W,8907,6,12,6,18,40,49,-9,42
Admira Wacke,8907,7,11,8,17,37,57,-20,41
SV Josko Rie,8907,8,9,9,18,32,59,-27,36
Mattersburg,8907,9,9,6,21,34,54,-20,33
St. Pölten,8907,10,8,9,19,40,66,-26,33
SC Rheindorf,8908,1,21,8,7,64,44,20,71
FC Salzburg,8908,2,20,6,10,68,36,32,66
SK Sturm Gra,8908,3,19,8,9,63,37,26,65
Rapid Vienna,8908,4,16,10,10,61,39,22,58
Vienna,8908,5,16,10,10,58,50,8,58
RZ Pellets W,8908,6,11,10,15,45,57,-12,43
Admira Wacke,8908,7,11,7,18,39,61,-22,40
SV Josko Rie,8908,8,10,7,19,33,53,-20,37
Mattersburg,8908,9,7,9,20,39,62,-23,30
St. Pölten,8908,10,7,9,20,42,73,-31,30
FC Salzburg,8909,1,23,7,6,71,31,40,76
SK Sturm Gra,8909,2,19,6,11,65,35,30,63
SC Rheindorf,8909,3,18,7,11,59,51,8,61
Vienna,8909,4,18,6,12,72,61,11,60
Rapid Vienna,8909,5,16,11,9,64,40,24,59
RZ Pellets W,8909,6,14,6,16,57,61,-4,48
St. Pölten,8909,7,11,8,17,44,67,-23,41
Admira Wacke,8909,8,10,6,20,35,65,-30,36
SV Josko Rie,8909,9,9,6,21,38,64,-26,33
Mattersburg,8909,10,7,7,22,32,62,-30,28
FC Salzburg,8910,1,21,7,8,75,39,36,70
SK Sturm Gra,8910,2,21,4,11,66,35,31,67
SC Rheindorf,8910,3,19,8,9,54,49,5,65
Rapid Vienna,8910,4,16,12,8,71,47,24,60
Vienna,8910,5,18,4,14,66,51,15,58
RZ Pellets W,8910,6,11,10,15,46,56,-10,43
SV Josko Rie,8910,7,11,5,20,35,54,-19,38
Admira Wacke,8910,8,10,6,20,29,60,-31,36
Mattersburg,8910,9,8,10,18,37,60,-23,34
St. Pölten,8910,10,7,10,19,42,70,-28,31
FC Salzburg,8911,1,22,6,8,71,36,35,72
Vienna,8911,2,23,3,10,61,41,20,72
SC Rheindorf,8911,3,18,9,9,54,38,16,63
SK Sturm Gra,8911,4,15,8,13,49,38,11,53
Rapid Vienna,8911,5,12,11,13,50,40,10,47
RZ Pellets W,8911,6,13,8,15,41,52,-11,47
Admira Wacke,8911,7,12,8,16,36,53,-17,44
St. Pölten,8911,8,11,9,16,42,60,-18,42
Mattersburg,8911,9,11,6,19,42,56,-14,39
SV Josko Rie,8911,10,7,4,25,24,56,-32,25
Vienna,8912,1,23,4,9,75,41,34,73
FC Salzburg,8912,2,21,9,6,65,25,40,72
SC Rheindorf,8912,3,18,10,8,53,41,12,64
SK Sturm Gra,8912,4,17,8,11,50,33,17,59
Rapid Vienna,8912,5,12,10,14,47,39,8,46
RZ Pellets W,8912,6,13,7,16,45,57,-12,46
SV Josko Rie,8912,7,11,7,18,32,52,-20,40
Mattersburg,8912,8,8,13,15,42,59,-17,37
Admira Wacke,8912,9,9,6,21,30,59,-29,33
St. Pölten,8912,10,7,8,21,35,68,-33,29
SK Sturm Gra,8913,1,21,5,10,64,31,33,68
FC Salzburg,8913,2,18,9,9,64,36,28,63
SC Rheindorf,8913,3,17,10,9,53,42,11,61
Rapid Vienna,8913,4,16,10,10,57,37,20,58
Vienna,8913,5,17,6,13,59,56,3,57
RZ Pellets W,8913,6,14,7,15,50,55,-5,49
Admira Wacke,8913,7,14,5,17,40,59,-19,47
Mattersburg,8913,8,9,11,16,35,51,-16,38
St. Pölten,8913,9,7,10,19,41,65,-24,31
SV Josko Rie,8913,10,7,7,22,28,59,-31,28
FC Salzburg,8914,1,20,10,6,70,34,36,70
SK Sturm Gra,8914,2,22,4,10,64,34,30,70
SC Rheindorf,8914,3,19,6,11,61,46,15,63
Vienna,8914,4,20,3,13,71,59,12,63
Rapid Vienna,8914,5,14,12,10,53,40,13,54
RZ Pellets W,8914,6,14,6,16,56,58,-2,48
Admira Wacke,8914,7,12,7,17,44,64,-20,43
SV Josko Rie,8914,8,11,4,21,40,64,-24,37
St. Pölten,8914,9,8,8,20,42,69,-27,32
Mattersburg,8914,10,7,6,23,34,67,-33,27
Vienna,8915,1,21,5,10,65,49,16,68
FC Salzburg,8915,2,20,7,9,66,35,31,67
SK Sturm Gra,8915,3,20,6,10,62,33,29,66
SC Rheindorf,8915,4,18,6,12,60,48,12,60
Rapid Vienna,8915,5,17,8,11,62,41,21,59
Admira Wacke,8915,6,12,7,17,40,60,-20,43
RZ Pellets W,8915,7,11,9,16,46,58,-12,42
SV Josko Rie,8915,8,10,5,21,28,51,-23,35
Mattersburg,8915,9,9,7,20,35,54,-19,34
St. Pölten,8915,10,8,8,20,39,74,-35,32
FC Salzburg,8916,1,24,6,6,70,30,40,78
SK Sturm Gra,8916,2,22,5,9,70,32,38,71
Vienna,8916,3,20,5,11,72,53,19,65
SC Rheindorf,8916,4,17,11,8,56,46,10,62
RZ Pellets W,8916,5,14,7,15,54,58,-4,49
Rapid Vienna,8916,6,11,15,10,54,47,7,48
Admira Wacke,8916,7,10,5,21,37,64,-27,35
St. Pölten,8916,8,8,10,18,42,68,-26,34
SV Josko Rie,8916,9,9,6,21,36,58,-22,33
Mattersburg,8916,10,6,8,22,37,72,-35,26
SC Rheindorf,8917,1,21,6,9,69,44,25,69
FC Salzburg,8917,2,20,7,9,67,37,30,67
Rapid Vienna,8917,3,17,10,9,61,41,20,61
SK Sturm Gra,8917,4,17,9,10,62,37,25,60
Vienna,8917,5,19,3,14,61,59,2,60
RZ Pellets W,8917,6,13,4,19,44,55,-11,43
Admira Wacke,8917,7,12,6,18,36,63,-27,42
Mattersburg,8917,8,10,6,20,43,59,-16,36
SV Josko Rie,8917,9,10,6,20,36,60,-24,36
St. Pölten,8917,10,6,13,17,45,69,-24,31
SK Sturm Gra,8918,1,22,5,9,63,32,31,71
FC Salzburg,8918,2,21,7,8,68,31,37,70
Vienna,8918,3,19,5,12,64,50,14,62
SC Rheindorf,8918,4,18,8,10,54,46,8,62
Rapid Vienna,8918,5,13,11,12,53,38,15,50
RZ Pellets W,8918,6,14,8,14,48,54,-6,50
Admira Wacke,8918,7,11,7,18,46,69,-23,40
Mattersburg,8918,8,10,6,20,43,64,-21,36
St. Pölten,8918,9,7,10,19,37,64,-27,31
SV Josko Rie,8918,10,8,7,21,32,60,-28,31
FC Salzburg,8919,1,21,9,6,66,29,37,72
SK Sturm Gra,8919,2,21,4,11,58,31,27,67
SC Rheindorf,8919,3,17,8,11,54,45,9,59
Vienna,8919,4,17,6,13,57,56,1,57
Admira Wacke,8919,5,12,10,14,40,53,-13,46
Rapid Vienna,8919,6,11,11,14,46,40,6,44
SV Josko Rie,8919,7,12,8,16,39,48,-9,44
RZ Pellets W,8919,8,12,8,16,47,57,-10,44
St. Pölten,8919,9,9,9,18,45,70,-25,36
Mattersburg,8919,10,8,7,21,37,60,-23,31
SK Sturm Gra,8920,1,20,8,8,67,35,32,68
Vienna,8920,2,19,6,11,65,51,14,63
SC Rheindorf,8920,3,16,11,9,45,39,6,59
FC Salzburg,8920,4,16,10,10,55,33,22,58
Rapid Vienna,8920,5,15,11,10,64,47,17,56
SV Josko Rie,8920,6,14,6,16,39,51,-12,48
RZ Pellets W,8920,7,13,7,16,42,49,-7,46
Mattersburg,8920,8,9,9,18,38,56,-18,36
Admira Wacke,8920,9,9,6,21,38,64,-26,33
St. Pölten,8920,10,6,12,18,35,63,-28,30
FC Salzburg,8921,1,20,10,6,64,29,35,70
Vienna,8921,2,21,4,11,71,46,25,67
SK Sturm Gra,8921,3,19,9,8,58,31,27,66
SC Rheindorf,8921,4,17,7,12,56,54,2,58
Rapid Vienna,8921,5,14,12,10,61,44,17,54
RZ Pellets W,8921,6,10,11,15,45,67,-22,41
Admira Wacke,8921,7,11,6,19,32,56,-24,39
SV Josko Rie,8921,8,10,7,19,32,49,-17,37
Mattersburg,8921,9,8,10,18,37,57,-20,34
St. Pölten,8921,10,6,12,18,43,66,-23,30
FC Salzburg,8922,1,21,7,8,67,34,33,70
SK Sturm Gra,8922,2,19,7,10,59,35,24,64
SC Rheindorf,8922,3,19,4,13,52,43,9,61
Rapid Vienna,8922,4,16,8,12,61,41,20,56
Vienna,8922,5,17,5,14,57,55,2,56
RZ Pellets W,8922,6,16,4,16,56,57,-1,52
SV Josko Rie,8922,7,13,3,20,39,48,-9,42
Admira Wacke,8922,8,12,6,18,38,62,-24,42
St. Pölten,8922,9,9,8,19,41,69,-28,35
Mattersburg,8922,10,9,6,21,35,61,-26,33
FC Salzburg,8923,1,21,7,8,67,37,30,70
SK Sturm Gra,8923,2,21,5,10,67,41,26,68
SC Rheindorf,8923,3,19,7,10,58,43,15,64
Vienna,8923,4,17,7,12,60,55,5,58
Rapid Vienna,8923,5,14,9,13,55,45,10,51
RZ Pellets W,8923,6,11,9,16,49,61,-12,42
SV Josko Rie,8923,7,12,3,21,38,57,-19,39
St. Pölten,8923,8,8,13,15,47,63,-16,37
Admira Wacke,8923,9,10,7,19,31,57,-26,37
Mattersburg,8923,10,8,11,17,42,55,-13,35
FC Salzburg,8924,1,24,5,7,73,30,43,77
SC Rheindorf,8924,2,19,8,9,51,40,11,65
Vienna,8924,3,19,6,11,63,51,12,63
SK Sturm Gra,8924,4,18,6,12,62,39,23,60
Rapid Vienna,8924,5,15,11,10,53,40,13,56
St. Pölten,8924,6,11,8,17,45,62,-17,41
SV Josko Rie,8924,7,10,7,19,33,51,-18,37
Admira Wacke,8924,8,10,7,19,32,56,-24,37
RZ Pellets W,8924,9,10,6,20,46,64,-18,36
Mattersburg,8924,10,8,8,20,30,55,-25,32
Vienna,8925,1,22,2,12,69,48,21,68
SC Rheindorf,8925,2,20,7,9,57,43,14,67
FC Salzburg,8925,3,19,7,10,62,39,23,64
SK Sturm Gra,8925,4,20,4,12,57,34,23,64
Rapid Vienna,8925,5,16,11,9,60,40,20,59
RZ Pellets W,8925,6,12,6,18,45,52,-7,42
Mattersburg,8925,7,11,6,19,39,59,-20,39
Admira Wacke,8925,8,10,8,18,35,61,-26,38
SV Josko Rie,8925,9,10,6,20,34,54,-20,36
St. Pölten,8925,10,6,11,19,43,71,-28,29
FC Salzburg,8926,1,20,8,8,61,30,31,68
SK Sturm Gra,8926,2,19,8,9,58,32,26,65
SC Rheindorf,8926,3,19,8,9,59,44,15,65
Vienna,8926,4,18,5,13,60,56,4,59
Rapid Vienna,8926,5,14,11,11,53,41,12,53
Admira Wacke,8926,6,13,7,16,35,51,-16,46
RZ Pellets W,8926,7,11,7,18,43,59,-16,40
St. Pölten,8926,8,10,9,17,41,57,-16,39
SV Josko Rie,8926,9,9,7,20,34,52,-18,34
Mattersburg,8926,10,8,8,20,36,58,-22,32
FC Salzburg,8927,1,22,9,5,66,27,39,75
SC Rheindorf,8927,2,21,6,9,67,49,18,69
SK Sturm Gra,8927,3,21,3,12,58,35,23,66
Vienna,8927,4,17,6,13,62,55,7,57
Rapid Vienna,8927,5,14,9,13,50,42,8,51
Admira Wacke,8927,6,14,8,14,46,55,-9,50
RZ Pellets W,8927,7,12,7,17,43,54,-11,43
SV Josko Rie,8927,8,11,6,19,41,54,-13,39
St. Pölten,8927,9,5,12,19,38,72,-34,27
Mattersburg,8927,10,6,8,22,37,65,-28,26
FC Salzburg,8928,1,20,10,6,69,27,42,70
SC Rheindorf,8928,2,18,7,11,61,56,5,61
Rapid Vienna,8928,3,16,12,8,59,36,23,60
Vienna,8928,4,19,3,14,62,55,7,60
SK Sturm Gra,8928,5,16,7,13,58,40,18,55
RZ Pellets W,8928,6,14,7,15,44,51,-7,49
SV Josko Rie,8928,7,13,6,17,43,51,-8,45
St. Pölten,8928,8,9,10,17,39,61,-22,37
Admira Wacke,8928,9,8,9,19,32,63,-31,33
Mattersburg,8928,10,6,11,19,33,60,-27,29
FC Salzburg,8929,1,23,6,7,75,30,45,75
Vienna,8929,2,20,7,9,72,52,20,67
SC Rheindorf,8929,3,17,8,11,57,50,7,59
SK Sturm Gra,8929,4,17,7,12,60,41,19,58
Rapid Vienna,8929,5,15,9,12,64,44,20,54
RZ Pellets W,8929,6,11,9,16,48,61,-13,42
Admira Wacke,8929,7,11,9,16,35,58,-23,42
SV Josko Rie,8929,8,10,6,20,30,52,-22,36
St. Pölten,8929,9,8,10,18,45,68,-23,34
Mattersburg,8929,10,8,9,19,31,61,-30,33
FC Salzburg,8930,1,21,6,9,74,38,36,69
SK Sturm Gra,8930,2,21,6,9,62,35,27,69
Vienna,8930,3,20,3,13,64,55,9,63
SC Rheindorf,8930,4,17,11,8,61,47,14,62
Rapid Vienna,8930,5,15,11,10,61,42,19,56
Admira Wacke,8930,6,12,6,18,37,58,-21,42
RZ Pellets W,8930,7,11,7,18,43,55,-12,40
SV Josko Rie,8930,8,11,6,19,36,56,-20,39
Mattersburg,8930,9,9,6,21,34,58,-24,33
St. Pölten,8930,10,8,8,20,45,73,-28,32
FC Salzburg,8931,1,21,7,8,66,32,34,70
SC Rheindorf,8931,2,20,7,9,54,39,15,67
Vienna,8931,3,19,5,12,61,47,14,62
SK Sturm Gra,8931,4,16,9,11,53,32,21,57
Rapid Vienna,8931,5,14,11,11,58,39,19,53
Admira Wacke,8931,6,12,9,15,42,59,-17,45
SV Josko Rie,8931,7,11,6,19,40,59,-19,39
RZ Pellets W,8931,8,10,7,19,42,66,-24,37
St. Pölten,8931,9,9,9,18,40,64,-24,36
Mattersburg,8931,10,7,12,17,32,51,-19,33
FC Salzburg,8932,1,19,9,8,65,33,32,66
SC Rheindorf,8932,2,18,10,8,52,42,10,64
SK Sturm Gra,8932,3,16,10,10,58,38,20,58
Vienna,8932,4,17,6,13,54,48,6,57
Rapid Vienna,8932,5,13,11,12,55,42,13,50
Admira Wacke,8932,6,14,5,17,44,58,-14,47
RZ Pellets W,8932,7,10,11,15,40,54,-14,41
St. Pölten,8932,8,10,10,16,45,61,-16,40
SV Josko Rie,8932,9,11,6,19,31,49,-18,39
Mattersburg,8932,10,8,10,18,38,57,-19,34
FC Salzburg,8933,1,21,9,6,63,28,35,72
SK Sturm Gra,8933,2,19,6,11,66,44,22,63
SC Rheindorf,8933,3,18,8,10,57,49,8,62
Vienna,8933,4,18,6,12,63,51,12,60
Rapid Vienna,8933,5,12,9,15,53,46,7,45
RZ Pellets W,8933,6,12,8,16,47,53,-6,44
St. Pölten,8933,7,11,11,14,50,62,-12,44
Admira Wacke,8933,8,12,8,16,46,64,-18,44
SV Josko Rie,8933,9,12,5,19,39,56,-17,41
Mattersburg,8933,10,5,10,21,27,58,-31,25
SC Rheindorf,8934,1,20,8,8,61,45,16,68
SK Sturm Gra,8934,2,19,6,11,63,40,23,63
Vienna,8934,3,20,3,13,63,55,8,63
Rapid Vienna,8934,4,18,8,10,58,33,25,62
FC Salzburg,8934,5,18,7,11,65,43,22,61
RZ Pellets W,8934,6,13,7,16,43,52,-9,46
St. Pölten,8934,7,11,10,15,44,56,-12,43
Admira Wacke,8934,8,10,5,21,35,64,-29,35
Mattersburg,8934,9,8,9,19,37,60,-23,33
SV Josko Rie,8934,10,9,5,22,33,54,-21,32
FC Salzburg,8935,1,20,10,6,70,41,29,70
SC Rheindorf,8935,2,20,8,8,56,37,19,68
SK Sturm Gra,8935,3,20,7,9,67,35,32,67
RZ Pellets W,8935,4,16,7,13,53,47,6,55
Rapid Vienna,8935,5,14,11,11,55,46,9,53
Vienna,8935,6,16,4,16,59,51,8,52
Admira Wacke,8935,7,12,5,19,39,60,-21,41
Mattersburg,8935,8,10,8,18,42,64,-22,38
SV Josko Rie,8935,9,10,5,21,32,59,-27,35
St. Pölten,8935,10,5,9,22,36,69,-33,24
FC Salzburg,8936,1,22,8,6,67,29,38,74
SC Rheindorf,8936,2,21,8,7,60,40,20,71
SK Sturm Gra,8936,3,19,7,10,67,36,31,64
Vienna,8936,4,19,5,12,62,48,14,62
RZ Pellets W,8936,5,14,9,13,45,47,-2,51
Rapid Vienna,8936,6,11,11,14,48,50,-2,44
SV Josko Rie,8936,7,10,8,18,30,52,-22,38
Admira Wacke,8936,8,10,7,19,39,59,-20,37
St. Pölten,8936,9,8,7,21,40,67,-27,31
Mattersburg,8936,10,7,8,21,30,60,-30,29
SK Sturm Gra,8937,1,21,7,8,66,32,34,70
FC Salzburg,8937,2,20,6,10,69,32,37,66
Vienna,8937,3,20,6,10,63,44,19,66
SC Rheindorf,8937,4,19,9,8,52,41,11,66
Rapid Vienna,8937,5,11,12,13,47,43,4,45
RZ Pellets W,8937,6,9,12,15,42,59,-17,39
Admira Wacke,8937,7,11,6,19,33,58,-25,39
SV Josko Rie,8937,8,11,5,20,38,54,-16,38
Mattersburg,8937,9,10,8,18,36,57,-21,38
St. Pölten,8937,10,7,11,18,37,63,-26,32
FC Salzburg,8938,1,23,7,6,69,29,40,76
Vienna,8938,2,20,7,9,64,42,22,67
SC Rheindorf,8938,3,18,8,10,57,52,5,62
SK Sturm Gra,8938,4,17,9,10,55,37,18,60
Rapid Vienna,8938,5,13,12,11,54,41,13,51
RZ Pellets W,8938,6,11,10,15,42,52,-10,43
Mattersburg,8938,7,10,8,18,42,52,-10,38
Admira Wacke,8938,8,10,8,18,32,55,-23,38
SV Josko Rie,8938,9,9,9,18,31,49,-18,36
St. Pölten,8938,10,6,8,22,34,71,-37,26
SC Rheindorf,8939,1,21,8,7,55,36,19,71
FC Salzburg,8939,2,22,4,10,62,37,25,70
SK Sturm Gra,8939,3,21,6,9,60,33,27,69
Vienna,8939,4,17,5,14,60,48,12,56
Rapid Vienna,8939,5,14,10,12,57,42,15,52
RZ Pellets W,8939,6,14,8,14,47,51,-4,50
Admira Wacke,8939,7,10,7,19,34,62,-28,37
Mattersburg,8939,8,10,6,20,39,57,-18,36
St. Pölten,8939,9,9,8,19,46,68,-22,35
SV Josko Rie,8939,10,9,4,23,33,59,-26,31
FC Salzburg,8940,1,20,6,10,63,33,30,66
Vienna,8940,2,21,3,12,71,55,16,66
SC Rheindorf,8940,3,19,8,9,54,40,14,65
SK Sturm Gra,8940,4,17,7,12,56,35,21,58
Rapid Vienna,8940,5,14,10,12,57,42,15,52
RZ Pellets W,8940,6,14,7,15,49,53,-4,49
SV Josko Rie,8940,7,15,2,19,48,57,-9,47
Admira Wacke,8940,8,13,5,18,37,67,-30,44
Mattersburg,8940,9,8,9,19,36,57,-21,33
St. Pölten,8940,10,6,9,21,40,72,-32,27
FC Salzburg,8941,1,22,6,8,72,34,38,72
SK Sturm Gra,8941,2,21,5,10,60,32,28,68
Rapid Vienna,8941,3,18,9,9,60,40,20,63
SC Rheindorf,8941,4,19,6,11,57,45,12,63
Vienna,8941,5,16,5,15,60,56,4,53
Admira Wacke,8941,6,13,5,18,41,64,-23,44
RZ Pellets W,8941,7,11,7,18,44,61,-17,40
Mattersburg,8941,8,10,8,18,43,59,-16,38
SV Josko Rie,8941,9,10,6,20,34,54,-20,36
St. Pölten,8941,10,6,11,19,40,66,-26,29
FC Salzburg,8942,1,22,8,6,71,30,41,74
SC Rheindorf,8942,2,17,10,9,53,43,10,61
Rapid Vienna,8942,3,17,9,10,61,38,23,60
Vienna,8942,4,19,3,14,61,53,8,60
SK Sturm Gra,8942,5,16,7,13,50,35,15,55
RZ Pellets W,8942,6,12,8,16,48,59,-11,44
Admira Wacke,8942,7,9,11,16,32,53,-21,38
St. Pölten,8942,8,9,10,17,44,62,-18,37
SV Josko Rie,8942,9,10,7,19,36,58,-22,37
Mattersburg,8942,10,8,9,19,39,64,-25,33
FC Salzburg,8943,1,21,7,8,71,29,42,70
SC Rheindorf,8943,2,19,9,8,56,41,15,66
SK Sturm Gra,8943,3,18,7,11,56,34,22,61
Vienna,8943,4,18,6,12,59,55,4,60
Rapid Vienna,8943,5,14,10,12,58,45,13,52
RZ Pellets W,8943,6,13,8,15,51,58,-7,47
St. Pölten,8943,7,11,8,17,47,62,-15,41
SV Josko Rie,8943,8,11,5,20,40,58,-18,38
Admira Wacke,8943,9,10,7,19,34,64,-30,37
Mattersburg,8943,10,7,9,20,33,59,-26,30
FC Salzburg,8944,1,22,9,5,67,28,39,75
SC Rheindorf,8944,2,18,9,9,52,41,11,63
SK Sturm Gra,8944,3,17,11,8,66,41,25,62
Vienna,8944,4,17,6,13,62,56,6,57
Rapid Vienna,8944,5,13,13,10,50,40,10,52
SV Josko Rie,8944,6,12,7,17,35,52,-17,43
Admira Wacke,8944,7,11,7,18,37,57,-20,40
RZ Pellets W,8944,8,10,8,18,43,61,-18,38
Mattersburg,8944,9,10,6,20,40,54,-14,36
St. Pölten,8944,10,7,10,19,37,59,-22,31
FC Salzburg,8945,1,23,5,8,65,29,36,74
SC Rheindorf,8945,2,21,6,9,59,45,14,69
SK Sturm Gra,8945,3,18,4,14,58,39,19,58
Vienna,8945,4,17,5,14,71,62,9,56
Rapid Vienna,8945,5,14,10,12,59,42,17,52
RZ Pellets W,8945,6,14,7,15,50,55,-5,49
Admira Wacke,8945,7,12,6,18,37,59,-22,42
SV Josko Rie,8945,8,11,5,20,35,60,-25,38
St. Pölten,8945,9,8,11,17,38,60,-22,35
Mattersburg,8945,10,9,7,20,40,61,-21,34
FC Salzburg,8946,1,19,10,7,63,31,32,67
SK Sturm Gra,8946,2,19,8,9,62,39,23,65
SC Rheindorf,8946,3,16,13,7,51,39,12,61
Rapid Vienna,8946,4,16,8,12,56,38,18,56
Vienna,8946,5,16,6,14,58,57,1,54
Admira Wacke,8946,6,15,5,16,40,54,-14,50
SV Josko Rie,8946,7,11,7,18,41,54,-13,40
RZ Pellets W,8946,8,10,8,18,46,59,-13,38
St. Pölten,8946,9,9,9,18,45,63,-18,36
Mattersburg,8946,10,7,10,19,33,61,-28,31
SC Rheindorf,8947,1,21,8,7,62,39,23,71
Vienna,8947,2,21,5,10,69,51,18,68
FC Salzburg,8947,3,20,7,9,58,30,28,67
SK Sturm Gra,8947,4,16,13,7,56,33,23,61
Rapid Vienna,8947,5,16,9,11,54,33,21,57
Admira Wacke,8947,6,12,7,17,39,59,-20,43
RZ Pellets W,8947,7,11,9,16,41,53,-12,42
SV Josko Rie,8947,8,11,6,19,38,52,-14,39
St. Pölten,8947,9,5,11,20,30,62,-32,26
Mattersburg,8947,10,6,7,23,34,69,-35,25
FC Salzburg,8948,1,22,7,7,65,26,39,73
SC Rheindorf,8948,2,20,9,7,53,35,18,69
SK Sturm Gra,8948,3,21,4,11,67,40,27,67
Vienna,8948,4,19,5,12,56,46,10,62
Rapid Vienna,8948,5,12,10,14,53,50,3,46
SV Josko Rie,8948,6,11,6,19,38,51,-13,39
Mattersburg,8948,7,9,11,16,42,58,-16,38
RZ Pellets W,8948,8,11,5,20,42,62,-20,38
Admira Wacke,8948,9,11,4,21,33,60,-27,37
St. Pölten,8948,10,9,9,18,41,62,-21,36
FC Salzburg,8949,1,20,8,8,65,33,32,68
SK Sturm Gra,8949,2,18,10,8,60,36,24,64
Vienna,8949,3,19,7,10,61,45,16,64
SC Rheindorf,8949,4,16,13,7,50,44,6,61
Rapid Vienna,8949,5,15,10,11,60,38,22,55
RZ Pellets W,8949,6,12,10,14,46,56,-10,46
Admira Wacke,8949,7,12,8,16,36,54,-18,44
SV Josko Rie,8949,8,9,7,20,33,55,-22,34
Mattersburg,8949,9,7,11,18,38,59,-21,32
St. Pölten,8949,10,6,8,22,39,68,-29,26
SK Sturm Gra,8950,1,23,5,8,69,36,33,74
Vienna,8950,2,20,6,10,61,48,13,66
FC Salzburg,8950,3,19,7,10,61,35,26,64
SC Rheindorf,8950,4,18,9,9,57,43,14,63
Rapid Vienna,8950,5,13,11,12,51,40,11,50
RZ Pellets W,8950,6,14,6,16,47,52,-5,48
Mattersburg,8950,7,10,6,20,37,56,-19,36
SV Josko Rie,8950,8,11,3,22,34,56,-22,36
St. Pölten,8950,9,8,10,18,40,63,-23,34
Admira Wacke,8950,10,9,7,20,39,67,-28,34
Vienna,8951,1,19,8,9,64,45,19,65
SC Rheindorf,8951,2,19,8,9,57,44,13,65
FC Salzburg,8951,3,17,10,9,54,30,24,61
SK Sturm Gra,8951,4,17,9,10,68,45,23,60
Rapid Vienna,8951,5,13,13,10,55,41,14,52
RZ Pellets W,8951,6,12,9,15,42,51,-9,45
St. Pölten,8951,7,11,8,17,40,57,-17,41
SV Josko Rie,8951,8,11,5,20,32,51,-19,38
Admira Wacke,8951,9,10,8,18,30,55,-25,38
Mattersburg,8951,10,8,8,20,32,55,-23,32
Vienna,8952,1,23,3,10,70,48,22,72
FC Salzburg,8952,2,19,9,8,67,34,33,66
SK Sturm Gra,8952,3,19,5,12,59,38,21,62
Rapid Vienna,8952,4,16,12,8,58,37,21,60
SC Rheindorf,8952,5,17,8,11,50,42,8,59
RZ Pellets W,8952,6,11,12,13,48,53,-5,45
SV Josko Rie,8952,7,11,5,20,38,53,-15,38
St. Pölten,8952,8,8,13,15,36,58,-22,37
Mattersburg,8952,9,7,9,20,32,59,-27,30
Admira Wacke,8952,10,8,6,22,38,74,-36,30
SC Rheindorf,8953,1,23,5,8,61,35,26,74
FC Salzburg,8953,2,21,8,7,67,28,39,71
SK Sturm Gra,8953,3,22,3,11,68,38,30,69
Rapid Vienna,8953,4,17,9,10,71,43,28,60
Vienna,8953,5,18,3,15,58,50,8,57
Admira Wacke,8953,6,14,5,17,43,64,-21,47
RZ Pellets W,8953,7,12,7,17,47,56,-9,43
SV Josko Rie,8953,8,9,5,22,30,62,-32,32
St. Pölten,8953,9,7,10,19,37,75,-38,31
Mattersburg,8953,10,7,5,24,29,60,-31,26
SC Rheindorf,8954,1,21,8,7,63,41,22,71
FC Salzburg,8954,2,19,10,7,65,34,31,67
SK Sturm Gra,8954,3,19,8,9,59,38,21,65
Vienna,8954,4,19,5,12,61,50,11,62
Rapid Vienna,8954,5,13,11,12,56,43,13,50
RZ Pellets W,8954,6,12,7,17,44,55,-11,43
SV Josko Rie,8954,7,11,8,17,33,47,-14,41
Mattersburg,8954,8,9,7,20,40,64,-24,34
Admira Wacke,8954,9,9,7,20,33,60,-27,34
St. Pölten,8954,10,8,9,19,44,66,-22,33
FC Salzburg,8955,1,22,7,7,72,37,35,73
SK Sturm Gra,8955,2,20,6,10,58,30,28,66
Vienna,8955,3,19,6,11,61,51,10,63
SC Rheindorf,8955,4,18,9,9,53,46,7,63
Rapid Vienna,8955,5,14,13,9,59,37,22,55
Admira Wacke,8955,6,11,8,17,41,60,-19,41
RZ Pellets W,8955,7,9,9,18,42,64,-22,36
SV Josko Rie,8955,8,9,8,19,36,52,-16,35
Mattersburg,8955,9,7,12,17,39,56,-17,33
St. Pölten,8955,10,6,12,18,44,72,-28,30
SK Sturm Gra,8956,1,21,7,8,61,32,29,70
FC Salzburg,8956,2,20,9,7,77,39,38,69
Rapid Vienna,8956,3,17,10,9,61,39,22,61
Vienna,8956,4,18,4,14,67,61,6,58
SC Rheindorf,8956,5,15,8,13,48,50,-2,53
Admira Wacke,8956,6,13,7,16,42,57,-15,46
SV Josko Rie,8956,7,12,4,20,35,56,-21,40
Mattersburg,8956,8,10,9,17,40,50,-10,39
RZ Pellets W,8956,9,9,9,18,43,61,-18,36
St. Pölten,8956,10,7,9,20,39,68,-29,30
FC Salzburg,8957,1,20,9,7,64,31,33,69
SC Rheindorf,8957,2,19,9,8,56,37,19,66
SK Sturm Gra,8957,3,18,8,10,56,34,22,62
Rapid Vienna,8957,4,15,11,10,58,39,19,56
Vienna,8957,5,17,5,14,54,49,5,56
Admira Wacke,8957,6,12,10,14,41,55,-14,46
RZ Pellets W,8957,7,12,7,17,42,50,-8,43
SV Josko Rie,8957,8,12,5,19,35,53,-18,41
Mattersburg,8957,9,9,8,19,34,54,-20,35
St. Pölten,8957,10,5,10,21,37,75,-38,25
FC Salzburg,8958,1,22,9,5,72,33,39,75
SK Sturm Gra,8958,2,21,6,9,67,37,30,69
SC Rheindorf,8958,3,20,8,8,59,43,16,68
Vienna,8958,4,17,7,12,63,56,7,58
Rapid Vienna,8958,5,12,11,13,54,47,7,47
Admira Wacke,8958,6,12,7,17,39,60,-21,43
RZ Pellets W,8958,7,11,7,18,40,51,-11,40
SV Josko Rie,8958,8,11,4,21,41,61,-20,37
St. Pölten,8958,9,8,10,18,41,66,-25,34
Mattersburg,8958,10,8,7,21,40,62,-22,31
FC Salzburg,8959,1,23,6,7,68,30,38,75
SK Sturm Gra,8959,2,22,6,8,67,32,35,72
Vienna,8959,3,19,5,12,62,47,15,62
SC Rheindorf,8959,4,16,10,10,55,48,7,58
Rapid Vienna,8959,5,11,12,13,49,45,4,45
Admira Wacke,8959,6,12,8,16,39,57,-18,44
RZ Pellets W,8959,7,12,6,18,51,62,-11,42
SV Josko Rie,8959,8,12,5,19,39,55,-16,41
St. Pölten,8959,9,7,10,19,42,78,-36,31
Mattersburg,8959,10,6,12,18,33,51,-18,30
SK Sturm Gra,8960,1,21,6,9,66,42,24,69
FC Salzburg,8960,2,20,7,9,59,34,25,67
SC Rheindorf,8960,3,19,6,11,51,43,8,63
Vienna,8960,4,16,6,14,58,54,4,54
Rapid Vienna,8960,5,14,11,11,61,46,15,53
St. Pölten,8960,6,11,11,14,41,52,-11,44
Admira Wacke,8960,7,12,5,19,37,57,-20,41
SV Josko Rie,8960,8,12,4,20,35,49,-14,40
RZ Pellets W,8960,9,11,6,19,44,58,-14,39
Mattersburg,8960,10,8,10,18,37,54,-17,34
FC Salzburg,8961,1,22,7,7,67,28,39,73
SK Sturm Gra,8961,2,21,4,11,60,36,24,67
Vienna,8961,3,20,3,13,64,51,13,63
SC Rheindorf,8961,4,16,8,12,55,42,13,56
RZ Pellets W,8961,5,15,7,14,45,49,-4,52
Rapid Vienna,8961,6,14,9,13,51,44,7,51
SV Josko Rie,8961,7,11,5,20,40,60,-20,38
Admira Wacke,8961,8,11,5,20,34,62,-28,38
Mattersburg,8961,9,9,8,19,37,56,-19,35
St. Pölten,8961,10,8,10,18,43,68,-25,34
FC Salzburg,8962,1,21,8,7,67,31,36,71
Vienna,8962,2,19,7,10,65,45,20,64
SK Sturm Gra,8962,3,19,6,11,58,38,20,63
SC Rheindorf,8962,4,18,9,9,52,35,17,63
Rapid Vienna,8962,5,13,13,10,55,39,16,52
RZ Pellets W,8962,6,12,10,14,43,48,-5,46
Admira Wacke,8962,7,9,11,16,31,55,-24,38
SV Josko Rie,8962,8,10,5,21,26,55,-29,35
Mattersburg,8962,9,8,9,19,33,58,-25,33
St. Pölten,8962,10,6,12,18,40,66,-26,30
FC Salzburg,8963,1,22,8,6,66,25,41,74
SC Rheindorf,8963,2,20,8,8,55,41,14,68
SK Sturm Gra,8963,3,18,9,9,61,33,28,63
Vienna,8963,4,18,8,10,60,50,10,62
Rapid Vienna,8963,5,11,15,10,51,37,14,48
RZ Pellets W,8963,6,13,6,17,44,57,-13,45
SV Josko Rie,8963,7,10,9,17,48,64,-16,39
Admira Wacke,8963,8,8,12,16,36,58,-22,36
St. Pölten,8963,9,8,10,18,41,64,-23,34
Mattersburg,8963,10,5,9,22,31,64,-33,24
FC Salzburg,8964,1,21,7,8,69,32,37,70
SK Sturm Gra,8964,2,21,5,10,60,33,27,68
SC Rheindorf,8964,3,19,9,8,65,44,21,66
Rapid Vienna,8964,4,14,13,9,57,41,16,55
Vienna,8964,5,14,5,17,57,63,-6,47
RZ Pellets W,8964,6,13,8,15,42,52,-10,47
SV Josko Rie,8964,7,13,4,19,39,57,-18,43
Admira Wacke,8964,8,11,5,20,35,61,-26,38
St. Pölten,8964,9,9,8,19,38,63,-25,35
Mattersburg,8964,10,8,10,18,39,55,-16,34
SC Rheindorf,8965,1,20,9,7,57,41,16,69
FC Salzburg,8965,2,19,8,9,63,36,27,65
SK Sturm Gra,8965,3,19,7,10,59,33,26,64
Vienna,8965,4,17,8,11,67,54,13,59
Rapid Vienna,8965,5,14,9,13,48,39,9,51
RZ Pellets W,8965,6,14,8,14,54,56,-2,50
SV Josko Rie,8965,7,11,6,19,41,53,-12,39
St. Pölten,8965,8,10,9,17,39,63,-24,39
Admira Wacke,8965,9,8,9,19,36,65,-29,33
Mattersburg,8965,10,6,11,19,36,60,-24,29
FC Salzburg,8966,1,21,6,9,65,32,33,69
SC Rheindorf,8966,2,20,7,9,51,45,6,67
Vienna,8966,3,19,6,11,62,41,21,63
SK Sturm Gra,8966,4,17,7,12,58,37,21,58
Rapid Vienna,8966,5,15,9,12,55,42,13,54
RZ Pellets W,8966,6,14,8,14,45,52,-7,50
Admira Wacke,8966,7,12,6,18,35,55,-20,42
St. Pölten,8966,8,10,10,16,41,54,-13,40
SV Josko Rie,8966,9,8,6,22,31,57,-26,30
Mattersburg,8966,10,7,9,20,34,62,-28,30
FC Salzburg,8967,1,23,7,6,63,26,37,76
SK Sturm Gra,8967,2,20,6,10,61,36,25,66
Vienna,8967,3,18,8,10,63,49,14,62
SC Rheindorf,8967,4,18,8,10,54,44,10,62
Rapid Vienna,8967,5,15,12,9,61,40,21,57
RZ Pellets W,8967,6,11,10,15,51,62,-11,43
Admira Wacke,8967,7,12,6,18,34,55,-21,42
SV Josko Rie,8967,8,9,8,19,37,54,-17,35
St. Pölten,8967,9,6,10,20,41,72,-31,28
Mattersburg,8967,10,5,11,20,30,57,-27,26
SC Rheindorf,8968,1,22,7,7,57,39,18,73
Vienna,8968,2,19,6,11,64,50,14,63
FC Salzburg,8968,3,17,9,10,54,32,22,60
SK Sturm Gra,8968,4,16,9,11,57,39,18,57
Rapid Vienna,8968,5,13,11,12,58,41,17,50
Mattersburg,8968,6,11,9,16,44,52,-8,42
St. Pölten,8968,7,11,9,16,46,61,-15,42
RZ Pellets W,8968,8,11,9,16,43,61,-18,42
Admira Wacke,8968,9,10,7,19,38,63,-25,37
SV Josko Rie,8968,10,8,8,20,34,57,-23,32
FC Salzburg,8969,1,25,6,5,75,31,44,81
Vienna,8969,2,19,7,10,69,50,19,64
SK Sturm Gra,8969,3,17,10,9,60,37,23,61
SC Rheindorf,8969,4,17,8,11,59,46,13,59
Rapid Vienna,8969,5,12,13,11,49,39,10,49
RZ Pellets W,8969,6,12,7,17,50,58,-8,43
Admira Wacke,8969,7,12,4,20,34,64,-30,40
St. Pölten,8969,8,9,11,16,42,59,-17,38
SV Josko Rie,8969,9,9,5,22,30,61,-31,32
Mattersburg,8969,10,6,13,17,33,56,-23,31
FC Salzburg,8970,1,18,11,7,60,27,33,65
SC Rheindorf,8970,2,19,8,9,55,44,11,65
Vienna,8970,3,19,6,11,60,50,10,63
SK Sturm Gra,8970,4,17,6,13,60,41,19,57
Rapid Vienna,8970,5,15,10,11,57,45,12,55
SV Josko Rie,8970,6,12,7,17,36,51,-15,43
Admira Wacke,8970,7,11,8,17,43,59,-16,41
Mattersburg,8970,8,10,9,17,38,51,-13,39
RZ Pellets W,8970,9,10,6,20,41,59,-18,36
St. Pölten,8970,10,8,11,17,41,64,-23,35
SC Rheindorf,8971,1,20,9,7,53,42,11,69
FC Salzburg,8971,2,20,7,9,67,34,33,67
SK Sturm Gra,8971,3,18,7,11,60,38,22,61
Vienna,8971,4,17,7,12,59,49,10,58
Rapid Vienna,8971,5,14,12,10,59,40,19,54
RZ Pellets W,8971,6,12,7,17,49,58,-9,43
Mattersburg,8971,7,10,10,16,39,54,-15,40
SV Josko Rie,8971,8,11,5,20,32,48,-16,38
Admira Wacke,8971,9,10,6,20,30,61,-31,36
St. Pölten,8971,10,7,12,17,41,65,-24,33
FC Salzburg,8972,1,20,8,8,67,36,31,68
SK Sturm Gra,8972,2,21,4,11,60,42,18,67
SC Rheindorf,8972,3,19,7,10,56,44,12,64
Vienna,8972,4,19,6,11,66,47,19,63
Rapid Vienna,8972,5,15,8,13,57,43,14,53
RZ Pellets W,8972,6,15,5,16,52,59,-7,50
SV Josko Rie,8972,7,12,4,20,36,55,-19,40
Admira Wacke,8972,8,11,6,19,40,67,-27,39
Mattersburg,8972,9,8,9,19,40,58,-18,33
St. Pölten,8972,10,8,7,21,41,64,-23,31
SC Rheindorf,8973,1,22,8,6,61,38,23,74
Vienna,8973,2,20,7,9,65,48,17,67
SK Sturm Gra,8973,3,17,8,11,56,33,23,59
FC Salzburg,8973,4,17,8,11,63,41,22,59
Rapid Vienna,8973,5,13,10,13,50,40,10,49
RZ Pellets W,8973,6,13,9,14,47,56,-9,48
SV Josko Rie,8973,7,10,7,19,29,48,-19,37
St. Pölten,8973,8,8,13,15,47,67,-20,37
Admira Wacke,8973,9,8,9,19,31,59,-28,33
Mattersburg,8973,10,6,13,17,38,57,-19,31
FC Salzburg,8974,1,21,7,8,67,32,35,70
SK Sturm Gra,8974,2,20,8,8,59,34,25,68
SC Rheindorf,8974,3,18,10,8,60,48,12,64
Rapid Vienna,8974,4,15,9,12,55,39,16,54
Vienna,8974,5,16,6,14,57,54,3,54
RZ Pellets W,8974,6,12,10,14,49,56,-7,46
SV Josko Rie,8974,7,11,7,18,33,51,-18,40
Admira Wacke,8974,8,11,7,18,39,60,-21,40
Mattersburg,8974,9,7,13,16,42,60,-18,34
St. Pölten,8974,10,6,9,21,39,66,-27,27
FC Salzburg,8975,1,21,6,9,69,35,34,69
SC Rheindorf,8975,2,20,7,9,60,44,16,67
SK Sturm Gra,8975,3,19,7,10,62,36,26,64
Vienna,8975,4,19,5,12,58,47,11,62
Rapid Vienna,8975,5,14,13,9,63,38,25,55
Admira Wacke,8975,6,12,7,17,37,57,-20,43
RZ Pellets W,8975,7,10,10,16,38,52,-14,40
St. Pölten,8975,8,9,9,18,39,61,-22,36
Mattersburg,8975,9,9,6,21,32,59,-27,33
SV Josko Rie,8975,10,9,6,21,29,58,-29,33
Vienna,8976,1,20,4,12,64,52,12,64
FC Salzburg,8976,2,18,8,10,61,37,24,62
SC Rheindorf,8976,3,17,11,8,55,45,10,62
SK Sturm Gra,8976,4,18,6,12,57,37,20,60
Rapid Vienna,8976,5,17,7,12,58,42,16,58
Admira Wacke,8976,6,15,6,15,41,48,-7,51
SV Josko Rie,8976,7,11,7,18,41,52,-11,40
Mattersburg,8976,8,10,8,18,40,55,-15,38
RZ Pellets W,8976,9,10,8,18,40,60,-20,38
St. Pölten,8976,10,5,13,18,35,64,-29,28
FC Salzburg,8977,1,19,10,7,58,25,33,67
SC Rheindorf,8977,2,19,10,7,55,40,15,67
Rapid Vienna,8977,3,17,10,9,63,34,29,61
SK Sturm Gra,8977,4,16,9,11,49,35,14,57
Vienna,8977,5,14,7,15,53,56,-3,49
SV Josko Rie,8977,6,11,8,17,39,54,-15,41
RZ Pellets W,8977,7,10,10,16,41,58,-17,40
St. Pölten,8977,8,8,15,13,44,56,-12,39
Admira Wacke,8977,9,11,6,19,31,53,-22,39
Mattersburg,8977,10,8,9,19,37,59,-22,33
FC Salzburg,8978,1,22,6,8,67,35,32,72
Vienna,8978,2,22,5,9,74,45,29,71
SK Sturm Gra,8978,3,20,6,10,58,29,29,66
SC Rheindorf,8978,4,18,7,11,51,40,11,61
Rapid Vienna,8978,5,15,8,13,59,45,14,53
RZ Pellets W,8978,6,13,8,15,38,51,-13,47
St. Pölten,8978,7,9,10,17,40,62,-22,37
Mattersburg,8978,8,9,7,20,39,64,-25,34
Admira Wacke,8978,9,9,6,21,34,63,-29,33
SV Josko Rie,8978,10,9,5,22,34,60,-26,32
SK Sturm Gra,8979,1,22,5,9,67,35,32,71
FC Salzburg,8979,2,21,6,9,64,33,31,69
Vienna,8979,3,20,5,11,68,46,22,65
SC Rheindorf,8979,4,18,9,9,52,44,8,63
Rapid Vienna,8979,5,13,10,13,60,50,10,49
SV Josko Rie,8979,6,13,5,18,38,57,-19,44
RZ Pellets W,8979,7,12,7,17,52,62,-10,43
Admira Wacke,8979,8,12,6,18,39,64,-25,42
St. Pölten,8979,9,7,11,18,37,56,-19,32
Mattersburg,8979,10,6,8,22,32,62,-30,26
Vienna,8980,1,21,5,10,77,53,24,68
SC Rheindorf,8980,2,20,7,9,58,45,13,67
FC Salzburg,8980,3,17,11,8,65,38,27,62
Rapid Vienna,8980,4,15,10,11,60,40,20,55
Admira Wacke,8980,5,15,8,13,49,55,-6,53
SK Sturm Gra,8980,6,15,7,14,50,42,8,52
RZ Pellets W,8980,7,11,9,16,49,63,-14,42
St. Pölten,8980,8,11,8,17,53,62,-9,41
Mattersburg,8980,9,7,11,18,37,64,-27,32
SV Josko Rie,8980,10,7,6,23,32,68,-36,27
FC Salzburg,8981,1,21,8,7,65,29,36,71
SK Sturm Gra,8981,2,21,6,9,59,30,29,69
Vienna,8981,3,20,5,11,57,41,16,65
SC Rheindorf,8981,4,19,7,10,58,44,14,64
Rapid Vienna,8981,5,12,16,8,53,36,17,52
RZ Pellets W,8981,6,11,8,17,40,55,-15,41
St. Pölten,8981,7,10,8,18,45,64,-19,38
SV Josko Rie,8981,8,9,7,20,29,51,-22,34
Admira Wacke,8981,9,9,7,20,28,54,-26,34
Mattersburg,8981,10,9,6,21,35,65,-30,33
FC Salzburg,8982,1,23,6,7,71,33,38,75
SC Rheindorf,8982,2,22,8,6,55,32,23,74
Vienna,8982,3,19,6,11,69,52,17,63
SK Sturm Gra,8982,4,17,7,12,55,41,14,58
Rapid Vienna,8982,5,15,11,10,58,41,17,56
RZ Pellets W,8982,6,12,7,17,45,58,-13,43
Admira Wacke,8982,7,11,7,18,33,57,-24,40
St. Pölten,8982,8,8,9,19,32,53,-21,33
SV Josko Rie,8982,9,10,3,23,31,57,-26,33
Mattersburg,8982,10,6,10,20,37,62,-25,28
SC Rheindorf,8983,1,18,9,9,55,47,8,63
FC Salzburg,8983,2,17,11,8,55,28,27,62
SK Sturm Gra,8983,3,17,7,12,53,34,19,58
Vienna,8983,4,17,6,13,61,52,9,57
Rapid Vienna,8983,5,14,10,12,58,41,17,52
RZ Pellets W,8983,6,12,9,15,47,59,-12,45
St. Pölten,8983,7,11,9,16,49,64,-15,42
Admira Wacke,8983,8,12,6,18,39,59,-20,42
Mattersburg,8983,9,10,9,17,44,60,-16,39
SV Josko Rie,8983,10,10,8,18,32,49,-17,38
SK Sturm Gra,8984,1,23,4,9,65,35,30,73
Vienna,8984,2,22,5,9,64,49,15,71
SC Rheindorf,8984,3,20,7,9,56,44,12,67
FC Salzburg,8984,4,18,7,11,62,34,28,61
RZ Pellets W,8984,5,16,5,15,50,49,1,53
Rapid Vienna,8984,6,11,11,14,50,43,7,44
SV Josko Rie,8984,7,12,5,19,36,53,-17,41
Admira Wacke,8984,8,11,5,20,35,59,-24,38
Mattersburg,8984,9,7,10,19,36,57,-21,31
St. Pölten,8984,10,7,7,22,32,63,-31,28
FC Salzburg,8985,1,21,8,7,66,27,39,71
SK Sturm Gra,8985,2,20,6,10,70,42,28,66
SC Rheindorf,8985,3,17,8,11,58,57,1,59
Vienna,8985,4,17,6,13,63,54,9,57
Rapid Vienna,8985,5,12,11,13,49,42,7,47
RZ Pellets W,8985,6,12,10,14,49,55,-6,46
SV Josko Rie,8985,7,12,8,16,40,51,-11,44
St. Pölten,8985,8,11,9,16,48,65,-17,42
Admira Wacke,8985,9,11,4,21,35,63,-28,37
Mattersburg,8985,10,7,10,19,30,52,-22,31
SK Sturm Gra,8986,1,23,5,8,67,29,38,74
FC Salzburg,8986,2,21,9,6,67,27,40,72
SC Rheindorf,8986,3,19,6,11,62,48,14,63
Rapid Vienna,8986,4,16,9,11,60,41,19,57
Vienna,8986,5,17,6,13,61,52,9,57
Admira Wacke,8986,6,14,6,16,44,59,-15,48
RZ Pellets W,8986,7,10,8,18,43,58,-15,38
SV Josko Rie,8986,8,10,6,20,34,59,-25,36
St. Pölten,8986,9,8,8,20,42,75,-33,32
Mattersburg,8986,10,7,7,22,37,69,-32,28
SC Rheindorf,8987,1,22,7,7,60,37,23,73
FC Salzburg,8987,2,20,6,10,60,32,28,66
Rapid Vienna,8987,3,19,8,9,62,38,24,65
Vienna,8987,4,18,6,12,61,47,14,60
SK Sturm Gra,8987,5,17,8,11,54,38,16,59
Admira Wacke,8987,6,13,5,18,38,57,-19,44
SV Josko Rie,8987,7,13,4,19,40,48,-8,43
RZ Pellets W,8987,8,12,4,20,43,63,-20,40
St. Pölten,8987,9,8,9,19,38,64,-26,33
Mattersburg,8987,10,6,7,23,28,60,-32,25
SK Sturm Gra,8988,1,21,6,9,58,28,30,69
FC Salzburg,8988,2,20,9,7,62,33,29,69
SC Rheindorf,8988,3,19,7,10,57,43,14,64
Vienna,8988,4,17,6,13,54,47,7,57
Rapid Vienna,8988,5,12,11,13,53,47,6,47
SV Josko Rie,8988,6,13,4,19,41,55,-14,43
Admira Wacke,8988,7,12,7,17,36,52,-16,43
RZ Pellets W,8988,8,10,8,18,40,57,-17,38
Mattersburg,8988,9,9,9,18,34,48,-14,36
St. Pölten,8988,10,9,9,18,35,60,-25,36
SC Rheindorf,8989,1,24,7,5,59,32,27,79
FC Salzburg,8989,2,21,8,7,69,31,38,71
SK Sturm Gra,8989,3,17,6,13,65,42,23,57
Vienna,8989,4,16,9,11,59,49,10,57
Rapid Vienna,8989,5,14,11,11,53,40,13,53
Admira Wacke,8989,6,14,6,16,46,55,-9,48
Mattersburg,8989,7,8,11,17,37,55,-18,35
SV Josko Rie,8989,8,10,5,21,39,65,-26,35
St. Pölten,8989,9,8,9,19,34,63,-29,33
RZ Pellets W,8989,10,8,8,20,35,64,-29,32
Vienna,8990,1,21,5,10,69,50,19,68
SK Sturm Gra,8990,2,19,7,10,57,36,21,64
FC Salzburg,8990,3,18,7,11,59,35,24,61
SC Rheindorf,8990,4,17,10,9,55,43,12,61
RZ Pellets W,8990,5,17,6,13,57,47,10,57
SV Josko Rie,8990,6,14,5,17,42,55,-13,47
Rapid Vienna,8990,7,12,10,14,52,41,11,46
St. Pölten,8990,8,10,10,16,45,65,-20,40
Admira Wacke,8990,9,11,4,21,35,66,-31,37
Mattersburg,8990,10,5,8,23,37,70,-33,23
FC Salzburg,8991,1,20,5,11,59,34,25,65
SK Sturm Gra,8991,2,19,8,9,53,31,22,65
Vienna,8991,3,19,7,10,61,48,13,64
SC Rheindorf,8991,4,17,9,10,55,48,7,60
Rapid Vienna,8991,5,15,11,10,59,39,20,56
SV Josko Rie,8991,6,13,6,17,42,51,-9,45
St. Pölten,8991,7,13,6,17,48,60,-12,45
Admira Wacke,8991,8,11,7,18,39,54,-15,40
RZ Pellets W,8991,9,8,8,20,33,58,-25,32
Mattersburg,8991,10,8,7,21,33,59,-26,31
FC Salzburg,8992,1,19,7,10,73,41,32,64
SK Sturm Gra,8992,2,18,8,10,61,38,23,62
Vienna,8992,3,18,8,10,60,46,14,62
SC Rheindorf,8992,4,18,8,10,51,45,6,62
Rapid Vienna,8992,5,12,14,10,57,42,15,50
RZ Pellets W,8992,6,13,11,12,49,48,1,50
Admira Wacke,8992,7,11,9,16,35,59,-24,42
SV Josko Rie,8992,8,11,4,21,34,60,-26,37
Mattersburg,8992,9,9,9,18,34,52,-18,36
St. Pölten,8992,10,8,8,20,42,65,-23,32
FC Salzburg,8993,1,21,7,8,67,38,29,70
SK Sturm Gra,8993,2,19,8,9,58,33,25,65
Vienna,8993,3,19,6,11,64,51,13,63
SC Rheindorf,8993,4,18,7,11,60,48,12,61
Rapid Vienna,8993,5,16,10,10,60,38,22,58
RZ Pellets W,8993,6,12,8,16,52,58,-6,44
Mattersburg,8993,7,10,8,18,42,62,-20,38
St. Pölten,8993,8,8,11,17,42,69,-27,35
SV Josko Rie,8993,9,9,7,20,34,55,-21,34
Admira Wacke,8993,10,9,6,21,33,60,-27,33
FC Salzburg,8994,1,25,6,5,67,22,45,81
SK Sturm Gra,8994,2,20,7,9,62,37,25,67
SC Rheindorf,8994,3,19,8,9,49,37,12,65
Vienna,8994,4,17,5,14,61,53,8,56
RZ Pellets W,8994,5,15,7,14,49,53,-4,52
Rapid Vienna,8994,6,11,14,11,48,40,8,47
SV Josko Rie,8994,7,11,7,18,37,50,-13,40
Admira Wacke,8994,8,10,6,20,34,56,-22,36
St. Pölten,8994,9,7,10,19,42,69,-27,31
Mattersburg,8994,10,7,6,23,31,63,-32,27
FC Salzburg,8995,1,25,6,5,76,28,48,81
Vienna,8995,2,21,4,11,61,47,14,67
SK Sturm Gra,8995,3,18,6,12,54,39,15,60
Rapid Vienna,8995,4,16,11,9,60,37,23,59
SC Rheindorf,8995,5,16,8,12,57,45,12,56
RZ Pellets W,8995,6,11,10,15,40,51,-11,43
Admira Wacke,8995,7,9,10,17,32,55,-23,37
SV Josko Rie,8995,8,10,6,20,33,53,-20,36
Mattersburg,8995,9,8,11,17,35,55,-20,35
St. Pölten,8995,10,6,8,22,33,71,-38,26
FC Salzburg,8996,1,24,6,6,64,25,39,78
SC Rheindorf,8996,2,22,8,6,58,35,23,74
SK Sturm Gra,8996,3,17,9,10,56,34,22,60
Vienna,8996,4,14,8,14,51,53,-2,50
Rapid Vienna,8996,5,12,12,12,54,39,15,48
RZ Pellets W,8996,6,13,9,14,44,52,-8,48
Mattersburg,8996,7,10,8,18,40,57,-17,38
Admira Wacke,8996,8,10,5,21,33,63,-30,35
St. Pölten,8996,9,7,13,16,41,61,-20,34
SV Josko Rie,8996,10,9,6,21,33,55,-22,33
FC Salzburg,8997,1,20,8,8,63,36,27,68
SC Rheindorf,8997,2,19,9,8,51,35,16,66
SK Sturm Gra,8997,3,17,8,11,60,41,19,59
Vienna,8997,4,18,4,14,62,50,12,58
Rapid Vienna,8997,5,14,10,12,56,43,13,52
RZ Pellets W,8997,6,14,10,12,51,52,-1,52
SV Josko Rie,8997,7,12,4,20,36,53,-17,40
Admira Wacke,8997,8,10,9,17,37,59,-22,39
Mattersburg,8997,9,7,11,18,37,59,-22,32
St. Pölten,8997,10,7,11,18,43,68,-25,32
FC Salzburg,8998,1,24,7,5,73,26,47,79
Vienna,8998,2,23,2,11,76,52,24,71
SK Sturm Gra,8998,3,19,7,10,53,33,20,64
SC Rheindorf,8998,4,18,6,12,61,48,13,60
Rapid Vienna,8998,5,13,11,12,51,36,15,50
RZ Pellets W,8998,6,14,7,15,46,52,-6,49
Admira Wacke,8998,7,11,8,17,34,58,-24,41
Mattersburg,8998,8,7,10,19,33,55,-22,31
SV Josko Rie,8998,9,9,4,23,30,58,-28,31
St. Pölten,8998,10,6,10,20,37,76,-39,28
FC Salzburg,8999,1,24,6,6,69,29,40,78
SC Rheindorf,8999,2,22,6,8,62,45,17,72
SK Sturm Gra,8999,3,18,8,10,57,35,22,62
Vienna,8999,4,17,7,12,63,53,10,58
Rapid Vienna,8999,5,13,12,11,53,41,12,51
RZ Pellets W,8999,6,14,9,13,51,49,2,51
Admira Wacke,8999,7,9,8,19,30,56,-26,35
St. Pölten,8999,8,9,8,19,40,68,-28,35
SV Josko Rie,8999,9,8,6,22,30,55,-25,30
Mattersburg,8999,10,7,8,21,40,64,-24,29
SC Rheindorf,9000,1,21,7,8,50,35,15,70
Vienna,9000,2,21,6,9,66,47,19,69
SK Sturm Gra,9000,3,20,6,10,64,37,27,66
FC Salzburg,9000,4,17,10,9,57,35,22,61
Rapid Vienna,9000,5,14,13,9,63,42,21,55
RZ Pellets W,9000,6,13,7,16,47,56,-9,46
Admira Wacke,9000,7,9,10,17,36,60,-24,37
SV Josko Rie,9000,8,8,9,19,32,54,-22,33
Mattersburg,9000,9,8,8,20,34,55,-21,32
St. Pölten,9000,10,6,10,20,41,69,-28,28
FC Salzburg,9001,1,19,9,8,64,33,31,66
SC Rheindorf,9001,2,19,7,10,56,44,12,64
SK Sturm Gra,9001,3,18,9,9,57,32,25,63
Vienna,9001,4,19,5,12,67,53,14,62
Rapid Vienna,9001,5,15,10,11,69,44,25,55
RZ Pellets W,9001,6,12,7,17,49,64,-15,43
Admira Wacke,9001,7,11,6,19,38,67,-29,39
St. Pölten,9001,8,10,8,18,44,67,-23,38
Mattersburg,9001,9,10,7,19,36,57,-21,37
SV Josko Rie,9001,10,9,8,19,37,56,-19,35
FC Salzburg,9002,1,23,8,5,67,24,43,77
SK Sturm Gra,9002,2,20,5,11,59,32,27,65
SC Rheindorf,9002,3,19,7,10,51,43,8,64
Vienna,9002,4,18,5,13,61,53,8,59
Rapid Vienna,9002,5,16,9,11,57,42,15,57
SV Josko Rie,9002,6,12,6,18,40,52,-12,42
Admira Wacke,9002,7,11,6,19,42,66,-24,39
Mattersburg,9002,8,10,8,18,40,56,-16,38
RZ Pellets W,9002,9,11,5,20,47,64,-17,38
St. Pölten,9002,10,6,9,21,42,74,-32,27
FC Salzburg,9003,1,21,6,9,68,31,37,69
Rapid Vienna,9003,2,19,8,9,62,38,24,65
Vienna,9003,3,20,5,11,61,45,16,65
SK Sturm Gra,9003,4,17,8,11,49,32,17,59
SC Rheindorf,9003,5,17,8,11,51,42,9,59
RZ Pellets W,9003,6,12,7,17,43,59,-16,43
Mattersburg,9003,7,10,9,17,52,65,-13,39
Admira Wacke,9003,8,10,8,18,34,60,-26,38
St. Pölten,9003,9,7,12,17,43,65,-22,33
SV Josko Rie,9003,10,8,7,21,33,59,-26,31
FC Salzburg,9004,1,21,7,8,70,33,37,70
SC Rheindorf,9004,2,20,7,9,53,35,18,67
SK Sturm Gra,9004,3,20,6,10,69,43,26,66
Vienna,9004,4,18,4,14,58,55,3,58
Rapid Vienna,9004,5,12,12,12,58,43,15,48
SV Josko Rie,9004,6,13,6,17,32,42,-10,45
RZ Pellets W,9004,7,11,7,18,39,57,-18,40
Mattersburg,9004,8,10,9,17,38,55,-17,39
Admira Wacke,9004,9,11,4,21,38,64,-26,37
St. Pölten,9004,10,9,8,19,40,68,-28,35
FC Salzburg,9005,1,22,9,5,65,23,42,75
SK Sturm Gra,9005,2,20,6,10,52,30,22,66
Vienna,9005,3,19,6,11,64,43,21,63
SC Rheindorf,9005,4,15,7,14,49,51,-2,52
Rapid Vienna,9005,5,13,11,12,62,42,20,50
RZ Pellets W,9005,6,12,5,19,43,62,-19,41
Admira Wacke,9005,7,11,8,17,35,55,-20,41
St. Pölten,9005,8,11,8,17,45,67,-22,41
Mattersburg,9005,9,9,10,17,39,55,-16,37
SV Josko Rie,9005,10,9,8,19,29,55,-26,35
SK Sturm Gra,9006,1,22,4,10,57,31,26,70
FC Salzburg,9006,2,20,7,9,69,34,35,67
SC Rheindorf,9006,3,19,9,8,58,42,16,66
Vienna,9006,4,18,4,14,64,54,10,58
Rapid Vienna,9006,5,14,9,13,50,42,8,51
SV Josko Rie,9006,6,14,4,18,35,48,-13,46
RZ Pellets W,9006,7,12,6,18,47,61,-14,42
Mattersburg,9006,8,11,8,17,37,53,-16,41
St. Pölten,9006,9,8,10,18,45,66,-21,34
Admira Wacke,9006,10,10,3,23,33,64,-31,33
FC Salzburg,9007,1,21,10,5,70,28,42,73
SK Sturm Gra,9007,2,22,4,10,70,32,38,70
SC Rheindorf,9007,3,20,8,8,54,35,19,68
Rapid Vienna,9007,4,14,12,10,52,36,16,54
Vienna,9007,5,15,6,15,54,57,-3,51
Admira Wacke,9007,6,13,8,15,39,48,-9,47
SV Josko Rie,9007,7,12,5,19,41,57,-16,41
RZ Pellets W,9007,8,10,5,21,39,65,-26,35
Mattersburg,9007,9,8,9,19,38,63,-25,33
St. Pölten,9007,10,7,9,20,38,74,-36,30
FC Salzburg,9008,1,24,6,6,67,27,40,78
SC Rheindorf,9008,2,20,6,10,60,43,17,66
SK Sturm Gra,9008,3,19,5,12,58,39,19,62
Vienna,9008,4,15,5,16,59,62,-3,50
Rapid Vienna,9008,5,13,10,13,56,50,6,49
RZ Pellets W,9008,6,14,7,15,53,54,-1,49
SV Josko Rie,9008,7,11,6,19,43,57,-14,39
Mattersburg,9008,8,10,9,17,41,57,-16,39
Admira Wacke,9008,9,10,9,17,32,56,-24,39
St. Pölten,9008,10,9,7,20,37,61,-24,34
FC Salzburg,9009,1,20,9,7,60,32,28,69
SK Sturm Gra,9009,2,19,7,10,65,36,29,64
Vienna,9009,3,19,6,11,67,48,19,63
SC Rheindorf,9009,4,18,8,10,53,44,9,62
Rapid Vienna,9009,5,14,11,11,51,38,13,53
RZ Pellets W,9009,6,14,6,16,46,54,-8,48
St. Pölten,9009,7,11,10,15,50,59,-9,43
Admira Wacke,9009,8,11,7,18,37,60,-23,40
SV Josko Rie,9009,9,8,8,20,32,58,-26,32
Mattersburg,9009,10,5,10,21,34,66,-32,25
SC Rheindorf,9010,1,21,8,7,62,39,23,71
FC Salzburg,9010,2,19,8,9,60,33,27,65
Rapid Vienna,9010,3,18,8,10,57,35,22,62
Vienna,9010,4,19,5,12,68,53,15,62
SK Sturm Gra,9010,5,17,9,10,55,30,25,60
RZ Pellets W,9010,6,12,6,18,43,60,-17,42
St. Pölten,9010,7,10,9,17,35,58,-23,39
Mattersburg,9010,8,10,6,20,38,52,-14,36
Admira Wacke,9010,9,9,7,20,31,62,-31,34
SV Josko Rie,9010,10,9,6,21,33,60,-27,33
FC Salzburg,9011,1,20,12,4,66,23,43,72
SK Sturm Gra,9011,2,22,5,9,64,28,36,71
SC Rheindorf,9011,3,18,8,10,55,47,8,62
Rapid Vienna,9011,4,15,12,9,63,34,29,57
Vienna,9011,5,17,4,15,58,51,7,55
RZ Pellets W,9011,6,11,9,16,44,58,-14,42
Mattersburg,9011,7,9,11,16,38,52,-14,38
SV Josko Rie,9011,8,10,8,18,31,52,-21,38
Admira Wacke,9011,9,9,8,19,33,73,-40,35
St. Pölten,9011,10,6,9,21,41,75,-34,27
SC Rheindorf,9012,1,20,9,7,57,39,18,69
FC Salzburg,9012,2,20,8,8,69,33,36,68
SK Sturm Gra,9012,3,19,8,9,64,35,29,65
Vienna,9012,4,17,6,13,57,51,6,57
Rapid Vienna,9012,5,13,10,13,49,40,9,49
RZ Pellets W,9012,6,11,9,16,43,53,-10,42
St. Pölten,9012,7,10,11,15,42,57,-15,41
SV Josko Rie,9012,8,12,4,20,38,57,-19,40
Admira Wacke,9012,9,9,8,19,31,62,-31,35
Mattersburg,9012,10,9,7,20,35,58,-23,34
FC Salzburg,9013,1,21,8,7,62,27,35,71
Vienna,9013,2,19,6,11,61,48,13,63
Rapid Vienna,9013,3,18,8,10,61,32,29,62
SK Sturm Gra,9013,4,18,8,10,57,34,23,62
SC Rheindorf,9013,5,17,9,10,55,49,6,60
RZ Pellets W,9013,6,12,6,18,45,63,-18,42
Mattersburg,9013,7,11,7,18,43,54,-11,40
St. Pölten,9013,8,10,7,19,40,66,-26,37
Admira Wacke,9013,9,10,6,20,30,59,-29,36
SV Josko Rie,9013,10,9,5,22,29,51,-22,32
SC Rheindorf,9014,1,21,8,7,54,35,19,71
SK Sturm Gra,9014,2,21,6,9,62,36,26,69
FC Salzburg,9014,3,20,8,8,64,35,29,68
Vienna,9014,4,17,6,13,57,48,9,57
Rapid Vienna,9014,5,15,10,11,64,39,25,55
SV Josko Rie,9014,6,12,6,18,35,49,-14,42
St. Pölten,9014,7,10,8,18,38,57,-19,38
RZ Pellets W,9014,8,10,8,18,37,60,-23,38
Admira Wacke,9014,9,9,7,20,30,57,-27,34
Mattersburg,9014,10,7,9,20,34,59,-25,30
FC Salzburg,9015,1,21,7,8,70,34,36,70
SK Sturm Gra,9015,2,20,6,10,63,33,30,66
SC Rheindorf,9015,3,19,6,11,59,45,14,63
Vienna,9015,4,17,4,15,57,52,5,55
Rapid Vienna,9015,5,14,10,12,58,40,18,52
Admira Wacke,9015,6,14,7,15,39,53,-14,49
SV Josko Rie,9015,7,12,5,19,35,53,-18,41
RZ Pellets W,9015,8,10,8,18,45,68,-23,38
St. Pölten,9015,9,10,6,20,41,69,-28,36
Mattersburg,9015,10,8,11,17,37,57,-20,35
FC Salzburg,9016,1,24,6,6,73,30,43,78
SK Sturm Gra,9016,2,21,6,9,63,34,29,69
SC Rheindorf,9016,3,19,10,7,58,45,13,67
Rapid Vienna,9016,4,14,10,12,53,40,13,52
Vienna,9016,5,14,9,13,54,54,0,51
Mattersburg,9016,6,10,11,15,41,53,-12,41
RZ Pellets W,9016,7,10,8,18,53,62,-9,38
SV Josko Rie,9016,8,11,5,20,36,47,-11,38
Admira Wacke,9016,9,10,6,20,34,71,-37,36
St. Pölten,9016,10,7,9,20,41,70,-29,30
FC Salzburg,9017,1,21,7,8,80,39,41,70
SC Rheindorf,9017,2,21,6,9,58,37,21,69
Vienna,9017,3,18,8,10,67,55,12,62
Rapid Vienna,9017,4,16,10,10,65,37,28,58
SK Sturm Gra,9017,5,17,7,12,56,45,11,58
RZ Pellets W,9017,6,13,6,17,47,58,-11,45
Admira Wacke,9017,7,12,6,18,33,58,-25,42
St. Pölten,9017,8,8,11,17,42,64,-22,35
Mattersburg,9017,9,9,7,20,41,66,-25,34
SV Josko Rie,9017,10,8,6,22,32,62,-30,30
SC Rheindorf,9018,1,22,8,6,62,32,30,74
FC Salzburg,9018,2,21,8,7,70,31,39,71
SK Sturm Gra,9018,3,18,8,10,60,40,20,62
Vienna,9018,4,17,7,12,60,56,4,58
Rapid Vienna,9018,5,13,10,13,50,42,8,49
RZ Pellets W,9018,6,11,7,18,41,59,-18,40
SV Josko Rie,9018,7,12,4,20,38,58,-20,40
Admira Wacke,9018,8,10,7,19,40,64,-24,37
Mattersburg,9018,9,8,11,17,37,55,-18,35
St. Pölten,9018,10,8,10,18,42,63,-21,34
FC Salzburg,9019,1,22,6,8,69,28,41,72
SC Rheindorf,9019,2,17,9,10,48,42,6,60
SK Sturm Gra,9019,3,17,8,11,54,34,20,59
Vienna,9019,4,17,6,13,59,52,7,57
Rapid Vienna,9019,5,14,10,12,50,39,11,52
RZ Pellets W,9019,6,14,7,15,51,53,-2,49
Admira Wacke,9019,7,12,6,18,40,68,-28,42
St. Pölten,9019,8,11,6,19,42,63,-21,39
Mattersburg,9019,9,10,8,18,40,54,-14,38
SV Josko Rie,9019,10,11,4,21,37,57,-20,37
FC Salzburg,9020,1,21,7,8,63,30,33,70
Vienna,9020,2,20,5,11,64,48,16,65
SK Sturm Gra,9020,3,19,7,10,60,34,26,64
SC Rheindorf,9020,4,18,9,9,56,49,7,63
Rapid Vienna,9020,5,16,8,12,60,42,18,56
RZ Pellets W,9020,6,12,6,18,42,59,-17,42
SV Josko Rie,9020,7,11,7,18,35,51,-16,40
Admira Wacke,9020,8,11,6,19,40,60,-20,39
St. Pölten,9020,9,8,11,17,41,63,-22,35
Mattersburg,9020,10,5,12,19,30,55,-25,27
FC Salzburg,9021,1,22,5,9,72,35,37,71
Vienna,9021,2,19,4,13,69,55,14,61
SC Rheindorf,9021,3,17,10,9,57,43,14,61
SK Sturm Gra,9021,4,18,6,12,61,40,21,60
Rapid Vienna,9021,5,15,12,9,61,47,14,57
SV Josko Rie,9021,6,12,6,18,40,55,-15,42
RZ Pellets W,9021,7,12,6,18,47,66,-19,42
Admira Wacke,9021,8,12,5,19,38,65,-27,41
Mattersburg,9021,9,10,7,19,41,59,-18,37
St. Pölten,9021,10,7,11,18,43,64,-21,32
FC Salzburg,9022,1,21,8,7,65,31,34,71
SK Sturm Gra,9022,2,21,6,9,57,32,25,69
Vienna,9022,3,18,4,14,61,57,4,58
SC Rheindorf,9022,4,16,9,11,49,38,11,57
Rapid Vienna,9022,5,13,11,12,55,43,12,50
Admira Wacke,9022,6,14,4,18,44,60,-16,46
RZ Pellets W,9022,7,12,6,18,44,57,-13,42
Mattersburg,9022,8,10,10,16,40,54,-14,40
SV Josko Rie,9022,9,11,4,21,34,54,-20,37
St. Pölten,9022,10,8,10,18,36,59,-23,34
SK Sturm Gra,9023,1,21,5,10,61,36,25,68
FC Salzburg,9023,2,18,12,6,59,25,34,66
SC Rheindorf,9023,3,19,7,10,59,51,8,64
Rapid Vienna,9023,4,15,9,12,47,36,11,54
Vienna,9023,5,15,9,12,57,52,5,54
Admira Wacke,9023,6,13,7,16,44,59,-15,46
Mattersburg,9023,7,11,7,18,41,55,-14,40
SV Josko Rie,9023,8,11,6,19,33,51,-18,39
RZ Pellets W,9023,9,9,9,18,40,52,-12,36
St. Pölten,9023,10,9,7,20,37,61,-24,34
FC Salzburg,9024,1,21,8,7,62,31,31,71
SK Sturm Gra,9024,2,21,4,11,62,32,30,67
SC Rheindorf,9024,3,17,9,10,53,44,9,60
Vienna,9024,4,17,5,14,68,54,14,56
RZ Pellets W,9024,5,14,9,13,47,54,-7,51
Rapid Vienna,9024,6,13,11,12,55,40,15,50
Admira Wacke,9024,7,14,4,18,43,63,-20,46
SV Josko Rie,9024,8,13,5,18,39,52,-13,44
St. Pölten,9024,9,7,10,19,44,73,-29,31
Mattersburg,9024,10,6,9,21,34,64,-30,27
FC Salzburg,9025,1,19,10,7,61,30,31,67
Vienna,9025,2,19,8,9,71,45,26,65
SK Sturm Gra,9025,3,18,7,11,52,34,18,61
SC Rheindorf,9025,4,18,7,11,53,46,7,61
Rapid Vienna,9025,5,12,15,9,54,39,15,51
RZ Pellets W,9025,6,10,12,14,45,56,-11,42
Admira Wacke,9025,7,11,8,17,38,60,-22,41
St. Pölten,9025,8,9,10,17,41,63,-22,37
Mattersburg,9025,9,9,9,18,40,58,-18,36
SV Josko Rie,9025,10,8,8,20,34,58,-24,32
FC Salzburg,9026,1,21,8,7,71,32,39,71
SC Rheindorf,9026,2,20,10,6,63,44,19,70
SK Sturm Gra,9026,3,19,7,10,61,37,24,64
Vienna,9026,4,19,3,14,63,58,5,60
Rapid Vienna,9026,5,16,10,10,64,43,21,58
RZ Pellets W,9026,6,12,8,16,48,60,-12,44
Admira Wacke,9026,7,10,5,21,38,70,-32,35
St. Pölten,9026,8,8,10,18,43,64,-21,34
Mattersburg,9026,9,8,9,19,43,63,-20,33
SV Josko Rie,9026,10,8,8,20,35,58,-23,32
FC Salzburg,9027,1,23,6,7,67,34,33,75
SC Rheindorf,9027,2,22,6,8,68,40,28,72
Vienna,9027,3,21,7,8,64,44,20,70
SK Sturm Gra,9027,4,18,6,12,61,41,20,60
Rapid Vienna,9027,5,13,11,12,57,48,9,50
RZ Pellets W,9027,6,14,7,15,52,53,-1,49
St. Pölten,9027,7,9,12,15,50,66,-16,39
SV Josko Rie,9027,8,9,8,19,35,57,-22,35
Admira Wacke,9027,9,7,6,23,34,72,-38,27
Mattersburg,9027,10,5,9,22,32,65,-33,24
SC Rheindorf,9028,1,20,8,8,55,40,15,68
Vienna,9028,2,21,4,11,67,48,19,67
SK Sturm Gra,9028,3,20,6,10,63,33,30,66
FC Salzburg,9028,4,18,7,11,58,34,24,61
Rapid Vienna,9028,5,14,11,11,53,43,10,53
RZ Pellets W,9028,6,12,9,15,41,50,-9,45
Admira Wacke,9028,7,12,7,17,34,50,-16,43
SV Josko Rie,9028,8,12,4,20,32,53,-21,40
Mattersburg,9028,9,9,7,20,34,53,-19,34
St. Pölten,9028,10,6,9,21,38,71,-33,27
FC Salzburg,9029,1,22,7,7,73,32,41,73
SC Rheindorf,9029,2,21,5,10,55,39,16,68
SK Sturm Gra,9029,3,19,7,10,64,38,26,64
Vienna,9029,4,18,5,13,62,56,6,59
RZ Pellets W,9029,5,13,9,14,48,59,-11,48
Rapid Vienna,9029,6,11,13,12,53,47,6,46
Mattersburg,9029,7,10,9,17,43,51,-8,39
SV Josko Rie,9029,8,11,5,20,33,53,-20,38
Admira Wacke,9029,9,11,4,21,38,64,-26,37
St. Pölten,9029,10,7,10,19,38,68,-30,31
FC Salzburg,9030,1,20,10,6,71,34,37,70
Vienna,9030,2,21,4,11,68,52,16,67
SK Sturm Gra,9030,3,20,6,10,67,39,28,66
Rapid Vienna,9030,4,15,11,10,53,36,17,56
SC Rheindorf,9030,5,16,8,12,54,48,6,56
RZ Pellets W,9030,6,13,7,16,46,58,-12,46
Admira Wacke,9030,7,11,6,19,41,63,-22,39
Mattersburg,9030,8,10,6,20,42,58,-16,36
St. Pölten,9030,9,9,9,18,45,71,-26,36
SV Josko Rie,9030,10,9,5,22,37,65,-28,32
FC Salzburg,9031,1,23,6,7,69,33,36,75
Vienna,9031,2,18,7,11,64,59,5,61
SK Sturm Gra,9031,3,17,9,10,57,35,22,60
SC Rheindorf,9031,4,17,8,11,52,40,12,59
Rapid Vienna,9031,5,13,13,10,51,36,15,52
RZ Pellets W,9031,6,15,6,15,52,52,0,51
St. Pölten,9031,7,10,13,13,47,60,-13,43
Admira Wacke,9031,8,11,7,18,31,59,-28,40
SV Josko Rie,9031,9,8,7,21,36,60,-24,31
Mattersburg,9031,10,6,8,22,37,62,-25,26
FC Salzburg,9032,1,20,7,9,60,32,28,67
Vienna,9032,2,21,3,12,70,47,23,66
SK Sturm Gra,9032,3,18,8,10,56,34,22,62
SC Rheindorf,9032,4,18,7,11,47,43,4,61
Rapid Vienna,9032,5,12,14,10,45,32,13,50
Admira Wacke,9032,6,14,7,15,37,49,-12,49
RZ Pellets W,9032,7,12,7,17,42,50,-8,43
St. Pölten,9032,8,10,11,15,40,59,-19,41
SV Josko Rie,9032,9,9,7,20,31,54,-23,34
Mattersburg,9032,10,6,9,21,31,59,-28,27
FC Salzburg,9033,1,21,6,9,69,35,34,69
SK Sturm Gra,9033,2,20,8,8,64,34,30,68
SC Rheindorf,9033,3,20,8,8,55,35,20,68
Vienna,9033,4,19,5,12,66,54,12,62
Rapid Vienna,9033,5,13,11,12,55,49,6,50
Admira Wacke,9033,6,14,6,16,39,52,-13,48
RZ Pellets W,9033,7,10,9,17,46,63,-17,39
SV Josko Rie,9033,8,10,5,21,33,58,-25,35
Mattersburg,9033,9,9,6,21,37,62,-25,33
St. Pölten,9033,10,5,14,17,41,63,-22,29
FC Salzburg,9034,1,23,7,6,69,28,41,76
SK Sturm Gra,9034,2,21,6,9,62,29,33,69
SC Rheindorf,9034,3,20,8,8,57,42,15,68
Rapid Vienna,9034,4,17,10,9,63,36,27,61
Vienna,9034,5,19,4,13,61,50,11,61
RZ Pellets W,9034,6,13,8,15,44,51,-7,47
Admira Wacke,9034,7,11,5,20,39,65,-26,38
SV Josko Rie,9034,8,8,8,20,29,55,-26,32
St. Pölten,9034,9,7,7,22,39,75,-36,28
Mattersburg,9034,10,6,7,23,29,61,-32,25
FC Salzburg,9035,1,23,5,8,79,41,38,74
Vienna,9035,2,19,6,11,66,52,14,63
SK Sturm Gra,9035,3,19,5,12,66,38,28,62
SC Rheindorf,9035,4,18,8,10,54,44,10,62
Rapid Vienna,9035,5,15,11,10,54,42,12,56
Mattersburg,9035,6,12,9,15,51,59,-8,45
SV Josko Rie,9035,7,12,6,18,40,52,-12,42
RZ Pellets W,9035,8,11,7,18,44,56,-12,40
Admira Wacke,9035,9,10,4,22,37,74,-37,34
St. Pölten,9035,10,6,9,21,35,68,-33,27
FC Salzburg,9036,1,21,8,7,75,37,38,71
SC Rheindorf,9036,2,20,9,7,53,35,18,69
Vienna,9036,3,20,5,11,74,57,17,65
SK Sturm Gra,9036,4,19,3,14,50,36,14,60
Rapid Vienna,9036,5,13,10,13,56,42,14,49
RZ Pellets W,9036,6,13,7,16,52,58,-6,46
Admira Wacke,9036,7,14,3,19,40,67,-27,45
Mattersburg,9036,8,10,10,16,37,50,-13,40
SV Josko Rie,9036,9,11,4,21,41,59,-18,37
St. Pölten,9036,10,6,7,23,37,74,-37,25
SK Sturm Gra,9037,1,23,4,9,64,31,33,73
FC Salzburg,9037,2,19,9,8,61,33,28,66
Vienna,9037,3,17,6,13,53,48,5,57
SC Rheindorf,9037,4,16,8,12,51,45,6,56
Rapid Vienna,9037,5,14,12,10,58,42,16,54
Mattersburg,9037,6,12,8,16,40,48,-8,44
SV Josko Rie,9037,7,12,7,17,38,50,-12,43
Admira Wacke,9037,8,11,6,19,32,55,-23,39
St. Pölten,9037,9,10,7,19,44,68,-24,37
RZ Pellets W,9037,10,9,7,20,39,60,-21,34
SC Rheindorf,9038,1,21,9,6,59,40,19,72
FC Salzburg,9038,2,20,10,6,71,34,37,70
SK Sturm Gra,9038,3,18,5,13,57,41,16,59
Rapid Vienna,9038,4,15,13,8,57,37,20,58
Vienna,9038,5,17,7,12,67,54,13,58
RZ Pellets W,9038,6,13,8,15,46,50,-4,47
Admira Wacke,9038,7,12,8,16,33,55,-22,44
St. Pölten,9038,8,7,13,16,39,60,-21,34
SV Josko Rie,9038,9,9,3,24,29,60,-31,30
Mattersburg,9038,10,6,8,22,34,61,-27,26
FC Salzburg,9039,1,21,6,9,67,32,35,69
SC Rheindorf,9039,2,21,6,9,52,43,9,69
SK Sturm Gra,9039,3,18,7,11,54,34,20,61
Vienna,9039,4,19,3,14,65,53,12,60
Rapid Vienna,9039,5,13,12,11,54,41,13,51
SV Josko Rie,9039,6,13,5,18,45,50,-5,44
Admira Wacke,9039,7,13,3,20,45,66,-21,42
RZ Pellets W,9039,8,10,9,17,44,64,-20,39
St. Pölten,9039,9,10,8,18,42,60,-18,38
Mattersburg,9039,10,8,9,19,40,65,-25,33
FC Salzburg,9040,1,22,6,8,66,30,36,72
SC Rheindorf,9040,2,20,7,9,59,42,17,67
Vienna,9040,3,20,3,13,63,45,18,63
SK Sturm Gra,9040,4,17,8,11,55,33,22,59
Rapid Vienna,9040,5,12,11,13,50,42,8,47
RZ Pellets W,9040,6,13,7,16,47,56,-9,46
St. Pölten,9040,7,11,9,16,47,62,-15,42
Admira Wacke,9040,8,11,6,19,32,60,-28,39
Mattersburg,9040,9,9,8,19,30,54,-24,35
SV Josko Rie,9040,10,10,5,21,35,60,-25,35
FC Salzburg,9041,1,24,5,7,66,29,37,77
SC Rheindorf,9041,2,19,7,10,54,45,9,64
SK Sturm Gra,9041,3,18,9,9,62,38,24,63
Rapid Vienna,9041,4,15,9,12,53,40,13,54
Vienna,9041,5,15,4,17,52,54,-2,49
RZ Pellets W,9041,6,14,5,17,48,54,-6,47
Admira Wacke,9041,7,12,6,18,37,54,-17,42
Mattersburg,9041,8,9,10,17,38,52,-14,37
SV Josko Rie,9041,9,9,8,19,35,55,-20,35
St. Pölten,9041,10,7,13,16,37,61,-24,34
FC Salzburg,9042,1,20,7,9,62,32,30,67
Vienna,9042,2,21,4,11,65,45,20,67
SC Rheindorf,9042,3,19,7,10,57,48,9,64
Rapid Vienna,9042,4,15,12,9,52,36,16,57
SK Sturm Gra,9042,5,16,8,12,54,39,15,56
RZ Pellets W,9042,6,12,9,15,47,53,-6,45
Admira Wacke,9042,7,11,7,18,40,66,-26,40
SV Josko Rie,9042,8,10,7,19,39,53,-14,37
Mattersburg,9042,9,9,9,18,46,63,-17,36
St. Pölten,9042,10,7,10,19,40,67,-27,31
FC Salzburg,9043,1,22,8,6,71,28,43,74
SC Rheindorf,9043,2,21,7,8,59,42,17,70
Vienna,9043,3,19,4,13,70,60,10,61
SK Sturm Gra,9043,4,17,7,12,56,40,16,58
Rapid Vienna,9043,5,14,12,10,56,39,17,54
RZ Pellets W,9043,6,12,8,16,53,60,-7,44
Admira Wacke,9043,7,13,5,18,41,63,-22,44
St. Pölten,9043,8,8,12,16,50,77,-27,36
SV Josko Rie,9043,9,8,7,21,37,59,-22,31
Mattersburg,9043,10,6,10,20,43,68,-25,28
FC Salzburg,9044,1,21,9,6,73,33,40,72
SK Sturm Gra,9044,2,19,7,10,62,43,19,64
SC Rheindorf,9044,3,18,8,10,57,45,12,62
RZ Pellets W,9044,4,16,7,13,61,54,7,55
Vienna,9044,5,15,6,15,60,56,4,51
Rapid Vienna,9044,6,13,11,12,55,44,11,50
Admira Wacke,9044,7,12,8,16,38,59,-21,44
SV Josko Rie,9044,8,12,5,19,35,50,-15,41
St. Pölten,9044,9,8,8,20,44,74,-30,32
Mattersburg,9044,10,8,7,21,35,62,-27,31
FC Salzburg,9045,1,23,5,8,67,27,40,74
SC Rheindorf,9045,2,21,5,10,54,43,11,68
Vienna,9045,3,20,5,11,64,45,19,65
SK Sturm Gra,9045,4,17,6,13,60,41,19,57
Rapid Vienna,9045,5,15,9,12,53,39,14,54
RZ Pellets W,9045,6,14,7,15,45,52,-7,49
St. Pölten,9045,7,12,9,15,46,59,-13,45
Mattersburg,9045,8,10,8,18,42,60,-18,38
Admira Wacke,9045,9,9,6,21,33,65,-32,33
SV Josko Rie,9045,10,7,4,25,28,61,-33,25
FC Salzburg,9046,1,21,9,6,68,30,38,72
SC Rheindorf,9046,2,20,6,10,48,37,11,66
Vienna,9046,3,19,7,10,68,48,20,64
SK Sturm Gra,9046,4,17,6,13,47,35,12,57
RZ Pellets W,9046,5,14,8,14,48,54,-6,50
Rapid Vienna,9046,6,13,10,13,51,37,14,49
Admira Wacke,9046,7,12,5,19,36,65,-29,41
SV Josko Rie,9046,8,11,7,18,36,52,-16,40
St. Pölten,9046,9,8,8,20,42,62,-20,32
Mattersburg,9046,10,8,8,20,35,59,-24,32
FC Salzburg,9047,1,22,7,7,72,31,41,73
SK Sturm Gra,9047,2,21,3,12,62,35,27,66
Vienna,9047,3,20,3,13,57,49,8,63
SC Rheindorf,9047,4,18,8,10,54,45,9,62
Rapid Vienna,9047,5,14,9,13,56,45,11,51
RZ Pellets W,9047,6,13,6,17,46,53,-7,45
SV Josko Rie,9047,7,12,5,19,36,51,-15,41
Mattersburg,9047,8,9,10,17,37,57,-20,37
St. Pölten,9047,9,8,10,18,42,63,-21,34
Admira Wacke,9047,10,9,7,20,34,67,-33,34
SC Rheindorf,9048,1,22,7,7,58,40,18,73
FC Salzburg,9048,2,21,7,8,73,27,46,70
SK Sturm Gra,9048,3,18,9,9,54,31,23,63
Vienna,9048,4,18,7,11,64,51,13,61
Rapid Vienna,9048,5,14,9,13,55,39,16,51
RZ Pellets W,9048,6,13,7,16,49,56,-7,46
Admira Wacke,9048,7,11,9,16,37,55,-18,42
Mattersburg,9048,8,11,7,18,40,59,-19,40
SV Josko Rie,9048,9,10,4,22,29,60,-31,34
St. Pölten,9048,10,5,8,23,30,71,-41,23
SK Sturm Gra,9049,1,19,9,8,55,31,24,66
Vienna,9049,2,19,6,11,65,50,15,63
FC Salzburg,9049,3,18,8,10,59,34,25,62
SC Rheindorf,9049,4,18,7,11,60,45,15,61
Rapid Vienna,9049,5,14,13,9,53,34,19,55
RZ Pellets W,9049,6,11,10,15,39,51,-12,43
SV Josko Rie,9049,7,12,5,19,37,57,-20,41
Admira Wacke,9049,8,10,8,18,31,57,-26,38
Mattersburg,9049,9,8,10,18,38,52,-14,34
St. Pölten,9049,10,8,10,18,38,64,-26,34
FC Salzburg,9050,1,20,9,7,64,31,33,69
SK Sturm Gra,9050,2,20,7,9,55,27,28,67
SC Rheindorf,9050,3,20,7,9,53,37,16,67
Rapid Vienna,9050,4,15,8,13,53,42,11,53
Vienna,9050,5,16,5,15,54,51,3,53
SV Josko Rie,9050,6,12,5,19,37,55,-18,41
Admira Wacke,9050,7,11,7,18,40,67,-27,40
Mattersburg,9050,8,10,9,17,40,52,-12,39
St. Pölten,9050,9,10,8,18,40,57,-17,38
RZ Pellets W,9050,10,9,9,18,42,59,-17,36
SC Rheindorf,9051,1,22,5,9,53,36,17,71
FC Salzburg,9051,2,20,6,10,62,33,29,66
Vienna,9051,3,19,5,12,69,54,15,62
SK Sturm Gra,9051,4,17,6,13,60,40,20,57
Rapid Vienna,9051,5,13,13,10,58,44,14,52
RZ Pellets W,9051,6,12,10,14,43,53,-10,46
Admira Wacke,9051,7,12,6,18,38,57,-19,42
Mattersburg,9051,8,10,7,19,38,57,-19,37
St. Pölten,9051,9,9,9,18,39,64,-25,36
SV Josko Rie,9051,10,10,5,21,32,54,-22,35
SK Sturm Gra,9052,1,21,6,9,61,32,29,69
SC Rheindorf,9052,2,20,8,8,56,42,14,68
FC Salzburg,9052,3,17,10,9,59,34,25,61
Vienna,9052,4,18,7,11,64,48,16,61
Rapid Vienna,9052,5,15,10,11,51,37,14,55
SV Josko Rie,9052,6,13,6,17,37,49,-12,45
RZ Pellets W,9052,7,10,12,14,41,50,-9,42
Admira Wacke,9052,8,9,7,20,34,63,-29,34
St. Pölten,9052,9,7,11,18,38,63,-25,32
Mattersburg,9052,10,5,13,18,36,59,-23,28
FC Salzburg,9053,1,23,8,5,74,32,42,77
SC Rheindorf,9053,2,23,6,7,65,40,25,75
SK Sturm Gra,9053,3,20,6,10,62,32,30,66
Vienna,9053,4,17,4,15,64,59,5,55
Rapid Vienna,9053,5,12,13,11,56,47,9,49
Admira Wacke,9053,6,13,5,18,39,63,-24,44
SV Josko Rie,9053,7,12,5,19,34,51,-17,41
RZ Pellets W,9053,8,10,9,17,47,56,-9,39
St. Pölten,9053,9,7,8,21,42,73,-31,29
Mattersburg,9053,10,6,10,20,36,66,-30,28
FC Salzburg,9054,1,22,9,5,68,30,38,75
SC Rheindorf,9054,2,21,5,10,58,41,17,68
Vienna,9054,3,20,6,10,65,49,16,66
SK Sturm Gra,9054,4,18,7,11,55,32,23,61
Rapid Vienna,9054,5,12,11,13,50,40,10,47
RZ Pellets W,9054,6,13,7,16,49,51,-2,46
Admira Wacke,9054,7,12,6,18,37,63,-26,42
SV Josko Rie,9054,8,11,5,20,34,52,-18,38
St. Pölten,9054,9,9,7,20,35,63,-28,34
Mattersburg,9054,10,7,7,22,37,67,-30,28
FC Salzburg,9055,1,20,10,6,63,28,35,70
SC Rheindorf,9055,2,21,7,8,61,42,19,70
Vienna,9055,3,20,5,11,65,45,20,65
SK Sturm Gra,9055,4,18,7,11,56,33,23,61
Rapid Vienna,9055,5,16,9,11,52,39,13,57
RZ Pellets W,9055,6,15,7,14,49,50,-1,52
Admira Wacke,9055,7,10,5,21,37,70,-33,35
Mattersburg,9055,8,9,6,21,41,60,-19,33
SV Josko Rie,9055,9,9,6,21,35,60,-25,33
St. Pölten,9055,10,6,10,20,37,69,-32,28
FC Salzburg,9056,1,21,7,8,65,30,35,70
SK Sturm Gra,9056,2,18,8,10,57,33,24,62
Vienna,9056,3,18,5,13,61,48,13,59
SC Rheindorf,9056,4,17,8,11,52,43,9,59
Rapid Vienna,9056,5,15,11,10,54,43,11,56
RZ Pellets W,9056,6,13,6,17,50,60,-10,45
St. Pölten,9056,7,9,12,15,48,69,-21,39
SV Josko Rie,9056,8,10,7,19,33,52,-19,37
Mattersburg,9056,9,8,12,16,45,59,-14,36
Admira Wacke,9056,10,9,8,19,36,64,-28,35
FC Salzburg,9057,1,22,7,7,67,30,37,73
SK Sturm Gra,9057,2,19,6,11,60,32,28,63
Vienna,9057,3,19,6,11,62,48,14,63
SC Rheindorf,9057,4,16,9,11,53,46,7,57
Rapid Vienna,9057,5,10,16,10,54,45,9,46
Admira Wacke,9057,6,13,7,16,36,58,-22,46
RZ Pellets W,9057,7,12,8,16,48,56,-8,44
St. Pölten,9057,8,9,10,17,41,59,-18,37
SV Josko Rie,9057,9,10,6,20,32,55,-23,36
Mattersburg,9057,10,7,11,18,36,60,-24,32
FC Salzburg,9058,1,22,6,8,65,31,34,72
SC Rheindorf,9058,2,19,7,10,56,46,10,64
Vienna,9058,3,18,8,10,62,49,13,62
SK Sturm Gra,9058,4,18,7,11,56,31,25,61
Rapid Vienna,9058,5,14,11,11,54,39,15,53
Admira Wacke,9058,6,13,5,18,40,61,-21,44
RZ Pellets W,9058,7,11,8,17,46,60,-14,41
SV Josko Rie,9058,8,12,5,19,36,54,-18,41
St. Pölten,9058,9,10,7,19,43,64,-21,37
Mattersburg,9058,10,6,10,20,31,54,-23,28
SC Rheindorf,9059,1,22,6,8,60,45,15,72
SK Sturm Gra,9059,2,20,7,9,67,39,28,67
FC Salzburg,9059,3,19,9,8,67,36,31,66
Vienna,9059,4,20,5,11,75,53,22,65
Rapid Vienna,9059,5,14,11,11,58,43,15,53
RZ Pellets W,9059,6,12,6,18,48,61,-13,42
SV Josko Rie,9059,7,11,7,18,40,56,-16,40
Admira Wacke,9059,8,10,6,20,34,61,-27,36
Mattersburg,9059,9,8,10,18,36,56,-20,34
St. Pölten,9059,10,5,11,20,43,78,-35,26
FC Salzburg,9060,1,22,7,7,73,30,43,73
Vienna,9060,2,20,6,10,69,50,19,66
SC Rheindorf,9060,3,19,7,10,56,45,11,64
SK Sturm Gra,9060,4,17,9,10,49,30,19,60
Rapid Vienna,9060,5,11,14,11,50,39,11,47
RZ Pellets W,9060,6,12,6,18,49,62,-13,42
St. Pölten,9060,7,10,12,14,38,55,-17,42
Admira Wacke,9060,8,11,7,18,39,62,-23,40
SV Josko Rie,9060,9,9,8,19,34,56,-22,35
Mattersburg,9060,10,7,8,21,34,62,-28,29
FC Salzburg,9061,1,21,8,7,60,28,32,71
Vienna,9061,2,21,5,10,64,51,13,68
SC Rheindorf,9061,3,19,8,9,57,41,16,65
SK Sturm Gra,9061,4,18,7,11,56,32,24,61
Rapid Vienna,9061,5,13,11,12,65,48,17,50
Admira Wacke,9061,6,13,7,16,42,57,-15,46
RZ Pellets W,9061,7,12,6,18,46,62,-16,42
Mattersburg,9061,8,7,13,16,38,56,-18,34
SV Josko Rie,9061,9,9,5,22,34,57,-23,32
St. Pölten,9061,10,8,8,20,46,76,-30,32
SK Sturm Gra,9062,1,22,8,6,71,30,41,74
SC Rheindorf,9062,2,21,10,5,59,32,27,73
FC Salzburg,9062,3,20,10,6,63,28,35,70
Vienna,9062,4,20,3,13,60,50,10,63
RZ Pellets W,9062,5,12,7,17,46,61,-15,43
SV Josko Rie,9062,6,12,4,20,32,55,-23,40
Admira Wacke,9062,7,12,3,21,38,62,-24,39
Rapid Vienna,9062,8,9,11,16,55,58,-3,38
Mattersburg,9062,9,8,8,20,35,55,-20,32
St. Pölten,9062,10,7,10,19,40,68,-28,31
SK Sturm Gra,9063,1,21,6,9,64,34,30,69
FC Salzburg,9063,2,21,5,10,63,35,28,68
Vienna,9063,3,19,4,13,64,51,13,61
Rapid Vienna,9063,4,16,9,11,59,40,19,57
SC Rheindorf,9063,5,16,7,13,52,51,1,55
RZ Pellets W,9063,6,12,7,17,50,56,-6,43
St. Pölten,9063,7,10,10,16,45,61,-16,40
SV Josko Rie,9063,8,11,7,18,35,52,-17,40
Admira Wacke,9063,9,11,6,19,37,64,-27,39
Mattersburg,9063,10,9,7,20,36,61,-25,34
FC Salzburg,9064,1,23,5,8,71,35,36,74
Vienna,9064,2,21,6,9,65,42,23,69
SK Sturm Gra,9064,3,19,6,11,62,37,25,63
SC Rheindorf,9064,4,17,9,10,49,40,9,60
Admira Wacke,9064,5,13,8,15,36,56,-20,47
RZ Pellets W,9064,6,13,7,16,51,53,-2,46
Rapid Vienna,9064,7,11,10,15,55,49,6,43
Mattersburg,9064,8,9,11,16,35,51,-16,38
SV Josko Rie,9064,9,9,6,21,34,61,-27,33
St. Pölten,9064,10,6,10,20,40,74,-34,28
Vienna,9065,1,22,4,10,68,54,14,70
FC Salzburg,9065,2,21,6,9,64,34,30,69
SC Rheindorf,9065,3,18,6,12,53,49,4,60
SK Sturm Gra,9065,4,18,5,13,57,37,20,59
Rapid Vienna,9065,5,16,9,11,52,35,17,57
Admira Wacke,9065,6,14,7,15,44,56,-12,49
RZ Pellets W,9065,7,13,7,16,46,54,-8,46
Mattersburg,9065,8,10,6,20,44,55,-11,36
St. Pölten,9065,9,8,8,20,42,65,-23,32
SV Josko Rie,9065,10,9,4,23,36,67,-31,31
FC Salzburg,9066,1,21,6,9,71,41,30,69
Vienna,9066,2,21,4,11,70,52,18,67
SC Rheindorf,9066,3,20,6,10,60,45,15,66
SK Sturm Gra,9066,4,18,8,10,56,38,18,62
Rapid Vienna,9066,5,14,9,13,55,43,12,51
RZ Pellets W,9066,6,14,6,16,53,54,-1,48
Admira Wacke,9066,7,13,5,18,41,66,-25,44
St. Pölten,9066,8,9,8,19,44,67,-23,35
SV Josko Rie,9066,9,9,6,21,32,56,-24,33
Mattersburg,9066,10,8,8,20,34,54,-20,32
FC Salzburg,9067,1,21,5,10,66,35,31,68
SC Rheindorf,9067,2,20,8,8,61,36,25,68
SK Sturm Gra,9067,3,18,7,11,55,41,14,61
Vienna,9067,4,16,8,12,60,54,6,56
RZ Pellets W,9067,5,14,9,13,46,49,-3,51
Rapid Vienna,9067,6,12,10,14,52,42,10,46
SV Josko Rie,9067,7,13,6,17,40,48,-8,45
St. Pölten,9067,8,10,11,15,47,61,-14,41
Admira Wacke,9067,9,11,7,18,35,59,-24,40
Mattersburg,9067,10,6,7,23,33,70,-37,25
FC Salzburg,9068,1,21,7,8,65,29,36,70
Vienna,9068,2,22,3,11,74,48,26,69
SC Rheindorf,9068,3,18,9,9,54,42,12,63
SK Sturm Gra,9068,4,19,5,12,59,38,21,62
Admira Wacke,9068,5,16,3,17,46,57,-11,51
Rapid Vienna,9068,6,13,10,13,52,44,8,49
RZ Pellets W,9068,7,12,6,18,43,57,-14,42
Mattersburg,9068,8,10,9,17,38,56,-18,39
St. Pölten,9068,9,9,8,19,38,64,-26,35
SV Josko Rie,9068,10,8,4,24,28,62,-34,28
FC Salzburg,9069,1,21,9,6,68,32,36,72
SC Rheindorf,9069,2,19,8,9,53,40,13,65
SK Sturm Gra,9069,3,17,7,12,56,42,14,58
Vienna,9069,4,17,6,13,61,53,8,57
Rapid Vienna,9069,5,14,12,10,55,35,20,54
RZ Pellets W,9069,6,14,5,17,44,58,-14,47
Admira Wacke,9069,7,12,5,19,38,61,-23,41
SV Josko Rie,9069,8,11,7,18,34,45,-11,40
Mattersburg,9069,9,10,8,18,44,60,-16,38
St. Pölten,9069,10,5,13,18,33,60,-27,28
SC Rheindorf,9070,1,24,7,5,66,37,29,79
FC Salzburg,9070,2,20,9,7,66,28,38,69
Vienna,9070,3,20,2,14,60,52,8,62
SK Sturm Gra,9070,4,16,7,13,56,42,14,55
Rapid Vienna,9070,5,14,11,11,56,39,17,53
SV Josko Rie,9070,6,13,5,18,45,60,-15,44
Admira Wacke,9070,7,12,6,18,46,65,-19,42
RZ Pellets W,9070,8,10,7,19,43,60,-17,37
St. Pölten,9070,9,9,9,18,49,72,-23,36
Mattersburg,9070,10,5,11,20,37,69,-32,26
SK Sturm Gra,9071,1,19,7,10,56,33,23,64
FC Salzburg,9071,2,19,7,10,56,35,21,64
SC Rheindorf,9071,3,18,8,10,55,43,12,62
Vienna,9071,4,19,3,14,66,54,12,60
Rapid Vienna,9071,5,15,12,9,60,36,24,57
RZ Pellets W,9071,6,12,9,15,45,58,-13,45
Admira Wacke,9071,7,11,9,16,42,53,-11,42
St. Pölten,9071,8,11,9,16,45,64,-19,42
SV Josko Rie,9071,9,11,5,20,33,56,-23,38
Mattersburg,9071,10,6,9,21,36,62,-26,27
FC Salzburg,9072,1,21,7,8,64,30,34,70
SC Rheindorf,9072,2,21,7,8,62,37,25,70
SK Sturm Gra,9072,3,20,7,9,61,34,27,67
Vienna,9072,4,15,6,15,59,57,2,51
Rapid Vienna,9072,5,12,11,13,48,43,5,47
RZ Pellets W,9072,6,11,11,14,42,50,-8,44
Mattersburg,9072,7,11,10,15,44,53,-9,43
Admira Wacke,9072,8,11,7,18,35,65,-30,40
SV Josko Rie,9072,9,10,6,20,42,61,-19,36
St. Pölten,9072,10,8,8,20,40,67,-27,32
FC Salzburg,9073,1,22,7,7,68,30,38,73
SK Sturm Gra,9073,2,20,6,10,63,38,25,66
SC Rheindorf,9073,3,20,6,10,57,42,15,66
Vienna,9073,4,18,4,14,63,56,7,58
Rapid Vienna,9073,5,15,8,13,53,40,13,53
St. Pölten,9073,6,11,9,16,46,62,-16,42
Admira Wacke,9073,7,12,6,18,34,58,-24,42
RZ Pellets W,9073,8,11,6,19,48,60,-12,39
SV Josko Rie,9073,9,9,8,19,37,56,-19,35
Mattersburg,9073,10,8,8,20,35,62,-27,32
FC Salzburg,9074,1,24,6,6,61,24,37,78
SC Rheindorf,9074,2,19,9,8,49,40,9,66
SK Sturm Gra,9074,3,18,8,10,56,37,19,62
Vienna,9074,4,19,3,14,60,54,6,60
RZ Pellets W,9074,5,14,10,12,58,49,9,52
Rapid Vienna,9074,6,10,13,13,59,45,14,43
SV Josko Rie,9074,7,11,5,20,37,56,-19,38
St. Pölten,9074,8,9,9,18,47,69,-22,36
Admira Wacke,9074,9,10,6,20,33,60,-27,36
Mattersburg,9074,10,6,11,19,35,61,-26,29
FC Salzburg,9075,1,20,8,8,66,37,29,68
SC Rheindorf,9075,2,19,10,7,54,38,16,67
Vienna,9075,3,20,6,10,67,50,17,66
SK Sturm Gra,9075,4,19,7,10,58,35,23,64
Rapid Vienna,9075,5,14,10,12,53,38,15,52
RZ Pellets W,9075,6,14,7,15,47,55,-8,49
Admira Wacke,9075,7,11,6,19,37,54,-17,39
Mattersburg,9075,8,8,10,18,37,55,-18,34
SV Josko Rie,9075,9,9,6,21,30,52,-22,33
St. Pölten,9075,10,6,10,20,34,69,-35,28
FC Salzburg,9076,1,22,6,8,66,29,37,72
SC Rheindorf,9076,2,21,6,9,60,46,14,69
SK Sturm Gra,9076,3,18,6,12,58,43,15,60
Rapid Vienna,9076,4,16,11,9,61,42,19,59
Vienna,9076,5,17,7,12,62,51,11,58
RZ Pellets W,9076,6,15,6,15,49,53,-4,51
Admira Wacke,9076,7,11,8,17,35,58,-23,41
SV Josko Rie,9076,8,11,5,20,31,53,-22,38
Mattersburg,9076,9,8,7,21,41,59,-18,31
St. Pölten,9076,10,6,8,22,36,65,-29,26
Vienna,9077,1,20,7,9,62,46,16,67
FC Salzburg,9077,2,19,9,8,61,27,34,66
SC Rheindorf,9077,3,18,11,7,49,36,13,65
Rapid Vienna,9077,4,14,11,11,56,38,18,53
SK Sturm Gra,9077,5,14,10,12,46,33,13,52
RZ Pellets W,9077,6,12,10,14,52,60,-8,46
Admira Wacke,9077,7,10,11,15,34,53,-19,41
SV Josko Rie,9077,8,10,7,19,32,53,-21,37
Mattersburg,9077,9,9,8,19,41,63,-22,35
St. Pölten,9077,10,8,8,20,43,67,-24,32
SC Rheindorf,9078,1,23,5,8,63,43,20,74
FC Salzburg,9078,2,22,5,9,74,36,38,71
SK Sturm Gra,9078,3,18,7,11,63,35,28,61
Vienna,9078,4,17,5,14,60,55,5,56
RZ Pellets W,9078,5,14,5,17,46,55,-9,47
Rapid Vienna,9078,6,12,10,14,49,43,6,46
Mattersburg,9078,7,12,8,16,43,60,-17,44
Admira Wacke,9078,8,10,8,18,31,57,-26,38
SV Josko Rie,9078,9,10,7,19,34,52,-18,37
St. Pölten,9078,10,7,10,19,37,64,-27,31
FC Salzburg,9079,1,21,8,7,61,29,32,71
Vienna,9079,2,19,5,12,63,47,16,62
SK Sturm Gra,9079,3,17,8,11,56,34,22,59
Rapid Vienna,9079,4,16,10,10,58,37,21,58
SC Rheindorf,9079,5,16,10,10,52,45,7,58
Admira Wacke,9079,6,14,7,15,38,53,-15,49
SV Josko Rie,9079,7,12,4,20,40,57,-17,40
Mattersburg,9079,8,11,6,19,41,59,-18,39
RZ Pellets W,9079,9,9,11,16,41,58,-17,38
St. Pölten,9079,10,5,11,20,30,61,-31,26
SK Sturm Gra,9080,1,19,7,10,60,40,20,64
FC Salzburg,9080,2,18,9,9,60,34,26,63
Vienna,9080,3,19,4,13,63,51,12,61
SC Rheindorf,9080,4,15,11,10,56,51,5,56
Rapid Vienna,9080,5,13,11,12,54,44,10,50
RZ Pellets W,9080,6,12,9,15,49,59,-10,45
St. Pölten,9080,7,9,13,14,44,58,-14,40
Admira Wacke,9080,8,10,10,16,43,59,-16,40
Mattersburg,9080,9,10,9,17,37,48,-11,39
SV Josko Rie,9080,10,10,7,19,34,56,-22,37
FC Salzburg,9081,1,23,5,8,69,30,39,74
SK Sturm Gra,9081,2,19,7,10,63,40,23,64
Vienna,9081,3,19,4,13,58,48,10,61
Rapid Vienna,9081,4,16,11,9,54,39,15,59
SC Rheindorf,9081,5,17,7,12,54,47,7,58
RZ Pellets W,9081,6,12,9,15,46,52,-6,45
SV Josko Rie,9081,7,11,8,17,36,47,-11,41
St. Pölten,9081,8,8,12,16,46,69,-23,36
Admira Wacke,9081,9,10,6,20,33,63,-30,36
Mattersburg,9081,10,7,7,22,40,64,-24,28
Vienna,9082,1,22,3,11,63,48,15,69
SC Rheindorf,9082,2,20,7,9,62,46,16,67
FC Salzburg,9082,3,19,8,9,64,30,34,65
SK Sturm Gra,9082,4,19,5,12,58,36,22,62
Rapid Vienna,9082,5,14,10,12,59,51,8,52
RZ Pellets W,9082,6,14,6,16,47,54,-7,48
SV Josko Rie,9082,7,13,5,18,34,49,-15,44
St. Pölten,9082,8,9,9,18,44,65,-21,36
Admira Wacke,9082,9,10,6,20,33,64,-31,36
Mattersburg,9082,10,7,7,22,37,58,-21,28
FC Salzburg,9083,1,23,4,9,67,30,37,73
SC Rheindorf,9083,2,20,6,10,57,42,15,66
SK Sturm Gra,9083,3,19,8,9,54,27,27,65
Vienna,9083,4,19,7,10,61,46,15,64
Rapid Vienna,9083,5,14,9,13,55,43,12,51
RZ Pellets W,9083,6,15,6,15,54,58,-4,51
SV Josko Rie,9083,7,12,5,19,42,59,-17,41
Admira Wacke,9083,8,10,8,18,38,66,-28,38
Mattersburg,9083,9,8,5,23,36,65,-29,29
St. Pölten,9083,10,6,10,20,37,65,-28,28
FC Salzburg,9084,1,21,9,6,57,23,34,72
SC Rheindorf,9084,2,17,13,6,54,40,14,64
SK Sturm Gra,9084,3,19,5,12,62,38,24,62
Vienna,9084,4,16,6,14,63,57,6,54
Rapid Vienna,9084,5,14,10,12,51,37,14,52
RZ Pellets W,9084,6,14,7,15,50,58,-8,49
Admira Wacke,9084,7,12,7,17,42,62,-20,43
Mattersburg,9084,8,10,8,18,38,50,-12,38
SV Josko Rie,9084,9,8,11,17,34,52,-18,35
St. Pölten,9084,10,6,10,20,31,65,-34,28
FC Salzburg,9085,1,18,11,7,62,31,31,65
SK Sturm Gra,9085,2,20,5,11,56,31,25,65
SC Rheindorf,9085,3,18,10,8,54,41,13,64
Vienna,9085,4,17,8,11,56,54,2,59
Rapid Vienna,9085,5,14,10,12,56,40,16,52
St. Pölten,9085,6,11,9,16,45,60,-15,42
Mattersburg,9085,7,11,8,17,45,58,-13,41
RZ Pellets W,9085,8,10,10,16,47,55,-8,40
SV Josko Rie,9085,9,10,5,21,35,56,-21,35
Admira Wacke,9085,10,8,10,18,32,62,-30,34
FC Salzburg,9086,1,22,8,6,64,28,36,74
SK Sturm Gra,9086,2,20,8,8,66,38,28,68
SC Rheindorf,9086,3,17,9,10,54,47,7,60
Vienna,9086,4,17,8,11,63,53,10,59
Rapid Vienna,9086,5,13,12,11,54,39,15,51
RZ Pellets W,9086,6,13,6,17,48,56,-8,45
SV Josko Rie,9086,7,12,6,18,39,54,-15,42
Admira Wacke,9086,8,11,9,16,42,59,-17,42
Mattersburg,9086,9,8,8,20,40,61,-21,32
St. Pölten,9086,10,6,8,22,37,72,-35,26
FC Salzburg,9087,1,24,7,5,73,28,45,79
SK Sturm Gra,9087,2,18,8,10,62,40,22,62
Vienna,9087,3,20,2,14,69,54,15,62
SC Rheindorf,9087,4,18,7,11,54,54,0,61
RZ Pellets W,9087,5,16,6,14,56,58,-2,54
Rapid Vienna,9087,6,14,10,12,61,48,13,52
Mattersburg,9087,7,10,8,18,41,57,-16,38
St. Pölten,9087,8,9,9,18,43,63,-20,36
Admira Wacke,9087,9,10,3,23,34,66,-32,33
SV Josko Rie,9087,10,9,4,23,35,60,-25,31
FC Salzburg,9088,1,25,6,5,71,27,44,81
SC Rheindorf,9088,2,20,8,8,51,38,13,68
Vienna,9088,3,21,4,11,59,43,16,67
SK Sturm Gra,9088,4,18,8,10,56,32,24,62
Rapid Vienna,9088,5,12,11,13,51,41,10,47
RZ Pellets W,9088,6,12,5,19,49,61,-12,41
St. Pölten,9088,7,10,8,18,42,63,-21,38
Admira Wacke,9088,8,10,7,19,29,54,-25,37
Mattersburg,9088,9,8,9,19,42,63,-21,33
SV Josko Rie,9088,10,8,6,22,30,58,-28,30
SK Sturm Gra,9089,1,22,5,9,64,33,31,71
FC Salzburg,9089,2,19,9,8,62,29,33,66
SC Rheindorf,9089,3,18,8,10,54,46,8,62
Vienna,9089,4,18,4,14,54,49,5,58
Rapid Vienna,9089,5,15,9,12,56,42,14,54
Admira Wacke,9089,6,14,5,17,40,58,-18,47
RZ Pellets W,9089,7,13,7,16,49,55,-6,46
St. Pölten,9089,8,10,9,17,40,62,-22,39
SV Josko Rie,9089,9,10,7,19,39,57,-18,37
Mattersburg,9089,10,5,9,22,28,55,-27,24
SK Sturm Gra,9090,1,21,5,10,69,39,30,68
FC Salzburg,9090,2,19,9,8,63,33,30,66
SC Rheindorf,9090,3,19,9,8,55,44,11,66
Rapid Vienna,9090,4,17,9,10,68,45,23,60
Vienna,9090,5,16,5,15,55,54,1,53
RZ Pellets W,9090,6,14,9,13,45,44,1,51
SV Josko Rie,9090,7,11,3,22,39,59,-20,36
Admira Wacke,9090,8,10,6,20,34,66,-32,36
Mattersburg,9090,9,8,11,17,42,59,-17,35
St. Pölten,9090,10,8,8,20,46,73,-27,32
FC Salzburg,9091,1,22,6,8,63,31,32,72
SC Rheindorf,9091,2,21,7,8,56,40,16,70
SK Sturm Gra,9091,3,20,5,11,62,39,23,65
Vienna,9091,4,19,4,13,67,53,14,61
Rapid Vienna,9091,5,13,11,12,60,44,16,50
RZ Pellets W,9091,6,12,6,18,48,62,-14,42
Mattersburg,9091,7,11,7,18,40,56,-16,40
Admira Wacke,9091,8,11,5,20,42,66,-24,38
St. Pölten,9091,9,9,9,18,47,71,-24,36
SV Josko Rie,9091,10,9,6,21,37,60,-23,33
FC Salzburg,9092,1,22,8,6,70,27,43,74
SK Sturm Gra,9092,2,18,8,10,59,35,24,62
SC Rheindorf,9092,3,18,8,10,53,45,8,62
Rapid Vienna,9092,4,16,12,8,62,34,28,60
Vienna,9092,5,17,7,12,57,50,7,58
SV Josko Rie,9092,6,12,4,20,34,50,-16,40
St. Pölten,9092,7,10,8,18,40,60,-20,38
RZ Pellets W,9092,8,10,8,18,42,63,-21,38
Admira Wacke,9092,9,9,8,19,35,62,-27,35
Mattersburg,9092,10,8,9,19,34,60,-26,33
FC Salzburg,9093,1,23,5,8,72,27,45,74
Vienna,9093,2,19,5,12,62,48,14,62
SC Rheindorf,9093,3,18,8,10,48,37,11,62
SK Sturm Gra,9093,4,18,4,14,53,40,13,58
Rapid Vienna,9093,5,13,12,11,48,37,11,51
SV Josko Rie,9093,6,12,6,18,38,56,-18,42
RZ Pellets W,9093,7,10,11,15,41,54,-13,41
Admira Wacke,9093,8,11,7,18,40,63,-23,40
St. Pölten,9093,9,8,12,16,41,59,-18,36
Mattersburg,9093,10,9,8,19,35,57,-22,35
FC Salzburg,9094,1,23,6,7,70,32,38,75
SK Sturm Gra,9094,2,20,7,9,62,38,24,67
Vienna,9094,3,20,4,12,68,50,18,64
SC Rheindorf,9094,4,16,9,11,50,47,3,57
RZ Pellets W,9094,5,13,5,18,44,59,-15,44
Mattersburg,9094,6,12,8,16,41,56,-15,44
Rapid Vienna,9094,7,9,13,14,49,41,8,40
SV Josko Rie,9094,8,11,7,18,37,47,-10,40
St. Pölten,9094,9,9,9,18,42,63,-21,36
Admira Wacke,9094,10,9,8,19,32,62,-30,35
FC Salzburg,9095,1,21,9,6,67,31,36,72
SK Sturm Gra,9095,2,21,5,10,58,33,25,68
SC Rheindorf,9095,3,18,7,11,54,43,11,61
Vienna,9095,4,17,8,11,57,49,8,59
Rapid Vienna,9095,5,16,10,10,61,43,18,58
RZ Pellets W,9095,6,12,10,14,45,49,-4,46
Mattersburg,9095,7,10,7,19,35,57,-22,37
St. Pölten,9095,8,8,10,18,43,67,-24,34
Admira Wacke,9095,9,9,7,20,31,59,-28,34
SV Josko Rie,9095,10,9,5,22,34,54,-20,32
SC Rheindorf,9096,1,19,9,8,63,43,20,66
FC Salzburg,9096,2,18,10,8,65,34,31,64
Vienna,9096,3,19,4,13,61,50,11,61
Rapid Vienna,9096,4,16,9,11,61,38,23,57
SK Sturm Gra,9096,5,16,8,12,51,37,14,56
RZ Pellets W,9096,6,14,6,16,46,55,-9,48
St. Pölten,9096,7,10,9,17,43,59,-16,39
Admira Wacke,9096,8,11,6,19,40,73,-33,39
SV Josko Rie,9096,9,9,9,18,32,50,-18,36
Mattersburg,9096,10,8,10,18,41,64,-23,34
FC Salzburg,9097,1,22,7,7,74,31,43,73
Vienna,9097,2,21,3,12,62,47,15,66
SK Sturm Gra,9097,3,19,7,10,57,34,23,64
SC Rheindorf,9097,4,18,8,10,54,43,11,62
Rapid Vienna,9097,5,12,10,14,65,57,8,46
RZ Pellets W,9097,6,12,8,16,48,57,-9,44
Mattersburg,9097,7,10,10,16,39,52,-13,40
Admira Wacke,9097,8,11,6,19,39,61,-22,39
SV Josko Rie,9097,9,11,3,22,32,55,-23,36
St. Pölten,9097,10,9,8,19,38,71,-33,35
FC Salzburg,9098,1,22,10,4,68,25,43,76
Vienna,9098,2,19,8,9,63,45,18,65
SK Sturm Gra,9098,3,19,7,10,53,34,19,64
SC Rheindorf,9098,4,18,5,13,52,49,3,59
Rapid Vienna,9098,5,11,12,13,50,40,10,45
Admira Wacke,9098,6,12,7,17,39,59,-20,43
RZ Pellets W,9098,7,10,11,15,42,55,-13,41
St. Pölten,9098,8,10,8,18,46,60,-14,38
Mattersburg,9098,9,9,9,18,38,55,-17,36
SV Josko Rie,9098,10,8,7,21,31,60,-29,31
FC Salzburg,9099,1,23,5,8,69,28,41,74
SC Rheindorf,9099,2,20,10,6,58,37,21,70
Vienna,9099,3,19,5,12,65,51,14,62
SK Sturm Gra,9099,4,18,7,11,51,30,21,61
Rapid Vienna,9099,5,11,14,11,55,44,11,47
RZ Pellets W,9099,6,11,8,17,45,60,-15,41
SV Josko Rie,9099,7,12,5,19,39,60,-21,41
Mattersburg,9099,8,10,9,17,44,58,-14,39
Admira Wacke,9099,9,7,11,18,33,62,-29,32
St. Pölten,9099,10,7,10,19,40,69,-29,31
FC Salzburg,9100,1,22,6,8,71,31,40,72
SK Sturm Gra,9100,2,20,8,8,54,25,29,68
SC Rheindorf,9100,3,18,7,11,49,44,5,61
Vienna,9100,4,18,6,12,61,54,7,60
Rapid Vienna,9100,5,14,12,10,54,39,15,54
SV Josko Rie,9100,6,12,5,19,32,50,-18,41
St. Pölten,9100,7,10,10,16,44,57,-13,40
RZ Pellets W,9100,8,10,9,17,43,57,-14,39
Admira Wacke,9100,9,9,7,20,29,56,-27,34
Mattersburg,9100,10,7,10,19,31,55,-24,31
FC Salzburg,9101,1,23,7,6,69,26,43,76
Vienna,9101,2,21,4,11,60,46,14,67
SC Rheindorf,9101,3,20,6,10,56,48,8,66
SK Sturm Gra,9101,4,15,11,10,55,37,18,56
Rapid Vienna,9101,5,15,8,13,56,42,14,53
RZ Pellets W,9101,6,13,7,16,49,58,-9,46
SV Josko Rie,9101,7,11,6,19,36,51,-15,39
St. Pölten,9101,8,9,11,16,44,64,-20,38
Mattersburg,9101,9,7,10,19,36,55,-19,31
Admira Wacke,9101,10,8,6,22,31,65,-34,30
Vienna,9102,1,22,4,10,68,49,19,70
SC Rheindorf,9102,2,21,6,9,61,42,19,69
FC Salzburg,9102,3,19,8,9,66,39,27,65
SK Sturm Gra,9102,4,20,4,12,57,33,24,64
Rapid Vienna,9102,5,14,10,12,53,41,12,52
RZ Pellets W,9102,6,13,6,17,44,59,-15,45
SV Josko Rie,9102,7,12,4,20,40,53,-13,40
St. Pölten,9102,8,11,7,18,42,67,-25,40
Mattersburg,9102,9,9,6,21,45,60,-15,33
Admira Wacke,9102,10,9,5,22,34,67,-33,32
SK Sturm Gra,9103,1,23,6,7,71,34,37,75
FC Salzburg,9103,2,22,8,6,64,29,35,74
SC Rheindorf,9103,3,18,8,10,58,49,9,62
Vienna,9103,4,18,5,13,63,52,11,59
Rapid Vienna,9103,5,15,10,11,59,42,17,55
RZ Pellets W,9103,6,10,8,18,43,56,-13,38
St. Pölten,9103,7,9,10,17,54,69,-15,37
Mattersburg,9103,8,9,8,19,39,58,-19,35
SV Josko Rie,9103,9,9,7,20,29,55,-26,34
Admira Wacke,9103,10,9,6,21,34,70,-36,33
FC Salzburg,9104,1,20,10,6,67,33,34,70
Vienna,9104,2,21,7,8,68,47,21,70
SC Rheindorf,9104,3,21,6,9,55,39,16,69
SK Sturm Gra,9104,4,17,8,11,53,30,23,59
Rapid Vienna,9104,5,13,12,11,57,44,13,51
RZ Pellets W,9104,6,11,8,17,39,57,-18,41
Admira Wacke,9104,7,12,4,20,38,60,-22,40
SV Josko Rie,9104,8,11,4,21,35,62,-27,37
Mattersburg,9104,9,9,8,19,44,61,-17,35
St. Pölten,9104,10,6,11,19,41,64,-23,29
Vienna,9105,1,23,4,9,69,46,23,73
FC Salzburg,9105,2,18,9,9,57,30,27,63
SC Rheindorf,9105,3,19,6,11,58,45,13,63
SK Sturm Gra,9105,4,18,7,11,57,37,20,61
Rapid Vienna,9105,5,13,12,11,56,36,20,51
Admira Wacke,9105,6,14,9,13,41,51,-10,51
RZ Pellets W,9105,7,11,10,15,41,51,-10,43
SV Josko Rie,9105,8,10,5,21,34,58,-24,35
St. Pölten,9105,9,8,9,19,33,63,-30,33
Mattersburg,9105,10,5,11,20,35,64,-29,26
SC Rheindorf,9106,1,20,10,6,57,32,25,70
FC Salzburg,9106,2,19,9,8,62,30,32,66
Vienna,9106,3,17,8,11,56,51,5,59
SK Sturm Gra,9106,4,17,7,12,50,32,18,58
Rapid Vienna,9106,5,13,11,12,52,41,11,50
Admira Wacke,9106,6,13,8,15,42,55,-13,47
RZ Pellets W,9106,7,13,6,17,43,54,-11,45
St. Pölten,9106,8,9,10,17,40,67,-27,37
SV Josko Rie,9106,9,10,5,21,37,56,-19,35
Mattersburg,9106,10,9,6,21,37,58,-21,33
SC Rheindorf,9107,1,20,9,7,56,42,14,69
SK Sturm Gra,9107,2,20,7,9,62,31,31,67
FC Salzburg,9107,3,18,8,10,66,38,28,62
Vienna,9107,4,17,8,11,64,50,14,59
Rapid Vienna,9107,5,12,13,11,54,45,9,49
Admira Wacke,9107,6,12,10,14,40,56,-16,46
St. Pölten,9107,7,10,10,16,41,59,-18,40
SV Josko Rie,9107,8,10,8,18,35,50,-15,38
RZ Pellets W,9107,9,9,9,18,41,60,-19,36
Mattersburg,9107,10,7,8,21,30,58,-28,29
SC Rheindorf,9108,1,21,9,6,58,39,19,72
FC Salzburg,9108,2,17,13,6,60,37,23,64
Vienna,9108,3,19,6,11,63,55,8,63
SK Sturm Gra,9108,4,17,7,12,62,42,20,58
Rapid Vienna,9108,5,15,10,11,56,39,17,55
Admira Wacke,9108,6,12,5,19,42,61,-19,41
Mattersburg,9108,7,10,10,16,42,52,-10,40
SV Josko Rie,9108,8,12,4,20,39,53,-14,40
St. Pölten,9108,9,8,11,17,42,60,-18,35
RZ Pellets W,9108,10,8,7,21,35,61,-26,31
SC Rheindorf,9109,1,23,5,8,60,36,24,74
FC Salzburg,9109,2,19,9,8,57,30,27,66
Vienna,9109,3,19,7,10,59,46,13,64
SK Sturm Gra,9109,4,17,8,11,58,37,21,59
Rapid Vienna,9109,5,15,9,12,50,40,10,54
Admira Wacke,9109,6,13,5,18,42,58,-16,44
RZ Pellets W,9109,7,11,8,17,44,59,-15,41
SV Josko Rie,9109,8,12,4,20,36,48,-12,40
Mattersburg,9109,9,10,6,20,38,59,-21,36
St. Pölten,9109,10,6,9,21,31,62,-31,27
FC Salzburg,9110,1,24,6,6,72,24,48,78
Vienna,9110,2,20,7,9,76,55,21,67
SC Rheindorf,9110,3,20,5,11,57,44,13,65
SK Sturm Gra,9110,4,18,5,13,53,40,13,59
RZ Pellets W,9110,5,16,6,14,46,51,-5,54
Rapid Vienna,9110,6,14,9,13,53,40,13,51
SV Josko Rie,9110,7,12,5,19,38,59,-21,41
Mattersburg,9110,8,9,6,21,31,53,-22,33
Admira Wacke,9110,9,9,5,22,32,66,-34,32
St. Pölten,9110,10,7,8,21,39,65,-26,29
FC Salzburg,9111,1,24,5,7,75,28,47,77
SK Sturm Gra,9111,2,21,6,9,61,35,26,69
SC Rheindorf,9111,3,19,8,9,55,41,14,65
Vienna,9111,4,18,6,12,63,54,9,60
Rapid Vienna,9111,5,14,9,13,56,42,14,51
Admira Wacke,9111,6,13,8,15,40,55,-15,47
RZ Pellets W,9111,7,11,8,17,37,52,-15,41
Mattersburg,9111,8,9,7,20,30,60,-30,34
SV Josko Rie,9111,9,9,5,22,32,51,-19,32
St. Pölten,9111,10,7,8,21,38,69,-31,29
SK Sturm Gra,9112,1,21,5,10,67,36,31,68
SC Rheindorf,9112,2,20,8,8,57,36,21,68
FC Salzburg,9112,3,19,8,9,66,35,31,65
Vienna,9112,4,17,5,14,56,48,8,56
Admira Wacke,9112,5,16,4,16,45,57,-12,52
Rapid Vienna,9112,6,12,11,13,49,49,0,47
RZ Pellets W,9112,7,13,5,18,48,62,-14,44
Mattersburg,9112,8,11,8,17,40,51,-11,41
SV Josko Rie,9112,9,9,6,21,30,55,-25,33
St. Pölten,9112,10,7,10,19,37,66,-29,31
FC Salzburg,9113,1,22,6,8,67,26,41,72
SC Rheindorf,9113,2,20,10,6,56,37,19,70
Vienna,9113,3,20,5,11,60,48,12,65
SK Sturm Gra,9113,4,16,6,14,50,38,12,54
RZ Pellets W,9113,5,12,8,16,49,59,-10,44
St. Pölten,9113,6,11,10,15,45,57,-12,43
Admira Wacke,9113,7,11,9,16,36,54,-18,42
Rapid Vienna,9113,8,10,10,16,48,49,-1,40
SV Josko Rie,9113,9,10,6,20,35,53,-18,36
Mattersburg,9113,10,9,8,19,35,60,-25,35
Vienna,9114,1,21,4,11,64,52,12,67
SK Sturm Gra,9114,2,19,8,9,72,41,31,65
FC Salzburg,9114,3,19,7,10,67,34,33,64
SC Rheindorf,9114,4,19,7,10,61,43,18,64
Rapid Vienna,9114,5,15,12,9,60,37,23,57
RZ Pellets W,9114,6,13,9,14,51,50,1,48
Mattersburg,9114,7,11,8,17,41,59,-18,41
Admira Wacke,9114,8,9,8,19,41,74,-33,35
SV Josko Rie,9114,9,8,6,22,28,64,-36,30
St. Pölten,9114,10,6,11,19,41,72,-31,29
FC Salzburg,9115,1,23,5,8,71,30,41,74
SC Rheindorf,9115,2,20,6,10,61,45,16,66
SK Sturm Gra,9115,3,19,7,10,52,32,20,64
Vienna,9115,4,18,6,12,62,55,7,60
Rapid Vienna,9115,5,14,9,13,58,44,14,51
RZ Pellets W,9115,6,15,5,16,47,50,-3,50
Admira Wacke,9115,7,10,8,18,36,62,-26,38
Mattersburg,9115,8,9,9,18,38,54,-16,36
SV Josko Rie,9115,9,10,4,22,31,56,-25,34
St. Pölten,9115,10,9,7,20,43,71,-28,34
FC Salzburg,9116,1,20,7,9,62,33,29,67
SC Rheindorf,9116,2,18,10,8,57,40,17,64
SK Sturm Gra,9116,3,17,12,7,54,29,25,63
Vienna,9116,4,19,5,12,60,54,6,62
Rapid Vienna,9116,5,13,14,9,59,40,19,53
RZ Pellets W,9116,6,12,8,16,51,60,-9,44
SV Josko Rie,9116,7,11,8,17,40,54,-14,41
Admira Wacke,9116,8,11,7,18,36,57,-21,40
Mattersburg,9116,9,7,12,17,37,52,-15,33
St. Pölten,9116,10,5,11,20,34,71,-37,26
FC Salzburg,9117,1,21,8,7,60,28,32,71
SC Rheindorf,9117,2,19,9,8,54,41,13,66
SK Sturm Gra,9117,3,19,8,9,60,32,28,65
Vienna,9117,4,17,6,13,61,53,8,57
Rapid Vienna,9117,5,14,13,9,55,36,19,55
RZ Pellets W,9117,6,12,8,16,40,53,-13,44
SV Josko Rie,9117,7,13,2,21,37,53,-16,41
Admira Wacke,9117,8,11,6,19,33,59,-26,39
Mattersburg,9117,9,8,8,20,29,48,-19,32
St. Pölten,9117,10,7,10,19,38,64,-26,31
SK Sturm Gra,9118,1,20,6,10,57,31,26,66
FC Salzburg,9118,2,18,11,7,61,33,28,65
SC Rheindorf,9118,3,19,7,10,53,35,18,64
Rapid Vienna,9118,4,16,11,9,48,35,13,59
Vienna,9118,5,16,9,11,54,42,12,57
Admira Wacke,9118,6,11,10,15,39,51,-12,43
SV Josko Rie,9118,7,12,5,19,38,57,-19,41
RZ Pellets W,9118,8,9,9,18,36,54,-18,36
St. Pölten,9118,9,8,9,19,41,62,-21,33
Mattersburg,9118,10,8,9,19,32,59,-27,33
FC Salzburg,9119,1,22,7,7,81,39,42,73
SC Rheindorf,9119,2,19,9,8,60,41,19,66
SK Sturm Gra,9119,3,18,5,13,53,37,16,59
Vienna,9119,4,18,4,14,57,60,-3,58
Rapid Vienna,9119,5,15,10,11,60,41,19,55
RZ Pellets W,9119,6,12,8,16,42,55,-13,44
Admira Wacke,9119,7,11,8,17,38,59,-21,41
Mattersburg,9119,8,11,6,19,42,57,-15,39
St. Pölten,9119,9,8,11,17,41,60,-19,35
SV Josko Rie,9119,10,9,6,21,30,55,-25,33
Vienna,9120,1,23,5,8,77,41,36,74
FC Salzburg,9120,2,22,6,8,65,30,35,72
SC Rheindorf,9120,3,18,6,12,53,47,6,60
SK Sturm Gra,9120,4,16,9,11,58,36,22,57
Rapid Vienna,9120,5,12,11,13,50,41,9,47
RZ Pellets W,9120,6,12,9,15,47,56,-9,45
Mattersburg,9120,7,10,9,17,40,55,-15,39
SV Josko Rie,9120,8,11,4,21,36,63,-27,37
St. Pölten,9120,9,9,9,18,42,67,-25,36
Admira Wacke,9120,10,9,8,19,37,69,-32,35
FC Salzburg,9121,1,23,7,6,68,23,45,76
SK Sturm Gra,9121,2,22,5,9,59,31,28,71
SC Rheindorf,9121,3,18,10,8,48,37,11,64
Vienna,9121,4,18,6,12,61,50,11,60
Rapid Vienna,9121,5,14,11,11,53,38,15,53
RZ Pellets W,9121,6,10,9,17,43,58,-15,39
SV Josko Rie,9121,7,11,6,19,32,50,-18,39
St. Pölten,9121,8,9,8,19,42,65,-23,35
Admira Wacke,9121,9,9,7,20,34,62,-28,34
Mattersburg,9121,10,7,9,20,31,57,-26,30
FC Salzburg,9122,1,22,6,8,71,32,39,72
Vienna,9122,2,21,4,11,65,46,19,67
SK Sturm Gra,9122,3,21,3,12,58,34,24,66
SC Rheindorf,9122,4,20,6,10,51,35,16,66
St. Pölten,9122,5,13,9,14,40,57,-17,48
Rapid Vienna,9122,6,11,12,13,48,45,3,45
Admira Wacke,9122,7,12,4,20,37,60,-23,40
RZ Pellets W,9122,8,10,7,19,37,56,-19,37
Mattersburg,9122,9,8,11,17,41,57,-16,35
SV Josko Rie,9122,10,9,4,23,37,63,-26,31
FC Salzburg,9123,1,23,6,7,74,32,42,75
SC Rheindorf,9123,2,21,7,8,60,42,18,70
Vienna,9123,3,20,4,12,61,50,11,64
SK Sturm Gra,9123,4,19,6,11,52,33,19,63
RZ Pellets W,9123,5,13,7,16,43,51,-8,46
Rapid Vienna,9123,6,10,13,13,49,41,8,43
SV Josko Rie,9123,7,11,5,20,36,59,-23,38
Mattersburg,9123,8,10,7,19,42,60,-18,37
Admira Wacke,9123,9,10,7,19,36,54,-18,37
St. Pölten,9123,10,7,10,19,39,70,-31,31
FC Salzburg,9124,1,22,7,7,70,33,37,73
SC Rheindorf,9124,2,20,8,8,64,47,17,68
Vienna,9124,3,20,7,9,69,52,17,67
SK Sturm Gra,9124,4,20,6,10,62,33,29,66
Rapid Vienna,9124,5,15,12,9,65,42,23,57
SV Josko Rie,9124,6,11,8,17,38,52,-14,41
RZ Pellets W,9124,7,10,6,20,37,63,-26,36
St. Pölten,9124,8,7,10,19,39,64,-25,31
Mattersburg,9124,9,7,10,19,37,62,-25,31
Admira Wacke,9124,10,9,4,23,39,72,-33,31
SC Rheindorf,9125,1,22,6,8,55,38,17,72
FC Salzburg,9125,2,21,5,10,65,35,30,68
SK Sturm Gra,9125,3,19,6,11,56,36,20,63
Rapid Vienna,9125,4,16,9,11,61,39,22,57
Vienna,9125,5,15,6,15,54,53,1,51
Admira Wacke,9125,6,12,9,15,40,54,-14,45
RZ Pellets W,9125,7,11,8,17,46,59,-13,41
SV Josko Rie,9125,8,11,5,20,31,51,-20,38
Mattersburg,9125,9,10,7,19,37,53,-16,37
St. Pölten,9125,10,8,9,19,37,64,-27,33
FC Salzburg,9126,1,20,9,7,63,34,29,69
SC Rheindorf,9126,2,17,9,10,50,45,5,60
Vienna,9126,3,18,5,13,60,49,11,59
SK Sturm Gra,9126,4,17,7,12,51,31,20,58
Rapid Vienna,9126,5,15,9,12,56,40,16,54
Admira Wacke,9126,6,13,7,16,39,55,-16,46
Mattersburg,9126,7,13,6,17,49,52,-3,45
RZ Pellets W,9126,8,12,6,18,44,56,-12,42
St. Pölten,9126,9,9,8,19,43,69,-26,35
SV Josko Rie,9126,10,8,10,18,33,57,-24,34
FC Salzburg,9127,1,20,8,8,63,32,31,68
SK Sturm Gra,9127,2,19,7,10,61,36,25,64
SC Rheindorf,9127,3,18,10,8,58,47,11,64
Vienna,9127,4,18,5,13,70,58,12,59
Rapid Vienna,9127,5,15,11,10,55,38,17,56
RZ Pellets W,9127,6,15,7,14,52,58,-6,52
SV Josko Rie,9127,7,11,4,21,33,54,-21,37
Mattersburg,9127,8,7,13,16,41,57,-16,34
Admira Wacke,9127,9,10,4,22,37,62,-25,34
St. Pölten,9127,10,9,7,20,42,70,-28,34
SK Sturm Gra,9128,1,21,6,9,65,36,29,69
FC Salzburg,9128,2,20,8,8,62,28,34,68
SC Rheindorf,9128,3,19,6,11,53,41,12,63
Vienna,9128,4,17,5,14,59,52,7,56
Rapid Vienna,9128,5,14,11,11,50,38,12,53
RZ Pellets W,9128,6,13,7,16,42,55,-13,46
Admira Wacke,9128,7,11,6,19,34,56,-22,39
SV Josko Rie,9128,8,11,5,20,34,52,-18,38
St. Pölten,9128,9,9,10,17,36,57,-21,37
Mattersburg,9128,10,9,8,19,35,55,-20,35
SK Sturm Gra,9129,1,21,6,9,66,35,31,69
SC Rheindorf,9129,2,19,9,8,57,45,12,66
FC Salzburg,9129,3,18,5,13,59,36,23,59
Vienna,9129,4,17,6,13,62,57,5,57
RZ Pellets W,9129,5,16,7,13,55,51,4,55
Rapid Vienna,9129,6,14,7,15,49,45,4,49
Admira Wacke,9129,7,13,4,19,36,53,-17,43
Mattersburg,9129,8,11,7,18,39,54,-15,40
SV Josko Rie,9129,9,11,4,21,31,50,-19,37
St. Pölten,9129,10,8,9,19,38,66,-28,33
FC Salzburg,9130,1,22,9,5,65,24,41,75
SC Rheindorf,9130,2,23,6,7,64,40,24,75
SK Sturm Gra,9130,3,17,6,13,60,42,18,57
Vienna,9130,4,16,7,13,60,51,9,55
Rapid Vienna,9130,5,15,9,12,59,41,18,54
RZ Pellets W,9130,6,11,8,17,45,57,-12,41
St. Pölten,9130,7,9,13,14,46,62,-16,40
Mattersburg,9130,8,10,9,17,37,54,-17,39
Admira Wacke,9130,9,11,5,20,33,65,-32,38
SV Josko Rie,9130,10,8,4,24,34,67,-33,28
FC Salzburg,9131,1,22,7,7,69,30,39,73
Vienna,9131,2,21,5,10,61,45,16,68
SK Sturm Gra,9131,3,20,5,11,69,43,26,65
SC Rheindorf,9131,4,19,8,9,49,40,9,65
Rapid Vienna,9131,5,13,12,11,54,37,17,51
RZ Pellets W,9131,6,12,9,15,40,52,-12,45
St. Pölten,9131,7,9,11,16,41,55,-14,38
SV Josko Rie,9131,8,9,7,20,31,56,-25,34
Admira Wacke,9131,9,9,7,20,39,66,-27,34
Mattersburg,9131,10,7,7,22,30,59,-29,28
FC Salzburg,9132,1,21,7,8,76,32,44,70
SK Sturm Gra,9132,2,21,7,8,62,33,29,70
SC Rheindorf,9132,3,21,6,9,63,46,17,69
Vienna,9132,4,19,5,12,67,55,12,62
Rapid Vienna,9132,5,12,13,11,55,49,6,49
RZ Pellets W,9132,6,11,8,17,42,57,-15,41
Mattersburg,9132,7,10,9,17,40,58,-18,39
SV Josko Rie,9132,8,9,10,17,31,48,-17,37
Admira Wacke,9132,9,10,5,21,40,69,-29,35
St. Pölten,9132,10,6,10,20,36,65,-29,28
FC Salzburg,9133,1,22,7,7,69,31,38,73
Vienna,9133,2,21,6,9,63,42,21,69
SC Rheindorf,9133,3,18,8,10,57,46,11,62
SK Sturm Gra,9133,4,16,8,12,66,39,27,56
Rapid Vienna,9133,5,15,9,12,53,41,12,54
RZ Pellets W,9133,6,12,6,18,46,64,-18,42
St. Pölten,9133,7,10,11,15,47,66,-19,41
Admira Wacke,9133,8,10,7,19,39,70,-31,37
SV Josko Rie,9133,9,10,5,21,30,52,-22,35
Mattersburg,9133,10,8,9,19,39,58,-19,33
FC Salzburg,9134,1,22,7,7,68,24,44,73
SC Rheindorf,9134,2,20,8,8,53,39,14,68
SK Sturm Gra,9134,3,20,7,9,64,32,32,67
Vienna,9134,4,19,2,15,60,61,-1,59
Rapid Vienna,9134,5,15,10,11,59,42,17,55
Admira Wacke,9134,6,14,4,18,42,59,-17,46
RZ Pellets W,9134,7,13,6,17,55,64,-9,45
SV Josko Rie,9134,8,10,3,23,32,58,-26,33
Mattersburg,9134,9,8,8,20,37,60,-23,32
St. Pölten,9134,10,7,9,20,37,68,-31,30
FC Salzburg,9135,1,22,7,7,65,30,35,73
Vienna,9135,2,20,4,12,69,53,16,64
Rapid Vienna,9135,3,17,10,9,53,32,21,61
SK Sturm Gra,9135,4,18,6,12,57,35,22,60
SC Rheindorf,9135,5,16,7,13,55,51,4,55
RZ Pellets W,9135,6,14,8,14,45,52,-7,50
SV Josko Rie,9135,7,11,4,21,37,61,-24,37
Mattersburg,9135,8,9,9,18,39,58,-19,36
St. Pölten,9135,9,9,8,19,45,67,-22,35
Admira Wacke,9135,10,9,7,20,32,58,-26,34
FC Salzburg,9136,1,24,7,5,68,26,42,79
SC Rheindorf,9136,2,16,11,9,55,41,14,59
Vienna,9136,3,17,8,11,65,55,10,59
SK Sturm Gra,9136,4,17,6,13,52,34,18,57
RZ Pellets W,9136,5,13,8,15,48,54,-6,47
Rapid Vienna,9136,6,12,10,14,48,43,5,46
Admira Wacke,9136,7,11,11,14,45,56,-11,44
SV Josko Rie,9136,8,9,8,19,39,63,-24,35
Mattersburg,9136,9,7,13,16,40,59,-19,34
St. Pölten,9136,10,8,10,18,37,66,-29,34
FC Salzburg,9137,1,23,5,8,60,26,34,74
SC Rheindorf,9137,2,22,5,9,57,38,19,71
SK Sturm Gra,9137,3,20,4,12,56,38,18,64
Rapid Vienna,9137,4,17,9,10,60,37,23,60
RZ Pellets W,9137,5,15,8,13,47,46,1,53
Vienna,9137,6,14,8,14,55,54,1,50
Admira Wacke,9137,7,12,8,16,37,55,-18,44
SV Josko Rie,9137,8,8,6,22,31,55,-24,30
St. Pölten,9137,9,7,9,20,43,73,-30,30
Mattersburg,9137,10,7,8,21,37,61,-24,29
SC Rheindorf,9138,1,20,8,8,59,43,16,68
SK Sturm Gra,9138,2,20,6,10,65,38,27,66
FC Salzburg,9138,3,19,8,9,61,31,30,65
Rapid Vienna,9138,4,17,9,10,58,39,19,60
Vienna,9138,5,16,5,15,57,51,6,53
RZ Pellets W,9138,6,13,6,17,45,58,-13,45
Admira Wacke,9138,7,13,5,18,43,61,-18,44
SV Josko Rie,9138,8,9,10,17,35,54,-19,37
St. Pölten,9138,9,6,14,16,43,63,-20,32
Mattersburg,9138,10,8,7,21,41,69,-28,31
SC Rheindorf,9139,1,21,8,7,62,40,22,71
FC Salzburg,9139,2,20,9,7,63,32,31,69
Rapid Vienna,9139,3,16,10,10,59,41,18,58
SK Sturm Gra,9139,4,18,4,14,51,37,14,58
Vienna,9139,5,17,7,12,62,56,6,58
RZ Pellets W,9139,6,12,7,17,43,55,-12,43
Admira Wacke,9139,7,11,8,17,37,60,-23,41
St. Pölten,9139,8,10,10,16,44,57,-13,40
SV Josko Rie,9139,9,10,7,19,33,51,-18,37
Mattersburg,9139,10,6,8,22,38,63,-25,26
SK Sturm Gra,9140,1,22,6,8,67,30,37,72
FC Salzburg,9140,2,20,11,5,64,27,37,71
Vienna,9140,3,21,3,12,68,57,11,66
SC Rheindorf,9140,4,19,5,12,55,39,16,62
Rapid Vienna,9140,5,13,10,13,57,46,11,49
SV Josko Rie,9140,6,12,7,17,34,48,-14,43
St. Pölten,9140,7,10,9,17,49,70,-21,39
Admira Wacke,9140,8,11,5,20,37,65,-28,38
RZ Pellets W,9140,9,9,7,20,42,65,-23,34
Mattersburg,9140,10,7,9,20,32,58,-26,30
FC Salzburg,9141,1,22,7,7,71,26,45,73
SK Sturm Gra,9141,2,20,8,8,62,31,31,68
SC Rheindorf,9141,3,20,8,8,53,40,13,68
Vienna,9141,4,17,7,12,65,52,13,58
Rapid Vienna,9141,5,13,11,12,54,48,6,50
RZ Pellets W,9141,6,13,5,18,50,64,-14,44
St. Pölten,9141,7,9,9,18,47,65,-18,36
SV Josko Rie,9141,8,10,6,20,31,52,-21,36
Admira Wacke,9141,9,9,9,18,35,65,-30,36
Mattersburg,9141,10,9,6,21,37,62,-25,33
SK Sturm Gra,9142,1,24,3,9,68,32,36,75
Vienna,9142,2,22,5,9,69,43,26,71
FC Salzburg,9142,3,20,5,11,64,38,26,65
SC Rheindorf,9142,4,15,10,11,52,47,5,55
Rapid Vienna,9142,5,14,10,12,52,38,14,52
SV Josko Rie,9142,6,13,4,19,39,56,-17,43
RZ Pellets W,9142,7,11,6,19,40,59,-19,39
Admira Wacke,9142,8,11,6,19,39,67,-28,39
St. Pölten,9142,9,8,11,17,44,65,-21,35
Mattersburg,9142,10,8,8,20,43,65,-22,32
FC Salzburg,9143,1,20,11,5,63,29,34,71
SK Sturm Gra,9143,2,19,8,9,65,34,31,65
SC Rheindorf,9143,3,18,9,9,49,43,6,63
Vienna,9143,4,19,4,13,62,52,10,61
Rapid Vienna,9143,5,16,10,10,58,38,20,58
RZ Pellets W,9143,6,11,7,18,46,63,-17,40
Mattersburg,9143,7,10,8,18,41,55,-14,38
Admira Wacke,9143,8,10,8,18,36,56,-20,38
St. Pölten,9143,9,8,10,18,43,66,-23,34
SV Josko Rie,9143,10,8,7,21,27,54,-27,31
SC Rheindorf,9144,1,20,8,8,58,38,20,68
Vienna,9144,2,19,5,12,58,52,6,62
SK Sturm Gra,9144,3,18,7,11,57,29,28,61
Rapid Vienna,9144,4,16,10,10,58,38,20,58
FC Salzburg,9144,5,15,11,10,55,33,22,56
Mattersburg,9144,6,12,8,16,37,49,-12,44
SV Josko Rie,9144,7,12,7,17,37,47,-10,43
St. Pölten,9144,8,10,9,17,42,65,-23,39
Admira Wacke,9144,9,11,4,21,31,60,-29,37
RZ Pellets W,9144,10,10,5,21,40,62,-22,35
SK Sturm Gra,9145,1,21,7,8,65,31,34,70
FC Salzburg,9145,2,20,9,7,65,31,34,69
Vienna,9145,3,17,5,14,62,53,9,56
SC Rheindorf,9145,4,15,10,11,51,46,5,55
Rapid Vienna,9145,5,14,12,10,54,39,15,54
SV Josko Rie,9145,6,14,4,18,36,52,-16,46
RZ Pellets W,9145,7,11,7,18,41,54,-13,40
Admira Wacke,9145,8,10,10,16,37,54,-17,40
Mattersburg,9145,9,10,6,20,33,62,-29,36
St. Pölten,9145,10,7,12,17,39,61,-22,33
FC Salzburg,9146,1,20,8,8,65,35,30,68
Vienna,9146,2,20,6,10,63,49,14,66
SC Rheindorf,9146,3,19,6,11,50,42,8,63
SK Sturm Gra,9146,4,19,5,12,53,32,21,62
Rapid Vienna,9146,5,13,12,11,55,42,13,51
SV Josko Rie,9146,6,14,4,18,35,48,-13,46
RZ Pellets W,9146,7,10,8,18,42,57,-15,38
Mattersburg,9146,8,10,8,18,35,51,-16,38
Admira Wacke,9146,9,11,5,20,40,63,-23,38
St. Pölten,9146,10,7,12,17,46,65,-19,33
FC Salzburg,9147,1,22,4,10,66,33,33,70
SK Sturm Gra,9147,2,20,7,9,62,36,26,67
SC Rheindorf,9147,3,20,7,9,52,36,16,67
Vienna,9147,4,18,8,10,64,49,15,62
Mattersburg,9147,5,14,7,15,38,47,-9,49
Rapid Vienna,9147,6,13,8,15,57,52,5,47
RZ Pellets W,9147,7,11,7,18,48,63,-15,40
SV Josko Rie,9147,8,11,6,19,38,53,-15,39
Admira Wacke,9147,9,10,7,19,34,61,-27,37
St. Pölten,9147,10,6,9,21,38,67,-29,27
FC Salzburg,9148,1,20,9,7,67,28,39,69
SK Sturm Gra,9148,2,19,5,12,59,39,20,62
SC Rheindorf,9148,3,17,8,11,47,43,4,59
Vienna,9148,4,18,4,14,63,53,10,58
Rapid Vienna,9148,5,15,10,11,52,34,18,55
RZ Pellets W,9148,6,12,8,16,47,51,-4,44
Mattersburg,9148,7,11,9,16,39,49,-10,42
Admira Wacke,9148,8,12,6,18,39,64,-25,42
SV Josko Rie,9148,9,11,6,19,35,55,-20,39
St. Pölten,9148,10,7,11,18,37,69,-32,32
SC Rheindorf,9149,1,20,9,7,61,35,26,69
FC Salzburg,9149,2,20,8,8,70,35,35,68
Vienna,9149,3,18,6,12,67,57,10,60
SK Sturm Gra,9149,4,17,7,12,57,37,20,58
Rapid Vienna,9149,5,15,11,10,55,40,15,56
Admira Wacke,9149,6,14,5,17,42,57,-15,47
RZ Pellets W,9149,7,12,7,17,45,63,-18,43
SV Josko Rie,9149,8,10,5,21,36,62,-26,35
Mattersburg,9149,9,8,10,18,43,59,-16,34
St. Pölten,9149,10,8,8,20,40,71,-31,32
FC Salzburg,9150,1,22,6,8,66,35,31,72
SC Rheindorf,9150,2,19,9,8,56,39,17,66
SK Sturm Gra,9150,3,18,8,10,58,33,25,62
Vienna,9150,4,16,10,10,64,61,3,58
Rapid Vienna,9150,5,16,9,11,65,42,23,57
RZ Pellets W,9150,6,13,7,16,57,59,-2,46
Admira Wacke,9150,7,11,5,20,33,57,-24,38
SV Josko Rie,9150,8,10,7,19,39,57,-18,37
St. Pölten,9150,9,8,10,18,42,68,-26,34
Mattersburg,9150,10,7,9,20,40,69,-29,30
FC Salzburg,9151,1,20,10,6,71,35,36,70
SC Rheindorf,9151,2,21,6,9,57,38,19,69
Vienna,9151,3,17,6,13,62,55,7,57
SK Sturm Gra,9151,4,16,8,12,51,38,13,56
Rapid Vienna,9151,5,13,13,10,59,44,15,52
RZ Pellets W,9151,6,12,9,15,46,53,-7,45
SV Josko Rie,9151,7,11,7,18,37,50,-13,40
Admira Wacke,9151,8,9,13,14,38,59,-21,40
Mattersburg,9151,9,8,11,17,35,52,-17,35
St. Pölten,9151,10,7,9,20,39,71,-32,30
FC Salzburg,9152,1,22,5,9,61,29,32,71
Rapid Vienna,9152,2,19,9,8,61,31,30,66
SK Sturm Gra,9152,3,20,4,12,58,38,20,64
SC Rheindorf,9152,4,19,6,11,56,47,9,63
Vienna,9152,5,19,4,13,59,51,8,61
SV Josko Rie,9152,6,12,5,19,29,47,-18,41
RZ Pellets W,9152,7,11,7,18,45,55,-10,40
Admira Wacke,9152,8,10,7,19,31,54,-23,37
Mattersburg,9152,9,9,7,20,34,56,-22,34
St. Pölten,9152,10,8,8,20,39,65,-26,32
FC Salzburg,9153,1,24,5,7,71,29,42,77
SC Rheindorf,9153,2,19,7,10,58,43,15,64
SK Sturm Gra,9153,3,19,5,12,61,39,22,62
Vienna,9153,4,17,2,17,58,61,-3,53
RZ Pellets W,9153,5,15,5,16,45,55,-10,50
Admira Wacke,9153,6,14,6,16,43,53,-10,48
Rapid Vienna,9153,7,11,10,15,48,47,1,43
St. Pölten,9153,8,11,9,16,41,57,-16,42
SV Josko Rie,9153,9,12,4,20,40,55,-15,40
Mattersburg,9153,10,9,5,22,34,60,-26,32
FC Salzburg,9154,1,20,8,8,60,26,34,68
SK Sturm Gra,9154,2,21,5,10,63,38,25,68
SC Rheindorf,9154,3,19,5,12,53,45,8,62
Vienna,9154,4,17,5,14,56,47,9,56
Rapid Vienna,9154,5,15,9,12,56,38,18,54
SV Josko Rie,9154,6,13,6,17,33,44,-11,45
RZ Pellets W,9154,7,11,9,16,43,57,-14,42
Mattersburg,9154,8,11,9,16,40,55,-15,42
Admira Wacke,9154,9,9,8,19,32,63,-31,35
St. Pölten,9154,10,7,10,19,41,64,-23,31
SK Sturm Gra,9155,1,21,6,9,56,29,27,69
SC Rheindorf,9155,2,20,9,7,59,43,16,69
FC Salzburg,9155,3,18,10,8,68,35,33,64
Vienna,9155,4,15,9,12,60,56,4,54
RZ Pellets W,9155,5,14,7,15,55,57,-2,49
Rapid Vienna,9155,6,12,9,15,49,47,2,45
Admira Wacke,9155,7,11,8,17,38,57,-19,41
Mattersburg,9155,8,9,10,17,40,57,-17,37
St. Pölten,9155,9,8,12,16,46,63,-17,36
SV Josko Rie,9155,10,9,6,21,40,67,-27,33
FC Salzburg,9156,1,24,5,7,70,29,41,77
SC Rheindorf,9156,2,21,8,7,60,42,18,71
Vienna,9156,3,18,6,12,64,49,15,60
SK Sturm Gra,9156,4,17,7,12,57,32,25,58
Rapid Vienna,9156,5,14,12,10,59,47,12,54
RZ Pellets W,9156,6,11,8,17,46,61,-15,41
St. Pölten,9156,7,10,8,18,37,61,-24,38
SV Josko Rie,9156,8,10,6,20,33,56,-23,36
Admira Wacke,9156,9,10,6,20,33,64,-31,36
Mattersburg,9156,10,7,10,19,37,55,-18,31
FC Salzburg,9157,1,22,6,8,66,29,37,72
SC Rheindorf,9157,2,20,7,9,56,38,18,67
Vienna,9157,3,21,3,12,64,50,14,66
SK Sturm Gra,9157,4,19,4,13,58,37,21,61
Rapid Vienna,9157,5,15,10,11,62,42,20,55
RZ Pellets W,9157,6,12,7,17,44,56,-12,43
Admira Wacke,9157,7,13,3,20,37,59,-22,42
SV Josko Rie,9157,8,11,6,19,34,55,-21,39
Mattersburg,9157,9,9,7,20,35,59,-24,34
St. Pölten,9157,10,8,7,21,36,67,-31,31
SC Rheindorf,9158,1,21,6,9,62,39,23,69
FC Salzburg,9158,2,20,7,9,61,33,28,67
Vienna,9158,3,18,6,12,59,51,8,60
SK Sturm Gra,9158,4,17,6,13,56,40,16,57
Rapid Vienna,9158,5,15,10,11,59,43,16,55
RZ Pellets W,9158,6,13,9,14,48,55,-7,48
Mattersburg,9158,7,10,9,17,37,52,-15,39
St. Pölten,9158,8,9,11,16,40,59,-19,38
Admira Wacke,9158,9,11,5,20,35,60,-25,38
SV Josko Rie,9158,10,9,5,22,35,60,-25,32
FC Salzburg,9159,1,21,8,7,71,31,40,71
SC Rheindorf,9159,2,21,6,9,61,48,13,69
SK Sturm Gra,9159,3,19,5,12,54,41,13,62
Vienna,9159,4,18,5,13,75,63,12,59
Rapid Vienna,9159,5,16,9,11,52,37,15,57
RZ Pellets W,9159,6,13,9,14,55,54,1,48
Admira Wacke,9159,7,10,7,19,36,60,-24,37
Mattersburg,9159,8,8,10,18,34,53,-19,34
SV Josko Rie,9159,9,8,10,18,34,55,-21,34
St. Pölten,9159,10,7,9,20,34,64,-30,30
FC Salzburg,9160,1,22,7,7,64,33,31,73
Vienna,9160,2,20,5,11,65,52,13,65
SC Rheindorf,9160,3,20,4,12,55,49,6,64
SK Sturm Gra,9160,4,20,3,13,66,36,30,63
Rapid Vienna,9160,5,16,8,12,60,41,19,56
Admira Wacke,9160,6,14,4,18,40,58,-18,46
RZ Pellets W,9160,7,12,6,18,42,58,-16,42
St. Pölten,9160,8,9,10,17,42,60,-18,37
SV Josko Rie,9160,9,10,4,22,29,54,-25,34
Mattersburg,9160,10,7,9,20,34,56,-22,30
FC Salzburg,9161,1,21,7,8,61,29,32,70
SK Sturm Gra,9161,2,21,7,8,63,34,29,70
SC Rheindorf,9161,3,20,6,10,55,41,14,66
Vienna,9161,4,16,9,11,53,46,7,57
Rapid Vienna,9161,5,12,9,15,47,47,0,45
SV Josko Rie,9161,6,12,5,19,31,44,-13,41
RZ Pellets W,9161,7,10,10,16,45,56,-11,40
Mattersburg,9161,8,10,10,16,40,57,-17,40
St. Pölten,9161,9,10,7,19,45,67,-22,37
Admira Wacke,9161,10,10,6,20,37,56,-19,36
FC Salzburg,9162,1,21,9,6,64,32,32,72
SK Sturm Gra,9162,2,21,3,12,68,42,26,66
SC Rheindorf,9162,3,20,6,10,59,41,18,66
Rapid Vienna,9162,4,16,10,10,59,35,24,58
Vienna,9162,5,17,5,14,61,56,5,56
RZ Pellets W,9162,6,13,5,18,41,54,-13,44
Admira Wacke,9162,7,11,5,20,31,63,-32,38
Mattersburg,9162,8,9,10,17,36,54,-18,37
SV Josko Rie,9162,9,10,6,20,37,53,-16,36
St. Pölten,9162,10,8,9,19,39,65,-26,33
FC Salzburg,9163,1,23,6,7,74,36,38,75
Vienna,9163,2,19,7,10,62,44,18,64
SC Rheindorf,9163,3,18,8,10,53,43,10,62
SK Sturm Gra,9163,4,17,7,12,53,32,21,58
Rapid Vienna,9163,5,15,11,10,57,41,16,56
St. Pölten,9163,6,10,12,14,44,57,-13,42
RZ Pellets W,9163,7,11,7,18,46,64,-18,40
SV Josko Rie,9163,8,11,6,19,34,53,-19,39
Mattersburg,9163,9,9,8,19,36,53,-17,35
Admira Wacke,9163,10,9,4,23,34,70,-36,31
Vienna,9164,1,20,7,9,60,45,15,67
SC Rheindorf,9164,2,20,7,9,56,42,14,67
SK Sturm Gra,9164,3,19,8,9,58,34,24,65
FC Salzburg,9164,4,17,12,7,61,33,28,63
Rapid Vienna,9164,5,14,13,9,51,33,18,55
RZ Pellets W,9164,6,11,11,14,44,52,-8,44
SV Josko Rie,9164,7,12,5,19,37,53,-16,41
St. Pölten,9164,8,9,8,19,44,65,-21,35
Admira Wacke,9164,9,9,8,19,35,59,-24,35
Mattersburg,9164,10,6,7,23,26,56,-30,25
Vienna,9165,1,22,5,9,64,45,19,71
SC Rheindorf,9165,2,19,8,9,57,43,14,65
Rapid Vienna,9165,3,18,9,9,68,42,26,63
SK Sturm Gra,9165,4,19,4,13,60,38,22,61
FC Salzburg,9165,5,16,11,9,56,32,24,59
RZ Pellets W,9165,6,12,8,16,50,57,-7,44
SV Josko Rie,9165,7,11,8,17,38,54,-16,41
Mattersburg,9165,8,10,8,18,36,55,-19,38
Admira Wacke,9165,9,9,6,21,33,61,-28,33
St. Pölten,9165,10,7,7,22,37,72,-35,28
FC Salzburg,9166,1,20,8,8,60,29,31,68
SK Sturm Gra,9166,2,19,6,11,54,31,23,63
SC Rheindorf,9166,3,18,8,10,53,44,9,62
Rapid Vienna,9166,4,17,10,9,63,34,29,61
Vienna,9166,5,15,6,15,52,49,3,51
RZ Pellets W,9166,6,13,8,15,46,55,-9,47
Admira Wacke,9166,7,13,5,18,39,55,-16,44
St. Pölten,9166,8,9,12,15,45,69,-24,39
SV Josko Rie,9166,9,10,6,20,34,57,-23,36
Mattersburg,9166,10,8,7,21,35,58,-23,31
SC Rheindorf,9167,1,21,8,7,61,36,25,71
Vienna,9167,2,20,7,9,59,47,12,67
FC Salzburg,9167,3,19,9,8,59,30,29,66
SK Sturm Gra,9167,4,18,11,7,56,31,25,65
RZ Pellets W,9167,5,16,5,15,54,56,-2,53
Rapid Vienna,9167,6,10,14,12,52,45,7,44
St. Pölten,9167,7,11,8,17,43,60,-17,41
Mattersburg,9167,8,7,11,18,31,51,-20,32
Admira Wacke,9167,9,8,7,21,29,59,-30,31
SV Josko Rie,9167,10,7,6,23,32,61,-29,27
FC Salzburg,9168,1,22,6,8,69,32,37,72
SC Rheindorf,9168,2,21,7,8,56,39,17,70
Vienna,9168,3,21,4,11,67,52,15,67
SK Sturm Gra,9168,4,20,5,11,56,35,21,65
Rapid Vienna,9168,5,12,10,14,54,48,6,46
RZ Pellets W,9168,6,12,5,19,42,62,-20,41
Admira Wacke,9168,7,11,7,18,34,54,-20,40
SV Josko Rie,9168,8,11,6,19,36,49,-13,39
St. Pölten,9168,9,8,11,17,41,62,-21,35
Mattersburg,9168,10,9,5,22,39,61,-22,32
Vienna,9169,1,21,6,9,63,45,18,69
SC Rheindorf,9169,2,20,9,7,57,41,16,69
SK Sturm Gra,9169,3,21,5,10,66,35,31,68
FC Salzburg,9169,4,18,9,9,60,33,27,63
Rapid Vienna,9169,5,14,11,11,52,40,12,53
SV Josko Rie,9169,6,14,3,19,39,57,-18,45
RZ Pellets W,9169,7,11,9,16,45,52,-7,42
St. Pölten,9169,8,8,9,19,40,62,-22,33
Admira Wacke,9169,9,9,6,21,29,59,-30,33
Mattersburg,9169,10,6,9,21,32,59,-27,27
FC Salzburg,9170,1,23,5,8,68,32,36,74
SC Rheindorf,9170,2,22,4,10,55,37,18,70
SK Sturm Gra,9170,3,19,5,12,57,37,20,62
Vienna,9170,4,18,4,14,67,58,9,58
Rapid Vienna,9170,5,16,9,11,63,39,24,57
RZ Pellets W,9170,6,14,6,16,48,60,-12,48
SV Josko Rie,9170,7,12,7,17,38,47,-9,43
Admira Wacke,9170,8,11,5,20,33,61,-28,38
St. Pölten,9170,9,9,8,19,39,60,-21,35
Mattersburg,9170,10,6,7,23,32,69,-37,25
SK Sturm Gra,9171,1,21,6,9,58,31,27,69
SC Rheindorf,9171,2,20,7,9,54,42,12,67
FC Salzburg,9171,3,18,8,10,58,30,28,62
Vienna,9171,4,17,4,15,57,52,5,55
Admira Wacke,9171,5,16,5,15,45,48,-3,53
Rapid Vienna,9171,6,14,8,14,49,43,6,50
RZ Pellets W,9171,7,12,8,16,42,53,-11,44
SV Josko Rie,9171,8,13,4,19,32,47,-15,43
St. Pölten,9171,9,9,8,19,35,58,-23,35
Mattersburg,9171,10,8,6,22,27,53,-26,30
FC Salzburg,9172,1,22,4,10,73,30,43,70
SC Rheindorf,9172,2,19,8,9,54,40,14,65
SK Sturm Gra,9172,3,18,8,10,59,39,20,62
Vienna,9172,4,17,6,13,60,60,0,57
Rapid Vienna,9172,5,13,12,11,54,41,13,51
RZ Pellets W,9172,6,12,11,13,51,57,-6,47
Admira Wacke,9172,7,11,9,16,36,55,-19,42
St. Pölten,9172,8,11,8,17,43,56,-13,41
SV Josko Rie,9172,9,11,4,21,33,53,-20,37
Mattersburg,9172,10,7,8,21,37,69,-32,29
SC Rheindorf,9173,1,24,7,5,60,34,26,79
SK Sturm Gra,9173,2,22,5,9,73,35,38,71
FC Salzburg,9173,3,20,8,8,65,30,35,68
Vienna,9173,4,19,4,13,62,50,12,61
Rapid Vienna,9173,5,12,12,12,55,46,9,48
RZ Pellets W,9173,6,12,9,15,42,52,-10,45
Mattersburg,9173,7,8,10,18,38,62,-24,34
St. Pölten,9173,8,6,14,16,40,61,-21,32
Admira Wacke,9173,9,8,8,20,29,64,-35,32
SV Josko Rie,9173,10,7,7,22,28,58,-30,28
SK Sturm Gra,9174,1,20,6,10,60,36,24,66
FC Salzburg,9174,2,19,7,10,65,39,26,64
Vienna,9174,3,20,4,12,84,64,20,64
SC Rheindorf,9174,4,18,9,9,58,43,15,63
Rapid Vienna,9174,5,15,9,12,57,45,12,54
RZ Pellets W,9174,6,14,6,16,50,53,-3,48
Mattersburg,9174,7,11,6,19,41,55,-14,39
SV Josko Rie,9174,8,11,6,19,37,54,-17,39
Admira Wacke,9174,9,10,7,19,39,63,-24,37
St. Pölten,9174,10,6,12,18,35,74,-39,30
SC Rheindorf,9175,1,23,5,8,65,45,20,74
FC Salzburg,9175,2,19,8,9,65,38,27,65
SK Sturm Gra,9175,3,17,9,10,55,34,21,60
Vienna,9175,4,19,3,14,74,56,18,60
Rapid Vienna,9175,5,16,10,10,65,39,26,58
RZ Pellets W,9175,6,13,5,18,48,60,-12,44
Admira Wacke,9175,7,12,6,18,39,62,-23,42
Mattersburg,9175,8,10,8,18,42,60,-18,38
SV Josko Rie,9175,9,9,6,21,27,59,-32,33
St. Pölten,9175,10,6,12,18,36,63,-27,30
FC Salzburg,9176,1,22,6,8,70,33,37,72
SK Sturm Gra,9176,2,21,6,9,64,38,26,69
Vienna,9176,3,22,2,12,68,48,20,68
Rapid Vienna,9176,4,17,7,12,71,44,27,58
SC Rheindorf,9176,5,14,8,14,48,58,-10,50
RZ Pellets W,9176,6,14,7,15,51,58,-7,49
Mattersburg,9176,7,11,8,17,39,52,-13,41
Admira Wacke,9176,8,12,4,20,34,58,-24,40
SV Josko Rie,9176,9,8,9,19,29,54,-25,33
St. Pölten,9176,10,6,9,21,38,69,-31,27
FC Salzburg,9177,1,19,9,8,72,38,34,66
SC Rheindorf,9177,2,20,6,10,52,40,12,66
SK Sturm Gra,9177,3,19,8,9,59,33,26,65
Vienna,9177,4,18,4,14,62,51,11,58
Rapid Vienna,9177,5,14,11,11,54,43,11,53
SV Josko Rie,9177,6,14,4,18,33,47,-14,46
RZ Pellets W,9177,7,12,9,15,52,61,-9,45
Admira Wacke,9177,8,10,7,19,31,58,-27,37
Mattersburg,9177,9,8,9,19,36,55,-19,33
St. Pölten,9177,10,6,13,17,40,65,-25,31
FC Salzburg,9178,1,22,7,7,68,32,36,73
SK Sturm Gra,9178,2,20,8,8,59,30,29,68
SC Rheindorf,9178,3,18,9,9,56,45,11,63
Vienna,9178,4,14,7,15,59,61,-2,49
Rapid Vienna,9178,5,12,12,12,53,44,9,48
SV Josko Rie,9178,6,13,7,16,35,44,-9,46
Admira Wacke,9178,7,13,6,17,36,51,-15,45
RZ Pellets W,9178,8,9,15,12,47,53,-6,42
Mattersburg,9178,9,7,12,17,40,56,-16,33
St. Pölten,9178,10,5,11,20,40,77,-37,26
SC Rheindorf,9179,1,22,6,8,62,40,22,72
FC Salzburg,9179,2,20,10,6,68,27,41,70
SK Sturm Gra,9179,3,20,6,10,63,35,28,66
Vienna,9179,4,20,4,12,64,57,7,64
Rapid Vienna,9179,5,13,9,14,57,54,3,48
RZ Pellets W,9179,6,12,10,14,51,57,-6,46
SV Josko Rie,9179,7,9,8,19,32,48,-16,35
St. Pölten,9179,8,7,14,15,41,59,-18,35
Admira Wacke,9179,9,9,7,20,38,71,-33,34
Mattersburg,9179,10,7,8,21,36,64,-28,29
SK Sturm Gra,9180,1,21,6,9,59,29,30,69
FC Salzburg,9180,2,20,7,9,61,32,29,67
SC Rheindorf,9180,3,20,6,10,57,41,16,66
Rapid Vienna,9180,4,15,12,9,71,45,26,57
Vienna,9180,5,17,6,13,59,49,10,57
RZ Pellets W,9180,6,12,6,18,42,63,-21,42
Admira Wacke,9180,7,10,8,18,33,58,-25,38
SV Josko Rie,9180,8,9,10,17,30,45,-15,37
St. Pölten,9180,9,8,11,17,39,63,-24,35
Mattersburg,9180,10,9,6,21,39,65,-26,33
SC Rheindorf,9181,1,21,9,6,57,37,20,72
FC Salzburg,9181,2,21,6,9,65,34,31,69
SK Sturm Gra,9181,3,18,8,10,61,37,24,62
Vienna,9181,4,18,6,12,71,51,20,60
Rapid Vienna,9181,5,13,12,11,54,40,14,51
RZ Pellets W,9181,6,11,9,16,45,56,-11,42
St. Pölten,9181,7,10,9,17,37,60,-23,39
Admira Wacke,9181,8,11,5,20,37,65,-28,38
Mattersburg,9181,9,9,8,19,33,53,-20,35
SV Josko Rie,9181,10,10,4,22,28,55,-27,34
SK Sturm Gra,9182,1,22,7,7,59,27,32,73
FC Salzburg,9182,2,22,6,8,69,27,42,72
Vienna,9182,3,18,6,12,55,47,8,60
SC Rheindorf,9182,4,17,8,11,46,38,8,59
Rapid Vienna,9182,5,15,8,13,58,38,20,53
RZ Pellets W,9182,6,11,8,17,39,64,-25,41
St. Pölten,9182,7,10,10,16,46,58,-12,40
Admira Wacke,9182,8,10,8,18,34,61,-27,38
Mattersburg,9182,9,8,11,17,34,54,-20,35
SV Josko Rie,9182,10,9,4,23,28,54,-26,31
FC Salzburg,9183,1,23,7,6,67,26,41,76
SC Rheindorf,9183,2,18,8,10,51,43,8,62
Vienna,9183,3,18,6,12,58,46,12,60
SK Sturm Gra,9183,4,16,11,9,51,31,20,59
Rapid Vienna,9183,5,17,7,12,59,39,20,58
St. Pölten,9183,6,11,9,16,48,58,-10,42
RZ Pellets W,9183,7,11,6,19,43,59,-16,39
Mattersburg,9183,8,9,9,18,34,53,-19,36
Admira Wacke,9183,9,9,8,19,36,70,-34,35
SV Josko Rie,9183,10,8,9,19,36,58,-22,33
FC Salzburg,9184,1,22,6,8,60,27,33,72
SC Rheindorf,9184,2,21,5,10,62,48,14,68
SK Sturm Gra,9184,3,18,6,12,48,31,17,60
Vienna,9184,4,18,3,15,59,56,3,57
Rapid Vienna,9184,5,14,10,12,53,43,10,52
RZ Pellets W,9184,6,14,8,14,45,51,-6,50
Admira Wacke,9184,7,11,9,16,35,49,-14,42
Mattersburg,9184,8,11,8,17,45,52,-7,41
St. Pölten,9184,9,8,9,19,36,61,-25,33
SV Josko Rie,9184,10,8,6,22,32,57,-25,30
FC Salzburg,9185,1,22,9,5,70,29,41,75
SC Rheindorf,9185,2,19,11,6,60,43,17,68
SK Sturm Gra,9185,3,20,6,10,61,34,27,66
Vienna,9185,4,17,4,15,59,53,6,55
Rapid Vienna,9185,5,13,14,9,58,39,19,53
RZ Pellets W,9185,6,11,7,18,45,66,-21,40
St. Pölten,9185,7,10,9,17,45,58,-13,39
Mattersburg,9185,8,8,11,17,39,60,-21,35
Admira Wacke,9185,9,9,8,19,35,60,-25,35
SV Josko Rie,9185,10,9,5,22,32,62,-30,32
SK Sturm Gra,9186,1,19,10,7,61,35,26,67
SC Rheindorf,9186,2,19,7,10,60,44,16,64
FC Salzburg,9186,3,18,8,10,68,34,34,62
Rapid Vienna,9186,4,15,13,8,62,36,26,58
Vienna,9186,5,18,2,16,59,61,-2,56
RZ Pellets W,9186,6,14,8,14,50,54,-4,50
SV Josko Rie,9186,7,12,5,19,36,51,-15,41
Admira Wacke,9186,8,9,9,18,34,59,-25,36
St. Pölten,9186,9,9,9,18,49,76,-27,36
Mattersburg,9186,10,6,11,19,34,63,-29,29
SC Rheindorf,9187,1,21,8,7,57,39,18,71
FC Salzburg,9187,2,20,7,9,59,31,28,67
Vienna,9187,3,20,5,11,70,45,25,65
SK Sturm Gra,9187,4,18,6,12,54,32,22,60
Rapid Vienna,9187,5,15,11,10,59,41,18,56
RZ Pellets W,9187,6,11,9,16,43,52,-9,42
St. Pölten,9187,7,10,9,17,41,63,-22,39
SV Josko Rie,9187,8,12,2,22,37,60,-23,38
Admira Wacke,9187,9,11,4,21,35,62,-27,37
Mattersburg,9187,10,7,9,20,31,61,-30,30
SK Sturm Gra,9188,1,21,5,10,66,36,30,68
FC Salzburg,9188,2,20,6,10,57,32,25,66
Vienna,9188,3,20,5,11,68,48,20,65
SC Rheindorf,9188,4,18,6,12,47,45,2,60
RZ Pellets W,9188,5,13,6,17,48,59,-11,45
Rapid Vienna,9188,6,11,11,14,50,50,0,44
SV Josko Rie,9188,7,14,2,20,40,51,-11,44
Admira Wacke,9188,8,12,7,17,41,58,-17,43
St. Pölten,9188,9,9,10,17,42,60,-18,37
Mattersburg,9188,10,9,8,19,36,56,-20,35
FC Salzburg,9189,1,22,8,6,80,30,50,74
Vienna,9189,2,21,4,11,67,49,18,67
SK Sturm Gra,9189,3,18,8,10,55,35,20,62
SC Rheindorf,9189,4,17,9,10,50,41,9,60
Rapid Vienna,9189,5,13,15,8,53,38,15,54
RZ Pellets W,9189,6,10,11,15,50,62,-12,41
Admira Wacke,9189,7,12,4,20,36,66,-30,40
Mattersburg,9189,8,8,12,16,38,58,-20,36
SV Josko Rie,9189,9,10,4,22,32,55,-23,34
St. Pölten,9189,10,7,9,20,42,69,-27,30
SC Rheindorf,9190,1,22,8,6,64,38,26,74
SK Sturm Gra,9190,2,22,4,10,63,31,32,70
FC Salzburg,9190,3,21,6,9,67,34,33,69
Vienna,9190,4,19,4,13,60,46,14,61
Rapid Vienna,9190,5,12,12,12,50,43,7,48
RZ Pellets W,9190,6,13,5,18,50,61,-11,44
Admira Wacke,9190,7,12,6,18,36,56,-20,42
SV Josko Rie,9190,8,11,6,19,33,48,-15,39
Mattersburg,9190,9,7,10,19,35,61,-26,31
St. Pölten,9190,10,6,9,21,37,77,-40,27
FC Salzburg,9191,1,24,7,5,74,28,46,79
SC Rheindorf,9191,2,21,4,11,55,48,7,67
SK Sturm Gra,9191,3,18,6,12,61,41,20,60
Rapid Vienna,9191,4,15,11,10,63,42,21,56
RZ Pellets W,9191,5,16,7,13,52,51,1,55
Vienna,9191,6,16,5,15,54,53,1,53
Admira Wacke,9191,7,12,4,20,33,61,-28,40
St. Pölten,9191,8,8,10,18,44,62,-18,34
SV Josko Rie,9191,9,9,5,22,34,57,-23,32
Mattersburg,9191,10,8,7,21,38,65,-27,31
FC Salzburg,9192,1,22,6,8,67,29,38,72
SK Sturm Gra,9192,2,20,8,8,59,32,27,68
SC Rheindorf,9192,3,19,8,9,55,39,16,65
Vienna,9192,4,18,4,14,58,60,-2,58
Rapid Vienna,9192,5,15,10,11,64,44,20,55
Admira Wacke,9192,6,12,8,16,47,59,-12,44
SV Josko Rie,9192,7,10,8,18,35,50,-15,38
RZ Pellets W,9192,8,10,7,19,37,55,-18,37
St. Pölten,9192,9,7,12,17,34,60,-26,33
Mattersburg,9192,10,6,11,19,34,62,-28,29
SK Sturm Gra,9193,1,20,8,8,58,29,29,68
FC Salzburg,9193,2,19,9,8,65,35,30,66
Vienna,9193,3,17,6,13,63,50,13,57
SC Rheindorf,9193,4,16,9,11,55,53,2,57
Rapid Vienna,9193,5,14,10,12,56,45,11,52
RZ Pellets W,9193,6,13,9,14,44,49,-5,48
SV Josko Rie,9193,7,15,3,18,36,51,-15,48
Admira Wacke,9193,8,9,9,18,31,57,-26,36
St. Pölten,9193,9,8,11,17,44,62,-18,35
Mattersburg,9193,10,6,12,18,44,65,-21,30
FC Salzburg,9194,1,22,6,8,73,32,41,72
SC Rheindorf,9194,2,21,5,10,52,38,14,68
SK Sturm Gra,9194,3,17,8,11,53,35,18,59
Vienna,9194,4,18,4,14,53,51,2,58
Rapid Vienna,9194,5,16,9,11,58,41,17,57
RZ Pellets W,9194,6,13,7,16,43,51,-8,46
St. Pölten,9194,7,10,8,18,43,61,-18,38
Mattersburg,9194,8,9,10,17,39,54,-15,37
SV Josko Rie,9194,9,11,4,21,34,59,-25,37
Admira Wacke,9194,10,10,5,21,35,61,-26,35
SC Rheindorf,9195,1,22,8,6,63,39,24,74
FC Salzburg,9195,2,20,8,8,68,34,34,68
SK Sturm Gra,9195,3,20,5,11,62,37,25,65
Vienna,9195,4,18,5,13,59,54,5,59
Rapid Vienna,9195,5,14,9,13,57,44,13,51
Admira Wacke,9195,6,14,7,15,44,59,-15,49
RZ Pellets W,9195,7,11,7,18,43,60,-17,40
SV Josko Rie,9195,8,9,8,19,40,57,-17,35
St. Pölten,9195,9,8,10,18,45,66,-21,34
Mattersburg,9195,10,7,7,22,37,68,-31,28
SC Rheindorf,9196,1,21,8,7,57,41,16,71
Vienna,9196,2,21,6,9,68,48,20,69
SK Sturm Gra,9196,3,19,5,12,57,38,19,62
FC Salzburg,9196,4,17,8,11,60,37,23,59
Rapid Vienna,9196,5,15,9,12,56,44,12,54
Admira Wacke,9196,6,13,5,18,34,59,-25,44
RZ Pellets W,9196,7,11,5,20,42,58,-16,38
Mattersburg,9196,8,9,10,17,44,56,-12,37
St. Pölten,9196,9,9,9,18,39,59,-20,36
SV Josko Rie,9196,10,10,5,21,38,55,-17,35
FC Salzburg,9197,1,25,7,4,70,25,45,82
Vienna,9197,2,18,8,10,64,50,14,62
SC Rheindorf,9197,3,18,7,11,51,46,5,61
SK Sturm Gra,9197,4,18,6,12,55,37,18,60
RZ Pellets W,9197,5,13,7,16,43,52,-9,46
Rapid Vienna,9197,6,11,10,15,48,45,3,43
Admira Wacke,9197,7,11,7,18,35,56,-21,40
SV Josko Rie,9197,8,11,6,19,36,56,-20,39
St. Pölten,9197,9,9,11,16,49,62,-13,38
Mattersburg,9197,10,7,9,20,32,54,-22,30
FC Salzburg,9198,1,21,9,6,63,28,35,72
SK Sturm Gra,9198,2,20,5,11,60,35,25,65
SC Rheindorf,9198,3,18,6,12,53,43,10,60
Rapid Vienna,9198,4,16,10,10,57,34,23,58
Vienna,9198,5,15,6,15,56,58,-2,51
RZ Pellets W,9198,6,12,8,16,44,50,-6,44
SV Josko Rie,9198,7,12,7,17,40,51,-11,43
Admira Wacke,9198,8,10,8,18,31,56,-25,38
Mattersburg,9198,9,9,8,19,39,61,-22,35
St. Pölten,9198,10,8,11,17,39,66,-27,35
FC Salzburg,9199,1,22,4,10,78,37,41,70
SC Rheindorf,9199,2,22,4,10,63,43,20,70
Vienna,9199,3,21,4,11,66,49,17,67
SK Sturm Gra,9199,4,19,7,10,58,30,28,64
Rapid Vienna,9199,5,16,8,12,59,37,22,56
SV Josko Rie,9199,6,12,6,18,35,55,-20,42
Admira Wacke,9199,7,12,6,18,36,57,-21,42
RZ Pellets W,9199,8,11,8,17,42,65,-23,41
St. Pölten,9199,9,7,8,21,31,65,-34,29
Mattersburg,9199,10,7,7,22,32,62,-30,28
FC Salzburg,9200,1,22,6,8,69,37,32,72
SK Sturm Gra,9200,2,20,6,10,61,36,25,66
Vienna,9200,3,19,3,14,64,53,11,60
SC Rheindorf,9200,4,18,5,13,53,47,6,59
Rapid Vienna,9200,5,12,13,11,56,43,13,49
Admira Wacke,9200,6,13,6,17,36,62,-26,45
RZ Pellets W,9200,7,11,9,16,49,57,-8,42
Mattersburg,9200,8,11,5,20,41,57,-16,38
St. Pölten,9200,9,9,11,16,42,65,-23,38
SV Josko Rie,9200,10,10,6,20,42,56,-14,36
SC Rheindorf,9201,1,23,4,9,62,40,22,73
SK Sturm Gra,9201,2,21,7,8,56,32,24,70
FC Salzburg,9201,3,21,6,9,62,30,32,69
Vienna,9201,4,20,3,13,63,48,15,63
Admira Wacke,9201,5,14,5,17,40,55,-15,47
Rapid Vienna,9201,6,12,10,14,48,39,9,46
RZ Pellets W,9201,7,12,6,18,45,55,-10,42
SV Josko Rie,9201,8,11,5,20,35,53,-18,38
St. Pölten,9201,9,8,8,20,32,65,-33,32
Mattersburg,9201,10,8,6,22,31,57,-26,30
FC Salzburg,9202,1,21,7,8,72,36,36,70
SC Rheindorf,9202,2,18,9,9,54,42,12,63
SK Sturm Gra,9202,3,16,11,9,55,32,23,59
Rapid Vienna,9202,4,15,11,10,52,36,16,56
Vienna,9202,5,15,8,13,60,62,-2,53
RZ Pellets W,9202,6,12,10,14,40,49,-9,46
Admira Wacke,9202,7,11,9,16,36,53,-17,42
SV Josko Rie,9202,8,12,5,19,48,57,-9,41
St. Pölten,9202,9,10,11,15,46,60,-14,41
Mattersburg,9202,10,6,7,23,26,62,-36,25
SC Rheindorf,9203,1,22,8,6,63,36,27,74
FC Salzburg,9203,2,20,10,6,73,31,42,70
SK Sturm Gra,9203,3,20,5,11,62,35,27,65
Vienna,9203,4,20,4,12,58,53,5,64
Rapid Vienna,9203,5,13,9,14,56,43,13,48
RZ Pellets W,9203,6,13,8,15,53,58,-5,47
SV Josko Rie,9203,7,11,4,21,32,57,-25,37
Admira Wacke,9203,8,10,7,19,33,63,-30,37
Mattersburg,9203,9,9,8,19,37,58,-21,35
St. Pölten,9203,10,7,7,22,42,75,-33,28
FC Salzburg,9204,1,20,9,7,66,35,31,69
SC Rheindorf,9204,2,18,10,8,53,39,14,64
SK Sturm Gra,9204,3,19,6,11,56,35,21,63
Vienna,9204,4,19,5,12,67,52,15,62
Rapid Vienna,9204,5,14,12,10,56,39,17,54
RZ Pellets W,9204,6,14,7,15,48,56,-8,49
SV Josko Rie,9204,7,12,6,18,39,55,-16,42
St. Pölten,9204,8,11,7,18,50,66,-16,40
Admira Wacke,9204,9,10,6,20,32,57,-25,36
Mattersburg,9204,10,5,8,23,29,62,-33,23
FC Salzburg,9205,1,23,8,5,72,30,42,77
SK Sturm Gra,9205,2,19,6,11,60,39,21,63
Vienna,9205,3,19,6,11,68,56,12,63
SC Rheindorf,9205,4,16,10,10,48,41,7,58
Rapid Vienna,9205,5,12,12,12,56,43,13,48
Admira Wacke,9205,6,14,6,16,43,55,-12,48
RZ Pellets W,9205,7,10,9,17,44,59,-15,39
St. Pölten,9205,8,9,10,17,44,66,-22,37
Mattersburg,9205,9,7,12,17,34,56,-22,33
SV Josko Rie,9205,10,9,5,22,38,62,-24,32
FC Salzburg,9206,1,25,7,4,73,29,44,82
SK Sturm Gra,9206,2,22,4,10,59,33,26,70
SC Rheindorf,9206,3,19,9,8,55,44,11,66
Vienna,9206,4,20,3,13,74,51,23,63
Rapid Vienna,9206,5,13,11,12,50,35,15,50
Mattersburg,9206,6,10,11,15,40,54,-14,41
RZ Pellets W,9206,7,10,7,19,42,58,-16,37
Admira Wacke,9206,8,10,7,19,38,63,-25,37
SV Josko Rie,9206,9,9,4,23,30,58,-28,31
St. Pölten,9206,10,6,9,21,36,72,-36,27
FC Salzburg,9207,1,22,8,6,65,26,39,74
SK Sturm Gra,9207,2,18,6,12,54,31,23,60
Vienna,9207,3,16,9,11,58,48,10,57
SC Rheindorf,9207,4,16,7,13,44,46,-2,55
Rapid Vienna,9207,5,14,10,12,51,38,13,52
RZ Pellets W,9207,6,15,7,14,52,55,-3,52
SV Josko Rie,9207,7,14,3,19,40,51,-11,45
Admira Wacke,9207,8,11,7,18,34,62,-28,40
Mattersburg,9207,9,7,12,17,32,50,-18,33
St. Pölten,9207,10,8,9,19,40,63,-23,33
FC Salzburg,9208,1,23,6,7,65,22,43,75
SC Rheindorf,9208,2,23,6,7,68,36,32,75
Vienna,9208,3,21,2,13,63,53,10,65
SK Sturm Gra,9208,4,19,6,11,57,38,19,63
RZ Pellets W,9208,5,16,4,16,50,51,-1,52
Rapid Vienna,9208,6,12,12,12,53,40,13,48
SV Josko Rie,9208,7,11,4,21,34,57,-23,37
Admira Wacke,9208,8,11,4,21,34,61,-27,37
St. Pölten,9208,9,8,9,19,46,74,-28,33
Mattersburg,9208,10,5,9,22,31,69,-38,24
FC Salzburg,9209,1,20,7,9,71,37,34,67
SC Rheindorf,9209,2,17,10,9,53,44,9,61
SK Sturm Gra,9209,3,18,6,12,60,44,16,60
Vienna,9209,4,18,6,12,57,49,8,60
Rapid Vienna,9209,5,13,11,12,56,46,10,50
RZ Pellets W,9209,6,11,11,14,50,57,-7,44
Admira Wacke,9209,7,12,8,16,49,62,-13,44
SV Josko Rie,9209,8,13,3,20,41,54,-13,42
Mattersburg,9209,9,10,7,19,32,58,-26,37
St. Pölten,9209,10,9,9,18,39,57,-18,36
SK Sturm Gra,9210,1,21,6,9,59,27,32,69
FC Salzburg,9210,2,19,6,11,63,35,28,63
SC Rheindorf,9210,3,18,7,11,51,49,2,61
Rapid Vienna,9210,4,15,11,10,56,39,17,56
Vienna,9210,5,16,5,15,57,56,1,53
RZ Pellets W,9210,6,15,4,17,54,61,-7,49
St. Pölten,9210,7,11,9,16,48,64,-16,42
SV Josko Rie,9210,8,11,7,18,35,52,-17,40
Admira Wacke,9210,9,9,9,18,39,61,-22,36
Mattersburg,9210,10,8,10,18,35,53,-18,34
FC Salzburg,9211,1,23,6,7,69,28,41,75
SC Rheindorf,9211,2,21,7,8,62,44,18,70
SK Sturm Gra,9211,3,19,8,9,57,36,21,65
Vienna,9211,4,18,7,11,69,55,14,61
Rapid Vienna,9211,5,12,12,12,58,46,12,48
Mattersburg,9211,6,12,7,17,42,53,-11,43
RZ Pellets W,9211,7,11,7,18,44,58,-14,40
St. Pölten,9211,8,10,8,18,48,69,-21,38
Admira Wacke,9211,9,9,6,21,36,72,-36,33
SV Josko Rie,9211,10,8,6,22,33,57,-24,30
SC Rheindorf,9212,1,23,5,8,58,40,18,74
FC Salzburg,9212,2,21,8,7,67,37,30,71
Vienna,9212,3,18,7,11,64,55,9,61
SK Sturm Gra,9212,4,17,7,12,54,38,16,58
Rapid Vienna,9212,5,12,13,11,56,44,12,49
Admira Wacke,9212,6,13,6,17,35,55,-20,45
RZ Pellets W,9212,7,13,5,18,49,61,-12,44
St. Pölten,9212,8,8,13,15,43,57,-14,37
SV Josko Rie,9212,9,9,6,21,35,51,-16,33
Mattersburg,9212,10,8,6,22,37,60,-23,30
FC Salzburg,9213,1,24,7,5,72,28,44,79
Vienna,9213,2,22,3,11,67,46,21,69
SK Sturm Gra,9213,3,19,5,12,55,32,23,62
SC Rheindorf,9213,4,17,8,11,57,48,9,59
Rapid Vienna,9213,5,14,11,11,50,36,14,53
RZ Pellets W,9213,6,12,7,17,48,61,-13,43
Admira Wacke,9213,7,12,7,17,41,67,-26,43
Mattersburg,9213,8,8,9,19,36,51,-15,33
SV Josko Rie,9213,9,8,7,21,33,58,-25,31
St. Pölten,9213,10,6,12,18,37,69,-32,30
SC Rheindorf,9214,1,21,7,8,57,40,17,70
FC Salzburg,9214,2,18,9,9,55,27,28,63
Rapid Vienna,9214,3,17,8,11,55,36,19,59
Vienna,9214,4,16,9,11,55,44,11,57
SK Sturm Gra,9214,5,16,8,12,53,43,10,56
Admira Wacke,9214,6,13,6,17,38,50,-12,45
SV Josko Rie,9214,7,13,4,19,37,47,-10,43
RZ Pellets W,9214,8,11,6,19,44,58,-14,39
Mattersburg,9214,9,10,8,18,34,58,-24,38
St. Pölten,9214,10,7,11,18,38,63,-25,32
FC Salzburg,9215,1,26,5,5,78,32,46,83
SC Rheindorf,9215,2,18,10,8,51,39,12,64
SK Sturm Gra,9215,3,19,4,13,60,40,20,61
Vienna,9215,4,19,4,13,63,47,16,61
Rapid Vienna,9215,5,13,13,10,55,39,16,52
RZ Pellets W,9215,6,15,7,14,54,52,2,52
Admira Wacke,9215,7,11,8,17,40,63,-23,41
Mattersburg,9215,8,8,9,19,41,60,-19,33
SV Josko Rie,9215,9,9,2,25,27,66,-39,29
St. Pölten,9215,10,6,10,20,34,65,-31,28
FC Salzburg,9216,1,20,10,6,75,39,36,70
SC Rheindorf,9216,2,18,10,8,64,53,11,64
SK Sturm Gra,9216,3,17,7,12,58,40,18,58
Vienna,9216,4,17,6,13,63,61,2,57
Rapid Vienna,9216,5,13,12,11,66,41,25,51
RZ Pellets W,9216,6,14,7,15,46,51,-5,49
Admira Wacke,9216,7,13,8,15,43,59,-16,47
SV Josko Rie,9216,8,10,6,20,43,58,-15,36
St. Pölten,9216,9,8,10,18,40,72,-32,34
Mattersburg,9216,10,6,12,18,38,62,-24,30
SC Rheindorf,9217,1,20,8,8,58,43,15,68
FC Salzburg,9217,2,20,6,10,58,30,28,66
SK Sturm Gra,9217,3,18,10,8,65,34,31,64
Rapid Vienna,9217,4,14,13,9,55,34,21,55
Vienna,9217,5,16,5,15,63,64,-1,53
Admira Wacke,9217,6,12,7,17,40,60,-20,43
RZ Pellets W,9217,7,11,9,16,45,56,-11,42
SV Josko Rie,9217,8,11,6,19,38,55,-17,39
Mattersburg,9217,9,10,8,18,44,58,-14,38
St. Pölten,9217,10,6,12,18,38,70,-32,30
SC Rheindorf,9218,1,22,5,9,59,37,22,71
SK Sturm Gra,9218,2,21,6,9,65,36,29,69
FC Salzburg,9218,3,19,10,7,58,30,28,67
Rapid Vienna,9218,4,17,10,9,67,39,28,61
Vienna,9218,5,17,6,13,60,53,7,57
RZ Pellets W,9218,6,12,7,17,41,50,-9,43
St. Pölten,9218,7,8,11,17,43,61,-18,35
SV Josko Rie,9218,8,10,5,21,32,60,-28,35
Admira Wacke,9218,9,9,6,21,31,67,-36,33
Mattersburg,9218,10,6,12,18,34,57,-23,30
SC Rheindorf,9219,1,22,7,7,66,40,26,73
FC Salzburg,9219,2,21,8,7,67,26,41,71
Vienna,9219,3,18,7,11,69,60,9,61
SK Sturm Gra,9219,4,16,10,10,55,38,17,58
Rapid Vienna,9219,5,15,11,10,60,38,22,56
RZ Pellets W,9219,6,13,9,14,49,51,-2,48
SV Josko Rie,9219,7,11,7,18,41,53,-12,40
Admira Wacke,9219,8,11,6,19,33,62,-29,39
Mattersburg,9219,9,7,8,21,33,64,-31,29
St. Pölten,9219,10,5,9,22,32,73,-41,24
SK Sturm Gra,9220,1,21,7,8,69,36,33,70
FC Salzburg,9220,2,21,5,10,71,35,36,68
SC Rheindorf,9220,3,20,5,11,66,50,16,65
Vienna,9220,4,20,4,12,71,55,16,64
Rapid Vienna,9220,5,16,10,10,65,45,20,58
RZ Pellets W,9220,6,14,5,17,48,64,-16,47
SV Josko Rie,9220,7,11,5,20,34,55,-21,38
Admira Wacke,9220,8,9,9,18,32,63,-31,36
Mattersburg,9220,9,6,11,19,35,57,-22,29
St. Pölten,9220,10,6,11,19,35,66,-31,29
FC Salzburg,9221,1,24,8,4,65,23,42,80
Vienna,9221,2,18,6,12,58,47,11,60
SK Sturm Gra,9221,3,17,6,13,53,32,21,57
RZ Pellets W,9221,4,16,9,11,48,45,3,57
SC Rheindorf,9221,5,16,9,11,51,52,-1,57
Rapid Vienna,9221,6,12,13,11,45,35,10,49
St. Pölten,9221,7,11,8,17,37,55,-18,41
Admira Wacke,9221,8,11,6,19,37,58,-21,39
Mattersburg,9221,9,7,9,20,35,55,-20,30
SV Josko Rie,9221,10,7,8,21,32,59,-27,29
FC Salzburg,9222,1,26,6,4,79,24,55,84
SC Rheindorf,9222,2,18,7,11,56,43,13,61
Vienna,9222,3,18,5,13,64,53,11,59
SK Sturm Gra,9222,4,17,6,13,56,43,13,57
RZ Pellets W,9222,5,16,6,14,53,51,2,54
Rapid Vienna,9222,6,14,11,11,60,42,18,53
St. Pölten,9222,7,9,8,19,37,63,-26,35
Admira Wacke,9222,8,9,8,19,34,65,-31,35
Mattersburg,9222,9,8,9,19,33,63,-30,33
SV Josko Rie,9222,10,8,8,20,32,57,-25,32
FC Salzburg,9223,1,22,6,8,65,29,36,72
Vienna,9223,2,19,6,11,63,49,14,63
SK Sturm Gra,9223,3,17,7,12,58,36,22,58
SC Rheindorf,9223,4,16,8,12,49,47,2,56
Rapid Vienna,9223,5,15,9,12,56,41,15,54
SV Josko Rie,9223,6,12,9,15,39,47,-8,45
RZ Pellets W,9223,7,11,9,16,47,62,-15,42
St. Pölten,9223,8,9,10,17,42,66,-24,37
Admira Wacke,9223,9,10,7,19,39,63,-24,37
Mattersburg,9223,10,9,9,18,35,53,-18,36
SK Sturm Gra,9224,1,21,9,6,64,29,35,72
FC Salzburg,9224,2,19,9,8,68,32,36,66
Vienna,9224,3,19,8,9,65,48,17,65
SC Rheindorf,9224,4,16,9,11,51,52,-1,57
Rapid Vienna,9224,5,15,9,12,61,43,18,54
RZ Pellets W,9224,6,11,8,17,50,61,-11,41
Mattersburg,9224,7,11,8,17,43,55,-12,41
Admira Wacke,9224,8,11,8,17,36,62,-26,41
SV Josko Rie,9224,9,10,8,18,35,55,-20,38
St. Pölten,9224,10,5,8,23,37,73,-36,23
FC Salzburg,9225,1,21,10,5,73,32,41,73
SC Rheindorf,9225,2,19,9,8,56,42,14,66
SK Sturm Gra,9225,3,19,5,12,59,38,21,62
Vienna,9225,4,18,8,10,62,54,8,62
Rapid Vienna,9225,5,12,13,11,51,37,14,49
Admira Wacke,9225,6,12,8,16,34,54,-20,44
SV Josko Rie,9225,7,11,7,18,33,51,-18,40
RZ Pellets W,9225,8,10,8,18,42,60,-18,38
St. Pölten,9225,9,9,9,18,46,66,-20,36
Mattersburg,9225,10,6,9,21,39,61,-22,27
FC Salzburg,9226,1,22,6,8,67,36,31,72
SK Sturm Gra,9226,2,21,8,7,57,28,29,71
Vienna,9226,3,20,5,11,67,52,15,65
SC Rheindorf,9226,4,19,7,10,59,43,16,64
Rapid Vienna,9226,5,13,9,14,53,38,15,48
SV Josko Rie,9226,6,15,3,18,38,46,-8,48
RZ Pellets W,9226,7,11,8,17,42,55,-13,41
St. Pölten,9226,8,8,13,15,43,63,-20,37
Admira Wacke,9226,9,11,4,21,32,65,-33,37
Mattersburg,9226,10,4,9,23,28,60,-32,21
FC Salzburg,9227,1,22,7,7,70,31,39,73
SK Sturm Gra,9227,2,19,7,10,57,33,24,64
Vienna,9227,3,19,7,10,62,49,13,64
SC Rheindorf,9227,4,16,11,9,48,40,8,59
Rapid Vienna,9227,5,14,10,12,54,38,16,52
Admira Wacke,9227,6,14,6,16,42,53,-11,48
RZ Pellets W,9227,7,12,9,15,46,57,-11,45
Mattersburg,9227,8,9,7,20,40,59,-19,34
SV Josko Rie,9227,9,9,5,22,32,59,-27,32
St. Pölten,9227,10,7,9,20,39,71,-32,30
SC Rheindorf,9228,1,21,7,8,56,39,17,70
SK Sturm Gra,9228,2,17,9,10,58,37,21,60
FC Salzburg,9228,3,16,10,10,54,29,25,58
Vienna,9228,4,17,6,13,66,57,9,57
Rapid Vienna,9228,5,14,11,11,56,41,15,53
RZ Pellets W,9228,6,14,7,15,43,47,-4,49
Mattersburg,9228,7,10,9,17,41,58,-17,39
St. Pölten,9228,8,9,11,16,42,59,-17,38
SV Josko Rie,9228,9,10,7,19,30,51,-21,37
Admira Wacke,9228,10,9,9,18,33,61,-28,36
FC Salzburg,9229,1,21,8,7,71,34,37,71
SC Rheindorf,9229,2,20,7,9,64,49,15,67
SK Sturm Gra,9229,3,19,6,11,58,39,19,63
Vienna,9229,4,19,5,12,65,49,16,62
Rapid Vienna,9229,5,17,10,9,65,40,25,61
RZ Pellets W,9229,6,15,6,15,52,52,0,51
Admira Wacke,9229,7,10,8,18,36,62,-26,38
Mattersburg,9229,8,7,9,20,35,58,-23,30
SV Josko Rie,9229,9,8,6,22,36,68,-32,30
St. Pölten,9229,10,6,11,19,36,67,-31,29
SC Rheindorf,9230,1,22,5,9,59,38,21,71
SK Sturm Gra,9230,2,21,5,10,67,37,30,68
FC Salzburg,9230,3,19,7,10,64,34,30,64
Vienna,9230,4,20,4,12,62,50,12,64
Admira Wacke,9230,5,15,6,15,39,58,-19,51
Rapid Vienna,9230,6,13,11,12,59,37,22,50
RZ Pellets W,9230,7,11,8,17,40,57,-17,41
St. Pölten,9230,8,10,10,16,44,61,-17,40
SV Josko Rie,9230,9,7,6,23,33,63,-30,27
Mattersburg,9230,10,5,12,19,34,66,-32,27
FC Salzburg,9231,1,23,6,7,71,33,38,75
SC Rheindorf,9231,2,21,8,7,64,45,19,71
SK Sturm Gra,9231,3,19,5,12,63,38,25,62
Vienna,9231,4,19,3,14,68,54,14,60
Rapid Vienna,9231,5,14,9,13,58,49,9,51
RZ Pellets W,9231,6,13,7,16,50,56,-6,46
Admira Wacke,9231,7,14,4,18,48,67,-19,46
St. Pölten,9231,8,10,8,18,48,68,-20,38
SV Josko Rie,9231,9,10,4,22,34,59,-25,34
Mattersburg,9231,10,6,8,22,44,79,-35,26
FC Salzburg,9232,1,21,7,8,61,27,34,70
Vienna,9232,2,22,4,10,63,47,16,70
SK Sturm Gra,9232,3,20,5,11,54,30,24,65
SC Rheindorf,9232,4,20,4,12,51,41,10,64
SV Josko Rie,9232,5,15,3,18,41,47,-6,48
Rapid Vienna,9232,6,12,8,16,52,47,5,44
St. Pölten,9232,7,11,9,16,43,57,-14,42
Admira Wacke,9232,8,12,6,18,36,60,-24,42
RZ Pellets W,9232,9,10,7,19,42,59,-17,37
Mattersburg,9232,10,6,9,21,35,63,-28,27
SC Rheindorf,9233,1,21,9,6,57,37,20,72
FC Salzburg,9233,2,19,8,9,58,32,26,65
SK Sturm Gra,9233,3,18,10,8,59,29,30,64
Vienna,9233,4,16,10,10,57,46,11,58
Rapid Vienna,9233,5,13,10,13,66,48,18,49
Admira Wacke,9233,6,12,8,16,46,65,-19,44
SV Josko Rie,9233,7,12,7,17,39,54,-15,43
Mattersburg,9233,8,9,8,19,40,57,-17,35
RZ Pellets W,9233,9,8,10,18,38,60,-22,34
St. Pölten,9233,10,8,8,20,38,70,-32,32
SC Rheindorf,9234,1,23,6,7,60,36,24,75
FC Salzburg,9234,2,22,8,6,68,29,39,74
Vienna,9234,3,20,4,12,70,52,18,64
SK Sturm Gra,9234,4,18,8,10,53,36,17,62
Rapid Vienna,9234,5,12,11,13,55,43,12,47
RZ Pellets W,9234,6,13,8,15,47,51,-4,47
St. Pölten,9234,7,9,10,17,39,67,-28,37
SV Josko Rie,9234,8,10,6,20,35,56,-21,36
Admira Wacke,9234,9,8,9,19,36,66,-30,33
Mattersburg,9234,10,6,8,22,32,59,-27,26
FC Salzburg,9235,1,19,9,8,67,38,29,66
Vienna,9235,2,21,3,12,69,46,23,66
SC Rheindorf,9235,3,18,7,11,49,46,3,61
Rapid Vienna,9235,4,14,13,9,57,40,17,55
SK Sturm Gra,9235,5,15,8,13,50,37,13,53
RZ Pellets W,9235,6,14,7,15,51,55,-4,49
SV Josko Rie,9235,7,15,3,18,50,56,-6,48
Admira Wacke,9235,8,11,6,19,35,62,-27,39
Mattersburg,9235,9,7,11,18,32,54,-22,32
St. Pölten,9235,10,7,11,18,40,66,-26,32
SC Rheindorf,9236,1,20,9,7,56,41,15,69
FC Salzburg,9236,2,19,8,9,63,28,35,65
Vienna,9236,3,20,5,11,73,55,18,65
SK Sturm Gra,9236,4,19,5,12,63,37,26,62
RZ Pellets W,9236,5,13,8,15,48,55,-7,47
Rapid Vienna,9236,6,11,13,12,48,42,6,46
St. Pölten,9236,7,11,9,16,44,58,-14,42
Admira Wacke,9236,8,10,8,18,36,63,-27,38
SV Josko Rie,9236,9,8,9,19,35,63,-28,33
Mattersburg,9236,10,7,10,19,36,60,-24,31
FC Salzburg,9237,1,22,6,8,65,28,37,72
SC Rheindorf,9237,2,21,6,9,55,38,17,69
SK Sturm Gra,9237,3,20,3,13,59,36,23,63
Vienna,9237,4,18,3,15,64,57,7,57
Rapid Vienna,9237,5,13,11,12,62,46,16,50
RZ Pellets W,9237,6,14,8,14,50,55,-5,50
SV Josko Rie,9237,7,13,4,19,39,56,-17,43
St. Pölten,9237,8,10,8,18,42,68,-26,38
Admira Wacke,9237,9,10,5,21,37,66,-29,35
Mattersburg,9237,10,9,6,21,36,59,-23,33
SC Rheindorf,9238,1,21,9,6,64,38,26,72
FC Salzburg,9238,2,20,10,6,61,28,33,70
SK Sturm Gra,9238,3,18,6,12,57,37,20,60
Vienna,9238,4,17,6,13,57,51,6,57
Admira Wacke,9238,5,13,6,17,35,55,-20,45
RZ Pellets W,9238,6,12,8,16,46,54,-8,44
Rapid Vienna,9238,7,10,12,14,45,41,4,42
Mattersburg,9238,8,10,9,17,41,55,-14,39
SV Josko Rie,9238,9,10,7,19,31,52,-21,37
St. Pölten,9238,10,6,13,17,40,66,-26,31
FC Salzburg,9239,1,24,6,6,69,23,46,78
SC Rheindorf,9239,2,21,6,9,60,42,18,69
Vienna,9239,3,19,8,9,66,48,18,65
SK Sturm Gra,9239,4,18,5,13,61,46,15,59
Rapid Vienna,9239,5,12,14,10,49,34,15,50
RZ Pellets W,9239,6,11,7,18,43,57,-14,40
Admira Wacke,9239,7,11,7,18,35,62,-27,40
SV Josko Rie,9239,8,9,8,19,32,55,-23,35
Mattersburg,9239,9,8,8,20,34,56,-22,32
St. Pölten,9239,10,5,15,16,38,64,-26,30
FC Salzburg,9240,1,21,7,8,70,34,36,70
SC Rheindorf,9240,2,20,6,10,59,44,15,66
Vienna,9240,3,21,2,13,68,53,15,65
SK Sturm Gra,9240,4,18,5,13,61,41,20,59
Rapid Vienna,9240,5,15,9,12,58,41,17,54
RZ Pellets W,9240,6,13,7,16,49,54,-5,46
Admira Wacke,9240,7,13,5,18,40,58,-18,44
St. Pölten,9240,8,11,7,18,45,63,-18,40
Mattersburg,9240,9,9,7,20,39,70,-31,34
SV Josko Rie,9240,10,10,3,23,33,64,-31,33
Vienna,9241,1,23,5,8,64,42,22,74
FC Salzburg,9241,2,22,7,7,68,29,39,73
SK Sturm Gra,9241,3,19,6,11,61,38,23,63
SC Rheindorf,9241,4,18,7,11,51,45,6,61
Rapid Vienna,9241,5,13,10,13,54,41,13,49
RZ Pellets W,9241,6,11,9,16,41,57,-16,42
Admira Wacke,9241,7,12,5,19,36,59,-23,41
Mattersburg,9241,8,10,7,19,38,56,-18,37
St. Pölten,9241,9,9,9,18,41,59,-18,36
SV Josko Rie,9241,10,8,5,23,27,55,-28,29
SK Sturm Gra,9242,1,22,6,8,62,30,32,72
FC Salzburg,9242,2,21,6,9,65,33,32,69
SC Rheindorf,9242,3,19,8,9,54,36,18,65
Rapid Vienna,9242,4,18,8,10,62,38,24,62
Vienna,9242,5,17,5,14,61,60,1,56
RZ Pellets W,9242,6,12,6,18,46,58,-12,42
Admira Wacke,9242,7,12,6,18,36,52,-16,42
St. Pölten,9242,8,9,10,17,41,65,-24,37
SV Josko Rie,9242,9,7,9,20,32,57,-25,30
Mattersburg,9242,10,8,6,22,33,63,-30,30
FC Salzburg,9243,1,18,11,7,57,27,30,65
SK Sturm Gra,9243,2,19,7,10,50,31,19,64
Vienna,9243,3,19,6,11,63,45,18,63
SC Rheindorf,9243,4,17,10,9,53,47,6,61
Rapid Vienna,9243,5,15,11,10,55,37,18,56
RZ Pellets W,9243,6,13,6,17,46,58,-12,45
St. Pölten,9243,7,9,10,17,41,57,-16,37
Mattersburg,9243,8,9,9,18,36,53,-17,36
SV Josko Rie,9243,9,10,6,20,31,53,-22,36
Admira Wacke,9243,10,9,8,19,31,55,-24,35
FC Salzburg,9244,1,21,6,9,69,34,35,69
SK Sturm Gra,9244,2,21,6,9,65,36,29,69
Vienna,9244,3,21,3,12,72,57,15,66
Rapid Vienna,9244,4,14,13,9,56,35,21,55
SC Rheindorf,9244,5,15,8,13,51,57,-6,53
SV Josko Rie,9244,6,13,5,18,34,47,-13,44
RZ Pellets W,9244,7,11,10,15,43,52,-9,43
Admira Wacke,9244,8,13,3,20,38,65,-27,42
Mattersburg,9244,9,7,11,18,33,51,-18,32
St. Pölten,9244,10,7,9,20,42,69,-27,30
FC Salzburg,9245,1,20,10,6,73,34,39,70
SC Rheindorf,9245,2,19,9,8,48,38,10,66
Vienna,9245,3,17,6,13,59,51,8,57
Rapid Vienna,9245,4,15,11,10,63,42,21,56
SK Sturm Gra,9245,5,15,9,12,54,42,12,54
Admira Wacke,9245,6,13,9,14,42,55,-13,48
Mattersburg,9245,7,10,7,19,41,59,-18,37
RZ Pellets W,9245,8,9,10,17,40,60,-20,37
SV Josko Rie,9245,9,10,7,19,31,51,-20,37
St. Pölten,9245,10,8,10,18,42,61,-19,34
SK Sturm Gra,9246,1,22,4,10,64,30,34,70
SC Rheindorf,9246,2,21,5,10,62,49,13,68
FC Salzburg,9246,3,19,9,8,72,36,36,66
Vienna,9246,4,17,6,13,61,53,8,57
Rapid Vienna,9246,5,12,11,13,52,43,9,47
Admira Wacke,9246,6,13,5,18,33,60,-27,44
St. Pölten,9246,7,11,8,17,43,64,-21,41
SV Josko Rie,9246,8,11,5,20,37,55,-18,38
RZ Pellets W,9246,9,9,10,17,38,54,-16,37
Mattersburg,9246,10,9,9,18,34,52,-18,36
FC Salzburg,9247,1,22,9,5,68,26,42,75
SC Rheindorf,9247,2,17,11,8,50,39,11,62
SK Sturm Gra,9247,3,18,3,15,65,46,19,57
Vienna,9247,4,16,7,13,58,51,7,55
Rapid Vienna,9247,5,15,9,12,58,49,9,54
Mattersburg,9247,6,12,9,15,43,51,-8,45
SV Josko Rie,9247,7,12,6,18,39,52,-13,42
RZ Pellets W,9247,8,11,7,18,42,58,-16,40
Admira Wacke,9247,9,10,9,17,36,61,-25,39
St. Pölten,9247,10,8,8,20,39,65,-26,32
Vienna,9248,1,21,6,9,73,44,29,69
SK Sturm Gra,9248,2,20,7,9,58,32,26,67
FC Salzburg,9248,3,19,9,8,64,34,30,66
SC Rheindorf,9248,4,19,8,9,54,42,12,65
RZ Pellets W,9248,5,14,8,14,50,50,0,50
Rapid Vienna,9248,6,11,13,12,52,46,6,46
SV Josko Rie,9248,7,11,6,19,39,58,-19,39
Admira Wacke,9248,8,10,6,20,36,69,-33,36
St. Pölten,9248,9,8,9,19,39,62,-23,33
Mattersburg,9248,10,7,8,21,30,58,-28,29
FC Salzburg,9249,1,25,5,6,65,26,39,80
SC Rheindorf,9249,2,22,6,8,62,34,28,72
SK Sturm Gra,9249,3,19,5,12,55,39,16,62
Vienna,9249,4,17,9,10,63,51,12,60
Rapid Vienna,9249,5,15,8,13,60,43,17,53
Admira Wacke,9249,6,12,7,17,38,58,-20,43
RZ Pellets W,9249,7,12,6,18,48,65,-17,42
Mattersburg,9249,8,8,8,20,35,59,-24,32
St. Pölten,9249,9,7,10,19,41,67,-26,31
SV Josko Rie,9249,10,8,6,22,33,58,-25,30
FC Salzburg,9250,1,21,7,8,67,31,36,70
Vienna,9250,2,20,4,12,69,50,19,64
SK Sturm Gra,9250,3,17,11,8,51,30,21,62
SC Rheindorf,9250,4,17,9,10,51,40,11,60
RZ Pellets W,9250,5,14,6,16,52,58,-6,48
Rapid Vienna,9250,6,12,11,13,55,47,8,47
Admira Wacke,9250,7,11,7,18,32,55,-23,40
SV Josko Rie,9250,8,11,6,19,33,58,-25,39
Mattersburg,9250,9,9,11,16,37,56,-19,38
St. Pölten,9250,10,8,8,20,38,60,-22,32
FC Salzburg,9251,1,23,9,4,70,28,42,78
SK Sturm Gra,9251,2,21,8,7,59,26,33,71
SC Rheindorf,9251,3,18,9,9,58,49,9,63
Vienna,9251,4,19,4,13,66,50,16,61
Rapid Vienna,9251,5,13,10,13,56,46,10,49
RZ Pellets W,9251,6,12,10,14,47,53,-6,46
St. Pölten,9251,7,11,10,15,45,58,-13,43
Mattersburg,9251,8,8,7,21,35,60,-25,31
Admira Wacke,9251,9,9,4,23,36,74,-38,31
SV Josko Rie,9251,10,9,3,24,32,60,-28,30
FC Salzburg,9252,1,22,8,6,64,28,36,74
SC Rheindorf,9252,2,18,9,9,51,39,12,63
SK Sturm Gra,9252,3,15,11,10,49,30,19,56
Vienna,9252,4,17,5,14,64,60,4,56
Rapid Vienna,9252,5,14,11,11,55,39,16,53
Admira Wacke,9252,6,12,6,18,38,57,-19,42
St. Pölten,9252,7,10,11,15,45,60,-15,41
RZ Pellets W,9252,8,10,10,16,34,47,-13,40
Mattersburg,9252,9,11,7,18,37,55,-18,40
SV Josko Rie,9252,10,8,8,20,36,58,-22,32
Vienna,9253,1,23,4,9,71,43,28,73
FC Salzburg,9253,2,20,7,9,59,32,27,67
SK Sturm Gra,9253,3,19,5,12,58,39,19,62
SC Rheindorf,9253,4,17,8,11,47,41,6,59
Rapid Vienna,9253,5,14,10,12,62,43,19,52
St. Pölten,9253,6,13,8,15,44,55,-11,47
Mattersburg,9253,7,11,8,17,44,59,-15,41
SV Josko Rie,9253,8,10,7,19,34,57,-23,37
RZ Pellets W,9253,9,10,6,20,36,56,-20,36
Admira Wacke,9253,10,7,9,20,32,62,-30,30
FC Salzburg,9254,1,22,6,8,67,36,31,72
SK Sturm Gra,9254,2,20,7,9,58,31,27,67
SC Rheindorf,9254,3,17,8,11,52,42,10,59
Vienna,9254,4,16,7,13,57,55,2,55
Rapid Vienna,9254,5,13,9,14,48,38,10,48
RZ Pellets W,9254,6,13,7,16,46,52,-6,46
Mattersburg,9254,7,12,8,16,46,54,-8,44
St. Pölten,9254,8,10,10,16,42,56,-14,40
SV Josko Rie,9254,9,10,7,19,35,55,-20,37
Admira Wacke,9254,10,10,5,21,34,66,-32,35
SK Sturm Gra,9255,1,23,5,8,74,29,45,74
FC Salzburg,9255,2,21,8,7,69,30,39,71
SC Rheindorf,9255,3,21,5,10,54,40,14,68
Rapid Vienna,9255,4,16,10,10,55,43,12,58
Vienna,9255,5,16,4,16,63,64,-1,52
RZ Pellets W,9255,6,13,7,16,48,60,-12,46
St. Pölten,9255,7,10,8,18,51,67,-16,38
SV Josko Rie,9255,8,11,2,23,32,52,-20,35
Admira Wacke,9255,9,10,5,21,31,62,-31,35
Mattersburg,9255,10,7,10,19,33,63,-30,31
SC Rheindorf,9256,1,19,9,8,58,48,10,66
SK Sturm Gra,9256,2,20,4,12,60,35,25,64
FC Salzburg,9256,3,18,8,10,64,34,30,62
Vienna,9256,4,18,4,14,61,56,5,58
Rapid Vienna,9256,5,12,12,12,56,49,7,48
RZ Pellets W,9256,6,14,6,16,45,49,-4,48
Admira Wacke,9256,7,13,8,15,44,56,-12,47
St. Pölten,9256,8,12,7,17,42,59,-17,43
SV Josko Rie,9256,9,11,7,18,43,58,-15,40
Mattersburg,9256,10,7,7,22,33,62,-29,28
FC Salzburg,9257,1,23,8,5,76,25,51,77
SK Sturm Gra,9257,2,20,6,10,57,33,24,66
SC Rheindorf,9257,3,17,10,9,52,42,10,61
Vienna,9257,4,16,6,14,57,59,-2,54
RZ Pellets W,9257,5,15,5,16,50,52,-2,50
Rapid Vienna,9257,6,12,13,11,56,40,16,49
Admira Wacke,9257,7,11,7,18,37,61,-24,40
Mattersburg,9257,8,10,8,18,38,55,-17,38
SV Josko Rie,9257,9,9,7,20,30,50,-20,34
St. Pölten,9257,10,8,8,20,38,74,-36,32
SC Rheindorf,9258,1,24,5,7,64,38,26,77
FC Salzburg,9258,2,22,6,8,69,35,34,72
Vienna,9258,3,20,4,12,65,51,14,64
SK Sturm Gra,9258,4,17,10,9,55,34,21,61
Rapid Vienna,9258,5,14,11,11,57,42,15,53
RZ Pellets W,9258,6,14,7,15,49,54,-5,49
SV Josko Rie,9258,7,9,8,19,40,57,-17,35
Admira Wacke,9258,8,9,7,20,35,60,-25,34
Mattersburg,9258,9,8,9,19,42,64,-22,33
St. Pölten,9258,10,5,9,22,36,77,-41,24
SK Sturm Gra,9259,1,21,6,9,65,34,31,69
SC Rheindorf,9259,2,18,10,8,56,37,19,64
FC Salzburg,9259,3,17,11,8,59,29,30,62
Rapid Vienna,9259,4,17,8,11,64,41,23,59
Vienna,9259,5,15,8,13,60,55,5,53
Admira Wacke,9259,6,11,10,15,33,51,-18,43
SV Josko Rie,9259,7,10,9,17,29,48,-19,39
RZ Pellets W,9259,8,10,9,17,37,61,-24,39
Mattersburg,9259,9,9,10,17,37,52,-15,37
St. Pölten,9259,10,7,9,20,36,68,-32,30
FC Salzburg,9260,1,20,9,7,60,30,30,69
SC Rheindorf,9260,2,18,8,10,52,41,11,62
Vienna,9260,3,19,4,13,59,50,9,61
Rapid Vienna,9260,4,16,12,8,62,33,29,60
SK Sturm Gra,9260,5,17,6,13,51,36,15,57
RZ Pellets W,9260,6,14,8,14,52,51,1,50
St. Pölten,9260,7,9,11,16,39,61,-22,38
Admira Wacke,9260,8,10,7,19,30,59,-29,37
Mattersburg,9260,9,8,9,19,34,54,-20,33
SV Josko Rie,9260,10,9,6,21,28,52,-24,33
SC Rheindorf,9261,1,22,7,7,64,39,25,73
FC Salzburg,9261,2,20,10,6,68,31,37,70
SK Sturm Gra,9261,3,21,6,9,62,32,30,69
Vienna,9261,4,17,6,13,57,53,4,57
Rapid Vienna,9261,5,12,13,11,54,43,11,49
RZ Pellets W,9261,6,10,9,17,50,65,-15,39
Admira Wacke,9261,7,10,7,19,43,64,-21,37
SV Josko Rie,9261,8,10,7,19,37,59,-22,37
Mattersburg,9261,9,8,10,18,39,57,-18,34
St. Pölten,9261,10,8,9,19,40,71,-31,33
Vienna,9262,1,22,4,10,66,47,19,70
FC Salzburg,9262,2,20,7,9,64,32,32,67
SK Sturm Gra,9262,3,20,6,10,66,38,28,66
SC Rheindorf,9262,4,17,10,9,48,43,5,61
Rapid Vienna,9262,5,13,10,13,52,41,11,49
RZ Pellets W,9262,6,14,6,16,43,48,-5,48
Admira Wacke,9262,7,12,4,20,41,65,-24,40
Mattersburg,9262,8,10,8,18,39,51,-12,38
SV Josko Rie,9262,9,10,6,20,36,59,-23,36
St. Pölten,9262,10,8,7,21,41,72,-31,31
FC Salzburg,9263,1,23,5,8,68,31,37,74
SC Rheindorf,9263,2,20,8,8,57,39,18,68
SK Sturm Gra,9263,3,19,7,10,56,34,22,64
Rapid Vienna,9263,4,17,8,11,61,42,19,59
Vienna,9263,5,17,5,14,66,56,10,56
RZ Pellets W,9263,6,12,5,19,43,59,-16,41
SV Josko Rie,9263,7,11,6,19,38,53,-15,39
St. Pölten,9263,8,10,9,17,45,63,-18,39
Admira Wacke,9263,9,11,6,19,36,66,-30,39
Mattersburg,9263,10,7,7,22,37,64,-27,28
SK Sturm Gra,9264,1,22,7,7,66,28,38,73
Vienna,9264,2,18,8,10,64,50,14,62
SC Rheindorf,9264,3,18,8,10,55,46,9,62
FC Salzburg,9264,4,18,7,11,52,28,24,61
Rapid Vienna,9264,5,15,10,11,59,48,11,55
SV Josko Rie,9264,6,15,5,16,50,52,-2,50
Admira Wacke,9264,7,12,6,18,44,62,-18,42
RZ Pellets W,9264,8,10,7,19,39,60,-21,37
St. Pölten,9264,9,9,8,19,34,62,-28,35
Mattersburg,9264,10,5,10,21,33,60,-27,25
FC Salzburg,9265,1,22,8,6,67,28,39,74
SK Sturm Gra,9265,2,21,6,9,60,29,31,69
Vienna,9265,3,20,4,12,68,55,13,64
Rapid Vienna,9265,4,14,12,10,55,41,14,54
SC Rheindorf,9265,5,14,10,12,53,54,-1,52
RZ Pellets W,9265,6,12,7,17,44,55,-11,43
Mattersburg,9265,7,11,9,16,40,46,-6,42
Admira Wacke,9265,8,10,9,17,35,61,-26,39
SV Josko Rie,9265,9,10,7,19,32,50,-18,37
St. Pölten,9265,10,5,10,21,41,76,-35,25
FC Salzburg,9266,1,21,7,8,68,31,37,70
SC Rheindorf,9266,2,21,6,9,60,46,14,69
Rapid Vienna,9266,3,17,9,10,62,37,25,60
SK Sturm Gra,9266,4,18,5,13,62,41,21,59
RZ Pellets W,9266,5,16,7,13,47,48,-1,55
Vienna,9266,6,15,7,14,60,58,2,52
St. Pölten,9266,7,9,9,18,45,65,-20,36
SV Josko Rie,9266,8,10,5,21,39,60,-21,35
Mattersburg,9266,9,9,8,19,37,60,-23,35
Admira Wacke,9266,10,9,7,20,37,71,-34,34
SK Sturm Gra,9267,1,18,10,8,61,32,29,64
SC Rheindorf,9267,2,18,10,8,49,39,10,64
FC Salzburg,9267,3,17,12,7,63,34,29,63
Vienna,9267,4,18,7,11,68,54,14,61
Admira Wacke,9267,5,14,5,17,47,62,-15,47
Rapid Vienna,9267,6,12,8,16,51,49,2,44
Mattersburg,9267,7,11,7,18,44,56,-12,40
SV Josko Rie,9267,8,11,7,18,40,55,-15,40
RZ Pellets W,9267,9,10,8,18,43,60,-17,38
St. Pölten,9267,10,9,10,17,37,62,-25,37
SC Rheindorf,9268,1,24,4,8,66,42,24,76
FC Salzburg,9268,2,22,7,7,70,30,40,73
SK Sturm Gra,9268,3,19,7,10,55,31,24,64
Vienna,9268,4,18,5,13,62,53,9,59
Rapid Vienna,9268,5,14,11,11,55,38,17,53
RZ Pellets W,9268,6,12,11,13,45,53,-8,47
Admira Wacke,9268,7,12,6,18,34,58,-24,42
St. Pölten,9268,8,7,10,19,39,66,-27,31
SV Josko Rie,9268,9,9,3,24,34,62,-28,30
Mattersburg,9268,10,7,8,21,34,61,-27,29
SC Rheindorf,9269,1,21,6,9,57,41,16,69
FC Salzburg,9269,2,20,6,10,63,30,33,66
SK Sturm Gra,9269,3,19,7,10,56,36,20,64
Vienna,9269,4,20,3,13,63,54,9,63
Rapid Vienna,9269,5,14,10,12,55,41,14,52
RZ Pellets W,9269,6,13,9,14,42,48,-6,48
St. Pölten,9269,7,9,11,16,46,64,-18,38
Admira Wacke,9269,8,10,6,20,35,62,-27,36
SV Josko Rie,9269,9,10,5,21,34,53,-19,35
Mattersburg,9269,10,8,9,19,33,55,-22,33
Vienna,9270,1,23,2,11,75,47,28,71
SC Rheindorf,9270,2,20,9,7,55,38,17,69
SK Sturm Gra,9270,3,20,7,9,65,34,31,67
FC Salzburg,9270,4,17,7,12,55,33,22,58
Rapid Vienna,9270,5,12,12,12,58,44,14,48
RZ Pellets W,9270,6,11,10,15,41,55,-14,43
Mattersburg,9270,7,10,9,17,39,57,-18,39
SV Josko Rie,9270,8,12,3,21,34,57,-23,39
Admira Wacke,9270,9,10,5,21,34,62,-28,35
St. Pölten,9270,10,8,10,18,37,66,-29,34
SK Sturm Gra,9271,1,22,5,9,61,33,28,71
FC Salzburg,9271,2,19,7,10,68,35,33,64
SC Rheindorf,9271,3,19,6,11,54,42,12,63
Vienna,9271,4,17,5,14,56,63,-7,56
Rapid Vienna,9271,5,13,12,11,57,40,17,51
RZ Pellets W,9271,6,14,9,13,48,51,-3,51
Admira Wacke,9271,7,12,5,19,42,61,-19,41
St. Pölten,9271,8,9,11,16,44,57,-13,38
SV Josko Rie,9271,9,10,5,21,31,56,-25,35
Mattersburg,9271,10,9,7,20,32,55,-23,34
FC Salzburg,9272,1,22,9,5,66,24,42,75
Vienna,9272,2,20,3,13,66,51,15,63
SK Sturm Gra,9272,3,19,5,12,50,32,18,62
Rapid Vienna,9272,4,15,12,9,51,35,16,57
SC Rheindorf,9272,5,16,8,12,48,38,10,56
RZ Pellets W,9272,6,15,6,15,47,51,-4,51
St. Pölten,9272,7,10,9,17,45,62,-17,39
Admira Wacke,9272,8,11,6,19,34,64,-30,39
Mattersburg,9272,9,6,13,17,34,53,-19,31
SV Josko Rie,9272,10,9,3,24,31,62,-31,30
FC Salzburg,9273,1,24,7,5,74,28,46,79
SK Sturm Gra,9273,2,22,5,9,66,33,33,71
SC Rheindorf,9273,3,20,10,6,61,41,20,70
Vienna,9273,4,17,5,14,66,59,7,56
Rapid Vienna,9273,5,15,10,11,62,41,21,55
SV Josko Rie,9273,6,13,7,16,44,54,-10,46
RZ Pellets W,9273,7,11,9,16,41,54,-13,42
Admira Wacke,9273,8,9,5,22,35,71,-36,32
St. Pölten,9273,9,6,8,22,36,72,-36,26
Mattersburg,9273,10,5,10,21,26,58,-32,25
FC Salzburg,9274,1,23,7,6,65,24,41,76
SK Sturm Gra,9274,2,21,5,10,64,36,28,68
SC Rheindorf,9274,3,20,6,10,52,38,14,66
Vienna,9274,4,17,7,12,57,49,8,58
Admira Wacke,9274,5,13,8,15,45,58,-13,47
Rapid Vienna,9274,6,10,13,13,49,42,7,43
RZ Pellets W,9274,7,11,8,17,41,58,-17,41
SV Josko Rie,9274,8,10,6,20,28,50,-22,36
St. Pölten,9274,9,8,10,18,38,62,-24,34
Mattersburg,9274,10,8,8,20,40,62,-22,32
SC Rheindorf,9275,1,22,5,9,56,42,14,71
FC Salzburg,9275,2,20,8,8,67,28,39,68
Vienna,9275,3,21,3,12,66,52,14,66
SK Sturm Gra,9275,4,20,4,12,65,38,27,64
Rapid Vienna,9275,5,15,10,11,58,46,12,55
RZ Pellets W,9275,6,14,5,17,45,56,-11,47
Admira Wacke,9275,7,12,4,20,41,67,-26,40
SV Josko Rie,9275,8,11,6,19,35,50,-15,39
St. Pölten,9275,9,8,9,19,40,66,-26,33
Mattersburg,9275,10,5,10,21,33,61,-28,25
SC Rheindorf,9276,1,20,6,10,55,42,13,66
FC Salzburg,9276,2,18,10,8,61,36,25,64
Vienna,9276,3,19,4,13,74,59,15,61
SK Sturm Gra,9276,4,18,3,15,56,42,14,57
Rapid Vienna,9276,5,16,8,12,56,37,19,56
RZ Pellets W,9276,6,15,6,15,52,51,1,51
Admira Wacke,9276,7,14,5,17,37,55,-18,47
SV Josko Rie,9276,8,11,5,20,34,55,-21,38
St. Pölten,9276,9,10,8,18,43,69,-26,38
Mattersburg,9276,10,7,9,20,36,58,-22,30
FC Salzburg,9277,1,24,5,7,64,27,37,77
SK Sturm Gra,9277,2,23,6,7,65,27,38,75
SC Rheindorf,9277,3,17,8,11,50,42,8,59
Vienna,9277,4,18,4,14,54,47,7,58
Rapid Vienna,9277,5,15,8,13,48,36,12,53
RZ Pellets W,9277,6,12,9,15,42,49,-7,45
Admira Wacke,9277,7,9,9,18,35,58,-23,36
Mattersburg,9277,8,9,7,20,35,56,-21,34
St. Pölten,9277,9,8,10,18,43,69,-26,34
SV Josko Rie,9277,10,9,6,21,31,56,-25,33
FC Salzburg,9278,1,19,8,9,63,38,25,65
SC Rheindorf,9278,2,18,9,9,52,40,12,63
Vienna,9278,3,19,6,11,63,52,11,63
Rapid Vienna,9278,4,16,9,11,59,33,26,57
SK Sturm Gra,9278,5,14,10,12,52,37,15,52
Admira Wacke,9278,6,14,6,16,41,54,-13,48
RZ Pellets W,9278,7,13,8,15,44,51,-7,47
St. Pölten,9278,8,10,10,16,43,62,-19,40
SV Josko Rie,9278,9,10,4,22,31,62,-31,34
Mattersburg,9278,10,7,10,19,37,56,-19,31
FC Salzburg,9279,1,22,8,6,67,28,39,74
SK Sturm Gra,9279,2,19,7,10,65,42,23,64
SC Rheindorf,9279,3,19,7,10,53,48,5,64
Vienna,9279,4,18,4,14,71,55,16,58
Rapid Vienna,9279,5,15,12,9,53,35,18,57
RZ Pellets W,9279,6,14,7,15,48,56,-8,49
Admira Wacke,9279,7,12,7,17,38,54,-16,43
SV Josko Rie,9279,8,10,5,21,33,57,-24,35
Mattersburg,9279,9,8,8,20,34,54,-20,32
St. Pölten,9279,10,5,11,20,33,66,-33,26
FC Salzburg,9280,1,22,7,7,69,33,36,73
SK Sturm Gra,9280,2,19,8,9,58,31,27,65
SC Rheindorf,9280,3,18,11,7,53,37,16,65
RZ Pellets W,9280,4,16,6,14,53,52,1,54
Vienna,9280,5,15,3,18,53,58,-5,48
Admira Wacke,9280,6,13,9,14,42,56,-14,48
Rapid Vienna,9280,7,11,11,14,51,46,5,44
SV Josko Rie,9280,8,13,5,18,35,51,-16,44
St. Pölten,9280,9,7,10,19,42,67,-25,31
Mattersburg,9280,10,6,10,20,33,58,-25,28
SK Sturm Gra,9281,1,21,4,11,62,41,21,67
FC Salzburg,9281,2,19,9,8,67,35,32,66
SC Rheindorf,9281,3,18,10,8,53,44,9,64
Vienna,9281,4,18,9,9,61,48,13,63
Rapid Vienna,9281,5,15,12,9,57,40,17,57
RZ Pellets W,9281,6,12,9,15,50,59,-9,45
St. Pölten,9281,7,10,8,18,47,62,-15,38
SV Josko Rie,9281,8,10,7,19,38,54,-16,37
Admira Wacke,9281,9,9,7,20,34,62,-28,34
Mattersburg,9281,10,7,7,22,44,68,-24,28
SK Sturm Gra,9282,1,24,5,7,68,26,42,77
FC Salzburg,9282,2,22,8,6,70,29,41,74
Vienna,9282,3,19,6,11,60,50,10,63
SC Rheindorf,9282,4,16,6,14,49,47,2,54
Rapid Vienna,9282,5,14,8,14,64,48,16,50
RZ Pellets W,9282,6,13,8,15,48,56,-8,47
Admira Wacke,9282,7,14,5,17,40,58,-18,47
St. Pölten,9282,8,8,10,18,38,62,-24,34
SV Josko Rie,9282,9,9,4,23,30,57,-27,31
Mattersburg,9282,10,6,10,20,37,71,-34,28
SC Rheindorf,9283,1,22,6,8,66,41,25,72
FC Salzburg,9283,2,20,9,7,72,33,39,69
SK Sturm Gra,9283,3,21,6,9,66,39,27,69
Vienna,9283,4,20,5,11,70,54,16,65
Rapid Vienna,9283,5,13,11,12,63,44,19,50
RZ Pellets W,9283,6,13,8,15,44,57,-13,47
Admira Wacke,9283,7,11,8,17,38,64,-26,41
SV Josko Rie,9283,8,9,5,22,33,64,-31,32
Mattersburg,9283,9,8,7,21,37,61,-24,31
St. Pölten,9283,10,6,9,21,37,69,-32,27
SC Rheindorf,9284,1,21,8,7,64,37,27,71
SK Sturm Gra,9284,2,19,8,9,58,33,25,65
FC Salzburg,9284,3,18,10,8,62,31,31,64
Vienna,9284,4,16,9,11,63,53,10,57
Rapid Vienna,9284,5,12,12,12,57,47,10,48
Admira Wacke,9284,6,13,8,15,42,56,-14,47
RZ Pellets W,9284,7,12,9,15,48,57,-9,45
Mattersburg,9284,8,10,9,17,40,57,-17,39
SV Josko Rie,9284,9,9,6,21,32,58,-26,33
St. Pölten,9284,10,6,9,21,35,72,-37,27
SC Rheindorf,9285,1,21,8,7,57,36,21,71
FC Salzburg,9285,2,20,9,7,60,31,29,69
SK Sturm Gra,9285,3,19,8,9,59,35,24,65
Vienna,9285,4,17,5,14,58,60,-2,56
Rapid Vienna,9285,5,15,7,14,55,43,12,52
RZ Pellets W,9285,6,12,9,15,47,51,-4,45
Admira Wacke,9285,7,11,8,17,38,55,-17,41
St. Pölten,9285,8,7,15,14,40,56,-16,36
SV Josko Rie,9285,9,10,6,20,34,52,-18,36
Mattersburg,9285,10,7,7,22,28,57,-29,28
FC Salzburg,9286,1,22,5,9,67,28,39,71
SK Sturm Gra,9286,2,20,4,12,64,42,22,64
Vienna,9286,3,19,4,13,68,57,11,61
SC Rheindorf,9286,4,18,7,11,51,42,9,61
Rapid Vienna,9286,5,14,10,12,62,48,14,52
RZ Pellets W,9286,6,13,8,15,42,53,-11,47
Admira Wacke,9286,7,11,6,19,31,56,-25,39
Mattersburg,9286,8,9,11,16,32,48,-16,38
St. Pölten,9286,9,9,10,17,45,63,-18,37
SV Josko Rie,9286,10,9,7,20,31,56,-25,34
FC Salzburg,9287,1,24,6,6,68,27,41,78
SC Rheindorf,9287,2,23,5,8,61,38,23,74
SK Sturm Gra,9287,3,19,8,9,61,31,30,65
Vienna,9287,4,15,8,13,58,59,-1,53
Rapid Vienna,9287,5,13,12,11,54,35,19,51
RZ Pellets W,9287,6,14,7,15,44,50,-6,49
Admira Wacke,9287,7,12,7,17,41,61,-20,43
Mattersburg,9287,8,8,8,20,35,59,-24,32
SV Josko Rie,9287,9,9,3,24,32,61,-29,30
St. Pölten,9287,10,7,8,21,36,69,-33,29
SK Sturm Gra,9288,1,20,7,9,58,32,26,67
Vienna,9288,2,18,7,11,61,52,9,61
SC Rheindorf,9288,3,17,10,9,49,40,9,61
FC Salzburg,9288,4,14,13,9,55,35,20,55
Admira Wacke,9288,5,14,9,13,41,46,-5,51
Rapid Vienna,9288,6,10,16,10,49,38,11,46
SV Josko Rie,9288,7,11,9,16,32,44,-12,42
RZ Pellets W,9288,8,8,12,16,40,58,-18,36
Mattersburg,9288,9,7,13,16,36,49,-13,34
St. Pölten,9288,10,7,12,17,39,66,-27,33
FC Salzburg,9289,1,22,7,7,65,26,39,73
SK Sturm Gra,9289,2,20,8,8,63,34,29,68
Vienna,9289,3,21,4,11,61,42,19,67
SC Rheindorf,9289,4,18,6,12,57,46,11,60
Rapid Vienna,9289,5,13,11,12,59,44,15,50
RZ Pellets W,9289,6,13,7,16,43,51,-8,46
Admira Wacke,9289,7,12,6,18,42,64,-22,42
St. Pölten,9289,8,8,11,17,37,60,-23,35
Mattersburg,9289,9,8,8,20,33,60,-27,32
SV Josko Rie,9289,10,7,8,21,26,59,-33,29
FC Salzburg,9290,1,23,6,7,69,35,34,75
SC Rheindorf,9290,2,22,7,7,63,42,21,73
Rapid Vienna,9290,3,17,10,9,65,41,24,61
SK Sturm Gra,9290,4,18,6,12,54,34,20,60
Vienna,9290,5,17,6,13,71,60,11,57
Admira Wacke,9290,6,12,6,18,42,65,-23,42
RZ Pellets W,9290,7,11,8,17,49,62,-13,41
SV Josko Rie,9290,8,9,6,21,31,55,-24,33
St. Pölten,9290,9,8,8,20,40,70,-30,32
Mattersburg,9290,10,8,7,21,38,58,-20,31
FC Salzburg,9291,1,20,8,8,65,32,33,68
SK Sturm Gra,9291,2,19,5,12,55,29,26,62
Vienna,9291,3,19,5,12,61,45,16,62
SC Rheindorf,9291,4,17,10,9,52,48,4,61
Rapid Vienna,9291,5,13,10,13,50,40,10,49
St. Pölten,9291,6,13,8,15,53,58,-5,47
SV Josko Rie,9291,7,11,7,18,39,54,-15,40
Mattersburg,9291,8,10,9,17,39,58,-19,39
Admira Wacke,9291,9,11,6,19,33,59,-26,39
RZ Pellets W,9291,10,10,6,20,37,61,-24,36
SK Sturm Gra,9292,1,22,7,7,71,30,41,73
FC Salzburg,9292,2,21,9,6,66,27,39,72
SC Rheindorf,9292,3,20,5,11,62,44,18,65
Vienna,9292,4,17,4,15,62,59,3,55
RZ Pellets W,9292,5,14,7,15,49,56,-7,49
Rapid Vienna,9292,6,11,11,14,50,44,6,44
St. Pölten,9292,7,9,10,17,40,64,-24,37
SV Josko Rie,9292,8,9,9,18,35,54,-19,36
Admira Wacke,9292,9,9,9,18,40,73,-33,36
Mattersburg,9292,10,7,11,18,36,60,-24,32
FC Salzburg,9293,1,20,7,9,71,38,33,67
SK Sturm Gra,9293,2,20,7,9,56,34,22,67
Vienna,9293,3,20,5,11,66,50,16,65
SC Rheindorf,9293,4,19,6,11,54,44,10,63
Rapid Vienna,9293,5,15,11,10,56,35,21,56
RZ Pellets W,9293,6,12,6,18,46,57,-11,42
SV Josko Rie,9293,7,12,4,20,37,52,-15,40
Admira Wacke,9293,8,11,7,18,34,58,-24,40
St. Pölten,9293,9,10,6,20,39,67,-28,36
Mattersburg,9293,10,7,9,20,29,53,-24,30
FC Salzburg,9294,1,20,11,5,68,33,35,71
SC Rheindorf,9294,2,19,10,7,59,43,16,67
SK Sturm Gra,9294,3,20,6,10,64,37,27,66
Rapid Vienna,9294,4,17,11,8,66,38,28,62
Vienna,9294,5,16,7,13,63,58,5,55
RZ Pellets W,9294,6,12,7,17,45,56,-11,43
St. Pölten,9294,7,12,7,17,39,57,-18,43
Admira Wacke,9294,8,10,5,21,40,67,-27,35
SV Josko Rie,9294,9,9,5,22,35,62,-27,32
Mattersburg,9294,10,6,9,21,35,63,-28,27
FC Salzburg,9295,1,21,10,5,67,29,38,73
SK Sturm Gra,9295,2,19,6,11,59,35,24,63
SC Rheindorf,9295,3,17,11,8,55,43,12,62
Vienna,9295,4,17,7,12,61,55,6,58
Rapid Vienna,9295,5,14,10,12,60,43,17,52
SV Josko Rie,9295,6,14,4,18,35,48,-13,46
RZ Pellets W,9295,7,12,7,17,45,54,-9,43
Admira Wacke,9295,8,12,7,17,36,57,-21,43
St. Pölten,9295,9,8,8,20,41,67,-26,32
Mattersburg,9295,10,7,8,21,32,60,-28,29
FC Salzburg,9296,1,21,8,7,73,30,43,71
SK Sturm Gra,9296,2,21,5,10,55,33,22,68
SC Rheindorf,9296,3,19,8,9,56,38,18,65
Vienna,9296,4,19,5,12,72,51,21,62
Rapid Vienna,9296,5,13,11,12,50,37,13,50
RZ Pellets W,9296,6,12,9,15,44,51,-7,45
SV Josko Rie,9296,7,12,6,18,44,59,-15,42
Mattersburg,9296,8,8,9,19,44,62,-18,33
Admira Wacke,9296,9,8,9,19,32,71,-39,33
St. Pölten,9296,10,8,8,20,34,72,-38,32
FC Salzburg,9297,1,20,9,7,58,24,34,69
SC Rheindorf,9297,2,19,10,7,58,40,18,67
SK Sturm Gra,9297,3,17,9,10,56,39,17,60
Vienna,9297,4,16,7,13,55,49,6,55
Rapid Vienna,9297,5,13,13,10,46,34,12,52
RZ Pellets W,9297,6,12,8,16,49,56,-7,44
Admira Wacke,9297,7,12,7,17,37,59,-22,43
SV Josko Rie,9297,8,11,6,19,31,50,-19,39
Mattersburg,9297,9,7,12,17,35,50,-15,33
St. Pölten,9297,10,7,11,18,38,62,-24,32
FC Salzburg,9298,1,26,5,5,76,24,52,83
SC Rheindorf,9298,2,18,8,10,50,43,7,62
SK Sturm Gra,9298,3,16,10,10,56,36,20,58
Vienna,9298,4,17,4,15,55,57,-2,55
Rapid Vienna,9298,5,12,15,9,56,39,17,51
RZ Pellets W,9298,6,13,7,16,48,55,-7,46
St. Pölten,9298,7,10,10,16,47,60,-13,40
SV Josko Rie,9298,8,11,5,20,43,65,-22,38
Admira Wacke,9298,9,9,8,19,33,62,-29,35
Mattersburg,9298,10,8,8,20,39,62,-23,32
SC Rheindorf,9299,1,22,6,8,59,39,20,72
FC Salzburg,9299,2,20,9,7,63,32,31,69
SK Sturm Gra,9299,3,18,8,10,55,34,21,62
Vienna,9299,4,19,4,13,61,55,6,61
Rapid Vienna,9299,5,16,9,11,58,36,22,57
Admira Wacke,9299,6,13,5,18,39,61,-22,44
RZ Pellets W,9299,7,11,8,17,45,54,-9,41
SV Josko Rie,9299,8,10,6,20,32,49,-17,36
St. Pölten,9299,9,7,12,17,38,61,-23,33
Mattersburg,9299,10,7,7,22,31,60,-29,28
SC Rheindorf,9300,1,20,9,7,55,41,14,69
SK Sturm Gra,9300,2,20,8,8,65,34,31,68
FC Salzburg,9300,3,19,10,7,68,37,31,67
Vienna,9300,4,17,7,12,64,54,10,58
Rapid Vienna,9300,5,15,10,11,60,42,18,55
Admira Wacke,9300,6,13,5,18,39,60,-21,44
RZ Pellets W,9300,7,11,8,17,47,61,-14,41
St. Pölten,9300,8,8,11,17,41,60,-19,35
SV Josko Rie,9300,9,11,2,23,34,59,-25,35
Mattersburg,9300,10,7,8,21,31,56,-25,29
FC Salzburg,9301,1,22,8,6,72,29,43,74
SC Rheindorf,9301,2,22,6,8,61,40,21,72
SK Sturm Gra,9301,3,19,7,10,54,29,25,64
Rapid Vienna,9301,4,15,11,10,65,44,21,56
Vienna,9301,5,15,7,14,55,54,1,52
RZ Pellets W,9301,6,13,4,19,50,60,-10,43
Admira Wacke,9301,7,12,6,18,39,62,-23,42
SV Josko Rie,9301,8,11,6,19,38,53,-15,39
St. Pölten,9301,9,8,10,18,41,62,-21,34
Mattersburg,9301,10,8,5,23,31,73,-42,29
FC Salzburg,9302,1,23,7,6,71,28,43,76
SK Sturm Gra,9302,2,20,8,8,62,29,33,68
SC Rheindorf,9302,3,20,7,9,58,42,16,67
Rapid Vienna,9302,4,16,11,9,66,40,26,59
Vienna,9302,5,17,6,13,55,49,6,57
RZ Pellets W,9302,6,11,8,17,41,56,-15,41
Admira Wacke,9302,7,12,4,20,33,59,-26,40
SV Josko Rie,9302,8,11,3,22,31,57,-26,36
St. Pölten,9302,9,7,10,19,35,67,-32,31
Mattersburg,9302,10,6,10,20,34,59,-25,28
SK Sturm Gra,9303,1,23,3,10,62,39,23,72
FC Salzburg,9303,2,21,6,9,64,31,33,69
SC Rheindorf,9303,3,19,9,8,61,39,22,66
Vienna,9303,4,18,5,13,66,54,12,59
Rapid Vienna,9303,5,15,9,12,54,37,17,54
Admira Wacke,9303,6,13,6,17,39,57,-18,45
St. Pölten,9303,7,10,8,18,43,60,-17,38
Mattersburg,9303,8,10,6,20,37,60,-23,36
RZ Pellets W,9303,9,9,9,18,35,60,-25,36
SV Josko Rie,9303,10,8,7,21,33,57,-24,31
SC Rheindorf,9304,1,22,7,7,60,39,21,73
FC Salzburg,9304,2,21,7,8,64,31,33,70
SK Sturm Gra,9304,3,19,8,9,56,30,26,65
Vienna,9304,4,17,5,14,61,53,8,56
Rapid Vienna,9304,5,15,10,11,58,37,21,55
RZ Pellets W,9304,6,13,8,15,46,53,-7,47
Admira Wacke,9304,7,12,4,20,37,64,-27,40
SV Josko Rie,9304,8,11,3,22,37,59,-22,36
Mattersburg,9304,9,9,7,20,38,63,-25,34
St. Pölten,9304,10,7,9,20,40,68,-28,30
SC Rheindorf,9305,1,20,8,8,62,44,18,68
FC Salzburg,9305,2,19,8,9,61,28,33,65
SK Sturm Gra,9305,3,20,5,11,62,39,23,65
Vienna,9305,4,19,5,12,63,52,11,62
RZ Pellets W,9305,5,14,5,17,50,58,-8,47
Admira Wacke,9305,6,12,8,16,37,55,-18,44
Rapid Vienna,9305,7,11,9,16,44,42,2,42
Mattersburg,9305,8,11,6,19,38,53,-15,39
SV Josko Rie,9305,9,11,4,21,35,57,-22,37
St. Pölten,9305,10,9,10,17,40,64,-24,37
FC Salzburg,9306,1,20,7,9,59,30,29,67
SC Rheindorf,9306,2,20,5,11,54,41,13,65
SK Sturm Gra,9306,3,19,5,12,54,34,20,62
Vienna,9306,4,19,4,13,60,46,14,61
Rapid Vienna,9306,5,14,10,12,52,39,13,52
RZ Pellets W,9306,6,13,5,18,48,58,-10,44
Admira Wacke,9306,7,13,5,18,38,54,-16,44
SV Josko Rie,9306,8,13,3,20,41,61,-20,42
St. Pölten,9306,9,9,10,17,46,69,-23,37
Mattersburg,9306,10,9,8,19,34,54,-20,35
FC Salzburg,9307,1,22,9,5,64,25,39,75
SK Sturm Gra,9307,2,22,4,10,64,34,30,70
SC Rheindorf,9307,3,20,7,9,56,40,16,67
Vienna,9307,4,18,5,13,59,54,5,59
RZ Pellets W,9307,5,14,5,17,48,62,-14,47
Rapid Vienna,9307,6,11,12,13,48,43,5,45
Admira Wacke,9307,7,12,6,18,43,59,-16,42
Mattersburg,9307,8,9,9,18,41,55,-14,36
SV Josko Rie,9307,9,11,3,22,33,52,-19,36
St. Pölten,9307,10,7,8,21,38,70,-32,29
FC Salzburg,9308,1,21,8,7,68,31,37,71
SK Sturm Gra,9308,2,21,6,9,67,32,35,69
SC Rheindorf,9308,3,20,7,9,54,40,14,67
Rapid Vienna,9308,4,13,11,12,59,45,14,50
Vienna,9308,5,15,4,17,51,59,-8,49
RZ Pellets W,9308,6,14,5,17,51,56,-5,47
SV Josko Rie,9308,7,14,4,18,38,48,-10,46
Admira Wacke,9308,8,12,6,18,34,56,-22,42
Mattersburg,9308,9,10,5,21,44,71,-27,35
St. Pölten,9308,10,8,8,20,38,66,-28,32
FC Salzburg,9309,1,20,9,7,59,26,33,69
SC Rheindorf,9309,2,19,7,10,49,39,10,64
SK Sturm Gra,9309,3,18,9,9,60,37,23,63
Rapid Vienna,9309,4,17,10,9,56,34,22,61
Vienna,9309,5,17,7,12,60,52,8,58
RZ Pellets W,9309,6,12,8,16,49,60,-11,44
SV Josko Rie,9309,7,12,4,20,41,55,-14,40
Admira Wacke,9309,8,9,8,19,32,61,-29,35
St. Pölten,9309,9,8,10,18,42,65,-23,34
Mattersburg,9309,10,6,12,18,34,53,-19,30
FC Salzburg,9310,1,26,4,6,73,25,48,82
SK Sturm Gra,9310,2,20,9,7,68,37,31,69
SC Rheindorf,9310,3,16,10,10,52,45,7,58
Vienna,9310,4,16,5,15,53,51,2,53
Rapid Vienna,9310,5,10,13,13,48,44,4,43
SV Josko Rie,9310,6,12,7,17,36,48,-12,43
RZ Pellets W,9310,7,12,5,19,39,55,-16,41
Admira Wacke,9310,8,12,4,20,36,63,-27,40
Mattersburg,9310,9,10,9,17,38,54,-16,39
St. Pölten,9310,10,8,10,18,40,61,-21,34
SK Sturm Gra,9311,1,21,7,8,64,31,33,70
SC Rheindorf,9311,2,19,8,9,57,45,12,65
FC Salzburg,9311,3,18,10,8,53,25,28,64
Vienna,9311,4,17,7,12,59,46,13,58
Rapid Vienna,9311,5,12,11,13,54,41,13,47
Admira Wacke,9311,6,13,7,16,39,54,-15,46
Mattersburg,9311,7,12,5,19,38,61,-23,41
RZ Pellets W,9311,8,10,9,17,41,58,-17,39
SV Josko Rie,9311,9,11,5,20,34,57,-23,38
St. Pölten,9311,10,9,7,20,44,65,-21,34
SC Rheindorf,9312,1,19,9,8,56,45,11,66
FC Salzburg,9312,2,19,8,9,66,36,30,65
Rapid Vienna,9312,3,17,9,10,64,38,26,60
SK Sturm Gra,9312,4,18,5,13,52,33,19,59
Vienna,9312,5,16,6,14,56,50,6,54
RZ Pellets W,9312,6,14,6,16,44,50,-6,48
Admira Wacke,9312,7,13,7,16,39,54,-15,46
SV Josko Rie,9312,8,10,8,18,34,56,-22,38
Mattersburg,9312,9,8,9,19,36,59,-23,33
St. Pölten,9312,10,8,9,19,38,64,-26,33
SK Sturm Gra,9313,1,21,5,10,63,34,29,68
Vienna,9313,2,19,5,12,61,47,14,62
FC Salzburg,9313,3,17,10,9,62,36,26,61
SC Rheindorf,9313,4,18,6,12,54,52,2,60
Rapid Vienna,9313,5,16,11,9,60,35,25,59
Admira Wacke,9313,6,12,6,18,40,67,-27,42
RZ Pellets W,9313,7,10,11,15,47,60,-13,41
SV Josko Rie,9313,8,12,4,20,42,50,-8,40
St. Pölten,9313,9,8,11,17,42,63,-21,35
Mattersburg,9313,10,9,7,20,34,61,-27,34
FC Salzburg,9314,1,23,6,7,74,29,45,75
SK Sturm Gra,9314,2,18,10,8,57,32,25,64
SC Rheindorf,9314,3,18,9,9,59,48,11,63
Rapid Vienna,9314,4,14,12,10,61,47,14,54
Vienna,9314,5,16,5,15,61,61,0,53
SV Josko Rie,9314,6,15,4,17,41,48,-7,49
Admira Wacke,9314,7,11,7,18,42,68,-26,40
RZ Pellets W,9314,8,9,11,16,46,59,-13,38
Mattersburg,9314,9,8,11,17,38,54,-16,35
St. Pölten,9314,10,5,11,20,43,76,-33,26
SC Rheindorf,9315,1,21,7,8,58,40,18,70
FC Salzburg,9315,2,21,6,9,64,29,35,69
Vienna,9315,3,20,7,9,61,43,18,67
SK Sturm Gra,9315,4,20,5,11,62,37,25,65
Rapid Vienna,9315,5,13,8,15,45,44,1,47
St. Pölten,9315,6,11,9,16,48,62,-14,42
Mattersburg,9315,7,9,11,16,37,54,-17,38
RZ Pellets W,9315,8,9,10,17,45,59,-14,37
Admira Wacke,9315,9,10,7,19,37,62,-25,37
SV Josko Rie,9315,10,9,4,23,34,61,-27,31
FC Salzburg,9316,1,21,7,8,63,30,33,70
Vienna,9316,2,20,5,11,66,54,12,65
SK Sturm Gra,9316,3,17,9,10,55,33,22,60
SC Rheindorf,9316,4,16,11,9,50,43,7,59
Rapid Vienna,9316,5,13,12,11,59,45,14,51
RZ Pellets W,9316,6,11,12,13,42,48,-6,45
Admira Wacke,9316,7,12,7,17,37,57,-20,43
SV Josko Rie,9316,8,12,6,18,34,49,-15,42
Mattersburg,9316,9,8,9,19,37,58,-21,33
St. Pölten,9316,10,8,6,22,40,66,-26,30
SK Sturm Gra,9317,1,21,7,8,69,40,29,70
SC Rheindorf,9317,2,21,5,10,68,48,20,68
FC Salzburg,9317,3,18,12,6,63,33,30,66
Vienna,9317,4,19,6,11,74,49,25,63
Rapid Vienna,9317,5,11,10,15,50,51,-1,43
St. Pölten,9317,6,11,10,15,41,59,-18,43
Admira Wacke,9317,7,11,7,18,35,55,-20,40
RZ Pellets W,9317,8,11,7,18,40,62,-22,40
SV Josko Rie,9317,9,10,5,21,36,57,-21,35
Mattersburg,9317,10,9,7,20,38,60,-22,34
Vienna,9318,1,23,2,11,68,40,28,71
SC Rheindorf,9318,2,20,8,8,57,36,21,68
FC Salzburg,9318,3,20,7,9,55,28,27,67
SK Sturm Gra,9318,4,19,6,11,56,36,20,63
Rapid Vienna,9318,5,14,10,12,53,41,12,52
SV Josko Rie,9318,6,14,6,16,41,49,-8,48
RZ Pellets W,9318,7,9,9,18,39,63,-24,36
Admira Wacke,9318,8,9,8,19,31,60,-29,35
Mattersburg,9318,9,8,10,18,37,53,-16,34
St. Pölten,9318,10,6,10,20,38,69,-31,28
Vienna,9319,1,23,3,10,68,44,24,72
FC Salzburg,9319,2,20,8,8,61,31,30,68
SK Sturm Gra,9319,3,19,9,8,56,29,27,66
SC Rheindorf,9319,4,17,7,12,49,46,3,58
Rapid Vienna,9319,5,13,12,11,54,39,15,51
RZ Pellets W,9319,6,12,7,17,49,59,-10,43
St. Pölten,9319,7,9,10,17,42,60,-18,37
Mattersburg,9319,8,9,10,17,41,60,-19,37
Admira Wacke,9319,9,11,4,21,34,61,-27,37
SV Josko Rie,9319,10,9,6,21,33,58,-25,33
FC Salzburg,9320,1,23,7,6,65,26,39,76
SK Sturm Gra,9320,2,20,8,8,56,30,26,68
SC Rheindorf,9320,3,18,10,8,52,42,10,64
Vienna,9320,4,16,6,14,57,56,1,54
SV Josko Rie,9320,5,14,4,18,41,47,-6,46
RZ Pellets W,9320,6,11,11,14,43,45,-2,44
Rapid Vienna,9320,7,9,13,14,49,44,5,40
Admira Wacke,9320,8,11,6,19,38,60,-22,39
St. Pölten,9320,9,9,10,17,39,63,-24,37
Mattersburg,9320,10,7,9,20,30,57,-27,30
FC Salzburg,9321,1,20,5,11,68,43,25,65
SC Rheindorf,9321,2,18,8,10,52,40,12,62
Rapid Vienna,9321,3,17,10,9,55,33,22,61
Vienna,9321,4,18,7,11,66,51,15,61
SK Sturm Gra,9321,5,17,9,10,55,35,20,60
RZ Pellets W,9321,6,14,7,15,46,51,-5,49
Admira Wacke,9321,7,13,5,18,39,58,-19,44
SV Josko Rie,9321,8,11,8,17,35,53,-18,41
St. Pölten,9321,9,8,9,19,47,69,-22,33
Mattersburg,9321,10,5,10,21,36,66,-30,25
FC Salzburg,9322,1,19,9,8,71,29,42,66
SK Sturm Gra,9322,2,20,6,10,60,37,23,66
SC Rheindorf,9322,3,18,8,10,60,47,13,62
Vienna,9322,4,17,4,15,64,65,-1,55
Rapid Vienna,9322,5,13,12,11,63,46,17,51
RZ Pellets W,9322,6,14,7,15,51,63,-12,49
Admira Wacke,9322,7,12,7,17,40,64,-24,43
Mattersburg,9322,8,10,10,16,43,56,-13,40
St. Pölten,9322,9,9,10,17,44,65,-21,37
SV Josko Rie,9322,10,9,5,22,34,58,-24,32
SC Rheindorf,9323,1,22,6,8,59,37,22,72
FC Salzburg,9323,2,21,8,7,69,38,31,71
Vienna,9323,3,20,5,11,69,51,18,65
SK Sturm Gra,9323,4,19,7,10,56,32,24,64
Rapid Vienna,9323,5,15,9,12,60,40,20,54
RZ Pellets W,9323,6,14,5,17,50,55,-5,47
Admira Wacke,9323,7,12,3,21,36,64,-28,39
St. Pölten,9323,8,8,11,17,43,67,-24,35
Mattersburg,9323,9,8,6,22,31,63,-32,30
SV Josko Rie,9323,10,7,8,21,31,57,-26,29
SK Sturm Gra,9324,1,19,9,8,61,29,32,66
SC Rheindorf,9324,2,19,9,8,58,45,13,66
FC Salzburg,9324,3,19,8,9,59,31,28,65
Rapid Vienna,9324,4,16,10,10,62,39,23,58
Vienna,9324,5,16,4,16,57,56,1,52
RZ Pellets W,9324,6,12,10,14,47,54,-7,46
St. Pölten,9324,7,8,14,14,43,59,-16,38
SV Josko Rie,9324,8,10,6,20,36,57,-21,36
Admira Wacke,9324,9,10,6,20,34,66,-32,36
Mattersburg,9324,10,9,8,19,40,61,-21,35
FC Salzburg,9325,1,22,6,8,67,31,36,72
SC Rheindorf,9325,2,20,9,7,50,37,13,69
Vienna,9325,3,18,6,12,62,54,8,60
SK Sturm Gra,9325,4,16,8,12,54,40,14,56
Rapid Vienna,9325,5,14,9,13,63,44,19,51
RZ Pellets W,9325,6,12,7,17,48,57,-9,43
Admira Wacke,9325,7,11,9,16,43,62,-19,42
SV Josko Rie,9325,8,12,5,19,39,51,-12,41
St. Pölten,9325,9,8,11,17,41,67,-26,35
Mattersburg,9325,10,8,8,20,41,65,-24,32
SC Rheindorf,9326,1,20,9,7,56,40,16,69
SK Sturm Gra,9326,2,20,7,9,55,25,30,67
FC Salzburg,9326,3,19,9,8,60,33,27,66
Vienna,9326,4,18,3,15,66,53,13,57
RZ Pellets W,9326,5,14,8,14,46,51,-5,50
Rapid Vienna,9326,6,13,8,15,52,50,2,47
Admira Wacke,9326,7,12,10,14,43,54,-11,46
St. Pölten,9326,8,8,10,18,44,67,-23,34
Mattersburg,9326,9,8,8,20,37,59,-22,32
SV Josko Rie,9326,10,8,8,20,29,56,-27,32
SK Sturm Gra,9327,1,19,9,8,56,28,28,66
FC Salzburg,9327,2,19,8,9,64,32,32,65
Vienna,9327,3,19,5,12,66,52,14,62
SC Rheindorf,9327,4,18,8,10,53,46,7,62
Rapid Vienna,9327,5,16,11,9,61,35,26,59
RZ Pellets W,9327,6,13,8,15,48,55,-7,47
Admira Wacke,9327,7,14,3,19,41,63,-22,45
Mattersburg,9327,8,9,9,18,34,55,-21,36
St. Pölten,9327,9,7,10,19,38,70,-32,31
SV Josko Rie,9327,10,8,5,23,35,60,-25,29
FC Salzburg,9328,1,22,9,5,70,34,36,75
SC Rheindorf,9328,2,21,8,7,61,37,24,71
SK Sturm Gra,9328,3,16,9,11,66,39,27,57
Rapid Vienna,9328,4,13,14,9,67,45,22,53
Vienna,9328,5,15,5,16,50,53,-3,50
RZ Pellets W,9328,6,13,7,16,50,55,-5,46
Admira Wacke,9328,7,12,6,18,35,60,-25,42
Mattersburg,9328,8,10,8,18,34,58,-24,38
SV Josko Rie,9328,9,10,5,21,35,66,-31,35
St. Pölten,9328,10,7,11,18,42,63,-21,32
FC Salzburg,9329,1,24,7,5,80,28,52,79
SC Rheindorf,9329,2,21,6,9,58,43,15,69
SK Sturm Gra,9329,3,19,8,9,66,43,23,65
Vienna,9329,4,15,6,15,60,62,-2,51
St. Pölten,9329,5,12,10,14,54,64,-10,46
Rapid Vienna,9329,6,11,12,13,58,54,4,45
RZ Pellets W,9329,7,13,5,18,51,59,-8,44
Admira Wacke,9329,8,11,8,17,40,62,-22,41
SV Josko Rie,9329,9,10,5,21,36,59,-23,35
Mattersburg,9329,10,7,7,22,39,68,-29,28
FC Salzburg,9330,1,21,8,7,67,34,33,71
SC Rheindorf,9330,2,21,8,7,59,39,20,71
SK Sturm Gra,9330,3,19,10,7,64,35,29,67
Vienna,9330,4,17,7,12,57,51,6,58
Rapid Vienna,9330,5,16,9,11,59,37,22,57
RZ Pellets W,9330,6,10,13,13,47,52,-5,43
Admira Wacke,9330,7,10,7,19,41,64,-23,37
SV Josko Rie,9330,8,9,6,21,27,56,-29,33
Mattersburg,9330,9,7,9,20,38,58,-20,30
St. Pölten,9330,10,7,9,20,37,70,-33,30
SC Rheindorf,9331,1,21,8,7,54,36,18,71
FC Salzburg,9331,2,20,9,7,63,29,34,69
SK Sturm Gra,9331,3,18,7,11,64,40,24,61
Vienna,9331,4,18,4,14,65,53,12,58
Rapid Vienna,9331,5,16,9,11,62,38,24,57
St. Pölten,9331,6,10,10,16,41,69,-28,40
RZ Pellets W,9331,7,10,8,18,43,61,-18,38
Admira Wacke,9331,8,9,10,17,33,58,-25,37
SV Josko Rie,9331,9,10,6,20,35,56,-21,36
Mattersburg,9331,10,8,9,19,37,57,-20,33
FC Salzburg,9332,1,21,7,8,66,30,36,70
SC Rheindorf,9332,2,20,7,9,59,39,20,67
SK Sturm Gra,9332,3,18,8,10,56,36,20,62
Vienna,9332,4,17,8,11,62,59,3,59
RZ Pellets W,9332,5,17,7,12,60,55,5,58
Rapid Vienna,9332,6,15,9,12,57,43,14,54
SV Josko Rie,9332,7,11,3,22,33,56,-23,36
Admira Wacke,9332,8,9,8,19,30,60,-30,35
Mattersburg,9332,9,8,9,19,40,56,-16,33
St. Pölten,9332,10,7,8,21,35,64,-29,29
FC Salzburg,9333,1,23,9,4,79,27,52,78
SK Sturm Gra,9333,2,21,6,9,61,33,28,69
SC Rheindorf,9333,3,15,12,9,49,48,1,57
Vienna,9333,4,16,6,14,62,62,0,54
Rapid Vienna,9333,5,13,11,12,52,44,8,50
St. Pölten,9333,6,11,8,17,47,58,-11,41
SV Josko Rie,9333,7,10,9,17,38,54,-16,39
RZ Pellets W,9333,8,10,8,18,47,66,-19,38
Mattersburg,9333,9,9,9,18,36,56,-20,36
Admira Wacke,9333,10,8,10,18,34,57,-23,34
FC Salzburg,9334,1,22,5,9,68,30,38,71
SC Rheindorf,9334,2,20,11,5,62,41,21,71
SK Sturm Gra,9334,3,19,8,9,61,35,26,65
Vienna,9334,4,20,5,11,65,50,15,65
Rapid Vienna,9334,5,13,12,11,50,39,11,51
Admira Wacke,9334,6,12,8,16,42,60,-18,44
Mattersburg,9334,7,9,10,17,41,56,-15,37
RZ Pellets W,9334,8,9,8,19,41,66,-25,35
St. Pölten,9334,9,8,8,20,39,63,-24,32
SV Josko Rie,9334,10,7,7,22,33,62,-29,28
SC Rheindorf,9335,1,24,7,5,61,31,30,79
FC Salzburg,9335,2,21,7,8,65,30,35,70
SK Sturm Gra,9335,3,20,7,9,66,36,30,67
Vienna,9335,4,18,4,14,63,61,2,58
Rapid Vienna,9335,5,15,8,13,53,45,8,53
RZ Pellets W,9335,6,11,6,19,45,60,-15,39
SV Josko Rie,9335,7,11,5,20,36,52,-16,38
Admira Wacke,9335,8,10,8,18,39,64,-25,38
Mattersburg,9335,9,10,7,19,37,54,-17,37
St. Pölten,9335,10,6,9,21,38,70,-32,27
SK Sturm Gra,9336,1,23,5,8,69,31,38,74
FC Salzburg,9336,2,21,8,7,70,33,37,71
Vienna,9336,3,20,4,12,61,49,12,64
SC Rheindorf,9336,4,18,7,11,60,55,5,61
Rapid Vienna,9336,5,11,12,13,47,42,5,45
RZ Pellets W,9336,6,12,8,16,40,52,-12,44
Admira Wacke,9336,7,12,7,17,35,53,-18,43
SV Josko Rie,9336,8,9,8,19,30,56,-26,35
Mattersburg,9336,9,8,10,18,32,49,-17,34
St. Pölten,9336,10,7,9,20,43,67,-24,30
FC Salzburg,9337,1,22,6,8,65,30,35,72
SK Sturm Gra,9337,2,21,7,8,65,34,31,70
SC Rheindorf,9337,3,16,10,10,55,49,6,58
Rapid Vienna,9337,4,15,12,9,58,40,18,57
Vienna,9337,5,14,10,12,58,56,2,52
RZ Pellets W,9337,6,12,8,16,46,58,-12,44
SV Josko Rie,9337,7,11,5,20,35,58,-23,38
Admira Wacke,9337,8,10,7,19,37,61,-24,37
St. Pölten,9337,9,8,12,16,43,58,-15,36
Mattersburg,9337,10,9,7,20,42,60,-18,34
SK Sturm Gra,9338,1,23,5,8,66,30,36,74
FC Salzburg,9338,2,19,8,9,61,34,27,65
SC Rheindorf,9338,3,19,8,9,57,45,12,65
Vienna,9338,4,19,3,14,63,53,10,60
Rapid Vienna,9338,5,15,12,9,60,36,24,57
RZ Pellets W,9338,6,12,10,14,51,50,1,46
Admira Wacke,9338,7,11,6,19,35,60,-25,39
SV Josko Rie,9338,8,9,7,20,34,59,-25,34
Mattersburg,9338,9,6,12,18,36,60,-24,30
St. Pölten,9338,10,6,11,19,38,74,-36,29
FC Salzburg,9339,1,21,8,7,67,32,35,71
Vienna,9339,2,19,7,10,64,49,15,64
SC Rheindorf,9339,3,17,11,8,57,43,14,62
SK Sturm Gra,9339,4,17,8,11,56,40,16,59
Rapid Vienna,9339,5,12,14,10,59,46,13,50
RZ Pellets W,9339,6,11,11,14,45,51,-6,44
Admira Wacke,9339,7,12,7,17,44,56,-12,43
SV Josko Rie,9339,8,11,7,18,36,56,-20,40
Mattersburg,9339,9,6,12,18,33,60,-27,30
St. Pölten,9339,10,6,11,19,37,65,-28,29
FC Salzburg,9340,1,22,6,8,65,37,28,72
Vienna,9340,2,21,5,10,66,46,20,68
Rapid Vienna,9340,3,17,9,10,60,35,25,60
SK Sturm Gra,9340,4,18,6,12,52,36,16,60
SC Rheindorf,9340,5,17,9,10,54,45,9,60
Admira Wacke,9340,6,14,7,15,45,55,-10,49
St. Pölten,9340,7,10,9,17,43,61,-18,39
SV Josko Rie,9340,8,11,5,20,34,58,-24,38
Mattersburg,9340,9,8,6,22,37,59,-22,30
RZ Pellets W,9340,10,8,6,22,40,64,-24,30
SC Rheindorf,9341,1,21,7,8,58,45,13,70
Vienna,9341,2,21,4,11,65,49,16,67
FC Salzburg,9341,3,19,9,8,63,27,36,66
SK Sturm Gra,9341,4,19,9,8,66,35,31,66
Admira Wacke,9341,5,14,7,15,44,58,-14,49
Rapid Vienna,9341,6,12,11,13,54,48,6,47
RZ Pellets W,9341,7,12,9,15,46,56,-10,45
Mattersburg,9341,8,9,7,20,36,61,-25,34
St. Pölten,9341,9,6,10,20,41,67,-26,28
SV Josko Rie,9341,10,7,7,22,27,54,-27,28
FC Salzburg,9342,1,19,9,8,63,32,31,66
Vienna,9342,2,20,5,11,70,56,14,65
SC Rheindorf,9342,3,18,9,9,56,46,10,63
SK Sturm Gra,9342,4,17,7,12,55,41,14,58
Rapid Vienna,9342,5,14,11,11,57,43,14,53
Admira Wacke,9342,6,14,7,15,44,51,-7,49
RZ Pellets W,9342,7,12,6,18,52,61,-9,42
Mattersburg,9342,8,9,11,16,41,51,-10,38
SV Josko Rie,9342,9,9,6,21,32,59,-27,33
St. Pölten,9342,10,7,11,18,36,66,-30,32
FC Salzburg,9343,1,23,7,6,66,27,39,76
SK Sturm Gra,9343,2,20,5,11,57,39,18,65
Vienna,9343,3,20,3,13,70,59,11,63
SC Rheindorf,9343,4,17,8,11,52,45,7,59
Rapid Vienna,9343,5,15,10,11,60,37,23,55
St. Pölten,9343,6,10,11,15,45,58,-13,41
RZ Pellets W,9343,7,10,10,16,45,61,-16,40
Admira Wacke,9343,8,11,5,20,36,64,-28,38
Mattersburg,9343,9,9,8,19,40,54,-14,35
SV Josko Rie,9343,10,10,3,23,39,66,-27,33
FC Salzburg,9344,1,22,6,8,68,34,34,72
SC Rheindorf,9344,2,21,6,9,58,40,18,69
SK Sturm Gra,9344,3,17,8,11,50,33,17,59
Vienna,9344,4,18,4,14,60,55,5,58
Rapid Vienna,9344,5,14,10,12,50,44,6,52
Admira Wacke,9344,6,13,5,18,37,52,-15,44
RZ Pellets W,9344,7,11,10,15,41,57,-16,43
SV Josko Rie,9344,8,12,6,18,36,49,-13,42
Mattersburg,9344,9,7,10,19,40,56,-16,31
St. Pölten,9344,10,6,13,17,36,56,-20,31
SC Rheindorf,9345,1,21,7,8,57,36,21,70
SK Sturm Gra,9345,2,20,8,8,59,34,25,68
FC Salzburg,9345,3,20,7,9,63,37,26,67
Rapid Vienna,9345,4,15,9,12,57,37,20,54
Vienna,9345,5,16,6,14,59,55,4,54
Admira Wacke,9345,6,15,7,14,45,54,-9,52
SV Josko Rie,9345,7,12,5,19,43,56,-13,41
Mattersburg,9345,8,9,7,20,35,57,-22,34
St. Pölten,9345,9,8,9,19,37,67,-30,33
RZ Pellets W,9345,10,8,7,21,38,60,-22,31
FC Salzburg,9346,1,21,10,5,69,28,41,73
SC Rheindorf,9346,2,22,5,9,59,40,19,71
SK Sturm Gra,9346,3,21,6,9,58,31,27,69
Vienna,9346,4,17,4,15,62,55,7,55
Rapid Vienna,9346,5,13,11,12,53,41,12,50
SV Josko Rie,9346,6,13,6,17,43,56,-13,45
RZ Pellets W,9346,7,11,8,17,47,57,-10,41
Admira Wacke,9346,8,12,5,19,40,62,-22,41
Mattersburg,9346,9,8,9,19,38,62,-24,33
St. Pölten,9346,10,5,10,21,36,73,-37,25
SC Rheindorf,9347,1,23,5,8,67,33,34,74
Vienna,9347,2,22,3,11,72,50,22,69
FC Salzburg,9347,3,20,7,9,65,33,32,67
Rapid Vienna,9347,4,16,9,11,63,48,15,57
SK Sturm Gra,9347,5,15,9,12,51,38,13,54
RZ Pellets W,9347,6,13,7,16,48,58,-10,46
SV Josko Rie,9347,7,10,7,19,35,58,-23,37
Mattersburg,9347,8,9,8,19,41,59,-18,35
St. Pölten,9347,9,8,9,19,39,70,-31,33
Admira Wacke,9347,10,9,6,21,31,65,-34,33
FC Salzburg,9348,1,23,7,6,69,30,39,76
SK Sturm Gra,9348,2,20,7,9,55,30,25,67
SC Rheindorf,9348,3,19,7,10,54,36,18,64
Vienna,9348,4,18,8,10,57,45,12,62
Rapid Vienna,9348,5,13,11,12,55,45,10,50
Mattersburg,9348,6,12,7,17,47,57,-10,43
RZ Pellets W,9348,7,10,12,14,38,50,-12,42
Admira Wacke,9348,8,11,7,18,34,59,-25,40
St. Pölten,9348,9,6,11,19,38,68,-30,29
SV Josko Rie,9348,10,6,7,23,27,54,-27,25
FC Salzburg,9349,1,20,8,8,63,31,32,68
SK Sturm Gra,9349,2,19,6,11,59,33,26,63
SC Rheindorf,9349,3,17,10,9,54,44,10,61
Vienna,9349,4,16,9,11,60,49,11,57
Rapid Vienna,9349,5,13,11,12,57,43,14,50
RZ Pellets W,9349,6,14,8,14,56,59,-3,50
Admira Wacke,9349,7,12,8,16,38,59,-21,44
SV Josko Rie,9349,8,11,6,19,36,56,-20,39
Mattersburg,9349,9,9,10,17,40,57,-17,37
St. Pölten,9349,10,5,12,19,37,69,-32,27
SC Rheindorf,9350,1,21,9,6,63,40,23,72
FC Salzburg,9350,2,21,8,7,70,35,35,71
Vienna,9350,3,20,4,12,70,59,11,64
SK Sturm Gra,9350,4,18,6,12,53,32,21,60
RZ Pellets W,9350,5,15,8,13,49,47,2,53
Rapid Vienna,9350,6,11,14,11,50,41,9,47
SV Josko Rie,9350,7,11,7,18,37,53,-16,40
Admira Wacke,9350,8,9,7,20,35,64,-29,34
Mattersburg,9350,9,8,8,20,37,59,-22,32
St. Pölten,9350,10,6,9,21,36,70,-34,27
FC Salzburg,9351,1,21,8,7,61,23,38,71
SK Sturm Gra,9351,2,19,5,12,62,39,23,62
Vienna,9351,3,18,7,11,60,46,14,61
SC Rheindorf,9351,4,16,6,14,47,46,1,54
Admira Wacke,9351,5,16,5,15,38,54,-16,53
Rapid Vienna,9351,6,13,10,13,54,42,12,49
St. Pölten,9351,7,11,8,17,46,56,-10,41
SV Josko Rie,9351,8,11,8,17,36,56,-20,41
RZ Pellets W,9351,9,10,9,17,41,55,-14,39
Mattersburg,9351,10,7,10,19,31,59,-28,31
FC Salzburg,9352,1,25,5,6,74,28,46,80
SC Rheindorf,9352,2,19,6,11,54,43,11,63
SK Sturm Gra,9352,3,18,6,12,59,44,15,60
Vienna,9352,4,18,6,12,61,54,7,60
Rapid Vienna,9352,5,15,10,11,55,43,12,55
RZ Pellets W,9352,6,15,7,14,49,46,3,52
Admira Wacke,9352,7,13,6,17,44,61,-17,45
St. Pölten,9352,8,9,8,19,36,63,-27,35
SV Josko Rie,9352,9,10,4,22,36,54,-18,34
Mattersburg,9352,10,5,8,23,33,65,-32,23
FC Salzburg,9353,1,22,7,7,67,29,38,73
SK Sturm Gra,9353,2,19,6,11,60,38,22,63
SC Rheindorf,9353,3,18,9,9,53,40,13,63
Vienna,9353,4,19,4,13,63,60,3,61
Rapid Vienna,9353,5,16,11,9,61,33,28,59
Admira Wacke,9353,6,13,4,19,40,63,-23,43
SV Josko Rie,9353,7,12,5,19,38,52,-14,41
RZ Pellets W,9353,8,10,8,18,38,54,-16,38
St. Pölten,9353,9,9,6,21,37,66,-29,33
Mattersburg,9353,10,8,8,20,32,54,-22,32
Vienna,9354,1,21,5,10,64,42,22,68
SC Rheindorf,9354,2,18,10,8,51,42,9,64
FC Salzburg,9354,3,18,8,10,66,38,28,62
SK Sturm Gra,9354,4,17,7,12,51,35,16,58
Rapid Vienna,9354,5,15,10,11,62,46,16,55
Admira Wacke,9354,6,12,9,15,33,50,-17,45
St. Pölten,9354,7,10,12,14,39,50,-11,42
SV Josko Rie,9354,8,11,5,20,33,53,-20,38
RZ Pellets W,9354,9,9,8,19,36,57,-21,35
Mattersburg,9354,10,7,10,19,35,57,-22,31
FC Salzburg,9355,1,21,8,7,68,30,38,71
SK Sturm Gra,9355,2,21,5,10,61,32,29,68
SC Rheindorf,9355,3,19,8,9,54,40,14,65
Vienna,9355,4,20,3,13,63,53,10,63
Rapid Vienna,9355,5,11,14,11,46,38,8,47
St. Pölten,9355,6,9,13,14,43,57,-14,40
RZ Pellets W,9355,7,11,6,19,43,59,-16,39
SV Josko Rie,9355,8,11,5,20,38,56,-18,38
Mattersburg,9355,9,9,10,17,36,54,-18,37
Admira Wacke,9355,10,9,6,21,31,64,-33,33
FC Salzburg,9356,1,19,10,7,61,29,32,67
SK Sturm Gra,9356,2,20,6,10,61,39,22,66
Vienna,9356,3,18,6,12,66,55,11,60
SC Rheindorf,9356,4,17,7,12,48,46,2,58
Admira Wacke,9356,5,14,5,17,42,54,-12,47
St. Pölten,9356,6,12,9,15,55,59,-4,45
RZ Pellets W,9356,7,12,9,15,50,60,-10,45
Mattersburg,9356,8,11,10,15,45,58,-13,43
Rapid Vienna,9356,9,10,11,15,51,51,0,41
SV Josko Rie,9356,10,8,5,23,28,56,-28,29
FC Salzburg,9357,1,23,6,7,67,26,41,75
SC Rheindorf,9357,2,18,9,9,54,43,11,63
SK Sturm Gra,9357,3,17,7,12,59,41,18,58
Vienna,9357,4,16,7,13,65,54,11,55
Rapid Vienna,9357,5,13,13,10,51,36,15,52
St. Pölten,9357,6,11,10,15,42,58,-16,43
SV Josko Rie,9357,7,12,6,18,38,52,-14,42
Admira Wacke,9357,8,10,9,17,36,55,-19,39
RZ Pellets W,9357,9,11,5,20,44,67,-23,38
Mattersburg,9357,10,10,6,20,43,67,-24,36
FC Salzburg,9358,1,21,8,7,61,30,31,71
SC Rheindorf,9358,2,22,5,9,59,40,19,71
SK Sturm Gra,9358,3,19,8,9,58,28,30,65
Vienna,9358,4,15,10,11,59,49,10,55
Rapid Vienna,9358,5,12,13,11,56,44,12,49
Mattersburg,9358,6,12,8,16,40,54,-14,44
RZ Pellets W,9358,7,12,7,17,46,58,-12,43
Admira Wacke,9358,8,10,8,18,35,53,-18,38
SV Josko Rie,9358,9,10,5,21,29,52,-23,35
St. Pölten,9358,10,6,10,20,33,68,-35,28
FC Salzburg,9359,1,18,10,8,58,36,22,64
SK Sturm Gra,9359,2,19,6,11,63,37,26,63
Vienna,9359,3,18,9,9,69,50,19,63
SC Rheindorf,9359,4,18,9,9,52,37,15,63
Admira Wacke,9359,5,15,6,15,47,54,-7,51
Rapid Vienna,9359,6,12,12,12,50,43,7,48
Mattersburg,9359,7,9,12,15,40,50,-10,39
RZ Pellets W,9359,8,10,7,19,41,58,-17,37
SV Josko Rie,9359,9,11,4,21,34,62,-28,37
St. Pölten,9359,10,8,9,19,40,67,-27,33
FC Salzburg,9360,1,22,7,7,66,26,40,73
SK Sturm Gra,9360,2,21,6,9,58,32,26,69
Vienna,9360,3,21,5,10,68,51,17,68
SC Rheindorf,9360,4,14,12,10,49,43,6,54
Rapid Vienna,9360,5,12,10,14,53,43,10,46
SV Josko Rie,9360,6,11,9,16,32,45,-13,42
RZ Pellets W,9360,7,11,8,17,43,58,-15,41
St. Pölten,9360,8,10,8,18,43,60,-17,38
Mattersburg,9360,9,9,10,17,39,53,-14,37
Admira Wacke,9360,10,8,7,21,28,68,-40,31
FC Salzburg,9361,1,23,7,6,70,27,43,76
SC Rheindorf,9361,2,21,5,10,57,42,15,68
SK Sturm Gra,9361,3,20,5,11,63,33,30,65
Vienna,9361,4,17,6,13,61,54,7,57
Rapid Vienna,9361,5,13,11,12,55,45,10,50
SV Josko Rie,9361,6,12,4,20,32,55,-23,40
Admira Wacke,9361,7,11,6,19,37,63,-26,39
Mattersburg,9361,8,9,10,17,40,57,-17,37
RZ Pellets W,9361,9,8,11,17,45,63,-18,35
St. Pölten,9361,10,8,11,17,42,63,-21,35
FC Salzburg,9362,1,23,6,7,68,28,40,75
SK Sturm Gra,9362,2,21,7,8,58,26,32,70
SC Rheindorf,9362,3,18,8,10,53,46,7,62
Vienna,9362,4,18,6,12,70,53,17,60
Rapid Vienna,9362,5,12,9,15,51,46,5,45
RZ Pellets W,9362,6,12,6,18,41,52,-11,42
Admira Wacke,9362,7,11,8,17,39,60,-21,41
SV Josko Rie,9362,8,11,7,18,31,55,-24,40
Mattersburg,9362,9,8,10,18,37,54,-17,34
St. Pölten,9362,10,9,7,20,36,64,-28,34
FC Salzburg,9363,1,20,10,6,66,34,32,70
SK Sturm Gra,9363,2,20,7,9,63,36,27,67
SC Rheindorf,9363,3,18,7,11,56,48,8,61
Vienna,9363,4,16,7,13,60,51,9,55
Rapid Vienna,9363,5,15,9,12,58,45,13,54
RZ Pellets W,9363,6,12,8,16,46,55,-9,44
SV Josko Rie,9363,7,12,8,16,41,51,-10,44
Admira Wacke,9363,8,10,8,18,34,59,-25,38
Mattersburg,9363,9,9,9,18,37,53,-16,36
St. Pölten,9363,10,7,9,20,36,65,-29,30
SK Sturm Gra,9364,1,21,7,8,62,33,29,70
FC Salzburg,9364,2,20,8,8,63,32,31,68
SC Rheindorf,9364,3,18,10,8,56,46,10,64
Vienna,9364,4,18,9,9,64,47,17,63
RZ Pellets W,9364,5,13,7,16,51,60,-9,46
SV Josko Rie,9364,6,12,9,15,44,52,-8,45
Rapid Vienna,9364,7,10,14,12,50,44,6,44
Mattersburg,9364,8,9,7,20,38,56,-18,34
Admira Wacke,9364,9,8,7,21,41,70,-29,31
St. Pölten,9364,10,7,10,19,39,68,-29,31
FC Salzburg,9365,1,21,8,7,65,28,37,71
SK Sturm Gra,9365,2,19,8,9,61,36,25,65
SC Rheindorf,9365,3,18,8,10,52,44,8,62
Vienna,9365,4,18,6,12,64,54,10,60
RZ Pellets W,9365,5,16,5,15,55,53,2,53
Rapid Vienna,9365,6,12,13,11,58,38,20,49
St. Pölten,9365,7,11,8,17,35,53,-18,41
Admira Wacke,9365,8,11,4,21,31,67,-36,37
SV Josko Rie,9365,9,10,5,21,34,57,-23,35
Mattersburg,9365,10,6,11,19,30,55,-25,29
FC Salzburg,9366,1,21,10,5,66,25,41,73
SK Sturm Gra,9366,2,21,5,10,64,33,31,68
SC Rheindorf,9366,3,20,8,8,64,40,24,68
Rapid Vienna,9366,4,15,11,10,58,41,17,56
Vienna,9366,5,17,4,15,62,66,-4,55
RZ Pellets W,9366,6,11,9,16,45,57,-12,42
Admira Wacke,9366,7,9,10,17,36,62,-26,37
Mattersburg,9366,8,9,8,19,37,52,-15,35
SV Josko Rie,9366,9,10,5,21,30,56,-26,35
St. Pölten,9366,10,5,14,17,35,65,-30,29
FC Salzburg,9367,1,22,8,6,64,24,40,74
SK Sturm Gra,9367,2,20,6,10,60,37,23,66
SC Rheindorf,9367,3,17,8,11,60,48,12,59
Vienna,9367,4,18,4,14,60,51,9,58
Rapid Vienna,9367,5,14,11,11,65,47,18,53
RZ Pellets W,9367,6,14,7,15,50,58,-8,49
SV Josko Rie,9367,7,12,5,19,37,57,-20,41
Mattersburg,9367,8,9,10,17,40,58,-18,37
Admira Wacke,9367,9,9,8,19,36,65,-29,35
St. Pölten,9367,10,7,9,20,46,73,-27,30
FC Salzburg,9368,1,22,8,6,68,30,38,74
SC Rheindorf,9368,2,18,7,11,53,42,11,61
Rapid Vienna,9368,3,16,11,9,61,38,23,59
Vienna,9368,4,18,4,14,62,53,9,58
SK Sturm Gra,9368,5,16,8,12,51,35,16,56
Admira Wacke,9368,6,13,6,17,40,57,-17,45
RZ Pellets W,9368,7,11,7,18,39,60,-21,40
St. Pölten,9368,8,10,8,18,43,63,-20,38
Mattersburg,9368,9,9,9,18,40,59,-19,36
SV Josko Rie,9368,10,9,8,19,30,50,-20,35
FC Salzburg,9369,1,25,5,6,77,27,50,80
SC Rheindorf,9369,2,19,7,10,52,45,7,64
Rapid Vienna,9369,3,17,10,9,57,34,23,61
SK Sturm Gra,9369,4,17,9,10,57,36,21,60
Vienna,9369,5,17,7,12,63,56,7,58
RZ Pellets W,9369,6,12,9,15,50,54,-4,45
Mattersburg,9369,7,10,8,18,39,58,-19,38
Admira Wacke,9369,8,10,6,20,32,57,-25,36
SV Josko Rie,9369,9,10,5,21,31,50,-19,35
St. Pölten,9369,10,5,10,21,35,76,-41,25
FC Salzburg,9370,1,25,7,4,71,22,49,82
SK Sturm Gra,9370,2,20,6,10,60,32,28,66
SC Rheindorf,9370,3,18,7,11,56,49,7,61
Vienna,9370,4,15,6,15,56,59,-3,51
Rapid Vienna,9370,5,11,15,10,55,41,14,48
RZ Pellets W,9370,6,13,6,17,46,56,-10,45
Mattersburg,9370,7,11,9,16,45,52,-7,42
SV Josko Rie,9370,8,11,6,19,34,48,-14,39
St. Pölten,9370,9,9,9,18,39,66,-27,36
Admira Wacke,9370,10,8,7,21,30,67,-37,31
FC Salzburg,9371,1,22,7,7,63,29,34,73
Vienna,9371,2,21,5,10,69,52,17,68
SC Rheindorf,9371,3,18,8,10,52,40,12,62
SK Sturm Gra,9371,4,18,7,11,62,37,25,61
Rapid Vienna,9371,5,16,8,12,55,40,15,56
RZ Pellets W,9371,6,12,8,16,48,54,-6,44
Mattersburg,9371,7,11,8,17,41,55,-14,41
Admira Wacke,9371,8,10,5,21,32,58,-26,35
SV Josko Rie,9371,9,10,4,22,37,60,-23,34
St. Pölten,9371,10,6,12,18,37,71,-34,30
FC Salzburg,9372,1,22,7,7,64,29,35,73
SC Rheindorf,9372,2,20,7,9,56,40,16,67
SK Sturm Gra,9372,3,20,5,11,62,37,25,65
Rapid Vienna,9372,4,15,13,8,62,36,26,58
Vienna,9372,5,16,5,15,62,60,2,53
RZ Pellets W,9372,6,12,8,16,48,56,-8,44
St. Pölten,9372,7,11,7,18,46,62,-16,40
Mattersburg,9372,8,10,7,19,41,59,-18,37
Admira Wacke,9372,9,10,6,20,29,62,-33,36
SV Josko Rie,9372,10,9,5,22,27,56,-29,32
FC Salzburg,9373,1,20,6,10,58,29,29,66
Vienna,9373,2,20,4,12,62,51,11,64
SK Sturm Gra,9373,3,18,9,9,57,34,23,63
SC Rheindorf,9373,4,18,9,9,49,35,14,63
Rapid Vienna,9373,5,13,12,11,52,36,16,51
RZ Pellets W,9373,6,13,9,14,49,54,-5,48
SV Josko Rie,9373,7,10,9,17,32,48,-16,39
St. Pölten,9373,8,8,12,16,34,54,-20,36
Admira Wacke,9373,9,10,6,20,35,63,-28,36
Mattersburg,9373,10,8,8,20,32,56,-24,32
FC Salzburg,9374,1,23,4,9,58,29,29,73
SK Sturm Gra,9374,2,19,8,9,59,33,26,65
SC Rheindorf,9374,3,19,8,9,55,44,11,65
Vienna,9374,4,18,6,12,64,51,13,60
Rapid Vienna,9374,5,12,12,12,49,41,8,48
SV Josko Rie,9374,6,13,5,18,41,51,-10,44
Mattersburg,9374,7,11,9,16,40,49,-9,42
Admira Wacke,9374,8,11,7,18,32,59,-27,40
RZ Pellets W,9374,9,8,8,20,39,59,-20,32
St. Pölten,9374,10,7,11,18,41,62,-21,32
FC Salzburg,9375,1,20,7,9,66,37,29,67
SK Sturm Gra,9375,2,19,9,8,53,28,25,66
SC Rheindorf,9375,3,20,6,10,62,43,19,66
Vienna,9375,4,17,3,16,60,57,3,54
Rapid Vienna,9375,5,14,10,12,54,41,13,52
SV Josko Rie,9375,6,14,4,18,39,52,-13,46
Admira Wacke,9375,7,12,6,18,36,56,-20,42
RZ Pellets W,9375,8,11,7,18,42,56,-14,40
Mattersburg,9375,9,9,9,18,37,54,-17,36
St. Pölten,9375,10,8,11,17,35,60,-25,35
FC Salzburg,9376,1,23,8,5,74,28,46,77
SK Sturm Gra,9376,2,21,8,7,65,31,34,71
SC Rheindorf,9376,3,18,11,7,58,40,18,65
Vienna,9376,4,15,6,15,56,55,1,51
Rapid Vienna,9376,5,13,10,13,56,42,14,49
RZ Pellets W,9376,6,13,7,16,43,56,-13,46
St. Pölten,9376,7,11,8,17,42,62,-20,41
Admira Wacke,9376,8,10,7,19,38,65,-27,37
SV Josko Rie,9376,9,9,6,21,29,55,-26,33
Mattersburg,9376,10,7,9,20,35,62,-27,30
FC Salzburg,9377,1,19,7,10,59,34,25,64
SC Rheindorf,9377,2,18,10,8,57,44,13,64
SK Sturm Gra,9377,3,17,10,9,59,35,24,61
Rapid Vienna,9377,4,15,11,10,57,39,18,56
Vienna,9377,5,16,8,12,56,51,5,56
RZ Pellets W,9377,6,14,9,13,51,55,-4,51
Admira Wacke,9377,7,10,10,16,39,56,-17,40
SV Josko Rie,9377,8,11,6,19,46,60,-14,39
St. Pölten,9377,9,9,10,17,43,66,-23,37
Mattersburg,9377,10,5,11,20,29,56,-27,26
Vienna,9378,1,23,3,10,66,46,20,72
FC Salzburg,9378,2,21,5,10,65,31,34,68
SC Rheindorf,9378,3,19,9,8,61,50,11,66
SK Sturm Gra,9378,4,18,6,12,56,36,20,60
Rapid Vienna,9378,5,12,11,13,53,43,10,47
RZ Pellets W,9378,6,12,8,16,46,55,-9,44
Mattersburg,9378,7,12,6,18,36,55,-19,42
Admira Wacke,9378,8,12,5,19,37,58,-21,41
St. Pölten,9378,9,9,8,19,44,64,-20,35
SV Josko Rie,9378,10,9,5,22,33,59,-26,32
FC Salzburg,9379,1,24,6,6,67,30,37,78
SK Sturm Gra,9379,2,20,6,10,59,30,29,66
SC Rheindorf,9379,3,19,9,8,53,40,13,66
Vienna,9379,4,18,6,12,64,48,16,60
Rapid Vienna,9379,5,14,10,12,57,43,14,52
RZ Pellets W,9379,6,13,6,17,44,59,-15,45
Admira Wacke,9379,7,11,6,19,34,60,-26,39
St. Pölten,9379,8,9,9,18,41,60,-19,36
Mattersburg,9379,9,8,9,19,34,60,-26,33
SV Josko Rie,9379,10,7,7,22,27,50,-23,28
FC Salzburg,9380,1,24,6,6,75,30,45,78
SC Rheindorf,9380,2,23,8,5,61,31,30,77
SK Sturm Gra,9380,3,20,6,10,60,33,27,66
Rapid Vienna,9380,4,16,9,11,53,40,13,57
Vienna,9380,5,17,6,13,60,53,7,57
RZ Pellets W,9380,6,11,7,18,46,56,-10,40
St. Pölten,9380,7,10,9,17,38,59,-21,39
Admira Wacke,9380,8,11,4,21,39,64,-25,37
SV Josko Rie,9380,9,9,4,23,27,55,-28,31
Mattersburg,9380,10,7,5,24,30,68,-38,26
FC Salzburg,9381,1,21,8,7,68,28,40,71
SK Sturm Gra,9381,2,20,7,9,61,34,27,67
SC Rheindorf,9381,3,17,8,11,58,50,8,59
Rapid Vienna,9381,4,15,8,13,59,46,13,53
Vienna,9381,5,15,7,14,62,62,0,52
RZ Pellets W,9381,6,14,8,14,51,56,-5,50
St. Pölten,9381,7,11,9,16,42,56,-14,42
Admira Wacke,9381,8,12,6,18,41,60,-19,42
SV Josko Rie,9381,9,12,3,21,34,54,-20,39
Mattersburg,9381,10,7,8,21,31,61,-30,29
FC Salzburg,9382,1,21,8,7,67,29,38,71
SK Sturm Gra,9382,2,21,6,9,57,31,26,69
SC Rheindorf,9382,3,19,7,10,56,42,14,64
Vienna,9382,4,20,4,12,64,52,12,64
Rapid Vienna,9382,5,12,11,13,50,39,11,47
RZ Pellets W,9382,6,12,9,15,40,45,-5,45
Admira Wacke,9382,7,13,6,17,34,56,-22,45
St. Pölten,9382,8,9,10,17,38,63,-25,37
SV Josko Rie,9382,9,8,6,22,34,59,-25,30
Mattersburg,9382,10,6,11,19,31,55,-24,29
FC Salzburg,9383,1,21,8,7,66,32,34,71
SK Sturm Gra,9383,2,18,9,9,58,32,26,63
SC Rheindorf,9383,3,19,6,11,49,48,1,63
RZ Pellets W,9383,4,17,5,14,55,52,3,56
Vienna,9383,5,17,5,14,54,54,0,56
Rapid Vienna,9383,6,15,10,11,59,42,17,55
Mattersburg,9383,7,11,8,17,49,58,-9,41
Admira Wacke,9383,8,11,4,21,39,64,-25,37
SV Josko Rie,9383,9,10,5,21,37,57,-20,35
St. Pölten,9383,10,6,10,20,38,65,-27,28
SK Sturm Gra,9384,1,22,6,8,66,33,33,72
FC Salzburg,9384,2,21,7,8,66,35,31,70
SC Rheindorf,9384,3,19,6,11,58,42,16,63
Vienna,9384,4,18,4,14,71,62,9,58
Rapid Vienna,9384,5,16,9,11,63,44,19,57
RZ Pellets W,9384,6,14,5,17,46,55,-9,47
Admira Wacke,9384,7,12,6,18,40,65,-25,42
SV Josko Rie,9384,8,11,4,21,36,57,-21,37
St. Pölten,9384,9,9,7,20,43,73,-30,34
Mattersburg,9384,10,8,6,22,43,66,-23,30
FC Salzburg,9385,1,24,6,6,67,26,41,78
SC Rheindorf,9385,2,19,7,10,53,39,14,64
Vienna,9385,3,19,6,11,65,48,17,63
SK Sturm Gra,9385,4,15,8,13,51,45,6,53
RZ Pellets W,9385,5,15,8,13,51,52,-1,53
Rapid Vienna,9385,6,12,11,13,55,51,4,47
Admira Wacke,9385,7,12,10,14,43,56,-13,46
Mattersburg,9385,8,10,10,16,41,57,-16,40
SV Josko Rie,9385,9,8,6,22,30,56,-26,30
St. Pölten,9385,10,6,8,22,41,67,-26,26
FC Salzburg,9386,1,21,9,6,61,26,35,72
SC Rheindorf,9386,2,19,8,9,52,35,17,65
SK Sturm Gra,9386,3,15,12,9,51,33,18,57
Vienna,9386,4,17,6,13,58,53,5,57
Rapid Vienna,9386,5,13,10,13,52,41,11,49
RZ Pellets W,9386,6,14,6,16,45,53,-8,48
SV Josko Rie,9386,7,12,6,18,36,49,-13,42
Admira Wacke,9386,8,11,7,18,35,57,-22,40
St. Pölten,9386,9,10,8,18,41,61,-20,38
Mattersburg,9386,10,7,10,19,33,56,-23,31
FC Salzburg,9387,1,21,7,8,70,33,37,70
SK Sturm Gra,9387,2,21,7,8,64,29,35,70
SC Rheindorf,9387,3,21,6,9,57,42,15,69
Vienna,9387,4,19,5,12,62,51,11,62
Rapid Vienna,9387,5,16,8,12,60,44,16,56
Admira Wacke,9387,6,13,6,17,35,61,-26,45
RZ Pellets W,9387,7,13,5,18,52,61,-9,44
SV Josko Rie,9387,8,9,5,22,35,63,-28,32
St. Pölten,9387,9,6,11,19,38,63,-25,29
Mattersburg,9387,10,7,8,21,33,59,-26,29
FC Salzburg,9388,1,21,10,5,66,28,38,73
SK Sturm Gra,9388,2,22,5,9,69,38,31,71
Vienna,9388,3,18,4,14,62,55,7,58
SC Rheindorf,9388,4,15,10,11,51,45,6,55
Rapid Vienna,9388,5,11,14,11,66,55,11,47
RZ Pellets W,9388,6,12,9,15,52,60,-8,45
St. Pölten,9388,7,10,10,16,41,59,-18,40
Admira Wacke,9388,8,9,11,16,41,62,-21,38
SV Josko Rie,9388,9,10,6,20,30,51,-21,36
Mattersburg,9388,10,6,13,17,35,60,-25,31
SC Rheindorf,9389,1,22,7,7,61,42,19,73
SK Sturm Gra,9389,2,20,6,10,68,37,31,66
FC Salzburg,9389,3,19,8,9,61,34,27,65
Vienna,9389,4,17,5,14,61,62,-1,56
RZ Pellets W,9389,5,12,10,14,55,55,0,46
Admira Wacke,9389,6,13,7,16,38,56,-18,46
Rapid Vienna,9389,7,12,9,15,55,49,6,45
Mattersburg,9389,8,8,13,15,43,55,-12,37
SV Josko Rie,9389,9,8,8,20,34,61,-27,32
St. Pölten,9389,10,6,13,17,43,68,-25,31
SK Sturm Gra,9390,1,22,5,9,71,39,32,71
SC Rheindorf,9390,2,21,7,8,61,43,18,70
FC Salzburg,9390,3,20,9,7,63,33,30,69
Rapid Vienna,9390,4,15,10,11,59,44,15,55
Vienna,9390,5,17,4,15,62,59,3,55
Admira Wacke,9390,6,12,5,19,40,58,-18,41
SV Josko Rie,9390,7,11,7,18,39,56,-17,40
RZ Pellets W,9390,8,9,11,16,49,61,-12,38
Mattersburg,9390,9,8,10,18,44,60,-16,34
St. Pölten,9390,10,7,8,21,37,72,-35,29
FC Salzburg,9391,1,21,9,6,68,29,39,72
SK Sturm Gra,9391,2,20,5,11,65,39,26,65
SC Rheindorf,9391,3,19,8,9,53,39,14,65
Vienna,9391,4,19,5,12,62,48,14,62
Rapid Vienna,9391,5,14,12,10,52,37,15,54
Admira Wacke,9391,6,13,5,18,35,63,-28,44
RZ Pellets W,9391,7,11,9,16,49,58,-9,42
St. Pölten,9391,8,7,12,17,40,63,-23,33
SV Josko Rie,9391,9,8,8,20,28,53,-25,32
Mattersburg,9391,10,6,11,19,37,60,-23,29
FC Salzburg,9392,1,24,4,8,64,28,36,76
SC Rheindorf,9392,2,21,6,9,53,36,17,69
Vienna,9392,3,20,5,11,67,48,19,65
SK Sturm Gra,9392,4,18,7,11,55,34,21,61
Rapid Vienna,9392,5,14,10,12,64,42,22,52
RZ Pellets W,9392,6,10,10,16,40,52,-12,40
St. Pölten,9392,7,10,8,18,44,65,-21,38
Admira Wacke,9392,8,11,5,20,32,61,-29,38
Mattersburg,9392,9,9,8,19,35,62,-27,35
SV Josko Rie,9392,10,9,5,22,35,61,-26,32
SC Rheindorf,9393,1,21,5,10,55,43,12,68
FC Salzburg,9393,2,19,8,9,63,35,28,65
Rapid Vienna,9393,3,18,10,8,67,32,35,64
SK Sturm Gra,9393,4,19,6,11,51,34,17,63
Vienna,9393,5,15,8,13,62,54,8,53
RZ Pellets W,9393,6,12,8,16,44,56,-12,44
Admira Wacke,9393,7,12,6,18,40,60,-20,42
SV Josko Rie,9393,8,11,6,19,33,53,-20,39
Mattersburg,9393,9,9,7,20,31,51,-20,34
St. Pölten,9393,10,7,10,19,39,67,-28,31
FC Salzburg,9394,1,22,8,6,68,32,36,74
SK Sturm Gra,9394,2,20,8,8,63,35,28,68
SC Rheindorf,9394,3,18,8,10,62,43,19,62
Vienna,9394,4,18,3,15,64,56,8,57
Rapid Vienna,9394,5,15,8,13,54,40,14,53
Admira Wacke,9394,6,14,6,16,46,66,-20,48
St. Pölten,9394,7,11,7,18,37,57,-20,40
Mattersburg,9394,8,10,9,17,42,58,-16,39
RZ Pellets W,9394,9,10,7,19,41,63,-22,37
SV Josko Rie,9394,10,9,2,25,43,70,-27,29
SC Rheindorf,9395,1,22,6,8,67,44,23,72
SK Sturm Gra,9395,2,22,5,9,67,35,32,71
FC Salzburg,9395,3,22,4,10,73,35,38,70
Vienna,9395,4,18,5,13,63,54,9,59
RZ Pellets W,9395,5,13,11,12,48,49,-1,50
Rapid Vienna,9395,6,13,8,15,52,48,4,47
St. Pölten,9395,7,9,11,16,40,63,-23,38
SV Josko Rie,9395,8,10,6,20,33,55,-22,36
Admira Wacke,9395,9,10,6,20,38,64,-26,36
Mattersburg,9395,10,6,8,22,30,64,-34,26
FC Salzburg,9396,1,20,9,7,57,26,31,69
Vienna,9396,2,19,6,11,57,45,12,63
SK Sturm Gra,9396,3,18,7,11,58,40,18,61
SC Rheindorf,9396,4,17,8,11,52,45,7,59
Rapid Vienna,9396,5,11,12,13,49,40,9,45
SV Josko Rie,9396,6,13,6,17,36,46,-10,45
Mattersburg,9396,7,12,8,16,33,47,-14,44
Admira Wacke,9396,8,11,7,18,35,54,-19,40
RZ Pellets W,9396,9,9,10,17,42,56,-14,37
St. Pölten,9396,10,6,15,15,38,58,-20,33
Vienna,9397,1,21,6,9,70,48,22,69
SK Sturm Gra,9397,2,20,7,9,60,32,28,67
SC Rheindorf,9397,3,19,8,9,57,46,11,65
FC Salzburg,9397,4,18,9,9,58,32,26,63
Rapid Vienna,9397,5,16,10,10,58,42,16,58
RZ Pellets W,9397,6,11,7,18,40,56,-16,40
St. Pölten,9397,7,10,8,18,44,61,-17,38
Admira Wacke,9397,8,10,7,19,40,67,-27,37
SV Josko Rie,9397,9,9,6,21,36,56,-20,33
Mattersburg,9397,10,7,10,19,39,62,-23,31
FC Salzburg,9398,1,22,6,8,65,30,35,72
SC Rheindorf,9398,2,21,7,8,70,45,25,70
SK Sturm Gra,9398,3,19,7,10,59,36,23,64
Vienna,9398,4,18,6,12,62,50,12,60
Rapid Vienna,9398,5,13,10,13,58,43,15,49
Admira Wacke,9398,6,12,8,16,45,61,-16,44
RZ Pellets W,9398,7,11,7,18,43,59,-16,40
SV Josko Rie,9398,8,10,7,19,37,56,-19,37
St. Pölten,9398,9,9,9,18,41,67,-26,36
Mattersburg,9398,10,5,13,18,34,67,-33,28
SC Rheindorf,9399,1,21,7,8,59,38,21,70
FC Salzburg,9399,2,21,6,9,63,36,27,69
Vienna,9399,3,19,5,12,59,46,13,62
SK Sturm Gra,9399,4,16,10,10,59,42,17,58
RZ Pellets W,9399,5,14,7,15,49,56,-7,49
Rapid Vienna,9399,6,12,10,14,52,45,7,46
Admira Wacke,9399,7,11,8,17,37,57,-20,41
SV Josko Rie,9399,8,10,7,19,33,50,-17,37
St. Pölten,9399,9,8,12,16,37,55,-18,36
Mattersburg,9399,10,8,8,20,34,57,-23,32
SK Sturm Gra,9400,1,23,4,9,66,31,35,73
FC Salzburg,9400,2,20,10,6,61,25,36,70
SC Rheindorf,9400,3,19,7,10,51,40,11,64
Vienna,9400,4,18,3,15,61,60,1,57
Rapid Vienna,9400,5,13,9,14,56,40,16,48
RZ Pellets W,9400,6,13,9,14,45,51,-6,48
SV Josko Rie,9400,7,12,4,20,34,54,-20,40
Admira Wacke,9400,8,11,6,19,34,58,-24,39
St. Pölten,9400,9,8,10,18,36,59,-23,34
Mattersburg,9400,10,8,8,20,35,61,-26,32
FC Salzburg,9401,1,23,8,5,67,25,42,77
SK Sturm Gra,9401,2,20,9,7,62,32,30,69
SC Rheindorf,9401,3,17,8,11,53,47,6,59
Vienna,9401,4,18,4,14,61,53,8,58
Rapid Vienna,9401,5,13,13,10,53,36,17,52
Admira Wacke,9401,6,12,7,17,36,55,-19,43
RZ Pellets W,9401,7,10,8,18,41,56,-15,38
Mattersburg,9401,8,9,10,17,45,57,-12,37
St. Pölten,9401,9,8,11,17,37,66,-29,35
SV Josko Rie,9401,10,9,4,23,29,57,-28,31
Vienna,9402,1,23,4,9,83,54,29,73
FC Salzburg,9402,2,19,11,6,66,34,32,68
SK Sturm Gra,9402,3,17,9,10,66,37,29,60
SC Rheindorf,9402,4,16,6,14,47,51,-4,54
Rapid Vienna,9402,5,11,14,11,55,47,8,47
RZ Pellets W,9402,6,11,10,15,46,67,-21,43
Admira Wacke,9402,7,10,9,17,43,59,-16,39
SV Josko Rie,9402,8,11,6,19,39,56,-17,39
St. Pölten,9402,9,9,10,17,44,64,-20,37
Mattersburg,9402,10,8,11,17,40,60,-20,35
SC Rheindorf,9403,1,20,8,8,61,41,20,68
FC Salzburg,9403,2,18,7,11,59,40,19,61
SK Sturm Gra,9403,3,17,9,10,60,36,24,60
Vienna,9403,4,15,9,12,52,48,4,54
RZ Pellets W,9403,5,15,9,12,52,51,1,54
Rapid Vienna,9403,6,13,11,12,53,41,12,50
Admira Wacke,9403,7,12,8,16,36,54,-18,44
SV Josko Rie,9403,8,10,7,19,30,52,-22,37
Mattersburg,9403,9,9,8,19,41,56,-15,35
St. Pölten,9403,10,7,12,17,38,63,-25,33
Vienna,9404,1,22,6,8,72,42,30,72
SC Rheindorf,9404,2,21,9,6,59,39,20,72
SK Sturm Gra,9404,3,19,8,9,66,36,30,65
FC Salzburg,9404,4,17,9,10,63,35,28,60
Rapid Vienna,9404,5,14,11,11,67,48,19,53
SV Josko Rie,9404,6,12,3,21,33,59,-26,39
RZ Pellets W,9404,7,8,12,16,40,61,-21,36
Admira Wacke,9404,8,9,8,19,34,63,-29,35
Mattersburg,9404,9,8,9,19,38,63,-25,33
St. Pölten,9404,10,7,11,18,34,60,-26,32
FC Salzburg,9405,1,19,8,9,61,34,27,65
SC Rheindorf,9405,2,19,8,9,59,50,9,65
Vienna,9405,3,20,4,12,70,52,18,64
Rapid Vienna,9405,4,18,9,9,59,34,25,63
SK Sturm Gra,9405,5,18,5,13,60,38,22,59
Admira Wacke,9405,6,15,5,16,39,56,-17,50
RZ Pellets W,9405,7,13,8,15,45,53,-8,47
SV Josko Rie,9405,8,11,4,21,36,54,-18,37
Mattersburg,9405,9,8,7,21,33,57,-24,31
St. Pölten,9405,10,6,8,22,35,69,-34,26
FC Salzburg,9406,1,21,8,7,58,28,30,71
SK Sturm Gra,9406,2,21,5,10,59,33,26,68
SC Rheindorf,9406,3,20,7,9,62,45,17,67
Vienna,9406,4,19,6,11,71,53,18,63
Rapid Vienna,9406,5,14,9,13,54,42,12,51
RZ Pellets W,9406,6,14,6,16,44,52,-8,48
Admira Wacke,9406,7,11,5,20,38,58,-20,38
SV Josko Rie,9406,8,10,6,20,33,54,-21,36
St. Pölten,9406,9,9,8,19,40,64,-24,35
Mattersburg,9406,10,7,8,21,32,62,-30,29
SC Rheindorf,9407,1,20,10,6,61,37,24,70
Vienna,9407,2,22,3,11,68,42,26,69
FC Salzburg,9407,3,19,9,8,65,37,28,66
RZ Pellets W,9407,4,17,6,13,52,50,2,57
SK Sturm Gra,9407,5,15,8,13,53,39,14,53
Rapid Vienna,9407,6,12,11,13,47,42,5,47
Mattersburg,9407,7,11,8,17,36,49,-13,41
St. Pölten,9407,8,9,9,18,36,63,-27,36
Admira Wacke,9407,9,10,5,21,32,65,-33,35
SV Josko Rie,9407,10,8,5,23,28,54,-26,29
SC Rheindorf,9408,1,20,7,9,54,39,15,67
FC Salzburg,9408,2,18,9,9,58,31,27,63
SK Sturm Gra,9408,3,18,6,12,59,35,24,60
Vienna,9408,4,19,3,14,62,53,9,60
Rapid Vienna,9408,5,15,11,10,56,39,17,56
RZ Pellets W,9408,6,15,8,13,49,54,-5,53
Admira Wacke,9408,7,12,7,17,42,62,-20,43
Mattersburg,9408,8,11,9,16,46,56,-10,42
SV Josko Rie,9408,9,9,3,24,31,57,-26,30
St. Pölten,9408,10,6,11,19,40,71,-31,29
FC Salzburg,9409,1,24,7,5,66,22,44,79
SC Rheindorf,9409,2,20,8,8,60,43,17,68
Vienna,9409,3,20,6,10,63,46,17,66
SK Sturm Gra,9409,4,19,7,10,57,33,24,64
Rapid Vienna,9409,5,12,10,14,48,38,10,46
SV Josko Rie,9409,6,12,5,19,34,53,-19,41
RZ Pellets W,9409,7,11,7,18,42,54,-12,40
Admira Wacke,9409,8,11,7,18,36,57,-21,40
St. Pölten,9409,9,7,11,18,38,63,-25,32
Mattersburg,9409,10,6,8,22,30,65,-35,26
FC Salzburg,9410,1,24,7,5,69,30,39,79
SC Rheindorf,9410,2,20,7,9,58,43,15,67
Vienna,9410,3,19,3,14,67,57,10,60
Rapid Vienna,9410,4,14,12,10,55,38,17,54
SK Sturm Gra,9410,5,15,6,15,55,40,15,51
RZ Pellets W,9410,6,14,5,17,46,57,-11,47
Admira Wacke,9410,7,12,7,17,38,56,-18,43
SV Josko Rie,9410,8,12,4,20,34,53,-19,40
St. Pölten,9410,9,8,11,17,44,63,-19,35
Mattersburg,9410,10,8,6,22,37,66,-29,30
SC Rheindorf,9411,1,20,9,7,61,38,23,69
SK Sturm Gra,9411,2,21,5,10,62,38,24,68
FC Salzburg,9411,3,19,9,8,57,31,26,66
Vienna,9411,4,19,5,12,66,53,13,62
Rapid Vienna,9411,5,15,11,10,60,45,15,56
RZ Pellets W,9411,6,14,6,16,54,57,-3,48
Admira Wacke,9411,7,9,9,18,42,67,-25,36
Mattersburg,9411,8,7,11,18,35,54,-19,32
St. Pölten,9411,9,7,11,18,40,63,-23,32
SV Josko Rie,9411,10,7,8,21,30,61,-31,29
FC Salzburg,9412,1,22,7,7,70,33,37,73
SK Sturm Gra,9412,2,23,4,9,67,36,31,73
SC Rheindorf,9412,3,20,7,9,58,43,15,67
Vienna,9412,4,17,4,15,59,56,3,55
Rapid Vienna,9412,5,15,9,12,57,47,10,54
RZ Pellets W,9412,6,12,8,16,51,55,-4,44
Admira Wacke,9412,7,11,7,18,45,65,-20,40
St. Pölten,9412,8,10,8,18,45,68,-23,38
SV Josko Rie,9412,9,10,6,20,37,55,-18,36
Mattersburg,9412,10,7,6,23,34,65,-31,27
FC Salzburg,9413,1,23,6,7,70,27,43,75
SC Rheindorf,9413,2,20,6,10,59,38,21,66
SK Sturm Gra,9413,3,17,8,11,51,35,16,59
Rapid Vienna,9413,4,15,8,13,55,42,13,53
Vienna,9413,5,16,4,16,52,54,-2,52
SV Josko Rie,9413,6,14,6,16,37,45,-8,48
Admira Wacke,9413,7,13,8,15,40,50,-10,47
RZ Pellets W,9413,8,12,7,17,38,52,-14,43
St. Pölten,9413,9,8,8,20,41,75,-34,32
Mattersburg,9413,10,8,7,21,30,55,-25,31
FC Salzburg,9414,1,19,10,7,64,33,31,67
Vienna,9414,2,20,7,9,70,51,19,67
SK Sturm Gra,9414,3,20,5,11,65,35,30,65
SC Rheindorf,9414,4,16,8,12,52,48,4,56
Rapid Vienna,9414,5,13,11,12,50,39,11,50
RZ Pellets W,9414,6,14,4,18,52,65,-13,46
SV Josko Rie,9414,7,13,4,19,40,60,-20,43
Admira Wacke,9414,8,12,6,18,45,60,-15,42
Mattersburg,9414,9,9,9,18,42,61,-19,36
St. Pölten,9414,10,7,10,19,38,66,-28,31
FC Salzburg,9415,1,20,8,8,61,34,27,68
Vienna,9415,2,20,3,13,62,45,17,63
SC Rheindorf,9415,3,18,7,11,51,42,9,61
SK Sturm Gra,9415,4,18,5,13,57,44,13,59
Rapid Vienna,9415,5,13,12,11,50,39,11,51
St. Pölten,9415,6,12,11,13,47,54,-7,47
Admira Wacke,9415,7,13,4,19,39,59,-20,43
RZ Pellets W,9415,8,11,9,16,43,50,-7,42
SV Josko Rie,9415,9,11,7,18,35,52,-17,40
Mattersburg,9415,10,7,8,21,35,61,-26,29
FC Salzburg,9416,1,19,9,8,66,36,30,66
Vienna,9416,2,19,8,9,56,45,11,65
SK Sturm Gra,9416,3,19,5,12,64,34,30,62
SC Rheindorf,9416,4,18,8,10,49,40,9,62
Rapid Vienna,9416,5,13,11,12,56,40,16,50
SV Josko Rie,9416,6,14,4,18,41,48,-7,46
RZ Pellets W,9416,7,13,6,17,47,59,-12,45
Admira Wacke,9416,8,11,5,20,34,61,-27,38
Mattersburg,9416,9,9,9,18,33,58,-25,36
St. Pölten,9416,10,8,9,19,34,59,-25,33
FC Salzburg,9417,1,22,7,7,68,29,39,73
SK Sturm Gra,9417,2,19,5,12,57,34,23,62
Vienna,9417,3,18,7,11,62,49,13,61
SC Rheindorf,9417,4,17,10,9,53,46,7,61
RZ Pellets W,9417,5,14,8,14,47,53,-6,50
Rapid Vienna,9417,6,13,10,13,54,47,7,49
St. Pölten,9417,7,10,12,14,47,58,-11,42
Admira Wacke,9417,8,11,7,18,32,53,-21,40
SV Josko Rie,9417,9,10,5,21,39,59,-20,35
Mattersburg,9417,10,7,7,22,36,67,-31,28
SK Sturm Gra,9418,1,21,7,8,64,32,32,70
FC Salzburg,9418,2,21,5,10,64,39,25,68
SC Rheindorf,9418,3,19,7,10,54,48,6,64
Vienna,9418,4,19,4,13,65,49,16,61
SV Josko Rie,9418,5,14,7,15,38,45,-7,49
Rapid Vienna,9418,6,11,13,12,53,43,10,46
St. Pölten,9418,7,11,10,15,44,57,-13,43
RZ Pellets W,9418,8,11,8,17,41,52,-11,41
Admira Wacke,9418,9,9,6,21,34,64,-30,33
Mattersburg,9418,10,6,9,21,31,59,-28,27
FC Salzburg,9419,1,20,10,6,59,26,33,70
SC Rheindorf,9419,2,19,8,9,50,38,12,65
SK Sturm Gra,9419,3,19,5,12,58,30,28,62
Rapid Vienna,9419,4,15,10,11,52,39,13,55
Vienna,9419,5,16,5,15,50,54,-4,53
RZ Pellets W,9419,6,13,9,14,43,48,-5,48
Admira Wacke,9419,7,12,6,18,37,60,-23,42
SV Josko Rie,9419,8,11,7,18,32,47,-15,40
Mattersburg,9419,9,10,7,19,35,48,-13,37
St. Pölten,9419,10,7,9,20,35,61,-26,30
FC Salzburg,9420,1,20,6,10,62,34,28,66
SC Rheindorf,9420,2,18,6,12,56,43,13,60
Vienna,9420,3,17,9,10,57,48,9,60
SK Sturm Gra,9420,4,17,6,13,53,41,12,57
Rapid Vienna,9420,5,11,17,8,51,39,12,50
RZ Pellets W,9420,6,13,8,15,46,49,-3,47
Admira Wacke,9420,7,12,8,16,36,52,-16,44
St. Pölten,9420,8,10,10,16,48,62,-14,40
SV Josko Rie,9420,9,11,7,18,39,56,-17,40
Mattersburg,9420,10,8,9,19,36,60,-24,33
FC Salzburg,9421,1,20,8,8,67,34,33,68
SC Rheindorf,9421,2,20,7,9,54,35,19,67
SK Sturm Gra,9421,3,20,6,10,54,30,24,66
Vienna,9421,4,19,7,10,62,44,18,64
Rapid Vienna,9421,5,13,10,13,53,43,10,49
RZ Pellets W,9421,6,13,6,17,45,57,-12,45
SV Josko Rie,9421,7,12,6,18,32,50,-18,42
Admira Wacke,9421,8,12,5,19,34,59,-25,41
St. Pölten,9421,9,9,8,19,39,63,-24,35
Mattersburg,9421,10,6,9,21,32,57,-25,27
FC Salzburg,9422,1,23,6,7,66,30,36,75
SK Sturm Gra,9422,2,22,6,8,70,37,33,72
SC Rheindorf,9422,3,19,9,8,55,36,19,66
Vienna,9422,4,17,5,14,58,60,-2,56
RZ Pellets W,9422,5,15,8,13,62,54,8,53
Rapid Vienna,9422,6,14,10,12,54,40,14,52
SV Josko Rie,9422,7,10,6,20,38,65,-27,36
Mattersburg,9422,8,8,8,20,35,56,-21,32
Admira Wacke,9422,9,8,7,21,36,67,-31,31
St. Pölten,9422,10,7,9,20,39,68,-29,30
FC Salzburg,9423,1,22,8,6,69,29,40,74
SC Rheindorf,9423,2,22,5,9,54,37,17,71
SK Sturm Gra,9423,3,18,9,9,57,34,23,63
Vienna,9423,4,15,9,12,59,53,6,54
Rapid Vienna,9423,5,13,9,14,49,42,7,48
RZ Pellets W,9423,6,11,10,15,45,56,-11,43
SV Josko Rie,9423,7,13,4,19,37,50,-13,43
Admira Wacke,9423,8,10,6,20,31,58,-27,36
St. Pölten,9423,9,8,11,17,39,60,-21,35
Mattersburg,9423,10,9,7,20,34,55,-21,34
FC Salzburg,9424,1,19,9,8,62,34,28,66
SK Sturm Gra,9424,2,19,8,9,68,38,30,65
SC Rheindorf,9424,3,19,6,11,52,48,4,63
Vienna,9424,4,18,6,12,63,50,13,60
Rapid Vienna,9424,5,14,11,11,58,41,17,53
RZ Pellets W,9424,6,15,8,13,58,54,4,53
SV Josko Rie,9424,7,12,3,21,33,53,-20,39
St. Pölten,9424,8,9,9,18,43,65,-22,36
Admira Wacke,9424,9,10,6,20,30,59,-29,36
Mattersburg,9424,10,6,12,18,33,58,-25,30
FC Salzburg,9425,1,19,10,7,70,36,34,67
SK Sturm Gra,9425,2,19,9,8,63,33,30,66
SC Rheindorf,9425,3,19,4,13,54,44,10,61
Vienna,9425,4,18,5,13,60,54,6,59
Rapid Vienna,9425,5,14,14,8,56,40,16,56
RZ Pellets W,9425,6,11,9,16,49,63,-14,42
Mattersburg,9425,7,11,8,17,44,56,-12,41
Admira Wacke,9425,8,10,8,18,44,64,-20,38
St. Pölten,9425,9,8,12,16,49,65,-16,36
SV Josko Rie,9425,10,9,5,22,32,66,-34,32
FC Salzburg,9426,1,21,6,9,62,31,31,69
SC Rheindorf,9426,2,19,10,7,56,47,9,67
SK Sturm Gra,9426,3,19,6,11,62,36,26,63
Vienna,9426,4,19,6,11,61,46,15,63
Rapid Vienna,9426,5,15,10,11,58,40,18,55
RZ Pellets W,9426,6,13,8,15,50,52,-2,47
Admira Wacke,9426,7,14,5,17,38,55,-17,47
SV Josko Rie,9426,8,10,5,21,38,55,-17,35
St. Pölten,9426,9,9,7,20,43,68,-25,34
Mattersburg,9426,10,5,9,22,27,65,-38,24
SK Sturm Gra,9427,1,22,8,6,62,27,35,74
FC Salzburg,9427,2,19,7,10,68,36,32,64
SC Rheindorf,9427,3,18,10,8,50,38,12,64
Vienna,9427,4,19,6,11,71,53,18,63
Rapid Vienna,9427,5,14,10,12,54,42,12,52
Admira Wacke,9427,6,14,4,18,40,62,-22,46
SV Josko Rie,9427,7,11,6,19,36,55,-19,39
RZ Pellets W,9427,8,10,8,18,44,60,-16,38
Mattersburg,9427,9,8,10,18,40,59,-19,34
St. Pölten,9427,10,7,7,22,39,72,-33,28
FC Salzburg,9428,1,21,7,8,68,32,36,70
Vienna,9428,2,22,2,12,66,52,14,68
SK Sturm Gra,9428,3,21,4,11,66,45,21,67
SC Rheindorf,9428,4,20,6,10,49,40,9,66
Rapid Vienna,9428,5,12,12,12,53,47,6,48
RZ Pellets W,9428,6,13,6,17,54,66,-12,45
St. Pölten,9428,7,11,8,17,51,62,-11,41
Admira Wacke,9428,8,11,5,20,39,62,-23,38
SV Josko Rie,9428,9,9,6,21,31,51,-20,33
Mattersburg,9428,10,8,8,20,36,56,-20,32
SC Rheindorf,9429,1,22,7,7,59,42,17,73
FC Salzburg,9429,2,19,7,10,61,33,28,64
Rapid Vienna,9429,3,16,11,9,58,38,20,59
SK Sturm Gra,9429,4,17,5,14,61,44,17,56
Vienna,9429,5,16,7,13,63,52,11,55
Admira Wacke,9429,6,13,8,15,42,55,-13,47
RZ Pellets W,9429,7,11,8,17,45,61,-16,41
SV Josko Rie,9429,8,12,4,20,34,58,-24,40
St. Pölten,9429,9,8,13,15,47,63,-16,37
Mattersburg,9429,10,6,10,20,36,60,-24,28
FC Salzburg,9430,1,21,10,5,69,31,38,73
SK Sturm Gra,9430,2,19,7,10,59,34,25,64
SC Rheindorf,9430,3,19,6,11,62,46,16,63
Vienna,9430,4,19,5,12,62,51,11,62
Rapid Vienna,9430,5,14,12,10,56,38,18,54
Admira Wacke,9430,6,13,6,17,39,56,-17,45
RZ Pellets W,9430,7,12,6,18,42,59,-17,42
St. Pölten,9430,8,11,7,18,42,65,-23,40
SV Josko Rie,9430,9,11,5,20,35,56,-21,38
Mattersburg,9430,10,5,8,23,33,63,-30,23
FC Salzburg,9431,1,21,6,9,70,39,31,69
SC Rheindorf,9431,2,20,6,10,61,44,17,66
SK Sturm Gra,9431,3,20,4,12,65,40,25,64
Vienna,9431,4,17,7,12,61,52,9,58
Rapid Vienna,9431,5,13,10,13,52,44,8,49
St. Pölten,9431,6,11,11,14,43,62,-19,44
RZ Pellets W,9431,7,12,7,17,44,54,-10,43
SV Josko Rie,9431,8,12,6,18,38,57,-19,42
Admira Wacke,9431,9,10,6,20,39,68,-29,36
Mattersburg,9431,10,9,7,20,44,57,-13,34
FC Salzburg,9432,1,23,8,5,68,30,38,77
SK Sturm Gra,9432,2,20,4,12,60,33,27,64
SC Rheindorf,9432,3,19,6,11,55,46,9,63
Vienna,9432,4,19,3,14,61,46,15,60
Rapid Vienna,9432,5,12,10,14,49,50,-1,46
SV Josko Rie,9432,6,14,3,19,40,54,-14,45
St. Pölten,9432,7,13,6,17,45,60,-15,45
Admira Wacke,9432,8,12,7,17,40,57,-17,43
RZ Pellets W,9432,9,9,9,18,46,64,-18,36
Mattersburg,9432,10,7,8,21,35,59,-24,29
FC Salzburg,9433,1,20,6,10,61,29,32,66
SC Rheindorf,9433,2,20,5,11,59,47,12,65
Rapid Vienna,9433,3,18,10,8,67,39,28,64
SK Sturm Gra,9433,4,19,7,10,56,35,21,64
Vienna,9433,5,16,4,16,56,61,-5,52
SV Josko Rie,9433,6,13,5,18,35,49,-14,44
RZ Pellets W,9433,7,11,9,16,48,61,-13,42
Mattersburg,9433,8,11,6,19,43,55,-12,39
Admira Wacke,9433,9,9,9,18,34,57,-23,36
St. Pölten,9433,10,7,11,18,40,66,-26,32
SC Rheindorf,9434,1,21,7,8,63,44,19,70
FC Salzburg,9434,2,20,7,9,61,29,32,67
Vienna,9434,3,20,5,11,62,43,19,65
SK Sturm Gra,9434,4,18,7,11,59,41,18,61
Rapid Vienna,9434,5,15,10,11,59,44,15,55
RZ Pellets W,9434,6,12,10,14,44,51,-7,46
SV Josko Rie,9434,7,12,3,21,32,50,-18,39
Admira Wacke,9434,8,11,5,20,34,63,-29,38
Mattersburg,9434,9,8,8,20,35,55,-20,32
St. Pölten,9434,10,8,8,20,42,71,-29,32
SK Sturm Gra,9435,1,22,5,9,58,33,25,71
FC Salzburg,9435,2,21,7,8,68,32,36,70
SC Rheindorf,9435,3,20,7,9,57,42,15,67
Vienna,9435,4,19,4,13,57,51,6,61
Rapid Vienna,9435,5,14,10,12,54,42,12,52
RZ Pellets W,9435,6,13,7,16,44,53,-9,46
Admira Wacke,9435,7,11,6,19,35,56,-21,39
SV Josko Rie,9435,8,8,11,17,34,50,-16,35
St. Pölten,9435,9,8,9,19,44,63,-19,33
Mattersburg,9435,10,6,10,20,32,61,-29,28
FC Salzburg,9436,1,24,6,6,74,31,43,78
SK Sturm Gra,9436,2,22,4,10,71,39,32,70
SC Rheindorf,9436,3,19,7,10,56,42,14,64
Vienna,9436,4,17,6,13,62,57,5,57
Rapid Vienna,9436,5,11,12,13,51,46,5,45
RZ Pellets W,9436,6,12,6,18,51,56,-5,42
St. Pölten,9436,7,11,9,16,40,55,-15,42
SV Josko Rie,9436,8,11,8,17,32,51,-19,41
Admira Wacke,9436,9,11,7,18,37,64,-27,40
Mattersburg,9436,10,6,7,23,31,64,-33,25
SK Sturm Gra,9437,1,21,7,8,64,33,31,70
FC Salzburg,9437,2,19,9,8,66,39,27,66
SC Rheindorf,9437,3,20,6,10,51,39,12,66
Vienna,9437,4,17,7,12,64,53,11,58
Rapid Vienna,9437,5,11,11,14,51,44,7,44
SV Josko Rie,9437,6,12,8,16,35,44,-9,44
Admira Wacke,9437,7,11,6,19,34,55,-21,39
RZ Pellets W,9437,8,9,11,16,41,57,-16,38
Mattersburg,9437,9,9,10,17,35,55,-20,37
St. Pölten,9437,10,9,9,18,40,62,-22,36
FC Salzburg,9438,1,21,7,8,63,32,31,70
SC Rheindorf,9438,2,19,7,10,55,43,12,64
SK Sturm Gra,9438,3,18,7,11,56,37,19,61
Vienna,9438,4,19,4,13,60,51,9,61
Rapid Vienna,9438,5,12,12,12,52,39,13,48
RZ Pellets W,9438,6,12,11,13,46,54,-8,47
SV Josko Rie,9438,7,14,4,18,45,53,-8,46
St. Pölten,9438,8,9,10,17,40,63,-23,37
Mattersburg,9438,9,7,12,17,36,53,-17,33
Admira Wacke,9438,10,8,8,20,32,60,-28,32
FC Salzburg,9439,1,22,5,9,60,31,29,71
SC Rheindorf,9439,2,20,9,7,55,38,17,69
Rapid Vienna,9439,3,17,10,9,64,42,22,61
SK Sturm Gra,9439,4,17,9,10,64,39,25,60
Vienna,9439,5,14,7,15,64,66,-2,49
RZ Pellets W,9439,6,13,10,13,53,58,-5,49
Mattersburg,9439,7,10,10,16,44,57,-13,40
St. Pölten,9439,8,9,10,17,44,62,-18,37
SV Josko Rie,9439,9,9,5,22,32,54,-22,32
Admira Wacke,9439,10,9,5,22,33,66,-33,32
SC Rheindorf,9440,1,23,7,6,66,38,28,76
FC Salzburg,9440,2,21,7,8,65,27,38,70
SK Sturm Gra,9440,3,21,6,9,64,36,28,69
Rapid Vienna,9440,4,15,12,9,55,36,19,57
Vienna,9440,5,17,6,13,57,56,1,57
RZ Pellets W,9440,6,11,7,18,44,57,-13,40
Admira Wacke,9440,7,11,7,18,36,61,-25,40
Mattersburg,9440,8,9,9,18,34,54,-20,36
SV Josko Rie,9440,9,9,4,23,35,61,-26,31
St. Pölten,9440,10,7,7,22,42,72,-30,28
FC Salzburg,9441,1,21,8,7,63,30,33,71
SC Rheindorf,9441,2,20,8,8,55,37,18,68
Vienna,9441,3,18,6,12,62,48,14,60
SK Sturm Gra,9441,4,16,5,15,53,42,11,53
Rapid Vienna,9441,5,14,10,12,52,41,11,52
RZ Pellets W,9441,6,14,6,16,46,52,-6,48
Mattersburg,9441,7,12,7,17,40,53,-13,43
Admira Wacke,9441,8,12,5,19,31,60,-29,41
St. Pölten,9441,9,10,9,17,48,58,-10,39
SV Josko Rie,9441,10,8,6,22,27,56,-29,30
FC Salzburg,9442,1,21,9,6,68,30,38,72
SK Sturm Gra,9442,2,19,7,10,61,31,30,64
SC Rheindorf,9442,3,18,9,9,53,40,13,63
Rapid Vienna,9442,4,14,10,12,63,46,17,52
Vienna,9442,5,14,8,14,57,62,-5,50
Admira Wacke,9442,6,13,7,16,39,60,-21,46
RZ Pellets W,9442,7,11,8,17,47,57,-10,41
SV Josko Rie,9442,8,11,7,18,35,49,-14,40
St. Pölten,9442,9,9,12,15,40,57,-17,39
Mattersburg,9442,10,8,7,21,34,65,-31,31
SC Rheindorf,9443,1,18,11,7,54,40,14,65
SK Sturm Gra,9443,2,19,6,11,54,31,23,63
FC Salzburg,9443,3,17,10,9,60,34,26,61
Vienna,9443,4,15,5,16,63,61,2,50
Rapid Vienna,9443,5,12,12,12,55,41,14,48
RZ Pellets W,9443,6,13,5,18,47,58,-11,44
Mattersburg,9443,7,12,8,16,40,51,-11,44
St. Pölten,9443,8,11,9,16,46,63,-17,42
SV Josko Rie,9443,9,11,8,17,34,52,-18,41
Admira Wacke,9443,10,10,10,16,36,58,-22,40
SC Rheindorf,9444,1,23,9,4,66,38,28,78
FC Salzburg,9444,2,21,7,8,66,31,35,70
SK Sturm Gra,9444,3,18,5,13,58,40,18,59
Vienna,9444,4,18,5,13,63,59,4,59
Rapid Vienna,9444,5,15,11,10,57,40,17,56
RZ Pellets W,9444,6,13,5,18,45,54,-9,44
SV Josko Rie,9444,7,11,4,21,34,59,-25,37
Admira Wacke,9444,8,10,5,21,39,66,-27,35
Mattersburg,9444,9,8,10,18,35,54,-19,34
St. Pölten,9444,10,8,9,19,42,64,-22,33
FC Salzburg,9445,1,23,6,7,71,33,38,75
SC Rheindorf,9445,2,20,8,8,58,41,17,68
Vienna,9445,3,19,5,12,64,48,16,62
Rapid Vienna,9445,4,16,8,12,56,45,11,56
SK Sturm Gra,9445,5,16,6,14,56,45,11,54
RZ Pellets W,9445,6,13,6,17,43,52,-9,45
Admira Wacke,9445,7,11,7,18,39,61,-22,40
St. Pölten,9445,8,10,8,18,47,70,-23,38
SV Josko Rie,9445,9,10,7,19,37,53,-16,37
Mattersburg,9445,10,7,9,20,38,61,-23,30
FC Salzburg,9446,1,23,7,6,68,29,39,76
SC Rheindorf,9446,2,20,7,9,55,44,11,67
SK Sturm Gra,9446,3,20,5,11,64,33,31,65
Vienna,9446,4,18,5,13,61,54,7,59
Rapid Vienna,9446,5,14,8,14,61,48,13,50
RZ Pellets W,9446,6,14,7,15,48,52,-4,49
Admira Wacke,9446,7,11,5,20,35,58,-23,38
Mattersburg,9446,8,10,7,19,35,54,-19,37
St. Pölten,9446,9,8,11,17,42,68,-26,35
SV Josko Rie,9446,10,9,4,23,29,58,-29,31
FC Salzburg,9447,1,21,7,8,68,30,38,70
SC Rheindorf,9447,2,19,9,8,54,39,15,66
SK Sturm Gra,9447,3,18,7,11,61,36,25,61
Rapid Vienna,9447,4,16,11,9,60,37,23,59
Vienna,9447,5,17,4,15,58,59,-1,55
RZ Pellets W,9447,6,12,7,17,47,56,-9,43
Mattersburg,9447,7,10,9,17,36,50,-14,39
SV Josko Rie,9447,8,11,6,19,37,54,-17,39
Admira Wacke,9447,9,10,6,20,35,70,-35,36
St. Pölten,9447,10,6,14,16,41,66,-25,32
Vienna,9448,1,23,4,9,68,47,21,73
SC Rheindorf,9448,2,18,8,10,62,47,15,62
FC Salzburg,9448,3,18,7,11,57,33,24,61
SK Sturm Gra,9448,4,16,8,12,58,38,20,56
Rapid Vienna,9448,5,13,13,10,51,45,6,52
RZ Pellets W,9448,6,14,6,16,49,52,-3,48
Admira Wacke,9448,7,10,11,15,39,57,-18,41
St. Pölten,9448,8,9,10,17,38,60,-22,37
Mattersburg,9448,9,9,9,18,35,51,-16,36
SV Josko Rie,9448,10,9,6,21,33,60,-27,33
FC Salzburg,9449,1,18,13,5,64,32,32,67
SK Sturm Gra,9449,2,19,9,8,63,36,27,66
SC Rheindorf,9449,3,18,9,9,53,40,13,63
Vienna,9449,4,16,11,9,62,49,13,59
RZ Pellets W,9449,5,12,10,14,47,53,-6,46
SV Josko Rie,9449,6,13,7,16,36,46,-10,46
Admira Wacke,9449,7,11,9,16,38,56,-18,42
Rapid Vienna,9449,8,8,14,14,51,51,0,38
St. Pölten,9449,9,8,11,17,43,63,-20,35
Mattersburg,9449,10,6,9,21,30,61,-31,27
FC Salzburg,9450,1,22,6,8,67,31,36,72
Vienna,9450,2,21,4,11,63,45,18,67
SC Rheindorf,9450,3,19,9,8,53,40,13,66
SK Sturm Gra,9450,4,19,7,10,61,34,27,64
Rapid Vienna,9450,5,14,11,11,61,43,18,53
RZ Pellets W,9450,6,14,7,15,45,53,-8,49
SV Josko Rie,9450,7,10,5,21,32,53,-21,35
Admira Wacke,9450,8,9,7,20,40,73,-33,34
St. Pölten,9450,9,7,12,17,42,64,-22,33
Mattersburg,9450,10,7,8,21,31,59,-28,29
FC Salzburg,9451,1,22,6,8,66,33,33,72
SK Sturm Gra,9451,2,22,4,10,64,33,31,70
SC Rheindorf,9451,3,19,7,10,54,48,6,64
Vienna,9451,4,19,4,13,68,46,22,61
Admira Wacke,9451,5,12,8,16,37,57,-20,44
Rapid Vienna,9451,6,11,10,15,51,45,6,43
RZ Pellets W,9451,7,12,7,17,43,53,-10,43
SV Josko Rie,9451,8,13,3,20,33,50,-17,42
Mattersburg,9451,9,11,7,18,43,61,-18,40
St. Pölten,9451,10,7,8,21,35,68,-33,29
FC Salzburg,9452,1,22,6,8,64,33,31,72
SK Sturm Gra,9452,2,18,7,11,66,44,22,61
SC Rheindorf,9452,3,17,10,9,53,41,12,61
Rapid Vienna,9452,4,16,10,10,59,42,17,58
Vienna,9452,5,17,3,16,62,57,5,54
RZ Pellets W,9452,6,13,7,16,46,59,-13,46
Admira Wacke,9452,7,12,5,19,44,65,-21,41
Mattersburg,9452,8,9,10,17,37,51,-14,37
SV Josko Rie,9452,9,10,7,19,40,60,-20,37
St. Pölten,9452,10,9,9,18,40,59,-19,36
FC Salzburg,9453,1,20,8,8,68,31,37,68
Vienna,9453,2,20,5,11,68,50,18,65
SK Sturm Gra,9453,3,19,6,11,64,39,25,63
Rapid Vienna,9453,4,14,12,10,56,40,16,54
SC Rheindorf,9453,5,14,9,13,45,47,-2,51
RZ Pellets W,9453,6,13,8,15,47,63,-16,47
SV Josko Rie,9453,7,12,6,18,35,51,-16,42
Admira Wacke,9453,8,11,8,17,43,63,-20,41
Mattersburg,9453,9,9,9,18,34,54,-20,36
St. Pölten,9453,10,8,9,19,42,64,-22,33
FC Salzburg,9454,1,20,8,8,65,35,30,68
SC Rheindorf,9454,2,19,8,9,56,43,13,65
SK Sturm Gra,9454,3,18,10,8,56,31,25,64
Vienna,9454,4,17,7,12,59,53,6,58
Rapid Vienna,9454,5,11,11,14,54,46,8,44
RZ Pellets W,9454,6,13,5,18,51,57,-6,44
SV Josko Rie,9454,7,12,5,19,41,57,-16,41
St. Pölten,9454,8,11,8,17,43,62,-19,41
Admira Wacke,9454,9,10,9,17,31,54,-23,39
Mattersburg,9454,10,9,9,18,38,56,-18,36
FC Salzburg,9455,1,22,9,5,67,24,43,75
SC Rheindorf,9455,2,20,7,9,52,38,14,67
SK Sturm Gra,9455,3,18,11,7,56,30,26,65
Vienna,9455,4,14,6,16,55,59,-4,48
RZ Pellets W,9455,5,13,8,15,50,57,-7,47
Rapid Vienna,9455,6,11,12,13,49,43,6,45
SV Josko Rie,9455,7,12,7,17,37,49,-12,43
Admira Wacke,9455,8,11,9,16,39,59,-20,42
Mattersburg,9455,9,9,10,17,41,56,-15,37
St. Pölten,9455,10,6,9,21,34,65,-31,27
Vienna,9456,1,23,4,9,71,45,26,73
FC Salzburg,9456,2,22,6,8,71,35,36,72
SC Rheindorf,9456,3,19,8,9,53,41,12,65
SK Sturm Gra,9456,4,18,8,10,71,39,32,62
Rapid Vienna,9456,5,14,9,13,54,46,8,51
Admira Wacke,9456,6,11,7,18,36,60,-24,40
RZ Pellets W,9456,7,11,6,19,37,56,-19,39
Mattersburg,9456,8,8,11,17,33,51,-18,35
St. Pölten,9456,9,9,8,19,39,64,-25,35
SV Josko Rie,9456,10,9,5,22,30,58,-28,32
FC Salzburg,9457,1,21,8,7,63,30,33,71
SC Rheindorf,9457,2,21,8,7,59,41,18,71
SK Sturm Gra,9457,3,18,8,10,62,33,29,62
Vienna,9457,4,18,4,14,54,53,1,58
Rapid Vienna,9457,5,13,10,13,49,40,9,49
Admira Wacke,9457,6,12,8,16,38,57,-19,44
RZ Pellets W,9457,7,11,8,17,41,58,-17,41
St. Pölten,9457,8,9,12,15,37,51,-14,39
SV Josko Rie,9457,9,11,4,21,36,52,-16,37
Mattersburg,9457,10,6,10,20,30,54,-24,28
SC Rheindorf,9458,1,21,7,8,58,42,16,70
Vienna,9458,2,22,3,11,66,51,15,69
FC Salzburg,9458,3,21,5,10,69,36,33,68
SK Sturm Gra,9458,4,18,7,11,60,38,22,61
Rapid Vienna,9458,5,12,15,9,58,43,15,51
Admira Wacke,9458,6,13,5,18,41,56,-15,44
SV Josko Rie,9458,7,12,6,18,33,49,-16,42
RZ Pellets W,9458,8,9,8,19,42,63,-21,35
Mattersburg,9458,9,8,9,19,34,55,-21,33
St. Pölten,9458,10,6,11,19,46,74,-28,29
SC Rheindorf,9459,1,21,8,7,56,40,16,71
FC Salzburg,9459,2,19,8,9,63,35,28,65
SK Sturm Gra,9459,3,20,3,13,58,37,21,63
Rapid Vienna,9459,4,17,11,8,62,35,27,62
Vienna,9459,5,19,4,13,62,57,5,61
RZ Pellets W,9459,6,13,5,18,47,55,-8,44
Admira Wacke,9459,7,11,7,18,38,59,-21,40
St. Pölten,9459,8,9,9,18,44,65,-21,36
SV Josko Rie,9459,9,10,4,22,31,54,-23,34
Mattersburg,9459,10,7,9,20,39,63,-24,30
FC Salzburg,9460,1,21,7,8,67,32,35,70
SK Sturm Gra,9460,2,21,4,11,62,37,25,67
SC Rheindorf,9460,3,19,8,9,56,42,14,65
Rapid Vienna,9460,4,16,12,8,60,39,21,60
Vienna,9460,5,17,5,14,56,48,8,56
RZ Pellets W,9460,6,14,8,14,43,48,-5,50
Admira Wacke,9460,7,12,6,18,37,57,-20,42
Mattersburg,9460,8,8,7,21,33,52,-19,31
St. Pölten,9460,9,7,10,19,38,66,-28,31
SV Josko Rie,9460,10,8,7,21,31,62,-31,31
SK Sturm Gra,9461,1,20,9,7,57,27,30,69
FC Salzburg,9461,2,19,9,8,63,31,32,66
SC Rheindorf,9461,3,18,8,10,54,43,11,62
Vienna,9461,4,15,6,15,61,62,-1,51
SV Josko Rie,9461,5,14,6,16,42,49,-7,48
Admira Wacke,9461,6,13,7,16,34,53,-19,46
RZ Pellets W,9461,7,12,7,17,42,53,-11,43
Rapid Vienna,9461,8,11,9,16,48,48,0,42
St. Pölten,9461,9,8,13,15,35,51,-16,37
Mattersburg,9461,10,8,10,18,38,57,-19,34
FC Salzburg,9462,1,25,6,5,71,21,50,81
SC Rheindorf,9462,2,21,4,11,53,43,10,67
SK Sturm Gra,9462,3,19,5,12,60,37,23,62
Vienna,9462,4,17,7,12,63,52,11,58
Admira Wacke,9462,5,15,6,15,44,54,-10,51
Rapid Vienna,9462,6,13,8,15,51,44,7,47
RZ Pellets W,9462,7,12,8,16,48,58,-10,44
St. Pölten,9462,8,9,8,19,44,68,-24,35
SV Josko Rie,9462,9,9,5,22,30,60,-30,32
Mattersburg,9462,10,8,7,21,37,64,-27,31
FC Salzburg,9463,1,20,8,8,64,28,36,68
SC Rheindorf,9463,2,20,8,8,64,47,17,68
SK Sturm Gra,9463,3,19,5,12,64,46,18,62
Rapid Vienna,9463,4,16,12,8,57,36,21,60
Vienna,9463,5,17,5,14,60,55,5,56
RZ Pellets W,9463,6,13,8,15,55,55,0,47
Admira Wacke,9463,7,10,11,15,40,61,-21,41
SV Josko Rie,9463,8,11,4,21,34,61,-27,37
Mattersburg,9463,9,9,5,22,34,54,-20,32
St. Pölten,9463,10,8,8,20,41,70,-29,32
FC Salzburg,9464,1,22,6,8,68,33,35,72
SK Sturm Gra,9464,2,21,5,10,67,33,34,68
SC Rheindorf,9464,3,19,8,9,65,50,15,65
Vienna,9464,4,19,5,12,69,58,11,62
RZ Pellets W,9464,5,13,8,15,47,51,-4,47
Rapid Vienna,9464,6,11,11,14,52,47,5,44
SV Josko Rie,9464,7,10,7,19,36,54,-18,37
Admira Wacke,9464,8,11,4,21,38,71,-33,37
St. Pölten,9464,9,9,9,18,42,65,-23,36
Mattersburg,9464,10,8,11,17,33,55,-22,35
SK Sturm Gra,9465,1,25,3,8,65,29,36,78
FC Salzburg,9465,2,22,6,8,65,27,38,72
SC Rheindorf,9465,3,18,7,11,54,43,11,61
Vienna,9465,4,17,6,13,57,50,7,57
Admira Wacke,9465,5,13,6,17,38,58,-20,45
RZ Pellets W,9465,6,11,8,17,43,54,-11,41
Mattersburg,9465,7,9,13,14,32,46,-14,40
Rapid Vienna,9465,8,9,11,16,46,49,-3,38
St. Pölten,9465,9,9,9,18,41,64,-23,36
SV Josko Rie,9465,10,10,5,21,31,52,-21,35
FC Salzburg,9466,1,20,10,6,60,26,34,70
SC Rheindorf,9466,2,20,10,6,64,37,27,70
Vienna,9466,3,20,4,12,64,47,17,64
SK Sturm Gra,9466,4,18,7,11,61,35,26,61
Rapid Vienna,9466,5,11,17,8,51,38,13,50
RZ Pellets W,9466,6,12,9,15,45,54,-9,45
Admira Wacke,9466,7,10,11,15,33,54,-21,41
SV Josko Rie,9466,8,10,6,20,33,59,-26,36
Mattersburg,9466,9,8,7,21,32,56,-24,31
St. Pölten,9466,10,6,9,21,39,76,-37,27
FC Salzburg,9467,1,23,7,6,67,29,38,76
SK Sturm Gra,9467,2,20,9,7,67,32,35,69
Vienna,9467,3,17,7,12,67,61,6,58
SC Rheindorf,9467,4,16,8,12,50,50,0,56
Rapid Vienna,9467,5,14,12,10,52,34,18,54
Mattersburg,9467,6,11,8,17,40,50,-10,41
RZ Pellets W,9467,7,11,7,18,44,58,-14,40
SV Josko Rie,9467,8,11,5,20,35,57,-22,38
Admira Wacke,9467,9,8,12,16,34,54,-20,36
St. Pölten,9467,10,6,11,19,38,69,-31,29
SC Rheindorf,9468,1,22,7,7,63,36,27,73
FC Salzburg,9468,2,20,8,8,58,27,31,68
Vienna,9468,3,21,4,11,62,48,14,67
SK Sturm Gra,9468,4,18,8,10,58,35,23,62
Rapid Vienna,9468,5,11,12,13,54,49,5,45
RZ Pellets W,9468,6,12,9,15,51,57,-6,45
Admira Wacke,9468,7,13,6,17,47,64,-17,45
SV Josko Rie,9468,8,11,6,19,35,56,-21,39
Mattersburg,9468,9,7,9,20,33,61,-28,30
St. Pölten,9468,10,6,9,21,38,66,-28,27
SK Sturm Gra,9469,1,21,6,9,61,30,31,69
SC Rheindorf,9469,2,19,7,10,68,49,19,64
FC Salzburg,9469,3,18,9,9,64,31,33,63
Vienna,9469,4,19,4,13,67,64,3,61
Rapid Vienna,9469,5,13,11,12,52,41,11,50
RZ Pellets W,9469,6,13,7,16,52,60,-8,46
Admira Wacke,9469,7,13,7,16,36,57,-21,46
St. Pölten,9469,8,8,11,17,46,65,-19,35
Mattersburg,9469,9,8,10,18,37,56,-19,34
SV Josko Rie,9469,10,10,4,22,32,62,-30,34
FC Salzburg,9470,1,24,7,5,73,28,45,79
SK Sturm Gra,9470,2,18,8,10,54,32,22,62
SC Rheindorf,9470,3,17,8,11,55,44,11,59
Vienna,9470,4,17,6,13,55,51,4,57
RZ Pellets W,9470,5,14,7,15,51,55,-4,49
Rapid Vienna,9470,6,12,11,13,54,46,8,47
Admira Wacke,9470,7,11,8,17,35,57,-22,41
St. Pölten,9470,8,9,12,15,43,61,-18,39
SV Josko Rie,9470,9,9,8,19,33,55,-22,35
Mattersburg,9470,10,5,13,18,38,62,-24,28
FC Salzburg,9471,1,22,8,6,75,39,36,74
SC Rheindorf,9471,2,21,6,9,62,41,21,69
SK Sturm Gra,9471,3,19,7,10,59,34,25,64
Vienna,9471,4,17,6,13,53,49,4,57
Rapid Vienna,9471,5,15,10,11,59,43,16,55
Admira Wacke,9471,6,13,4,19,41,57,-16,43
RZ Pellets W,9471,7,11,7,18,43,60,-17,40
St. Pölten,9471,8,9,10,17,42,64,-22,37
SV Josko Rie,9471,9,10,5,21,29,51,-22,35
Mattersburg,9471,10,8,7,21,34,59,-25,31
FC Salzburg,9472,1,20,8,8,67,34,33,68
SK Sturm Gra,9472,2,21,5,10,61,35,26,68
Vienna,9472,3,21,4,11,66,49,17,67
SC Rheindorf,9472,4,20,7,9,54,37,17,67
Rapid Vienna,9472,5,14,11,11,56,46,10,53
Admira Wacke,9472,6,12,7,17,38,56,-18,43
RZ Pellets W,9472,7,9,12,15,38,47,-9,39
Mattersburg,9472,8,9,8,19,39,56,-17,35
SV Josko Rie,9472,9,9,6,21,32,57,-25,33
St. Pölten,9472,10,6,10,20,33,67,-34,28
SK Sturm Gra,9473,1,22,6,8,61,30,31,72
SC Rheindorf,9473,2,22,5,9,54,36,18,71
FC Salzburg,9473,3,20,9,7,59,29,30,69
Vienna,9473,4,20,2,14,61,49,12,62
Rapid Vienna,9473,5,14,9,13,64,47,17,51
RZ Pellets W,9473,6,11,6,19,40,56,-16,39
SV Josko Rie,9473,7,10,8,18,35,49,-14,38
Admira Wacke,9473,8,11,5,20,35,62,-27,38
Mattersburg,9473,9,9,10,17,33,55,-22,37
St. Pölten,9473,10,6,10,20,38,67,-29,28
FC Salzburg,9474,1,19,11,6,64,28,36,68
Vienna,9474,2,21,4,11,56,41,15,67
SC Rheindorf,9474,3,19,6,11,52,43,9,63
SK Sturm Gra,9474,4,17,5,14,60,44,16,56
Rapid Vienna,9474,5,14,9,13,53,38,15,51
RZ Pellets W,9474,6,14,9,13,46,52,-6,51
Admira Wacke,9474,7,12,7,17,34,60,-26,43
SV Josko Rie,9474,8,10,8,18,34,50,-16,38
Mattersburg,9474,9,8,11,17,30,47,-17,35
St. Pölten,9474,10,5,12,19,40,66,-26,27
FC Salzburg,9475,1,19,11,6,62,27,35,68
SC Rheindorf,9475,2,20,8,8,66,44,22,68
SK Sturm Gra,9475,3,20,5,11,53,35,18,65
Vienna,9475,4,17,5,14,55,56,-1,56
RZ Pellets W,9475,5,13,10,13,49,47,2,49
Admira Wacke,9475,6,12,10,14,37,52,-15,46
Rapid Vienna,9475,7,10,13,13,47,45,2,43
SV Josko Rie,9475,8,10,7,19,35,55,-20,37
Mattersburg,9475,9,8,10,18,41,62,-21,34
St. Pölten,9475,10,5,13,18,41,63,-22,28
FC Salzburg,9476,1,23,7,6,69,30,39,76
SK Sturm Gra,9476,2,19,7,10,56,33,23,64
SC Rheindorf,9476,3,19,7,10,55,40,15,64
Vienna,9476,4,19,5,12,62,49,13,62
Rapid Vienna,9476,5,14,10,12,52,43,9,52
SV Josko Rie,9476,6,13,6,17,34,47,-13,45
RZ Pellets W,9476,7,12,6,18,43,59,-16,42
Admira Wacke,9476,8,11,5,20,38,57,-19,38
Mattersburg,9476,9,8,8,20,35,61,-26,32
St. Pölten,9476,10,8,7,21,42,67,-25,31
SK Sturm Gra,9477,1,23,5,8,59,26,33,74
FC Salzburg,9477,2,20,8,8,68,30,38,68
SC Rheindorf,9477,3,19,8,9,60,43,17,65
Rapid Vienna,9477,4,16,11,9,58,37,21,59
Vienna,9477,5,16,8,12,57,53,4,56
RZ Pellets W,9477,6,12,8,16,42,53,-11,44
SV Josko Rie,9477,7,10,8,18,33,48,-15,38
Admira Wacke,9477,8,10,8,18,31,57,-26,38
St. Pölten,9477,9,7,11,18,34,66,-32,32
Mattersburg,9477,10,6,7,23,30,59,-29,25
FC Salzburg,9478,1,24,5,7,76,29,47,77
SK Sturm Gra,9478,2,21,5,10,64,38,26,68
SC Rheindorf,9478,3,18,10,8,59,43,16,64
Vienna,9478,4,17,7,12,60,55,5,58
Rapid Vienna,9478,5,14,10,12,64,48,16,52
Admira Wacke,9478,6,13,4,19,37,60,-23,43
RZ Pellets W,9478,7,12,5,19,41,59,-18,41
SV Josko Rie,9478,8,12,4,20,38,55,-17,40
St. Pölten,9478,9,9,9,18,47,64,-17,36
Mattersburg,9478,10,7,7,22,37,72,-35,28
FC Salzburg,9479,1,22,9,5,62,26,36,75
SC Rheindorf,9479,2,22,9,5,62,36,26,75
Vienna,9479,3,18,5,13,67,55,12,59
SK Sturm Gra,9479,4,16,5,15,56,43,13,53
Rapid Vienna,9479,5,14,10,12,56,46,10,52
RZ Pellets W,9479,6,14,6,16,45,53,-8,48
SV Josko Rie,9479,7,14,5,17,41,49,-8,47
Admira Wacke,9479,8,10,5,21,34,67,-33,35
Mattersburg,9479,9,7,9,20,28,49,-21,30
St. Pölten,9479,10,7,9,20,40,67,-27,30
SC Rheindorf,9480,1,20,10,6,62,40,22,70
FC Salzburg,9480,2,21,5,10,69,37,32,68
SK Sturm Gra,9480,3,20,7,9,62,32,30,67
Vienna,9480,4,18,7,11,59,50,9,61
RZ Pellets W,9480,5,14,9,13,51,51,0,51
Rapid Vienna,9480,6,11,12,13,48,43,5,45
Admira Wacke,9480,7,11,8,17,41,63,-22,41
SV Josko Rie,9480,8,10,8,18,35,56,-21,38
St. Pölten,9480,9,5,13,18,36,62,-26,28
Mattersburg,9480,10,7,7,22,32,61,-29,28
SK Sturm Gra,9481,1,22,5,9,65,35,30,71
SC Rheindorf,9481,2,21,7,8,62,43,19,70
FC Salzburg,9481,3,19,11,6,66,30,36,68
Vienna,9481,4,19,6,11,60,48,12,63
Rapid Vienna,9481,5,13,12,11,59,39,20,51
RZ Pellets W,9481,6,11,9,16,45,55,-10,42
Admira Wacke,9481,7,12,6,18,39,66,-27,42
SV Josko Rie,9481,8,9,7,20,34,58,-24,34
St. Pölten,9481,9,7,11,18,41,63,-22,32
Mattersburg,9481,10,6,8,22,31,65,-34,26
SC Rheindorf,9482,1,21,8,7,61,40,21,71
FC Salzburg,9482,2,20,9,7,66,30,36,69
SK Sturm Gra,9482,3,20,4,12,65,38,27,64
Vienna,9482,4,18,7,11,65,50,15,61
Rapid Vienna,9482,5,13,9,14,55,49,6,48
Mattersburg,9482,6,12,8,16,43,56,-13,44
RZ Pellets W,9482,7,11,7,18,46,60,-14,40
St. Pölten,9482,8,9,10,17,41,60,-19,37
Admira Wacke,9482,9,10,6,20,38,69,-31,36
SV Josko Rie,9482,10,9,6,21,33,61,-28,33
FC Salzburg,9483,1,22,10,4,68,25,43,76
SK Sturm Gra,9483,2,19,7,10,59,35,24,64
Vienna,9483,3,19,7,10,62,44,18,64
SC Rheindorf,9483,4,17,10,9,57,48,9,61
Rapid Vienna,9483,5,11,14,11,52,41,11,47
RZ Pellets W,9483,6,10,11,15,40,54,-14,41
St. Pölten,9483,7,11,8,17,46,63,-17,41
Admira Wacke,9483,8,9,7,20,30,55,-25,34
SV Josko Rie,9483,9,9,7,20,28,58,-30,34
Mattersburg,9483,10,8,9,19,39,58,-19,33
FC Salzburg,9484,1,23,5,8,71,33,38,74
SC Rheindorf,9484,2,21,5,10,56,36,20,68
Vienna,9484,3,20,6,10,58,43,15,66
SK Sturm Gra,9484,4,18,6,12,51,36,15,60
Rapid Vienna,9484,5,14,12,10,55,39,16,54
Admira Wacke,9484,6,12,6,18,35,55,-20,42
RZ Pellets W,9484,7,11,8,17,43,59,-16,41
St. Pölten,9484,8,10,7,19,40,60,-20,37
Mattersburg,9484,9,9,7,20,33,53,-20,34
SV Josko Rie,9484,10,8,6,22,27,55,-28,30
FC Salzburg,9485,1,19,11,6,67,31,36,68
Vienna,9485,2,18,8,10,69,52,17,62
SC Rheindorf,9485,3,17,11,8,47,39,8,62
SK Sturm Gra,9485,4,17,10,9,59,33,26,61
Rapid Vienna,9485,5,15,10,11,54,41,13,55
Admira Wacke,9485,6,12,8,16,34,54,-20,44
RZ Pellets W,9485,7,10,7,19,39,58,-19,37
Mattersburg,9485,8,8,12,16,34,49,-15,36
St. Pölten,9485,9,8,10,18,39,62,-23,34
SV Josko Rie,9485,10,9,7,20,28,51,-23,34
SC Rheindorf,9486,1,22,8,6,63,36,27,74
FC Salzburg,9486,2,20,8,8,64,28,36,68
SK Sturm Gra,9486,3,19,7,10,59,34,25,64
Vienna,9486,4,19,5,12,66,52,14,62
Rapid Vienna,9486,5,11,15,10,53,39,14,48
Admira Wacke,9486,6,13,5,18,35,57,-22,44
RZ Pellets W,9486,7,12,6,18,40,56,-16,42
SV Josko Rie,9486,8,12,3,21,34,56,-22,39
Mattersburg,9486,9,8,9,19,35,61,-26,33
St. Pölten,9486,10,7,8,21,37,67,-30,29
FC Salzburg,9487,1,20,10,6,69,33,36,70
SC Rheindorf,9487,2,20,9,7,67,43,24,69
SK Sturm Gra,9487,3,19,9,8,64,34,30,66
Vienna,9487,4,20,5,11,70,58,12,65
Rapid Vienna,9487,5,12,13,11,54,42,12,49
RZ Pellets W,9487,6,11,8,17,38,60,-22,41
SV Josko Rie,9487,7,10,9,17,41,52,-11,39
Admira Wacke,9487,8,10,5,21,38,62,-24,35
Mattersburg,9487,9,8,8,20,37,63,-26,32
St. Pölten,9487,10,7,10,19,45,76,-31,31
SC Rheindorf,9488,1,22,7,7,63,37,26,73
FC Salzburg,9488,2,18,10,8,67,34,33,64
SK Sturm Gra,9488,3,18,9,9,58,32,26,63
Vienna,9488,4,19,5,12,63,55,8,62
RZ Pellets W,9488,5,13,9,14,43,50,-7,48
Rapid Vienna,9488,6,11,11,14,46,46,0,44
Mattersburg,9488,7,9,10,17,40,51,-11,37
SV Josko Rie,9488,8,10,7,19,40,59,-19,37
Admira Wacke,9488,9,9,10,17,37,64,-27,37
St. Pölten,9488,10,8,8,20,41,70,-29,32
FC Salzburg,9489,1,20,9,7,66,31,35,69
SK Sturm Gra,9489,2,18,8,10,61,37,24,62
SC Rheindorf,9489,3,18,8,10,50,42,8,62
Vienna,9489,4,18,4,14,68,56,12,58
Rapid Vienna,9489,5,15,10,11,58,40,18,55
RZ Pellets W,9489,6,14,7,15,51,58,-7,49
St. Pölten,9489,7,12,9,15,50,59,-9,45
Admira Wacke,9489,8,11,5,20,38,66,-28,38
Mattersburg,9489,9,9,8,19,40,59,-19,35
SV Josko Rie,9489,10,7,8,21,31,65,-34,29
SC Rheindorf,9490,1,19,8,9,61,45,16,65
FC Salzburg,9490,2,18,10,8,66,34,32,64
SK Sturm Gra,9490,3,18,6,12,55,38,17,60
Vienna,9490,4,17,6,13,62,54,8,57
Rapid Vienna,9490,5,14,13,9,53,40,13,55
RZ Pellets W,9490,6,13,9,14,48,53,-5,48
Admira Wacke,9490,7,12,5,19,40,60,-20,41
St. Pölten,9490,8,8,12,16,42,61,-19,36
SV Josko Rie,9490,9,10,6,20,35,59,-24,36
Mattersburg,9490,10,8,11,17,42,60,-18,35
SK Sturm Gra,9491,1,20,6,10,62,39,23,66
Vienna,9491,2,20,5,11,63,52,11,65
SC Rheindorf,9491,3,18,6,12,55,47,8,60
Rapid Vienna,9491,4,15,12,9,63,40,23,57
FC Salzburg,9491,5,15,12,9,57,38,19,57
Mattersburg,9491,6,10,10,16,48,59,-11,40
St. Pölten,9491,7,10,9,17,45,60,-15,39
SV Josko Rie,9491,8,11,6,19,37,58,-21,39
Admira Wacke,9491,9,10,9,17,42,64,-22,39
RZ Pellets W,9491,10,10,7,19,45,60,-15,37
SC Rheindorf,9492,1,20,8,8,49,42,7,68
SK Sturm Gra,9492,2,20,5,11,57,33,24,65
FC Salzburg,9492,3,19,6,11,67,37,30,63
Vienna,9492,4,18,5,13,62,51,11,59
Rapid Vienna,9492,5,15,9,12,65,43,22,54
Admira Wacke,9492,6,13,6,17,47,64,-17,45
SV Josko Rie,9492,7,12,6,18,40,51,-11,42
RZ Pellets W,9492,8,11,8,17,41,58,-17,41
St. Pölten,9492,9,9,10,17,44,69,-25,37
Mattersburg,9492,10,7,9,20,38,62,-24,30
SC Rheindorf,9493,1,22,6,8,57,41,16,72
FC Salzburg,9493,2,20,9,7,54,28,26,69
Vienna,9493,3,20,3,13,71,54,17,63
SK Sturm Gra,9493,4,16,7,13,50,40,10,55
Rapid Vienna,9493,5,12,11,13,53,44,9,47
RZ Pellets W,9493,6,12,9,15,42,53,-11,45
Admira Wacke,9493,7,12,7,17,37,54,-17,43
Mattersburg,9493,8,9,11,16,38,47,-9,38
SV Josko Rie,9493,9,9,7,20,31,48,-17,34
St. Pölten,9493,10,8,10,18,39,63,-24,34
SC Rheindorf,9494,1,23,6,7,63,39,24,75
Vienna,9494,2,22,6,8,63,42,21,72
FC Salzburg,9494,3,18,10,8,59,31,28,64
SK Sturm Gra,9494,4,18,7,11,58,37,21,61
Rapid Vienna,9494,5,16,8,12,59,48,11,56
Admira Wacke,9494,6,12,7,17,36,52,-16,43
RZ Pellets W,9494,7,11,7,18,41,53,-12,40
SV Josko Rie,9494,8,9,7,20,38,56,-18,34
St. Pölten,9494,9,7,9,20,37,65,-28,30
Mattersburg,9494,10,7,7,22,31,62,-31,28
FC Salzburg,9495,1,21,5,10,68,32,36,68
SC Rheindorf,9495,2,20,6,10,49,39,10,66
SK Sturm Gra,9495,3,18,8,10,57,30,27,62
Vienna,9495,4,18,5,13,56,48,8,59
Rapid Vienna,9495,5,15,11,10,53,39,14,56
RZ Pellets W,9495,6,13,8,15,49,48,1,47
Mattersburg,9495,7,10,7,19,42,65,-23,37
SV Josko Rie,9495,8,10,6,20,34,54,-20,36
St. Pölten,9495,9,8,12,16,39,64,-25,36
Admira Wacke,9495,10,10,6,20,31,59,-28,36
FC Salzburg,9496,1,24,6,6,70,28,42,78
SC Rheindorf,9496,2,20,9,7,56,38,18,69
SK Sturm Gra,9496,3,19,5,12,63,34,29,62
Vienna,9496,4,19,2,15,60,54,6,59
Rapid Vienna,9496,5,16,10,10,57,43,14,58
RZ Pellets W,9496,6,12,7,17,43,56,-13,43
Admira Wacke,9496,7,10,8,18,35,59,-24,38
Mattersburg,9496,8,7,12,17,38,55,-17,33
SV Josko Rie,9496,9,9,6,21,33,57,-24,33
St. Pölten,9496,10,7,9,20,33,64,-31,30
SK Sturm Gra,9497,1,20,8,8,64,34,30,68
FC Salzburg,9497,2,20,7,9,61,36,25,67
Vienna,9497,3,19,6,11,63,51,12,63
SC Rheindorf,9497,4,18,7,11,52,39,13,61
Rapid Vienna,9497,5,12,12,12,55,41,14,48
RZ Pellets W,9497,6,13,9,14,48,56,-8,48
SV Josko Rie,9497,7,14,5,17,42,50,-8,47
Admira Wacke,9497,8,9,9,18,38,66,-28,36
St. Pölten,9497,9,9,8,19,40,64,-24,35
Mattersburg,9497,10,6,9,21,30,56,-26,27
SC Rheindorf,9498,1,20,7,9,55,41,14,67
Vienna,9498,2,20,5,11,66,47,19,65
FC Salzburg,9498,3,17,11,8,64,32,32,62
SK Sturm Gra,9498,4,17,8,11,54,36,18,59
Rapid Vienna,9498,5,13,11,12,51,47,4,50
Admira Wacke,9498,6,13,5,18,34,55,-21,44
Mattersburg,9498,7,11,10,15,42,54,-12,43
RZ Pellets W,9498,8,12,5,19,39,51,-12,41
St. Pölten,9498,9,9,9,18,42,63,-21,36
SV Josko Rie,9498,10,10,5,21,39,60,-21,35
SC Rheindorf,9499,1,22,6,8,58,40,18,72
FC Salzburg,9499,2,20,10,6,64,31,33,70
SK Sturm Gra,9499,3,19,6,11,59,34,25,63
Vienna,9499,4,17,7,12,57,51,6,58
Rapid Vienna,9499,5,13,12,11,53,40,13,51
RZ Pellets W,9499,6,13,8,15,40,47,-7,47
Admira Wacke,9499,7,11,6,19,33,51,-18,39
St. Pölten,9499,8,9,9,18,40,60,-20,36
SV Josko Rie,9499,9,10,5,21,28,50,-22,35
Mattersburg,9499,10,6,11,19,36,64,-28,29
FC Salzburg,9500,1,21,7,8,66,33,33,70
Vienna,9500,2,21,5,10,66,50,16,68
SC Rheindorf,9500,3,18,9,9,53,42,11,63
SK Sturm Gra,9500,4,17,5,14,52,38,14,56
Admira Wacke,9500,5,14,6,16,41,50,-9,48
Rapid Vienna,9500,6,11,11,14,46,44,2,44
RZ Pellets W,9500,7,12,8,16,48,60,-12,44
St. Pölten,9500,8,11,9,16,41,54,-13,42
SV Josko Rie,9500,9,11,7,18,35,46,-11,40
Mattersburg,9500,10,6,9,21,35,66,-31,27
SK Sturm Gra,9501,1,22,5,9,63,30,33,71
FC Salzburg,9501,2,20,10,6,64,33,31,70
SC Rheindorf,9501,3,20,6,10,59,45,14,66
Vienna,9501,4,17,6,13,63,53,10,57
Rapid Vienna,9501,5,14,10,12,56,45,11,52
SV Josko Rie,9501,6,12,7,17,40,55,-15,43
Mattersburg,9501,7,11,6,19,43,58,-15,39
RZ Pellets W,9501,8,11,6,19,40,59,-19,39
St. Pölten,9501,9,8,10,18,43,62,-19,34
Admira Wacke,9501,10,8,8,20,29,60,-31,32
FC Salzburg,9502,1,22,9,5,62,24,38,75
SK Sturm Gra,9502,2,19,6,11,59,33,26,63
SC Rheindorf,9502,3,18,8,10,51,42,9,62
Vienna,9502,4,17,8,11,54,44,10,59
Rapid Vienna,9502,5,12,13,11,50,36,14,49
SV Josko Rie,9502,6,14,5,17,38,49,-11,47
Admira Wacke,9502,7,12,8,16,38,54,-16,44
RZ Pellets W,9502,8,10,9,17,41,59,-18,39
Mattersburg,9502,9,7,11,18,33,56,-23,32
St. Pölten,9502,10,5,11,20,34,63,-29,26
FC Salzburg,9503,1,21,8,7,65,29,36,71
SC Rheindorf,9503,2,19,9,8,56,41,15,66
SK Sturm Gra,9503,3,19,6,11,56,31,25,63
Vienna,9503,4,20,3,13,64,52,12,63
Rapid Vienna,9503,5,16,11,9,58,41,17,59
RZ Pellets W,9503,6,12,7,17,40,55,-15,43
Admira Wacke,9503,7,11,5,20,34,52,-18,38
Mattersburg,9503,8,9,9,18,37,57,-20,36
St. Pölten,9503,9,8,9,19,41,66,-25,33
SV Josko Rie,9503,10,8,7,21,26,53,-27,31
FC Salzburg,9504,1,24,7,5,78,29,49,79
SK Sturm Gra,9504,2,19,8,9,62,36,26,65
Vienna,9504,3,19,5,12,62,52,10,62
SC Rheindorf,9504,4,17,10,9,54,43,11,61
Rapid Vienna,9504,5,12,10,14,60,51,9,46
RZ Pellets W,9504,6,12,9,15,53,63,-10,45
Admira Wacke,9504,7,13,6,17,38,57,-19,45
Mattersburg,9504,8,9,9,18,42,57,-15,36
SV Josko Rie,9504,9,8,7,21,34,63,-29,31
St. Pölten,9504,10,7,9,20,42,74,-32,30
SK Sturm Gra,9505,1,21,6,9,57,31,26,69
FC Salzburg,9505,2,19,10,7,63,31,32,67
SC Rheindorf,9505,3,17,10,9,52,42,10,61
Vienna,9505,4,17,7,12,64,55,9,58
Rapid Vienna,9505,5,13,12,11,55,35,20,51
Mattersburg,9505,6,12,8,16,42,55,-13,44
Admira Wacke,9505,7,11,7,18,36,58,-22,40
RZ Pellets W,9505,8,10,8,18,41,59,-18,38
SV Josko Rie,9505,9,10,5,21,33,52,-19,35
St. Pölten,9505,10,8,11,17,37,62,-25,35
SC Rheindorf,9506,1,22,9,5,63,33,30,75
FC Salzburg,9506,2,20,8,8,69,35,34,68
SK Sturm Gra,9506,3,18,9,9,56,32,24,63
Vienna,9506,4,19,3,14,64,59,5,60
Admira Wacke,9506,5,14,6,16,40,54,-14,48
Rapid Vienna,9506,6,11,13,12,49,39,10,46
RZ Pellets W,9506,7,13,7,16,48,58,-10,46
St. Pölten,9506,8,8,11,17,37,62,-25,35
SV Josko Rie,9506,9,10,5,21,25,50,-25,35
Mattersburg,9506,10,5,9,22,29,58,-29,24
FC Salzburg,9507,1,23,5,8,74,33,41,74
Vienna,9507,2,20,5,11,69,53,16,65
Rapid Vienna,9507,3,17,9,10,58,41,17,60
SK Sturm Gra,9507,4,16,7,13,53,37,16,55
SC Rheindorf,9507,5,16,7,13,50,50,0,55
RZ Pellets W,9507,6,11,11,14,51,57,-6,44
Admira Wacke,9507,7,11,8,17,34,58,-24,41
Mattersburg,9507,8,10,8,18,40,54,-14,38
SV Josko Rie,9507,9,10,7,19,32,53,-21,37
St. Pölten,9507,10,8,9,19,40,65,-25,33
FC Salzburg,9508,1,20,9,7,62,31,31,69
SC Rheindorf,9508,2,21,5,10,51,41,10,68
Vienna,9508,3,20,5,11,62,49,13,65
SK Sturm Gra,9508,4,19,7,10,56,32,24,64
Rapid Vienna,9508,5,13,13,10,60,45,15,52
RZ Pellets W,9508,6,10,10,16,46,62,-16,40
Admira Wacke,9508,7,11,7,18,37,54,-17,40
St. Pölten,9508,8,10,8,18,42,60,-18,38
SV Josko Rie,9508,9,9,7,20,34,53,-19,34
Mattersburg,9508,10,6,11,19,35,58,-23,29
SK Sturm Gra,9509,1,20,7,9,54,30,24,67
FC Salzburg,9509,2,20,6,10,68,35,33,66
SC Rheindorf,9509,3,18,8,10,54,42,12,62
Vienna,9509,4,16,9,11,56,50,6,57
Rapid Vienna,9509,5,14,9,13,55,43,12,51
RZ Pellets W,9509,6,13,7,16,47,49,-2,46
SV Josko Rie,9509,7,12,6,18,33,50,-17,42
Admira Wacke,9509,8,11,8,17,37,58,-21,41
St. Pölten,9509,9,9,9,18,40,61,-21,36
Mattersburg,9509,10,8,9,19,34,60,-26,33
FC Salzburg,9510,1,22,5,9,64,29,35,71
SC Rheindorf,9510,2,21,7,8,63,43,20,70
SK Sturm Gra,9510,3,19,6,11,55,33,22,63
Vienna,9510,4,17,7,12,57,49,8,58
Rapid Vienna,9510,5,15,10,11,62,42,20,55
RZ Pellets W,9510,6,13,8,15,47,55,-8,47
SV Josko Rie,9510,7,13,3,20,32,53,-21,42
Admira Wacke,9510,8,11,7,18,38,64,-26,40
Mattersburg,9510,9,8,10,18,38,53,-15,34
St. Pölten,9510,10,6,7,23,36,71,-35,25
SC Rheindorf,9511,1,22,7,7,63,35,28,73
SK Sturm Gra,9511,2,21,5,10,56,34,22,68
FC Salzburg,9511,3,19,6,11,62,31,31,63
Vienna,9511,4,19,6,11,71,57,14,63
Rapid Vienna,9511,5,15,12,9,58,34,24,57
Admira Wacke,9511,6,11,7,18,33,62,-29,40
SV Josko Rie,9511,7,10,8,18,38,56,-18,38
RZ Pellets W,9511,8,10,8,18,45,64,-19,38
Mattersburg,9511,9,9,9,18,35,53,-18,36
St. Pölten,9511,10,6,8,22,38,73,-35,26
SC Rheindorf,9512,1,20,7,9,63,51,12,67
SK Sturm Gra,9512,2,19,8,9,57,30,27,65
FC Salzburg,9512,3,19,8,9,57,31,26,65
Vienna,9512,4,19,7,10,65,48,17,64
Rapid Vienna,9512,5,15,11,10,54,40,14,56
SV Josko Rie,9512,6,14,3,19,43,47,-4,45
RZ Pellets W,9512,7,10,9,17,40,54,-14,39
Admira Wacke,9512,8,11,6,19,34,63,-29,39
St. Pölten,9512,9,7,11,18,36,63,-27,32
Mattersburg,9512,10,6,10,20,34,56,-22,28
FC Salzburg,9513,1,22,8,6,77,31,46,74
SK Sturm Gra,9513,2,20,7,9,54,28,26,67
SC Rheindorf,9513,3,19,7,10,54,46,8,64
Rapid Vienna,9513,4,17,10,9,60,32,28,61
Vienna,9513,5,17,5,14,55,53,2,56
RZ Pellets W,9513,6,14,6,16,48,52,-4,48
SV Josko Rie,9513,7,10,6,20,31,59,-28,36
St. Pölten,9513,8,9,8,19,46,64,-18,35
Admira Wacke,9513,9,10,5,21,31,59,-28,35
Mattersburg,9513,10,6,10,20,33,65,-32,28
SK Sturm Gra,9514,1,20,6,10,53,34,19,66
SC Rheindorf,9514,2,20,6,10,56,42,14,66
FC Salzburg,9514,3,19,8,9,64,33,31,65
Vienna,9514,4,18,9,9,64,48,16,63
Rapid Vienna,9514,5,18,8,10,60,31,29,62
Admira Wacke,9514,6,13,9,14,44,53,-9,48
Mattersburg,9514,7,10,8,18,40,59,-19,38
RZ Pellets W,9514,8,9,8,19,42,62,-20,35
SV Josko Rie,9514,9,10,3,23,31,59,-28,33
St. Pölten,9514,10,6,9,21,36,69,-33,27
FC Salzburg,9515,1,21,6,9,69,37,32,69
SK Sturm Gra,9515,2,20,7,9,63,32,31,67
Vienna,9515,3,20,3,13,68,56,12,63
SC Rheindorf,9515,4,17,8,11,52,43,9,59
Rapid Vienna,9515,5,14,11,11,56,43,13,53
SV Josko Rie,9515,6,13,5,18,35,49,-14,44
Admira Wacke,9515,7,12,7,17,33,55,-22,43
RZ Pellets W,9515,8,11,8,17,42,58,-16,41
St. Pölten,9515,9,7,11,18,40,64,-24,32
Mattersburg,9515,10,7,10,19,34,55,-21,31
FC Salzburg,9516,1,25,7,4,74,23,51,82
SK Sturm Gra,9516,2,23,6,7,66,26,40,75
SC Rheindorf,9516,3,19,9,8,50,42,8,66
Vienna,9516,4,16,5,15,54,63,-9,53
Rapid Vienna,9516,5,12,12,12,52,41,11,48
RZ Pellets W,9516,6,13,6,17,55,57,-2,45
Mattersburg,9516,7,8,11,17,37,52,-15,35
Admira Wacke,9516,8,9,7,20,27,58,-31,34
SV Josko Rie,9516,9,9,6,21,31,57,-26,33
St. Pölten,9516,10,7,9,20,37,64,-27,30
FC Salzburg,9517,1,21,7,8,66,28,38,70
SC Rheindorf,9517,2,18,10,8,49,37,12,64
Rapid Vienna,9517,3,18,9,9,64,42,22,63
SK Sturm Gra,9517,4,17,9,10,51,33,18,60
Vienna,9517,5,17,4,15,62,59,3,55
SV Josko Rie,9517,6,14,7,15,39,48,-9,49
RZ Pellets W,9517,7,14,5,17,47,52,-5,47
Admira Wacke,9517,8,11,6,19,39,59,-20,39
St. Pölten,9517,9,7,11,18,42,69,-27,32
Mattersburg,9517,10,6,6,24,32,64,-32,24
FC Salzburg,9518,1,22,7,7,63,29,34,73
SK Sturm Gra,9518,2,21,4,11,60,35,25,67
SC Rheindorf,9518,3,18,6,12,55,42,13,60
Vienna,9518,4,18,6,12,67,56,11,60
SV Josko Rie,9518,5,17,2,17,42,47,-5,53
Rapid Vienna,9518,6,13,10,13,54,41,13,49
RZ Pellets W,9518,7,14,6,16,50,56,-6,48
Admira Wacke,9518,8,12,4,20,39,67,-28,40
St. Pölten,9518,9,7,9,20,38,63,-25,30
Mattersburg,9518,10,8,6,22,32,64,-32,30
FC Salzburg,9519,1,22,6,8,67,33,34,72
SC Rheindorf,9519,2,19,9,8,62,49,13,66
Vienna,9519,3,19,6,11,63,51,12,63
SK Sturm Gra,9519,4,16,7,13,46,35,11,55
Rapid Vienna,9519,5,12,11,13,51,39,12,47
Admira Wacke,9519,6,11,9,16,36,52,-16,42
St. Pölten,9519,7,10,11,15,54,66,-12,41
RZ Pellets W,9519,8,10,9,17,39,56,-17,39
Mattersburg,9519,9,9,10,17,38,55,-17,37
SV Josko Rie,9519,10,10,6,20,37,57,-20,36
SC Rheindorf,9520,1,21,9,6,62,41,21,72
FC Salzburg,9520,2,18,9,9,62,30,32,63
SK Sturm Gra,9520,3,18,8,10,56,30,26,62
Vienna,9520,4,18,7,11,60,49,11,61
Rapid Vienna,9520,5,12,11,13,52,38,14,47
RZ Pellets W,9520,6,11,9,16,42,57,-15,42
Admira Wacke,9520,7,12,6,18,37,60,-23,42
SV Josko Rie,9520,8,12,5,19,35,56,-21,41
St. Pölten,9520,9,9,8,19,43,68,-25,35
Mattersburg,9520,10,8,10,18,32,52,-20,34
FC Salzburg,9521,1,20,7,9,60,34,26,67
SK Sturm Gra,9521,2,19,6,11,56,35,21,63
SC Rheindorf,9521,3,18,8,10,59,44,15,62
Vienna,9521,4,17,5,14,64,64,0,56
RZ Pellets W,9521,5,14,9,13,50,49,1,51
Rapid Vienna,9521,6,11,15,10,52,40,12,48
SV Josko Rie,9521,7,13,5,18,34,48,-14,44
Admira Wacke,9521,8,10,8,18,37,57,-20,38
St. Pölten,9521,9,7,13,16,41,60,-19,34
Mattersburg,9521,10,8,10,18,38,60,-22,34
FC Salzburg,9522,1,22,8,6,66,29,37,74
SC Rheindorf,9522,2,19,8,9,65,48,17,65
Vienna,9522,3,20,4,12,68,58,10,64
SK Sturm Gra,9522,4,19,6,11,57,38,19,63
Rapid Vienna,9522,5,13,9,14,55,44,11,48
SV Josko Rie,9522,6,13,5,18,39,57,-18,44
RZ Pellets W,9522,7,13,4,19,47,56,-9,43
Admira Wacke,9522,8,11,6,19,35,57,-22,39
Mattersburg,9522,9,10,6,20,50,63,-13,36
St. Pölten,9522,10,8,8,20,38,70,-32,32
FC Salzburg,9523,1,21,8,7,66,31,35,71
SC Rheindorf,9523,2,20,9,7,62,41,21,69
SK Sturm Gra,9523,3,18,9,9,54,30,24,63
Rapid Vienna,9523,4,14,12,10,50,36,14,54
Vienna,9523,5,16,5,15,64,67,-3,53
RZ Pellets W,9523,6,11,10,15,44,52,-8,43
Mattersburg,9523,7,11,7,18,40,53,-13,40
Admira Wacke,9523,8,11,7,18,34,53,-19,40
SV Josko Rie,9523,9,9,8,19,36,58,-22,35
St. Pölten,9523,10,7,9,20,37,66,-29,30
FC Salzburg,9524,1,21,9,6,65,25,40,72
SC Rheindorf,9524,2,19,7,10,50,42,8,64
Vienna,9524,3,20,3,13,67,48,19,63
SK Sturm Gra,9524,4,16,10,10,51,31,20,58
RZ Pellets W,9524,5,14,9,13,48,52,-4,51
Rapid Vienna,9524,6,12,13,11,49,39,10,49
Admira Wacke,9524,7,13,8,15,41,60,-19,47
SV Josko Rie,9524,8,11,5,20,35,54,-19,38
St. Pölten,9524,9,8,8,20,39,66,-27,32
Mattersburg,9524,10,7,6,23,33,61,-28,27
SC Rheindorf,9525,1,20,7,9,62,44,18,67
FC Salzburg,9525,2,19,8,9,57,28,29,65
SK Sturm Gra,9525,3,19,7,10,61,37,24,64
Vienna,9525,4,17,4,15,60,56,4,55
Rapid Vienna,9525,5,13,8,15,49,45,4,47
St. Pölten,9525,6,12,9,15,45,59,-14,45
Admira Wacke,9525,7,13,5,18,44,60,-16,44
SV Josko Rie,9525,8,13,4,19,39,56,-17,43
RZ Pellets W,9525,9,10,10,16,40,54,-14,40
Mattersburg,9525,10,9,8,19,42,60,-18,35
Vienna,9526,1,21,6,9,72,49,23,69
FC Salzburg,9526,2,19,9,8,58,29,29,66
SK Sturm Gra,9526,3,19,5,12,54,34,20,62
SC Rheindorf,9526,4,17,11,8,53,43,10,62
Rapid Vienna,9526,5,16,9,11,60,42,18,57
Mattersburg,9526,6,12,9,15,45,57,-12,45
RZ Pellets W,9526,7,11,9,16,38,50,-12,42
Admira Wacke,9526,8,11,6,19,34,60,-26,39
St. Pölten,9526,9,9,9,18,45,63,-18,36
SV Josko Rie,9526,10,6,5,25,29,61,-32,23
FC Salzburg,9527,1,23,7,6,74,31,43,76
Vienna,9527,2,19,7,10,70,51,19,64
SC Rheindorf,9527,3,19,7,10,56,45,11,64
Rapid Vienna,9527,4,17,10,9,61,39,22,61
SK Sturm Gra,9527,5,17,6,13,58,39,19,57
Admira Wacke,9527,6,11,7,18,38,54,-16,40
RZ Pellets W,9527,7,8,11,17,39,61,-22,35
SV Josko Rie,9527,8,8,10,18,30,50,-20,34
Mattersburg,9527,9,8,10,18,40,61,-21,34
St. Pölten,9527,10,7,11,18,39,74,-35,32
SK Sturm Gra,9528,1,23,5,8,76,33,43,74
Vienna,9528,2,21,5,10,67,46,21,68
FC Salzburg,9528,3,19,10,7,63,33,30,67
SC Rheindorf,9528,4,17,9,10,54,48,6,60
Rapid Vienna,9528,5,13,13,10,59,45,14,52
Admira Wacke,9528,6,11,7,18,37,59,-22,40
St. Pölten,9528,7,10,9,17,48,67,-19,39
SV Josko Rie,9528,8,9,8,19,32,52,-20,35
RZ Pellets W,9528,9,9,7,20,39,61,-22,34
Mattersburg,9528,10,7,9,20,33,64,-31,30
FC Salzburg,9529,1,23,8,5,82,32,50,77
SC Rheindorf,9529,2,19,6,11,53,45,8,63
Vienna,9529,3,19,4,13,59,51,8,61
SK Sturm Gra,9529,4,17,9,10,59,39,20,60
Rapid Vienna,9529,5,15,11,10,59,42,17,56
SV Josko Rie,9529,6,13,5,18,35,49,-14,44
Admira Wacke,9529,7,12,6,18,37,65,-28,42
RZ Pellets W,9529,8,10,9,17,44,56,-12,39
St. Pölten,9529,9,8,9,19,40,61,-21,33
Mattersburg,9529,10,6,9,21,30,58,-28,27
SC Rheindorf,9530,1,23,6,7,62,38,24,75
SK Sturm Gra,9530,2,21,5,10,53,26,27,68
Vienna,9530,3,21,4,11,61,51,10,67
FC Salzburg,9530,4,17,6,13,55,35,20,57
Rapid Vienna,9530,5,15,10,11,57,39,18,55
Admira Wacke,9530,6,12,9,15,37,54,-17,45
RZ Pellets W,9530,7,9,9,18,41,57,-16,36
St. Pölten,9530,8,9,9,18,39,60,-21,36
SV Josko Rie,9530,9,11,3,22,31,55,-24,36
Mattersburg,9530,10,6,11,19,33,54,-21,29
FC Salzburg,9531,1,22,5,9,69,35,34,71
SK Sturm Gra,9531,2,22,5,9,63,35,28,71
SC Rheindorf,9531,3,20,8,8,58,44,14,68
Vienna,9531,4,16,5,15,56,57,-1,53
Rapid Vienna,9531,5,13,10,13,57,46,11,49
Mattersburg,9531,6,13,6,17,43,57,-14,45
RZ Pellets W,9531,7,11,9,16,43,55,-12,42
Admira Wacke,9531,8,11,7,18,40,60,-20,40
St. Pölten,9531,9,9,9,18,42,62,-20,36
SV Josko Rie,9531,10,9,4,23,37,57,-20,31
FC Salzburg,9532,1,21,10,5,73,30,43,73
SC Rheindorf,9532,2,22,6,8,57,39,18,72
SK Sturm Gra,9532,3,17,7,12,55,35,20,58
Vienna,9532,4,17,7,12,63,58,5,58
Rapid Vienna,9532,5,13,10,13,59,45,14,49
RZ Pellets W,9532,6,11,10,15,44,55,-11,43
SV Josko Rie,9532,7,13,4,19,38,50,-12,43
St. Pölten,9532,8,11,8,17,39,62,-23,41
Admira Wacke,9532,9,9,9,18,38,62,-24,36
Mattersburg,9532,10,6,9,21,30,60,-30,27
SC Rheindorf,9533,1,21,8,7,59,36,23,71
FC Salzburg,9533,2,19,10,7,62,32,30,67
SK Sturm Gra,9533,3,19,6,11,61,36,25,63
Rapid Vienna,9533,4,17,9,10,62,42,20,60
Vienna,9533,5,17,5,14,61,55,6,56
RZ Pellets W,9533,6,12,7,17,47,60,-13,43
SV Josko Rie,9533,7,11,6,19,33,56,-23,39
Mattersburg,9533,8,11,5,20,38,54,-16,38
Admira Wacke,9533,9,11,5,20,38,63,-25,38
St. Pölten,9533,10,7,9,20,35,62,-27,30
FC Salzburg,9534,1,23,6,7,76,36,40,75
SK Sturm Gra,9534,2,20,5,11,61,35,26,65
SC Rheindorf,9534,3,18,11,7,57,47,10,65
Vienna,9534,4,17,4,15,69,57,12,55
Rapid Vienna,9534,5,14,11,11,60,42,18,53
RZ Pellets W,9534,6,13,6,17,47,63,-16,45
Admira Wacke,9534,7,13,6,17,40,60,-20,45
SV Josko Rie,9534,8,12,6,18,41,57,-16,42
St. Pölten,9534,9,8,8,20,38,62,-24,32
Mattersburg,9534,10,6,9,21,40,70,-30,27
FC Salzburg,9535,1,22,8,6,64,26,38,74
SC Rheindorf,9535,2,19,10,7,57,37,20,67
Vienna,9535,3,19,6,11,60,44,16,63
SK Sturm Gra,9535,4,17,6,13,56,41,15,57
Rapid Vienna,9535,5,15,9,12,57,44,13,54
RZ Pellets W,9535,6,12,9,15,42,52,-10,45
Admira Wacke,9535,7,12,6,18,38,56,-18,42
Mattersburg,9535,8,8,11,17,36,53,-17,35
SV Josko Rie,9535,9,8,8,20,31,56,-25,32
St. Pölten,9535,10,6,11,19,34,66,-32,29
SC Rheindorf,9536,1,22,6,8,60,37,23,72
FC Salzburg,9536,2,19,9,8,62,32,30,66
Rapid Vienna,9536,3,19,9,8,62,34,28,66
SK Sturm Gra,9536,4,18,5,13,65,41,24,59
Vienna,9536,5,18,4,14,59,51,8,58
Admira Wacke,9536,6,14,8,14,41,54,-13,50
St. Pölten,9536,7,9,13,14,38,54,-16,40
RZ Pellets W,9536,8,11,7,18,42,60,-18,40
SV Josko Rie,9536,9,9,5,22,26,51,-25,32
Mattersburg,9536,10,4,8,24,32,73,-41,20
FC Salzburg,9537,1,21,8,7,62,29,33,71
SK Sturm Gra,9537,2,21,5,10,71,38,33,68
SC Rheindorf,9537,3,20,8,8,55,40,15,68
Vienna,9537,4,19,4,13,66,54,12,61
Rapid Vienna,9537,5,15,11,10,66,40,26,56
St. Pölten,9537,6,10,9,17,39,58,-19,39
RZ Pellets W,9537,7,11,6,19,43,63,-20,39
SV Josko Rie,9537,8,11,5,20,32,54,-22,38
Mattersburg,9537,9,8,10,18,34,55,-21,34
Admira Wacke,9537,10,8,6,22,28,65,-37,30
FC Salzburg,9538,1,21,7,8,64,31,33,70
SC Rheindorf,9538,2,20,8,8,49,35,14,68
SK Sturm Gra,9538,3,19,8,9,63,37,26,65
Vienna,9538,4,18,5,13,56,49,7,59
Rapid Vienna,9538,5,11,15,10,46,37,9,48
Admira Wacke,9538,6,12,7,17,34,53,-19,43
SV Josko Rie,9538,7,12,5,19,39,50,-11,41
RZ Pellets W,9538,8,10,10,16,44,56,-12,40
Mattersburg,9538,9,7,13,16,30,49,-19,34
St. Pölten,9538,10,6,10,20,32,60,-28,28
SK Sturm Gra,9539,1,21,7,8,66,31,35,70
Vienna,9539,2,21,4,11,60,45,15,67
SC Rheindorf,9539,3,17,9,10,50,41,9,60
FC Salzburg,9539,4,17,8,11,64,38,26,59
RZ Pellets W,9539,5,14,9,13,53,54,-1,51
Rapid Vienna,9539,6,12,11,13,50,45,5,47
SV Josko Rie,9539,7,13,5,18,38,53,-15,44
St. Pölten,9539,8,10,8,18,41,63,-22,38
Admira Wacke,9539,9,8,9,19,37,63,-26,33
Mattersburg,9539,10,7,10,19,34,60,-26,31
FC Salzburg,9540,1,23,5,8,67,32,35,74
Vienna,9540,2,20,5,11,61,44,17,65
SC Rheindorf,9540,3,18,7,11,52,49,3,61
SK Sturm Gra,9540,4,18,5,13,51,36,15,59
Rapid Vienna,9540,5,16,9,11,62,41,21,57
RZ Pellets W,9540,6,13,7,16,42,53,-11,46
Admira Wacke,9540,7,12,6,18,36,58,-22,42
SV Josko Rie,9540,8,11,5,20,37,50,-13,38
St. Pölten,9540,9,8,10,18,43,61,-18,34
Mattersburg,9540,10,7,9,20,30,57,-27,30
FC Salzburg,9541,1,21,8,7,64,31,33,71
SK Sturm Gra,9541,2,20,5,11,67,39,28,65
SC Rheindorf,9541,3,19,7,10,51,41,10,64
Vienna,9541,4,17,5,14,63,59,4,56
Rapid Vienna,9541,5,13,11,12,52,45,7,50
RZ Pellets W,9541,6,13,7,16,51,57,-6,46
Admira Wacke,9541,7,12,6,18,37,57,-20,42
SV Josko Rie,9541,8,10,8,18,31,46,-15,38
Mattersburg,9541,9,9,9,18,38,57,-19,36
St. Pölten,9541,10,8,10,18,41,63,-22,34
FC Salzburg,9542,1,19,10,7,64,29,35,67
SK Sturm Gra,9542,2,21,4,11,56,33,23,67
Vienna,9542,3,20,5,11,62,50,12,65
Rapid Vienna,9542,4,15,9,12,57,42,15,54
RZ Pellets W,9542,5,16,6,14,50,47,3,54
SC Rheindorf,9542,6,15,8,13,46,47,-1,53
Admira Wacke,9542,7,12,6,18,36,55,-19,42
SV Josko Rie,9542,8,12,5,19,33,51,-18,41
St. Pölten,9542,9,8,9,19,41,67,-26,33
Mattersburg,9542,10,6,10,20,37,61,-24,28
FC Salzburg,9543,1,21,7,8,60,26,34,70
SK Sturm Gra,9543,2,20,4,12,58,34,24,64
SC Rheindorf,9543,3,19,7,10,51,41,10,64
Admira Wacke,9543,4,16,5,15,41,52,-11,53
Rapid Vienna,9543,5,13,10,13,50,41,9,49
Vienna,9543,6,14,6,16,56,59,-3,48
St. Pölten,9543,7,12,7,17,47,54,-7,43
RZ Pellets W,9543,8,12,7,17,46,56,-10,43
Mattersburg,9543,9,10,8,18,41,62,-21,38
SV Josko Rie,9543,10,10,5,21,31,56,-25,35
SK Sturm Gra,9544,1,23,4,9,68,32,36,73
SC Rheindorf,9544,2,21,6,9,61,44,17,69
Vienna,9544,3,21,5,10,69,50,19,68
FC Salzburg,9544,4,20,7,9,61,32,29,67
Rapid Vienna,9544,5,14,8,14,53,42,11,50
RZ Pellets W,9544,6,13,8,15,49,55,-6,47
Admira Wacke,9544,7,11,6,19,41,61,-20,39
St. Pölten,9544,8,8,10,18,40,65,-25,34
SV Josko Rie,9544,9,9,6,21,30,59,-29,33
Mattersburg,9544,10,7,6,23,31,63,-32,27
FC Salzburg,9545,1,25,6,5,72,27,45,81
SK Sturm Gra,9545,2,21,4,11,66,33,33,67
Rapid Vienna,9545,3,17,9,10,59,35,24,60
Vienna,9545,4,18,4,14,64,62,2,58
SC Rheindorf,9545,5,17,6,13,53,49,4,57
RZ Pellets W,9545,6,12,8,16,52,64,-12,44
SV Josko Rie,9545,7,13,4,19,37,51,-14,43
Admira Wacke,9545,8,9,8,19,35,65,-30,35
St. Pölten,9545,9,9,6,21,38,64,-26,33
Mattersburg,9545,10,8,7,21,42,68,-26,31
FC Salzburg,9546,1,20,8,8,70,34,36,68
SC Rheindorf,9546,2,19,8,9,52,40,12,65
SK Sturm Gra,9546,3,18,7,11,62,44,18,61
Vienna,9546,4,18,4,14,59,56,3,58
Rapid Vienna,9546,5,13,13,10,64,45,19,52
RZ Pellets W,9546,6,14,9,13,52,50,2,51
Admira Wacke,9546,7,12,6,18,30,56,-26,42
SV Josko Rie,9546,8,10,6,20,43,59,-16,36
Mattersburg,9546,9,8,11,17,39,57,-18,35
St. Pölten,9546,10,6,12,18,41,71,-30,30
Vienna,9547,1,20,7,9,67,50,17,67
SK Sturm Gra,9547,2,19,9,8,57,32,25,66
SC Rheindorf,9547,3,20,4,12,56,43,13,64
FC Salzburg,9547,4,18,9,9,58,28,30,63
Rapid Vienna,9547,5,13,13,10,54,39,15,52
Admira Wacke,9547,6,14,7,15,35,47,-12,49
RZ Pellets W,9547,7,12,10,14,48,51,-3,46
SV Josko Rie,9547,8,10,8,18,34,55,-21,38
Mattersburg,9547,9,7,8,21,31,57,-26,29
St. Pölten,9547,10,5,9,22,36,74,-38,24
FC Salzburg,9548,1,22,8,6,63,25,38,74
Vienna,9548,2,18,7,11,65,51,14,61
SK Sturm Gra,9548,3,15,9,12,52,37,15,54
SC Rheindorf,9548,4,15,9,12,43,43,0,54
RZ Pellets W,9548,5,15,9,12,54,56,-2,54
Rapid Vienna,9548,6,13,12,11,51,42,9,51
SV Josko Rie,9548,7,13,7,16,34,44,-10,46
Admira Wacke,9548,8,11,6,19,37,58,-21,39
St. Pölten,9548,9,7,12,17,44,62,-18,33
Mattersburg,9548,10,8,7,21,34,59,-25,31
FC Salzburg,9549,1,20,7,9,65,35,30,67
SC Rheindorf,9549,2,18,11,7,56,39,17,65
SK Sturm Gra,9549,3,18,10,8,62,38,24,64
Vienna,9549,4,20,4,12,62,52,10,64
Rapid Vienna,9549,5,16,8,12,59,38,21,56
RZ Pellets W,9549,6,13,9,14,55,55,0,48
SV Josko Rie,9549,7,11,5,20,35,50,-15,38
Mattersburg,9549,8,8,9,19,35,63,-28,33
Admira Wacke,9549,9,8,9,19,33,65,-32,33
St. Pölten,9549,10,7,10,19,34,61,-27,31
FC Salzburg,9550,1,22,7,7,71,27,44,73
SC Rheindorf,9550,2,21,5,10,59,43,16,68
SK Sturm Gra,9550,3,18,8,10,56,37,19,62
Vienna,9550,4,18,7,11,62,49,13,61
RZ Pellets W,9550,5,15,8,13,47,52,-5,53
Rapid Vienna,9550,6,12,10,14,51,41,10,46
Admira Wacke,9550,7,12,5,19,29,58,-29,41
SV Josko Rie,9550,8,10,4,22,35,61,-26,34
St. Pölten,9550,9,8,9,19,40,62,-22,33
Mattersburg,9550,10,7,11,18,37,57,-20,32
SC Rheindorf,9551,1,20,6,10,52,44,8,66
FC Salzburg,9551,2,19,8,9,63,33,30,65
SK Sturm Gra,9551,3,17,7,12,57,37,20,58
Rapid Vienna,9551,4,15,8,13,54,37,17,53
Vienna,9551,5,15,8,13,58,54,4,53
RZ Pellets W,9551,6,14,8,14,49,51,-2,50
SV Josko Rie,9551,7,13,5,18,41,50,-9,44
Mattersburg,9551,8,11,7,18,38,52,-14,40
St. Pölten,9551,9,10,9,17,44,66,-22,39
Admira Wacke,9551,10,10,6,20,27,59,-32,36
SK Sturm Gra,9552,1,22,3,11,66,35,31,69
SC Rheindorf,9552,2,20,7,9,56,37,19,67
FC Salzburg,9552,3,18,8,10,75,46,29,62
Rapid Vienna,9552,4,17,9,10,65,42,23,60
Vienna,9552,5,18,5,13,59,54,5,59
RZ Pellets W,9552,6,13,6,17,52,56,-4,45
Admira Wacke,9552,7,13,5,18,40,64,-24,44
SV Josko Rie,9552,8,10,7,19,36,57,-21,37
Mattersburg,9552,9,9,9,18,30,49,-19,36
St. Pölten,9552,10,7,7,22,36,75,-39,28
FC Salzburg,9553,1,21,7,8,65,36,29,70
SC Rheindorf,9553,2,18,8,10,55,42,13,62
SK Sturm Gra,9553,3,17,9,10,48,32,16,60
Rapid Vienna,9553,4,16,11,9,59,37,22,59
Vienna,9553,5,16,5,15,54,48,6,53
Admira Wacke,9553,6,12,8,16,36,54,-18,44
RZ Pellets W,9553,7,11,9,16,39,51,-12,42
St. Pölten,9553,8,9,11,16,41,59,-18,38
Mattersburg,9553,9,9,9,18,40,60,-20,36
SV Josko Rie,9553,10,9,7,20,34,52,-18,34
FC Salzburg,9554,1,21,8,7,65,29,36,71
SK Sturm Gra,9554,2,20,6,10,57,34,23,66
SC Rheindorf,9554,3,19,7,10,56,48,8,64
Vienna,9554,4,20,3,13,66,54,12,63
Rapid Vienna,9554,5,15,11,10,59,38,21,56
RZ Pellets W,9554,6,13,7,16,47,54,-7,46
St. Pölten,9554,7,11,9,16,51,65,-14,42
Admira Wacke,9554,8,10,7,19,34,60,-26,37
SV Josko Rie,9554,9,9,3,24,37,69,-32,30
Mattersburg,9554,10,6,11,19,36,57,-21,29
SC Rheindorf,9555,1,19,7,10,55,42,13,64
SK Sturm Gra,9555,2,18,9,9,52,30,22,63
FC Salzburg,9555,3,17,8,11,59,37,22,59
Vienna,9555,4,16,11,9,65,53,12,59
Rapid Vienna,9555,5,12,11,13,54,42,12,47
St. Pölten,9555,6,12,10,14,44,59,-15,46
RZ Pellets W,9555,7,11,9,16,43,54,-11,42
Admira Wacke,9555,8,11,8,17,35,59,-24,41
SV Josko Rie,9555,9,11,7,18,37,49,-12,40
Mattersburg,9555,10,10,6,20,37,56,-19,36
FC Salzburg,9556,1,21,5,10,70,36,34,68
SK Sturm Gra,9556,2,20,5,11,58,34,24,65
SC Rheindorf,9556,3,19,7,10,54,39,15,64
Vienna,9556,4,16,5,15,58,62,-4,53
Rapid Vienna,9556,5,13,12,11,52,39,13,51
RZ Pellets W,9556,6,13,8,15,48,60,-12,47
SV Josko Rie,9556,7,14,3,19,41,54,-13,45
Mattersburg,9556,8,10,10,16,38,53,-15,40
Admira Wacke,9556,9,11,7,18,43,60,-17,40
St. Pölten,9556,10,7,10,19,39,64,-25,31
FC Salzburg,9557,1,23,7,6,64,27,37,76
SK Sturm Gra,9557,2,19,9,8,64,39,25,66
SC Rheindorf,9557,3,18,7,11,54,44,10,61
Vienna,9557,4,17,6,13,58,53,5,57
Rapid Vienna,9557,5,13,11,12,62,49,13,50
RZ Pellets W,9557,6,13,8,15,47,53,-6,47
SV Josko Rie,9557,7,12,6,18,37,54,-17,42
St. Pölten,9557,8,9,10,17,48,66,-18,37
Admira Wacke,9557,9,10,5,21,39,67,-28,35
Mattersburg,9557,10,8,7,21,37,58,-21,31
FC Salzburg,9558,1,24,8,4,66,24,42,80
SC Rheindorf,9558,2,19,8,9,55,40,15,65
SK Sturm Gra,9558,3,18,7,11,60,37,23,61
Vienna,9558,4,17,4,15,66,61,5,55
Rapid Vienna,9558,5,10,15,11,46,38,8,45
RZ Pellets W,9558,6,13,6,17,44,57,-13,45
St. Pölten,9558,7,10,9,17,45,61,-16,39
Mattersburg,9558,8,10,8,18,40,55,-15,38
SV Josko Rie,9558,9,11,5,20,40,56,-16,38
Admira Wacke,9558,10,10,6,20,33,66,-33,36
SC Rheindorf,9559,1,21,9,6,51,31,20,72
FC Salzburg,9559,2,20,7,9,66,32,34,67
SK Sturm Gra,9559,3,17,11,8,57,30,27,62
Rapid Vienna,9559,4,16,11,9,59,35,24,59
Vienna,9559,5,17,6,13,61,58,3,57
RZ Pellets W,9559,6,11,9,16,42,58,-16,42
SV Josko Rie,9559,7,11,7,18,39,52,-13,40
St. Pölten,9559,8,8,11,17,41,64,-23,35
Mattersburg,9559,9,10,5,21,38,61,-23,35
Admira Wacke,9559,10,9,4,23,32,65,-33,31
Vienna,9560,1,22,6,8,74,46,28,72
FC Salzburg,9560,2,21,7,8,60,33,27,70
SC Rheindorf,9560,3,20,6,10,61,45,16,66
SK Sturm Gra,9560,4,16,8,12,56,38,18,56
Rapid Vienna,9560,5,14,8,14,55,43,12,50
St. Pölten,9560,6,12,9,15,44,61,-17,45
Admira Wacke,9560,7,12,8,16,44,59,-15,44
SV Josko Rie,9560,8,10,6,20,37,59,-22,36
RZ Pellets W,9560,9,9,7,20,44,64,-20,34
Mattersburg,9560,10,7,9,20,36,63,-27,30
FC Salzburg,9561,1,19,9,8,59,31,28,66
SK Sturm Gra,9561,2,19,7,10,63,35,28,64
Vienna,9561,3,18,5,13,56,50,6,59
SC Rheindorf,9561,4,15,12,9,46,40,6,57
Rapid Vienna,9561,5,14,11,11,56,44,12,53
RZ Pellets W,9561,6,15,7,14,53,52,1,52
Admira Wacke,9561,7,11,7,18,35,57,-22,40
SV Josko Rie,9561,8,10,8,18,28,45,-17,38
Mattersburg,9561,9,8,10,18,36,54,-18,34
St. Pölten,9561,10,8,10,18,36,60,-24,34
FC Salzburg,9562,1,24,7,5,74,30,44,79
SC Rheindorf,9562,2,18,9,9,50,38,12,63
Vienna,9562,3,19,5,12,64,55,9,62
SK Sturm Gra,9562,4,18,7,11,62,35,27,61
Rapid Vienna,9562,5,14,10,12,59,43,16,52
RZ Pellets W,9562,6,12,8,16,50,63,-13,44
SV Josko Rie,9562,7,10,8,18,36,54,-18,38
Mattersburg,9562,8,10,8,18,37,56,-19,38
Admira Wacke,9562,9,9,7,20,36,69,-33,34
St. Pölten,9562,10,7,9,20,40,65,-25,30
FC Salzburg,9563,1,20,8,8,61,25,36,68
SK Sturm Gra,9563,2,20,7,9,64,35,29,67
Rapid Vienna,9563,3,17,10,9,59,37,22,61
Vienna,9563,4,17,5,14,60,51,9,56
SC Rheindorf,9563,5,16,8,12,54,47,7,56
Admira Wacke,9563,6,13,8,15,42,59,-17,47
St. Pölten,9563,7,10,12,14,48,59,-11,42
RZ Pellets W,9563,8,9,10,17,41,59,-18,37
SV Josko Rie,9563,9,10,5,21,32,55,-23,35
Mattersburg,9563,10,7,9,20,32,66,-34,30
Vienna,9564,1,23,4,9,66,43,23,73
SK Sturm Gra,9564,2,21,5,10,66,33,33,68
FC Salzburg,9564,3,18,10,8,60,37,23,64
SC Rheindorf,9564,4,18,9,9,62,49,13,63
Rapid Vienna,9564,5,14,10,12,54,42,12,52
RZ Pellets W,9564,6,12,7,17,51,61,-10,43
St. Pölten,9564,7,9,11,16,45,64,-19,38
Admira Wacke,9564,8,10,7,19,35,63,-28,37
SV Josko Rie,9564,9,9,6,21,37,59,-22,33
Mattersburg,9564,10,6,11,19,36,61,-25,29
FC Salzburg,9565,1,24,5,7,74,35,39,77
SC Rheindorf,9565,2,21,5,10,55,41,14,68
Vienna,9565,3,18,6,12,59,50,9,60
Rapid Vienna,9565,4,17,8,11,62,37,25,59
SK Sturm Gra,9565,5,17,5,14,56,41,15,56
Admira Wacke,9565,6,13,4,19,48,58,-10,43
RZ Pellets W,9565,7,12,5,19,44,63,-19,41
SV Josko Rie,9565,8,11,7,18,37,49,-12,40
Mattersburg,9565,9,10,5,21,33,61,-28,35
St. Pölten,9565,10,8,8,20,34,67,-33,32
SK Sturm Gra,9566,1,19,7,10,59,37,22,64
FC Salzburg,9566,2,19,6,11,60,31,29,63
Vienna,9566,3,18,5,13,61,53,8,59
Rapid Vienna,9566,4,15,10,11,53,35,18,55
SC Rheindorf,9566,5,16,7,13,47,49,-2,55
SV Josko Rie,9566,6,12,8,16,38,45,-7,44
RZ Pellets W,9566,7,11,9,16,42,55,-13,42
Mattersburg,9566,8,10,11,15,41,53,-12,41
Admira Wacke,9566,9,11,7,18,40,68,-28,40
St. Pölten,9566,10,9,10,17,40,55,-15,37
FC Salzburg,9567,1,21,6,9,54,27,27,69
SC Rheindorf,9567,2,21,5,10,68,43,25,68
SK Sturm Gra,9567,3,18,4,14,62,40,22,58
Vienna,9567,4,18,4,14,65,54,11,58
Rapid Vienna,9567,5,16,9,11,56,36,20,57
RZ Pellets W,9567,6,13,10,13,46,48,-2,49
St. Pölten,9567,7,10,9,17,42,66,-24,39
Admira Wacke,9567,8,11,5,20,38,67,-29,38
Mattersburg,9567,9,10,7,19,43,64,-21,37
SV Josko Rie,9567,10,10,5,21,35,64,-29,35
FC Salzburg,9568,1,26,6,4,75,25,50,84
SK Sturm Gra,9568,2,19,8,9,56,30,26,65
SC Rheindorf,9568,3,20,5,11,56,47,9,65
Vienna,9568,4,18,4,14,63,58,5,58
Rapid Vienna,9568,5,14,10,12,53,40,13,52
RZ Pellets W,9568,6,14,6,16,53,53,0,48
SV Josko Rie,9568,7,12,4,20,33,51,-18,40
Mattersburg,9568,8,9,7,20,32,57,-25,34
Admira Wacke,9568,9,10,4,22,34,62,-28,34
St. Pölten,9568,10,7,8,21,33,65,-32,29
SC Rheindorf,9569,1,22,8,6,59,37,22,74
FC Salzburg,9569,2,21,6,9,61,28,33,69
SK Sturm Gra,9569,3,18,8,10,55,34,21,62
Vienna,9569,4,19,4,13,60,49,11,61
Rapid Vienna,9569,5,13,11,12,49,37,12,50
RZ Pellets W,9569,6,14,7,15,47,46,1,49
Admira Wacke,9569,7,11,8,17,33,55,-22,41
Mattersburg,9569,8,9,8,19,36,57,-21,35
SV Josko Rie,9569,9,10,5,21,29,51,-22,35
St. Pölten,9569,10,7,7,22,33,68,-35,28
SC Rheindorf,9570,1,20,7,9,58,37,21,67
FC Salzburg,9570,2,20,6,10,67,35,32,66
Rapid Vienna,9570,3,18,10,8,65,36,29,64
SK Sturm Gra,9570,4,19,6,11,60,35,25,63
Vienna,9570,5,15,5,16,56,59,-3,50
SV Josko Rie,9570,6,12,7,17,34,48,-14,43
Admira Wacke,9570,7,11,9,16,37,56,-19,42
RZ Pellets W,9570,8,12,4,20,44,65,-21,40
St. Pölten,9570,9,10,9,17,37,59,-22,39
Mattersburg,9570,10,8,7,21,34,62,-28,31
FC Salzburg,9571,1,22,8,6,67,30,37,74
SC Rheindorf,9571,2,20,8,8,60,42,18,68
SK Sturm Gra,9571,3,17,9,10,52,30,22,60
Vienna,9571,4,18,6,12,65,48,17,60
RZ Pellets W,9571,5,15,5,16,47,53,-6,50
Rapid Vienna,9571,6,10,12,14,46,44,2,42
St. Pölten,9571,7,11,8,17,43,59,-16,41
Admira Wacke,9571,8,11,6,19,33,59,-26,39
Mattersburg,9571,9,9,7,20,40,59,-19,34
SV Josko Rie,9571,10,9,7,20,29,58,-29,34
FC Salzburg,9572,1,20,8,8,67,33,34,68
SC Rheindorf,9572,2,20,7,9,53,41,12,67
Vienna,9572,3,21,3,12,63,51,12,66
SK Sturm Gra,9572,4,16,9,11,53,36,17,57
Rapid Vienna,9572,5,15,9,12,58,39,19,54
RZ Pellets W,9572,6,15,7,14,50,51,-1,52
St. Pölten,9572,7,11,7,18,41,58,-17,40
SV Josko Rie,9572,8,9,8,19,41,58,-17,35
Mattersburg,9572,9,9,7,20,39,61,-22,34
Admira Wacke,9572,10,8,7,21,31,68,-37,31
FC Salzburg,9573,1,22,7,7,64,29,35,73
SC Rheindorf,9573,2,20,6,10,56,40,16,66
SK Sturm Gra,9573,3,20,4,12,60,36,24,64
Rapid Vienna,9573,4,17,10,9,60,33,27,61
Vienna,9573,5,17,7,12,62,47,15,58
SV Josko Rie,9573,6,13,5,18,39,56,-17,44
RZ Pellets W,9573,7,10,9,17,44,60,-16,39
Admira Wacke,9573,8,11,6,19,37,63,-26,39
Mattersburg,9573,9,8,8,20,34,60,-26,32
St. Pölten,9573,10,6,10,20,36,68,-32,28
FC Salzburg,9574,1,24,5,7,73,31,42,77
SC Rheindorf,9574,2,23,6,7,67,41,26,75
Vienna,9574,3,19,7,10,63,48,15,64
SK Sturm Gra,9574,4,18,8,10,60,35,25,62
Rapid Vienna,9574,5,13,11,12,59,49,10,50
RZ Pellets W,9574,6,13,10,13,48,47,1,49
Admira Wacke,9574,7,11,7,18,33,58,-25,40
St. Pölten,9574,8,7,10,19,43,69,-26,31
SV Josko Rie,9574,9,8,5,23,31,70,-39,29
Mattersburg,9574,10,6,7,23,36,65,-29,25
SK Sturm Gra,9575,1,23,5,8,68,28,40,74
FC Salzburg,9575,2,20,8,8,65,31,34,68
SC Rheindorf,9575,3,17,9,10,58,46,12,60
Vienna,9575,4,18,5,13,64,55,9,59
Rapid Vienna,9575,5,13,11,12,55,48,7,50
St. Pölten,9575,6,11,10,15,40,56,-16,43
RZ Pellets W,9575,7,12,7,17,39,55,-16,43
Admira Wacke,9575,8,11,7,18,40,67,-27,40
SV Josko Rie,9575,9,11,6,19,38,53,-15,39
Mattersburg,9575,10,7,6,23,35,63,-28,27
SK Sturm Gra,9576,1,20,5,11,55,33,22,65
FC Salzburg,9576,2,18,10,8,63,35,28,64
Vienna,9576,3,19,7,10,62,46,16,64
SC Rheindorf,9576,4,17,9,10,50,43,7,60
Rapid Vienna,9576,5,15,8,13,51,37,14,53
RZ Pellets W,9576,6,14,8,14,46,52,-6,50
Mattersburg,9576,7,10,10,16,40,47,-7,40
Admira Wacke,9576,8,10,8,18,32,52,-20,38
SV Josko Rie,9576,9,9,8,19,29,53,-24,35
St. Pölten,9576,10,6,11,19,33,63,-30,29
SC Rheindorf,9577,1,21,6,9,56,47,9,69
FC Salzburg,9577,2,20,8,8,64,30,34,68
SK Sturm Gra,9577,3,18,6,12,54,34,20,60
Vienna,9577,4,17,5,14,62,56,6,56
Rapid Vienna,9577,5,14,13,9,61,42,19,55
Admira Wacke,9577,6,11,11,14,40,56,-16,44
St. Pölten,9577,7,11,7,18,43,57,-14,40
RZ Pellets W,9577,8,10,9,17,43,58,-15,39
SV Josko Rie,9577,9,10,7,19,40,62,-22,37
Mattersburg,9577,10,7,10,19,38,59,-21,31
FC Salzburg,9578,1,25,4,7,79,33,46,79
SC Rheindorf,9578,2,20,7,9,61,46,15,67
Vienna,9578,3,17,7,12,56,53,3,58
SK Sturm Gra,9578,4,16,7,13,53,36,17,55
Rapid Vienna,9578,5,14,9,13,55,41,14,51
Admira Wacke,9578,6,11,10,15,35,58,-23,43
SV Josko Rie,9578,7,12,5,19,32,51,-19,41
St. Pölten,9578,8,10,10,16,46,55,-9,40
RZ Pellets W,9578,9,11,6,19,40,61,-21,39
Mattersburg,9578,10,8,7,21,39,62,-23,31
FC Salzburg,9579,1,22,5,9,68,36,32,71
Vienna,9579,2,20,7,9,62,44,18,67
SC Rheindorf,9579,3,18,10,8,57,43,14,64
Rapid Vienna,9579,4,16,11,9,64,44,20,59
SK Sturm Gra,9579,5,16,9,11,50,34,16,57
St. Pölten,9579,6,11,8,17,46,63,-17,41
RZ Pellets W,9579,7,11,6,19,43,55,-12,39
Admira Wacke,9579,8,11,6,19,37,59,-22,39
SV Josko Rie,9579,9,10,5,21,37,62,-25,35
Mattersburg,9579,10,7,9,20,36,60,-24,30
SC Rheindorf,9580,1,21,8,7,53,36,17,71
SK Sturm Gra,9580,2,20,4,12,58,33,25,64
FC Salzburg,9580,3,18,9,9,59,29,30,63
Vienna,9580,4,18,6,12,62,55,7,60
Rapid Vienna,9580,5,13,14,9,54,37,17,53
SV Josko Rie,9580,6,12,6,18,32,52,-20,42
Admira Wacke,9580,7,12,5,19,34,56,-22,41
Mattersburg,9580,8,10,8,18,36,46,-10,38
RZ Pellets W,9580,9,11,5,20,45,65,-20,38
St. Pölten,9580,10,9,7,20,41,65,-24,34
Vienna,9581,1,21,6,9,70,45,25,69
FC Salzburg,9581,2,20,7,9,61,37,24,67
SC Rheindorf,9581,3,19,8,9,57,41,16,65
SK Sturm Gra,9581,4,17,9,10,56,40,16,60
Rapid Vienna,9581,5,11,13,12,52,41,11,46
St. Pölten,9581,6,9,12,15,46,61,-15,39
Admira Wacke,9581,7,10,9,17,35,61,-26,39
Mattersburg,9581,8,10,8,18,46,53,-7,38
RZ Pellets W,9581,9,9,11,16,40,63,-23,38
SV Josko Rie,9581,10,10,5,21,34,55,-21,35
FC Salzburg,9582,1,21,6,9,65,31,34,69
SK Sturm Gra,9582,2,20,5,11,61,33,28,65
SC Rheindorf,9582,3,18,8,10,54,44,10,62
Vienna,9582,4,18,7,11,65,58,7,61
Rapid Vienna,9582,5,16,8,12,60,44,16,56
RZ Pellets W,9582,6,14,7,15,44,51,-7,49
SV Josko Rie,9582,7,12,5,19,38,54,-16,41
Mattersburg,9582,8,10,9,17,41,53,-12,39
Admira Wacke,9582,9,10,6,20,34,62,-28,36
St. Pölten,9582,10,6,9,21,45,77,-32,27
Vienna,9583,1,21,6,9,70,48,22,69
FC Salzburg,9583,2,20,5,11,63,35,28,65
SC Rheindorf,9583,3,18,10,8,62,49,13,64
SK Sturm Gra,9583,4,18,5,13,59,39,20,59
Rapid Vienna,9583,5,15,9,12,61,46,15,54
Admira Wacke,9583,6,14,5,17,45,56,-11,47
Mattersburg,9583,7,11,10,15,37,52,-15,43
RZ Pellets W,9583,8,11,6,19,46,61,-15,39
SV Josko Rie,9583,9,10,6,20,38,66,-28,36
St. Pölten,9583,10,6,10,20,42,71,-29,28
FC Salzburg,9584,1,20,9,7,64,30,34,69
SC Rheindorf,9584,2,19,9,8,54,40,14,66
SK Sturm Gra,9584,3,19,6,11,55,35,20,63
Vienna,9584,4,19,4,13,60,50,10,61
Rapid Vienna,9584,5,12,11,13,46,40,6,47
RZ Pellets W,9584,6,11,10,15,49,56,-7,43
Admira Wacke,9584,7,11,7,18,34,51,-17,40
St. Pölten,9584,8,10,9,17,42,62,-20,39
SV Josko Rie,9584,9,8,11,17,29,47,-18,35
Mattersburg,9584,10,8,10,18,34,56,-22,34
Vienna,9585,1,23,4,9,69,46,23,73
SC Rheindorf,9585,2,20,6,10,57,42,15,66
FC Salzburg,9585,3,19,6,11,65,44,21,63
Rapid Vienna,9585,4,16,8,12,56,37,19,56
SK Sturm Gra,9585,5,15,7,14,51,37,14,52
RZ Pellets W,9585,6,11,8,17,47,58,-11,41
SV Josko Rie,9585,7,11,6,19,35,51,-16,39
Mattersburg,9585,8,9,11,16,40,53,-13,38
St. Pölten,9585,9,9,11,16,44,71,-27,38
Admira Wacke,9585,10,10,7,19,38,63,-25,37
FC Salzburg,9586,1,22,6,8,68,32,36,72
SC Rheindorf,9586,2,21,6,9,61,45,16,69
SK Sturm Gra,9586,3,20,7,9,58,31,27,67
Vienna,9586,4,21,3,12,64,45,19,66
Admira Wacke,9586,5,16,4,16,44,53,-9,52
Rapid Vienna,9586,6,13,9,14,50,50,0,48
RZ Pellets W,9586,7,12,5,19,44,57,-13,41
Mattersburg,9586,8,9,9,18,46,64,-18,36
St. Pölten,9586,9,8,9,19,43,67,-24,33
SV Josko Rie,9586,10,7,4,25,28,62,-34,25
FC Salzburg,9587,1,21,7,8,68,34,34,70
Vienna,9587,2,20,7,9,65,43,22,67
SC Rheindorf,9587,3,16,10,10,52,44,8,58
Rapid Vienna,9587,4,15,8,13,57,44,13,53
SK Sturm Gra,9587,5,15,8,13,53,44,9,53
SV Josko Rie,9587,6,14,6,16,44,51,-7,48
RZ Pellets W,9587,7,13,7,16,47,57,-10,46
St. Pölten,9587,8,9,9,18,41,64,-23,36
Mattersburg,9587,9,9,8,19,41,59,-18,35
Admira Wacke,9587,10,9,8,19,30,58,-28,35
FC Salzburg,9588,1,21,8,7,70,29,41,71
SC Rheindorf,9588,2,20,9,7,59,40,19,69
Vienna,9588,3,21,3,12,66,54,12,66
SK Sturm Gra,9588,4,19,5,12,62,39,23,62
RZ Pellets W,9588,5,14,8,14,48,49,-1,50
Rapid Vienna,9588,6,10,14,12,52,45,7,44
Admira Wacke,9588,7,12,5,19,33,56,-23,41
SV Josko Rie,9588,8,11,4,21,34,63,-29,37
Mattersburg,9588,9,7,11,18,36,58,-22,32
St. Pölten,9588,10,8,7,21,41,68,-27,31
SC Rheindorf,9589,1,20,8,8,61,41,20,68
FC Salzburg,9589,2,19,10,7,64,34,30,67
Vienna,9589,3,20,4,12,68,58,10,64
Rapid Vienna,9589,4,17,10,9,55,35,20,61
SK Sturm Gra,9589,5,18,5,13,59,41,18,59
Admira Wacke,9589,6,12,7,17,37,57,-20,43
RZ Pellets W,9589,7,11,6,19,48,59,-11,39
St. Pölten,9589,8,9,9,18,41,64,-23,36
Mattersburg,9589,9,8,9,19,39,59,-20,33
SV Josko Rie,9589,10,9,6,21,30,54,-24,33
FC Salzburg,9590,1,22,7,7,67,34,33,73
SK Sturm Gra,9590,2,21,6,9,63,33,30,69
SC Rheindorf,9590,3,18,8,10,55,49,6,62
Vienna,9590,4,18,5,13,69,56,13,59
Rapid Vienna,9590,5,15,10,11,63,42,21,55
RZ Pellets W,9590,6,12,7,17,49,66,-17,43
SV Josko Rie,9590,7,11,6,19,37,53,-16,39
Admira Wacke,9590,8,11,5,20,40,62,-22,38
Mattersburg,9590,9,9,8,19,41,66,-25,35
St. Pölten,9590,10,8,8,20,44,67,-23,32
SK Sturm Gra,9591,1,20,7,9,57,32,25,67
SC Rheindorf,9591,2,19,10,7,59,41,18,67
FC Salzburg,9591,3,18,11,7,58,26,32,65
Vienna,9591,4,18,6,12,64,56,8,60
Rapid Vienna,9591,5,16,11,9,59,33,26,59
RZ Pellets W,9591,6,14,6,16,55,61,-6,48
SV Josko Rie,9591,7,9,10,17,32,50,-18,37
Mattersburg,9591,8,8,10,18,38,59,-21,34
Admira Wacke,9591,9,9,7,20,32,59,-27,34
St. Pölten,9591,10,5,10,21,34,71,-37,25
FC Salzburg,9592,1,22,6,8,72,30,42,72
SK Sturm Gra,9592,2,21,6,9,64,29,35,69
SC Rheindorf,9592,3,18,8,10,56,51,5,62
Vienna,9592,4,18,4,14,60,54,6,58
Rapid Vienna,9592,5,13,11,12,49,41,8,50
Admira Wacke,9592,6,13,5,18,35,59,-24,44
SV Josko Rie,9592,7,11,6,19,41,62,-21,39
RZ Pellets W,9592,8,9,11,16,45,54,-9,38
Mattersburg,9592,9,9,9,18,37,57,-20,36
St. Pölten,9592,10,7,12,17,46,68,-22,33
SK Sturm Gra,9593,1,24,5,7,76,29,47,77
FC Salzburg,9593,2,20,10,6,66,34,32,70
SC Rheindorf,9593,3,18,7,11,57,49,8,61
Vienna,9593,4,17,6,13,61,55,6,57
Rapid Vienna,9593,5,14,8,14,59,48,11,50
RZ Pellets W,9593,6,13,7,16,44,51,-7,46
Admira Wacke,9593,7,13,7,16,42,60,-18,46
SV Josko Rie,9593,8,11,4,21,35,57,-22,37
St. Pölten,9593,9,7,10,19,36,66,-30,31
Mattersburg,9593,10,7,8,21,34,61,-27,29
FC Salzburg,9594,1,20,9,7,63,31,32,69
Vienna,9594,2,21,4,11,61,45,16,67
SK Sturm Gra,9594,3,19,6,11,62,35,27,63
SC Rheindorf,9594,4,18,8,10,53,44,9,62
Rapid Vienna,9594,5,10,14,12,54,46,8,44
RZ Pellets W,9594,6,11,7,18,44,57,-13,40
SV Josko Rie,9594,7,11,6,19,38,53,-15,39
Mattersburg,9594,8,10,9,17,34,51,-17,39
St. Pölten,9594,9,9,11,16,44,62,-18,38
Admira Wacke,9594,10,10,8,18,34,63,-29,38
SC Rheindorf,9595,1,24,4,8,60,36,24,76
SK Sturm Gra,9595,2,23,4,9,61,30,31,73
FC Salzburg,9595,3,22,6,8,65,27,38,72
Vienna,9595,4,21,3,12,58,49,9,66
Rapid Vienna,9595,5,18,7,11,56,38,18,61
SV Josko Rie,9595,6,12,4,20,29,43,-14,40
Mattersburg,9595,7,9,7,20,34,59,-25,34
RZ Pellets W,9595,8,9,6,21,45,64,-19,33
St. Pölten,9595,9,6,10,20,38,66,-28,28
Admira Wacke,9595,10,7,7,22,29,63,-34,28
SK Sturm Gra,9596,1,22,6,8,60,31,29,72
Vienna,9596,2,22,5,9,66,46,20,71
FC Salzburg,9596,3,21,6,9,73,37,36,69
SC Rheindorf,9596,4,19,10,7,60,46,14,67
Rapid Vienna,9596,5,13,11,12,54,41,13,50
SV Josko Rie,9596,6,12,5,19,38,55,-17,41
Mattersburg,9596,7,8,10,18,35,56,-21,34
RZ Pellets W,9596,8,8,9,19,41,60,-19,33
St. Pölten,9596,8,8,9,19,41,60,-19,33
Admira Wacke,9596,10,9,5,22,31,67,-36,32
FC Salzburg,9597,1,20,11,5,66,30,36,71
SC Rheindorf,9597,2,19,7,10,59,48,11,64
SK Sturm Gra,9597,3,18,6,12,55,36,19,60
Vienna,9597,4,18,6,12,63,56,7,60
Rapid Vienna,9597,5,13,10,13,55,42,13,49
RZ Pellets W,9597,6,13,7,16,43,55,-12,46
SV Josko Rie,9597,7,13,4,19,42,54,-12,43
St. Pölten,9597,8,10,9,17,42,60,-18,39
Admira Wacke,9597,9,10,9,17,39,59,-20,39
Mattersburg,9597,10,7,9,20,32,56,-24,30
FC Salzburg,9598,1,21,10,5,65,27,38,73
SK Sturm Gra,9598,2,19,6,11,57,30,27,63
Vienna,9598,3,18,7,11,61,52,9,61
SC Rheindorf,9598,4,17,7,12,49,47,2,58
Rapid Vienna,9598,5,15,11,10,52,33,19,56
RZ Pellets W,9598,6,13,11,12,47,48,-1,50
Admira Wacke,9598,7,10,9,17,41,64,-23,39
SV Josko Rie,9598,8,11,4,21,34,58,-24,37
St. Pölten,9598,9,9,8,19,39,61,-22,35
Mattersburg,9598,10,6,9,21,29,54,-25,27
FC Salzburg,9599,1,20,8,8,62,34,28,68
SC Rheindorf,9599,2,20,7,9,54,40,14,67
Vienna,9599,3,18,5,13,64,47,17,59
SK Sturm Gra,9599,4,17,5,14,58,42,16,56
Rapid Vienna,9599,5,12,15,9,52,38,14,51
RZ Pellets W,9599,6,15,6,15,48,58,-10,51
Admira Wacke,9599,7,12,7,17,45,57,-12,43
Mattersburg,9599,8,10,10,16,44,60,-16,40
SV Josko Rie,9599,9,9,7,20,31,54,-23,34
St. Pölten,9599,10,6,12,18,38,66,-28,30
FC Salzburg,9600,1,21,6,9,68,36,32,69
SC Rheindorf,9600,2,20,8,8,53,38,15,68
SK Sturm Gra,9600,3,20,7,9,64,34,30,67
Vienna,9600,4,18,4,14,59,52,7,58
Rapid Vienna,9600,5,14,11,11,58,37,21,53
RZ Pellets W,9600,6,12,5,19,42,58,-16,41
Admira Wacke,9600,7,11,8,17,37,61,-24,41
St. Pölten,9600,8,8,13,15,43,57,-14,37
Mattersburg,9600,9,8,10,18,32,55,-23,34
SV Josko Rie,9600,10,9,6,21,33,61,-28,33
SC Rheindorf,9601,1,20,9,7,57,37,20,69
SK Sturm Gra,9601,2,19,8,9,60,36,24,65
FC Salzburg,9601,3,18,7,11,68,43,25,61
Vienna,9601,4,19,4,13,66,50,16,61
Rapid Vienna,9601,5,12,13,11,56,42,14,49
RZ Pellets W,9601,6,12,7,17,44,53,-9,43
SV Josko Rie,9601,7,11,7,18,34,52,-18,40
Admira Wacke,9601,8,10,9,17,32,60,-28,39
Mattersburg,9601,9,9,9,18,38,51,-13,36
St. Pölten,9601,10,8,11,17,40,71,-31,35
SK Sturm Gra,9602,1,19,9,8,60,39,21,66
Vienna,9602,2,19,6,11,62,44,18,63
FC Salzburg,9602,3,18,8,10,61,34,27,62
SC Rheindorf,9602,4,18,8,10,55,44,11,62
Rapid Vienna,9602,5,15,10,11,58,41,17,55
RZ Pellets W,9602,6,13,8,15,48,58,-10,47
Admira Wacke,9602,7,10,8,18,42,59,-17,38
SV Josko Rie,9602,8,11,4,21,34,55,-21,37
St. Pölten,9602,9,9,10,17,44,66,-22,37
Mattersburg,9602,10,9,7,20,39,63,-24,34
SC Rheindorf,9603,1,25,5,6,61,38,23,80
FC Salzburg,9603,2,19,6,11,65,33,32,63
SK Sturm Gra,9603,3,18,9,9,64,33,31,63
Vienna,9603,4,16,6,14,54,56,-2,54
Rapid Vienna,9603,5,13,8,15,48,44,4,47
RZ Pellets W,9603,6,12,8,16,39,50,-11,44
Admira Wacke,9603,7,11,10,15,37,57,-20,43
Mattersburg,9603,8,11,5,20,39,56,-17,38
SV Josko Rie,9603,9,9,10,17,40,55,-15,37
St. Pölten,9603,10,8,9,19,40,65,-25,33
FC Salzburg,9604,1,26,5,5,81,27,54,83
SK Sturm Gra,9604,2,22,6,8,65,32,33,72
SC Rheindorf,9604,3,17,10,9,52,43,9,61
Rapid Vienna,9604,4,17,8,11,58,38,20,59
Vienna,9604,5,17,6,13,69,55,14,57
RZ Pellets W,9604,6,12,6,18,50,60,-10,42
SV Josko Rie,9604,7,11,5,20,39,58,-19,38
St. Pölten,9604,8,9,10,17,43,70,-27,37
Admira Wacke,9604,9,10,3,23,32,71,-39,33
Mattersburg,9604,10,5,9,22,32,67,-35,24
FC Salzburg,9605,1,19,11,6,66,34,32,68
SC Rheindorf,9605,2,19,8,9,58,43,15,65
SK Sturm Gra,9605,3,19,5,12,67,41,26,62
Rapid Vienna,9605,4,13,15,8,67,50,17,54
Vienna,9605,5,15,9,12,61,58,3,54
RZ Pellets W,9605,6,13,10,13,52,55,-3,49
St. Pölten,9605,7,11,10,15,54,66,-12,43
Admira Wacke,9605,8,8,9,19,33,65,-32,33
Mattersburg,9605,9,7,11,18,38,58,-20,32
SV Josko Rie,9605,10,6,12,18,35,61,-26,30
SC Rheindorf,9606,1,22,8,6,57,32,25,74
FC Salzburg,9606,2,20,9,7,61,25,36,69
SK Sturm Gra,9606,3,19,6,11,62,37,25,63
Vienna,9606,4,19,4,13,59,56,3,61
Rapid Vienna,9606,5,15,11,10,54,36,18,56
Admira Wacke,9606,6,12,7,17,36,53,-17,43
RZ Pellets W,9606,7,11,7,18,44,56,-12,40
Mattersburg,9606,8,10,8,18,37,54,-17,38
St. Pölten,9606,9,7,9,20,35,68,-33,30
SV Josko Rie,9606,10,7,7,22,32,60,-28,28
SC Rheindorf,9607,1,21,9,6,59,39,20,72
FC Salzburg,9607,2,20,10,6,67,33,34,70
SK Sturm Gra,9607,3,19,7,10,61,36,25,64
Vienna,9607,4,17,8,11,71,51,20,59
Rapid Vienna,9607,5,14,9,13,50,36,14,51
Admira Wacke,9607,6,12,9,15,38,55,-17,45
RZ Pellets W,9607,7,11,6,19,40,65,-25,39
SV Josko Rie,9607,8,10,6,20,35,60,-25,36
Mattersburg,9607,9,8,8,20,33,55,-22,32
St. Pölten,9607,10,8,8,20,44,68,-24,32
FC Salzburg,9608,1,22,7,7,72,42,30,73
Vienna,9608,2,21,4,11,64,50,14,67
SK Sturm Gra,9608,3,19,7,10,67,36,31,64
SC Rheindorf,9608,4,19,6,11,54,45,9,63
RZ Pellets W,9608,5,16,7,13,56,54,2,55
Rapid Vienna,9608,6,12,10,14,62,49,13,46
Admira Wacke,9608,7,10,9,17,38,63,-25,39
SV Josko Rie,9608,8,10,5,21,34,57,-23,35
Mattersburg,9608,9,7,12,17,43,63,-20,33
St. Pölten,9608,10,5,11,20,42,73,-31,26
FC Salzburg,9609,1,27,4,5,81,29,52,85
SC Rheindorf,9609,2,21,7,8,62,44,18,70
SK Sturm Gra,9609,3,15,8,13,49,37,12,53
Rapid Vienna,9609,4,13,12,11,51,39,12,51
Vienna,9609,5,14,7,15,56,59,-3,49
RZ Pellets W,9609,6,13,7,16,49,52,-3,46
Admira Wacke,9609,7,11,9,16,38,56,-18,42
Mattersburg,9609,8,10,7,19,37,59,-22,37
St. Pölten,9609,9,9,9,18,47,69,-22,36
SV Josko Rie,9609,10,8,8,20,39,65,-26,32
FC Salzburg,9610,1,22,8,6,68,29,39,74
SK Sturm Gra,9610,2,18,8,10,53,32,21,62
Vienna,9610,3,17,8,11,58,46,12,59
SC Rheindorf,9610,4,17,8,11,54,45,9,59
Rapid Vienna,9610,5,15,9,12,53,38,15,54
RZ Pellets W,9610,6,13,7,16,44,52,-8,46
Admira Wacke,9610,7,12,8,16,39,58,-19,44
SV Josko Rie,9610,8,9,8,19,32,54,-22,35
Mattersburg,9610,9,8,9,19,34,55,-21,33
St. Pölten,9610,10,8,9,19,35,61,-26,33
FC Salzburg,9611,1,23,8,5,74,30,44,77
SK Sturm Gra,9611,2,23,4,9,71,32,39,73
SC Rheindorf,9611,3,19,7,10,55,45,10,64
Vienna,9611,4,16,6,14,59,52,7,54
Rapid Vienna,9611,5,14,9,13,55,47,8,51
SV Josko Rie,9611,6,13,4,19,34,46,-12,43
RZ Pellets W,9611,7,12,6,18,46,64,-18,42
Admira Wacke,9611,8,11,5,20,31,58,-27,38
St. Pölten,9611,9,9,9,18,44,68,-24,36
Mattersburg,9611,10,7,8,21,36,63,-27,29
FC Salzburg,9612,1,22,6,8,74,31,43,72
SC Rheindorf,9612,2,21,6,9,54,45,9,69
Vienna,9612,3,17,8,11,61,55,6,59
SK Sturm Gra,9612,4,18,4,14,59,42,17,58
Rapid Vienna,9612,5,13,11,12,49,41,8,50
RZ Pellets W,9612,6,15,5,16,49,50,-1,50
Admira Wacke,9612,7,14,7,15,43,54,-11,49
St. Pölten,9612,8,9,9,18,40,61,-21,36
SV Josko Rie,9612,9,11,3,22,32,57,-25,36
Mattersburg,9612,10,6,9,21,34,59,-25,27
SC Rheindorf,9613,1,23,8,5,62,36,26,77
FC Salzburg,9613,2,22,7,7,66,31,35,73
Vienna,9613,3,18,5,13,59,51,8,59
SK Sturm Gra,9613,4,17,6,13,53,32,21,57
Rapid Vienna,9613,5,13,13,10,51,38,13,52
RZ Pellets W,9613,6,14,7,15,50,52,-2,49
SV Josko Rie,9613,7,10,8,18,42,54,-12,38
Admira Wacke,9613,8,10,8,18,35,66,-31,38
St. Pölten,9613,9,9,9,18,38,63,-25,36
Mattersburg,9613,10,5,7,24,30,63,-33,22
SC Rheindorf,9614,1,21,7,8,56,42,14,70
FC Salzburg,9614,2,18,10,8,61,30,31,64
Rapid Vienna,9614,3,17,11,8,69,40,29,62
SK Sturm Gra,9614,4,17,11,8,59,39,20,62
Vienna,9614,5,18,6,12,61,54,7,60
Mattersburg,9614,6,11,10,15,41,53,-12,43
Admira Wacke,9614,7,10,7,19,34,54,-20,37
RZ Pellets W,9614,8,10,6,20,44,60,-16,36
SV Josko Rie,9614,9,9,6,21,31,53,-22,33
St. Pölten,9614,10,8,8,20,36,67,-31,32
FC Salzburg,9615,1,20,8,8,64,33,31,68
SC Rheindorf,9615,2,18,8,10,54,55,-1,62
SK Sturm Gra,9615,3,18,7,11,57,34,23,61
Vienna,9615,4,19,4,13,62,52,10,61
Rapid Vienna,9615,5,15,10,11,55,35,20,55
St. Pölten,9615,6,12,9,15,50,58,-8,45
RZ Pellets W,9615,7,12,8,16,46,54,-8,44
SV Josko Rie,9615,8,12,4,20,39,60,-21,40
Admira Wacke,9615,9,10,6,20,38,62,-24,36
Mattersburg,9615,10,8,8,20,34,56,-22,32
SC Rheindorf,9616,1,22,4,10,66,45,21,70
SK Sturm Gra,9616,2,21,5,10,55,34,21,68
FC Salzburg,9616,3,19,7,10,58,37,21,64
Vienna,9616,4,17,6,13,60,52,8,57
St. Pölten,9616,5,12,8,16,50,61,-11,44
Admira Wacke,9616,6,13,5,18,40,53,-13,44
SV Josko Rie,9616,7,13,5,18,37,50,-13,44
Rapid Vienna,9616,8,11,10,15,47,43,4,43
RZ Pellets W,9616,9,11,7,18,44,62,-18,40
Mattersburg,9616,10,8,9,19,40,60,-20,33
FC Salzburg,9617,1,22,7,7,65,28,37,73
SC Rheindorf,9617,2,19,10,7,57,39,18,67
Vienna,9617,3,19,6,11,63,49,14,63
SK Sturm Gra,9617,4,16,8,12,54,46,8,56
Rapid Vienna,9617,5,14,10,12,65,45,20,52
St. Pölten,9617,6,11,8,17,45,60,-15,41
RZ Pellets W,9617,7,10,8,18,43,61,-18,38
Mattersburg,9617,8,9,11,16,37,59,-22,38
Admira Wacke,9617,9,10,7,19,36,60,-24,37
SV Josko Rie,9617,10,9,7,20,32,50,-18,34
FC Salzburg,9618,1,20,8,8,69,38,31,68
SC Rheindorf,9618,2,19,11,6,54,39,15,68
SK Sturm Gra,9618,3,18,5,13,60,39,21,59
Vienna,9618,4,18,5,13,59,48,11,59
Rapid Vienna,9618,5,13,12,11,61,43,18,51
RZ Pellets W,9618,6,12,10,14,54,61,-7,46
Admira Wacke,9618,7,13,6,17,38,58,-20,45
SV Josko Rie,9618,8,9,7,20,36,55,-19,34
St. Pölten,9618,9,7,13,16,42,68,-26,34
Mattersburg,9618,10,8,9,19,32,56,-24,33
FC Salzburg,9619,1,22,6,8,73,32,41,72
SK Sturm Gra,9619,2,21,5,10,62,34,28,68
SC Rheindorf,9619,3,19,7,10,56,44,12,64
Vienna,9619,4,20,4,12,65,56,9,64
Rapid Vienna,9619,5,17,9,10,64,44,20,60
RZ Pellets W,9619,6,12,9,15,45,49,-4,45
SV Josko Rie,9619,7,12,6,18,34,47,-13,42
Mattersburg,9619,8,11,5,20,38,57,-19,38
St. Pölten,9619,9,6,9,21,35,67,-32,27
Admira Wacke,9619,10,7,6,23,26,68,-42,27
SC Rheindorf,9620,1,24,4,8,60,36,24,76
FC Salzburg,9620,2,23,6,7,68,33,35,75
SK Sturm Gra,9620,3,22,4,10,63,32,31,70
Vienna,9620,4,17,4,15,67,54,13,55
Rapid Vienna,9620,5,12,13,11,52,40,12,49
RZ Pellets W,9620,6,11,7,18,45,62,-17,40
St. Pölten,9620,7,9,12,15,42,56,-14,39
Mattersburg,9620,8,9,9,18,35,56,-21,36
Admira Wacke,9620,9,10,6,20,38,64,-26,36
SV Josko Rie,9620,10,8,5,23,30,67,-37,29
FC Salzburg,9621,1,20,8,8,64,32,32,68
SK Sturm Gra,9621,2,18,9,9,55,35,20,63
SC Rheindorf,9621,3,17,8,11,54,50,4,59
Rapid Vienna,9621,4,16,10,10,56,41,15,58
Vienna,9621,5,17,6,13,62,56,6,57
Admira Wacke,9621,6,12,9,15,42,53,-11,45
RZ Pellets W,9621,7,12,8,16,46,53,-7,44
SV Josko Rie,9621,8,13,4,19,38,56,-18,43
St. Pölten,9621,9,8,11,17,42,59,-17,35
Mattersburg,9621,10,6,9,21,32,56,-24,27
FC Salzburg,9622,1,21,8,7,68,29,39,71
SC Rheindorf,9622,2,22,4,10,59,45,14,70
Vienna,9622,3,19,7,10,62,44,18,64
Rapid Vienna,9622,4,16,11,9,65,44,21,59
SK Sturm Gra,9622,5,17,7,12,55,37,18,58
RZ Pellets W,9622,6,11,10,15,44,55,-11,43
SV Josko Rie,9622,7,9,8,19,34,58,-24,35
Mattersburg,9622,8,8,10,18,45,62,-17,34
St. Pölten,9622,9,7,11,18,38,66,-28,32
Admira Wacke,9622,10,8,8,20,39,69,-30,32
SK Sturm Gra,9623,1,24,4,8,62,26,36,76
SC Rheindorf,9623,2,20,6,10,55,42,13,66
FC Salzburg,9623,3,19,7,10,60,35,25,64
Vienna,9623,4,18,3,15,61,58,3,57
Admira Wacke,9623,5,14,6,16,43,50,-7,48
RZ Pellets W,9623,6,13,7,16,47,58,-11,46
Mattersburg,9623,7,10,10,16,41,52,-11,40
Rapid Vienna,9623,8,7,15,14,44,46,-2,36
SV Josko Rie,9623,9,9,9,18,31,53,-22,36
St. Pölten,9623,10,7,11,18,35,59,-24,32
FC Salzburg,9624,1,21,10,5,70,32,38,73
SK Sturm Gra,9624,2,22,4,10,67,34,33,70
SC Rheindorf,9624,3,18,9,9,55,45,10,63
Vienna,9624,4,18,3,15,67,55,12,57
Rapid Vienna,9624,5,15,10,11,56,40,16,55
SV Josko Rie,9624,6,11,7,18,36,51,-15,40
St. Pölten,9624,7,10,9,17,42,66,-24,39
Admira Wacke,9624,8,10,8,18,33,58,-25,38
RZ Pellets W,9624,9,9,9,18,38,58,-20,36
Mattersburg,9624,10,7,9,20,34,59,-25,30
FC Salzburg,9625,1,20,8,8,72,28,44,68
SK Sturm Gra,9625,2,20,7,9,57,34,23,67
SC Rheindorf,9625,3,20,6,10,55,42,13,66
Vienna,9625,4,18,8,10,59,47,12,62
Rapid Vienna,9625,5,14,11,11,54,41,13,53
SV Josko Rie,9625,6,12,4,20,35,56,-21,40
RZ Pellets W,9625,7,10,9,17,43,57,-14,39
St. Pölten,9625,8,9,9,18,40,61,-21,36
Admira Wacke,9625,9,9,8,19,33,61,-28,35
Mattersburg,9625,10,8,10,18,38,59,-21,34
FC Salzburg,9626,1,21,9,6,74,38,36,72
SK Sturm Gra,9626,2,20,6,10,70,40,30,66
SC Rheindorf,9626,3,19,6,11,56,47,9,63
Rapid Vienna,9626,4,15,12,9,60,41,19,57
Vienna,9626,5,16,7,13,57,52,5,55
Admira Wacke,9626,6,12,8,16,43,56,-13,44
RZ Pellets W,9626,7,11,10,15,46,56,-10,43
Mattersburg,9626,8,8,11,17,42,60,-18,35
St. Pölten,9626,9,7,10,19,38,64,-26,31
SV Josko Rie,9626,10,8,7,21,27,59,-32,31
SC Rheindorf,9627,1,23,6,7,65,48,17,75
SK Sturm Gra,9627,2,20,6,10,60,33,27,66
Vienna,9627,3,19,7,10,69,48,21,64
FC Salzburg,9627,4,18,9,9,59,39,20,63
Rapid Vienna,9627,5,16,10,10,67,42,25,58
RZ Pellets W,9627,6,11,8,17,46,59,-13,41
SV Josko Rie,9627,7,10,7,19,39,60,-21,37
Admira Wacke,9627,8,11,4,21,34,65,-31,37
Mattersburg,9627,9,8,9,19,44,61,-17,33
St. Pölten,9627,10,6,10,20,43,71,-28,28
SK Sturm Gra,9628,1,23,5,8,75,29,46,74
FC Salzburg,9628,2,23,5,8,65,27,38,74
SC Rheindorf,9628,3,18,8,10,56,42,14,62
Vienna,9628,4,17,5,14,61,56,5,56
Rapid Vienna,9628,5,14,9,13,60,43,17,51
RZ Pellets W,9628,6,15,5,16,49,53,-4,50
SV Josko Rie,9628,7,14,4,18,41,53,-12,46
Admira Wacke,9628,8,11,6,19,37,68,-31,39
St. Pölten,9628,9,9,8,19,43,73,-30,35
Mattersburg,9628,10,5,7,24,29,72,-43,22
SK Sturm Gra,9629,1,20,5,11,66,38,28,65
FC Salzburg,9629,2,19,7,10,61,35,26,64
SC Rheindorf,9629,3,19,5,12,58,46,12,62
Vienna,9629,4,18,7,11,70,56,14,61
Rapid Vienna,9629,5,14,12,10,57,40,17,54
SV Josko Rie,9629,6,12,6,18,33,55,-22,42
Mattersburg,9629,7,11,7,18,39,53,-14,40
RZ Pellets W,9629,8,11,6,19,43,65,-22,39
St. Pölten,9629,9,9,11,16,47,61,-14,38
Admira Wacke,9629,10,10,8,18,39,64,-25,38
FC Salzburg,9630,1,21,7,8,64,31,33,70
SC Rheindorf,9630,2,21,7,8,60,44,16,70
SK Sturm Gra,9630,3,21,6,9,72,43,29,69
Vienna,9630,4,17,6,13,68,56,12,57
Rapid Vienna,9630,5,13,11,12,50,39,11,50
RZ Pellets W,9630,6,12,7,17,46,57,-11,43
Admira Wacke,9630,7,12,5,19,38,61,-23,41
SV Josko Rie,9630,8,10,6,20,35,56,-21,36
St. Pölten,9630,9,8,10,18,47,66,-19,34
Mattersburg,9630,10,9,7,20,37,64,-27,34
FC Salzburg,9631,1,24,5,7,74,31,43,77
SC Rheindorf,9631,2,18,11,7,54,38,16,65
Vienna,9631,3,20,4,12,65,47,18,64
SK Sturm Gra,9631,4,17,9,10,58,36,22,60
Rapid Vienna,9631,5,14,10,12,49,39,10,52
RZ Pellets W,9631,6,12,6,18,44,57,-13,42
Admira Wacke,9631,7,11,7,18,36,62,-26,40
St. Pölten,9631,8,9,8,19,45,68,-23,35
SV Josko Rie,9631,9,9,7,20,37,60,-23,34
Mattersburg,9631,10,9,7,20,36,60,-24,34
SC Rheindorf,9632,1,23,8,5,65,34,31,77
FC Salzburg,9632,2,22,5,9,72,38,34,71
SK Sturm Gra,9632,3,18,5,13,52,29,23,59
Rapid Vienna,9632,4,14,11,11,50,39,11,53
Vienna,9632,5,15,4,17,60,75,-15,49
Mattersburg,9632,6,11,11,14,43,53,-10,44
RZ Pellets W,9632,7,11,8,17,45,56,-11,41
Admira Wacke,9632,8,11,7,18,39,62,-23,40
St. Pölten,9632,9,10,8,18,44,58,-14,38
SV Josko Rie,9632,10,9,5,22,37,63,-26,32
FC Salzburg,9633,1,19,8,9,61,34,27,65
SC Rheindorf,9633,2,19,8,9,53,40,13,65
SK Sturm Gra,9633,3,18,7,11,58,42,16,61
Vienna,9633,4,18,7,11,64,49,15,61
Rapid Vienna,9633,5,14,11,11,58,39,19,53
Admira Wacke,9633,6,13,7,16,38,50,-12,46
RZ Pellets W,9633,7,12,7,17,45,53,-8,43
SV Josko Rie,9633,8,12,5,19,32,56,-24,41
Mattersburg,9633,9,9,7,20,40,58,-18,34
St. Pölten,9633,10,9,7,20,37,65,-28,34
FC Salzburg,9634,1,23,7,6,67,23,44,76
SC Rheindorf,9634,2,23,6,7,66,42,24,75
SK Sturm Gra,9634,3,22,6,8,73,37,36,72
Vienna,9634,4,15,4,17,56,61,-5,49
Rapid Vienna,9634,5,11,11,14,57,45,12,44
Admira Wacke,9634,6,13,5,18,41,58,-17,44
SV Josko Rie,9634,7,12,6,18,39,53,-14,42
RZ Pellets W,9634,8,11,6,19,38,70,-32,39
St. Pölten,9634,9,9,8,19,36,59,-23,35
Mattersburg,9634,10,8,7,21,38,63,-25,31
FC Salzburg,9635,1,23,6,7,74,31,43,75
SC Rheindorf,9635,2,19,10,7,53,35,18,67
Vienna,9635,3,20,3,13,61,53,8,63
SK Sturm Gra,9635,4,18,7,11,65,36,29,61
Rapid Vienna,9635,5,15,10,11,58,47,11,55
SV Josko Rie,9635,6,13,5,18,43,54,-11,44
RZ Pellets W,9635,7,11,6,19,47,61,-14,39
Mattersburg,9635,8,9,8,19,35,58,-23,35
Admira Wacke,9635,9,10,5,21,32,63,-31,35
St. Pölten,9635,10,8,8,20,43,73,-30,32
FC Salzburg,9636,1,20,10,6,65,26,39,70
SK Sturm Gra,9636,2,21,6,9,60,32,28,69
Rapid Vienna,9636,3,18,11,7,59,35,24,65
SC Rheindorf,9636,4,17,11,8,56,42,14,62
Vienna,9636,5,18,8,10,62,50,12,62
St. Pölten,9636,6,11,6,19,37,61,-24,39
SV Josko Rie,9636,7,11,4,21,32,57,-25,37
Mattersburg,9636,8,8,9,19,34,53,-19,33
RZ Pellets W,9636,9,8,8,20,43,62,-19,32
Admira Wacke,9636,10,9,5,22,34,64,-30,32
FC Salzburg,9637,1,22,8,6,74,30,44,74
SK Sturm Gra,9637,2,23,5,8,76,34,42,74
Vienna,9637,3,20,2,14,67,50,17,62
SC Rheindorf,9637,4,18,4,14,50,51,-1,58
Admira Wacke,9637,5,14,7,15,55,63,-8,49
Rapid Vienna,9637,6,12,11,13,48,41,7,47
RZ Pellets W,9637,7,12,8,16,46,62,-16,44
St. Pölten,9637,8,10,7,19,45,74,-29,37
Mattersburg,9637,9,7,10,19,37,61,-24,31
SV Josko Rie,9637,10,9,4,23,37,69,-32,31
FC Salzburg,9638,1,22,6,8,62,27,35,72
SC Rheindorf,9638,2,21,8,7,60,42,18,71
Vienna,9638,3,19,7,10,70,55,15,64
SK Sturm Gra,9638,4,18,7,11,51,31,20,61
Rapid Vienna,9638,5,15,9,12,62,39,23,54
Admira Wacke,9638,6,12,6,18,40,57,-17,42
RZ Pellets W,9638,7,11,6,19,42,67,-25,39
SV Josko Rie,9638,8,10,5,21,29,50,-21,35
Mattersburg,9638,9,9,7,20,32,56,-24,34
St. Pölten,9638,10,7,11,18,42,66,-24,32
FC Salzburg,9639,1,22,8,6,70,31,39,74
SC Rheindorf,9639,2,19,9,8,66,48,18,66
Vienna,9639,3,20,5,11,66,55,11,65
SK Sturm Gra,9639,4,18,8,10,64,37,27,62
Rapid Vienna,9639,5,13,10,13,53,48,5,49
RZ Pellets W,9639,6,11,9,16,42,56,-14,42
SV Josko Rie,9639,7,12,5,19,36,52,-16,41
St. Pölten,9639,8,10,9,17,50,66,-16,39
Admira Wacke,9639,9,11,3,22,41,68,-27,36
Mattersburg,9639,10,8,6,22,41,68,-27,30
FC Salzburg,9640,1,21,8,7,72,36,36,71
Vienna,9640,2,20,5,11,66,50,16,65
SC Rheindorf,9640,3,19,7,10,59,51,8,64
SK Sturm Gra,9640,4,18,8,10,60,38,22,62
Rapid Vienna,9640,5,13,13,10,65,47,18,52
RZ Pellets W,9640,6,12,9,15,52,56,-4,45
Admira Wacke,9640,7,12,7,17,35,56,-21,43
SV Josko Rie,9640,8,10,10,16,38,50,-12,40
Mattersburg,9640,9,8,9,19,35,56,-21,33
St. Pölten,9640,10,5,8,23,38,80,-42,23
FC Salzburg,9641,1,21,6,9,64,32,32,69
Rapid Vienna,9641,2,19,9,8,67,40,27,66
SC Rheindorf,9641,3,19,9,8,52,41,11,66
SK Sturm Gra,9641,4,18,7,11,55,36,19,61
Vienna,9641,5,15,7,14,57,54,3,52
RZ Pellets W,9641,6,13,7,16,52,61,-9,46
SV Josko Rie,9641,7,11,7,18,34,49,-15,40
St. Pölten,9641,8,10,7,19,47,69,-22,37
Admira Wacke,9641,9,9,8,19,36,64,-28,35
Mattersburg,9641,10,8,7,21,41,59,-18,31
SC Rheindorf,9642,1,25,6,5,64,35,29,81
FC Salzburg,9642,2,22,8,6,67,28,39,74
SK Sturm Gra,9642,3,18,7,11,56,34,22,61
Vienna,9642,4,18,7,11,60,49,11,61
Rapid Vienna,9642,5,14,10,12,53,39,14,52
RZ Pellets W,9642,6,13,7,16,44,56,-12,46
Admira Wacke,9642,7,12,9,15,38,54,-16,45
SV Josko Rie,9642,8,9,7,20,31,56,-25,34
Mattersburg,9642,9,5,10,21,30,56,-26,25
St. Pölten,9642,10,4,9,23,27,63,-36,21
FC Salzburg,9643,1,24,6,6,71,30,41,78
SC Rheindorf,9643,2,18,9,9,57,46,11,63
SK Sturm Gra,9643,3,16,8,12,54,39,15,56
Vienna,9643,4,18,2,16,59,61,-2,56
Rapid Vienna,9643,5,13,9,14,53,38,15,48
SV Josko Rie,9643,6,13,7,16,41,44,-3,46
St. Pölten,9643,7,11,10,15,45,56,-11,43
RZ Pellets W,9643,8,12,6,18,40,59,-19,42
Admira Wacke,9643,9,11,4,21,35,66,-31,37
Mattersburg,9643,10,9,9,18,43,59,-16,36
SC Rheindorf,9644,1,21,5,10,59,42,17,68
SK Sturm Gra,9644,2,20,6,10,63,30,33,66
FC Salzburg,9644,3,19,9,8,57,30,27,66
Vienna,9644,4,19,7,10,65,48,17,64
Rapid Vienna,9644,5,14,13,9,55,35,20,55
RZ Pellets W,9644,6,11,9,16,43,57,-14,42
SV Josko Rie,9644,7,11,5,20,39,54,-15,38
St. Pölten,9644,8,8,11,17,34,57,-23,35
Admira Wacke,9644,9,9,7,20,30,63,-33,34
Mattersburg,9644,10,8,8,20,31,60,-29,32
FC Salzburg,9645,1,27,5,4,73,23,50,86
Vienna,9645,2,22,3,11,72,57,15,69
SC Rheindorf,9645,3,19,7,10,57,46,11,64
SK Sturm Gra,9645,4,19,5,12,69,41,28,62
Rapid Vienna,9645,5,13,12,11,54,38,16,51
SV Josko Rie,9645,6,12,6,18,42,58,-16,42
Admira Wacke,9645,7,12,5,19,36,58,-22,41
RZ Pellets W,9645,8,10,8,18,37,55,-18,38
St. Pölten,9645,9,7,10,19,38,67,-29,31
Mattersburg,9645,10,5,7,24,28,63,-35,22
FC Salzburg,9646,1,23,9,4,70,23,47,78
SK Sturm Gra,9646,2,21,5,10,58,34,24,68
SC Rheindorf,9646,3,18,7,11,49,38,11,61
Vienna,9646,4,17,8,11,59,48,11,59
Rapid Vienna,9646,5,12,12,12,53,40,13,48
RZ Pellets W,9646,6,11,9,16,42,54,-12,42
Admira Wacke,9646,7,11,8,17,32,58,-26,41
SV Josko Rie,9646,8,11,5,20,41,60,-19,38
Mattersburg,9646,9,9,6,21,36,58,-22,33
St. Pölten,9646,10,7,11,18,42,69,-27,32
FC Salzburg,9647,1,23,7,6,73,28,45,76
SK Sturm Gra,9647,2,23,4,9,65,32,33,73
SC Rheindorf,9647,3,18,9,9,58,44,14,63
Rapid Vienna,9647,4,16,10,10,61,38,23,58
Vienna,9647,5,18,4,14,63,51,12,58
RZ Pellets W,9647,6,11,5,20,44,63,-19,38
Mattersburg,9647,7,9,10,17,39,58,-19,37
SV Josko Rie,9647,8,11,4,21,34,57,-23,37
Admira Wacke,9647,9,9,7,20,36,69,-33,34
St. Pölten,9647,10,9,6,21,35,68,-33,33
FC Salzburg,9648,1,23,6,7,69,29,40,75
SC Rheindorf,9648,2,20,8,8,61,42,19,68
Rapid Vienna,9648,3,17,9,10,62,44,18,60
Vienna,9648,4,17,6,13,59,54,5,57
SK Sturm Gra,9648,5,16,8,12,55,38,17,56
SV Josko Rie,9648,6,14,5,17,38,44,-6,47
RZ Pellets W,9648,7,12,6,18,47,62,-15,42
Admira Wacke,9648,8,12,6,18,39,62,-23,42
Mattersburg,9648,9,7,9,20,36,61,-25,30
St. Pölten,9648,10,6,9,21,38,68,-30,27
FC Salzburg,9649,1,21,6,9,65,33,32,69
SC Rheindorf,9649,2,20,8,8,59,36,23,68
Rapid Vienna,9649,3,20,7,9,67,39,28,67
Vienna,9649,4,20,4,12,66,53,13,64
SK Sturm Gra,9649,5,18,5,13,52,39,13,59
RZ Pellets W,9649,6,12,8,16,55,64,-9,44
Admira Wacke,9649,7,12,7,17,48,61,-13,43
St. Pölten,9649,8,10,7,19,46,70,-24,37
SV Josko Rie,9649,9,9,5,22,37,62,-25,32
Mattersburg,9649,10,5,9,22,31,69,-38,24
FC Salzburg,9650,1,19,10,7,53,24,29,67
SK Sturm Gra,9650,2,17,11,8,52,31,21,62
SC Rheindorf,9650,3,17,9,10,56,47,9,60
Rapid Vienna,9650,4,15,12,9,58,34,24,57
Vienna,9650,5,16,8,12,52,48,4,56
SV Josko Rie,9650,6,12,9,15,37,45,-8,45
Admira Wacke,9650,7,12,9,15,43,59,-16,45
RZ Pellets W,9650,8,11,7,18,42,59,-17,40
Mattersburg,9650,9,10,9,17,40,53,-13,39
St. Pölten,9650,10,5,8,23,34,67,-33,23
FC Salzburg,9651,1,22,8,6,66,27,39,74
SC Rheindorf,9651,2,20,7,9,54,40,14,67
SK Sturm Gra,9651,3,19,9,8,57,27,30,66
Vienna,9651,4,18,7,11,65,49,16,61
Rapid Vienna,9651,5,11,13,12,49,44,5,46
RZ Pellets W,9651,6,12,7,17,44,58,-14,43
Admira Wacke,9651,7,11,6,19,31,56,-25,39
SV Josko Rie,9651,8,10,6,20,32,58,-26,36
St. Pölten,9651,9,7,13,16,40,60,-20,34
Mattersburg,9651,10,7,10,19,37,56,-19,31
FC Salzburg,9652,1,21,6,9,63,30,33,69
SC Rheindorf,9652,2,17,9,10,57,49,8,60
Vienna,9652,3,18,5,13,67,57,10,59
SK Sturm Gra,9652,4,18,4,14,56,38,18,58
Rapid Vienna,9652,5,12,13,11,52,51,1,49
St. Pölten,9652,6,12,10,14,48,56,-8,46
RZ Pellets W,9652,7,12,7,17,45,54,-9,43
Mattersburg,9652,8,12,7,17,40,52,-12,43
SV Josko Rie,9652,9,11,6,19,33,54,-21,39
Admira Wacke,9652,10,11,5,20,39,59,-20,38
FC Salzburg,9653,1,20,9,7,71,38,33,69
SC Rheindorf,9653,2,19,11,6,64,39,25,68
SK Sturm Gra,9653,3,19,7,10,59,36,23,64
Rapid Vienna,9653,4,13,11,12,50,39,11,50
Vienna,9653,5,14,8,14,61,62,-1,50
RZ Pellets W,9653,6,14,7,15,49,52,-3,49
Mattersburg,9653,7,11,8,17,40,52,-12,41
Admira Wacke,9653,8,10,9,17,35,55,-20,39
St. Pölten,9653,9,9,9,18,37,65,-28,36
SV Josko Rie,9653,10,8,7,21,27,55,-28,31
FC Salzburg,9654,1,19,10,7,62,28,34,67
SK Sturm Gra,9654,2,20,5,11,66,32,34,65
SC Rheindorf,9654,3,19,5,12,54,46,8,62
Vienna,9654,4,19,4,13,54,53,1,61
RZ Pellets W,9654,5,13,8,15,49,53,-4,47
Rapid Vienna,9654,6,11,11,14,55,48,7,44
SV Josko Rie,9654,7,13,5,18,35,47,-12,44
Admira Wacke,9654,8,11,10,15,36,56,-20,43
St. Pölten,9654,9,10,10,16,43,62,-19,40
Mattersburg,9654,10,8,6,22,35,64,-29,30
SK Sturm Gra,9655,1,21,7,8,62,31,31,70
FC Salzburg,9655,2,19,8,9,62,32,30,65
Vienna,9655,3,21,2,13,73,55,18,65
SC Rheindorf,9655,4,19,7,10,58,39,19,64
Rapid Vienna,9655,5,14,10,12,51,39,12,52
SV Josko Rie,9655,6,14,3,19,35,53,-18,45
Mattersburg,9655,7,10,8,18,41,57,-16,38
RZ Pellets W,9655,8,10,8,18,47,65,-18,38
Admira Wacke,9655,9,10,6,20,35,60,-25,36
St. Pölten,9655,10,9,7,20,33,66,-33,34
FC Salzburg,9656,1,21,8,7,76,37,39,71
Vienna,9656,2,19,5,12,70,60,10,62
SC Rheindorf,9656,3,16,10,10,48,40,8,58
Rapid Vienna,9656,4,15,12,9,62,40,22,57
SK Sturm Gra,9656,5,16,9,11,58,44,14,57
Admira Wacke,9656,6,12,7,17,46,64,-18,43
RZ Pellets W,9656,7,11,8,17,46,58,-12,41
SV Josko Rie,9656,8,11,8,17,36,54,-18,41
Mattersburg,9656,9,9,8,19,40,57,-17,35
St. Pölten,9656,10,7,11,18,37,65,-28,32
FC Salzburg,9657,1,21,8,7,66,31,35,71
SC Rheindorf,9657,2,21,6,9,63,46,17,69
SK Sturm Gra,9657,3,19,8,9,61,36,25,65
Vienna,9657,4,16,8,12,52,47,5,56
Rapid Vienna,9657,5,14,11,11,58,45,13,53
Admira Wacke,9657,6,11,8,17,43,61,-18,41
Mattersburg,9657,7,10,9,17,36,54,-18,39
SV Josko Rie,9657,8,11,5,20,35,50,-15,38
RZ Pellets W,9657,9,10,7,19,41,56,-15,37
St. Pölten,9657,10,8,8,20,38,67,-29,32
FC Salzburg,9658,1,24,6,6,70,29,41,78
SC Rheindorf,9658,2,21,7,8,61,37,24,70
SK Sturm Gra,9658,3,18,9,9,57,36,21,63
Vienna,9658,4,16,7,13,56,54,2,55
Rapid Vienna,9658,5,13,13,10,54,41,13,52
RZ Pellets W,9658,6,13,9,14,51,51,0,48
Admira Wacke,9658,7,10,10,16,35,56,-21,40
SV Josko Rie,9658,8,8,8,20,29,55,-26,32
Mattersburg,9658,9,7,9,20,30,58,-28,30
St. Pölten,9658,10,6,10,20,37,63,-26,28
FC Salzburg,9659,1,22,6,8,63,29,34,72
Vienna,9659,2,20,6,10,65,46,19,66
SC Rheindorf,9659,3,20,6,10,56,45,11,66
SK Sturm Gra,9659,4,18,7,11,55,35,20,61
Rapid Vienna,9659,5,12,10,14,48,39,9,46
St. Pölten,9659,6,11,8,17,45,60,-15,41
Admira Wacke,9659,7,11,8,17,37,58,-21,41
RZ Pellets W,9659,8,11,7,18,40,57,-17,40
Mattersburg,9659,9,10,8,18,43,57,-14,38
SV Josko Rie,9659,10,8,8,20,33,59,-26,32
FC Salzburg,9660,1,23,8,5,71,29,42,77
SC Rheindorf,9660,2,21,9,6,59,36,23,72
Vienna,9660,3,16,7,13,64,57,7,55
SK Sturm Gra,9660,4,15,9,12,53,43,10,54
RZ Pellets W,9660,5,15,5,16,50,47,3,50
Rapid Vienna,9660,6,14,7,15,58,48,10,49
SV Josko Rie,9660,7,11,7,18,36,54,-18,40
Mattersburg,9660,8,10,8,18,43,59,-16,38
St. Pölten,9660,9,9,7,20,39,63,-24,34
Admira Wacke,9660,10,8,9,19,29,66,-37,33
SC Rheindorf,9661,1,20,10,6,57,37,20,70
FC Salzburg,9661,2,21,6,9,65,33,32,69
SK Sturm Gra,9661,3,19,5,12,54,35,19,62
Vienna,9661,4,18,5,13,61,52,9,59
RZ Pellets W,9661,5,13,7,16,49,57,-8,46
Admira Wacke,9661,6,12,6,18,37,57,-20,42
Rapid Vienna,9661,7,10,11,15,56,55,1,41
SV Josko Rie,9661,8,12,5,19,41,57,-16,41
Mattersburg,9661,9,10,9,17,41,51,-10,39
St. Pölten,9661,10,7,12,17,38,65,-27,33
FC Salzburg,9662,1,21,8,7,65,34,31,71
SC Rheindorf,9662,2,20,7,9,54,40,14,67
SK Sturm Gra,9662,3,18,7,11,58,38,20,61
Rapid Vienna,9662,4,16,9,11,57,34,23,57
Vienna,9662,5,16,5,15,58,55,3,53
RZ Pellets W,9662,6,14,8,14,48,51,-3,50
St. Pölten,9662,7,10,9,17,45,65,-20,39
Admira Wacke,9662,8,10,7,19,39,69,-30,37
SV Josko Rie,9662,9,10,5,21,35,55,-20,35
Mattersburg,9662,10,7,11,18,39,57,-18,32
FC Salzburg,9663,1,21,6,9,69,35,34,69
Vienna,9663,2,21,3,12,64,49,15,66
SK Sturm Gra,9663,3,20,5,11,63,35,28,65
SC Rheindorf,9663,4,17,8,11,53,47,6,59
Rapid Vienna,9663,5,14,9,13,65,46,19,51
RZ Pellets W,9663,6,14,5,17,45,55,-10,47
Mattersburg,9663,7,12,6,18,43,61,-18,42
SV Josko Rie,9663,8,11,5,20,37,56,-19,38
Admira Wacke,9663,9,11,5,20,33,59,-26,38
St. Pölten,9663,10,10,6,20,43,72,-29,36
SC Rheindorf,9664,1,19,10,7,58,40,18,67
FC Salzburg,9664,2,17,11,8,56,30,26,62
Vienna,9664,3,19,4,13,57,49,8,61
SK Sturm Gra,9664,4,17,7,12,59,39,20,58
Rapid Vienna,9664,5,14,12,10,52,36,16,54
Admira Wacke,9664,6,14,5,17,42,54,-12,47
RZ Pellets W,9664,7,12,7,17,44,51,-7,43
SV Josko Rie,9664,8,13,3,20,35,52,-17,42
Mattersburg,9664,9,10,7,19,40,58,-18,37
St. Pölten,9664,10,8,8,20,41,75,-34,32
FC Salzburg,9665,1,23,6,7,75,32,43,75
SC Rheindorf,9665,2,19,9,8,58,42,16,66
Vienna,9665,3,20,5,11,71,52,19,65
SK Sturm Gra,9665,4,18,9,9,62,37,25,63
Rapid Vienna,9665,5,14,10,12,56,40,16,52
RZ Pellets W,9665,6,12,7,17,45,63,-18,43
Admira Wacke,9665,7,10,10,16,46,68,-22,40
Mattersburg,9665,8,9,9,18,37,51,-14,36
St. Pölten,9665,9,6,12,18,37,63,-26,30
SV Josko Rie,9665,10,8,5,23,30,69,-39,29
FC Salzburg,9666,1,20,11,5,71,30,41,71
SC Rheindorf,9666,2,18,10,8,58,45,13,64
SK Sturm Gra,9666,3,19,4,13,62,47,15,61
Vienna,9666,4,16,6,14,62,51,11,54
Admira Wacke,9666,5,13,7,16,43,57,-14,46
Rapid Vienna,9666,6,11,12,13,52,45,7,45
Mattersburg,9666,7,11,10,15,42,52,-10,43
RZ Pellets W,9666,8,12,6,18,43,61,-18,42
SV Josko Rie,9666,9,9,9,18,31,53,-22,36
St. Pölten,9666,10,8,11,17,43,66,-23,35
FC Salzburg,9667,1,21,9,6,64,23,41,72
Vienna,9667,2,20,5,11,75,51,24,65
Rapid Vienna,9667,3,16,12,8,57,36,21,60
SK Sturm Gra,9667,4,16,10,10,63,41,22,58
SC Rheindorf,9667,5,15,12,9,50,45,5,57
Admira Wacke,9667,6,13,6,17,37,52,-15,45
RZ Pellets W,9667,7,11,8,17,45,65,-20,41
SV Josko Rie,9667,8,8,9,19,34,54,-20,33
Mattersburg,9667,9,8,9,19,38,63,-25,33
St. Pölten,9667,10,8,8,20,38,71,-33,32
FC Salzburg,9668,1,21,6,9,62,32,30,69
SK Sturm Gra,9668,2,20,6,10,60,29,31,66
Vienna,9668,3,20,3,13,68,56,12,63
SC Rheindorf,9668,4,18,9,9,53,43,10,63
Rapid Vienna,9668,5,17,8,11,62,37,25,59
RZ Pellets W,9668,6,14,7,15,48,51,-3,49
Admira Wacke,9668,7,13,4,19,39,60,-21,43
SV Josko Rie,9668,8,11,5,20,35,57,-22,38
St. Pölten,9668,9,7,9,20,34,66,-32,30
Mattersburg,9668,10,6,9,21,28,58,-30,27
FC Salzburg,9669,1,21,7,8,75,31,44,70
SK Sturm Gra,9669,2,19,8,9,63,37,26,65
Vienna,9669,3,18,6,12,71,59,12,60
SC Rheindorf,9669,4,17,7,12,54,52,2,58
Rapid Vienna,9669,5,14,11,11,53,39,14,53
RZ Pellets W,9669,6,11,10,15,48,59,-11,43
St. Pölten,9669,7,11,8,17,47,67,-20,41
Mattersburg,9669,8,10,9,17,40,55,-15,39
Admira Wacke,9669,9,11,6,19,33,58,-25,39
SV Josko Rie,9669,10,8,8,20,33,60,-27,32
FC Salzburg,9670,1,21,9,6,69,32,37,72
SC Rheindorf,9670,2,19,8,9,59,42,17,65
Vienna,9670,3,20,4,12,58,53,5,64
SK Sturm Gra,9670,4,18,6,12,53,37,16,60
Rapid Vienna,9670,5,17,8,11,65,41,24,59
RZ Pellets W,9670,6,14,5,17,51,55,-4,47
Mattersburg,9670,7,9,10,17,39,55,-16,37
SV Josko Rie,9670,8,10,6,20,32,52,-20,36
Admira Wacke,9670,9,10,6,20,35,62,-27,36
St. Pölten,9670,10,7,8,21,38,70,-32,29
FC Salzburg,9671,1,22,7,7,64,28,36,73
SC Rheindorf,9671,2,21,5,10,55,42,13,68
Vienna,9671,3,20,6,10,64,44,20,66
SK Sturm Gra,9671,4,16,5,15,56,42,14,53
Rapid Vienna,9671,5,14,9,13,64,49,15,51
RZ Pellets W,9671,6,12,8,16,56,59,-3,44
Admira Wacke,9671,7,13,5,18,40,69,-29,44
SV Josko Rie,9671,8,12,4,20,35,53,-18,40
St. Pölten,9671,9,8,10,18,46,62,-16,34
Mattersburg,9671,10,9,7,20,34,66,-32,34
SC Rheindorf,9672,1,22,8,6,59,42,17,74
SK Sturm Gra,9672,2,20,6,10,62,31,31,66
Rapid Vienna,9672,3,18,10,8,63,43,20,64
FC Salzburg,9672,4,16,8,12,54,34,20,56
Vienna,9672,5,17,4,15,55,51,4,55
RZ Pellets W,9672,6,12,6,18,48,59,-11,42
Admira Wacke,9672,7,10,9,17,37,56,-19,39
SV Josko Rie,9672,8,11,6,19,31,55,-24,39
St. Pölten,9672,9,8,10,18,47,66,-19,34
Mattersburg,9672,10,9,7,20,36,55,-19,34
FC Salzburg,9673,1,21,8,7,67,28,39,71
SK Sturm Gra,9673,2,21,7,8,69,36,33,70
SC Rheindorf,9673,3,19,10,7,60,43,17,67
Vienna,9673,4,16,6,14,56,55,1,54
Rapid Vienna,9673,5,14,11,11,53,39,14,53
RZ Pellets W,9673,6,13,7,16,54,57,-3,46
SV Josko Rie,9673,7,13,2,21,41,63,-22,41
Admira Wacke,9673,8,11,6,19,40,63,-23,39
Mattersburg,9673,9,8,8,20,40,66,-26,32
St. Pölten,9673,10,7,9,20,41,71,-30,30
FC Salzburg,9674,1,22,7,7,64,30,34,73
SC Rheindorf,9674,2,19,8,9,63,52,11,65
SK Sturm Gra,9674,3,18,8,10,60,39,21,62
Vienna,9674,4,15,7,14,60,58,2,52
RZ Pellets W,9674,5,14,9,13,47,50,-3,51
Rapid Vienna,9674,6,13,10,13,54,41,13,49
St. Pölten,9674,7,10,9,17,45,65,-20,39
Admira Wacke,9674,8,11,6,19,39,59,-20,39
SV Josko Rie,9674,9,11,4,21,31,54,-23,37
Mattersburg,9674,10,10,6,20,40,55,-15,36
SK Sturm Gra,9675,1,21,5,10,66,33,33,68
FC Salzburg,9675,2,19,9,8,67,39,28,66
SC Rheindorf,9675,3,19,7,10,59,44,15,64
Vienna,9675,4,19,6,11,65,54,11,63
RZ Pellets W,9675,5,15,7,14,53,55,-2,52
Rapid Vienna,9675,6,11,12,13,49,44,5,45
SV Josko Rie,9675,7,13,6,17,40,54,-14,45
Admira Wacke,9675,8,9,9,18,38,59,-21,36
St. Pölten,9675,9,8,9,19,38,63,-25,33
Mattersburg,9675,10,7,8,21,32,62,-30,29
FC Salzburg,9676,1,19,11,6,62,32,30,68
Vienna,9676,2,18,8,10,62,49,13,62
SK Sturm Gra,9676,3,17,10,9,58,35,23,61
SC Rheindorf,9676,4,18,7,11,58,41,17,61
Rapid Vienna,9676,5,14,11,11,61,38,23,53
Admira Wacke,9676,6,13,6,17,36,60,-24,45
RZ Pellets W,9676,7,12,6,18,43,59,-16,42
Mattersburg,9676,8,8,13,15,39,54,-15,37
St. Pölten,9676,9,8,11,17,36,61,-25,35
SV Josko Rie,9676,10,7,9,20,31,57,-26,30
FC Salzburg,9677,1,25,4,7,69,29,40,79
Vienna,9677,2,21,4,11,73,50,23,67
SC Rheindorf,9677,3,18,8,10,58,44,14,62
SK Sturm Gra,9677,4,16,7,13,53,47,6,55
Admira Wacke,9677,5,14,7,15,44,55,-11,49
Rapid Vienna,9677,6,10,12,14,60,46,14,42
RZ Pellets W,9677,7,11,8,17,44,56,-12,41
St. Pölten,9677,8,10,10,16,47,67,-20,40
SV Josko Rie,9677,9,8,10,18,34,56,-22,34
Mattersburg,9677,10,8,8,20,37,69,-32,32
SC Rheindorf,9678,1,19,10,7,56,41,15,67
Vienna,9678,2,19,8,9,75,53,22,65
SK Sturm Gra,9678,3,19,5,12,58,36,22,62
FC Salzburg,9678,4,16,13,7,59,31,28,61
Rapid Vienna,9678,5,13,13,10,53,36,17,52
RZ Pellets W,9678,6,13,9,14,41,48,-7,48
SV Josko Rie,9678,7,11,6,19,33,50,-17,39
Mattersburg,9678,8,9,10,17,41,61,-20,37
Admira Wacke,9678,9,9,7,20,29,61,-32,34
St. Pölten,9678,10,7,9,20,36,64,-28,30
FC Salzburg,9679,1,19,8,9,60,33,27,65
Vienna,9679,2,20,4,12,75,54,21,64
SC Rheindorf,9679,3,17,8,11,48,45,3,59
Rapid Vienna,9679,4,15,13,8,60,33,27,58
SK Sturm Gra,9679,5,15,10,11,53,38,15,55
RZ Pellets W,9679,6,13,9,14,46,51,-5,48
Admira Wacke,9679,7,12,8,16,42,66,-24,44
Mattersburg,9679,8,11,8,17,40,48,-8,41
St. Pölten,9679,9,11,8,17,47,65,-18,41
SV Josko Rie,9679,10,6,6,24,30,68,-38,24
FC Salzburg,9680,1,22,7,7,63,26,37,73
SK Sturm Gra,9680,2,19,8,9,63,35,28,65
SC Rheindorf,9680,3,19,6,11,62,49,13,63
Vienna,9680,4,17,7,12,62,54,8,58
Admira Wacke,9680,5,15,6,15,44,55,-11,51
Rapid Vienna,9680,6,12,10,14,53,44,9,46
SV Josko Rie,9680,7,13,4,19,33,46,-13,43
Mattersburg,9680,8,10,7,19,39,60,-21,37
St. Pölten,9680,9,9,9,18,43,69,-26,36
RZ Pellets W,9680,10,9,6,21,39,63,-24,33
FC Salzburg,9681,1,21,8,7,66,30,36,71
SC Rheindorf,9681,2,18,10,8,52,41,11,64
SK Sturm Gra,9681,3,19,6,11,57,36,21,63
Vienna,9681,4,19,4,13,69,57,12,61
Rapid Vienna,9681,5,14,8,14,57,45,12,50
RZ Pellets W,9681,6,12,9,15,45,55,-10,45
SV Josko Rie,9681,7,13,6,17,34,46,-12,45
Mattersburg,9681,8,9,8,19,36,57,-21,35
Admira Wacke,9681,9,10,5,21,30,62,-32,35
St. Pölten,9681,10,8,10,18,48,65,-17,34
FC Salzburg,9682,1,20,9,7,71,34,37,69
SK Sturm Gra,9682,2,20,6,10,60,33,27,66
Vienna,9682,3,18,6,12,61,53,8,60
SC Rheindorf,9682,4,16,11,9,54,45,9,59
Rapid Vienna,9682,5,15,13,8,53,33,20,58
Admira Wacke,9682,6,13,5,18,42,61,-19,44
SV Josko Rie,9682,7,12,6,18,37,55,-18,42
St. Pölten,9682,8,9,10,17,41,63,-22,37
Mattersburg,9682,9,8,8,20,29,49,-20,32
RZ Pellets W,9682,10,8,8,20,33,55,-22,32
FC Salzburg,9683,1,20,12,4,69,32,37,72
SK Sturm Gra,9683,2,19,8,9,58,30,28,65
SC Rheindorf,9683,3,16,14,6,47,38,9,62
Vienna,9683,4,17,5,14,59,55,4,56
Rapid Vienna,9683,5,11,15,10,50,43,7,48
St. Pölten,9683,6,11,12,13,46,53,-7,45
SV Josko Rie,9683,7,11,6,19,37,46,-9,39
RZ Pellets W,9683,8,10,7,19,40,59,-19,37
Admira Wacke,9683,9,10,6,20,29,56,-27,36
Mattersburg,9683,10,7,11,18,34,57,-23,32
FC Salzburg,9684,1,25,6,5,70,29,41,81
SK Sturm Gra,9684,2,19,8,9,58,32,26,65
SC Rheindorf,9684,3,18,10,8,54,39,15,64
Vienna,9684,4,19,4,13,67,55,12,61
Rapid Vienna,9684,5,13,10,13,58,43,15,49
RZ Pellets W,9684,6,11,10,15,45,57,-12,43
Admira Wacke,9684,7,12,3,21,41,69,-28,39
SV Josko Rie,9684,8,10,5,21,33,53,-20,35
Mattersburg,9684,9,9,8,19,37,63,-26,35
St. Pölten,9684,10,6,12,18,35,58,-23,30
SC Rheindorf,9685,1,20,8,8,62,44,18,68
FC Salzburg,9685,2,18,10,8,66,34,32,64
SK Sturm Gra,9685,3,17,6,13,52,36,16,57
Vienna,9685,4,17,6,13,62,58,4,57
Rapid Vienna,9685,5,16,8,12,59,41,18,56
RZ Pellets W,9685,6,14,8,14,55,57,-2,50
Admira Wacke,9685,7,14,5,17,45,65,-20,47
Mattersburg,9685,8,11,8,17,39,59,-20,41
SV Josko Rie,9685,9,10,4,22,28,54,-26,34
St. Pölten,9685,10,8,7,21,41,61,-20,31
FC Salzburg,9686,1,21,8,7,73,34,39,71
SC Rheindorf,9686,2,20,9,7,59,39,20,69
SK Sturm Gra,9686,3,21,5,10,55,28,27,68
Vienna,9686,4,17,5,14,61,58,3,56
Rapid Vienna,9686,5,13,9,14,53,46,7,48
RZ Pellets W,9686,6,13,8,15,51,56,-5,47
St. Pölten,9686,7,10,8,18,45,63,-18,38
Mattersburg,9686,8,10,7,19,45,66,-21,37
SV Josko Rie,9686,9,10,5,21,34,59,-25,35
Admira Wacke,9686,10,9,8,19,34,61,-27,35
FC Salzburg,9687,1,22,5,9,68,29,39,71
SK Sturm Gra,9687,2,20,8,8,68,32,36,68
SC Rheindorf,9687,3,19,6,11,53,45,8,63
Rapid Vienna,9687,4,16,10,10,58,42,16,58
Vienna,9687,5,18,2,16,62,58,4,56
Admira Wacke,9687,6,13,7,16,43,62,-19,46
SV Josko Rie,9687,7,12,6,18,42,54,-12,42
RZ Pellets W,9687,8,11,7,18,50,67,-17,40
Mattersburg,9687,9,8,8,20,36,64,-28,32
St. Pölten,9687,10,6,11,19,37,64,-27,29
FC Salzburg,9688,1,22,9,5,69,27,42,75
SC Rheindorf,9688,2,20,7,9,55,38,17,67
Vienna,9688,3,19,5,12,63,52,11,62
SK Sturm Gra,9688,4,16,6,14,53,40,13,54
Rapid Vienna,9688,5,11,13,12,56,47,9,46
Admira Wacke,9688,6,13,6,17,44,54,-10,45
RZ Pellets W,9688,7,12,8,16,36,48,-12,44
Mattersburg,9688,8,11,7,18,39,57,-18,40
SV Josko Rie,9688,9,12,3,21,32,54,-22,39
St. Pölten,9688,10,8,8,20,41,71,-30,32
SC Rheindorf,9689,1,23,5,8,59,45,14,74
SK Sturm Gra,9689,2,19,6,11,59,34,25,63
Vienna,9689,3,18,7,11,64,48,16,61
Rapid Vienna,9689,4,16,12,8,69,39,30,60
FC Salzburg,9689,5,17,9,10,60,40,20,60
Admira Wacke,9689,6,14,6,16,42,59,-17,48
St. Pölten,9689,7,9,10,17,45,66,-21,37
Mattersburg,9689,8,9,8,19,40,57,-17,35
RZ Pellets W,9689,9,9,8,19,45,67,-22,35
SV Josko Rie,9689,10,9,3,24,33,61,-28,30
FC Salzburg,9690,1,22,8,6,71,32,39,74
SK Sturm Gra,9690,2,23,4,9,65,32,33,73
SC Rheindorf,9690,3,19,8,9,54,42,12,65
Vienna,9690,4,15,8,13,59,55,4,53
Rapid Vienna,9690,5,14,9,13,53,44,9,51
RZ Pellets W,9690,6,14,6,16,45,51,-6,48
Admira Wacke,9690,7,13,8,15,43,58,-15,47
Mattersburg,9690,8,9,7,20,39,60,-21,34
SV Josko Rie,9690,9,9,7,20,31,54,-23,34
St. Pölten,9690,10,5,9,22,38,70,-32,24
SK Sturm Gra,9691,1,22,6,8,63,32,31,72
FC Salzburg,9691,2,18,8,10,56,32,24,62
SC Rheindorf,9691,3,17,10,9,55,46,9,61
Vienna,9691,4,19,3,14,62,55,7,60
Rapid Vienna,9691,5,15,9,12,58,41,17,54
Admira Wacke,9691,6,14,5,17,43,60,-17,47
SV Josko Rie,9691,7,12,8,16,39,48,-9,44
RZ Pellets W,9691,8,12,6,18,50,60,-10,42
St. Pölten,9691,9,8,8,20,40,67,-27,32
Mattersburg,9691,10,6,11,19,32,57,-25,29
FC Salzburg,9692,1,20,7,9,64,33,31,67
SC Rheindorf,9692,2,19,7,10,55,45,10,64
SK Sturm Gra,9692,3,18,8,10,56,35,21,62
Vienna,9692,4,18,4,14,60,53,7,58
Rapid Vienna,9692,5,12,12,12,49,41,8,48
RZ Pellets W,9692,6,12,9,15,54,59,-5,45
Admira Wacke,9692,7,12,8,16,38,56,-18,44
St. Pölten,9692,8,10,10,16,48,66,-18,40
Mattersburg,9692,9,11,5,20,42,57,-15,38
SV Josko Rie,9692,10,11,4,21,35,56,-21,37
SC Rheindorf,9693,1,23,7,6,65,37,28,76
FC Salzburg,9693,2,20,8,8,60,27,33,68
Vienna,9693,3,20,5,11,59,44,15,65
SK Sturm Gra,9693,4,18,6,12,56,42,14,60
Rapid Vienna,9693,5,16,10,10,62,44,18,58
RZ Pellets W,9693,6,12,9,15,45,51,-6,45
SV Josko Rie,9693,7,11,4,21,33,52,-19,37
Admira Wacke,9693,8,9,9,18,32,57,-25,36
Mattersburg,9693,9,7,10,19,34,58,-24,31
St. Pölten,9693,10,4,12,20,35,69,-34,24
FC Salzburg,9694,1,20,9,7,66,33,33,69
Vienna,9694,2,21,4,11,66,48,18,67
Rapid Vienna,9694,3,16,11,9,69,41,28,59
SK Sturm Gra,9694,4,17,8,11,54,31,23,59
SC Rheindorf,9694,5,17,7,12,52,47,5,58
RZ Pellets W,9694,6,13,6,17,51,61,-10,45
St. Pölten,9694,7,10,9,17,39,60,-21,39
Admira Wacke,9694,8,11,6,19,35,62,-27,39
Mattersburg,9694,9,9,9,18,39,62,-23,36
SV Josko Rie,9694,10,9,5,22,31,57,-26,32
FC Salzburg,9695,1,20,9,7,61,28,33,69
SC Rheindorf,9695,2,19,8,9,55,38,17,65
SK Sturm Gra,9695,3,19,6,11,59,35,24,63
Vienna,9695,4,19,6,11,62,52,10,63
Rapid Vienna,9695,5,16,8,12,63,38,25,56
Admira Wacke,9695,6,13,7,16,37,55,-18,46
RZ Pellets W,9695,7,11,6,19,43,62,-19,39
St. Pölten,9695,8,9,9,18,42,67,-25,36
SV Josko Rie,9695,9,10,5,21,37,62,-25,35
Mattersburg,9695,10,8,8,20,31,53,-22,32
SC Rheindorf,9696,1,21,9,6,60,36,24,72
FC Salzburg,9696,2,18,7,11,61,37,24,61
SK Sturm Gra,9696,3,18,7,11,55,35,20,61
Vienna,9696,4,18,5,13,70,60,10,59
Rapid Vienna,9696,5,16,8,12,49,37,12,56
RZ Pellets W,9696,6,15,6,15,53,51,2,51
Admira Wacke,9696,7,11,4,21,34,67,-33,37
Mattersburg,9696,8,9,9,18,40,60,-20,36
St. Pölten,9696,9,9,9,18,39,64,-25,36
SV Josko Rie,9696,10,9,8,19,40,54,-14,35
FC Salzburg,9697,1,20,9,7,63,34,29,69
Vienna,9697,2,21,4,11,66,47,19,67
SK Sturm Gra,9697,3,19,9,8,59,31,28,66
SC Rheindorf,9697,4,18,12,6,59,38,21,66
Rapid Vienna,9697,5,12,11,13,60,48,12,47
RZ Pellets W,9697,6,11,7,18,39,56,-17,40
Admira Wacke,9697,7,10,8,18,34,55,-21,38
SV Josko Rie,9697,8,11,5,20,37,60,-23,38
St. Pölten,9697,9,8,10,18,39,61,-22,34
Mattersburg,9697,10,8,9,19,38,64,-26,33
SC Rheindorf,9698,1,22,6,8,63,42,21,72
Vienna,9698,2,21,4,11,80,56,24,67
FC Salzburg,9698,3,18,8,10,62,35,27,62
SK Sturm Gra,9698,4,18,7,11,64,43,21,61
Rapid Vienna,9698,5,17,8,11,56,38,18,59
Admira Wacke,9698,6,13,5,18,41,61,-20,44
RZ Pellets W,9698,7,12,7,17,43,58,-15,43
St. Pölten,9698,8,8,10,18,45,63,-18,34
SV Josko Rie,9698,9,9,6,21,29,56,-27,33
Mattersburg,9698,10,6,11,19,33,64,-31,29
SC Rheindorf,9699,1,22,6,8,59,44,15,72
FC Salzburg,9699,2,20,8,8,71,33,38,68
Rapid Vienna,9699,3,15,11,10,58,38,20,56
SK Sturm Gra,9699,4,16,8,12,55,41,14,56
Vienna,9699,5,16,8,12,64,51,13,56
Mattersburg,9699,6,11,9,16,43,55,-12,42
RZ Pellets W,9699,7,11,8,17,51,60,-9,41
SV Josko Rie,9699,8,12,4,20,32,51,-19,40
Admira Wacke,9699,9,11,6,19,38,71,-33,39
St. Pölten,9699,10,6,12,18,34,61,-27,30
FC Salzburg,9700,1,22,7,7,61,28,33,73
SC Rheindorf,9700,2,19,9,8,61,40,21,66
SK Sturm Gra,9700,3,19,7,10,53,28,25,64
Rapid Vienna,9700,4,15,11,10,56,39,17,56
Vienna,9700,5,15,5,16,60,60,0,50
RZ Pellets W,9700,6,13,7,16,52,53,-1,46
Admira Wacke,9700,7,12,8,16,41,64,-23,44
Mattersburg,9700,8,8,11,17,39,59,-20,35
SV Josko Rie,9700,9,10,4,22,35,65,-30,34
St. Pölten,9700,10,7,11,18,45,67,-22,32
SC Rheindorf,9701,1,19,8,9,61,43,18,65
FC Salzburg,9701,2,18,10,8,63,34,29,64
SK Sturm Gra,9701,3,19,7,10,62,42,20,64
Vienna,9701,4,18,5,13,65,51,14,59
RZ Pellets W,9701,5,16,6,14,50,57,-7,54
Rapid Vienna,9701,6,14,10,12,51,43,8,52
Admira Wacke,9701,7,13,6,17,40,54,-14,45
Mattersburg,9701,8,10,9,17,49,52,-3,39
SV Josko Rie,9701,9,9,5,22,32,60,-28,32
St. Pölten,9701,10,6,10,20,37,74,-37,28
SC Rheindorf,9702,1,22,6,8,56,36,20,72
Vienna,9702,2,21,4,11,65,43,22,67
FC Salzburg,9702,3,19,8,9,65,33,32,65
SK Sturm Gra,9702,4,19,4,13,56,35,21,61
Admira Wacke,9702,5,14,7,15,42,53,-11,49
Rapid Vienna,9702,6,11,10,15,48,48,0,43
RZ Pellets W,9702,7,12,6,18,40,55,-15,42
SV Josko Rie,9702,8,11,6,19,30,50,-20,39
St. Pölten,9702,9,7,13,16,36,57,-21,34
Mattersburg,9702,10,8,8,20,31,59,-28,32
FC Salzburg,9703,1,21,10,5,63,25,38,73
Vienna,9703,2,19,9,8,64,45,19,66
SK Sturm Gra,9703,3,18,7,11,57,37,20,61
SC Rheindorf,9703,4,17,7,12,50,44,6,58
Rapid Vienna,9703,5,14,12,10,56,39,17,54
SV Josko Rie,9703,6,13,7,16,41,53,-12,46
St. Pölten,9703,7,10,9,17,43,62,-19,39
RZ Pellets W,9703,8,11,4,21,37,61,-24,37
Mattersburg,9703,9,8,9,19,37,55,-18,33
Admira Wacke,9703,10,8,8,20,38,65,-27,32
SK Sturm Gra,9704,1,22,7,7,75,32,43,73
FC Salzburg,9704,2,21,7,8,61,30,31,70
SC Rheindorf,9704,3,19,7,10,55,46,9,64
Vienna,9704,4,17,8,11,63,56,7,59
Rapid Vienna,9704,5,13,12,11,50,43,7,51
Admira Wacke,9704,6,12,7,17,42,57,-15,43
SV Josko Rie,9704,7,11,5,20,34,57,-23,38
Mattersburg,9704,8,9,8,19,38,59,-21,35
St. Pölten,9704,9,8,10,18,44,62,-18,34
RZ Pellets W,9704,10,7,11,18,38,58,-20,32
SK Sturm Gra,9705,1,21,5,10,63,35,28,68
SC Rheindorf,9705,2,20,8,8,57,47,10,68
FC Salzburg,9705,3,20,6,10,61,33,28,66
Vienna,9705,4,18,4,14,68,50,18,58
Rapid Vienna,9705,5,15,11,10,62,42,20,56
SV Josko Rie,9705,6,15,4,17,42,52,-10,49
RZ Pellets W,9705,7,11,8,17,46,63,-17,41
Admira Wacke,9705,8,11,8,17,40,62,-22,41
St. Pölten,9705,9,7,8,21,36,67,-31,29
Mattersburg,9705,10,6,10,20,37,61,-24,28
FC Salzburg,9706,1,23,6,7,69,32,37,75
SC Rheindorf,9706,2,22,6,8,55,40,15,72
Vienna,9706,3,21,4,11,63,43,20,67
SK Sturm Gra,9706,4,17,5,14,54,38,16,56
Rapid Vienna,9706,5,15,10,11,54,38,16,55
RZ Pellets W,9706,6,14,7,15,51,51,0,49
SV Josko Rie,9706,7,11,7,18,38,52,-14,40
Admira Wacke,9706,8,11,7,18,29,56,-27,40
Mattersburg,9706,9,6,8,22,30,57,-27,26
St. Pölten,9706,10,5,10,21,31,67,-36,25
FC Salzburg,9707,1,20,11,5,65,27,38,71
SC Rheindorf,9707,2,19,10,7,56,44,12,67
SK Sturm Gra,9707,3,18,7,11,55,34,21,61
Vienna,9707,4,17,6,13,59,51,8,57
Rapid Vienna,9707,5,14,12,10,56,40,16,54
RZ Pellets W,9707,6,15,5,16,50,56,-6,50
SV Josko Rie,9707,7,11,8,17,36,46,-10,41
Admira Wacke,9707,8,10,6,20,34,62,-28,36
Mattersburg,9707,9,7,12,17,32,53,-21,33
St. Pölten,9707,10,5,11,20,39,69,-30,26
FC Salzburg,9708,1,21,8,7,64,29,35,71
SC Rheindorf,9708,2,18,11,7,56,36,20,65
Vienna,9708,3,19,5,12,57,47,10,62
SK Sturm Gra,9708,4,17,9,10,53,34,19,60
Rapid Vienna,9708,5,13,14,9,56,42,14,53
RZ Pellets W,9708,6,13,7,16,45,50,-5,46
Admira Wacke,9708,7,11,7,18,31,55,-24,40
SV Josko Rie,9708,8,9,8,19,33,55,-22,35
Mattersburg,9708,9,8,8,20,38,59,-21,32
St. Pölten,9708,10,6,13,17,38,64,-26,31
SK Sturm Gra,9709,1,21,7,8,69,37,32,70
SC Rheindorf,9709,2,19,11,6,51,39,12,68
FC Salzburg,9709,3,20,7,9,59,31,28,67
Vienna,9709,4,19,7,10,66,49,17,64
Rapid Vienna,9709,5,15,10,11,56,40,16,55
RZ Pellets W,9709,6,12,9,15,48,54,-6,45
Admira Wacke,9709,7,11,7,18,41,61,-20,40
SV Josko Rie,9709,8,9,5,22,30,53,-23,32
St. Pölten,9709,9,7,11,18,36,60,-24,32
Mattersburg,9709,10,7,6,23,37,69,-32,27
SC Rheindorf,9710,1,22,5,9,48,32,16,71
FC Salzburg,9710,2,20,7,9,68,35,33,67
Vienna,9710,3,21,4,11,66,51,15,67
SK Sturm Gra,9710,4,20,6,10,60,35,25,66
Rapid Vienna,9710,5,12,13,11,55,45,10,49
RZ Pellets W,9710,6,11,9,16,43,53,-10,42
Admira Wacke,9710,7,11,8,17,39,56,-17,41
SV Josko Rie,9710,8,9,8,19,35,50,-15,35
St. Pölten,9710,9,8,10,18,43,66,-23,34
Mattersburg,9710,10,7,8,21,32,66,-34,29
FC Salzburg,9711,1,23,5,8,65,26,39,74
SC Rheindorf,9711,2,22,6,8,65,44,21,72
SK Sturm Gra,9711,3,19,6,11,60,42,18,63
Vienna,9711,4,18,8,10,64,53,11,62
RZ Pellets W,9711,5,14,8,14,51,56,-5,50
Rapid Vienna,9711,6,12,12,12,52,42,10,48
Admira Wacke,9711,7,13,6,17,40,50,-10,45
SV Josko Rie,9711,8,11,3,22,37,61,-24,36
Mattersburg,9711,9,7,8,21,31,59,-28,29
St. Pölten,9711,10,6,8,22,41,73,-32,26
FC Salzburg,9712,1,22,8,6,66,26,40,74
SC Rheindorf,9712,2,21,6,9,64,46,18,69
Vienna,9712,3,18,7,11,61,53,8,61
SK Sturm Gra,9712,4,18,4,14,59,43,16,58
Rapid Vienna,9712,5,15,10,11,59,39,20,55
RZ Pellets W,9712,6,13,7,16,51,59,-8,46
Admira Wacke,9712,7,11,7,18,36,62,-26,40
SV Josko Rie,9712,8,11,6,19,36,53,-17,39
St. Pölten,9712,9,8,7,21,42,62,-20,31
Mattersburg,9712,10,7,10,19,35,66,-31,31
FC Salzburg,9713,1,20,8,8,69,37,32,68
SC Rheindorf,9713,2,19,9,8,60,46,14,66
SK Sturm Gra,9713,3,19,7,10,56,33,23,64
Vienna,9713,4,20,4,12,67,52,15,64
RZ Pellets W,9713,5,15,6,15,51,53,-2,51
Rapid Vienna,9713,6,13,11,12,53,41,12,50
SV Josko Rie,9713,7,11,5,20,45,59,-14,38
Mattersburg,9713,8,9,10,17,41,60,-19,37
Admira Wacke,9713,9,10,5,21,36,70,-34,35
St. Pölten,9713,10,6,11,19,40,67,-27,29
SC Rheindorf,9714,1,20,7,9,55,38,17,67
FC Salzburg,9714,2,19,9,8,62,34,28,66
SK Sturm Gra,9714,3,20,6,10,58,35,23,66
Vienna,9714,4,18,7,11,53,43,10,61
Rapid Vienna,9714,5,14,10,12,57,41,16,52
SV Josko Rie,9714,6,13,6,17,33,46,-13,45
St. Pölten,9714,7,11,7,18,44,62,-18,40
RZ Pellets W,9714,8,9,10,17,43,57,-14,37
Mattersburg,9714,9,8,10,18,33,53,-20,34
Admira Wacke,9714,10,9,6,21,32,61,-29,33
FC Salzburg,9715,1,22,8,6,71,30,41,74
SK Sturm Gra,9715,2,20,4,12,66,37,29,64
Vienna,9715,3,19,6,11,59,51,8,63
SC Rheindorf,9715,4,18,8,10,54,43,11,62
Rapid Vienna,9715,5,15,9,12,62,44,18,54
RZ Pellets W,9715,6,13,7,16,46,52,-6,46
Mattersburg,9715,7,9,12,15,41,49,-8,39
SV Josko Rie,9715,8,10,6,20,35,64,-29,36
St. Pölten,9715,9,8,9,19,48,72,-24,33
Admira Wacke,9715,10,7,9,20,34,74,-40,30
FC Salzburg,9716,1,20,8,8,63,32,31,68
SC Rheindorf,9716,2,19,8,9,55,39,16,65
Vienna,9716,3,18,6,12,52,41,11,60
SK Sturm Gra,9716,4,17,6,13,52,33,19,57
Rapid Vienna,9716,5,14,10,12,55,41,14,52
RZ Pellets W,9716,6,12,9,15,44,53,-9,45
SV Josko Rie,9716,7,12,5,19,34,53,-19,41
Mattersburg,9716,8,9,13,14,38,49,-11,40
Admira Wacke,9716,9,9,9,18,36,60,-24,36
St. Pölten,9716,10,8,10,18,35,63,-28,34
SK Sturm Gra,9717,1,23,4,9,62,30,32,73
FC Salzburg,9717,2,21,8,7,68,31,37,71
SC Rheindorf,9717,3,20,8,8,59,41,18,68
Vienna,9717,4,20,5,11,60,52,8,65
Rapid Vienna,9717,5,15,11,10,63,44,19,56
RZ Pellets W,9717,6,12,8,16,41,49,-8,44
Admira Wacke,9717,7,10,4,22,34,61,-27,34
SV Josko Rie,9717,8,9,6,21,26,52,-26,33
Mattersburg,9717,9,7,9,20,37,56,-19,30
St. Pölten,9717,10,6,11,19,31,65,-34,29
FC Salzburg,9718,1,22,8,6,63,28,35,74
SC Rheindorf,9718,2,18,8,10,55,40,15,62
Vienna,9718,3,17,6,13,63,56,7,57
SK Sturm Gra,9718,4,16,8,12,56,41,15,56
Rapid Vienna,9718,5,15,9,12,54,42,12,54
RZ Pellets W,9718,6,12,8,16,49,58,-9,44
St. Pölten,9718,7,12,8,16,44,59,-15,44
Admira Wacke,9718,8,11,9,16,42,61,-19,42
Mattersburg,9718,9,9,10,17,35,51,-16,37
SV Josko Rie,9718,10,8,6,22,31,56,-25,30
SC Rheindorf,9719,1,22,6,8,59,43,16,72
FC Salzburg,9719,2,20,9,7,64,28,36,69
SK Sturm Gra,9719,3,20,5,11,61,34,27,65
Vienna,9719,4,19,7,10,65,51,14,64
RZ Pellets W,9719,5,14,7,15,46,56,-10,49
Rapid Vienna,9719,6,11,10,15,50,46,4,43
SV Josko Rie,9719,7,10,8,18,33,49,-16,38
Admira Wacke,9719,8,11,5,20,39,58,-19,38
St. Pölten,9719,9,6,16,14,40,60,-20,34
Mattersburg,9719,10,6,9,21,34,66,-32,27
FC Salzburg,9720,1,20,9,7,64,28,36,69
SK Sturm Gra,9720,2,21,6,9,61,33,28,69
Vienna,9720,3,21,6,9,65,48,17,69
SC Rheindorf,9720,4,16,8,12,47,45,2,56
Rapid Vienna,9720,5,12,11,13,56,52,4,47
RZ Pellets W,9720,6,12,8,16,50,54,-4,44
SV Josko Rie,9720,7,11,9,16,38,53,-15,42
Mattersburg,9720,8,7,13,16,37,56,-19,34
Admira Wacke,9720,9,8,9,19,33,60,-27,33
St. Pölten,9720,10,7,11,18,45,67,-22,32
FC Salzburg,9721,1,23,7,6,74,27,47,76
SC Rheindorf,9721,2,19,6,11,55,44,11,63
Vienna,9721,3,19,4,13,60,48,12,61
SK Sturm Gra,9721,4,18,5,13,56,35,21,59
Rapid Vienna,9721,5,15,10,11,60,44,16,55
Admira Wacke,9721,6,13,5,18,34,60,-26,44
RZ Pellets W,9721,7,12,6,18,41,60,-19,42
St. Pölten,9721,8,9,12,15,43,58,-15,39
SV Josko Rie,9721,9,12,3,21,33,53,-20,39
Mattersburg,9721,10,7,8,21,36,63,-27,29
FC Salzburg,9722,1,19,7,10,60,31,29,64
SK Sturm Gra,9722,2,19,6,11,61,35,26,63
SC Rheindorf,9722,3,18,9,9,50,38,12,63
Vienna,9722,4,18,4,14,59,50,9,58
Rapid Vienna,9722,5,16,9,11,58,35,23,57
SV Josko Rie,9722,6,15,5,16,41,50,-9,50
RZ Pellets W,9722,7,13,7,16,41,56,-15,46
Admira Wacke,9722,8,11,7,18,34,59,-25,40
Mattersburg,9722,9,6,12,18,32,54,-22,30
St. Pölten,9722,10,5,14,17,38,66,-28,29
SC Rheindorf,9723,1,19,12,5,55,37,18,69
FC Salzburg,9723,2,18,10,8,59,33,26,64
Vienna,9723,3,19,6,11,64,48,16,63
SK Sturm Gra,9723,4,19,5,12,61,42,19,62
Rapid Vienna,9723,5,14,8,14,63,48,15,50
Admira Wacke,9723,6,13,6,17,39,56,-17,45
RZ Pellets W,9723,7,12,7,17,49,66,-17,43
St. Pölten,9723,8,9,9,18,45,70,-25,36
Mattersburg,9723,9,8,10,18,40,55,-15,34
SV Josko Rie,9723,10,9,7,20,34,54,-20,34
SK Sturm Gra,9724,1,22,5,9,65,36,29,71
FC Salzburg,9724,2,21,6,9,64,33,31,69
SC Rheindorf,9724,3,20,8,8,59,41,18,68
Rapid Vienna,9724,4,17,8,11,60,36,24,59
Vienna,9724,5,18,4,14,61,52,9,58
Admira Wacke,9724,6,11,7,18,32,57,-25,40
RZ Pellets W,9724,7,11,6,19,47,66,-19,39
Mattersburg,9724,8,10,7,19,41,53,-12,37
SV Josko Rie,9724,9,9,7,20,28,59,-31,34
St. Pölten,9724,10,8,8,20,44,68,-24,32
FC Salzburg,9725,1,23,8,5,69,29,40,77
SK Sturm Gra,9725,2,22,5,9,71,37,34,71
SC Rheindorf,9725,3,20,7,9,59,44,15,67
Vienna,9725,4,17,8,11,67,55,12,59
Rapid Vienna,9725,5,13,13,10,56,38,18,52
Admira Wacke,9725,6,12,7,17,41,62,-21,43
Mattersburg,9725,7,9,9,18,37,58,-21,36
SV Josko Rie,9725,8,9,8,19,36,56,-20,35
St. Pölten,9725,9,8,7,21,41,73,-32,31
RZ Pellets W,9725,10,8,6,22,42,67,-25,30
FC Salzburg,9726,1,25,4,7,68,25,43,79
SK Sturm Gra,9726,2,21,5,10,60,32,28,68
SC Rheindorf,9726,3,19,7,10,53,41,12,64
Vienna,9726,4,16,6,14,56,54,2,54
Rapid Vienna,9726,5,13,10,13,51,41,10,49
Admira Wacke,9726,6,12,5,19,36,57,-21,41
St. Pölten,9726,7,10,9,17,38,56,-18,39
Mattersburg,9726,8,9,11,16,39,57,-18,38
RZ Pellets W,9726,9,10,8,18,38,57,-19,38
SV Josko Rie,9726,10,11,3,22,30,49,-19,36
FC Salzburg,9727,1,23,5,8,68,33,35,74
SK Sturm Gra,9727,2,20,7,9,64,30,34,67
SC Rheindorf,9727,3,19,7,10,56,47,9,64
Vienna,9727,4,17,4,15,58,55,3,55
Rapid Vienna,9727,5,14,10,12,50,38,12,52
RZ Pellets W,9727,6,14,6,16,52,55,-3,48
Admira Wacke,9727,7,12,4,20,43,70,-27,40
Mattersburg,9727,8,8,11,17,33,51,-18,35
St. Pölten,9727,9,8,11,17,40,60,-20,35
SV Josko Rie,9727,10,10,5,21,35,60,-25,35
SK Sturm Gra,9728,1,20,6,10,65,30,35,66
SC Rheindorf,9728,2,19,8,9,56,45,11,65
FC Salzburg,9728,3,19,7,10,63,34,29,64
Vienna,9728,4,18,5,13,57,52,5,59
Rapid Vienna,9728,5,14,10,12,53,38,15,52
RZ Pellets W,9728,6,13,9,14,47,52,-5,48
SV Josko Rie,9728,7,11,6,19,34,49,-15,39
Admira Wacke,9728,8,11,6,19,38,66,-28,39
Mattersburg,9728,9,9,8,19,34,57,-23,35
St. Pölten,9728,10,7,13,16,38,62,-24,34
FC Salzburg,9729,1,19,11,6,62,33,29,68
Vienna,9729,2,20,5,11,74,53,21,65
SK Sturm Gra,9729,3,19,6,11,60,41,19,63
SC Rheindorf,9729,4,18,9,9,58,46,12,63
Rapid Vienna,9729,5,15,12,9,55,36,19,57
RZ Pellets W,9729,6,12,8,16,45,50,-5,44
Mattersburg,9729,7,9,13,14,44,54,-10,40
Admira Wacke,9729,8,9,7,20,29,57,-28,34
SV Josko Rie,9729,9,9,6,21,33,61,-28,33
St. Pölten,9729,10,8,7,21,39,68,-29,31
FC Salzburg,9730,1,19,10,7,61,31,30,67
SK Sturm Gra,9730,2,18,8,10,62,36,26,62
SC Rheindorf,9730,3,17,9,10,58,48,10,60
Vienna,9730,4,15,7,14,63,64,-1,52
Rapid Vienna,9730,5,13,12,11,51,37,14,51
RZ Pellets W,9730,6,14,8,14,46,54,-8,50
Admira Wacke,9730,7,14,6,16,42,53,-11,48
SV Josko Rie,9730,8,11,7,18,36,49,-13,40
St. Pölten,9730,9,9,10,17,41,60,-19,37
Mattersburg,9730,10,8,7,21,38,66,-28,31
SK Sturm Gra,9731,1,21,6,9,64,27,37,69
SC Rheindorf,9731,2,21,6,9,55,38,17,69
Vienna,9731,3,20,6,10,65,48,17,66
FC Salzburg,9731,4,19,7,10,60,38,22,64
Rapid Vienna,9731,5,17,10,9,63,38,25,61
RZ Pellets W,9731,6,11,6,19,43,60,-17,39
SV Josko Rie,9731,7,11,4,21,35,53,-18,37
Admira Wacke,9731,8,11,4,21,35,69,-34,37
Mattersburg,9731,9,10,5,21,39,60,-21,35
St. Pölten,9731,10,8,8,20,43,71,-28,32
FC Salzburg,9732,1,22,7,7,65,31,34,73
SC Rheindorf,9732,2,22,6,8,55,38,17,72
SK Sturm Gra,9732,3,21,7,8,61,30,31,70
Vienna,9732,4,19,4,13,62,45,17,61
SV Josko Rie,9732,5,12,6,18,34,49,-15,42
Rapid Vienna,9732,6,10,10,16,56,50,6,40
Admira Wacke,9732,7,12,4,20,36,62,-26,40
RZ Pellets W,9732,8,11,6,19,40,56,-16,39
St. Pölten,9732,9,9,9,18,39,64,-25,36
Mattersburg,9732,10,8,9,19,37,60,-23,33
SK Sturm Gra,9733,1,22,5,9,64,32,32,71
Vienna,9733,2,22,3,11,73,48,25,69
FC Salzburg,9733,3,19,8,9,71,38,33,65
SC Rheindorf,9733,4,16,10,10,51,47,4,58
RZ Pellets W,9733,5,13,9,14,44,51,-7,48
Rapid Vienna,9733,6,12,10,14,52,45,7,46
Admira Wacke,9733,7,12,7,17,38,58,-20,43
SV Josko Rie,9733,8,9,9,18,35,55,-20,36
Mattersburg,9733,9,6,13,17,28,48,-20,31
St. Pölten,9733,10,6,12,18,36,70,-34,30
FC Salzburg,9734,1,23,6,7,73,34,39,75
SC Rheindorf,9734,2,21,7,8,56,40,16,70
SK Sturm Gra,9734,3,19,5,12,57,34,23,62
Vienna,9734,4,18,6,12,63,49,14,60
Rapid Vienna,9734,5,14,14,8,57,39,18,56
Mattersburg,9734,6,9,10,17,36,53,-17,37
St. Pölten,9734,7,8,13,15,39,61,-22,37
RZ Pellets W,9734,8,10,6,20,43,61,-18,36
Admira Wacke,9734,9,9,7,20,33,62,-29,34
SV Josko Rie,9734,10,7,10,19,31,55,-24,31
SK Sturm Gra,9735,1,20,9,7,63,31,32,69
FC Salzburg,9735,2,19,6,11,62,36,26,63
Vienna,9735,3,17,9,10,62,50,12,60
Rapid Vienna,9735,4,16,9,11,58,38,20,57
SC Rheindorf,9735,5,15,9,12,42,42,0,54
SV Josko Rie,9735,6,12,7,17,36,47,-11,43
Admira Wacke,9735,7,12,6,18,35,54,-19,42
RZ Pellets W,9735,8,10,9,17,42,57,-15,39
St. Pölten,9735,9,10,8,18,38,60,-22,38
Mattersburg,9735,10,6,14,16,38,61,-23,32
FC Salzburg,9736,1,21,8,7,73,36,37,71
SK Sturm Gra,9736,2,20,4,12,64,34,30,64
Vienna,9736,3,19,4,13,63,56,7,61
SC Rheindorf,9736,4,17,9,10,50,45,5,60
Rapid Vienna,9736,5,14,11,11,56,38,18,53
RZ Pellets W,9736,6,11,11,14,48,56,-8,44
Admira Wacke,9736,7,12,6,18,37,57,-20,42
SV Josko Rie,9736,8,12,3,21,39,64,-25,39
Mattersburg,9736,9,9,11,16,35,49,-14,38
St. Pölten,9736,10,7,9,20,38,68,-30,30
SK Sturm Gra,9737,1,20,5,11,57,36,21,65
Vienna,9737,2,19,7,10,70,47,23,64
FC Salzburg,9737,3,16,13,7,63,37,26,61
SC Rheindorf,9737,4,17,9,10,54,48,6,60
Rapid Vienna,9737,5,14,12,10,59,39,20,54
RZ Pellets W,9737,6,12,9,15,46,56,-10,45
St. Pölten,9737,7,10,10,16,35,56,-21,40
SV Josko Rie,9737,8,10,5,21,34,55,-21,35
Admira Wacke,9737,9,8,11,17,35,59,-24,35
Mattersburg,9737,10,7,13,16,37,57,-20,34
FC Salzburg,9738,1,22,9,5,64,26,38,75
SC Rheindorf,9738,2,22,5,9,52,37,15,71
SK Sturm Gra,9738,3,22,4,10,59,28,31,70
Vienna,9738,4,18,6,12,58,50,8,60
Rapid Vienna,9738,5,15,9,12,56,37,19,54
RZ Pellets W,9738,6,12,7,17,44,57,-13,43
Admira Wacke,9738,7,12,6,18,37,60,-23,42
SV Josko Rie,9738,8,12,5,19,38,54,-16,41
Mattersburg,9738,9,6,8,22,37,65,-28,26
St. Pölten,9738,10,5,9,22,31,62,-31,24
FC Salzburg,9739,1,21,9,6,66,32,34,72
SC Rheindorf,9739,2,21,4,11,52,37,15,67
SK Sturm Gra,9739,3,20,5,11,54,34,20,65
Vienna,9739,4,17,7,12,64,57,7,58
Rapid Vienna,9739,5,10,16,10,56,45,11,46
Mattersburg,9739,6,11,10,15,43,49,-6,43
RZ Pellets W,9739,7,10,10,16,43,59,-16,40
Admira Wacke,9739,8,10,9,17,35,51,-16,39
St. Pölten,9739,9,9,10,17,40,63,-23,37
SV Josko Rie,9739,10,8,6,22,34,60,-26,30
FC Salzburg,9740,1,21,7,8,55,25,30,70
Vienna,9740,2,19,6,11,60,51,9,63
SK Sturm Gra,9740,3,18,7,11,53,33,20,61
SC Rheindorf,9740,4,18,7,11,59,43,16,61
Rapid Vienna,9740,5,16,9,11,55,35,20,57
Admira Wacke,9740,6,12,8,16,38,57,-19,44
RZ Pellets W,9740,7,12,5,19,42,55,-13,41
SV Josko Rie,9740,8,10,8,18,33,53,-20,38
St. Pölten,9740,9,7,12,17,39,63,-24,33
Mattersburg,9740,10,7,11,18,31,50,-19,32
FC Salzburg,9741,1,19,8,9,65,40,25,65
Vienna,9741,2,19,4,13,70,56,14,61
Rapid Vienna,9741,3,16,12,8,61,33,28,60
SK Sturm Gra,9741,4,18,6,12,58,39,19,60
SC Rheindorf,9741,5,17,7,12,53,49,4,58
SV Josko Rie,9741,6,15,6,15,42,47,-5,51
RZ Pellets W,9741,7,13,6,17,49,58,-9,45
Admira Wacke,9741,8,10,9,17,38,58,-20,39
Mattersburg,9741,9,10,7,19,38,53,-15,37
St. Pölten,9741,10,7,7,22,37,78,-41,28
Vienna,9742,1,21,5,10,58,44,14,68
SK Sturm Gra,9742,2,20,7,9,58,36,22,67
FC Salzburg,9742,3,18,8,10,61,39,22,62
SC Rheindorf,9742,4,18,6,12,55,47,8,60
Rapid Vienna,9742,5,15,13,8,61,34,27,58
Admira Wacke,9742,6,13,4,19,36,57,-21,43
RZ Pellets W,9742,7,11,7,18,46,62,-16,40
SV Josko Rie,9742,8,11,3,22,35,49,-14,36
St. Pölten,9742,9,8,11,17,41,66,-25,35
Mattersburg,9742,10,8,10,18,39,56,-17,34
FC Salzburg,9743,1,22,7,7,71,35,36,73
SC Rheindorf,9743,2,21,5,10,63,49,14,68
SK Sturm Gra,9743,3,19,5,12,59,41,18,62
Vienna,9743,4,17,6,13,61,52,9,57
Rapid Vienna,9743,5,15,10,11,69,42,27,55
RZ Pellets W,9743,6,14,10,12,50,50,0,52
Admira Wacke,9743,7,11,8,17,36,58,-22,41
St. Pölten,9743,8,9,8,19,45,70,-25,35
SV Josko Rie,9743,9,9,5,22,27,63,-36,32
Mattersburg,9743,10,7,8,21,37,58,-21,29
SK Sturm Gra,9744,1,21,6,9,63,34,29,69
SC Rheindorf,9744,2,20,9,7,57,40,17,69
FC Salzburg,9744,3,19,9,8,70,36,34,66
Vienna,9744,4,16,7,13,62,62,0,55
Rapid Vienna,9744,5,13,10,13,50,43,7,49
RZ Pellets W,9744,6,11,8,17,42,54,-12,41
Admira Wacke,9744,7,11,8,17,34,51,-17,41
St. Pölten,9744,8,9,10,17,45,63,-18,37
Mattersburg,9744,9,9,9,18,34,53,-19,36
SV Josko Rie,9744,10,10,6,20,36,57,-21,36
FC Salzburg,9745,1,21,7,8,63,33,30,70
SC Rheindorf,9745,2,21,6,9,59,44,15,69
SK Sturm Gra,9745,3,17,8,11,59,36,23,59
Vienna,9745,4,17,6,13,62,51,11,57
Rapid Vienna,9745,5,12,14,10,55,40,15,50
Admira Wacke,9745,6,13,7,16,34,59,-25,46
SV Josko Rie,9745,7,12,7,17,38,52,-14,43
RZ Pellets W,9745,8,10,7,19,41,57,-16,37
St. Pölten,9745,9,9,9,18,44,61,-17,36
Mattersburg,9745,10,9,7,20,37,59,-22,34
SC Rheindorf,9746,1,21,9,6,54,34,20,72
Vienna,9746,2,19,6,11,64,54,10,63
FC Salzburg,9746,3,17,11,8,62,36,26,62
SK Sturm Gra,9746,4,15,10,11,54,33,21,55
Rapid Vienna,9746,5,14,11,11,55,37,18,53
SV Josko Rie,9746,6,12,5,19,37,52,-15,41
Admira Wacke,9746,7,11,7,18,41,60,-19,40
Mattersburg,9746,8,10,9,17,31,49,-18,39
St. Pölten,9746,9,9,11,16,40,58,-18,38
RZ Pellets W,9746,10,10,5,21,41,66,-25,35
FC Salzburg,9747,1,26,5,5,68,23,45,83
SK Sturm Gra,9747,2,20,5,11,69,36,33,65
SC Rheindorf,9747,3,20,5,11,57,46,11,65
Vienna,9747,4,18,4,14,61,53,8,58
Rapid Vienna,9747,5,13,10,13,62,47,15,49
Admira Wacke,9747,6,13,4,19,39,59,-20,43
RZ Pellets W,9747,7,12,6,18,42,67,-25,42
SV Josko Rie,9747,8,12,4,20,32,46,-14,40
Mattersburg,9747,9,9,7,20,36,62,-26,34
St. Pölten,9747,10,8,8,20,40,67,-27,32
FC Salzburg,9748,1,25,6,5,73,26,47,81
SC Rheindorf,9748,2,19,8,9,62,44,18,65
Rapid Vienna,9748,3,18,9,9,59,35,24,63
SK Sturm Gra,9748,4,18,7,11,65,43,22,61
Vienna,9748,5,15,7,14,58,62,-4,52
RZ Pellets W,9748,6,13,5,18,52,55,-3,44
Admira Wacke,9748,7,11,7,18,41,63,-22,40
SV Josko Rie,9748,8,11,6,19,41,60,-19,39
St. Pölten,9748,9,8,8,20,44,80,-36,32
Mattersburg,9748,10,7,7,22,28,55,-27,28
FC Salzburg,9749,1,19,8,9,65,39,26,65
SK Sturm Gra,9749,2,19,6,11,59,36,23,63
Vienna,9749,3,20,3,13,72,60,12,63
SC Rheindorf,9749,4,19,4,13,54,42,12,61
Rapid Vienna,9749,5,13,12,11,56,43,13,51
RZ Pellets W,9749,6,14,7,15,47,52,-5,49
Admira Wacke,9749,7,14,4,18,36,57,-21,46
Mattersburg,9749,8,9,11,16,43,57,-14,38
St. Pölten,9749,9,9,9,18,42,64,-22,36
SV Josko Rie,9749,10,9,6,21,34,58,-24,33
FC Salzburg,9750,1,20,7,9,66,31,35,67
SC Rheindorf,9750,2,20,7,9,60,46,14,67
Vienna,9750,3,20,6,10,67,51,16,66
SK Sturm Gra,9750,4,18,5,13,56,34,22,59
Rapid Vienna,9750,5,16,9,11,60,46,14,57
RZ Pellets W,9750,6,12,6,18,46,58,-12,42
St. Pölten,9750,7,11,8,17,49,63,-14,41
SV Josko Rie,9750,8,10,7,19,37,57,-20,37
Admira Wacke,9750,9,11,4,21,37,67,-30,37
Mattersburg,9750,10,9,7,20,37,62,-25,34
FC Salzburg,9751,1,21,10,5,64,23,41,73
SK Sturm Gra,9751,2,21,5,10,62,33,29,68
Vienna,9751,3,18,6,12,71,57,14,60
SC Rheindorf,9751,4,18,5,13,58,54,4,59
Rapid Vienna,9751,5,14,11,11,53,42,11,53
RZ Pellets W,9751,6,14,6,16,54,60,-6,48
SV Josko Rie,9751,7,13,5,18,31,44,-13,44
Admira Wacke,9751,8,11,7,18,42,60,-18,40
Mattersburg,9751,9,9,7,20,39,60,-21,34
St. Pölten,9751,10,5,10,21,38,79,-41,25
FC Salzburg,9752,1,20,12,4,63,25,38,72
SC Rheindorf,9752,2,20,8,8,55,39,16,68
SK Sturm Gra,9752,3,15,10,11,52,38,14,55
Vienna,9752,4,16,7,13,62,52,10,55
Admira Wacke,9752,5,15,9,12,45,53,-8,54
Rapid Vienna,9752,6,12,15,9,50,36,14,51
RZ Pellets W,9752,7,10,10,16,45,58,-13,40
SV Josko Rie,9752,8,10,6,20,29,51,-22,36
St. Pölten,9752,9,7,10,19,40,64,-24,31
Mattersburg,9752,10,8,7,21,36,61,-25,31
FC Salzburg,9753,1,19,10,7,67,32,35,67
SC Rheindorf,9753,2,20,7,9,54,42,12,67
SK Sturm Gra,9753,3,20,4,12,57,33,24,64
Vienna,9753,4,19,3,14,65,55,10,60
Rapid Vienna,9753,5,16,10,10,61,39,22,58
RZ Pellets W,9753,6,12,8,16,50,58,-8,44
Admira Wacke,9753,7,11,9,16,35,57,-22,42
Mattersburg,9753,8,9,11,16,44,56,-12,38
SV Josko Rie,9753,9,9,7,20,32,58,-26,34
St. Pölten,9753,10,6,9,21,36,71,-35,27
SC Rheindorf,9754,1,21,7,8,56,37,19,70
FC Salzburg,9754,2,21,5,10,64,34,30,68
SK Sturm Gra,9754,3,20,4,12,64,40,24,64
Rapid Vienna,9754,4,17,7,12,59,42,17,58
Vienna,9754,5,18,4,14,63,51,12,58
RZ Pellets W,9754,6,12,7,17,42,51,-9,43
Admira Wacke,9754,7,10,8,18,38,60,-22,38
Mattersburg,9754,8,10,8,18,36,59,-23,38
St. Pölten,9754,9,9,10,17,42,60,-18,37
SV Josko Rie,9754,10,10,4,22,37,67,-30,34
FC Salzburg,9755,1,26,5,5,79,23,56,83
SC Rheindorf,9755,2,23,5,8,62,37,25,74
SK Sturm Gra,9755,3,22,4,10,61,32,29,70
Vienna,9755,4,19,5,12,69,55,14,62
Rapid Vienna,9755,5,13,9,14,53,44,9,48
Admira Wacke,9755,6,11,9,16,38,58,-20,42
Mattersburg,9755,7,8,10,18,36,56,-20,34
SV Josko Rie,9755,8,9,6,21,34,65,-31,33
St. Pölten,9755,9,8,8,20,39,63,-24,32
RZ Pellets W,9755,10,8,5,23,38,76,-38,29
FC Salzburg,9756,1,20,10,6,65,31,34,70
SK Sturm Gra,9756,2,18,6,12,53,34,19,60
SC Rheindorf,9756,3,17,9,10,47,38,9,60
Vienna,9756,4,18,5,13,58,49,9,59
Rapid Vienna,9756,5,16,10,10,51,36,15,58
RZ Pellets W,9756,6,11,10,15,44,53,-9,43
Admira Wacke,9756,7,11,7,18,35,60,-25,40
St. Pölten,9756,8,9,12,15,44,58,-14,39
SV Josko Rie,9756,9,10,7,19,35,50,-15,37
Mattersburg,9756,10,7,10,19,31,54,-23,31
SK Sturm Gra,9757,1,26,3,7,71,28,43,81
FC Salzburg,9757,2,24,4,8,73,29,44,76
SC Rheindorf,9757,3,22,6,8,67,44,23,72
Vienna,9757,4,18,5,13,61,54,7,59
Rapid Vienna,9757,5,13,12,11,55,44,11,51
RZ Pellets W,9757,6,11,8,17,47,61,-14,41
Admira Wacke,9757,7,11,5,20,39,67,-28,38
St. Pölten,9757,8,9,8,19,43,69,-26,35
SV Josko Rie,9757,9,10,3,23,35,60,-25,33
Mattersburg,9757,10,5,8,23,37,72,-35,23
SK Sturm Gra,9758,1,21,5,10,62,39,23,68
FC Salzburg,9758,2,18,10,8,65,39,26,64
SC Rheindorf,9758,3,19,7,10,55,42,13,64
Vienna,9758,4,17,8,11,62,52,10,59
Rapid Vienna,9758,5,14,11,11,60,42,18,53
SV Josko Rie,9758,6,14,5,17,38,55,-17,47
RZ Pellets W,9758,7,13,7,16,58,59,-1,46
Admira Wacke,9758,8,10,6,20,38,63,-25,36
St. Pölten,9758,9,8,10,18,41,65,-24,34
Mattersburg,9758,10,8,7,21,36,59,-23,31
SK Sturm Gra,9759,1,22,6,8,62,31,31,72
FC Salzburg,9759,2,21,8,7,65,31,34,71
Vienna,9759,3,21,4,11,66,49,17,67
SC Rheindorf,9759,4,17,9,10,48,43,5,60
Rapid Vienna,9759,5,13,10,13,55,40,15,49
SV Josko Rie,9759,6,13,4,19,37,50,-13,43
Admira Wacke,9759,7,12,6,18,40,56,-16,42
RZ Pellets W,9759,8,10,8,18,40,52,-12,38
St. Pölten,9759,9,9,9,18,39,61,-22,36
Mattersburg,9759,10,7,6,23,27,66,-39,27
FC Salzburg,9760,1,21,8,7,69,32,37,71
SC Rheindorf,9760,2,21,6,9,59,42,17,69
SK Sturm Gra,9760,3,19,6,11,57,35,22,63
Vienna,9760,4,19,5,12,59,52,7,62
Rapid Vienna,9760,5,18,7,11,62,42,20,61
Mattersburg,9760,6,11,10,15,37,46,-9,43
RZ Pellets W,9760,7,11,7,18,40,55,-15,40
Admira Wacke,9760,8,11,7,18,37,57,-20,40
SV Josko Rie,9760,9,7,7,22,34,62,-28,28
St. Pölten,9760,10,5,11,20,39,70,-31,26
FC Salzburg,9761,1,19,10,7,61,30,31,67
SC Rheindorf,9761,2,18,11,7,50,39,11,65
SK Sturm Gra,9761,3,18,7,11,60,33,27,61
Vienna,9761,4,17,6,13,60,52,8,57
Rapid Vienna,9761,5,14,13,9,62,46,16,55
RZ Pellets W,9761,6,12,8,16,45,59,-14,44
SV Josko Rie,9761,7,11,7,18,36,50,-14,40
Admira Wacke,9761,8,10,9,17,32,54,-22,39
St. Pölten,9761,9,8,11,17,40,59,-19,35
Mattersburg,9761,10,8,8,20,36,60,-24,32
SK Sturm Gra,9762,1,20,8,8,60,29,31,68
SC Rheindorf,9762,2,19,8,9,56,40,16,65
FC Salzburg,9762,3,18,10,8,61,32,29,64
Rapid Vienna,9762,4,16,11,9,58,35,23,59
Vienna,9762,5,17,5,14,59,52,7,56
RZ Pellets W,9762,6,14,7,15,46,54,-8,49
Admira Wacke,9762,7,9,10,17,34,58,-24,37
SV Josko Rie,9762,8,10,5,21,31,62,-31,35
St. Pölten,9762,9,9,7,20,37,65,-28,34
Mattersburg,9762,10,8,9,19,44,59,-15,33
SC Rheindorf,9763,1,21,8,7,55,37,18,71
FC Salzburg,9763,2,20,10,6,68,33,35,70
Vienna,9763,3,22,2,12,66,51,15,68
SK Sturm Gra,9763,4,15,8,13,56,40,16,53
Rapid Vienna,9763,5,12,13,11,52,43,9,49
RZ Pellets W,9763,6,14,6,16,47,52,-5,48
Admira Wacke,9763,7,13,7,16,45,57,-12,46
SV Josko Rie,9763,8,10,6,20,33,54,-21,36
St. Pölten,9763,9,8,11,17,38,60,-22,35
Mattersburg,9763,10,5,9,22,30,63,-33,24
SK Sturm Gra,9764,1,23,5,8,58,31,27,74
FC Salzburg,9764,2,19,8,9,63,34,29,65
Vienna,9764,3,19,5,12,66,54,12,62
SC Rheindorf,9764,4,19,5,12,54,44,10,62
Rapid Vienna,9764,5,14,9,13,60,45,15,51
RZ Pellets W,9764,6,12,8,16,47,60,-13,44
Admira Wacke,9764,7,12,6,18,36,56,-20,42
St. Pölten,9764,8,10,10,16,41,55,-14,40
SV Josko Rie,9764,9,11,6,19,39,56,-17,39
Mattersburg,9764,10,6,8,22,28,57,-29,26
FC Salzburg,9765,1,21,7,8,71,37,34,70
Vienna,9765,2,20,5,11,74,55,19,65
Rapid Vienna,9765,3,17,11,8,66,38,28,62
SC Rheindorf,9765,4,19,5,12,55,47,8,62
SK Sturm Gra,9765,5,18,7,11,53,39,14,61
Admira Wacke,9765,6,13,7,16,38,51,-13,46
SV Josko Rie,9765,7,11,7,18,36,50,-14,40
Mattersburg,9765,8,9,8,19,34,55,-21,35
RZ Pellets W,9765,9,10,5,21,38,63,-25,35
St. Pölten,9765,10,7,8,21,37,67,-30,29
FC Salzburg,9766,1,21,7,8,64,34,30,70
Vienna,9766,2,19,5,12,65,52,13,62
SC Rheindorf,9766,3,18,8,10,58,50,8,62
SK Sturm Gra,9766,4,18,5,13,60,39,21,59
Rapid Vienna,9766,5,15,10,11,50,36,14,55
RZ Pellets W,9766,6,12,11,13,43,47,-4,47
SV Josko Rie,9766,7,11,8,17,35,53,-18,41
St. Pölten,9766,8,8,11,17,44,63,-19,35
Admira Wacke,9766,9,9,7,20,37,61,-24,34
Mattersburg,9766,10,7,12,17,38,59,-21,33
FC Salzburg,9767,1,22,6,8,60,29,31,72
SK Sturm Gra,9767,2,22,3,11,63,35,28,69
SC Rheindorf,9767,3,20,5,11,52,40,12,65
Vienna,9767,4,17,5,14,60,52,8,56
Rapid Vienna,9767,5,13,11,12,55,45,10,50
St. Pölten,9767,6,11,9,16,41,54,-13,42
SV Josko Rie,9767,7,11,7,18,38,49,-11,40
RZ Pellets W,9767,8,11,7,18,41,61,-20,40
Admira Wacke,9767,9,10,8,18,36,59,-23,38
Mattersburg,9767,10,9,7,20,36,58,-22,34
Vienna,9768,1,21,6,9,68,49,19,69
FC Salzburg,9768,2,20,8,8,67,37,30,68
SC Rheindorf,9768,3,18,11,7,56,42,14,65
SK Sturm Gra,9768,4,18,10,8,59,36,23,64
RZ Pellets W,9768,5,13,9,14,51,52,-1,48
Rapid Vienna,9768,6,12,9,15,49,47,2,45
Mattersburg,9768,7,9,10,17,39,54,-15,37
SV Josko Rie,9768,8,10,7,19,34,54,-20,37
St. Pölten,9768,9,8,10,18,40,61,-21,34
Admira Wacke,9768,10,8,6,22,34,65,-31,30
SK Sturm Gra,9769,1,20,6,10,61,33,28,66
FC Salzburg,9769,2,19,8,9,63,32,31,65
SC Rheindorf,9769,3,19,7,10,58,48,10,64
Vienna,9769,4,19,4,13,55,49,6,61
Rapid Vienna,9769,5,15,10,11,57,40,17,55
RZ Pellets W,9769,6,11,9,16,41,53,-12,42
SV Josko Rie,9769,7,13,3,20,40,52,-12,42
Mattersburg,9769,8,10,8,18,44,59,-15,38
St. Pölten,9769,9,10,7,19,41,67,-26,37
Admira Wacke,9769,10,10,6,20,32,59,-27,36
Vienna,9770,1,22,3,11,66,45,21,69
FC Salzburg,9770,2,20,7,9,62,34,28,67
SK Sturm Gra,9770,3,20,5,11,60,32,28,65
SC Rheindorf,9770,4,18,8,10,57,50,7,62
Rapid Vienna,9770,5,16,11,9,62,40,22,59
RZ Pellets W,9770,6,13,8,15,46,54,-8,47
SV Josko Rie,9770,7,11,6,19,35,50,-15,39
St. Pölten,9770,8,9,8,19,42,64,-22,35
Mattersburg,9770,9,8,7,21,34,60,-26,31
Admira Wacke,9770,10,8,7,21,29,64,-35,31
SC Rheindorf,9771,1,20,9,7,58,44,14,69
SK Sturm Gra,9771,2,20,5,11,66,35,31,65
FC Salzburg,9771,3,18,8,10,68,41,27,62
Vienna,9771,4,16,8,12,61,54,7,56
Rapid Vienna,9771,5,12,13,11,55,39,16,49
Admira Wacke,9771,6,13,5,18,41,65,-24,44
SV Josko Rie,9771,7,12,7,17,41,50,-9,43
RZ Pellets W,9771,8,11,9,16,47,58,-11,42
St. Pölten,9771,9,10,10,16,45,63,-18,40
Mattersburg,9771,10,7,8,21,36,69,-33,29
FC Salzburg,9772,1,21,7,8,65,34,31,70
Vienna,9772,2,21,4,11,69,51,18,67
SK Sturm Gra,9772,3,19,6,11,66,34,32,63
SC Rheindorf,9772,4,18,8,10,61,51,10,62
Rapid Vienna,9772,5,12,13,11,57,43,14,49
Admira Wacke,9772,6,13,5,18,41,69,-28,44
RZ Pellets W,9772,7,12,7,17,45,57,-12,43
Mattersburg,9772,8,10,9,17,43,55,-12,39
SV Josko Rie,9772,9,11,4,21,41,61,-20,37
St. Pölten,9772,10,7,9,20,41,74,-33,30
FC Salzburg,9773,1,25,6,5,69,25,44,81
SC Rheindorf,9773,2,18,8,10,52,39,13,62
Rapid Vienna,9773,3,17,10,9,56,37,19,61
SK Sturm Gra,9773,4,16,10,10,55,37,18,58
Vienna,9773,5,18,3,15,67,60,7,57
RZ Pellets W,9773,6,12,8,16,43,48,-5,44
Admira Wacke,9773,7,11,7,18,37,60,-23,40
Mattersburg,9773,8,9,9,18,39,55,-16,36
St. Pölten,9773,9,8,10,18,47,70,-23,34
SV Josko Rie,9773,10,9,3,24,32,66,-34,30
FC Salzburg,9774,1,22,7,7,73,26,47,73
SK Sturm Gra,9774,2,23,4,9,55,25,30,73
Vienna,9774,3,20,3,13,65,54,11,63
SC Rheindorf,9774,4,18,6,12,47,42,5,60
Rapid Vienna,9774,5,15,10,11,54,45,9,55
RZ Pellets W,9774,6,14,6,16,44,50,-6,48
Admira Wacke,9774,7,11,7,18,36,59,-23,40
St. Pölten,9774,8,7,10,19,43,67,-24,31
Mattersburg,9774,9,7,10,19,29,54,-25,31
SV Josko Rie,9774,10,7,9,20,29,53,-24,30
SK Sturm Gra,9775,1,21,5,10,65,30,35,68
FC Salzburg,9775,2,19,7,10,66,37,29,64
SC Rheindorf,9775,3,19,7,10,57,43,14,64
Vienna,9775,4,18,7,11,69,55,14,61
Rapid Vienna,9775,5,14,11,11,61,44,17,53
RZ Pellets W,9775,6,12,8,16,46,56,-10,44
SV Josko Rie,9775,7,12,5,19,40,57,-17,41
St. Pölten,9775,8,9,11,16,41,66,-25,38
Mattersburg,9775,9,10,7,19,35,55,-20,37
Admira Wacke,9775,10,10,4,22,30,67,-37,34
FC Salzburg,9776,1,21,6,9,70,33,37,69
Vienna,9776,2,19,7,10,62,51,11,64
SC Rheindorf,9776,3,18,9,9,55,46,9,63
SK Sturm Gra,9776,4,17,8,11,60,36,24,59
Rapid Vienna,9776,5,13,12,11,49,37,12,51
RZ Pellets W,9776,6,13,7,16,42,52,-10,46
Admira Wacke,9776,7,13,6,17,40,55,-15,45
SV Josko Rie,9776,8,9,9,18,32,52,-20,36
Mattersburg,9776,9,9,9,18,39,61,-22,36
St. Pölten,9776,10,8,7,21,36,62,-26,31
SC Rheindorf,9777,1,20,9,7,64,44,20,69
Vienna,9777,2,21,5,10,71,53,18,68
SK Sturm Gra,9777,3,20,7,9,64,38,26,67
FC Salzburg,9777,4,17,9,10,59,37,22,60
Rapid Vienna,9777,5,15,11,10,54,35,19,56
RZ Pellets W,9777,6,12,8,16,43,51,-8,44
St. Pölten,9777,7,10,8,18,42,66,-24,38
Admira Wacke,9777,8,11,5,20,36,62,-26,38
Mattersburg,9777,9,8,8,20,42,61,-19,32
SV Josko Rie,9777,10,9,4,23,35,63,-28,31
FC Salzburg,9778,1,21,8,7,64,28,36,71
SK Sturm Gra,9778,2,19,7,10,55,30,25,64
SC Rheindorf,9778,3,18,7,11,50,40,10,61
Rapid Vienna,9778,4,15,11,10,63,39,24,56
Vienna,9778,5,17,5,14,56,48,8,56
RZ Pellets W,9778,6,14,6,16,44,52,-8,48
Admira Wacke,9778,7,11,7,18,40,65,-25,40
SV Josko Rie,9778,8,12,3,21,37,57,-20,39
St. Pölten,9778,9,10,9,17,43,66,-23,39
Mattersburg,9778,10,6,11,19,34,61,-27,29
SC Rheindorf,9779,1,20,8,8,57,45,12,68
FC Salzburg,9779,2,19,10,7,68,33,35,67
Vienna,9779,3,20,7,9,63,47,16,67
SK Sturm Gra,9779,4,16,8,12,57,40,17,56
Rapid Vienna,9779,5,11,11,14,49,45,4,44
Admira Wacke,9779,6,11,9,16,37,57,-20,42
Mattersburg,9779,7,10,9,17,40,52,-12,39
St. Pölten,9779,8,9,12,15,47,61,-14,39
SV Josko Rie,9779,9,10,9,17,35,53,-18,39
RZ Pellets W,9779,10,9,7,20,37,57,-20,34
SC Rheindorf,9780,1,20,9,7,65,44,21,69
SK Sturm Gra,9780,2,20,6,10,65,41,24,66
FC Salzburg,9780,3,17,11,8,56,32,24,62
Vienna,9780,4,19,2,15,65,59,6,59
Rapid Vienna,9780,5,14,10,12,60,44,16,52
Admira Wacke,9780,6,14,5,17,40,55,-15,47
SV Josko Rie,9780,7,12,7,17,36,52,-16,43
RZ Pellets W,9780,8,11,9,16,52,58,-6,42
Mattersburg,9780,9,8,9,19,37,63,-26,33
St. Pölten,9780,10,5,12,19,33,61,-28,27
Vienna,9781,1,24,4,8,70,45,25,76
SC Rheindorf,9781,2,23,5,8,69,47,22,74
SK Sturm Gra,9781,3,18,8,10,65,35,30,62
FC Salzburg,9781,4,16,10,10,60,37,23,58
Rapid Vienna,9781,5,14,9,13,52,45,7,51
RZ Pellets W,9781,6,13,7,16,47,50,-3,46
Mattersburg,9781,7,9,9,18,41,57,-16,36
Admira Wacke,9781,8,9,8,19,28,61,-33,35
SV Josko Rie,9781,9,8,9,19,36,58,-22,33
St. Pölten,9781,10,7,9,20,37,70,-33,30
SK Sturm Gra,9782,1,20,8,8,59,33,26,68
SC Rheindorf,9782,2,20,6,10,50,37,13,66
FC Salzburg,9782,3,20,5,11,55,27,28,65
Rapid Vienna,9782,4,17,11,8,50,29,21,62
Vienna,9782,5,19,5,12,55,45,10,62
RZ Pellets W,9782,6,12,8,16,41,50,-9,44
Admira Wacke,9782,7,9,11,16,32,55,-23,38
SV Josko Rie,9782,8,11,4,21,31,52,-21,37
St. Pölten,9782,9,8,9,19,41,62,-21,33
Mattersburg,9782,10,7,7,22,32,56,-24,28
FC Salzburg,9783,1,22,7,7,61,25,36,73
SK Sturm Gra,9783,2,21,6,9,67,33,34,69
SC Rheindorf,9783,3,19,9,8,62,51,11,66
Vienna,9783,4,16,5,15,56,58,-2,53
Admira Wacke,9783,5,15,5,16,38,53,-15,50
Rapid Vienna,9783,6,12,9,15,50,44,6,45
RZ Pellets W,9783,7,11,8,17,42,54,-12,41
SV Josko Rie,9783,8,9,8,19,38,53,-15,35
St. Pölten,9783,9,8,10,18,46,72,-26,34
Mattersburg,9783,10,6,15,15,40,57,-17,33
FC Salzburg,9784,1,23,7,6,74,30,44,76
SK Sturm Gra,9784,2,20,5,11,55,34,21,65
SC Rheindorf,9784,3,19,8,9,60,46,14,65
Vienna,9784,4,18,7,11,61,46,15,61
Rapid Vienna,9784,5,14,11,11,51,38,13,53
St. Pölten,9784,6,10,10,16,42,61,-19,40
RZ Pellets W,9784,7,9,10,17,39,55,-16,37
SV Josko Rie,9784,8,9,7,20,30,55,-25,34
Admira Wacke,9784,9,9,7,20,31,60,-29,34
Mattersburg,9784,10,7,12,17,34,52,-18,33
FC Salzburg,9785,1,22,5,9,66,33,33,71
SK Sturm Gra,9785,2,20,6,10,62,34,28,66
Vienna,9785,3,20,4,12,65,49,16,64
SC Rheindorf,9785,4,17,6,13,53,52,1,57
Rapid Vienna,9785,5,14,10,12,59,47,12,52
SV Josko Rie,9785,6,12,7,17,41,52,-11,43
RZ Pellets W,9785,7,12,7,17,44,59,-15,43
Admira Wacke,9785,8,12,7,17,41,58,-17,43
Mattersburg,9785,9,10,7,19,41,58,-17,37
St. Pölten,9785,10,7,9,20,40,70,-30,30
SC Rheindorf,9786,1,21,7,8,60,38,22,70
FC Salzburg,9786,2,19,7,10,55,29,26,64
SK Sturm Gra,9786,3,16,9,11,56,38,18,57
Vienna,9786,4,17,6,13,59,54,5,57
Admira Wacke,9786,5,16,8,12,44,51,-7,56
Rapid Vienna,9786,6,13,9,14,59,44,15,48
SV Josko Rie,9786,7,12,7,17,39,53,-14,43
RZ Pellets W,9786,8,10,6,20,44,64,-20,36
Mattersburg,9786,9,8,11,17,37,53,-16,35
St. Pölten,9786,10,9,8,19,44,73,-29,35
FC Salzburg,9787,1,22,9,5,69,27,42,75
SK Sturm Gra,9787,2,20,4,12,62,36,26,64
SC Rheindorf,9787,3,19,7,10,55,46,9,64
Vienna,9787,4,20,3,13,67,58,9,63
Rapid Vienna,9787,5,16,11,9,70,40,30,59
Admira Wacke,9787,6,13,5,18,41,62,-21,44
RZ Pellets W,9787,7,11,5,20,47,71,-24,38
St. Pölten,9787,8,9,9,18,45,63,-18,36
Mattersburg,9787,9,9,6,21,38,62,-24,33
SV Josko Rie,9787,10,8,7,21,33,62,-29,31
SK Sturm Gra,9788,1,22,6,8,74,36,38,72
FC Salzburg,9788,2,21,7,8,65,31,34,70
SC Rheindorf,9788,3,17,8,11,54,45,9,59
Vienna,9788,4,16,7,13,62,59,3,55
RZ Pellets W,9788,5,13,8,15,48,54,-6,47
Admira Wacke,9788,6,14,5,17,40,53,-13,47
SV Josko Rie,9788,7,13,4,19,35,51,-16,43
Rapid Vienna,9788,8,9,14,13,51,53,-2,41
Mattersburg,9788,9,9,8,19,37,57,-20,35
St. Pölten,9788,10,7,11,18,39,66,-27,32
SK Sturm Gra,9789,1,23,4,9,59,30,29,73
FC Salzburg,9789,2,20,8,8,66,36,30,68
SC Rheindorf,9789,3,18,7,11,49,44,5,61
Vienna,9789,4,18,6,12,59,46,13,60
Rapid Vienna,9789,5,13,11,12,54,41,13,50
RZ Pellets W,9789,6,13,8,15,48,50,-2,47
SV Josko Rie,9789,7,11,5,20,36,57,-21,38
Admira Wacke,9789,8,10,8,18,31,57,-26,38
St. Pölten,9789,9,8,10,18,45,65,-20,34
Mattersburg,9789,10,8,9,19,34,55,-21,33
FC Salzburg,9790,1,22,7,7,67,32,35,73
SC Rheindorf,9790,2,19,9,8,56,42,14,66
SK Sturm Gra,9790,3,18,9,9,61,36,25,63
Vienna,9790,4,17,7,12,56,52,4,58
Rapid Vienna,9790,5,16,9,11,63,45,18,57
RZ Pellets W,9790,6,10,9,17,42,58,-16,39
SV Josko Rie,9790,7,10,8,18,38,53,-15,38
Mattersburg,9790,8,9,10,17,41,55,-14,37
St. Pölten,9790,9,9,9,18,45,64,-19,36
Admira Wacke,9790,10,8,7,21,29,61,-32,31
FC Salzburg,9791,1,23,6,7,73,29,44,75
SC Rheindorf,9791,2,21,7,8,57,39,18,70
SK Sturm Gra,9791,3,17,8,11,57,39,18,59
Rapid Vienna,9791,4,14,12,10,61,42,19,54
Vienna,9791,5,15,8,13,52,50,2,53
RZ Pellets W,9791,6,11,11,14,44,52,-8,44
SV Josko Rie,9791,7,12,4,20,36,56,-20,40
Admira Wacke,9791,8,10,9,17,39,60,-21,39
Mattersburg,9791,9,8,8,20,37,58,-21,32
St. Pölten,9791,10,7,11,18,33,64,-31,32
FC Salzburg,9792,1,20,8,8,70,35,35,68
SC Rheindorf,9792,2,16,12,8,51,43,8,60
Vienna,9792,3,16,9,11,53,48,5,57
SK Sturm Gra,9792,4,15,11,10,54,36,18,56
RZ Pellets W,9792,5,13,10,13,50,49,1,49
Rapid Vienna,9792,6,12,12,12,51,42,9,48
Admira Wacke,9792,7,13,7,16,34,54,-20,46
St. Pölten,9792,8,9,11,16,47,63,-16,38
Mattersburg,9792,9,9,9,18,38,56,-18,36
SV Josko Rie,9792,10,10,5,21,32,54,-22,35
SC Rheindorf,9793,1,24,5,7,63,39,24,77
FC Salzburg,9793,2,20,7,9,64,33,31,67
SK Sturm Gra,9793,3,21,4,11,64,38,26,67
Vienna,9793,4,18,6,12,65,57,8,60
Rapid Vienna,9793,5,15,11,10,65,47,18,56
RZ Pellets W,9793,6,11,11,14,43,48,-5,44
Admira Wacke,9793,7,11,6,19,38,65,-27,39
SV Josko Rie,9793,8,11,4,21,42,59,-17,37
Mattersburg,9793,9,8,8,20,37,59,-22,32
St. Pölten,9793,10,6,8,22,33,69,-36,26
SC Rheindorf,9794,1,21,9,6,61,36,25,72
FC Salzburg,9794,2,21,7,8,63,35,28,70
SK Sturm Gra,9794,3,20,5,11,61,39,22,65
Vienna,9794,4,17,10,9,63,44,19,61
Rapid Vienna,9794,5,11,14,11,51,40,11,47
RZ Pellets W,9794,6,13,8,15,47,55,-8,47
Admira Wacke,9794,7,11,9,16,46,60,-14,42
St. Pölten,9794,8,8,9,19,42,67,-25,33
Mattersburg,9794,9,9,6,21,38,65,-27,33
SV Josko Rie,9794,10,9,3,24,28,59,-31,30
FC Salzburg,9795,1,23,6,7,73,33,40,75
SC Rheindorf,9795,2,20,6,10,55,39,16,66
Vienna,9795,3,18,8,10,67,51,16,62
SK Sturm Gra,9795,4,17,6,13,57,42,15,57
Admira Wacke,9795,5,14,7,15,47,59,-12,49
SV Josko Rie,9795,6,13,6,17,42,53,-11,45
Rapid Vienna,9795,7,11,10,15,51,42,9,43
RZ Pellets W,9795,8,12,5,19,41,59,-18,41
Mattersburg,9795,9,10,6,20,38,63,-25,36
St. Pölten,9795,10,8,8,20,37,67,-30,32
SC Rheindorf,9796,1,24,5,7,63,41,22,77
SK Sturm Gra,9796,2,19,7,10,60,32,28,64
FC Salzburg,9796,3,19,5,12,60,38,22,62
RZ Pellets W,9796,4,15,10,11,49,50,-1,55
Vienna,9796,5,15,7,14,58,54,4,52
Rapid Vienna,9796,6,12,11,13,57,44,13,47
Admira Wacke,9796,7,11,9,16,39,55,-16,42
Mattersburg,9796,8,10,9,17,35,57,-22,39
SV Josko Rie,9796,9,9,8,19,38,58,-20,35
St. Pölten,9796,10,6,9,21,33,63,-30,27
SC Rheindorf,9797,1,20,9,7,65,46,19,69
SK Sturm Gra,9797,2,21,5,10,61,37,24,68
FC Salzburg,9797,3,20,6,10,68,37,31,66
Vienna,9797,4,20,4,12,66,52,14,64
Rapid Vienna,9797,5,15,11,10,61,42,19,56
St. Pölten,9797,6,12,7,17,53,61,-8,43
Admira Wacke,9797,7,11,6,19,38,65,-27,39
RZ Pellets W,9797,8,10,8,18,40,59,-19,38
Mattersburg,9797,9,9,8,19,44,63,-19,35
SV Josko Rie,9797,10,8,4,24,29,63,-34,28
SC Rheindorf,9798,1,22,6,8,65,43,22,72
Vienna,9798,2,21,5,10,59,45,14,68
FC Salzburg,9798,3,19,9,8,66,35,31,66
SK Sturm Gra,9798,4,17,10,9,57,36,21,61
Rapid Vienna,9798,5,11,14,11,44,35,9,47
RZ Pellets W,9798,6,12,6,18,46,55,-9,42
Admira Wacke,9798,7,10,7,19,37,60,-23,37
St. Pölten,9798,8,8,13,15,42,66,-24,37
Mattersburg,9798,9,9,7,20,42,62,-20,34
SV Josko Rie,9798,10,8,9,19,35,56,-21,33
FC Salzburg,9799,1,21,10,5,66,30,36,73
SC Rheindorf,9799,2,18,9,9,57,42,15,63
SK Sturm Gra,9799,3,18,7,11,55,35,20,61
Rapid Vienna,9799,4,14,12,10,56,40,16,54
Vienna,9799,5,16,6,14,62,59,3,54
Mattersburg,9799,6,12,11,13,49,52,-3,47
RZ Pellets W,9799,7,12,8,16,42,57,-15,44
Admira Wacke,9799,8,9,8,19,32,55,-23,35
St. Pölten,9799,9,8,10,18,42,66,-24,34
SV Josko Rie,9799,10,7,9,20,36,61,-25,30
FC Salzburg,9800,1,20,8,8,75,37,38,68
Vienna,9800,2,19,6,11,67,56,11,63
SC Rheindorf,9800,3,19,6,11,54,43,11,63
SK Sturm Gra,9800,4,18,6,12,58,38,20,60
Rapid Vienna,9800,5,17,8,11,67,44,23,59
RZ Pellets W,9800,6,16,6,14,52,54,-2,54
Mattersburg,9800,7,11,8,17,38,55,-17,41
Admira Wacke,9800,8,12,5,19,37,59,-22,41
SV Josko Rie,9800,9,9,3,24,32,60,-28,30
St. Pölten,9800,10,7,8,21,36,70,-34,29
FC Salzburg,9801,1,24,5,7,77,29,48,77
SC Rheindorf,9801,2,21,9,6,60,38,22,72
Vienna,9801,3,18,6,12,63,48,15,60
SK Sturm Gra,9801,4,16,7,13,57,42,15,55
Rapid Vienna,9801,5,14,10,12,52,44,8,52
RZ Pellets W,9801,6,12,7,17,41,54,-13,43
Admira Wacke,9801,7,12,5,19,39,60,-21,41
Mattersburg,9801,8,10,8,18,39,62,-23,38
SV Josko Rie,9801,9,10,5,21,34,61,-27,35
St. Pölten,9801,10,8,8,20,38,62,-24,32
FC Salzburg,9802,1,22,7,7,70,29,41,73
SK Sturm Gra,9802,2,20,7,9,54,30,24,67
SC Rheindorf,9802,3,20,5,11,59,44,15,65
Vienna,9802,4,20,4,12,71,52,19,64
Rapid Vienna,9802,5,12,9,15,49,45,4,45
RZ Pellets W,9802,6,11,8,17,43,59,-16,41
St. Pölten,9802,7,10,10,16,44,61,-17,40
SV Josko Rie,9802,8,11,5,20,38,59,-21,38
Admira Wacke,9802,9,11,5,20,31,65,-34,38
Mattersburg,9802,10,9,8,19,40,55,-15,35
FC Salzburg,9803,1,20,8,8,54,27,27,68
SK Sturm Gra,9803,2,21,4,11,59,39,20,67
Vienna,9803,3,19,4,13,60,52,8,61
SC Rheindorf,9803,4,16,8,12,51,42,9,56
Rapid Vienna,9803,5,14,10,12,51,35,16,52
Admira Wacke,9803,6,14,5,17,43,58,-15,47
RZ Pellets W,9803,7,13,5,18,48,60,-12,44
SV Josko Rie,9803,8,11,7,18,37,56,-19,40
St. Pölten,9803,9,9,10,17,40,57,-17,37
Mattersburg,9803,10,9,7,20,39,56,-17,34
FC Salzburg,9804,1,22,6,8,78,35,43,72
Vienna,9804,2,23,3,10,70,43,27,72
SC Rheindorf,9804,3,20,8,8,54,42,12,68
Rapid Vienna,9804,4,15,12,9,51,35,16,57
SK Sturm Gra,9804,5,16,5,15,54,40,14,53
RZ Pellets W,9804,6,15,6,15,47,50,-3,51
Admira Wacke,9804,7,12,4,20,34,60,-26,40
SV Josko Rie,9804,8,10,4,22,37,66,-29,34
St. Pölten,9804,9,7,10,19,38,64,-26,31
Mattersburg,9804,10,7,8,21,37,65,-28,29
FC Salzburg,9805,1,22,5,9,63,33,30,71
SC Rheindorf,9805,2,20,9,7,61,43,18,69
SK Sturm Gra,9805,3,20,5,11,62,38,24,65
Vienna,9805,4,15,7,14,53,50,3,52
RZ Pellets W,9805,5,14,8,14,43,48,-5,50
Admira Wacke,9805,6,13,7,16,35,52,-17,46
Rapid Vienna,9805,7,11,10,15,52,45,7,43
Mattersburg,9805,8,10,10,16,37,51,-14,40
SV Josko Rie,9805,9,11,6,19,35,53,-18,39
St. Pölten,9805,10,7,7,22,40,68,-28,28
FC Salzburg,9806,1,22,6,8,66,30,36,72
SK Sturm Gra,9806,2,19,8,9,64,38,26,65
SC Rheindorf,9806,3,18,11,7,54,38,16,65
Vienna,9806,4,17,6,13,56,51,5,57
Rapid Vienna,9806,5,11,12,13,56,46,10,45
Admira Wacke,9806,6,11,10,15,32,53,-21,43
RZ Pellets W,9806,7,10,11,15,44,58,-14,41
SV Josko Rie,9806,8,11,7,18,34,47,-13,40
Mattersburg,9806,9,9,10,17,43,61,-18,37
St. Pölten,9806,10,6,11,19,37,64,-27,29
SK Sturm Gra,9807,1,20,9,7,55,22,33,69
FC Salzburg,9807,2,19,9,8,57,30,27,66
SC Rheindorf,9807,3,19,9,8,50,40,10,66
Vienna,9807,4,17,5,14,62,58,4,56
RZ Pellets W,9807,5,12,12,12,49,50,-1,48
Rapid Vienna,9807,6,11,13,12,51,39,12,46
Mattersburg,9807,7,11,10,15,43,51,-8,43
St. Pölten,9807,8,7,12,17,38,64,-26,33
Admira Wacke,9807,9,8,9,19,35,65,-30,33
SV Josko Rie,9807,10,8,8,20,32,53,-21,32
FC Salzburg,9808,1,23,7,6,72,32,40,76
Rapid Vienna,9808,2,18,8,10,66,38,28,62
SC Rheindorf,9808,3,18,7,11,55,49,6,61
Vienna,9808,4,17,7,12,60,51,9,58
SK Sturm Gra,9808,5,17,5,14,55,41,14,56
RZ Pellets W,9808,6,16,6,14,57,54,3,54
Admira Wacke,9808,7,10,8,18,36,64,-28,38
Mattersburg,9808,8,9,10,17,37,54,-17,37
St. Pölten,9808,9,8,8,20,43,69,-26,32
SV Josko Rie,9808,10,8,6,22,32,61,-29,30
FC Salzburg,9809,1,23,6,7,76,32,44,75
SC Rheindorf,9809,2,18,8,10,50,40,10,62
Vienna,9809,3,19,4,13,64,50,14,61
SK Sturm Gra,9809,4,17,7,12,57,34,23,58
RZ Pellets W,9809,5,15,6,15,41,46,-5,51
Rapid Vienna,9809,6,12,13,11,52,38,14,49
Admira Wacke,9809,7,14,3,19,36,62,-26,45
St. Pölten,9809,8,10,8,18,39,60,-21,38
SV Josko Rie,9809,9,11,5,20,35,57,-22,38
Mattersburg,9809,10,6,10,20,33,64,-31,28
SC Rheindorf,9810,1,20,7,9,55,37,18,67
SK Sturm Gra,9810,2,20,6,10,60,40,20,66
Vienna,9810,3,20,5,11,61,44,17,65
FC Salzburg,9810,4,19,5,12,59,34,25,62
Rapid Vienna,9810,5,18,7,11,61,39,22,61
RZ Pellets W,9810,6,14,7,15,44,55,-11,49
SV Josko Rie,9810,7,11,6,19,34,50,-16,39
St. Pölten,9810,8,10,7,19,42,62,-20,37
Admira Wacke,9810,9,8,8,20,35,62,-27,32
Mattersburg,9810,10,8,6,22,32,60,-28,30
FC Salzburg,9811,1,20,8,8,61,33,28,68
Vienna,9811,2,20,5,11,66,51,15,65
SC Rheindorf,9811,3,19,8,9,56,44,12,65
Rapid Vienna,9811,4,17,9,10,58,39,19,60
SK Sturm Gra,9811,5,18,6,12,57,40,17,60
RZ Pellets W,9811,6,12,7,17,51,56,-5,43
Mattersburg,9811,7,9,11,16,38,52,-14,38
Admira Wacke,9811,8,10,7,19,40,63,-23,37
SV Josko Rie,9811,9,9,8,19,31,53,-22,35
St. Pölten,9811,10,8,7,21,37,64,-27,31
SC Rheindorf,9812,1,22,6,8,59,38,21,72
FC Salzburg,9812,2,22,5,9,72,29,43,71
SK Sturm Gra,9812,3,20,4,12,62,37,25,64
Vienna,9812,4,18,5,13,65,60,5,59
RZ Pellets W,9812,5,16,4,16,45,50,-5,52
Rapid Vienna,9812,6,12,11,13,49,45,4,47
Admira Wacke,9812,7,12,6,18,40,58,-18,42
SV Josko Rie,9812,8,11,4,21,38,62,-24,37
St. Pölten,9812,9,9,7,20,42,68,-26,34
Mattersburg,9812,10,9,6,21,39,64,-25,33
FC Salzburg,9813,1,21,9,6,67,29,38,72
SC Rheindorf,9813,2,20,6,10,56,41,15,66
SK Sturm Gra,9813,3,20,5,11,59,37,22,65
Vienna,9813,4,19,7,10,65,49,16,64
Rapid Vienna,9813,5,15,11,10,67,39,28,56
Admira Wacke,9813,6,13,6,17,44,72,-28,45
Mattersburg,9813,7,9,9,18,36,56,-20,36
RZ Pellets W,9813,8,10,5,21,39,65,-26,35
St. Pölten,9813,8,9,8,19,39,65,-26,35
SV Josko Rie,9813,10,9,4,23,35,54,-19,31
SC Rheindorf,9814,1,19,8,9,53,40,13,65
Vienna,9814,2,19,6,11,69,49,20,63
FC Salzburg,9814,3,17,8,11,59,37,22,59
SK Sturm Gra,9814,4,16,10,10,51,31,20,58
Rapid Vienna,9814,5,12,14,10,55,44,11,50
Admira Wacke,9814,6,12,9,15,40,56,-16,45
St. Pölten,9814,7,10,13,13,38,53,-15,43
RZ Pellets W,9814,8,10,11,15,42,53,-11,41
SV Josko Rie,9814,9,8,10,18,28,48,-20,34
Mattersburg,9814,10,6,13,17,34,58,-24,31
FC Salzburg,9815,1,20,8,8,62,34,28,68
SC Rheindorf,9815,2,20,6,10,50,40,10,66
Vienna,9815,3,19,5,12,67,55,12,62
SK Sturm Gra,9815,4,15,6,15,48,38,10,51
RZ Pellets W,9815,5,14,7,15,46,50,-4,49
St. Pölten,9815,6,14,7,15,51,60,-9,49
Rapid Vienna,9815,7,12,12,12,57,43,14,48
Admira Wacke,9815,8,14,6,16,46,60,-14,48
SV Josko Rie,9815,9,10,4,22,28,53,-25,34
Mattersburg,9815,10,7,9,20,37,59,-22,30
SC Rheindorf,9816,1,19,10,7,55,40,15,67
FC Salzburg,9816,2,19,9,8,65,35,30,66
SK Sturm Gra,9816,3,19,8,9,67,41,26,65
Vienna,9816,4,16,7,13,55,52,3,55
Rapid Vienna,9816,5,13,11,12,49,36,13,50
RZ Pellets W,9816,6,12,6,18,47,56,-9,42
Mattersburg,9816,7,11,9,16,41,53,-12,42
Admira Wacke,9816,8,12,4,20,36,65,-29,40
SV Josko Rie,9816,9,11,6,19,33,47,-14,39
St. Pölten,9816,10,7,12,17,41,64,-23,33
SC Rheindorf,9817,1,22,7,7,62,41,21,73
FC Salzburg,9817,2,20,5,11,61,35,26,65
Vienna,9817,3,19,8,9,67,48,19,65
Rapid Vienna,9817,4,15,11,10,57,36,21,56
SK Sturm Gra,9817,5,13,8,15,54,53,1,47
RZ Pellets W,9817,6,14,4,18,47,59,-12,46
Mattersburg,9817,7,11,10,15,45,51,-6,43
Admira Wacke,9817,8,12,7,17,40,56,-16,43
SV Josko Rie,9817,9,10,5,21,33,59,-26,35
St. Pölten,9817,10,7,9,20,43,71,-28,30
FC Salzburg,9818,1,25,5,6,77,26,51,80
SK Sturm Gra,9818,2,20,6,10,60,36,24,66
SC Rheindorf,9818,3,18,8,10,54,50,4,62
Vienna,9818,4,17,5,14,66,59,7,56
Rapid Vienna,9818,5,14,9,13,58,46,12,51
Admira Wacke,9818,6,14,4,18,46,64,-18,46
Mattersburg,9818,7,11,8,17,36,52,-16,41
SV Josko Rie,9818,8,12,4,20,41,56,-15,40
RZ Pellets W,9818,9,11,7,18,42,58,-16,40
St. Pölten,9818,10,6,8,22,33,66,-33,26
FC Salzburg,9819,1,22,7,7,72,33,39,73
Vienna,9819,2,22,5,9,63,45,18,71
SC Rheindorf,9819,3,19,8,9,54,43,11,65
SK Sturm Gra,9819,4,20,4,12,64,40,24,64
Rapid Vienna,9819,5,15,10,11,57,38,19,55
RZ Pellets W,9819,6,13,5,18,52,65,-13,44
Admira Wacke,9819,7,12,7,17,41,58,-17,43
Mattersburg,9819,8,8,10,18,41,57,-16,34
SV Josko Rie,9819,9,7,8,21,29,59,-30,29
St. Pölten,9819,10,5,10,21,41,76,-35,25
FC Salzburg,9820,1,22,7,7,67,28,39,73
SC Rheindorf,9820,2,20,5,11,52,42,10,65
SK Sturm Gra,9820,3,19,6,11,56,39,17,63
Vienna,9820,4,19,5,12,67,51,16,62
Rapid Vienna,9820,5,13,11,12,61,50,11,50
RZ Pellets W,9820,6,12,7,17,44,60,-16,43
Mattersburg,9820,7,12,6,18,44,50,-6,42
Admira Wacke,9820,8,12,5,19,38,61,-23,41
St. Pölten,9820,9,9,8,19,44,62,-18,35
SV Josko Rie,9820,10,10,4,22,29,59,-30,34
FC Salzburg,9821,1,19,12,5,66,28,38,69
SC Rheindorf,9821,2,19,8,9,53,45,8,65
SK Sturm Gra,9821,3,18,7,11,60,35,25,61
Vienna,9821,4,17,10,9,57,45,12,61
SV Josko Rie,9821,5,13,8,15,40,47,-7,47
RZ Pellets W,9821,6,11,10,15,35,48,-13,43
Admira Wacke,9821,7,11,8,17,36,53,-17,41
Mattersburg,9821,8,7,15,14,34,52,-18,36
Rapid Vienna,9821,9,8,11,17,46,50,-4,35
St. Pölten,9821,10,7,11,18,33,57,-24,32
FC Salzburg,9822,1,23,6,7,74,31,43,75
Vienna,9822,2,20,5,11,69,54,15,65
SK Sturm Gra,9822,3,19,6,11,62,35,27,63
SC Rheindorf,9822,4,18,5,13,47,42,5,59
Rapid Vienna,9822,5,14,10,12,51,43,8,52
Admira Wacke,9822,6,15,6,15,49,55,-6,51
RZ Pellets W,9822,7,11,5,20,46,67,-21,38
St. Pölten,9822,8,9,9,18,43,60,-17,36
SV Josko Rie,9822,9,9,7,20,30,58,-28,34
Mattersburg,9822,10,8,9,19,39,65,-26,33
Rapid Vienna,9823,1,18,10,8,67,39,28,64
SC Rheindorf,9823,2,19,7,10,60,43,17,64
FC Salzburg,9823,3,18,7,11,57,34,23,61
SK Sturm Gra,9823,4,18,6,12,59,39,20,60
Vienna,9823,5,16,5,15,57,55,2,53
Admira Wacke,9823,6,14,5,17,41,58,-17,47
RZ Pellets W,9823,7,11,10,15,47,59,-12,43
SV Josko Rie,9823,8,12,5,19,34,56,-22,41
Mattersburg,9823,9,9,9,18,38,59,-21,36
St. Pölten,9823,10,9,8,19,50,68,-18,35
FC Salzburg,9824,1,24,6,6,74,32,42,78
SC Rheindorf,9824,2,19,8,9,57,47,10,65
Vienna,9824,3,19,4,13,67,59,8,61
SK Sturm Gra,9824,4,16,9,11,61,44,17,57
Admira Wacke,9824,5,14,5,17,48,61,-13,47
Rapid Vienna,9824,6,12,10,14,62,49,13,46
RZ Pellets W,9824,7,12,7,17,48,63,-15,43
SV Josko Rie,9824,8,11,6,19,35,53,-18,39
Mattersburg,9824,9,10,8,18,37,54,-17,38
St. Pölten,9824,10,7,9,20,41,68,-27,30
SC Rheindorf,9825,1,21,8,7,66,45,21,71
FC Salzburg,9825,2,20,7,9,60,30,30,67
SK Sturm Gra,9825,3,19,8,9,62,37,25,65
Vienna,9825,4,19,4,13,70,59,11,61
RZ Pellets W,9825,5,13,7,16,53,60,-7,46
Rapid Vienna,9825,6,11,12,13,55,43,12,45
SV Josko Rie,9825,7,14,3,19,38,65,-27,45
Admira Wacke,9825,8,9,10,17,34,59,-25,37
St. Pölten,9825,9,8,10,18,39,62,-23,34
Mattersburg,9825,10,7,9,20,36,53,-17,30
SC Rheindorf,9826,1,20,10,6,59,37,22,70
Vienna,9826,2,18,8,10,71,55,16,62
Rapid Vienna,9826,3,17,9,10,55,38,17,60
FC Salzburg,9826,4,16,9,11,58,37,21,57
RZ Pellets W,9826,5,16,5,15,54,54,0,53
SK Sturm Gra,9826,6,15,7,14,52,37,15,52
Admira Wacke,9826,7,12,8,16,37,58,-21,44
Mattersburg,9826,8,11,7,18,43,58,-15,40
St. Pölten,9826,9,7,10,19,40,67,-27,31
SV Josko Rie,9826,10,7,9,20,35,63,-28,30
FC Salzburg,9827,1,22,8,6,70,29,41,74
SC Rheindorf,9827,2,20,8,8,61,45,16,68
SK Sturm Gra,9827,3,20,5,11,60,33,27,65
Rapid Vienna,9827,4,17,11,8,63,33,30,62
Vienna,9827,5,16,5,15,56,56,0,53
RZ Pellets W,9827,6,11,9,16,41,58,-17,42
St. Pölten,9827,7,11,9,16,44,65,-21,42
SV Josko Rie,9827,8,11,4,21,34,56,-22,37
Admira Wacke,9827,9,9,8,19,31,55,-24,35
Mattersburg,9827,10,6,7,23,32,62,-30,25
FC Salzburg,9828,1,23,6,7,68,27,41,75
Vienna,9828,2,24,3,9,70,47,23,75
SC Rheindorf,9828,3,21,8,7,59,39,20,71
SK Sturm Gra,9828,4,19,7,10,61,37,24,64
Rapid Vienna,9828,5,14,9,13,56,43,13,51
RZ Pellets W,9828,6,11,6,19,45,64,-19,39
Admira Wacke,9828,7,10,7,19,34,63,-29,37
Mattersburg,9828,8,8,9,19,39,58,-19,33
SV Josko Rie,9828,9,9,6,21,40,62,-22,33
St. Pölten,9828,10,6,9,21,36,68,-32,27
FC Salzburg,9829,1,22,7,7,64,30,34,73
SK Sturm Gra,9829,2,19,5,12,57,33,24,62
SC Rheindorf,9829,3,15,12,9,50,43,7,57
Vienna,9829,4,16,7,13,56,51,5,55
RZ Pellets W,9829,5,15,8,13,46,50,-4,53
Admira Wacke,9829,6,14,7,15,37,51,-14,49
Rapid Vienna,9829,7,12,9,15,46,40,6,45
SV Josko Rie,9829,8,11,6,19,38,52,-14,39
St. Pölten,9829,9,9,9,18,36,57,-21,36
Mattersburg,9829,10,8,8,20,37,60,-23,32
FC Salzburg,9830,1,20,6,10,65,37,28,66
SC Rheindorf,9830,2,19,8,9,57,44,13,65
Vienna,9830,3,19,5,12,61,51,10,62
SK Sturm Gra,9830,4,17,10,9,56,36,20,61
Rapid Vienna,9830,5,17,8,11,58,36,22,59
SV Josko Rie,9830,6,11,7,18,38,53,-15,40
RZ Pellets W,9830,7,11,6,19,41,59,-18,39
St. Pölten,9830,8,8,13,15,46,61,-15,37
Admira Wacke,9830,9,9,10,17,37,61,-24,37
Mattersburg,9830,10,8,9,19,35,56,-21,33
Vienna,9831,1,23,4,9,70,44,26,73
SC Rheindorf,9831,2,21,6,9,52,42,10,69
FC Salzburg,9831,3,21,5,10,63,31,32,68
SK Sturm Gra,9831,4,20,6,10,59,29,30,66
Rapid Vienna,9831,5,14,8,14,46,37,9,50
RZ Pellets W,9831,6,11,7,18,41,54,-13,40
Mattersburg,9831,7,9,9,18,34,49,-15,36
SV Josko Rie,9831,8,10,6,20,31,56,-25,36
St. Pölten,9831,9,9,8,19,47,68,-21,35
Admira Wacke,9831,10,8,9,19,29,62,-33,33
FC Salzburg,9832,1,23,6,7,64,27,37,75
SK Sturm Gra,9832,2,21,5,10,63,37,26,68
SC Rheindorf,9832,3,20,7,9,58,42,16,67
Vienna,9832,4,17,6,13,62,53,9,57
Rapid Vienna,9832,5,12,12,12,54,41,13,48
Admira Wacke,9832,6,14,5,17,44,58,-14,47
RZ Pellets W,9832,7,10,9,17,45,63,-18,39
Mattersburg,9832,8,9,9,18,37,56,-19,36
SV Josko Rie,9832,9,9,6,21,38,65,-27,33
St. Pölten,9832,10,6,13,17,43,66,-23,31
FC Salzburg,9833,1,22,10,4,69,26,43,76
Vienna,9833,2,20,5,11,69,49,20,65
SK Sturm Gra,9833,3,19,6,11,62,36,26,63
SC Rheindorf,9833,4,18,8,10,57,41,16,62
SV Josko Rie,9833,5,14,3,19,39,59,-20,45
Rapid Vienna,9833,6,11,10,15,50,43,7,43
RZ Pellets W,9833,7,11,10,15,38,54,-16,43
Admira Wacke,9833,8,11,5,20,35,65,-30,38
Mattersburg,9833,9,9,8,19,35,54,-19,35
St. Pölten,9833,10,8,9,19,44,71,-27,33
FC Salzburg,9834,1,24,5,7,66,29,37,77
SC Rheindorf,9834,2,19,7,10,64,50,14,64
Vienna,9834,3,20,4,12,70,57,13,64
SK Sturm Gra,9834,4,17,6,13,55,40,15,57
Rapid Vienna,9834,5,12,12,12,55,45,10,48
St. Pölten,9834,6,13,9,14,49,57,-8,48
Mattersburg,9834,7,12,6,18,41,55,-14,42
RZ Pellets W,9834,8,11,6,19,44,60,-16,39
Admira Wacke,9834,9,11,5,20,41,66,-25,38
SV Josko Rie,9834,10,9,4,23,35,61,-26,31
FC Salzburg,9835,1,20,8,8,65,31,34,68
SC Rheindorf,9835,2,20,7,9,59,41,18,67
Vienna,9835,3,20,4,12,57,45,12,64
SK Sturm Gra,9835,4,19,6,11,58,31,27,63
Rapid Vienna,9835,5,13,10,13,51,44,7,49
Admira Wacke,9835,6,14,6,16,34,49,-15,48
RZ Pellets W,9835,7,13,6,17,49,58,-9,45
Mattersburg,9835,8,10,8,18,40,56,-16,38
SV Josko Rie,9835,9,9,5,22,31,62,-31,32
St. Pölten,9835,10,7,10,19,41,68,-27,31
FC Salzburg,9836,1,24,6,6,68,29,39,78
Vienna,9836,2,19,8,9,66,51,15,65
SC Rheindorf,9836,3,20,5,11,52,43,9,65
SK Sturm Gra,9836,4,16,8,12,52,36,16,56
Rapid Vienna,9836,5,15,10,11,54,36,18,55
RZ Pellets W,9836,6,13,8,15,46,53,-7,47
Admira Wacke,9836,7,11,6,19,37,63,-26,39
SV Josko Rie,9836,8,10,6,20,38,55,-17,36
Mattersburg,9836,9,8,8,20,39,61,-22,32
St. Pölten,9836,10,5,13,18,35,60,-25,28
FC Salzburg,9837,1,19,7,10,61,35,26,64
SC Rheindorf,9837,2,18,7,11,50,45,5,61
SK Sturm Gra,9837,3,18,6,12,63,40,23,60
Vienna,9837,4,18,6,12,61,54,7,60
Rapid Vienna,9837,5,16,11,9,57,38,19,59
RZ Pellets W,9837,6,12,10,14,50,53,-3,46
St. Pölten,9837,7,11,9,16,48,62,-14,42
SV Josko Rie,9837,8,11,6,19,38,54,-16,39
Admira Wacke,9837,9,11,6,19,41,69,-28,39
Mattersburg,9837,10,8,8,20,37,56,-19,32
SC Rheindorf,9838,1,20,8,8,57,38,19,68
FC Salzburg,9838,2,19,9,8,60,29,31,66
Vienna,9838,3,19,5,12,63,51,12,62
SK Sturm Gra,9838,4,19,4,13,58,39,19,61
Rapid Vienna,9838,5,15,11,10,59,42,17,56
St. Pölten,9838,6,12,7,17,47,65,-18,43
Admira Wacke,9838,7,13,4,19,43,63,-20,43
RZ Pellets W,9838,8,9,10,17,42,62,-20,37
Mattersburg,9838,9,8,10,18,34,52,-18,34
SV Josko Rie,9838,10,9,6,21,31,53,-22,33
FC Salzburg,9839,1,22,8,6,68,29,39,74
SK Sturm Gra,9839,2,19,7,10,60,35,25,64
Vienna,9839,3,19,6,11,62,51,11,63
SC Rheindorf,9839,4,17,9,10,56,45,11,60
Rapid Vienna,9839,5,13,13,10,49,34,15,52
RZ Pellets W,9839,6,11,7,18,44,60,-16,40
SV Josko Rie,9839,7,12,4,20,37,59,-22,40
Mattersburg,9839,8,11,6,19,41,53,-12,39
Admira Wacke,9839,9,11,5,20,36,60,-24,38
St. Pölten,9839,10,8,9,19,37,64,-27,33
FC Salzburg,9840,1,22,6,8,69,32,37,72
SK Sturm Gra,9840,2,21,6,9,63,31,32,69
Vienna,9840,3,19,5,12,68,52,16,62
SC Rheindorf,9840,4,16,7,13,46,43,3,55
Rapid Vienna,9840,5,13,10,13,52,40,12,49
RZ Pellets W,9840,6,14,6,16,43,55,-12,48
SV Josko Rie,9840,7,11,6,19,33,51,-18,39
Mattersburg,9840,8,10,8,18,37,53,-16,38
St. Pölten,9840,9,9,10,17,41,60,-19,37
Admira Wacke,9840,10,11,4,21,34,69,-35,37
FC Salzburg,9841,1,23,6,7,68,32,36,75
SK Sturm Gra,9841,2,21,5,10,60,38,22,68
Vienna,9841,3,20,5,11,69,50,19,65
SC Rheindorf,9841,4,18,6,12,56,52,4,60
Rapid Vienna,9841,5,13,10,13,62,45,17,49
RZ Pellets W,9841,6,12,8,16,48,56,-8,44
Admira Wacke,9841,7,12,7,17,39,58,-19,43
St. Pölten,9841,8,8,10,18,40,64,-24,34
SV Josko Rie,9841,9,9,6,21,32,52,-20,33
Mattersburg,9841,10,7,11,18,35,62,-27,32
SC Rheindorf,9842,1,20,8,8,62,45,17,68
FC Salzburg,9842,2,18,10,8,62,35,27,64
SK Sturm Gra,9842,3,17,11,8,55,32,23,62
Rapid Vienna,9842,4,16,7,13,55,41,14,55
Vienna,9842,5,15,9,12,60,51,9,54
RZ Pellets W,9842,6,13,7,16,48,55,-7,46
Mattersburg,9842,7,11,8,17,42,55,-13,41
Admira Wacke,9842,8,11,6,19,37,61,-24,39
SV Josko Rie,9842,9,10,7,19,33,55,-22,37
St. Pölten,9842,10,8,9,19,42,66,-24,33
SK Sturm Gra,9843,1,22,3,11,65,34,31,69
SC Rheindorf,9843,2,19,7,10,47,44,3,64
FC Salzburg,9843,3,18,8,10,58,32,26,62
Vienna,9843,4,17,6,13,62,53,9,57
Admira Wacke,9843,5,13,8,15,41,54,-13,47
Rapid Vienna,9843,6,12,9,15,52,44,8,45
Mattersburg,9843,7,11,11,14,41,50,-9,44
RZ Pellets W,9843,8,12,8,16,54,65,-11,44
SV Josko Rie,9843,9,10,6,20,38,63,-25,36
St. Pölten,9843,10,9,8,19,43,62,-19,35
FC Salzburg,9844,1,25,5,6,69,28,41,80
SC Rheindorf,9844,2,20,7,9,56,44,12,67
SK Sturm Gra,9844,3,19,8,9,54,31,23,65
Vienna,9844,4,19,5,12,76,54,22,62
Rapid Vienna,9844,5,14,11,11,58,42,16,53
RZ Pellets W,9844,6,14,8,14,50,57,-7,50
Admira Wacke,9844,7,9,10,17,34,58,-24,37
SV Josko Rie,9844,8,10,5,21,42,66,-24,35
Mattersburg,9844,9,6,10,20,37,60,-23,28
St. Pölten,9844,10,6,7,23,37,73,-36,25
SC Rheindorf,9845,1,22,6,8,65,42,23,72
FC Salzburg,9845,2,21,7,8,62,30,32,70
Vienna,9845,3,20,6,10,67,49,18,66
SK Sturm Gra,9845,4,19,7,10,56,40,16,64
Rapid Vienna,9845,5,14,12,10,58,38,20,54
Admira Wacke,9845,6,12,8,16,33,50,-17,44
RZ Pellets W,9845,7,12,6,18,39,50,-11,42
Mattersburg,9845,8,9,7,20,35,55,-20,34
SV Josko Rie,9845,9,9,7,20,34,58,-24,34
St. Pölten,9845,10,5,8,23,34,71,-37,23
FC Salzburg,9846,1,21,5,10,73,35,38,68
SK Sturm Gra,9846,2,20,8,8,68,36,32,68
Vienna,9846,3,20,6,10,65,49,16,66
SC Rheindorf,9846,4,18,8,10,55,43,12,62
Rapid Vienna,9846,5,14,8,14,60,50,10,50
RZ Pellets W,9846,6,12,7,17,43,54,-11,43
Mattersburg,9846,7,11,9,16,42,57,-15,42
Admira Wacke,9846,8,10,8,18,36,62,-26,38
SV Josko Rie,9846,9,9,6,21,27,54,-27,33
St. Pölten,9846,10,8,9,19,40,69,-29,33
SK Sturm Gra,9847,1,21,7,8,64,37,27,70
SC Rheindorf,9847,2,19,8,9,51,42,9,65
FC Salzburg,9847,3,18,9,9,60,31,29,63
Vienna,9847,4,17,6,13,59,58,1,57
RZ Pellets W,9847,5,14,7,15,47,53,-6,49
Rapid Vienna,9847,6,11,14,11,54,40,14,47
SV Josko Rie,9847,7,11,8,17,38,50,-12,41
Mattersburg,9847,8,9,10,17,38,54,-16,37
St. Pölten,9847,9,7,14,15,40,58,-18,35
Admira Wacke,9847,10,7,9,20,31,59,-28,30
FC Salzburg,9848,1,24,6,6,68,27,41,78
SK Sturm Gra,9848,2,20,6,10,65,33,32,66
SC Rheindorf,9848,3,19,9,8,59,41,18,66
Vienna,9848,4,17,7,12,59,52,7,58
Rapid Vienna,9848,5,12,11,13,53,46,7,47
RZ Pellets W,9848,6,11,10,15,43,53,-10,43
SV Josko Rie,9848,7,12,6,18,35,54,-19,42
Admira Wacke,9848,8,10,9,17,32,55,-23,39
St. Pölten,9848,9,7,10,19,34,61,-27,31
Mattersburg,9848,10,6,10,20,35,61,-26,28
SC Rheindorf,9849,1,22,5,9,63,39,24,71
FC Salzburg,9849,2,20,6,10,66,37,29,66
Vienna,9849,3,19,3,14,67,55,12,60
SK Sturm Gra,9849,4,15,7,14,53,44,9,52
RZ Pellets W,9849,5,15,7,14,50,55,-5,52
Rapid Vienna,9849,6,11,13,12,48,41,7,46
Admira Wacke,9849,7,12,7,17,36,54,-18,43
St. Pölten,9849,8,10,10,16,45,63,-18,40
SV Josko Rie,9849,9,12,4,20,38,58,-20,40
Mattersburg,9849,10,8,10,18,38,58,-20,34
FC Salzburg,9850,1,23,8,5,65,28,37,77
Vienna,9850,2,20,6,10,65,48,17,66
SC Rheindorf,9850,3,20,5,11,54,46,8,65
SK Sturm Gra,9850,4,19,4,13,54,33,21,61
Rapid Vienna,9850,5,13,12,11,55,39,16,51
RZ Pellets W,9850,6,12,7,17,46,54,-8,43
SV Josko Rie,9850,7,12,5,19,33,48,-15,41
Admira Wacke,9850,8,11,7,18,35,56,-21,40
St. Pölten,9850,9,8,8,20,38,65,-27,32
Mattersburg,9850,10,7,8,21,35,63,-28,29
SK Sturm Gra,9851,1,21,8,7,63,28,35,71
Vienna,9851,2,21,6,9,63,45,18,69
SC Rheindorf,9851,3,17,9,10,50,44,6,60
FC Salzburg,9851,4,16,9,11,63,39,24,57
Rapid Vienna,9851,5,14,7,15,54,44,10,49
RZ Pellets W,9851,6,12,8,16,40,51,-11,44
Mattersburg,9851,7,10,11,15,47,48,-1,41
Admira Wacke,9851,8,11,7,18,33,60,-27,40
St. Pölten,9851,9,9,9,18,38,64,-26,36
SV Josko Rie,9851,10,9,6,21,33,61,-28,33
SC Rheindorf,9852,1,21,7,8,52,39,13,70
FC Salzburg,9852,2,19,11,6,61,27,34,68
Rapid Vienna,9852,3,16,10,10,60,36,24,58
Vienna,9852,4,16,5,15,53,55,-2,53
SK Sturm Gra,9852,5,15,5,16,47,36,11,50
RZ Pellets W,9852,6,13,8,15,49,51,-2,47
SV Josko Rie,9852,7,14,5,17,36,47,-11,47
Admira Wacke,9852,8,12,6,18,36,56,-20,42
St. Pölten,9852,9,10,9,17,38,61,-23,39
Mattersburg,9852,10,6,10,20,35,59,-24,28
FC Salzburg,9853,1,19,10,7,58,27,31,67
Rapid Vienna,9853,2,17,11,8,62,35,27,62
SC Rheindorf,9853,3,18,8,10,53,39,14,62
Vienna,9853,4,18,6,12,63,52,11,60
SK Sturm Gra,9853,5,17,6,13,55,36,19,57
RZ Pellets W,9853,6,13,7,16,47,57,-10,46
Admira Wacke,9853,7,13,6,17,40,61,-21,45
SV Josko Rie,9853,8,11,5,20,35,57,-22,38
St. Pölten,9853,9,9,10,17,42,58,-16,37
Mattersburg,9853,10,7,7,22,30,63,-33,28
FC Salzburg,9854,1,21,9,6,71,33,38,72
SC Rheindorf,9854,2,21,9,6,61,39,22,72
Vienna,9854,3,19,3,14,65,60,5,60
SK Sturm Gra,9854,4,17,8,11,52,33,19,59
Rapid Vienna,9854,5,13,10,13,54,36,18,49
RZ Pellets W,9854,6,12,7,17,42,58,-16,43
SV Josko Rie,9854,7,12,5,19,41,58,-17,41
Admira Wacke,9854,8,11,6,19,34,60,-26,39
St. Pölten,9854,9,8,11,17,46,63,-17,35
Mattersburg,9854,10,7,10,19,31,57,-26,31
SK Sturm Gra,9855,1,21,7,8,67,35,32,70
SC Rheindorf,9855,2,20,9,7,62,45,17,69
FC Salzburg,9855,3,18,8,10,62,38,24,62
Rapid Vienna,9855,4,15,10,11,56,39,17,55
Vienna,9855,5,16,7,13,58,55,3,55
Admira Wacke,9855,6,12,6,18,35,57,-22,42
SV Josko Rie,9855,7,11,7,18,43,54,-11,40
RZ Pellets W,9855,8,9,11,16,39,52,-13,38
Mattersburg,9855,9,9,7,20,37,62,-25,34
St. Pölten,9855,10,7,12,17,44,66,-22,33
FC Salzburg,9856,1,21,9,6,71,32,39,72
Rapid Vienna,9856,2,17,11,8,62,38,24,62
SC Rheindorf,9856,3,18,8,10,62,53,9,62
SK Sturm Gra,9856,4,18,6,12,58,37,21,60
Vienna,9856,5,16,6,14,58,58,0,54
Mattersburg,9856,6,11,8,17,45,55,-10,41
Admira Wacke,9856,7,11,6,19,37,58,-21,39
SV Josko Rie,9856,8,10,8,18,35,51,-16,38
RZ Pellets W,9856,9,10,8,18,43,63,-20,38
St. Pölten,9856,10,8,10,18,38,64,-26,34
FC Salzburg,9857,1,23,6,7,70,31,39,75
SC Rheindorf,9857,2,20,7,9,57,43,14,67
Vienna,9857,3,20,6,10,64,46,18,66
SK Sturm Gra,9857,4,17,9,10,61,39,22,60
Rapid Vienna,9857,5,12,11,13,52,43,9,47
Admira Wacke,9857,6,13,7,16,38,59,-21,46
RZ Pellets W,9857,7,11,9,16,49,61,-12,42
SV Josko Rie,9857,8,11,6,19,38,58,-20,39
St. Pölten,9857,9,8,9,19,41,61,-20,33
Mattersburg,9857,10,6,8,22,33,62,-29,26
FC Salzburg,9858,1,21,10,5,74,27,47,73
SK Sturm Gra,9858,2,18,10,8,60,33,27,64
SC Rheindorf,9858,3,19,7,10,53,46,7,64
Vienna,9858,4,18,7,11,65,52,13,61
RZ Pellets W,9858,5,12,12,12,47,50,-3,48
Rapid Vienna,9858,6,12,11,13,63,49,14,47
St. Pölten,9858,7,12,8,16,43,63,-20,44
Admira Wacke,9858,8,11,7,18,35,55,-20,40
SV Josko Rie,9858,9,9,5,22,33,62,-29,32
Mattersburg,9858,10,5,9,22,30,66,-36,24
FC Salzburg,9859,1,27,4,5,74,25,49,85
SC Rheindorf,9859,2,21,9,6,60,39,21,72
Vienna,9859,3,18,6,12,59,50,9,60
SK Sturm Gra,9859,4,16,7,13,54,38,16,55
Rapid Vienna,9859,5,14,11,11,51,40,11,53
RZ Pellets W,9859,6,13,9,14,48,54,-6,48
Admira Wacke,9859,7,10,6,20,35,63,-28,36
SV Josko Rie,9859,8,9,6,21,37,57,-20,33
St. Pölten,9859,9,6,12,18,43,65,-22,30
Mattersburg,9859,10,8,6,22,33,63,-30,30
FC Salzburg,9860,1,21,10,5,66,27,39,73
SK Sturm Gra,9860,2,22,5,9,61,33,28,71
SC Rheindorf,9860,3,18,9,9,60,46,14,63
Vienna,9860,4,19,4,13,68,54,14,61
Rapid Vienna,9860,5,14,10,12,53,38,15,52
RZ Pellets W,9860,6,10,10,16,37,48,-11,40
Admira Wacke,9860,7,11,7,18,30,58,-28,40
Mattersburg,9860,8,9,9,18,37,57,-20,36
SV Josko Rie,9860,9,9,6,21,31,54,-23,33
St. Pölten,9860,10,8,8,20,35,63,-28,32
FC Salzburg,9861,1,22,5,9,70,35,35,71
SC Rheindorf,9861,2,19,8,9,49,42,7,65
SK Sturm Gra,9861,3,19,5,12,63,34,29,62
Vienna,9861,4,17,4,15,57,56,1,55
Rapid Vienna,9861,5,11,13,12,50,40,10,46
Admira Wacke,9861,6,13,6,17,41,55,-14,45
Mattersburg,9861,7,11,9,16,40,52,-12,42
St. Pölten,9861,8,10,11,15,43,66,-23,41
RZ Pellets W,9861,9,10,8,18,50,61,-11,38
SV Josko Rie,9861,10,11,5,20,36,58,-22,38
FC Salzburg,9862,1,21,8,7,67,29,38,71
SC Rheindorf,9862,2,21,8,7,58,37,21,71
SK Sturm Gra,9862,3,19,5,12,55,35,20,62
Vienna,9862,4,18,6,12,55,48,7,60
RZ Pellets W,9862,5,15,8,13,50,51,-1,53
Rapid Vienna,9862,6,12,11,13,51,41,10,47
Admira Wacke,9862,7,10,7,19,35,63,-28,37
Mattersburg,9862,8,8,12,16,36,53,-17,36
SV Josko Rie,9862,9,10,5,21,30,53,-23,35
St. Pölten,9862,10,8,6,22,41,68,-27,30
SK Sturm Gra,9863,1,20,5,11,61,36,25,65
SC Rheindorf,9863,2,19,8,9,49,38,11,65
FC Salzburg,9863,3,17,12,7,66,38,28,63
Vienna,9863,4,17,5,14,61,54,7,56
Rapid Vienna,9863,5,13,12,11,57,47,10,51
RZ Pellets W,9863,6,14,7,15,49,52,-3,49
SV Josko Rie,9863,7,11,8,17,35,48,-13,41
Admira Wacke,9863,8,11,6,19,43,64,-21,39
St. Pölten,9863,9,9,9,18,38,64,-26,36
Mattersburg,9863,10,7,12,17,37,55,-18,33
FC Salzburg,9864,1,20,7,9,65,30,35,67
SC Rheindorf,9864,2,19,9,8,51,37,14,66
SK Sturm Gra,9864,3,18,8,10,61,32,29,62
Vienna,9864,4,19,5,12,66,49,17,62
Rapid Vienna,9864,5,15,9,12,48,40,8,54
Admira Wacke,9864,6,11,8,17,36,63,-27,41
SV Josko Rie,9864,7,11,7,18,38,50,-12,40
RZ Pellets W,9864,8,10,9,17,45,59,-14,39
Mattersburg,9864,9,9,10,17,39,54,-15,37
St. Pölten,9864,10,8,8,20,35,70,-35,32
FC Salzburg,9865,1,23,8,5,63,24,39,77
SC Rheindorf,9865,2,20,8,8,62,45,17,68
SK Sturm Gra,9865,3,20,5,11,57,32,25,65
Vienna,9865,4,19,4,13,59,55,4,61
Rapid Vienna,9865,5,15,8,13,54,38,16,53
RZ Pellets W,9865,6,12,8,16,48,54,-6,44
Mattersburg,9865,7,10,10,16,36,48,-12,40
Admira Wacke,9865,8,10,7,19,35,65,-30,37
SV Josko Rie,9865,9,9,4,23,32,57,-25,31
St. Pölten,9865,10,6,10,20,43,71,-28,28
FC Salzburg,9866,1,23,6,7,66,27,39,75
SK Sturm Gra,9866,2,22,6,8,64,31,33,72
Vienna,9866,3,18,7,11,70,49,21,61
SC Rheindorf,9866,4,16,12,8,59,48,11,60
Rapid Vienna,9866,5,14,10,12,57,47,10,52
St. Pölten,9866,6,11,9,16,41,62,-21,42
Admira Wacke,9866,7,11,7,18,36,61,-25,40
SV Josko Rie,9866,8,9,8,19,36,54,-18,35
RZ Pellets W,9866,9,8,10,18,42,62,-20,34
Mattersburg,9866,10,6,9,21,39,69,-30,27
SK Sturm Gra,9867,1,22,7,7,62,32,30,73
FC Salzburg,9867,2,19,11,6,65,33,32,68
Vienna,9867,3,19,5,12,68,53,15,62
SC Rheindorf,9867,4,16,10,10,52,45,7,58
Admira Wacke,9867,5,14,9,13,41,52,-11,51
Rapid Vienna,9867,6,12,11,13,51,43,8,47
Mattersburg,9867,7,10,9,17,46,58,-12,39
St. Pölten,9867,8,9,9,18,41,66,-25,36
RZ Pellets W,9867,9,8,8,20,40,60,-20,32
SV Josko Rie,9867,10,9,5,22,32,56,-24,32
SK Sturm Gra,9868,1,21,6,9,62,34,28,69
SC Rheindorf,9868,2,18,10,8,53,40,13,64
FC Salzburg,9868,3,18,9,9,55,30,25,63
Vienna,9868,4,19,5,12,62,44,18,62
Rapid Vienna,9868,5,17,9,10,56,36,20,60
RZ Pellets W,9868,6,11,8,17,44,55,-11,41
St. Pölten,9868,7,9,11,16,41,59,-18,38
SV Josko Rie,9868,8,11,5,20,37,58,-21,38
Mattersburg,9868,9,10,7,19,35,52,-17,37
Admira Wacke,9868,10,8,6,22,25,62,-37,30
FC Salzburg,9869,1,20,7,9,57,27,30,67
SK Sturm Gra,9869,2,19,8,9,60,30,30,65
Vienna,9869,3,20,5,11,64,48,16,65
SC Rheindorf,9869,4,17,9,10,53,44,9,60
RZ Pellets W,9869,5,15,5,16,44,56,-12,50
Rapid Vienna,9869,6,13,10,13,43,36,7,49
Admira Wacke,9869,7,14,4,18,38,51,-13,46
SV Josko Rie,9869,8,12,4,20,35,52,-17,40
St. Pölten,9869,9,9,10,17,41,59,-18,37
Mattersburg,9869,10,6,8,22,32,64,-32,26
SC Rheindorf,9870,1,25,5,6,59,38,21,80
SK Sturm Gra,9870,2,21,4,11,68,37,31,67
FC Salzburg,9870,3,20,6,10,57,31,26,66
Vienna,9870,4,19,5,12,63,45,18,62
RZ Pellets W,9870,5,13,7,16,46,58,-12,46
Rapid Vienna,9870,6,11,12,13,54,44,10,45
SV Josko Rie,9870,7,10,8,18,28,47,-19,38
Admira Wacke,9870,8,10,8,18,40,63,-23,38
Mattersburg,9870,9,9,8,19,41,60,-19,35
St. Pölten,9870,10,5,11,20,36,69,-33,26
SC Rheindorf,9871,1,24,6,6,73,41,32,78
FC Salzburg,9871,2,21,6,9,66,33,33,69
Vienna,9871,3,19,4,13,70,52,18,61
SK Sturm Gra,9871,4,18,5,13,57,40,17,59
Rapid Vienna,9871,5,15,10,11,59,43,16,55
RZ Pellets W,9871,6,11,9,16,43,57,-14,42
St. Pölten,9871,7,10,8,18,48,69,-21,38
SV Josko Rie,9871,8,10,6,20,33,60,-27,36
Admira Wacke,9871,9,11,3,22,38,72,-34,36
Mattersburg,9871,10,8,9,19,34,54,-20,33
FC Salzburg,9872,1,22,6,8,73,35,38,72
SC Rheindorf,9872,2,22,6,8,63,39,24,72
Vienna,9872,3,20,5,11,64,48,16,65
SK Sturm Gra,9872,4,17,6,13,61,41,20,57
Rapid Vienna,9872,5,13,10,13,51,48,3,49
Admira Wacke,9872,6,13,6,17,39,58,-19,45
SV Josko Rie,9872,7,11,6,19,37,54,-17,39
Mattersburg,9872,8,9,11,16,40,55,-15,38
RZ Pellets W,9872,9,10,7,19,42,64,-22,37
St. Pölten,9872,10,7,9,20,42,70,-28,30
FC Salzburg,9873,1,19,11,6,61,30,31,68
SC Rheindorf,9873,2,17,7,12,51,42,9,58
SK Sturm Gra,9873,3,17,5,14,55,44,11,56
Vienna,9873,4,17,5,14,60,54,6,56
Rapid Vienna,9873,5,14,11,11,61,43,18,53
RZ Pellets W,9873,6,13,7,16,40,54,-14,46
Admira Wacke,9873,7,12,8,16,42,56,-14,44
Mattersburg,9873,8,10,10,16,38,53,-15,40
St. Pölten,9873,9,9,12,15,44,59,-15,39
SV Josko Rie,9873,10,11,6,19,34,51,-17,39
FC Salzburg,9874,1,19,11,6,70,36,34,68
SC Rheindorf,9874,2,20,7,9,55,42,13,67
Vienna,9874,3,18,4,14,60,53,7,58
SK Sturm Gra,9874,4,17,6,13,63,44,19,57
Rapid Vienna,9874,5,13,10,13,52,41,11,49
Admira Wacke,9874,6,13,8,15,48,57,-9,47
RZ Pellets W,9874,7,13,7,16,48,59,-11,46
SV Josko Rie,9874,8,13,6,17,37,49,-12,45
St. Pölten,9874,9,8,11,17,41,68,-27,35
Mattersburg,9874,10,6,10,20,35,60,-25,28
FC Salzburg,9875,1,20,9,7,58,28,30,69
SK Sturm Gra,9875,2,19,6,11,57,39,18,63
SC Rheindorf,9875,3,19,6,11,54,40,14,63
Vienna,9875,4,19,4,13,60,50,10,61
Rapid Vienna,9875,5,13,11,12,53,44,9,50
Mattersburg,9875,6,13,9,14,47,46,1,48
St. Pölten,9875,7,11,9,16,40,58,-18,42
RZ Pellets W,9875,8,11,8,17,47,58,-11,41
Admira Wacke,9875,9,12,4,20,37,60,-23,40
SV Josko Rie,9875,10,8,4,24,28,58,-30,28
FC Salzburg,9876,1,22,5,9,65,25,40,71
Vienna,9876,2,21,6,9,69,46,23,69
SK Sturm Gra,9876,3,19,8,9,67,34,33,65
SC Rheindorf,9876,4,19,7,10,56,43,13,64
Rapid Vienna,9876,5,12,14,10,51,40,11,50
RZ Pellets W,9876,6,12,10,14,48,56,-8,46
Admira Wacke,9876,7,12,6,18,39,66,-27,42
SV Josko Rie,9876,8,9,6,21,41,70,-29,33
St. Pölten,9876,9,6,13,17,37,65,-28,31
Mattersburg,9876,10,6,9,21,36,64,-28,27
FC Salzburg,9877,1,23,5,8,63,28,35,74
SC Rheindorf,9877,2,19,7,10,56,42,14,64
Vienna,9877,3,18,7,11,70,53,17,61
SK Sturm Gra,9877,4,17,9,10,58,38,20,60
Rapid Vienna,9877,5,14,11,11,55,40,15,53
Admira Wacke,9877,6,11,8,17,36,57,-21,41
SV Josko Rie,9877,7,11,7,18,33,49,-16,40
RZ Pellets W,9877,8,11,5,20,41,62,-21,38
St. Pölten,9877,9,9,9,18,39,66,-27,36
Mattersburg,9877,10,9,8,19,35,51,-16,35
FC Salzburg,9878,1,20,6,10,62,34,28,66
SK Sturm Gra,9878,2,20,5,11,61,36,25,65
Vienna,9878,3,19,6,11,64,50,14,63
SC Rheindorf,9878,4,18,9,9,53,40,13,63
Rapid Vienna,9878,5,14,13,9,57,35,22,55
Admira Wacke,9878,6,14,5,17,36,61,-25,47
RZ Pellets W,9878,7,12,8,16,49,57,-8,44
St. Pölten,9878,8,9,8,19,41,66,-25,35
SV Josko Rie,9878,9,8,9,19,33,53,-20,33
Mattersburg,9878,10,7,9,20,36,60,-24,30
FC Salzburg,9879,1,21,8,7,68,33,35,71
SC Rheindorf,9879,2,21,7,8,54,37,17,70
Vienna,9879,3,19,7,10,61,47,14,64
SK Sturm Gra,9879,4,19,6,11,60,37,23,63
Rapid Vienna,9879,5,16,11,9,65,36,29,59
Admira Wacke,9879,6,12,6,18,34,57,-23,42
RZ Pellets W,9879,7,9,11,16,35,57,-22,38
St. Pölten,9879,8,8,10,18,45,63,-18,34
SV Josko Rie,9879,9,8,6,22,37,68,-31,30
Mattersburg,9879,10,7,8,21,34,58,-24,29
FC Salzburg,9880,1,22,7,7,67,30,37,73
SC Rheindorf,9880,2,19,8,9,59,44,15,65
SK Sturm Gra,9880,3,19,7,10,66,34,32,64
Vienna,9880,4,18,10,8,62,44,18,64
RZ Pellets W,9880,5,13,10,13,48,54,-6,49
Rapid Vienna,9880,6,12,11,13,47,40,7,47
Admira Wacke,9880,7,12,5,19,37,57,-20,41
St. Pölten,9880,8,11,6,19,48,72,-24,39
SV Josko Rie,9880,9,9,6,21,32,60,-28,33
Mattersburg,9880,10,6,8,22,36,67,-31,26
SK Sturm Gra,9881,1,22,4,10,57,35,22,70
FC Salzburg,9881,2,19,8,9,61,31,30,65
SC Rheindorf,9881,3,17,9,10,48,41,7,60
Vienna,9881,4,16,8,12,55,47,8,56
Rapid Vienna,9881,5,14,10,12,60,42,18,52
SV Josko Rie,9881,6,15,4,17,41,51,-10,49
Admira Wacke,9881,7,14,6,16,38,51,-13,48
RZ Pellets W,9881,8,11,7,18,44,59,-15,40
St. Pölten,9881,9,10,8,18,45,60,-15,38
Mattersburg,9881,10,6,8,22,30,62,-32,26
FC Salzburg,9882,1,24,6,6,69,31,38,78
SK Sturm Gra,9882,2,20,6,10,60,38,22,66
SC Rheindorf,9882,3,18,8,10,56,46,10,62
Vienna,9882,4,17,6,13,57,49,8,57
Rapid Vienna,9882,5,13,11,12,51,45,6,50
RZ Pellets W,9882,6,11,9,16,41,53,-12,42
St. Pölten,9882,7,10,10,16,46,59,-13,40
Admira Wacke,9882,8,9,11,16,31,50,-19,38
SV Josko Rie,9882,9,10,5,21,33,55,-22,35
Mattersburg,9882,10,8,8,20,35,53,-18,32
SK Sturm Gra,9883,1,24,3,9,69,29,40,75
FC Salzburg,9883,2,20,7,9,63,32,31,67
Rapid Vienna,9883,3,16,11,9,57,37,20,59
SC Rheindorf,9883,4,17,7,12,48,43,5,58
Vienna,9883,5,15,6,15,52,52,0,51
SV Josko Rie,9883,6,12,9,15,34,42,-8,45
RZ Pellets W,9883,7,13,5,18,41,54,-13,44
Admira Wacke,9883,8,11,5,20,31,59,-28,38
Mattersburg,9883,9,9,7,20,40,61,-21,34
St. Pölten,9883,10,8,10,18,32,58,-26,34
FC Salzburg,9884,1,20,7,9,68,32,36,67
SK Sturm Gra,9884,2,20,5,11,62,38,24,65
SC Rheindorf,9884,3,18,9,9,52,41,11,63
Vienna,9884,4,18,5,13,61,62,-1,59
Rapid Vienna,9884,5,16,9,11,70,46,24,57
RZ Pellets W,9884,6,14,7,15,55,63,-8,49
Admira Wacke,9884,7,12,6,18,40,61,-21,42
St. Pölten,9884,8,10,9,17,51,66,-15,39
SV Josko Rie,9884,9,10,8,18,40,55,-15,38
Mattersburg,9884,10,6,7,23,32,67,-35,25
FC Salzburg,9885,1,23,5,8,85,32,53,74
SK Sturm Gra,9885,2,20,7,9,63,36,27,67
SC Rheindorf,9885,3,18,9,9,58,48,10,63
Vienna,9885,4,17,4,15,57,56,1,55
Rapid Vienna,9885,5,11,15,10,55,46,9,48
SV Josko Rie,9885,6,13,6,17,36,48,-12,45
Admira Wacke,9885,7,12,4,20,40,61,-21,40
RZ Pellets W,9885,8,11,7,18,42,64,-22,40
St. Pölten,9885,9,10,9,17,44,65,-21,39
Mattersburg,9885,10,8,8,20,41,65,-24,32
SC Rheindorf,9886,1,24,5,7,59,33,26,77
FC Salzburg,9886,2,24,4,8,76,32,44,76
SK Sturm Gra,9886,3,17,9,10,52,32,20,60
Vienna,9886,4,17,4,15,63,55,8,55
Rapid Vienna,9886,5,14,9,13,57,45,12,51
RZ Pellets W,9886,6,13,7,16,42,55,-13,46
Mattersburg,9886,7,10,8,18,41,56,-15,38
Admira Wacke,9886,8,11,5,20,38,72,-34,38
SV Josko Rie,9886,9,10,5,21,34,56,-22,35
St. Pölten,9886,10,7,10,19,37,63,-26,31
SC Rheindorf,9887,1,23,4,9,54,39,15,73
SK Sturm Gra,9887,2,22,5,9,63,30,33,71
FC Salzburg,9887,3,18,7,11,61,36,25,61
Vienna,9887,4,18,6,12,61,49,12,60
Rapid Vienna,9887,5,15,10,11,55,36,19,55
RZ Pellets W,9887,6,10,8,18,38,56,-18,38
St. Pölten,9887,7,9,10,17,38,60,-22,37
Admira Wacke,9887,8,10,7,19,31,59,-28,37
Mattersburg,9887,9,9,9,18,36,56,-20,36
SV Josko Rie,9887,10,9,8,19,38,54,-16,35
FC Salzburg,9888,1,22,6,8,71,28,43,72
SK Sturm Gra,9888,2,22,6,8,61,28,33,72
SC Rheindorf,9888,3,20,7,9,55,39,16,67
Vienna,9888,4,16,6,14,53,51,2,54
Rapid Vienna,9888,5,14,11,11,52,40,12,53
RZ Pellets W,9888,6,10,10,16,41,54,-13,40
Mattersburg,9888,7,10,9,17,43,55,-12,39
Admira Wacke,9888,8,11,6,19,34,63,-29,39
SV Josko Rie,9888,9,10,6,20,32,53,-21,36
St. Pölten,9888,10,7,9,20,40,71,-31,30
FC Salzburg,9889,1,21,9,6,74,33,41,72
SK Sturm Gra,9889,2,20,6,10,60,32,28,66
SC Rheindorf,9889,3,19,7,10,59,43,16,64
Rapid Vienna,9889,4,16,7,13,59,43,16,55
Vienna,9889,5,17,4,15,55,56,-1,55
RZ Pellets W,9889,6,14,8,14,46,52,-6,50
St. Pölten,9889,7,11,10,15,44,57,-13,43
Admira Wacke,9889,8,11,6,19,36,63,-27,39
SV Josko Rie,9889,9,11,4,21,42,62,-20,37
Mattersburg,9889,10,6,7,23,36,70,-34,25
SC Rheindorf,9890,1,23,6,7,65,36,29,75
FC Salzburg,9890,2,22,7,7,73,28,45,73
SK Sturm Gra,9890,3,17,7,12,53,39,14,58
Vienna,9890,4,17,3,16,60,59,1,54
Rapid Vienna,9890,5,14,10,12,57,44,13,52
RZ Pellets W,9890,6,15,7,14,52,56,-4,52
Admira Wacke,9890,7,12,5,19,47,62,-15,41
SV Josko Rie,9890,8,12,2,22,34,66,-32,38
St. Pölten,9890,9,7,12,17,43,64,-21,33
Mattersburg,9890,10,8,7,21,39,69,-30,31
SC Rheindorf,9891,1,22,6,8,62,37,25,72
SK Sturm Gra,9891,2,20,7,9,65,31,34,67
FC Salzburg,9891,3,19,10,7,64,41,23,67
Rapid Vienna,9891,4,16,11,9,64,38,26,59
Vienna,9891,5,17,8,11,64,57,7,59
Admira Wacke,9891,6,12,6,18,41,68,-27,42
RZ Pellets W,9891,7,11,7,18,46,63,-17,40
SV Josko Rie,9891,8,11,4,21,35,56,-21,37
St. Pölten,9891,9,7,11,18,37,56,-19,32
Mattersburg,9891,10,7,6,23,31,62,-31,27
FC Salzburg,9892,1,21,8,7,66,29,37,71
SK Sturm Gra,9892,2,22,4,10,60,30,30,70
SC Rheindorf,9892,3,19,8,9,52,38,14,65
Vienna,9892,4,18,5,13,63,54,9,59
Rapid Vienna,9892,5,16,9,11,57,33,24,57
RZ Pellets W,9892,6,14,7,15,45,58,-13,49
St. Pölten,9892,7,9,11,16,45,60,-15,38
Admira Wacke,9892,8,10,7,19,37,66,-29,37
Mattersburg,9892,9,7,8,21,32,62,-30,29
SV Josko Rie,9892,10,7,7,22,30,57,-27,28
SC Rheindorf,9893,1,22,8,6,59,36,23,74
FC Salzburg,9893,2,18,10,8,58,32,26,64
Rapid Vienna,9893,3,16,12,8,56,33,23,60
Vienna,9893,4,17,5,14,57,52,5,56
SK Sturm Gra,9893,5,16,6,14,56,39,17,54
Admira Wacke,9893,6,13,5,18,35,53,-18,44
SV Josko Rie,9893,7,12,6,18,32,49,-17,42
RZ Pellets W,9893,8,11,7,18,43,53,-10,40
Mattersburg,9893,9,9,10,17,41,58,-17,37
St. Pölten,9893,10,8,7,21,36,68,-32,31
FC Salzburg,9894,1,27,4,5,79,23,56,85
SK Sturm Gra,9894,2,21,6,9,70,36,34,69
SC Rheindorf,9894,3,18,7,11,52,51,1,61
Rapid Vienna,9894,4,13,11,12,56,52,4,50
Vienna,9894,5,14,8,14,52,54,-2,50
RZ Pellets W,9894,6,12,9,15,51,59,-8,45
Admira Wacke,9894,7,11,5,20,36,61,-25,38
Mattersburg,9894,8,10,7,19,39,58,-19,37
SV Josko Rie,9894,9,10,5,21,35,54,-19,35
St. Pölten,9894,10,9,8,19,50,72,-22,35
SC Rheindorf,9895,1,19,9,8,55,41,14,66
FC Salzburg,9895,2,19,7,10,61,34,27,64
Rapid Vienna,9895,3,18,7,11,62,44,18,61
SK Sturm Gra,9895,4,18,6,12,66,45,21,60
Vienna,9895,5,18,4,14,52,47,5,58
RZ Pellets W,9895,6,12,7,17,42,53,-11,43
St. Pölten,9895,7,10,11,15,48,60,-12,41
Admira Wacke,9895,8,12,4,20,36,61,-25,40
Mattersburg,9895,9,9,9,18,39,56,-17,36
SV Josko Rie,9895,10,10,6,20,31,51,-20,36
FC Salzburg,9896,1,22,6,8,68,30,38,72
SC Rheindorf,9896,2,21,7,8,58,40,18,70
SK Sturm Gra,9896,3,17,7,12,52,35,17,58
Vienna,9896,4,17,6,13,57,50,7,57
Rapid Vienna,9896,5,16,7,13,62,45,17,55
RZ Pellets W,9896,6,12,7,17,40,49,-9,43
Admira Wacke,9896,7,12,6,18,40,62,-22,42
SV Josko Rie,9896,8,12,5,19,35,52,-17,41
Mattersburg,9896,9,10,8,18,35,56,-21,38
St. Pölten,9896,10,8,7,21,42,70,-28,31
FC Salzburg,9897,1,22,8,6,70,32,38,74
SK Sturm Gra,9897,2,20,7,9,58,32,26,67
SC Rheindorf,9897,3,20,7,9,59,43,16,67
Vienna,9897,4,16,6,14,62,54,8,54
Rapid Vienna,9897,5,12,11,13,50,39,11,47
St. Pölten,9897,6,10,12,14,40,56,-16,42
Admira Wacke,9897,7,12,5,19,37,67,-30,41
SV Josko Rie,9897,8,11,7,18,39,49,-10,40
RZ Pellets W,9897,9,9,8,19,41,64,-23,35
Mattersburg,9897,10,9,7,20,40,60,-20,34
FC Salzburg,9898,1,22,8,6,64,28,36,74
SC Rheindorf,9898,2,19,9,8,61,43,18,66
Vienna,9898,3,20,2,14,63,54,9,62
SK Sturm Gra,9898,4,16,10,10,53,33,20,58
Rapid Vienna,9898,5,15,10,11,55,43,12,55
RZ Pellets W,9898,6,12,9,15,47,53,-6,45
SV Josko Rie,9898,7,11,4,21,32,49,-17,37
Admira Wacke,9898,8,9,10,17,37,57,-20,37
St. Pölten,9898,9,9,9,18,35,61,-26,36
Mattersburg,9898,10,8,7,21,34,60,-26,31
SC Rheindorf,9899,1,21,11,4,60,31,29,74
FC Salzburg,9899,2,22,5,9,69,35,34,71
Vienna,9899,3,18,5,13,64,51,13,59
SK Sturm Gra,9899,4,16,10,10,55,32,23,58
Rapid Vienna,9899,5,13,11,12,55,42,13,50
Mattersburg,9899,6,11,9,16,45,58,-13,42
Admira Wacke,9899,7,11,8,17,39,57,-18,41
RZ Pellets W,9899,8,11,5,20,41,65,-24,38
SV Josko Rie,9899,9,10,7,19,34,53,-19,37
St. Pölten,9899,10,7,9,20,37,75,-38,30
SC Rheindorf,9900,1,21,6,9,59,45,14,69
SK Sturm Gra,9900,2,21,4,11,60,39,21,67
FC Salzburg,9900,3,18,10,8,69,34,35,64
Vienna,9900,4,18,6,12,66,53,13,60
Rapid Vienna,9900,5,16,10,10,54,36,18,58
Admira Wacke,9900,6,11,7,18,41,62,-21,40
RZ Pellets W,9900,7,10,8,18,42,59,-17,38
SV Josko Rie,9900,8,11,4,21,35,56,-21,37
Mattersburg,9900,9,8,11,17,39,56,-17,35
St. Pölten,9900,10,9,8,19,41,66,-25,35
FC Salzburg,9901,1,23,8,5,68,27,41,77
SK Sturm Gra,9901,2,21,8,7,61,28,33,71
SC Rheindorf,9901,3,19,9,8,66,42,24,66
Rapid Vienna,9901,4,13,11,12,57,45,12,50
Vienna,9901,5,14,8,14,55,61,-6,50
Admira Wacke,9901,6,15,4,17,38,59,-21,49
RZ Pellets W,9901,7,12,6,18,39,54,-15,42
Mattersburg,9901,8,11,6,19,39,59,-20,39
St. Pölten,9901,9,7,9,20,36,59,-23,30
SV Josko Rie,9901,10,7,7,22,30,55,-25,28
FC Salzburg,9902,1,21,7,8,68,40,28,70
Vienna,9902,2,20,8,8,73,47,26,68
SC Rheindorf,9902,3,18,6,12,51,47,4,60
SK Sturm Gra,9902,4,16,8,12,52,37,15,56
Rapid Vienna,9902,5,14,10,12,56,40,16,52
RZ Pellets W,9902,6,12,9,15,48,60,-12,45
Admira Wacke,9902,7,13,6,17,46,63,-17,45
St. Pölten,9902,8,10,11,15,43,56,-13,41
SV Josko Rie,9902,9,8,10,18,32,54,-22,34
Mattersburg,9902,10,5,11,20,35,60,-25,26
FC Salzburg,9903,1,22,9,5,64,26,38,75
SK Sturm Gra,9903,2,19,6,11,61,37,24,63
SC Rheindorf,9903,3,18,8,10,51,41,10,62
Vienna,9903,4,16,10,10,57,47,10,58
RZ Pellets W,9903,5,15,6,15,48,51,-3,51
Rapid Vienna,9903,6,13,10,13,49,43,6,49
Admira Wacke,9903,7,12,6,18,38,57,-19,42
SV Josko Rie,9903,8,11,5,20,32,55,-23,38
Mattersburg,9903,9,8,10,18,40,56,-16,34
St. Pölten,9903,10,6,10,20,39,66,-27,28
FC Salzburg,9904,1,20,7,9,60,34,26,67
Vienna,9904,2,20,5,11,66,44,22,65
SK Sturm Gra,9904,3,19,4,13,57,32,25,61
SC Rheindorf,9904,4,17,8,11,54,48,6,59
Admira Wacke,9904,5,14,7,15,45,56,-11,49
Rapid Vienna,9904,6,12,10,14,47,42,5,46
Mattersburg,9904,7,12,8,16,45,56,-11,44
RZ Pellets W,9904,8,11,9,16,47,58,-11,42
SV Josko Rie,9904,9,12,5,19,34,57,-23,41
St. Pölten,9904,10,7,9,20,45,73,-28,30
FC Salzburg,9905,1,23,4,9,68,36,32,73
SK Sturm Gra,9905,2,20,5,11,62,37,25,65
SC Rheindorf,9905,3,18,8,10,60,45,15,62
Vienna,9905,4,19,5,12,60,52,8,62
Rapid Vienna,9905,5,14,10,12,54,40,14,52
RZ Pellets W,9905,6,14,6,16,49,57,-8,48
Admira Wacke,9905,7,13,6,17,37,53,-16,45
SV Josko Rie,9905,8,10,6,20,37,56,-19,36
St. Pölten,9905,9,9,7,20,44,66,-22,34
Mattersburg,9905,10,8,7,21,30,59,-29,31
SK Sturm Gra,9906,1,20,7,9,58,30,28,67
SC Rheindorf,9906,2,19,8,9,52,44,8,65
Rapid Vienna,9906,3,18,10,8,68,38,30,64
FC Salzburg,9906,4,18,10,8,60,36,24,64
Vienna,9906,5,17,6,13,58,52,6,57
RZ Pellets W,9906,6,11,9,16,44,52,-8,42
Mattersburg,9906,7,10,9,17,41,53,-12,39
SV Josko Rie,9906,8,11,5,20,34,54,-20,38
Admira Wacke,9906,9,10,7,19,33,57,-24,37
St. Pölten,9906,10,6,9,21,34,66,-32,27
FC Salzburg,9907,1,24,5,7,70,29,41,77
SK Sturm Gra,9907,2,21,8,7,62,31,31,71
SC Rheindorf,9907,3,17,9,10,52,43,9,60
Vienna,9907,4,17,7,12,67,59,8,58
Rapid Vienna,9907,5,12,12,12,57,45,12,48
St. Pölten,9907,6,11,9,16,43,59,-16,42
RZ Pellets W,9907,7,10,9,17,46,59,-13,39
SV Josko Rie,9907,8,11,5,20,39,53,-14,38
Admira Wacke,9907,9,9,8,19,38,69,-31,35
Mattersburg,9907,10,7,10,19,41,68,-27,31
FC Salzburg,9908,1,23,7,6,64,29,35,76
SC Rheindorf,9908,2,20,7,9,56,42,14,67
SK Sturm Gra,9908,3,19,7,10,51,29,22,64
Vienna,9908,4,17,7,12,65,51,14,58
Rapid Vienna,9908,5,14,11,11,60,43,17,53
Mattersburg,9908,6,11,7,18,47,54,-7,40
RZ Pellets W,9908,7,10,9,17,45,66,-21,39
Admira Wacke,9908,8,10,7,19,41,62,-21,37
SV Josko Rie,9908,9,11,4,21,34,56,-22,37
St. Pölten,9908,10,6,12,18,34,65,-31,30
SC Rheindorf,9909,1,21,8,7,59,43,16,71
FC Salzburg,9909,2,21,6,9,70,42,28,69
Rapid Vienna,9909,3,20,8,8,71,34,37,68
SK Sturm Gra,9909,4,19,6,11,60,43,17,63
Vienna,9909,5,19,3,14,64,54,10,60
St. Pölten,9909,6,11,9,16,47,58,-11,42
RZ Pellets W,9909,7,12,6,18,42,56,-14,42
SV Josko Rie,9909,8,10,5,21,34,57,-23,35
Admira Wacke,9909,9,7,8,21,30,60,-30,29
Mattersburg,9909,10,7,7,22,36,66,-30,28
SK Sturm Gra,9910,1,21,6,9,70,37,33,69
FC Salzburg,9910,2,20,8,8,62,32,30,68
SC Rheindorf,9910,3,21,5,10,60,43,17,68
Vienna,9910,4,20,4,12,67,56,11,64
Admira Wacke,9910,5,14,5,17,39,56,-17,47
RZ Pellets W,9910,6,13,6,17,43,55,-12,45
Rapid Vienna,9910,7,11,11,14,47,48,-1,44
St. Pölten,9910,8,10,9,17,42,60,-18,39
Mattersburg,9910,9,9,8,19,32,48,-16,35
SV Josko Rie,9910,10,8,4,24,31,58,-27,28
FC Salzburg,9911,1,21,8,7,63,29,34,71
SK Sturm Gra,9911,2,18,8,10,56,35,21,62
Vienna,9911,3,18,6,12,59,49,10,60
SC Rheindorf,9911,4,17,5,14,58,49,9,56
Rapid Vienna,9911,5,14,10,12,58,46,12,52
Admira Wacke,9911,6,14,6,16,43,53,-10,48
RZ Pellets W,9911,7,12,6,18,39,59,-20,42
Mattersburg,9911,8,10,10,16,34,46,-12,40
St. Pölten,9911,9,8,12,16,39,61,-22,36
SV Josko Rie,9911,10,11,3,22,31,53,-22,36
FC Salzburg,9912,1,21,7,8,71,36,35,70
SK Sturm Gra,9912,2,20,7,9,61,36,25,67
SC Rheindorf,9912,3,17,8,11,50,43,7,59
Vienna,9912,4,17,3,16,60,54,6,54
RZ Pellets W,9912,5,15,5,16,53,56,-3,50
SV Josko Rie,9912,6,15,5,16,42,47,-5,50
Rapid Vienna,9912,7,12,12,12,58,47,11,48
Admira Wacke,9912,8,10,9,17,40,69,-29,39
Mattersburg,9912,9,9,10,17,41,59,-18,37
St. Pölten,9912,10,6,10,20,32,61,-29,28
FC Salzburg,9913,1,23,8,5,80,28,52,77
SK Sturm Gra,9913,2,21,5,10,64,36,28,68
SC Rheindorf,9913,3,19,8,9,48,40,8,65
Vienna,9913,4,18,4,14,59,56,3,58
Rapid Vienna,9913,5,12,10,14,51,43,8,46
RZ Pellets W,9913,6,11,10,15,41,54,-13,43
Admira Wacke,9913,7,11,7,18,33,65,-32,40
SV Josko Rie,9913,8,11,5,20,39,54,-15,38
Mattersburg,9913,9,8,11,17,38,50,-12,35
St. Pölten,9913,10,6,12,18,41,68,-27,30
FC Salzburg,9914,1,22,6,8,64,26,38,72
SK Sturm Gra,9914,2,21,6,9,64,32,32,69
SC Rheindorf,9914,3,21,6,9,59,41,18,69
Vienna,9914,4,20,3,13,52,47,5,63
Rapid Vienna,9914,5,15,9,12,53,44,9,54
RZ Pellets W,9914,6,12,8,16,47,61,-14,44
St. Pölten,9914,7,11,10,15,43,55,-12,43
SV Josko Rie,9914,8,10,3,23,28,52,-24,33
Admira Wacke,9914,9,10,3,23,35,63,-28,33
Mattersburg,9914,10,7,8,21,33,57,-24,29
FC Salzburg,9915,1,22,9,5,69,28,41,75
SK Sturm Gra,9915,2,21,7,8,60,24,36,70
SC Rheindorf,9915,3,18,10,8,60,45,15,64
Vienna,9915,4,17,7,12,55,50,5,58
Rapid Vienna,9915,5,15,10,11,57,40,17,55
RZ Pellets W,9915,6,12,5,19,45,61,-16,41
SV Josko Rie,9915,7,10,8,18,35,51,-16,38
Admira Wacke,9915,8,10,5,21,34,64,-30,35
Mattersburg,9915,9,9,7,20,44,62,-18,34
St. Pölten,9915,10,7,10,19,37,71,-34,31
FC Salzburg,9916,1,22,4,10,62,33,29,70
SC Rheindorf,9916,2,20,6,10,59,45,14,66
Vienna,9916,3,19,5,12,59,51,8,62
Rapid Vienna,9916,4,17,9,10,58,38,20,60
SK Sturm Gra,9916,5,14,8,14,56,41,15,50
Admira Wacke,9916,6,12,7,17,38,54,-16,43
Mattersburg,9916,7,11,9,16,45,58,-13,42
RZ Pellets W,9916,8,10,10,16,41,52,-11,40
St. Pölten,9916,9,9,10,17,43,59,-16,37
SV Josko Rie,9916,10,9,6,21,29,59,-30,33
FC Salzburg,9917,1,20,8,8,63,30,33,68
SC Rheindorf,9917,2,20,7,9,55,39,16,67
SK Sturm Gra,9917,3,18,7,11,55,39,16,61
Vienna,9917,4,18,6,12,61,51,10,60
RZ Pellets W,9917,5,12,8,16,52,60,-8,44
Admira Wacke,9917,6,12,6,18,44,65,-21,42
Rapid Vienna,9917,7,9,13,14,52,54,-2,40
SV Josko Rie,9917,8,11,7,18,33,49,-16,40
Mattersburg,9917,9,10,9,17,43,56,-13,39
St. Pölten,9917,10,8,13,15,47,62,-15,37
FC Salzburg,9918,1,24,5,7,74,34,40,77
SC Rheindorf,9918,2,19,10,7,56,39,17,67
SK Sturm Gra,9918,3,20,6,10,63,39,24,66
Vienna,9918,4,16,4,16,50,48,2,52
Rapid Vienna,9918,5,13,12,11,57,41,16,51
RZ Pellets W,9918,6,13,7,16,46,49,-3,46
Admira Wacke,9918,7,12,6,18,34,57,-23,42
St. Pölten,9918,8,10,9,17,43,63,-20,39
Mattersburg,9918,9,9,9,18,35,55,-20,36
SV Josko Rie,9918,10,8,4,24,26,59,-33,28
SC Rheindorf,9919,1,20,8,8,61,45,16,68
FC Salzburg,9919,2,20,7,9,62,40,22,67
SK Sturm Gra,9919,3,19,8,9,52,30,22,65
Vienna,9919,4,19,3,14,65,53,12,60
Rapid Vienna,9919,5,16,11,9,56,35,21,59
RZ Pellets W,9919,6,14,8,14,45,48,-3,50
St. Pölten,9919,7,9,10,17,39,60,-21,37
SV Josko Rie,9919,8,10,5,21,31,51,-20,35
Admira Wacke,9919,9,9,8,19,35,58,-23,35
Mattersburg,9919,10,5,10,21,33,59,-26,25
FC Salzburg,9920,1,23,6,7,66,30,36,75
SC Rheindorf,9920,2,20,10,6,58,33,25,70
Rapid Vienna,9920,3,16,10,10,56,37,19,58
Vienna,9920,4,17,6,13,65,53,12,57
SK Sturm Gra,9920,5,16,9,11,59,48,11,57
RZ Pellets W,9920,6,12,8,16,47,61,-14,44
Admira Wacke,9920,7,11,5,20,33,58,-25,38
SV Josko Rie,9920,8,9,7,20,37,55,-18,34
St. Pölten,9920,9,8,10,18,42,64,-22,34
Mattersburg,9920,10,9,7,20,38,62,-24,34
SC Rheindorf,9921,1,20,9,7,52,34,18,69
FC Salzburg,9921,2,18,8,10,59,37,22,62
SK Sturm Gra,9921,3,19,5,12,58,37,21,62
Vienna,9921,4,17,7,12,63,53,10,58
Rapid Vienna,9921,5,14,11,11,52,36,16,53
RZ Pellets W,9921,6,14,9,13,53,53,0,51
Admira Wacke,9921,7,10,9,17,35,60,-25,39
SV Josko Rie,9921,8,11,5,20,35,57,-22,38
Mattersburg,9921,9,9,8,19,37,56,-19,35
St. Pölten,9921,10,8,9,19,48,69,-21,33
FC Salzburg,9922,1,23,6,7,67,28,39,75
SC Rheindorf,9922,2,20,10,6,60,40,20,70
Vienna,9922,3,18,7,11,59,46,13,61
SK Sturm Gra,9922,4,16,9,11,61,38,23,57
Rapid Vienna,9922,5,13,14,9,54,40,14,53
RZ Pellets W,9922,6,12,11,13,46,51,-5,47
Admira Wacke,9922,7,10,7,19,39,62,-23,37
SV Josko Rie,9922,8,9,9,18,39,59,-20,36
Mattersburg,9922,9,5,13,18,34,59,-25,28
St. Pölten,9922,10,6,10,20,38,74,-36,28
SC Rheindorf,9923,1,21,9,6,56,36,20,72
SK Sturm Gra,9923,2,20,8,8,56,28,28,68
FC Salzburg,9923,3,19,8,9,59,27,32,65
Vienna,9923,4,17,6,13,60,51,9,57
Rapid Vienna,9923,5,13,12,11,52,41,11,51
Admira Wacke,9923,6,12,7,17,39,56,-17,43
Mattersburg,9923,7,11,8,17,42,52,-10,41
SV Josko Rie,9923,8,12,4,20,32,49,-17,40
RZ Pellets W,9923,9,10,6,20,39,64,-25,36
St. Pölten,9923,10,6,10,20,37,68,-31,28
FC Salzburg,9924,1,19,10,7,64,37,27,67
Vienna,9924,2,21,3,12,69,51,18,66
SK Sturm Gra,9924,3,19,8,9,60,33,27,65
SC Rheindorf,9924,4,17,7,12,58,49,9,58
Rapid Vienna,9924,5,14,11,11,54,46,8,53
RZ Pellets W,9924,6,12,8,16,41,52,-11,44
SV Josko Rie,9924,7,12,7,17,42,52,-10,43
Mattersburg,9924,8,10,9,17,43,58,-15,39
Admira Wacke,9924,9,9,10,17,37,61,-24,37
St. Pölten,9924,10,5,11,20,39,68,-29,26
SC Rheindorf,9925,1,21,6,9,60,39,21,69
Vienna,9925,2,21,3,12,68,49,19,66
FC Salzburg,9925,3,18,11,7,59,33,26,65
SK Sturm Gra,9925,4,17,6,13,54,39,15,57
Rapid Vienna,9925,5,13,13,10,54,37,17,52
SV Josko Rie,9925,6,14,6,16,42,49,-7,48
RZ Pellets W,9925,7,12,10,14,52,56,-4,46
Admira Wacke,9925,8,10,7,19,34,65,-31,37
St. Pölten,9925,9,8,8,20,43,71,-28,32
Mattersburg,9925,10,6,10,20,31,59,-28,28
FC Salzburg,9926,1,21,8,7,63,28,35,71
SK Sturm Gra,9926,2,19,6,11,61,37,24,63
SC Rheindorf,9926,3,19,6,11,50,45,5,63
Rapid Vienna,9926,4,16,10,10,60,38,22,58
Vienna,9926,5,17,6,13,56,47,9,57
RZ Pellets W,9926,6,12,9,15,45,52,-7,45
Admira Wacke,9926,7,12,7,17,40,60,-20,43
St. Pölten,9926,8,8,11,17,44,63,-19,35
Mattersburg,9926,9,8,9,19,39,63,-24,33
SV Josko Rie,9926,10,9,6,21,31,56,-25,33
FC Salzburg,9927,1,21,8,7,66,32,34,71
SK Sturm Gra,9927,2,19,9,8,60,29,31,66
SC Rheindorf,9927,3,17,10,9,53,44,9,61
Vienna,9927,4,18,4,14,63,63,0,58
Rapid Vienna,9927,5,15,12,9,54,32,22,57
RZ Pellets W,9927,6,11,9,16,50,59,-9,42
Admira Wacke,9927,7,10,7,19,39,59,-20,37
Mattersburg,9927,8,9,9,18,39,60,-21,36
SV Josko Rie,9927,9,11,3,22,34,57,-23,36
St. Pölten,9927,10,8,11,17,40,63,-23,35
FC Salzburg,9928,1,25,5,6,77,31,46,80
SC Rheindorf,9928,2,21,6,9,57,43,14,69
RZ Pellets W,9928,3,19,6,11,56,48,8,63
Rapid Vienna,9928,4,15,10,11,60,43,17,55
SK Sturm Gra,9928,5,17,4,15,60,46,14,55
Vienna,9928,6,14,5,17,60,62,-2,47
Admira Wacke,9928,7,13,5,18,37,59,-22,44
SV Josko Rie,9928,8,11,6,19,38,58,-20,39
St. Pölten,9928,9,6,10,20,38,68,-30,28
Mattersburg,9928,10,5,11,20,39,64,-25,26
SK Sturm Gra,9929,1,22,5,9,65,26,39,71
FC Salzburg,9929,2,21,7,8,65,29,36,70
SC Rheindorf,9929,3,21,7,8,59,39,20,70
Vienna,9929,4,19,4,13,70,55,15,61
Rapid Vienna,9929,5,12,12,12,48,41,7,48
RZ Pellets W,9929,6,13,6,17,43,53,-10,45
SV Josko Rie,9929,7,12,4,20,37,55,-18,40
St. Pölten,9929,8,10,8,18,44,72,-28,38
Admira Wacke,9929,9,9,8,19,29,59,-30,35
Mattersburg,9929,10,6,9,21,31,62,-31,27
SK Sturm Gra,9930,1,22,5,9,62,28,34,71
FC Salzburg,9930,2,21,7,8,72,32,40,70
SC Rheindorf,9930,3,18,6,12,54,45,9,60
Vienna,9930,4,17,3,16,56,60,-4,54
Rapid Vienna,9930,5,13,10,13,58,48,10,49
RZ Pellets W,9930,6,13,7,16,45,57,-12,46
Admira Wacke,9930,7,12,7,17,37,63,-26,43
St. Pölten,9930,8,10,11,15,47,64,-17,41
SV Josko Rie,9930,9,10,6,20,33,49,-16,36
Mattersburg,9930,10,8,10,18,40,58,-18,34
FC Salzburg,9931,1,22,6,8,70,36,34,72
SC Rheindorf,9931,2,20,9,7,61,45,16,69
SK Sturm Gra,9931,3,19,5,12,62,39,23,62
Rapid Vienna,9931,4,17,8,11,65,40,25,59
Vienna,9931,5,18,3,15,63,55,8,57
SV Josko Rie,9931,6,12,6,18,40,51,-11,42
RZ Pellets W,9931,7,11,8,17,44,59,-15,41
Admira Wacke,9931,8,10,5,21,34,59,-25,35
Mattersburg,9931,9,9,8,19,43,69,-26,35
St. Pölten,9931,10,9,8,19,40,69,-29,35
FC Salzburg,9932,1,21,5,10,68,33,35,68
Rapid Vienna,9932,2,18,8,10,58,35,23,62
SK Sturm Gra,9932,3,18,7,11,60,40,20,61
Vienna,9932,4,19,4,13,63,52,11,61
SC Rheindorf,9932,5,18,6,12,58,43,15,60
Admira Wacke,9932,6,13,8,15,38,55,-17,47
RZ Pellets W,9932,7,12,6,18,44,55,-11,42
St. Pölten,9932,8,11,8,17,41,59,-18,41
SV Josko Rie,9932,9,9,7,20,28,58,-30,34
Mattersburg,9932,10,7,9,20,33,61,-28,30
Vienna,9933,1,20,6,10,66,49,17,66
FC Salzburg,9933,2,18,9,9,57,31,26,63
Rapid Vienna,9933,3,16,12,8,53,32,21,60
SK Sturm Gra,9933,4,17,9,10,57,42,15,60
SC Rheindorf,9933,5,17,9,10,47,39,8,60
RZ Pellets W,9933,6,12,10,14,52,58,-6,46
St. Pölten,9933,7,10,11,15,44,53,-9,41
Admira Wacke,9933,8,11,8,17,36,56,-20,41
SV Josko Rie,9933,9,9,8,19,30,51,-21,35
Mattersburg,9933,10,5,8,23,25,56,-31,23
FC Salzburg,9934,1,21,8,7,64,28,36,71
Vienna,9934,2,18,5,13,59,51,8,59
SC Rheindorf,9934,3,17,7,12,50,42,8,58
Rapid Vienna,9934,4,15,11,10,57,38,19,56
SK Sturm Gra,9934,5,17,3,16,55,43,12,54
SV Josko Rie,9934,6,15,4,17,40,52,-12,49
Admira Wacke,9934,7,14,6,16,37,54,-17,48
RZ Pellets W,9934,8,13,6,17,49,58,-9,45
St. Pölten,9934,9,9,9,18,36,61,-25,36
Mattersburg,9934,10,8,7,21,39,59,-20,31
FC Salzburg,9935,1,23,7,6,64,25,39,76
SK Sturm Gra,9935,2,23,3,10,65,34,31,72
SC Rheindorf,9935,3,21,6,9,59,45,14,69
Vienna,9935,4,17,5,14,66,57,9,56
Rapid Vienna,9935,5,14,11,11,60,46,14,53
RZ Pellets W,9935,6,12,6,18,48,58,-10,42
Mattersburg,9935,7,10,9,17,32,46,-14,39
Admira Wacke,9935,8,10,7,19,36,61,-25,37
St. Pölten,9935,9,8,8,20,42,70,-28,32
SV Josko Rie,9935,10,8,6,22,29,59,-30,30
FC Salzburg,9936,1,21,8,7,70,35,35,71
SC Rheindorf,9936,2,21,6,9,59,42,17,69
Vienna,9936,3,21,4,11,64,52,12,67
SK Sturm Gra,9936,4,17,5,14,55,41,14,56
RZ Pellets W,9936,5,12,9,15,46,55,-9,45
Rapid Vienna,9936,6,11,11,14,55,45,10,44
Admira Wacke,9936,7,13,5,18,39,54,-15,44
St. Pölten,9936,8,10,9,17,49,59,-10,39
SV Josko Rie,9936,9,12,3,21,32,55,-23,39
Mattersburg,9936,10,9,6,21,37,68,-31,33
SC Rheindorf,9937,1,22,8,6,64,37,27,74
FC Salzburg,9937,2,19,8,9,59,29,30,65
SK Sturm Gra,9937,3,17,9,10,54,38,16,60
Vienna,9937,4,19,3,14,59,49,10,60
Rapid Vienna,9937,5,14,11,11,51,39,12,53
SV Josko Rie,9937,6,13,5,18,43,55,-12,44
RZ Pellets W,9937,7,11,6,19,44,61,-17,39
Admira Wacke,9937,8,11,6,19,40,63,-23,39
Mattersburg,9937,9,9,8,19,38,60,-22,35
St. Pölten,9937,10,7,12,17,34,55,-21,33
SK Sturm Gra,9938,1,21,5,10,59,29,30,68
SC Rheindorf,9938,2,20,7,9,56,42,14,67
FC Salzburg,9938,3,20,6,10,64,35,29,66
Vienna,9938,4,20,4,12,67,53,14,64
Rapid Vienna,9938,5,18,7,11,59,38,21,61
RZ Pellets W,9938,6,12,8,16,49,57,-8,44
Admira Wacke,9938,7,12,7,17,37,55,-18,43
SV Josko Rie,9938,8,11,5,20,34,57,-23,38
Mattersburg,9938,9,8,7,21,39,67,-28,31
St. Pölten,9938,10,7,6,23,38,69,-31,27
SK Sturm Gra,9939,1,20,8,8,59,29,30,68
SC Rheindorf,9939,2,20,5,11,54,46,8,65
FC Salzburg,9939,3,19,7,10,69,39,30,64
Rapid Vienna,9939,4,15,12,9,65,41,24,57
Vienna,9939,5,16,7,13,66,55,11,55
Admira Wacke,9939,6,13,5,18,34,58,-24,44
RZ Pellets W,9939,7,11,9,16,46,59,-13,42
SV Josko Rie,9939,8,10,7,19,33,52,-19,37
Mattersburg,9939,9,9,10,17,38,58,-20,37
St. Pölten,9939,10,8,8,20,36,63,-27,32
FC Salzburg,9940,1,22,10,4,69,29,40,76
SC Rheindorf,9940,2,17,13,6,52,39,13,64
SK Sturm Gra,9940,3,19,4,13,59,40,19,61
Vienna,9940,4,17,5,14,57,52,5,56
Rapid Vienna,9940,5,12,14,10,53,42,11,50
Admira Wacke,9940,6,14,7,15,44,52,-8,49
SV Josko Rie,9940,7,10,7,19,31,49,-18,37
RZ Pellets W,9940,8,9,9,18,44,62,-18,36
Mattersburg,9940,9,8,11,17,39,57,-18,35
St. Pölten,9940,10,8,8,20,39,65,-26,32
FC Salzburg,9941,1,24,6,6,64,26,38,78
SK Sturm Gra,9941,2,21,7,8,64,27,37,70
SC Rheindorf,9941,3,20,6,10,56,45,11,66
Rapid Vienna,9941,4,15,12,9,61,41,20,57
Vienna,9941,5,16,4,16,57,57,0,52
RZ Pellets W,9941,6,13,6,17,49,56,-7,45
SV Josko Rie,9941,7,13,6,17,40,52,-12,45
Admira Wacke,9941,8,10,8,18,35,60,-25,38
Mattersburg,9941,9,9,5,22,36,59,-23,32
St. Pölten,9941,10,4,10,22,34,73,-39,22
SC Rheindorf,9942,1,21,7,8,58,39,19,70
FC Salzburg,9942,2,18,11,7,65,32,33,65
SK Sturm Gra,9942,3,19,7,10,69,40,29,64
Rapid Vienna,9942,4,15,12,9,63,34,29,57
Vienna,9942,5,16,8,12,66,54,12,56
Admira Wacke,9942,6,12,5,19,34,65,-31,41
SV Josko Rie,9942,7,11,6,19,37,60,-23,39
RZ Pellets W,9942,8,10,8,18,38,52,-14,38
Mattersburg,9942,9,10,8,18,41,61,-20,38
St. Pölten,9942,10,8,8,20,46,80,-34,32
FC Salzburg,9943,1,23,6,7,70,27,43,75
SC Rheindorf,9943,2,20,6,10,59,51,8,66
Vienna,9943,3,19,7,10,60,48,12,64
SK Sturm Gra,9943,4,17,8,11,60,36,24,59
Rapid Vienna,9943,5,13,14,9,62,36,26,53
Admira Wacke,9943,6,13,7,16,41,58,-17,46
RZ Pellets W,9943,7,11,9,16,46,58,-12,42
St. Pölten,9943,8,8,10,18,41,66,-25,34
Mattersburg,9943,9,7,10,19,36,67,-31,31
SV Josko Rie,9943,10,7,7,22,24,52,-28,28
SC Rheindorf,9944,1,21,8,7,63,42,21,71
FC Salzburg,9944,2,20,7,9,70,35,35,67
SK Sturm Gra,9944,3,20,6,10,60,33,27,66
Vienna,9944,4,19,6,11,53,42,11,63
RZ Pellets W,9944,5,13,7,16,46,53,-7,46
Rapid Vienna,9944,6,11,12,13,53,44,9,45
Admira Wacke,9944,7,12,8,16,40,56,-16,44
SV Josko Rie,9944,8,9,7,20,33,58,-25,34
Mattersburg,9944,9,9,7,20,33,62,-29,34
St. Pölten,9944,10,8,8,20,39,65,-26,32
SK Sturm Gra,9945,1,21,5,10,66,39,27,68
FC Salzburg,9945,2,18,11,7,63,32,31,65
SC Rheindorf,9945,3,18,8,10,55,42,13,62
Vienna,9945,4,18,5,13,59,51,8,59
Rapid Vienna,9945,5,14,13,9,58,41,17,55
SV Josko Rie,9945,6,14,5,17,45,52,-7,47
RZ Pellets W,9945,7,13,7,16,47,56,-9,46
Admira Wacke,9945,8,11,5,20,34,61,-27,38
Mattersburg,9945,9,7,10,19,35,58,-23,31
St. Pölten,9945,10,6,11,19,35,65,-30,29
SC Rheindorf,9946,1,20,8,8,57,42,15,68
FC Salzburg,9946,2,19,8,9,67,31,36,65
SK Sturm Gra,9946,3,19,7,10,60,33,27,64
Vienna,9946,4,18,5,13,59,53,6,59
Rapid Vienna,9946,5,11,13,12,50,44,6,46
RZ Pellets W,9946,6,12,9,15,44,57,-13,45
SV Josko Rie,9946,7,14,3,19,38,53,-15,45
St. Pölten,9946,8,11,9,16,40,54,-14,42
Admira Wacke,9946,9,10,6,20,40,66,-26,36
Mattersburg,9946,10,8,8,20,38,60,-22,32
FC Salzburg,9947,1,23,6,7,66,26,40,75
SK Sturm Gra,9947,2,20,7,9,59,30,29,67
SC Rheindorf,9947,3,20,7,9,54,39,15,67
Vienna,9947,4,18,5,13,62,55,7,59
Rapid Vienna,9947,5,15,10,11,57,45,12,55
Admira Wacke,9947,6,14,6,16,44,56,-12,48
RZ Pellets W,9947,7,10,7,19,38,57,-19,37
St. Pölten,9947,8,9,10,17,45,68,-23,37
SV Josko Rie,9947,9,9,6,21,32,57,-25,33
Mattersburg,9947,10,6,8,22,30,54,-24,26
FC Salzburg,9948,1,21,8,7,64,27,37,71
SC Rheindorf,9948,2,21,7,8,57,39,18,70
Vienna,9948,3,20,4,12,67,52,15,64
SK Sturm Gra,9948,4,18,8,10,65,38,27,62
Rapid Vienna,9948,5,13,10,13,52,45,7,49
SV Josko Rie,9948,6,13,4,19,37,53,-16,43
RZ Pellets W,9948,7,12,5,19,46,64,-18,41
Mattersburg,9948,8,10,9,17,40,54,-14,39
Admira Wacke,9948,9,10,6,20,43,71,-28,36
St. Pölten,9948,10,7,9,20,40,68,-28,30
FC Salzburg,9949,1,22,6,8,68,34,34,72
SK Sturm Gra,9949,2,20,8,8,66,28,38,68
Vienna,9949,3,18,7,11,63,46,17,61
SC Rheindorf,9949,4,17,9,10,53,50,3,60
Rapid Vienna,9949,5,16,10,10,52,38,14,58
Admira Wacke,9949,6,11,9,16,38,59,-21,42
Mattersburg,9949,7,10,9,17,40,55,-15,39
RZ Pellets W,9949,8,10,8,18,33,52,-19,38
SV Josko Rie,9949,9,9,5,22,35,62,-27,32
St. Pölten,9949,10,7,9,20,42,66,-24,30
FC Salzburg,9950,1,21,7,8,65,31,34,70
SC Rheindorf,9950,2,19,10,7,53,37,16,67
Rapid Vienna,9950,3,17,11,8,64,39,25,62
Vienna,9950,4,18,7,11,59,54,5,61
SK Sturm Gra,9950,5,17,9,10,59,34,25,60
St. Pölten,9950,6,9,12,15,51,64,-13,39
RZ Pellets W,9950,7,9,10,17,40,56,-16,37
Admira Wacke,9950,8,9,10,17,35,59,-24,37
SV Josko Rie,9950,9,8,7,21,30,55,-25,31
Mattersburg,9950,10,6,11,19,36,63,-27,29
FC Salzburg,9951,1,22,8,6,64,24,40,74
SK Sturm Gra,9951,2,18,10,8,61,34,27,64
SC Rheindorf,9951,3,18,10,8,62,47,15,64
Vienna,9951,4,17,7,12,65,57,8,58
Rapid Vienna,9951,5,11,13,12,56,48,8,46
Admira Wacke,9951,6,11,9,16,42,60,-18,42
RZ Pellets W,9951,7,10,8,18,41,61,-20,38
Mattersburg,9951,8,10,7,19,37,55,-18,37
St. Pölten,9951,9,9,10,17,42,62,-20,37
SV Josko Rie,9951,10,10,6,20,36,58,-22,36
FC Salzburg,9952,1,22,10,4,72,28,44,76
SK Sturm Gra,9952,2,19,6,11,63,37,26,63
Vienna,9952,3,18,6,12,57,52,5,60
SC Rheindorf,9952,4,16,9,11,54,48,6,57
Rapid Vienna,9952,5,14,10,12,50,42,8,52
RZ Pellets W,9952,6,14,7,15,48,50,-2,49
Mattersburg,9952,7,10,10,16,46,57,-11,40
St. Pölten,9952,8,10,8,18,39,59,-20,38
SV Josko Rie,9952,9,10,5,21,32,55,-23,35
Admira Wacke,9952,10,8,7,21,27,60,-33,31
SC Rheindorf,9953,1,21,7,8,63,42,21,70
FC Salzburg,9953,2,19,9,8,64,34,30,66
SK Sturm Gra,9953,3,18,9,9,61,44,17,63
Vienna,9953,4,19,4,13,72,57,15,61
Rapid Vienna,9953,5,16,10,10,55,33,22,58
RZ Pellets W,9953,6,10,10,16,42,54,-12,40
Admira Wacke,9953,7,12,4,20,39,64,-25,40
SV Josko Rie,9953,8,11,6,19,37,57,-20,39
Mattersburg,9953,9,9,10,17,42,55,-13,37
St. Pölten,9953,10,7,7,22,37,72,-35,28
FC Salzburg,9954,1,23,8,5,66,26,40,77
SK Sturm Gra,9954,2,21,4,11,63,37,26,67
Vienna,9954,3,20,3,13,64,51,13,63
SC Rheindorf,9954,4,17,8,11,51,43,8,59
Rapid Vienna,9954,5,15,10,11,55,36,19,55
RZ Pellets W,9954,6,10,10,16,43,55,-12,40
Admira Wacke,9954,7,11,5,20,33,64,-31,38
SV Josko Rie,9954,8,10,6,20,36,52,-16,36
St. Pölten,9954,9,8,11,17,41,67,-26,35
Mattersburg,9954,10,7,11,18,28,49,-21,32
FC Salzburg,9955,1,22,6,8,71,35,36,72
Vienna,9955,2,19,7,10,64,45,19,64
SC Rheindorf,9955,3,18,8,10,52,38,14,62
SK Sturm Gra,9955,4,17,10,9,51,34,17,61
Rapid Vienna,9955,5,14,11,11,59,44,15,53
RZ Pellets W,9955,6,12,8,16,45,61,-16,44
SV Josko Rie,9955,7,12,6,18,34,45,-11,42
Admira Wacke,9955,8,10,7,19,36,61,-25,37
St. Pölten,9955,9,7,12,17,45,64,-19,33
Mattersburg,9955,10,7,9,20,33,63,-30,30
FC Salzburg,9956,1,21,7,8,66,33,33,70
SC Rheindorf,9956,2,20,7,9,54,48,6,67
SK Sturm Gra,9956,3,19,6,11,59,36,23,63
Vienna,9956,4,17,7,12,60,51,9,58
Rapid Vienna,9956,5,12,13,11,53,38,15,49
St. Pölten,9956,6,11,10,15,47,57,-10,43
RZ Pellets W,9956,7,11,8,17,38,51,-13,41
SV Josko Rie,9956,8,12,2,22,33,53,-20,38
Admira Wacke,9956,9,10,8,18,31,51,-20,38
Mattersburg,9956,10,8,10,18,35,58,-23,34
FC Salzburg,9957,1,21,6,9,66,33,33,69
SC Rheindorf,9957,2,18,11,7,57,42,15,65
SK Sturm Gra,9957,3,18,7,11,56,37,19,61
Rapid Vienna,9957,4,16,12,8,63,39,24,60
Vienna,9957,5,18,4,14,68,59,9,58
Admira Wacke,9957,6,13,5,18,43,64,-21,44
RZ Pellets W,9957,7,11,9,16,44,56,-12,42
SV Josko Rie,9957,8,11,3,22,31,58,-27,36
Mattersburg,9957,9,9,8,19,38,57,-19,35
St. Pölten,9957,10,7,11,18,41,62,-21,32
FC Salzburg,9958,1,20,8,8,63,30,33,68
SK Sturm Gra,9958,2,20,8,8,60,31,29,68
SC Rheindorf,9958,3,17,10,9,57,44,13,61
Vienna,9958,4,18,7,11,63,53,10,61
Rapid Vienna,9958,5,14,9,13,56,46,10,51
Admira Wacke,9958,6,12,8,16,45,58,-13,44
SV Josko Rie,9958,7,13,5,18,38,55,-17,44
RZ Pellets W,9958,8,9,10,17,47,61,-14,37
Mattersburg,9958,9,10,7,19,39,60,-21,37
St. Pölten,9958,10,7,8,21,35,65,-30,29
SC Rheindorf,9959,1,20,7,9,60,37,23,67
Vienna,9959,2,21,4,11,62,46,16,67
SK Sturm Gra,9959,3,20,5,11,57,35,22,65
FC Salzburg,9959,4,18,6,12,58,38,20,60
Rapid Vienna,9959,5,13,10,13,51,44,7,49
SV Josko Rie,9959,6,13,3,20,33,50,-17,42
RZ Pellets W,9959,7,11,8,17,45,61,-16,41
Admira Wacke,9959,8,12,5,19,44,67,-23,41
St. Pölten,9959,9,11,7,18,50,64,-14,40
Mattersburg,9959,10,10,7,19,40,58,-18,37
FC Salzburg,9960,1,22,8,6,64,28,36,74
SK Sturm Gra,9960,2,19,7,10,64,40,24,64
Vienna,9960,3,18,8,10,60,49,11,62
SC Rheindorf,9960,4,18,6,12,56,50,6,60
Rapid Vienna,9960,5,13,13,10,59,40,19,52
RZ Pellets W,9960,6,13,9,14,53,55,-2,48
Admira Wacke,9960,7,11,4,21,42,66,-24,37
SV Josko Rie,9960,8,10,5,21,35,63,-28,35
St. Pölten,9960,9,7,13,16,42,64,-22,34
Mattersburg,9960,10,8,9,19,41,61,-20,33
FC Salzburg,9961,1,24,5,7,72,35,37,77
SC Rheindorf,9961,2,21,7,8,56,43,13,70
SK Sturm Gra,9961,3,21,4,11,63,36,27,67
Vienna,9961,4,20,4,12,69,51,18,64
Rapid Vienna,9961,5,14,9,13,56,46,10,51
RZ Pellets W,9961,6,12,8,16,47,59,-12,44
SV Josko Rie,9961,7,9,7,20,38,57,-19,34
St. Pölten,9961,8,8,10,18,44,70,-26,34
Admira Wacke,9961,9,8,9,19,28,56,-28,33
Mattersburg,9961,10,5,13,18,38,58,-20,28
FC Salzburg,9962,1,21,9,6,74,33,41,72
SC Rheindorf,9962,2,21,6,9,62,43,19,69
SK Sturm Gra,9962,3,18,7,11,58,40,18,61
Vienna,9962,4,17,5,14,60,51,9,56
Rapid Vienna,9962,5,14,13,9,60,38,22,55
Admira Wacke,9962,6,13,7,16,47,57,-10,46
RZ Pellets W,9962,7,12,6,18,43,60,-17,42
St. Pölten,9962,8,10,6,20,45,70,-25,36
Mattersburg,9962,9,9,8,19,42,65,-23,35
SV Josko Rie,9962,10,9,5,22,30,64,-34,32
SC Rheindorf,9963,1,21,7,8,60,43,17,70
Vienna,9963,2,20,8,8,73,46,27,68
SK Sturm Gra,9963,3,19,6,11,66,39,27,63
Rapid Vienna,9963,4,17,11,8,62,38,24,62
FC Salzburg,9963,5,18,6,12,57,42,15,60
RZ Pellets W,9963,6,13,8,15,45,48,-3,47
SV Josko Rie,9963,7,12,4,20,36,59,-23,40
Admira Wacke,9963,8,10,8,18,35,59,-24,38
St. Pölten,9963,9,7,8,21,40,76,-36,29
Mattersburg,9963,10,6,8,22,36,60,-24,26
FC Salzburg,9964,1,20,9,7,64,30,34,69
SK Sturm Gra,9964,2,20,5,11,63,31,32,65
Vienna,9964,3,19,5,12,64,51,13,62
SC Rheindorf,9964,4,17,10,9,54,48,6,61
Admira Wacke,9964,5,14,5,17,48,58,-10,47
Rapid Vienna,9964,6,10,15,11,50,44,6,45
SV Josko Rie,9964,7,13,6,17,40,55,-15,45
RZ Pellets W,9964,8,10,9,17,34,51,-17,39
Mattersburg,9964,9,9,9,18,45,60,-15,36
St. Pölten,9964,10,7,9,20,35,69,-34,30
FC Salzburg,9965,1,21,6,9,60,32,28,69
Vienna,9965,2,21,5,10,71,46,25,68
SK Sturm Gra,9965,3,20,5,11,60,36,24,65
SC Rheindorf,9965,4,19,8,9,51,39,12,65
Rapid Vienna,9965,5,13,12,11,52,40,12,51
RZ Pellets W,9965,6,14,8,14,48,50,-2,50
Admira Wacke,9965,7,13,5,18,43,60,-17,44
SV Josko Rie,9965,8,11,4,21,32,52,-20,37
Mattersburg,9965,9,7,8,21,35,59,-24,29
St. Pölten,9965,10,6,9,21,32,70,-38,27
FC Salzburg,9966,1,22,6,8,66,31,35,72
SC Rheindorf,9966,2,20,6,10,62,48,14,66
Rapid Vienna,9966,3,17,10,9,62,35,27,61
SK Sturm Gra,9966,4,16,7,13,54,45,9,55
Vienna,9966,5,16,6,14,60,56,4,54
RZ Pellets W,9966,6,13,9,14,48,54,-6,48
Mattersburg,9966,7,12,8,16,47,55,-8,44
Admira Wacke,9966,8,11,8,17,36,58,-22,41
St. Pölten,9966,9,9,10,17,41,61,-20,37
SV Josko Rie,9966,10,6,6,24,28,61,-33,24
SK Sturm Gra,9967,1,21,5,10,63,31,32,68
SC Rheindorf,9967,2,20,6,10,50,44,6,66
FC Salzburg,9967,3,18,7,11,69,40,29,61
Vienna,9967,4,17,5,14,60,52,8,56
Rapid Vienna,9967,5,15,10,11,65,41,24,55
Admira Wacke,9967,6,14,4,18,43,65,-22,46
St. Pölten,9967,7,12,8,16,46,62,-16,44
SV Josko Rie,9967,8,12,3,21,39,58,-19,39
RZ Pellets W,9967,9,10,7,19,37,56,-19,37
Mattersburg,9967,10,10,7,19,40,63,-23,37
SC Rheindorf,9968,1,20,7,9,56,38,18,67
FC Salzburg,9968,2,20,6,10,66,38,28,66
Vienna,9968,3,20,4,12,58,54,4,64
Rapid Vienna,9968,4,15,11,10,61,42,19,56
SK Sturm Gra,9968,5,16,8,12,54,36,18,56
Admira Wacke,9968,6,15,4,17,44,61,-17,49
St. Pölten,9968,7,13,7,16,56,62,-6,46
RZ Pellets W,9968,8,11,7,18,45,57,-12,40
SV Josko Rie,9968,9,10,4,22,33,58,-25,34
Mattersburg,9968,10,7,8,21,35,62,-27,29
FC Salzburg,9969,1,22,7,7,68,27,41,73
SC Rheindorf,9969,2,21,7,8,63,39,24,70
SK Sturm Gra,9969,3,20,5,11,59,37,22,65
Vienna,9969,4,16,7,13,55,56,-1,55
Rapid Vienna,9969,5,13,13,10,55,39,16,52
RZ Pellets W,9969,6,11,10,15,48,56,-8,43
Admira Wacke,9969,7,12,7,17,38,59,-21,43
St. Pölten,9969,8,10,10,16,47,58,-11,40
SV Josko Rie,9969,9,9,3,24,38,66,-28,30
Mattersburg,9969,10,6,11,19,32,66,-34,29
SC Rheindorf,9970,1,23,5,8,61,39,22,74
SK Sturm Gra,9970,2,20,5,11,59,40,19,65
Vienna,9970,3,19,8,9,59,42,17,65
FC Salzburg,9970,4,19,7,10,57,35,22,64
Rapid Vienna,9970,5,15,11,10,59,39,20,56
RZ Pellets W,9970,6,13,6,17,45,55,-10,45
Admira Wacke,9970,7,10,9,17,29,49,-20,39
SV Josko Rie,9970,8,11,5,20,30,46,-16,38
St. Pölten,9970,9,8,8,20,40,65,-25,32
Mattersburg,9970,10,6,8,22,32,61,-29,26
FC Salzburg,9971,1,23,4,9,62,26,36,73
Vienna,9971,2,22,3,11,66,48,18,69
SK Sturm Gra,9971,3,21,5,10,71,39,32,68
Rapid Vienna,9971,4,17,9,10,65,42,23,60
SC Rheindorf,9971,5,17,6,13,50,54,-4,57
St. Pölten,9971,6,12,8,16,45,58,-13,44
RZ Pellets W,9971,7,13,4,19,47,63,-16,43
SV Josko Rie,9971,8,11,4,21,36,52,-16,37
Admira Wacke,9971,9,10,7,19,36,59,-23,37
Mattersburg,9971,10,5,8,23,26,63,-37,23
FC Salzburg,9972,1,21,8,7,69,35,34,71
SK Sturm Gra,9972,2,20,6,10,63,35,28,66
SC Rheindorf,9972,3,19,9,8,50,39,11,66
Vienna,9972,4,18,7,11,63,54,9,61
Rapid Vienna,9972,5,13,11,12,56,42,14,50
Admira Wacke,9972,6,13,7,16,45,60,-15,46
RZ Pellets W,9972,7,10,8,18,43,59,-16,38
SV Josko Rie,9972,8,9,8,19,38,56,-18,35
St. Pölten,9972,9,9,8,19,38,64,-26,35
Mattersburg,9972,10,8,8,20,31,52,-21,32
FC Salzburg,9973,1,21,7,8,67,30,37,70
SK Sturm Gra,9973,2,20,5,11,61,33,28,65
SC Rheindorf,9973,3,18,9,9,51,44,7,63
Vienna,9973,4,18,5,13,55,52,3,59
Rapid Vienna,9973,5,12,13,11,46,36,10,49
RZ Pellets W,9973,6,13,9,14,47,50,-3,48
St. Pölten,9973,7,11,8,17,43,61,-18,41
Admira Wacke,9973,8,11,6,19,29,49,-20,39
SV Josko Rie,9973,9,11,4,21,34,57,-23,37
Mattersburg,9973,10,7,10,19,37,58,-21,31
FC Salzburg,9974,1,22,10,4,62,23,39,76
SK Sturm Gra,9974,2,19,8,9,62,35,27,65
SC Rheindorf,9974,3,18,7,11,51,41,10,61
Rapid Vienna,9974,4,15,12,9,56,36,20,57
Vienna,9974,5,16,5,15,52,52,0,53
RZ Pellets W,9974,6,14,9,13,46,49,-3,51
Mattersburg,9974,7,9,8,19,39,57,-18,35
St. Pölten,9974,8,8,11,17,40,64,-24,35
SV Josko Rie,9974,9,9,6,21,35,56,-21,33
Admira Wacke,9974,10,9,6,21,32,62,-30,33
SK Sturm Gra,9975,1,21,6,9,62,33,29,69
FC Salzburg,9975,2,20,8,8,59,28,31,68
SC Rheindorf,9975,3,20,8,8,55,40,15,68
Vienna,9975,4,19,4,13,66,57,9,61
Rapid Vienna,9975,5,12,12,12,50,41,9,48
Admira Wacke,9975,6,14,4,18,38,55,-17,46
SV Josko Rie,9975,7,12,6,18,37,53,-16,42
RZ Pellets W,9975,8,11,6,19,52,66,-14,39
Mattersburg,9975,9,7,11,18,39,56,-17,32
St. Pölten,9975,10,7,9,20,40,69,-29,30
FC Salzburg,9976,1,22,7,7,61,24,37,73
Rapid Vienna,9976,2,18,11,7,59,33,26,65
SK Sturm Gra,9976,3,18,8,10,52,32,20,62
Vienna,9976,4,17,9,10,58,45,13,60
SC Rheindorf,9976,5,18,4,14,49,44,5,58
Admira Wacke,9976,6,13,6,17,40,56,-16,45
RZ Pellets W,9976,7,10,11,15,44,59,-15,41
SV Josko Rie,9976,8,11,5,20,34,52,-18,38
St. Pölten,9976,9,8,7,21,42,70,-28,31
Mattersburg,9976,10,6,10,20,34,58,-24,28
FC Salzburg,9977,1,22,7,7,75,28,47,73
SK Sturm Gra,9977,2,22,5,9,61,36,25,71
SC Rheindorf,9977,3,19,6,11,49,39,10,63
Vienna,9977,4,17,5,14,57,57,0,56
Rapid Vienna,9977,5,13,10,13,51,44,7,49
RZ Pellets W,9977,6,13,6,17,55,59,-4,45
St. Pölten,9977,7,10,10,16,43,59,-16,40
Mattersburg,9977,8,11,6,19,37,55,-18,39
Admira Wacke,9977,9,9,8,19,35,60,-25,35
SV Josko Rie,9977,10,9,7,20,33,59,-26,34
FC Salzburg,9978,1,22,7,7,67,32,35,73
SK Sturm Gra,9978,2,21,6,9,70,34,36,69
SC Rheindorf,9978,3,19,8,9,58,45,13,65
Rapid Vienna,9978,4,17,10,9,55,33,22,61
Vienna,9978,5,19,3,14,68,57,11,60
RZ Pellets W,9978,6,13,4,19,43,61,-18,43
Admira Wacke,9978,7,10,7,19,40,61,-21,37
SV Josko Rie,9978,8,9,9,18,39,57,-18,36
Mattersburg,9978,9,8,9,19,37,63,-26,33
St. Pölten,9978,10,5,11,20,40,74,-34,26
FC Salzburg,9979,1,24,5,7,66,27,39,77
SC Rheindorf,9979,2,20,7,9,58,38,20,67
Rapid Vienna,9979,3,18,8,10,67,43,24,62
SK Sturm Gra,9979,4,18,4,14,58,40,18,58
Vienna,9979,5,15,7,14,55,60,-5,52
RZ Pellets W,9979,6,12,7,17,50,63,-13,43
Admira Wacke,9979,7,13,3,20,41,66,-25,42
St. Pölten,9979,8,10,9,17,47,68,-21,39
SV Josko Rie,9979,9,10,7,19,40,52,-12,37
Mattersburg,9979,10,7,9,20,37,62,-25,30
SC Rheindorf,9980,1,21,8,7,57,36,21,71
FC Salzburg,9980,2,20,10,6,72,30,42,70
Vienna,9980,3,20,4,12,67,50,17,64
SK Sturm Gra,9980,4,18,6,12,61,43,18,60
Rapid Vienna,9980,5,14,10,12,52,39,13,52
Admira Wacke,9980,6,13,8,15,42,57,-15,47
Mattersburg,9980,7,12,7,17,47,58,-11,43
St. Pölten,9980,8,9,9,18,37,56,-19,36
RZ Pellets W,9980,9,8,8,20,42,66,-24,32
SV Josko Rie,9980,10,8,4,24,33,75,-42,28
FC Salzburg,9981,1,22,5,9,67,32,35,71
SC Rheindorf,9981,2,20,9,7,66,51,15,69
SK Sturm Gra,9981,3,18,6,12,63,40,23,60
Vienna,9981,4,17,3,16,55,55,0,54
RZ Pellets W,9981,5,16,5,15,49,49,0,53
Rapid Vienna,9981,6,12,12,12,52,38,14,48
SV Josko Rie,9981,7,13,7,16,36,48,-12,46
Admira Wacke,9981,8,12,7,17,34,57,-23,43
St. Pölten,9981,9,7,10,19,37,66,-29,31
Mattersburg,9981,10,6,10,20,31,54,-23,28
Vienna,9982,1,22,6,8,69,49,20,72
FC Salzburg,9982,2,21,6,9,67,35,32,69
SK Sturm Gra,9982,3,19,8,9,55,31,24,65
SC Rheindorf,9982,4,17,7,12,48,48,0,58
Rapid Vienna,9982,5,12,11,13,52,46,6,47
St. Pölten,9982,6,11,10,15,45,59,-14,43
RZ Pellets W,9982,7,11,9,16,54,59,-5,42
SV Josko Rie,9982,8,10,7,19,30,48,-18,37
Mattersburg,9982,9,8,10,18,36,53,-17,34
Admira Wacke,9982,10,9,6,21,33,61,-28,33
FC Salzburg,9983,1,24,7,5,80,28,52,79
SC Rheindorf,9983,2,19,9,8,55,48,7,66
SK Sturm Gra,9983,3,17,7,12,52,31,21,58
Vienna,9983,4,17,6,13,62,57,5,57
SV Josko Rie,9983,5,16,5,15,50,53,-3,53
Rapid Vienna,9983,6,13,13,10,57,41,16,52
Mattersburg,9983,7,9,9,18,40,60,-20,36
RZ Pellets W,9983,8,9,8,19,42,64,-22,35
Admira Wacke,9983,9,8,8,20,35,67,-32,32
St. Pölten,9983,10,7,10,19,38,62,-24,31
SK Sturm Gra,9984,1,20,8,8,60,29,31,68
SC Rheindorf,9984,2,21,5,10,58,44,14,68
FC Salzburg,9984,3,18,10,8,60,31,29,64
Vienna,9984,4,16,9,11,57,52,5,57
Rapid Vienna,9984,5,15,9,12,55,41,14,54
St. Pölten,9984,6,11,10,15,44,59,-15,43
RZ Pellets W,9984,7,11,9,16,41,53,-12,42
Admira Wacke,9984,8,11,7,18,38,56,-18,40
Mattersburg,9984,9,10,7,19,41,57,-16,37
SV Josko Rie,9984,10,7,6,23,34,66,-32,27
FC Salzburg,9985,1,23,7,6,73,34,39,76
SC Rheindorf,9985,2,21,6,9,58,37,21,69
Vienna,9985,3,18,7,11,67,55,12,61
Rapid Vienna,9985,4,15,9,12,59,43,16,54
SK Sturm Gra,9985,5,15,8,13,50,40,10,53
RZ Pellets W,9985,6,12,10,14,48,53,-5,46
SV Josko Rie,9985,7,11,5,20,41,57,-16,38
Admira Wacke,9985,8,9,10,17,33,59,-26,37
Mattersburg,9985,9,9,8,19,31,54,-23,35
St. Pölten,9985,10,6,12,18,43,71,-28,30
SC Rheindorf,9986,1,21,8,7,59,38,21,71
FC Salzburg,9986,2,20,6,10,68,36,32,66
Vienna,9986,3,21,3,12,69,53,16,66
SK Sturm Gra,9986,4,17,8,11,59,35,24,59
Rapid Vienna,9986,5,13,10,13,55,41,14,49
RZ Pellets W,9986,6,13,9,14,46,54,-8,48
Admira Wacke,9986,7,12,8,16,41,64,-23,44
St. Pölten,9986,8,8,12,16,40,65,-25,36
SV Josko Rie,9986,9,9,5,22,34,63,-29,32
Mattersburg,9986,10,7,9,20,34,56,-22,30
SK Sturm Gra,9987,1,21,5,10,58,32,26,68
FC Salzburg,9987,2,18,10,8,59,32,27,64
SC Rheindorf,9987,3,18,8,10,56,42,14,62
Vienna,9987,4,18,5,13,62,55,7,59
Rapid Vienna,9987,5,16,9,11,61,47,14,57
RZ Pellets W,9987,6,14,8,14,49,51,-2,50
St. Pölten,9987,7,10,10,16,39,57,-18,40
SV Josko Rie,9987,8,11,5,20,39,54,-15,38
Admira Wacke,9987,9,9,8,19,36,62,-26,35
Mattersburg,9987,10,7,8,21,32,59,-27,29
SK Sturm Gra,9988,1,22,6,8,62,29,33,72
FC Salzburg,9988,2,20,9,7,61,35,26,69
SC Rheindorf,9988,3,20,8,8,56,38,18,68
Vienna,9988,4,18,7,11,66,55,11,61
Rapid Vienna,9988,5,14,11,11,59,39,20,53
Admira Wacke,9988,6,11,8,17,32,54,-22,41
RZ Pellets W,9988,7,9,10,17,42,59,-17,37
Mattersburg,9988,8,10,6,20,40,59,-19,36
St. Pölten,9988,9,7,10,19,43,67,-24,31
SV Josko Rie,9988,10,8,7,21,30,56,-26,31
FC Salzburg,9989,1,20,7,9,66,32,34,67
SC Rheindorf,9989,2,19,9,8,61,43,18,66
SK Sturm Gra,9989,3,17,10,9,56,36,20,61
Vienna,9989,4,17,7,12,55,49,6,58
Rapid Vienna,9989,5,15,9,12,55,40,15,54
RZ Pellets W,9989,6,12,9,15,48,53,-5,45
St. Pölten,9989,7,10,9,17,47,67,-20,39
Mattersburg,9989,8,10,8,18,37,56,-19,38
SV Josko Rie,9989,9,11,4,21,36,60,-24,37
Admira Wacke,9989,10,9,8,19,37,62,-25,35
SC Rheindorf,9990,1,20,7,9,56,41,15,67
Vienna,9990,2,20,5,11,67,51,16,65
FC Salzburg,9990,3,18,10,8,60,29,31,64
SK Sturm Gra,9990,4,19,5,12,63,37,26,62
RZ Pellets W,9990,5,15,8,13,54,53,1,53
Rapid Vienna,9990,6,13,11,12,53,36,17,50
SV Josko Rie,9990,7,11,5,20,31,53,-22,38
Admira Wacke,9990,8,10,8,18,29,55,-26,38
Mattersburg,9990,9,8,9,19,30,57,-27,33
St. Pölten,9990,10,7,10,19,37,68,-31,31
SC Rheindorf,9991,1,21,6,9,58,40,18,69
SK Sturm Gra,9991,2,18,7,11,58,36,22,61
FC Salzburg,9991,3,18,7,11,64,45,19,61
Vienna,9991,4,17,6,13,66,51,15,57
Rapid Vienna,9991,5,14,11,11,57,41,16,53
RZ Pellets W,9991,6,14,8,14,50,50,0,50
SV Josko Rie,9991,7,13,5,18,38,54,-16,44
Admira Wacke,9991,8,12,6,18,34,60,-26,42
St. Pölten,9991,9,8,11,17,45,65,-20,35
Mattersburg,9991,10,8,7,21,35,63,-28,31
FC Salzburg,9992,1,21,8,7,60,27,33,71
Vienna,9992,2,20,5,11,70,44,26,65
SK Sturm Gra,9992,3,18,8,10,56,38,18,62
SC Rheindorf,9992,4,18,6,12,53,47,6,60
Rapid Vienna,9992,5,12,10,14,51,46,5,46
RZ Pellets W,9992,6,12,10,14,47,53,-6,46
SV Josko Rie,9992,7,13,5,18,34,45,-11,44
Admira Wacke,9992,8,12,6,18,30,55,-25,42
Mattersburg,9992,9,8,10,18,34,54,-20,34
St. Pölten,9992,10,8,8,20,41,67,-26,32
FC Salzburg,9993,1,22,5,9,64,29,35,71
Vienna,9993,2,21,3,12,68,51,17,66
SK Sturm Gra,9993,3,20,5,11,65,34,31,65
SC Rheindorf,9993,4,20,5,11,59,48,11,65
Rapid Vienna,9993,5,13,12,11,56,40,16,51
Admira Wacke,9993,6,12,8,16,35,60,-25,44
RZ Pellets W,9993,7,11,9,16,46,53,-7,42
St. Pölten,9993,8,9,11,16,41,61,-20,38
Mattersburg,9993,9,10,5,21,37,62,-25,35
SV Josko Rie,9993,10,8,5,23,31,64,-33,29
SC Rheindorf,9994,1,20,8,8,55,44,11,68
SK Sturm Gra,9994,2,20,7,9,61,30,31,67
FC Salzburg,9994,3,20,7,9,65,43,22,67
Vienna,9994,4,19,7,10,74,53,21,64
Rapid Vienna,9994,5,12,15,9,56,38,18,51
RZ Pellets W,9994,6,10,11,15,40,53,-13,41
SV Josko Rie,9994,7,11,7,18,35,53,-18,40
Mattersburg,9994,8,9,9,18,37,53,-16,36
Admira Wacke,9994,9,8,7,21,35,71,-36,31
St. Pölten,9994,10,6,12,18,41,61,-20,30
SK Sturm Gra,9995,1,20,8,8,68,40,28,68
FC Salzburg,9995,2,19,9,8,67,34,33,66
Vienna,9995,3,18,7,11,68,55,13,61
SC Rheindorf,9995,4,17,9,10,53,43,10,60
Rapid Vienna,9995,5,15,10,11,55,39,16,55
Admira Wacke,9995,6,12,8,16,38,55,-17,44
RZ Pellets W,9995,7,12,7,17,44,60,-16,43
SV Josko Rie,9995,8,10,7,19,38,53,-15,37
St. Pölten,9995,9,8,10,18,38,60,-22,34
Mattersburg,9995,10,8,7,21,34,64,-30,31
FC Salzburg,9996,1,24,6,6,78,32,46,78
SC Rheindorf,9996,2,20,9,7,67,38,29,69
SK Sturm Gra,9996,3,18,9,9,61,36,25,63
Vienna,9996,4,19,4,13,67,53,14,61
Rapid Vienna,9996,5,15,10,11,65,48,17,55
Admira Wacke,9996,6,12,6,18,36,65,-29,42
St. Pölten,9996,7,11,7,18,48,65,-17,40
RZ Pellets W,9996,8,9,7,20,43,65,-22,34
Mattersburg,9996,9,8,9,19,37,65,-28,33
SV Josko Rie,9996,10,7,7,22,28,63,-35,28
FC Salzburg,9997,1,22,6,8,63,30,33,72
SC Rheindorf,9997,2,21,7,8,58,44,14,70
SK Sturm Gra,9997,3,19,7,10,62,35,27,64
Vienna,9997,4,19,5,12,63,48,15,62
Rapid Vienna,9997,5,15,10,11,57,38,19,55
Admira Wacke,9997,6,13,5,18,38,59,-21,44
RZ Pellets W,9997,7,12,6,18,44,59,-15,42
St. Pölten,9997,8,8,9,19,40,64,-24,33
SV Josko Rie,9997,9,10,3,23,30,58,-28,33
Mattersburg,9997,10,7,10,19,35,55,-20,31
FC Salzburg,9998,1,22,6,8,66,27,39,72
SC Rheindorf,9998,2,19,7,10,61,48,13,64
Vienna,9998,3,17,8,11,62,57,5,59
SK Sturm Gra,9998,4,17,7,12,56,37,19,58
Rapid Vienna,9998,5,15,10,11,54,38,16,55
RZ Pellets W,9998,6,12,8,16,46,54,-8,44
Admira Wacke,9998,7,12,8,16,37,55,-18,44
Mattersburg,9998,8,10,6,20,38,62,-24,36
St. Pölten,9998,9,8,11,17,42,63,-21,35
SV Josko Rie,9998,10,8,9,19,31,52,-21,33
FC Salzburg,9999,1,21,8,7,64,30,34,71
SK Sturm Gra,9999,2,19,9,8,54,33,21,66
SC Rheindorf,9999,3,19,9,8,55,41,14,66
Vienna,9999,4,18,4,14,61,52,9,58
Rapid Vienna,9999,5,15,7,14,59,48,11,52
Admira Wacke,9999,6,13,7,16,39,52,-13,46
SV Josko Rie,9999,7,12,6,18,36,52,-16,42
RZ Pellets W,9999,8,11,7,18,45,61,-16,40
St. Pölten,9999,9,8,10,18,49,68,-19,34
Mattersburg,9999,10,7,7,22,35,60,-25,28
