team,n,rank,w,d,l,gf,ga,gd,pts
Mumbai City,0,1,7,4,3,18,9,9,25
Kolkata,0,2,4,8,2,17,14,3,20
NorthEast Un,0,3,6,2,6,11,10,1,20
Delhi Dynamo,0,4,4,6,4,22,17,5,18
FC Pune City,0,5,4,5,5,14,16,-2,17
Chennaiyin,0,6,4,5,5,14,19,-5,17
FC Goa,0,7,4,4,6,11,15,-4,16
Kerala Blast,0,8,4,4,6,10,17,-7,16
Delhi Dynamo,1,1,7,5,2,26,14,12,26
Mumbai City,1,2,6,4,4,16,10,6,22
Kolkata,1,3,5,6,3,18,15,3,21
FC Pune City,1,4,5,3,6,15,15,0,18
Chennaiyin,1,5,4,6,4,18,19,-1,18
NorthEast Un,1,6,5,2,7,10,13,-3,17
FC Goa,1,7,4,3,7,13,20,-7,15
Kerala Blast,1,8,4,3,7,9,19,-10,15
Delhi Dynamo,2,1,7,5,2,26,16,10,26
Mumbai City,2,2,6,4,4,16,9,7,22
Kerala Blast,2,3,6,3,5,12,15,-3,21
Chennaiyin,2,4,5,5,4,17,19,-2,20
Kolkata,2,5,4,6,4,16,16,0,18
FC Pune City,2,6,5,3,6,14,16,-2,18
NorthEast Un,2,7,4,2,8,11,14,-3,14
FC Goa,2,8,4,2,8,13,20,-7,14
Mumbai City,3,1,6,5,3,17,9,8,23
Delhi Dynamo,3,2,4,8,2,22,15,7,20
Kolkata,3,3,4,7,3,19,18,1,19
FC Pune City,3,4,5,4,5,14,15,-1,19
NorthEast Un,3,5,5,3,6,10,12,-2,18
FC Goa,3,6,5,3,6,13,16,-3,18
Kerala Blast,3,7,5,3,6,14,18,-4,18
Chennaiyin,3,8,3,5,6,14,20,-6,14
Mumbai City,4,1,7,4,3,19,9,10,25
Kolkata,4,2,5,7,2,19,14,5,22
Delhi Dynamo,4,3,5,5,4,25,20,5,20
Kerala Blast,4,4,5,4,5,12,18,-6,19
NorthEast Un,4,5,5,3,6,16,12,4,18
FC Goa,4,6,4,4,6,13,18,-5,16
FC Pune City,4,7,4,3,7,13,17,-4,15
Chennaiyin,4,8,3,6,5,16,25,-9,15
Delhi Dynamo,5,1,7,5,2,26,14,12,26
Mumbai City,5,2,6,4,4,16,10,6,22
Kolkata,5,3,5,6,3,17,14,3,21
Kerala Blast,5,4,5,4,5,12,16,-4,19
Chennaiyin,5,5,3,7,4,13,17,-4,16
FC Pune City,5,5,4,4,6,13,17,-4,16
NorthEast Un,5,7,4,3,7,10,12,-2,15
FC Goa,5,8,4,3,7,10,17,-7,15
Mumbai City,6,1,6,5,3,18,10,8,23
Delhi Dynamo,6,2,5,7,2,25,17,8,22
Kolkata,6,3,4,7,3,19,16,3,19
FC Pune City,6,4,5,4,5,15,16,-1,19
Kerala Blast,6,5,5,3,6,11,19,-8,18
NorthEast Un,6,6,4,4,6,11,12,-1,16
Chennaiyin,6,7,3,7,4,15,19,-4,16
FC Goa,6,8,4,3,7,12,17,-5,15
Mumbai City,7,1,7,4,3,18,9,9,25
Kerala Blast,7,2,5,5,4,15,15,0,20
Kolkata,7,3,4,7,3,15,14,1,19
NorthEast Un,7,4,5,4,5,13,12,1,19
FC Goa,7,5,5,3,6,12,15,-3,18
Delhi Dynamo,7,6,4,5,5,22,19,3,17
Chennaiyin,7,7,3,7,4,16,20,-4,16
FC Pune City,7,8,4,3,7,12,19,-7,15
Delhi Dynamo,8,1,6,5,3,26,17,9,23
Mumbai City,8,2,6,4,4,16,9,7,22
FC Pune City,8,3,6,3,5,14,14,0,21
Kolkata,8,4,4,7,3,17,14,3,19
FC Goa,8,5,5,3,6,15,17,-2,18
Kerala Blast,8,6,5,3,6,11,18,-7,18
Chennaiyin,8,7,4,5,5,14,20,-6,17
NorthEast Un,8,8,4,2,8,10,14,-4,14
Mumbai City,9,1,7,4,3,19,9,10,25
Kolkata,9,2,5,7,2,17,13,4,22
Delhi Dynamo,9,3,5,6,3,26,19,7,21
Kerala Blast,9,4,5,5,4,11,14,-3,20
Chennaiyin,9,5,4,5,5,18,20,-2,17
FC Pune City,9,6,4,4,6,14,17,-3,16
NorthEast Un,9,7,4,3,7,11,16,-5,15
FC Goa,9,8,4,2,8,11,19,-8,14
Mumbai City,10,1,7,4,3,19,10,9,25
Delhi Dynamo,10,2,5,5,4,24,18,6,20
Kolkata,10,3,4,8,2,18,16,2,20
Chennaiyin,10,4,5,5,4,16,17,-1,20
Kerala Blast,10,5,4,6,4,14,18,-4,18
FC Pune City,10,6,4,4,6,18,21,-3,16
NorthEast Un,10,7,4,3,7,9,11,-2,15
FC Goa,10,8,4,3,7,10,17,-7,15
Mumbai City,11,1,6,5,3,16,8,8,23
Kerala Blast,11,2,6,4,4,17,15,2,22
Delhi Dynamo,11,3,5,6,3,25,18,7,21
Kolkata,11,4,5,6,3,16,15,1,21
Chennaiyin,11,5,4,5,5,15,18,-3,17
NorthEast Un,11,6,5,2,7,11,15,-4,17
FC Pune City,11,7,4,4,6,14,18,-4,16
FC Goa,11,8,4,2,8,11,18,-7,14
Kerala Blast,12,1,7,3,4,13,13,0,24
Mumbai City,12,2,6,4,4,17,11,6,22
Delhi Dynamo,12,3,5,6,3,25,17,8,21
Kolkata,12,4,5,6,3,17,14,3,21
Chennaiyin,12,5,4,5,5,20,20,0,17
NorthEast Un,12,6,5,2,7,12,18,-6,17
FC Pune City,12,7,4,3,7,13,17,-4,15
FC Goa,12,8,4,3,7,10,17,-7,15
Mumbai City,13,1,7,4,3,18,9,9,25
Kolkata,13,2,6,6,2,22,16,6,24
Delhi Dynamo,13,3,6,5,3,27,16,11,23
Chennaiyin,13,4,4,6,4,15,17,-2,18
NorthEast Un,13,5,5,2,7,11,14,-3,17
FC Pune City,13,6,4,4,6,14,18,-4,16
Kerala Blast,13,7,4,4,6,11,19,-8,16
FC Goa,13,8,3,3,8,10,19,-9,12
Mumbai City,14,1,6,5,3,18,10,8,23
Delhi Dynamo,14,2,5,6,3,25,17,8,21
Kolkata,14,3,5,6,3,18,15,3,21
Kerala Blast,14,4,5,4,5,10,14,-4,19
NorthEast Un,14,5,5,3,6,11,11,0,18
Chennaiyin,14,6,3,7,4,14,18,-4,16
FC Pune City,14,7,4,4,6,12,17,-5,16
FC Goa,14,8,4,3,7,11,17,-6,15
Delhi Dynamo,15,1,6,6,2,26,15,11,24
Mumbai City,15,2,6,5,3,17,9,8,23
Kolkata,15,3,4,8,2,17,15,2,20
FC Pune City,15,4,5,4,5,13,14,-1,19
Kerala Blast,15,5,5,4,5,14,16,-2,19
NorthEast Un,15,6,5,2,7,11,14,-3,17
Chennaiyin,15,7,3,5,6,15,21,-6,14
FC Goa,15,8,4,2,8,11,20,-9,14
Mumbai City,16,1,6,4,4,18,11,7,22
Delhi Dynamo,16,2,5,6,3,25,20,5,21
NorthEast Un,16,3,6,2,6,15,11,4,20
Kolkata,16,4,4,8,2,17,14,3,20
Kerala Blast,16,5,5,4,5,12,17,-5,19
FC Pune City,16,6,5,3,6,15,17,-2,18
Chennaiyin,16,7,3,6,5,13,19,-6,15
FC Goa,16,8,3,5,6,9,15,-6,14
Delhi Dynamo,17,1,6,6,2,27,16,11,24
Mumbai City,17,2,6,4,4,16,9,7,22
Chennaiyin,17,3,5,5,4,19,17,2,20
Kolkata,17,4,4,7,3,18,18,0,19
FC Pune City,17,5,5,4,5,18,19,-1,19
NorthEast Un,17,6,4,4,6,12,14,-2,16
Kerala Blast,17,7,4,4,6,15,21,-6,16
FC Goa,17,8,4,2,8,10,21,-11,14
Mumbai City,18,1,7,4,3,18,9,9,25
Delhi Dynamo,18,2,6,5,3,25,17,8,23
Kerala Blast,18,3,6,4,4,13,13,0,22
Kolkata,18,4,4,7,3,16,16,0,19
NorthEast Un,18,5,5,2,7,11,13,-2,17
Chennaiyin,18,6,4,5,5,16,20,-4,17
FC Pune City,18,7,4,4,6,13,16,-3,16
FC Goa,18,8,3,3,8,11,19,-8,12
Mumbai City,19,1,7,4,3,20,8,12,25
FC Pune City,19,2,5,4,5,15,16,-1,19
Delhi Dynamo,19,3,4,6,4,23,21,2,18
NorthEast Un,19,4,5,3,6,12,12,0,18
Chennaiyin,19,5,4,6,4,14,17,-3,18
Kerala Blast,19,6,4,6,4,10,14,-4,18
Kolkata,19,7,3,7,4,17,18,-1,16
FC Goa,19,8,4,4,6,10,15,-5,16
Delhi Dynamo,20,1,6,6,2,27,17,10,24
Mumbai City,20,2,6,5,3,17,9,8,23
Kolkata,20,3,4,8,2,18,15,3,20
Chennaiyin,20,4,5,5,4,18,17,1,20
FC Pune City,20,5,4,5,5,14,16,-2,17
Kerala Blast,20,6,4,5,5,10,16,-6,17
NorthEast Un,20,7,4,3,7,11,14,-3,15
FC Goa,20,8,3,3,8,10,21,-11,12
Delhi Dynamo,21,1,6,5,3,27,19,8,23
Mumbai City,21,2,6,4,4,17,10,7,22
Kolkata,21,3,5,6,3,20,15,5,21
Kerala Blast,21,4,6,3,5,12,15,-3,21
FC Pune City,21,5,5,3,6,14,17,-3,18
NorthEast Un,21,6,5,2,7,13,13,0,17
Chennaiyin,21,7,4,5,5,14,18,-4,17
FC Goa,21,8,4,2,8,11,21,-10,14
Mumbai City,22,1,7,4,3,19,9,10,25
Delhi Dynamo,22,2,5,6,3,27,19,8,21
Kolkata,22,3,4,7,3,16,15,1,19
Kerala Blast,22,4,5,4,5,14,18,-4,19
NorthEast Un,22,5,5,3,6,14,15,-1,18
Chennaiyin,22,6,4,6,4,15,17,-2,18
FC Pune City,22,7,4,4,6,13,16,-3,16
FC Goa,22,8,3,4,7,9,18,-9,13
Mumbai City,23,1,7,4,3,17,8,9,25
Delhi Dynamo,23,2,6,5,3,25,15,10,23
Kolkata,23,3,5,7,2,19,14,5,22
FC Pune City,23,4,5,4,5,15,16,-1,19
NorthEast Un,23,5,5,3,6,10,12,-2,18
Chennaiyin,23,6,4,5,5,14,18,-4,17
Kerala Blast,23,7,4,4,6,11,17,-6,16
FC Goa,23,8,3,2,9,8,19,-11,11
Mumbai City,24,1,6,5,3,19,11,8,23
Delhi Dynamo,24,2,5,7,2,28,18,10,22
Kolkata,24,3,5,7,2,16,12,4,22
NorthEast Un,24,4,5,3,6,12,14,-2,18
FC Pune City,24,5,5,3,6,13,16,-3,18
Chennaiyin,24,6,4,5,5,14,18,-4,17
Kerala Blast,24,7,4,4,6,11,17,-6,16
FC Goa,24,8,3,4,7,9,16,-7,13
Mumbai City,25,1,7,4,3,20,8,12,25
Delhi Dynamo,25,2,5,5,4,25,21,4,20
Kolkata,25,3,4,7,3,17,15,2,19
NorthEast Un,25,4,5,4,5,14,13,1,19
FC Pune City,25,5,4,5,5,14,16,-2,17
FC Goa,25,6,5,2,7,14,17,-3,17
Kerala Blast,25,7,4,5,5,12,19,-7,17
Chennaiyin,25,8,3,6,5,14,21,-7,15
Mumbai City,26,1,7,4,3,18,8,10,25
Chennaiyin,26,2,5,5,4,16,17,-1,20
Kerala Blast,26,3,5,5,4,10,13,-3,20
Kolkata,26,4,4,7,3,15,13,2,19
NorthEast Un,26,5,5,3,6,12,11,1,18
Delhi Dynamo,26,6,4,5,5,22,20,2,17
FC Goa,26,7,5,2,7,10,16,-6,17
FC Pune City,26,8,4,3,7,12,17,-5,15
Mumbai City,27,1,6,5,3,17,9,8,23
Kerala Blast,27,2,6,4,4,12,14,-2,22
Delhi Dynamo,27,3,5,6,3,24,18,6,21
NorthEast Un,27,4,5,3,6,11,10,1,18
Kolkata,27,5,4,6,4,14,17,-3,18
FC Goa,27,6,5,2,7,16,16,0,17
FC Pune City,27,7,4,4,6,13,16,-3,16
Chennaiyin,27,8,3,6,5,13,20,-7,15
Delhi Dynamo,28,1,6,6,2,27,15,12,24
Mumbai City,28,2,6,5,3,17,9,8,23
Kerala Blast,28,3,6,3,5,14,14,0,21
NorthEast Un,28,4,6,2,6,11,11,0,20
Kolkata,28,5,4,6,4,14,15,-1,18
FC Pune City,28,6,5,3,6,13,17,-4,18
Chennaiyin,28,7,3,5,6,14,20,-6,14
FC Goa,28,8,4,2,8,10,19,-9,14
Mumbai City,29,1,6,5,3,16,8,8,23
Delhi Dynamo,29,2,4,8,2,26,19,7,20
Kolkata,29,3,4,8,2,16,14,2,20
Chennaiyin,29,4,5,5,4,19,18,1,20
FC Pune City,29,5,5,3,6,15,16,-1,18
NorthEast Un,29,6,5,3,6,13,15,-2,18
Kerala Blast,29,7,4,4,6,10,18,-8,16
FC Goa,29,8,3,4,7,14,21,-7,13
Mumbai City,30,1,7,4,3,18,9,9,25
Delhi Dynamo,30,2,5,6,3,24,17,7,21
FC Pune City,30,3,6,3,5,18,15,3,21
NorthEast Un,30,4,5,4,5,12,11,1,19
Kolkata,30,5,4,6,4,14,16,-2,18
FC Goa,30,6,5,2,7,12,16,-4,17
Kerala Blast,30,7,4,4,6,11,19,-8,16
Chennaiyin,30,8,3,5,6,14,20,-6,14
Mumbai City,31,1,7,4,3,18,9,9,25
Kerala Blast,31,2,6,4,4,12,14,-2,22
Delhi Dynamo,31,3,5,5,4,24,18,6,20
FC Pune City,31,4,5,3,6,13,15,-2,18
NorthEast Un,31,5,5,2,7,13,14,-1,17
Chennaiyin,31,6,4,5,5,16,20,-4,17
FC Goa,31,7,5,2,7,12,16,-4,17
Kolkata,31,8,3,7,4,13,15,-2,16
Mumbai City,32,1,6,5,3,16,8,8,23
Delhi Dynamo,32,2,5,6,3,23,16,7,21
FC Pune City,32,3,6,3,5,14,14,0,21
NorthEast Un,32,4,6,2,6,11,12,-1,20
Chennaiyin,32,5,4,6,4,17,18,-1,18
Kolkata,32,5,4,6,4,17,18,-1,18
FC Goa,32,7,4,3,7,14,19,-5,15
Kerala Blast,32,8,4,3,7,10,17,-7,15
Delhi Dynamo,33,1,7,5,2,26,14,12,26
Mumbai City,33,2,6,4,4,16,10,6,22
Kolkata,33,3,4,8,2,17,14,3,20
NorthEast Un,33,4,5,3,6,13,13,0,18
FC Pune City,33,5,5,3,6,15,16,-1,18
Kerala Blast,33,6,4,5,5,11,18,-7,17
Chennaiyin,33,7,3,6,5,15,21,-6,15
FC Goa,33,8,3,4,7,10,17,-7,13
Kolkata,34,1,6,6,2,21,15,6,24
Mumbai City,34,2,6,5,3,18,10,8,23
Delhi Dynamo,34,3,4,8,2,25,18,7,20
Kerala Blast,34,4,5,4,5,13,17,-4,19
Chennaiyin,34,5,4,5,5,14,19,-5,17
NorthEast Un,34,6,4,4,6,12,13,-1,16
FC Goa,34,7,4,3,7,11,16,-5,15
FC Pune City,34,8,4,3,7,12,18,-6,15
Mumbai City,35,1,6,5,3,17,9,8,23
Delhi Dynamo,35,2,5,7,2,24,16,8,22
FC Pune City,35,3,6,3,5,17,15,2,21
Kerala Blast,35,4,5,4,5,12,16,-4,19
Chennaiyin,35,5,4,5,5,15,19,-4,17
NorthEast Un,35,6,4,4,6,10,11,-1,16
Kolkata,35,7,3,7,4,15,18,-3,16
FC Goa,35,8,4,3,7,12,18,-6,15
Delhi Dynamo,36,1,6,6,2,25,15,10,24
Mumbai City,36,2,6,4,4,16,9,7,22
NorthEast Un,36,3,6,3,5,16,10,6,21
Kolkata,36,4,5,6,3,18,15,3,21
FC Pune City,36,5,5,4,5,14,15,-1,19
Kerala Blast,36,6,4,4,6,11,20,-9,16
Chennaiyin,36,7,3,6,5,13,20,-7,15
FC Goa,36,8,3,3,8,9,18,-9,12
Mumbai City,37,1,6,5,3,18,10,8,23
Delhi Dynamo,37,2,5,7,2,27,17,10,22
Kolkata,37,3,4,7,3,14,13,1,19
FC Pune City,37,4,5,4,5,14,14,0,19
Kerala Blast,37,5,5,3,6,11,16,-5,18
Chennaiyin,37,6,4,5,5,18,20,-2,17
NorthEast Un,37,7,5,2,7,12,16,-4,17
FC Goa,37,8,4,3,7,10,18,-8,15
Mumbai City,38,1,6,5,3,17,9,8,23
NorthEast Un,38,2,6,3,5,13,10,3,21
Delhi Dynamo,38,3,4,6,4,25,20,5,18
FC Goa,38,4,5,3,6,14,17,-3,18
Kolkata,38,5,3,8,3,13,14,-1,17
FC Pune City,38,6,4,5,5,13,15,-2,17
Kerala Blast,38,7,4,5,5,10,16,-6,17
Chennaiyin,38,8,3,7,4,14,18,-4,16
Mumbai City,39,1,6,4,4,17,10,7,22
Kerala Blast,39,2,6,4,4,11,13,-2,22
Delhi Dynamo,39,3,5,6,3,26,25,1,21
Kolkata,39,4,4,6,4,17,17,0,18
FC Pune City,39,5,5,3,6,16,17,-1,18
FC Goa,39,6,5,2,7,18,17,1,17
Chennaiyin,39,7,4,5,5,18,20,-2,17
NorthEast Un,39,8,4,4,6,12,16,-4,16
Mumbai City,40,1,7,4,3,18,8,10,25
Delhi Dynamo,40,2,5,5,4,24,19,5,20
Kerala Blast,40,3,5,5,4,12,14,-2,20
FC Pune City,40,4,5,4,5,13,14,-1,19
Kolkata,40,5,4,6,4,16,15,1,18
Chennaiyin,40,6,4,5,5,17,22,-5,17
FC Goa,40,7,5,2,7,14,20,-6,17
NorthEast Un,40,8,4,3,7,12,14,-2,15
Mumbai City,41,1,7,4,3,20,8,12,25
Delhi Dynamo,41,2,4,7,3,24,21,3,19
Kolkata,41,3,4,7,3,14,13,1,19
NorthEast Un,41,4,5,3,6,15,12,3,18
FC Goa,41,5,5,3,6,14,18,-4,18
FC Pune City,41,6,4,5,5,12,14,-2,17
Chennaiyin,41,7,4,5,5,16,20,-4,17
Kerala Blast,41,8,4,4,6,10,19,-9,16
Kerala Blast,42,1,7,3,4,13,14,-1,24
Mumbai City,42,2,6,4,4,16,9,7,22
Delhi Dynamo,42,3,5,6,3,22,15,7,21
Kolkata,42,4,4,6,4,15,15,0,18
NorthEast Un,42,5,5,3,6,10,10,0,18
Chennaiyin,42,6,3,7,4,14,18,-4,16
FC Goa,42,7,4,4,6,11,16,-5,16
FC Pune City,42,8,4,3,7,13,17,-4,15
Delhi Dynamo,43,1,6,6,2,25,16,9,24
Mumbai City,43,2,6,4,4,16,9,7,22
Kerala Blast,43,3,5,4,5,12,16,-4,19
FC Pune City,43,4,5,3,6,15,17,-2,18
FC Goa,43,5,5,3,6,13,17,-4,18
NorthEast Un,43,6,5,2,7,11,13,-2,17
Chennaiyin,43,7,4,5,5,17,20,-3,17
Kolkata,43,8,3,7,4,13,14,-1,16
Mumbai City,44,1,6,4,4,17,12,5,22
Kolkata,44,2,5,6,3,20,14,6,21
NorthEast Un,44,3,6,3,5,17,12,5,21
Delhi Dynamo,44,4,5,5,4,27,19,8,20
FC Goa,44,5,5,3,6,11,15,-4,18
FC Pune City,44,6,5,3,6,13,18,-5,18
Kerala Blast,44,7,4,4,6,11,18,-7,16
Chennaiyin,44,8,3,6,5,14,22,-8,15
Delhi Dynamo,45,1,6,6,2,26,16,10,24
Mumbai City,45,2,6,4,4,17,10,7,22
Chennaiyin,45,3,5,5,4,19,19,0,20
Kolkata,45,4,4,7,3,15,15,0,19
Kerala Blast,45,5,5,4,5,14,18,-4,19
NorthEast Un,45,6,4,4,6,10,12,-2,16
FC Pune City,45,7,4,4,6,14,18,-4,16
FC Goa,45,8,4,2,8,14,21,-7,14
NorthEast Un,46,1,7,2,5,16,11,5,23
Mumbai City,46,2,6,4,4,16,10,6,22
Delhi Dynamo,46,3,5,6,3,24,18,6,21
Kolkata,46,4,5,6,3,17,17,0,21
Kerala Blast,46,5,5,4,5,13,15,-2,19
FC Pune City,46,6,4,4,6,12,15,-3,16
FC Goa,46,7,4,3,7,11,17,-6,15
Chennaiyin,46,8,3,5,6,15,21,-6,14
Mumbai City,47,1,7,4,3,19,8,11,25
Kolkata,47,2,5,6,3,16,13,3,21
Delhi Dynamo,47,3,4,7,3,22,18,4,19
NorthEast Un,47,4,5,3,6,11,13,-2,18
FC Goa,47,5,5,3,6,12,16,-4,18
Kerala Blast,47,6,5,3,6,10,15,-5,18
Chennaiyin,47,7,4,5,5,18,20,-2,17
FC Pune City,47,8,4,3,7,12,17,-5,15
Delhi Dynamo,48,1,6,6,2,30,17,13,24
Kolkata,48,2,6,6,2,21,13,8,24
Mumbai City,48,3,6,5,3,18,10,8,23
Kerala Blast,48,4,5,4,5,12,17,-5,19
NorthEast Un,48,5,4,4,6,12,17,-5,16
Chennaiyin,48,6,3,6,5,13,18,-5,15
FC Pune City,48,6,4,3,7,13,18,-5,15
FC Goa,48,8,4,2,8,9,18,-9,14
Mumbai City,49,1,6,5,3,16,8,8,23
Kerala Blast,49,2,6,3,5,15,17,-2,21
Kolkata,49,3,4,8,2,17,15,2,20
NorthEast Un,49,4,6,2,6,14,13,1,20
Delhi Dynamo,49,5,4,6,4,23,19,4,18
FC Goa,49,6,4,4,6,14,18,-4,16
FC Pune City,49,6,4,4,6,14,18,-4,16
Chennaiyin,49,8,3,6,5,16,21,-5,15
Mumbai City,50,1,7,4,3,20,9,11,25
Kerala Blast,50,2,6,4,4,15,16,-1,22
Delhi Dynamo,50,3,5,6,3,23,18,5,21
FC Pune City,50,4,5,4,5,15,16,-1,19
Kolkata,50,5,4,6,4,17,18,-1,18
Chennaiyin,50,6,4,6,4,15,18,-3,18
NorthEast Un,50,7,4,3,7,11,13,-2,15
FC Goa,50,8,3,3,8,9,17,-8,12
Delhi Dynamo,51,1,7,5,2,28,16,12,26
Mumbai City,51,2,6,4,4,16,10,6,22
NorthEast Un,51,3,6,2,6,13,11,2,20
Kerala Blast,51,4,5,4,5,12,17,-5,19
Chennaiyin,51,5,4,5,5,16,19,-3,17
Kolkata,51,5,3,8,3,16,19,-3,17
FC Pune City,51,7,4,4,6,15,18,-3,16
FC Goa,51,8,4,2,8,14,20,-6,14
Mumbai City,52,1,6,5,3,18,10,8,23
Delhi Dynamo,52,2,5,7,2,26,18,8,22
Kerala Blast,52,3,6,4,4,14,14,0,22
Kolkata,52,4,4,7,3,17,16,1,19
NorthEast Un,52,5,5,3,6,13,12,1,18
Chennaiyin,52,6,3,6,5,16,22,-6,15
FC Pune City,52,7,4,3,7,13,19,-6,15
FC Goa,52,8,3,5,6,14,20,-6,14
Kerala Blast,53,1,7,3,4,15,16,-1,24
Mumbai City,53,2,6,4,4,16,9,7,22
Delhi Dynamo,53,3,5,6,3,22,16,6,21
FC Goa,53,4,5,3,6,12,16,-4,18
NorthEast Un,53,5,5,2,7,11,11,0,17
Chennaiyin,53,6,4,5,5,15,19,-4,17
Kolkata,53,7,3,7,4,17,18,-1,16
FC Pune City,53,8,4,4,6,16,19,-3,16
Mumbai City,54,1,7,4,3,17,8,9,25
Kolkata,54,2,6,6,2,19,13,6,24
Delhi Dynamo,54,3,6,5,3,28,16,12,23
Kerala Blast,54,4,6,3,5,14,17,-3,21
Chennaiyin,54,5,4,5,5,16,20,-4,17
FC Pune City,54,6,4,3,7,12,17,-5,15
NorthEast Un,54,7,4,2,8,11,16,-5,14
FC Goa,54,8,4,2,8,11,21,-10,14
Delhi Dynamo,55,1,7,5,2,27,14,13,26
Mumbai City,55,2,6,4,4,16,11,5,22
Kolkata,55,3,4,8,2,18,15,3,20
Chennaiyin,55,4,4,6,4,15,18,-3,18
FC Pune City,55,5,4,5,5,15,17,-2,17
NorthEast Un,55,6,5,2,7,10,12,-2,17
Kerala Blast,55,7,4,4,6,11,18,-7,16
FC Goa,55,8,3,4,7,9,16,-7,13
Mumbai City,56,1,6,5,3,18,10,8,23
FC Pune City,56,2,6,3,5,15,15,0,21
Delhi Dynamo,56,3,4,8,2,24,17,7,20
Chennaiyin,56,4,5,5,4,16,18,-2,20
Kolkata,56,5,4,7,3,20,17,3,19
NorthEast Un,56,6,5,3,6,12,11,1,18
Kerala Blast,56,7,4,3,7,10,20,-10,15
FC Goa,56,8,3,4,7,11,18,-7,13
Mumbai City,57,1,7,4,3,20,10,10,25
Delhi Dynamo,57,2,5,6,3,25,19,6,21
Kolkata,57,3,5,6,3,21,15,6,21
Chennaiyin,57,4,4,6,4,15,18,-3,18
FC Pune City,57,5,5,3,6,15,19,-4,18
Kerala Blast,57,6,5,3,6,12,18,-6,18
NorthEast Un,57,7,4,3,7,11,15,-4,15
FC Goa,57,8,4,3,7,11,16,-5,15
Mumbai City,58,1,7,4,3,18,8,10,25
Delhi Dynamo,58,2,5,5,4,24,21,3,20
Kerala Blast,58,3,5,4,5,11,15,-4,19
Kolkata,58,4,3,9,2,14,13,1,18
NorthEast Un,58,5,5,3,6,12,11,1,18
FC Goa,58,6,5,3,6,13,15,-2,18
FC Pune City,58,7,4,4,6,13,17,-4,16
Chennaiyin,58,8,3,6,5,13,18,-5,15
Delhi Dynamo,59,1,6,6,2,26,17,9,24
Mumbai City,59,2,6,5,3,17,9,8,23
Kolkata,59,3,5,7,2,20,16,4,22
FC Pune City,59,4,5,4,5,15,16,-1,19
NorthEast Un,59,5,5,3,6,12,12,0,18
Chennaiyin,59,6,4,5,5,16,18,-2,17
Kerala Blast,59,7,4,4,6,10,17,-7,16
FC Goa,59,8,3,2,9,11,22,-11,11
Mumbai City,60,1,7,4,3,20,8,12,25
Delhi Dynamo,60,2,5,6,3,24,20,4,21
FC Pune City,60,3,5,4,5,14,15,-1,19
Kerala Blast,60,4,5,4,5,12,16,-4,19
NorthEast Un,60,5,5,3,6,14,11,3,18
Kolkata,60,6,4,6,4,15,16,-1,18
FC Goa,60,7,4,3,7,13,18,-5,15
Chennaiyin,60,8,3,6,5,15,23,-8,15
Mumbai City,61,1,7,4,3,20,9,11,25
Delhi Dynamo,61,2,5,5,4,26,22,4,20
Chennaiyin,61,3,5,5,4,17,17,0,20
Kolkata,61,4,4,7,3,15,16,-1,19
Kerala Blast,61,5,5,4,5,13,15,-2,19
FC Pune City,61,6,4,5,5,14,16,-2,17
FC Goa,61,7,5,2,7,15,18,-3,17
NorthEast Un,61,8,4,2,8,9,16,-7,14
Mumbai City,62,1,7,4,3,18,9,9,25
Delhi Dynamo,62,2,6,5,3,25,17,8,23
Kolkata,62,3,5,6,3,15,14,1,21
NorthEast Un,62,4,5,3,6,11,11,0,18
Chennaiyin,62,5,4,6,4,15,18,-3,18
FC Pune City,62,6,4,4,6,14,17,-3,16
Kerala Blast,62,7,4,4,6,11,17,-6,16
FC Goa,62,8,4,2,8,11,17,-6,14
Delhi Dynamo,63,1,6,6,2,30,19,11,24
Mumbai City,63,2,6,5,3,18,10,8,23
Kerala Blast,63,3,6,4,4,13,15,-2,22
FC Pune City,63,4,5,3,6,15,16,-1,18
Kolkata,63,5,4,6,4,14,15,-1,18
NorthEast Un,63,6,4,4,6,12,14,-2,16
Chennaiyin,63,7,3,6,5,15,20,-5,15
FC Goa,63,8,4,2,8,12,20,-8,14
Kolkata,64,1,6,6,2,17,12,5,24
Mumbai City,64,2,6,5,3,17,9,8,23
Delhi Dynamo,64,3,5,6,3,26,18,8,21
Kerala Blast,64,4,6,3,5,15,15,0,21
NorthEast Un,64,5,6,2,6,12,14,-2,20
Chennaiyin,64,6,3,6,5,13,18,-5,15
FC Pune City,64,6,4,3,7,13,18,-5,15
FC Goa,64,8,3,3,8,9,18,-9,12
Mumbai City,65,1,7,4,3,18,9,9,25
Kerala Blast,65,2,7,3,4,13,14,-1,24
Delhi Dynamo,65,3,6,5,3,24,16,8,23
FC Pune City,65,4,5,3,6,14,15,-1,18
FC Goa,65,5,5,2,7,12,16,-4,17
NorthEast Un,65,6,4,3,7,10,12,-2,15
Kolkata,65,7,3,6,5,14,17,-3,15
Chennaiyin,65,8,3,6,5,15,21,-6,15
Delhi Dynamo,66,1,6,6,2,28,17,11,24
Mumbai City,66,2,6,5,3,16,8,8,23
NorthEast Un,66,3,6,2,6,16,16,0,20
FC Pune City,66,4,5,4,5,15,15,0,19
Kolkata,66,5,3,9,2,15,14,1,18
Chennaiyin,66,6,4,5,5,17,20,-3,17
Kerala Blast,66,7,4,4,6,11,18,-7,16
FC Goa,66,8,3,3,8,9,19,-10,12
Mumbai City,67,1,7,4,3,20,9,11,25
Delhi Dynamo,67,2,5,6,3,28,23,5,21
Kerala Blast,67,3,5,5,4,11,13,-2,20
Kolkata,67,4,4,7,3,16,14,2,19
NorthEast Un,67,5,5,2,7,12,12,0,17
Chennaiyin,67,6,4,5,5,16,21,-5,17
FC Pune City,67,7,4,4,6,13,17,-4,16
FC Goa,67,8,4,3,7,15,22,-7,15
Kolkata,68,1,6,6,2,19,13,6,24
Delhi Dynamo,68,2,6,5,3,24,16,8,23
Mumbai City,68,3,6,4,4,16,9,7,22
NorthEast Un,68,4,6,2,6,12,13,-1,20
Chennaiyin,68,5,4,6,4,18,18,0,18
FC Pune City,68,6,5,3,6,13,16,-3,18
Kerala Blast,68,7,4,3,7,9,18,-9,15
FC Goa,68,8,3,3,8,11,19,-8,12
Mumbai City,69,1,7,4,3,18,9,9,25
Kerala Blast,69,2,7,3,4,14,14,0,24
Delhi Dynamo,69,3,5,6,3,26,18,8,21
Chennaiyin,69,4,5,5,4,18,18,0,20
Kolkata,69,5,4,6,4,15,15,0,18
FC Pune City,69,6,5,3,6,14,16,-2,18
NorthEast Un,69,7,4,2,8,10,16,-6,14
FC Goa,69,8,3,3,8,11,20,-9,12
Delhi Dynamo,70,1,6,5,3,23,15,8,23
Mumbai City,70,2,6,4,4,16,9,7,22
Kerala Blast,70,3,6,3,5,13,17,-4,21
NorthEast Un,70,4,6,2,6,12,11,1,20
Kolkata,70,5,4,6,4,16,15,1,18
FC Pune City,70,6,5,3,6,17,19,-2,18
FC Goa,70,7,5,2,7,10,15,-5,17
Chennaiyin,70,8,3,5,6,14,20,-6,14
Mumbai City,71,1,6,5,3,18,10,8,23
Delhi Dynamo,71,2,5,7,2,28,18,10,22
Kolkata,71,3,5,6,3,18,14,4,21
FC Pune City,71,4,5,3,6,14,16,-2,18
Kerala Blast,71,5,5,3,6,11,18,-7,18
NorthEast Un,71,6,5,2,7,10,13,-3,17
FC Goa,71,7,4,4,6,12,17,-5,16
Chennaiyin,71,8,3,6,5,13,18,-5,15
Mumbai City,72,1,6,5,3,16,8,8,23
Delhi Dynamo,72,2,5,6,3,24,17,7,21
Kolkata,72,3,5,6,3,19,15,4,21
Kerala Blast,72,4,6,3,5,14,17,-3,21
NorthEast Un,72,5,5,2,7,12,14,-2,17
FC Goa,72,6,5,2,7,13,17,-4,17
Chennaiyin,72,7,4,5,5,16,21,-5,17
FC Pune City,72,8,4,3,7,13,18,-5,15
Mumbai City,73,1,6,5,3,18,10,8,23
Delhi Dynamo,73,2,5,6,3,27,20,7,21
NorthEast Un,73,3,5,4,5,14,12,2,19
Kerala Blast,73,4,4,6,4,11,15,-4,18
Kolkata,73,5,3,8,3,16,16,0,17
FC Pune City,73,6,4,5,5,15,17,-2,17
FC Goa,73,7,5,2,7,12,17,-5,17
Chennaiyin,73,8,3,6,5,13,19,-6,15
Mumbai City,74,1,6,4,4,16,9,7,22
Kerala Blast,74,2,6,4,4,17,16,1,22
Delhi Dynamo,74,3,5,5,4,24,18,6,20
Kolkata,74,4,4,7,3,20,21,-1,19
Chennaiyin,74,5,4,6,4,15,18,-3,18
NorthEast Un,74,6,5,2,7,11,12,-1,17
FC Pune City,74,7,4,4,6,13,17,-4,16
FC Goa,74,8,4,4,6,14,19,-5,16
Delhi Dynamo,75,1,6,5,3,27,17,10,23
Mumbai City,75,2,6,4,4,16,9,7,22
Kerala Blast,75,3,5,5,4,13,16,-3,20
NorthEast Un,75,4,5,4,5,12,10,2,19
Kolkata,75,5,4,7,3,17,17,0,19
Chennaiyin,75,6,3,7,4,13,17,-4,16
FC Pune City,75,7,4,3,7,12,17,-5,15
FC Goa,75,8,4,3,7,12,19,-7,15
NorthEast Un,76,1,7,2,5,20,9,11,23
Mumbai City,76,2,6,5,3,17,9,8,23
Delhi Dynamo,76,3,5,6,3,24,20,4,21
Kolkata,76,4,4,8,2,17,15,2,20
Kerala Blast,76,5,5,4,5,13,19,-6,19
FC Pune City,76,6,4,3,7,13,17,-4,15
FC Goa,76,7,4,3,7,11,18,-7,15
Chennaiyin,76,8,3,5,6,14,22,-8,14
Mumbai City,77,1,6,5,3,18,10,8,23
NorthEast Un,77,2,6,2,6,13,10,3,20
Kolkata,77,3,4,8,2,17,15,2,20
Delhi Dynamo,77,4,4,7,3,23,18,5,19
Kerala Blast,77,5,5,4,5,10,14,-4,19
FC Pune City,77,6,5,3,6,14,16,-2,18
Chennaiyin,77,7,4,5,5,14,19,-5,17
FC Goa,77,8,3,4,7,10,17,-7,13
Mumbai City,78,1,7,4,3,20,9,11,25
Kolkata,78,2,5,7,2,18,15,3,22
Delhi Dynamo,78,3,5,5,4,26,22,4,20
NorthEast Un,78,4,6,2,6,12,11,1,20
Kerala Blast,78,5,5,4,5,12,16,-4,19
FC Pune City,78,6,5,3,6,14,16,-2,18
Chennaiyin,78,7,4,5,5,14,18,-4,17
FC Goa,78,8,3,2,9,10,19,-9,11
Delhi Dynamo,79,1,6,6,2,27,16,11,24
Mumbai City,79,2,6,5,3,16,8,8,23
Kolkata,79,3,4,7,3,14,14,0,19
Kerala Blast,79,4,5,4,5,11,15,-4,19
Chennaiyin,79,5,4,6,4,16,18,-2,18
FC Pune City,79,6,4,4,6,13,16,-3,16
NorthEast Un,79,7,4,3,7,11,14,-3,15
FC Goa,79,8,4,3,7,11,18,-7,15
Mumbai City,80,1,7,4,3,18,8,10,25
NorthEast Un,80,2,7,2,5,17,12,5,23
Kerala Blast,80,3,5,4,5,14,18,-4,19
Delhi Dynamo,80,4,4,5,5,23,21,2,17
Kolkata,80,5,3,8,3,14,14,0,17
FC Goa,80,6,5,2,7,12,16,-4,17
Chennaiyin,80,7,4,5,5,14,20,-6,17
FC Pune City,80,8,4,4,6,13,16,-3,16
Mumbai City,81,1,7,4,3,19,8,11,25
NorthEast Un,81,2,6,3,5,14,12,2,21
Delhi Dynamo,81,3,5,5,4,23,19,4,20
Kolkata,81,4,4,7,3,17,15,2,19
Kerala Blast,81,5,5,4,5,14,16,-2,19
FC Pune City,81,6,5,3,6,14,19,-5,18
Chennaiyin,81,7,4,5,5,15,19,-4,17
FC Goa,81,8,3,3,8,9,17,-8,12
Delhi Dynamo,82,1,6,6,2,28,16,12,24
Mumbai City,82,2,6,4,4,18,11,7,22
Kerala Blast,82,3,6,4,4,16,17,-1,22
Kolkata,82,4,4,6,4,17,17,0,18
Chennaiyin,82,5,4,5,5,16,20,-4,17
FC Goa,82,6,5,2,7,12,19,-7,17
FC Pune City,82,7,4,4,6,13,17,-4,16
NorthEast Un,82,8,4,3,7,11,14,-3,15
Mumbai City,83,1,6,5,3,17,9,8,23
Kerala Blast,83,2,6,4,4,13,14,-1,22
Delhi Dynamo,83,3,4,7,3,24,20,4,19
FC Pune City,83,4,5,3,6,13,16,-3,18
FC Goa,83,5,5,3,6,12,16,-4,18
NorthEast Un,83,6,5,2,7,13,12,1,17
Chennaiyin,83,7,4,5,5,15,19,-4,17
Kolkata,83,8,3,7,4,14,15,-1,16
Delhi Dynamo,84,1,7,5,2,25,14,11,26
Mumbai City,84,2,6,4,4,16,9,7,22
Kerala Blast,84,3,6,4,4,14,14,0,22
Kolkata,84,4,5,6,3,15,15,0,21
Chennaiyin,84,5,4,6,4,14,17,-3,18
NorthEast Un,84,6,4,3,7,9,12,-3,15
FC Pune City,84,7,4,3,7,13,17,-4,15
FC Goa,84,8,3,3,8,8,16,-8,12
Mumbai City,85,1,7,4,3,18,9,9,25
NorthEast Un,85,2,7,2,5,15,11,4,23
Kerala Blast,85,3,6,3,5,14,17,-3,21
Kolkata,85,4,4,7,3,18,16,2,19
Delhi Dynamo,85,5,4,5,5,24,21,3,17
FC Pune City,85,6,4,4,6,14,17,-3,16
Chennaiyin,85,7,3,6,5,14,20,-6,15
FC Goa,85,8,4,3,7,13,19,-6,15
Mumbai City,86,1,7,4,3,18,9,9,25
Delhi Dynamo,86,2,5,6,3,25,16,9,21
Kolkata,86,3,4,7,3,16,14,2,19
FC Pune City,86,4,5,4,5,15,16,-1,19
NorthEast Un,86,5,4,5,5,11,11,0,17
Kerala Blast,86,6,4,5,5,12,18,-6,17
FC Goa,86,7,4,3,7,11,17,-6,15
Chennaiyin,86,8,3,6,5,15,22,-7,15
Delhi Dynamo,87,1,6,5,3,27,19,8,23
Mumbai City,87,2,6,4,4,16,10,6,22
Kolkata,87,3,4,8,2,16,14,2,20
NorthEast Un,87,4,5,4,5,15,13,2,19
Kerala Blast,87,5,5,4,5,15,17,-2,19
FC Pune City,87,6,4,4,6,13,18,-5,16
FC Goa,87,7,4,3,7,13,18,-5,15
Chennaiyin,87,8,3,6,5,15,21,-6,15
Mumbai City,88,1,7,4,3,17,8,9,25
Delhi Dynamo,88,2,5,6,3,24,17,7,21
Kerala Blast,88,3,6,3,5,14,16,-2,21
Kolkata,88,4,4,6,4,17,16,1,18
NorthEast Un,88,5,5,3,6,13,14,-1,18
FC Pune City,88,6,5,3,6,13,16,-3,18
FC Goa,88,7,5,2,7,15,17,-2,17
Chennaiyin,88,8,3,5,6,14,23,-9,14
Mumbai City,89,1,7,4,3,18,8,10,25
Kerala Blast,89,2,6,4,4,15,17,-2,22
Delhi Dynamo,89,3,4,6,4,21,17,4,18
Kolkata,89,4,4,6,4,18,16,2,18
Chennaiyin,89,5,4,6,4,17,19,-2,18
FC Goa,89,6,5,3,6,14,18,-4,18
FC Pune City,89,7,4,4,6,15,20,-5,16
NorthEast Un,89,8,4,3,7,10,13,-3,15
Mumbai City,90,1,6,4,4,16,9,7,22
Kerala Blast,90,2,6,3,5,13,16,-3,21
Delhi Dynamo,90,3,5,5,4,22,18,4,20
NorthEast Un,90,4,6,2,6,13,12,1,20
Kolkata,90,5,4,7,3,17,15,2,19
Chennaiyin,90,6,4,6,4,17,19,-2,18
FC Pune City,90,7,4,4,6,13,17,-4,16
FC Goa,90,8,4,3,7,12,17,-5,15
Mumbai City,91,1,7,4,3,20,8,12,25
Kerala Blast,91,2,6,4,4,14,15,-1,22
Kolkata,91,3,5,6,3,19,14,5,21
Delhi Dynamo,91,4,5,5,4,23,21,2,20
NorthEast Un,91,5,5,2,7,14,16,-2,17
FC Goa,91,6,5,2,7,13,19,-6,17
FC Pune City,91,7,4,4,6,13,17,-4,16
Chennaiyin,91,8,3,5,6,16,22,-6,14
Delhi Dynamo,92,1,6,6,2,28,16,12,24
Mumbai City,92,2,6,5,3,18,10,8,23
Kerala Blast,92,3,6,4,4,16,17,-1,22
FC Pune City,92,4,5,3,6,16,18,-2,18
Chennaiyin,92,5,4,6,4,15,18,-3,18
Kolkata,92,6,3,8,3,17,17,0,17
NorthEast Un,92,7,4,2,8,10,16,-6,14
FC Goa,92,8,3,4,7,9,17,-8,13
Mumbai City,93,1,6,5,3,17,9,8,23
Delhi Dynamo,93,2,5,6,3,25,18,7,21
Kolkata,93,3,4,7,3,16,15,1,19
Kerala Blast,93,4,5,4,5,12,16,-4,19
NorthEast Un,93,5,5,3,6,12,12,0,18
FC Pune City,93,6,5,3,6,15,17,-2,18
Chennaiyin,93,7,4,6,4,15,18,-3,18
FC Goa,93,8,3,4,7,11,18,-7,13
Mumbai City,94,1,7,4,3,18,9,9,25
Delhi Dynamo,94,2,6,5,3,27,17,10,23
Kerala Blast,94,3,6,4,4,14,16,-2,22
Kolkata,94,4,4,8,2,18,14,4,20
Chennaiyin,94,5,4,5,5,18,20,-2,17
FC Pune City,94,6,4,3,7,13,19,-6,15
FC Goa,94,7,4,3,7,12,18,-6,15
NorthEast Un,94,8,4,2,8,11,18,-7,14
Delhi Dynamo,95,1,6,5,3,25,17,8,23
Mumbai City,95,2,6,4,4,16,10,6,22
Kolkata,95,3,5,6,3,19,15,4,21
NorthEast Un,95,4,6,2,6,14,12,2,20
Kerala Blast,95,5,5,3,6,12,18,-6,18
FC Goa,95,6,5,2,7,13,17,-4,17
Chennaiyin,95,7,4,5,5,15,20,-5,17
FC Pune City,95,8,4,3,7,12,17,-5,15
Mumbai City,96,1,7,4,3,19,9,10,25
Kolkata,96,2,5,6,3,18,15,3,21
Kerala Blast,96,3,6,3,5,16,20,-4,21
Delhi Dynamo,96,4,4,6,4,24,20,4,18
NorthEast Un,96,5,5,3,6,13,13,0,18
FC Pune City,96,6,5,3,6,16,18,-2,18
FC Goa,96,7,4,3,7,14,17,-3,15
Chennaiyin,96,8,3,6,5,13,21,-8,15
Delhi Dynamo,97,1,7,5,2,27,15,12,26
Kolkata,97,2,6,6,2,20,14,6,24
Mumbai City,97,3,6,4,4,17,11,6,22
Chennaiyin,97,4,4,6,4,17,20,-3,18
Kerala Blast,97,5,4,5,5,13,18,-5,17
FC Pune City,97,6,4,4,6,14,17,-3,16
NorthEast Un,97,7,4,3,7,15,17,-2,15
FC Goa,97,8,3,3,8,9,20,-11,12
Delhi Dynamo,98,1,6,5,3,26,23,3,23
Mumbai City,98,2,6,4,4,17,10,7,22
NorthEast Un,98,3,6,3,5,21,12,9,21
Kolkata,98,4,4,7,3,21,17,4,19
FC Pune City,98,5,5,4,5,18,19,-1,19
Chennaiyin,98,6,4,6,4,16,19,-3,18
Kerala Blast,98,7,5,3,6,15,20,-5,18
FC Goa,98,8,3,2,9,9,23,-14,11
Delhi Dynamo,99,1,6,6,2,24,14,10,24
Mumbai City,99,2,6,4,4,16,9,7,22
Kerala Blast,99,3,6,4,4,15,15,0,22
Kolkata,99,4,4,6,4,15,15,0,18
NorthEast Un,99,5,5,3,6,10,12,-2,18
Chennaiyin,99,6,4,5,5,16,18,-2,17
FC Pune City,99,7,4,4,6,15,18,-3,16
FC Goa,99,8,4,2,8,9,19,-10,14
Delhi Dynamo,100,1,6,6,2,26,17,9,24
Mumbai City,100,2,6,5,3,17,9,8,23
Kolkata,100,3,5,6,3,18,15,3,21
FC Pune City,100,4,6,3,5,15,15,0,21
Chennaiyin,100,5,4,6,4,14,17,-3,18
Kerala Blast,100,6,5,3,6,13,16,-3,18
NorthEast Un,100,7,4,2,8,9,15,-6,14
FC Goa,100,8,3,3,8,11,19,-8,12
Mumbai City,101,1,7,4,3,18,9,9,25
Delhi Dynamo,101,2,6,5,3,29,18,11,23
Kerala Blast,101,3,5,5,4,13,16,-3,20
Kolkata,101,4,4,7,3,17,16,1,19
NorthEast Un,101,5,5,3,6,12,15,-3,18
FC Pune City,101,6,4,5,5,14,16,-2,17
Chennaiyin,101,7,4,5,5,15,19,-4,17
FC Goa,101,8,3,2,9,11,20,-9,11
Mumbai City,102,1,6,5,3,18,10,8,23
NorthEast Un,102,2,7,2,5,17,12,5,23
Delhi Dynamo,102,3,4,7,3,24,19,5,19
FC Pune City,102,4,5,4,5,16,15,1,19
Kolkata,102,5,3,8,3,15,15,0,17
Chennaiyin,102,6,4,5,5,15,19,-4,17
Kerala Blast,102,7,4,4,6,10,19,-9,16
FC Goa,102,8,4,3,7,10,16,-6,15
Mumbai City,103,1,6,5,3,17,9,8,23
NorthEast Un,103,2,6,3,5,14,11,3,21
Kolkata,103,3,5,6,3,15,13,2,21
Delhi Dynamo,103,4,4,6,4,23,19,4,18
Kerala Blast,103,5,5,3,6,14,15,-1,18
FC Pune City,103,6,5,3,6,13,19,-6,18
FC Goa,103,7,5,2,7,12,16,-4,17
Chennaiyin,103,8,3,6,5,15,21,-6,15
Mumbai City,104,1,6,5,3,17,9,8,23
Delhi Dynamo,104,2,4,8,2,24,17,7,20
NorthEast Un,104,3,5,4,5,12,11,1,19
Kerala Blast,104,4,5,4,5,12,16,-4,19
FC Pune City,104,5,5,3,6,15,16,-1,18
Kolkata,104,5,4,6,4,15,16,-1,18
Chennaiyin,104,7,4,5,5,16,20,-4,17
FC Goa,104,8,4,3,7,11,17,-6,15
Delhi Dynamo,105,1,6,5,3,25,17,8,23
Mumbai City,105,2,6,4,4,16,10,6,22
NorthEast Un,105,3,6,2,6,13,12,1,20
Kolkata,105,4,4,7,3,17,16,1,19
Kerala Blast,105,5,5,4,5,15,18,-3,19
FC Pune City,105,6,5,3,6,13,16,-3,18
Chennaiyin,105,7,4,5,5,16,20,-4,17
FC Goa,105,8,4,2,8,12,18,-6,14
Mumbai City,106,1,7,4,3,19,8,11,25
Delhi Dynamo,106,2,6,5,3,26,20,6,23
FC Pune City,106,3,6,3,5,15,15,0,21
Kolkata,106,4,4,7,3,15,13,2,19
Kerala Blast,106,5,4,5,5,13,18,-5,17
NorthEast Un,106,6,4,4,6,12,13,-1,16
Chennaiyin,106,7,3,6,5,15,20,-5,15
FC Goa,106,8,4,2,8,14,22,-8,14
Kolkata,107,1,6,6,2,22,16,6,24
Mumbai City,107,2,6,5,3,16,8,8,23
Delhi Dynamo,107,3,5,7,2,24,15,9,22
Kerala Blast,107,4,6,3,5,16,19,-3,21
NorthEast Un,107,5,5,2,7,10,12,-2,17
Chennaiyin,107,6,4,5,5,15,19,-4,17
FC Pune City,107,7,4,3,7,15,19,-4,15
FC Goa,107,8,3,3,8,12,22,-10,12
Mumbai City,108,1,7,4,3,18,9,9,25
Delhi Dynamo,108,2,5,5,4,24,20,4,20
Kolkata,108,3,4,8,2,19,15,4,20
Chennaiyin,108,4,5,5,4,16,17,-1,20
FC Pune City,108,5,5,4,5,15,16,-1,19
NorthEast Un,108,6,5,3,6,12,10,2,18
Kerala Blast,108,7,4,5,5,10,15,-5,17
FC Goa,108,8,3,2,9,9,21,-12,11
Mumbai City,109,1,6,5,3,17,9,8,23
Delhi Dynamo,109,2,5,6,3,24,19,5,21
Kolkata,109,3,4,7,3,14,13,1,19
NorthEast Un,109,4,5,3,6,13,12,1,18
Chennaiyin,109,5,4,6,4,15,17,-2,18
FC Pune City,109,6,4,5,5,12,14,-2,17
Kerala Blast,109,7,4,5,5,10,15,-5,17
FC Goa,109,8,4,3,7,10,16,-6,15
Mumbai City,110,1,6,5,3,17,9,8,23
Delhi Dynamo,110,2,5,7,2,26,17,9,22
Kolkata,110,3,4,7,3,17,15,2,19
Kerala Blast,110,4,5,4,5,12,16,-4,19
Chennaiyin,110,5,4,6,4,15,18,-3,18
FC Pune City,110,6,5,3,6,14,17,-3,18
NorthEast Un,110,7,4,3,7,11,14,-3,15
FC Goa,110,8,3,5,6,11,17,-6,14
Mumbai City,111,1,7,4,3,18,9,9,25
Delhi Dynamo,111,2,5,6,3,25,17,8,21
Kerala Blast,111,3,5,4,5,14,16,-2,19
Kolkata,111,4,4,6,4,16,18,-2,18
FC Pune City,111,5,5,3,6,14,16,-2,18
Chennaiyin,111,6,4,6,4,16,19,-3,18
NorthEast Un,111,7,4,4,6,12,13,-1,16
FC Goa,111,8,4,3,7,10,17,-7,15
Mumbai City,112,1,7,4,3,19,8,11,25
Delhi Dynamo,112,2,6,5,3,25,19,6,23
Kerala Blast,112,3,6,3,5,15,16,-1,21
Kolkata,112,4,4,6,4,16,15,1,18
Chennaiyin,112,5,4,6,4,14,17,-3,18
FC Pune City,112,6,5,3,6,14,18,-4,18
NorthEast Un,112,7,5,2,7,12,13,-1,17
FC Goa,112,8,3,3,8,8,17,-9,12
Mumbai City,113,1,6,4,4,16,11,5,22
Delhi Dynamo,113,2,5,6,3,25,16,9,21
FC Pune City,113,3,6,3,5,14,14,0,21
NorthEast Un,113,4,5,4,5,13,12,1,19
Kolkata,113,5,4,6,4,19,16,3,18
Chennaiyin,113,6,4,6,4,18,19,-1,18
Kerala Blast,113,7,4,4,6,10,21,-11,16
FC Goa,113,8,4,3,7,12,18,-6,15
Mumbai City,114,1,6,5,3,18,10,8,23
Delhi Dynamo,114,2,5,7,2,27,18,9,22
NorthEast Un,114,3,6,2,6,12,12,0,20
FC Pune City,114,4,5,4,5,13,14,-1,19
Kerala Blast,114,5,5,4,5,13,16,-3,19
Kolkata,114,6,4,6,4,18,17,1,18
Chennaiyin,114,7,4,5,5,16,18,-2,17
FC Goa,114,8,3,3,8,9,21,-12,12
Mumbai City,115,1,7,4,3,17,8,9,25
Delhi Dynamo,115,2,6,5,3,24,15,9,23
Kolkata,115,3,4,8,2,15,13,2,20
Kerala Blast,115,4,5,4,5,12,14,-2,19
Chennaiyin,115,5,4,6,4,18,19,-1,18
FC Pune City,115,6,5,3,6,13,15,-2,18
NorthEast Un,115,7,4,2,8,10,18,-8,14
FC Goa,115,8,3,4,7,10,17,-7,13
Mumbai City,116,1,7,4,3,18,9,9,25
Kolkata,116,2,5,6,3,17,15,2,21
NorthEast Un,116,3,6,3,5,11,9,2,21
Kerala Blast,116,4,5,5,4,10,13,-3,20
Delhi Dynamo,116,5,4,6,4,23,18,5,18
FC Pune City,116,6,4,4,6,13,16,-3,16
FC Goa,116,7,4,3,7,12,17,-5,15
Chennaiyin,116,8,3,5,6,13,20,-7,14
Delhi Dynamo,117,1,6,6,2,27,16,11,24
Mumbai City,117,2,6,5,3,17,9,8,23
Kolkata,117,3,5,6,3,18,15,3,21
NorthEast Un,117,4,5,3,6,11,11,0,18
FC Pune City,117,5,5,3,6,15,17,-2,18
Kerala Blast,117,6,4,4,6,10,17,-7,16
Chennaiyin,117,7,3,6,5,15,20,-5,15
FC Goa,117,8,4,3,7,12,20,-8,15
Delhi Dynamo,118,1,6,6,2,28,17,11,24
Mumbai City,118,2,6,4,4,16,10,6,22
Kolkata,118,3,4,6,4,15,14,1,18
Chennaiyin,118,4,4,6,4,16,18,-2,18
FC Pune City,118,5,5,3,6,15,18,-3,18
Kerala Blast,118,6,5,3,6,12,19,-7,18
NorthEast Un,118,7,5,2,7,13,14,-1,17
FC Goa,118,8,4,4,6,12,17,-5,16
Delhi Dynamo,119,1,7,5,2,27,15,12,26
Mumbai City,119,2,6,4,4,16,10,6,22
Kerala Blast,119,3,6,4,4,15,14,1,22
NorthEast Un,119,4,5,3,6,10,11,-1,18
Chennaiyin,119,5,4,5,5,14,18,-4,17
FC Pune City,119,6,4,4,6,14,17,-3,16
Kolkata,119,7,3,7,4,15,19,-4,16
FC Goa,119,8,4,2,8,11,18,-7,14
Mumbai City,120,1,7,4,3,17,8,9,25
Kolkata,120,2,4,8,2,15,13,2,20
Chennaiyin,120,3,5,5,4,16,18,-2,20
Delhi Dynamo,120,4,4,7,3,25,19,6,19
Kerala Blast,120,5,5,4,5,11,15,-4,19
FC Pune City,120,6,4,5,5,13,15,-2,17
NorthEast Un,120,7,4,3,7,12,14,-2,15
FC Goa,120,8,3,4,7,11,18,-7,13
Mumbai City,121,1,6,5,3,17,9,8,23
Delhi Dynamo,121,2,5,7,2,27,19,8,22
Kolkata,121,3,5,6,3,18,15,3,21
NorthEast Un,121,4,6,2,6,15,12,3,20
FC Pune City,121,5,5,4,5,16,16,0,19
Kerala Blast,121,6,4,4,6,12,18,-6,16
FC Goa,121,7,4,3,7,11,19,-8,15
Chennaiyin,121,8,3,5,6,13,21,-8,14
Mumbai City,122,1,7,4,3,21,10,11,25
FC Goa,122,2,6,2,6,18,17,1,20
FC Pune City,122,3,5,4,5,15,16,-1,19
Delhi Dynamo,122,4,4,6,4,25,24,1,18
NorthEast Un,122,5,5,3,6,13,13,0,18
Kolkata,122,6,4,6,4,18,19,-1,18
Chennaiyin,122,7,4,5,5,17,20,-3,17
Kerala Blast,122,8,4,4,6,10,18,-8,16
Delhi Dynamo,123,1,6,6,2,25,15,10,24
Mumbai City,123,2,6,4,4,16,10,6,22
Kolkata,123,3,4,7,3,17,16,1,19
FC Goa,123,4,5,3,6,13,16,-3,18
Kerala Blast,123,5,4,6,4,11,15,-4,18
Chennaiyin,123,6,4,5,5,17,19,-2,17
FC Pune City,123,7,4,4,6,13,16,-3,16
NorthEast Un,123,8,4,3,7,10,15,-5,15
Mumbai City,124,1,7,4,3,19,8,11,25
NorthEast Un,124,2,6,3,5,15,11,4,21
Delhi Dynamo,124,3,5,5,4,24,22,2,20
FC Pune City,124,4,5,4,5,15,16,-1,19
Kerala Blast,124,5,4,6,4,9,13,-4,18
Kolkata,124,6,3,8,3,18,18,0,17
FC Goa,124,7,4,3,7,16,20,-4,15
Chennaiyin,124,8,3,5,6,15,23,-8,14
Mumbai City,125,1,7,4,3,18,9,9,25
Delhi Dynamo,125,2,5,6,3,26,17,9,21
Kolkata,125,3,5,6,3,17,16,1,21
Kerala Blast,125,4,5,4,5,12,15,-3,19
NorthEast Un,125,5,4,5,5,11,11,0,17
FC Goa,125,6,5,2,7,13,19,-6,17
Chennaiyin,125,7,3,6,5,15,20,-5,15
FC Pune City,125,8,4,3,7,14,19,-5,15
Mumbai City,126,1,7,4,3,18,9,9,25
Delhi Dynamo,126,2,6,5,3,26,16,10,23
Kolkata,126,3,4,7,3,18,15,3,19
FC Pune City,126,4,5,4,5,16,17,-1,19
Kerala Blast,126,5,4,5,5,12,19,-7,17
NorthEast Un,126,6,4,4,6,12,14,-2,16
Chennaiyin,126,7,3,6,5,17,22,-5,15
FC Goa,126,8,4,3,7,12,19,-7,15
Mumbai City,127,1,7,4,3,19,8,11,25
Kolkata,127,2,6,6,2,20,14,6,24
NorthEast Un,127,3,6,3,5,14,11,3,21
Delhi Dynamo,127,4,4,6,4,22,19,3,18
FC Pune City,127,5,5,3,6,14,17,-3,18
Kerala Blast,127,6,4,4,6,9,16,-7,16
Chennaiyin,127,7,3,6,5,14,20,-6,15
FC Goa,127,8,3,4,7,9,16,-7,13
Delhi Dynamo,128,1,7,5,2,27,17,10,26
Mumbai City,128,2,6,4,4,16,9,7,22
Kerala Blast,128,3,6,4,4,17,15,2,22
Kolkata,128,4,4,7,3,17,16,1,19
Chennaiyin,128,5,4,6,4,14,17,-3,18
NorthEast Un,128,6,4,4,6,12,13,-1,16
FC Pune City,128,7,4,3,7,13,21,-8,15
FC Goa,128,8,3,3,8,8,16,-8,12
Mumbai City,129,1,7,4,3,19,9,10,25
Delhi Dynamo,129,2,5,6,3,27,21,6,21
Kolkata,129,3,4,7,3,22,19,3,19
FC Pune City,129,4,5,4,5,16,16,0,19
Chennaiyin,129,5,4,6,4,19,20,-1,18
NorthEast Un,129,6,4,4,6,13,14,-1,16
Kerala Blast,129,7,4,4,6,11,21,-10,16
FC Goa,129,8,4,3,7,14,21,-7,15
Delhi Dynamo,130,1,7,5,2,30,15,15,26
Mumbai City,130,2,6,4,4,16,11,5,22
FC Pune City,130,3,6,3,5,18,16,2,21
Kolkata,130,4,5,6,3,19,18,1,21
NorthEast Un,130,5,6,2,6,14,14,0,20
Chennaiyin,130,6,3,6,5,14,19,-5,15
Kerala Blast,130,7,4,3,7,10,17,-7,15
FC Goa,130,8,3,3,8,9,20,-11,12
Delhi Dynamo,131,1,7,5,2,26,14,12,26
Mumbai City,131,2,6,4,4,16,9,7,22
Kolkata,131,3,5,7,2,18,13,5,22
Kerala Blast,131,4,6,3,5,12,16,-4,21
Chennaiyin,131,5,4,6,4,17,19,-2,18
FC Pune City,131,6,4,4,6,12,15,-3,16
NorthEast Un,131,7,4,2,8,10,14,-4,14
FC Goa,131,8,3,3,8,9,20,-11,12
Mumbai City,132,1,7,4,3,20,8,12,25
Kerala Blast,132,2,6,4,4,15,16,-1,22
Delhi Dynamo,132,3,5,6,3,25,20,5,21
FC Pune City,132,4,5,4,5,15,16,-1,19
Kolkata,132,5,3,7,4,16,17,-1,16
NorthEast Un,132,6,4,4,6,11,13,-2,16
Chennaiyin,132,7,3,7,4,14,18,-4,16
FC Goa,132,8,3,4,7,9,17,-8,13
Mumbai City,133,1,7,4,3,20,10,10,25
FC Pune City,133,2,6,3,5,18,18,0,21
Delhi Dynamo,133,3,5,5,4,27,21,6,20
NorthEast Un,133,4,6,2,6,12,12,0,20
Kolkata,133,5,4,7,3,16,15,1,19
Kerala Blast,133,6,5,4,5,13,16,-3,19
Chennaiyin,133,7,4,5,5,15,19,-4,17
FC Goa,133,8,3,2,9,10,20,-10,11
Kerala Blast,134,1,7,3,4,16,15,1,24
Mumbai City,134,2,6,5,3,18,10,8,23
Delhi Dynamo,134,3,5,6,3,25,20,5,21
FC Goa,134,4,5,3,6,15,17,-2,18
Kolkata,134,5,3,8,3,18,18,0,17
NorthEast Un,134,6,5,2,7,13,14,-1,17
FC Pune City,134,7,4,4,6,13,17,-4,16
Chennaiyin,134,8,3,5,6,15,22,-7,14
Mumbai City,135,1,6,5,3,16,8,8,23
Kolkata,135,2,4,8,2,16,14,2,20
NorthEast Un,135,3,6,2,6,14,14,0,20
Chennaiyin,135,4,5,5,4,16,17,-1,20
Delhi Dynamo,135,5,4,7,3,23,17,6,19
Kerala Blast,135,6,5,4,5,12,16,-4,19
FC Pune City,135,7,4,3,7,13,17,-4,15
FC Goa,135,8,3,4,7,8,15,-7,13
Delhi Dynamo,136,1,7,5,2,27,16,11,26
Mumbai City,136,2,6,4,4,17,11,6,22
Kolkata,136,3,5,7,2,15,12,3,22
Chennaiyin,136,4,5,5,4,18,17,1,20
Kerala Blast,136,5,5,5,4,11,14,-3,20
NorthEast Un,136,6,4,3,7,10,13,-3,15
FC Pune City,136,7,4,3,7,13,17,-4,15
FC Goa,136,8,3,2,9,8,19,-11,11
Mumbai City,137,1,7,4,3,17,8,9,25
Delhi Dynamo,137,2,5,5,4,23,16,7,20
Chennaiyin,137,3,5,5,4,18,17,1,20
Kolkata,137,4,4,7,3,16,15,1,19
Kerala Blast,137,5,5,4,5,12,16,-4,19
FC Pune City,137,6,5,3,6,14,16,-2,18
NorthEast Un,137,7,5,2,7,10,13,-3,17
FC Goa,137,8,4,2,8,10,19,-9,14
Mumbai City,138,1,7,4,3,18,9,9,25
Kolkata,138,2,6,6,2,19,14,5,24
Delhi Dynamo,138,3,5,5,4,26,19,7,20
NorthEast Un,138,4,5,4,5,15,13,2,19
Kerala Blast,138,5,5,4,5,14,18,-4,19
Chennaiyin,138,6,4,6,4,16,19,-3,18
FC Pune City,138,7,4,3,7,13,18,-5,15
FC Goa,138,8,3,2,9,10,21,-11,11
Mumbai City,139,1,7,4,3,18,9,9,25
Delhi Dynamo,139,2,6,5,3,31,18,13,23
Kerala Blast,139,3,6,4,4,14,14,0,22
Kolkata,139,4,4,6,4,16,17,-1,18
Chennaiyin,139,5,4,5,5,16,20,-4,17
NorthEast Un,139,6,5,2,7,11,16,-5,17
FC Pune City,139,7,4,4,6,14,18,-4,16
FC Goa,139,8,4,2,8,12,20,-8,14
Mumbai City,140,1,6,5,3,17,9,8,23
Delhi Dynamo,140,2,5,7,2,25,17,8,22
Kolkata,140,3,5,6,3,20,16,4,21
Kerala Blast,140,4,5,4,5,13,18,-5,19
FC Goa,140,5,5,3,6,13,16,-3,18
NorthEast Un,140,6,4,4,6,12,13,-1,16
Chennaiyin,140,7,3,6,5,14,19,-5,15
FC Pune City,140,8,4,3,7,12,18,-6,15
Mumbai City,141,1,7,4,3,23,10,13,25
Kerala Blast,141,2,6,4,4,13,15,-2,22
Delhi Dynamo,141,3,5,6,3,27,23,4,21
Chennaiyin,141,4,5,5,4,21,18,3,20
Kolkata,141,5,4,7,3,16,14,2,19
FC Pune City,141,6,4,4,6,14,18,-4,16
NorthEast Un,141,7,4,2,8,11,17,-6,14
FC Goa,141,8,3,4,7,10,20,-10,13
Mumbai City,142,1,6,5,3,17,9,8,23
FC Pune City,142,2,6,3,5,15,14,1,21
FC Goa,142,3,6,2,6,13,15,-2,20
Delhi Dynamo,142,4,4,6,4,22,18,4,18
NorthEast Un,142,5,5,3,6,13,13,0,18
Kolkata,142,6,4,6,4,15,17,-2,18
Kerala Blast,142,7,5,3,6,13,17,-4,18
Chennaiyin,142,8,3,6,5,15,20,-5,15
Mumbai City,143,1,7,4,3,17,8,9,25
NorthEast Un,143,2,7,2,5,15,9,6,23
Delhi Dynamo,143,3,5,5,4,23,19,4,20
Kerala Blast,143,4,5,4,5,12,17,-5,19
FC Pune City,143,5,4,5,5,15,17,-2,17
FC Goa,143,6,5,2,7,12,17,-5,17
Kolkata,143,7,3,7,4,19,20,-1,16
Chennaiyin,143,8,3,5,6,13,19,-6,14
Mumbai City,144,1,7,4,3,18,8,10,25
Delhi Dynamo,144,2,6,5,3,25,17,8,23
FC Pune City,144,3,6,3,5,16,14,2,21
Chennaiyin,144,4,5,5,4,18,17,1,20
Kerala Blast,144,5,5,3,6,11,16,-5,18
NorthEast Un,144,6,5,2,7,10,13,-3,17
Kolkata,144,7,3,7,4,14,17,-3,16
FC Goa,144,8,3,3,8,10,20,-10,12
Mumbai City,145,1,6,4,4,16,9,7,22
Kerala Blast,145,2,6,4,4,15,15,0,22
Delhi Dynamo,145,3,5,6,3,23,16,7,21
Kolkata,145,4,4,7,3,18,16,2,19
NorthEast Un,145,5,5,3,6,12,14,-2,18
FC Goa,145,6,5,3,6,12,16,-4,18
FC Pune City,145,7,4,4,6,14,18,-4,16
Chennaiyin,145,8,3,5,6,15,21,-6,14
Delhi Dynamo,146,1,7,5,2,27,15,12,26
Mumbai City,146,2,6,4,4,16,9,7,22
Kolkata,146,3,5,6,3,19,15,4,21
Chennaiyin,146,4,4,5,5,17,21,-4,17
FC Goa,146,5,5,2,7,13,20,-7,17
Kerala Blast,146,6,4,5,5,12,19,-7,17
FC Pune City,146,7,4,4,6,13,16,-3,16
NorthEast Un,146,8,4,3,7,14,16,-2,15
Delhi Dynamo,147,1,6,6,2,27,17,10,24
Mumbai City,147,2,6,5,3,18,10,8,23
Kerala Blast,147,3,5,5,4,11,14,-3,20
Kolkata,147,4,4,7,3,18,16,2,19
Chennaiyin,147,5,4,5,5,17,20,-3,17
FC Goa,147,6,5,2,7,13,18,-5,17
NorthEast Un,147,7,4,3,7,10,14,-4,15
FC Pune City,147,8,4,3,7,13,18,-5,15
Mumbai City,148,1,7,4,3,18,9,9,25
NorthEast Un,148,2,6,2,6,13,10,3,20
Kerala Blast,148,3,5,5,4,13,16,-3,20
Kolkata,148,4,4,7,3,17,15,2,19
FC Pune City,148,5,5,4,5,14,15,-1,19
Delhi Dynamo,148,6,4,6,4,22,19,3,18
Chennaiyin,148,7,4,5,5,15,18,-3,17
FC Goa,148,8,3,3,8,8,18,-10,12
Delhi Dynamo,149,1,6,5,3,28,16,12,23
Mumbai City,149,2,6,4,4,16,9,7,22
NorthEast Un,149,3,6,3,5,13,10,3,21
Kerala Blast,149,4,5,5,4,11,14,-3,20
Kolkata,149,5,4,7,3,16,15,1,19
FC Pune City,149,6,5,3,6,15,16,-1,18
Chennaiyin,149,7,3,5,6,14,22,-8,14
FC Goa,149,8,4,2,8,12,23,-11,14
Mumbai City,150,1,7,4,3,18,9,9,25
Kolkata,150,2,6,6,2,20,13,7,24
Kerala Blast,150,3,5,4,5,12,17,-5,19
Delhi Dynamo,150,4,4,6,4,25,20,5,18
NorthEast Un,150,5,4,4,6,11,12,-1,16
Chennaiyin,150,6,3,7,4,15,19,-4,16
FC Pune City,150,7,4,4,6,12,16,-4,16
FC Goa,150,8,4,3,7,13,20,-7,15
Delhi Dynamo,151,1,7,5,2,25,15,10,26
Mumbai City,151,2,6,4,4,16,9,7,22
FC Pune City,151,3,6,3,5,15,15,0,21
NorthEast Un,151,4,5,3,6,12,12,0,18
Kolkata,151,5,3,8,3,14,14,0,17
Chennaiyin,151,6,3,7,4,15,19,-4,16
Kerala Blast,151,7,4,4,6,11,17,-6,16
FC Goa,151,8,3,4,7,9,16,-7,13
Delhi Dynamo,152,1,7,5,2,27,15,12,26
Mumbai City,152,2,6,4,4,16,11,5,22
Kolkata,152,3,5,6,3,16,13,3,21
Kerala Blast,152,4,5,4,5,11,14,-3,19
FC Pune City,152,5,5,3,6,13,16,-3,18
Chennaiyin,152,6,4,5,5,14,19,-5,17
NorthEast Un,152,7,4,3,7,9,11,-2,15
FC Goa,152,8,4,2,8,11,18,-7,14
Mumbai City,153,1,7,4,3,17,8,9,25
Delhi Dynamo,153,2,5,6,3,23,16,7,21
Kerala Blast,153,3,5,5,4,14,17,-3,20
FC Pune City,153,4,5,4,5,17,16,1,19
Kolkata,153,5,4,7,3,17,18,-1,19
Chennaiyin,153,6,4,5,5,16,18,-2,17
NorthEast Un,153,7,4,3,7,12,16,-4,15
FC Goa,153,8,4,2,8,10,17,-7,14
Kolkata,154,1,6,6,2,17,13,4,24
Delhi Dynamo,154,2,6,5,3,28,19,9,23
Mumbai City,154,3,6,4,4,16,11,5,22
NorthEast Un,154,4,5,4,5,13,11,2,19
Kerala Blast,154,5,5,4,5,11,15,-4,19
FC Pune City,154,6,4,3,7,12,16,-4,15
Chennaiyin,154,7,3,6,5,14,19,-5,15
FC Goa,154,8,4,2,8,11,18,-7,14
Mumbai City,155,1,7,4,3,17,8,9,25
NorthEast Un,155,2,7,2,5,16,9,7,23
Kerala Blast,155,3,6,3,5,17,16,1,21
Delhi Dynamo,155,4,4,6,4,22,19,3,18
Kolkata,155,5,3,8,3,15,16,-1,17
FC Goa,155,6,4,4,6,12,16,-4,16
FC Pune City,155,7,4,4,6,15,21,-6,16
Chennaiyin,155,8,3,5,6,13,22,-9,14
Delhi Dynamo,156,1,6,5,3,24,16,8,23
Mumbai City,156,2,6,4,4,17,10,7,22
NorthEast Un,156,3,6,2,6,11,10,1,20
Kolkata,156,4,4,7,3,17,17,0,19
FC Goa,156,5,5,2,7,14,15,-1,17
FC Pune City,156,6,4,5,5,16,18,-2,17
Chennaiyin,156,7,4,5,5,14,21,-7,17
Kerala Blast,156,8,4,4,6,12,18,-6,16
Mumbai City,157,1,6,5,3,17,9,8,23
Delhi Dynamo,157,2,5,6,3,25,17,8,21
NorthEast Un,157,3,6,3,5,13,10,3,21
Kolkata,157,4,4,6,4,15,15,0,18
Chennaiyin,157,5,4,6,4,14,17,-3,18
FC Pune City,157,5,5,3,6,14,17,-3,18
Kerala Blast,157,7,5,3,6,13,17,-4,18
FC Goa,157,8,4,2,8,9,18,-9,14
Mumbai City,158,1,7,4,3,18,9,9,25
Kolkata,158,2,5,7,2,19,15,4,22
Delhi Dynamo,158,3,4,7,3,24,18,6,19
FC Pune City,158,4,5,3,6,15,17,-2,18
Kerala Blast,158,5,5,3,6,14,18,-4,18
NorthEast Un,158,6,4,4,6,12,15,-3,16
Chennaiyin,158,7,3,7,4,15,19,-4,16
FC Goa,158,8,3,5,6,11,17,-6,14
Mumbai City,159,1,7,4,3,17,8,9,25
Delhi Dynamo,159,2,6,5,3,25,17,8,23
Kolkata,159,3,5,6,3,18,15,3,21
NorthEast Un,159,4,5,3,6,12,12,0,18
FC Pune City,159,5,5,3,6,16,18,-2,18
Kerala Blast,159,6,5,3,6,14,18,-4,18
Chennaiyin,159,7,3,6,5,14,20,-6,15
FC Goa,159,8,4,2,8,11,19,-8,14
Mumbai City,160,1,7,4,3,18,9,9,25
Kolkata,160,2,4,8,2,18,16,2,20
Chennaiyin,160,3,5,5,4,18,18,0,20
Delhi Dynamo,160,4,4,7,3,24,18,6,19
Kerala Blast,160,5,5,4,5,12,16,-4,19
FC Pune City,160,6,5,3,6,14,16,-2,18
NorthEast Un,160,7,4,3,7,9,12,-3,15
FC Goa,160,8,3,4,7,12,20,-8,13
Mumbai City,161,1,7,4,3,19,9,10,25
Kolkata,161,2,5,7,2,18,15,3,22
Kerala Blast,161,3,5,4,5,14,16,-2,19
Delhi Dynamo,161,4,4,6,4,23,19,4,18
Chennaiyin,161,5,4,6,4,16,17,-1,18
NorthEast Un,161,6,5,3,6,12,14,-2,18
FC Pune City,161,7,4,3,7,13,19,-6,15
FC Goa,161,8,3,5,6,9,15,-6,14
Delhi Dynamo,162,1,6,5,3,27,18,9,23
Mumbai City,162,2,6,4,4,17,12,5,22
Kerala Blast,162,3,6,4,4,16,17,-1,22
Chennaiyin,162,4,5,5,4,16,18,-2,20
Kolkata,162,5,4,7,3,19,16,3,19
FC Goa,162,6,5,2,7,12,15,-3,17
FC Pune City,162,7,4,3,7,15,22,-7,15
NorthEast Un,162,8,4,2,8,12,16,-4,14
Kolkata,163,1,6,6,2,24,13,11,24
Mumbai City,163,2,6,5,3,17,9,8,23
Delhi Dynamo,163,3,5,7,2,28,19,9,22
NorthEast Un,163,4,6,3,5,15,13,2,21
Kerala Blast,163,5,5,3,6,11,18,-7,18
Chennaiyin,163,6,4,5,5,14,18,-4,17
FC Pune City,163,7,4,3,7,12,20,-8,15
FC Goa,163,8,3,2,9,10,21,-11,11
Delhi Dynamo,164,1,7,5,2,25,15,10,26
Mumbai City,164,2,6,4,4,16,9,7,22
Kerala Blast,164,3,6,4,4,14,16,-2,22
Kolkata,164,4,4,6,4,16,17,-1,18
Chennaiyin,164,5,4,6,4,16,18,-2,18
FC Pune City,164,6,4,4,6,13,16,-3,16
FC Goa,164,7,4,3,7,13,18,-5,15
NorthEast Un,164,8,4,2,8,10,14,-4,14
Mumbai City,165,1,7,4,3,18,8,10,25
Delhi Dynamo,165,2,5,5,4,23,18,5,20
Kolkata,165,3,4,8,2,16,14,2,20
Kerala Blast,165,4,5,5,4,14,16,-2,20
Chennaiyin,165,5,4,6,4,16,18,-2,18
NorthEast Un,165,6,5,2,7,11,14,-3,17
FC Pune City,165,7,4,4,6,13,16,-3,16
FC Goa,165,8,3,4,7,11,18,-7,13
Mumbai City,166,1,7,4,3,20,9,11,25
Kerala Blast,166,2,7,3,4,14,14,0,24
Delhi Dynamo,166,3,5,5,4,25,21,4,20
Kolkata,166,4,4,7,3,16,15,1,19
NorthEast Un,166,5,5,3,6,12,11,1,18
FC Pune City,166,6,4,4,6,13,16,-3,16
Chennaiyin,166,7,3,6,5,15,20,-5,15
FC Goa,166,8,4,2,8,12,21,-9,14
Mumbai City,167,1,7,4,3,18,8,10,25
Delhi Dynamo,167,2,6,5,3,27,18,9,23
Kolkata,167,3,4,8,2,17,15,2,20
Chennaiyin,167,4,5,5,4,17,18,-1,20
FC Pune City,167,5,5,3,6,13,15,-2,18
Kerala Blast,167,6,4,5,5,12,17,-5,17
NorthEast Un,167,7,4,3,7,10,15,-5,15
FC Goa,167,8,3,3,8,12,20,-8,12
Mumbai City,168,1,7,4,3,18,8,10,25
Kolkata,168,2,4,8,2,15,13,2,20
Kerala Blast,168,3,5,5,4,10,13,-3,20
Delhi Dynamo,168,4,4,7,3,24,19,5,19
NorthEast Un,168,5,4,4,6,11,12,-1,16
FC Pune City,168,6,4,4,6,12,15,-3,16
Chennaiyin,168,7,3,7,4,16,20,-4,16
FC Goa,168,8,3,5,6,13,19,-6,14
Delhi Dynamo,169,1,6,6,2,27,17,10,24
Mumbai City,169,2,6,5,3,18,10,8,23
Chennaiyin,169,3,5,5,4,17,17,0,20
Kerala Blast,169,4,5,4,5,10,17,-7,19
Kolkata,169,5,4,6,4,16,14,2,18
FC Pune City,169,6,5,3,6,16,17,-1,18
NorthEast Un,169,7,4,3,7,10,14,-4,15
FC Goa,169,8,4,2,8,9,17,-8,14
Mumbai City,170,1,7,4,3,18,8,10,25
Kerala Blast,170,2,7,3,4,14,14,0,24
Delhi Dynamo,170,3,4,7,3,24,19,5,19
Chennaiyin,170,4,4,6,4,15,17,-2,18
Kolkata,170,5,3,8,3,14,14,0,17
FC Pune City,170,6,4,4,6,13,17,-4,16
NorthEast Un,170,7,4,3,7,12,15,-3,15
FC Goa,170,8,3,5,6,9,15,-6,14
Delhi Dynamo,171,1,6,5,3,26,15,11,23
Mumbai City,171,2,6,4,4,16,10,6,22
NorthEast Un,171,3,6,3,5,13,10,3,21
FC Pune City,171,4,6,3,5,16,15,1,21
Kerala Blast,171,5,5,4,5,14,17,-3,19
Kolkata,171,6,4,6,4,15,17,-2,18
Chennaiyin,171,7,4,5,5,16,21,-5,17
FC Goa,171,8,3,2,9,11,22,-11,11
Delhi Dynamo,172,1,6,5,3,23,15,8,23
Mumbai City,172,2,6,4,4,16,9,7,22
NorthEast Un,172,3,6,3,5,12,10,2,21
FC Pune City,172,4,5,4,5,17,17,0,19
Kolkata,172,5,3,9,2,17,16,1,18
Chennaiyin,172,6,4,6,4,16,18,-2,18
Kerala Blast,172,7,4,4,6,12,19,-7,16
FC Goa,172,8,3,3,8,10,19,-9,12
Delhi Dynamo,173,1,6,6,2,25,15,10,24
Mumbai City,173,2,6,5,3,17,9,8,23
FC Pune City,173,3,6,3,5,18,15,3,21
Chennaiyin,173,4,5,5,4,15,17,-2,20
Kerala Blast,173,5,4,5,5,13,18,-5,17
Kolkata,173,6,3,7,4,16,21,-5,16
NorthEast Un,173,7,4,3,7,10,13,-3,15
FC Goa,173,8,4,2,8,11,17,-6,14
Mumbai City,174,1,7,4,3,19,9,10,25
Delhi Dynamo,174,2,6,5,3,25,18,7,23
Kolkata,174,3,5,7,2,18,14,4,22
Kerala Blast,174,4,5,5,4,15,18,-3,20
NorthEast Un,174,5,5,2,7,12,13,-1,17
FC Pune City,174,6,4,4,6,14,18,-4,16
Chennaiyin,174,7,3,6,5,13,18,-5,15
FC Goa,174,8,3,3,8,10,18,-8,12
Mumbai City,175,1,6,4,4,16,10,6,22
Delhi Dynamo,175,2,5,6,3,25,18,7,21
Kerala Blast,175,3,5,5,4,10,13,-3,20
Kolkata,175,4,4,7,3,16,14,2,19
NorthEast Un,175,5,5,3,6,13,14,-1,18
Chennaiyin,175,6,4,5,5,16,20,-4,17
FC Goa,175,7,4,4,6,12,15,-3,16
FC Pune City,175,8,4,4,6,12,16,-4,16
Mumbai City,176,1,7,4,3,18,8,10,25
Delhi Dynamo,176,2,6,5,3,26,18,8,23
Kerala Blast,176,3,6,4,4,14,14,0,22
Kolkata,176,4,4,6,4,17,15,2,18
NorthEast Un,176,5,5,2,7,13,15,-2,17
FC Pune City,176,6,4,4,6,12,18,-6,16
Chennaiyin,176,7,3,6,5,14,19,-5,15
FC Goa,176,8,4,3,7,10,17,-7,15
Mumbai City,177,1,7,4,3,17,8,9,25
Delhi Dynamo,177,2,6,5,3,29,20,9,23
Kerala Blast,177,3,6,4,4,15,14,1,22
Kolkata,177,4,3,9,2,17,16,1,18
Chennaiyin,177,5,4,5,5,16,19,-3,17
FC Pune City,177,6,4,4,6,13,18,-5,16
FC Goa,177,7,4,3,7,13,19,-6,15
NorthEast Un,177,8,4,2,8,13,19,-6,14
Delhi Dynamo,178,1,7,5,2,33,15,18,26
Mumbai City,178,2,6,4,4,16,10,6,22
Kerala Blast,178,3,5,5,4,13,14,-1,20
Kolkata,178,4,3,9,2,14,13,1,18
Chennaiyin,178,5,4,5,5,15,19,-4,17
FC Pune City,178,6,4,4,6,13,18,-5,16
NorthEast Un,178,7,4,3,7,9,14,-5,15
FC Goa,178,8,4,3,7,12,22,-10,15
Mumbai City,179,1,7,4,3,17,8,9,25
Delhi Dynamo,179,2,6,5,3,24,15,9,23
Kerala Blast,179,3,5,5,4,13,16,-3,20
Kolkata,179,4,3,8,3,15,15,0,17
FC Pune City,179,5,4,5,5,13,15,-2,17
Chennaiyin,179,6,4,5,5,15,19,-4,17
FC Goa,179,7,5,2,7,11,16,-5,17
NorthEast Un,179,8,4,2,8,11,15,-4,14
Mumbai City,180,1,7,4,3,19,8,11,25
Delhi Dynamo,180,2,5,6,3,25,18,7,21
Kolkata,180,3,5,6,3,21,18,3,21
NorthEast Un,180,4,5,4,5,11,9,2,19
Kerala Blast,180,5,5,4,5,12,16,-4,19
FC Goa,180,6,5,2,7,18,22,-4,17
FC Pune City,180,7,4,3,7,14,20,-6,15
Chennaiyin,180,8,3,5,6,14,23,-9,14
Mumbai City,181,1,7,4,3,19,10,9,25
Delhi Dynamo,181,2,5,6,3,27,19,8,21
Kolkata,181,3,4,7,3,15,13,2,19
NorthEast Un,181,4,5,4,5,14,13,1,19
Kerala Blast,181,5,4,6,4,10,14,-4,18
FC Pune City,181,6,4,4,6,12,16,-4,16
Chennaiyin,181,7,3,6,5,14,19,-5,15
FC Goa,181,8,4,3,7,9,16,-7,15
Mumbai City,182,1,6,5,3,17,9,8,23
Kerala Blast,182,2,6,4,4,15,15,0,22
Delhi Dynamo,182,3,5,6,3,28,16,12,21
Kolkata,182,4,4,7,3,16,16,0,19
FC Pune City,182,5,4,5,5,14,16,-2,17
FC Goa,182,6,5,2,7,11,16,-5,17
NorthEast Un,182,7,5,2,7,12,19,-7,17
Chennaiyin,182,8,3,5,6,14,20,-6,14
Mumbai City,183,1,7,4,3,20,9,11,25
Delhi Dynamo,183,2,5,5,4,25,21,4,20
NorthEast Un,183,3,6,2,6,13,12,1,20
Chennaiyin,183,4,5,5,4,15,17,-2,20
Kolkata,183,5,4,7,3,16,15,1,19
FC Pune City,183,6,5,4,5,14,14,0,19
Kerala Blast,183,7,4,3,7,10,19,-9,15
FC Goa,183,8,4,2,8,12,18,-6,14
Mumbai City,184,1,7,4,3,18,8,10,25
Kerala Blast,184,2,6,3,5,11,14,-3,21
Chennaiyin,184,3,5,5,4,16,17,-1,20
Delhi Dynamo,184,4,4,6,4,24,21,3,18
NorthEast Un,184,5,5,3,6,11,12,-1,18
FC Pune City,184,6,5,3,6,13,15,-2,18
FC Goa,184,7,5,2,7,16,19,-3,17
Kolkata,184,8,3,6,5,15,18,-3,15
Mumbai City,185,1,6,4,4,16,10,6,22
Kerala Blast,185,2,6,4,4,16,16,0,22
Delhi Dynamo,185,3,5,6,3,25,17,8,21
FC Goa,185,4,6,2,6,14,17,-3,20
Kolkata,185,5,3,8,3,18,18,0,17
Chennaiyin,185,6,4,5,5,14,18,-4,17
FC Pune City,185,7,4,4,6,13,16,-3,16
NorthEast Un,185,8,4,3,7,11,15,-4,15
Mumbai City,186,1,7,4,3,19,10,9,25
Kerala Blast,186,2,6,4,4,15,16,-1,22
Delhi Dynamo,186,3,5,6,3,30,20,10,21
FC Pune City,186,4,5,3,6,15,18,-3,18
Kolkata,186,5,3,8,3,17,17,0,17
FC Goa,186,6,4,4,6,12,16,-4,16
NorthEast Un,186,7,4,3,7,11,16,-5,15
Chennaiyin,186,8,3,6,5,13,19,-6,15
Mumbai City,187,1,6,4,4,17,10,7,22
Delhi Dynamo,187,2,5,6,3,26,19,7,21
NorthEast Un,187,3,5,4,5,13,12,1,19
Kolkata,187,4,3,9,2,15,14,1,18
FC Goa,187,5,5,3,6,14,18,-4,18
Kerala Blast,187,6,4,6,4,10,14,-4,18
FC Pune City,187,7,4,5,5,13,15,-2,17
Chennaiyin,187,8,3,5,6,15,21,-6,14
Mumbai City,188,1,6,5,3,17,9,8,23
Delhi Dynamo,188,2,5,6,3,30,17,13,21
Kolkata,188,3,5,6,3,18,14,4,21
Kerala Blast,188,4,5,4,5,11,15,-4,19
NorthEast Un,188,5,5,3,6,12,11,1,18
Chennaiyin,188,6,4,6,4,15,18,-3,18
FC Pune City,188,7,4,4,6,12,17,-5,16
FC Goa,188,8,4,2,8,9,23,-14,14
Mumbai City,189,1,7,4,3,21,10,11,25
Delhi Dynamo,189,2,5,6,3,27,21,6,21
Kolkata,189,3,4,8,2,16,14,2,20
FC Pune City,189,4,5,3,6,14,16,-2,18
Chennaiyin,189,5,4,5,5,15,20,-5,17
Kerala Blast,189,6,4,5,5,13,18,-5,17
NorthEast Un,189,7,4,4,6,11,13,-2,16
FC Goa,189,8,4,3,7,12,17,-5,15
Kerala Blast,190,1,7,3,4,15,15,0,24
Mumbai City,190,2,6,5,3,18,10,8,23
Delhi Dynamo,190,3,4,7,3,25,19,6,19
Kolkata,190,4,4,7,3,17,16,1,19
NorthEast Un,190,5,5,3,6,14,14,0,18
Chennaiyin,190,6,4,6,4,17,19,-2,18
FC Pune City,190,7,4,3,7,14,19,-5,15
FC Goa,190,8,3,4,7,9,17,-8,13
Delhi Dynamo,191,1,6,5,3,25,15,10,23
Mumbai City,191,2,6,4,4,16,10,6,22
Kolkata,191,3,5,6,3,17,14,3,21
FC Pune City,191,4,5,3,6,14,16,-2,18
Kerala Blast,191,5,5,3,6,11,17,-6,18
NorthEast Un,191,6,5,2,7,11,13,-2,17
Chennaiyin,191,7,4,5,5,15,19,-4,17
FC Goa,191,8,5,2,7,11,16,-5,17
Mumbai City,192,1,6,4,4,16,9,7,22
Delhi Dynamo,192,2,5,6,3,24,17,7,21
Kolkata,192,3,3,9,2,14,13,1,18
FC Goa,192,4,5,3,6,11,14,-3,18
Kerala Blast,192,5,4,6,4,10,14,-4,18
FC Pune City,192,6,4,5,5,14,16,-2,17
Chennaiyin,192,7,4,5,5,14,19,-5,17
NorthEast Un,192,8,4,4,6,11,12,-1,16
Delhi Dynamo,193,1,6,5,3,24,16,8,23
NorthEast Un,193,2,7,2,5,12,9,3,23
Mumbai City,193,3,6,4,4,17,10,7,22
Kolkata,193,4,5,6,3,18,14,4,21
FC Pune City,193,5,5,4,5,15,16,-1,19
Kerala Blast,193,6,4,4,6,10,18,-8,16
Chennaiyin,193,7,3,6,5,14,19,-5,15
FC Goa,193,8,3,3,8,9,17,-8,12
Mumbai City,194,1,6,5,3,16,8,8,23
Delhi Dynamo,194,2,4,7,3,22,17,5,19
Kolkata,194,3,4,7,3,16,15,1,19
FC Pune City,194,4,5,4,5,14,14,0,19
NorthEast Un,194,5,5,3,6,11,11,0,18
Chennaiyin,194,6,4,6,4,15,17,-2,18
Kerala Blast,194,7,4,6,4,10,14,-4,18
FC Goa,194,8,3,4,7,9,17,-8,13
Mumbai City,195,1,7,4,3,19,10,9,25
Kerala Blast,195,2,6,3,5,14,17,-3,21
FC Goa,195,3,6,2,6,11,14,-3,20
FC Pune City,195,4,5,4,5,15,15,0,19
NorthEast Un,195,5,5,3,6,12,13,-1,18
Delhi Dynamo,195,6,4,5,5,24,20,4,17
Kolkata,195,7,3,7,4,16,17,-1,16
Chennaiyin,195,8,3,6,5,14,19,-5,15
Mumbai City,196,1,7,4,3,18,9,9,25
Kolkata,196,2,5,6,3,16,13,3,21
Kerala Blast,196,3,5,5,4,12,15,-3,20
Delhi Dynamo,196,4,4,7,3,22,16,6,19
Chennaiyin,196,5,4,6,4,16,19,-3,18
NorthEast Un,196,6,4,4,6,11,12,-1,16
FC Pune City,196,7,4,4,6,13,17,-4,16
FC Goa,196,8,3,4,7,9,16,-7,13
Delhi Dynamo,197,1,6,6,2,27,15,12,24
Mumbai City,197,2,6,5,3,17,9,8,23
FC Pune City,197,3,5,4,5,18,17,1,19
Kolkata,197,3,4,7,3,18,17,1,19
NorthEast Un,197,5,5,3,6,11,10,1,18
FC Goa,197,6,5,2,7,12,19,-7,17
Kerala Blast,197,7,4,4,6,10,18,-8,16
Chennaiyin,197,8,3,5,6,14,22,-8,14
Delhi Dynamo,198,1,6,5,3,24,16,8,23
Mumbai City,198,2,6,4,4,17,10,7,22
FC Pune City,198,3,6,3,5,17,14,3,21
Kolkata,198,4,5,6,3,16,13,3,21
Chennaiyin,198,5,4,6,4,14,17,-3,18
Kerala Blast,198,6,5,3,6,12,20,-8,18
NorthEast Un,198,7,5,2,7,12,13,-1,17
FC Goa,198,8,3,3,8,8,17,-9,12
Mumbai City,199,1,7,4,3,18,9,9,25
NorthEast Un,199,2,7,2,5,15,12,3,23
FC Pune City,199,3,6,3,5,17,14,3,21
Delhi Dynamo,199,4,4,6,4,24,19,5,18
Kerala Blast,199,5,5,3,6,11,17,-6,18
Kolkata,199,6,3,7,4,15,18,-3,16
Chennaiyin,199,7,3,6,5,15,20,-5,15
FC Goa,199,8,3,5,6,12,18,-6,14
Mumbai City,200,1,7,4,3,18,9,9,25
Kolkata,200,2,5,7,2,18,15,3,22
Delhi Dynamo,200,3,5,6,3,28,21,7,21
Kerala Blast,200,4,5,4,5,12,16,-4,19
Chennaiyin,200,5,4,5,5,14,19,-5,17
FC Pune City,200,6,4,4,6,14,17,-3,16
FC Goa,200,7,4,4,6,13,17,-4,16
NorthEast Un,200,8,4,2,8,12,15,-3,14
Mumbai City,201,1,7,4,3,19,8,11,25
Delhi Dynamo,201,2,6,5,3,26,18,8,23
Kolkata,201,3,5,6,3,19,15,4,21
Kerala Blast,201,4,6,3,5,16,14,2,21
NorthEast Un,201,5,6,2,6,13,12,1,20
Chennaiyin,201,6,4,5,5,16,20,-4,17
FC Pune City,201,7,4,3,7,12,23,-11,15
FC Goa,201,8,3,2,9,10,21,-11,11
Mumbai City,202,1,7,4,3,17,8,9,25
Kolkata,202,2,6,6,2,17,12,5,24
NorthEast Un,202,3,6,2,6,15,11,4,20
Chennaiyin,202,4,4,6,4,18,20,-2,18
Delhi Dynamo,202,5,4,5,5,22,20,2,17
FC Pune City,202,6,4,4,6,12,15,-3,16
Kerala Blast,202,7,4,4,6,9,18,-9,16
FC Goa,202,8,4,3,7,13,19,-6,15
Mumbai City,203,1,6,5,3,17,9,8,23
NorthEast Un,203,2,6,3,5,14,10,4,21
Delhi Dynamo,203,3,4,7,3,24,18,6,19
Kerala Blast,203,4,5,4,5,10,17,-7,19
FC Pune City,203,5,5,3,6,17,16,1,18
Kolkata,203,6,4,6,4,15,18,-3,18
Chennaiyin,203,7,4,5,5,14,20,-6,17
FC Goa,203,8,4,3,7,13,16,-3,15
Delhi Dynamo,204,1,6,6,2,31,16,15,24
Mumbai City,204,2,6,4,4,16,12,4,22
Kolkata,204,3,5,6,3,20,15,5,21
Kerala Blast,204,4,5,4,5,13,17,-4,19
NorthEast Un,204,5,5,3,6,13,13,0,18
FC Goa,204,6,5,2,7,15,20,-5,17
FC Pune City,204,7,4,4,6,13,18,-5,16
Chennaiyin,204,8,3,5,6,13,23,-10,14
Mumbai City,205,1,7,4,3,17,8,9,25
Delhi Dynamo,205,2,6,5,3,23,15,8,23
Kolkata,205,3,5,7,2,18,13,5,22
NorthEast Un,205,4,5,3,6,10,10,0,18
FC Pune City,205,5,4,4,6,13,16,-3,16
Chennaiyin,205,6,3,7,4,14,18,-4,16
Kerala Blast,205,7,4,4,6,10,18,-8,16
FC Goa,205,8,3,4,7,10,17,-7,13
Mumbai City,206,1,7,4,3,21,9,12,25
Delhi Dynamo,206,2,6,5,3,27,20,7,23
Kerala Blast,206,3,6,3,5,11,14,-3,21
NorthEast Un,206,4,6,2,6,12,12,0,20
FC Pune City,206,5,5,3,6,13,15,-2,18
Kolkata,206,6,3,6,5,13,15,-2,15
Chennaiyin,206,7,3,6,5,15,20,-5,15
FC Goa,206,8,4,3,7,11,18,-7,15
Delhi Dynamo,207,1,6,5,3,26,16,10,23
Mumbai City,207,2,6,4,4,16,10,6,22
FC Pune City,207,3,5,4,5,14,14,0,19
Kerala Blast,207,4,5,4,5,12,16,-4,19
Kolkata,207,5,4,6,4,15,15,0,18
Chennaiyin,207,6,4,6,4,17,18,-1,18
NorthEast Un,207,7,5,3,6,12,13,-1,18
FC Goa,207,8,4,2,8,10,20,-10,14
Mumbai City,208,1,7,4,3,18,8,10,25
Delhi Dynamo,208,2,5,5,4,23,18,5,20
Kerala Blast,208,3,5,5,4,14,17,-3,20
NorthEast Un,208,4,5,3,6,14,14,0,18
Kolkata,208,5,3,8,3,15,15,0,17
FC Pune City,208,6,4,5,5,14,16,-2,17
FC Goa,208,7,5,2,7,14,18,-4,17
Chennaiyin,208,8,3,6,5,17,23,-6,15
Mumbai City,209,1,7,4,3,18,8,10,25
Delhi Dynamo,209,2,6,5,3,24,16,8,23
Kerala Blast,209,3,5,5,4,12,14,-2,20
FC Pune City,209,4,5,4,5,16,15,1,19
Kolkata,209,5,3,8,3,13,15,-2,17
NorthEast Un,209,6,5,2,7,10,12,-2,17
Chennaiyin,209,7,4,5,5,16,20,-4,17
FC Goa,209,8,3,3,8,10,19,-9,12
Mumbai City,210,1,6,5,3,17,9,8,23
Delhi Dynamo,210,2,5,7,2,25,16,9,22
Kolkata,210,3,5,7,2,19,14,5,22
NorthEast Un,210,4,5,4,5,13,11,2,19
Kerala Blast,210,5,5,3,6,13,19,-6,18
Chennaiyin,210,6,3,7,4,14,18,-4,16
FC Pune City,210,7,4,3,7,13,19,-6,15
FC Goa,210,8,3,4,7,10,18,-8,13
Mumbai City,211,1,7,4,3,20,10,10,25
Kolkata,211,2,4,7,3,16,15,1,19
FC Pune City,211,3,5,4,5,15,15,0,19
Delhi Dynamo,211,4,4,6,4,24,20,4,18
FC Goa,211,5,5,3,6,13,16,-3,18
NorthEast Un,211,6,4,5,5,12,12,0,17
Chennaiyin,211,7,3,7,4,16,20,-4,16
Kerala Blast,211,8,4,4,6,10,18,-8,16
Mumbai City,212,1,6,5,3,16,8,8,23
Kerala Blast,212,2,6,3,5,14,14,0,21
Delhi Dynamo,212,3,4,7,3,22,17,5,19
Kolkata,212,4,4,6,4,15,17,-2,18
FC Goa,212,5,5,3,6,13,15,-2,18
FC Pune City,212,6,5,3,6,15,18,-3,18
NorthEast Un,212,7,5,2,7,11,12,-1,17
Chennaiyin,212,8,4,5,5,14,19,-5,17
Delhi Dynamo,213,1,7,5,2,27,15,12,26
Mumbai City,213,2,6,4,4,16,9,7,22
Kerala Blast,213,3,6,3,5,12,16,-4,21
NorthEast Un,213,4,6,2,6,13,11,2,20
Kolkata,213,5,4,6,4,17,15,2,18
Chennaiyin,213,6,3,6,5,13,18,-5,15
FC Pune City,213,7,4,3,7,12,18,-6,15
FC Goa,213,8,4,3,7,9,17,-8,15
Mumbai City,214,1,6,5,3,18,10,8,23
Delhi Dynamo,214,2,5,7,2,28,18,10,22
Kolkata,214,3,5,7,2,21,14,7,22
Chennaiyin,214,4,4,6,4,18,18,0,18
FC Pune City,214,5,5,3,6,17,18,-1,18
Kerala Blast,214,6,5,3,6,12,22,-10,18
NorthEast Un,214,7,4,3,7,11,16,-5,15
FC Goa,214,8,3,4,7,10,19,-9,13
Delhi Dynamo,215,1,6,6,2,27,18,9,24
Mumbai City,215,2,6,5,3,18,10,8,23
Kerala Blast,215,3,6,3,5,11,15,-4,21
NorthEast Un,215,4,5,2,7,13,14,-1,17
FC Goa,215,5,5,2,7,15,18,-3,17
Chennaiyin,215,6,4,5,5,16,20,-4,17
Kolkata,215,7,3,7,4,16,18,-2,16
FC Pune City,215,8,4,4,6,13,16,-3,16
Mumbai City,216,1,7,4,3,21,9,12,25
Delhi Dynamo,216,2,5,6,3,25,21,4,21
Kolkata,216,3,4,7,3,17,17,0,19
Kerala Blast,216,4,5,4,5,15,19,-4,19
Chennaiyin,216,5,4,6,4,15,18,-3,18
NorthEast Un,216,6,5,2,7,12,13,-1,17
FC Goa,216,7,4,4,6,12,16,-4,16
FC Pune City,216,8,4,3,7,13,17,-4,15
Mumbai City,217,1,6,4,4,17,10,7,22
Delhi Dynamo,217,2,5,5,4,24,21,3,20
FC Goa,217,3,6,2,6,14,15,-1,20
Kerala Blast,217,4,5,4,5,13,15,-2,19
NorthEast Un,217,5,5,3,6,14,14,0,18
Kolkata,217,6,4,6,4,15,17,-2,18
FC Pune City,217,7,5,3,6,13,16,-3,18
Chennaiyin,217,8,4,5,5,17,19,-2,17
Delhi Dynamo,218,1,6,6,2,25,16,9,24
Mumbai City,218,2,6,4,4,16,9,7,22
Kolkata,218,3,5,6,3,19,15,4,21
Kerala Blast,218,4,5,4,5,12,17,-5,19
NorthEast Un,218,5,5,3,6,12,12,0,18
FC Pune City,218,6,5,3,6,14,17,-3,18
Chennaiyin,218,7,3,6,5,13,18,-5,15
FC Goa,218,8,3,4,7,10,17,-7,13
Mumbai City,219,1,7,4,3,18,8,10,25
Kolkata,219,2,5,7,2,22,15,7,22
Kerala Blast,219,3,6,3,5,14,18,-4,21
Delhi Dynamo,219,4,4,6,4,23,19,4,18
NorthEast Un,219,5,5,2,7,12,14,-2,17
Chennaiyin,219,6,4,5,5,17,20,-3,17
FC Goa,219,7,4,4,6,13,18,-5,16
FC Pune City,219,8,4,3,7,13,20,-7,15
Mumbai City,220,1,7,4,3,18,9,9,25
Delhi Dynamo,220,2,6,5,3,25,17,8,23
Kerala Blast,220,3,6,3,5,14,16,-2,21
Kolkata,220,4,4,7,3,19,17,2,19
FC Pune City,220,5,5,3,6,15,18,-3,18
Chennaiyin,220,6,4,5,5,15,21,-6,17
FC Goa,220,7,4,3,7,15,19,-4,15
NorthEast Un,220,8,4,2,8,10,14,-4,14
Mumbai City,221,1,7,4,3,19,8,11,25
Kerala Blast,221,2,6,4,4,14,15,-1,22
Kolkata,221,3,4,8,2,17,14,3,20
Delhi Dynamo,221,4,4,6,4,22,20,2,18
NorthEast Un,221,5,5,3,6,15,15,0,18
Chennaiyin,221,6,3,7,4,17,21,-4,16
FC Pune City,221,7,4,3,7,12,17,-5,15
FC Goa,221,8,3,5,6,11,17,-6,14
Mumbai City,222,1,7,4,3,20,9,11,25
Kerala Blast,222,2,6,3,5,13,17,-4,21
Delhi Dynamo,222,3,5,5,4,27,21,6,20
NorthEast Un,222,4,6,2,6,14,12,2,20
FC Pune City,222,5,5,3,6,14,16,-2,18
Chennaiyin,222,6,4,5,5,16,19,-3,17
FC Goa,222,7,5,2,7,12,20,-8,17
Kolkata,222,8,3,6,5,15,17,-2,15
Mumbai City,223,1,7,4,3,20,9,11,25
Delhi Dynamo,223,2,6,5,3,27,19,8,23
Kolkata,223,3,5,7,2,16,13,3,22
Kerala Blast,223,4,6,3,5,14,15,-1,21
Chennaiyin,223,5,4,6,4,19,20,-1,18
FC Pune City,223,6,4,3,7,12,16,-4,15
NorthEast Un,223,7,4,3,7,12,18,-6,15
FC Goa,223,8,3,3,8,9,19,-10,12
Mumbai City,224,1,7,4,3,19,9,10,25
Delhi Dynamo,224,2,6,5,3,25,17,8,23
FC Pune City,224,3,6,3,5,16,15,1,21
Kolkata,224,4,4,7,3,17,16,1,19
NorthEast Un,224,5,5,3,6,10,11,-1,18
Kerala Blast,224,6,4,4,6,11,18,-7,16
Chennaiyin,224,7,3,6,5,13,19,-6,15
FC Goa,224,8,4,2,8,10,16,-6,14
Mumbai City,225,1,6,5,3,17,9,8,23
NorthEast Un,225,2,7,2,5,13,10,3,23
Delhi Dynamo,225,3,5,6,3,24,16,8,21
Kolkata,225,4,4,7,3,17,18,-1,19
FC Pune City,225,5,4,5,5,13,15,-2,17
FC Goa,225,6,5,2,7,14,18,-4,17
Kerala Blast,225,7,4,4,6,10,16,-6,16
Chennaiyin,225,8,3,5,6,15,21,-6,14
Mumbai City,226,1,7,4,3,18,8,10,25
Kolkata,226,2,6,6,2,19,13,6,24
Delhi Dynamo,226,3,5,5,4,24,17,7,20
Kerala Blast,226,4,5,4,5,10,15,-5,19
NorthEast Un,226,5,5,3,6,10,10,0,18
Chennaiyin,226,6,4,6,4,15,18,-3,18
FC Pune City,226,7,4,3,7,13,18,-5,15
FC Goa,226,8,3,3,8,9,19,-10,12
Mumbai City,227,1,6,5,3,16,8,8,23
Delhi Dynamo,227,2,5,6,3,24,17,7,21
Kerala Blast,227,3,6,3,5,12,15,-3,21
Kolkata,227,4,4,8,2,18,16,2,20
Chennaiyin,227,5,4,6,4,17,20,-3,18
NorthEast Un,227,6,5,2,7,13,14,-1,17
FC Pune City,227,7,4,4,6,14,17,-3,16
FC Goa,227,8,3,4,7,11,18,-7,13
Mumbai City,228,1,7,4,3,19,8,11,25
Delhi Dynamo,228,2,6,5,3,29,17,12,23
Chennaiyin,228,3,5,5,4,18,17,1,20
Kerala Blast,228,4,5,4,5,13,18,-5,19
Kolkata,228,5,3,8,3,16,17,-1,17
NorthEast Un,228,6,5,2,7,12,15,-3,17
FC Pune City,228,7,4,4,6,14,17,-3,16
FC Goa,228,8,4,2,8,11,23,-12,14
Delhi Dynamo,229,1,6,6,2,27,18,9,24
Mumbai City,229,2,6,5,3,17,9,8,23
FC Pune City,229,3,6,3,5,15,14,1,21
Kerala Blast,229,4,6,3,5,13,15,-2,21
Chennaiyin,229,5,4,6,4,15,17,-2,18
Kolkata,229,6,3,6,5,15,20,-5,15
FC Goa,229,7,4,3,7,12,17,-5,15
NorthEast Un,229,8,4,2,8,11,15,-4,14
Mumbai City,230,1,6,5,3,17,9,8,23
Delhi Dynamo,230,2,5,7,2,24,15,9,22
Kerala Blast,230,3,5,5,4,11,13,-2,20
Kolkata,230,4,4,7,3,16,16,0,19
FC Goa,230,5,5,2,7,14,17,-3,17
Chennaiyin,230,6,4,5,5,15,21,-6,17
NorthEast Un,230,7,4,4,6,10,11,-1,16
FC Pune City,230,8,4,3,7,13,18,-5,15
Mumbai City,231,1,7,4,3,20,11,9,25
Delhi Dynamo,231,2,6,5,3,26,18,8,23
FC Pune City,231,3,6,3,5,16,16,0,21
Kolkata,231,4,4,7,3,17,16,1,19
NorthEast Un,231,5,5,3,6,11,11,0,18
Kerala Blast,231,6,4,4,6,11,17,-6,16
Chennaiyin,231,7,3,6,5,13,19,-6,15
FC Goa,231,8,4,2,8,12,18,-6,14
Mumbai City,232,1,6,5,3,18,10,8,23
Delhi Dynamo,232,2,5,6,3,25,18,7,21
Kerala Blast,232,3,6,3,5,13,15,-2,21
Kolkata,232,4,4,8,2,17,15,2,20
NorthEast Un,232,5,6,2,6,12,10,2,20
FC Pune City,232,6,4,4,6,13,17,-4,16
Chennaiyin,232,7,3,6,5,13,18,-5,15
FC Goa,232,8,3,4,7,9,17,-8,13
Mumbai City,233,1,7,4,3,17,8,9,25
Kolkata,233,2,5,7,2,19,14,5,22
Delhi Dynamo,233,3,5,6,3,24,16,8,21
Kerala Blast,233,4,6,3,5,14,14,0,21
Chennaiyin,233,5,5,5,4,18,20,-2,20
NorthEast Un,233,6,4,3,7,12,17,-5,15
FC Pune City,233,7,4,3,7,13,19,-6,15
FC Goa,233,8,3,3,8,10,19,-9,12
Mumbai City,234,1,7,4,3,17,8,9,25
Kerala Blast,234,2,6,4,4,15,15,0,22
Kolkata,234,3,4,7,3,18,16,2,19
Delhi Dynamo,234,4,4,6,4,23,18,5,18
FC Goa,234,5,5,3,6,15,19,-4,18
NorthEast Un,234,6,5,2,7,12,13,-1,17
Chennaiyin,234,7,4,5,5,17,21,-4,17
FC Pune City,234,8,4,3,7,13,20,-7,15
Mumbai City,235,1,6,4,4,16,11,5,22
Delhi Dynamo,235,2,5,6,3,27,18,9,21
NorthEast Un,235,3,6,2,6,14,13,1,20
Kolkata,235,4,4,7,3,15,14,1,19
Kerala Blast,235,5,5,4,5,11,15,-4,19
FC Pune City,235,6,4,5,5,13,15,-2,17
Chennaiyin,235,7,4,5,5,15,19,-4,17
FC Goa,235,8,4,3,7,11,17,-6,15
Mumbai City,236,1,6,5,3,17,9,8,23
Delhi Dynamo,236,2,5,7,2,25,15,10,22
Kolkata,236,3,4,8,2,18,15,3,20
Kerala Blast,236,4,5,5,4,12,15,-3,20
NorthEast Un,236,5,5,4,5,12,10,2,19
FC Pune City,236,6,4,3,7,14,19,-5,15
Chennaiyin,236,7,3,6,5,13,19,-6,15
FC Goa,236,8,3,4,7,8,17,-9,13
Delhi Dynamo,237,1,6,6,2,25,16,9,24
Kolkata,237,2,6,6,2,17,12,5,24
Mumbai City,237,3,6,4,4,16,9,7,22
Chennaiyin,237,4,4,6,4,16,19,-3,18
Kerala Blast,237,5,4,5,5,12,17,-5,17
NorthEast Un,237,6,4,4,6,13,14,-1,16
FC Pune City,237,7,4,4,6,13,16,-3,16
FC Goa,237,8,3,3,8,10,19,-9,12
Mumbai City,238,1,6,5,3,17,9,8,23
Kolkata,238,2,5,6,3,20,15,5,21
NorthEast Un,238,3,6,3,5,13,11,2,21
FC Pune City,238,4,6,3,5,15,14,1,21
Delhi Dynamo,238,5,4,6,4,22,18,4,18
Kerala Blast,238,6,4,4,6,10,18,-8,16
Chennaiyin,238,7,3,6,5,15,20,-5,15
FC Goa,238,8,4,3,7,12,19,-7,15
Mumbai City,239,1,7,4,3,18,8,10,25
Kerala Blast,239,2,6,4,4,16,16,0,22
Delhi Dynamo,239,3,5,5,4,24,20,4,20
Kolkata,239,4,4,7,3,15,15,0,19
NorthEast Un,239,5,5,3,6,13,12,1,18
Chennaiyin,239,6,4,6,4,14,17,-3,18
FC Pune City,239,7,4,5,5,13,15,-2,17
FC Goa,239,8,3,2,9,9,19,-10,11
Delhi Dynamo,240,1,7,5,2,27,14,13,26
Mumbai City,240,2,6,4,4,16,10,6,22
Kerala Blast,240,3,6,3,5,14,15,-1,21
FC Pune City,240,4,5,3,6,14,16,-2,18
Kolkata,240,5,4,6,4,15,18,-3,18
NorthEast Un,240,6,5,2,7,12,14,-2,17
FC Goa,240,7,5,2,7,13,16,-3,17
Chennaiyin,240,8,3,5,6,13,21,-8,14
Mumbai City,241,1,7,4,3,18,9,9,25
Kerala Blast,241,2,6,3,5,13,15,-2,21
Delhi Dynamo,241,3,5,5,4,25,19,6,20
Kolkata,241,4,4,7,3,16,15,1,19
NorthEast Un,241,5,5,3,6,12,12,0,18
Chennaiyin,241,6,4,6,4,15,18,-3,18
FC Pune City,241,7,4,3,7,14,19,-5,15
FC Goa,241,8,4,3,7,10,16,-6,15
Delhi Dynamo,242,1,6,6,2,25,16,9,24
Mumbai City,242,2,6,4,4,17,10,7,22
Kolkata,242,3,4,8,2,15,13,2,20
Kerala Blast,242,4,4,6,4,12,16,-4,18
NorthEast Un,242,5,4,4,6,12,13,-1,16
FC Pune City,242,6,4,4,6,14,17,-3,16
FC Goa,242,7,4,4,6,11,16,-5,16
Chennaiyin,242,8,3,6,5,15,20,-5,15
Mumbai City,243,1,6,4,4,18,12,6,22
Kolkata,243,2,5,7,2,15,12,3,22
Delhi Dynamo,243,3,5,5,4,27,24,3,20
FC Pune City,243,4,5,4,5,14,15,-1,19
NorthEast Un,243,5,5,3,6,17,14,3,18
Chennaiyin,243,6,4,5,5,17,21,-4,17
FC Goa,243,7,5,2,7,13,17,-4,17
Kerala Blast,243,8,4,4,6,11,17,-6,16
Mumbai City,244,1,7,4,3,20,8,12,25
NorthEast Un,244,2,6,2,6,13,12,1,20
FC Goa,244,3,6,2,6,17,17,0,20
FC Pune City,244,4,5,4,5,13,14,-1,19
Delhi Dynamo,244,5,4,5,5,22,22,0,17
Chennaiyin,244,6,4,5,5,16,20,-4,17
Kerala Blast,244,7,4,5,5,9,14,-5,17
Kolkata,244,8,3,7,4,15,18,-3,16
Mumbai City,245,1,6,4,4,16,9,7,22
Kerala Blast,245,2,6,4,4,13,15,-2,22
Delhi Dynamo,245,3,5,6,3,23,18,5,21
NorthEast Un,245,4,6,2,6,15,10,5,20
Kolkata,245,5,3,8,3,16,16,0,17
Chennaiyin,245,6,4,5,5,17,20,-3,17
FC Pune City,245,7,4,4,6,12,15,-3,16
FC Goa,245,8,4,3,7,11,20,-9,15
Mumbai City,246,1,7,4,3,19,9,10,25
Kolkata,246,2,5,6,3,18,16,2,21
Kerala Blast,246,3,6,3,5,13,18,-5,21
Delhi Dynamo,246,4,5,5,4,25,21,4,20
Chennaiyin,246,5,5,5,4,18,17,1,20
FC Goa,246,6,5,2,7,15,20,-5,17
FC Pune City,246,7,4,3,7,14,18,-4,15
NorthEast Un,246,8,4,2,8,10,13,-3,14
Mumbai City,247,1,7,4,3,18,9,9,25
Delhi Dynamo,247,2,5,5,4,26,18,8,20
FC Pune City,247,3,5,4,5,14,14,0,19
Kolkata,247,4,4,6,4,15,16,-1,18
NorthEast Un,247,5,5,3,6,11,13,-2,18
Chennaiyin,247,6,4,6,4,15,18,-3,18
FC Goa,247,7,5,2,7,12,17,-5,17
Kerala Blast,247,8,4,4,6,9,15,-6,16
Mumbai City,248,1,7,4,3,19,8,11,25
NorthEast Un,248,2,7,2,5,13,10,3,23
Kolkata,248,3,4,7,3,14,14,0,19
Delhi Dynamo,248,4,4,6,4,24,21,3,18
FC Pune City,248,5,5,3,6,13,15,-2,18
FC Goa,248,6,5,3,6,14,17,-3,18
Kerala Blast,248,7,4,4,6,9,15,-6,16
Chennaiyin,248,8,3,5,6,14,20,-6,14
Mumbai City,249,1,7,4,3,21,9,12,25
Kolkata,249,2,6,6,2,21,12,9,24
Delhi Dynamo,249,3,5,6,3,25,20,5,21
NorthEast Un,249,4,5,2,7,11,13,-2,17
Chennaiyin,249,5,4,5,5,16,20,-4,17
FC Pune City,249,6,4,4,6,13,17,-4,16
Kerala Blast,249,7,4,4,6,10,19,-9,16
FC Goa,249,8,4,3,7,12,19,-7,15
Mumbai City,250,1,6,5,3,18,10,8,23
Kerala Blast,250,2,6,3,5,15,17,-2,21
NorthEast Un,250,3,6,2,6,15,12,3,20
Chennaiyin,250,4,5,5,4,18,18,0,20
Delhi Dynamo,250,5,4,7,3,26,20,6,19
FC Pune City,250,6,5,3,6,16,17,-1,18
Kolkata,250,7,3,7,4,16,21,-5,16
FC Goa,250,8,3,4,7,12,21,-9,13
Mumbai City,251,1,7,4,3,18,8,10,25
NorthEast Un,251,2,6,2,6,11,11,0,20
Chennaiyin,251,3,5,5,4,17,18,-1,20
FC Pune City,251,4,5,4,5,15,14,1,19
Delhi Dynamo,251,5,4,5,5,22,19,3,17
FC Goa,251,6,5,2,7,12,17,-5,17
Kerala Blast,251,7,4,5,5,10,15,-5,17
Kolkata,251,8,3,7,4,14,17,-3,16
Mumbai City,252,1,7,4,3,19,8,11,25
Delhi Dynamo,252,2,5,6,3,24,17,7,21
NorthEast Un,252,3,6,3,5,13,9,4,21
Kolkata,252,4,4,8,2,19,14,5,20
Kerala Blast,252,5,5,4,5,10,14,-4,19
Chennaiyin,252,6,3,6,5,16,23,-7,15
FC Pune City,252,7,4,3,7,12,19,-7,15
FC Goa,252,8,3,4,7,13,22,-9,13
Delhi Dynamo,253,1,6,6,2,25,15,10,24
Mumbai City,253,2,6,4,4,16,9,7,22
NorthEast Un,253,3,5,4,5,13,12,1,19
FC Pune City,253,4,5,4,5,16,16,0,19
Kolkata,253,5,4,6,4,17,17,0,18
Chennaiyin,253,6,4,6,4,17,20,-3,18
Kerala Blast,253,7,4,4,6,12,19,-7,16
FC Goa,253,8,4,2,8,11,19,-8,14
Mumbai City,254,1,7,4,3,20,9,11,25
Kolkata,254,2,6,6,2,20,13,7,24
Delhi Dynamo,254,3,5,5,4,26,20,6,20
Kerala Blast,254,4,5,4,5,11,15,-4,19
NorthEast Un,254,5,5,2,7,12,13,-1,17
Chennaiyin,254,6,4,5,5,16,21,-5,17
FC Pune City,254,7,4,4,6,13,18,-5,16
FC Goa,254,8,4,2,8,12,21,-9,14
Mumbai City,255,1,7,4,3,20,9,11,25
Delhi Dynamo,255,2,5,5,4,25,21,4,20
Kerala Blast,255,3,5,5,4,13,16,-3,20
FC Pune City,255,4,5,4,5,14,15,-1,19
NorthEast Un,255,5,5,3,6,13,12,1,18
FC Goa,255,6,5,2,7,14,17,-3,17
Kolkata,255,7,3,7,4,13,14,-1,16
Chennaiyin,255,8,3,6,5,13,21,-8,15
Mumbai City,256,1,7,4,3,18,8,10,25
Kolkata,256,2,5,7,2,17,14,3,22
Kerala Blast,256,3,6,3,5,14,16,-2,21
NorthEast Un,256,4,6,2,6,13,13,0,20
Delhi Dynamo,256,5,4,5,5,22,19,3,17
FC Pune City,256,6,4,4,6,13,16,-3,16
Chennaiyin,256,7,3,6,5,15,20,-5,15
FC Goa,256,8,4,3,7,11,17,-6,15
Mumbai City,257,1,6,4,4,16,11,5,22
Delhi Dynamo,257,2,5,6,3,25,16,9,21
Kolkata,257,3,5,6,3,16,13,3,21
Kerala Blast,257,4,6,3,5,13,14,-1,21
Chennaiyin,257,5,5,5,4,17,17,0,20
FC Pune City,257,6,5,3,6,13,16,-3,18
NorthEast Un,257,7,5,2,7,10,13,-3,17
FC Goa,257,8,3,3,8,9,19,-10,12
Mumbai City,258,1,7,4,3,19,8,11,25
FC Pune City,258,2,6,3,5,15,15,0,21
Delhi Dynamo,258,3,4,7,3,23,19,4,19
Kolkata,258,4,4,7,3,15,14,1,19
Kerala Blast,258,5,5,4,5,12,15,-3,19
NorthEast Un,258,6,5,3,6,16,16,0,18
FC Goa,258,7,4,3,7,9,15,-6,15
Chennaiyin,258,8,3,5,6,15,22,-7,14
Mumbai City,259,1,7,4,3,20,9,11,25
NorthEast Un,259,2,7,2,5,18,10,8,23
Kerala Blast,259,3,6,3,5,13,17,-4,21
Delhi Dynamo,259,4,5,5,4,25,23,2,20
Kolkata,259,5,4,6,4,16,17,-1,18
Chennaiyin,259,6,4,5,5,14,19,-5,17
FC Pune City,259,7,4,3,7,12,17,-5,15
FC Goa,259,8,4,2,8,11,17,-6,14
Delhi Dynamo,260,1,6,5,3,26,18,8,23
Mumbai City,260,2,6,4,4,16,10,6,22
NorthEast Un,260,3,6,3,5,15,12,3,21
Kolkata,260,4,4,7,3,16,17,-1,19
FC Pune City,260,5,5,4,5,14,15,-1,19
Kerala Blast,260,6,5,4,5,13,15,-2,19
FC Goa,260,7,4,2,8,13,19,-6,14
Chennaiyin,260,8,3,5,6,15,22,-7,14
Delhi Dynamo,261,1,7,5,2,27,14,13,26
Mumbai City,261,2,6,4,4,16,9,7,22
FC Pune City,261,3,6,3,5,16,16,0,21
Chennaiyin,261,4,5,5,4,18,18,0,20
Kolkata,261,5,4,6,4,16,17,-1,18
Kerala Blast,261,6,5,3,6,11,16,-5,18
NorthEast Un,261,7,4,2,8,10,15,-5,14
FC Goa,261,8,4,2,8,11,20,-9,14
Mumbai City,262,1,6,5,3,17,9,8,23
Kolkata,262,2,5,7,2,15,12,3,22
NorthEast Un,262,3,6,3,5,12,10,2,21
Delhi Dynamo,262,4,4,8,2,23,16,7,20
FC Pune City,262,5,5,3,6,14,16,-2,18
Kerala Blast,262,6,4,4,6,10,16,-6,16
FC Goa,262,7,4,3,7,10,16,-6,15
Chennaiyin,262,8,3,5,6,14,20,-6,14
Mumbai City,263,1,6,4,4,16,12,4,22
Delhi Dynamo,263,2,5,6,3,25,15,10,21
Kerala Blast,263,3,6,3,5,15,16,-1,21
Kolkata,263,4,4,7,3,18,16,2,19
NorthEast Un,263,5,5,3,6,10,11,-1,18
FC Pune City,263,6,5,3,6,16,20,-4,18
FC Goa,263,7,4,4,6,12,15,-3,16
Chennaiyin,263,8,3,6,5,13,20,-7,15
Mumbai City,264,1,7,4,3,19,9,10,25
Delhi Dynamo,264,2,5,6,3,25,18,7,21
Kerala Blast,264,3,5,5,4,13,15,-2,20
FC Pune City,264,4,5,4,5,15,16,-1,19
Kolkata,264,5,3,7,4,15,16,-1,16
NorthEast Un,264,6,4,4,6,11,13,-2,16
Chennaiyin,264,7,3,7,4,16,20,-4,16
FC Goa,264,8,4,3,7,11,18,-7,15
Mumbai City,265,1,6,5,3,19,11,8,23
Kolkata,265,2,5,7,2,19,14,5,22
NorthEast Un,265,3,6,3,5,15,11,4,21
Delhi Dynamo,265,4,4,7,3,25,21,4,19
FC Pune City,265,5,5,3,6,15,17,-2,18
Chennaiyin,265,6,3,7,4,16,20,-4,16
Kerala Blast,265,7,4,4,6,12,19,-7,16
FC Goa,265,8,3,4,7,10,18,-8,13
Mumbai City,266,1,6,5,3,18,10,8,23
Kerala Blast,266,2,6,4,4,15,17,-2,22
Delhi Dynamo,266,3,5,6,3,30,20,10,21
FC Pune City,266,4,5,4,5,19,17,2,19
NorthEast Un,266,5,5,3,6,13,11,2,18
Chennaiyin,266,6,4,6,4,16,19,-3,18
Kolkata,266,7,3,6,5,17,22,-5,15
FC Goa,266,8,4,2,8,12,24,-12,14
Mumbai City,267,1,7,4,3,18,9,9,25
NorthEast Un,267,2,7,2,5,12,9,3,23
Kolkata,267,3,5,6,3,16,14,2,21
Delhi Dynamo,267,4,4,6,4,24,19,5,18
FC Goa,267,5,5,3,6,13,16,-3,18
FC Pune City,267,6,4,4,6,13,17,-4,16
Kerala Blast,267,7,4,4,6,10,16,-6,16
Chennaiyin,267,8,3,5,6,13,19,-6,14
Delhi Dynamo,268,1,5,7,2,25,16,9,22
Mumbai City,268,2,6,4,4,16,10,6,22
NorthEast Un,268,3,5,4,5,14,12,2,19
Kolkata,268,4,4,7,3,14,13,1,19
FC Pune City,268,5,5,3,6,14,16,-2,18
FC Goa,268,6,5,3,6,12,16,-4,18
Kerala Blast,268,7,4,4,6,10,17,-7,16
Chennaiyin,268,8,3,6,5,16,21,-5,15
Delhi Dynamo,269,1,6,6,2,25,16,9,24
Mumbai City,269,2,6,4,4,16,9,7,22
Kerala Blast,269,3,6,4,4,14,16,-2,22
Chennaiyin,269,4,5,5,4,18,19,-1,20
Kolkata,269,5,3,9,2,16,15,1,18
FC Pune City,269,6,4,4,6,14,17,-3,16
NorthEast Un,269,7,4,3,7,13,15,-2,15
FC Goa,269,8,3,3,8,10,19,-9,12
Delhi Dynamo,270,1,6,5,3,30,18,12,23
Kolkata,270,2,5,7,2,21,16,5,22
Mumbai City,270,3,6,4,4,17,12,5,22
NorthEast Un,270,4,6,2,6,14,12,2,20
Kerala Blast,270,5,5,3,6,13,20,-7,18
Chennaiyin,270,6,4,5,5,14,18,-4,17
FC Pune City,270,7,4,3,7,15,20,-5,15
FC Goa,270,8,4,3,7,10,18,-8,15
Mumbai City,271,1,6,5,3,17,9,8,23
FC Goa,271,2,6,2,6,13,15,-2,20
Delhi Dynamo,271,3,4,7,3,23,18,5,19
Kolkata,271,4,4,7,3,16,15,1,19
NorthEast Un,271,5,5,4,5,13,12,1,19
Kerala Blast,271,6,5,3,6,13,17,-4,18
FC Pune City,271,7,4,4,6,12,16,-4,16
Chennaiyin,271,8,3,6,5,16,21,-5,15
Mumbai City,272,1,6,5,3,16,8,8,23
Delhi Dynamo,272,2,5,7,2,26,18,8,22
Kerala Blast,272,3,5,5,4,14,17,-3,20
Kolkata,272,4,4,7,3,15,14,1,19
Chennaiyin,272,5,4,6,4,15,18,-3,18
NorthEast Un,272,6,4,5,5,15,15,0,17
FC Pune City,272,7,4,4,6,14,17,-3,16
FC Goa,272,8,3,3,8,10,18,-8,12
Mumbai City,273,1,6,4,4,16,9,7,22
Kolkata,273,2,5,7,2,20,16,4,22
Kerala Blast,273,3,6,3,5,14,17,-3,21
Delhi Dynamo,273,4,5,5,4,23,18,5,20
NorthEast Un,273,5,5,3,6,11,11,0,18
FC Goa,273,6,5,3,6,11,15,-4,18
FC Pune City,273,7,4,3,7,14,18,-4,15
Chennaiyin,273,8,3,6,5,13,18,-5,15
Mumbai City,274,1,7,4,3,20,8,12,25
Delhi Dynamo,274,2,5,5,4,24,22,2,20
Kolkata,274,3,4,7,3,16,15,1,19
NorthEast Un,274,4,5,3,6,13,13,0,18
Chennaiyin,274,5,4,6,4,17,20,-3,18
FC Pune City,274,6,4,5,5,14,16,-2,17
FC Goa,274,7,5,2,7,15,19,-4,17
Kerala Blast,274,8,4,4,6,11,17,-6,16
Kolkata,275,1,6,6,2,20,13,7,24
Delhi Dynamo,275,2,6,5,3,25,18,7,23
Mumbai City,275,3,6,4,4,16,10,6,22
NorthEast Un,275,4,6,2,6,14,10,4,20
Chennaiyin,275,5,4,6,4,15,18,-3,18
FC Pune City,275,6,4,4,6,13,18,-5,16
Kerala Blast,275,7,4,4,6,10,17,-7,16
FC Goa,275,8,3,3,8,11,20,-9,12
Delhi Dynamo,276,1,6,6,2,25,15,10,24
Mumbai City,276,2,6,4,4,16,9,7,22
Kolkata,276,3,5,6,3,17,13,4,21
Kerala Blast,276,4,6,3,5,11,15,-4,21
NorthEast Un,276,5,5,3,6,12,11,1,18
FC Goa,276,6,5,2,7,12,17,-5,17
FC Pune City,276,7,4,3,7,12,17,-5,15
Chennaiyin,276,8,3,5,6,14,22,-8,14
Mumbai City,277,1,6,5,3,17,9,8,23
NorthEast Un,277,2,6,2,6,14,13,1,20
Kerala Blast,277,3,5,5,4,12,14,-2,20
Delhi Dynamo,277,4,4,7,3,23,18,5,19
Kolkata,277,5,4,7,3,16,15,1,19
FC Pune City,277,6,5,4,5,15,16,-1,19
Chennaiyin,277,7,4,5,5,16,20,-4,17
FC Goa,277,8,3,3,8,10,18,-8,12
Mumbai City,278,1,6,5,3,17,9,8,23
Kolkata,278,2,5,6,3,18,13,5,21
NorthEast Un,278,3,6,2,6,16,13,3,20
Delhi Dynamo,278,4,4,7,3,23,20,3,19
FC Pune City,278,5,5,3,6,14,17,-3,18
Kerala Blast,278,6,5,3,6,12,18,-6,18
Chennaiyin,278,7,4,5,5,15,19,-4,17
FC Goa,278,8,4,3,7,9,15,-6,15
Mumbai City,279,1,7,4,3,18,8,10,25
Kolkata,279,2,5,7,2,18,14,4,22
Delhi Dynamo,279,3,5,6,3,27,21,6,21
Kerala Blast,279,4,5,4,5,11,16,-5,19
Chennaiyin,279,5,4,5,5,15,20,-5,17
FC Pune City,279,6,4,4,6,12,15,-3,16
NorthEast Un,279,7,4,3,7,12,14,-2,15
FC Goa,279,8,4,3,7,14,19,-5,15
Kolkata,280,1,6,6,2,21,13,8,24
Delhi Dynamo,280,2,6,5,3,28,17,11,23
Mumbai City,280,3,6,4,4,16,10,6,22
Kerala Blast,280,4,6,3,5,15,18,-3,21
NorthEast Un,280,5,5,3,6,10,11,-1,18
FC Pune City,280,6,4,3,7,13,18,-5,15
Chennaiyin,280,7,3,6,5,13,19,-6,15
FC Goa,280,8,4,2,8,12,22,-10,14
Mumbai City,281,1,7,4,3,19,9,10,25
Kolkata,281,2,5,6,3,20,16,4,21
Delhi Dynamo,281,3,4,7,3,23,18,5,19
NorthEast Un,281,4,5,4,5,12,10,2,19
Chennaiyin,281,5,4,6,4,17,19,-2,18
FC Pune City,281,6,5,3,6,14,16,-2,18
Kerala Blast,281,7,5,3,6,12,18,-6,18
FC Goa,281,8,3,3,8,11,22,-11,12
Mumbai City,282,1,6,5,3,17,9,8,23
Delhi Dynamo,282,2,5,7,2,27,19,8,22
Kolkata,282,3,5,6,3,16,14,2,21
Kerala Blast,282,4,5,4,5,12,15,-3,19
FC Goa,282,5,5,2,7,15,18,-3,17
Chennaiyin,282,6,4,5,5,15,20,-5,17
NorthEast Un,282,7,4,4,6,10,12,-2,16
FC Pune City,282,8,4,3,7,14,19,-5,15
Mumbai City,283,1,6,4,4,17,10,7,22
Delhi Dynamo,283,2,5,5,4,25,19,6,20
FC Goa,283,3,6,2,6,13,16,-3,20
Kerala Blast,283,4,5,5,4,11,14,-3,20
NorthEast Un,283,5,5,3,6,15,15,0,18
FC Pune City,283,6,5,3,6,13,15,-2,18
Chennaiyin,283,7,4,5,5,17,21,-4,17
Kolkata,283,8,3,7,4,14,15,-1,16
Mumbai City,284,1,7,4,3,19,10,9,25
Kolkata,284,2,5,6,3,22,15,7,21
Delhi Dynamo,284,3,5,5,4,27,22,5,20
NorthEast Un,284,4,5,3,6,11,10,1,18
Chennaiyin,284,5,4,6,4,17,18,-1,18
FC Pune City,284,6,5,3,6,14,18,-4,18
Kerala Blast,284,7,5,3,6,12,20,-8,18
FC Goa,284,8,4,2,8,14,23,-9,14
Mumbai City,285,1,6,5,3,16,8,8,23
Delhi Dynamo,285,2,5,7,2,22,14,8,22
Kolkata,285,3,4,7,3,15,14,1,19
Kerala Blast,285,4,5,4,5,10,14,-4,19
Chennaiyin,285,5,4,6,4,14,17,-3,18
NorthEast Un,285,6,5,2,7,10,11,-1,17
FC Goa,285,7,4,4,6,9,14,-5,16
FC Pune City,285,8,4,3,7,13,17,-4,15
Mumbai City,286,1,7,4,3,19,9,10,25
Chennaiyin,286,2,5,5,4,18,17,1,20
Delhi Dynamo,286,3,4,7,3,24,19,5,19
Kolkata,286,4,4,7,3,16,15,1,19
FC Pune City,286,5,5,4,5,14,14,0,19
NorthEast Un,286,6,5,3,6,12,13,-1,18
Kerala Blast,286,7,4,4,6,9,17,-8,16
FC Goa,286,8,3,4,7,10,18,-8,13
Mumbai City,287,1,7,4,3,18,8,10,25
NorthEast Un,287,2,6,3,5,14,12,2,21
Delhi Dynamo,287,3,5,5,4,23,18,5,20
Kolkata,287,4,4,8,2,18,16,2,20
FC Pune City,287,5,5,4,5,17,18,-1,19
Chennaiyin,287,6,4,6,4,17,19,-2,18
Kerala Blast,287,7,4,4,6,14,20,-6,16
FC Goa,287,8,3,2,9,11,21,-10,11
Mumbai City,288,1,7,4,3,18,9,9,25
Delhi Dynamo,288,2,6,5,3,27,17,10,23
Kerala Blast,288,3,5,5,4,10,13,-3,20
Kolkata,288,4,3,9,2,15,14,1,18
FC Pune City,288,5,4,5,5,12,14,-2,17
Chennaiyin,288,6,4,5,5,16,21,-5,17
FC Goa,288,7,4,3,7,12,19,-7,15
NorthEast Un,288,8,4,2,8,12,15,-3,14
Mumbai City,289,1,7,4,3,18,8,10,25
Kerala Blast,289,2,6,4,4,13,14,-1,22
Kolkata,289,3,4,8,2,19,13,6,20
Delhi Dynamo,289,4,4,6,4,21,18,3,18
NorthEast Un,289,5,5,2,7,13,13,0,17
Chennaiyin,289,6,4,5,5,15,21,-6,17
FC Goa,289,7,4,4,6,12,15,-3,16
FC Pune City,289,8,4,3,7,12,21,-9,15
Delhi Dynamo,290,1,7,5,2,25,14,11,26
Kolkata,290,2,6,6,2,21,14,7,24
Mumbai City,290,3,6,4,4,16,10,6,22
FC Pune City,290,4,5,3,6,16,17,-1,18
Chennaiyin,290,5,4,6,4,15,18,-3,18
Kerala Blast,290,6,4,4,6,10,18,-8,16
NorthEast Un,290,7,4,3,7,10,12,-2,15
FC Goa,290,8,3,3,8,10,20,-10,12
Mumbai City,291,1,6,5,3,17,9,8,23
Delhi Dynamo,291,2,5,7,2,25,17,8,22
Chennaiyin,291,3,5,5,4,16,17,-1,20
Kolkata,291,4,4,7,3,16,15,1,19
Kerala Blast,291,5,5,4,5,12,17,-5,19
NorthEast Un,291,6,5,2,7,12,12,0,17
FC Pune City,291,7,4,5,5,14,16,-2,17
FC Goa,291,8,3,3,8,9,18,-9,12
Mumbai City,292,1,7,4,3,18,9,9,25
NorthEast Un,292,2,6,3,5,13,11,2,21
Delhi Dynamo,292,3,5,5,4,26,20,6,20
Kolkata,292,4,4,7,3,16,14,2,19
Chennaiyin,292,5,4,6,4,14,17,-3,18
Kerala Blast,292,6,5,3,6,13,19,-6,18
FC Pune City,292,7,4,4,6,13,16,-3,16
FC Goa,292,8,4,2,8,11,18,-7,14
Delhi Dynamo,293,1,6,6,2,28,16,12,24
Mumbai City,293,2,6,4,4,17,10,7,22
Kolkata,293,3,5,6,3,21,18,3,21
Kerala Blast,293,4,6,3,5,17,18,-1,21
FC Goa,293,5,5,3,6,12,15,-3,18
Chennaiyin,293,6,4,5,5,14,19,-5,17
FC Pune City,293,7,4,3,7,14,20,-6,15
NorthEast Un,293,8,4,2,8,9,16,-7,14
Mumbai City,294,1,7,4,3,19,10,9,25
Kolkata,294,2,5,7,2,15,12,3,22
Delhi Dynamo,294,3,5,5,4,26,20,6,20
NorthEast Un,294,4,6,2,6,14,12,2,20
Chennaiyin,294,5,5,5,4,18,17,1,20
Kerala Blast,294,6,5,3,6,11,16,-5,18
FC Pune City,294,7,4,3,7,12,16,-4,15
FC Goa,294,8,3,3,8,8,20,-12,12
Mumbai City,295,1,7,4,3,18,9,9,25
Kolkata,295,2,4,7,3,18,17,1,19
Kerala Blast,295,3,5,4,5,14,18,-4,19
NorthEast Un,295,4,5,3,6,16,15,1,18
FC Pune City,295,5,5,3,6,15,17,-2,18
FC Goa,295,6,5,3,6,13,15,-2,18
Delhi Dynamo,295,7,4,5,5,22,21,1,17
Chennaiyin,295,8,4,5,5,16,20,-4,17
Mumbai City,296,1,7,4,3,17,8,9,25
Delhi Dynamo,296,2,6,5,3,26,17,9,23
Kolkata,296,3,5,7,2,15,12,3,22
NorthEast Un,296,4,6,2,6,14,12,2,20
Kerala Blast,296,5,5,3,6,10,15,-5,18
FC Pune City,296,6,4,3,7,12,16,-4,15
Chennaiyin,296,7,3,6,5,15,21,-6,15
FC Goa,296,8,3,4,7,10,18,-8,13
Delhi Dynamo,297,1,6,5,3,25,18,7,23
Mumbai City,297,2,6,4,4,17,10,7,22
Kolkata,297,3,4,8,2,17,14,3,20
NorthEast Un,297,4,6,2,6,12,11,1,20
FC Goa,297,5,5,3,6,13,15,-2,18
Kerala Blast,297,6,5,3,6,12,16,-4,18
FC Pune City,297,7,4,4,6,13,18,-5,16
Chennaiyin,297,8,3,5,6,13,20,-7,14
Mumbai City,298,1,6,4,4,18,12,6,22
Kolkata,298,2,5,7,2,19,15,4,22
Kerala Blast,298,3,6,4,4,14,15,-1,22
Delhi Dynamo,298,4,5,5,4,25,18,7,20
Chennaiyin,298,5,4,6,4,16,19,-3,18
NorthEast Un,298,6,5,2,7,11,13,-2,17
FC Pune City,298,7,4,3,7,12,17,-5,15
FC Goa,298,8,4,3,7,11,17,-6,15
Delhi Dynamo,299,1,6,6,2,26,16,10,24
Mumbai City,299,2,6,5,3,16,8,8,23
Kolkata,299,3,4,7,3,16,15,1,19
Kerala Blast,299,4,5,4,5,14,18,-4,19
FC Pune City,299,5,5,3,6,15,17,-2,18
NorthEast Un,299,6,4,4,6,12,13,-1,16
Chennaiyin,299,7,3,7,4,13,17,-4,16
FC Goa,299,8,3,4,7,9,17,-8,13
Mumbai City,300,1,7,4,3,18,9,9,25
Delhi Dynamo,300,2,5,6,3,24,17,7,21
Kolkata,300,3,4,8,2,16,14,2,20
FC Pune City,300,4,5,4,5,15,15,0,19
Kerala Blast,300,5,5,4,5,11,16,-5,19
Chennaiyin,300,6,4,6,4,15,17,-2,18
NorthEast Un,300,7,4,2,8,9,13,-4,14
FC Goa,300,8,3,4,7,9,16,-7,13
Delhi Dynamo,301,1,7,5,2,28,15,13,26
Mumbai City,301,2,6,4,4,17,10,7,22
Kolkata,301,3,5,7,2,17,13,4,22
Chennaiyin,301,4,4,6,4,14,17,-3,18
NorthEast Un,301,5,5,2,7,10,12,-2,17
FC Pune City,301,6,4,4,6,12,16,-4,16
Kerala Blast,301,7,4,4,6,10,16,-6,16
FC Goa,301,8,3,4,7,8,17,-9,13
Mumbai City,302,1,6,5,3,17,9,8,23
Kerala Blast,302,2,6,4,4,14,15,-1,22
Delhi Dynamo,302,3,5,6,3,24,17,7,21
Kolkata,302,4,4,8,2,18,16,2,20
Chennaiyin,302,5,4,6,4,17,18,-1,18
NorthEast Un,302,6,5,2,7,12,14,-2,17
FC Pune City,302,7,4,3,7,13,18,-5,15
FC Goa,302,8,3,4,7,11,19,-8,13
Mumbai City,303,1,6,5,3,17,9,8,23
NorthEast Un,303,2,6,3,5,14,12,2,21
Delhi Dynamo,303,3,4,7,3,25,19,6,19
FC Pune City,303,4,5,4,5,17,15,2,19
Kolkata,303,5,4,6,4,16,19,-3,18
Chennaiyin,303,6,4,6,4,14,17,-3,18
Kerala Blast,303,7,4,4,6,11,18,-7,16
FC Goa,303,8,4,3,7,12,17,-5,15
Mumbai City,304,1,6,4,4,16,9,7,22
Delhi Dynamo,304,2,5,6,3,23,16,7,21
Kolkata,304,3,4,8,2,16,13,3,20
Kerala Blast,304,4,5,5,4,12,15,-3,20
FC Pune City,304,5,4,5,5,13,15,-2,17
Chennaiyin,304,6,4,5,5,19,22,-3,17
FC Goa,304,7,5,2,7,14,19,-5,17
NorthEast Un,304,8,4,3,7,12,16,-4,15
Delhi Dynamo,305,1,6,6,2,28,17,11,24
Mumbai City,305,2,6,4,4,17,10,7,22
Kerala Blast,305,3,6,4,4,14,16,-2,22
Chennaiyin,305,4,5,5,4,18,18,0,20
Kolkata,305,5,4,6,4,17,17,0,18
FC Pune City,305,6,4,4,6,13,16,-3,16
NorthEast Un,305,7,4,3,7,12,14,-2,15
FC Goa,305,8,4,2,8,10,21,-11,14
Mumbai City,306,1,6,5,3,17,9,8,23
Delhi Dynamo,306,2,5,7,2,25,17,8,22
Kerala Blast,306,3,6,3,5,13,16,-3,21
Kolkata,306,4,4,8,2,16,14,2,20
Chennaiyin,306,5,5,5,4,17,19,-2,20
FC Pune City,306,6,4,4,6,13,16,-3,16
NorthEast Un,306,7,4,3,7,13,15,-2,15
FC Goa,306,8,3,3,8,9,17,-8,12
Delhi Dynamo,307,1,7,5,2,31,16,15,26
Mumbai City,307,2,6,4,4,18,12,6,22
Kerala Blast,307,3,6,4,4,13,14,-1,22
Kolkata,307,4,4,6,4,14,15,-1,18
FC Goa,307,5,5,2,7,10,17,-7,17
FC Pune City,307,6,4,4,6,13,16,-3,16
NorthEast Un,307,7,4,3,7,11,15,-4,15
Chennaiyin,307,8,3,6,5,15,20,-5,15
Delhi Dynamo,308,1,7,5,2,29,17,12,26
Mumbai City,308,2,6,4,4,17,11,6,22
FC Pune City,308,3,6,3,5,15,14,1,21
NorthEast Un,308,4,6,2,6,15,12,3,20
Kolkata,308,5,4,6,4,18,16,2,18
FC Goa,308,6,5,2,7,12,18,-6,17
Kerala Blast,308,7,4,3,7,11,22,-11,15
Chennaiyin,308,8,3,5,6,13,20,-7,14
Mumbai City,309,1,6,5,3,18,10,8,23
Kolkata,309,2,5,7,2,20,14,6,22
NorthEast Un,309,3,6,2,6,13,12,1,20
Kerala Blast,309,4,5,5,4,11,14,-3,20
Delhi Dynamo,309,5,4,7,3,24,18,6,19
Chennaiyin,309,6,4,5,5,15,19,-4,17
FC Pune City,309,7,4,4,6,12,17,-5,16
FC Goa,309,8,3,3,8,9,18,-9,12
Mumbai City,310,1,6,4,4,17,10,7,22
Kolkata,310,2,5,7,2,19,14,5,22
Delhi Dynamo,310,3,5,6,3,24,18,6,21
NorthEast Un,310,4,6,2,6,17,13,4,20
FC Pune City,310,5,5,3,6,16,17,-1,18
Kerala Blast,310,6,5,3,6,11,19,-8,18
FC Goa,310,7,4,4,6,12,15,-3,16
Chennaiyin,310,8,3,5,6,14,24,-10,14
Delhi Dynamo,311,1,6,6,2,28,19,9,24
Mumbai City,311,2,6,5,3,19,11,8,23
Kerala Blast,311,3,6,3,5,16,19,-3,21
Kolkata,311,4,4,8,2,20,18,2,20
NorthEast Un,311,5,5,2,7,12,13,-1,17
Chennaiyin,311,6,4,5,5,14,18,-4,17
FC Pune City,311,7,4,4,6,15,18,-3,16
FC Goa,311,8,3,3,8,10,18,-8,12
Mumbai City,312,1,6,5,3,16,8,8,23
Delhi Dynamo,312,2,5,6,3,25,17,8,21
Kerala Blast,312,3,5,5,4,14,17,-3,20
Kolkata,312,4,3,9,2,16,15,1,18
Chennaiyin,312,5,4,6,4,16,17,-1,18
NorthEast Un,312,6,5,3,6,13,15,-2,18
FC Pune City,312,7,4,4,6,15,18,-3,16
FC Goa,312,8,3,4,7,9,17,-8,13
Mumbai City,313,1,6,5,3,16,8,8,23
Delhi Dynamo,313,2,5,7,2,24,15,9,22
Kerala Blast,313,3,5,5,4,11,14,-3,20
FC Pune City,313,4,5,4,5,15,16,-1,19
Kolkata,313,5,4,6,4,15,15,0,18
Chennaiyin,313,6,4,6,4,15,18,-3,18
NorthEast Un,313,7,4,5,5,11,11,0,17
FC Goa,313,8,3,2,9,8,18,-10,11
Mumbai City,314,1,7,4,3,20,10,10,25
Kerala Blast,314,2,7,3,4,20,15,5,24
Delhi Dynamo,314,3,5,5,4,26,21,5,20
Chennaiyin,314,4,4,6,4,15,18,-3,18
FC Goa,314,5,5,3,6,12,15,-3,18
Kolkata,314,6,3,7,4,17,19,-2,16
FC Pune City,314,7,4,4,6,14,21,-7,16
NorthEast Un,314,8,4,2,8,10,15,-5,14
Mumbai City,315,1,6,5,3,16,8,8,23
Delhi Dynamo,315,2,5,6,3,22,16,6,21
Chennaiyin,315,3,5,5,4,16,17,-1,20
Kerala Blast,315,4,5,5,4,13,15,-2,20
FC Pune City,315,5,5,4,5,14,15,-1,19
NorthEast Un,315,6,5,3,6,13,13,0,18
Kolkata,315,7,3,6,5,14,17,-3,15
FC Goa,315,8,4,2,8,9,16,-7,14
Mumbai City,316,1,7,4,3,19,8,11,25
Delhi Dynamo,316,2,5,6,3,24,18,6,21
Kerala Blast,316,3,6,3,5,13,17,-4,21
FC Pune City,316,4,5,4,5,16,16,0,19
NorthEast Un,316,5,5,3,6,12,12,0,18
Chennaiyin,316,6,4,5,5,15,19,-4,17
Kolkata,316,7,3,7,4,15,17,-2,16
FC Goa,316,8,4,2,8,10,17,-7,14
Kerala Blast,317,1,7,3,4,18,15,3,24
Delhi Dynamo,317,2,5,7,2,23,15,8,22
Mumbai City,317,3,6,4,4,17,10,7,22
Kolkata,317,4,3,8,3,16,19,-3,17
NorthEast Un,317,5,4,4,6,10,12,-2,16
FC Pune City,317,6,4,4,6,14,17,-3,16
FC Goa,317,7,4,4,6,12,16,-4,16
Chennaiyin,317,8,3,6,5,15,21,-6,15
Mumbai City,318,1,7,4,3,17,8,9,25
Delhi Dynamo,318,2,6,5,3,25,16,9,23
Kerala Blast,318,3,6,4,4,13,13,0,22
FC Pune City,318,4,5,3,6,15,17,-2,18
FC Goa,318,5,5,2,7,12,17,-5,17
Kolkata,318,6,3,7,4,14,17,-3,16
NorthEast Un,318,7,4,3,7,10,13,-3,15
Chennaiyin,318,8,3,6,5,14,19,-5,15
Delhi Dynamo,319,1,6,5,3,26,17,9,23
Mumbai City,319,2,6,4,4,16,10,6,22
Kerala Blast,319,3,6,3,5,14,16,-2,21
Kolkata,319,4,4,6,4,17,18,-1,18
FC Pune City,319,5,5,3,6,16,17,-1,18
FC Goa,319,6,5,2,7,14,17,-3,17
Chennaiyin,319,7,4,5,5,15,19,-4,17
NorthEast Un,319,8,5,2,7,11,15,-4,17
Mumbai City,320,1,7,4,3,18,8,10,25
Kerala Blast,320,2,6,3,5,16,14,2,21
Chennaiyin,320,3,5,5,4,20,18,2,20
Kolkata,320,4,4,7,3,18,17,1,19
Delhi Dynamo,320,5,4,6,4,24,20,4,18
FC Goa,320,6,5,2,7,14,21,-7,17
FC Pune City,320,7,4,4,6,15,21,-6,16
NorthEast Un,320,8,4,3,7,10,16,-6,15
Mumbai City,321,1,7,4,3,17,8,9,25
Delhi Dynamo,321,2,4,7,3,27,21,6,19
NorthEast Un,321,3,5,4,5,16,14,2,19
Kolkata,321,4,4,7,3,15,14,1,19
Kerala Blast,321,5,5,4,5,11,14,-3,19
FC Pune City,321,6,5,3,6,14,17,-3,18
Chennaiyin,321,7,4,5,5,18,23,-5,17
FC Goa,321,8,3,4,7,13,20,-7,13
Mumbai City,322,1,7,4,3,19,8,11,25
Kerala Blast,322,2,6,4,4,13,15,-2,22
Delhi Dynamo,322,3,5,6,3,24,18,6,21
FC Pune City,322,4,4,5,5,13,15,-2,17
FC Goa,322,5,5,2,7,12,17,-5,17
NorthEast Un,322,6,4,4,6,12,13,-1,16
Kolkata,322,7,3,7,4,15,17,-2,16
Chennaiyin,322,8,3,6,5,15,20,-5,15
Delhi Dynamo,323,1,6,6,2,28,17,11,24
Mumbai City,323,2,6,5,3,18,10,8,23
Kolkata,323,3,5,6,3,16,16,0,21
Kerala Blast,323,4,6,3,5,13,16,-3,21
FC Pune City,323,5,5,3,6,15,15,0,18
Chennaiyin,323,6,4,6,4,16,19,-3,18
NorthEast Un,323,7,4,2,8,10,13,-3,14
FC Goa,323,8,3,3,8,11,21,-10,12
Mumbai City,324,1,6,5,3,17,9,8,23
Kolkata,324,2,5,7,2,18,15,3,22
NorthEast Un,324,3,5,4,5,13,11,2,19
FC Pune City,324,4,5,4,5,15,15,0,19
Delhi Dynamo,324,5,4,6,4,23,19,4,18
Chennaiyin,324,6,3,7,4,15,19,-4,16
Kerala Blast,324,7,4,4,6,10,17,-7,16
FC Goa,324,8,4,3,7,13,19,-6,15
Mumbai City,325,1,7,4,3,19,9,10,25
FC Goa,325,2,6,2,6,14,14,0,20
FC Pune City,325,3,5,4,5,16,16,0,19
Kerala Blast,325,4,5,4,5,12,17,-5,19
Delhi Dynamo,325,5,4,6,4,22,19,3,18
Chennaiyin,325,6,4,5,5,15,20,-5,17
NorthEast Un,325,7,4,4,6,11,12,-1,16
Kolkata,325,8,3,7,4,16,18,-2,16
Mumbai City,326,1,7,4,3,20,9,11,25
Kolkata,326,2,6,6,2,20,14,6,24
Delhi Dynamo,326,3,4,6,4,23,20,3,18
FC Pune City,326,4,5,3,6,18,18,0,18
Kerala Blast,326,5,5,3,6,11,19,-8,18
NorthEast Un,326,6,4,4,6,10,12,-2,16
Chennaiyin,326,7,3,7,4,15,19,-4,16
FC Goa,326,8,4,3,7,11,17,-6,15
Mumbai City,327,1,7,4,3,19,9,10,25
Kolkata,327,2,6,6,2,22,16,6,24
Kerala Blast,327,3,5,4,5,12,18,-6,19
NorthEast Un,327,4,5,3,6,12,12,0,18
Chennaiyin,327,5,4,6,4,17,20,-3,18
Delhi Dynamo,327,6,4,5,5,23,21,2,17
FC Pune City,327,7,4,4,6,15,18,-3,16
FC Goa,327,8,4,2,8,15,21,-6,14
Mumbai City,328,1,6,5,3,17,9,8,23
Kerala Blast,328,2,6,3,5,15,18,-3,21
NorthEast Un,328,3,6,2,6,15,12,3,20
Delhi Dynamo,328,4,4,7,3,23,19,4,19
Kolkata,328,5,4,7,3,15,14,1,19
FC Pune City,328,6,5,4,5,15,16,-1,19
Chennaiyin,328,7,3,6,5,15,20,-5,15
FC Goa,328,8,3,4,7,10,17,-7,13
Mumbai City,329,1,7,4,3,18,8,10,25
NorthEast Un,329,2,7,2,5,15,10,5,23
Kolkata,329,3,4,7,3,15,14,1,19
Kerala Blast,329,4,5,4,5,11,16,-5,19
Delhi Dynamo,329,5,4,5,5,23,20,3,17
Chennaiyin,329,6,4,5,5,15,19,-4,17
FC Goa,329,7,5,2,7,11,17,-6,17
FC Pune City,329,8,4,3,7,14,18,-4,15
Delhi Dynamo,330,1,7,5,2,26,14,12,26
Mumbai City,330,2,6,4,4,16,9,7,22
Kolkata,330,3,5,7,2,20,14,6,22
NorthEast Un,330,4,5,3,6,12,13,-1,18
FC Pune City,330,5,5,3,6,13,17,-4,18
Kerala Blast,330,6,4,5,5,12,17,-5,17
Chennaiyin,330,7,3,6,5,17,22,-5,15
FC Goa,330,8,3,3,8,11,21,-10,12
Delhi Dynamo,331,1,6,6,2,28,15,13,24
Mumbai City,331,2,6,5,3,17,9,8,23
FC Pune City,331,3,6,3,5,16,16,0,21
Kolkata,331,4,4,6,4,18,16,2,18
Kerala Blast,331,5,5,3,6,11,17,-6,18
FC Goa,331,6,5,2,7,11,19,-8,17
NorthEast Un,331,7,4,3,7,9,13,-4,15
Chennaiyin,331,8,3,6,5,14,19,-5,15
Mumbai City,332,1,7,4,3,17,8,9,25
FC Pune City,332,2,6,3,5,16,16,0,21
Delhi Dynamo,332,3,5,5,4,23,17,6,20
Kolkata,332,4,4,7,3,16,15,1,19
NorthEast Un,332,5,5,3,6,10,11,-1,18
Kerala Blast,332,6,5,3,6,13,17,-4,18
Chennaiyin,332,7,3,7,4,14,18,-4,16
FC Goa,332,8,3,4,7,12,19,-7,13
Mumbai City,333,1,7,4,3,19,8,11,25
Delhi Dynamo,333,2,5,6,3,27,18,9,21
Kolkata,333,3,5,6,3,18,14,4,21
NorthEast Un,333,4,5,3,6,13,12,1,18
Chennaiyin,333,5,4,6,4,16,19,-3,18
FC Pune City,333,6,4,4,6,12,16,-4,16
Kerala Blast,333,7,4,4,6,10,19,-9,16
FC Goa,333,8,4,3,7,12,21,-9,15
Delhi Dynamo,334,1,6,6,2,28,17,11,24
Kerala Blast,334,2,7,3,4,15,14,1,24
Mumbai City,334,3,6,4,4,17,12,5,22
Kolkata,334,4,3,8,3,16,16,0,17
Chennaiyin,334,5,3,7,4,17,21,-4,16
FC Pune City,334,6,4,4,6,14,19,-5,16
NorthEast Un,334,7,4,3,7,12,14,-2,15
FC Goa,334,8,3,5,6,13,19,-6,14
Delhi Dynamo,335,1,6,5,3,25,17,8,23
Mumbai City,335,2,6,4,4,17,10,7,22
Kerala Blast,335,3,6,3,5,14,17,-3,21
Chennaiyin,335,4,5,5,4,18,19,-1,20
FC Pune City,335,5,5,4,5,14,15,-1,19
Kolkata,335,6,3,8,3,14,14,0,17
NorthEast Un,335,7,5,2,7,13,13,0,17
FC Goa,335,8,3,3,8,9,19,-10,12
Mumbai City,336,1,7,4,3,18,9,9,25
Kolkata,336,2,5,6,3,17,16,1,21
Delhi Dynamo,336,3,5,5,4,24,18,6,20
NorthEast Un,336,4,6,2,6,16,10,6,20
FC Goa,336,5,5,2,7,15,17,-2,17
Chennaiyin,336,6,4,5,5,15,20,-5,17
FC Pune City,336,7,4,4,6,12,16,-4,16
Kerala Blast,336,8,4,4,6,9,20,-11,16
Mumbai City,337,1,6,5,3,16,8,8,23
Delhi Dynamo,337,2,5,7,2,23,14,9,22
Kolkata,337,3,4,7,3,19,16,3,19
Kerala Blast,337,4,5,4,5,11,15,-4,19
NorthEast Un,337,5,5,3,6,11,10,1,18
Chennaiyin,337,6,4,6,4,15,18,-3,18
FC Pune City,337,7,4,4,6,13,19,-6,16
FC Goa,337,8,3,4,7,10,18,-8,13
Mumbai City,338,1,6,4,4,17,10,7,22
Delhi Dynamo,338,2,5,6,3,24,17,7,21
Kerala Blast,338,3,6,3,5,12,17,-5,21
Kolkata,338,4,4,8,2,19,14,5,20
NorthEast Un,338,5,5,3,6,12,13,-1,18
FC Pune City,338,6,4,4,6,12,15,-3,16
FC Goa,338,7,4,4,6,14,18,-4,16
Chennaiyin,338,8,3,6,5,16,22,-6,15
Kolkata,339,1,6,6,2,17,12,5,24
Delhi Dynamo,339,2,6,5,3,24,17,7,23
Mumbai City,339,3,6,4,4,16,9,7,22
NorthEast Un,339,4,5,4,5,12,10,2,19
FC Pune City,339,5,5,3,6,15,17,-2,18
Chennaiyin,339,6,3,7,4,15,19,-4,16
Kerala Blast,339,7,4,4,6,12,18,-6,16
FC Goa,339,8,3,3,8,11,20,-9,12
Mumbai City,340,1,7,4,3,20,11,9,25
Kolkata,340,2,5,6,3,16,13,3,21
NorthEast Un,340,3,5,4,5,11,10,1,19
Kerala Blast,340,4,5,4,5,12,16,-4,19
Delhi Dynamo,340,5,4,6,4,25,20,5,18
FC Goa,340,6,5,3,6,11,15,-4,18
Chennaiyin,340,7,3,6,5,13,18,-5,15
FC Pune City,340,7,4,3,7,13,18,-5,15
Mumbai City,341,1,6,4,4,16,10,6,22
Delhi Dynamo,341,2,5,6,3,24,16,8,21
Kolkata,341,3,4,7,3,18,16,2,19
FC Pune City,341,4,5,4,5,14,15,-1,19
Kerala Blast,341,5,5,4,5,13,16,-3,19
NorthEast Un,341,6,5,3,6,11,12,-1,18
Chennaiyin,341,7,4,5,5,16,19,-3,17
FC Goa,341,8,4,3,7,11,19,-8,15
Mumbai City,342,1,6,5,3,19,11,8,23
Delhi Dynamo,342,2,5,6,3,27,20,7,21
Kerala Blast,342,3,5,5,4,13,14,-1,20
Chennaiyin,342,4,5,5,4,16,18,-2,20
FC Pune City,342,5,5,4,5,17,15,2,19
NorthEast Un,342,6,5,3,6,11,11,0,18
Kolkata,342,7,3,7,4,13,19,-6,16
FC Goa,342,8,3,3,8,10,18,-8,12
Mumbai City,343,1,7,4,3,18,8,10,25
Delhi Dynamo,343,2,5,6,3,25,17,8,21
Kolkata,343,3,4,8,2,18,15,3,20
Kerala Blast,343,4,5,5,4,16,18,-2,20
NorthEast Un,343,5,4,5,5,12,12,0,17
Chennaiyin,343,6,3,6,5,14,19,-5,15
FC Pune City,343,7,4,3,7,15,21,-6,15
FC Goa,343,8,4,3,7,11,19,-8,15
Delhi Dynamo,344,1,6,5,3,23,15,8,23
Mumbai City,344,2,6,4,4,16,9,7,22
Kolkata,344,3,5,6,3,20,18,2,21
FC Pune City,344,4,5,3,6,18,20,-2,18
Chennaiyin,344,5,4,6,4,17,20,-3,18
Kerala Blast,344,6,5,3,6,16,19,-3,18
NorthEast Un,344,7,5,2,7,11,12,-1,17
FC Goa,344,8,4,3,7,11,19,-8,15
Mumbai City,345,1,7,4,3,18,9,9,25
Delhi Dynamo,345,2,6,5,3,26,16,10,23
Kerala Blast,345,3,6,3,5,12,14,-2,21
Kolkata,345,4,4,7,3,14,15,-1,19
FC Goa,345,5,5,2,7,14,16,-2,17
Chennaiyin,345,6,4,5,5,15,20,-5,17
FC Pune City,345,7,4,4,6,12,16,-4,16
NorthEast Un,345,8,4,2,8,9,14,-5,14
Mumbai City,346,1,7,4,3,20,8,12,25
Kolkata,346,2,5,7,2,17,14,3,22
Delhi Dynamo,346,3,5,6,3,26,21,5,21
Chennaiyin,346,4,5,5,4,18,19,-1,20
FC Pune City,346,5,5,4,5,14,15,-1,19
NorthEast Un,346,6,5,3,6,15,15,0,18
Kerala Blast,346,7,4,3,7,10,17,-7,15
FC Goa,346,8,3,2,9,10,21,-11,11
Mumbai City,347,1,7,4,3,18,8,10,25
Delhi Dynamo,347,2,5,5,4,24,20,4,20
Kolkata,347,3,4,8,2,17,15,2,20
Chennaiyin,347,4,5,5,4,16,17,-1,20
Kerala Blast,347,5,5,5,4,12,15,-3,20
FC Pune City,347,6,4,4,6,13,16,-3,16
NorthEast Un,347,7,4,3,7,11,13,-2,15
FC Goa,347,8,4,2,8,12,19,-7,14
Mumbai City,348,1,7,4,3,18,9,9,25
Delhi Dynamo,348,2,6,5,3,25,16,9,23
NorthEast Un,348,3,6,2,6,14,11,3,20
Kolkata,348,4,4,8,2,18,16,2,20
Kerala Blast,348,5,5,3,6,14,19,-5,18
FC Pune City,348,6,4,4,6,15,18,-3,16
Chennaiyin,348,7,3,6,5,13,21,-8,15
FC Goa,348,8,3,4,7,9,16,-7,13
Delhi Dynamo,349,1,6,5,3,27,18,9,23
Mumbai City,349,2,6,4,4,18,12,6,22
Kolkata,349,3,4,8,2,18,16,2,20
Kerala Blast,349,4,5,5,4,13,15,-2,20
FC Goa,349,5,5,3,6,12,16,-4,18
Chennaiyin,349,6,4,5,5,15,19,-4,17
FC Pune City,349,7,4,4,6,15,18,-3,16
NorthEast Un,349,8,4,2,8,10,14,-4,14
Mumbai City,350,1,7,4,3,19,9,10,25
Kerala Blast,350,2,7,3,4,15,15,0,24
FC Goa,350,3,6,2,6,14,17,-3,20
NorthEast Un,350,4,5,3,6,18,11,7,18
Kolkata,350,5,4,6,4,15,16,-1,18
Delhi Dynamo,350,6,4,5,5,24,28,-4,17
FC Pune City,350,7,4,3,7,14,18,-4,15
Chennaiyin,350,8,3,6,5,14,19,-5,15
Mumbai City,351,1,6,5,3,16,8,8,23
Delhi Dynamo,351,2,5,7,2,22,14,8,22
Kolkata,351,3,5,7,2,17,14,3,22
NorthEast Un,351,4,5,4,5,14,11,3,19
Kerala Blast,351,5,5,4,5,14,15,-1,19
FC Goa,351,6,4,3,7,11,17,-6,15
FC Pune City,351,7,4,3,7,13,20,-7,15
Chennaiyin,351,8,3,5,6,15,23,-8,14
Delhi Dynamo,352,1,6,6,2,29,17,12,24
Mumbai City,352,2,6,4,4,18,11,7,22
Kerala Blast,352,3,6,4,4,12,13,-1,22
Kolkata,352,4,4,8,2,18,15,3,20
NorthEast Un,352,5,5,3,6,12,11,1,18
FC Pune City,352,6,4,4,6,15,19,-4,16
Chennaiyin,352,7,3,5,6,15,22,-7,14
FC Goa,352,8,4,2,8,11,22,-11,14
Kolkata,353,1,6,6,2,20,14,6,24
Mumbai City,353,2,6,5,3,18,10,8,23
NorthEast Un,353,3,6,2,6,14,13,1,20
Delhi Dynamo,353,4,4,7,3,24,18,6,19
Chennaiyin,353,5,4,5,5,16,20,-4,17
FC Pune City,353,6,4,4,6,14,19,-5,16
Kerala Blast,353,7,4,4,6,14,20,-6,16
FC Goa,353,8,4,3,7,10,16,-6,15
Mumbai City,354,1,6,5,3,16,8,8,23
Delhi Dynamo,354,2,5,7,2,23,15,8,22
Chennaiyin,354,3,5,5,4,17,18,-1,20
NorthEast Un,354,4,5,3,6,11,10,1,18
Kolkata,354,5,3,8,3,14,14,0,17
FC Pune City,354,6,4,5,5,14,16,-2,17
Kerala Blast,354,7,4,5,5,10,16,-6,17
FC Goa,354,8,4,2,8,11,19,-8,14
Mumbai City,355,1,6,5,3,17,9,8,23
Delhi Dynamo,355,2,5,7,2,29,19,10,22
NorthEast Un,355,3,6,3,5,17,14,3,21
Kolkata,355,4,4,7,3,18,15,3,19
Kerala Blast,355,5,5,4,5,15,19,-4,19
Chennaiyin,355,6,4,5,5,16,21,-5,17
FC Pune City,355,7,4,4,6,15,20,-5,16
FC Goa,355,8,3,3,8,11,21,-10,12
Mumbai City,356,1,7,4,3,18,8,10,25
NorthEast Un,356,2,7,2,5,16,11,5,23
Kolkata,356,3,5,7,2,20,15,5,22
Delhi Dynamo,356,4,5,5,4,26,21,5,20
FC Pune City,356,5,5,3,6,15,18,-3,18
FC Goa,356,6,4,3,7,13,19,-6,15
Kerala Blast,356,7,4,3,7,11,20,-9,15
Chennaiyin,356,8,3,5,6,14,21,-7,14
Mumbai City,357,1,7,4,3,18,9,9,25
Delhi Dynamo,357,2,5,6,3,25,17,8,21
Kolkata,357,3,4,7,3,16,15,1,19
Kerala Blast,357,4,5,4,5,12,16,-4,19
FC Pune City,357,5,5,3,6,13,15,-2,18
Chennaiyin,357,6,4,5,5,16,22,-6,17
NorthEast Un,357,7,4,4,6,12,13,-1,16
FC Goa,357,8,4,3,7,13,18,-5,15
Mumbai City,358,1,7,4,3,18,9,9,25
Kerala Blast,358,2,7,3,4,14,15,-1,24
Delhi Dynamo,358,3,5,5,4,27,17,10,20
Kolkata,358,4,4,6,4,17,15,2,18
NorthEast Un,358,5,5,3,6,12,12,0,18
FC Goa,358,6,5,2,7,12,21,-9,17
Chennaiyin,358,7,3,6,5,16,21,-5,15
FC Pune City,358,8,4,3,7,14,20,-6,15
Mumbai City,359,1,7,4,3,18,8,10,25
Kerala Blast,359,2,6,4,4,16,17,-1,22
Delhi Dynamo,359,3,5,6,3,22,16,6,21
Chennaiyin,359,4,5,5,4,19,19,0,20
Kolkata,359,5,4,7,3,17,17,0,19
NorthEast Un,359,6,4,3,7,11,14,-3,15
FC Pune City,359,7,4,3,7,12,17,-5,15
FC Goa,359,8,4,2,8,11,18,-7,14
Mumbai City,360,1,7,4,3,19,9,10,25
FC Pune City,360,2,6,3,5,16,16,0,21
Kerala Blast,360,3,6,3,5,13,15,-2,21
Chennaiyin,360,4,5,5,4,18,18,0,20
Delhi Dynamo,360,5,4,7,3,25,20,5,19
Kolkata,360,6,3,6,5,14,16,-2,15
NorthEast Un,360,7,4,3,7,11,14,-3,15
FC Goa,360,8,4,3,7,11,19,-8,15
Mumbai City,361,1,7,4,3,19,10,9,25
Delhi Dynamo,361,2,6,5,3,26,18,8,23
Kolkata,361,3,5,7,2,17,13,4,22
Kerala Blast,361,4,5,4,5,13,18,-5,19
Chennaiyin,361,5,4,6,4,18,20,-2,18
NorthEast Un,361,6,4,3,7,13,16,-3,15
FC Pune City,361,7,4,3,7,14,18,-4,15
FC Goa,361,8,3,4,7,10,17,-7,13
Mumbai City,362,1,7,4,3,18,9,9,25
NorthEast Un,362,2,6,3,5,15,10,5,21
Kolkata,362,3,4,7,3,15,14,1,19
Delhi Dynamo,362,4,4,6,4,25,22,3,18
FC Pune City,362,5,5,3,6,14,17,-3,18
Kerala Blast,362,6,5,3,6,12,17,-5,18
Chennaiyin,362,7,3,7,4,13,17,-4,16
FC Goa,362,8,3,5,6,11,17,-6,14
Mumbai City,363,1,7,4,3,17,8,9,25
FC Pune City,363,2,6,3,5,17,15,2,21
Kerala Blast,363,3,6,3,5,14,18,-4,21
Delhi Dynamo,363,4,5,5,4,24,18,6,20
NorthEast Un,363,5,6,2,6,14,12,2,20
Chennaiyin,363,6,4,5,5,15,20,-5,17
Kolkata,363,7,3,7,4,16,18,-2,16
FC Goa,363,8,3,3,8,11,19,-8,12
Delhi Dynamo,364,1,7,5,2,26,15,11,26
Mumbai City,364,2,6,4,4,17,11,6,22
Kolkata,364,3,4,6,4,16,16,0,18
NorthEast Un,364,4,5,3,6,11,11,0,18
FC Pune City,364,5,5,3,6,14,16,-2,18
Kerala Blast,364,6,5,3,6,13,19,-6,18
FC Goa,364,7,5,2,7,12,16,-4,17
Chennaiyin,364,8,3,6,5,14,19,-5,15
Mumbai City,365,1,7,4,3,18,9,9,25
Delhi Dynamo,365,2,5,5,4,26,18,8,20
NorthEast Un,365,3,6,2,6,14,13,1,20
FC Pune City,365,4,5,4,5,13,14,-1,19
Kerala Blast,365,5,5,4,5,11,15,-4,19
Kolkata,365,6,3,9,2,16,15,1,18
FC Goa,365,7,4,3,7,11,19,-8,15
Chennaiyin,365,8,3,5,6,15,21,-6,14
Mumbai City,366,1,7,4,3,18,8,10,25
FC Pune City,366,2,6,3,5,18,16,2,21
Kerala Blast,366,3,6,3,5,13,16,-3,21
FC Goa,366,4,6,2,6,14,16,-2,20
Delhi Dynamo,366,5,4,5,5,22,20,2,17
NorthEast Un,366,6,5,2,7,11,11,0,17
Chennaiyin,366,7,4,5,5,15,19,-4,17
Kolkata,366,8,3,6,5,13,18,-5,15
Delhi Dynamo,367,1,6,5,3,26,18,8,23
NorthEast Un,367,2,7,2,5,17,10,7,23
Mumbai City,367,3,6,4,4,17,11,6,22
Kolkata,367,4,4,8,2,18,14,4,20
Kerala Blast,367,5,5,3,6,13,19,-6,18
FC Pune City,367,6,4,4,6,12,17,-5,16
Chennaiyin,367,7,3,6,5,15,21,-6,15
FC Goa,367,8,3,4,7,12,20,-8,13
Mumbai City,368,1,7,4,3,18,9,9,25
Delhi Dynamo,368,2,5,6,3,25,18,7,21
Kolkata,368,3,5,6,3,18,16,2,21
Kerala Blast,368,4,6,3,5,12,15,-3,21
FC Pune City,368,5,5,3,6,16,18,-2,18
Chennaiyin,368,6,4,6,4,15,18,-3,18
NorthEast Un,368,7,4,2,8,11,14,-3,14
FC Goa,368,8,3,4,7,10,17,-7,13
Mumbai City,369,1,7,4,3,17,8,9,25
NorthEast Un,369,2,6,3,5,15,10,5,21
Delhi Dynamo,369,3,4,6,4,24,20,4,18
Chennaiyin,369,4,4,6,4,17,17,0,18
Kolkata,369,5,4,6,4,15,16,-1,18
FC Pune City,369,6,5,3,6,13,15,-2,18
Kerala Blast,369,7,5,3,6,12,18,-6,18
FC Goa,369,8,4,3,7,11,20,-9,15
Mumbai City,370,1,6,5,3,17,9,8,23
Delhi Dynamo,370,2,5,7,2,24,16,8,22
Chennaiyin,370,3,5,5,4,20,18,2,20
Kerala Blast,370,4,5,5,4,13,15,-2,20
Kolkata,370,5,4,7,3,17,14,3,19
NorthEast Un,370,6,4,4,6,10,11,-1,16
FC Pune City,370,7,4,3,7,13,20,-7,15
FC Goa,370,8,4,2,8,10,21,-11,14
Delhi Dynamo,371,1,6,6,2,27,15,12,24
Mumbai City,371,2,6,4,4,17,12,5,22
Kolkata,371,3,5,6,3,18,16,2,21
FC Pune City,371,4,5,3,6,14,15,-1,18
Chennaiyin,371,5,4,6,4,14,17,-3,18
Kerala Blast,371,6,5,3,6,12,18,-6,18
NorthEast Un,371,7,5,2,7,11,12,-1,17
FC Goa,371,8,3,4,7,8,16,-8,13
Mumbai City,372,1,6,4,4,16,9,7,22
Delhi Dynamo,372,2,5,6,3,22,15,7,21
Kolkata,372,3,5,6,3,16,13,3,21
FC Pune City,372,4,5,3,6,13,15,-2,18
FC Goa,372,5,5,3,6,11,14,-3,18
Kerala Blast,372,6,5,3,6,10,16,-6,18
Chennaiyin,372,7,4,5,5,16,19,-3,17
NorthEast Un,372,8,5,2,7,10,13,-3,17
Mumbai City,373,1,7,4,3,18,8,10,25
NorthEast Un,373,2,6,3,5,16,12,4,21
Kerala Blast,373,3,6,3,5,11,16,-5,21
Delhi Dynamo,373,4,5,5,4,23,18,5,20
FC Goa,373,5,5,2,7,14,17,-3,17
Kolkata,373,6,3,7,4,15,17,-2,16
FC Pune City,373,7,4,4,6,13,16,-3,16
Chennaiyin,373,8,3,6,5,16,22,-6,15
Mumbai City,374,1,7,4,3,20,8,12,25
Kolkata,374,2,5,6,3,22,18,4,21
Kerala Blast,374,3,6,3,5,14,17,-3,21
FC Pune City,374,4,5,3,6,15,17,-2,18
Chennaiyin,374,5,4,6,4,15,18,-3,18
Delhi Dynamo,374,6,4,5,5,21,21,0,17
NorthEast Un,374,7,5,2,7,12,13,-1,17
FC Goa,374,8,4,3,7,12,19,-7,15
Delhi Dynamo,375,1,6,5,3,25,16,9,23
Mumbai City,375,2,6,4,4,16,9,7,22
Kolkata,375,3,4,7,3,15,14,1,19
NorthEast Un,375,4,5,4,5,12,11,1,19
FC Pune City,375,5,5,4,5,14,15,-1,19
FC Goa,375,6,5,2,7,12,17,-5,17
Kerala Blast,375,7,4,4,6,10,16,-6,16
Chennaiyin,375,8,3,6,5,14,20,-6,15
Mumbai City,376,1,6,5,3,17,9,8,23
Delhi Dynamo,376,2,5,6,3,24,17,7,21
NorthEast Un,376,3,6,2,6,14,13,1,20
Kerala Blast,376,4,5,4,5,14,18,-4,19
Kolkata,376,5,3,8,3,15,15,0,17
Chennaiyin,376,6,4,5,5,16,18,-2,17
FC Goa,376,7,5,2,7,11,17,-6,17
FC Pune City,376,8,4,4,6,13,17,-4,16
Delhi Dynamo,377,1,6,6,2,28,19,9,24
Mumbai City,377,2,6,4,4,18,11,7,22
Kolkata,377,3,4,7,3,16,16,0,19
Kerala Blast,377,4,5,4,5,13,17,-4,19
FC Pune City,377,5,5,3,6,16,17,-1,18
NorthEast Un,377,6,4,4,6,11,13,-2,16
Chennaiyin,377,7,3,7,4,13,17,-4,16
FC Goa,377,8,4,3,7,11,16,-5,15
Delhi Dynamo,378,1,7,5,2,28,16,12,26
Mumbai City,378,2,6,4,4,17,11,6,22
Kolkata,378,3,5,6,3,21,16,5,21
Chennaiyin,378,4,4,6,4,15,18,-3,18
FC Pune City,378,5,5,3,6,13,17,-4,18
Kerala Blast,378,6,5,3,6,11,18,-7,18
NorthEast Un,378,7,4,3,7,10,12,-2,15
FC Goa,378,8,4,2,8,12,19,-7,14
Mumbai City,379,1,7,4,3,20,9,11,25
FC Pune City,379,2,6,3,5,15,15,0,21
NorthEast Un,379,3,6,2,6,16,14,2,20
Kolkata,379,4,4,7,3,18,17,1,19
Chennaiyin,379,5,4,6,4,14,17,-3,18
Delhi Dynamo,379,6,4,5,5,24,22,2,17
FC Goa,379,7,4,4,6,11,16,-5,16
Kerala Blast,379,8,4,3,7,14,22,-8,15
Delhi Dynamo,380,1,6,6,2,27,15,12,24
Mumbai City,380,2,6,4,4,16,11,5,22
NorthEast Un,380,3,6,3,5,13,10,3,21
Kolkata,380,4,4,7,3,17,16,1,19
FC Pune City,380,5,5,3,6,14,15,-1,18
Kerala Blast,380,6,5,3,6,11,17,-6,18
FC Goa,380,7,4,3,7,10,17,-7,15
Chennaiyin,380,8,3,5,6,13,20,-7,14
Mumbai City,381,1,7,4,3,18,8,10,25
NorthEast Un,381,2,6,3,5,13,10,3,21
FC Pune City,381,3,5,4,5,18,19,-1,19
Kerala Blast,381,4,5,4,5,13,17,-4,19
Delhi Dynamo,381,5,4,6,4,21,18,3,18
Kolkata,381,6,3,8,3,15,15,0,17
FC Goa,381,7,4,4,6,10,15,-5,16
Chennaiyin,381,8,3,5,6,15,21,-6,14
Mumbai City,382,1,6,4,4,17,10,7,22
Kerala Blast,382,2,6,4,4,13,15,-2,22
Delhi Dynamo,382,3,5,5,4,24,22,2,20
FC Goa,382,4,6,2,6,14,15,-1,20
FC Pune City,382,5,5,4,5,16,17,-1,19
NorthEast Un,382,6,5,3,6,14,10,4,18
Kolkata,382,7,3,6,5,14,17,-3,15
Chennaiyin,382,8,3,6,5,13,19,-6,15
Mumbai City,383,1,6,5,3,16,8,8,23
Delhi Dynamo,383,2,4,8,2,23,16,7,20
Kolkata,383,3,4,8,2,19,16,3,20
Chennaiyin,383,4,5,5,4,18,18,0,20
Kerala Blast,383,5,5,4,5,13,17,-4,19
NorthEast Un,383,6,4,4,6,11,14,-3,16
FC Pune City,383,7,4,4,6,13,17,-4,16
FC Goa,383,8,3,4,7,12,19,-7,13
Delhi Dynamo,384,1,6,5,3,28,16,12,23
Mumbai City,384,2,6,4,4,17,11,6,22
NorthEast Un,384,3,6,3,5,12,10,2,21
Kolkata,384,4,4,7,3,19,16,3,19
FC Pune City,384,5,5,3,6,14,16,-2,18
Kerala Blast,384,6,5,3,6,10,17,-7,18
Chennaiyin,384,7,3,7,4,15,19,-4,16
FC Goa,384,8,3,4,7,11,21,-10,13
Mumbai City,385,1,7,4,3,19,9,10,25
Delhi Dynamo,385,2,5,6,3,27,21,6,21
FC Pune City,385,3,5,4,5,14,15,-1,19
Kolkata,385,4,4,6,4,17,14,3,18
FC Goa,385,5,5,2,7,14,17,-3,17
Chennaiyin,385,6,4,5,5,15,21,-6,17
Kerala Blast,385,7,4,5,5,11,19,-8,17
NorthEast Un,385,8,4,4,6,13,14,-1,16
Mumbai City,386,1,6,5,3,16,8,8,23
Delhi Dynamo,386,2,5,7,2,24,15,9,22
Kolkata,386,3,5,7,2,19,14,5,22
Kerala Blast,386,4,6,3,5,12,16,-4,21
Chennaiyin,386,5,4,5,5,17,19,-2,17
NorthEast Un,386,6,4,3,7,10,14,-4,15
FC Pune City,386,7,4,3,7,12,17,-5,15
FC Goa,386,8,4,3,7,11,18,-7,15
Mumbai City,387,1,7,4,3,18,9,9,25
Chennaiyin,387,2,5,5,4,19,17,2,20
Delhi Dynamo,387,3,4,7,3,25,19,6,19
Kolkata,387,4,4,7,3,17,15,2,19
NorthEast Un,387,5,5,3,6,12,15,-3,18
Kerala Blast,387,6,4,5,5,10,15,-5,17
FC Pune City,387,7,4,4,6,13,18,-5,16
FC Goa,387,8,4,3,7,12,18,-6,15
Mumbai City,388,1,7,4,3,17,8,9,25
NorthEast Un,388,2,6,2,6,15,12,3,20
FC Pune City,388,3,5,4,5,14,15,-1,19
Delhi Dynamo,388,4,4,6,4,22,19,3,18
Kolkata,388,5,3,9,2,18,17,1,18
Chennaiyin,388,6,4,6,4,17,19,-2,18
Kerala Blast,388,7,4,4,6,11,18,-7,16
FC Goa,388,8,3,5,6,12,18,-6,14
Delhi Dynamo,389,1,6,5,3,26,17,9,23
Mumbai City,389,2,6,4,4,17,10,7,22
Kolkata,389,3,4,8,2,15,13,2,20
NorthEast Un,389,4,5,4,5,14,13,1,19
FC Pune City,389,5,4,5,5,13,15,-2,17
Kerala Blast,389,6,4,5,5,10,15,-5,17
Chennaiyin,389,7,3,7,4,16,20,-4,16
FC Goa,389,8,3,4,7,9,17,-8,13
Delhi Dynamo,390,1,6,6,2,25,15,10,24
Mumbai City,390,2,6,5,3,16,8,8,23
NorthEast Un,390,3,6,2,6,13,11,2,20
Kerala Blast,390,4,5,4,5,13,16,-3,19
Kolkata,390,5,3,8,3,15,20,-5,17
FC Pune City,390,6,4,4,6,13,17,-4,16
FC Goa,390,7,4,3,7,15,17,-2,15
Chennaiyin,390,8,3,6,5,13,19,-6,15
Kolkata,391,1,6,6,2,22,14,8,24
Delhi Dynamo,391,2,6,5,3,26,17,9,23
Mumbai City,391,3,6,4,4,17,11,6,22
NorthEast Un,391,4,5,4,5,12,10,2,19
Kerala Blast,391,5,5,4,5,12,17,-5,19
Chennaiyin,391,6,4,6,4,16,18,-2,18
FC Pune City,391,7,4,3,7,13,17,-4,15
FC Goa,391,8,3,2,9,9,23,-14,11
Delhi Dynamo,392,1,6,6,2,26,16,10,24
Mumbai City,392,2,6,4,4,17,10,7,22
NorthEast Un,392,3,6,3,5,14,10,4,21
Kolkata,392,4,4,7,3,15,14,1,19
FC Pune City,392,5,5,3,6,14,16,-2,18
Kerala Blast,392,6,5,3,6,10,17,-7,18
Chennaiyin,392,7,3,6,5,15,20,-5,15
FC Goa,392,8,3,4,7,10,18,-8,13
Mumbai City,393,1,7,4,3,17,8,9,25
Delhi Dynamo,393,2,6,5,3,24,15,9,23
Kolkata,393,3,4,7,3,16,15,1,19
Chennaiyin,393,4,4,5,5,17,19,-2,17
FC Pune City,393,5,4,5,5,12,14,-2,17
FC Goa,393,6,5,2,7,12,16,-4,17
NorthEast Un,393,7,5,2,7,10,14,-4,17
Kerala Blast,393,8,4,4,6,10,17,-7,16
Mumbai City,394,1,6,5,3,18,10,8,23
NorthEast Un,394,2,6,3,5,17,11,6,21
Kolkata,394,3,4,8,2,17,14,3,20
Delhi Dynamo,394,4,4,7,3,25,20,5,19
Kerala Blast,394,5,5,3,6,13,20,-7,18
Chennaiyin,394,6,3,7,4,14,18,-4,16
FC Pune City,394,7,4,4,6,13,18,-5,16
FC Goa,394,8,3,5,6,11,17,-6,14
Delhi Dynamo,395,1,6,6,2,32,19,13,24
Mumbai City,395,2,6,4,4,18,11,7,22
FC Pune City,395,3,6,3,5,17,16,1,21
Kolkata,395,4,4,7,3,19,19,0,19
Chennaiyin,395,5,4,6,4,15,18,-3,18
NorthEast Un,395,6,4,4,6,10,15,-5,16
Kerala Blast,395,7,4,4,6,12,18,-6,16
FC Goa,395,8,3,4,7,13,20,-7,13
Mumbai City,396,1,7,4,3,19,9,10,25
Kolkata,396,2,6,6,2,21,14,7,24
Delhi Dynamo,396,3,5,6,3,29,21,8,21
Chennaiyin,396,4,5,5,4,17,18,-1,20
NorthEast Un,396,5,5,3,6,13,12,1,18
FC Pune City,396,6,4,4,6,13,18,-5,16
Kerala Blast,396,7,4,4,6,11,19,-8,16
FC Goa,396,8,3,2,9,12,24,-12,11
Delhi Dynamo,397,1,6,6,2,26,15,11,24
Mumbai City,397,2,6,5,3,16,8,8,23
Kolkata,397,3,5,6,3,17,13,4,21
FC Pune City,397,4,6,3,5,14,14,0,21
Chennaiyin,397,5,4,6,4,18,20,-2,18
Kerala Blast,397,6,5,3,6,11,17,-6,18
NorthEast Un,397,7,4,3,7,13,16,-3,15
FC Goa,397,8,3,2,9,8,20,-12,11
Mumbai City,398,1,6,4,4,17,11,6,22
Delhi Dynamo,398,2,5,6,3,25,17,8,21
NorthEast Un,398,3,6,3,5,13,11,2,21
FC Pune City,398,4,5,4,5,19,15,4,19
Kolkata,398,5,4,7,3,16,15,1,19
Kerala Blast,398,6,5,3,6,13,23,-10,18
Chennaiyin,398,7,4,5,5,16,19,-3,17
FC Goa,398,8,4,2,8,11,19,-8,14
Mumbai City,399,1,6,5,3,17,9,8,23
Delhi Dynamo,399,2,5,7,2,25,15,10,22
Kolkata,399,3,5,6,3,17,13,4,21
FC Pune City,399,4,5,4,5,14,15,-1,19
Kerala Blast,399,5,5,4,5,11,16,-5,19
Chennaiyin,399,6,4,5,5,15,19,-4,17
NorthEast Un,399,7,4,3,7,9,11,-2,15
FC Goa,399,8,4,2,8,10,20,-10,14
Mumbai City,400,1,7,4,3,17,8,9,25
Kolkata,400,2,4,7,3,17,16,1,19
NorthEast Un,400,3,5,4,5,14,13,1,19
Kerala Blast,400,4,5,4,5,15,17,-2,19
Delhi Dynamo,400,5,4,6,4,23,18,5,18
FC Pune City,400,6,5,3,6,13,17,-4,18
FC Goa,400,7,4,4,6,12,17,-5,16
Chennaiyin,400,8,3,6,5,14,19,-5,15
Mumbai City,401,1,6,4,4,16,11,5,22
Delhi Dynamo,401,2,5,6,3,26,18,8,21
Kerala Blast,401,3,6,3,5,14,17,-3,21
Kolkata,401,4,4,6,4,17,17,0,18
FC Pune City,401,5,5,3,6,15,17,-2,18
FC Goa,401,6,5,3,6,13,15,-2,18
NorthEast Un,401,7,4,4,6,11,13,-2,16
Chennaiyin,401,8,3,7,4,14,18,-4,16
Delhi Dynamo,402,1,6,5,3,24,15,9,23
Mumbai City,402,2,6,4,4,16,9,7,22
Kolkata,402,3,5,7,2,19,14,5,22
NorthEast Un,402,4,6,2,6,12,11,1,20
Kerala Blast,402,5,5,4,5,13,17,-4,19
Chennaiyin,402,6,4,5,5,17,19,-2,17
FC Pune City,402,7,4,4,6,14,19,-5,16
FC Goa,402,8,3,3,8,9,20,-11,12
Delhi Dynamo,403,1,6,6,2,28,17,11,24
Mumbai City,403,2,6,5,3,18,10,8,23
FC Pune City,403,3,6,3,5,16,16,0,21
Kerala Blast,403,4,5,4,5,13,17,-4,19
NorthEast Un,403,5,5,3,6,12,14,-2,18
Kolkata,403,6,3,7,4,15,16,-1,16
FC Goa,403,7,4,3,7,11,17,-6,15
Chennaiyin,403,8,3,5,6,13,19,-6,14
Mumbai City,404,1,6,5,3,18,10,8,23
Delhi Dynamo,404,2,5,6,3,26,20,6,21
Kolkata,404,3,5,6,3,20,16,4,21
Chennaiyin,404,4,4,6,4,18,21,-3,18
FC Pune City,404,5,5,3,6,15,19,-4,18
Kerala Blast,404,6,5,3,6,11,17,-6,18
NorthEast Un,404,7,5,2,7,15,15,0,17
FC Goa,404,8,4,3,7,13,18,-5,15
Mumbai City,405,1,6,4,4,16,9,7,22
Kerala Blast,405,2,6,3,5,13,14,-1,21
Delhi Dynamo,405,3,5,5,4,22,17,5,20
NorthEast Un,405,4,6,2,6,12,12,0,20
Kolkata,405,5,4,6,4,15,15,0,18
FC Pune City,405,6,5,3,6,14,18,-4,18
Chennaiyin,405,7,4,5,5,16,19,-3,17
FC Goa,405,8,5,2,7,11,15,-4,17
Delhi Dynamo,406,1,6,6,2,25,15,10,24
Mumbai City,406,2,6,4,4,16,10,6,22
Kolkata,406,3,5,6,3,16,17,-1,21
Chennaiyin,406,4,5,5,4,16,18,-2,20
FC Pune City,406,5,5,3,6,13,16,-3,18
Kerala Blast,406,6,5,3,6,11,15,-4,18
FC Goa,406,7,4,3,7,15,17,-2,15
NorthEast Un,406,8,4,2,8,9,13,-4,14
Mumbai City,407,1,7,4,3,17,8,9,25
Kolkata,407,2,6,6,2,16,12,4,24
Kerala Blast,407,3,6,3,5,12,14,-2,21
Delhi Dynamo,407,4,4,6,4,23,18,5,18
NorthEast Un,407,5,5,3,6,14,14,0,18
Chennaiyin,407,6,3,6,5,16,21,-5,15
FC Pune City,407,7,4,3,7,12,17,-5,15
FC Goa,407,8,4,3,7,10,16,-6,15
Delhi Dynamo,408,1,6,5,3,29,17,12,23
Mumbai City,408,2,6,4,4,17,12,5,22
Kolkata,408,3,4,7,3,17,16,1,19
Kerala Blast,408,4,5,4,5,14,17,-3,19
FC Pune City,408,5,5,3,6,15,17,-2,18
Chennaiyin,408,6,4,5,5,16,19,-3,17
NorthEast Un,408,7,5,2,7,13,16,-3,17
FC Goa,408,8,5,2,7,11,18,-7,17
Mumbai City,409,1,7,4,3,17,8,9,25
NorthEast Un,409,2,5,4,5,11,9,2,19
FC Pune City,409,3,5,4,5,16,16,0,19
Kolkata,409,4,4,7,3,17,18,-1,19
Delhi Dynamo,409,5,4,6,4,21,16,5,18
FC Goa,409,6,5,2,7,12,15,-3,17
Chennaiyin,409,7,4,5,5,14,19,-5,17
Kerala Blast,409,8,4,4,6,10,17,-7,16
Mumbai City,410,1,7,4,3,20,9,11,25
Kerala Blast,410,2,6,3,5,13,16,-3,21
Delhi Dynamo,410,3,4,6,4,23,20,3,18
Chennaiyin,410,4,4,6,4,16,18,-2,18
Kolkata,410,4,4,6,4,16,18,-2,18
FC Pune City,410,6,5,3,6,14,16,-2,18
FC Goa,410,7,5,2,7,14,18,-4,17
NorthEast Un,410,8,4,4,6,10,11,-1,16
Mumbai City,411,1,7,4,3,19,9,10,25
Delhi Dynamo,411,2,5,6,3,26,20,6,21
Kerala Blast,411,3,5,4,5,14,16,-2,19
Kolkata,411,4,4,6,4,16,18,-2,18
NorthEast Un,411,5,5,3,6,12,14,-2,18
FC Goa,411,6,5,2,7,15,18,-3,17
Chennaiyin,411,7,4,5,5,16,20,-4,17
FC Pune City,411,8,4,4,6,14,17,-3,16
Mumbai City,412,1,7,4,3,19,8,11,25
Delhi Dynamo,412,2,5,5,4,22,18,4,20
Kolkata,412,3,4,7,3,17,15,2,19
Kerala Blast,412,4,5,4,5,13,17,-4,19
FC Pune City,412,5,5,3,6,14,17,-3,18
FC Goa,412,6,5,3,6,11,14,-3,18
NorthEast Un,412,7,4,4,6,11,12,-1,16
Chennaiyin,412,8,3,6,5,13,19,-6,15
Delhi Dynamo,413,1,6,6,2,26,15,11,24
Mumbai City,413,2,6,5,3,17,9,8,23
Kolkata,413,3,4,8,2,16,14,2,20
FC Pune City,413,4,5,4,5,14,14,0,19
NorthEast Un,413,5,5,3,6,12,13,-1,18
Chennaiyin,413,6,4,5,5,14,18,-4,17
Kerala Blast,413,7,4,4,6,12,19,-7,16
FC Goa,413,8,3,3,8,9,18,-9,12
Mumbai City,414,1,7,4,3,19,8,11,25
FC Pune City,414,2,6,3,5,14,14,0,21
Delhi Dynamo,414,3,4,7,3,24,20,4,19
Kolkata,414,4,4,7,3,16,14,2,19
NorthEast Un,414,5,5,3,6,13,12,1,18
Chennaiyin,414,6,4,5,5,16,20,-4,17
FC Goa,414,7,4,4,6,13,18,-5,16
Kerala Blast,414,8,4,3,7,9,18,-9,15
Mumbai City,415,1,7,4,3,20,9,11,25
Kolkata,415,2,6,6,2,20,13,7,24
Chennaiyin,415,3,5,5,4,18,18,0,20
Kerala Blast,415,4,5,4,5,14,19,-5,19
Delhi Dynamo,415,5,4,6,4,23,21,2,18
NorthEast Un,415,6,5,3,6,13,14,-1,18
FC Pune City,415,7,4,3,7,14,20,-6,15
FC Goa,415,8,3,3,8,10,18,-8,12
Mumbai City,416,1,7,4,3,19,8,11,25
Delhi Dynamo,416,2,6,5,3,26,18,8,23
Kolkata,416,3,5,6,3,16,15,1,21
FC Pune City,416,4,5,4,5,16,16,0,19
Chennaiyin,416,5,4,6,4,14,17,-3,18
Kerala Blast,416,6,4,5,5,11,16,-5,17
NorthEast Un,416,7,4,3,7,10,14,-4,15
FC Goa,416,8,3,3,8,9,17,-8,12
Delhi Dynamo,417,1,6,6,2,27,15,12,24
Mumbai City,417,2,6,5,3,16,8,8,23
FC Pune City,417,3,5,4,5,15,15,0,19
Kolkata,417,4,3,9,2,15,14,1,18
NorthEast Un,417,5,5,3,6,13,14,-1,18
Kerala Blast,417,6,4,4,6,10,17,-7,16
Chennaiyin,417,7,3,6,5,14,19,-5,15
FC Goa,417,8,4,3,7,10,18,-8,15
Mumbai City,418,1,7,4,3,18,9,9,25
Kerala Blast,418,2,7,3,4,14,15,-1,24
Delhi Dynamo,418,3,5,5,4,25,20,5,20
NorthEast Un,418,4,6,2,6,14,11,3,20
Kolkata,418,5,3,8,3,14,14,0,17
FC Pune City,418,6,4,4,6,14,17,-3,16
Chennaiyin,418,7,3,6,5,14,19,-5,15
FC Goa,418,8,3,4,7,10,18,-8,13
Mumbai City,419,1,7,4,3,18,8,10,25
Kerala Blast,419,2,6,3,5,12,17,-5,21
Delhi Dynamo,419,3,5,5,4,23,19,4,20
NorthEast Un,419,4,6,2,6,13,11,2,20
Kolkata,419,5,4,6,4,18,17,1,18
FC Pune City,419,6,5,3,6,14,16,-2,18
Chennaiyin,419,7,3,6,5,14,19,-5,15
FC Goa,419,8,4,3,7,13,18,-5,15
Kerala Blast,420,1,7,3,4,16,15,1,24
Mumbai City,420,2,6,4,4,17,10,7,22
Delhi Dynamo,420,3,5,6,3,25,19,6,21
NorthEast Un,420,4,6,2,6,14,11,3,20
FC Pune City,420,5,5,3,6,17,18,-1,18
Chennaiyin,420,6,4,5,5,16,21,-5,17
Kolkata,420,7,3,7,4,17,21,-4,16
FC Goa,420,8,3,4,7,13,20,-7,13
Mumbai City,421,1,7,4,3,20,9,11,25
Delhi Dynamo,421,2,4,7,3,24,20,4,19
Kolkata,421,3,4,7,3,18,17,1,19
FC Pune City,421,4,5,4,5,17,17,0,19
Chennaiyin,421,5,4,6,4,18,18,0,18
NorthEast Un,421,6,5,3,6,11,14,-3,18
FC Goa,421,7,4,4,6,13,17,-4,16
Kerala Blast,421,8,4,3,7,10,19,-9,15
Mumbai City,422,1,6,4,4,16,9,7,22
Delhi Dynamo,422,2,5,6,3,24,19,5,21
Chennaiyin,422,3,5,5,4,17,19,-2,20
FC Pune City,422,4,5,4,5,15,16,-1,19
Kerala Blast,422,5,5,4,5,13,17,-4,19
FC Goa,422,6,5,2,7,15,18,-3,17
Kolkata,422,7,3,7,4,17,18,-1,16
NorthEast Un,422,8,4,4,6,13,14,-1,16
Mumbai City,423,1,6,5,3,17,9,8,23
Kerala Blast,423,2,6,3,5,13,16,-3,21
NorthEast Un,423,3,6,2,6,14,13,1,20
Delhi Dynamo,423,4,4,7,3,24,18,6,19
Kolkata,423,5,4,7,3,18,15,3,19
Chennaiyin,423,6,4,5,5,17,20,-3,17
FC Goa,423,7,4,4,6,12,17,-5,16
FC Pune City,423,8,4,3,7,14,21,-7,15
Delhi Dynamo,424,1,6,5,3,28,17,11,23
Mumbai City,424,2,6,4,4,17,10,7,22
Kerala Blast,424,3,6,4,4,17,16,1,22
NorthEast Un,424,4,6,3,5,15,13,2,21
FC Pune City,424,5,5,3,6,13,18,-5,18
FC Goa,424,6,5,2,7,14,19,-5,17
Kolkata,424,7,3,6,5,14,19,-5,15
Chennaiyin,424,8,3,5,6,15,21,-6,14
Mumbai City,425,1,7,4,3,18,8,10,25
FC Pune City,425,2,6,3,5,16,14,2,21
NorthEast Un,425,3,6,3,5,14,12,2,21
Delhi Dynamo,425,4,5,5,4,23,17,6,20
Kolkata,425,5,4,7,3,15,15,0,19
Kerala Blast,425,6,4,5,5,11,17,-6,17
Chennaiyin,425,7,3,6,5,15,20,-5,15
FC Goa,425,8,3,3,8,10,19,-9,12
Mumbai City,426,1,7,4,3,17,8,9,25
Kerala Blast,426,2,7,3,4,13,13,0,24
Delhi Dynamo,426,3,5,5,4,23,17,6,20
NorthEast Un,426,4,6,2,6,12,11,1,20
Kolkata,426,5,4,6,4,16,15,1,18
FC Goa,426,6,5,2,7,11,16,-5,17
FC Pune City,426,7,4,3,7,12,18,-6,15
Chennaiyin,426,8,3,5,6,13,19,-6,14
Mumbai City,427,1,6,5,3,16,8,8,23
NorthEast Un,427,2,6,3,5,15,9,6,21
Kolkata,427,3,5,6,3,18,14,4,21
Delhi Dynamo,427,4,4,7,3,22,19,3,19
FC Pune City,427,5,5,3,6,15,18,-3,18
Chennaiyin,427,6,4,5,5,17,20,-3,17
Kerala Blast,427,7,4,4,6,10,17,-7,16
FC Goa,427,8,4,3,7,11,19,-8,15
Mumbai City,428,1,6,5,3,17,9,8,23
Delhi Dynamo,428,2,5,6,3,26,20,6,21
Kerala Blast,428,3,6,3,5,15,16,-1,21
NorthEast Un,428,4,6,2,6,14,13,1,20
Kolkata,428,5,4,7,3,21,18,3,19
Chennaiyin,428,6,4,6,4,17,19,-2,18
FC Pune City,428,7,4,3,7,12,20,-8,15
FC Goa,428,8,3,4,7,16,23,-7,13
Mumbai City,429,1,7,4,3,17,8,9,25
NorthEast Un,429,2,6,3,5,12,9,3,21
Kerala Blast,429,3,6,3,5,14,15,-1,21
Delhi Dynamo,429,4,5,5,4,23,17,6,20
Kolkata,429,5,4,7,3,14,15,-1,19
Chennaiyin,429,6,3,7,4,15,19,-4,16
FC Pune City,429,7,4,3,7,12,17,-5,15
FC Goa,429,8,3,4,7,11,18,-7,13
Mumbai City,430,1,6,5,3,18,10,8,23
Delhi Dynamo,430,2,5,6,3,28,21,7,21
NorthEast Un,430,3,6,2,6,15,12,3,20
FC Pune City,430,4,5,4,5,14,15,-1,19
Kerala Blast,430,5,5,4,5,11,15,-4,19
Kolkata,430,6,3,9,2,15,14,1,18
FC Goa,430,7,4,3,7,14,18,-4,15
Chennaiyin,430,8,3,5,6,14,24,-10,14
Kerala Blast,431,1,7,3,4,16,15,1,24
Mumbai City,431,2,6,5,3,17,9,8,23
Delhi Dynamo,431,3,5,7,2,25,17,8,22
Chennaiyin,431,4,4,6,4,17,18,-1,18
Kolkata,431,5,3,7,4,17,19,-2,16
FC Pune City,431,6,4,4,6,13,17,-4,16
FC Goa,431,7,4,4,6,12,17,-5,16
NorthEast Un,431,8,4,2,8,10,15,-5,14
Delhi Dynamo,432,1,6,6,2,28,16,12,24
Mumbai City,432,2,6,5,3,16,8,8,23
Kerala Blast,432,3,6,3,5,14,16,-2,21
Kolkata,432,4,4,8,2,18,15,3,20
FC Pune City,432,5,4,4,6,12,16,-4,16
NorthEast Un,432,6,4,3,7,13,16,-3,15
Chennaiyin,432,7,3,6,5,15,20,-5,15
FC Goa,432,8,4,3,7,13,22,-9,15
Mumbai City,433,1,7,4,3,18,9,9,25
Kerala Blast,433,2,6,4,4,15,16,-1,22
Delhi Dynamo,433,3,5,6,3,23,16,7,21
Kolkata,433,4,4,7,3,18,18,0,19
FC Pune City,433,5,5,3,6,17,17,0,18
NorthEast Un,433,6,5,2,7,11,12,-1,17
Chennaiyin,433,7,4,5,5,15,19,-4,17
FC Goa,433,8,3,3,8,8,18,-10,12
Mumbai City,434,1,7,4,3,18,9,9,25
FC Pune City,434,2,6,3,5,15,15,0,21
Delhi Dynamo,434,3,5,5,4,26,20,6,20
NorthEast Un,434,4,6,2,6,17,14,3,20
Kolkata,434,5,4,6,4,17,17,0,18
Chennaiyin,434,6,4,6,4,18,21,-3,18
FC Goa,434,7,4,3,7,14,21,-7,15
Kerala Blast,434,8,4,3,7,10,18,-8,15
Mumbai City,435,1,7,4,3,18,9,9,25
Delhi Dynamo,435,2,5,6,3,27,17,10,21
Kolkata,435,3,4,8,2,20,16,4,20
Kerala Blast,435,4,5,4,5,13,17,-4,19
NorthEast Un,435,5,5,3,6,13,12,1,18
FC Pune City,435,6,5,3,6,15,19,-4,18
FC Goa,435,7,4,3,7,11,20,-9,15
Chennaiyin,435,8,3,5,6,13,20,-7,14
Mumbai City,436,1,6,4,4,17,10,7,22
Kerala Blast,436,2,6,4,4,11,13,-2,22
Delhi Dynamo,436,3,5,6,3,28,21,7,21
NorthEast Un,436,4,6,2,6,14,13,1,20
FC Pune City,436,5,5,4,5,13,14,-1,19
Chennaiyin,436,6,4,5,5,17,21,-4,17
Kolkata,436,7,3,6,5,13,16,-3,15
FC Goa,436,8,4,3,7,15,20,-5,15
Mumbai City,437,1,6,5,3,17,9,8,23
Delhi Dynamo,437,2,5,7,2,23,15,8,22
Kerala Blast,437,3,6,3,5,13,15,-2,21
Kolkata,437,4,4,7,3,14,13,1,19
FC Goa,437,5,5,2,7,10,15,-5,17
NorthEast Un,437,6,4,4,6,10,12,-2,16
FC Pune City,437,7,4,4,6,13,16,-3,16
Chennaiyin,437,8,3,6,5,14,19,-5,15
Delhi Dynamo,438,1,6,6,2,26,16,10,24
Mumbai City,438,2,6,5,3,18,10,8,23
Kerala Blast,438,3,6,4,4,12,13,-1,22
FC Pune City,438,4,5,4,5,14,14,0,19
NorthEast Un,438,5,5,2,7,10,13,-3,17
FC Goa,438,6,5,2,7,11,15,-4,17
Kolkata,438,7,3,6,5,13,17,-4,15
Chennaiyin,438,8,3,5,6,13,19,-6,14
Mumbai City,439,1,7,4,3,18,9,9,25
Delhi Dynamo,439,2,6,5,3,25,16,9,23
NorthEast Un,439,3,6,2,6,11,11,0,20
Kolkata,439,4,4,7,3,15,14,1,19
Kerala Blast,439,5,4,5,5,11,16,-5,17
FC Pune City,439,6,4,4,6,13,16,-3,16
Chennaiyin,439,7,3,6,5,15,20,-5,15
FC Goa,439,8,4,3,7,11,17,-6,15
Mumbai City,440,1,7,4,3,18,8,10,25
Kolkata,440,2,6,6,2,18,12,6,24
Delhi Dynamo,440,3,5,5,4,24,19,5,20
NorthEast Un,440,4,5,4,5,13,11,2,19
Kerala Blast,440,5,5,4,5,15,16,-1,19
Chennaiyin,440,6,3,6,5,17,22,-5,15
FC Pune City,440,7,4,3,7,12,20,-8,15
FC Goa,440,8,4,2,8,13,22,-9,14
Mumbai City,441,1,7,4,3,18,8,10,25
Kerala Blast,441,2,5,5,4,11,14,-3,20
Kolkata,441,3,4,7,3,17,14,3,19
Delhi Dynamo,441,4,4,6,4,22,18,4,18
FC Goa,441,5,5,3,6,13,17,-4,18
NorthEast Un,441,6,4,5,5,11,11,0,17
FC Pune City,441,7,4,4,6,12,17,-5,16
Chennaiyin,441,8,3,6,5,15,20,-5,15
Mumbai City,442,1,6,5,3,16,8,8,23
Delhi Dynamo,442,2,5,6,3,24,17,7,21
Kolkata,442,3,5,6,3,17,14,3,21
Kerala Blast,442,4,5,4,5,12,15,-3,19
Chennaiyin,442,5,4,6,4,17,19,-2,18
FC Goa,442,6,5,2,7,12,18,-6,17
FC Pune City,442,7,4,4,6,13,17,-4,16
NorthEast Un,442,8,4,3,7,12,15,-3,15
Mumbai City,443,1,6,5,3,17,9,8,23
Kolkata,443,2,5,7,2,16,13,3,22
Delhi Dynamo,443,3,5,6,3,26,18,8,21
NorthEast Un,443,4,6,3,5,13,11,2,21
FC Pune City,443,5,5,3,6,14,16,-2,18
Chennaiyin,443,6,4,5,5,14,18,-4,17
Kerala Blast,443,7,4,4,6,9,15,-6,16
FC Goa,443,8,3,3,8,8,17,-9,12
Delhi Dynamo,444,1,6,5,3,25,17,8,23
Mumbai City,444,2,6,4,4,16,9,7,22
FC Pune City,444,3,6,3,5,17,15,2,21
Kerala Blast,444,4,5,4,5,12,16,-4,19
NorthEast Un,444,5,5,3,6,12,11,1,18
Kolkata,444,6,4,6,4,16,18,-2,18
Chennaiyin,444,7,4,6,4,16,19,-3,18
FC Goa,444,8,3,3,8,11,20,-9,12
Kolkata,445,1,5,7,2,18,13,5,22
Mumbai City,445,2,6,4,4,16,12,4,22
Delhi Dynamo,445,3,5,6,3,27,18,9,21
NorthEast Un,445,4,6,2,6,16,15,1,20
FC Pune City,445,5,5,3,6,13,17,-4,18
Chennaiyin,445,6,4,5,5,17,20,-3,17
FC Goa,445,7,4,4,6,11,16,-5,16
Kerala Blast,445,8,4,3,7,10,17,-7,15
Delhi Dynamo,446,1,6,6,2,26,17,9,24
Mumbai City,446,2,6,5,3,17,9,8,23
Kolkata,446,3,4,7,3,17,16,1,19
Kerala Blast,446,4,5,4,5,11,18,-7,19
NorthEast Un,446,5,5,3,6,13,10,3,18
Chennaiyin,446,6,4,6,4,14,17,-3,18
FC Pune City,446,7,4,3,7,15,19,-4,15
FC Goa,446,8,4,2,8,12,19,-7,14
Delhi Dynamo,447,1,6,6,2,25,15,10,24
Kolkata,447,2,6,6,2,19,14,5,24
Mumbai City,447,3,6,4,4,16,10,6,22
Chennaiyin,447,4,4,6,4,18,19,-1,18
Kerala Blast,447,5,4,5,5,11,16,-5,17
NorthEast Un,447,6,4,4,6,12,15,-3,16
FC Pune City,447,7,4,4,6,13,17,-4,16
FC Goa,447,8,3,3,8,9,17,-8,12
Mumbai City,448,1,6,5,3,16,8,8,23
Kerala Blast,448,2,6,3,5,12,15,-3,21
NorthEast Un,448,3,6,2,6,14,13,1,20
Kolkata,448,4,4,7,3,15,14,1,19
Delhi Dynamo,448,5,4,6,4,24,19,5,18
FC Pune City,448,6,5,3,6,13,15,-2,18
FC Goa,448,7,4,4,6,11,16,-5,16
Chennaiyin,448,8,3,6,5,13,18,-5,15
Mumbai City,449,1,7,4,3,17,8,9,25
Delhi Dynamo,449,2,6,5,3,25,16,9,23
Kerala Blast,449,3,5,5,4,12,15,-3,20
Kolkata,449,4,3,9,2,14,13,1,18
FC Pune City,449,5,4,5,5,13,15,-2,17
NorthEast Un,449,6,4,3,7,10,12,-2,15
FC Goa,449,7,4,3,7,13,17,-4,15
Chennaiyin,449,8,3,6,5,14,22,-8,15
Mumbai City,450,1,7,4,3,19,9,10,25
FC Pune City,450,2,6,3,5,18,15,3,21
Delhi Dynamo,450,3,4,6,4,24,20,4,18
Chennaiyin,450,4,4,6,4,17,18,-1,18
NorthEast Un,450,5,5,3,6,11,13,-2,18
Kerala Blast,450,6,5,3,6,12,17,-5,18
Kolkata,450,7,3,7,4,15,19,-4,16
FC Goa,450,8,4,4,6,12,17,-5,16
Mumbai City,451,1,6,5,3,17,9,8,23
FC Pune City,451,2,6,3,5,16,16,0,21
Delhi Dynamo,451,3,4,7,3,24,18,6,19
Kerala Blast,451,4,5,4,5,12,16,-4,19
Kolkata,451,5,3,8,3,16,16,0,17
NorthEast Un,451,6,5,2,7,11,12,-1,17
Chennaiyin,451,7,4,5,5,16,21,-5,17
FC Goa,451,8,4,4,6,14,18,-4,16
Delhi Dynamo,452,1,6,5,3,27,20,7,23
Mumbai City,452,2,6,4,4,18,11,7,22
NorthEast Un,452,3,6,3,5,13,10,3,21
Kolkata,452,4,4,7,3,15,14,1,19
Chennaiyin,452,5,4,6,4,16,19,-3,18
Kerala Blast,452,6,4,5,5,11,16,-5,17
FC Pune City,452,7,4,4,6,13,16,-3,16
FC Goa,452,8,4,2,8,12,19,-7,14
Mumbai City,453,1,6,5,3,17,9,8,23
NorthEast Un,453,2,7,2,5,13,10,3,23
FC Pune City,453,3,5,4,5,14,15,-1,19
Kerala Blast,453,4,5,4,5,12,16,-4,19
Delhi Dynamo,453,5,4,6,4,22,17,5,18
Kolkata,453,6,4,6,4,16,15,1,18
FC Goa,453,7,5,2,7,11,16,-5,17
Chennaiyin,453,8,3,5,6,14,21,-7,14
Mumbai City,454,1,6,5,3,17,9,8,23
Delhi Dynamo,454,2,5,6,3,24,17,7,21
Kolkata,454,3,5,6,3,19,14,5,21
NorthEast Un,454,4,6,2,6,12,11,1,20
FC Pune City,454,5,5,3,6,14,15,-1,18
Kerala Blast,454,6,5,3,6,10,16,-6,18
FC Goa,454,7,5,2,7,10,18,-8,17
Chennaiyin,454,8,3,5,6,13,19,-6,14
Mumbai City,455,1,6,5,3,17,9,8,23
Kolkata,455,2,5,7,2,18,14,4,22
Delhi Dynamo,455,3,5,6,3,25,18,7,21
NorthEast Un,455,4,5,3,6,15,14,1,18
FC Pune City,455,5,5,3,6,14,17,-3,18
Kerala Blast,455,6,5,3,6,13,17,-4,18
Chennaiyin,455,7,3,6,5,15,21,-6,15
FC Goa,455,8,4,3,7,10,17,-7,15
Mumbai City,456,1,7,4,3,18,8,10,25
NorthEast Un,456,2,6,3,5,12,10,2,21
Delhi Dynamo,456,3,5,5,4,22,17,5,20
Kolkata,456,4,4,8,2,18,16,2,20
Kerala Blast,456,5,4,6,4,13,17,-4,18
Chennaiyin,456,6,4,5,5,16,20,-4,17
FC Pune City,456,7,4,4,6,15,18,-3,16
FC Goa,456,8,3,3,8,10,18,-8,12
Mumbai City,457,1,6,5,3,17,9,8,23
NorthEast Un,457,2,6,3,5,16,12,4,21
Kerala Blast,457,3,6,3,5,13,17,-4,21
Delhi Dynamo,457,4,4,6,4,23,21,2,18
Kolkata,457,5,4,6,4,17,17,0,18
Chennaiyin,457,6,4,6,4,16,18,-2,18
FC Goa,457,7,5,2,7,13,17,-4,17
FC Pune City,457,8,4,3,7,15,19,-4,15
Mumbai City,458,1,6,4,4,17,10,7,22
Kolkata,458,2,5,7,2,16,13,3,22
Delhi Dynamo,458,3,5,6,3,25,18,7,21
NorthEast Un,458,4,6,3,5,14,12,2,21
Kerala Blast,458,5,5,5,4,12,14,-2,20
Chennaiyin,458,6,4,5,5,18,21,-3,17
FC Pune City,458,7,4,3,7,13,18,-5,15
FC Goa,458,8,3,3,8,11,20,-9,12
Mumbai City,459,1,7,4,3,17,8,9,25
Kolkata,459,2,6,6,2,22,14,8,24
NorthEast Un,459,3,5,4,5,13,10,3,19
Kerala Blast,459,4,5,4,5,11,16,-5,19
Delhi Dynamo,459,5,4,6,4,22,17,5,18
FC Pune City,459,6,4,3,7,12,17,-5,15
Chennaiyin,459,7,3,6,5,13,20,-7,15
FC Goa,459,8,4,3,7,11,19,-8,15
Mumbai City,460,1,7,4,3,19,9,10,25
Kolkata,460,2,5,7,2,19,13,6,22
Delhi Dynamo,460,3,5,5,4,26,21,5,20
FC Pune City,460,4,5,4,5,14,15,-1,19
FC Goa,460,5,5,2,7,14,18,-4,17
Chennaiyin,460,6,4,5,5,14,19,-5,17
Kerala Blast,460,7,4,4,6,9,18,-9,16
NorthEast Un,460,8,4,3,7,9,11,-2,15
Kolkata,461,1,6,6,2,17,12,5,24
Delhi Dynamo,461,2,6,5,3,27,18,9,23
Mumbai City,461,3,6,4,4,19,12,7,22
NorthEast Un,461,4,6,2,6,13,12,1,20
Chennaiyin,461,5,4,6,4,16,19,-3,18
Kerala Blast,461,6,5,3,6,10,16,-6,18
FC Pune City,461,7,4,3,7,12,16,-4,15
FC Goa,461,8,3,3,8,8,17,-9,12
Mumbai City,462,1,7,4,3,18,8,10,25
Delhi Dynamo,462,2,5,6,3,24,18,6,21
FC Pune City,462,3,6,3,5,15,15,0,21
Kolkata,462,4,4,7,3,19,16,3,19
Chennaiyin,462,5,4,6,4,15,18,-3,18
Kerala Blast,462,6,5,3,6,11,18,-7,18
NorthEast Un,462,7,4,3,7,11,13,-2,15
FC Goa,462,8,3,4,7,12,19,-7,13
Mumbai City,463,1,7,4,3,19,8,11,25
Delhi Dynamo,463,2,6,5,3,26,17,9,23
Kolkata,463,3,5,6,3,18,13,5,21
Kerala Blast,463,4,6,3,5,11,14,-3,21
Chennaiyin,463,5,4,5,5,16,19,-3,17
NorthEast Un,463,6,5,2,7,10,14,-4,17
FC Pune City,463,7,4,3,7,12,19,-7,15
FC Goa,463,8,4,2,8,10,18,-8,14
Delhi Dynamo,464,1,6,6,2,25,15,10,24
Mumbai City,464,2,6,4,4,17,10,7,22
Kolkata,464,3,4,7,3,16,15,1,19
FC Goa,464,4,5,3,6,13,15,-2,18
Kerala Blast,464,5,5,3,6,12,18,-6,18
NorthEast Un,464,6,5,2,7,12,14,-2,17
Chennaiyin,464,7,4,5,5,15,20,-5,17
FC Pune City,464,8,4,4,6,12,15,-3,16
Mumbai City,465,1,7,4,3,17,8,9,25
Kerala Blast,465,2,6,4,4,14,16,-2,22
Delhi Dynamo,465,3,5,6,3,25,16,9,21
Kolkata,465,4,5,6,3,17,14,3,21
Chennaiyin,465,5,4,6,4,19,20,-1,18
FC Pune City,465,6,4,4,6,12,16,-4,16
NorthEast Un,465,7,4,3,7,12,16,-4,15
FC Goa,465,8,3,3,8,11,21,-10,12
Mumbai City,466,1,7,4,3,20,9,11,25
Kolkata,466,2,5,6,3,15,13,2,21
FC Pune City,466,3,6,3,5,17,16,1,21
Delhi Dynamo,466,4,5,5,4,24,19,5,20
NorthEast Un,466,5,6,2,6,13,12,1,20
Chennaiyin,466,6,4,5,5,15,20,-5,17
Kerala Blast,466,7,4,3,7,11,19,-8,15
FC Goa,466,8,4,2,8,9,16,-7,14
Delhi Dynamo,467,1,6,5,3,25,16,9,23
Mumbai City,467,2,6,4,4,16,11,5,22
Kerala Blast,467,3,6,3,5,13,16,-3,21
NorthEast Un,467,4,6,2,6,15,13,2,20
Kolkata,467,5,4,7,3,17,18,-1,19
FC Pune City,467,6,5,3,6,16,16,0,18
Chennaiyin,467,7,3,6,5,16,21,-5,15
FC Goa,467,8,3,4,7,10,17,-7,13
Mumbai City,468,1,7,4,3,17,8,9,25
NorthEast Un,468,2,6,3,5,15,10,5,21
Kolkata,468,3,4,7,3,16,17,-1,19
FC Pune City,468,4,5,3,6,16,16,0,18
Kerala Blast,468,5,5,3,6,11,19,-8,18
Delhi Dynamo,468,6,4,5,5,22,18,4,17
Chennaiyin,468,7,3,7,4,14,18,-4,16
FC Goa,468,8,4,4,6,12,17,-5,16
Mumbai City,469,1,6,5,3,17,9,8,23
Delhi Dynamo,469,2,5,7,2,23,15,8,22
Kerala Blast,469,3,6,4,4,12,13,-1,22
Kolkata,469,4,4,8,2,15,13,2,20
Chennaiyin,469,5,5,5,4,18,18,0,20
FC Pune City,469,6,4,3,7,13,17,-4,15
NorthEast Un,469,7,4,3,7,9,14,-5,15
FC Goa,469,8,3,3,8,9,17,-8,12
Mumbai City,470,1,7,4,3,18,9,9,25
FC Pune City,470,2,6,3,5,17,14,3,21
Delhi Dynamo,470,3,4,6,4,23,20,3,18
Chennaiyin,470,4,4,6,4,17,18,-1,18
Kolkata,470,5,4,6,4,16,17,-1,18
Kerala Blast,470,6,5,3,6,12,19,-7,18
NorthEast Un,470,7,5,2,7,12,14,-2,17
FC Goa,470,8,4,4,6,13,17,-4,16
Delhi Dynamo,471,1,6,6,2,27,18,9,24
Mumbai City,471,2,6,4,4,18,11,7,22
NorthEast Un,471,3,5,4,5,14,12,2,19
Kolkata,471,4,4,7,3,16,15,1,19
Kerala Blast,471,5,4,6,4,12,16,-4,18
FC Pune City,471,6,4,4,6,13,16,-3,16
Chennaiyin,471,7,3,6,5,13,19,-6,15
FC Goa,471,8,4,3,7,10,16,-6,15
Mumbai City,472,1,7,4,3,17,8,9,25
Kolkata,472,2,5,6,3,17,14,3,21
NorthEast Un,472,3,6,3,5,12,10,2,21
Delhi Dynamo,472,4,5,5,4,25,18,7,20
FC Pune City,472,5,5,3,6,13,15,-2,18
Kerala Blast,472,6,5,3,6,10,15,-5,18
Chennaiyin,472,7,3,7,4,14,18,-4,16
FC Goa,472,8,3,3,8,11,21,-10,12
Mumbai City,473,1,7,4,3,18,9,9,25
Kerala Blast,473,2,7,3,4,16,15,1,24
Delhi Dynamo,473,3,5,6,3,26,18,8,21
Kolkata,473,4,4,7,3,18,17,1,19
NorthEast Un,473,5,5,3,6,11,12,-1,18
Chennaiyin,473,6,4,5,5,15,19,-4,17
FC Pune City,473,7,4,3,7,12,17,-5,15
FC Goa,473,8,3,3,8,11,20,-9,12
Mumbai City,474,1,6,5,3,18,10,8,23
Kerala Blast,474,2,6,3,5,15,16,-1,21
NorthEast Un,474,3,6,2,6,13,12,1,20
Delhi Dynamo,474,4,4,7,3,25,19,6,19
FC Pune City,474,5,5,3,6,14,16,-2,18
Chennaiyin,474,6,4,5,5,14,19,-5,17
Kolkata,474,7,3,7,4,16,19,-3,16
FC Goa,474,8,4,4,6,13,17,-4,16
Mumbai City,475,1,7,4,3,17,8,9,25
Delhi Dynamo,475,2,5,6,3,25,16,9,21
Kerala Blast,475,3,5,5,4,13,15,-2,20
FC Pune City,475,4,5,4,5,14,15,-1,19
NorthEast Un,475,5,4,5,5,11,11,0,17
FC Goa,475,6,5,2,7,12,17,-5,17
Kolkata,475,7,3,6,5,16,20,-4,15
Chennaiyin,475,8,3,6,5,14,20,-6,15
Mumbai City,476,1,6,5,3,16,8,8,23
Delhi Dynamo,476,2,5,6,3,22,15,7,21
Kolkata,476,3,5,6,3,16,16,0,21
NorthEast Un,476,4,6,2,6,14,13,1,20
FC Goa,476,5,6,2,6,16,16,0,20
FC Pune City,476,6,5,3,6,14,16,-2,18
Kerala Blast,476,7,4,3,7,11,18,-7,15
Chennaiyin,476,8,3,5,6,16,23,-7,14
Kerala Blast,477,1,7,3,4,18,17,1,24
Mumbai City,477,2,6,5,3,18,10,8,23
Kolkata,477,3,4,7,3,18,17,1,19
Delhi Dynamo,477,4,4,6,4,23,19,4,18
FC Goa,477,5,5,3,6,12,16,-4,18
NorthEast Un,477,6,5,2,7,12,13,-1,17
Chennaiyin,477,7,4,5,5,15,19,-4,17
FC Pune City,477,8,4,3,7,14,19,-5,15
Mumbai City,478,1,6,4,4,16,9,7,22
Kolkata,478,2,5,7,2,16,13,3,22
Delhi Dynamo,478,3,5,6,3,23,16,7,21
NorthEast Un,478,4,5,3,6,13,13,0,18
Chennaiyin,478,5,4,5,5,15,19,-4,17
Kerala Blast,478,6,4,5,5,11,16,-5,17
FC Pune City,478,7,4,4,6,12,15,-3,16
FC Goa,478,8,4,4,6,11,16,-5,16
Delhi Dynamo,479,1,6,6,2,25,16,9,24
Mumbai City,479,2,6,5,3,16,8,8,23
Kerala Blast,479,3,6,3,5,13,17,-4,21
Chennaiyin,479,4,5,5,4,16,17,-1,20
Kolkata,479,5,4,7,3,16,15,1,19
FC Pune City,479,6,5,3,6,15,16,-1,18
NorthEast Un,479,7,4,2,8,11,15,-4,14
FC Goa,479,8,3,3,8,10,18,-8,12
Mumbai City,480,1,7,4,3,19,10,9,25
Delhi Dynamo,480,2,5,6,3,27,18,9,21
Kolkata,480,3,4,7,3,17,15,2,19
Kerala Blast,480,4,5,4,5,11,16,-5,19
FC Pune City,480,5,4,5,5,13,15,-2,17
FC Goa,480,6,5,2,7,12,17,-5,17
NorthEast Un,480,7,4,4,6,11,13,-2,16
Chennaiyin,480,8,3,6,5,14,20,-6,15
Delhi Dynamo,481,1,7,5,2,29,14,15,26
Kolkata,481,2,6,6,2,21,14,7,24
Mumbai City,481,3,6,4,4,16,10,6,22
Chennaiyin,481,4,5,5,4,21,19,2,20
Kerala Blast,481,5,5,4,5,10,15,-5,19
FC Pune City,481,6,4,4,6,12,17,-5,16
NorthEast Un,481,7,4,2,8,10,16,-6,14
FC Goa,481,8,3,2,9,11,25,-14,11
Mumbai City,482,1,7,4,3,17,8,9,25
Delhi Dynamo,482,2,6,5,3,24,15,9,23
Kolkata,482,3,5,6,3,18,16,2,21
FC Goa,482,4,5,2,7,13,18,-5,17
Kerala Blast,482,4,4,5,5,13,18,-5,17
NorthEast Un,482,6,4,4,6,12,13,-1,16
FC Pune City,482,7,4,4,6,13,17,-4,16
Chennaiyin,482,8,3,6,5,15,20,-5,15
Mumbai City,483,1,7,4,3,18,8,10,25
Delhi Dynamo,483,2,6,5,3,26,18,8,23
FC Pune City,483,3,5,4,5,17,17,0,19
Kerala Blast,483,4,5,4,5,13,17,-4,19
Chennaiyin,483,5,4,6,4,19,19,0,18
Kolkata,483,6,3,7,4,15,18,-3,16
FC Goa,483,7,4,3,7,12,17,-5,15
NorthEast Un,483,8,4,3,7,12,18,-6,15
Mumbai City,484,1,6,4,4,16,10,6,22
Kerala Blast,484,2,6,3,5,12,19,-7,21
Delhi Dynamo,484,3,5,5,4,24,17,7,20
FC Pune City,484,4,5,3,6,17,16,1,18
Kolkata,484,5,4,6,4,16,15,1,18
NorthEast Un,484,6,5,3,6,11,11,0,18
Chennaiyin,484,7,4,6,4,15,17,-2,18
FC Goa,484,8,5,2,7,10,16,-6,17
Mumbai City,485,1,6,5,3,17,9,8,23
Kolkata,485,2,5,6,3,18,16,2,21
NorthEast Un,485,3,6,2,6,15,12,3,20
FC Goa,485,4,6,2,6,15,16,-1,20
Delhi Dynamo,485,5,4,6,4,23,18,5,18
Chennaiyin,485,6,4,5,5,17,20,-3,17
FC Pune City,485,7,4,4,6,14,18,-4,16
Kerala Blast,485,8,4,4,6,10,20,-10,16
Kerala Blast,486,1,7,3,4,14,14,0,24
Mumbai City,486,2,6,5,3,18,10,8,23
Delhi Dynamo,486,3,4,8,2,25,18,7,20
FC Pune City,486,4,5,3,6,16,18,-2,18
Chennaiyin,486,5,4,6,4,15,18,-3,18
Kolkata,486,6,3,7,4,18,19,-1,16
NorthEast Un,486,7,4,4,6,11,13,-2,16
FC Goa,486,8,3,4,7,12,19,-7,13
Delhi Dynamo,487,1,6,5,3,24,19,5,23
Mumbai City,487,2,6,4,4,16,9,7,22
Kolkata,487,3,5,6,3,15,13,2,21
FC Goa,487,4,5,3,6,17,18,-1,18
FC Pune City,487,5,5,3,6,13,15,-2,18
Kerala Blast,487,6,5,3,6,10,15,-5,18
Chennaiyin,487,7,3,7,4,16,20,-4,16
NorthEast Un,487,8,4,3,7,9,11,-2,15
Mumbai City,488,1,7,4,3,18,9,9,25
Kolkata,488,2,6,6,2,20,13,7,24
Delhi Dynamo,488,3,6,5,3,28,19,9,23
FC Pune City,488,4,5,3,6,13,17,-4,18
Kerala Blast,488,5,5,3,6,12,17,-5,18
NorthEast Un,488,6,5,2,7,14,15,-1,17
Chennaiyin,488,7,4,5,5,14,18,-4,17
FC Goa,488,8,3,2,9,8,19,-11,11
Mumbai City,489,1,6,5,3,17,9,8,23
Delhi Dynamo,489,2,5,7,2,25,16,9,22
Kolkata,489,3,4,7,3,17,15,2,19
Kerala Blast,489,4,5,4,5,14,16,-2,19
FC Pune City,489,5,5,3,6,14,18,-4,18
Chennaiyin,489,6,4,5,5,15,19,-4,17
FC Goa,489,7,5,2,7,12,17,-5,17
NorthEast Un,489,8,4,3,7,10,14,-4,15
Kolkata,490,1,6,6,2,21,13,8,24
Mumbai City,490,2,6,5,3,17,9,8,23
Kerala Blast,490,3,5,4,5,12,19,-7,19
Delhi Dynamo,490,4,4,6,4,22,18,4,18
Chennaiyin,490,5,4,6,4,16,18,-2,18
NorthEast Un,490,6,5,2,7,11,13,-2,17
FC Pune City,490,7,4,4,6,13,16,-3,16
FC Goa,490,8,4,3,7,11,17,-6,15
Mumbai City,491,1,7,4,3,18,8,10,25
Kerala Blast,491,2,6,4,4,13,14,-1,22
Delhi Dynamo,491,3,5,5,4,24,18,6,20
NorthEast Un,491,4,5,3,6,11,12,-1,18
Chennaiyin,491,5,4,6,4,14,17,-3,18
Kolkata,491,6,3,8,3,15,15,0,17
FC Pune City,491,7,4,5,5,14,16,-2,17
FC Goa,491,8,3,3,8,9,18,-9,12
Mumbai City,492,1,7,4,3,19,9,10,25
Kolkata,492,2,5,6,3,19,16,3,21
Kerala Blast,492,3,5,4,5,11,14,-3,19
Delhi Dynamo,492,4,4,6,4,23,19,4,18
NorthEast Un,492,5,5,3,6,12,12,0,18
FC Goa,492,6,5,2,7,12,16,-4,17
Chennaiyin,492,7,4,5,5,15,20,-5,17
FC Pune City,492,8,4,4,6,14,19,-5,16
Delhi Dynamo,493,1,6,6,2,26,14,12,24
Mumbai City,493,2,6,5,3,16,8,8,23
Kolkata,493,3,4,8,2,20,15,5,20
NorthEast Un,493,4,5,3,6,12,13,-1,18
Kerala Blast,493,5,4,6,4,10,14,-4,18
FC Pune City,493,6,4,5,5,14,16,-2,17
Chennaiyin,493,7,4,5,5,15,19,-4,17
FC Goa,493,8,3,2,9,9,23,-14,11
Mumbai City,494,1,7,4,3,18,9,9,25
Delhi Dynamo,494,2,6,5,3,26,18,8,23
Kolkata,494,3,4,7,3,17,15,2,19
Chennaiyin,494,4,4,6,4,15,18,-3,18
NorthEast Un,494,5,5,2,7,11,12,-1,17
FC Pune City,494,6,4,5,5,14,16,-2,17
Kerala Blast,494,7,4,4,6,10,17,-7,16
FC Goa,494,8,4,3,7,12,18,-6,15
Mumbai City,495,1,7,4,3,17,8,9,25
Delhi Dynamo,495,2,5,5,4,23,18,5,20
Kolkata,495,3,4,8,2,16,14,2,20
FC Pune City,495,4,5,4,5,16,17,-1,19
FC Goa,495,5,5,3,6,12,15,-3,18
Kerala Blast,495,6,5,3,6,11,16,-5,18
Chennaiyin,495,7,4,5,5,15,18,-3,17
NorthEast Un,495,8,4,2,8,9,13,-4,14
Mumbai City,496,1,7,4,3,18,8,10,25
Delhi Dynamo,496,2,5,5,4,25,19,6,20
NorthEast Un,496,3,6,2,6,13,12,1,20
Kolkata,496,4,4,7,3,16,17,-1,19
Kerala Blast,496,5,5,4,5,13,18,-5,19
FC Pune City,496,6,4,5,5,14,16,-2,17
FC Goa,496,7,5,2,7,13,16,-3,17
Chennaiyin,496,8,3,5,6,13,19,-6,14
Mumbai City,497,1,7,4,3,19,9,10,25
Delhi Dynamo,497,2,5,5,4,23,19,4,20
Kerala Blast,497,3,5,5,4,14,17,-3,20
NorthEast Un,497,4,5,2,7,13,13,0,17
Kolkata,497,5,3,8,3,15,17,-2,17
FC Pune City,497,6,4,5,5,12,14,-2,17
FC Goa,497,7,5,2,7,12,15,-3,17
Chennaiyin,497,8,4,5,5,14,18,-4,17
Mumbai City,498,1,7,4,3,17,8,9,25
FC Goa,498,2,6,2,6,14,15,-1,20
Kolkata,498,3,4,7,3,17,14,3,19
Delhi Dynamo,498,4,4,6,4,23,20,3,18
FC Pune City,498,5,5,3,6,16,18,-2,18
Chennaiyin,498,6,4,5,5,15,19,-4,17
Kerala Blast,498,7,4,5,5,12,19,-7,17
NorthEast Un,498,8,4,4,6,12,13,-1,16
Delhi Dynamo,499,1,6,6,2,30,17,13,24
Mumbai City,499,2,6,5,3,18,10,8,23
Kolkata,499,3,5,6,3,18,16,2,21
FC Pune City,499,4,6,3,5,15,15,0,21
Kerala Blast,499,5,5,3,6,14,18,-4,18
NorthEast Un,499,6,5,2,7,12,16,-4,17
Chennaiyin,499,7,3,5,6,14,21,-7,14
FC Goa,499,8,4,2,8,11,19,-8,14
Mumbai City,500,1,6,5,3,17,9,8,23
Kolkata,500,2,5,6,3,17,19,-2,21
Delhi Dynamo,500,3,4,8,2,25,18,7,20
FC Goa,500,4,5,3,6,19,16,3,18
NorthEast Un,500,5,5,3,6,12,12,0,18
Chennaiyin,500,6,4,5,5,15,21,-6,17
FC Pune City,500,7,4,4,6,13,16,-3,16
Kerala Blast,500,8,4,4,6,12,19,-7,16
Mumbai City,501,1,7,4,3,18,9,9,25
Delhi Dynamo,501,2,4,7,3,23,17,6,19
Kerala Blast,501,3,5,4,5,11,15,-4,19
NorthEast Un,501,4,5,3,6,11,12,-1,18
FC Goa,501,5,5,3,6,14,16,-2,18
FC Pune City,501,6,4,5,5,14,16,-2,17
Chennaiyin,501,7,4,5,5,16,20,-4,17
Kolkata,501,8,3,7,4,15,17,-2,16
Mumbai City,502,1,6,5,3,16,8,8,23
Delhi Dynamo,502,2,5,6,3,22,17,5,21
Kerala Blast,502,3,6,3,5,16,16,0,21
NorthEast Un,502,4,6,2,6,13,14,-1,20
Kolkata,502,5,4,7,3,18,16,2,19
FC Pune City,502,6,5,3,6,14,16,-2,18
Chennaiyin,502,7,4,5,5,14,18,-4,17
FC Goa,502,8,3,3,8,10,18,-8,12
Mumbai City,503,1,6,5,3,16,8,8,23
Delhi Dynamo,503,2,5,7,2,24,15,9,22
FC Pune City,503,3,6,3,5,16,16,0,21
Kerala Blast,503,4,5,4,5,13,17,-4,19
NorthEast Un,503,5,5,3,6,13,13,0,18
Chennaiyin,503,6,4,5,5,17,19,-2,17
Kolkata,503,7,3,7,4,16,18,-2,16
FC Goa,503,8,4,2,8,11,20,-9,14
Mumbai City,504,1,7,4,3,17,8,9,25
Kerala Blast,504,2,7,3,4,15,15,0,24
Delhi Dynamo,504,3,5,5,4,23,18,5,20
NorthEast Un,504,4,5,3,6,13,12,1,18
FC Goa,504,5,5,2,7,12,17,-5,17
Kolkata,504,6,3,7,4,14,16,-2,16
FC Pune City,504,7,4,4,6,14,17,-3,16
Chennaiyin,504,8,3,6,5,15,20,-5,15
Mumbai City,505,1,7,4,3,21,9,12,25
FC Pune City,505,2,6,3,5,15,15,0,21
Delhi Dynamo,505,3,5,5,4,23,20,3,20
Chennaiyin,505,4,5,5,4,19,18,1,20
Kolkata,505,5,4,7,3,17,16,1,19
Kerala Blast,505,6,4,4,6,12,18,-6,16
NorthEast Un,505,7,4,3,7,11,15,-4,15
FC Goa,505,8,4,3,7,11,18,-7,15
Mumbai City,506,1,7,4,3,18,8,10,25
Delhi Dynamo,506,2,6,5,3,25,17,8,23
Kolkata,506,3,4,7,3,17,16,1,19
NorthEast Un,506,4,5,3,6,13,13,0,18
Kerala Blast,506,5,5,3,6,13,17,-4,18
FC Goa,506,6,5,2,7,12,17,-5,17
FC Pune City,506,7,4,4,6,14,19,-5,16
Chennaiyin,506,8,3,6,5,14,19,-5,15
Mumbai City,507,1,6,5,3,18,10,8,23
Delhi Dynamo,507,2,4,8,2,24,17,7,20
Kolkata,507,3,4,7,3,18,16,2,19
Kerala Blast,507,4,5,4,5,13,18,-5,19
NorthEast Un,507,5,5,3,6,13,13,0,18
FC Pune City,507,6,5,3,6,15,18,-3,18
Chennaiyin,507,7,4,5,5,16,20,-4,17
FC Goa,507,8,4,3,7,12,17,-5,15
Mumbai City,508,1,7,4,3,17,8,9,25
Kerala Blast,508,2,6,4,4,13,15,-2,22
NorthEast Un,508,3,6,2,6,14,11,3,20
Delhi Dynamo,508,4,4,6,4,21,17,4,18
Kolkata,508,5,3,8,3,14,14,0,17
FC Pune City,508,6,4,4,6,14,17,-3,16
FC Goa,508,7,4,4,6,10,15,-5,16
Chennaiyin,508,8,3,6,5,14,20,-6,15
Mumbai City,509,1,7,4,3,18,9,9,25
Delhi Dynamo,509,2,5,6,3,24,17,7,21
FC Pune City,509,3,6,3,5,17,14,3,21
NorthEast Un,509,4,5,3,6,13,13,0,18
FC Goa,509,5,5,3,6,10,14,-4,18
Kerala Blast,509,6,5,3,6,11,17,-6,18
Kolkata,509,7,3,6,5,13,17,-4,15
Chennaiyin,509,8,3,6,5,14,19,-5,15
Mumbai City,510,1,7,4,3,18,9,9,25
Delhi Dynamo,510,2,5,6,3,25,17,8,21
Kolkata,510,3,5,6,3,19,15,4,21
NorthEast Un,510,4,6,3,5,16,12,4,21
Kerala Blast,510,5,5,3,6,11,17,-6,18
Chennaiyin,510,6,4,5,5,17,22,-5,17
FC Pune City,510,7,4,3,7,13,19,-6,15
FC Goa,510,8,4,2,8,11,19,-8,14
Mumbai City,511,1,6,5,3,17,9,8,23
NorthEast Un,511,2,6,2,6,13,14,-1,20
Kolkata,511,3,4,7,3,15,15,0,19
FC Pune City,511,4,5,4,5,13,14,-1,19
Delhi Dynamo,511,5,4,6,4,24,19,5,18
Kerala Blast,511,6,5,3,6,12,16,-4,18
Chennaiyin,511,7,4,5,5,16,18,-2,17
FC Goa,511,8,5,2,7,12,17,-5,17
Delhi Dynamo,512,1,6,5,3,25,19,6,23
Mumbai City,512,2,6,4,4,17,10,7,22
Kerala Blast,512,3,6,3,5,14,17,-3,21
Kolkata,512,4,4,7,3,15,14,1,19
FC Goa,512,5,5,3,6,13,14,-1,18
FC Pune City,512,6,5,3,6,14,16,-2,18
NorthEast Un,512,7,5,2,7,12,13,-1,17
Chennaiyin,512,8,3,5,6,13,20,-7,14
Mumbai City,513,1,7,4,3,19,9,10,25
Delhi Dynamo,513,2,5,5,4,24,20,4,20
FC Pune City,513,3,5,4,5,18,18,0,19
NorthEast Un,513,4,5,3,6,14,13,1,18
Kerala Blast,513,5,4,6,4,14,18,-4,18
Kolkata,513,6,3,8,3,17,18,-1,17
Chennaiyin,513,7,4,5,5,15,19,-4,17
FC Goa,513,8,4,3,7,11,17,-6,15
Mumbai City,514,1,7,4,3,17,8,9,25
NorthEast Un,514,2,6,3,5,14,10,4,21
Kolkata,514,3,5,6,3,16,16,0,21
Delhi Dynamo,514,4,5,5,4,23,18,5,20
Kerala Blast,514,5,5,3,6,12,17,-5,18
Chennaiyin,514,6,3,7,4,13,17,-4,16
FC Pune City,514,7,4,3,7,12,16,-4,15
FC Goa,514,8,4,3,7,11,16,-5,15
Mumbai City,515,1,7,4,3,19,8,11,25
Kerala Blast,515,2,6,4,4,15,16,-1,22
Delhi Dynamo,515,3,5,6,3,27,21,6,21
Chennaiyin,515,4,5,5,4,16,18,-2,20
Kolkata,515,5,4,7,3,18,16,2,19
NorthEast Un,515,6,4,3,7,13,16,-3,15
FC Pune City,515,7,4,3,7,12,18,-6,15
FC Goa,515,8,3,4,7,13,20,-7,13
Delhi Dynamo,516,1,6,6,2,27,17,10,24
Mumbai City,516,2,6,4,4,19,13,6,22
Kolkata,516,3,5,6,3,20,15,5,21
NorthEast Un,516,4,5,3,6,11,11,0,18
Chennaiyin,516,5,4,5,5,15,18,-3,17
Kerala Blast,516,6,4,5,5,11,19,-8,17
FC Pune City,516,7,4,4,6,13,16,-3,16
FC Goa,516,8,4,3,7,11,18,-7,15
Mumbai City,517,1,6,5,3,17,9,8,23
Delhi Dynamo,517,2,5,6,3,27,18,9,21
Kerala Blast,517,3,5,5,4,12,15,-3,20
Kolkata,517,4,4,7,3,15,13,2,19
Chennaiyin,517,5,4,6,4,15,18,-3,18
FC Goa,517,6,5,3,6,10,14,-4,18
NorthEast Un,517,7,4,3,7,12,16,-4,15
FC Pune City,517,8,4,3,7,14,19,-5,15
Delhi Dynamo,518,1,6,6,2,24,14,10,24
Kolkata,518,2,6,6,2,21,14,7,24
Mumbai City,518,3,6,5,3,16,8,8,23
NorthEast Un,518,4,5,3,6,10,10,0,18
Kerala Blast,518,5,4,5,5,10,16,-6,17
FC Pune City,518,6,4,4,6,14,18,-4,16
Chennaiyin,518,7,3,6,5,14,19,-5,15
FC Goa,518,8,3,3,8,10,20,-10,12
Mumbai City,519,1,6,5,3,19,11,8,23
Delhi Dynamo,519,2,5,6,3,28,19,9,21
Kolkata,519,3,4,8,2,16,14,2,20
NorthEast Un,519,4,5,4,5,15,14,1,19
Kerala Blast,519,5,5,4,5,13,17,-4,19
FC Pune City,519,6,4,4,6,13,16,-3,16
Chennaiyin,519,7,3,6,5,16,22,-6,15
FC Goa,519,8,4,3,7,11,18,-7,15
Mumbai City,520,1,7,4,3,17,8,9,25
Delhi Dynamo,520,2,5,6,3,29,18,11,21
Kolkata,520,3,5,6,3,17,15,2,21
NorthEast Un,520,4,6,3,5,15,13,2,21
Kerala Blast,520,5,5,3,6,13,17,-4,18
FC Goa,520,6,5,2,7,10,19,-9,17
FC Pune City,520,7,4,3,7,15,20,-5,15
Chennaiyin,520,8,3,5,6,13,19,-6,14
Mumbai City,521,1,7,4,3,17,8,9,25
Delhi Dynamo,521,2,5,6,3,23,16,7,21
Kerala Blast,521,3,6,3,5,17,16,1,21
Kolkata,521,4,5,6,3,16,16,0,21
Chennaiyin,521,5,5,5,4,19,20,-1,20
FC Pune City,521,6,5,3,6,14,15,-1,18
NorthEast Un,521,7,4,3,7,14,19,-5,15
FC Goa,521,8,3,2,9,9,19,-10,11
Mumbai City,522,1,7,4,3,21,10,11,25
Kolkata,522,2,5,7,2,21,16,5,22
NorthEast Un,522,3,6,2,6,15,14,1,20
Delhi Dynamo,522,4,4,6,4,26,23,3,18
Kerala Blast,522,5,5,3,6,13,20,-7,18
Chennaiyin,522,6,4,5,5,15,21,-6,17
FC Goa,522,7,4,4,6,15,17,-2,16
FC Pune City,522,8,4,3,7,13,18,-5,15
Mumbai City,523,1,7,4,3,20,8,12,25
Delhi Dynamo,523,2,5,5,4,22,20,2,20
NorthEast Un,523,3,6,2,6,13,13,0,20
Kolkata,523,4,4,7,3,17,16,1,19
Kerala Blast,523,5,5,4,5,13,16,-3,19
FC Pune City,523,6,4,5,5,12,14,-2,17
Chennaiyin,523,7,4,5,5,15,19,-4,17
FC Goa,523,8,4,2,8,13,19,-6,14
Mumbai City,524,1,7,4,3,17,8,9,25
Delhi Dynamo,524,2,5,5,4,24,17,7,20
Chennaiyin,524,3,5,5,4,20,17,3,20
Kerala Blast,524,4,5,4,5,13,16,-3,19
Kolkata,524,5,4,6,4,16,18,-2,18
FC Pune City,524,6,5,3,6,14,16,-2,18
NorthEast Un,524,7,5,3,6,13,17,-4,18
FC Goa,524,8,4,2,8,11,19,-8,14
Mumbai City,525,1,6,5,3,17,9,8,23
Kerala Blast,525,2,6,4,4,14,15,-1,22
Delhi Dynamo,525,3,4,7,3,24,19,5,19
NorthEast Un,525,4,5,3,6,11,10,1,18
Kolkata,525,5,3,8,3,15,15,0,17
Chennaiyin,525,6,3,7,4,15,19,-4,16
FC Pune City,525,7,4,4,6,14,18,-4,16
FC Goa,525,8,4,4,6,13,18,-5,16
Mumbai City,526,1,7,4,3,21,8,13,25
Kolkata,526,2,5,6,3,16,14,2,21
Kerala Blast,526,3,6,3,5,14,17,-3,21
NorthEast Un,526,4,6,2,6,14,11,3,20
Delhi Dynamo,526,5,5,5,4,23,21,2,20
Chennaiyin,526,6,4,5,5,14,20,-6,17
FC Pune City,526,7,4,3,7,14,19,-5,15
FC Goa,526,8,4,2,8,10,16,-6,14
Mumbai City,527,1,6,5,3,17,9,8,23
Delhi Dynamo,527,2,5,7,2,26,17,9,22
Kerala Blast,527,3,6,4,4,14,14,0,22
Kolkata,527,4,4,7,3,19,18,1,19
NorthEast Un,527,5,5,3,6,12,13,-1,18
FC Goa,527,6,5,2,7,13,19,-6,17
FC Pune City,527,7,4,3,7,14,19,-5,15
Chennaiyin,527,8,3,5,6,14,20,-6,14
Mumbai City,528,1,7,4,3,19,8,11,25
Kolkata,528,2,6,6,2,18,13,5,24
Delhi Dynamo,528,3,5,5,4,25,23,2,20
NorthEast Un,528,4,5,4,5,17,14,3,19
FC Pune City,528,5,5,3,6,15,17,-2,18
Chennaiyin,528,6,3,7,4,13,17,-4,16
Kerala Blast,528,7,4,4,6,12,19,-7,16
FC Goa,528,8,3,3,8,9,17,-8,12
Mumbai City,529,1,7,4,3,18,8,10,25
Kolkata,529,2,6,6,2,18,12,6,24
Delhi Dynamo,529,3,6,5,3,24,17,7,23
Chennaiyin,529,4,4,6,4,15,18,-3,18
Kerala Blast,529,5,5,3,6,10,17,-7,18
NorthEast Un,529,6,5,2,7,10,11,-1,17
FC Pune City,529,7,4,3,7,12,16,-4,15
FC Goa,529,8,3,3,8,10,18,-8,12
Mumbai City,530,1,7,4,3,17,8,9,25
Kolkata,530,2,5,7,2,20,16,4,22
Delhi Dynamo,530,3,4,6,4,24,20,4,18
NorthEast Un,530,4,4,5,5,12,12,0,17
Kerala Blast,530,5,4,5,5,10,16,-6,17
FC Pune City,530,6,4,4,6,14,17,-3,16
Chennaiyin,530,7,3,7,4,15,19,-4,16
FC Goa,530,7,4,4,6,15,19,-4,16
Mumbai City,531,1,7,4,3,18,8,10,25
Delhi Dynamo,531,2,6,5,3,25,18,7,23
Kolkata,531,3,5,7,2,16,12,4,22
Chennaiyin,531,4,4,6,4,19,20,-1,18
NorthEast Un,531,5,5,2,7,12,15,-3,17
FC Pune City,531,6,4,4,6,14,18,-4,16
Kerala Blast,531,7,4,4,6,11,17,-6,16
FC Goa,531,8,3,4,7,11,18,-7,13
Mumbai City,532,1,6,5,3,17,9,8,23
Delhi Dynamo,532,2,5,7,2,25,17,8,22
Kolkata,532,3,5,7,2,20,14,6,22
Kerala Blast,532,4,6,3,5,12,17,-5,21
FC Pune City,532,5,4,4,6,14,17,-3,16
Chennaiyin,532,6,3,7,4,15,19,-4,16
NorthEast Un,532,7,4,3,7,11,13,-2,15
FC Goa,532,8,3,4,7,11,19,-8,13
Mumbai City,533,1,7,4,3,19,9,10,25
Kolkata,533,2,4,8,2,17,14,3,20
NorthEast Un,533,3,6,2,6,15,12,3,20
Delhi Dynamo,533,4,4,6,4,23,20,3,18
Kerala Blast,533,5,5,3,6,10,18,-8,18
Chennaiyin,533,6,4,5,5,16,19,-3,17
FC Pune City,533,7,4,4,6,13,16,-3,16
FC Goa,533,8,4,4,6,11,16,-5,16
Delhi Dynamo,534,1,5,7,2,26,17,9,22
Mumbai City,534,2,6,4,4,16,10,6,22
Kolkata,534,3,5,6,3,19,14,5,21
NorthEast Un,534,4,5,4,5,13,12,1,19
Kerala Blast,534,5,5,4,5,12,16,-4,19
FC Pune City,534,6,5,3,6,13,18,-5,18
Chennaiyin,534,7,4,5,5,17,20,-3,17
FC Goa,534,8,3,3,8,11,20,-9,12
Mumbai City,535,1,7,4,3,17,8,9,25
Kolkata,535,2,5,7,2,17,14,3,22
Delhi Dynamo,535,3,5,5,4,24,16,8,20
Chennaiyin,535,4,4,6,4,16,19,-3,18
FC Pune City,535,5,4,5,5,15,17,-2,17
Kerala Blast,535,6,4,5,5,12,17,-5,17
NorthEast Un,535,7,4,4,6,10,13,-3,16
FC Goa,535,8,4,2,8,10,17,-7,14
Kolkata,536,1,6,6,2,20,15,5,24
Delhi Dynamo,536,2,6,5,3,25,16,9,23
Mumbai City,536,3,6,4,4,16,10,6,22
FC Pune City,536,4,5,3,6,18,18,0,18
NorthEast Un,536,5,5,2,7,13,14,-1,17
Chennaiyin,536,6,4,5,5,15,20,-5,17
FC Goa,536,7,5,2,7,12,17,-5,17
Kerala Blast,536,8,4,3,7,11,20,-9,15
Kerala Blast,537,1,7,3,4,16,15,1,24
Delhi Dynamo,537,2,5,7,2,28,20,8,22
Mumbai City,537,3,6,4,4,17,10,7,22
Chennaiyin,537,4,5,5,4,19,20,-1,20
FC Pune City,537,5,5,3,6,14,16,-2,18
Kolkata,537,6,3,6,5,14,17,-3,15
NorthEast Un,537,7,4,3,7,12,15,-3,15
FC Goa,537,8,4,3,7,14,21,-7,15
Delhi Dynamo,538,1,6,6,2,25,14,11,24
Mumbai City,538,2,6,5,3,16,8,8,23
Kerala Blast,538,3,6,4,4,14,14,0,22
Kolkata,538,4,4,7,3,18,15,3,19
NorthEast Un,538,5,5,2,7,17,15,2,17
FC Goa,538,6,5,2,7,11,15,-4,17
FC Pune City,538,7,4,3,7,13,21,-8,15
Chennaiyin,538,8,3,5,6,13,25,-12,14
Mumbai City,539,1,7,4,3,17,8,9,25
Kerala Blast,539,2,6,3,5,15,15,0,21
NorthEast Un,539,3,5,4,5,11,10,1,19
Delhi Dynamo,539,4,4,6,4,22,21,1,18
Kolkata,539,5,4,6,4,15,17,-2,18
Chennaiyin,539,6,4,6,4,16,19,-3,18
FC Goa,539,7,5,2,7,17,17,0,17
FC Pune City,539,8,4,3,7,12,18,-6,15
Delhi Dynamo,540,1,6,6,2,31,17,14,24
Mumbai City,540,2,6,5,3,17,9,8,23
Kolkata,540,3,4,7,3,17,16,1,19
Kerala Blast,540,4,5,4,5,14,19,-5,19
FC Pune City,540,5,5,3,6,15,16,-1,18
NorthEast Un,540,6,4,4,6,11,13,-2,16
Chennaiyin,540,7,3,7,4,14,18,-4,16
FC Goa,540,8,3,4,7,10,21,-11,13
Mumbai City,541,1,6,5,3,18,10,8,23
Delhi Dynamo,541,2,4,8,2,25,18,7,20
FC Pune City,541,3,5,4,5,16,17,-1,19
Chennaiyin,541,4,4,6,4,16,17,-1,18
NorthEast Un,541,5,5,3,6,13,14,-1,18
Kerala Blast,541,6,5,3,6,13,17,-4,18
Kolkata,541,7,3,7,4,16,19,-3,16
FC Goa,541,8,4,4,6,10,15,-5,16
Mumbai City,542,1,7,4,3,18,9,9,25
Kerala Blast,542,2,6,4,4,16,15,1,22
Delhi Dynamo,542,3,5,5,4,24,18,6,20
NorthEast Un,542,4,6,2,6,12,11,1,20
Kolkata,542,5,4,7,3,16,16,0,19
FC Goa,542,6,5,2,7,14,17,-3,17
FC Pune City,542,7,4,3,7,12,18,-6,15
Chennaiyin,542,8,3,5,6,14,22,-8,14
Mumbai City,543,1,6,4,4,16,9,7,22
Delhi Dynamo,543,2,5,5,4,24,18,6,20
NorthEast Un,543,3,6,2,6,15,14,1,20
Chennaiyin,543,4,5,5,4,19,21,-2,20
Kerala Blast,543,5,5,4,5,13,16,-3,19
FC Pune City,543,6,4,5,5,13,15,-2,17
FC Goa,543,7,5,2,7,13,18,-5,17
Kolkata,543,8,3,7,4,13,15,-2,16
Mumbai City,544,1,7,4,3,18,8,10,25
Kolkata,544,2,5,7,2,18,15,3,22
Kerala Blast,544,3,6,3,5,15,16,-1,21
Chennaiyin,544,4,5,5,4,16,18,-2,20
Delhi Dynamo,544,5,4,6,4,24,20,4,18
FC Pune City,544,6,4,4,6,13,16,-3,16
NorthEast Un,544,7,4,3,7,12,16,-4,15
FC Goa,544,8,4,2,8,10,17,-7,14
Delhi Dynamo,545,1,6,5,3,28,17,11,23
Mumbai City,545,2,6,4,4,16,10,6,22
Kolkata,545,3,4,8,2,20,16,4,20
Chennaiyin,545,4,5,5,4,18,18,0,20
FC Pune City,545,5,5,4,5,13,14,-1,19
Kerala Blast,545,6,4,4,6,11,19,-8,16
FC Goa,545,7,4,3,7,15,21,-6,15
NorthEast Un,545,8,4,3,7,10,16,-6,15
Delhi Dynamo,546,1,6,5,3,25,18,7,23
Mumbai City,546,2,6,4,4,16,10,6,22
NorthEast Un,546,3,6,3,5,16,11,5,21
Kolkata,546,4,4,7,3,16,15,1,19
FC Pune City,546,5,5,4,5,16,16,0,19
Chennaiyin,546,6,4,5,5,16,19,-3,17
Kerala Blast,546,7,4,5,5,12,18,-6,17
FC Goa,546,8,3,3,8,9,19,-10,12
Mumbai City,547,1,7,4,3,21,8,13,25
Kerala Blast,547,2,6,3,5,12,16,-4,21
Kolkata,547,3,4,8,2,18,14,4,20
Delhi Dynamo,547,4,4,7,3,25,23,2,19
NorthEast Un,547,5,4,4,6,12,14,-2,16
FC Pune City,547,6,4,4,6,13,16,-3,16
FC Goa,547,7,4,4,6,13,18,-5,16
Chennaiyin,547,8,3,6,5,15,20,-5,15
Delhi Dynamo,548,1,7,5,2,26,16,10,26
Mumbai City,548,2,6,4,4,17,10,7,22
Kolkata,548,3,5,6,3,16,15,1,21
FC Pune City,548,4,5,3,6,17,15,2,18
NorthEast Un,548,5,5,3,6,13,13,0,18
Chennaiyin,548,6,3,7,4,16,20,-4,16
FC Goa,548,7,4,3,7,12,16,-4,15
Kerala Blast,548,8,4,3,7,9,21,-12,15
Mumbai City,549,1,6,5,3,17,9,8,23
NorthEast Un,549,2,7,2,5,17,11,6,23
Kolkata,549,3,5,7,2,16,12,4,22
Kerala Blast,549,4,5,4,5,11,16,-5,19
Delhi Dynamo,549,5,4,6,4,23,18,5,18
FC Goa,549,6,5,2,7,12,17,-5,17
FC Pune City,549,7,4,3,7,12,17,-5,15
Chennaiyin,549,8,3,5,6,15,23,-8,14
Delhi Dynamo,550,1,6,5,3,28,15,13,23
Kolkata,550,2,5,7,2,18,13,5,22
Mumbai City,550,3,6,4,4,16,12,4,22
Kerala Blast,550,4,6,4,4,15,15,0,22
Chennaiyin,550,5,4,6,4,18,20,-2,18
NorthEast Un,550,6,5,2,7,13,16,-3,17
FC Pune City,550,7,4,3,7,12,18,-6,15
FC Goa,550,8,3,3,8,11,22,-11,12
Mumbai City,551,1,6,4,4,17,11,6,22
Delhi Dynamo,551,2,5,5,4,26,20,6,20
NorthEast Un,551,3,6,2,6,15,14,1,20
FC Goa,551,4,6,2,6,12,14,-2,20
Kolkata,551,5,4,7,3,15,14,1,19
Kerala Blast,551,6,5,4,5,13,17,-4,19
FC Pune City,551,7,4,5,5,13,15,-2,17
Chennaiyin,551,8,3,5,6,14,20,-6,14
Mumbai City,552,1,7,4,3,20,11,9,25
Kerala Blast,552,2,7,3,4,14,14,0,24
NorthEast Un,552,3,6,2,6,14,10,4,20
Delhi Dynamo,552,4,4,6,4,25,22,3,18
FC Pune City,552,5,5,3,6,15,17,-2,18
Chennaiyin,552,6,4,5,5,14,19,-5,17
Kolkata,552,7,3,6,5,13,17,-4,15
FC Goa,552,8,4,3,7,11,16,-5,15
Mumbai City,553,1,6,5,3,17,9,8,23
Chennaiyin,553,2,5,5,4,17,19,-2,20
Delhi Dynamo,553,3,4,7,3,23,18,5,19
Kerala Blast,553,4,5,4,5,14,15,-1,19
Kolkata,553,5,3,9,2,16,15,1,18
NorthEast Un,553,6,5,3,6,12,12,0,18
FC Pune City,553,7,4,4,6,13,19,-6,16
FC Goa,553,8,4,3,7,12,17,-5,15
Mumbai City,554,1,7,4,3,18,8,10,25
Delhi Dynamo,554,2,6,5,3,26,16,10,23
FC Pune City,554,3,6,3,5,17,16,1,21
Kolkata,554,4,4,6,4,14,15,-1,18
Chennaiyin,554,5,4,6,4,16,19,-3,18
Kerala Blast,554,6,4,4,6,12,18,-6,16
NorthEast Un,554,7,4,3,7,11,15,-4,15
FC Goa,554,8,4,3,7,10,17,-7,15
Mumbai City,555,1,7,4,3,17,8,9,25
Kerala Blast,555,2,7,3,4,17,13,4,24
Delhi Dynamo,555,3,5,6,3,27,18,9,21
Kolkata,555,4,5,6,3,16,14,2,21
NorthEast Un,555,5,5,3,6,15,16,-1,18
Chennaiyin,555,6,4,5,5,16,20,-4,17
FC Pune City,555,7,4,3,7,12,19,-7,15
FC Goa,555,8,3,2,9,8,20,-12,11
Mumbai City,556,1,7,4,3,18,9,9,25
FC Goa,556,2,6,2,6,12,15,-3,20
Kerala Blast,556,3,5,4,5,12,16,-4,19
Delhi Dynamo,556,4,4,6,4,25,20,5,18
Kolkata,556,5,4,6,4,14,14,0,18
FC Pune City,556,6,5,3,6,14,16,-2,18
Chennaiyin,556,7,4,5,5,17,18,-1,17
NorthEast Un,556,8,4,4,6,12,16,-4,16
Mumbai City,557,1,6,4,4,17,10,7,22
Delhi Dynamo,557,2,5,6,3,26,19,7,21
Kolkata,557,3,5,6,3,17,16,1,21
FC Goa,557,4,6,2,6,16,17,-1,20
FC Pune City,557,5,5,3,6,14,16,-2,18
Kerala Blast,557,6,5,3,6,13,17,-4,18
Chennaiyin,557,7,4,5,5,18,21,-3,17
NorthEast Un,557,8,4,3,7,12,17,-5,15
Mumbai City,558,1,7,4,3,19,9,10,25
Delhi Dynamo,558,2,5,6,3,26,20,6,21
NorthEast Un,558,3,6,2,6,13,10,3,20
Kerala Blast,558,4,5,4,5,13,18,-5,19
Kolkata,558,5,4,6,4,16,16,0,18
FC Goa,558,6,5,3,6,13,17,-4,18
FC Pune City,558,7,4,4,6,13,16,-3,16
Chennaiyin,558,8,3,5,6,13,20,-7,14
Mumbai City,559,1,7,4,3,21,9,12,25
Delhi Dynamo,559,2,5,6,3,25,21,4,21
Kerala Blast,559,3,6,3,5,12,17,-5,21
NorthEast Un,559,4,5,4,5,14,11,3,19
FC Pune City,559,5,5,3,6,16,17,-1,18
Chennaiyin,559,6,4,6,4,14,17,-3,18
Kolkata,559,7,3,6,5,16,19,-3,15
FC Goa,559,8,4,2,8,9,16,-7,14
Mumbai City,560,1,7,4,3,18,8,10,25
Delhi Dynamo,560,2,5,6,3,24,18,6,21
FC Pune City,560,3,5,4,5,16,14,2,19
Kolkata,560,4,4,7,3,15,16,-1,19
Chennaiyin,560,5,4,6,4,16,18,-2,18
Kerala Blast,560,6,4,5,5,10,16,-6,17
NorthEast Un,560,7,4,4,6,12,14,-2,16
FC Goa,560,8,3,4,7,9,16,-7,13
Mumbai City,561,1,7,4,3,19,8,11,25
Kolkata,561,2,4,8,2,18,16,2,20
Delhi Dynamo,561,3,4,7,3,26,22,4,19
NorthEast Un,561,4,5,4,5,13,12,1,19
FC Pune City,561,5,5,3,6,13,15,-2,18
FC Goa,561,6,4,4,6,15,19,-4,16
Kerala Blast,561,7,4,4,6,10,16,-6,16
Chennaiyin,561,8,3,6,5,13,19,-6,15
Mumbai City,562,1,7,4,3,17,8,9,25
Kolkata,562,2,4,8,2,19,17,2,20
Kerala Blast,562,3,5,4,5,12,16,-4,19
Delhi Dynamo,562,4,4,6,4,22,17,5,18
Chennaiyin,562,5,4,6,4,15,18,-3,18
NorthEast Un,562,6,5,2,7,11,12,-1,17
FC Pune City,562,7,4,5,5,14,16,-2,17
FC Goa,562,8,3,5,6,12,18,-6,14
Mumbai City,563,1,6,5,3,17,9,8,23
Kerala Blast,563,2,6,4,4,15,17,-2,22
Chennaiyin,563,3,5,5,4,16,17,-1,20
Kolkata,563,4,4,7,3,17,15,2,19
Delhi Dynamo,563,5,4,6,4,23,22,1,18
NorthEast Un,563,6,5,2,7,16,13,3,17
FC Goa,563,7,5,2,7,12,18,-6,17
FC Pune City,563,8,4,3,7,13,18,-5,15
Mumbai City,564,1,7,4,3,19,8,11,25
Delhi Dynamo,564,2,6,5,3,28,18,10,23
Chennaiyin,564,3,5,5,4,15,17,-2,20
Kolkata,564,4,4,7,3,14,13,1,19
FC Pune City,564,5,5,4,5,13,14,-1,19
Kerala Blast,564,6,5,3,6,11,16,-5,18
NorthEast Un,564,7,4,2,8,10,15,-5,14
FC Goa,564,8,4,2,8,10,19,-9,14
Mumbai City,565,1,7,4,3,18,8,10,25
Delhi Dynamo,565,2,5,5,4,27,20,7,20
Kolkata,565,3,4,8,2,16,14,2,20
Kerala Blast,565,4,5,5,4,14,13,1,20
Chennaiyin,565,5,5,5,4,19,19,0,20
FC Pune City,565,6,4,4,6,13,20,-7,16
NorthEast Un,565,7,4,3,7,10,16,-6,15
FC Goa,565,8,4,2,8,14,21,-7,14
Delhi Dynamo,566,1,6,6,2,27,16,11,24
Mumbai City,566,2,6,5,3,17,9,8,23
Kerala Blast,566,3,5,5,4,12,14,-2,20
Kolkata,566,4,4,7,3,18,17,1,19
FC Pune City,566,5,5,4,5,15,15,0,19
NorthEast Un,566,6,5,2,7,10,12,-2,17
Chennaiyin,566,7,3,6,5,15,20,-5,15
FC Goa,566,8,3,3,8,12,23,-11,12
Mumbai City,567,1,7,4,3,17,8,9,25
Kerala Blast,567,2,6,4,4,12,14,-2,22
Delhi Dynamo,567,3,5,6,3,24,16,8,21
Kolkata,567,4,4,6,4,14,14,0,18
Chennaiyin,567,5,4,5,5,14,18,-4,17
FC Goa,567,6,5,2,7,10,16,-6,17
FC Pune City,567,7,4,4,6,13,16,-3,16
NorthEast Un,567,8,4,3,7,10,12,-2,15
Delhi Dynamo,568,1,6,6,2,28,15,13,24
Mumbai City,568,2,6,4,4,16,11,5,22
Kolkata,568,3,5,6,3,20,15,5,21
FC Pune City,568,4,6,3,5,17,15,2,21
NorthEast Un,568,5,5,4,5,12,11,1,19
Kerala Blast,568,6,4,4,6,10,19,-9,16
Chennaiyin,568,7,3,6,5,15,20,-5,15
FC Goa,568,8,3,3,8,10,22,-12,12
Mumbai City,569,1,6,5,3,16,8,8,23
Delhi Dynamo,569,2,5,6,3,24,16,8,21
FC Pune City,569,3,5,4,5,15,16,-1,19
Kolkata,569,4,4,6,4,16,16,0,18
NorthEast Un,569,5,5,3,6,11,12,-1,18
Chennaiyin,569,6,4,6,4,17,19,-2,18
Kerala Blast,569,7,4,5,5,12,17,-5,17
FC Goa,569,8,4,3,7,12,19,-7,15
Mumbai City,570,1,6,4,4,17,11,6,22
Kolkata,570,2,5,6,3,21,14,7,21
Delhi Dynamo,570,3,5,6,3,25,19,6,21
Kerala Blast,570,4,6,3,5,12,19,-7,21
FC Pune City,570,5,5,3,6,14,17,-3,18
Chennaiyin,570,6,4,5,5,17,20,-3,17
FC Goa,570,7,5,2,7,15,18,-3,17
NorthEast Un,570,8,4,3,7,9,12,-3,15
Mumbai City,571,1,7,4,3,17,8,9,25
Kolkata,571,2,5,7,2,16,13,3,22
Delhi Dynamo,571,3,5,6,3,24,15,9,21
Chennaiyin,571,4,5,5,4,21,20,1,20
Kerala Blast,571,5,4,5,5,11,16,-5,17
FC Pune City,571,6,4,4,6,14,17,-3,16
NorthEast Un,571,7,4,4,6,11,14,-3,16
FC Goa,571,8,3,3,8,10,21,-11,12
Delhi Dynamo,572,1,6,6,2,28,17,11,24
Mumbai City,572,2,6,5,3,18,10,8,23
Kolkata,572,3,4,7,3,15,14,1,19
Kerala Blast,572,4,5,4,5,13,16,-3,19
Chennaiyin,572,5,4,6,4,16,19,-3,18
NorthEast Un,572,6,5,2,7,12,15,-3,17
FC Pune City,572,7,4,3,7,14,19,-5,15
FC Goa,572,8,4,3,7,11,17,-6,15
Delhi Dynamo,573,1,6,5,3,26,15,11,23
Mumbai City,573,2,6,4,4,16,11,5,22
Kolkata,573,3,5,7,2,17,13,4,22
NorthEast Un,573,4,6,3,5,12,10,2,21
FC Pune City,573,5,4,5,5,13,15,-2,17
Kerala Blast,573,6,4,5,5,12,18,-6,17
Chennaiyin,573,7,3,5,6,13,20,-7,14
FC Goa,573,8,4,2,8,10,17,-7,14
Mumbai City,574,1,7,4,3,18,9,9,25
NorthEast Un,574,2,7,2,5,14,10,4,23
Kolkata,574,3,5,7,2,22,18,4,22
Kerala Blast,574,4,5,4,5,13,17,-4,19
Delhi Dynamo,574,5,4,5,5,24,21,3,17
FC Goa,574,6,5,2,7,13,18,-5,17
FC Pune City,574,7,4,3,7,14,19,-5,15
Chennaiyin,574,8,3,5,6,14,20,-6,14
Mumbai City,575,1,6,5,3,18,10,8,23
Kolkata,575,2,5,7,2,20,16,4,22
Delhi Dynamo,575,3,4,7,3,24,19,5,19
FC Goa,575,4,5,3,6,13,16,-3,18
NorthEast Un,575,5,4,5,5,11,11,0,17
Kerala Blast,575,6,4,5,5,13,19,-6,17
FC Pune City,575,7,4,4,6,14,17,-3,16
Chennaiyin,575,8,3,6,5,14,19,-5,15
Mumbai City,576,1,7,4,3,18,8,10,25
Kerala Blast,576,2,6,3,5,14,16,-2,21
Delhi Dynamo,576,3,5,5,4,26,22,4,20
Kolkata,576,4,4,7,3,17,16,1,19
NorthEast Un,576,5,5,3,6,13,11,2,18
FC Goa,576,6,5,2,7,16,20,-4,17
FC Pune City,576,7,4,4,6,12,16,-4,16
Chennaiyin,576,8,3,6,5,14,21,-7,15
Mumbai City,577,1,7,4,3,17,8,9,25
Delhi Dynamo,577,2,5,6,3,22,15,7,21
Kerala Blast,577,3,6,3,5,15,17,-2,21
Kolkata,577,4,4,7,3,15,16,-1,19
FC Pune City,577,5,5,3,6,17,18,-1,18
NorthEast Un,577,6,4,4,6,11,12,-1,16
FC Goa,577,7,4,3,7,11,16,-5,15
Chennaiyin,577,8,3,6,5,14,20,-6,15
Delhi Dynamo,578,1,7,5,2,28,18,10,26
Mumbai City,578,2,6,4,4,17,10,7,22
Kerala Blast,578,3,6,4,4,15,15,0,22
Kolkata,578,4,4,7,3,15,16,-1,19
NorthEast Un,578,5,5,2,7,14,15,-1,17
Chennaiyin,578,6,4,5,5,17,21,-4,17
FC Pune City,578,7,4,4,6,13,16,-3,16
FC Goa,578,8,3,3,8,12,20,-8,12
Mumbai City,579,1,7,4,3,17,8,9,25
Kolkata,579,2,6,6,2,18,14,4,24
Delhi Dynamo,579,3,4,7,3,23,17,6,19
FC Pune City,579,4,5,3,6,15,17,-2,18
NorthEast Un,579,5,4,5,5,15,15,0,17
Chennaiyin,579,6,3,7,4,19,23,-4,16
Kerala Blast,579,7,4,4,6,12,18,-6,16
FC Goa,579,8,3,4,7,13,20,-7,13
Mumbai City,580,1,6,5,3,17,9,8,23
Kolkata,580,2,5,7,2,17,13,4,22
Chennaiyin,580,3,5,5,4,17,17,0,20
Kerala Blast,580,4,5,5,4,13,14,-1,20
Delhi Dynamo,580,5,4,7,3,24,19,5,19
NorthEast Un,580,6,5,2,7,11,15,-4,17
FC Pune City,580,7,4,4,6,14,18,-4,16
FC Goa,580,8,3,3,8,10,18,-8,12
Mumbai City,581,1,6,5,3,16,8,8,23
Delhi Dynamo,581,2,5,6,3,25,17,8,21
Kolkata,581,3,5,6,3,18,17,1,21
NorthEast Un,581,4,6,2,6,12,12,0,20
FC Goa,581,5,6,2,6,15,16,-1,20
FC Pune City,581,6,5,3,6,15,16,-1,18
Kerala Blast,581,7,4,3,7,10,19,-9,15
Chennaiyin,581,8,3,5,6,14,20,-6,14
Mumbai City,582,1,6,4,4,18,11,7,22
Delhi Dynamo,582,2,5,6,3,25,19,6,21
NorthEast Un,582,3,6,2,6,13,11,2,20
Kolkata,582,4,4,7,3,18,15,3,19
Kerala Blast,582,5,5,4,5,14,18,-4,19
Chennaiyin,582,6,4,6,4,15,18,-3,18
FC Goa,582,7,4,4,6,11,16,-5,16
FC Pune City,582,8,4,3,7,15,21,-6,15
Mumbai City,583,1,7,4,3,17,8,9,25
Kerala Blast,583,2,6,4,4,14,16,-2,22
Delhi Dynamo,583,3,5,5,4,23,16,7,20
NorthEast Un,583,4,5,3,6,12,13,-1,18
FC Pune City,583,5,5,3,6,16,18,-2,18
FC Goa,583,6,5,3,6,12,15,-3,18
Kolkata,583,7,3,7,4,17,18,-1,16
Chennaiyin,583,8,3,5,6,14,21,-7,14
Delhi Dynamo,584,1,6,5,3,23,17,6,23
NorthEast Un,584,2,7,2,5,14,9,5,23
Mumbai City,584,3,6,4,4,16,9,7,22
Kerala Blast,584,4,6,3,5,12,15,-3,21
Kolkata,584,5,4,6,4,17,14,3,18
Chennaiyin,584,6,4,5,5,14,18,-4,17
FC Pune City,584,7,4,3,7,13,20,-7,15
FC Goa,584,8,4,2,8,9,16,-7,14
Delhi Dynamo,585,1,6,6,2,30,15,15,24
Mumbai City,585,2,6,4,4,16,12,4,22
Kolkata,585,3,4,7,3,16,15,1,19
NorthEast Un,585,4,5,3,6,13,14,-1,18
Chennaiyin,585,5,4,5,5,15,20,-5,17
Kerala Blast,585,6,4,5,5,13,18,-5,17
FC Goa,585,7,5,2,7,13,19,-6,17
FC Pune City,585,8,4,4,6,13,16,-3,16
Mumbai City,586,1,6,5,3,16,8,8,23
NorthEast Un,586,2,7,2,5,14,10,4,23
Delhi Dynamo,586,3,5,6,3,24,16,8,21
Kolkata,586,4,5,6,3,17,15,2,21
Kerala Blast,586,5,5,3,6,11,16,-5,18
Chennaiyin,586,6,3,6,5,15,20,-5,15
FC Pune City,586,7,4,3,7,13,19,-6,15
FC Goa,586,8,4,3,7,12,18,-6,15
Mumbai City,587,1,6,5,3,17,9,8,23
Delhi Dynamo,587,2,5,7,2,28,18,10,22
Kolkata,587,3,4,8,2,17,14,3,20
NorthEast Un,587,4,5,4,5,14,13,1,19
Kerala Blast,587,5,5,4,5,14,18,-4,19
Chennaiyin,587,6,4,6,4,15,18,-3,18
FC Pune City,587,7,4,4,6,15,18,-3,16
FC Goa,587,8,3,2,9,9,21,-12,11
Mumbai City,588,1,7,4,3,18,8,10,25
Kolkata,588,2,5,7,2,20,17,3,22
Delhi Dynamo,588,3,5,6,3,27,18,9,21
Kerala Blast,588,4,5,5,4,14,16,-2,20
Chennaiyin,588,5,4,5,5,15,18,-3,17
NorthEast Un,588,6,4,4,6,11,13,-2,16
FC Pune City,588,7,4,3,7,14,19,-5,15
FC Goa,588,8,4,2,8,11,21,-10,14
Delhi Dynamo,589,1,6,6,2,25,15,10,24
Mumbai City,589,2,6,4,4,16,9,7,22
Kerala Blast,589,3,5,5,4,14,17,-3,20
Kolkata,589,4,4,7,3,17,16,1,19
Chennaiyin,589,5,4,6,4,17,20,-3,18
NorthEast Un,589,6,4,4,6,13,14,-1,16
FC Pune City,589,7,4,3,7,14,18,-4,15
FC Goa,589,8,4,3,7,14,21,-7,15
Mumbai City,590,1,7,4,3,20,8,12,25
Kerala Blast,590,2,6,3,5,13,16,-3,21
Delhi Dynamo,590,3,5,5,4,27,21,6,20
Kolkata,590,4,4,7,3,17,15,2,19
FC Pune City,590,5,5,4,5,14,15,-1,19
Chennaiyin,590,6,4,6,4,16,19,-3,18
FC Goa,590,7,4,3,7,13,20,-7,15
NorthEast Un,590,8,4,2,8,10,16,-6,14
Kolkata,591,1,6,6,2,19,15,4,24
Mumbai City,591,2,6,5,3,18,10,8,23
Delhi Dynamo,591,3,4,7,3,24,18,6,19
Kerala Blast,591,4,5,4,5,15,19,-4,19
Chennaiyin,591,5,4,6,4,16,19,-3,18
NorthEast Un,591,6,5,2,7,13,14,-1,17
FC Pune City,591,7,4,4,6,12,15,-3,16
FC Goa,591,8,3,4,7,10,17,-7,13
Delhi Dynamo,592,1,6,5,3,25,17,8,23
NorthEast Un,592,2,7,2,5,14,9,5,23
Mumbai City,592,3,6,4,4,17,10,7,22
Kolkata,592,4,5,7,2,19,16,3,22
Kerala Blast,592,5,5,3,6,13,17,-4,18
FC Pune City,592,6,4,3,7,14,19,-5,15
Chennaiyin,592,7,3,6,5,14,20,-6,15
FC Goa,592,8,3,4,7,11,19,-8,13
Mumbai City,593,1,6,5,3,18,10,8,23
Delhi Dynamo,593,2,5,7,2,27,17,10,22
Chennaiyin,593,3,5,5,4,18,17,1,20
Kerala Blast,593,4,5,5,4,13,15,-2,20
Kolkata,593,5,4,7,3,16,16,0,19
NorthEast Un,593,6,4,4,6,10,12,-2,16
FC Pune City,593,7,4,3,7,12,18,-6,15
FC Goa,593,8,4,2,8,12,21,-9,14
Delhi Dynamo,594,1,6,5,3,25,17,8,23
Kolkata,594,2,5,7,2,21,13,8,22
Mumbai City,594,3,6,4,4,17,10,7,22
NorthEast Un,594,4,5,4,5,13,11,2,19
Kerala Blast,594,5,5,4,5,12,20,-8,19
FC Pune City,594,6,4,4,6,12,16,-4,16
Chennaiyin,594,7,3,6,5,15,21,-6,15
FC Goa,594,8,4,2,8,12,19,-7,14
Mumbai City,595,1,6,5,3,18,10,8,23
Kerala Blast,595,2,6,4,4,13,15,-2,22
Delhi Dynamo,595,3,4,8,2,25,18,7,20
FC Pune City,595,4,5,3,6,14,16,-2,18
Chennaiyin,595,5,4,6,4,14,17,-3,18
Kolkata,595,6,3,8,3,16,16,0,17
NorthEast Un,595,7,4,4,6,11,12,-1,16
FC Goa,595,8,3,4,7,10,17,-7,13
Mumbai City,596,1,7,4,3,19,9,10,25
Kerala Blast,596,2,6,4,4,13,15,-2,22
Delhi Dynamo,596,3,5,6,3,27,20,7,21
Kolkata,596,4,4,7,3,16,15,1,19
NorthEast Un,596,5,5,2,7,15,16,-1,17
Chennaiyin,596,6,4,5,5,16,21,-5,17
FC Pune City,596,7,4,3,7,13,18,-5,15
FC Goa,596,8,4,3,7,11,16,-5,15
Mumbai City,597,1,6,4,4,16,9,7,22
Delhi Dynamo,597,2,5,6,3,24,17,7,21
FC Pune City,597,3,6,3,5,18,15,3,21
Kolkata,597,4,5,6,3,16,17,-1,21
Chennaiyin,597,5,5,5,4,18,18,0,20
NorthEast Un,597,6,5,3,6,13,12,1,18
Kerala Blast,597,7,4,3,7,12,20,-8,15
FC Goa,597,8,4,2,8,11,20,-9,14
Delhi Dynamo,598,1,6,5,3,28,18,10,23
Mumbai City,598,2,6,4,4,19,12,7,22
Kerala Blast,598,3,6,3,5,13,17,-4,21
NorthEast Un,598,4,6,2,6,14,11,3,20
Chennaiyin,598,5,4,6,4,14,17,-3,18
FC Pune City,598,6,5,3,6,13,16,-3,18
Kolkata,598,7,3,6,5,14,16,-2,15
FC Goa,598,8,4,3,7,10,18,-8,15
Mumbai City,599,1,6,5,3,17,9,8,23
Delhi Dynamo,599,2,5,7,2,25,16,9,22
Chennaiyin,599,3,5,5,4,16,17,-1,20
Kerala Blast,599,4,5,5,4,12,15,-3,20
FC Pune City,599,5,5,4,5,16,17,-1,19
Kolkata,599,6,3,8,3,16,16,0,17
NorthEast Un,599,7,4,3,7,10,13,-3,15
FC Goa,599,8,3,3,8,8,17,-9,12
Mumbai City,600,1,6,5,3,16,8,8,23
Delhi Dynamo,600,2,5,6,3,23,19,4,21
FC Goa,600,3,6,2,6,17,16,1,20
Kolkata,600,4,4,7,3,16,15,1,19
Kerala Blast,600,5,5,4,5,13,15,-2,19
NorthEast Un,600,6,5,3,6,13,14,-1,18
Chennaiyin,600,7,3,6,5,17,22,-5,15
FC Pune City,600,8,4,3,7,12,18,-6,15
Mumbai City,601,1,7,4,3,20,8,12,25
Kolkata,601,2,5,6,3,18,15,3,21
NorthEast Un,601,3,6,2,6,13,11,2,20
FC Goa,601,4,5,3,6,15,17,-2,18
Chennaiyin,601,5,4,6,4,15,18,-3,18
FC Pune City,601,6,5,3,6,14,18,-4,18
Delhi Dynamo,601,7,4,5,5,22,23,-1,17
Kerala Blast,601,8,4,3,7,11,18,-7,15
Mumbai City,602,1,7,4,3,20,9,11,25
Delhi Dynamo,602,2,6,5,3,28,18,10,23
Kerala Blast,602,3,5,5,4,10,13,-3,20
Kolkata,602,4,4,7,3,15,15,0,19
NorthEast Un,602,5,5,2,7,10,12,-2,17
FC Goa,602,6,5,2,7,13,18,-5,17
FC Pune City,602,7,4,4,6,12,16,-4,16
Chennaiyin,602,8,3,5,6,13,20,-7,14
Mumbai City,603,1,7,4,3,19,10,9,25
Delhi Dynamo,603,2,5,6,3,27,19,8,21
Kolkata,603,3,5,6,3,22,16,6,21
Chennaiyin,603,4,5,5,4,16,18,-2,20
Kerala Blast,603,5,4,5,5,10,17,-7,17
NorthEast Un,603,6,4,4,6,11,12,-1,16
FC Pune City,603,7,4,4,6,12,17,-5,16
FC Goa,603,8,4,2,8,14,22,-8,14
Mumbai City,604,1,6,5,3,16,8,8,23
Delhi Dynamo,604,2,5,7,2,24,16,8,22
Kolkata,604,3,5,7,2,18,13,5,22
Kerala Blast,604,4,6,3,5,14,16,-2,21
Chennaiyin,604,5,4,6,4,15,18,-3,18
NorthEast Un,604,6,4,3,7,10,14,-4,15
FC Pune City,604,7,4,3,7,12,17,-5,15
FC Goa,604,8,3,4,7,11,18,-7,13
Delhi Dynamo,605,1,6,6,2,27,17,10,24
Mumbai City,605,2,6,4,4,17,10,7,22
FC Pune City,605,3,5,4,5,17,17,0,19
FC Goa,605,4,5,3,6,13,17,-4,18
Kerala Blast,605,5,5,3,6,10,16,-6,18
NorthEast Un,605,6,5,2,7,11,13,-2,17
Chennaiyin,605,7,4,5,5,14,18,-4,17
Kolkata,605,8,3,7,4,18,19,-1,16
Kolkata,606,1,6,6,2,22,14,8,24
Delhi Dynamo,606,2,6,5,3,26,17,9,23
Mumbai City,606,3,6,4,4,17,10,7,22
NorthEast Un,606,4,6,3,5,13,9,4,21
Chennaiyin,606,5,4,6,4,15,17,-2,18
FC Pune City,606,6,5,3,6,14,19,-5,18
Kerala Blast,606,7,4,3,7,9,18,-9,15
FC Goa,606,8,3,2,9,9,21,-12,11
Mumbai City,607,1,6,5,3,17,9,8,23
Delhi Dynamo,607,2,5,6,3,28,19,9,21
Kolkata,607,3,4,7,3,16,16,0,19
Kerala Blast,607,4,5,4,5,14,17,-3,19
Chennaiyin,607,5,4,6,4,15,18,-3,18
NorthEast Un,607,6,5,2,7,12,15,-3,17
FC Pune City,607,7,4,4,6,14,17,-3,16
FC Goa,607,8,4,4,6,12,17,-5,16
Delhi Dynamo,608,1,6,5,3,26,18,8,23
Mumbai City,608,2,6,4,4,16,9,7,22
NorthEast Un,608,3,6,2,6,13,11,2,20
FC Pune City,608,4,5,4,5,14,15,-1,19
Kolkata,608,5,3,8,3,15,16,-1,17
FC Goa,608,6,5,2,7,16,20,-4,17
Chennaiyin,608,7,4,5,5,16,21,-5,17
Kerala Blast,608,8,4,4,6,11,17,-6,16
Mumbai City,609,1,7,4,3,17,8,9,25
Delhi Dynamo,609,2,5,5,4,25,19,6,20
Kolkata,609,3,4,8,2,16,13,3,20
Kerala Blast,609,4,5,4,5,10,16,-6,19
FC Pune City,609,5,5,3,6,15,16,-1,18
NorthEast Un,609,6,5,2,7,12,13,-1,17
FC Goa,609,7,4,4,6,13,18,-5,16
Chennaiyin,609,8,3,6,5,15,20,-5,15
Delhi Dynamo,610,1,6,6,2,27,16,11,24
Mumbai City,610,2,6,5,3,17,9,8,23
Kerala Blast,610,3,6,4,4,11,13,-2,22
Chennaiyin,610,4,4,6,4,15,18,-3,18
Kolkata,610,5,3,7,4,15,16,-1,16
FC Pune City,610,6,4,4,6,13,16,-3,16
NorthEast Un,610,7,4,3,7,11,14,-3,15
FC Goa,610,8,4,3,7,10,17,-7,15
Mumbai City,611,1,7,4,3,19,9,10,25
Kolkata,611,2,5,6,3,17,15,2,21
Delhi Dynamo,611,3,4,6,4,25,21,4,18
NorthEast Un,611,4,5,3,6,13,13,0,18
FC Pune City,611,5,5,3,6,15,16,-1,18
FC Goa,611,6,5,3,6,15,17,-2,18
Chennaiyin,611,7,4,5,5,17,22,-5,17
Kerala Blast,611,8,4,4,6,10,18,-8,16
Mumbai City,612,1,7,4,3,18,9,9,25
Kolkata,612,2,4,7,3,15,13,2,19
Delhi Dynamo,612,3,4,6,4,22,17,5,18
FC Goa,612,4,5,3,6,10,14,-4,18
Kerala Blast,612,4,4,6,4,10,14,-4,18
NorthEast Un,612,6,4,5,5,10,10,0,17
Chennaiyin,612,7,3,7,4,13,17,-4,16
FC Pune City,612,8,4,4,6,12,16,-4,16
Mumbai City,613,1,7,4,3,18,9,9,25
Delhi Dynamo,613,2,6,5,3,30,19,11,23
Kolkata,613,3,5,7,2,16,12,4,22
Chennaiyin,613,4,5,5,4,18,18,0,20
Kerala Blast,613,5,5,4,5,10,15,-5,19
FC Pune City,613,6,4,4,6,12,15,-3,16
NorthEast Un,613,7,4,2,8,13,16,-3,14
FC Goa,613,8,3,3,8,8,21,-13,12
Delhi Dynamo,614,1,6,5,3,24,15,9,23
NorthEast Un,614,2,7,2,5,14,9,5,23
Mumbai City,614,3,6,4,4,16,9,7,22
Kolkata,614,4,3,8,3,16,16,0,17
FC Pune City,614,5,4,5,5,15,17,-2,17
FC Goa,614,6,5,2,7,11,16,-5,17
Kerala Blast,614,7,4,5,5,11,17,-6,17
Chennaiyin,614,8,3,5,6,13,21,-8,14
Delhi Dynamo,615,1,6,6,2,25,15,10,24
Mumbai City,615,2,6,5,3,16,8,8,23
FC Pune City,615,3,5,4,5,15,15,0,19
Kerala Blast,615,4,5,4,5,13,17,-4,19
Kolkata,615,5,3,8,3,17,18,-1,17
FC Goa,615,6,5,2,7,12,17,-5,17
NorthEast Un,615,7,4,3,7,10,13,-3,15
Chennaiyin,615,8,3,6,5,13,18,-5,15
Delhi Dynamo,616,1,7,5,2,29,16,13,26
Mumbai City,616,2,6,4,4,17,10,7,22
Kolkata,616,3,4,8,2,15,13,2,20
Chennaiyin,616,4,4,6,4,18,18,0,18
Kerala Blast,616,5,4,6,4,11,15,-4,18
FC Pune City,616,6,4,5,5,13,15,-2,17
NorthEast Un,616,7,4,3,7,10,17,-7,15
FC Goa,616,8,3,3,8,11,20,-9,12
Delhi Dynamo,617,1,6,6,2,29,17,12,24
Mumbai City,617,2,6,4,4,16,9,7,22
Kerala Blast,617,3,5,5,4,10,13,-3,20
Kolkata,617,4,4,7,3,15,13,2,19
NorthEast Un,617,5,5,4,5,12,11,1,19
FC Goa,617,6,5,2,7,11,19,-8,17
FC Pune City,617,7,4,3,7,12,17,-5,15
Chennaiyin,617,8,3,5,6,13,19,-6,14
Mumbai City,618,1,7,4,3,18,8,10,25
Kolkata,618,2,5,6,3,17,16,1,21
Kerala Blast,618,3,6,3,5,16,15,1,21
Delhi Dynamo,618,4,5,5,4,23,20,3,20
Chennaiyin,618,5,5,5,4,19,18,1,20
NorthEast Un,618,6,5,2,7,12,18,-6,17
FC Pune City,618,7,4,3,7,15,19,-4,15
FC Goa,618,8,4,2,8,12,18,-6,14
Mumbai City,619,1,7,4,3,19,9,10,25
Delhi Dynamo,619,2,5,6,3,25,19,6,21
Kolkata,619,3,4,8,2,16,14,2,20
NorthEast Un,619,4,5,4,5,16,14,2,19
Kerala Blast,619,5,5,4,5,13,17,-4,19
FC Pune City,619,6,4,4,6,12,15,-3,16
Chennaiyin,619,7,3,6,5,15,21,-6,15
FC Goa,619,8,3,4,7,10,17,-7,13
Mumbai City,620,1,6,5,3,16,8,8,23
Kolkata,620,2,4,8,2,17,15,2,20
Chennaiyin,620,3,5,5,4,17,17,0,20
Delhi Dynamo,620,4,4,7,3,24,18,6,19
Kerala Blast,620,5,5,4,5,11,15,-4,19
NorthEast Un,620,6,5,3,6,12,13,-1,18
FC Pune City,620,7,4,3,7,12,16,-4,15
FC Goa,620,8,4,3,7,12,19,-7,15
Mumbai City,621,1,6,4,4,17,10,7,22
Delhi Dynamo,621,2,5,5,4,24,19,5,20
NorthEast Un,621,3,6,2,6,14,13,1,20
Chennaiyin,621,4,5,5,4,17,19,-2,20
FC Pune City,621,5,5,4,5,14,15,-1,19
Kolkata,621,6,4,6,4,16,16,0,18
FC Goa,621,7,5,2,7,13,16,-3,17
Kerala Blast,621,8,4,4,6,12,19,-7,16
Mumbai City,622,1,6,5,3,17,9,8,23
Delhi Dynamo,622,2,5,6,3,25,18,7,21
FC Pune City,622,3,6,3,5,16,14,2,21
FC Goa,622,4,6,2,6,14,17,-3,20
Kerala Blast,622,5,5,4,5,11,16,-5,19
NorthEast Un,622,6,5,2,7,13,13,0,17
Kolkata,622,7,3,7,4,15,17,-2,16
Chennaiyin,622,8,3,5,6,15,22,-7,14
Mumbai City,623,1,6,5,3,16,8,8,23
Delhi Dynamo,623,2,5,7,2,25,17,8,22
Kolkata,623,3,4,8,2,16,14,2,20
Kerala Blast,623,4,5,5,4,15,15,0,20
NorthEast Un,623,5,4,4,6,11,12,-1,16
FC Pune City,623,6,4,4,6,12,18,-6,16
FC Goa,623,7,4,3,7,14,16,-2,15
Chennaiyin,623,8,3,6,5,13,22,-9,15
Delhi Dynamo,624,1,6,6,2,26,15,11,24
Mumbai City,624,2,6,4,4,16,10,6,22
Kolkata,624,3,5,6,3,17,15,2,21
Kerala Blast,624,4,6,3,5,14,15,-1,21
Chennaiyin,624,5,4,6,4,14,17,-3,18
NorthEast Un,624,6,4,3,7,11,13,-2,15
FC Pune City,624,7,4,3,7,13,19,-6,15
FC Goa,624,8,4,3,7,10,17,-7,15
Mumbai City,625,1,7,4,3,20,8,12,25
Kerala Blast,625,2,6,3,5,13,16,-3,21
NorthEast Un,625,3,6,2,6,15,13,2,20
Kolkata,625,4,4,7,3,15,16,-1,19
Chennaiyin,625,5,4,6,4,18,19,-1,18
Delhi Dynamo,625,6,4,5,5,21,22,-1,17
FC Pune City,625,7,4,4,6,12,15,-3,16
FC Goa,625,8,4,3,7,12,17,-5,15
Mumbai City,626,1,6,5,3,17,9,8,23
Delhi Dynamo,626,2,5,6,3,26,19,7,21
FC Pune City,626,3,5,4,5,14,14,0,19
NorthEast Un,626,4,5,3,6,12,12,0,18
Kolkata,626,5,3,8,3,13,13,0,17
Chennaiyin,626,6,4,5,5,15,19,-4,17
FC Goa,626,7,5,2,7,13,18,-5,17
Kerala Blast,626,8,4,5,5,10,16,-6,17
Delhi Dynamo,627,1,5,7,2,23,14,9,22
Mumbai City,627,2,6,4,4,16,10,6,22
Kerala Blast,627,3,6,4,4,18,17,1,22
FC Pune City,627,4,5,3,6,17,17,0,18
Kolkata,627,5,3,8,3,16,18,-2,17
NorthEast Un,627,6,4,4,6,10,14,-4,16
FC Goa,627,7,4,4,6,10,15,-5,16
Chennaiyin,627,8,3,6,5,14,19,-5,15
Kolkata,628,1,6,6,2,20,13,7,24
Mumbai City,628,2,6,5,3,16,8,8,23
Delhi Dynamo,628,3,5,6,3,23,16,7,21
NorthEast Un,628,4,5,4,5,13,11,2,19
FC Pune City,628,5,5,3,6,13,17,-4,18
Chennaiyin,628,6,3,7,4,15,19,-4,16
Kerala Blast,628,7,4,4,6,11,18,-7,16
FC Goa,628,8,3,3,8,9,18,-9,12
Delhi Dynamo,629,1,7,5,2,28,14,14,26
Mumbai City,629,2,6,4,4,16,11,5,22
Kerala Blast,629,3,6,4,4,15,17,-2,22
NorthEast Un,629,4,5,2,7,15,14,1,17
Kolkata,629,5,3,8,3,16,16,0,17
FC Goa,629,6,5,2,7,11,17,-6,17
FC Pune City,629,7,4,4,6,13,16,-3,16
Chennaiyin,629,8,3,5,6,14,23,-9,14
Mumbai City,630,1,6,5,3,17,9,8,23
Kolkata,630,2,5,7,2,19,14,5,22
Delhi Dynamo,630,3,5,6,3,24,19,5,21
NorthEast Un,630,4,6,2,6,14,10,4,20
Chennaiyin,630,5,4,6,4,14,17,-3,18
Kerala Blast,630,6,5,3,6,10,18,-8,18
FC Pune City,630,7,4,4,6,13,16,-3,16
FC Goa,630,8,3,3,8,10,18,-8,12
Mumbai City,631,1,7,4,3,17,8,9,25
Kolkata,631,2,5,6,3,18,14,4,21
FC Pune City,631,3,6,3,5,14,14,0,21
NorthEast Un,631,4,5,4,5,13,11,2,19
Chennaiyin,631,5,4,6,4,16,18,-2,18
Delhi Dynamo,631,6,4,5,5,21,19,2,17
Kerala Blast,631,7,4,4,6,10,17,-7,16
FC Goa,631,8,4,2,8,11,19,-8,14
Mumbai City,632,1,7,4,3,21,8,13,25
Kolkata,632,2,5,7,2,19,15,4,22
NorthEast Un,632,3,6,2,6,13,12,1,20
Delhi Dynamo,632,4,4,6,4,22,21,1,18
FC Pune City,632,5,5,3,6,14,17,-3,18
Chennaiyin,632,6,4,5,5,17,20,-3,17
FC Goa,632,7,4,4,6,13,18,-5,16
Kerala Blast,632,8,4,3,7,11,19,-8,15
Mumbai City,633,1,7,4,3,18,8,10,25
Kolkata,633,2,6,6,2,18,14,4,24
Delhi Dynamo,633,3,6,5,3,26,19,7,23
NorthEast Un,633,4,6,2,6,15,13,2,20
FC Pune City,633,5,4,4,6,14,17,-3,16
Kerala Blast,633,6,4,4,6,11,18,-7,16
FC Goa,633,7,4,2,8,14,19,-5,14
Chennaiyin,633,8,3,5,6,14,22,-8,14
Delhi Dynamo,634,1,6,5,3,26,17,9,23
Mumbai City,634,2,6,4,4,16,10,6,22
Kolkata,634,3,4,8,2,16,13,3,20
NorthEast Un,634,4,6,2,6,14,13,1,20
Chennaiyin,634,5,5,5,4,18,19,-1,20
FC Pune City,634,6,4,5,5,13,15,-2,17
Kerala Blast,634,7,4,4,6,11,19,-8,16
FC Goa,634,8,3,3,8,12,20,-8,12
Delhi Dynamo,635,1,6,6,2,28,19,9,24
Mumbai City,635,2,6,4,4,18,11,7,22
NorthEast Un,635,3,5,4,5,13,12,1,19
Kerala Blast,635,4,5,4,5,11,15,-4,19
FC Pune City,635,5,5,3,6,15,16,-1,18
Kolkata,635,6,3,8,3,16,17,-1,17
Chennaiyin,635,7,3,6,5,14,19,-5,15
FC Goa,635,8,4,3,7,11,17,-6,15
Mumbai City,636,1,6,4,4,16,9,7,22
Delhi Dynamo,636,2,5,6,3,24,19,5,21
NorthEast Un,636,3,5,4,5,14,11,3,19
FC Pune City,636,4,5,4,5,16,15,1,19
Kolkata,636,5,4,7,3,16,16,0,19
Chennaiyin,636,6,4,6,4,16,19,-3,18
Kerala Blast,636,7,4,4,6,10,18,-8,16
FC Goa,636,8,4,3,7,14,19,-5,15
Mumbai City,637,1,6,5,3,19,11,8,23
NorthEast Un,637,2,6,3,5,15,9,6,21
Kolkata,637,3,4,8,2,16,14,2,20
Delhi Dynamo,637,4,4,7,3,24,18,6,19
FC Pune City,637,5,5,4,5,16,17,-1,19
Chennaiyin,637,6,4,5,5,14,20,-6,17
Kerala Blast,637,7,4,4,6,12,20,-8,16
FC Goa,637,8,4,2,8,9,16,-7,14
Delhi Dynamo,638,1,6,5,3,26,18,8,23
Mumbai City,638,2,6,4,4,18,11,7,22
Kolkata,638,3,5,7,2,19,13,6,22
Kerala Blast,638,4,6,3,5,13,17,-4,21
NorthEast Un,638,5,5,2,7,12,14,-2,17
FC Pune City,638,6,4,4,6,13,17,-4,16
Chennaiyin,638,7,3,6,5,15,20,-5,15
FC Goa,638,8,4,3,7,11,17,-6,15
Mumbai City,639,1,6,5,3,17,9,8,23
FC Pune City,639,2,6,3,5,16,15,1,21
Delhi Dynamo,639,3,4,7,3,25,19,6,19
NorthEast Un,639,4,5,4,5,14,13,1,19
Kolkata,639,5,4,6,4,14,14,0,18
Chennaiyin,639,6,3,7,4,15,19,-4,16
FC Goa,639,7,4,4,6,10,15,-5,16
Kerala Blast,639,8,4,4,6,10,17,-7,16
Mumbai City,640,1,6,5,3,16,8,8,23
Delhi Dynamo,640,2,5,6,3,24,20,4,21
Kerala Blast,640,3,5,5,4,12,15,-3,20
FC Pune City,640,4,5,4,5,17,16,1,19
NorthEast Un,640,5,5,3,6,16,13,3,18
Kolkata,640,6,4,6,4,16,18,-2,18
Chennaiyin,640,7,4,5,5,16,20,-4,17
FC Goa,640,8,4,2,8,12,19,-7,14
Kerala Blast,641,1,7,3,4,17,14,3,24
Mumbai City,641,2,6,4,4,17,11,6,22
Delhi Dynamo,641,3,5,5,4,25,20,5,20
NorthEast Un,641,4,5,3,6,13,13,0,18
FC Goa,641,5,5,3,6,12,15,-3,18
Kolkata,641,6,3,8,3,14,15,-1,17
FC Pune City,641,7,4,4,6,12,16,-4,16
Chennaiyin,641,8,3,6,5,14,20,-6,15
Delhi Dynamo,642,1,5,7,2,24,16,8,22
Mumbai City,642,2,6,4,4,16,9,7,22
Kolkata,642,3,4,8,2,17,14,3,20
Kerala Blast,642,4,5,5,4,11,14,-3,20
NorthEast Un,642,5,5,3,6,11,11,0,18
FC Pune City,642,6,4,4,6,12,16,-4,16
FC Goa,642,7,4,4,6,12,17,-5,16
Chennaiyin,642,8,3,5,6,14,20,-6,14
Mumbai City,643,1,6,5,3,17,9,8,23
Delhi Dynamo,643,2,5,6,3,25,16,9,21
Kolkata,643,3,5,6,3,19,15,4,21
Kerala Blast,643,4,5,4,5,12,16,-4,19
NorthEast Un,643,5,5,3,6,11,13,-2,18
FC Goa,643,6,5,2,7,13,16,-3,17
FC Pune City,643,7,4,4,6,14,19,-5,16
Chennaiyin,643,8,3,6,5,13,20,-7,15
Mumbai City,644,1,6,4,4,16,11,5,22
Delhi Dynamo,644,2,5,6,3,25,16,9,21
NorthEast Un,644,3,5,4,5,14,13,1,19
Kerala Blast,644,4,5,4,5,11,15,-4,19
FC Pune City,644,5,5,3,6,16,16,0,18
Kolkata,644,6,3,8,3,15,17,-2,17
Chennaiyin,644,7,3,7,4,16,20,-4,16
FC Goa,644,8,4,4,6,11,16,-5,16
Mumbai City,645,1,7,4,3,18,8,10,25
Kerala Blast,645,2,6,4,4,15,17,-2,22
Delhi Dynamo,645,3,5,6,3,24,17,7,21
FC Pune City,645,4,5,4,5,15,15,0,19
FC Goa,645,5,5,2,7,11,16,-5,17
NorthEast Un,645,6,4,4,6,12,13,-1,16
Kolkata,645,7,3,6,5,15,19,-4,15
Chennaiyin,645,8,3,6,5,14,19,-5,15
Mumbai City,646,1,6,5,3,18,10,8,23
Delhi Dynamo,646,2,5,7,2,26,17,9,22
Kerala Blast,646,3,6,3,5,12,15,-3,21
Kolkata,646,4,4,6,4,14,14,0,18
Chennaiyin,646,5,4,6,4,17,18,-1,18
NorthEast Un,646,6,5,3,6,13,15,-2,18
FC Pune City,646,7,4,3,7,12,16,-4,15
FC Goa,646,8,4,3,7,9,16,-7,15
Mumbai City,647,1,6,5,3,18,10,8,23
Kolkata,647,2,5,6,3,20,17,3,21
Delhi Dynamo,647,3,4,8,2,24,17,7,20
Kerala Blast,647,4,5,4,5,14,15,-1,19
Chennaiyin,647,5,4,6,4,16,18,-2,18
NorthEast Un,647,6,4,4,6,9,11,-2,16
FC Goa,647,7,4,4,6,13,16,-3,16
FC Pune City,647,8,4,3,7,13,23,-10,15
Delhi Dynamo,648,1,6,6,2,28,16,12,24
Kolkata,648,2,6,6,2,20,15,5,24
Mumbai City,648,3,6,4,4,16,10,6,22
FC Pune City,648,4,5,3,6,14,17,-3,18
Kerala Blast,648,5,5,3,6,15,19,-4,18
NorthEast Un,648,6,4,4,6,11,13,-2,16
Chennaiyin,648,7,3,7,4,15,19,-4,16
FC Goa,648,8,3,3,8,12,22,-10,12
Mumbai City,649,1,6,4,4,16,10,6,22
Delhi Dynamo,649,2,5,6,3,26,18,8,21
Kerala Blast,649,3,6,3,5,12,15,-3,21
Chennaiyin,649,4,5,5,4,19,17,2,20
Kolkata,649,5,4,7,3,17,13,4,19
NorthEast Un,649,6,5,3,6,12,15,-3,18
FC Pune City,649,7,4,4,6,12,16,-4,16
FC Goa,649,8,4,2,8,11,21,-10,14
Mumbai City,650,1,7,4,3,18,8,10,25
Delhi Dynamo,650,2,5,6,3,25,17,8,21
Kolkata,650,3,5,6,3,16,14,2,21
FC Goa,650,4,5,3,6,14,15,-1,18
NorthEast Un,650,5,5,2,7,11,15,-4,17
Chennaiyin,650,6,4,5,5,16,22,-6,17
FC Pune City,650,7,4,4,6,14,17,-3,16
Kerala Blast,650,8,4,4,6,12,18,-6,16
Delhi Dynamo,651,1,6,6,2,27,14,13,24
Mumbai City,651,2,6,4,4,16,11,5,22
Kolkata,651,3,5,6,3,17,14,3,21
NorthEast Un,651,4,5,4,5,13,12,1,19
Kerala Blast,651,5,5,3,6,12,17,-5,18
Chennaiyin,651,6,3,7,4,15,19,-4,16
FC Pune City,651,7,4,3,7,13,18,-5,15
FC Goa,651,8,4,3,7,9,17,-8,15
Delhi Dynamo,652,1,7,5,2,29,18,11,26
Mumbai City,652,2,6,4,4,16,9,7,22
Kolkata,652,3,5,7,2,18,15,3,22
Kerala Blast,652,4,5,4,5,11,14,-3,19
FC Pune City,652,5,4,4,6,13,16,-3,16
Chennaiyin,652,6,3,7,4,13,17,-4,16
NorthEast Un,652,7,4,3,7,10,14,-4,15
FC Goa,652,8,3,4,7,13,20,-7,13
Delhi Dynamo,653,1,7,5,2,29,16,13,26
Mumbai City,653,2,6,4,4,16,9,7,22
Kerala Blast,653,3,5,5,4,12,15,-3,20
Kolkata,653,4,4,7,3,17,14,3,19
FC Pune City,653,5,4,5,5,12,14,-2,17
Chennaiyin,653,6,4,5,5,17,20,-3,17
NorthEast Un,653,7,4,3,7,13,17,-4,15
FC Goa,653,8,4,2,8,10,21,-11,14
Mumbai City,654,1,7,4,3,17,8,9,25
Kerala Blast,654,2,6,4,4,13,15,-2,22
FC Pune City,654,3,5,4,5,14,15,-1,19
Delhi Dynamo,654,4,4,6,4,25,22,3,18
NorthEast Un,654,5,5,3,6,16,14,2,18
Kolkata,654,6,3,7,4,14,15,-1,16
FC Goa,654,7,4,4,6,15,18,-3,16
Chennaiyin,654,8,3,6,5,15,22,-7,15
Delhi Dynamo,655,1,6,5,3,24,18,6,23
Mumbai City,655,2,6,4,4,16,9,7,22
Kerala Blast,655,3,6,3,5,14,19,-5,21
Kolkata,655,4,4,8,2,20,16,4,20
NorthEast Un,655,5,5,2,7,13,14,-1,17
FC Pune City,655,6,4,4,6,15,18,-3,16
FC Goa,655,7,4,4,6,13,16,-3,16
Chennaiyin,655,8,3,6,5,15,20,-5,15
Mumbai City,656,1,7,4,3,20,10,10,25
Delhi Dynamo,656,2,6,5,3,27,19,8,23
Kolkata,656,3,5,6,3,19,15,4,21
Chennaiyin,656,4,5,5,4,18,18,0,20
Kerala Blast,656,5,5,4,5,13,18,-5,19
FC Pune City,656,6,5,3,6,13,16,-3,18
NorthEast Un,656,7,4,3,7,10,14,-4,15
FC Goa,656,8,3,2,9,11,21,-10,11
Mumbai City,657,1,7,4,3,17,8,9,25
Kolkata,657,2,5,6,3,15,13,2,21
Kerala Blast,657,3,6,3,5,11,14,-3,21
Delhi Dynamo,657,4,5,5,4,23,16,7,20
NorthEast Un,657,5,5,3,6,10,10,0,18
FC Goa,657,6,5,2,7,12,17,-5,17
FC Pune City,657,7,4,3,7,12,16,-4,15
Chennaiyin,657,8,3,6,5,14,20,-6,15
Mumbai City,658,1,6,5,3,16,8,8,23
Delhi Dynamo,658,2,5,7,2,27,19,8,22
FC Pune City,658,3,6,3,5,18,16,2,21
NorthEast Un,658,4,5,3,6,14,14,0,18
FC Goa,658,5,5,3,6,15,16,-1,18
Kolkata,658,6,4,6,4,17,20,-3,18
Chennaiyin,658,7,3,6,5,14,19,-5,15
Kerala Blast,658,8,4,3,7,10,19,-9,15
Mumbai City,659,1,6,5,3,16,8,8,23
Kolkata,659,2,5,6,3,17,14,3,21
Kerala Blast,659,3,6,3,5,15,16,-1,21
Delhi Dynamo,659,4,4,7,3,21,16,5,19
FC Pune City,659,5,5,3,6,15,16,-1,18
NorthEast Un,659,6,5,2,7,12,15,-3,17
Chennaiyin,659,7,4,5,5,15,19,-4,17
FC Goa,659,8,4,3,7,10,17,-7,15
Mumbai City,660,1,6,5,3,17,9,8,23
Kolkata,660,2,5,7,2,15,12,3,22
Delhi Dynamo,660,3,5,6,3,25,18,7,21
Kerala Blast,660,4,5,4,5,10,14,-4,19
NorthEast Un,660,5,5,3,6,12,12,0,18
Chennaiyin,660,6,4,5,5,15,19,-4,17
FC Pune City,660,7,4,3,7,12,16,-4,15
FC Goa,660,8,4,3,7,10,16,-6,15
Mumbai City,661,1,6,4,4,17,10,7,22
Kolkata,661,2,5,6,3,18,15,3,21
NorthEast Un,661,3,6,3,5,14,11,3,21
Delhi Dynamo,661,4,5,5,4,24,18,6,20
FC Pune City,661,5,5,3,6,15,17,-2,18
Kerala Blast,661,6,5,3,6,12,18,-6,18
FC Goa,661,7,5,2,7,11,17,-6,17
Chennaiyin,661,8,3,6,5,14,19,-5,15
Mumbai City,662,1,7,4,3,19,8,11,25
Delhi Dynamo,662,2,6,5,3,24,18,6,23
Kolkata,662,3,5,7,2,19,12,7,22
FC Pune City,662,4,5,3,6,14,19,-5,18
NorthEast Un,662,5,5,2,7,12,12,0,17
Chennaiyin,662,6,4,5,5,14,19,-5,17
FC Goa,662,7,4,3,7,10,15,-5,15
Kerala Blast,662,8,4,3,7,10,19,-9,15
Mumbai City,663,1,7,4,3,20,9,11,25
Kolkata,663,2,5,6,3,17,15,2,21
Delhi Dynamo,663,3,4,7,3,24,20,4,19
NorthEast Un,663,4,5,4,5,14,13,1,19
Kerala Blast,663,5,5,4,5,12,16,-4,19
Chennaiyin,663,6,4,5,5,18,21,-3,17
FC Pune City,663,7,4,3,7,12,17,-5,15
FC Goa,663,8,4,3,7,12,18,-6,15
Delhi Dynamo,664,1,6,6,2,31,18,13,24
Mumbai City,664,2,6,4,4,18,13,5,22
Kerala Blast,664,3,6,3,5,14,15,-1,21
Kolkata,664,4,4,7,3,17,14,3,19
NorthEast Un,664,5,5,4,5,15,14,1,19
Chennaiyin,664,6,4,6,4,16,19,-3,18
FC Pune City,664,7,4,4,6,13,18,-5,16
FC Goa,664,8,3,2,9,8,21,-13,11
Delhi Dynamo,665,1,5,7,2,27,18,9,22
Mumbai City,665,2,6,4,4,17,11,6,22
Kerala Blast,665,3,6,3,5,14,17,-3,21
FC Pune City,665,4,5,4,5,15,16,-1,19
NorthEast Un,665,5,5,3,6,16,15,1,18
Kolkata,665,6,3,8,3,14,14,0,17
Chennaiyin,665,7,4,5,5,17,22,-5,17
FC Goa,665,8,3,4,7,11,18,-7,13
Delhi Dynamo,666,1,7,5,2,29,16,13,26
Mumbai City,666,2,6,4,4,16,11,5,22
FC Pune City,666,3,6,3,5,15,15,0,21
Kolkata,666,4,4,7,3,19,17,2,19
Chennaiyin,666,5,4,6,4,17,20,-3,18
Kerala Blast,666,6,4,4,6,10,17,-7,16
NorthEast Un,666,7,4,3,7,11,13,-2,15
FC Goa,666,8,3,4,7,13,21,-8,13
Delhi Dynamo,667,1,6,5,3,28,18,10,23
Mumbai City,667,2,6,4,4,16,11,5,22
FC Pune City,667,3,5,4,5,14,14,0,19
Kerala Blast,667,4,5,4,5,12,18,-6,19
Kolkata,667,5,4,6,4,17,16,1,18
Chennaiyin,667,6,4,6,4,16,18,-2,18
FC Goa,667,7,5,2,7,12,18,-6,17
NorthEast Un,667,8,4,3,7,12,14,-2,15
Mumbai City,668,1,7,4,3,18,9,9,25
Kerala Blast,668,2,5,5,4,10,13,-3,20
FC Pune City,668,3,5,4,5,13,14,-1,19
FC Goa,668,4,5,3,6,12,15,-3,18
Delhi Dynamo,668,5,4,5,5,22,19,3,17
Kolkata,668,6,3,8,3,14,14,0,17
NorthEast Un,668,7,5,2,7,12,12,0,17
Chennaiyin,668,8,4,5,5,15,20,-5,17
Delhi Dynamo,669,1,5,7,2,23,15,8,22
Mumbai City,669,2,6,4,4,17,10,7,22
Kerala Blast,669,3,5,5,4,12,14,-2,20
Kolkata,669,4,4,7,3,15,14,1,19
FC Goa,669,5,5,3,6,11,15,-4,18
Chennaiyin,669,6,4,5,5,16,20,-4,17
FC Pune City,669,7,4,4,6,12,15,-3,16
NorthEast Un,669,8,4,3,7,10,13,-3,15
Mumbai City,670,1,7,4,3,17,8,9,25
Kerala Blast,670,2,6,4,4,13,15,-2,22
Delhi Dynamo,670,3,5,6,3,25,18,7,21
Kolkata,670,4,4,6,4,14,16,-2,18
NorthEast Un,670,5,5,2,7,16,15,1,17
Chennaiyin,670,6,4,5,5,15,21,-6,17
FC Pune City,670,7,4,4,6,13,16,-3,16
FC Goa,670,8,4,3,7,12,16,-4,15
Kolkata,671,1,6,6,2,21,14,7,24
Mumbai City,671,2,6,5,3,18,10,8,23
Delhi Dynamo,671,3,5,6,3,25,20,5,21
Kerala Blast,671,4,5,4,5,12,19,-7,19
NorthEast Un,671,5,5,3,6,13,11,2,18
FC Pune City,671,6,4,4,6,14,17,-3,16
Chennaiyin,671,7,3,6,5,16,21,-5,15
FC Goa,671,8,4,2,8,14,21,-7,14
Delhi Dynamo,672,1,6,6,2,26,17,9,24
Mumbai City,672,2,6,5,3,18,10,8,23
Kerala Blast,672,3,6,4,4,13,14,-1,22
Kolkata,672,4,4,6,4,15,15,0,18
FC Goa,672,5,5,2,7,14,16,-2,17
Chennaiyin,672,6,4,5,5,14,20,-6,17
NorthEast Un,672,7,4,3,7,9,11,-2,15
FC Pune City,672,8,4,3,7,13,19,-6,15
Mumbai City,673,1,7,4,3,18,8,10,25
Kerala Blast,673,2,7,3,4,16,15,1,24
Kolkata,673,3,5,6,3,18,16,2,21
Delhi Dynamo,673,4,5,5,4,23,17,6,20
Chennaiyin,673,5,4,6,4,17,19,-2,18
FC Pune City,673,6,4,3,7,12,18,-6,15
FC Goa,673,7,4,3,7,11,17,-6,15
NorthEast Un,673,8,4,2,8,10,15,-5,14
Delhi Dynamo,674,1,6,5,3,27,18,9,23
Mumbai City,674,2,6,4,4,18,11,7,22
Kolkata,674,3,5,7,2,19,16,3,22
Kerala Blast,674,4,6,3,5,16,18,-2,21
NorthEast Un,674,5,5,3,6,13,14,-1,18
Chennaiyin,674,6,4,6,4,15,18,-3,18
FC Pune City,674,7,4,4,6,15,18,-3,16
FC Goa,674,8,3,2,9,10,20,-10,11
Mumbai City,675,1,7,4,3,20,8,12,25
Delhi Dynamo,675,2,6,5,3,26,20,6,23
Chennaiyin,675,3,5,5,4,17,18,-1,20
Kerala Blast,675,4,5,4,5,12,14,-2,19
Kolkata,675,5,4,6,4,15,18,-3,18
FC Pune City,675,6,5,3,6,14,17,-3,18
NorthEast Un,675,7,4,3,7,10,12,-2,15
FC Goa,675,8,4,2,8,14,21,-7,14
Mumbai City,676,1,7,4,3,20,8,12,25
FC Pune City,676,2,6,3,5,19,16,3,21
Kerala Blast,676,3,6,3,5,12,18,-6,21
Chennaiyin,676,4,5,5,4,17,18,-1,20
Delhi Dynamo,676,5,4,7,3,25,22,3,19
Kolkata,676,6,4,6,4,22,17,5,18
NorthEast Un,676,7,4,3,7,12,14,-2,15
FC Goa,676,8,3,3,8,10,24,-14,12
Mumbai City,677,1,6,5,3,16,8,8,23
Delhi Dynamo,677,2,5,7,2,24,16,8,22
Kolkata,677,3,5,6,3,16,15,1,21
NorthEast Un,677,4,5,4,5,10,9,1,19
Kerala Blast,677,5,5,4,5,11,15,-4,19
FC Goa,677,6,5,2,7,13,17,-4,17
FC Pune City,677,7,4,3,7,12,16,-4,15
Chennaiyin,677,8,3,5,6,13,19,-6,14
Mumbai City,678,1,6,4,4,17,10,7,22
Delhi Dynamo,678,2,5,6,3,24,19,5,21
Kerala Blast,678,3,6,3,5,13,14,-1,21
NorthEast Un,678,4,6,2,6,15,12,3,20
Kolkata,678,5,4,8,2,16,14,2,20
Chennaiyin,678,6,4,5,5,16,20,-4,17
FC Pune City,678,7,4,4,6,13,18,-5,16
FC Goa,678,8,3,4,7,10,17,-7,13
Mumbai City,679,1,6,5,3,16,8,8,23
Delhi Dynamo,679,2,5,7,2,24,16,8,22
Kerala Blast,679,3,6,3,5,12,15,-3,21
Chennaiyin,679,4,5,5,4,17,19,-2,20
Kolkata,679,5,4,6,4,17,15,2,18
NorthEast Un,679,6,5,2,7,12,13,-1,17
FC Goa,679,7,4,3,7,13,19,-6,15
FC Pune City,679,8,4,3,7,12,18,-6,15
Mumbai City,680,1,7,4,3,18,8,10,25
Kerala Blast,680,2,6,4,4,14,14,0,22
Delhi Dynamo,680,3,5,6,3,23,17,6,21
Kolkata,680,4,4,8,2,17,13,4,20
Chennaiyin,680,5,3,7,4,16,20,-4,16
NorthEast Un,680,6,4,3,7,10,12,-2,15
FC Pune City,680,7,4,3,7,12,20,-8,15
FC Goa,680,8,3,5,6,11,17,-6,14
Delhi Dynamo,681,1,6,6,2,27,17,10,24
Kerala Blast,681,2,7,3,4,19,15,4,24
Mumbai City,681,3,6,4,4,18,11,7,22
Kolkata,681,4,5,6,3,18,16,2,21
Chennaiyin,681,5,4,5,5,16,20,-4,17
NorthEast Un,681,6,5,2,7,11,15,-4,17
FC Pune City,681,7,4,3,7,12,18,-6,15
FC Goa,681,8,3,3,8,10,19,-9,12
Mumbai City,682,1,6,5,3,17,9,8,23
Delhi Dynamo,682,2,5,6,3,27,17,10,21
Kolkata,682,3,5,6,3,18,14,4,21
Kerala Blast,682,4,6,3,5,15,16,-1,21
Chennaiyin,682,5,4,6,4,17,19,-2,18
NorthEast Un,682,6,5,2,7,12,15,-3,17
FC Pune City,682,7,4,3,7,12,19,-7,15
FC Goa,682,8,4,3,7,11,20,-9,15
Mumbai City,683,1,7,4,3,18,8,10,25
Kerala Blast,683,2,6,4,4,14,14,0,22
FC Goa,683,3,6,2,6,14,16,-2,20
Delhi Dynamo,683,4,4,6,4,24,20,4,18
Kolkata,683,5,4,6,4,14,15,-1,18
Chennaiyin,683,6,4,5,5,14,19,-5,17
FC Pune City,683,7,4,4,6,12,15,-3,16
NorthEast Un,683,8,4,3,7,11,14,-3,15
Mumbai City,684,1,7,4,3,17,8,9,25
Kolkata,684,2,5,6,3,16,14,2,21
NorthEast Un,684,3,6,2,6,15,13,2,20
Chennaiyin,684,4,5,5,4,17,18,-1,20
Delhi Dynamo,684,5,4,6,4,24,19,5,18
FC Pune City,684,6,4,4,6,13,17,-4,16
Kerala Blast,684,7,4,4,6,10,18,-8,16
FC Goa,684,8,4,3,7,12,17,-5,15
Mumbai City,685,1,6,4,4,16,9,7,22
Kerala Blast,685,2,6,4,4,18,17,1,22
Delhi Dynamo,685,3,5,5,4,24,19,5,20
Chennaiyin,685,4,5,5,4,18,20,-2,20
NorthEast Un,685,5,5,3,6,13,12,1,18
FC Pune City,685,6,5,3,6,17,21,-4,18
Kolkata,685,7,3,7,4,20,22,-2,16
FC Goa,685,8,4,3,7,15,21,-6,15
Kolkata,686,1,6,6,2,21,15,6,24
Delhi Dynamo,686,2,6,5,3,25,18,7,23
Mumbai City,686,3,6,4,4,16,9,7,22
Kerala Blast,686,4,5,4,5,13,17,-4,19
FC Goa,686,5,5,2,7,14,17,-3,17
NorthEast Un,686,6,5,2,7,11,14,-3,17
FC Pune City,686,7,4,4,6,15,18,-3,16
Chennaiyin,686,8,3,5,6,13,20,-7,14
Mumbai City,687,1,7,4,3,18,8,10,25
Delhi Dynamo,687,2,6,5,3,26,16,10,23
Kolkata,687,3,5,6,3,19,14,5,21
Kerala Blast,687,4,5,4,5,11,15,-4,19
NorthEast Un,687,5,5,3,6,10,11,-1,18
FC Goa,687,6,5,2,7,13,18,-5,17
FC Pune City,687,7,4,3,7,13,20,-7,15
Chennaiyin,687,8,3,5,6,14,22,-8,14
Mumbai City,688,1,6,5,3,19,11,8,23
Kolkata,688,2,5,7,2,18,13,5,22
NorthEast Un,688,3,6,3,5,13,10,3,21
Delhi Dynamo,688,4,4,7,3,26,21,5,19
Chennaiyin,688,5,4,5,5,15,19,-4,17
Kerala Blast,688,6,4,5,5,11,17,-6,17
FC Pune City,688,7,4,4,6,15,19,-4,16
FC Goa,688,8,3,4,7,10,17,-7,13
Delhi Dynamo,689,1,6,6,2,26,16,10,24
Kerala Blast,689,2,7,3,4,15,15,0,24
Mumbai City,689,3,6,4,4,16,9,7,22
Kolkata,689,4,4,6,4,17,18,-1,18
FC Pune City,689,5,5,3,6,14,16,-2,18
NorthEast Un,689,6,5,2,7,14,15,-1,17
Chennaiyin,689,7,3,6,5,14,20,-6,15
FC Goa,689,8,3,4,7,10,17,-7,13
Kolkata,690,1,6,6,2,20,16,4,24
Mumbai City,690,2,6,5,3,18,10,8,23
Delhi Dynamo,690,3,5,6,3,28,21,7,21
NorthEast Un,690,4,6,2,6,14,14,0,20
Kerala Blast,690,5,5,3,6,12,17,-5,18
Chennaiyin,690,6,4,5,5,16,19,-3,17
FC Pune City,690,7,4,3,7,14,18,-4,15
FC Goa,690,8,4,2,8,15,22,-7,14
Delhi Dynamo,691,1,7,5,2,30,18,12,26
Kolkata,691,2,5,7,2,19,13,6,22
Mumbai City,691,2,6,4,4,19,13,6,22
Kerala Blast,691,4,5,4,5,12,17,-5,19
NorthEast Un,691,5,5,2,7,12,11,1,17
Chennaiyin,691,6,4,5,5,14,18,-4,17
FC Pune City,691,7,4,3,7,12,20,-8,15
FC Goa,691,8,4,2,8,10,18,-8,14
Mumbai City,692,1,7,4,3,19,9,10,25
Kerala Blast,692,2,6,4,4,14,15,-1,22
Delhi Dynamo,692,3,5,5,4,27,21,6,20
NorthEast Un,692,4,6,2,6,15,14,1,20
Kolkata,692,5,4,7,3,17,16,1,19
FC Goa,692,6,5,2,7,13,19,-6,17
FC Pune City,692,7,4,3,7,13,18,-5,15
Chennaiyin,692,8,3,5,6,15,21,-6,14
Delhi Dynamo,693,1,5,7,2,25,16,9,22
Mumbai City,693,2,6,4,4,17,11,6,22
Kolkata,693,3,4,8,2,17,13,4,20
Kerala Blast,693,4,5,5,4,11,14,-3,20
Chennaiyin,693,5,4,5,5,15,22,-7,17
NorthEast Un,693,6,4,4,6,10,11,-1,16
FC Goa,693,7,4,4,6,14,16,-2,16
FC Pune City,693,8,4,3,7,13,19,-6,15
Delhi Dynamo,694,1,6,5,3,29,19,10,23
NorthEast Un,694,2,7,2,5,15,12,3,23
Mumbai City,694,3,6,4,4,17,11,6,22
FC Pune City,694,4,6,3,5,15,15,0,21
Kolkata,694,5,3,8,3,16,16,0,17
Kerala Blast,694,6,4,4,6,10,16,-6,16
Chennaiyin,694,7,3,6,5,14,19,-5,15
FC Goa,694,8,3,4,7,10,18,-8,13
Mumbai City,695,1,7,4,3,17,8,9,25
Kolkata,695,2,5,7,2,20,16,4,22
Kerala Blast,695,3,6,3,5,12,15,-3,21
NorthEast Un,695,4,6,2,6,13,11,2,20
Delhi Dynamo,695,5,4,6,4,21,17,4,18
FC Goa,695,6,4,4,6,13,17,-4,16
FC Pune City,695,7,4,3,7,13,18,-5,15
Chennaiyin,695,8,3,5,6,13,20,-7,14
Delhi Dynamo,696,1,7,5,2,31,17,14,26
Mumbai City,696,2,6,4,4,18,11,7,22
Kolkata,696,3,5,6,3,18,17,1,21
Kerala Blast,696,4,5,4,5,12,15,-3,19
FC Pune City,696,5,5,3,6,15,17,-2,18
NorthEast Un,696,6,4,4,6,12,14,-2,16
Chennaiyin,696,7,3,7,4,16,20,-4,16
FC Goa,696,8,3,3,8,10,21,-11,12
Mumbai City,697,1,6,5,3,16,8,8,23
Delhi Dynamo,697,2,5,6,3,25,17,8,21
Chennaiyin,697,3,5,5,4,16,17,-1,20
Kerala Blast,697,4,5,4,5,10,14,-4,19
Kolkata,697,5,4,6,4,15,16,-1,18
NorthEast Un,697,6,5,2,7,10,13,-3,17
FC Goa,697,7,5,2,7,14,18,-4,17
FC Pune City,697,8,4,4,6,12,15,-3,16
Mumbai City,698,1,7,4,3,17,8,9,25
Kolkata,698,2,5,7,2,20,13,7,22
Delhi Dynamo,698,3,5,6,3,22,15,7,21
FC Pune City,698,4,5,4,5,13,14,-1,19
Chennaiyin,698,5,4,5,5,16,21,-5,17
Kerala Blast,698,6,4,4,6,10,18,-8,16
NorthEast Un,698,7,4,3,7,11,13,-2,15
FC Goa,698,8,4,3,7,12,19,-7,15
Mumbai City,699,1,7,4,3,17,8,9,25
Delhi Dynamo,699,2,6,5,3,24,16,8,23
Kerala Blast,699,3,5,5,4,13,16,-3,20
Kolkata,699,4,3,8,3,16,17,-1,17
NorthEast Un,699,5,4,4,6,11,12,-1,16
FC Pune City,699,6,4,4,6,15,18,-3,16
Chennaiyin,699,7,3,7,4,15,19,-4,16
FC Goa,699,8,4,3,7,12,17,-5,15
Delhi Dynamo,700,1,6,5,3,25,17,8,23
Mumbai City,700,2,6,4,4,16,10,6,22
FC Pune City,700,3,6,3,5,17,17,0,21
NorthEast Un,700,4,5,3,6,12,11,1,18
Kolkata,700,5,4,6,4,18,19,-1,18
Kerala Blast,700,6,5,3,6,13,18,-5,18
FC Goa,700,7,5,2,7,15,18,-3,17
Chennaiyin,700,8,3,6,5,14,20,-6,15
Delhi Dynamo,701,1,6,5,3,28,16,12,23
Mumbai City,701,2,6,4,4,16,12,4,22
Kolkata,701,3,5,6,3,17,15,2,21
NorthEast Un,701,4,6,2,6,13,14,-1,20
Kerala Blast,701,5,5,4,5,10,14,-4,19
Chennaiyin,701,6,4,5,5,18,20,-2,17
FC Pune City,701,7,4,4,6,13,16,-3,16
FC Goa,701,8,4,2,8,11,19,-8,14
Mumbai City,702,1,7,4,3,17,8,9,25
Delhi Dynamo,702,2,6,5,3,26,17,9,23
Kerala Blast,702,3,6,4,4,14,16,-2,22
Kolkata,702,4,4,8,2,22,14,8,20
Chennaiyin,702,5,5,5,4,19,18,1,20
FC Pune City,702,6,4,3,7,13,23,-10,15
NorthEast Un,702,7,4,2,8,11,17,-6,14
FC Goa,702,8,3,3,8,11,20,-9,12
Mumbai City,703,1,6,5,3,17,9,8,23
Kolkata,703,2,5,6,3,21,16,5,21
FC Pune City,703,3,5,4,5,15,15,0,19
Kerala Blast,703,4,5,4,5,14,16,-2,19
Delhi Dynamo,703,5,4,6,4,24,19,5,18
NorthEast Un,703,6,5,3,6,13,15,-2,18
FC Goa,703,7,5,2,7,13,20,-7,17
Chennaiyin,703,8,3,6,5,14,21,-7,15
Mumbai City,704,1,7,4,3,18,8,10,25
Delhi Dynamo,704,2,5,6,3,25,18,7,21
Chennaiyin,704,3,4,6,4,17,20,-3,18
Kerala Blast,704,4,4,6,4,13,17,-4,18
Kolkata,704,5,3,8,3,16,16,0,17
FC Pune City,704,6,4,5,5,13,15,-2,17
NorthEast Un,704,7,4,4,6,13,14,-1,16
FC Goa,704,8,4,3,7,12,19,-7,15
Mumbai City,705,1,7,4,3,19,9,10,25
Kolkata,705,2,5,7,2,18,13,5,22
Chennaiyin,705,3,5,5,4,17,18,-1,20
Kerala Blast,705,4,5,4,5,14,17,-3,19
Delhi Dynamo,705,5,4,5,5,22,20,2,17
NorthEast Un,705,6,5,2,7,12,15,-3,17
FC Pune City,705,7,4,4,6,13,17,-4,16
FC Goa,705,8,4,3,7,9,15,-6,15
Mumbai City,706,1,7,4,3,17,8,9,25
Kerala Blast,706,2,7,3,4,16,16,0,24
Delhi Dynamo,706,3,5,6,3,23,16,7,21
Kolkata,706,4,4,6,4,16,17,-1,18
Chennaiyin,706,5,4,6,4,17,19,-2,18
FC Pune City,706,6,5,3,6,16,18,-2,18
NorthEast Un,706,7,4,3,7,12,15,-3,15
FC Goa,706,8,3,3,8,9,17,-8,12
Mumbai City,707,1,7,4,3,17,8,9,25
FC Pune City,707,2,6,3,5,15,14,1,21
Delhi Dynamo,707,3,5,5,4,22,17,5,20
FC Goa,707,4,6,2,6,17,14,3,20
NorthEast Un,707,5,5,3,6,14,14,0,18
Kolkata,707,6,4,6,4,14,15,-1,18
Kerala Blast,707,7,4,3,7,10,18,-8,15
Chennaiyin,707,8,3,6,5,16,25,-9,15
Delhi Dynamo,708,1,6,5,3,26,19,7,23
Mumbai City,708,2,6,4,4,18,11,7,22
Kolkata,708,3,5,6,3,18,15,3,21
Chennaiyin,708,4,5,5,4,22,20,2,20
Kerala Blast,708,5,5,4,5,12,16,-4,19
FC Pune City,708,6,5,3,6,13,15,-2,18
NorthEast Un,708,7,5,3,6,12,14,-2,18
FC Goa,708,8,3,2,9,13,24,-11,11
Mumbai City,709,1,6,5,3,18,10,8,23
Kerala Blast,709,2,6,4,4,15,14,1,22
Delhi Dynamo,709,3,5,6,3,25,19,6,21
Kolkata,709,4,5,6,3,19,16,3,21
Chennaiyin,709,5,5,5,4,15,17,-2,20
NorthEast Un,709,6,5,2,7,11,14,-3,17
FC Pune City,709,7,4,4,6,15,19,-4,16
FC Goa,709,8,3,2,9,10,19,-9,11
Delhi Dynamo,710,1,6,6,2,25,15,10,24
Mumbai City,710,2,6,5,3,17,9,8,23
Kolkata,710,3,4,8,2,16,13,3,20
NorthEast Un,710,4,6,2,6,12,11,1,20
Kerala Blast,710,5,5,3,6,11,17,-6,18
Chennaiyin,710,6,4,5,5,14,19,-5,17
FC Pune City,710,7,4,4,6,14,17,-3,16
FC Goa,710,8,3,3,8,8,16,-8,12
Mumbai City,711,1,6,5,3,17,9,8,23
Delhi Dynamo,711,2,4,8,2,25,18,7,20
NorthEast Un,711,3,5,4,5,15,13,2,19
Kerala Blast,711,4,5,4,5,13,16,-3,19
Chennaiyin,711,5,4,6,4,18,21,-3,18
FC Pune City,711,6,4,5,5,15,17,-2,17
Kolkata,711,7,3,7,4,15,18,-3,16
FC Goa,711,8,4,3,7,12,18,-6,15
Mumbai City,712,1,6,5,3,17,9,8,23
NorthEast Un,712,2,6,3,5,16,12,4,21
Kolkata,712,3,4,8,2,20,17,3,20
Delhi Dynamo,712,4,4,7,3,25,19,6,19
FC Pune City,712,5,4,5,5,15,17,-2,17
Chennaiyin,712,6,4,5,5,15,20,-5,17
Kerala Blast,712,7,4,5,5,12,18,-6,17
FC Goa,712,8,3,4,7,11,19,-8,13
Mumbai City,713,1,7,4,3,19,9,10,25
Kolkata,713,2,6,6,2,19,14,5,24
Chennaiyin,713,3,5,5,4,22,20,2,20
NorthEast Un,713,4,6,2,6,15,14,1,20
FC Pune City,713,5,5,3,6,14,17,-3,18
Delhi Dynamo,713,6,4,5,5,23,21,2,17
Kerala Blast,713,7,4,3,7,12,19,-7,15
FC Goa,713,8,4,2,8,12,22,-10,14
Mumbai City,714,1,7,4,3,17,8,9,25
Kerala Blast,714,2,7,3,4,15,13,2,24
Delhi Dynamo,714,3,4,6,4,21,17,4,18
NorthEast Un,714,4,5,3,6,11,11,0,18
Kolkata,714,5,4,6,4,14,15,-1,18
Chennaiyin,714,6,4,6,4,15,18,-3,18
FC Pune City,714,7,5,3,6,13,16,-3,18
FC Goa,714,8,3,3,8,9,17,-8,12
Mumbai City,715,1,7,4,3,18,8,10,25
Kolkata,715,2,5,6,3,16,13,3,21
Delhi Dynamo,715,3,5,5,4,22,20,2,20
NorthEast Un,715,4,6,2,6,14,12,2,20
Chennaiyin,715,5,4,6,4,18,19,-1,18
FC Pune City,715,6,5,3,6,15,18,-3,18
FC Goa,715,7,4,3,7,11,17,-6,15
Kerala Blast,715,8,4,3,7,11,18,-7,15
Delhi Dynamo,716,1,7,5,2,29,18,11,26
Mumbai City,716,2,6,4,4,16,10,6,22
Kolkata,716,3,4,7,3,16,15,1,19
FC Pune City,716,4,5,3,6,14,15,-1,18
Chennaiyin,716,5,4,6,4,17,20,-3,18
Kerala Blast,716,6,4,5,5,11,17,-6,17
NorthEast Un,716,7,4,4,6,13,14,-1,16
FC Goa,716,8,4,2,8,14,21,-7,14
Mumbai City,717,1,7,4,3,17,8,9,25
Kerala Blast,717,2,6,4,4,13,14,-1,22
Delhi Dynamo,717,3,5,5,4,26,22,4,20
NorthEast Un,717,4,5,3,6,15,13,2,18
FC Pune City,717,5,5,3,6,14,16,-2,18
FC Goa,717,6,5,2,7,14,16,-2,17
Chennaiyin,717,7,4,5,5,14,19,-5,17
Kolkata,717,8,3,6,5,15,20,-5,15
Delhi Dynamo,718,1,5,7,2,25,17,8,22
Mumbai City,718,2,6,4,4,16,9,7,22
Kolkata,718,3,5,7,2,19,15,4,22
Kerala Blast,718,4,6,4,4,15,15,0,22
Chennaiyin,718,5,4,6,4,14,17,-3,18
NorthEast Un,718,6,4,3,7,10,13,-3,15
FC Pune City,718,7,4,3,7,13,18,-5,15
FC Goa,718,8,3,4,7,12,20,-8,13
Mumbai City,719,1,7,4,3,19,9,10,25
Delhi Dynamo,719,2,5,6,3,27,20,7,21
Chennaiyin,719,3,5,5,4,18,17,1,20
Kolkata,719,4,4,7,3,18,15,3,19
Kerala Blast,719,5,5,4,5,11,15,-4,19
NorthEast Un,719,6,5,3,6,13,14,-1,18
FC Pune City,719,7,5,3,6,16,18,-2,18
FC Goa,719,8,3,2,9,8,22,-14,11
Mumbai City,720,1,7,4,3,19,10,9,25
Delhi Dynamo,720,2,5,6,3,29,20,9,21
Kolkata,720,3,4,8,2,17,13,4,20
Kerala Blast,720,4,5,4,5,11,17,-6,19
Chennaiyin,720,5,4,6,4,15,18,-3,18
NorthEast Un,720,6,4,5,5,11,11,0,17
FC Pune City,720,7,4,4,6,12,15,-3,16
FC Goa,720,8,3,3,8,12,22,-10,12
Delhi Dynamo,721,1,5,7,2,26,18,8,22
Mumbai City,721,2,6,4,4,18,11,7,22
Kerala Blast,721,3,5,4,5,13,16,-3,19
Kolkata,721,4,4,6,4,14,15,-1,18
FC Pune City,721,5,5,3,6,14,16,-2,18
FC Goa,721,6,5,3,6,12,16,-4,18
Chennaiyin,721,7,4,5,5,15,19,-4,17
NorthEast Un,721,8,4,4,6,11,12,-1,16
Mumbai City,722,1,7,4,3,19,8,11,25
Delhi Dynamo,722,2,5,6,3,25,17,8,21
Kerala Blast,722,3,5,5,4,12,15,-3,20
Kolkata,722,4,4,7,3,17,14,3,19
NorthEast Un,722,5,5,4,5,13,12,1,19
Chennaiyin,722,6,4,5,5,18,20,-2,17
FC Pune City,722,7,4,3,7,13,19,-6,15
FC Goa,722,8,4,2,8,10,22,-12,14
Mumbai City,723,1,6,5,3,17,9,8,23
NorthEast Un,723,2,6,3,5,17,13,4,21
Delhi Dynamo,723,3,4,7,3,25,21,4,19
Kerala Blast,723,4,5,4,5,13,17,-4,19
Kolkata,723,5,3,8,3,15,15,0,17
FC Pune City,723,6,4,5,5,14,16,-2,17
FC Goa,723,7,4,4,6,12,17,-5,16
Chennaiyin,723,8,3,6,5,16,21,-5,15
Mumbai City,724,1,6,5,3,16,8,8,23
Delhi Dynamo,724,2,5,7,2,25,16,9,22
Kolkata,724,3,5,6,3,17,15,2,21
Chennaiyin,724,4,5,5,4,19,18,1,20
NorthEast Un,724,5,5,2,7,10,15,-5,17
FC Pune City,724,6,4,4,6,13,16,-3,16
Kerala Blast,724,7,4,4,6,11,17,-6,16
FC Goa,724,8,4,3,7,13,19,-6,15
Kolkata,725,1,6,6,2,19,13,6,24
Mumbai City,725,2,6,4,4,16,9,7,22
Delhi Dynamo,725,3,5,6,3,23,16,7,21
NorthEast Un,725,4,6,3,5,15,11,4,21
Kerala Blast,725,5,5,4,5,13,18,-5,19
Chennaiyin,725,6,4,5,5,14,20,-6,17
FC Pune City,725,7,4,3,7,13,17,-4,15
FC Goa,725,8,3,3,8,10,19,-9,12
Delhi Dynamo,726,1,6,5,3,27,15,12,23
Mumbai City,726,2,6,4,4,16,10,6,22
NorthEast Un,726,3,6,3,5,13,10,3,21
Kerala Blast,726,4,5,5,4,13,15,-2,20
Kolkata,726,5,4,7,3,16,14,2,19
FC Goa,726,6,5,2,7,12,19,-7,17
FC Pune City,726,7,4,3,7,12,18,-6,15
Chennaiyin,726,8,3,5,6,14,22,-8,14
Mumbai City,727,1,7,4,3,17,8,9,25
Delhi Dynamo,727,2,6,5,3,25,15,10,23
Kolkata,727,3,5,7,2,19,16,3,22
Chennaiyin,727,4,4,6,4,15,18,-3,18
NorthEast Un,727,5,5,2,7,12,13,-1,17
FC Pune City,727,6,4,5,5,14,16,-2,17
Kerala Blast,727,7,4,4,6,12,19,-7,16
FC Goa,727,8,3,3,8,9,18,-9,12
Mumbai City,728,1,7,4,3,18,9,9,25
Kolkata,728,2,5,7,2,18,15,3,22
Delhi Dynamo,728,3,5,6,3,24,17,7,21
Kerala Blast,728,4,5,4,5,13,17,-4,19
NorthEast Un,728,5,4,4,6,10,11,-1,16
FC Pune City,728,6,4,4,6,15,18,-3,16
Chennaiyin,728,7,3,6,5,14,19,-5,15
FC Goa,728,8,4,3,7,11,17,-6,15
Mumbai City,729,1,6,4,4,16,10,6,22
NorthEast Un,729,2,6,3,5,12,10,2,21
Delhi Dynamo,729,3,5,5,4,25,18,7,20
Kolkata,729,4,4,8,2,15,13,2,20
FC Pune City,729,5,4,5,5,15,17,-2,17
Chennaiyin,729,6,4,5,5,16,19,-3,17
Kerala Blast,729,7,4,5,5,11,16,-5,17
FC Goa,729,8,4,3,7,11,18,-7,15
Mumbai City,730,1,7,4,3,18,9,9,25
Kolkata,730,2,5,6,3,19,15,4,21
NorthEast Un,730,3,6,3,5,16,13,3,21
Delhi Dynamo,730,4,4,7,3,26,20,6,19
Chennaiyin,730,5,4,5,5,16,21,-5,17
FC Pune City,730,6,4,4,6,15,19,-4,16
Kerala Blast,730,7,4,4,6,10,17,-7,16
FC Goa,730,8,4,3,7,11,17,-6,15
Delhi Dynamo,731,1,6,5,3,23,16,7,23
Mumbai City,731,2,6,4,4,16,9,7,22
Kerala Blast,731,3,6,4,4,14,14,0,22
NorthEast Un,731,4,5,3,6,13,14,-1,18
Chennaiyin,731,5,4,6,4,17,20,-3,18
Kolkata,731,6,3,8,3,15,15,0,17
FC Pune City,731,7,4,4,6,13,16,-3,16
FC Goa,731,8,4,2,8,10,17,-7,14
Mumbai City,732,1,6,5,3,17,9,8,23
Kolkata,732,2,5,7,2,17,14,3,22
Delhi Dynamo,732,3,4,8,2,24,17,7,20
NorthEast Un,732,4,5,4,5,14,13,1,19
FC Pune City,732,5,4,4,6,14,17,-3,16
FC Goa,732,6,4,4,6,11,15,-4,16
Kerala Blast,732,7,4,4,6,11,17,-6,16
Chennaiyin,732,8,3,6,5,16,22,-6,15
Delhi Dynamo,733,1,6,5,3,27,17,10,23
Kolkata,733,2,5,7,2,20,15,5,22
Mumbai City,733,3,6,4,4,16,11,5,22
NorthEast Un,733,4,5,4,5,11,10,1,19
FC Pune City,733,5,5,4,5,15,16,-1,19
Chennaiyin,733,6,3,7,4,13,17,-4,16
Kerala Blast,733,7,4,4,6,11,18,-7,16
FC Goa,733,8,3,3,8,10,19,-9,12
Delhi Dynamo,734,1,7,5,2,29,16,13,26
Mumbai City,734,2,6,4,4,17,11,6,22
Kerala Blast,734,3,6,3,5,15,15,0,21
Chennaiyin,734,4,5,5,4,18,18,0,20
FC Pune City,734,5,5,3,6,15,17,-2,18
NorthEast Un,734,6,5,2,7,11,14,-3,17
Kolkata,734,7,3,7,4,14,18,-4,16
FC Goa,734,8,3,3,8,10,20,-10,12
Delhi Dynamo,735,1,5,7,2,24,16,8,22
Mumbai City,735,2,6,4,4,16,9,7,22
Kolkata,735,3,5,7,2,19,14,5,22
Kerala Blast,735,4,5,4,5,12,17,-5,19
Chennaiyin,735,5,4,6,4,15,18,-3,18
NorthEast Un,735,6,4,4,6,9,10,-1,16
FC Pune City,735,7,4,4,6,13,17,-4,16
FC Goa,735,8,3,4,7,11,18,-7,13
Mumbai City,736,1,6,4,4,17,10,7,22
Kolkata,736,2,5,7,2,17,13,4,22
Delhi Dynamo,736,3,5,5,4,23,18,5,20
Chennaiyin,736,4,5,5,4,16,18,-2,20
NorthEast Un,736,5,5,3,6,10,10,0,18
Kerala Blast,736,6,4,5,5,12,17,-5,17
FC Pune City,736,7,4,4,6,14,18,-4,16
FC Goa,736,8,4,3,7,11,16,-5,15
Mumbai City,737,1,7,4,3,19,9,10,25
NorthEast Un,737,2,6,3,5,14,10,4,21
Kerala Blast,737,3,5,5,4,13,16,-3,20
FC Pune City,737,4,5,4,5,15,15,0,19
Delhi Dynamo,737,5,4,5,5,22,21,1,17
FC Goa,737,6,5,2,7,16,17,-1,17
Chennaiyin,737,7,4,5,5,15,21,-6,17
Kolkata,737,8,3,6,5,15,20,-5,15
Mumbai City,738,1,7,4,3,19,8,11,25
Kerala Blast,738,2,6,4,4,15,15,0,22
Delhi Dynamo,738,3,4,7,3,23,19,4,19
Kolkata,738,4,4,6,4,19,17,2,18
FC Pune City,738,5,5,3,6,15,18,-3,18
NorthEast Un,738,6,4,5,5,10,10,0,17
Chennaiyin,738,7,3,6,5,13,18,-5,15
FC Goa,738,8,4,3,7,10,19,-9,15
Delhi Dynamo,739,1,6,6,2,25,16,9,24
Mumbai City,739,2,6,5,3,17,9,8,23
Kolkata,739,3,5,7,2,19,15,4,22
Kerala Blast,739,4,5,4,5,13,18,-5,19
Chennaiyin,739,5,4,6,4,17,18,-1,18
FC Pune City,739,6,4,4,6,14,17,-3,16
NorthEast Un,739,7,4,3,7,10,14,-4,15
FC Goa,739,8,3,3,8,11,19,-8,12
Delhi Dynamo,740,1,6,5,3,25,18,7,23
Mumbai City,740,2,6,4,4,17,10,7,22
FC Goa,740,3,6,2,6,12,14,-2,20
Kolkata,740,4,4,7,3,14,13,1,19
FC Pune City,740,5,5,3,6,14,16,-2,18
NorthEast Un,740,6,5,2,7,12,13,-1,17
Chennaiyin,740,7,4,5,5,14,18,-4,17
Kerala Blast,740,8,4,4,6,11,17,-6,16
Delhi Dynamo,741,1,6,6,2,27,16,11,24
Mumbai City,741,2,6,4,4,16,10,6,22
NorthEast Un,741,3,5,3,6,12,12,0,18
Kolkata,741,4,4,6,4,17,19,-2,18
Kerala Blast,741,5,5,3,6,15,17,-2,18
Chennaiyin,741,6,4,6,4,15,18,-3,18
FC Pune City,741,7,5,3,6,13,16,-3,18
FC Goa,741,8,4,3,7,12,19,-7,15
Delhi Dynamo,742,1,7,5,2,30,17,13,26
Mumbai City,742,2,6,4,4,17,10,7,22
FC Pune City,742,3,6,3,5,18,18,0,21
Kerala Blast,742,4,5,4,5,18,19,-1,19
Chennaiyin,742,5,4,5,5,15,19,-4,17
FC Goa,742,6,5,2,7,12,17,-5,17
Kolkata,742,7,3,7,4,17,19,-2,16
NorthEast Un,742,8,4,2,8,12,20,-8,14
Mumbai City,743,1,7,4,3,19,10,9,25
Delhi Dynamo,743,2,5,6,3,27,19,8,21
Chennaiyin,743,3,5,5,4,18,19,-1,20
Kolkata,743,4,4,7,3,17,15,2,19
FC Pune City,743,5,5,3,6,16,16,0,18
Kerala Blast,743,6,4,5,5,12,20,-8,17
NorthEast Un,743,7,4,4,6,14,15,-1,16
FC Goa,743,8,4,2,8,11,20,-9,14
Mumbai City,744,1,6,4,4,16,12,4,22
Delhi Dynamo,744,2,5,6,3,26,17,9,21
NorthEast Un,744,3,5,4,5,15,13,2,19
Kolkata,744,4,4,7,3,14,14,0,19
FC Pune City,744,5,5,4,5,13,14,-1,19
Chennaiyin,744,6,4,6,4,18,19,-1,18
Kerala Blast,744,7,4,4,6,11,17,-6,16
FC Goa,744,8,4,3,7,11,18,-7,15
Delhi Dynamo,745,1,7,5,2,26,15,11,26
Mumbai City,745,2,6,4,4,17,10,7,22
Kerala Blast,745,3,6,3,5,14,16,-2,21
Kolkata,745,4,4,6,4,15,16,-1,18
NorthEast Un,745,5,5,3,6,11,12,-1,18
FC Goa,745,6,5,2,7,11,15,-4,17
FC Pune City,745,7,4,3,7,14,19,-5,15
Chennaiyin,745,8,3,6,5,13,18,-5,15
Mumbai City,746,1,6,5,3,16,8,8,23
FC Pune City,746,2,6,3,5,16,16,0,21
Delhi Dynamo,746,3,4,7,3,23,17,6,19
Kerala Blast,746,4,5,4,5,12,16,-4,19
NorthEast Un,746,5,5,3,6,16,12,4,18
FC Goa,746,6,5,2,7,11,16,-5,17
Chennaiyin,746,7,4,5,5,14,22,-8,17
Kolkata,746,8,3,7,4,16,17,-1,16
Mumbai City,747,1,6,5,3,16,8,8,23
Delhi Dynamo,747,2,5,7,2,22,14,8,22
Kolkata,747,3,4,6,4,16,14,2,18
NorthEast Un,747,4,5,3,6,10,10,0,18
FC Pune City,747,5,5,3,6,15,17,-2,18
Kerala Blast,747,6,5,3,6,12,19,-7,18
Chennaiyin,747,7,3,7,4,14,18,-4,16
FC Goa,747,8,4,4,6,10,15,-5,16
Mumbai City,748,1,6,5,3,18,10,8,23
Delhi Dynamo,748,2,5,6,3,25,18,7,21
Kolkata,748,3,5,6,3,18,16,2,21
Kerala Blast,748,4,6,3,5,16,16,0,21
Chennaiyin,748,5,5,5,4,18,19,-1,20
NorthEast Un,748,6,5,2,7,12,14,-2,17
FC Pune City,748,7,4,3,7,13,20,-7,15
FC Goa,748,8,4,2,8,11,18,-7,14
Mumbai City,749,1,6,4,4,16,9,7,22
Kerala Blast,749,2,6,4,4,14,14,0,22
Delhi Dynamo,749,3,5,6,3,22,15,7,21
NorthEast Un,749,4,5,3,6,11,12,-1,18
FC Goa,749,5,5,3,6,11,14,-3,18
FC Pune City,749,6,4,5,5,13,15,-2,17
Kolkata,749,7,3,7,4,13,15,-2,16
Chennaiyin,749,8,3,6,5,14,20,-6,15
Mumbai City,750,1,7,4,3,21,12,9,25
Delhi Dynamo,750,2,4,7,3,27,21,6,19
NorthEast Un,750,3,5,4,5,12,10,2,19
FC Pune City,750,4,5,4,5,14,14,0,19
Kerala Blast,750,5,4,6,4,9,13,-4,18
Kolkata,750,6,3,8,3,13,14,-1,17
FC Goa,750,7,4,4,6,15,15,0,16
Chennaiyin,750,8,3,5,6,13,25,-12,14
Mumbai City,751,1,6,5,3,16,8,8,23
Kolkata,751,2,5,6,3,18,16,2,21
Kerala Blast,751,3,6,3,5,12,15,-3,21
NorthEast Un,751,4,6,2,6,14,12,2,20
Delhi Dynamo,751,5,4,6,4,24,21,3,18
FC Pune City,751,6,5,3,6,15,17,-2,18
Chennaiyin,751,7,3,6,5,16,21,-5,15
FC Goa,751,8,4,3,7,15,20,-5,15
Mumbai City,752,1,7,4,3,18,8,10,25
Delhi Dynamo,752,2,5,6,3,26,18,8,21
Kerala Blast,752,3,5,4,5,14,15,-1,19
Kolkata,752,3,4,7,3,14,15,-1,19
NorthEast Un,752,5,5,3,6,11,13,-2,18
FC Pune City,752,6,5,3,6,15,18,-3,18
Chennaiyin,752,7,3,7,4,13,17,-4,16
FC Goa,752,8,3,4,7,10,17,-7,13
Kolkata,753,1,6,6,2,18,13,5,24
Mumbai City,753,2,6,4,4,17,10,7,22
Delhi Dynamo,753,3,5,6,3,25,19,6,21
NorthEast Un,753,4,5,3,6,11,12,-1,18
Kerala Blast,753,5,5,3,6,11,16,-5,18
Chennaiyin,753,6,4,5,5,16,19,-3,17
FC Goa,753,7,5,2,7,13,17,-4,17
FC Pune City,753,8,4,3,7,13,18,-5,15
Mumbai City,754,1,7,4,3,18,8,10,25
Kerala Blast,754,2,6,3,5,15,18,-3,21
NorthEast Un,754,3,6,2,6,16,10,6,20
Delhi Dynamo,754,4,5,5,4,24,21,3,20
Chennaiyin,754,5,4,5,5,15,19,-4,17
FC Goa,754,6,5,2,7,12,18,-6,17
Kolkata,754,7,3,7,4,13,15,-2,16
FC Pune City,754,8,4,4,6,14,18,-4,16
Delhi Dynamo,755,1,6,5,3,25,17,8,23
Mumbai City,755,2,6,4,4,16,9,7,22
Kolkata,755,3,5,7,2,21,15,6,22
NorthEast Un,755,4,6,3,5,16,11,5,21
FC Pune City,755,5,4,5,5,13,15,-2,17
Kerala Blast,755,6,4,4,6,9,20,-11,16
Chennaiyin,755,7,3,6,5,14,19,-5,15
FC Goa,755,8,4,2,8,11,19,-8,14
Mumbai City,756,1,7,4,3,18,8,10,25
Delhi Dynamo,756,2,6,5,3,24,16,8,23
Kolkata,756,3,5,7,2,21,16,5,22
Kerala Blast,756,4,5,4,5,12,17,-5,19
NorthEast Un,756,5,4,4,6,9,11,-2,16
Chennaiyin,756,6,3,6,5,14,19,-5,15
FC Pune City,756,7,4,3,7,12,17,-5,15
FC Goa,756,8,4,3,7,13,19,-6,15
Mumbai City,757,1,6,5,3,16,8,8,23
Kolkata,757,2,5,6,3,19,13,6,21
NorthEast Un,757,3,6,3,5,13,11,2,21
Kerala Blast,757,4,6,3,5,13,16,-3,21
Delhi Dynamo,757,5,4,8,2,23,16,7,20
Chennaiyin,757,6,3,6,5,13,18,-5,15
FC Pune City,757,7,4,3,7,13,19,-6,15
FC Goa,757,8,3,4,7,9,18,-9,13
Mumbai City,758,1,7,4,3,21,8,13,25
Kolkata,758,2,5,7,2,17,13,4,22
Delhi Dynamo,758,3,5,6,3,24,21,3,21
Kerala Blast,758,4,5,4,5,10,15,-5,19
NorthEast Un,758,5,4,4,6,9,10,-1,16
FC Pune City,758,6,4,4,6,13,16,-3,16
FC Goa,758,7,4,3,7,12,17,-5,15
Chennaiyin,758,8,3,6,5,13,19,-6,15
Delhi Dynamo,759,1,6,5,3,25,16,9,23
Mumbai City,759,2,6,4,4,16,9,7,22
Kerala Blast,759,3,5,5,4,14,17,-3,20
Kolkata,759,4,4,7,3,16,14,2,19
NorthEast Un,759,5,5,3,6,14,14,0,18
FC Pune City,759,6,4,5,5,15,17,-2,17
Chennaiyin,759,7,4,5,5,16,20,-4,17
FC Goa,759,8,4,2,8,10,19,-9,14
Mumbai City,760,1,6,5,3,17,9,8,23
Delhi Dynamo,760,2,5,7,2,23,15,8,22
Kolkata,760,3,5,7,2,20,15,5,22
NorthEast Un,760,4,5,4,5,12,11,1,19
FC Pune City,760,5,4,5,5,14,16,-2,17
Chennaiyin,760,6,4,5,5,15,19,-4,17
Kerala Blast,760,7,4,5,5,13,18,-5,17
FC Goa,760,8,3,2,9,8,19,-11,11
Delhi Dynamo,761,1,6,6,2,30,19,11,24
Mumbai City,761,2,6,5,3,18,10,8,23
Kerala Blast,761,3,6,4,4,14,14,0,22
Kolkata,761,4,4,8,2,17,14,3,20
Chennaiyin,761,5,5,5,4,20,18,2,20
FC Pune City,761,6,4,3,7,12,19,-7,15
NorthEast Un,761,7,4,2,8,12,17,-5,14
FC Goa,761,8,3,3,8,10,22,-12,12
Delhi Dynamo,762,1,6,6,2,27,17,10,24
Mumbai City,762,2,6,4,4,18,11,7,22
Kolkata,762,3,5,7,2,21,17,4,22
NorthEast Un,762,4,5,3,6,15,15,0,18
Chennaiyin,762,5,4,6,4,16,18,-2,18
Kerala Blast,762,6,4,5,5,13,19,-6,17
FC Pune City,762,7,4,4,6,14,18,-4,16
FC Goa,762,8,3,3,8,9,18,-9,12
Mumbai City,763,1,7,4,3,18,9,9,25
Kolkata,763,2,5,6,3,21,16,5,21
Delhi Dynamo,763,3,5,5,4,25,19,6,20
NorthEast Un,763,4,5,4,5,13,12,1,19
Chennaiyin,763,5,4,6,4,15,18,-3,18
FC Pune City,763,6,5,3,6,15,19,-4,18
Kerala Blast,763,7,4,4,6,10,17,-7,16
FC Goa,763,8,4,2,8,11,18,-7,14
Mumbai City,764,1,7,4,3,18,8,10,25
NorthEast Un,764,2,6,3,5,15,12,3,21
Delhi Dynamo,764,3,4,7,3,22,17,5,19
FC Pune City,764,4,5,3,6,17,18,-1,18
Kolkata,764,5,4,6,4,16,18,-2,18
Kerala Blast,764,6,5,3,6,16,20,-4,18
Chennaiyin,764,7,4,5,5,17,20,-3,17
FC Goa,764,8,4,3,7,10,18,-8,15
Mumbai City,765,1,7,4,3,18,8,10,25
Delhi Dynamo,765,2,5,6,3,23,17,6,21
NorthEast Un,765,3,5,4,5,12,11,1,19
Kerala Blast,765,4,5,4,5,13,16,-3,19
Kolkata,765,5,4,6,4,15,15,0,18
FC Pune City,765,6,5,3,6,14,17,-3,18
Chennaiyin,765,7,3,6,5,17,22,-5,15
FC Goa,765,8,4,3,7,13,19,-6,15
Mumbai City,766,1,7,4,3,18,9,9,25
Delhi Dynamo,766,2,5,6,3,27,19,8,21
NorthEast Un,766,3,5,4,5,14,13,1,19
Kerala Blast,766,4,5,4,5,12,15,-3,19
Kolkata,766,5,4,6,4,15,16,-1,18
FC Pune City,766,6,5,3,6,14,17,-3,18
FC Goa,766,7,5,2,7,12,17,-5,17
Chennaiyin,766,8,3,5,6,15,21,-6,14
Mumbai City,767,1,6,5,3,17,9,8,23
Kerala Blast,767,2,6,3,5,14,17,-3,21
Delhi Dynamo,767,3,4,8,2,23,16,7,20
Kolkata,767,4,4,7,3,15,13,2,19
FC Goa,767,5,5,3,6,12,16,-4,18
Chennaiyin,767,6,4,5,5,16,20,-4,17
FC Pune City,767,7,4,4,6,13,16,-3,16
NorthEast Un,767,8,4,3,7,11,14,-3,15
Delhi Dynamo,768,1,6,6,2,26,16,10,24
Mumbai City,768,2,6,4,4,16,9,7,22
NorthEast Un,768,3,5,4,5,16,12,4,19
FC Pune City,768,4,5,4,5,14,15,-1,19
Kolkata,768,5,3,9,2,15,14,1,18
Kerala Blast,768,6,4,5,5,11,16,-5,17
Chennaiyin,768,7,4,5,5,14,21,-7,17
FC Goa,768,8,3,3,8,8,17,-9,12
Mumbai City,769,1,7,4,3,18,9,9,25
Kerala Blast,769,2,6,4,4,12,13,-1,22
NorthEast Un,769,3,6,3,5,12,10,2,21
Delhi Dynamo,769,4,5,5,4,26,19,7,20
FC Pune City,769,5,5,3,6,14,16,-2,18
Kolkata,769,6,3,6,5,14,18,-4,15
Chennaiyin,769,7,3,6,5,14,19,-5,15
FC Goa,769,8,4,3,7,12,18,-6,15
Delhi Dynamo,770,1,6,6,2,27,15,12,24
Mumbai City,770,2,6,4,4,17,10,7,22
Kolkata,770,3,4,8,2,17,14,3,20
Kerala Blast,770,4,5,5,4,11,13,-2,20
NorthEast Un,770,5,5,3,6,11,12,-1,18
FC Pune City,770,6,4,4,6,12,16,-4,16
Chennaiyin,770,7,3,6,5,14,19,-5,15
FC Goa,770,8,3,4,7,10,20,-10,13
Delhi Dynamo,771,1,7,5,2,30,16,14,26
Mumbai City,771,2,6,4,4,17,11,6,22
Kolkata,771,3,5,7,2,18,14,4,22
Kerala Blast,771,4,6,3,5,12,15,-3,21
NorthEast Un,771,5,5,2,7,13,15,-2,17
FC Pune City,771,6,4,3,7,13,18,-5,15
FC Goa,771,7,4,3,7,12,19,-7,15
Chennaiyin,771,8,3,5,6,15,22,-7,14
Kolkata,772,1,6,6,2,21,15,6,24
Mumbai City,772,2,6,5,3,18,10,8,23
Delhi Dynamo,772,3,5,7,2,26,18,8,22
Chennaiyin,772,4,5,5,4,18,19,-1,20
Kerala Blast,772,5,5,4,5,13,18,-5,19
FC Pune City,772,6,4,4,6,15,18,-3,16
NorthEast Un,772,7,4,3,7,13,16,-3,15
FC Goa,772,8,3,2,9,10,20,-10,11
Kerala Blast,773,1,7,3,4,17,16,1,24
Mumbai City,773,2,6,5,3,18,10,8,23
Delhi Dynamo,773,3,5,7,2,25,16,9,22
NorthEast Un,773,4,5,3,6,12,12,0,18
Kolkata,773,5,3,8,3,16,16,0,17
Chennaiyin,773,6,4,5,5,15,19,-4,17
FC Pune City,773,7,4,4,6,12,17,-5,16
FC Goa,773,8,3,3,8,11,20,-9,12
Mumbai City,774,1,6,5,3,16,8,8,23
NorthEast Un,774,2,7,2,5,16,12,4,23
Delhi Dynamo,774,3,4,7,3,21,15,6,19
Kerala Blast,774,4,5,4,5,13,18,-5,19
FC Pune City,774,5,5,3,6,14,15,-1,18
Kolkata,774,6,3,8,3,16,17,-1,17
FC Goa,774,7,4,4,6,12,16,-4,16
Chennaiyin,774,8,3,5,6,16,23,-7,14
Delhi Dynamo,775,1,6,6,2,25,16,9,24
Mumbai City,775,2,6,4,4,16,9,7,22
Kerala Blast,775,3,6,3,5,14,17,-3,21
Kolkata,775,4,4,7,3,16,16,0,19
NorthEast Un,775,5,5,3,6,13,13,0,18
FC Goa,775,6,5,2,7,16,17,-1,17
FC Pune City,775,7,4,4,6,14,17,-3,16
Chennaiyin,775,8,3,5,6,15,24,-9,14
Mumbai City,776,1,7,4,3,18,8,10,25
FC Pune City,776,2,5,4,5,13,14,-1,19
Kerala Blast,776,3,5,4,5,11,14,-3,19
Delhi Dynamo,776,4,4,6,4,22,19,3,18
Kolkata,776,5,4,6,4,14,14,0,18
NorthEast Un,776,6,5,3,6,13,13,0,18
Chennaiyin,776,7,4,6,4,18,21,-3,18
FC Goa,776,8,4,3,7,12,18,-6,15
Delhi Dynamo,777,1,6,6,2,27,18,9,24
Mumbai City,777,2,6,4,4,18,11,7,22
FC Pune City,777,3,6,3,5,14,14,0,21
Kolkata,777,4,4,7,3,17,16,1,19
Kerala Blast,777,5,5,4,5,14,17,-3,19
NorthEast Un,777,6,5,3,6,13,14,-1,18
Chennaiyin,777,7,3,6,5,15,20,-5,15
FC Goa,777,8,3,3,8,11,19,-8,12
Mumbai City,778,1,6,5,3,17,9,8,23
Delhi Dynamo,778,2,5,6,3,26,20,6,21
Kolkata,778,3,5,6,3,16,14,2,21
FC Pune City,778,4,5,4,5,14,15,-1,19
Kerala Blast,778,5,5,4,5,12,15,-3,19
NorthEast Un,778,6,5,3,6,13,12,1,18
Chennaiyin,778,7,3,6,5,13,19,-6,15
FC Goa,778,8,4,2,8,12,19,-7,14
Mumbai City,779,1,6,5,3,16,8,8,23
NorthEast Un,779,2,6,3,5,17,12,5,21
Kolkata,779,3,5,6,3,18,16,2,21
Delhi Dynamo,779,4,4,8,2,25,18,7,20
Chennaiyin,779,5,4,5,5,15,20,-5,17
FC Pune City,779,6,4,4,6,13,17,-4,16
Kerala Blast,779,7,4,4,6,11,19,-8,16
FC Goa,779,8,4,3,7,13,18,-5,15
Mumbai City,780,1,7,4,3,17,8,9,25
Kerala Blast,780,2,6,3,5,11,14,-3,21
Kolkata,780,3,4,7,3,16,15,1,19
FC Pune City,780,4,5,4,5,15,16,-1,19
Delhi Dynamo,780,5,4,6,4,23,18,5,18
Chennaiyin,780,6,4,6,4,15,18,-3,18
NorthEast Un,780,7,5,2,7,11,12,-1,17
FC Goa,780,8,3,4,7,10,17,-7,13
Mumbai City,781,1,7,4,3,19,10,9,25
NorthEast Un,781,2,6,3,5,14,12,2,21
Kerala Blast,781,3,5,4,5,13,16,-3,19
Delhi Dynamo,781,4,4,6,4,25,20,5,18
Chennaiyin,781,5,4,6,4,15,18,-3,18
Kolkata,781,6,3,8,3,15,16,-1,17
FC Pune City,781,7,4,4,6,13,17,-4,16
FC Goa,781,8,4,3,7,11,16,-5,15
Mumbai City,782,1,7,4,3,20,10,10,25
NorthEast Un,782,2,7,2,5,15,11,4,23
Kolkata,782,3,5,7,2,18,14,4,22
Delhi Dynamo,782,4,5,5,4,25,20,5,20
Kerala Blast,782,5,4,5,5,11,17,-6,17
FC Pune City,782,6,4,4,6,14,17,-3,16
Chennaiyin,782,7,3,5,6,15,21,-6,14
FC Goa,782,8,4,2,8,10,18,-8,14
Mumbai City,783,1,7,4,3,20,9,11,25
Delhi Dynamo,783,2,5,6,3,26,21,5,21
Kerala Blast,783,3,6,3,5,12,15,-3,21
Chennaiyin,783,4,4,6,4,16,17,-1,18
FC Pune City,783,5,5,3,6,14,16,-2,18
NorthEast Un,783,6,5,2,7,12,15,-3,17
Kolkata,783,7,3,7,4,17,18,-1,16
FC Goa,783,8,3,5,6,11,17,-6,14
Mumbai City,784,1,7,4,3,19,10,9,25
Kerala Blast,784,2,6,4,4,16,14,2,22
Kolkata,784,3,4,8,2,17,13,4,20
NorthEast Un,784,4,6,2,6,12,11,1,20
Delhi Dynamo,784,5,4,6,4,25,20,5,18
FC Goa,784,6,4,4,6,11,16,-5,16
FC Pune City,784,7,4,3,7,12,21,-9,15
Chennaiyin,784,8,3,5,6,13,20,-7,14
Mumbai City,785,1,7,4,3,17,8,9,25
Delhi Dynamo,785,2,5,6,3,23,16,7,21
FC Pune City,785,3,6,3,5,14,14,0,21
NorthEast Un,785,4,5,4,5,12,11,1,19
Kolkata,785,5,3,8,3,14,14,0,17
Kerala Blast,785,6,4,4,6,10,16,-6,16
Chennaiyin,785,7,3,6,5,14,19,-5,15
FC Goa,785,8,4,3,7,9,15,-6,15
Delhi Dynamo,786,1,6,6,2,27,15,12,24
Mumbai City,786,2,6,5,3,17,9,8,23
Chennaiyin,786,3,5,5,4,18,18,0,20
Kolkata,786,4,4,7,3,15,15,0,19
FC Pune City,786,5,5,3,6,15,17,-2,18
Kerala Blast,786,6,5,3,6,12,16,-4,18
NorthEast Un,786,7,5,2,7,11,16,-5,17
FC Goa,786,8,3,3,8,9,18,-9,12
Delhi Dynamo,787,1,6,6,2,29,20,9,24
Mumbai City,787,2,6,4,4,18,11,7,22
Kolkata,787,3,5,7,2,18,13,5,22
FC Pune City,787,4,5,4,5,14,15,-1,19
Chennaiyin,787,5,4,6,4,19,18,1,18
Kerala Blast,787,6,5,3,6,11,17,-6,18
NorthEast Un,787,7,4,3,7,12,18,-6,15
FC Goa,787,8,3,3,8,11,20,-9,12
Kerala Blast,788,1,7,3,4,18,16,2,24
Mumbai City,788,2,6,5,3,17,9,8,23
NorthEast Un,788,3,6,2,6,18,14,4,20
Delhi Dynamo,788,4,4,6,4,23,21,2,18
FC Goa,788,5,5,3,6,14,17,-3,18
FC Pune City,788,6,5,3,6,15,19,-4,18
Kolkata,788,7,3,7,4,15,17,-2,16
Chennaiyin,788,8,3,5,6,16,23,-7,14
Mumbai City,789,1,7,4,3,18,8,10,25
Delhi Dynamo,789,2,5,5,4,23,17,6,20
Kerala Blast,789,3,5,5,4,12,14,-2,20
FC Pune City,789,4,5,4,5,15,15,0,19
Kolkata,789,5,4,7,3,14,14,0,19
NorthEast Un,789,6,5,2,7,10,13,-3,17
FC Goa,789,7,5,2,7,11,15,-4,17
Chennaiyin,789,8,3,5,6,13,20,-7,14
Delhi Dynamo,790,1,6,6,2,26,14,12,24
Mumbai City,790,2,6,4,4,16,9,7,22
Kerala Blast,790,3,6,3,5,12,15,-3,21
Kolkata,790,4,4,7,3,17,15,2,19
FC Pune City,790,5,5,3,6,13,15,-2,18
Chennaiyin,790,6,4,5,5,15,21,-6,17
FC Goa,790,7,4,4,6,14,17,-3,16
NorthEast Un,790,8,4,2,8,9,16,-7,14
Mumbai City,791,1,7,4,3,18,9,9,25
Delhi Dynamo,791,2,6,5,3,27,17,10,23
Kolkata,791,3,4,7,3,18,17,1,19
NorthEast Un,791,4,5,3,6,14,16,-2,18
Kerala Blast,791,5,4,6,4,14,18,-4,18
Chennaiyin,791,6,4,5,5,17,21,-4,17
FC Pune City,791,7,4,4,6,15,19,-4,16
FC Goa,791,8,4,2,8,13,19,-6,14
Mumbai City,792,1,6,4,4,16,9,7,22
Kolkata,792,2,5,7,2,16,12,4,22
Kerala Blast,792,3,6,3,5,13,14,-1,21
Delhi Dynamo,792,4,5,5,4,26,20,6,20
FC Goa,792,5,5,2,7,14,17,-3,17
NorthEast Un,792,6,5,2,7,13,16,-3,17
Chennaiyin,792,7,4,5,5,14,21,-7,17
FC Pune City,792,8,4,4,6,12,15,-3,16
Mumbai City,793,1,7,4,3,17,8,9,25
Delhi Dynamo,793,2,5,5,4,22,16,6,20
FC Pune City,793,3,5,4,5,14,14,0,19
Kerala Blast,793,4,5,4,5,10,14,-4,19
NorthEast Un,793,5,5,3,6,11,11,0,18
Chennaiyin,793,6,4,6,4,16,18,-2,18
Kolkata,793,7,3,7,4,13,15,-2,16
FC Goa,793,8,4,3,7,9,16,-7,15
Delhi Dynamo,794,1,6,6,2,28,18,10,24
Mumbai City,794,2,6,4,4,18,11,7,22
NorthEast Un,794,3,6,3,5,16,11,5,21
Kerala Blast,794,4,6,3,5,12,16,-4,21
Kolkata,794,5,3,7,4,16,17,-1,16
FC Pune City,794,6,4,4,6,14,17,-3,16
Chennaiyin,794,7,3,6,5,13,20,-7,15
FC Goa,794,8,4,3,7,11,18,-7,15
Mumbai City,795,1,7,4,3,19,8,11,25
Kolkata,795,2,5,7,2,17,13,4,22
Delhi Dynamo,795,3,5,6,3,22,17,5,21
FC Pune City,795,4,5,4,5,14,15,-1,19
Chennaiyin,795,5,4,6,4,15,18,-3,18
NorthEast Un,795,6,4,4,6,11,12,-1,16
Kerala Blast,795,7,4,4,6,10,16,-6,16
FC Goa,795,8,3,3,8,8,17,-9,12
Mumbai City,796,1,7,4,3,18,8,10,25
Kolkata,796,2,5,7,2,17,13,4,22
Delhi Dynamo,796,3,5,6,3,24,16,8,21
Kerala Blast,796,4,5,5,4,11,14,-3,20
Chennaiyin,796,5,4,5,5,15,21,-6,17
FC Goa,796,6,4,3,7,13,17,-4,15
NorthEast Un,796,7,4,3,7,10,14,-4,15
FC Pune City,796,8,4,3,7,12,17,-5,15
Delhi Dynamo,797,1,6,6,2,28,19,9,24
Mumbai City,797,2,6,4,4,17,10,7,22
Kolkata,797,3,5,7,2,18,14,4,22
NorthEast Un,797,4,6,3,5,14,11,3,21
Kerala Blast,797,5,5,4,5,14,17,-3,19
FC Pune City,797,6,4,3,7,13,18,-5,15
FC Goa,797,7,4,2,8,14,20,-6,14
Chennaiyin,797,8,3,5,6,14,23,-9,14
Mumbai City,798,1,7,4,3,19,9,10,25
Kolkata,798,2,5,6,3,18,17,1,21
Delhi Dynamo,798,3,5,5,4,25,20,5,20
Chennaiyin,798,4,5,5,4,18,19,-1,20
Kerala Blast,798,5,5,3,6,14,17,-3,18
FC Pune City,798,6,5,3,6,13,16,-3,18
NorthEast Un,798,7,5,2,7,12,16,-4,17
FC Goa,798,8,4,2,8,13,18,-5,14
Mumbai City,799,1,7,4,3,18,9,9,25
Delhi Dynamo,799,2,5,6,3,26,16,10,21
Kerala Blast,799,3,6,3,5,13,15,-2,21
Chennaiyin,799,4,5,5,4,19,20,-1,20
NorthEast Un,799,5,5,3,6,11,12,-1,18
Kolkata,799,6,3,8,3,16,16,0,17
FC Pune City,799,7,4,4,6,13,17,-4,16
FC Goa,799,8,3,3,8,11,22,-11,12
Mumbai City,800,1,7,4,3,18,9,9,25
Kolkata,800,2,6,6,2,20,15,5,24
Delhi Dynamo,800,3,5,6,3,27,18,9,21
NorthEast Un,800,4,5,3,6,11,13,-2,18
Chennaiyin,800,5,4,6,4,16,19,-3,18
FC Pune City,800,6,4,4,6,14,18,-4,16
Kerala Blast,800,7,4,4,6,13,19,-6,16
FC Goa,800,8,3,3,8,12,20,-8,12
Mumbai City,801,1,7,4,3,18,8,10,25
Kolkata,801,2,4,8,2,17,13,4,20
NorthEast Un,801,3,5,4,5,12,11,1,19
Delhi Dynamo,801,4,4,6,4,21,18,3,18
Chennaiyin,801,5,4,6,4,17,18,-1,18
FC Pune City,801,6,5,3,6,15,18,-3,18
Kerala Blast,801,7,4,4,6,12,19,-7,16
FC Goa,801,8,4,3,7,10,17,-7,15
Mumbai City,802,1,6,4,4,16,9,7,22
Delhi Dynamo,802,2,5,6,3,23,16,7,21
NorthEast Un,802,3,6,2,6,11,10,1,20
Kolkata,802,4,4,7,3,16,15,1,19
FC Goa,802,5,5,3,6,14,16,-2,18
Kerala Blast,802,6,4,5,5,11,16,-5,17
Chennaiyin,802,7,4,5,5,15,21,-6,17
FC Pune City,802,8,4,4,6,12,15,-3,16
Mumbai City,803,1,6,5,3,17,9,8,23
Kolkata,803,2,5,7,2,18,15,3,22
Delhi Dynamo,803,3,5,6,3,24,20,4,21
Kerala Blast,803,4,5,4,5,13,17,-4,19
Chennaiyin,803,5,4,5,5,18,19,-1,17
NorthEast Un,803,6,5,2,7,15,16,-1,17
FC Pune City,803,7,4,5,5,14,16,-2,17
FC Goa,803,8,4,2,8,11,18,-7,14
Mumbai City,804,1,7,4,3,20,8,12,25
Delhi Dynamo,804,2,5,6,3,24,20,4,21
Kerala Blast,804,3,6,3,5,13,15,-2,21
Chennaiyin,804,4,5,5,4,16,18,-2,20
Kolkata,804,5,4,7,3,15,15,0,19
NorthEast Un,804,6,5,2,7,11,12,-1,17
FC Pune City,804,7,4,3,7,13,17,-4,15
FC Goa,804,8,3,4,7,11,18,-7,13
Mumbai City,805,1,6,5,3,17,9,8,23
Kolkata,805,2,5,7,2,18,14,4,22
Kerala Blast,805,3,6,3,5,15,19,-4,21
NorthEast Un,805,4,6,2,6,11,10,1,20
Delhi Dynamo,805,5,4,7,3,23,17,6,19
FC Goa,805,6,4,4,6,12,17,-5,16
FC Pune City,805,7,4,3,7,15,19,-4,15
Chennaiyin,805,8,3,5,6,14,20,-6,14
Mumbai City,806,1,6,5,3,17,9,8,23
Delhi Dynamo,806,2,5,6,3,24,17,7,21
NorthEast Un,806,3,6,2,6,13,12,1,20
Kolkata,806,4,4,7,3,17,14,3,19
Kerala Blast,806,5,5,3,6,11,17,-6,18
Chennaiyin,806,6,4,5,5,15,19,-4,17
FC Goa,806,7,5,2,7,10,15,-5,17
FC Pune City,806,8,4,4,6,13,17,-4,16
Mumbai City,807,1,7,4,3,19,8,11,25
Delhi Dynamo,807,2,5,6,3,23,17,6,21
Kerala Blast,807,3,6,3,5,12,14,-2,21
Kolkata,807,4,4,7,3,16,16,0,19
NorthEast Un,807,5,5,3,6,11,11,0,18
FC Pune City,807,6,5,3,6,15,17,-2,18
Chennaiyin,807,7,4,5,5,16,19,-3,17
FC Goa,807,8,3,3,8,9,19,-10,12
Mumbai City,808,1,6,5,3,16,8,8,23
Kolkata,808,2,5,7,2,20,16,4,22
Delhi Dynamo,808,3,4,7,3,24,19,5,19
NorthEast Un,808,4,5,4,5,13,11,2,19
Kerala Blast,808,5,5,4,5,12,16,-4,19
Chennaiyin,808,6,4,6,4,16,19,-3,18
FC Pune City,808,7,4,3,7,13,18,-5,15
FC Goa,808,8,3,4,7,13,20,-7,13
Kerala Blast,809,1,7,3,4,14,14,0,24
Mumbai City,809,2,6,4,4,16,9,7,22
Delhi Dynamo,809,3,5,5,4,24,19,5,20
Kolkata,809,4,4,7,3,18,15,3,19
NorthEast Un,809,5,5,2,7,13,14,-1,17
Chennaiyin,809,6,4,5,5,16,19,-3,17
FC Goa,809,7,5,2,7,12,20,-8,17
FC Pune City,809,8,4,4,6,13,16,-3,16
Mumbai City,810,1,7,4,3,18,9,9,25
Kolkata,810,2,5,7,2,18,15,3,22
NorthEast Un,810,3,6,3,5,15,11,4,21
Delhi Dynamo,810,4,5,5,4,26,21,5,20
FC Pune City,810,5,5,4,5,16,17,-1,19
Chennaiyin,810,6,4,6,4,16,19,-3,18
Kerala Blast,810,7,4,3,7,9,16,-7,15
FC Goa,810,8,3,2,9,10,20,-10,11
Delhi Dynamo,811,1,6,6,2,26,17,9,24
Mumbai City,811,2,6,4,4,17,10,7,22
Kolkata,811,3,5,7,2,19,16,3,22
NorthEast Un,811,4,5,3,6,13,11,2,18
FC Pune City,811,5,5,3,6,15,16,-1,18
Chennaiyin,811,6,4,6,4,15,17,-2,18
Kerala Blast,811,7,4,4,6,10,19,-9,16
FC Goa,811,8,3,3,8,11,20,-9,12
Mumbai City,812,1,7,4,3,19,9,10,25
Kolkata,812,2,5,7,2,15,12,3,22
Kerala Blast,812,3,6,4,4,15,13,2,22
Delhi Dynamo,812,4,5,6,3,25,18,7,21
Chennaiyin,812,5,4,6,4,16,19,-3,18
FC Pune City,812,6,4,3,7,12,17,-5,15
NorthEast Un,812,7,4,3,7,11,16,-5,15
FC Goa,812,8,3,3,8,9,18,-9,12
Mumbai City,813,1,6,4,4,17,10,7,22
FC Pune City,813,2,6,3,5,15,15,0,21
Delhi Dynamo,813,3,5,5,4,26,20,6,20
FC Goa,813,4,6,2,6,14,17,-3,20
Kolkata,813,5,4,6,4,14,14,0,18
NorthEast Un,813,6,5,3,6,13,13,0,18
Kerala Blast,813,7,5,3,6,12,17,-5,18
Chennaiyin,813,8,3,6,5,15,20,-5,15
Mumbai City,814,1,6,4,4,17,10,7,22
Delhi Dynamo,814,2,5,6,3,26,19,7,21
NorthEast Un,814,3,6,3,5,15,11,4,21
FC Pune City,814,4,5,4,5,14,14,0,19
FC Goa,814,5,5,3,6,13,16,-3,18
Kolkata,814,6,3,8,3,14,15,-1,17
Kerala Blast,814,7,4,5,5,11,17,-6,17
Chennaiyin,814,8,3,5,6,13,21,-8,14
Mumbai City,815,1,6,5,3,16,8,8,23
NorthEast Un,815,2,7,2,5,14,10,4,23
Kolkata,815,3,5,7,2,20,15,5,22
Delhi Dynamo,815,4,5,6,3,23,17,6,21
Kerala Blast,815,5,5,4,5,11,15,-4,19
Chennaiyin,815,6,3,6,5,14,19,-5,15
FC Pune City,815,7,4,3,7,13,18,-5,15
FC Goa,815,8,3,3,8,10,19,-9,12
Delhi Dynamo,816,1,6,5,3,24,15,9,23
Mumbai City,816,2,6,4,4,16,9,7,22
NorthEast Un,816,3,6,2,6,13,12,1,20
Kolkata,816,4,4,7,3,16,15,1,19
FC Pune City,816,5,5,4,5,13,14,-1,19
Chennaiyin,816,6,4,5,5,16,20,-4,17
Kerala Blast,816,7,4,4,6,12,18,-6,16
FC Goa,816,8,4,3,7,12,19,-7,15
Kolkata,817,1,6,6,2,21,14,7,24
Mumbai City,817,2,6,4,4,16,9,7,22
Delhi Dynamo,817,3,5,5,4,24,20,4,20
NorthEast Un,817,4,6,2,6,13,12,1,20
FC Pune City,817,5,5,3,6,14,16,-2,18
Chennaiyin,817,6,4,5,5,15,19,-4,17
FC Goa,817,7,5,2,7,14,18,-4,17
Kerala Blast,817,8,4,3,7,10,19,-9,15
Mumbai City,818,1,6,5,3,17,9,8,23
Kerala Blast,818,2,6,3,5,13,16,-3,21
NorthEast Un,818,3,6,2,6,14,11,3,20
Kolkata,818,4,4,7,3,17,16,1,19
Delhi Dynamo,818,5,4,6,4,23,20,3,18
FC Goa,818,6,5,3,6,15,15,0,18
Chennaiyin,818,7,4,5,5,14,21,-7,17
FC Pune City,818,8,4,3,7,14,19,-5,15
Mumbai City,819,1,7,4,3,18,9,9,25
Kolkata,819,2,6,6,2,17,12,5,24
NorthEast Un,819,3,6,3,5,14,10,4,21
Delhi Dynamo,819,4,5,5,4,25,18,7,20
Kerala Blast,819,5,5,4,5,11,15,-4,19
Chennaiyin,819,6,4,5,5,16,20,-4,17
FC Pune City,819,7,4,3,7,13,18,-5,15
FC Goa,819,8,3,2,9,8,20,-12,11
Delhi Dynamo,820,1,6,6,2,25,15,10,24
Kerala Blast,820,2,7,3,4,15,14,1,24
Mumbai City,820,3,6,4,4,16,10,6,22
Kolkata,820,4,5,6,3,16,15,1,21
Chennaiyin,820,5,4,5,5,14,20,-6,17
NorthEast Un,820,6,4,3,7,10,12,-2,15
FC Pune City,820,7,4,3,7,13,18,-5,15
FC Goa,820,8,4,2,8,12,17,-5,14
Delhi Dynamo,821,1,7,5,2,27,15,12,26
Mumbai City,821,2,6,4,4,16,10,6,22
FC Pune City,821,3,6,3,5,15,15,0,21
NorthEast Un,821,4,6,2,6,14,12,2,20
Kolkata,821,5,4,6,4,17,16,1,18
FC Goa,821,6,5,2,7,14,16,-2,17
Kerala Blast,821,7,4,3,7,10,19,-9,15
Chennaiyin,821,8,3,5,6,14,24,-10,14
Mumbai City,822,1,6,5,3,16,8,8,23
Delhi Dynamo,822,2,4,8,2,24,17,7,20
Kolkata,822,3,4,7,3,16,15,1,19
Kerala Blast,822,4,5,4,5,11,15,-4,19
FC Pune City,822,5,5,3,6,13,15,-2,18
NorthEast Un,822,6,4,5,5,12,12,0,17
FC Goa,822,7,4,4,6,11,16,-5,16
Chennaiyin,822,8,3,6,5,14,19,-5,15
Kolkata,823,1,6,6,2,21,12,9,24
Mumbai City,823,2,6,5,3,17,9,8,23
Delhi Dynamo,823,3,5,7,2,27,15,12,22
Kerala Blast,823,4,6,3,5,15,17,-2,21
NorthEast Un,823,5,5,3,6,12,12,0,18
Chennaiyin,823,6,3,6,5,15,20,-5,15
FC Pune City,823,7,4,3,7,12,22,-10,15
FC Goa,823,8,3,3,8,9,21,-12,12
Mumbai City,824,1,7,4,3,18,8,10,25
FC Pune City,824,2,6,3,5,15,14,1,21
Delhi Dynamo,824,3,5,5,4,23,18,5,20
Chennaiyin,824,4,5,5,4,16,18,-2,20
Kolkata,824,5,4,7,3,18,15,3,19
Kerala Blast,824,6,5,4,5,11,15,-4,19
NorthEast Un,824,7,5,2,7,12,13,-1,17
FC Goa,824,8,3,2,9,8,20,-12,11
Kerala Blast,825,1,7,3,4,15,13,2,24
Mumbai City,825,2,6,4,4,17,12,5,22
Delhi Dynamo,825,3,5,6,3,28,21,7,21
Kolkata,825,4,4,7,3,16,15,1,19
NorthEast Un,825,5,5,3,6,12,15,-3,18
FC Goa,825,6,5,2,7,15,17,-2,17
FC Pune City,825,7,4,4,6,13,16,-3,16
Chennaiyin,825,8,3,5,6,13,20,-7,14
Delhi Dynamo,826,1,6,5,3,25,17,8,23
Mumbai City,826,2,6,4,4,17,10,7,22
NorthEast Un,826,3,6,3,5,12,10,2,21
Kerala Blast,826,4,5,5,4,11,14,-3,20
FC Pune City,826,5,4,5,5,15,17,-2,17
Kolkata,826,6,3,7,4,15,16,-1,16
Chennaiyin,826,7,3,6,5,15,20,-5,15
FC Goa,826,8,4,3,7,11,17,-6,15
Mumbai City,827,1,7,4,3,18,8,10,25
Delhi Dynamo,827,2,5,6,3,27,18,9,21
Kolkata,827,3,5,6,3,17,16,1,21
Kerala Blast,827,4,5,4,5,13,16,-3,19
FC Goa,827,5,4,4,6,11,14,-3,16
Chennaiyin,827,6,3,7,4,14,18,-4,16
NorthEast Un,827,7,4,4,6,13,17,-4,16
FC Pune City,827,8,4,3,7,13,19,-6,15
Mumbai City,828,1,7,4,3,17,8,9,25
Kolkata,828,2,6,6,2,17,13,4,24
NorthEast Un,828,3,6,3,5,14,11,3,21
Delhi Dynamo,828,4,4,6,4,23,19,4,18
Chennaiyin,828,5,4,5,5,16,20,-4,17
Kerala Blast,828,6,4,5,5,11,16,-5,17
FC Pune City,828,7,4,4,6,13,16,-3,16
FC Goa,828,8,3,3,8,10,18,-8,12
Mumbai City,829,1,7,4,3,18,9,9,25
Delhi Dynamo,829,2,6,5,3,24,16,8,23
Kerala Blast,829,3,5,5,4,13,15,-2,20
FC Pune City,829,4,5,4,5,16,16,0,19
Kolkata,829,5,4,6,4,17,16,1,18
NorthEast Un,829,6,5,3,6,11,10,1,18
Chennaiyin,829,7,3,6,5,14,20,-6,15
FC Goa,829,8,3,3,8,9,20,-11,12
Mumbai City,830,1,7,4,3,19,8,11,25
NorthEast Un,830,2,6,3,5,14,11,3,21
Delhi Dynamo,830,3,5,5,4,23,19,4,20
Kolkata,830,4,4,7,3,18,15,3,19
Kerala Blast,830,5,5,4,5,14,18,-4,19
FC Pune City,830,6,4,4,6,14,19,-5,16
Chennaiyin,830,7,3,6,5,15,20,-5,15
FC Goa,830,8,4,3,7,11,18,-7,15
Mumbai City,831,1,7,4,3,18,8,10,25
Delhi Dynamo,831,2,5,5,4,26,20,6,20
Kerala Blast,831,3,5,5,4,16,17,-1,20
FC Goa,831,4,5,3,6,14,18,-4,18
Kolkata,831,5,3,8,3,16,16,0,17
FC Pune City,831,6,4,5,5,14,16,-2,17
Chennaiyin,831,7,3,7,4,14,18,-4,16
NorthEast Un,831,8,4,3,7,10,15,-5,15
Kolkata,832,1,6,6,2,24,17,7,24
Mumbai City,832,2,6,5,3,17,9,8,23
Delhi Dynamo,832,3,5,6,3,24,17,7,21
NorthEast Un,832,4,5,4,5,13,12,1,19
Kerala Blast,832,5,4,5,5,12,20,-8,17
FC Pune City,832,6,4,4,6,15,18,-3,16
Chennaiyin,832,7,3,7,4,16,20,-4,16
FC Goa,832,8,3,3,8,12,20,-8,12
Delhi Dynamo,833,1,6,6,2,30,18,12,24
Mumbai City,833,2,6,5,3,18,10,8,23
Kolkata,833,3,5,7,2,19,15,4,22
Chennaiyin,833,4,4,6,4,17,18,-1,18
FC Pune City,833,5,5,3,6,15,18,-3,18
Kerala Blast,833,6,4,5,5,9,14,-5,17
NorthEast Un,833,7,4,3,7,10,16,-6,15
FC Goa,833,8,3,3,8,11,20,-9,12
Mumbai City,834,1,7,4,3,17,8,9,25
Delhi Dynamo,834,2,4,7,3,22,16,6,19
Kolkata,834,3,3,9,2,16,15,1,18
Kerala Blast,834,4,4,6,4,11,15,-4,18
NorthEast Un,834,5,4,5,5,11,11,0,17
FC Pune City,834,6,4,5,5,13,15,-2,17
FC Goa,834,7,4,4,6,11,16,-5,16
Chennaiyin,834,8,3,6,5,14,19,-5,15
Delhi Dynamo,835,1,7,5,2,29,18,11,26
Mumbai City,835,2,6,4,4,16,10,6,22
Kolkata,835,3,5,6,3,18,15,3,21
Kerala Blast,835,4,5,4,5,13,16,-3,19
FC Goa,835,5,5,2,7,13,18,-5,17
NorthEast Un,835,6,4,4,6,11,12,-1,16
Chennaiyin,835,7,3,6,5,13,18,-5,15
FC Pune City,835,8,4,3,7,12,18,-6,15
Mumbai City,836,1,6,5,3,16,8,8,23
Kolkata,836,2,5,7,2,20,13,7,22
Delhi Dynamo,836,3,5,6,3,24,15,9,21
FC Goa,836,4,5,3,6,11,14,-3,18
Kerala Blast,836,5,4,5,5,9,17,-8,17
NorthEast Un,836,6,4,4,6,9,12,-3,16
FC Pune City,836,7,4,4,6,13,17,-4,16
Chennaiyin,836,8,3,6,5,13,19,-6,15
Mumbai City,837,1,7,4,3,17,8,9,25
Delhi Dynamo,837,2,5,6,3,23,16,7,21
Kolkata,837,3,5,6,3,17,15,2,21
NorthEast Un,837,4,5,4,5,12,10,2,19
FC Pune City,837,5,5,4,5,16,16,0,19
Kerala Blast,837,6,4,5,5,11,17,-6,17
Chennaiyin,837,7,3,5,6,13,20,-7,14
FC Goa,837,8,4,2,8,10,17,-7,14
Mumbai City,838,1,7,4,3,17,8,9,25
Kolkata,838,2,6,6,2,19,13,6,24
Delhi Dynamo,838,3,6,5,3,25,16,9,23
FC Pune City,838,4,5,3,6,14,16,-2,18
Kerala Blast,838,5,5,3,6,13,17,-4,18
NorthEast Un,838,6,5,2,7,12,16,-4,17
Chennaiyin,838,7,3,5,6,15,22,-7,14
FC Goa,838,8,4,2,8,12,19,-7,14
Mumbai City,839,1,7,4,3,19,9,10,25
NorthEast Un,839,2,6,2,6,18,15,3,20
Kolkata,839,3,4,8,2,16,14,2,20
Kerala Blast,839,4,5,5,4,13,16,-3,20
Delhi Dynamo,839,5,4,5,5,26,23,3,17
FC Pune City,839,6,4,5,5,16,18,-2,17
FC Goa,839,7,5,2,7,12,16,-4,17
Chennaiyin,839,8,3,5,6,14,23,-9,14
Delhi Dynamo,840,1,6,6,2,28,16,12,24
Mumbai City,840,2,6,4,4,17,12,5,22
Kerala Blast,840,3,6,4,4,15,15,0,22
Kolkata,840,4,4,6,4,15,16,-1,18
Chennaiyin,840,5,4,6,4,17,19,-2,18
FC Pune City,840,6,5,3,6,15,18,-3,18
NorthEast Un,840,7,4,3,7,11,15,-4,15
FC Goa,840,8,3,4,7,10,17,-7,13
Mumbai City,841,1,7,4,3,18,9,9,25
Kerala Blast,841,2,6,4,4,17,16,1,22
Kolkata,841,3,4,8,2,19,16,3,20
FC Goa,841,4,5,3,6,12,16,-4,18
Delhi Dynamo,841,5,4,5,5,23,19,4,17
NorthEast Un,841,6,5,2,7,12,14,-2,17
Chennaiyin,841,7,4,5,5,15,19,-4,17
FC Pune City,841,8,4,3,7,13,20,-7,15
Mumbai City,842,1,6,4,4,19,12,7,22
Delhi Dynamo,842,2,5,6,3,28,21,7,21
Kolkata,842,3,4,7,3,19,15,4,19
NorthEast Un,842,4,5,4,5,16,13,3,19
Kerala Blast,842,5,5,4,5,16,22,-6,19
FC Goa,842,6,5,3,6,12,15,-3,18
FC Pune City,842,7,4,4,6,13,18,-5,16
Chennaiyin,842,8,3,6,5,13,20,-7,15
Mumbai City,843,1,6,5,3,17,9,8,23
Delhi Dynamo,843,2,5,7,2,24,15,9,22
Kerala Blast,843,3,6,3,5,17,17,0,21
Chennaiyin,843,4,5,5,4,18,19,-1,20
Kolkata,843,5,4,7,3,20,17,3,19
FC Pune City,843,6,4,4,6,13,20,-7,16
NorthEast Un,843,7,4,3,7,10,14,-4,15
FC Goa,843,8,4,2,8,14,22,-8,14
Delhi Dynamo,844,1,6,5,3,25,16,9,23
Mumbai City,844,2,6,4,4,16,9,7,22
Kerala Blast,844,3,5,5,4,13,16,-3,20
Kolkata,844,4,4,7,3,16,15,1,19
NorthEast Un,844,5,5,2,7,12,14,-2,17
FC Goa,844,6,5,2,7,14,18,-4,17
Chennaiyin,844,7,4,5,5,16,21,-5,17
FC Pune City,844,8,4,4,6,13,16,-3,16
Mumbai City,845,1,7,4,3,18,9,9,25
Delhi Dynamo,845,2,6,5,3,27,17,10,23
Kolkata,845,3,4,8,2,16,13,3,20
FC Pune City,845,4,5,4,5,16,17,-1,19
Chennaiyin,845,5,4,6,4,15,18,-3,18
NorthEast Un,845,6,4,4,6,10,13,-3,16
Kerala Blast,845,7,4,4,6,12,19,-7,16
FC Goa,845,8,3,3,8,10,18,-8,12
Mumbai City,846,1,6,4,4,16,9,7,22
Delhi Dynamo,846,2,5,6,3,22,16,6,21
NorthEast Un,846,3,6,3,5,15,11,4,21
Kolkata,846,4,4,7,3,15,14,1,19
Kerala Blast,846,5,5,4,5,13,19,-6,19
FC Goa,846,6,5,3,6,12,14,-2,18
FC Pune City,846,7,4,4,6,13,16,-3,16
Chennaiyin,846,8,3,5,6,14,21,-7,14
Mumbai City,847,1,7,4,3,21,8,13,25
Delhi Dynamo,847,2,6,5,3,24,20,4,23
Kolkata,847,3,5,7,2,19,14,5,22
Chennaiyin,847,4,5,5,4,17,18,-1,20
Kerala Blast,847,5,5,4,5,13,18,-5,19
FC Pune City,847,6,5,3,6,15,16,-1,18
NorthEast Un,847,7,4,2,8,11,15,-4,14
FC Goa,847,8,3,2,9,10,21,-11,11
Mumbai City,848,1,7,4,3,19,9,10,25
Kolkata,848,2,5,7,2,22,17,5,22
Delhi Dynamo,848,3,5,5,4,23,18,5,20
Kerala Blast,848,4,5,4,5,14,16,-2,19
Chennaiyin,848,5,4,6,4,16,18,-2,18
NorthEast Un,848,6,5,2,7,10,14,-4,17
FC Pune City,848,7,4,4,6,13,18,-5,16
FC Goa,848,8,3,4,7,11,18,-7,13
Mumbai City,849,1,6,5,3,18,10,8,23
NorthEast Un,849,2,7,2,5,14,10,4,23
Kolkata,849,3,5,7,2,17,13,4,22
Delhi Dynamo,849,4,4,6,4,24,20,4,18
FC Goa,849,5,5,2,7,12,16,-4,17
Kerala Blast,849,6,4,5,5,11,16,-5,17
FC Pune City,849,7,4,4,6,13,17,-4,16
Chennaiyin,849,8,3,5,6,14,21,-7,14
Mumbai City,850,1,7,4,3,18,8,10,25
Delhi Dynamo,850,2,5,6,3,23,16,7,21
Kolkata,850,3,4,7,3,16,14,2,19
Kerala Blast,850,4,5,4,5,11,15,-4,19
FC Goa,850,5,5,3,6,14,15,-1,18
FC Pune City,850,6,5,3,6,14,17,-3,18
NorthEast Un,850,7,4,3,7,11,14,-3,15
Chennaiyin,850,8,3,6,5,15,23,-8,15
Delhi Dynamo,851,1,6,5,3,23,15,8,23
Mumbai City,851,2,6,4,4,16,9,7,22
FC Pune City,851,3,6,3,5,17,17,0,21
Chennaiyin,851,4,4,6,4,17,19,-2,18
Kerala Blast,851,5,4,5,5,12,17,-5,17
FC Goa,851,6,5,2,7,11,17,-6,17
Kolkata,851,7,3,7,4,16,17,-1,16
NorthEast Un,851,8,4,4,6,11,12,-1,16
Delhi Dynamo,852,1,6,5,3,23,15,8,23
Mumbai City,852,2,6,4,4,16,9,7,22
Kolkata,852,3,5,6,3,19,16,3,21
FC Pune City,852,4,6,3,5,16,16,0,21
Kerala Blast,852,5,5,3,6,11,16,-5,18
Chennaiyin,852,6,3,7,4,16,20,-4,16
NorthEast Un,852,7,4,3,7,11,14,-3,15
FC Goa,852,8,4,3,7,11,17,-6,15
Mumbai City,853,1,7,4,3,17,8,9,25
Kerala Blast,853,2,6,4,4,12,14,-2,22
Delhi Dynamo,853,3,4,7,3,22,16,6,19
FC Pune City,853,4,5,3,6,15,15,0,18
FC Goa,853,5,5,3,6,10,14,-4,18
NorthEast Un,853,6,4,4,6,11,12,-1,16
Kolkata,853,7,3,7,4,14,17,-3,16
Chennaiyin,853,8,3,6,5,14,19,-5,15
Mumbai City,854,1,7,4,3,17,8,9,25
Delhi Dynamo,854,2,5,6,3,26,18,8,21
FC Pune City,854,3,6,3,5,16,15,1,21
Kerala Blast,854,4,6,3,5,11,14,-3,21
Kolkata,854,5,3,7,4,15,17,-2,16
FC Goa,854,6,4,4,6,15,18,-3,16
NorthEast Un,854,7,4,3,7,10,13,-3,15
Chennaiyin,854,8,3,6,5,14,21,-7,15
Mumbai City,855,1,7,4,3,20,8,12,25
Kolkata,855,2,6,6,2,18,14,4,24
Delhi Dynamo,855,3,4,7,3,24,21,3,19
NorthEast Un,855,4,5,3,6,16,14,2,18
Chennaiyin,855,5,4,6,4,15,17,-2,18
FC Pune City,855,6,4,4,6,12,15,-3,16
Kerala Blast,855,7,4,4,6,11,20,-9,16
FC Goa,855,8,3,4,7,10,17,-7,13
Delhi Dynamo,856,1,7,5,2,26,15,11,26
Mumbai City,856,2,6,4,4,16,9,7,22
Kerala Blast,856,3,6,3,5,14,16,-2,21
Kolkata,856,4,4,7,3,17,16,1,19
NorthEast Un,856,5,5,3,6,13,13,0,18
Chennaiyin,856,6,3,7,4,16,20,-4,16
FC Pune City,856,7,4,3,7,13,18,-5,15
FC Goa,856,8,3,4,7,11,19,-8,13
Mumbai City,857,1,6,5,3,17,9,8,23
Kolkata,857,2,5,7,2,19,13,6,22
Delhi Dynamo,857,3,5,6,3,24,17,7,21
Kerala Blast,857,4,5,4,5,12,17,-5,19
Chennaiyin,857,5,4,6,4,15,18,-3,18
NorthEast Un,857,6,5,2,7,12,14,-2,17
FC Pune City,857,7,4,4,6,12,16,-4,16
FC Goa,857,8,3,4,7,10,17,-7,13
Mumbai City,858,1,7,4,3,20,9,11,25
Delhi Dynamo,858,2,5,6,3,26,20,6,21
Kolkata,858,3,4,8,2,18,15,3,20
Kerala Blast,858,4,5,4,5,12,17,-5,19
NorthEast Un,858,5,4,5,5,10,10,0,17
FC Pune City,858,6,4,4,6,12,15,-3,16
Chennaiyin,858,7,3,7,4,14,18,-4,16
FC Goa,858,8,3,4,7,11,19,-8,13
Delhi Dynamo,859,1,5,7,2,25,17,8,22
Mumbai City,859,2,6,4,4,16,9,7,22
Kolkata,859,3,5,7,2,19,14,5,22
Chennaiyin,859,4,4,6,4,14,17,-3,18
FC Pune City,859,4,5,3,6,14,17,-3,18
Kerala Blast,859,6,5,3,6,10,16,-6,18
NorthEast Un,859,7,4,3,7,10,12,-2,15
FC Goa,859,8,3,5,6,12,18,-6,14
Mumbai City,860,1,7,4,3,23,8,15,25
Delhi Dynamo,860,2,5,5,4,25,24,1,20
NorthEast Un,860,3,5,4,5,15,13,2,19
Kolkata,860,4,4,7,3,15,15,0,19
Kerala Blast,860,5,5,4,5,10,14,-4,19
FC Pune City,860,6,4,4,6,13,16,-3,16
Chennaiyin,860,7,3,7,4,16,20,-4,16
FC Goa,860,8,4,3,7,10,17,-7,15
Mumbai City,861,1,7,4,3,18,8,10,25
Kolkata,861,2,5,6,3,16,14,2,21
NorthEast Un,861,3,6,3,5,12,10,2,21
Delhi Dynamo,861,4,5,5,4,23,18,5,20
Kerala Blast,861,5,5,4,5,11,15,-4,19
FC Pune City,861,6,4,3,7,14,18,-4,15
Chennaiyin,861,7,3,6,5,14,19,-5,15
FC Goa,861,8,4,3,7,10,16,-6,15
Delhi Dynamo,862,1,7,5,2,29,18,11,26
Mumbai City,862,2,6,4,4,19,12,7,22
Kolkata,862,3,4,8,2,19,16,3,20
FC Pune City,862,4,5,4,5,16,17,-1,19
Chennaiyin,862,5,4,6,4,16,19,-3,18
Kerala Blast,862,6,5,3,6,13,18,-5,18
NorthEast Un,862,7,4,2,8,10,15,-5,14
FC Goa,862,8,3,4,7,11,18,-7,13
Mumbai City,863,1,6,4,4,17,10,7,22
Kolkata,863,2,5,6,3,18,14,4,21
Delhi Dynamo,863,3,5,5,4,23,19,4,20
Chennaiyin,863,4,5,5,4,18,18,0,20
FC Pune City,863,5,5,3,6,17,18,-1,18
NorthEast Un,863,6,5,3,6,12,14,-2,18
FC Goa,863,7,5,2,7,14,17,-3,17
Kerala Blast,863,8,4,4,6,12,21,-9,16
Delhi Dynamo,864,1,7,5,2,29,17,12,26
Mumbai City,864,2,6,4,4,16,11,5,22
Kolkata,864,3,4,8,2,17,15,2,20
Chennaiyin,864,4,5,5,4,19,19,0,20
FC Pune City,864,5,4,5,5,14,16,-2,17
Kerala Blast,864,6,4,5,5,13,18,-5,17
NorthEast Un,864,7,4,3,7,15,18,-3,15
FC Goa,864,8,3,3,8,10,19,-9,12
Mumbai City,865,1,7,4,3,18,9,9,25
Kerala Blast,865,2,7,3,4,18,16,2,24
Kolkata,865,3,5,6,3,18,17,1,21
Delhi Dynamo,865,4,5,5,4,24,21,3,20
Chennaiyin,865,5,4,6,4,17,19,-2,18
NorthEast Un,865,6,5,2,7,14,14,0,17
FC Pune City,865,7,4,3,7,14,19,-5,15
FC Goa,865,8,3,3,8,11,19,-8,12
Mumbai City,866,1,7,4,3,18,8,10,25
Kerala Blast,866,2,6,3,5,16,17,-1,21
Kolkata,866,3,4,8,2,17,14,3,20
Delhi Dynamo,866,4,4,6,4,23,19,4,18
Chennaiyin,866,5,4,6,4,17,18,-1,18
FC Pune City,866,6,4,4,6,12,17,-5,16
FC Goa,866,7,4,4,6,10,15,-5,16
NorthEast Un,866,8,4,3,7,11,16,-5,15
Mumbai City,867,1,7,4,3,17,8,9,25
Kolkata,867,2,5,7,2,16,13,3,22
Delhi Dynamo,867,3,5,6,3,25,16,9,21
NorthEast Un,867,4,6,3,5,11,9,2,21
FC Pune City,867,5,5,3,6,15,16,-1,18
Chennaiyin,867,6,4,5,5,16,20,-4,17
Kerala Blast,867,7,4,4,6,9,16,-7,16
FC Goa,867,8,3,2,9,11,22,-11,11
Mumbai City,868,1,7,4,3,18,8,10,25
Kolkata,868,2,4,7,3,16,15,1,19
Kerala Blast,868,3,5,4,5,13,17,-4,19
FC Pune City,868,4,5,3,6,15,17,-2,18
Chennaiyin,868,5,4,6,4,16,19,-3,18
FC Goa,868,6,5,3,6,14,17,-3,18
Delhi Dynamo,868,7,4,5,5,23,21,2,17
NorthEast Un,868,8,5,2,7,12,13,-1,17
Delhi Dynamo,869,1,6,5,3,23,15,8,23
Mumbai City,869,2,6,4,4,16,9,7,22
Kerala Blast,869,3,6,3,5,14,21,-7,21
NorthEast Un,869,4,6,2,6,13,11,2,20
FC Pune City,869,5,5,4,5,19,16,3,19
Kolkata,869,6,3,8,3,17,17,0,17
FC Goa,869,7,4,3,7,11,16,-5,15
Chennaiyin,869,8,3,5,6,14,22,-8,14
Mumbai City,870,1,6,5,3,16,8,8,23
Delhi Dynamo,870,2,5,6,3,26,17,9,21
Kolkata,870,3,4,8,2,18,15,3,20
NorthEast Un,870,4,6,2,6,16,17,-1,20
FC Pune City,870,5,5,4,5,16,16,0,19
Kerala Blast,870,6,5,4,5,16,19,-3,19
Chennaiyin,870,7,3,5,6,15,21,-6,14
FC Goa,870,8,4,2,8,9,19,-10,14
Mumbai City,871,1,6,5,3,17,9,8,23
Delhi Dynamo,871,2,5,6,3,25,17,8,21
Kolkata,871,3,5,6,3,15,14,1,21
Kerala Blast,871,4,6,3,5,13,14,-1,21
NorthEast Un,871,5,6,2,6,12,11,1,20
Chennaiyin,871,6,4,5,5,15,18,-3,17
FC Pune City,871,7,4,3,7,12,17,-5,15
FC Goa,871,8,4,2,8,10,19,-9,14
Mumbai City,872,1,7,4,3,20,9,11,25
Kolkata,872,2,5,6,3,17,16,1,21
NorthEast Un,872,3,5,3,6,10,10,0,18
FC Pune City,872,4,5,3,6,16,17,-1,18
Chennaiyin,872,5,4,6,4,16,18,-2,18
Kerala Blast,872,6,5,3,6,11,17,-6,18
Delhi Dynamo,872,7,4,5,5,23,22,1,17
FC Goa,872,8,5,2,7,15,19,-4,17
Kolkata,873,1,6,6,2,20,13,7,24
Mumbai City,873,2,6,4,4,17,12,5,22
Delhi Dynamo,873,3,5,6,3,26,17,9,21
Kerala Blast,873,4,6,3,5,14,16,-2,21
NorthEast Un,873,5,6,2,6,14,13,1,20
Chennaiyin,873,6,3,6,5,17,22,-5,15
FC Pune City,873,7,4,3,7,12,20,-8,15
FC Goa,873,8,3,4,7,10,17,-7,13
Mumbai City,874,1,6,5,3,18,10,8,23
Kolkata,874,2,5,7,2,21,15,6,22
Delhi Dynamo,874,3,5,6,3,24,17,7,21
Chennaiyin,874,4,5,5,4,16,17,-1,20
Kerala Blast,874,5,5,4,5,15,18,-3,19
FC Pune City,874,6,4,5,5,13,15,-2,17
NorthEast Un,874,7,5,2,7,10,13,-3,17
FC Goa,874,8,3,2,9,9,21,-12,11
Mumbai City,875,1,6,4,4,17,10,7,22
Kolkata,875,2,5,7,2,18,13,5,22
Delhi Dynamo,875,3,5,6,3,23,16,7,21
NorthEast Un,875,4,5,3,6,13,13,0,18
Chennaiyin,875,5,4,5,5,16,20,-4,17
Kerala Blast,875,6,4,5,5,12,17,-5,17
FC Goa,875,7,5,2,7,11,17,-6,17
FC Pune City,875,8,4,4,6,12,16,-4,16
Mumbai City,876,1,7,4,3,18,8,10,25
Delhi Dynamo,876,2,6,5,3,26,16,10,23
FC Pune City,876,3,6,3,5,14,14,0,21
Kolkata,876,4,4,6,4,16,16,0,18
Chennaiyin,876,5,4,5,5,14,18,-4,17
FC Goa,876,6,5,2,7,10,16,-6,17
Kerala Blast,876,7,4,4,6,11,17,-6,16
NorthEast Un,876,8,4,3,7,9,13,-4,15
Mumbai City,877,1,7,4,3,17,8,9,25
Kolkata,877,2,5,7,2,19,13,6,22
NorthEast Un,877,3,6,3,5,13,11,2,21
Delhi Dynamo,877,4,4,6,4,23,18,5,18
FC Pune City,877,5,5,3,6,13,15,-2,18
FC Goa,877,6,4,4,6,11,16,-5,16
Chennaiyin,877,7,3,6,5,14,19,-5,15
Kerala Blast,877,8,4,3,7,9,19,-10,15
Mumbai City,878,1,7,4,3,18,8,10,25
Delhi Dynamo,878,2,5,6,3,25,19,6,21
Kolkata,878,3,5,6,3,19,16,3,21
FC Pune City,878,4,5,4,5,15,16,-1,19
NorthEast Un,878,5,5,3,6,13,13,0,18
Chennaiyin,878,6,4,5,5,16,22,-6,17
Kerala Blast,878,7,4,4,6,12,19,-7,16
FC Goa,878,8,4,2,8,13,18,-5,14
Mumbai City,879,1,7,4,3,17,8,9,25
Kolkata,879,2,5,7,2,17,14,3,22
Delhi Dynamo,879,3,5,5,4,22,17,5,20
NorthEast Un,879,4,6,2,6,14,10,4,20
Chennaiyin,879,5,5,5,4,16,17,-1,20
FC Pune City,879,6,4,4,6,12,15,-3,16
Kerala Blast,879,7,4,4,6,10,18,-8,16
FC Goa,879,8,3,3,8,9,18,-9,12
Mumbai City,880,1,7,4,3,18,8,10,25
Kerala Blast,880,2,6,4,4,12,14,-2,22
FC Goa,880,3,6,2,6,14,15,-1,20
FC Pune City,880,4,5,4,5,14,15,-1,19
Delhi Dynamo,880,5,4,5,5,23,20,3,17
NorthEast Un,880,6,5,2,7,13,15,-2,17
Chennaiyin,880,7,4,5,5,16,19,-3,17
Kolkata,880,8,3,6,5,14,18,-4,15
Mumbai City,881,1,7,4,3,19,8,11,25
NorthEast Un,881,2,6,3,5,11,9,2,21
Delhi Dynamo,881,3,5,5,4,25,20,5,20
Kolkata,881,4,4,7,3,16,14,2,19
Kerala Blast,881,5,5,4,5,12,16,-4,19
FC Pune City,881,6,5,3,6,15,18,-3,18
Chennaiyin,881,7,3,6,5,13,18,-5,15
FC Goa,881,8,3,4,7,11,19,-8,13
Kolkata,882,1,6,6,2,22,18,4,24
Mumbai City,882,2,6,5,3,16,8,8,23
Delhi Dynamo,882,3,5,6,3,26,16,10,21
Kerala Blast,882,4,6,3,5,14,15,-1,21
Chennaiyin,882,5,4,5,5,15,18,-3,17
NorthEast Un,882,6,5,2,7,12,16,-4,17
FC Pune City,882,7,4,3,7,15,19,-4,15
FC Goa,882,8,4,2,8,12,22,-10,14
Mumbai City,883,1,7,4,3,19,8,11,25
Kolkata,883,2,5,6,3,18,15,3,21
FC Pune City,883,3,6,3,5,16,16,0,21
Delhi Dynamo,883,4,5,5,4,24,19,5,20
NorthEast Un,883,5,5,3,6,11,11,0,18
Chennaiyin,883,6,4,5,5,15,19,-4,17
Kerala Blast,883,7,4,4,6,10,17,-7,16
FC Goa,883,8,4,2,8,11,19,-8,14
Mumbai City,884,1,7,4,3,17,8,9,25
Kerala Blast,884,2,6,3,5,16,16,0,21
Delhi Dynamo,884,3,5,5,4,25,19,6,20
FC Goa,884,4,6,2,6,15,16,-1,20
Kolkata,884,5,4,6,4,18,17,1,18
FC Pune City,884,6,5,3,6,15,19,-4,18
Chennaiyin,884,7,3,6,5,15,20,-5,15
NorthEast Un,884,8,4,3,7,11,17,-6,15
Mumbai City,885,1,7,4,3,19,8,11,25
Kolkata,885,2,5,6,3,17,15,2,21
Delhi Dynamo,885,3,5,5,4,23,19,4,20
NorthEast Un,885,4,6,2,6,13,12,1,20
FC Goa,885,5,6,2,6,13,15,-2,20
Kerala Blast,885,6,5,3,6,16,18,-2,18
FC Pune City,885,7,4,3,7,13,21,-8,15
Chennaiyin,885,8,3,5,6,14,20,-6,14
Mumbai City,886,1,6,5,3,17,9,8,23
Kerala Blast,886,2,6,4,4,16,16,0,22
Delhi Dynamo,886,3,5,6,3,26,17,9,21
NorthEast Un,886,4,5,4,5,11,10,1,19
Chennaiyin,886,5,4,6,4,14,17,-3,18
FC Pune City,886,6,5,3,6,14,18,-4,18
Kolkata,886,7,3,6,5,15,17,-2,15
FC Goa,886,8,4,2,8,9,18,-9,14
Delhi Dynamo,887,1,6,5,3,26,18,8,23
Mumbai City,887,2,6,4,4,16,11,5,22
Kolkata,887,3,5,6,3,18,15,3,21
NorthEast Un,887,4,6,2,6,15,12,3,20
Chennaiyin,887,5,5,5,4,19,19,0,20
Kerala Blast,887,6,5,4,5,13,17,-4,19
FC Pune City,887,7,4,4,6,13,17,-4,16
FC Goa,887,8,3,2,9,9,20,-11,11
Delhi Dynamo,888,1,6,6,2,26,16,10,24
Mumbai City,888,2,6,5,3,18,10,8,23
Kerala Blast,888,3,6,4,4,12,14,-2,22
FC Pune City,888,4,5,3,6,15,16,-1,18
Chennaiyin,888,5,4,5,5,14,18,-4,17
FC Goa,888,6,5,2,7,10,16,-6,17
Kolkata,888,7,3,7,4,15,17,-2,16
NorthEast Un,888,8,4,2,8,9,12,-3,14
Mumbai City,889,1,7,4,3,18,9,9,25
Kerala Blast,889,2,6,4,4,14,15,-1,22
Delhi Dynamo,889,3,5,5,4,24,19,5,20
NorthEast Un,889,4,5,3,6,13,12,1,18
FC Goa,889,5,5,3,6,12,15,-3,18
Kolkata,889,6,3,7,4,14,16,-2,16
FC Pune City,889,7,4,4,6,14,17,-3,16
Chennaiyin,889,8,3,6,5,14,20,-6,15
Delhi Dynamo,890,1,6,6,2,26,15,11,24
Mumbai City,890,2,6,5,3,16,8,8,23
Kerala Blast,890,3,6,4,4,13,13,0,22
FC Pune City,890,4,5,3,6,13,15,-2,18
Kolkata,890,5,3,8,3,16,16,0,17
NorthEast Un,890,6,4,3,7,10,14,-4,15
Chennaiyin,890,7,3,6,5,14,19,-5,15
FC Goa,890,8,4,3,7,13,21,-8,15
Delhi Dynamo,891,1,6,5,3,23,15,8,23
Mumbai City,891,2,6,4,4,16,9,7,22
Kolkata,891,3,5,6,3,16,15,1,21
NorthEast Un,891,4,6,2,6,12,11,1,20
Chennaiyin,891,5,5,5,4,17,18,-1,20
Kerala Blast,891,6,5,4,5,14,17,-3,19
FC Pune City,891,7,4,4,6,13,16,-3,16
FC Goa,891,8,3,2,9,9,19,-10,11
Mumbai City,892,1,7,4,3,19,8,11,25
Delhi Dynamo,892,2,5,6,3,25,20,5,21
Kolkata,892,3,5,6,3,19,15,4,21
Kerala Blast,892,4,6,3,5,14,18,-4,21
NorthEast Un,892,5,5,2,7,14,15,-1,17
Chennaiyin,892,6,4,5,5,17,20,-3,17
FC Pune City,892,7,4,3,7,14,19,-5,15
FC Goa,892,8,4,3,7,13,20,-7,15
Mumbai City,893,1,6,4,4,16,11,5,22
Delhi Dynamo,893,2,5,6,3,26,18,8,21
Kerala Blast,893,3,6,3,5,15,14,1,21
Kolkata,893,4,5,6,3,17,17,0,21
NorthEast Un,893,5,5,3,6,12,13,-1,18
FC Pune City,893,6,5,3,6,14,16,-2,18
Chennaiyin,893,7,3,6,5,13,18,-5,15
FC Goa,893,8,4,3,7,11,17,-6,15
Mumbai City,894,1,7,4,3,19,9,10,25
Kerala Blast,894,2,6,4,4,18,16,2,22
Delhi Dynamo,894,3,5,6,3,27,19,8,21
Chennaiyin,894,4,5,5,4,16,17,-1,20
FC Pune City,894,5,5,4,5,13,14,-1,19
Kolkata,894,6,3,7,4,16,18,-2,16
NorthEast Un,894,7,4,3,7,11,16,-5,15
FC Goa,894,8,3,3,8,10,21,-11,12
Mumbai City,895,1,7,4,3,18,9,9,25
Kerala Blast,895,2,7,3,4,15,13,2,24
Delhi Dynamo,895,3,6,5,3,28,16,12,23
Chennaiyin,895,4,5,5,4,22,19,3,20
Kolkata,895,5,3,8,3,14,14,0,17
FC Pune City,895,6,4,4,6,12,17,-5,16
NorthEast Un,895,7,4,2,8,10,19,-9,14
FC Goa,895,8,3,3,8,10,22,-12,12
Mumbai City,896,1,7,4,3,18,8,10,25
NorthEast Un,896,2,6,3,5,13,11,2,21
Delhi Dynamo,896,3,5,5,4,23,18,5,20
Kolkata,896,4,4,7,3,15,15,0,19
Kerala Blast,896,5,5,4,5,12,16,-4,19
FC Goa,896,6,5,2,7,13,16,-3,17
FC Pune City,896,7,4,3,7,13,17,-4,15
Chennaiyin,896,8,3,6,5,13,19,-6,15
Mumbai City,897,1,7,4,3,18,8,10,25
Kerala Blast,897,2,7,3,4,12,13,-1,24
Delhi Dynamo,897,3,5,5,4,26,21,5,20
Kolkata,897,4,3,8,3,14,14,0,17
NorthEast Un,897,5,5,2,7,14,15,-1,17
Chennaiyin,897,6,4,5,5,14,18,-4,17
FC Pune City,897,7,4,4,6,12,15,-3,16
FC Goa,897,8,4,3,7,10,16,-6,15
Mumbai City,898,1,7,4,3,19,8,11,25
Delhi Dynamo,898,2,5,5,4,26,21,5,20
NorthEast Un,898,3,5,4,5,16,15,1,19
Kerala Blast,898,4,5,4,5,13,18,-5,19
Kolkata,898,5,4,6,4,18,19,-1,18
FC Pune City,898,6,5,3,6,16,17,-1,18
Chennaiyin,898,7,4,6,4,16,19,-3,18
FC Goa,898,8,4,2,8,11,18,-7,14
Kolkata,899,1,6,6,2,19,14,5,24
Mumbai City,899,2,6,4,4,18,11,7,22
Delhi Dynamo,899,3,5,6,3,25,18,7,21
Kerala Blast,899,4,6,3,5,14,15,-1,21
FC Goa,899,5,5,2,7,13,17,-4,17
Chennaiyin,899,6,4,5,5,15,20,-5,17
NorthEast Un,899,7,4,3,7,10,13,-3,15
FC Pune City,899,8,4,3,7,13,19,-6,15
Mumbai City,900,1,7,4,3,17,8,9,25
NorthEast Un,900,2,6,3,5,15,11,4,21
Delhi Dynamo,900,3,5,5,4,24,19,5,20
Kerala Blast,900,4,5,5,4,11,14,-3,20
Kolkata,900,5,4,7,3,18,15,3,19
FC Pune City,900,6,4,4,6,12,17,-5,16
FC Goa,900,7,4,3,7,12,18,-6,15
Chennaiyin,900,8,3,5,6,13,20,-7,14
Delhi Dynamo,901,1,6,6,2,25,16,9,24
Mumbai City,901,2,6,4,4,16,9,7,22
NorthEast Un,901,3,5,4,5,12,11,1,19
FC Pune City,901,4,5,4,5,15,16,-1,19
Kolkata,901,5,4,6,4,19,17,2,18
FC Goa,901,6,5,2,7,13,18,-5,17
Kerala Blast,901,7,4,5,5,12,19,-7,17
Chennaiyin,901,8,3,5,6,14,20,-6,14
Delhi Dynamo,902,1,7,5,2,28,17,11,26
Mumbai City,902,2,6,4,4,18,11,7,22
NorthEast Un,902,3,6,2,6,12,11,1,20
Kolkata,902,4,3,8,3,16,16,0,17
FC Pune City,902,5,4,5,5,14,16,-2,17
Chennaiyin,902,6,4,5,5,14,19,-5,17
Kerala Blast,902,7,4,5,5,11,16,-5,17
FC Goa,902,8,4,2,8,11,18,-7,14
Mumbai City,903,1,7,4,3,19,9,10,25
NorthEast Un,903,2,6,3,5,14,11,3,21
Kolkata,903,3,4,7,3,15,13,2,19
Kerala Blast,903,4,5,4,5,10,15,-5,19
Delhi Dynamo,903,5,4,6,4,25,21,4,18
FC Goa,903,6,5,3,6,15,16,-1,18
FC Pune City,903,7,4,4,6,12,15,-3,16
Chennaiyin,903,8,3,5,6,14,24,-10,14
Mumbai City,904,1,7,4,3,20,9,11,25
Kerala Blast,904,2,7,3,4,17,14,3,24
Delhi Dynamo,904,3,6,5,3,29,21,8,23
FC Pune City,904,4,5,3,6,14,17,-3,18
Chennaiyin,904,5,4,5,5,16,21,-5,17
Kolkata,904,6,3,7,4,13,15,-2,16
FC Goa,904,7,4,3,7,14,18,-4,15
NorthEast Un,904,8,4,2,8,10,18,-8,14
Mumbai City,905,1,7,4,3,19,8,11,25
Kerala Blast,905,2,6,4,4,15,14,1,22
Delhi Dynamo,905,3,5,5,4,23,20,3,20
NorthEast Un,905,4,5,4,5,13,11,2,19
Kolkata,905,5,4,6,4,16,16,0,18
FC Goa,905,6,5,2,7,11,16,-5,17
Chennaiyin,905,7,3,6,5,15,20,-5,15
FC Pune City,905,8,4,3,7,12,19,-7,15
Kolkata,906,1,5,7,2,20,13,7,22
Mumbai City,906,2,6,4,4,17,10,7,22
Kerala Blast,906,3,6,3,5,11,18,-7,21
Delhi Dynamo,906,4,5,5,4,23,18,5,20
NorthEast Un,906,5,5,3,6,13,12,1,18
FC Goa,906,6,5,2,7,12,15,-3,17
FC Pune City,906,7,4,4,6,13,16,-3,16
Chennaiyin,906,8,3,6,5,15,22,-7,15
Kerala Blast,907,1,7,3,4,18,13,5,24
Delhi Dynamo,907,2,5,7,2,24,15,9,22
Mumbai City,907,3,6,4,4,16,10,6,22
Kolkata,907,4,5,6,3,20,13,7,21
Chennaiyin,907,5,4,5,5,17,18,-1,17
FC Goa,907,6,4,3,7,10,17,-7,15
NorthEast Un,907,7,4,3,7,9,18,-9,15
FC Pune City,907,8,4,3,7,12,22,-10,15
Mumbai City,908,1,6,4,4,16,10,6,22
Delhi Dynamo,908,2,5,5,4,23,16,7,20
Kolkata,908,3,4,8,2,17,15,2,20
Kerala Blast,908,4,5,5,4,13,16,-3,20
NorthEast Un,908,5,5,3,6,12,12,0,18
Chennaiyin,908,6,4,6,4,17,19,-2,18
FC Pune City,908,7,4,4,6,16,19,-3,16
FC Goa,908,8,4,3,7,11,18,-7,15
Mumbai City,909,1,7,4,3,20,10,10,25
Delhi Dynamo,909,2,5,6,3,27,20,7,21
Kolkata,909,3,4,7,3,16,15,1,19
NorthEast Un,909,4,5,3,6,12,12,0,18
FC Pune City,909,5,5,3,6,15,16,-1,18
Chennaiyin,909,6,4,5,5,16,20,-4,17
FC Goa,909,7,5,2,7,12,18,-6,17
Kerala Blast,909,8,4,4,6,12,19,-7,16
Mumbai City,910,1,7,4,3,19,9,10,25
Kerala Blast,910,2,6,4,4,12,14,-2,22
Kolkata,910,3,5,6,3,18,14,4,21
Delhi Dynamo,910,4,5,5,4,23,18,5,20
NorthEast Un,910,5,5,4,5,10,9,1,19
Chennaiyin,910,6,3,7,4,13,17,-4,16
FC Pune City,910,7,4,3,7,12,18,-6,15
FC Goa,910,8,3,3,8,8,16,-8,12
Kolkata,911,1,6,6,2,22,14,8,24
Mumbai City,911,2,6,4,4,16,10,6,22
Delhi Dynamo,911,3,5,6,3,24,16,8,21
NorthEast Un,911,4,5,4,5,12,11,1,19
Kerala Blast,911,5,5,3,6,14,19,-5,18
Chennaiyin,911,6,3,7,4,15,19,-4,16
FC Pune City,911,7,4,3,7,13,19,-6,15
FC Goa,911,8,4,3,7,11,19,-8,15
Mumbai City,912,1,6,5,3,16,8,8,23
NorthEast Un,912,2,7,2,5,15,10,5,23
Delhi Dynamo,912,3,5,6,3,26,17,9,21
Kolkata,912,4,5,6,3,17,14,3,21
Kerala Blast,912,5,5,3,6,11,17,-6,18
FC Pune City,912,6,4,3,7,12,16,-4,15
Chennaiyin,912,7,3,6,5,15,21,-6,15
FC Goa,912,8,4,3,7,11,20,-9,15
Mumbai City,913,1,7,4,3,18,9,9,25
FC Pune City,913,2,6,3,5,16,16,0,21
Kerala Blast,913,3,6,3,5,12,15,-3,21
Delhi Dynamo,913,4,5,5,4,25,19,6,20
FC Goa,913,5,5,3,6,12,16,-4,18
Chennaiyin,913,6,3,7,4,14,18,-4,16
Kolkata,913,7,3,6,5,14,16,-2,15
NorthEast Un,913,8,4,3,7,10,12,-2,15
Mumbai City,914,1,6,4,4,16,10,6,22
Delhi Dynamo,914,2,5,6,3,24,17,7,21
NorthEast Un,914,3,6,3,5,14,10,4,21
Kolkata,914,4,5,6,3,16,14,2,21
Kerala Blast,914,5,5,3,6,12,16,-4,18
Chennaiyin,914,6,3,7,4,16,20,-4,16
FC Goa,914,7,4,4,6,13,18,-5,16
FC Pune City,914,8,4,3,7,12,18,-6,15
Mumbai City,915,1,6,5,3,19,11,8,23
Delhi Dynamo,915,2,5,7,2,27,19,8,22
Kolkata,915,3,5,7,2,20,15,5,22
Kerala Blast,915,4,5,4,5,11,15,-4,19
Chennaiyin,915,5,4,6,4,16,19,-3,18
NorthEast Un,915,6,4,3,7,11,13,-2,15
FC Pune City,915,7,4,3,7,13,19,-6,15
FC Goa,915,8,3,5,6,12,18,-6,14
Kolkata,916,1,5,7,2,21,13,8,22
Mumbai City,916,2,6,4,4,16,9,7,22
Kerala Blast,916,3,6,4,4,13,14,-1,22
Delhi Dynamo,916,4,5,6,3,24,19,5,21
NorthEast Un,916,5,5,3,6,14,13,1,18
Chennaiyin,916,6,3,7,4,15,19,-4,16
FC Pune City,916,7,4,3,7,12,20,-8,15
FC Goa,916,8,3,4,7,10,18,-8,13
Mumbai City,917,1,6,5,3,17,9,8,23
Delhi Dynamo,917,2,5,6,3,24,17,7,21
Kolkata,917,3,4,8,2,17,15,2,20
FC Pune City,917,4,5,4,5,16,17,-1,19
Kerala Blast,917,5,5,4,5,16,19,-3,19
Chennaiyin,917,6,3,7,4,15,19,-4,16
NorthEast Un,917,7,4,3,7,13,16,-3,15
FC Goa,917,8,4,3,7,9,15,-6,15
Delhi Dynamo,918,1,6,6,2,27,17,10,24
Mumbai City,918,2,6,4,4,16,9,7,22
Kerala Blast,918,3,6,4,4,16,17,-1,22
FC Goa,918,4,5,3,6,13,15,-2,18
Kolkata,918,5,3,7,4,15,17,-2,16
NorthEast Un,918,6,4,4,6,13,15,-2,16
FC Pune City,918,7,4,4,6,15,18,-3,16
Chennaiyin,918,8,3,6,5,14,21,-7,15
Kerala Blast,919,1,7,3,4,14,14,0,24
Mumbai City,919,2,6,5,3,19,11,8,23
Delhi Dynamo,919,3,4,8,2,28,21,7,20
Kolkata,919,4,3,8,3,14,14,0,17
Chennaiyin,919,5,4,5,5,15,20,-5,17
FC Pune City,919,6,4,4,6,13,16,-3,16
FC Goa,919,7,4,4,6,13,17,-4,16
NorthEast Un,919,8,4,3,7,12,15,-3,15
Mumbai City,920,1,7,4,3,19,8,11,25
Delhi Dynamo,920,2,5,6,3,22,17,5,21
Kerala Blast,920,3,5,4,5,12,17,-5,19
Kolkata,920,4,4,6,4,18,18,0,18
NorthEast Un,920,5,5,3,6,10,10,0,18
FC Pune City,920,6,5,3,6,15,16,-1,18
FC Goa,920,7,5,3,6,13,16,-3,18
Chennaiyin,920,8,3,5,6,14,21,-7,14
Mumbai City,921,1,6,4,4,17,10,7,22
Kolkata,921,2,5,6,3,17,16,1,21
Kerala Blast,921,3,6,3,5,14,17,-3,21
Delhi Dynamo,921,4,5,5,4,25,19,6,20
FC Goa,921,5,6,2,6,15,15,0,20
NorthEast Un,921,6,5,2,7,11,14,-3,17
Chennaiyin,921,7,4,5,5,15,19,-4,17
FC Pune City,921,8,4,3,7,15,19,-4,15
Mumbai City,922,1,6,5,3,18,10,8,23
Kerala Blast,922,2,6,4,4,14,16,-2,22
Delhi Dynamo,922,3,5,6,3,28,18,10,21
Kolkata,922,4,4,7,3,19,17,2,19
NorthEast Un,922,5,5,4,5,13,11,2,19
Chennaiyin,922,6,3,6,5,14,19,-5,15
FC Pune City,922,7,4,3,7,13,18,-5,15
FC Goa,922,8,4,3,7,10,20,-10,15
Mumbai City,923,1,6,4,4,16,9,7,22
Delhi Dynamo,923,2,5,6,3,26,20,6,21
Kerala Blast,923,3,6,3,5,13,17,-4,21
NorthEast Un,923,4,6,2,6,16,15,1,20
FC Goa,923,5,5,3,6,17,17,0,18
FC Pune City,923,6,5,3,6,16,16,0,18
Kolkata,923,6,4,6,4,16,16,0,18
Chennaiyin,923,8,3,5,6,14,24,-10,14
Mumbai City,924,1,7,4,3,18,8,10,25
Delhi Dynamo,924,2,5,6,3,25,18,7,21
Kolkata,924,3,4,7,3,16,14,2,19
Kerala Blast,924,4,5,4,5,13,15,-2,19
NorthEast Un,924,5,5,3,6,12,13,-1,18
FC Goa,924,6,5,2,7,14,18,-4,17
Chennaiyin,924,7,4,5,5,15,20,-5,17
FC Pune City,924,8,4,3,7,12,19,-7,15
Mumbai City,925,1,7,4,3,18,9,9,25
Delhi Dynamo,925,2,5,6,3,25,18,7,21
Kolkata,925,3,5,6,3,16,13,3,21
NorthEast Un,925,4,5,4,5,12,11,1,19
Kerala Blast,925,5,5,4,5,11,15,-4,19
FC Pune City,925,6,5,3,6,13,15,-2,18
Chennaiyin,925,7,3,6,5,16,21,-5,15
FC Goa,925,8,3,3,8,12,21,-9,12
Mumbai City,926,1,7,4,3,18,9,9,25
Kerala Blast,926,2,6,3,5,13,15,-2,21
Delhi Dynamo,926,3,4,7,3,24,18,6,19
Kolkata,926,4,4,7,3,16,15,1,19
NorthEast Un,926,5,5,3,6,11,12,-1,18
Chennaiyin,926,6,4,5,5,15,19,-4,17
FC Pune City,926,7,4,4,6,13,16,-3,16
FC Goa,926,8,4,3,7,11,17,-6,15
Mumbai City,927,1,6,5,3,17,9,8,23
Kolkata,927,2,5,7,2,19,15,4,22
Delhi Dynamo,927,3,4,7,3,24,19,5,19
NorthEast Un,927,4,5,4,5,12,11,1,19
FC Goa,927,5,5,3,6,17,19,-2,18
FC Pune City,927,6,5,3,6,15,18,-3,18
Chennaiyin,927,7,3,6,5,15,21,-6,15
Kerala Blast,927,8,4,3,7,11,18,-7,15
Mumbai City,928,1,7,4,3,17,8,9,25
Kolkata,928,2,4,8,2,15,12,3,20
Kerala Blast,928,3,5,5,4,12,15,-3,20
Delhi Dynamo,928,4,4,6,4,23,20,3,18
NorthEast Un,928,5,5,3,6,12,12,0,18
FC Pune City,928,6,4,5,5,13,15,-2,17
FC Goa,928,7,5,2,7,14,17,-3,17
Chennaiyin,928,8,3,5,6,13,20,-7,14
Mumbai City,929,1,6,5,3,16,8,8,23
NorthEast Un,929,2,6,3,5,15,11,4,21
Kolkata,929,3,4,7,3,16,14,2,19
Delhi Dynamo,929,4,4,6,4,22,18,4,18
FC Pune City,929,5,5,3,6,13,15,-2,18
Kerala Blast,929,6,5,3,6,10,17,-7,18
Chennaiyin,929,7,3,7,4,14,18,-4,16
FC Goa,929,8,4,4,6,10,15,-5,16
Mumbai City,930,1,7,4,3,19,10,9,25
Kolkata,930,2,5,6,3,20,15,5,21
Delhi Dynamo,930,3,5,5,4,25,19,6,20
Kerala Blast,930,4,5,4,5,13,17,-4,19
NorthEast Un,930,5,5,3,6,12,14,-2,18
FC Pune City,930,6,5,3,6,14,17,-3,18
Chennaiyin,930,7,4,5,5,16,18,-2,17
FC Goa,930,8,4,2,8,9,18,-9,14
Mumbai City,931,1,7,4,3,19,10,9,25
Delhi Dynamo,931,2,5,6,3,27,19,8,21
Kolkata,931,3,5,6,3,17,14,3,21
Kerala Blast,931,4,6,3,5,13,16,-3,21
FC Pune City,931,5,5,3,6,14,16,-2,18
NorthEast Un,931,6,5,2,7,11,14,-3,17
FC Goa,931,7,4,3,7,11,17,-6,15
Chennaiyin,931,8,3,5,6,14,20,-6,14
Mumbai City,932,1,7,4,3,18,9,9,25
Delhi Dynamo,932,2,6,5,3,29,16,13,23
Kolkata,932,3,5,6,3,18,16,2,21
FC Pune City,932,4,6,3,5,17,16,1,21
Chennaiyin,932,5,5,5,4,15,17,-2,20
NorthEast Un,932,6,5,2,7,12,17,-5,17
Kerala Blast,932,7,4,3,7,12,20,-8,15
FC Goa,932,8,3,2,9,9,19,-10,11
Mumbai City,933,1,7,4,3,18,9,9,25
Kolkata,933,2,5,7,2,18,12,6,22
Delhi Dynamo,933,3,5,5,4,27,19,8,20
NorthEast Un,933,4,6,2,6,13,12,1,20
Kerala Blast,933,5,5,4,5,10,14,-4,19
FC Pune City,933,6,5,3,6,13,18,-5,18
Chennaiyin,933,7,3,6,5,15,20,-5,15
FC Goa,933,8,3,3,8,10,20,-10,12
Mumbai City,934,1,7,4,3,20,8,12,25
FC Pune City,934,2,6,3,5,19,17,2,21
Delhi Dynamo,934,3,5,5,4,23,19,4,20
Kerala Blast,934,4,5,4,5,14,16,-2,19
Kolkata,934,5,3,8,3,16,18,-2,17
NorthEast Un,934,6,5,2,7,11,14,-3,17
Chennaiyin,934,7,4,5,5,16,20,-4,17
FC Goa,934,8,4,3,7,10,17,-7,15
Delhi Dynamo,935,1,6,5,3,26,17,9,23
Mumbai City,935,2,6,4,4,16,9,7,22
Kerala Blast,935,3,6,4,4,16,16,0,22
NorthEast Un,935,4,5,3,6,14,15,-1,18
FC Pune City,935,5,5,3,6,15,17,-2,18
Kolkata,935,6,3,8,3,14,14,0,17
Chennaiyin,935,7,3,7,4,15,19,-4,16
FC Goa,935,8,3,4,7,10,19,-9,13
Delhi Dynamo,936,1,6,6,2,25,15,10,24
Mumbai City,936,2,6,5,3,17,9,8,23
Kerala Blast,936,3,5,5,4,12,15,-3,20
NorthEast Un,936,4,5,3,6,12,12,0,18
Kolkata,936,5,3,8,3,16,16,0,17
Chennaiyin,936,6,4,5,5,15,20,-5,17
FC Pune City,936,7,4,4,6,14,17,-3,16
FC Goa,936,8,4,2,8,10,17,-7,14
Mumbai City,937,1,7,4,3,18,8,10,25
Delhi Dynamo,937,2,5,6,3,24,18,6,21
FC Pune City,937,3,6,3,5,16,14,2,21
Kolkata,937,4,4,6,4,15,15,0,18
NorthEast Un,937,5,4,5,5,12,12,0,17
Chennaiyin,937,6,3,7,4,15,19,-4,16
Kerala Blast,937,7,4,4,6,10,18,-8,16
FC Goa,937,8,4,3,7,11,17,-6,15
Mumbai City,938,1,7,4,3,19,10,9,25
NorthEast Un,938,2,6,2,6,12,12,0,20
Kolkata,938,3,4,7,3,17,15,2,19
Kerala Blast,938,4,5,4,5,11,14,-3,19
Delhi Dynamo,938,5,4,6,4,24,19,5,18
FC Pune City,938,6,5,3,6,14,17,-3,18
Chennaiyin,938,7,4,5,5,18,20,-2,17
FC Goa,938,8,4,3,7,12,20,-8,15
Mumbai City,939,1,7,4,3,19,9,10,25
Kerala Blast,939,2,6,3,5,14,16,-2,21
Kolkata,939,3,4,7,3,16,15,1,19
Chennaiyin,939,4,4,6,4,15,17,-2,18
FC Goa,939,5,5,3,6,11,14,-3,18
Delhi Dynamo,939,6,4,5,5,22,20,2,17
NorthEast Un,939,7,5,2,7,11,14,-3,17
FC Pune City,939,8,4,4,6,13,16,-3,16
Mumbai City,940,1,7,4,3,17,8,9,25
Delhi Dynamo,940,2,6,5,3,29,18,11,23
Kolkata,940,3,4,7,3,15,14,1,19
Kerala Blast,940,4,5,4,5,12,17,-5,19
NorthEast Un,940,5,4,4,6,14,15,-1,16
FC Pune City,940,6,4,4,6,12,15,-3,16
Chennaiyin,940,7,3,7,4,16,20,-4,16
FC Goa,940,8,4,3,7,13,21,-8,15
Delhi Dynamo,941,1,6,6,2,29,16,13,24
Mumbai City,941,2,6,5,3,17,9,8,23
Kerala Blast,941,3,6,3,5,15,17,-2,21
Kolkata,941,4,4,6,4,19,18,1,18
NorthEast Un,941,5,5,2,7,12,14,-2,17
Chennaiyin,941,6,4,5,5,15,18,-3,17
FC Goa,941,7,5,2,7,12,20,-8,17
FC Pune City,941,8,4,3,7,13,20,-7,15
Mumbai City,942,1,7,4,3,21,9,12,25
Delhi Dynamo,942,2,5,5,4,25,22,3,20
Kerala Blast,942,3,5,5,4,15,16,-1,20
FC Pune City,942,4,5,4,5,19,17,2,19
Chennaiyin,942,5,4,6,4,14,17,-3,18
NorthEast Un,942,6,5,2,7,11,14,-3,17
Kolkata,942,7,3,7,4,13,18,-5,16
FC Goa,942,8,4,3,7,11,16,-5,15
Kolkata,943,1,5,7,2,19,14,5,22
Mumbai City,943,2,6,4,4,17,12,5,22
Delhi Dynamo,943,3,5,6,3,28,19,9,21
NorthEast Un,943,4,6,3,5,14,11,3,21
Kerala Blast,943,5,5,4,5,15,15,0,19
FC Goa,943,6,4,4,6,13,18,-5,16
FC Pune City,943,7,4,3,7,12,22,-10,15
Chennaiyin,943,8,3,5,6,15,22,-7,14
Mumbai City,944,1,6,5,3,17,9,8,23
Delhi Dynamo,944,2,5,7,2,26,18,8,22
Kolkata,944,3,4,8,2,16,14,2,20
NorthEast Un,944,4,5,4,5,13,11,2,19
Kerala Blast,944,5,5,4,5,11,15,-4,19
FC Pune City,944,6,4,4,6,14,17,-3,16
FC Goa,944,7,4,3,7,11,17,-6,15
Chennaiyin,944,8,3,5,6,13,20,-7,14
Delhi Dynamo,945,1,5,7,2,26,17,9,22
Kolkata,945,2,5,7,2,19,13,6,22
Mumbai City,945,3,6,4,4,17,11,6,22
Kerala Blast,945,4,6,3,5,14,17,-3,21
Chennaiyin,945,5,4,6,4,17,19,-2,18
NorthEast Un,945,6,4,4,6,11,12,-1,16
FC Pune City,945,7,4,3,7,13,20,-7,15
FC Goa,945,8,3,4,7,11,19,-8,13
Mumbai City,946,1,7,4,3,18,8,10,25
Kolkata,946,2,5,7,2,16,12,4,22
Delhi Dynamo,946,3,5,6,3,24,18,6,21
Kerala Blast,946,4,6,3,5,15,15,0,21
Chennaiyin,946,5,4,5,5,16,23,-7,17
FC Pune City,946,6,4,4,6,12,17,-5,16
NorthEast Un,946,7,4,3,7,11,14,-3,15
FC Goa,946,8,4,2,8,15,20,-5,14
Delhi Dynamo,947,1,6,6,2,27,17,10,24
Mumbai City,947,2,6,4,4,17,10,7,22
Kolkata,947,3,5,7,2,17,14,3,22
NorthEast Un,947,4,6,3,5,17,14,3,21
Kerala Blast,947,5,5,4,5,17,20,-3,19
FC Pune City,947,6,4,3,7,13,19,-6,15
Chennaiyin,947,7,3,5,6,15,21,-6,14
FC Goa,947,8,4,2,8,10,18,-8,14
Kolkata,948,1,6,6,2,18,13,5,24
Mumbai City,948,2,6,5,3,16,8,8,23
NorthEast Un,948,3,6,3,5,14,10,4,21
Delhi Dynamo,948,4,4,6,4,22,20,2,18
FC Pune City,948,5,5,3,6,14,17,-3,18
Chennaiyin,948,6,4,5,5,16,18,-2,17
Kerala Blast,948,7,4,4,6,11,17,-6,16
FC Goa,948,8,4,2,8,12,20,-8,14
Mumbai City,949,1,7,4,3,19,8,11,25
Kolkata,949,2,5,6,3,17,16,1,21
Delhi Dynamo,949,3,5,5,4,22,18,4,20
NorthEast Un,949,4,6,2,6,12,11,1,20
Chennaiyin,949,5,4,6,4,14,17,-3,18
Kerala Blast,949,6,5,3,6,14,18,-4,18
FC Pune City,949,7,4,3,7,13,18,-5,15
FC Goa,949,8,4,3,7,11,16,-5,15
Mumbai City,950,1,6,5,3,17,9,8,23
Delhi Dynamo,950,2,5,7,2,27,17,10,22
Kolkata,950,3,5,6,3,18,13,5,21
Kerala Blast,950,4,5,4,5,13,17,-4,19
Chennaiyin,950,5,4,5,5,15,19,-4,17
FC Goa,950,6,5,2,7,12,19,-7,17
NorthEast Un,950,7,4,4,6,12,13,-1,16
FC Pune City,950,8,4,3,7,12,19,-7,15
Mumbai City,951,1,6,5,3,17,9,8,23
Kerala Blast,951,2,6,4,4,14,16,-2,22
Delhi Dynamo,951,3,5,6,3,26,18,8,21
FC Pune City,951,4,5,4,5,15,16,-1,19
Kolkata,951,5,4,6,4,14,14,0,18
NorthEast Un,951,6,5,2,7,12,14,-2,17
Chennaiyin,951,7,4,5,5,15,20,-5,17
FC Goa,951,8,4,2,8,12,18,-6,14
Mumbai City,952,1,7,4,3,19,8,11,25
FC Pune City,952,2,6,3,5,17,15,2,21
NorthEast Un,952,3,6,3,5,13,11,2,21
Kerala Blast,952,4,5,4,5,12,18,-6,19
Kolkata,952,5,4,6,4,16,16,0,18
Delhi Dynamo,952,6,4,5,5,21,19,2,17
Chennaiyin,952,7,4,5,5,17,20,-3,17
FC Goa,952,8,4,2,8,12,20,-8,14
Delhi Dynamo,953,1,7,5,2,27,14,13,26
Mumbai City,953,2,6,4,4,16,9,7,22
Kolkata,953,3,5,6,3,18,17,1,21
Kerala Blast,953,4,6,3,5,14,15,-1,21
Chennaiyin,953,5,5,5,4,16,18,-2,20
FC Pune City,953,6,5,3,6,13,15,-2,18
NorthEast Un,953,7,4,2,8,9,14,-5,14
FC Goa,953,8,3,2,9,11,22,-11,11
Mumbai City,954,1,6,5,3,18,10,8,23
Delhi Dynamo,954,2,5,7,2,24,16,8,22
Kolkata,954,3,4,7,3,17,15,2,19
FC Pune City,954,4,5,3,6,14,17,-3,18
FC Goa,954,5,5,3,6,11,14,-3,18
NorthEast Un,954,6,5,2,7,12,12,0,17
Chennaiyin,954,7,4,5,5,14,18,-4,17
Kerala Blast,954,8,4,4,6,11,19,-8,16
Mumbai City,955,1,7,4,3,18,8,10,25
Delhi Dynamo,955,2,6,5,3,27,16,11,23
FC Pune City,955,3,5,4,5,16,17,-1,19
NorthEast Un,955,4,5,3,6,12,11,1,18
Kerala Blast,955,5,4,5,5,10,16,-6,17
Kolkata,955,6,3,7,4,15,16,-1,16
Chennaiyin,955,7,3,7,4,17,21,-4,16
FC Goa,955,8,4,3,7,12,22,-10,15
Mumbai City,956,1,7,4,3,20,8,12,25
Delhi Dynamo,956,2,6,5,3,24,18,6,23
NorthEast Un,956,3,5,3,6,12,10,2,18
Kerala Blast,956,4,4,6,4,13,17,-4,18
Kolkata,956,5,3,8,3,18,18,0,17
FC Pune City,956,6,4,5,5,16,18,-2,17
FC Goa,956,7,5,2,7,12,17,-5,17
Chennaiyin,956,8,3,5,6,13,22,-9,14
Mumbai City,957,1,6,5,3,16,8,8,23
Delhi Dynamo,957,2,4,8,2,23,16,7,20
NorthEast Un,957,3,5,4,5,15,12,3,19
Kolkata,957,4,4,6,4,16,16,0,18
Chennaiyin,957,5,4,6,4,15,18,-3,18
FC Pune City,957,6,5,3,6,13,16,-3,18
Kerala Blast,957,7,5,3,6,13,19,-6,18
FC Goa,957,8,4,3,7,10,16,-6,15
Mumbai City,958,1,7,4,3,19,9,10,25
Delhi Dynamo,958,2,5,6,3,26,18,8,21
FC Pune City,958,3,6,3,5,16,14,2,21
Kolkata,958,4,5,6,3,15,15,0,21
Kerala Blast,958,5,5,3,6,10,15,-5,18
Chennaiyin,958,6,4,5,5,16,20,-4,17
NorthEast Un,958,7,4,3,7,11,13,-2,15
FC Goa,958,8,4,2,8,10,19,-9,14
Mumbai City,959,1,6,5,3,18,10,8,23
Delhi Dynamo,959,2,4,7,3,24,18,6,19
Kolkata,959,3,4,7,3,15,14,1,19
Kerala Blast,959,4,5,4,5,11,16,-5,19
FC Pune City,959,5,5,3,6,15,16,-1,18
Chennaiyin,959,6,4,6,4,15,17,-2,18
NorthEast Un,959,7,4,5,5,10,10,0,17
FC Goa,959,8,4,3,7,10,17,-7,15
Mumbai City,960,1,6,5,3,17,9,8,23
Delhi Dynamo,960,2,5,6,3,26,16,10,21
FC Pune City,960,3,6,3,5,18,15,3,21
NorthEast Un,960,4,6,2,6,14,13,1,20
Kerala Blast,960,5,5,4,5,13,18,-5,19
FC Goa,960,6,5,2,7,15,21,-6,17
Kolkata,960,7,3,7,4,17,21,-4,16
Chennaiyin,960,8,3,5,6,15,22,-7,14
Mumbai City,961,1,6,5,3,18,10,8,23
Kerala Blast,961,2,6,3,5,13,15,-2,21
NorthEast Un,961,3,6,2,6,14,12,2,20
FC Goa,961,4,6,2,6,16,16,0,20
Delhi Dynamo,961,5,4,6,4,25,20,5,18
Kolkata,961,6,4,6,4,15,16,-1,18
FC Pune City,961,7,5,3,6,14,16,-2,18
Chennaiyin,961,8,3,5,6,14,24,-10,14
Mumbai City,962,1,6,5,3,18,10,8,23
Delhi Dynamo,962,2,5,6,3,25,19,6,21
NorthEast Un,962,3,6,3,5,13,10,3,21
FC Pune City,962,4,5,4,5,15,16,-1,19
Kolkata,962,5,3,8,3,14,18,-4,17
Chennaiyin,962,6,3,7,4,15,19,-4,16
Kerala Blast,962,7,4,4,6,10,16,-6,16
FC Goa,962,8,4,3,7,15,17,-2,15
Mumbai City,963,1,7,4,3,18,8,10,25
Delhi Dynamo,963,2,5,5,4,23,19,4,20
Kolkata,963,3,4,8,2,16,14,2,20
Kerala Blast,963,4,5,4,5,13,17,-4,19
FC Pune City,963,5,5,3,6,15,17,-2,18
FC Goa,963,6,5,3,6,13,15,-2,18
NorthEast Un,963,7,4,3,7,11,13,-2,15
Chennaiyin,963,8,3,6,5,14,20,-6,15
Mumbai City,964,1,7,4,3,19,9,10,25
Delhi Dynamo,964,2,5,6,3,26,19,7,21
Chennaiyin,964,3,5,5,4,16,18,-2,20
Kolkata,964,4,4,7,3,15,16,-1,19
Kerala Blast,964,5,5,4,5,11,15,-4,19
NorthEast Un,964,6,5,3,6,14,14,0,18
FC Pune City,964,7,4,3,7,13,17,-4,15
FC Goa,964,8,4,2,8,11,17,-6,14
Delhi Dynamo,965,1,7,5,2,28,16,12,26
Mumbai City,965,2,6,4,4,17,10,7,22
Kolkata,965,3,4,8,2,21,15,6,20
NorthEast Un,965,4,6,2,6,14,12,2,20
FC Pune City,965,5,4,5,5,14,16,-2,17
Kerala Blast,965,6,4,4,6,10,21,-11,16
FC Goa,965,7,4,3,7,13,20,-7,15
Chennaiyin,965,8,3,5,6,15,22,-7,14
Mumbai City,966,1,7,4,3,17,8,9,25
Delhi Dynamo,966,2,6,5,3,28,17,11,23
Kolkata,966,3,4,8,2,14,12,2,20
FC Pune City,966,4,4,5,5,13,15,-2,17
Kerala Blast,966,5,4,5,5,11,16,-5,17
NorthEast Un,966,6,4,4,6,12,15,-3,16
Chennaiyin,966,7,3,6,5,13,19,-6,15
FC Goa,966,8,4,3,7,10,16,-6,15
Mumbai City,967,1,6,5,3,16,8,8,23
Delhi Dynamo,967,2,5,6,3,24,17,7,21
FC Pune City,967,3,6,3,5,17,15,2,21
Chennaiyin,967,4,5,5,4,17,17,0,20
Kolkata,967,5,4,7,3,16,17,-1,19
NorthEast Un,967,6,5,3,6,12,12,0,18
Kerala Blast,967,7,4,4,6,10,16,-6,16
FC Goa,967,8,3,3,8,10,20,-10,12
Mumbai City,968,1,6,4,4,17,10,7,22
Delhi Dynamo,968,2,5,6,3,24,17,7,21
NorthEast Un,968,3,5,4,5,11,10,1,19
Kerala Blast,968,4,5,4,5,12,15,-3,19
Kolkata,968,5,4,6,4,16,16,0,18
FC Pune City,968,6,5,3,6,14,17,-3,18
FC Goa,968,7,5,3,6,14,18,-4,18
Chennaiyin,968,8,3,6,5,16,21,-5,15
Mumbai City,969,1,7,4,3,18,8,10,25
Kerala Blast,969,2,6,4,4,14,14,0,22
NorthEast Un,969,3,6,3,5,14,11,3,21
Delhi Dynamo,969,4,5,5,4,22,18,4,20
FC Pune City,969,5,5,3,6,15,16,-1,18
FC Goa,969,6,5,2,7,13,16,-3,17
Kolkata,969,7,3,6,5,15,22,-7,15
Chennaiyin,969,8,3,5,6,14,20,-6,14
Kolkata,970,1,6,6,2,19,14,5,24
Mumbai City,970,2,6,4,4,16,10,6,22
Delhi Dynamo,970,3,5,6,3,26,19,7,21
NorthEast Un,970,4,6,3,5,16,11,5,21
Chennaiyin,970,5,4,6,4,16,19,-3,18
Kerala Blast,970,6,5,3,6,11,19,-8,18
FC Pune City,970,7,4,3,7,13,17,-4,15
FC Goa,970,8,3,3,8,11,19,-8,12
Mumbai City,971,1,7,4,3,17,8,9,25
Kolkata,971,2,6,6,2,18,12,6,24
Delhi Dynamo,971,3,5,6,3,22,15,7,21
Chennaiyin,971,4,4,6,4,15,18,-3,18
FC Pune City,971,4,5,3,6,15,18,-3,18
Kerala Blast,971,6,5,3,6,12,17,-5,18
NorthEast Un,971,7,4,3,7,9,12,-3,15
FC Goa,971,8,3,3,8,9,17,-8,12
Mumbai City,972,1,7,4,3,17,8,9,25
Kerala Blast,972,2,6,3,5,12,15,-3,21
Delhi Dynamo,972,3,5,5,4,23,17,6,20
Chennaiyin,972,4,5,5,4,18,17,1,20
NorthEast Un,972,5,6,2,6,11,10,1,20
Kolkata,972,6,4,7,3,15,14,1,19
FC Pune City,972,7,4,4,6,14,17,-3,16
FC Goa,972,8,3,2,9,9,21,-12,11
Mumbai City,973,1,6,4,4,16,9,7,22
Delhi Dynamo,973,2,5,6,3,23,16,7,21
FC Pune City,973,3,5,4,5,14,15,-1,19
NorthEast Un,973,4,5,3,6,12,12,0,18
Kolkata,973,5,4,6,4,16,17,-1,18
FC Goa,973,6,5,3,6,14,16,-2,18
Chennaiyin,973,7,4,5,5,15,19,-4,17
Kerala Blast,973,8,4,5,5,11,17,-6,17
Mumbai City,974,1,6,5,3,18,10,8,23
Delhi Dynamo,974,2,5,6,3,24,17,7,21
Kerala Blast,974,3,6,3,5,13,17,-4,21
Kolkata,974,4,4,7,3,15,14,1,19
FC Pune City,974,5,5,4,5,15,15,0,19
NorthEast Un,974,6,5,3,6,11,11,0,18
Chennaiyin,974,7,3,7,4,14,18,-4,16
FC Goa,974,8,3,3,8,10,18,-8,12
Mumbai City,975,1,7,4,3,18,8,10,25
NorthEast Un,975,2,7,2,5,15,10,5,23
Delhi Dynamo,975,3,5,5,4,25,19,6,20
Kolkata,975,4,4,8,2,17,15,2,20
Kerala Blast,975,5,5,4,5,15,18,-3,19
FC Pune City,975,6,4,4,6,14,19,-5,16
Chennaiyin,975,7,3,5,6,13,19,-6,14
FC Goa,975,8,4,2,8,11,20,-9,14
Mumbai City,976,1,7,4,3,18,8,10,25
Delhi Dynamo,976,2,5,5,4,23,20,3,20
Kolkata,976,3,4,7,3,16,15,1,19
NorthEast Un,976,4,5,3,6,12,12,0,18
FC Pune City,976,5,5,3,6,14,16,-2,18
Kerala Blast,976,6,5,3,6,13,18,-5,18
FC Goa,976,7,4,4,6,14,17,-3,16
Chennaiyin,976,8,3,7,4,15,19,-4,16
Mumbai City,977,1,7,4,3,18,9,9,25
NorthEast Un,977,2,6,3,5,15,10,5,21
Kolkata,977,3,5,6,3,18,17,1,21
Delhi Dynamo,977,4,5,5,4,29,20,9,20
FC Pune City,977,5,5,4,5,16,16,0,19
Kerala Blast,977,6,4,5,5,11,16,-5,17
Chennaiyin,977,7,3,6,5,14,20,-6,15
FC Goa,977,8,3,3,8,10,23,-13,12
Mumbai City,978,1,7,4,3,19,9,10,25
Kolkata,978,2,5,6,3,19,16,3,21
Delhi Dynamo,978,3,5,5,4,25,19,6,20
NorthEast Un,978,4,5,4,5,12,11,1,19
Kerala Blast,978,5,5,4,5,11,16,-5,19
FC Goa,978,6,5,2,7,13,18,-5,17
Chennaiyin,978,7,3,6,5,15,20,-5,15
FC Pune City,978,8,4,3,7,12,17,-5,15
Delhi Dynamo,979,1,7,5,2,26,14,12,26
Mumbai City,979,2,6,4,4,16,9,7,22
Kolkata,979,3,4,8,2,16,13,3,20
NorthEast Un,979,4,5,3,6,11,10,1,18
FC Pune City,979,5,5,3,6,15,17,-2,18
Kerala Blast,979,6,4,5,5,9,15,-6,17
Chennaiyin,979,7,3,6,5,14,20,-6,15
FC Goa,979,8,3,4,7,9,18,-9,13
Mumbai City,980,1,7,4,3,18,8,10,25
Kolkata,980,2,5,6,3,21,14,7,21
Delhi Dynamo,980,3,4,7,3,24,19,5,19
NorthEast Un,980,4,5,4,5,13,11,2,19
Chennaiyin,980,5,3,7,4,16,20,-4,16
FC Goa,980,6,4,4,6,14,19,-5,16
FC Pune City,980,7,4,4,6,14,20,-6,16
Kerala Blast,980,8,4,4,6,11,20,-9,16
Mumbai City,981,1,7,4,3,18,8,10,25
NorthEast Un,981,2,7,2,5,15,11,4,23
Kerala Blast,981,3,6,3,5,13,16,-3,21
Delhi Dynamo,981,4,5,5,4,26,18,8,20
FC Pune City,981,5,5,3,6,15,15,0,18
Kolkata,981,6,4,6,4,16,18,-2,18
Chennaiyin,981,7,4,5,5,18,21,-3,17
FC Goa,981,8,3,2,9,11,25,-14,11
Mumbai City,982,1,6,5,3,19,11,8,23
Kerala Blast,982,2,6,3,5,15,19,-4,21
Delhi Dynamo,982,3,4,7,3,28,22,6,19
Kolkata,982,4,4,7,3,20,19,1,19
NorthEast Un,982,5,5,3,6,15,14,1,18
FC Goa,982,6,5,2,7,15,19,-4,17
Chennaiyin,982,7,4,5,5,15,20,-5,17
FC Pune City,982,8,4,4,6,14,17,-3,16
Delhi Dynamo,983,1,6,5,3,25,17,8,23
Mumbai City,983,2,6,4,4,16,10,6,22
Kolkata,983,3,5,6,3,18,16,2,21
FC Pune City,983,4,6,3,5,16,15,1,21
NorthEast Un,983,5,5,3,6,12,11,1,18
Chennaiyin,983,6,4,6,4,17,19,-2,18
Kerala Blast,983,7,5,3,6,10,16,-6,18
FC Goa,983,8,3,2,9,12,22,-10,11
Mumbai City,984,1,6,5,3,17,9,8,23
Delhi Dynamo,984,2,5,7,2,23,15,8,22
Kolkata,984,3,5,7,2,15,12,3,22
Chennaiyin,984,4,5,5,4,19,19,0,20
FC Pune City,984,5,5,3,6,14,15,-1,18
NorthEast Un,984,6,5,2,7,11,14,-3,17
Kerala Blast,984,7,4,3,7,10,18,-8,15
FC Goa,984,8,3,4,7,10,17,-7,13
Mumbai City,985,1,7,4,3,19,10,9,25
Delhi Dynamo,985,2,6,5,3,28,20,8,23
NorthEast Un,985,3,6,2,6,18,14,4,20
FC Pune City,985,4,5,4,5,14,14,0,19
Kolkata,985,5,3,8,3,14,14,0,17
Chennaiyin,985,6,4,5,5,19,21,-2,17
Kerala Blast,985,7,4,4,6,10,20,-10,16
FC Goa,985,8,4,2,8,11,20,-9,14
Mumbai City,986,1,7,4,3,17,8,9,25
NorthEast Un,986,2,6,3,5,14,11,3,21
Kolkata,986,3,5,6,3,17,16,1,21
Delhi Dynamo,986,4,4,6,4,22,17,5,18
Chennaiyin,986,5,4,6,4,17,18,-1,18
FC Pune City,986,5,5,3,6,17,18,-1,18
Kerala Blast,986,7,5,3,6,13,19,-6,18
FC Goa,986,8,3,3,8,8,18,-10,12
Delhi Dynamo,987,1,7,5,2,27,16,11,26
Mumbai City,987,2,6,4,4,17,10,7,22
Kolkata,987,3,4,7,3,19,20,-1,19
Kerala Blast,987,4,5,4,5,12,16,-4,19
FC Pune City,987,5,5,3,6,17,19,-2,18
NorthEast Un,987,6,5,2,7,12,14,-2,17
FC Goa,987,7,4,3,7,15,18,-3,15
Chennaiyin,987,8,3,6,5,16,22,-6,15
Mumbai City,988,1,7,4,3,17,8,9,25
Delhi Dynamo,988,2,6,5,3,24,16,8,23
Kolkata,988,3,5,7,2,18,14,4,22
Kerala Blast,988,4,6,3,5,13,17,-4,21
NorthEast Un,988,5,5,2,7,13,14,-1,17
Chennaiyin,988,6,4,5,5,17,19,-2,17
FC Pune City,988,7,4,3,7,13,17,-4,15
FC Goa,988,8,3,3,8,10,20,-10,12
Mumbai City,989,1,7,4,3,19,9,10,25
Delhi Dynamo,989,2,5,6,3,26,19,7,21
FC Pune City,989,3,5,4,5,16,17,-1,19
Kerala Blast,989,4,5,4,5,15,17,-2,19
Kolkata,989,5,4,6,4,17,17,0,18
Chennaiyin,989,6,4,5,5,15,19,-4,17
NorthEast Un,989,7,5,2,7,13,17,-4,17
FC Goa,989,8,4,3,7,12,18,-6,15
Mumbai City,990,1,6,5,3,17,9,8,23
Kerala Blast,990,2,6,3,5,13,15,-2,21
Delhi Dynamo,990,3,4,7,3,25,19,6,19
Kolkata,990,4,4,7,3,17,16,1,19
NorthEast Un,990,5,5,3,6,12,13,-1,18
FC Pune City,990,6,5,3,6,15,17,-2,18
FC Goa,990,7,4,4,6,14,19,-5,16
Chennaiyin,990,8,3,6,5,15,20,-5,15
Mumbai City,991,1,7,4,3,18,8,10,25
NorthEast Un,991,2,7,2,5,15,11,4,23
Kerala Blast,991,3,6,3,5,13,16,-3,21
Kolkata,991,4,4,7,3,15,14,1,19
Delhi Dynamo,991,5,4,5,5,24,22,2,17
FC Goa,991,6,5,2,7,14,18,-4,17
FC Pune City,991,7,4,4,6,13,16,-3,16
Chennaiyin,991,8,3,5,6,13,20,-7,14
Mumbai City,992,1,7,4,3,18,8,10,25
Delhi Dynamo,992,2,5,5,4,25,20,5,20
NorthEast Un,992,3,6,2,6,16,15,1,20
Kolkata,992,4,4,7,3,16,14,2,19
Kerala Blast,992,5,5,3,6,13,19,-6,18
Chennaiyin,992,6,4,5,5,16,20,-4,17
FC Goa,992,7,5,2,7,11,16,-5,17
FC Pune City,992,8,4,4,6,13,16,-3,16
Mumbai City,993,1,7,4,3,18,9,9,25
Delhi Dynamo,993,2,6,5,3,29,18,11,23
Kerala Blast,993,3,6,4,4,18,15,3,22
FC Pune City,993,4,5,4,5,14,15,-1,19
FC Goa,993,5,5,2,7,14,19,-5,17
Kolkata,993,6,3,6,5,16,20,-4,15
NorthEast Un,993,7,4,3,7,10,16,-6,15
Chennaiyin,993,8,3,6,5,13,20,-7,15
Mumbai City,994,1,7,4,3,21,10,11,25
NorthEast Un,994,2,7,2,5,15,9,6,23
Kerala Blast,994,3,6,3,5,13,16,-3,21
Kolkata,994,4,4,6,4,14,17,-3,18
Delhi Dynamo,994,5,4,5,5,24,24,0,17
FC Goa,994,6,5,2,7,13,16,-3,17
Chennaiyin,994,7,4,5,5,14,18,-4,17
FC Pune City,994,8,4,3,7,13,17,-4,15
Delhi Dynamo,995,1,5,7,2,26,18,8,22
Mumbai City,995,2,6,4,4,17,10,7,22
Kolkata,995,3,5,7,2,20,17,3,22
Chennaiyin,995,4,4,6,4,14,17,-3,18
Kerala Blast,995,5,4,6,4,13,17,-4,18
NorthEast Un,995,6,4,5,5,12,12,0,17
FC Pune City,995,7,4,4,6,12,15,-3,16
FC Goa,995,8,3,3,8,11,19,-8,12
Kolkata,996,1,6,6,2,21,13,8,24
Mumbai City,996,2,6,5,3,17,9,8,23
Delhi Dynamo,996,3,5,6,3,24,17,7,21
Kerala Blast,996,4,6,3,5,12,16,-4,21
FC Goa,996,5,5,2,7,13,17,-4,17
Chennaiyin,996,6,4,5,5,14,19,-5,17
FC Pune City,996,7,4,3,7,12,19,-7,15
NorthEast Un,996,8,4,2,8,9,12,-3,14
NorthEast Un,997,1,7,2,5,15,10,5,23
Mumbai City,997,2,6,4,4,17,11,6,22
Kolkata,997,3,5,7,2,18,14,4,22
Delhi Dynamo,997,4,5,5,4,25,18,7,20
FC Pune City,997,5,4,5,5,13,15,-2,17
FC Goa,997,6,5,2,7,14,18,-4,17
Kerala Blast,997,7,4,4,6,9,17,-8,16
Chennaiyin,997,8,3,5,6,15,23,-8,14
Mumbai City,998,1,6,5,3,18,10,8,23
NorthEast Un,998,2,6,3,5,14,10,4,21
Delhi Dynamo,998,3,4,7,3,23,19,4,19
Kerala Blast,998,4,5,4,5,12,17,-5,19
Kolkata,998,5,4,6,4,19,18,1,18
FC Pune City,998,6,5,3,6,16,18,-2,18
FC Goa,998,7,5,3,6,13,16,-3,18
Chennaiyin,998,8,3,5,6,15,22,-7,14
Delhi Dynamo,999,1,6,5,3,27,16,11,23
Mumbai City,999,2,6,4,4,17,10,7,22
Kerala Blast,999,3,6,3,5,13,16,-3,21
Kolkata,999,4,4,6,4,16,16,0,18
Chennaiyin,999,5,4,6,4,15,18,-3,18
FC Pune City,999,6,5,3,6,14,17,-3,18
NorthEast Un,999,7,5,2,7,11,12,-1,17
FC Goa,999,8,4,3,7,11,19,-8,15
Mumbai City,1000,1,6,4,4,16,9,7,22
Kolkata,1000,2,5,7,2,18,14,4,22
Delhi Dynamo,1000,3,5,6,3,24,17,7,21
FC Pune City,1000,4,5,4,5,15,16,-1,19
Kerala Blast,1000,5,5,3,6,13,15,-2,18
NorthEast Un,1000,6,5,3,6,13,16,-3,18
FC Goa,1000,7,5,2,7,12,18,-6,17
Chennaiyin,1000,8,3,5,6,16,22,-6,14
Delhi Dynamo,1001,1,6,6,2,28,18,10,24
Mumbai City,1001,2,6,5,3,17,9,8,23
Kolkata,1001,3,5,6,3,18,15,3,21
NorthEast Un,1001,4,5,3,6,11,12,-1,18
Kerala Blast,1001,5,5,3,6,10,16,-6,18
FC Goa,1001,6,5,2,7,14,18,-4,17
FC Pune City,1001,7,4,3,7,13,17,-4,15
Chennaiyin,1001,8,3,6,5,13,19,-6,15
Mumbai City,1002,1,6,4,4,17,10,7,22
Delhi Dynamo,1002,2,5,5,4,23,17,6,20
FC Goa,1002,3,6,2,6,14,16,-2,20
Kerala Blast,1002,4,5,5,4,13,16,-3,20
NorthEast Un,1002,5,5,4,5,11,10,1,19
Kolkata,1002,6,3,8,3,16,16,0,17
FC Pune City,1002,7,4,4,6,15,18,-3,16
Chennaiyin,1002,8,3,6,5,15,21,-6,15
Mumbai City,1003,1,6,4,4,16,9,7,22
Kerala Blast,1003,2,6,4,4,14,14,0,22
Delhi Dynamo,1003,3,5,6,3,23,17,6,21
NorthEast Un,1003,4,5,3,6,12,11,1,18
FC Pune City,1003,5,5,3,6,13,16,-3,18
Kolkata,1003,6,3,8,3,15,15,0,17
Chennaiyin,1003,7,4,5,5,16,22,-6,17
FC Goa,1003,8,4,3,7,14,19,-5,15
Mumbai City,1004,1,7,4,3,20,8,12,25
Kerala Blast,1004,2,6,3,5,17,18,-1,21
NorthEast Un,1004,3,6,2,6,13,13,0,20
Chennaiyin,1004,4,4,6,4,18,20,-2,18
FC Goa,1004,5,5,3,6,15,17,-2,18
Kolkata,1004,6,4,6,4,18,22,-4,18
Delhi Dynamo,1004,7,4,5,5,21,20,1,17
FC Pune City,1004,8,4,3,7,14,18,-4,15
Mumbai City,1005,1,7,4,3,19,10,9,25
Kerala Blast,1005,2,6,3,5,11,15,-4,21
NorthEast Un,1005,3,6,2,6,14,10,4,20
Kolkata,1005,4,4,7,3,16,14,2,19
FC Pune City,1005,5,5,3,6,13,15,-2,18
Delhi Dynamo,1005,6,4,5,5,24,22,2,17
FC Goa,1005,7,4,4,6,12,16,-4,16
Chennaiyin,1005,8,3,6,5,13,20,-7,15
Mumbai City,1006,1,7,4,3,19,8,11,25
Kolkata,1006,2,6,6,2,21,14,7,24
Delhi Dynamo,1006,3,5,6,3,24,17,7,21
FC Pune City,1006,4,5,3,6,16,20,-4,18
Chennaiyin,1006,5,4,5,5,15,19,-4,17
NorthEast Un,1006,6,4,4,6,11,12,-1,16
Kerala Blast,1006,7,4,4,6,11,17,-6,16
FC Goa,1006,8,4,2,8,9,19,-10,14
Mumbai City,1007,1,7,4,3,20,8,12,25
Delhi Dynamo,1007,2,5,5,4,25,20,5,20
NorthEast Un,1007,3,6,2,6,14,14,0,20
Kerala Blast,1007,4,5,5,4,15,16,-1,20
FC Pune City,1007,5,5,4,5,16,17,-1,19
Kolkata,1007,6,3,8,3,18,18,0,17
Chennaiyin,1007,7,3,6,5,14,20,-6,15
FC Goa,1007,8,3,4,7,11,20,-9,13
Mumbai City,1008,1,6,5,3,16,8,8,23
Delhi Dynamo,1008,2,5,6,3,24,16,8,21
FC Goa,1008,3,6,2,6,13,15,-2,20
Kolkata,1008,4,4,7,3,17,16,1,19
FC Pune City,1008,5,5,3,6,14,17,-3,18
NorthEast Un,1008,6,5,2,7,12,13,-1,17
Chennaiyin,1008,7,4,5,5,14,18,-4,17
Kerala Blast,1008,8,4,4,6,11,18,-7,16
Mumbai City,1009,1,7,4,3,23,8,15,25
Kolkata,1009,2,4,7,3,18,17,1,19
FC Pune City,1009,3,5,4,5,14,14,0,19
NorthEast Un,1009,4,5,3,6,13,13,0,18
Delhi Dynamo,1009,5,4,6,4,23,24,-1,18
Chennaiyin,1009,6,4,5,5,16,20,-4,17
Kerala Blast,1009,7,4,5,5,10,16,-6,17
FC Goa,1009,8,4,4,6,12,17,-5,16
Mumbai City,1010,1,7,4,3,17,8,9,25
Kerala Blast,1010,2,7,3,4,19,14,5,24
Delhi Dynamo,1010,3,5,5,4,23,17,6,20
NorthEast Un,1010,4,6,2,6,13,15,-2,20
Kolkata,1010,5,3,8,3,13,14,-1,17
FC Pune City,1010,6,4,4,6,12,17,-5,16
FC Goa,1010,7,4,3,7,13,16,-3,15
Chennaiyin,1010,8,3,5,6,14,23,-9,14
Mumbai City,1011,1,6,5,3,18,10,8,23
Delhi Dynamo,1011,2,5,7,2,26,18,8,22
Kolkata,1011,3,5,6,3,17,14,3,21
NorthEast Un,1011,4,5,3,6,13,12,1,18
FC Pune City,1011,5,5,3,6,13,16,-3,18
Kerala Blast,1011,6,5,3,6,11,16,-5,18
Chennaiyin,1011,7,4,5,5,15,20,-5,17
FC Goa,1011,8,4,2,8,10,17,-7,14
Mumbai City,1012,1,6,5,3,18,10,8,23
Delhi Dynamo,1012,2,5,6,3,25,18,7,21
Kolkata,1012,3,4,8,2,17,15,2,20
NorthEast Un,1012,4,5,3,6,12,13,-1,18
Kerala Blast,1012,5,4,6,4,12,16,-4,18
Chennaiyin,1012,6,4,5,5,15,18,-3,17
FC Pune City,1012,7,4,4,6,12,15,-3,16
FC Goa,1012,8,4,3,7,12,18,-6,15
Mumbai City,1013,1,6,5,3,16,8,8,23
Delhi Dynamo,1013,2,5,7,2,23,14,9,22
Kolkata,1013,3,5,7,2,20,13,7,22
Kerala Blast,1013,4,6,3,5,15,18,-3,21
Chennaiyin,1013,5,5,5,4,19,19,0,20
NorthEast Un,1013,6,4,3,7,9,12,-3,15
FC Pune City,1013,7,4,3,7,14,22,-8,15
FC Goa,1013,8,3,3,8,11,21,-10,12
Mumbai City,1014,1,7,4,3,18,8,10,25
Kolkata,1014,2,5,7,2,20,14,6,22
NorthEast Un,1014,3,5,4,5,13,10,3,19
FC Pune City,1014,4,5,4,5,13,14,-1,19
Delhi Dynamo,1014,5,4,5,5,22,22,0,17
Chennaiyin,1014,6,3,7,4,15,19,-4,16
Kerala Blast,1014,7,4,4,6,10,19,-9,16
FC Goa,1014,8,4,3,7,13,18,-5,15
Delhi Dynamo,1015,1,6,5,3,27,17,10,23
Mumbai City,1015,2,6,4,4,16,9,7,22
Kolkata,1015,3,4,8,2,19,16,3,20
Kerala Blast,1015,4,5,4,5,12,17,-5,19
NorthEast Un,1015,5,5,2,7,11,12,-1,17
FC Pune City,1015,6,4,5,5,14,16,-2,17
Chennaiyin,1015,7,4,5,5,15,19,-4,17
FC Goa,1015,8,4,3,7,13,21,-8,15
Mumbai City,1016,1,7,4,3,19,9,10,25
Kolkata,1016,2,5,7,2,17,13,4,22
Delhi Dynamo,1016,3,5,5,4,24,19,5,20
FC Pune City,1016,4,5,4,5,14,15,-1,19
NorthEast Un,1016,5,5,3,6,12,13,-1,18
Chennaiyin,1016,6,4,6,4,17,19,-2,18
Kerala Blast,1016,7,4,4,6,12,18,-6,16
FC Goa,1016,8,3,3,8,10,19,-9,12
Mumbai City,1017,1,6,4,4,17,11,6,22
Kolkata,1017,2,5,7,2,18,14,4,22
Delhi Dynamo,1017,3,5,6,3,24,18,6,21
NorthEast Un,1017,4,6,2,6,14,11,3,20
Chennaiyin,1017,5,5,5,4,17,18,-1,20
FC Pune City,1017,6,5,4,5,14,15,-1,19
Kerala Blast,1017,7,4,3,7,12,19,-7,15
FC Goa,1017,8,3,3,8,10,20,-10,12
Delhi Dynamo,1018,1,6,6,2,27,18,9,24
Mumbai City,1018,2,6,5,3,18,10,8,23
Kerala Blast,1018,3,6,4,4,15,14,1,22
Chennaiyin,1018,4,5,5,4,18,17,1,20
Kolkata,1018,5,3,8,3,16,17,-1,17
FC Pune City,1018,6,4,5,5,15,17,-2,17
NorthEast Un,1018,7,4,2,8,10,17,-7,14
FC Goa,1018,8,3,3,8,10,19,-9,12
Mumbai City,1019,1,7,4,3,18,9,9,25
Delhi Dynamo,1019,2,5,5,4,25,17,8,20
Kolkata,1019,3,4,8,2,17,15,2,20
Kerala Blast,1019,4,5,5,4,14,17,-3,20
NorthEast Un,1019,5,5,4,5,10,9,1,19
Chennaiyin,1019,6,4,6,4,16,17,-1,18
FC Pune City,1019,7,4,3,7,16,20,-4,15
FC Goa,1019,8,3,3,8,9,21,-12,12
Mumbai City,1020,1,7,4,3,18,9,9,25
Delhi Dynamo,1020,2,5,6,3,27,18,9,21
Kolkata,1020,3,4,8,2,20,17,3,20
Chennaiyin,1020,4,5,5,4,17,17,0,20
NorthEast Un,1020,5,5,3,6,11,13,-2,18
Kerala Blast,1020,6,5,3,6,12,18,-6,18
FC Pune City,1020,7,4,4,6,16,19,-3,16
FC Goa,1020,8,3,3,8,10,20,-10,12
Mumbai City,1021,1,7,4,3,18,9,9,25
Delhi Dynamo,1021,2,5,6,3,25,18,7,21
Kerala Blast,1021,3,5,5,4,12,14,-2,20
NorthEast Un,1021,4,5,4,5,13,11,2,19
Kolkata,1021,5,4,7,3,17,17,0,19
FC Pune City,1021,6,5,3,6,15,17,-2,18
FC Goa,1021,7,4,2,8,14,18,-4,14
Chennaiyin,1021,8,3,5,6,14,24,-10,14
Delhi Dynamo,1022,1,7,5,2,30,16,14,26
Mumbai City,1022,2,6,4,4,16,9,7,22
Kolkata,1022,3,5,7,2,19,14,5,22
Kerala Blast,1022,4,6,3,5,15,14,1,21
NorthEast Un,1022,5,5,2,7,13,16,-3,17
Chennaiyin,1022,6,3,6,5,15,20,-5,15
FC Pune City,1022,7,4,3,7,12,20,-8,15
FC Goa,1022,8,3,4,7,11,22,-11,13
Delhi Dynamo,1023,1,6,6,2,29,16,13,24
Mumbai City,1023,2,6,4,4,16,11,5,22
Kerala Blast,1023,3,6,4,4,17,15,2,22
Kolkata,1023,4,4,8,2,16,14,2,20
Chennaiyin,1023,5,4,6,4,14,17,-3,18
NorthEast Un,1023,6,4,3,7,12,14,-2,15
FC Pune City,1023,7,4,3,7,15,23,-8,15
FC Goa,1023,8,3,4,7,8,17,-9,13
Mumbai City,1024,1,7,4,3,18,9,9,25
Delhi Dynamo,1024,2,4,7,3,23,17,6,19
NorthEast Un,1024,3,5,4,5,12,11,1,19
Chennaiyin,1024,4,4,6,4,17,18,-1,18
Kolkata,1024,5,3,8,3,14,14,0,17
FC Pune City,1024,6,4,5,5,13,15,-2,17
Kerala Blast,1024,7,4,5,5,10,15,-5,17
FC Goa,1024,8,4,3,7,10,18,-8,15
Mumbai City,1025,1,7,4,3,18,8,10,25
Kolkata,1025,2,5,7,2,20,15,5,22
NorthEast Un,1025,3,6,2,6,14,12,2,20
Chennaiyin,1025,4,5,5,4,16,18,-2,20
Delhi Dynamo,1025,5,4,5,5,22,20,2,17
FC Pune City,1025,6,4,5,5,17,19,-2,17
Kerala Blast,1025,7,4,4,6,14,21,-7,16
FC Goa,1025,8,4,2,8,12,20,-8,14
Mumbai City,1026,1,7,4,3,19,9,10,25
FC Pune City,1026,2,6,3,5,16,16,0,21
Delhi Dynamo,1026,3,5,5,4,23,18,5,20
NorthEast Un,1026,4,6,2,6,13,14,-1,20
Kolkata,1026,5,4,6,4,15,16,-1,18
Kerala Blast,1026,6,5,3,6,14,17,-3,18
Chennaiyin,1026,7,3,6,5,15,20,-5,15
FC Goa,1026,8,4,3,7,11,16,-5,15
Mumbai City,1027,1,6,5,3,17,9,8,23
Kolkata,1027,2,5,7,2,23,14,9,22
Delhi Dynamo,1027,3,5,6,3,25,19,6,21
Kerala Blast,1027,4,5,5,4,16,18,-2,20
Chennaiyin,1027,5,4,5,5,16,20,-4,17
FC Goa,1027,6,5,2,7,14,19,-5,17
NorthEast Un,1027,7,4,3,7,12,15,-3,15
FC Pune City,1027,8,4,3,7,13,22,-9,15
Mumbai City,1028,1,6,4,4,16,9,7,22
Kolkata,1028,2,5,7,2,21,15,6,22
NorthEast Un,1028,3,6,3,5,14,12,2,21
Delhi Dynamo,1028,4,5,5,4,24,18,6,20
FC Pune City,1028,5,5,3,6,15,17,-2,18
Chennaiyin,1028,6,3,7,4,13,17,-4,16
FC Goa,1028,7,4,4,6,10,15,-5,16
Kerala Blast,1028,8,4,3,7,10,20,-10,15
Mumbai City,1029,1,7,4,3,21,12,9,25
Kolkata,1029,2,5,7,2,18,14,4,22
Delhi Dynamo,1029,3,5,5,4,28,24,4,20
FC Pune City,1029,4,5,3,6,14,17,-3,18
FC Goa,1029,5,5,2,7,17,17,0,17
NorthEast Un,1029,6,5,2,7,12,15,-3,17
Chennaiyin,1029,7,4,5,5,16,21,-5,17
Kerala Blast,1029,8,4,4,6,10,16,-6,16
Mumbai City,1030,1,6,4,4,16,11,5,22
Kerala Blast,1030,2,6,4,4,14,14,0,22
Delhi Dynamo,1030,3,5,6,3,25,17,8,21
NorthEast Un,1030,4,6,2,6,12,10,2,20
Kolkata,1030,5,4,6,4,18,19,-1,18
FC Goa,1030,6,4,4,6,13,17,-4,16
FC Pune City,1030,7,4,4,6,14,19,-5,16
Chennaiyin,1030,8,3,6,5,14,19,-5,15
Mumbai City,1031,1,7,4,3,19,8,11,25
Kolkata,1031,2,5,6,3,17,19,-2,21
Delhi Dynamo,1031,3,5,5,4,25,20,5,20
NorthEast Un,1031,4,6,2,6,14,13,1,20
Chennaiyin,1031,5,5,5,4,18,20,-2,20
FC Pune City,1031,6,4,4,6,13,16,-3,16
Kerala Blast,1031,7,4,4,6,10,16,-6,16
FC Goa,1031,8,4,2,8,15,19,-4,14
Delhi Dynamo,1032,1,6,5,3,30,18,12,23
Mumbai City,1032,2,6,4,4,17,11,6,22
Kolkata,1032,3,5,7,2,19,15,4,22
NorthEast Un,1032,4,6,2,6,14,16,-2,20
Chennaiyin,1032,5,4,6,4,18,18,0,18
FC Pune City,1032,6,4,5,5,16,18,-2,17
Kerala Blast,1032,7,4,4,6,14,20,-6,16
FC Goa,1032,8,3,3,8,10,22,-12,12
Mumbai City,1033,1,7,4,3,17,8,9,25
Delhi Dynamo,1033,2,6,5,3,27,16,11,23
Chennaiyin,1033,3,5,5,4,17,18,-1,20
Kerala Blast,1033,4,5,5,4,13,16,-3,20
FC Pune City,1033,5,5,4,5,16,17,-1,19
Kolkata,1033,6,3,8,3,17,17,0,17
NorthEast Un,1033,7,4,2,8,10,16,-6,14
FC Goa,1033,8,3,3,8,11,20,-9,12
Delhi Dynamo,1034,1,6,6,2,26,17,9,24
Mumbai City,1034,2,6,4,4,17,10,7,22
Kolkata,1034,3,5,7,2,16,13,3,22
Chennaiyin,1034,4,5,5,4,18,17,1,20
FC Pune City,1034,5,5,4,5,14,15,-1,19
Kerala Blast,1034,6,5,3,6,10,15,-5,18
NorthEast Un,1034,7,4,2,8,10,16,-6,14
FC Goa,1034,8,3,3,8,9,17,-8,12
Mumbai City,1035,1,6,4,4,16,9,7,22
Kolkata,1035,2,5,7,2,19,14,5,22
Kerala Blast,1035,3,6,4,4,14,16,-2,22
Delhi Dynamo,1035,4,5,6,3,24,18,6,21
NorthEast Un,1035,5,5,2,7,14,15,-1,17
Chennaiyin,1035,6,4,5,5,17,21,-4,17
FC Pune City,1035,7,4,3,7,12,16,-4,15
FC Goa,1035,8,4,3,7,12,19,-7,15
Kerala Blast,1036,1,7,3,4,14,14,0,24
Delhi Dynamo,1036,2,6,5,3,26,19,7,23
Mumbai City,1036,3,6,4,4,16,10,6,22
NorthEast Un,1036,4,6,2,6,14,10,4,20
Kolkata,1036,5,3,8,3,15,15,0,17
Chennaiyin,1036,6,4,5,5,15,20,-5,17
FC Pune City,1036,7,4,4,6,13,17,-4,16
FC Goa,1036,8,3,3,8,11,19,-8,12
Mumbai City,1037,1,7,4,3,18,9,9,25
NorthEast Un,1037,2,6,3,5,15,10,5,21
Kerala Blast,1037,3,6,3,5,12,14,-2,21
Delhi Dynamo,1037,4,5,5,4,25,21,4,20
Kolkata,1037,5,4,7,3,15,15,0,19
FC Pune City,1037,6,4,3,7,13,17,-4,15
Chennaiyin,1037,7,3,6,5,14,19,-5,15
FC Goa,1037,8,4,3,7,10,17,-7,15
Mumbai City,1038,1,6,5,3,17,9,8,23
Delhi Dynamo,1038,2,5,6,3,23,16,7,21
Kerala Blast,1038,3,6,3,5,12,15,-3,21
NorthEast Un,1038,4,6,2,6,12,11,1,20
Kolkata,1038,5,4,7,3,16,15,1,19
FC Pune City,1038,6,5,3,6,14,16,-2,18
Chennaiyin,1038,7,3,6,5,14,19,-5,15
FC Goa,1038,8,3,4,7,10,17,-7,13
Mumbai City,1039,1,6,5,3,18,10,8,23
Delhi Dynamo,1039,2,4,7,3,25,21,4,19
NorthEast Un,1039,3,5,4,5,16,13,3,19
Kolkata,1039,4,4,7,3,17,17,0,19
Kerala Blast,1039,5,5,4,5,14,18,-4,19
FC Pune City,1039,6,5,3,6,15,16,-1,18
FC Goa,1039,7,4,4,6,12,16,-4,16
Chennaiyin,1039,8,3,6,5,14,20,-6,15
Delhi Dynamo,1040,1,6,6,2,26,16,10,24
Mumbai City,1040,2,6,4,4,16,9,7,22
Kerala Blast,1040,3,5,5,4,15,18,-3,20
FC Pune City,1040,4,5,4,5,16,15,1,19
Kolkata,1040,5,3,8,3,15,17,-2,17
NorthEast Un,1040,6,5,2,7,12,14,-2,17
Chennaiyin,1040,7,4,5,5,14,18,-4,17
FC Goa,1040,8,3,4,7,10,17,-7,13
Mumbai City,1041,1,7,4,3,18,8,10,25
NorthEast Un,1041,2,6,3,5,15,10,5,21
Kolkata,1041,3,5,6,3,17,14,3,21
Delhi Dynamo,1041,4,5,5,4,23,17,6,20
Kerala Blast,1041,5,5,4,5,12,16,-4,19
FC Pune City,1041,6,5,3,6,13,15,-2,18
Chennaiyin,1041,7,3,5,6,13,22,-9,14
FC Goa,1041,8,4,2,8,9,18,-9,14
Mumbai City,1042,1,7,4,3,20,8,12,25
Delhi Dynamo,1042,2,5,6,3,24,19,5,21
Kolkata,1042,3,4,8,2,17,15,2,20
NorthEast Un,1042,4,5,4,5,13,12,1,19
Kerala Blast,1042,5,4,5,5,12,17,-5,17
FC Pune City,1042,6,4,4,6,13,16,-3,16
Chennaiyin,1042,7,3,6,5,14,19,-5,15
FC Goa,1042,8,4,3,7,11,18,-7,15
Delhi Dynamo,1043,1,6,6,2,27,18,9,24
Mumbai City,1043,2,6,5,3,17,9,8,23
Kolkata,1043,3,5,7,2,19,13,6,22
Kerala Blast,1043,4,5,5,4,13,16,-3,20
Chennaiyin,1043,5,4,5,5,15,20,-5,17
FC Pune City,1043,6,4,4,6,13,19,-6,16
NorthEast Un,1043,7,4,2,8,11,14,-3,14
FC Goa,1043,8,4,2,8,13,19,-6,14
Mumbai City,1044,1,6,5,3,16,8,8,23
Kerala Blast,1044,2,6,4,4,17,19,-2,22
Delhi Dynamo,1044,3,5,6,3,23,16,7,21
Kolkata,1044,4,4,7,3,17,15,2,19
Chennaiyin,1044,5,4,6,4,16,18,-2,18
NorthEast Un,1044,6,5,2,7,12,13,-1,17
FC Pune City,1044,7,4,4,6,15,19,-4,16
FC Goa,1044,8,3,4,7,9,17,-8,13
Mumbai City,1045,1,6,5,3,18,10,8,23
Kerala Blast,1045,2,6,3,5,13,16,-3,21
NorthEast Un,1045,3,6,2,6,13,12,1,20
Delhi Dynamo,1045,4,4,7,3,25,19,6,19
Chennaiyin,1045,5,4,6,4,17,18,-1,18
Kolkata,1045,6,3,8,3,14,15,-1,17
FC Pune City,1045,7,4,4,6,13,17,-4,16
FC Goa,1045,8,3,5,6,11,17,-6,14
Mumbai City,1046,1,6,5,3,18,10,8,23
Delhi Dynamo,1046,2,5,6,3,25,18,7,21
FC Goa,1046,3,6,2,6,11,14,-3,20
Kolkata,1046,4,4,7,3,17,15,2,19
Kerala Blast,1046,5,5,4,5,12,16,-4,19
Chennaiyin,1046,6,4,5,5,19,20,-1,17
NorthEast Un,1046,7,5,2,7,13,17,-4,17
FC Pune City,1046,8,4,3,7,14,19,-5,15
Delhi Dynamo,1047,1,6,6,2,27,17,10,24
Mumbai City,1047,2,6,5,3,17,9,8,23
Chennaiyin,1047,3,4,6,4,15,18,-3,18
Kerala Blast,1047,4,4,6,4,10,14,-4,18
Kolkata,1047,5,3,8,3,16,17,-1,17
FC Pune City,1047,6,4,5,5,15,17,-2,17
NorthEast Un,1047,7,4,4,6,10,12,-2,16
FC Goa,1047,8,4,2,8,13,19,-6,14
Delhi Dynamo,1048,1,5,7,2,26,18,8,22
Mumbai City,1048,2,6,4,4,17,10,7,22
Kolkata,1048,3,5,6,3,16,14,2,21
Kerala Blast,1048,4,6,3,5,14,17,-3,21
FC Goa,1048,5,5,3,6,14,17,-3,18
Chennaiyin,1048,6,4,5,5,15,20,-5,17
NorthEast Un,1048,7,4,3,7,12,14,-2,15
FC Pune City,1048,8,4,3,7,14,18,-4,15
Kerala Blast,1049,1,7,3,4,18,16,2,24
Mumbai City,1049,2,6,5,3,19,11,8,23
Delhi Dynamo,1049,3,5,7,2,25,17,8,22
Kolkata,1049,4,4,6,4,18,19,-1,18
Chennaiyin,1049,5,4,6,4,15,18,-3,18
NorthEast Un,1049,6,4,3,7,10,14,-4,15
FC Pune City,1049,7,4,3,7,13,18,-5,15
FC Goa,1049,8,4,3,7,11,16,-5,15
Mumbai City,1050,1,7,4,3,18,8,10,25
Kolkata,1050,2,5,6,3,18,14,4,21
Delhi Dynamo,1050,3,4,7,3,22,17,5,19
NorthEast Un,1050,4,5,4,5,12,11,1,19
Kerala Blast,1050,5,5,4,5,13,18,-5,19
FC Goa,1050,6,5,3,6,14,15,-1,18
FC Pune City,1050,7,4,3,7,12,17,-5,15
Chennaiyin,1050,8,3,5,6,14,23,-9,14
Mumbai City,1051,1,6,4,4,17,10,7,22
Kolkata,1051,2,5,7,2,19,13,6,22
Delhi Dynamo,1051,3,5,6,3,25,18,7,21
NorthEast Un,1051,4,5,4,5,14,13,1,19
Chennaiyin,1051,5,4,6,4,15,18,-3,18
FC Pune City,1051,6,4,5,5,15,17,-2,17
Kerala Blast,1051,7,4,5,5,13,20,-7,17
FC Goa,1051,8,3,3,8,9,18,-9,12
Mumbai City,1052,1,7,4,3,17,8,9,25
Kerala Blast,1052,2,7,3,4,12,13,-1,24
Delhi Dynamo,1052,3,5,6,3,25,18,7,21
Kolkata,1052,4,4,7,3,15,14,1,19
NorthEast Un,1052,5,5,2,7,11,12,-1,17
FC Pune City,1052,6,4,4,6,13,16,-3,16
Chennaiyin,1052,7,3,6,5,14,19,-5,15
FC Goa,1052,8,3,4,7,11,18,-7,13
Delhi Dynamo,1053,1,6,6,2,24,14,10,24
Mumbai City,1053,2,6,4,4,16,9,7,22
Kerala Blast,1053,3,6,4,4,11,13,-2,22
FC Pune City,1053,4,5,3,6,14,16,-2,18
FC Goa,1053,5,4,4,6,16,19,-3,16
Kolkata,1053,5,3,7,4,16,19,-3,16
Chennaiyin,1053,7,3,7,4,16,20,-4,16
NorthEast Un,1053,8,4,3,7,9,12,-3,15
Mumbai City,1054,1,6,5,3,18,10,8,23
Kolkata,1054,2,5,7,2,19,16,3,22
NorthEast Un,1054,3,6,3,5,14,11,3,21
Delhi Dynamo,1054,4,4,6,4,25,20,5,18
FC Goa,1054,5,5,3,6,15,18,-3,18
Kerala Blast,1054,6,5,3,6,10,16,-6,18
FC Pune City,1054,7,4,3,7,13,17,-4,15
Chennaiyin,1054,8,3,6,5,14,20,-6,15
Mumbai City,1055,1,7,4,3,17,8,9,25
Delhi Dynamo,1055,2,5,6,3,24,17,7,21
Kerala Blast,1055,3,5,5,4,13,16,-3,20
NorthEast Un,1055,4,5,3,6,14,12,2,18
FC Pune City,1055,5,5,3,6,13,15,-2,18
FC Goa,1055,6,5,3,6,13,17,-4,18
Kolkata,1055,7,3,7,4,15,16,-1,16
Chennaiyin,1055,8,3,5,6,13,21,-8,14
Mumbai City,1056,1,7,4,3,19,9,10,25
Kerala Blast,1056,2,6,4,4,12,13,-1,22
Delhi Dynamo,1056,3,5,6,3,26,19,7,21
Kolkata,1056,4,4,8,2,16,13,3,20
Chennaiyin,1056,5,4,5,5,15,20,-5,17
FC Goa,1056,6,4,4,6,13,17,-4,16
FC Pune City,1056,7,4,3,7,12,17,-5,15
NorthEast Un,1056,8,4,2,8,10,15,-5,14
Mumbai City,1057,1,7,4,3,17,8,9,25
Kolkata,1057,2,4,8,2,17,15,2,20
Chennaiyin,1057,3,5,5,4,19,19,0,20
Kerala Blast,1057,4,5,5,4,15,18,-3,20
Delhi Dynamo,1057,5,4,6,4,23,19,4,18
NorthEast Un,1057,6,5,2,7,14,14,0,17
FC Pune City,1057,7,4,4,6,14,17,-3,16
FC Goa,1057,8,3,4,7,11,20,-9,13
Delhi Dynamo,1058,1,6,5,3,27,19,8,23
Mumbai City,1058,2,6,4,4,18,12,6,22
Kolkata,1058,3,5,6,3,18,15,3,21
Kerala Blast,1058,4,6,3,5,14,16,-2,21
Chennaiyin,1058,5,5,5,4,17,19,-2,20
FC Pune City,1058,6,5,3,6,15,17,-2,18
NorthEast Un,1058,7,5,2,7,14,13,1,17
FC Goa,1058,8,3,2,9,9,21,-12,11
Mumbai City,1059,1,6,5,3,17,9,8,23
Delhi Dynamo,1059,2,5,7,2,24,16,8,22
Kolkata,1059,3,4,7,3,15,13,2,19
Kerala Blast,1059,4,5,4,5,10,14,-4,19
FC Pune City,1059,5,5,3,6,13,16,-3,18
FC Goa,1059,6,5,3,6,12,16,-4,18
NorthEast Un,1059,7,5,2,7,12,11,1,17
Chennaiyin,1059,8,3,5,6,14,22,-8,14
Delhi Dynamo,1060,1,7,5,2,28,15,13,26
Mumbai City,1060,2,6,4,4,16,10,6,22
Kolkata,1060,3,5,6,3,18,15,3,21
Chennaiyin,1060,4,4,6,4,17,20,-3,18
Kerala Blast,1060,5,5,3,6,12,17,-5,18
NorthEast Un,1060,6,5,2,7,13,15,-2,17
FC Pune City,1060,7,4,3,7,14,19,-5,15
FC Goa,1060,8,4,3,7,12,19,-7,15
Delhi Dynamo,1061,1,6,5,3,25,17,8,23
Mumbai City,1061,2,6,4,4,16,9,7,22
Chennaiyin,1061,3,5,5,4,16,18,-2,20
Kerala Blast,1061,4,5,5,4,11,13,-2,20
FC Pune City,1061,5,5,4,5,13,14,-1,19
NorthEast Un,1061,6,5,3,6,12,12,0,18
Kolkata,1061,7,3,7,4,15,17,-2,16
FC Goa,1061,8,3,3,8,11,19,-8,12
Delhi Dynamo,1062,1,6,5,3,30,20,10,23
Mumbai City,1062,2,6,4,4,18,12,6,22
NorthEast Un,1062,3,6,3,5,14,10,4,21
Kolkata,1062,4,4,7,3,19,16,3,19
FC Pune City,1062,5,5,4,5,14,15,-1,19
Chennaiyin,1062,6,4,6,4,16,17,-1,18
Kerala Blast,1062,7,4,4,6,10,18,-8,16
FC Goa,1062,8,3,3,8,11,24,-13,12
Delhi Dynamo,1063,1,6,5,3,30,17,13,23
Mumbai City,1063,2,6,4,4,17,12,5,22
Kolkata,1063,3,5,7,2,16,12,4,22
Kerala Blast,1063,4,6,3,5,11,14,-3,21
Chennaiyin,1063,5,5,5,4,18,18,0,20
NorthEast Un,1063,6,5,2,7,11,14,-3,17
FC Pune City,1063,7,4,4,6,12,15,-3,16
FC Goa,1063,8,3,2,9,9,22,-13,11
Mumbai City,1064,1,6,5,3,16,8,8,23
Kerala Blast,1064,2,5,5,4,14,17,-3,20
Delhi Dynamo,1064,3,4,7,3,22,17,5,19
Kolkata,1064,4,4,7,3,17,16,1,19
NorthEast Un,1064,5,5,3,6,13,14,-1,18
FC Pune City,1064,6,4,5,5,12,14,-2,17
Chennaiyin,1064,7,4,5,5,17,20,-3,17
FC Goa,1064,8,4,3,7,13,18,-5,15
Mumbai City,1065,1,7,4,3,18,9,9,25
Delhi Dynamo,1065,2,5,6,3,24,17,7,21
Kolkata,1065,3,5,6,3,15,16,-1,21
Kerala Blast,1065,4,6,3,5,12,15,-3,21
FC Pune City,1065,5,5,3,6,17,16,1,18
NorthEast Un,1065,6,5,3,6,11,11,0,18
Chennaiyin,1065,7,3,5,6,14,20,-6,14
FC Goa,1065,8,4,2,8,10,17,-7,14
Mumbai City,1066,1,7,4,3,20,9,11,25
Delhi Dynamo,1066,2,6,5,3,26,18,8,23
Kerala Blast,1066,3,6,4,4,14,15,-1,22
Kolkata,1066,4,4,8,2,16,14,2,20
NorthEast Un,1066,5,5,2,7,10,12,-2,17
Chennaiyin,1066,6,3,6,5,14,19,-5,15
FC Pune City,1066,7,4,3,7,12,17,-5,15
FC Goa,1066,8,3,4,7,9,17,-8,13
Mumbai City,1067,1,7,4,3,17,8,9,25
Delhi Dynamo,1067,2,6,5,3,23,15,8,23
NorthEast Un,1067,3,6,2,6,12,11,1,20
FC Pune City,1067,4,5,4,5,15,16,-1,19
Kolkata,1067,5,4,6,4,15,16,-1,18
FC Goa,1067,6,5,2,7,12,16,-4,17
Kerala Blast,1067,7,4,4,6,10,16,-6,16
Chennaiyin,1067,8,3,5,6,15,21,-6,14
Mumbai City,1068,1,7,4,3,21,12,9,25
Kolkata,1068,2,5,7,2,18,15,3,22
NorthEast Un,1068,3,6,2,6,12,14,-2,20
Chennaiyin,1068,4,4,6,4,18,18,0,18
Kerala Blast,1068,5,5,3,6,13,17,-4,18
Delhi Dynamo,1068,6,4,5,5,25,21,4,17
FC Pune City,1068,7,4,4,6,14,18,-4,16
FC Goa,1068,8,4,3,7,10,16,-6,15
Mumbai City,1069,1,6,5,3,17,9,8,23
NorthEast Un,1069,2,7,2,5,13,9,4,23
Delhi Dynamo,1069,3,5,6,3,23,17,6,21
Kolkata,1069,4,5,6,3,21,15,6,21
Kerala Blast,1069,5,5,3,6,11,18,-7,18
Chennaiyin,1069,6,4,5,5,15,19,-4,17
FC Pune City,1069,7,4,3,7,12,18,-6,15
FC Goa,1069,8,4,2,8,12,19,-7,14
Delhi Dynamo,1070,1,6,5,3,24,16,8,23
Mumbai City,1070,2,6,4,4,17,10,7,22
Kerala Blast,1070,3,6,3,5,12,16,-4,21
Kolkata,1070,4,4,7,3,18,16,2,19
FC Pune City,1070,5,5,3,6,14,16,-2,18
NorthEast Un,1070,6,5,2,7,11,12,-1,17
Chennaiyin,1070,7,4,5,5,14,20,-6,17
FC Goa,1070,8,4,3,7,13,17,-4,15
Mumbai City,1071,1,7,4,3,17,8,9,25
Kolkata,1071,2,6,6,2,24,14,10,24
Delhi Dynamo,1071,3,6,5,3,26,18,8,23
NorthEast Un,1071,4,5,3,6,11,11,0,18
Kerala Blast,1071,5,5,3,6,11,18,-7,18
Chennaiyin,1071,6,3,6,5,13,18,-5,15
FC Pune City,1071,7,4,3,7,13,20,-7,15
FC Goa,1071,8,4,2,8,12,20,-8,14
Mumbai City,1072,1,7,4,3,18,8,10,25
Delhi Dynamo,1072,2,6,5,3,24,17,7,23
Kerala Blast,1072,3,6,3,5,12,15,-3,21
Kolkata,1072,4,4,6,4,17,16,1,18
FC Pune City,1072,5,5,3,6,14,17,-3,18
NorthEast Un,1072,6,5,2,7,12,13,-1,17
Chennaiyin,1072,7,4,5,5,15,18,-3,17
FC Goa,1072,8,4,2,8,10,18,-8,14
Mumbai City,1073,1,6,5,3,18,10,8,23
Kolkata,1073,2,5,7,2,22,14,8,22
NorthEast Un,1073,3,6,2,6,13,11,2,20
Chennaiyin,1073,4,5,5,4,17,19,-2,20
Kerala Blast,1073,5,5,4,5,11,15,-4,19
Delhi Dynamo,1073,6,4,6,4,23,19,4,18
FC Pune City,1073,7,4,3,7,13,18,-5,15
FC Goa,1073,8,4,2,8,10,21,-11,14
Mumbai City,1074,1,6,4,4,17,10,7,22
Delhi Dynamo,1074,2,5,6,3,27,21,6,21
Kolkata,1074,3,5,6,3,19,16,3,21
Chennaiyin,1074,4,5,5,4,16,18,-2,20
NorthEast Un,1074,5,5,3,6,13,12,1,18
Kerala Blast,1074,6,4,5,5,10,15,-5,17
FC Pune City,1074,7,4,4,6,13,18,-5,16
FC Goa,1074,8,4,3,7,15,20,-5,15
Mumbai City,1075,1,7,4,3,18,9,9,25
Delhi Dynamo,1075,2,6,5,3,25,17,8,23
Kolkata,1075,3,4,8,2,20,17,3,20
Chennaiyin,1075,4,5,5,4,17,19,-2,20
Kerala Blast,1075,5,5,5,4,13,16,-3,20
FC Pune City,1075,6,4,4,6,14,17,-3,16
NorthEast Un,1075,7,4,3,7,12,14,-2,15
FC Goa,1075,8,3,2,9,12,22,-10,11
Mumbai City,1076,1,7,4,3,19,8,11,25
Delhi Dynamo,1076,2,5,6,3,24,17,7,21
Chennaiyin,1076,3,5,5,4,16,18,-2,20
Kerala Blast,1076,4,5,4,5,13,18,-5,19
FC Pune City,1076,5,5,3,6,16,16,0,18
Kolkata,1076,6,4,6,4,16,17,-1,18
NorthEast Un,1076,7,4,3,7,10,14,-4,15
FC Goa,1076,8,4,3,7,10,16,-6,15
Delhi Dynamo,1077,1,6,6,2,28,18,10,24
Mumbai City,1077,2,6,5,3,19,11,8,23
Kolkata,1077,3,4,7,3,16,15,1,19
Kerala Blast,1077,4,5,4,5,14,18,-4,19
Chennaiyin,1077,5,4,6,4,15,18,-3,18
FC Pune City,1077,6,4,4,6,14,17,-3,16
NorthEast Un,1077,7,4,3,7,10,13,-3,15
FC Goa,1077,8,4,3,7,12,18,-6,15
Mumbai City,1078,1,7,4,3,19,10,9,25
Delhi Dynamo,1078,2,6,5,3,28,18,10,23
Kolkata,1078,3,5,6,3,16,14,2,21
FC Pune City,1078,4,5,4,5,15,15,0,19
Chennaiyin,1078,5,4,5,5,18,20,-2,17
NorthEast Un,1078,6,5,2,7,13,16,-3,17
Kerala Blast,1078,7,4,4,6,11,19,-8,16
FC Goa,1078,8,4,2,8,11,19,-8,14
Mumbai City,1079,1,7,4,3,18,8,10,25
Delhi Dynamo,1079,2,6,5,3,26,17,9,23
FC Pune City,1079,3,6,3,5,16,15,1,21
Kolkata,1079,4,4,7,3,17,16,1,19
Kerala Blast,1079,5,5,3,6,12,17,-5,18
Chennaiyin,1079,6,4,5,5,14,18,-4,17
FC Goa,1079,7,4,3,7,11,19,-8,15
NorthEast Un,1079,8,4,2,8,10,14,-4,14
Mumbai City,1080,1,6,5,3,18,10,8,23
Kerala Blast,1080,2,6,4,4,15,15,0,22
Delhi Dynamo,1080,3,5,6,3,27,20,7,21
NorthEast Un,1080,4,6,2,6,12,11,1,20
FC Pune City,1080,5,4,5,5,12,14,-2,17
Kolkata,1080,6,3,7,4,16,19,-3,16
Chennaiyin,1080,7,3,6,5,16,21,-5,15
FC Goa,1080,8,4,3,7,15,21,-6,15
Mumbai City,1081,1,6,5,3,16,8,8,23
Kerala Blast,1081,2,6,3,5,14,17,-3,21
NorthEast Un,1081,3,6,2,6,15,14,1,20
FC Goa,1081,4,6,2,6,13,14,-1,20
Delhi Dynamo,1081,5,4,6,4,23,19,4,18
FC Pune City,1081,6,5,3,6,14,15,-1,18
Kolkata,1081,7,4,6,4,15,17,-2,18
Chennaiyin,1081,8,3,5,6,13,19,-6,14
Mumbai City,1082,1,7,4,3,20,9,11,25
Kerala Blast,1082,2,7,3,4,18,15,3,24
Delhi Dynamo,1082,3,5,6,3,30,23,7,21
Chennaiyin,1082,4,4,6,4,14,17,-3,18
Kolkata,1082,5,3,7,4,15,18,-3,16
FC Pune City,1082,6,4,4,6,14,19,-5,16
NorthEast Un,1082,7,4,3,7,13,17,-4,15
FC Goa,1082,8,4,3,7,12,18,-6,15
Mumbai City,1083,1,7,4,3,17,8,9,25
FC Pune City,1083,2,6,3,5,17,15,2,21
Delhi Dynamo,1083,3,4,7,3,22,16,6,19
Kerala Blast,1083,4,5,4,5,12,16,-4,19
Kolkata,1083,5,4,6,4,15,16,-1,18
Chennaiyin,1083,6,4,5,5,15,19,-4,17
NorthEast Un,1083,7,4,4,6,10,11,-1,16
FC Goa,1083,8,4,3,7,11,18,-7,15
Mumbai City,1084,1,7,4,3,17,8,9,25
Kolkata,1084,2,6,6,2,19,12,7,24
Delhi Dynamo,1084,3,5,6,3,24,17,7,21
NorthEast Un,1084,4,5,3,6,14,15,-1,18
Kerala Blast,1084,5,5,3,6,13,18,-5,18
Chennaiyin,1084,6,4,5,5,16,19,-3,17
FC Pune City,1084,7,4,3,7,12,19,-7,15
FC Goa,1084,8,4,2,8,9,16,-7,14
Delhi Dynamo,1085,1,6,5,3,23,17,6,23
NorthEast Un,1085,2,7,2,5,16,10,6,23
Mumbai City,1085,3,6,4,4,16,9,7,22
Kolkata,1085,4,5,7,2,21,15,6,22
Kerala Blast,1085,5,5,3,6,12,19,-7,18
FC Goa,1085,6,4,3,7,11,16,-5,15
FC Pune City,1085,7,4,3,7,14,20,-6,15
Chennaiyin,1085,8,3,5,6,14,21,-7,14
Delhi Dynamo,1086,1,6,5,3,30,22,8,23
Mumbai City,1086,2,6,4,4,19,12,7,22
Kolkata,1086,3,5,6,3,18,16,2,21
NorthEast Un,1086,4,6,2,6,16,14,2,20
FC Pune City,1086,5,5,4,5,16,15,1,19
FC Goa,1086,6,5,2,7,13,18,-5,17
Kerala Blast,1086,7,4,4,6,11,20,-9,16
Chennaiyin,1086,8,3,5,6,14,20,-6,14
Mumbai City,1087,1,6,5,3,18,10,8,23
NorthEast Un,1087,2,6,3,5,15,11,4,21
Kolkata,1087,3,5,6,3,17,15,2,21
Delhi Dynamo,1087,4,4,6,4,24,21,3,18
FC Pune City,1087,5,5,3,6,16,17,-1,18
Kerala Blast,1087,6,5,3,6,13,19,-6,18
Chennaiyin,1087,7,3,7,4,14,18,-4,16
FC Goa,1087,8,4,3,7,10,16,-6,15
Mumbai City,1088,1,7,4,3,17,8,9,25
Kerala Blast,1088,2,6,4,4,14,15,-1,22
Delhi Dynamo,1088,3,5,5,4,25,18,7,20
Kolkata,1088,4,4,8,2,20,15,5,20
NorthEast Un,1088,5,5,2,7,12,13,-1,17
Chennaiyin,1088,6,4,5,5,17,21,-4,17
FC Pune City,1088,7,4,4,6,13,17,-4,16
FC Goa,1088,8,4,2,8,12,23,-11,14
Mumbai City,1089,1,7,4,3,17,8,9,25
Kolkata,1089,2,4,8,2,18,15,3,20
Kerala Blast,1089,3,5,5,4,14,16,-2,20
Delhi Dynamo,1089,4,4,6,4,23,18,5,18
Chennaiyin,1089,5,4,6,4,18,19,-1,18
NorthEast Un,1089,6,4,4,6,11,13,-2,16
FC Pune City,1089,7,4,4,6,13,17,-4,16
FC Goa,1089,8,4,3,7,12,20,-8,15
Mumbai City,1090,1,7,4,3,17,8,9,25
Delhi Dynamo,1090,2,5,6,3,22,15,7,21
NorthEast Un,1090,3,5,4,5,13,11,2,19
Kolkata,1090,4,4,7,3,16,15,1,19
FC Pune City,1090,5,5,4,5,15,16,-1,19
Chennaiyin,1090,6,4,6,4,15,18,-3,18
Kerala Blast,1090,7,5,3,6,14,20,-6,18
FC Goa,1090,8,3,2,9,9,18,-9,11
Mumbai City,1091,1,7,4,3,18,9,9,25
Kolkata,1091,2,5,7,2,17,13,4,22
Delhi Dynamo,1091,3,5,6,3,24,17,7,21
Kerala Blast,1091,4,4,6,4,10,14,-4,18
Chennaiyin,1091,5,4,5,5,14,18,-4,17
FC Pune City,1091,6,4,4,6,14,17,-3,16
NorthEast Un,1091,7,4,3,7,9,11,-2,15
FC Goa,1091,8,4,3,7,10,17,-7,15
Mumbai City,1092,1,6,5,3,17,9,8,23
Delhi Dynamo,1092,2,5,7,2,24,16,8,22
FC Pune City,1092,3,6,3,5,19,14,5,21
Kolkata,1092,4,4,7,3,18,20,-2,19
Chennaiyin,1092,5,4,5,5,16,20,-4,17
Kerala Blast,1092,6,4,5,5,11,16,-5,17
NorthEast Un,1092,7,4,3,7,10,12,-2,15
FC Goa,1092,8,4,3,7,11,19,-8,15
Mumbai City,1093,1,7,4,3,18,9,9,25
Delhi Dynamo,1093,2,4,7,3,22,16,6,19
Kolkata,1093,3,4,7,3,16,14,2,19
NorthEast Un,1093,4,5,4,5,12,10,2,19
Kerala Blast,1093,5,5,4,5,14,18,-4,19
FC Pune City,1093,6,4,4,6,13,17,-4,16
FC Goa,1093,7,4,4,6,10,15,-5,16
Chennaiyin,1093,8,3,6,5,14,20,-6,15
Mumbai City,1094,1,7,4,3,20,8,12,25
Kerala Blast,1094,2,6,4,4,16,15,1,22
NorthEast Un,1094,3,5,4,5,18,17,1,19
Delhi Dynamo,1094,4,4,6,4,25,23,2,18
Chennaiyin,1094,5,4,5,5,16,20,-4,17
FC Goa,1094,6,5,2,7,13,18,-5,17
Kolkata,1094,7,3,7,4,17,20,-3,16
FC Pune City,1094,8,4,4,6,13,17,-4,16
Mumbai City,1095,1,7,4,3,18,9,9,25
Kerala Blast,1095,2,6,4,4,15,17,-2,22
Delhi Dynamo,1095,3,5,6,3,28,20,8,21
Kolkata,1095,4,4,7,3,16,15,1,19
NorthEast Un,1095,5,4,5,5,12,12,0,17
FC Pune City,1095,6,4,4,6,15,18,-3,16
Chennaiyin,1095,7,3,6,5,13,18,-5,15
FC Goa,1095,8,4,2,8,11,19,-8,14
Mumbai City,1096,1,7,4,3,19,9,10,25
Kolkata,1096,2,5,7,2,20,16,4,22
Delhi Dynamo,1096,3,5,6,3,25,18,7,21
NorthEast Un,1096,4,6,3,5,16,12,4,21
FC Pune City,1096,5,4,4,6,14,18,-4,16
Kerala Blast,1096,6,4,4,6,12,20,-8,16
Chennaiyin,1096,7,3,6,5,16,21,-5,15
FC Goa,1096,8,3,4,7,12,20,-8,13
Mumbai City,1097,1,6,5,3,16,8,8,23
Delhi Dynamo,1097,2,5,7,2,24,16,8,22
FC Pune City,1097,3,5,4,5,16,17,-1,19
NorthEast Un,1097,4,5,3,6,13,13,0,18
FC Goa,1097,5,5,2,7,12,16,-4,17
Chennaiyin,1097,6,4,5,5,15,20,-5,17
Kerala Blast,1097,7,4,5,5,13,18,-5,17
Kolkata,1097,8,3,7,4,15,16,-1,16
Kerala Blast,1098,1,7,3,4,14,15,-1,24
Mumbai City,1098,2,6,5,3,18,10,8,23
Delhi Dynamo,1098,3,5,7,2,26,17,9,22
Kolkata,1098,4,4,6,4,18,18,0,18
FC Goa,1098,5,5,2,7,14,17,-3,17
Chennaiyin,1098,6,4,5,5,15,20,-5,17
NorthEast Un,1098,7,4,3,7,11,14,-3,15
FC Pune City,1098,8,4,3,7,13,18,-5,15
Mumbai City,1099,1,7,4,3,17,8,9,25
Kerala Blast,1099,2,5,5,4,14,17,-3,20
Delhi Dynamo,1099,3,4,7,3,22,16,6,19
NorthEast Un,1099,4,5,3,6,11,11,0,18
FC Goa,1099,5,5,3,6,12,16,-4,18
Kolkata,1099,6,3,8,3,15,15,0,17
FC Pune City,1099,7,4,5,5,15,17,-2,17
Chennaiyin,1099,8,3,5,6,14,20,-6,14
Delhi Dynamo,1100,1,6,5,3,24,17,7,23
Mumbai City,1100,2,6,4,4,16,9,7,22
Kolkata,1100,3,5,7,2,16,13,3,22
Kerala Blast,1100,4,5,4,5,11,15,-4,19
FC Goa,1100,5,5,3,6,11,14,-3,18
NorthEast Un,1100,6,5,2,7,12,13,-1,17
FC Pune City,1100,7,4,4,6,14,17,-3,16
Chennaiyin,1100,8,3,5,6,14,20,-6,14
Mumbai City,1101,1,7,4,3,23,10,13,25
Delhi Dynamo,1101,2,5,6,3,27,24,3,21
Kolkata,1101,3,4,7,3,18,18,0,19
Kerala Blast,1101,4,5,4,5,14,17,-3,19
NorthEast Un,1101,5,5,3,6,13,13,0,18
Chennaiyin,1101,6,4,6,4,16,19,-3,18
FC Pune City,1101,7,4,4,6,16,19,-3,16
FC Goa,1101,8,3,4,7,13,20,-7,13
Mumbai City,1102,1,7,4,3,19,9,10,25
Kolkata,1102,2,5,7,2,19,14,5,22
Kerala Blast,1102,3,6,3,5,14,18,-4,21
Delhi Dynamo,1102,4,5,5,4,26,22,4,20
NorthEast Un,1102,5,6,2,6,15,11,4,20
FC Pune City,1102,6,4,4,6,13,16,-3,16
Chennaiyin,1102,7,3,6,5,13,20,-7,15
FC Goa,1102,8,3,3,8,12,21,-9,12
Mumbai City,1103,1,7,4,3,18,8,10,25
Kolkata,1103,2,5,7,2,18,15,3,22
Delhi Dynamo,1103,3,5,6,3,24,18,6,21
Chennaiyin,1103,4,5,5,4,18,18,0,20
Kerala Blast,1103,5,5,4,5,11,18,-7,19
FC Pune City,1103,6,5,3,6,16,15,1,18
NorthEast Un,1103,7,4,3,7,11,13,-2,15
FC Goa,1103,8,3,2,9,11,22,-11,11
Mumbai City,1104,1,6,4,4,16,9,7,22
Kolkata,1104,2,4,8,2,19,14,5,20
Delhi Dynamo,1104,3,5,5,4,25,21,4,20
NorthEast Un,1104,4,6,2,6,15,11,4,20
Kerala Blast,1104,5,5,4,5,12,16,-4,19
FC Goa,1104,6,5,3,6,15,19,-4,18
Chennaiyin,1104,7,4,5,5,15,19,-4,17
FC Pune City,1104,8,4,3,7,13,21,-8,15
Kerala Blast,1105,1,7,3,4,12,13,-1,24
Mumbai City,1105,2,6,4,4,17,10,7,22
Delhi Dynamo,1105,3,5,6,3,23,16,7,21
NorthEast Un,1105,4,5,3,6,10,10,0,18
FC Pune City,1105,5,5,3,6,14,16,-2,18
Chennaiyin,1105,6,4,5,5,15,18,-3,17
Kolkata,1105,7,3,7,4,17,18,-1,16
FC Goa,1105,8,4,3,7,12,19,-7,15
Mumbai City,1106,1,6,5,3,18,10,8,23
Delhi Dynamo,1106,2,5,7,2,24,16,8,22
FC Pune City,1106,3,6,3,5,16,15,1,21
NorthEast Un,1106,4,5,3,6,11,11,0,18
Chennaiyin,1106,5,4,6,4,16,17,-1,18
Kerala Blast,1106,6,5,3,6,13,18,-5,18
Kolkata,1106,7,3,6,5,15,18,-3,15
FC Goa,1106,8,4,3,7,10,18,-8,15
Delhi Dynamo,1107,1,6,5,3,25,18,7,23
NorthEast Un,1107,2,7,2,5,15,10,5,23
Mumbai City,1107,3,6,4,4,16,10,6,22
Kolkata,1107,4,5,6,3,21,16,5,21
Kerala Blast,1107,5,6,3,5,19,18,1,21
FC Pune City,1107,6,4,3,7,13,22,-9,15
Chennaiyin,1107,7,3,5,6,14,20,-6,14
FC Goa,1107,8,4,2,8,11,20,-9,14
Mumbai City,1108,1,6,5,3,16,8,8,23
Delhi Dynamo,1108,2,5,6,3,23,17,6,21
NorthEast Un,1108,3,6,2,6,13,10,3,20
Kerala Blast,1108,4,5,4,5,13,17,-4,19
Kolkata,1108,5,3,9,2,17,16,1,18
Chennaiyin,1108,6,4,5,5,16,21,-5,17
FC Pune City,1108,7,4,4,6,13,17,-4,16
FC Goa,1108,8,4,3,7,14,19,-5,15
Mumbai City,1109,1,7,4,3,19,9,10,25
Delhi Dynamo,1109,2,5,5,4,24,19,5,20
NorthEast Un,1109,3,6,2,6,14,11,3,20
Kolkata,1109,4,4,7,3,16,15,1,19
FC Goa,1109,5,5,3,6,12,15,-3,18
Kerala Blast,1109,6,4,5,5,13,18,-5,17
FC Pune City,1109,7,4,4,6,14,18,-4,16
Chennaiyin,1109,8,3,6,5,13,20,-7,15
Kolkata,1110,1,6,6,2,22,16,6,24
Mumbai City,1110,2,6,4,4,19,12,7,22
Kerala Blast,1110,3,6,3,5,18,19,-1,21
Delhi Dynamo,1110,4,5,5,4,25,19,6,20
NorthEast Un,1110,5,5,3,6,13,13,0,18
FC Goa,1110,6,5,2,7,14,19,-5,17
FC Pune City,1110,7,4,3,7,13,19,-6,15
Chennaiyin,1110,8,3,6,5,14,21,-7,15
Mumbai City,1111,1,7,4,3,19,9,10,25
Delhi Dynamo,1111,2,6,5,3,26,18,8,23
Kolkata,1111,3,4,7,3,14,15,-1,19
FC Pune City,1111,4,5,3,6,15,17,-2,18
Chennaiyin,1111,5,4,6,4,17,20,-3,18
Kerala Blast,1111,6,5,3,6,12,15,-3,18
NorthEast Un,1111,7,5,2,7,11,13,-2,17
FC Goa,1111,8,3,4,7,11,18,-7,13
Mumbai City,1112,1,7,4,3,18,9,9,25
NorthEast Un,1112,2,7,2,5,17,10,7,23
Delhi Dynamo,1112,3,4,6,4,22,17,5,18
Kolkata,1112,4,4,6,4,19,17,2,18
FC Pune City,1112,5,5,3,6,14,16,-2,18
Kerala Blast,1112,6,5,3,6,12,23,-11,18
Chennaiyin,1112,7,4,5,5,14,18,-4,17
FC Goa,1112,8,4,3,7,10,16,-6,15
Mumbai City,1113,1,7,4,3,20,9,11,25
Delhi Dynamo,1113,2,6,5,3,27,19,8,23
Kolkata,1113,3,5,7,2,20,14,6,22
Chennaiyin,1113,4,4,6,4,16,18,-2,18
Kerala Blast,1113,5,5,3,6,10,19,-9,18
NorthEast Un,1113,6,5,2,7,11,13,-2,17
FC Pune City,1113,7,4,4,6,13,16,-3,16
FC Goa,1113,8,3,3,8,11,20,-9,12
Mumbai City,1114,1,7,4,3,17,8,9,25
Kerala Blast,1114,2,7,3,4,15,14,1,24
Delhi Dynamo,1114,3,5,5,4,24,18,6,20
Chennaiyin,1114,4,4,6,4,15,18,-3,18
FC Goa,1114,5,5,2,7,15,19,-4,17
Kolkata,1114,6,3,7,4,17,19,-2,16
FC Pune City,1114,7,4,4,6,13,17,-4,16
NorthEast Un,1114,8,4,3,7,10,13,-3,15
Mumbai City,1115,1,6,5,3,17,9,8,23
Delhi Dynamo,1115,2,5,6,3,23,19,4,21
NorthEast Un,1115,3,5,4,5,15,11,4,19
Kolkata,1115,4,4,7,3,16,13,3,19
FC Pune City,1115,5,5,4,5,14,15,-1,19
Chennaiyin,1115,6,4,6,4,15,18,-3,18
Kerala Blast,1115,7,4,5,5,11,18,-7,17
FC Goa,1115,8,3,3,8,8,16,-8,12
Delhi Dynamo,1116,1,6,6,2,28,17,11,24
Mumbai City,1116,2,6,4,4,18,13,5,22
FC Pune City,1116,3,5,4,5,16,16,0,19
Kerala Blast,1116,4,5,4,5,16,19,-3,19
Kolkata,1116,5,3,8,3,18,20,-2,17
Chennaiyin,1116,6,4,5,5,16,20,-4,17
NorthEast Un,1116,7,4,4,6,11,12,-1,16
FC Goa,1116,8,4,3,7,11,17,-6,15
Mumbai City,1117,1,6,5,3,16,8,8,23
Kerala Blast,1117,2,5,5,4,13,16,-3,20
Delhi Dynamo,1117,3,4,7,3,21,15,6,19
NorthEast Un,1117,4,5,4,5,14,12,2,19
Kolkata,1117,5,3,8,3,15,16,-1,17
FC Goa,1117,6,5,2,7,11,15,-4,17
Chennaiyin,1117,7,4,5,5,15,20,-5,17
FC Pune City,1117,8,4,4,6,13,16,-3,16
Delhi Dynamo,1118,1,7,5,2,30,17,13,26
Mumbai City,1118,2,6,4,4,18,13,5,22
FC Pune City,1118,3,6,3,5,14,14,0,21
NorthEast Un,1118,4,6,2,6,14,14,0,20
Kolkata,1118,5,4,7,3,16,14,2,19
Chennaiyin,1118,6,4,5,5,18,21,-3,17
Kerala Blast,1118,7,4,4,6,11,17,-6,16
FC Goa,1118,8,3,2,9,10,21,-11,11
Delhi Dynamo,1119,1,6,6,2,25,16,9,24
Mumbai City,1119,2,6,4,4,16,9,7,22
Kolkata,1119,3,4,8,2,17,12,5,20
NorthEast Un,1119,4,5,4,5,12,11,1,19
FC Pune City,1119,5,5,3,6,14,19,-5,18
Chennaiyin,1119,6,4,5,5,15,19,-4,17
Kerala Blast,1119,7,4,5,5,11,16,-5,17
FC Goa,1119,8,3,3,8,10,18,-8,12
Delhi Dynamo,1120,1,6,5,3,27,20,7,23
Mumbai City,1120,2,6,4,4,18,11,7,22
NorthEast Un,1120,3,6,3,5,16,11,5,21
Kolkata,1120,4,5,6,3,17,15,2,21
FC Pune City,1120,5,5,4,5,15,15,0,19
Chennaiyin,1120,6,4,5,5,15,21,-6,17
Kerala Blast,1120,7,4,5,5,11,17,-6,17
FC Goa,1120,8,3,2,9,11,20,-9,11
Mumbai City,1121,1,7,4,3,19,8,11,25
Delhi Dynamo,1121,2,5,6,3,23,17,6,21
Kerala Blast,1121,3,6,3,5,12,15,-3,21
Kolkata,1121,4,4,6,4,18,18,0,18
FC Pune City,1121,5,5,3,6,16,18,-2,18
NorthEast Un,1121,6,5,2,7,11,13,-2,17
FC Goa,1121,7,4,4,6,9,14,-5,16
Chennaiyin,1121,8,3,6,5,14,19,-5,15
Mumbai City,1122,1,7,4,3,19,8,11,25
Kerala Blast,1122,2,6,3,5,11,15,-4,21
Delhi Dynamo,1122,3,5,5,4,27,19,8,20
NorthEast Un,1122,4,6,2,6,14,13,1,20
FC Pune City,1122,5,5,3,6,14,16,-2,18
Chennaiyin,1122,6,4,5,5,16,19,-3,17
FC Goa,1122,7,5,2,7,10,19,-9,17
Kolkata,1122,8,3,6,5,14,16,-2,15
Mumbai City,1123,1,6,5,3,16,8,8,23
Delhi Dynamo,1123,2,4,8,2,23,16,7,20
Kerala Blast,1123,3,5,5,4,12,15,-3,20
Kolkata,1123,4,4,7,3,16,15,1,19
Chennaiyin,1123,5,4,6,4,17,18,-1,18
FC Pune City,1123,6,4,5,5,13,15,-2,17
NorthEast Un,1123,7,4,4,6,11,14,-3,16
FC Goa,1123,8,3,4,7,10,17,-7,13
Mumbai City,1124,1,7,4,3,19,8,11,25
Kerala Blast,1124,2,6,3,5,13,14,-1,21
NorthEast Un,1124,3,6,2,6,13,12,1,20
FC Pune City,1124,4,5,4,5,14,15,-1,19
Delhi Dynamo,1124,5,4,6,4,22,19,3,18
Chennaiyin,1124,6,4,5,5,15,21,-6,17
Kolkata,1124,7,3,7,4,15,17,-2,16
FC Goa,1124,8,4,3,7,13,18,-5,15
Mumbai City,1125,1,6,5,3,16,8,8,23
Kerala Blast,1125,2,6,3,5,12,15,-3,21
Delhi Dynamo,1125,3,4,8,2,22,15,7,20
Kolkata,1125,4,4,7,3,16,14,2,19
NorthEast Un,1125,5,5,3,6,12,13,-1,18
FC Pune City,1125,6,5,3,6,13,15,-2,18
Chennaiyin,1125,7,4,5,5,17,19,-2,17
FC Goa,1125,8,3,4,7,9,18,-9,13
Delhi Dynamo,1126,1,6,6,2,26,15,11,24
Mumbai City,1126,2,6,5,3,17,9,8,23
Kerala Blast,1126,3,6,3,5,15,17,-2,21
Kolkata,1126,4,4,8,2,18,13,5,20
Chennaiyin,1126,5,4,6,4,15,18,-3,18
FC Pune City,1126,6,4,4,6,13,17,-4,16
NorthEast Un,1126,7,4,2,8,9,15,-6,14
FC Goa,1126,8,3,4,7,9,18,-9,13
Mumbai City,1127,1,7,4,3,18,8,10,25
Delhi Dynamo,1127,2,6,5,3,27,17,10,23
Kerala Blast,1127,3,6,3,5,11,15,-4,21
Kolkata,1127,4,4,6,4,15,16,-1,18
FC Pune City,1127,5,5,3,6,13,15,-2,18
Chennaiyin,1127,6,4,5,5,14,18,-4,17
NorthEast Un,1127,7,5,2,7,10,14,-4,17
FC Goa,1127,8,4,2,8,12,17,-5,14
NorthEast Un,1128,1,7,2,5,15,12,3,23
Mumbai City,1128,2,6,4,4,16,9,7,22
Kolkata,1128,3,5,6,3,21,16,5,21
FC Pune City,1128,4,6,3,5,16,16,0,21
Delhi Dynamo,1128,5,5,5,4,23,17,6,20
Chennaiyin,1128,6,4,5,5,19,22,-3,17
Kerala Blast,1128,7,4,3,7,12,19,-7,15
FC Goa,1128,8,4,2,8,11,22,-11,14
Delhi Dynamo,1129,1,5,7,2,24,16,8,22
Mumbai City,1129,2,6,4,4,17,10,7,22
Kolkata,1129,3,4,8,2,19,14,5,20
Kerala Blast,1129,4,5,5,4,11,14,-3,20
NorthEast Un,1129,5,5,3,6,12,11,1,18
FC Goa,1129,6,4,4,6,10,15,-5,16
FC Pune City,1129,7,4,4,6,14,20,-6,16
Chennaiyin,1129,8,3,5,6,13,20,-7,14
Kerala Blast,1130,1,7,3,4,16,13,3,24
Delhi Dynamo,1130,2,6,5,3,28,21,7,23
Mumbai City,1130,3,6,4,4,18,11,7,22
FC Goa,1130,4,6,2,6,17,16,1,20
Kolkata,1130,5,4,6,4,15,16,-1,18
NorthEast Un,1130,6,4,3,7,11,15,-4,15
FC Pune City,1130,7,4,3,7,12,18,-6,15
Chennaiyin,1130,8,3,6,5,14,21,-7,15
Kolkata,1131,1,6,6,2,17,12,5,24
Mumbai City,1131,2,6,5,3,19,11,8,23
Kerala Blast,1131,3,6,3,5,13,14,-1,21
NorthEast Un,1131,4,6,2,6,13,12,1,20
Delhi Dynamo,1131,5,4,6,4,25,21,4,18
FC Goa,1131,6,5,2,7,12,16,-4,17
FC Pune City,1131,7,4,3,7,12,18,-6,15
Chennaiyin,1131,8,3,5,6,14,21,-7,14
Mumbai City,1132,1,7,4,3,18,9,9,25
Delhi Dynamo,1132,2,6,5,3,28,17,11,23
NorthEast Un,1132,3,6,2,6,13,12,1,20
Kolkata,1132,4,4,7,3,15,14,1,19
Kerala Blast,1132,5,5,4,5,11,16,-5,19
FC Goa,1132,6,5,2,7,10,17,-7,17
FC Pune City,1132,7,4,3,7,12,16,-4,15
Chennaiyin,1132,8,3,5,6,13,19,-6,14
Mumbai City,1133,1,7,4,3,18,9,9,25
Kolkata,1133,2,6,6,2,21,14,7,24
Delhi Dynamo,1133,3,6,5,3,26,17,9,23
Kerala Blast,1133,4,5,4,5,10,15,-5,19
Chennaiyin,1133,5,4,6,4,16,19,-3,18
FC Pune City,1133,6,4,4,6,13,16,-3,16
NorthEast Un,1133,7,4,3,7,11,13,-2,15
FC Goa,1133,8,3,2,9,10,22,-12,11
Mumbai City,1134,1,7,4,3,18,9,9,25
Delhi Dynamo,1134,2,5,5,4,24,18,6,20
Kolkata,1134,3,4,8,2,18,15,3,20
NorthEast Un,1134,4,6,2,6,12,11,1,20
Chennaiyin,1134,5,4,5,5,15,20,-5,17
Kerala Blast,1134,6,4,5,5,12,17,-5,17
FC Pune City,1134,7,4,4,6,14,18,-4,16
FC Goa,1134,8,4,3,7,13,18,-5,15
Mumbai City,1135,1,7,4,3,18,8,10,25
FC Pune City,1135,2,6,3,5,17,14,3,21
Delhi Dynamo,1135,3,5,5,4,25,18,7,20
Kolkata,1135,4,4,7,3,15,16,-1,19
NorthEast Un,1135,5,5,3,6,15,15,0,18
Chennaiyin,1135,6,4,5,5,17,21,-4,17
Kerala Blast,1135,7,4,4,6,10,17,-7,16
FC Goa,1135,8,4,3,7,9,17,-8,15
Kolkata,1136,1,6,6,2,20,15,5,24
Mumbai City,1136,2,6,5,3,18,10,8,23
Delhi Dynamo,1136,3,5,7,2,26,17,9,22
Chennaiyin,1136,4,5,5,4,17,17,0,20
Kerala Blast,1136,5,4,5,5,11,17,-6,17
NorthEast Un,1136,6,4,4,6,10,11,-1,16
FC Pune City,1136,7,4,4,6,14,17,-3,16
FC Goa,1136,8,3,2,9,9,21,-12,11
Mumbai City,1137,1,7,4,3,18,9,9,25
Kolkata,1137,2,5,7,2,18,15,3,22
Delhi Dynamo,1137,3,5,5,4,25,20,5,20
NorthEast Un,1137,4,6,2,6,15,14,1,20
Chennaiyin,1137,5,4,6,4,15,17,-2,18
FC Pune City,1137,5,5,3,6,15,17,-2,18
Kerala Blast,1137,7,4,4,6,12,18,-6,16
FC Goa,1137,8,3,3,8,9,17,-8,12
Kolkata,1138,1,6,6,2,22,12,10,24
Mumbai City,1138,2,6,5,3,19,11,8,23
Delhi Dynamo,1138,3,4,7,3,25,19,6,19
Kerala Blast,1138,4,5,4,5,14,19,-5,19
NorthEast Un,1138,5,5,3,6,13,14,-1,18
Chennaiyin,1138,6,3,7,4,16,20,-4,16
FC Pune City,1138,7,4,4,6,14,18,-4,16
FC Goa,1138,8,3,4,7,10,20,-10,13
Mumbai City,1139,1,7,4,3,17,8,9,25
Delhi Dynamo,1139,2,6,5,3,25,15,10,23
Chennaiyin,1139,3,5,5,4,18,17,1,20
Kerala Blast,1139,4,5,5,4,13,16,-3,20
Kolkata,1139,5,3,8,3,14,14,0,17
FC Pune City,1139,6,4,4,6,15,18,-3,16
NorthEast Un,1139,7,4,3,7,10,14,-4,15
FC Goa,1139,8,4,2,8,9,19,-10,14
Mumbai City,1140,1,7,4,3,18,8,10,25
Delhi Dynamo,1140,2,6,5,3,25,17,8,23
FC Pune City,1140,3,6,3,5,17,15,2,21
Kolkata,1140,4,4,6,4,16,15,1,18
Chennaiyin,1140,5,4,6,4,15,18,-3,18
Kerala Blast,1140,6,5,3,6,10,18,-8,18
NorthEast Un,1140,7,4,3,7,10,12,-2,15
FC Goa,1140,8,4,2,8,10,18,-8,14
Mumbai City,1141,1,7,4,3,18,9,9,25
Kolkata,1141,2,5,6,3,21,14,7,21
Delhi Dynamo,1141,3,5,5,4,24,19,5,20
NorthEast Un,1141,4,6,2,6,16,14,2,20
FC Pune City,1141,5,5,4,5,13,14,-1,19
Kerala Blast,1141,6,5,4,5,12,17,-5,19
Chennaiyin,1141,7,3,5,6,14,21,-7,14
FC Goa,1141,8,4,2,8,11,21,-10,14
Delhi Dynamo,1142,1,6,5,3,25,16,9,23
Mumbai City,1142,2,6,4,4,17,10,7,22
Kolkata,1142,3,5,7,2,17,13,4,22
NorthEast Un,1142,4,6,2,6,14,12,2,20
Kerala Blast,1142,5,5,4,5,13,17,-4,19
Chennaiyin,1142,6,4,5,5,17,22,-5,17
FC Pune City,1142,7,4,3,7,12,17,-5,15
FC Goa,1142,8,4,2,8,12,20,-8,14
Mumbai City,1143,1,7,4,3,18,9,9,25
FC Pune City,1143,2,6,3,5,15,15,0,21
NorthEast Un,1143,3,6,2,6,13,14,-1,20
Kolkata,1143,4,4,7,3,15,14,1,19
Delhi Dynamo,1143,5,4,6,4,23,18,5,18
Chennaiyin,1143,6,4,5,5,18,21,-3,17
FC Goa,1143,7,4,4,6,11,15,-4,16
Kerala Blast,1143,8,4,3,7,11,18,-7,15
Mumbai City,1144,1,7,4,3,19,9,10,25
Kerala Blast,1144,2,6,4,4,15,17,-2,22
Delhi Dynamo,1144,3,5,5,4,28,23,5,20
FC Pune City,1144,4,5,4,5,17,18,-1,19
FC Goa,1144,5,5,3,6,12,16,-4,18
NorthEast Un,1144,6,5,2,7,17,17,0,17
Kolkata,1144,7,3,6,5,15,17,-2,15
Chennaiyin,1144,8,3,6,5,14,20,-6,15
Mumbai City,1145,1,7,4,3,18,9,9,25
Delhi Dynamo,1145,2,5,5,4,24,18,6,20
Kolkata,1145,3,4,8,2,18,15,3,20
NorthEast Un,1145,4,6,2,6,15,12,3,20
Chennaiyin,1145,5,4,6,4,16,19,-3,18
FC Pune City,1145,6,4,5,5,15,17,-2,17
Kerala Blast,1145,7,4,4,6,12,21,-9,16
FC Goa,1145,8,3,4,7,12,19,-7,13
Mumbai City,1146,1,7,4,3,18,8,10,25
Kerala Blast,1146,2,5,5,4,14,17,-3,20
Kolkata,1146,3,4,7,3,19,16,3,19
Delhi Dynamo,1146,4,4,6,4,23,21,2,18
Chennaiyin,1146,5,4,6,4,17,20,-3,18
NorthEast Un,1146,6,4,5,5,14,14,0,17
FC Goa,1146,7,5,2,7,13,16,-3,17
FC Pune City,1146,8,4,3,7,12,18,-6,15
Mumbai City,1147,1,7,4,3,18,9,9,25
Delhi Dynamo,1147,2,6,5,3,31,17,14,23
Kolkata,1147,3,4,7,3,17,15,2,19
FC Pune City,1147,4,5,4,5,15,15,0,19
Chennaiyin,1147,5,4,6,4,15,18,-3,18
Kerala Blast,1147,6,4,4,6,9,18,-9,16
NorthEast Un,1147,7,4,3,7,10,15,-5,15
FC Goa,1147,8,4,3,7,11,19,-8,15
Delhi Dynamo,1148,1,6,5,3,25,17,8,23
Mumbai City,1148,2,6,4,4,16,9,7,22
Kolkata,1148,3,5,7,2,18,14,4,22
NorthEast Un,1148,4,6,3,5,13,10,3,21
Chennaiyin,1148,5,4,6,4,14,17,-3,18
Kerala Blast,1148,6,5,3,6,14,18,-4,18
FC Pune City,1148,7,4,3,7,14,20,-6,15
FC Goa,1148,8,3,3,8,9,18,-9,12
Mumbai City,1149,1,6,4,4,16,9,7,22
Delhi Dynamo,1149,2,5,6,3,24,18,6,21
Kerala Blast,1149,3,6,3,5,14,18,-4,21
Kolkata,1149,4,4,8,2,17,14,3,20
NorthEast Un,1149,5,5,3,6,14,13,1,18
Chennaiyin,1149,6,4,6,4,16,18,-2,18
FC Pune City,1149,7,4,4,6,14,17,-3,16
FC Goa,1149,8,3,4,7,11,19,-8,13
Delhi Dynamo,1150,1,6,6,2,26,17,9,24
Mumbai City,1150,2,6,4,4,17,10,7,22
Kerala Blast,1150,3,6,3,5,15,18,-3,21
NorthEast Un,1150,4,5,3,6,14,13,1,18
Kolkata,1150,5,4,6,4,16,17,-1,18
FC Pune City,1150,6,5,3,6,15,17,-2,18
Chennaiyin,1150,7,3,6,5,16,21,-5,15
FC Goa,1150,8,4,3,7,11,17,-6,15
Mumbai City,1151,1,7,4,3,18,9,9,25
Delhi Dynamo,1151,2,6,5,3,25,17,8,23
Kolkata,1151,3,5,7,2,18,13,5,22
Kerala Blast,1151,4,5,4,5,10,15,-5,19
NorthEast Un,1151,5,5,3,6,11,11,0,18
FC Pune City,1151,6,4,4,6,13,16,-3,16
Chennaiyin,1151,7,3,6,5,15,20,-5,15
FC Goa,1151,8,3,3,8,10,19,-9,12
Mumbai City,1152,1,7,4,3,19,9,10,25
Delhi Dynamo,1152,2,6,5,3,26,17,9,23
Kerala Blast,1152,3,6,4,4,15,17,-2,22
Kolkata,1152,4,4,7,3,17,16,1,19
Chennaiyin,1152,5,4,6,4,17,19,-2,18
FC Pune City,1152,6,4,5,5,14,16,-2,17
NorthEast Un,1152,7,4,2,8,11,16,-5,14
FC Goa,1152,8,3,3,8,9,18,-9,12
Delhi Dynamo,1153,1,6,6,2,28,16,12,24
Mumbai City,1153,2,6,5,3,17,9,8,23
Kerala Blast,1153,3,5,4,5,12,15,-3,19
FC Pune City,1153,4,5,3,6,16,18,-2,18
NorthEast Un,1153,5,5,2,7,12,14,-2,17
Chennaiyin,1153,6,4,5,5,17,22,-5,17
FC Goa,1153,7,5,2,7,15,20,-5,17
Kolkata,1153,8,3,7,4,17,20,-3,16
Mumbai City,1154,1,7,4,3,18,9,9,25
Delhi Dynamo,1154,2,5,5,4,25,19,6,20
Chennaiyin,1154,3,5,5,4,18,17,1,20
FC Pune City,1154,4,5,4,5,15,15,0,19
Kerala Blast,1154,5,5,4,5,13,17,-4,19
Kolkata,1154,6,3,9,2,16,15,1,18
NorthEast Un,1154,7,5,2,7,12,15,-3,17
FC Goa,1154,8,3,3,8,10,20,-10,12
Mumbai City,1155,1,7,4,3,17,8,9,25
Delhi Dynamo,1155,2,5,5,4,23,18,5,20
Kolkata,1155,3,4,7,3,17,16,1,19
NorthEast Un,1155,4,5,3,6,15,15,0,18
FC Pune City,1155,5,5,3,6,14,16,-2,18
Chennaiyin,1155,6,4,5,5,17,21,-4,17
FC Goa,1155,7,5,2,7,13,17,-4,17
Kerala Blast,1155,8,4,5,5,14,19,-5,17
Delhi Dynamo,1156,1,6,5,3,25,16,9,23
Mumbai City,1156,2,6,4,4,16,9,7,22
Kolkata,1156,3,5,7,2,19,15,4,22
Chennaiyin,1156,4,5,5,4,18,17,1,20
Kerala Blast,1156,5,5,4,5,12,16,-4,19
FC Pune City,1156,6,4,5,5,15,17,-2,17
FC Goa,1156,7,4,2,8,10,17,-7,14
NorthEast Un,1156,8,4,2,8,10,18,-8,14
Mumbai City,1157,1,7,4,3,19,9,10,25
FC Pune City,1157,2,6,3,5,14,14,0,21
Delhi Dynamo,1157,3,5,5,4,24,20,4,20
FC Goa,1157,4,5,3,6,13,15,-2,18
Kolkata,1157,5,3,8,3,14,14,0,17
Chennaiyin,1157,6,4,5,5,18,19,-1,17
Kerala Blast,1157,7,4,5,5,12,17,-5,17
NorthEast Un,1157,8,4,3,7,11,17,-6,15
Mumbai City,1158,1,7,4,3,19,10,9,25
Delhi Dynamo,1158,2,6,5,3,28,20,8,23
Kolkata,1158,3,4,8,2,16,14,2,20
FC Pune City,1158,4,5,4,5,17,16,1,19
Chennaiyin,1158,5,4,6,4,18,19,-1,18
Kerala Blast,1158,6,5,3,6,11,18,-7,18
NorthEast Un,1158,7,4,2,8,12,17,-5,14
FC Goa,1158,8,3,4,7,11,18,-7,13
Delhi Dynamo,1159,1,6,6,2,28,16,12,24
Mumbai City,1159,2,6,4,4,17,10,7,22
Kolkata,1159,3,5,6,3,18,16,2,21
NorthEast Un,1159,4,5,4,5,11,10,1,19
FC Pune City,1159,5,5,3,6,16,16,0,18
Kerala Blast,1159,6,4,4,6,10,18,-8,16
Chennaiyin,1159,7,3,6,5,13,18,-5,15
FC Goa,1159,8,4,3,7,10,19,-9,15
Mumbai City,1160,1,6,5,3,18,10,8,23
Kolkata,1160,2,4,8,2,16,13,3,20
Delhi Dynamo,1160,3,4,7,3,25,20,5,19
NorthEast Un,1160,4,5,4,5,13,12,1,19
FC Pune City,1160,5,5,4,5,14,15,-1,19
Chennaiyin,1160,6,4,5,5,14,18,-4,17
Kerala Blast,1160,7,4,4,6,10,17,-7,16
FC Goa,1160,8,4,3,7,10,15,-5,15
Mumbai City,1161,1,6,5,3,17,9,8,23
Kerala Blast,1161,2,6,4,4,16,15,1,22
Delhi Dynamo,1161,3,4,8,2,23,16,7,20
Kolkata,1161,4,4,7,3,15,14,1,19
NorthEast Un,1161,5,4,5,5,11,11,0,17
Chennaiyin,1161,6,3,7,4,15,19,-4,16
FC Pune City,1161,7,4,3,7,13,20,-7,15
FC Goa,1161,8,3,5,6,10,16,-6,14
Mumbai City,1162,1,6,5,3,17,9,8,23
Delhi Dynamo,1162,2,5,6,3,23,16,7,21
NorthEast Un,1162,3,6,2,6,13,12,1,20
FC Pune City,1162,4,5,4,5,16,17,-1,19
Kerala Blast,1162,5,5,4,5,13,17,-4,19
Chennaiyin,1162,6,4,5,5,15,20,-5,17
Kolkata,1162,7,3,7,4,14,15,-1,16
FC Goa,1162,8,4,3,7,10,15,-5,15
Delhi Dynamo,1163,1,7,5,2,28,15,13,26
Kolkata,1163,2,6,6,2,20,13,7,24
Mumbai City,1163,3,6,4,4,17,12,5,22
Kerala Blast,1163,4,6,3,5,13,16,-3,21
NorthEast Un,1163,5,4,3,7,11,13,-2,15
FC Pune City,1163,6,4,3,7,13,19,-6,15
Chennaiyin,1163,7,3,6,5,14,21,-7,15
FC Goa,1163,8,4,2,8,11,18,-7,14
Mumbai City,1164,1,7,4,3,17,8,9,25
Kerala Blast,1164,2,7,3,4,15,14,1,24
Delhi Dynamo,1164,3,5,5,4,22,16,6,20
Kolkata,1164,4,4,7,3,15,14,1,19
FC Goa,1164,5,5,2,7,13,16,-3,17
FC Pune City,1164,6,4,4,6,13,17,-4,16
NorthEast Un,1164,7,4,3,7,10,13,-3,15
Chennaiyin,1164,8,3,6,5,14,21,-7,15
Delhi Dynamo,1165,1,7,5,2,28,15,13,26
Mumbai City,1165,2,6,4,4,16,9,7,22
Kerala Blast,1165,3,6,4,4,13,14,-1,22
Kolkata,1165,4,4,8,2,17,15,2,20
Chennaiyin,1165,5,4,5,5,16,20,-4,17
FC Pune City,1165,6,4,3,7,12,16,-4,15
FC Goa,1165,7,4,3,7,14,21,-7,15
NorthEast Un,1165,8,4,2,8,9,15,-6,14
Mumbai City,1166,1,7,4,3,17,8,9,25
Delhi Dynamo,1166,2,5,6,3,25,17,8,21
Kerala Blast,1166,3,5,5,4,13,15,-2,20
Kolkata,1166,4,3,9,2,19,18,1,18
Chennaiyin,1166,5,4,6,4,16,19,-3,18
NorthEast Un,1166,6,4,4,6,10,12,-2,16
FC Pune City,1166,7,4,4,6,14,18,-4,16
FC Goa,1166,8,3,4,7,13,20,-7,13
Mumbai City,1167,1,7,4,3,18,8,10,25
Kerala Blast,1167,2,6,4,4,15,14,1,22
Delhi Dynamo,1167,3,5,5,4,24,19,5,20
Kolkata,1167,4,4,7,3,14,14,0,19
NorthEast Un,1167,5,5,3,6,13,15,-2,18
FC Pune City,1167,6,4,4,6,13,16,-3,16
Chennaiyin,1167,7,3,7,4,16,20,-4,16
FC Goa,1167,8,3,4,7,10,17,-7,13
Mumbai City,1168,1,7,4,3,18,8,10,25
Delhi Dynamo,1168,2,6,5,3,24,17,7,23
Kolkata,1168,3,4,7,3,18,16,2,19
Kerala Blast,1168,4,5,4,5,11,15,-4,19
FC Pune City,1168,5,5,3,6,14,16,-2,18
Chennaiyin,1168,6,4,6,4,17,20,-3,18
NorthEast Un,1168,7,5,2,7,13,14,-1,17
FC Goa,1168,8,3,3,8,10,19,-9,12
Mumbai City,1169,1,7,4,3,18,9,9,25
FC Pune City,1169,2,6,3,5,17,15,2,21
Delhi Dynamo,1169,3,5,5,4,23,18,5,20
NorthEast Un,1169,4,6,2,6,14,12,2,20
Chennaiyin,1169,5,5,5,4,17,19,-2,20
Kolkata,1169,6,4,6,4,16,15,1,18
Kerala Blast,1169,7,5,3,6,11,18,-7,18
FC Goa,1169,8,3,2,9,9,19,-10,11
Mumbai City,1170,1,7,4,3,17,8,9,25
Delhi Dynamo,1170,2,6,5,3,27,18,9,23
Chennaiyin,1170,3,5,5,4,16,17,-1,20
Kolkata,1170,4,4,7,3,16,16,0,19
Kerala Blast,1170,5,5,4,5,12,15,-3,19
FC Pune City,1170,6,5,3,6,14,16,-2,18
NorthEast Un,1170,7,4,2,8,10,14,-4,14
FC Goa,1170,8,4,2,8,12,20,-8,14
Mumbai City,1171,1,7,4,3,18,9,9,25
Delhi Dynamo,1171,2,5,5,4,25,18,7,20
Kolkata,1171,3,3,9,2,19,18,1,18
NorthEast Un,1171,4,5,3,6,11,12,-1,18
Kerala Blast,1171,5,4,6,4,13,17,-4,18
FC Pune City,1171,6,4,5,5,18,20,-2,17
Chennaiyin,1171,7,4,5,5,15,21,-6,17
FC Goa,1171,8,4,3,7,14,18,-4,15
Delhi Dynamo,1172,1,6,6,2,26,16,10,24
Mumbai City,1172,2,6,5,3,18,10,8,23
Kolkata,1172,3,5,7,2,17,14,3,22
Kerala Blast,1172,4,5,4,5,14,18,-4,19
FC Pune City,1172,5,5,3,6,14,16,-2,18
NorthEast Un,1172,6,4,3,7,10,12,-2,15
Chennaiyin,1172,7,3,6,5,14,21,-7,15
FC Goa,1172,8,4,2,8,12,18,-6,14
Mumbai City,1173,1,7,4,3,18,9,9,25
Delhi Dynamo,1173,2,6,5,3,26,18,8,23
Kerala Blast,1173,3,6,3,5,14,15,-1,21
Chennaiyin,1173,4,5,5,4,17,18,-1,20
Kolkata,1173,5,4,7,3,17,16,1,19
FC Pune City,1173,6,5,4,5,13,14,-1,19
NorthEast Un,1173,7,4,2,8,10,15,-5,14
FC Goa,1173,8,3,2,9,12,22,-10,11
Delhi Dynamo,1174,1,7,5,2,30,15,15,26
Mumbai City,1174,2,6,4,4,16,11,5,22
Kolkata,1174,3,5,7,2,15,12,3,22
Chennaiyin,1174,4,5,5,4,20,19,1,20
Kerala Blast,1174,5,5,4,5,12,18,-6,19
FC Pune City,1174,6,5,3,6,15,15,0,18
NorthEast Un,1174,7,4,2,8,13,20,-7,14
FC Goa,1174,8,3,2,9,9,20,-11,11
Mumbai City,1175,1,7,4,3,18,9,9,25
Kolkata,1175,2,5,6,3,16,13,3,21
Delhi Dynamo,1175,3,5,5,4,25,17,8,20
NorthEast Un,1175,4,6,2,6,11,11,0,20
FC Pune City,1175,5,5,4,5,13,14,-1,19
Kerala Blast,1175,6,5,4,5,11,14,-3,19
Chennaiyin,1175,7,4,5,5,14,18,-4,17
FC Goa,1175,8,3,2,9,8,20,-12,11
Mumbai City,1176,1,6,5,3,16,8,8,23
Delhi Dynamo,1176,2,5,6,3,23,16,7,21
Kolkata,1176,3,5,6,3,17,14,3,21
Kerala Blast,1176,4,6,3,5,12,15,-3,21
Chennaiyin,1176,5,5,5,4,19,18,1,20
NorthEast Un,1176,6,6,2,6,13,14,-1,20
FC Pune City,1176,7,4,3,7,12,16,-4,15
FC Goa,1176,8,3,2,9,10,21,-11,11
Mumbai City,1177,1,7,4,3,19,9,10,25
Delhi Dynamo,1177,2,6,5,3,25,17,8,23
FC Pune City,1177,3,5,4,5,13,14,-1,19
NorthEast Un,1177,4,5,3,6,13,12,1,18
FC Goa,1177,5,5,2,7,14,16,-2,17
Kolkata,1177,6,3,8,3,13,15,-2,17
Kerala Blast,1177,7,4,4,6,9,17,-8,16
Chennaiyin,1177,8,3,6,5,15,21,-6,15
Mumbai City,1178,1,7,4,3,17,8,9,25
Delhi Dynamo,1178,2,5,6,3,25,17,8,21
Kerala Blast,1178,3,6,3,5,17,19,-2,21
Chennaiyin,1178,4,5,5,4,18,18,0,20
FC Pune City,1178,5,5,3,6,15,16,-1,18
Kolkata,1178,6,4,6,4,17,19,-2,18
FC Goa,1178,7,4,3,7,11,18,-7,15
NorthEast Un,1178,8,4,2,8,12,17,-5,14
Mumbai City,1179,1,7,4,3,18,9,9,25
Kerala Blast,1179,2,6,4,4,14,16,-2,22
Delhi Dynamo,1179,3,5,5,4,23,17,6,20
Kolkata,1179,4,4,7,3,16,15,1,19
FC Pune City,1179,5,4,5,5,15,17,-2,17
Chennaiyin,1179,6,4,5,5,17,20,-3,17
FC Goa,1179,7,5,2,7,10,15,-5,17
NorthEast Un,1179,8,4,2,8,11,15,-4,14
Delhi Dynamo,1180,1,6,6,2,28,18,10,24
Mumbai City,1180,2,6,4,4,18,12,6,22
Kolkata,1180,3,5,7,2,19,14,5,22
FC Pune City,1180,4,5,4,5,15,15,0,19
NorthEast Un,1180,5,5,3,6,15,14,1,18
Chennaiyin,1180,6,4,6,4,17,19,-2,18
Kerala Blast,1180,7,4,3,7,11,21,-10,15
FC Goa,1180,8,3,3,8,9,19,-10,12
Mumbai City,1181,1,7,4,3,18,9,9,25
FC Pune City,1181,2,6,3,5,16,15,1,21
Delhi Dynamo,1181,3,5,5,4,24,17,7,20
Kerala Blast,1181,4,5,4,5,10,15,-5,19
FC Goa,1181,5,5,3,6,12,15,-3,18
Chennaiyin,1181,6,4,5,5,15,19,-4,17
Kolkata,1181,7,3,7,4,15,16,-1,16
NorthEast Un,1181,8,4,3,7,9,13,-4,15
Mumbai City,1182,1,7,4,3,21,9,12,25
Delhi Dynamo,1182,2,5,6,3,24,19,5,21
Kerala Blast,1182,3,6,3,5,15,17,-2,21
Chennaiyin,1182,4,5,5,4,16,17,-1,20
Kolkata,1182,5,4,7,3,16,17,-1,19
FC Pune City,1182,6,4,4,6,15,18,-3,16
NorthEast Un,1182,7,4,3,7,9,12,-3,15
FC Goa,1182,8,4,2,8,11,18,-7,14
Mumbai City,1183,1,7,4,3,18,8,10,25
Kerala Blast,1183,2,6,4,4,15,15,0,22
Delhi Dynamo,1183,3,5,5,4,24,20,4,20
Kolkata,1183,4,4,8,2,15,13,2,20
Chennaiyin,1183,5,4,6,4,16,19,-3,18
NorthEast Un,1183,6,5,2,7,14,14,0,17
FC Pune City,1183,7,4,4,6,12,17,-5,16
FC Goa,1183,8,3,3,8,10,18,-8,12
Mumbai City,1184,1,7,4,3,19,10,9,25
Delhi Dynamo,1184,2,6,5,3,26,18,8,23
Kolkata,1184,3,5,7,2,19,15,4,22
FC Pune City,1184,4,5,3,6,15,18,-3,18
Kerala Blast,1184,5,5,3,6,13,18,-5,18
NorthEast Un,1184,6,5,2,7,11,11,0,17
Chennaiyin,1184,7,3,6,5,13,19,-6,15
FC Goa,1184,8,3,4,7,9,16,-7,13
Mumbai City,1185,1,6,5,3,17,9,8,23
Chennaiyin,1185,2,5,5,4,17,17,0,20
Kolkata,1185,3,4,7,3,17,15,2,19
Kerala Blast,1185,4,5,4,5,12,15,-3,19
Delhi Dynamo,1185,5,4,6,4,25,21,4,18
FC Pune City,1185,6,5,3,6,14,19,-5,18
FC Goa,1185,7,5,2,7,14,17,-3,17
NorthEast Un,1185,8,5,2,7,12,15,-3,17
Mumbai City,1186,1,6,4,4,16,11,5,22
Kolkata,1186,2,5,6,3,18,16,2,21
Kerala Blast,1186,3,6,3,5,12,14,-2,21
Delhi Dynamo,1186,4,5,5,4,27,20,7,20
FC Pune City,1186,5,5,3,6,13,16,-3,18
Chennaiyin,1186,6,4,5,5,18,20,-2,17
NorthEast Un,1186,7,5,2,7,11,14,-3,17
FC Goa,1186,8,5,2,7,18,22,-4,17
Delhi Dynamo,1187,1,6,6,2,27,17,10,24
Mumbai City,1187,2,6,4,4,17,10,7,22
Kerala Blast,1187,3,6,4,4,17,16,1,22
FC Pune City,1187,4,5,4,5,17,17,0,19
Chennaiyin,1187,5,4,6,4,14,17,-3,18
FC Goa,1187,6,4,4,6,11,16,-5,16
Kolkata,1187,7,3,6,5,17,22,-5,15
NorthEast Un,1187,8,4,2,8,11,16,-5,14
Mumbai City,1188,1,6,5,3,17,9,8,23
Delhi Dynamo,1188,2,5,6,3,24,17,7,21
FC Pune City,1188,3,5,4,5,16,16,0,19
Kerala Blast,1188,4,5,4,5,12,17,-5,19
Kolkata,1188,5,3,9,2,15,14,1,18
NorthEast Un,1188,6,5,2,7,11,11,0,17
Chennaiyin,1188,7,4,5,5,15,20,-5,17
FC Goa,1188,8,4,3,7,11,17,-6,15
Kolkata,1189,1,6,6,2,17,12,5,24
Delhi Dynamo,1189,2,6,5,3,28,19,9,23
Mumbai City,1189,3,6,4,4,17,11,6,22
NorthEast Un,1189,4,5,3,6,13,11,2,18
Kerala Blast,1189,5,5,3,6,11,18,-7,18
FC Goa,1189,6,5,2,7,15,19,-4,17
FC Pune City,1189,7,4,3,7,12,16,-4,15
Chennaiyin,1189,8,3,6,5,13,20,-7,15
Delhi Dynamo,1190,1,6,5,3,27,18,9,23
Mumbai City,1190,2,6,4,4,17,11,6,22
Kerala Blast,1190,3,6,4,4,12,13,-1,22
Chennaiyin,1190,4,5,5,4,21,22,-1,20
FC Pune City,1190,5,5,4,5,14,14,0,19
NorthEast Un,1190,6,5,2,7,12,14,-2,17
Kolkata,1190,7,3,6,5,14,19,-5,15
FC Goa,1190,8,4,2,8,17,23,-6,14
Mumbai City,1191,1,6,5,3,16,8,8,23
Delhi Dynamo,1191,2,5,6,3,23,16,7,21
NorthEast Un,1191,3,6,3,5,12,10,2,21
Kerala Blast,1191,4,5,5,4,13,15,-2,20
Kolkata,1191,5,3,9,2,15,14,1,18
FC Pune City,1191,6,4,4,6,12,16,-4,16
FC Goa,1191,7,4,3,7,13,16,-3,15
Chennaiyin,1191,8,3,5,6,14,23,-9,14
Mumbai City,1192,1,6,5,3,17,9,8,23
Kerala Blast,1192,2,6,4,4,15,16,-1,22
Delhi Dynamo,1192,3,5,6,3,26,18,8,21
NorthEast Un,1192,4,5,4,5,12,10,2,19
FC Pune City,1192,5,5,3,6,16,18,-2,18
Chennaiyin,1192,6,3,7,4,14,18,-4,16
Kolkata,1192,7,3,6,5,15,18,-3,15
FC Goa,1192,8,4,3,7,10,18,-8,15
Mumbai City,1193,1,7,4,3,18,8,10,25
Kerala Blast,1193,2,7,3,4,15,16,-1,24
Delhi Dynamo,1193,3,5,5,4,23,18,5,20
FC Pune City,1193,4,5,3,6,15,16,-1,18
NorthEast Un,1193,5,5,2,7,11,12,-1,17
Chennaiyin,1193,6,4,5,5,16,20,-4,17
FC Goa,1193,7,5,2,7,13,18,-5,17
Kolkata,1193,8,3,6,5,16,19,-3,15
Mumbai City,1194,1,7,4,3,17,8,9,25
Kerala Blast,1194,2,6,4,4,15,15,0,22
Kolkata,1194,3,4,7,3,15,14,1,19
Delhi Dynamo,1194,4,4,6,4,24,20,4,18
FC Pune City,1194,5,5,3,6,14,16,-2,18
NorthEast Un,1194,6,5,2,7,14,16,-2,17
Chennaiyin,1194,7,4,5,5,17,21,-4,17
FC Goa,1194,8,4,3,7,12,18,-6,15
Mumbai City,1195,1,7,4,3,19,9,10,25
NorthEast Un,1195,2,7,2,5,14,10,4,23
Delhi Dynamo,1195,3,5,5,4,26,20,6,20
FC Pune City,1195,4,5,4,5,13,14,-1,19
Kerala Blast,1195,5,4,5,5,11,16,-5,17
Kolkata,1195,6,3,7,4,15,19,-4,16
FC Goa,1195,7,4,3,7,15,19,-4,15
Chennaiyin,1195,8,3,6,5,15,21,-6,15
Delhi Dynamo,1196,1,6,5,3,24,16,8,23
Mumbai City,1196,2,6,4,4,17,10,7,22
FC Pune City,1196,3,6,3,5,17,17,0,21
NorthEast Un,1196,4,6,2,6,13,11,2,20
Kerala Blast,1196,5,5,4,5,14,18,-4,19
Kolkata,1196,6,3,8,3,18,18,0,17
Chennaiyin,1196,7,3,6,5,14,20,-6,15
FC Goa,1196,8,3,4,7,10,17,-7,13
Mumbai City,1197,1,7,4,3,19,10,9,25
FC Pune City,1197,2,6,3,5,17,16,1,21
NorthEast Un,1197,3,6,2,6,14,12,2,20
Kolkata,1197,4,4,7,3,18,18,0,19
Delhi Dynamo,1197,5,4,6,4,26,21,5,18
Chennaiyin,1197,6,4,5,5,15,19,-4,17
Kerala Blast,1197,7,4,4,6,12,20,-8,16
FC Goa,1197,8,4,3,7,13,18,-5,15
Mumbai City,1198,1,7,4,3,17,8,9,25
Kerala Blast,1198,2,7,3,4,16,17,-1,24
Delhi Dynamo,1198,3,5,5,4,22,16,6,20
Kolkata,1198,4,3,8,3,15,15,0,17
NorthEast Un,1198,5,5,2,7,11,12,-1,17
FC Pune City,1198,6,4,4,6,15,18,-3,16
FC Goa,1198,7,4,4,6,10,15,-5,16
Chennaiyin,1198,8,3,6,5,14,19,-5,15
Delhi Dynamo,1199,1,5,7,2,26,18,8,22
Mumbai City,1199,2,6,4,4,17,10,7,22
Kolkata,1199,3,5,6,3,20,17,3,21
FC Goa,1199,4,5,3,6,14,17,-3,18
NorthEast Un,1199,5,4,5,5,13,13,0,17
Kerala Blast,1199,6,4,5,5,11,17,-6,17
FC Pune City,1199,7,4,4,6,14,18,-4,16
Chennaiyin,1199,8,3,6,5,14,19,-5,15
Mumbai City,1200,1,7,4,3,19,9,10,25
Kolkata,1200,2,6,6,2,20,15,5,24
Delhi Dynamo,1200,3,5,5,4,24,19,5,20
Kerala Blast,1200,4,5,4,5,13,17,-4,19
FC Goa,1200,5,5,2,7,11,15,-4,17
Chennaiyin,1200,6,4,5,5,15,20,-5,17
FC Pune City,1200,7,4,4,6,13,17,-4,16
NorthEast Un,1200,8,4,2,8,12,15,-3,14
Mumbai City,1201,1,7,4,3,19,10,9,25
Delhi Dynamo,1201,2,5,6,3,25,18,7,21
Chennaiyin,1201,3,5,5,4,17,18,-1,20
Kolkata,1201,4,4,7,3,17,17,0,19
NorthEast Un,1201,5,5,2,7,10,11,-1,17
Kerala Blast,1201,6,4,5,5,12,17,-5,17
FC Pune City,1201,7,4,4,6,14,18,-4,16
FC Goa,1201,8,4,3,7,14,19,-5,15
Mumbai City,1202,1,7,4,3,21,9,12,25
Kolkata,1202,2,5,6,3,18,15,3,21
Delhi Dynamo,1202,3,5,5,4,25,20,5,20
NorthEast Un,1202,4,6,2,6,11,11,0,20
Chennaiyin,1202,5,4,6,4,15,17,-2,18
Kerala Blast,1202,6,5,3,6,13,17,-4,18
FC Pune City,1202,7,4,3,7,13,20,-7,15
FC Goa,1202,8,4,3,7,10,17,-7,15
Mumbai City,1203,1,7,4,3,19,8,11,25
Kerala Blast,1203,2,6,4,4,13,15,-2,22
Delhi Dynamo,1203,3,5,6,3,24,19,5,21
FC Pune City,1203,4,5,4,5,16,16,0,19
Chennaiyin,1203,5,4,6,4,14,17,-3,18
NorthEast Un,1203,6,4,3,7,10,12,-2,15
Kolkata,1203,7,3,6,5,14,17,-3,15
FC Goa,1203,8,4,3,7,11,17,-6,15
Mumbai City,1204,1,7,4,3,19,9,10,25
NorthEast Un,1204,2,7,2,5,15,10,5,23
Delhi Dynamo,1204,3,5,5,4,25,21,4,20
Kolkata,1204,4,4,8,2,16,14,2,20
FC Pune City,1204,5,5,4,5,15,14,1,19
Chennaiyin,1204,6,4,5,5,15,19,-4,17
Kerala Blast,1204,7,4,4,6,10,18,-8,16
FC Goa,1204,8,3,2,9,10,20,-10,11
Mumbai City,1205,1,7,4,3,18,9,9,25
Kolkata,1205,2,5,6,3,16,15,1,21
Delhi Dynamo,1205,3,5,5,4,27,18,9,20
NorthEast Un,1205,4,5,4,5,11,9,2,19
Kerala Blast,1205,5,5,4,5,11,14,-3,19
FC Pune City,1205,6,5,3,6,15,16,-1,18
Chennaiyin,1205,7,3,6,5,13,21,-8,15
FC Goa,1205,8,4,2,8,12,21,-9,14
Mumbai City,1206,1,7,4,3,21,8,13,25
Kolkata,1206,2,5,7,2,18,15,3,22
Delhi Dynamo,1206,3,5,6,3,26,20,6,21
Chennaiyin,1206,4,5,5,4,17,19,-2,20
Kerala Blast,1206,5,5,4,5,12,16,-4,19
FC Pune City,1206,6,4,5,5,14,16,-2,17
NorthEast Un,1206,7,4,3,7,11,13,-2,15
FC Goa,1206,8,3,2,9,10,22,-12,11
Mumbai City,1207,1,6,5,3,17,9,8,23
NorthEast Un,1207,2,6,3,5,14,11,3,21
Kerala Blast,1207,3,6,3,5,12,15,-3,21
Delhi Dynamo,1207,4,4,7,3,24,19,5,19
Kolkata,1207,5,4,7,3,18,15,3,19
FC Goa,1207,6,4,4,6,13,17,-4,16
Chennaiyin,1207,7,3,6,5,15,20,-5,15
FC Pune City,1207,8,4,3,7,13,20,-7,15
Delhi Dynamo,1208,1,6,5,3,26,18,8,23
NorthEast Un,1208,2,7,2,5,14,10,4,23
Mumbai City,1208,3,6,4,4,18,11,7,22
Kolkata,1208,4,5,6,3,18,15,3,21
Kerala Blast,1208,5,5,3,6,10,16,-6,18
FC Pune City,1208,6,4,3,7,13,17,-4,15
Chennaiyin,1208,7,3,6,5,15,20,-5,15
FC Goa,1208,8,4,3,7,11,18,-7,15
Kolkata,1209,1,6,6,2,19,12,7,24
Mumbai City,1209,2,6,5,3,16,8,8,23
Delhi Dynamo,1209,3,5,7,2,23,15,8,22
Chennaiyin,1209,4,4,6,4,17,19,-2,18
Kerala Blast,1209,5,5,3,6,11,17,-6,18
NorthEast Un,1209,6,5,2,7,10,12,-2,17
FC Pune City,1209,7,4,3,7,13,19,-6,15
FC Goa,1209,8,3,4,7,11,18,-7,13
Mumbai City,1210,1,6,4,4,17,12,5,22
Delhi Dynamo,1210,2,5,6,3,28,20,8,21
Kolkata,1210,3,5,6,3,19,15,4,21
NorthEast Un,1210,4,6,2,6,17,15,2,20
FC Pune City,1210,5,5,3,6,15,17,-2,18
Kerala Blast,1210,6,5,3,6,15,19,-4,18
Chennaiyin,1210,7,4,5,5,15,22,-7,17
FC Goa,1210,8,4,3,7,13,19,-6,15
Mumbai City,1211,1,6,5,3,16,8,8,23
Kolkata,1211,2,4,8,2,16,14,2,20
Chennaiyin,1211,3,5,5,4,17,17,0,20
NorthEast Un,1211,4,6,2,6,15,15,0,20
Delhi Dynamo,1211,5,4,7,3,24,19,5,19
FC Pune City,1211,6,4,5,5,14,16,-2,17
Kerala Blast,1211,7,4,4,6,13,19,-6,16
FC Goa,1211,8,3,4,7,12,19,-7,13
Mumbai City,1212,1,7,4,3,21,8,13,25
NorthEast Un,1212,2,7,2,5,16,10,6,23
FC Pune City,1212,3,5,4,5,15,16,-1,19
Delhi Dynamo,1212,4,4,6,4,23,22,1,18
Kolkata,1212,5,3,8,3,16,16,0,17
Chennaiyin,1212,6,4,5,5,16,23,-7,17
Kerala Blast,1212,7,4,4,6,11,17,-6,16
FC Goa,1212,8,4,3,7,13,19,-6,15
Delhi Dynamo,1213,1,6,6,2,29,15,14,24
Mumbai City,1213,2,6,5,3,17,9,8,23
Kerala Blast,1213,3,5,5,4,14,17,-3,20
Kolkata,1213,4,4,7,3,16,15,1,19
FC Pune City,1213,5,5,3,6,17,18,-1,18
NorthEast Un,1213,6,5,3,6,14,16,-2,18
Chennaiyin,1213,7,3,6,5,15,21,-6,15
FC Goa,1213,8,3,3,8,9,20,-11,12
Delhi Dynamo,1214,1,5,7,2,24,15,9,22
Mumbai City,1214,2,6,4,4,16,10,6,22
FC Pune City,1214,3,5,4,5,17,14,3,19
NorthEast Un,1214,4,5,4,5,13,10,3,19
Kerala Blast,1214,5,5,3,6,12,23,-11,18
Kolkata,1214,6,3,7,4,15,17,-2,16
Chennaiyin,1214,7,3,7,4,15,19,-4,16
FC Goa,1214,8,4,4,6,12,16,-4,16
Mumbai City,1215,1,7,4,3,17,8,9,25
Kerala Blast,1215,2,7,3,4,14,13,1,24
Delhi Dynamo,1215,3,6,5,3,27,16,11,23
Kolkata,1215,4,5,6,3,15,13,2,21
NorthEast Un,1215,5,5,2,7,11,13,-2,17
Chennaiyin,1215,6,3,6,5,14,19,-5,15
FC Pune City,1215,7,4,3,7,12,18,-6,15
FC Goa,1215,8,3,3,8,9,19,-10,12
Delhi Dynamo,1216,1,6,5,3,28,18,10,23
Mumbai City,1216,2,6,4,4,17,11,6,22
Kerala Blast,1216,3,6,4,4,16,16,0,22
Kolkata,1216,4,4,6,4,16,16,0,18
Chennaiyin,1216,5,4,6,4,15,17,-2,18
FC Goa,1216,6,5,3,6,12,16,-4,18
NorthEast Un,1216,7,4,3,7,10,14,-4,15
FC Pune City,1216,8,4,3,7,13,19,-6,15
Delhi Dynamo,1217,1,7,5,2,26,16,10,26
Mumbai City,1217,2,6,4,4,17,10,7,22
Kerala Blast,1217,3,6,4,4,14,13,1,22
Chennaiyin,1217,4,5,5,4,15,17,-2,20
FC Pune City,1217,5,4,4,6,12,15,-3,16
Kolkata,1217,6,3,7,4,13,17,-4,16
NorthEast Un,1217,7,4,3,7,9,11,-2,15
FC Goa,1217,8,4,2,8,10,17,-7,14
Delhi Dynamo,1218,1,5,7,2,26,17,9,22
Mumbai City,1218,2,6,4,4,17,11,6,22
Kerala Blast,1218,3,6,3,5,13,15,-2,21
Kolkata,1218,4,4,7,3,15,14,1,19
NorthEast Un,1218,5,5,3,6,14,14,0,18
Chennaiyin,1218,6,4,5,5,16,20,-4,17
FC Goa,1218,7,4,4,6,11,16,-5,16
FC Pune City,1218,8,4,3,7,12,17,-5,15
Delhi Dynamo,1219,1,6,6,2,32,18,14,24
Mumbai City,1219,2,6,4,4,17,11,6,22
Kolkata,1219,3,4,8,2,17,15,2,20
Chennaiyin,1219,4,5,5,4,16,18,-2,20
Kerala Blast,1219,5,4,6,4,11,15,-4,18
NorthEast Un,1219,6,4,4,6,12,13,-1,16
FC Pune City,1219,7,4,4,6,12,15,-3,16
FC Goa,1219,8,3,3,8,12,24,-12,12
Mumbai City,1220,1,7,4,3,19,10,9,25
Delhi Dynamo,1220,2,6,5,3,27,19,8,23
Kerala Blast,1220,3,5,5,4,12,15,-3,20
FC Pune City,1220,4,5,3,6,13,15,-2,18
Kolkata,1220,5,3,8,3,17,17,0,17
Chennaiyin,1220,6,4,5,5,15,19,-4,17
NorthEast Un,1220,7,4,3,7,12,14,-2,15
FC Goa,1220,8,4,3,7,13,19,-6,15
Mumbai City,1221,1,7,4,3,19,9,10,25
NorthEast Un,1221,2,5,4,5,14,13,1,19
Delhi Dynamo,1221,3,4,6,4,23,19,4,18
FC Pune City,1221,4,5,3,6,15,17,-2,18
Kolkata,1221,4,4,6,4,15,17,-2,18
FC Goa,1221,6,5,3,6,12,15,-3,18
Kerala Blast,1221,7,5,3,6,13,17,-4,18
Chennaiyin,1221,8,3,7,4,15,19,-4,16
Mumbai City,1222,1,7,4,3,18,9,9,25
Kerala Blast,1222,2,6,4,4,15,14,1,22
Delhi Dynamo,1222,3,4,7,3,24,18,6,19
NorthEast Un,1222,4,5,3,6,13,13,0,18
Kolkata,1222,5,3,8,3,14,14,0,17
Chennaiyin,1222,6,4,5,5,15,20,-5,17
FC Pune City,1222,7,4,4,6,13,18,-5,16
FC Goa,1222,8,4,3,7,11,17,-6,15
Mumbai City,1223,1,7,4,3,20,8,12,25
Delhi Dynamo,1223,2,6,5,3,25,20,5,23
Kolkata,1223,3,4,8,2,17,14,3,20
Kerala Blast,1223,4,5,5,4,13,14,-1,20
FC Pune City,1223,5,4,5,5,13,15,-2,17
NorthEast Un,1223,6,5,2,7,11,14,-3,17
Chennaiyin,1223,7,3,5,6,13,19,-6,14
FC Goa,1223,8,4,2,8,10,18,-8,14
Mumbai City,1224,1,7,4,3,20,8,12,25
Delhi Dynamo,1224,2,6,5,3,24,18,6,23
Kolkata,1224,3,5,6,3,18,15,3,21
NorthEast Un,1224,4,5,3,6,11,11,0,18
FC Pune City,1224,5,5,3,6,14,15,-1,18
Kerala Blast,1224,6,4,4,6,12,20,-8,16
Chennaiyin,1224,7,3,6,5,13,18,-5,15
FC Goa,1224,8,4,3,7,9,16,-7,15
Delhi Dynamo,1225,1,7,5,2,29,16,13,26
Mumbai City,1225,2,6,4,4,16,9,7,22
FC Pune City,1225,3,6,3,5,16,15,1,21
Kolkata,1225,4,4,6,4,17,16,1,18
Chennaiyin,1225,5,4,6,4,15,17,-2,18
Kerala Blast,1225,6,5,3,6,11,17,-6,18
FC Goa,1225,7,4,3,7,12,20,-8,15
NorthEast Un,1225,8,4,2,8,9,15,-6,14
Mumbai City,1226,1,7,4,3,18,9,9,25
Delhi Dynamo,1226,2,6,5,3,25,17,8,23
NorthEast Un,1226,3,6,2,6,14,12,2,20
Kolkata,1226,4,3,9,2,14,13,1,18
FC Pune City,1226,5,4,5,5,13,15,-2,17
Chennaiyin,1226,6,4,5,5,16,20,-4,17
Kerala Blast,1226,7,4,5,5,10,16,-6,17
FC Goa,1226,8,3,3,8,10,18,-8,12
Mumbai City,1227,1,6,5,3,17,9,8,23
FC Pune City,1227,2,5,4,5,14,15,-1,19
Kerala Blast,1227,3,5,4,5,12,15,-3,19
Delhi Dynamo,1227,4,4,6,4,23,20,3,18
NorthEast Un,1227,5,5,3,6,13,12,1,18
Chennaiyin,1227,6,4,6,4,16,18,-2,18
Kolkata,1227,7,3,8,3,15,16,-1,17
FC Goa,1227,8,4,4,6,12,17,-5,16
Mumbai City,1228,1,7,4,3,19,8,11,25
Kolkata,1228,2,6,6,2,17,12,5,24
NorthEast Un,1228,3,6,3,5,14,12,2,21
Delhi Dynamo,1228,4,4,6,4,22,19,3,18
Chennaiyin,1228,5,4,5,5,15,19,-4,17
Kerala Blast,1228,6,4,5,5,13,19,-6,17
FC Pune City,1228,7,4,4,6,14,17,-3,16
FC Goa,1228,8,3,3,8,9,17,-8,12
Mumbai City,1229,1,7,4,3,18,8,10,25
Kolkata,1229,2,6,6,2,18,14,4,24
Kerala Blast,1229,3,5,4,5,11,15,-4,19
Delhi Dynamo,1229,4,4,6,4,23,19,4,18
Chennaiyin,1229,5,4,5,5,15,19,-4,17
FC Goa,1229,6,5,2,7,13,18,-5,17
NorthEast Un,1229,7,4,4,6,11,12,-1,16
FC Pune City,1229,8,4,3,7,13,17,-4,15
Delhi Dynamo,1230,1,7,5,2,28,16,12,26
Mumbai City,1230,2,6,4,4,17,10,7,22
Kolkata,1230,3,5,7,2,17,13,4,22
FC Pune City,1230,4,5,3,6,13,15,-2,18
Kerala Blast,1230,5,5,3,6,11,17,-6,18
NorthEast Un,1230,6,5,2,7,11,11,0,17
FC Goa,1230,7,4,3,7,10,18,-8,15
Chennaiyin,1230,8,3,5,6,13,20,-7,14
Mumbai City,1231,1,6,4,4,18,11,7,22
Kolkata,1231,2,5,7,2,20,16,4,22
Delhi Dynamo,1231,3,5,6,3,26,19,7,21
Kerala Blast,1231,4,6,3,5,16,17,-1,21
Chennaiyin,1231,5,4,5,5,15,18,-3,17
NorthEast Un,1231,6,5,2,7,11,14,-3,17
FC Pune City,1231,7,4,4,6,12,16,-4,16
FC Goa,1231,8,4,3,7,11,18,-7,15
Mumbai City,1232,1,7,4,3,18,8,10,25
Delhi Dynamo,1232,2,5,6,3,25,18,7,21
FC Pune City,1232,3,6,3,5,17,15,2,21
Kerala Blast,1232,4,5,4,5,12,15,-3,19
FC Goa,1232,5,5,3,6,13,15,-2,18
NorthEast Un,1232,6,5,2,7,11,15,-4,17
Kolkata,1232,7,3,7,4,14,18,-4,16
Chennaiyin,1232,8,3,5,6,13,19,-6,14
Delhi Dynamo,1233,1,7,5,2,26,15,11,26
Kerala Blast,1233,2,7,3,4,15,15,0,24
Mumbai City,1233,3,6,4,4,16,9,7,22
FC Pune City,1233,4,5,3,6,16,17,-1,18
Chennaiyin,1233,5,4,5,5,18,21,-3,17
FC Goa,1233,6,5,2,7,16,19,-3,17
Kolkata,1233,7,3,6,5,15,21,-6,15
NorthEast Un,1233,8,4,2,8,10,15,-5,14
Mumbai City,1234,1,6,5,3,17,9,8,23
NorthEast Un,1234,2,6,2,6,13,12,1,20
Chennaiyin,1234,3,5,5,4,17,19,-2,20
Delhi Dynamo,1234,4,4,6,4,22,17,5,18
Kolkata,1234,5,3,8,3,16,17,-1,17
FC Pune City,1234,6,4,5,5,14,16,-2,17
FC Goa,1234,7,5,2,7,11,15,-4,17
Kerala Blast,1234,8,4,5,5,12,17,-5,17
Delhi Dynamo,1235,1,6,6,2,30,19,11,24
Mumbai City,1235,2,6,4,4,17,11,6,22
Kolkata,1235,3,5,6,3,17,14,3,21
Kerala Blast,1235,4,5,4,5,11,15,-4,19
Chennaiyin,1235,5,4,6,4,15,18,-3,18
NorthEast Un,1235,6,5,2,7,11,13,-2,17
FC Pune City,1235,7,4,4,6,12,15,-3,16
FC Goa,1235,8,3,4,7,12,20,-8,13
Mumbai City,1236,1,6,5,3,18,10,8,23
Kerala Blast,1236,2,6,3,5,12,14,-2,21
Delhi Dynamo,1236,3,4,7,3,24,19,5,19
NorthEast Un,1236,4,5,3,6,12,13,-1,18
Chennaiyin,1236,5,4,6,4,17,19,-2,18
FC Pune City,1236,6,5,3,6,13,15,-2,18
FC Goa,1236,7,5,3,6,12,15,-3,18
Kolkata,1236,8,3,6,5,13,16,-3,15
Delhi Dynamo,1237,1,7,5,2,26,16,10,26
Mumbai City,1237,2,6,4,4,17,10,7,22
Kerala Blast,1237,3,6,4,4,13,13,0,22
Kolkata,1237,4,4,7,3,16,15,1,19
NorthEast Un,1237,5,5,2,7,12,15,-3,17
FC Pune City,1237,6,4,4,6,13,16,-3,16
FC Goa,1237,7,4,3,7,10,16,-6,15
Chennaiyin,1237,8,3,5,6,14,20,-6,14
Mumbai City,1238,1,7,4,3,18,8,10,25
Kerala Blast,1238,2,7,3,4,14,14,0,24
Delhi Dynamo,1238,3,5,6,3,24,17,7,21
Chennaiyin,1238,4,4,6,4,15,18,-3,18
Kolkata,1238,5,3,8,3,14,15,-1,17
NorthEast Un,1238,6,4,4,6,12,13,-1,16
FC Pune City,1238,7,4,4,6,12,15,-3,16
FC Goa,1238,8,3,3,8,9,18,-9,12
Mumbai City,1239,1,7,4,3,22,10,12,25
Kerala Blast,1239,2,6,4,4,13,14,-1,22
Delhi Dynamo,1239,3,5,6,3,25,21,4,21
Chennaiyin,1239,4,4,6,4,16,18,-2,18
Kolkata,1239,5,3,8,3,13,13,0,17
FC Pune City,1239,6,4,4,6,12,16,-4,16
NorthEast Un,1239,7,4,3,7,10,13,-3,15
FC Goa,1239,8,4,3,7,11,17,-6,15
Mumbai City,1240,1,7,4,3,18,9,9,25
Kerala Blast,1240,2,6,4,4,17,16,1,22
Delhi Dynamo,1240,3,5,5,4,23,18,5,20
Kolkata,1240,4,4,7,3,17,16,1,19
FC Pune City,1240,5,4,5,5,13,15,-2,17
NorthEast Un,1240,6,5,2,7,10,14,-4,17
Chennaiyin,1240,7,3,6,5,13,18,-5,15
FC Goa,1240,8,4,3,7,11,16,-5,15
Mumbai City,1241,1,7,4,3,19,10,9,25
Delhi Dynamo,1241,2,5,6,3,27,20,7,21
Kerala Blast,1241,3,5,4,5,12,17,-5,19
Kolkata,1241,4,4,6,4,16,14,2,18
Chennaiyin,1241,5,4,6,4,15,18,-3,18
FC Pune City,1241,6,5,3,6,13,16,-3,18
NorthEast Un,1241,7,4,4,6,11,12,-1,16
FC Goa,1241,8,4,3,7,12,18,-6,15
Delhi Dynamo,1242,1,6,6,2,28,15,13,24
Mumbai City,1242,2,6,5,3,17,9,8,23
Kolkata,1242,3,4,8,2,17,14,3,20
Chennaiyin,1242,4,5,5,4,15,17,-2,20
FC Pune City,1242,5,5,4,5,14,15,-1,19
Kerala Blast,1242,6,5,4,5,12,15,-3,19
NorthEast Un,1242,7,4,2,8,9,16,-7,14
FC Goa,1242,8,3,2,9,8,19,-11,11
Kerala Blast,1243,1,7,3,4,14,14,0,24
Mumbai City,1243,2,6,4,4,18,12,6,22
Kolkata,1243,3,5,6,3,22,14,8,21
Delhi Dynamo,1243,4,5,5,4,28,21,7,20
NorthEast Un,1243,5,5,3,6,13,14,-1,18
Chennaiyin,1243,6,3,7,4,15,19,-4,16
FC Pune City,1243,7,4,3,7,12,18,-6,15
FC Goa,1243,8,4,3,7,11,21,-10,15
Mumbai City,1244,1,6,5,3,16,8,8,23
Delhi Dynamo,1244,2,5,7,2,25,16,9,22
Kolkata,1244,3,4,7,3,16,15,1,19
FC Pune City,1244,4,5,3,6,13,15,-2,18
Chennaiyin,1244,5,4,6,4,15,18,-3,18
Kerala Blast,1244,6,4,5,5,11,16,-5,17
NorthEast Un,1244,7,4,4,6,10,12,-2,16
FC Goa,1244,8,4,3,7,11,17,-6,15
Mumbai City,1245,1,6,5,3,18,10,8,23
Delhi Dynamo,1245,2,5,7,2,25,17,8,22
Kerala Blast,1245,3,6,4,4,15,16,-1,22
FC Pune City,1245,4,5,3,6,18,17,1,18
FC Goa,1245,5,5,3,6,13,16,-3,18
Kolkata,1245,6,3,7,4,15,19,-4,16
NorthEast Un,1245,7,4,3,7,10,13,-3,15
Chennaiyin,1245,8,3,6,5,14,20,-6,15
Mumbai City,1246,1,7,4,3,20,9,11,25
Delhi Dynamo,1246,2,5,5,4,23,20,3,20
Kerala Blast,1246,3,5,5,4,12,14,-2,20
Kolkata,1246,4,4,7,3,17,15,2,19
Chennaiyin,1246,5,4,6,4,17,19,-2,18
FC Goa,1246,6,5,3,6,13,15,-2,18
NorthEast Un,1246,7,4,3,7,10,13,-3,15
FC Pune City,1246,8,4,3,7,12,19,-7,15
Mumbai City,1247,1,7,4,3,20,9,11,25
Kolkata,1247,2,6,6,2,18,12,6,24
Delhi Dynamo,1247,3,4,7,3,25,21,4,19
NorthEast Un,1247,4,5,3,6,13,13,0,18
Kerala Blast,1247,5,5,3,6,12,15,-3,18
Chennaiyin,1247,6,4,5,5,16,20,-4,17
FC Pune City,1247,7,4,3,7,12,19,-7,15
FC Goa,1247,8,4,3,7,11,18,-7,15
Delhi Dynamo,1248,1,6,6,2,24,15,9,24
Mumbai City,1248,2,6,5,3,17,9,8,23
Kolkata,1248,3,5,6,3,16,13,3,21
FC Pune City,1248,4,5,4,5,13,14,-1,19
Chennaiyin,1248,5,4,6,4,15,18,-3,18
Kerala Blast,1248,6,4,5,5,10,15,-5,17
NorthEast Un,1248,7,4,3,7,10,12,-2,15
FC Goa,1248,8,3,3,8,9,18,-9,12
Mumbai City,1249,1,7,4,3,20,10,10,25
Kerala Blast,1249,2,7,3,4,15,13,2,24
Delhi Dynamo,1249,3,5,6,3,30,23,7,21
FC Goa,1249,4,5,3,6,16,18,-2,18
NorthEast Un,1249,5,5,2,7,13,16,-3,17
Kolkata,1249,6,3,7,4,13,15,-2,16
FC Pune City,1249,7,4,4,6,12,15,-3,16
Chennaiyin,1249,8,3,5,6,14,23,-9,14
Mumbai City,1250,1,6,5,3,17,9,8,23
Delhi Dynamo,1250,2,5,7,2,27,17,10,22
Kerala Blast,1250,3,6,4,4,11,13,-2,22
Chennaiyin,1250,4,5,5,4,16,17,-1,20
Kolkata,1250,5,4,7,3,15,14,1,19
FC Pune City,1250,6,4,4,6,12,15,-3,16
NorthEast Un,1250,7,4,3,7,11,13,-2,15
FC Goa,1250,8,3,3,8,9,20,-11,12
Mumbai City,1251,1,6,5,3,16,8,8,23
Delhi Dynamo,1251,2,5,7,2,23,15,8,22
Kolkata,1251,3,5,6,3,18,16,2,21
FC Pune City,1251,4,6,3,5,17,15,2,21
Chennaiyin,1251,5,5,5,4,17,19,-2,20
Kerala Blast,1251,6,4,4,6,10,18,-8,16
NorthEast Un,1251,7,4,3,7,10,12,-2,15
FC Goa,1251,8,3,3,8,11,19,-8,12
Mumbai City,1252,1,6,4,4,16,10,6,22
Delhi Dynamo,1252,2,5,6,3,24,18,6,21
Kerala Blast,1252,3,5,5,4,14,16,-2,20
NorthEast Un,1252,4,5,4,5,12,11,1,19
FC Goa,1252,5,5,3,6,15,16,-1,18
Kolkata,1252,6,3,8,3,16,17,-1,17
FC Pune City,1252,7,4,4,6,13,17,-4,16
Chennaiyin,1252,8,3,6,5,15,20,-5,15
Mumbai City,1253,1,7,4,3,18,8,10,25
Delhi Dynamo,1253,2,5,5,4,25,20,5,20
Kerala Blast,1253,3,5,5,4,12,15,-3,20
Kolkata,1253,4,4,7,3,16,13,3,19
NorthEast Un,1253,5,5,2,7,14,14,0,17
Chennaiyin,1253,6,4,5,5,15,19,-4,17
FC Goa,1253,7,5,2,7,11,17,-6,17
FC Pune City,1253,8,4,4,6,13,18,-5,16
Delhi Dynamo,1254,1,7,5,2,27,16,11,26
Mumbai City,1254,2,6,4,4,16,9,7,22
Kerala Blast,1254,3,6,3,5,17,17,0,21
NorthEast Un,1254,4,5,3,6,14,13,1,18
Kolkata,1254,5,4,6,4,20,20,0,18
Chennaiyin,1254,6,4,6,4,16,18,-2,18
FC Pune City,1254,7,4,3,7,12,20,-8,15
FC Goa,1254,8,4,2,8,11,20,-9,14
Delhi Dynamo,1255,1,6,6,2,28,15,13,24
Mumbai City,1255,2,6,5,3,17,9,8,23
Chennaiyin,1255,3,5,5,4,19,19,0,20
FC Pune City,1255,4,5,4,5,15,14,1,19
Kerala Blast,1255,5,5,4,5,12,15,-3,19
Kolkata,1255,6,4,6,4,15,18,-3,18
NorthEast Un,1255,7,4,2,8,10,17,-7,14
FC Goa,1255,8,4,2,8,11,20,-9,14
Mumbai City,1256,1,6,4,4,16,9,7,22
Kolkata,1256,2,5,7,2,19,14,5,22
Delhi Dynamo,1256,3,5,6,3,22,18,4,21
Kerala Blast,1256,4,6,3,5,14,15,-1,21
NorthEast Un,1256,5,5,3,6,15,13,2,18
Chennaiyin,1256,6,4,6,4,17,19,-2,18
FC Pune City,1256,7,4,3,7,13,20,-7,15
FC Goa,1256,8,3,4,7,9,17,-8,13
Delhi Dynamo,1257,1,7,5,2,29,18,11,26
Mumbai City,1257,2,6,4,4,18,11,7,22
FC Pune City,1257,3,6,3,5,15,14,1,21
Kerala Blast,1257,4,5,4,5,14,16,-2,19
NorthEast Un,1257,5,5,3,6,12,13,-1,18
Chennaiyin,1257,6,3,6,5,14,19,-5,15
FC Goa,1257,7,4,3,7,13,18,-5,15
Kolkata,1257,8,3,6,5,13,19,-6,15
Mumbai City,1258,1,7,4,3,18,9,9,25
Kolkata,1258,2,5,6,3,18,15,3,21
Chennaiyin,1258,3,5,5,4,15,17,-2,20
Kerala Blast,1258,4,5,4,5,15,18,-3,19
Delhi Dynamo,1258,5,4,6,4,23,18,5,18
NorthEast Un,1258,6,5,2,7,12,14,-2,17
FC Pune City,1258,7,4,4,6,13,17,-4,16
FC Goa,1258,8,4,3,7,11,17,-6,15
Mumbai City,1259,1,7,4,3,19,9,10,25
Kerala Blast,1259,2,7,3,4,15,15,0,24
Delhi Dynamo,1259,3,5,5,4,24,19,5,20
Kolkata,1259,4,4,6,4,14,17,-3,18
Chennaiyin,1259,5,4,5,5,17,19,-2,17
FC Goa,1259,6,5,2,7,13,16,-3,17
NorthEast Un,1259,7,5,2,7,12,15,-3,17
FC Pune City,1259,8,4,3,7,13,17,-4,15
Mumbai City,1260,1,7,4,3,17,8,9,25
Kolkata,1260,2,5,7,2,19,12,7,22
Delhi Dynamo,1260,3,5,6,3,26,19,7,21
Kerala Blast,1260,4,6,3,5,15,19,-4,21
Chennaiyin,1260,5,4,5,5,14,18,-4,17
FC Pune City,1260,6,4,4,6,14,18,-4,16
NorthEast Un,1260,7,4,3,7,10,13,-3,15
FC Goa,1260,8,4,2,8,12,20,-8,14
Delhi Dynamo,1261,1,6,6,2,29,19,10,24
Mumbai City,1261,2,6,5,3,17,9,8,23
Kerala Blast,1261,3,6,3,5,11,15,-4,21
Kolkata,1261,4,4,7,3,15,14,1,19
FC Pune City,1261,5,5,4,5,14,14,0,19
Chennaiyin,1261,6,3,7,4,14,18,-4,16
NorthEast Un,1261,7,4,3,7,12,14,-2,15
FC Goa,1261,8,3,3,8,11,20,-9,12
Delhi Dynamo,1262,1,6,5,3,27,16,11,23
Mumbai City,1262,2,6,4,4,16,11,5,22
Kolkata,1262,3,5,6,3,17,14,3,21
FC Pune City,1262,4,6,3,5,16,15,1,21
NorthEast Un,1262,5,5,3,6,12,12,0,18
Chennaiyin,1262,6,4,5,5,15,19,-4,17
Kerala Blast,1262,7,4,4,6,13,21,-8,16
FC Goa,1262,8,4,2,8,11,19,-8,14
Mumbai City,1263,1,6,5,3,17,9,8,23
Delhi Dynamo,1263,2,5,7,2,27,18,9,22
NorthEast Un,1263,3,5,4,5,13,11,2,19
Kolkata,1263,4,4,7,3,17,16,1,19
FC Pune City,1263,5,5,4,5,15,16,-1,19
Kerala Blast,1263,6,5,4,5,11,15,-4,19
Chennaiyin,1263,7,4,5,5,17,20,-3,17
FC Goa,1263,8,3,2,9,10,22,-12,11
Mumbai City,1264,1,7,4,3,19,8,11,25
Delhi Dynamo,1264,2,5,6,3,24,19,5,21
Kolkata,1264,3,4,8,2,20,15,5,20
FC Pune City,1264,4,5,4,5,15,15,0,19
NorthEast Un,1264,5,5,3,6,11,12,-1,18
Kerala Blast,1264,6,5,3,6,11,19,-8,18
FC Goa,1264,7,4,3,7,12,18,-6,15
Chennaiyin,1264,8,3,5,6,13,19,-6,14
Delhi Dynamo,1265,1,7,5,2,30,14,16,26
Mumbai City,1265,2,6,4,4,16,9,7,22
Kolkata,1265,3,5,6,3,17,15,2,21
Kerala Blast,1265,4,5,4,5,13,16,-3,19
NorthEast Un,1265,5,5,2,7,11,13,-2,17
Chennaiyin,1265,6,4,5,5,14,18,-4,17
FC Pune City,1265,7,4,4,6,13,18,-5,16
FC Goa,1265,8,4,2,8,9,20,-11,14
Delhi Dynamo,1266,1,6,6,2,27,17,10,24
Mumbai City,1266,2,6,4,4,16,9,7,22
Kolkata,1266,3,4,7,3,14,14,0,19
Kerala Blast,1266,4,4,6,4,11,15,-4,18
NorthEast Un,1266,5,4,5,5,12,12,0,17
FC Goa,1266,6,5,2,7,13,18,-5,17
FC Pune City,1266,7,4,4,6,13,16,-3,16
Chennaiyin,1266,8,3,6,5,14,19,-5,15
Mumbai City,1267,1,6,5,3,17,9,8,23
Kerala Blast,1267,2,6,4,4,15,16,-1,22
Delhi Dynamo,1267,3,4,7,3,24,19,5,19
FC Pune City,1267,4,5,4,5,16,15,1,19
NorthEast Un,1267,5,5,3,6,13,12,1,18
Chennaiyin,1267,6,4,6,4,15,18,-3,18
Kolkata,1267,7,3,7,4,16,20,-4,16
FC Goa,1267,8,3,4,7,10,17,-7,13
Mumbai City,1268,1,7,4,3,17,8,9,25
Delhi Dynamo,1268,2,6,5,3,24,16,8,23
Kolkata,1268,3,5,7,2,18,13,5,22
Kerala Blast,1268,4,6,3,5,12,15,-3,21
FC Pune City,1268,5,4,4,6,13,16,-3,16
NorthEast Un,1268,6,4,3,7,11,14,-3,15
Chennaiyin,1268,7,3,6,5,14,19,-5,15
FC Goa,1268,8,4,2,8,9,17,-8,14
Mumbai City,1269,1,6,5,3,16,8,8,23
Delhi Dynamo,1269,2,5,7,2,26,18,8,22
FC Pune City,1269,3,6,3,5,14,14,0,21
NorthEast Un,1269,4,5,4,5,16,13,3,19
Kerala Blast,1269,5,5,4,5,13,16,-3,19
Kolkata,1269,6,4,6,4,17,17,0,18
FC Goa,1269,7,4,2,8,12,19,-7,14
Chennaiyin,1269,8,3,5,6,13,22,-9,14
Delhi Dynamo,1270,1,6,6,2,25,15,10,24
Mumbai City,1270,2,6,4,4,16,9,7,22
Kolkata,1270,3,5,7,2,20,15,5,22
Kerala Blast,1270,4,5,5,4,12,14,-2,20
Chennaiyin,1270,5,4,5,5,16,20,-4,17
NorthEast Un,1270,6,4,4,6,11,13,-2,16
FC Pune City,1270,7,4,3,7,14,20,-6,15
FC Goa,1270,8,4,2,8,12,20,-8,14
Delhi Dynamo,1271,1,6,6,2,25,14,11,24
Mumbai City,1271,2,6,5,3,16,8,8,23
Kolkata,1271,3,5,7,2,20,15,5,22
NorthEast Un,1271,4,6,2,6,12,13,-1,20
FC Pune City,1271,5,4,4,6,14,19,-5,16
Kerala Blast,1271,6,4,4,6,10,16,-6,16
Chennaiyin,1271,7,3,6,5,15,20,-5,15
FC Goa,1271,8,3,4,7,11,18,-7,13
Delhi Dynamo,1272,1,6,6,2,27,18,9,24
Mumbai City,1272,2,6,4,4,17,10,7,22
Kolkata,1272,3,5,7,2,22,17,5,22
Kerala Blast,1272,4,5,4,5,12,16,-4,19
NorthEast Un,1272,5,5,3,6,12,13,-1,18
Chennaiyin,1272,6,4,6,4,16,18,-2,18
FC Pune City,1272,7,4,3,7,13,18,-5,15
FC Goa,1272,8,3,3,8,14,23,-9,12
Mumbai City,1273,1,7,4,3,18,8,10,25
Kerala Blast,1273,2,6,3,5,14,15,-1,21
Delhi Dynamo,1273,3,5,5,4,24,19,5,20
Kolkata,1273,4,4,7,3,17,17,0,19
NorthEast Un,1273,5,5,3,6,11,11,0,18
Chennaiyin,1273,6,4,6,4,17,19,-2,18
FC Pune City,1273,7,5,3,6,15,18,-3,18
FC Goa,1273,8,3,3,8,12,21,-9,12
Mumbai City,1274,1,7,4,3,17,8,9,25
Kolkata,1274,2,5,7,2,16,13,3,22
Delhi Dynamo,1274,3,5,6,3,24,17,7,21
Kerala Blast,1274,4,5,5,4,12,14,-2,20
NorthEast Un,1274,5,4,4,6,11,12,-1,16
Chennaiyin,1274,6,3,7,4,14,18,-4,16
FC Pune City,1274,7,4,3,7,12,17,-5,15
FC Goa,1274,8,3,4,7,9,16,-7,13
Mumbai City,1275,1,7,4,3,18,9,9,25
FC Pune City,1275,2,6,3,5,18,16,2,21
NorthEast Un,1275,3,6,3,5,13,11,2,21
Delhi Dynamo,1275,4,5,5,4,24,18,6,20
Kolkata,1275,5,4,7,3,16,16,0,19
Kerala Blast,1275,6,4,4,6,11,18,-7,16
FC Goa,1275,7,4,3,7,13,17,-4,15
Chennaiyin,1275,8,3,5,6,14,22,-8,14
Mumbai City,1276,1,7,4,3,21,9,12,25
Delhi Dynamo,1276,2,6,5,3,24,19,5,23
Kerala Blast,1276,3,6,4,4,17,17,0,22
NorthEast Un,1276,4,5,2,7,11,12,-1,17
FC Pune City,1276,5,4,5,5,16,18,-2,17
Kolkata,1276,5,3,8,3,16,18,-2,17
Chennaiyin,1276,7,3,6,5,15,20,-5,15
FC Goa,1276,8,3,4,7,10,17,-7,13
Mumbai City,1277,1,6,4,4,17,10,7,22
Delhi Dynamo,1277,2,5,6,3,24,17,7,21
Kolkata,1277,3,5,6,3,18,14,4,21
NorthEast Un,1277,4,6,3,5,12,10,2,21
FC Pune City,1277,5,5,3,6,15,17,-2,18
Chennaiyin,1277,6,4,5,5,15,18,-3,17
Kerala Blast,1277,7,4,4,6,11,19,-8,16
FC Goa,1277,8,4,3,7,10,17,-7,15
Mumbai City,1278,1,7,4,3,18,9,9,25
Kolkata,1278,2,5,7,2,17,13,4,22
Delhi Dynamo,1278,3,5,6,3,29,19,10,21
Kerala Blast,1278,4,6,3,5,12,15,-3,21
NorthEast Un,1278,5,5,3,6,15,14,1,18
Chennaiyin,1278,6,4,5,5,17,20,-3,17
FC Pune City,1278,7,4,3,7,13,18,-5,15
FC Goa,1278,8,3,3,8,9,22,-13,12
Mumbai City,1279,1,6,4,4,17,11,6,22
Delhi Dynamo,1279,2,5,6,3,26,18,8,21
Kolkata,1279,3,5,6,3,17,13,4,21
NorthEast Un,1279,4,6,3,5,16,12,4,21
FC Pune City,1279,5,6,3,5,15,14,1,21
Kerala Blast,1279,6,4,4,6,10,18,-8,16
FC Goa,1279,7,4,3,7,11,18,-7,15
Chennaiyin,1279,8,3,5,6,15,23,-8,14
Mumbai City,1280,1,7,4,3,17,8,9,25
Kerala Blast,1280,2,6,3,5,15,16,-1,21
Delhi Dynamo,1280,3,5,5,4,24,17,7,20
FC Pune City,1280,4,5,4,5,15,16,-1,19
NorthEast Un,1280,5,5,2,7,10,11,-1,17
Chennaiyin,1280,6,4,5,5,15,19,-4,17
FC Goa,1280,7,5,2,7,14,18,-4,17
Kolkata,1280,8,3,7,4,13,18,-5,16
Mumbai City,1281,1,7,4,3,18,9,9,25
Delhi Dynamo,1281,2,6,5,3,29,21,8,23
Kerala Blast,1281,3,6,4,4,13,15,-2,22
Kolkata,1281,4,4,7,3,17,16,1,19
FC Pune City,1281,5,4,5,5,12,14,-2,17
Chennaiyin,1281,6,4,5,5,16,20,-4,17
NorthEast Un,1281,7,4,2,8,14,17,-3,14
FC Goa,1281,8,4,2,8,14,21,-7,14
Delhi Dynamo,1282,1,6,5,3,27,17,10,23
Mumbai City,1282,2,6,4,4,16,10,6,22
Kerala Blast,1282,3,5,5,4,11,14,-3,20
NorthEast Un,1282,4,5,3,6,12,12,0,18
Kolkata,1282,5,4,6,4,16,17,-1,18
Chennaiyin,1282,6,4,6,4,14,17,-3,18
FC Pune City,1282,7,4,4,6,13,17,-4,16
FC Goa,1282,8,4,3,7,12,17,-5,15
Mumbai City,1283,1,7,4,3,18,8,10,25
Delhi Dynamo,1283,2,6,5,3,26,17,9,23
Kerala Blast,1283,3,6,4,4,13,15,-2,22
Kolkata,1283,4,5,6,3,17,15,2,21
Chennaiyin,1283,5,4,5,5,15,19,-4,17
NorthEast Un,1283,6,4,3,7,11,14,-3,15
FC Pune City,1283,7,4,3,7,13,17,-4,15
FC Goa,1283,8,4,2,8,12,20,-8,14
Delhi Dynamo,1284,1,6,5,3,24,16,8,23
Mumbai City,1284,2,6,4,4,16,9,7,22
Kerala Blast,1284,3,6,4,4,15,14,1,22
NorthEast Un,1284,4,5,4,5,13,12,1,19
Kolkata,1284,5,4,6,4,15,17,-2,18
Chennaiyin,1284,6,4,6,4,17,20,-3,18
FC Pune City,1284,7,4,3,7,13,19,-6,15
FC Goa,1284,8,4,2,8,12,18,-6,14
Delhi Dynamo,1285,1,7,5,2,26,15,11,26
Kerala Blast,1285,2,7,3,4,14,13,1,24
Mumbai City,1285,3,6,4,4,16,9,7,22
NorthEast Un,1285,4,5,2,7,10,11,-1,17
FC Goa,1285,5,5,2,7,12,18,-6,17
Kolkata,1285,6,3,7,4,13,16,-3,16
FC Pune City,1285,7,4,4,6,12,15,-3,16
Chennaiyin,1285,8,3,5,6,14,20,-6,14
Delhi Dynamo,1286,1,6,6,2,26,16,10,24
Mumbai City,1286,2,6,5,3,17,9,8,23
Kerala Blast,1286,3,6,3,5,14,18,-4,21
FC Pune City,1286,4,5,4,5,16,16,0,19
NorthEast Un,1286,5,5,2,7,11,13,-2,17
FC Goa,1286,6,5,2,7,15,18,-3,17
Kolkata,1286,7,3,7,4,15,17,-2,16
Chennaiyin,1286,8,3,5,6,15,22,-7,14
Mumbai City,1287,1,6,5,3,17,9,8,23
Delhi Dynamo,1287,2,5,7,2,24,16,8,22
FC Pune City,1287,3,5,4,5,14,15,-1,19
Kerala Blast,1287,4,5,4,5,13,15,-2,19
NorthEast Un,1287,5,5,3,6,12,12,0,18
Chennaiyin,1287,6,4,6,4,16,18,-2,18
Kolkata,1287,7,4,6,4,14,16,-2,18
FC Goa,1287,8,3,3,8,8,17,-9,12
Mumbai City,1288,1,6,5,3,16,8,8,23
Kolkata,1288,2,5,7,2,16,13,3,22
NorthEast Un,1288,3,6,3,5,14,10,4,21
Delhi Dynamo,1288,4,4,7,3,23,17,6,19
Kerala Blast,1288,5,5,4,5,14,16,-2,19
FC Pune City,1288,6,4,4,6,12,17,-5,16
FC Goa,1288,7,4,3,7,12,18,-6,15
Chennaiyin,1288,8,3,5,6,14,22,-8,14
Mumbai City,1289,1,7,4,3,19,8,11,25
Delhi Dynamo,1289,2,6,5,3,23,17,6,23
Kolkata,1289,3,4,8,2,18,15,3,20
Chennaiyin,1289,4,4,6,4,15,18,-3,18
Kerala Blast,1289,5,4,6,4,11,15,-4,18
FC Pune City,1289,6,4,4,6,15,19,-4,16
NorthEast Un,1289,7,4,3,7,9,11,-2,15
FC Goa,1289,8,3,4,7,9,16,-7,13
Mumbai City,1290,1,7,4,3,18,9,9,25
Kolkata,1290,2,5,7,2,17,13,4,22
Delhi Dynamo,1290,3,5,5,4,26,18,8,20
Chennaiyin,1290,4,4,6,4,17,18,-1,18
NorthEast Un,1290,5,5,3,6,11,12,-1,18
FC Pune City,1290,6,5,3,6,13,16,-3,18
Kerala Blast,1290,7,4,4,6,10,17,-7,16
FC Goa,1290,8,4,2,8,11,20,-9,14
Kerala Blast,1291,1,7,3,4,13,13,0,24
Mumbai City,1291,2,6,4,4,17,10,7,22
Delhi Dynamo,1291,3,5,6,3,25,18,7,21
Kolkata,1291,4,4,7,3,16,14,2,19
Chennaiyin,1291,5,4,5,5,17,19,-2,17
NorthEast Un,1291,6,5,2,7,11,14,-3,17
FC Goa,1291,7,4,4,6,12,17,-5,16
FC Pune City,1291,8,4,3,7,12,18,-6,15
Delhi Dynamo,1292,1,7,5,2,28,16,12,26
Mumbai City,1292,2,6,4,4,17,10,7,22
Kolkata,1292,3,5,7,2,18,14,4,22
Kerala Blast,1292,4,5,5,4,12,15,-3,20
Chennaiyin,1292,5,4,5,5,17,20,-3,17
NorthEast Un,1292,6,4,3,7,11,15,-4,15
FC Pune City,1292,7,4,3,7,13,18,-5,15
FC Goa,1292,8,4,2,8,11,19,-8,14
Mumbai City,1293,1,7,4,3,17,8,9,25
NorthEast Un,1293,2,6,3,5,12,10,2,21
Kolkata,1293,3,4,8,2,16,14,2,20
Delhi Dynamo,1293,4,4,6,4,23,18,5,18
FC Pune City,1293,5,4,5,5,14,16,-2,17
FC Goa,1293,6,4,4,6,12,17,-5,16
Kerala Blast,1293,7,4,4,6,10,16,-6,16
Chennaiyin,1293,8,3,6,5,14,19,-5,15
Mumbai City,1294,1,6,5,3,16,8,8,23
Kolkata,1294,2,5,7,2,21,17,4,22
Delhi Dynamo,1294,3,5,6,3,22,16,6,21
NorthEast Un,1294,4,5,3,6,14,14,0,18
FC Pune City,1294,5,5,3,6,16,19,-3,18
Kerala Blast,1294,6,5,3,6,14,18,-4,18
Chennaiyin,1294,7,3,7,4,16,20,-4,16
FC Goa,1294,8,3,4,7,11,18,-7,13
Delhi Dynamo,1295,1,6,6,2,28,16,12,24
Mumbai City,1295,2,6,4,4,17,10,7,22
FC Pune City,1295,3,5,4,5,14,15,-1,19
Kerala Blast,1295,4,5,4,5,10,14,-4,19
Kolkata,1295,5,3,8,3,14,14,0,17
NorthEast Un,1295,6,4,5,5,12,12,0,17
Chennaiyin,1295,7,3,6,5,16,21,-5,15
FC Goa,1295,8,4,3,7,10,19,-9,15
Mumbai City,1296,1,7,4,3,19,9,10,25
NorthEast Un,1296,2,6,3,5,14,11,3,21
Delhi Dynamo,1296,3,4,7,3,24,19,5,19
Kolkata,1296,4,4,7,3,15,14,1,19
FC Goa,1296,5,5,3,6,13,15,-2,18
Kerala Blast,1296,6,4,5,5,11,16,-5,17
FC Pune City,1296,7,4,4,6,12,15,-3,16
Chennaiyin,1296,8,3,5,6,13,22,-9,14
Mumbai City,1297,1,6,4,4,18,11,7,22
Delhi Dynamo,1297,2,5,6,3,24,17,7,21
FC Pune City,1297,3,6,3,5,17,16,1,21
FC Goa,1297,4,6,2,6,12,14,-2,20
Kolkata,1297,5,4,6,4,17,18,-1,18
NorthEast Un,1297,6,4,5,5,10,10,0,17
Kerala Blast,1297,7,4,4,6,11,17,-6,16
Chennaiyin,1297,8,3,6,5,13,19,-6,15
Mumbai City,1298,1,7,4,3,17,8,9,25
Delhi Dynamo,1298,2,5,6,3,22,15,7,21
FC Pune City,1298,3,6,3,5,14,14,0,21
Kolkata,1298,4,4,7,3,16,13,3,19
NorthEast Un,1298,5,5,3,6,11,11,0,18
FC Goa,1298,6,4,4,6,12,14,-2,16
Kerala Blast,1298,7,4,4,6,10,18,-8,16
Chennaiyin,1298,8,3,5,6,13,22,-9,14
Mumbai City,1299,1,7,4,3,18,9,9,25
FC Pune City,1299,2,6,3,5,14,14,0,21
Delhi Dynamo,1299,3,5,5,4,26,18,8,20
NorthEast Un,1299,4,6,2,6,14,11,3,20
Kolkata,1299,5,4,6,4,16,15,1,18
Chennaiyin,1299,6,4,5,5,15,20,-5,17
FC Goa,1299,7,5,2,7,12,18,-6,17
Kerala Blast,1299,8,4,3,7,10,20,-10,15
Delhi Dynamo,1300,1,6,5,3,26,19,7,23
Mumbai City,1300,2,6,4,4,16,10,6,22
FC Pune City,1300,3,6,3,5,16,15,1,21
Kolkata,1300,4,4,7,3,15,14,1,19
Kerala Blast,1300,5,5,3,6,12,17,-5,18
NorthEast Un,1300,6,5,2,7,12,12,0,17
Chennaiyin,1300,7,4,5,5,14,18,-4,17
FC Goa,1300,8,4,3,7,11,17,-6,15
Mumbai City,1301,1,6,5,3,16,8,8,23
Kolkata,1301,2,4,8,2,17,15,2,20
Chennaiyin,1301,3,5,5,4,17,18,-1,20
Delhi Dynamo,1301,4,4,7,3,21,16,5,19
Kerala Blast,1301,5,5,4,5,12,16,-4,19
NorthEast Un,1301,6,4,4,6,10,12,-2,16
FC Pune City,1301,7,4,4,6,15,18,-3,16
FC Goa,1301,8,4,3,7,12,17,-5,15
Mumbai City,1302,1,7,4,3,19,8,11,25
Delhi Dynamo,1302,2,5,6,3,24,18,6,21
Kolkata,1302,3,5,6,3,16,15,1,21
FC Goa,1302,4,5,3,6,13,16,-3,18
Chennaiyin,1302,5,4,5,5,15,19,-4,17
Kerala Blast,1302,6,4,5,5,14,19,-5,17
FC Pune City,1302,7,4,4,6,14,17,-3,16
NorthEast Un,1302,8,4,3,7,11,14,-3,15
Delhi Dynamo,1303,1,7,5,2,26,15,11,26
Mumbai City,1303,2,6,4,4,16,9,7,22
Kolkata,1303,3,4,7,3,17,16,1,19
Kerala Blast,1303,4,5,4,5,12,15,-3,19
Chennaiyin,1303,5,4,6,4,15,18,-3,18
FC Pune City,1303,6,5,3,6,14,17,-3,18
NorthEast Un,1303,7,4,3,7,10,13,-3,15
FC Goa,1303,8,3,4,7,10,17,-7,13
Mumbai City,1304,1,7,4,3,18,8,10,25
Kerala Blast,1304,2,7,3,4,15,16,-1,24
Delhi Dynamo,1304,3,5,6,3,23,16,7,21
Chennaiyin,1304,4,4,6,4,17,19,-2,18
Kolkata,1304,5,4,6,4,15,17,-2,18
FC Goa,1304,6,4,4,6,13,16,-3,16
FC Pune City,1304,7,4,3,7,13,17,-4,15
NorthEast Un,1304,8,4,2,8,12,17,-5,14
Mumbai City,1305,1,6,5,3,18,10,8,23
Delhi Dynamo,1305,2,5,6,3,25,19,6,21
NorthEast Un,1305,3,5,4,5,14,11,3,19
FC Pune City,1305,4,5,4,5,13,14,-1,19
Chennaiyin,1305,5,4,6,4,16,18,-2,18
Kolkata,1305,6,3,8,3,14,14,0,17
Kerala Blast,1305,7,4,5,5,10,15,-5,17
FC Goa,1305,8,4,2,8,10,19,-9,14
Delhi Dynamo,1306,1,6,6,2,28,17,11,24
Mumbai City,1306,2,6,5,3,17,9,8,23
Kolkata,1306,3,4,8,2,15,13,2,20
Kerala Blast,1306,4,5,4,5,12,16,-4,19
FC Pune City,1306,5,4,5,5,13,15,-2,17
Chennaiyin,1306,6,4,5,5,15,19,-4,17
FC Goa,1306,7,4,3,7,10,18,-8,15
NorthEast Un,1306,8,4,2,8,11,14,-3,14
Delhi Dynamo,1307,1,6,6,2,27,15,12,24
Mumbai City,1307,2,6,5,3,17,9,8,23
Kerala Blast,1307,3,6,4,4,15,13,2,22
Kolkata,1307,4,5,6,3,17,16,1,21
NorthEast Un,1307,5,5,2,7,10,15,-5,17
FC Pune City,1307,6,4,4,6,13,17,-4,16
Chennaiyin,1307,7,3,6,5,16,21,-5,15
FC Goa,1307,8,3,3,8,11,20,-9,12
Mumbai City,1308,1,7,4,3,18,8,10,25
Kolkata,1308,2,5,7,2,17,14,3,22
Delhi Dynamo,1308,3,5,5,4,22,18,4,20
FC Pune City,1308,4,5,3,6,16,16,0,18
Chennaiyin,1308,5,4,6,4,17,20,-3,18
NorthEast Un,1308,6,4,4,6,12,13,-1,16
Kerala Blast,1308,7,4,4,6,11,19,-8,16
FC Goa,1308,8,4,3,7,11,16,-5,15
Mumbai City,1309,1,6,5,3,18,10,8,23
Kolkata,1309,2,5,6,3,18,13,5,21
Delhi Dynamo,1309,3,4,7,3,23,17,6,19
NorthEast Un,1309,4,5,4,5,11,10,1,19
FC Pune City,1309,5,5,4,5,13,14,-1,19
Kerala Blast,1309,6,4,5,5,9,15,-6,17
Chennaiyin,1309,7,3,6,5,15,20,-5,15
FC Goa,1309,8,4,3,7,10,18,-8,15
Mumbai City,1310,1,6,5,3,16,8,8,23
Delhi Dynamo,1310,2,5,6,3,25,18,7,21
NorthEast Un,1310,3,6,2,6,16,15,1,20
FC Pune City,1310,4,5,4,5,15,15,0,19
Kerala Blast,1310,5,5,4,5,15,19,-4,19
Kolkata,1310,6,4,6,4,16,17,-1,18
Chennaiyin,1310,7,3,6,5,14,19,-5,15
FC Goa,1310,8,4,3,7,10,16,-6,15
Delhi Dynamo,1311,1,7,5,2,28,17,11,26
Mumbai City,1311,2,6,4,4,18,11,7,22
Chennaiyin,1311,3,5,5,4,16,18,-2,20
FC Pune City,1311,4,5,4,5,13,14,-1,19
Kolkata,1311,5,4,6,4,15,16,-1,18
Kerala Blast,1311,6,4,5,5,10,15,-5,17
NorthEast Un,1311,7,4,3,7,11,13,-2,15
FC Goa,1311,8,4,2,8,12,19,-7,14
Kolkata,1312,1,6,6,2,20,14,6,24
Mumbai City,1312,2,6,5,3,17,9,8,23
NorthEast Un,1312,3,6,3,5,13,10,3,21
Delhi Dynamo,1312,4,4,7,3,22,16,6,19
Kerala Blast,1312,5,4,5,5,10,17,-7,17
FC Pune City,1312,6,4,4,6,14,17,-3,16
Chennaiyin,1312,7,3,6,5,15,21,-6,15
FC Goa,1312,8,3,4,7,10,17,-7,13
Mumbai City,1313,1,6,5,3,16,8,8,23
Delhi Dynamo,1313,2,5,7,2,24,14,10,22
Kolkata,1313,3,4,8,2,16,14,2,20
Kerala Blast,1313,4,5,4,5,18,18,0,19
FC Pune City,1313,5,5,4,5,17,17,0,19
Chennaiyin,1313,6,4,5,5,18,21,-3,17
NorthEast Un,1313,7,4,3,7,10,19,-9,15
FC Goa,1313,8,4,2,8,11,19,-8,14
Mumbai City,1314,1,7,4,3,20,9,11,25
Kerala Blast,1314,2,7,3,4,15,14,1,24
Delhi Dynamo,1314,3,5,6,3,25,19,6,21
Kolkata,1314,4,5,6,3,15,14,1,21
NorthEast Un,1314,5,5,2,7,13,13,0,17
Chennaiyin,1314,6,4,5,5,14,20,-6,17
FC Pune City,1314,7,4,3,7,12,17,-5,15
FC Goa,1314,8,3,3,8,9,17,-8,12
Mumbai City,1315,1,6,4,4,16,9,7,22
NorthEast Un,1315,2,6,2,6,17,12,5,20
Delhi Dynamo,1315,3,5,5,4,22,19,3,20
FC Goa,1315,4,6,2,6,11,14,-3,20
Kolkata,1315,5,4,7,3,15,14,1,19
Kerala Blast,1315,6,5,4,5,13,18,-5,19
Chennaiyin,1315,7,4,5,5,15,19,-4,17
FC Pune City,1315,8,4,3,7,13,17,-4,15
Mumbai City,1316,1,7,4,3,17,8,9,25
Kolkata,1316,2,6,6,2,17,13,4,24
Delhi Dynamo,1316,3,5,5,4,25,20,5,20
NorthEast Un,1316,4,6,2,6,14,10,4,20
Chennaiyin,1316,5,4,6,4,16,19,-3,18
FC Pune City,1316,6,4,4,6,12,15,-3,16
Kerala Blast,1316,7,4,4,6,9,16,-7,16
FC Goa,1316,8,3,3,8,13,22,-9,12
Mumbai City,1317,1,7,4,3,19,8,11,25
Kolkata,1317,2,5,7,2,18,15,3,22
Delhi Dynamo,1317,3,5,5,4,23,19,4,20
Chennaiyin,1317,4,5,5,4,19,19,0,20
NorthEast Un,1317,5,5,2,7,14,15,-1,17
FC Pune City,1317,6,4,5,5,17,19,-2,17
Kerala Blast,1317,7,4,4,6,13,19,-6,16
FC Goa,1317,8,4,2,8,10,19,-9,14
Kolkata,1318,1,6,6,2,20,14,6,24
Delhi Dynamo,1318,2,6,5,3,27,19,8,23
Mumbai City,1318,3,6,4,4,17,10,7,22
NorthEast Un,1318,4,6,2,6,14,13,1,20
FC Pune City,1318,5,5,3,6,16,18,-2,18
FC Goa,1318,6,5,2,7,12,17,-5,17
Kerala Blast,1318,7,4,3,7,11,20,-9,15
Chennaiyin,1318,8,3,5,6,13,19,-6,14
Mumbai City,1319,1,6,4,4,17,10,7,22
NorthEast Un,1319,2,6,3,5,13,9,4,21
Delhi Dynamo,1319,3,5,5,4,23,18,5,20
FC Goa,1319,4,6,2,6,14,15,-1,20
Kolkata,1319,5,4,7,3,16,14,2,19
Kerala Blast,1319,6,4,5,5,10,17,-7,17
FC Pune City,1319,7,4,4,6,13,17,-4,16
Chennaiyin,1319,8,3,6,5,13,19,-6,15
Mumbai City,1320,1,6,5,3,16,8,8,23
Delhi Dynamo,1320,2,5,7,2,25,16,9,22
Kolkata,1320,3,5,7,2,16,13,3,22
NorthEast Un,1320,4,5,4,5,13,12,1,19
FC Pune City,1320,5,5,3,6,14,16,-2,18
Chennaiyin,1320,6,4,5,5,16,20,-4,17
Kerala Blast,1320,7,4,5,5,9,14,-5,17
FC Goa,1320,8,3,2,9,9,19,-10,11
Delhi Dynamo,1321,1,6,6,2,24,15,9,24
Mumbai City,1321,2,6,4,4,16,9,7,22
FC Pune City,1321,3,6,3,5,18,17,1,21
Kolkata,1321,4,4,7,3,16,16,0,19
Kerala Blast,1321,5,5,4,5,11,15,-4,19
NorthEast Un,1321,6,4,4,6,11,12,-1,16
Chennaiyin,1321,7,3,6,5,17,22,-5,15
FC Goa,1321,8,4,2,8,12,19,-7,14
Kerala Blast,1322,1,7,3,4,17,15,2,24
Mumbai City,1322,2,6,5,3,18,10,8,23
Delhi Dynamo,1322,3,4,8,2,26,19,7,20
Chennaiyin,1322,4,5,5,4,15,17,-2,20
Kolkata,1322,5,3,8,3,18,20,-2,17
FC Pune City,1322,6,4,4,6,15,18,-3,16
NorthEast Un,1322,7,4,3,7,11,14,-3,15
FC Goa,1322,8,3,4,7,11,18,-7,13
Mumbai City,1323,1,7,4,3,18,9,9,25
Delhi Dynamo,1323,2,5,6,3,26,18,8,21
Chennaiyin,1323,3,5,5,4,15,17,-2,20
Kolkata,1323,4,4,7,3,16,16,0,19
Kerala Blast,1323,5,4,6,4,11,15,-4,18
NorthEast Un,1323,6,4,4,6,12,13,-1,16
FC Pune City,1323,7,4,4,6,13,16,-3,16
FC Goa,1323,8,4,2,8,12,19,-7,14
Delhi Dynamo,1324,1,6,6,2,30,17,13,24
Mumbai City,1324,2,6,5,3,18,10,8,23
Kolkata,1324,3,4,7,3,17,17,0,19
FC Pune City,1324,4,5,4,5,15,16,-1,19
NorthEast Un,1324,5,5,3,6,14,15,-1,18
Chennaiyin,1324,6,4,6,4,19,22,-3,18
Kerala Blast,1324,7,4,3,7,9,17,-8,15
FC Goa,1324,8,4,2,8,13,21,-8,14
Mumbai City,1325,1,7,4,3,19,9,10,25
Kerala Blast,1325,2,6,4,4,13,15,-2,22
Delhi Dynamo,1325,3,5,5,4,24,19,5,20
Chennaiyin,1325,4,5,5,4,16,17,-1,20
Kolkata,1325,5,4,7,3,17,16,1,19
FC Pune City,1325,6,5,3,6,14,16,-2,18
NorthEast Un,1325,7,5,2,7,12,12,0,17
FC Goa,1325,8,3,2,9,9,20,-11,11
Delhi Dynamo,1326,1,6,5,3,29,20,9,23
Mumbai City,1326,2,6,4,4,19,12,7,22
Kerala Blast,1326,3,6,4,4,13,15,-2,22
Kolkata,1326,4,4,8,2,15,13,2,20
NorthEast Un,1326,5,5,3,6,12,12,0,18
Chennaiyin,1326,6,4,6,4,17,19,-2,18
FC Pune City,1326,7,4,3,7,13,17,-4,15
FC Goa,1326,8,3,3,8,12,22,-10,12
Delhi Dynamo,1327,1,6,6,2,28,15,13,24
Mumbai City,1327,2,6,4,4,16,11,5,22
Kerala Blast,1327,3,6,4,4,15,15,0,22
Kolkata,1327,4,4,7,3,18,16,2,19
Chennaiyin,1327,5,4,6,4,15,18,-3,18
NorthEast Un,1327,6,4,3,7,11,14,-3,15
FC Pune City,1327,7,4,3,7,12,18,-6,15
FC Goa,1327,8,4,3,7,12,20,-8,15
Mumbai City,1328,1,6,5,3,17,9,8,23
Delhi Dynamo,1328,2,4,8,2,28,21,7,20
FC Pune City,1328,3,5,4,5,14,15,-1,19
Kerala Blast,1328,4,5,4,5,13,15,-2,19
Chennaiyin,1328,5,4,6,4,16,19,-3,18
NorthEast Un,1328,6,4,5,5,12,12,0,17
Kolkata,1328,7,3,8,3,15,17,-2,17
FC Goa,1328,8,3,4,7,15,22,-7,13
Delhi Dynamo,1329,1,6,6,2,23,14,9,24
Mumbai City,1329,2,6,5,3,16,8,8,23
Kerala Blast,1329,3,6,4,4,13,15,-2,22
Kolkata,1329,4,4,8,2,18,15,3,20
Chennaiyin,1329,5,5,5,4,17,19,-2,20
FC Pune City,1329,6,4,3,7,13,18,-5,15
NorthEast Un,1329,7,4,2,8,11,14,-3,14
FC Goa,1329,8,3,3,8,12,20,-8,12
Mumbai City,1330,1,7,4,3,19,8,11,25
Delhi Dynamo,1330,2,5,6,3,23,18,5,21
Kolkata,1330,3,4,8,2,17,13,4,20
FC Pune City,1330,4,5,4,5,16,15,1,19
NorthEast Un,1330,5,5,3,6,12,11,1,18
Kerala Blast,1330,6,4,4,6,9,19,-10,16
Chennaiyin,1330,7,3,6,5,13,19,-6,15
FC Goa,1330,8,3,5,6,8,14,-6,14
Mumbai City,1331,1,7,4,3,18,9,9,25
FC Pune City,1331,2,6,3,5,14,14,0,21
Delhi Dynamo,1331,3,5,5,4,25,18,7,20
Kolkata,1331,4,4,6,4,15,15,0,18
Kerala Blast,1331,5,5,3,6,12,17,-5,18
NorthEast Un,1331,6,5,2,7,12,15,-3,17
Chennaiyin,1331,7,4,5,5,15,19,-4,17
FC Goa,1331,8,5,2,7,12,16,-4,17
Mumbai City,1332,1,7,4,3,18,9,9,25
FC Pune City,1332,2,6,3,5,18,16,2,21
Delhi Dynamo,1332,3,5,5,4,25,20,5,20
Chennaiyin,1332,4,5,5,4,17,19,-2,20
Kolkata,1332,5,4,7,3,18,19,-1,19
NorthEast Un,1332,6,5,3,6,14,13,1,18
Kerala Blast,1332,7,4,5,5,14,19,-5,17
FC Goa,1332,8,3,2,9,10,19,-9,11
Mumbai City,1333,1,6,5,3,17,9,8,23
Kolkata,1333,2,5,6,3,18,14,4,21
NorthEast Un,1333,3,6,2,6,11,10,1,20
Delhi Dynamo,1333,4,4,7,3,23,17,6,19
FC Pune City,1333,5,5,3,6,14,16,-2,18
Chennaiyin,1333,6,4,6,4,14,17,-3,18
FC Goa,1333,7,4,4,6,11,16,-5,16
Kerala Blast,1333,8,4,3,7,10,19,-9,15
Mumbai City,1334,1,6,5,3,16,8,8,23
Kerala Blast,1334,2,6,4,4,14,15,-1,22
Delhi Dynamo,1334,3,4,8,2,22,15,7,20
Kolkata,1334,4,4,7,3,15,15,0,19
Chennaiyin,1334,5,4,6,4,17,20,-3,18
FC Pune City,1334,6,4,5,5,14,16,-2,17
NorthEast Un,1334,7,4,4,6,12,13,-1,16
FC Goa,1334,8,3,3,8,10,18,-8,12
Mumbai City,1335,1,7,4,3,20,8,12,25
Kerala Blast,1335,2,7,3,4,15,14,1,24
Delhi Dynamo,1335,3,5,5,4,23,22,1,20
FC Pune City,1335,4,5,3,6,16,18,-2,18
NorthEast Un,1335,5,5,2,7,12,12,0,17
Chennaiyin,1335,6,4,5,5,14,18,-4,17
FC Goa,1335,7,5,2,7,13,17,-4,17
Kolkata,1335,8,3,6,5,16,20,-4,15
Delhi Dynamo,1336,1,6,6,2,27,16,11,24
Kolkata,1336,2,6,6,2,22,15,7,24
Mumbai City,1336,3,6,4,4,16,9,7,22
Kerala Blast,1336,4,5,4,5,11,16,-5,19
NorthEast Un,1336,5,5,3,6,12,14,-2,18
Chennaiyin,1336,6,4,5,5,17,20,-3,17
FC Pune City,1336,7,4,3,7,12,18,-6,15
FC Goa,1336,8,3,3,8,12,21,-9,12
Delhi Dynamo,1337,1,7,5,2,26,15,11,26
Mumbai City,1337,2,6,4,4,16,10,6,22
NorthEast Un,1337,3,6,2,6,15,13,2,20
Kolkata,1337,4,4,7,3,14,13,1,19
FC Pune City,1337,5,5,4,5,14,14,0,19
Kerala Blast,1337,6,5,3,6,11,17,-6,18
Chennaiyin,1337,7,3,5,6,14,21,-7,14
FC Goa,1337,8,4,2,8,9,16,-7,14
Delhi Dynamo,1338,1,7,5,2,32,19,13,26
Mumbai City,1338,2,6,4,4,18,13,5,22
Kerala Blast,1338,3,6,4,4,14,14,0,22
Kolkata,1338,4,5,6,3,19,15,4,21
Chennaiyin,1338,5,5,5,4,17,19,-2,20
NorthEast Un,1338,6,4,3,7,13,15,-2,15
FC Pune City,1338,7,4,3,7,12,20,-8,15
FC Goa,1338,8,3,2,9,11,21,-10,11
Mumbai City,1339,1,7,4,3,18,8,10,25
Delhi Dynamo,1339,2,5,5,4,23,17,6,20
Kolkata,1339,3,4,7,3,15,14,1,19
FC Pune City,1339,4,5,4,5,13,14,-1,19
NorthEast Un,1339,5,5,3,6,11,12,-1,18
Chennaiyin,1339,6,4,6,4,20,22,-2,18
Kerala Blast,1339,7,4,5,5,9,14,-5,17
FC Goa,1339,8,3,4,7,13,21,-8,13
Mumbai City,1340,1,7,4,3,19,9,10,25
Delhi Dynamo,1340,2,5,6,3,26,18,8,21
Kolkata,1340,3,5,6,3,20,17,3,21
Kerala Blast,1340,4,5,5,4,14,17,-3,20
NorthEast Un,1340,5,4,5,5,13,13,0,17
FC Pune City,1340,6,4,4,6,15,18,-3,16
Chennaiyin,1340,7,3,7,4,15,19,-4,16
FC Goa,1340,8,3,3,8,8,19,-11,12
Mumbai City,1341,1,7,4,3,18,9,9,25
Kerala Blast,1341,2,6,3,5,16,15,1,21
Kolkata,1341,3,4,8,2,16,13,3,20
Delhi Dynamo,1341,4,4,7,3,23,17,6,19
Chennaiyin,1341,5,4,5,5,15,21,-6,17
FC Goa,1341,6,4,4,6,12,15,-3,16
FC Pune City,1341,7,4,4,6,13,18,-5,16
NorthEast Un,1341,8,4,3,7,10,15,-5,15
Mumbai City,1342,1,7,4,3,18,9,9,25
Delhi Dynamo,1342,2,6,5,3,25,16,9,23
Kerala Blast,1342,3,6,3,5,14,18,-4,21
FC Pune City,1342,4,5,4,5,16,16,0,19
Kolkata,1342,5,3,8,3,15,15,0,17
NorthEast Un,1342,6,5,2,7,10,11,-1,17
FC Goa,1342,7,4,3,7,12,18,-6,15
Chennaiyin,1342,8,3,5,6,14,21,-7,14
Kolkata,1343,1,6,6,2,19,12,7,24
Mumbai City,1343,2,6,5,3,16,8,8,23
Delhi Dynamo,1343,3,5,7,2,24,15,9,22
NorthEast Un,1343,4,6,3,5,15,10,5,21
FC Pune City,1343,5,4,4,6,13,17,-4,16
Kerala Blast,1343,6,4,4,6,11,21,-10,16
FC Goa,1343,7,4,2,8,11,18,-7,14
Chennaiyin,1343,8,3,5,6,13,21,-8,14
Delhi Dynamo,1344,1,6,6,2,26,17,9,24
Mumbai City,1344,2,6,4,4,16,9,7,22
Kolkata,1344,3,5,7,2,18,13,5,22
NorthEast Un,1344,4,5,3,6,11,11,0,18
Kerala Blast,1344,5,4,6,4,9,13,-4,18
FC Pune City,1344,6,4,4,6,13,18,-5,16
FC Goa,1344,7,4,3,7,11,17,-6,15
Chennaiyin,1344,8,3,5,6,13,19,-6,14
Mumbai City,1345,1,6,5,3,16,8,8,23
Delhi Dynamo,1345,2,5,7,2,23,15,8,22
Kerala Blast,1345,3,6,3,5,14,15,-1,21
Kolkata,1345,4,4,7,3,16,15,1,19
FC Pune City,1345,5,5,3,6,15,19,-4,18
FC Goa,1345,6,4,4,6,10,15,-5,16
NorthEast Un,1345,7,4,3,7,10,12,-2,15
Chennaiyin,1345,8,3,6,5,13,18,-5,15
Mumbai City,1346,1,6,5,3,16,8,8,23
Kerala Blast,1346,2,6,3,5,11,16,-5,21
Delhi Dynamo,1346,3,4,8,2,21,14,7,20
Chennaiyin,1346,4,5,5,4,15,17,-2,20
Kolkata,1346,5,4,7,3,18,15,3,19
FC Pune City,1346,6,4,4,6,13,16,-3,16
NorthEast Un,1346,7,4,3,7,9,11,-2,15
FC Goa,1346,8,4,3,7,10,16,-6,15
Mumbai City,1347,1,7,4,3,19,8,11,25
NorthEast Un,1347,2,6,3,5,15,12,3,21
Delhi Dynamo,1347,3,5,5,4,26,21,5,20
FC Pune City,1347,4,5,4,5,15,15,0,19
Kerala Blast,1347,5,4,5,5,10,16,-6,17
Kolkata,1347,6,3,7,4,15,17,-2,16
Chennaiyin,1347,7,3,7,4,18,22,-4,16
FC Goa,1347,8,4,3,7,14,21,-7,15
Mumbai City,1348,1,6,5,3,16,8,8,23
Delhi Dynamo,1348,2,5,6,3,25,16,9,21
Chennaiyin,1348,3,5,5,4,19,19,0,20
Kolkata,1348,4,4,7,3,16,17,-1,19
NorthEast Un,1348,5,5,3,6,12,14,-2,18
FC Pune City,1348,6,4,5,5,13,15,-2,17
Kerala Blast,1348,7,4,5,5,10,15,-5,17
FC Goa,1348,8,4,2,8,12,19,-7,14
Delhi Dynamo,1349,1,5,7,2,26,16,10,22
Mumbai City,1349,2,6,4,4,16,11,5,22
Kolkata,1349,3,5,6,3,16,14,2,21
Kerala Blast,1349,4,6,3,5,13,17,-4,21
NorthEast Un,1349,5,5,4,5,13,11,2,19
FC Pune City,1349,6,4,3,7,13,17,-4,15
FC Goa,1349,7,4,3,7,11,16,-5,15
Chennaiyin,1349,8,3,6,5,14,20,-6,15
Delhi Dynamo,1350,1,6,6,2,26,15,11,24
Mumbai City,1350,2,6,5,3,17,9,8,23
Kerala Blast,1350,3,5,4,5,12,15,-3,19
Chennaiyin,1350,4,4,6,4,17,18,-1,18
Kolkata,1350,5,4,6,4,14,15,-1,18
FC Pune City,1350,6,5,3,6,13,15,-2,18
NorthEast Un,1350,7,4,3,7,10,15,-5,15
FC Goa,1350,8,4,3,7,10,17,-7,15
Delhi Dynamo,1351,1,7,5,2,27,15,12,26
Mumbai City,1351,2,6,4,4,16,9,7,22
Kolkata,1351,3,5,6,3,16,15,1,21
Kerala Blast,1351,4,5,4,5,13,15,-2,19
FC Pune City,1351,5,5,3,6,14,17,-3,18
Chennaiyin,1351,6,4,5,5,15,18,-3,17
NorthEast Un,1351,7,4,3,7,9,14,-5,15
FC Goa,1351,8,4,2,8,10,17,-7,14
Mumbai City,1352,1,7,4,3,19,9,10,25
Delhi Dynamo,1352,2,6,5,3,25,17,8,23
Kolkata,1352,3,4,6,4,19,17,2,18
NorthEast Un,1352,4,5,3,6,11,12,-1,18
FC Pune City,1352,5,5,3,6,14,16,-2,18
Kerala Blast,1352,6,5,3,6,12,19,-7,18
FC Goa,1352,7,5,2,7,11,16,-5,17
Chennaiyin,1352,8,3,6,5,15,20,-5,15
Delhi Dynamo,1353,1,6,6,2,27,17,10,24
Mumbai City,1353,2,6,4,4,17,10,7,22
NorthEast Un,1353,3,6,3,5,15,13,2,21
Kerala Blast,1353,4,6,3,5,13,16,-3,21
FC Pune City,1353,5,5,3,6,14,16,-2,18
Chennaiyin,1353,6,4,5,5,17,19,-2,17
Kolkata,1353,7,3,7,4,14,15,-1,16
FC Goa,1353,8,3,3,8,9,20,-11,12
Delhi Dynamo,1354,1,6,6,2,26,17,9,24
Mumbai City,1354,2,6,4,4,19,12,7,22
Kerala Blast,1354,3,5,5,4,13,15,-2,20
Kolkata,1354,4,4,7,3,14,13,1,19
NorthEast Un,1354,5,5,3,6,11,11,0,18
FC Pune City,1354,6,5,3,6,14,17,-3,18
FC Goa,1354,7,4,3,7,9,15,-6,15
Chennaiyin,1354,8,3,5,6,13,19,-6,14
Mumbai City,1355,1,7,4,3,17,8,9,25
Delhi Dynamo,1355,2,6,5,3,27,16,11,23
Kolkata,1355,3,4,7,3,16,15,1,19
Kerala Blast,1355,4,5,4,5,12,16,-4,19
FC Pune City,1355,5,5,3,6,14,16,-2,18
NorthEast Un,1355,6,5,3,6,13,15,-2,18
Chennaiyin,1355,7,3,7,4,14,18,-4,16
FC Goa,1355,8,3,3,8,10,19,-9,12
Delhi Dynamo,1356,1,6,5,3,27,18,9,23
Mumbai City,1356,2,6,4,4,16,10,6,22
Kolkata,1356,3,5,6,3,19,15,4,21
Kerala Blast,1356,4,6,3,5,16,18,-2,21
FC Pune City,1356,5,5,3,6,15,19,-4,18
Chennaiyin,1356,6,4,5,5,15,19,-4,17
FC Goa,1356,7,5,2,7,14,19,-5,17
NorthEast Un,1356,8,4,2,8,11,15,-4,14
Mumbai City,1357,1,7,4,3,19,8,11,25
NorthEast Un,1357,2,6,2,6,15,14,1,20
Kerala Blast,1357,3,5,4,5,14,17,-3,19
Delhi Dynamo,1357,4,4,6,4,23,20,3,18
Chennaiyin,1357,5,4,6,4,18,21,-3,18
FC Pune City,1357,6,5,3,6,15,18,-3,18
Kolkata,1357,7,3,7,4,15,18,-3,16
FC Goa,1357,8,4,4,6,14,17,-3,16
Mumbai City,1358,1,7,4,3,18,9,9,25
Kolkata,1358,2,4,7,3,20,15,5,19
NorthEast Un,1358,3,5,4,5,13,12,1,19
FC Pune City,1358,4,5,4,5,15,16,-1,19
FC Goa,1358,5,5,3,6,11,14,-3,18
Delhi Dynamo,1358,6,4,5,5,22,18,4,17
Kerala Blast,1358,7,4,5,5,14,23,-9,17
Chennaiyin,1358,8,3,6,5,13,19,-6,15
Mumbai City,1359,1,7,4,3,19,9,10,25
Kerala Blast,1359,2,6,4,4,16,17,-1,22
Chennaiyin,1359,3,5,5,4,16,18,-2,20
Delhi Dynamo,1359,4,4,7,3,22,17,5,19
Kolkata,1359,5,4,7,3,17,16,1,19
FC Pune City,1359,6,4,4,6,15,18,-3,16
NorthEast Un,1359,7,4,3,7,11,14,-3,15
FC Goa,1359,8,3,4,7,9,16,-7,13
Mumbai City,1360,1,6,5,3,17,9,8,23
Delhi Dynamo,1360,2,5,6,3,25,16,9,21
FC Pune City,1360,3,6,3,5,16,15,1,21
NorthEast Un,1360,4,5,4,5,11,10,1,19
FC Goa,1360,5,5,2,7,14,19,-5,17
Kerala Blast,1360,6,4,5,5,11,16,-5,17
Kolkata,1360,7,3,7,4,16,18,-2,16
Chennaiyin,1360,8,3,6,5,14,21,-7,15
Delhi Dynamo,1361,1,6,5,3,25,17,8,23
Mumbai City,1361,2,6,4,4,16,10,6,22
FC Pune City,1361,3,6,3,5,16,14,2,21
Kerala Blast,1361,4,5,4,5,10,15,-5,19
FC Goa,1361,5,5,3,6,13,15,-2,18
Kolkata,1361,6,3,8,3,14,15,-1,17
Chennaiyin,1361,7,4,5,5,15,19,-4,17
NorthEast Un,1361,8,4,2,8,10,14,-4,14
Mumbai City,1362,1,6,5,3,17,9,8,23
Delhi Dynamo,1362,2,4,8,2,25,18,7,20
NorthEast Un,1362,3,5,3,6,14,13,1,18
FC Goa,1362,4,5,3,6,12,15,-3,18
Kolkata,1362,5,3,8,3,15,15,0,17
FC Pune City,1362,6,4,5,5,15,17,-2,17
Chennaiyin,1362,7,4,5,5,15,19,-4,17
Kerala Blast,1362,8,4,5,5,10,17,-7,17
Delhi Dynamo,1363,1,6,6,2,25,16,9,24
Mumbai City,1363,2,6,4,4,16,9,7,22
Kerala Blast,1363,3,6,3,5,11,14,-3,21
Kolkata,1363,4,4,6,4,15,15,0,18
Chennaiyin,1363,5,4,6,4,15,17,-2,18
FC Pune City,1363,6,5,3,6,14,16,-2,18
NorthEast Un,1363,7,4,3,7,11,14,-3,15
FC Goa,1363,8,4,3,7,9,15,-6,15
Mumbai City,1364,1,7,4,3,20,9,11,25
Delhi Dynamo,1364,2,6,5,3,27,21,6,23
Kerala Blast,1364,3,6,3,5,14,16,-2,21
NorthEast Un,1364,4,6,2,6,15,13,2,20
Kolkata,1364,5,4,6,4,17,18,-1,18
Chennaiyin,1364,6,4,5,5,15,19,-4,17
FC Pune City,1364,7,4,3,7,14,19,-5,15
FC Goa,1364,8,4,2,8,11,18,-7,14
Mumbai City,1365,1,7,4,3,17,8,9,25
FC Pune City,1365,2,6,3,5,15,14,1,21
NorthEast Un,1365,3,6,2,6,12,11,1,20
Chennaiyin,1365,4,5,5,4,17,18,-1,20
Kolkata,1365,5,4,6,4,15,16,-1,18
Delhi Dynamo,1365,6,4,5,5,21,19,2,17
FC Goa,1365,7,5,2,7,12,16,-4,17
Kerala Blast,1365,8,4,3,7,10,17,-7,15
Mumbai City,1366,1,7,4,3,17,8,9,25
Kolkata,1366,2,5,7,2,22,14,8,22
Kerala Blast,1366,3,6,4,4,16,16,0,22
Delhi Dynamo,1366,4,4,7,3,22,16,6,19
NorthEast Un,1366,5,5,3,6,12,10,2,18
Chennaiyin,1366,6,4,5,5,15,20,-5,17
FC Pune City,1366,7,4,3,7,13,19,-6,15
FC Goa,1366,8,3,3,8,9,23,-14,12
Mumbai City,1367,1,6,5,3,16,8,8,23
Delhi Dynamo,1367,2,5,7,2,24,15,9,22
Kolkata,1367,3,5,6,3,18,15,3,21
FC Goa,1367,4,5,3,6,12,15,-3,18
Kerala Blast,1367,5,5,3,6,11,18,-7,18
NorthEast Un,1367,6,5,2,7,12,14,-2,17
Chennaiyin,1367,7,4,5,5,16,20,-4,17
FC Pune City,1367,8,4,3,7,13,17,-4,15
Mumbai City,1368,1,6,5,3,17,9,8,23
Delhi Dynamo,1368,2,5,6,3,23,17,6,21
Kerala Blast,1368,3,6,3,5,12,15,-3,21
NorthEast Un,1368,4,6,2,6,13,11,2,20
Kolkata,1368,5,4,6,4,17,17,0,18
FC Pune City,1368,6,5,3,6,14,15,-1,18
Chennaiyin,1368,7,4,5,5,15,19,-4,17
FC Goa,1368,8,4,2,8,10,18,-8,14
Mumbai City,1369,1,6,5,3,17,9,8,23
Delhi Dynamo,1369,2,5,6,3,24,17,7,21
Kerala Blast,1369,3,5,5,4,13,14,-1,20
NorthEast Un,1369,3,6,2,6,13,14,-1,20
FC Pune City,1369,5,5,4,5,14,15,-1,19
Kolkata,1369,6,3,8,3,14,14,0,17
FC Goa,1369,7,4,3,7,11,17,-6,15
Chennaiyin,1369,8,3,5,6,15,21,-6,14
Mumbai City,1370,1,7,4,3,18,8,10,25
Kolkata,1370,2,5,6,3,17,15,2,21
FC Goa,1370,3,6,2,6,13,15,-2,20
Delhi Dynamo,1370,4,4,6,4,22,18,4,18
NorthEast Un,1370,5,5,3,6,12,14,-2,18
Chennaiyin,1370,6,4,5,5,17,19,-2,17
FC Pune City,1370,7,4,4,6,12,16,-4,16
Kerala Blast,1370,8,4,4,6,11,17,-6,16
Mumbai City,1371,1,7,4,3,18,9,9,25
FC Pune City,1371,2,6,3,5,16,15,1,21
Kerala Blast,1371,3,6,3,5,11,15,-4,21
Delhi Dynamo,1371,4,5,5,4,25,19,6,20
Chennaiyin,1371,5,5,5,4,18,20,-2,20
NorthEast Un,1371,6,5,2,7,13,12,1,17
Kolkata,1371,7,3,7,4,14,15,-1,16
FC Goa,1371,8,3,3,8,10,20,-10,12
Delhi Dynamo,1372,1,6,5,3,25,15,10,23
Mumbai City,1372,2,6,4,4,16,10,6,22
Kolkata,1372,3,5,6,3,19,14,5,21
Chennaiyin,1372,4,5,5,4,18,17,1,20
Kerala Blast,1372,5,5,4,5,11,18,-7,19
NorthEast Un,1372,6,5,2,7,11,13,-2,17
FC Pune City,1372,7,4,4,6,12,15,-3,16
FC Goa,1372,8,4,2,8,10,20,-10,14
Mumbai City,1373,1,7,4,3,18,9,9,25
Kolkata,1373,2,5,6,3,20,16,4,21
Delhi Dynamo,1373,3,5,5,4,25,19,6,20
NorthEast Un,1373,4,6,2,6,11,10,1,20
Kerala Blast,1373,5,5,4,5,11,17,-6,19
Chennaiyin,1373,6,4,5,5,14,18,-4,17
FC Pune City,1373,7,4,4,6,12,17,-5,16
FC Goa,1373,8,4,2,8,13,18,-5,14
Mumbai City,1374,1,6,5,3,17,9,8,23
Delhi Dynamo,1374,2,5,6,3,25,18,7,21
Kolkata,1374,3,5,6,3,18,16,2,21
NorthEast Un,1374,4,6,2,6,13,11,2,20
FC Pune City,1374,5,5,3,6,15,16,-1,18
Kerala Blast,1374,6,5,3,6,12,17,-5,18
Chennaiyin,1374,7,4,5,5,15,19,-4,17
FC Goa,1374,8,4,2,8,11,20,-9,14
Mumbai City,1375,1,7,4,3,19,9,10,25
Delhi Dynamo,1375,2,6,5,3,25,17,8,23
FC Pune City,1375,3,5,4,5,13,14,-1,19
Kolkata,1375,4,3,8,3,13,13,0,17
Chennaiyin,1375,5,4,5,5,15,19,-4,17
FC Goa,1375,6,5,2,7,11,16,-5,17
Kerala Blast,1375,7,4,5,5,10,15,-5,17
NorthEast Un,1375,8,4,3,7,10,13,-3,15
Kolkata,1376,1,6,6,2,18,12,6,24
Mumbai City,1376,2,6,5,3,16,8,8,23
Delhi Dynamo,1376,3,4,8,2,24,17,7,20
Chennaiyin,1376,4,4,6,4,18,17,1,18
FC Pune City,1376,5,5,3,6,16,17,-1,18
NorthEast Un,1376,6,4,4,6,12,17,-5,16
Kerala Blast,1376,7,4,4,6,10,19,-9,16
FC Goa,1376,8,3,4,7,8,15,-7,13
Mumbai City,1377,1,7,4,3,18,9,9,25
Delhi Dynamo,1377,2,6,5,3,26,17,9,23
Kolkata,1377,3,5,6,3,19,16,3,21
NorthEast Un,1377,4,6,2,6,12,12,0,20
Kerala Blast,1377,5,5,3,6,12,17,-5,18
Chennaiyin,1377,6,4,5,5,14,18,-4,17
FC Pune City,1377,7,4,3,7,13,19,-6,15
FC Goa,1377,8,4,2,8,11,17,-6,14
Mumbai City,1378,1,7,4,3,19,9,10,25
FC Pune City,1378,2,6,3,5,16,15,1,21
Kolkata,1378,3,4,7,3,15,15,0,19
NorthEast Un,1378,4,5,3,6,14,14,0,18
FC Goa,1378,5,5,3,6,13,17,-4,18
Delhi Dynamo,1378,6,4,5,5,25,22,3,17
Chennaiyin,1378,7,4,5,5,15,19,-4,17
Kerala Blast,1378,8,4,4,6,14,20,-6,16
Delhi Dynamo,1379,1,6,5,3,31,17,14,23
Mumbai City,1379,2,6,4,4,17,13,4,22
NorthEast Un,1379,3,6,3,5,14,12,2,21
Kerala Blast,1379,4,5,5,4,12,15,-3,20
FC Pune City,1379,5,5,4,5,15,16,-1,19
Kolkata,1379,6,3,6,5,14,16,-2,15
Chennaiyin,1379,7,3,6,5,16,21,-5,15
FC Goa,1379,8,4,3,7,11,20,-9,15
Mumbai City,1380,1,7,4,3,18,8,10,25
Delhi Dynamo,1380,2,5,6,3,25,19,6,21
Kolkata,1380,3,5,6,3,18,17,1,21
Chennaiyin,1380,4,4,6,4,14,17,-3,18
NorthEast Un,1380,5,4,5,5,10,10,0,17
Kerala Blast,1380,6,4,5,5,11,16,-5,17
FC Pune City,1380,7,4,4,6,13,16,-3,16
FC Goa,1380,8,4,2,8,14,20,-6,14
Mumbai City,1381,1,6,4,4,18,11,7,22
Kerala Blast,1381,2,6,4,4,14,15,-1,22
NorthEast Un,1381,3,6,3,5,16,14,2,21
Delhi Dynamo,1381,4,5,5,4,25,20,5,20
Kolkata,1381,5,4,7,3,20,16,4,19
FC Goa,1381,6,5,3,6,14,16,-2,18
FC Pune City,1381,7,4,3,7,12,20,-8,15
Chennaiyin,1381,8,3,5,6,16,23,-7,14
Mumbai City,1382,1,6,5,3,17,9,8,23
Kerala Blast,1382,2,5,5,4,16,16,0,20
NorthEast Un,1382,3,5,4,5,14,13,1,19
Delhi Dynamo,1382,4,4,6,4,23,19,4,18
Kolkata,1382,5,3,9,2,16,15,1,18
FC Goa,1382,6,5,3,6,12,15,-3,18
FC Pune City,1382,7,4,4,6,13,19,-6,16
Chennaiyin,1382,8,3,6,5,14,19,-5,15
Mumbai City,1383,1,7,4,3,19,9,10,25
NorthEast Un,1383,2,6,3,5,14,10,4,21
Delhi Dynamo,1383,3,5,5,4,24,19,5,20
FC Pune City,1383,4,4,5,5,15,17,-2,17
Kolkata,1383,4,3,8,3,15,17,-2,17
FC Goa,1383,6,5,2,7,14,17,-3,17
Kerala Blast,1383,7,4,5,5,11,18,-7,17
Chennaiyin,1383,8,3,6,5,14,19,-5,15
Mumbai City,1384,1,7,4,3,17,8,9,25
Kerala Blast,1384,2,6,4,4,13,15,-2,22
Delhi Dynamo,1384,3,5,6,3,24,17,7,21
Kolkata,1384,4,5,6,3,20,17,3,21
Chennaiyin,1384,5,4,6,4,16,19,-3,18
FC Pune City,1384,6,4,4,6,13,17,-4,16
NorthEast Un,1384,7,4,2,8,12,15,-3,14
FC Goa,1384,8,3,4,7,10,17,-7,13
Delhi Dynamo,1385,1,7,5,2,24,14,10,26
Mumbai City,1385,2,6,4,4,16,9,7,22
Kerala Blast,1385,3,5,5,4,13,16,-3,20
Kolkata,1385,4,4,6,4,16,17,-1,18
NorthEast Un,1385,5,4,4,6,11,12,-1,16
FC Pune City,1385,6,4,4,6,15,18,-3,16
Chennaiyin,1385,7,3,7,4,16,20,-4,16
FC Goa,1385,8,4,3,7,11,16,-5,15
Mumbai City,1386,1,6,5,3,16,8,8,23
NorthEast Un,1386,2,7,2,5,16,11,5,23
Kolkata,1386,3,5,6,3,18,16,2,21
Delhi Dynamo,1386,4,4,6,4,21,17,4,18
FC Pune City,1386,5,5,3,6,15,17,-2,18
Kerala Blast,1386,6,5,3,6,15,20,-5,18
Chennaiyin,1386,7,3,6,5,13,19,-6,15
FC Goa,1386,8,4,3,7,9,15,-6,15
Mumbai City,1387,1,7,4,3,17,8,9,25
NorthEast Un,1387,2,7,2,5,18,10,8,23
Delhi Dynamo,1387,3,5,5,4,24,19,5,20
Kolkata,1387,4,4,8,2,16,13,3,20
FC Pune City,1387,5,4,5,5,13,15,-2,17
Chennaiyin,1387,6,4,5,5,17,21,-4,17
Kerala Blast,1387,7,4,5,5,10,17,-7,17
FC Goa,1387,8,3,2,9,11,23,-12,11
Mumbai City,1388,1,7,4,3,17,8,9,25
Delhi Dynamo,1388,2,5,5,4,22,16,6,20
NorthEast Un,1388,3,6,2,6,11,11,0,20
Chennaiyin,1388,4,5,5,4,18,19,-1,20
FC Pune City,1388,5,5,4,5,15,15,0,19
Kolkata,1388,6,4,6,4,15,18,-3,18
Kerala Blast,1388,7,4,4,6,11,17,-6,16
FC Goa,1388,8,4,2,8,13,18,-5,14
Mumbai City,1389,1,7,4,3,18,9,9,25
NorthEast Un,1389,2,6,3,5,13,11,2,21
Kolkata,1389,3,4,7,3,18,15,3,19
Kerala Blast,1389,4,5,4,5,15,19,-4,19
FC Goa,1389,5,5,3,6,11,15,-4,18
Delhi Dynamo,1389,6,4,5,5,23,19,4,17
FC Pune City,1389,7,4,4,6,14,19,-5,16
Chennaiyin,1389,8,3,6,5,14,19,-5,15
Mumbai City,1390,1,7,4,3,17,8,9,25
Delhi Dynamo,1390,2,5,5,4,25,19,6,20
Kolkata,1390,3,4,8,2,18,14,4,20
FC Pune City,1390,4,5,4,5,17,15,2,19
NorthEast Un,1390,5,5,4,5,14,13,1,19
Kerala Blast,1390,6,4,4,6,10,21,-11,16
Chennaiyin,1390,7,3,6,5,15,20,-5,15
FC Goa,1390,8,4,3,7,12,18,-6,15
Kerala Blast,1391,1,7,3,4,14,14,0,24
Mumbai City,1391,2,6,5,3,17,9,8,23
Delhi Dynamo,1391,3,5,6,3,25,18,7,21
Kolkata,1391,4,4,7,3,18,14,4,19
Chennaiyin,1391,5,4,6,4,15,18,-3,18
FC Goa,1391,6,4,4,6,11,15,-4,16
FC Pune City,1391,7,4,3,7,13,20,-7,15
NorthEast Un,1391,8,4,2,8,11,16,-5,14
Mumbai City,1392,1,7,4,3,21,9,12,25
Delhi Dynamo,1392,2,6,5,3,25,20,5,23
Kolkata,1392,3,5,6,3,17,15,2,21
FC Pune City,1392,4,5,3,6,15,17,-2,18
Kerala Blast,1392,5,5,3,6,13,17,-4,18
Chennaiyin,1392,6,3,7,4,16,20,-4,16
NorthEast Un,1392,7,4,3,7,11,15,-4,15
FC Goa,1392,8,4,3,7,12,17,-5,15
Mumbai City,1393,1,6,4,4,18,11,7,22
NorthEast Un,1393,2,6,3,5,17,11,6,21
Delhi Dynamo,1393,3,5,6,3,25,22,3,21
Kolkata,1393,4,4,6,4,17,17,0,18
Chennaiyin,1393,5,4,6,4,16,18,-2,18
FC Pune City,1393,6,5,3,6,15,17,-2,18
Kerala Blast,1393,7,5,3,6,12,17,-5,18
FC Goa,1393,8,4,3,7,10,17,-7,15
Delhi Dynamo,1394,1,6,5,3,27,18,9,23
Mumbai City,1394,2,6,4,4,16,9,7,22
Kerala Blast,1394,3,6,4,4,13,14,-1,22
FC Pune City,1394,4,5,4,5,15,15,0,19
Chennaiyin,1394,5,4,5,5,17,20,-3,17
NorthEast Un,1394,6,5,2,7,13,16,-3,17
Kolkata,1394,7,3,7,4,14,16,-2,16
FC Goa,1394,8,4,3,7,12,19,-7,15
Mumbai City,1395,1,7,4,3,18,8,10,25
Kolkata,1395,2,5,6,3,19,15,4,21
FC Pune City,1395,3,6,3,5,14,14,0,21
Delhi Dynamo,1395,4,5,5,4,24,19,5,20
NorthEast Un,1395,5,5,2,7,12,13,-1,17
Chennaiyin,1395,6,4,5,5,15,20,-5,17
FC Goa,1395,7,5,2,7,13,19,-6,17
Kerala Blast,1395,8,4,3,7,10,17,-7,15
Delhi Dynamo,1396,1,6,5,3,23,16,7,23
Mumbai City,1396,2,6,4,4,16,9,7,22
FC Pune City,1396,3,6,3,5,20,16,4,21
NorthEast Un,1396,4,6,2,6,12,10,2,20
Kolkata,1396,5,4,6,4,17,19,-2,18
Chennaiyin,1396,6,4,6,4,15,18,-3,18
FC Goa,1396,7,4,3,7,13,17,-4,15
Kerala Blast,1396,8,4,3,7,9,20,-11,15
Mumbai City,1397,1,7,4,3,18,8,10,25
FC Goa,1397,2,6,2,6,15,17,-2,20
NorthEast Un,1397,3,5,4,5,11,10,1,19
Delhi Dynamo,1397,4,4,6,4,23,19,4,18
Kerala Blast,1397,5,4,6,4,10,14,-4,18
Kolkata,1397,6,3,8,3,14,14,0,17
FC Pune City,1397,7,4,5,5,13,15,-2,17
Chennaiyin,1397,8,3,5,6,14,21,-7,14
Delhi Dynamo,1398,1,6,5,3,26,17,9,23
Mumbai City,1398,2,6,4,4,17,11,6,22
NorthEast Un,1398,3,6,2,6,15,12,3,20
Kerala Blast,1398,4,5,5,4,12,15,-3,20
FC Pune City,1398,5,5,4,5,15,15,0,19
Kolkata,1398,6,3,8,3,14,15,-1,17
FC Goa,1398,7,4,3,7,12,17,-5,15
Chennaiyin,1398,8,3,5,6,14,23,-9,14
Mumbai City,1399,1,7,4,3,20,9,11,25
Delhi Dynamo,1399,2,5,6,3,28,20,8,21
FC Pune City,1399,3,5,4,5,13,14,-1,19
Kolkata,1399,4,4,6,4,17,16,1,18
Chennaiyin,1399,5,4,5,5,16,21,-5,17
Kerala Blast,1399,6,4,5,5,10,16,-6,17
FC Goa,1399,7,5,2,7,15,22,-7,17
NorthEast Un,1399,8,4,4,6,10,11,-1,16
Delhi Dynamo,1400,1,6,6,2,27,18,9,24
Mumbai City,1400,2,6,4,4,16,9,7,22
Kerala Blast,1400,3,5,5,4,13,14,-1,20
Chennaiyin,1400,4,4,6,4,16,19,-3,18
Kolkata,1400,5,3,8,3,15,17,-2,17
FC Goa,1400,6,4,4,6,15,18,-3,16
FC Pune City,1400,7,4,4,6,15,20,-5,16
NorthEast Un,1400,8,4,3,7,11,13,-2,15
Kerala Blast,1401,1,7,3,4,14,15,-1,24
Mumbai City,1401,2,6,5,3,17,9,8,23
Delhi Dynamo,1401,3,5,6,3,24,17,7,21
NorthEast Un,1401,4,5,2,7,11,12,-1,17
FC Goa,1401,5,5,2,7,12,15,-3,17
Chennaiyin,1401,6,4,5,5,14,18,-4,17
FC Pune City,1401,7,4,4,6,16,19,-3,16
Kolkata,1401,8,3,7,4,15,18,-3,16
Delhi Dynamo,1402,1,5,7,2,25,16,9,22
Mumbai City,1402,2,6,4,4,17,11,6,22
NorthEast Un,1402,3,6,3,5,15,10,5,21
Kolkata,1402,4,4,7,3,17,16,1,19
Kerala Blast,1402,5,5,3,6,15,18,-3,18
FC Pune City,1402,6,5,3,6,15,22,-7,18
Chennaiyin,1402,7,4,5,5,14,18,-4,17
FC Goa,1402,8,3,4,7,9,16,-7,13
Mumbai City,1403,1,6,5,3,18,10,8,23
Kolkata,1403,2,5,6,3,17,13,4,21
Chennaiyin,1403,3,5,5,4,25,18,7,20
Delhi Dynamo,1403,4,4,7,3,24,18,6,19
Kerala Blast,1403,5,5,4,5,12,15,-3,19
FC Pune City,1403,6,5,3,6,13,17,-4,18
NorthEast Un,1403,7,5,3,6,11,17,-6,18
FC Goa,1403,8,3,3,8,9,21,-12,12
Mumbai City,1404,1,7,4,3,18,8,10,25
Delhi Dynamo,1404,2,5,6,3,24,18,6,21
Kolkata,1404,3,5,6,3,19,15,4,21
NorthEast Un,1404,4,5,4,5,16,13,3,19
FC Pune City,1404,5,5,3,6,14,17,-3,18
FC Goa,1404,6,5,2,7,11,16,-5,17
Chennaiyin,1404,7,3,6,5,16,21,-5,15
Kerala Blast,1404,8,4,3,7,10,20,-10,15
Mumbai City,1405,1,7,4,3,17,8,9,25
Delhi Dynamo,1405,2,6,5,3,26,15,11,23
Kolkata,1405,3,5,6,3,17,16,1,21
Kerala Blast,1405,4,6,3,5,17,18,-1,21
FC Pune City,1405,5,5,3,6,14,16,-2,18
Chennaiyin,1405,6,4,5,5,15,19,-4,17
NorthEast Un,1405,7,4,2,8,12,17,-5,14
FC Goa,1405,8,4,2,8,10,19,-9,14
Delhi Dynamo,1406,1,7,5,2,34,17,17,26
Kolkata,1406,2,6,6,2,22,13,9,24
Mumbai City,1406,3,6,4,4,18,14,4,22
FC Pune City,1406,4,5,3,6,13,16,-3,18
Chennaiyin,1406,5,4,5,5,16,19,-3,17
NorthEast Un,1406,6,5,2,7,12,16,-4,17
Kerala Blast,1406,7,4,3,7,10,19,-9,15
FC Goa,1406,8,4,2,8,11,22,-11,14
Kolkata,1407,1,6,6,2,21,14,7,24
Mumbai City,1407,2,6,5,3,17,9,8,23
Delhi Dynamo,1407,3,5,7,2,25,15,10,22
Kerala Blast,1407,4,6,3,5,13,19,-6,21
NorthEast Un,1407,5,5,3,6,12,12,0,18
Chennaiyin,1407,6,4,5,5,15,19,-4,17
FC Pune City,1407,7,4,3,7,13,17,-4,15
FC Goa,1407,8,3,2,9,10,21,-11,11
Delhi Dynamo,1408,1,6,6,2,26,16,10,24
Mumbai City,1408,2,6,4,4,16,10,6,22
Kerala Blast,1408,3,6,4,4,12,14,-2,22
FC Pune City,1408,4,5,4,5,16,15,1,19
NorthEast Un,1408,5,5,3,6,12,12,0,18
Kolkata,1408,6,4,6,4,14,16,-2,18
Chennaiyin,1408,7,4,5,5,15,19,-4,17
FC Goa,1408,8,3,2,9,9,18,-9,11
Mumbai City,1409,1,6,4,4,16,9,7,22
Delhi Dynamo,1409,2,5,5,4,24,19,5,20
FC Goa,1409,3,6,2,6,12,15,-3,20
FC Pune City,1409,4,5,4,5,15,15,0,19
Kerala Blast,1409,5,5,4,5,13,16,-3,19
NorthEast Un,1409,6,5,3,6,14,15,-1,18
Kolkata,1409,7,3,8,3,15,15,0,17
Chennaiyin,1409,8,3,6,5,15,20,-5,15
Mumbai City,1410,1,7,4,3,20,10,10,25
Delhi Dynamo,1410,2,6,5,3,28,20,8,23
Kolkata,1410,3,4,8,2,18,15,3,20
Kerala Blast,1410,4,5,4,5,14,18,-4,19
NorthEast Un,1410,5,5,3,6,12,13,-1,18
FC Pune City,1410,6,4,4,6,14,18,-4,16
FC Goa,1410,7,4,3,7,12,18,-6,15
Chennaiyin,1410,8,3,5,6,14,20,-6,14
Mumbai City,1411,1,7,4,3,19,8,11,25
Delhi Dynamo,1411,2,6,5,3,27,18,9,23
FC Pune City,1411,3,5,4,5,14,15,-1,19
Kerala Blast,1411,4,5,4,5,12,15,-3,19
Kolkata,1411,5,4,6,4,17,18,-1,18
Chennaiyin,1411,6,4,5,5,17,21,-4,17
NorthEast Un,1411,7,5,2,7,11,16,-5,17
FC Goa,1411,8,4,2,8,15,21,-6,14
Delhi Dynamo,1412,1,6,6,2,25,15,10,24
Mumbai City,1412,2,6,4,4,16,9,7,22
Kerala Blast,1412,3,6,4,4,12,13,-1,22
Chennaiyin,1412,4,5,5,4,17,19,-2,20
Kolkata,1412,5,4,7,3,15,14,1,19
FC Pune City,1412,6,4,4,6,12,16,-4,16
NorthEast Un,1412,7,4,3,7,11,13,-2,15
FC Goa,1412,8,3,3,8,9,18,-9,12
Mumbai City,1413,1,6,5,3,16,8,8,23
Delhi Dynamo,1413,2,4,7,3,23,18,5,19
FC Pune City,1413,3,5,4,5,14,15,-1,19
Kerala Blast,1413,4,5,4,5,13,15,-2,19
NorthEast Un,1413,5,5,3,6,13,13,0,18
Kolkata,1413,6,4,6,4,14,15,-1,18
FC Goa,1413,7,5,3,6,13,15,-2,18
Chennaiyin,1413,8,3,6,5,13,20,-7,15
Mumbai City,1414,1,6,4,4,16,9,7,22
Kolkata,1414,2,5,7,2,18,14,4,22
Delhi Dynamo,1414,3,5,6,3,23,18,5,21
NorthEast Un,1414,4,5,3,6,12,12,0,18
FC Pune City,1414,5,4,5,5,13,15,-2,17
FC Goa,1414,6,5,2,7,14,17,-3,17
Chennaiyin,1414,7,4,5,5,15,20,-5,17
Kerala Blast,1414,8,4,4,6,9,15,-6,16
Mumbai City,1415,1,7,4,3,17,8,9,25
Kolkata,1415,2,5,7,2,22,14,8,22
NorthEast Un,1415,3,6,3,5,14,11,3,21
Delhi Dynamo,1415,4,5,5,4,24,19,5,20
Kerala Blast,1415,5,5,5,4,12,14,-2,20
FC Pune City,1415,6,4,3,7,13,20,-7,15
Chennaiyin,1415,7,3,5,6,13,19,-6,14
FC Goa,1415,8,4,2,8,9,19,-10,14
Mumbai City,1416,1,6,5,3,17,9,8,23
NorthEast Un,1416,2,6,2,6,15,13,2,20
Delhi Dynamo,1416,3,4,7,3,24,19,5,19
FC Pune City,1416,4,5,4,5,16,16,0,19
Kerala Blast,1416,5,5,4,5,12,16,-4,19
Kolkata,1416,6,4,6,4,15,16,-1,18
FC Goa,1416,7,5,3,6,13,16,-3,18
Chennaiyin,1416,8,3,5,6,15,22,-7,14
Delhi Dynamo,1417,1,7,5,2,25,14,11,26
Mumbai City,1417,2,6,4,4,16,9,7,22
Kerala Blast,1417,3,5,4,5,12,17,-5,19
Chennaiyin,1417,4,4,6,4,16,18,-2,18
NorthEast Un,1417,5,5,2,7,12,13,-1,17
Kolkata,1417,6,3,8,3,15,20,-5,17
FC Pune City,1417,7,4,4,6,12,15,-3,16
FC Goa,1417,8,4,3,7,16,18,-2,15
NorthEast Un,1418,1,7,2,5,17,10,7,23
Delhi Dynamo,1418,2,6,5,3,25,19,6,23
Mumbai City,1418,3,6,4,4,16,9,7,22
Kolkata,1418,4,5,6,3,18,16,2,21
Kerala Blast,1418,5,6,3,5,13,15,-2,21
Chennaiyin,1418,6,4,5,5,14,20,-6,17
FC Pune City,1418,7,4,3,7,13,18,-5,15
FC Goa,1418,8,3,2,9,9,18,-9,11
Mumbai City,1419,1,7,4,3,17,8,9,25
Kolkata,1419,2,5,7,2,19,13,6,22
Delhi Dynamo,1419,3,5,6,3,23,15,8,21
Kerala Blast,1419,4,6,3,5,13,17,-4,21
NorthEast Un,1419,5,4,4,6,10,11,-1,16
Chennaiyin,1419,6,3,6,5,14,19,-5,15
FC Pune City,1419,7,4,3,7,13,19,-6,15
FC Goa,1419,8,4,3,7,11,18,-7,15
Delhi Dynamo,1420,1,6,5,3,27,18,9,23
Mumbai City,1420,2,6,4,4,17,11,6,22
Kolkata,1420,3,5,7,2,18,14,4,22
NorthEast Un,1420,4,5,4,5,11,10,1,19
Kerala Blast,1420,5,4,5,5,9,15,-6,17
FC Pune City,1420,6,4,4,6,13,16,-3,16
Chennaiyin,1420,7,3,6,5,15,20,-5,15
FC Goa,1420,8,4,3,7,13,19,-6,15
Delhi Dynamo,1421,1,6,6,2,26,16,10,24
Mumbai City,1421,2,6,4,4,16,10,6,22
Kolkata,1421,3,5,7,2,17,14,3,22
Chennaiyin,1421,4,5,5,4,17,19,-2,20
Kerala Blast,1421,5,5,4,5,14,17,-3,19
FC Pune City,1421,6,5,3,6,14,16,-2,18
NorthEast Un,1421,7,4,2,8,13,17,-4,14
FC Goa,1421,8,3,3,8,10,18,-8,12
Delhi Dynamo,1422,1,6,5,3,26,17,9,23
Mumbai City,1422,2,6,4,4,17,10,7,22
NorthEast Un,1422,3,6,3,5,13,9,4,21
Kolkata,1422,4,4,6,4,16,14,2,18
FC Pune City,1422,5,5,3,6,13,15,-2,18
Kerala Blast,1422,6,5,3,6,10,18,-8,18
FC Goa,1422,7,5,2,7,12,19,-7,17
Chennaiyin,1422,8,3,6,5,15,20,-5,15
Mumbai City,1423,1,6,5,3,16,8,8,23
Kolkata,1423,2,5,7,2,19,14,5,22
Kerala Blast,1423,3,6,3,5,12,14,-2,21
Delhi Dynamo,1423,4,4,7,3,23,18,5,19
NorthEast Un,1423,5,5,2,7,13,14,-1,17
Chennaiyin,1423,6,4,5,5,15,19,-4,17
FC Goa,1423,7,4,4,6,12,17,-5,16
FC Pune City,1423,8,4,3,7,12,18,-6,15
Mumbai City,1424,1,6,5,3,16,8,8,23
Delhi Dynamo,1424,2,5,7,2,22,14,8,22
Kolkata,1424,3,4,7,3,17,17,0,19
FC Pune City,1424,4,5,4,5,15,15,0,19
NorthEast Un,1424,5,5,3,6,11,11,0,18
Chennaiyin,1424,6,4,6,4,15,18,-3,18
Kerala Blast,1424,7,4,5,5,11,16,-5,17
FC Goa,1424,8,3,3,8,10,18,-8,12
Mumbai City,1425,1,7,4,3,18,9,9,25
Delhi Dynamo,1425,2,6,5,3,26,16,10,23
Kolkata,1425,3,5,6,3,16,17,-1,21
Kerala Blast,1425,4,5,4,5,14,17,-3,19
FC Goa,1425,5,5,2,7,15,16,-1,17
Chennaiyin,1425,6,4,5,5,18,21,-3,17
FC Pune City,1425,7,4,3,7,13,18,-5,15
NorthEast Un,1425,8,4,3,7,11,17,-6,15
Delhi Dynamo,1426,1,7,5,2,28,16,12,26
Mumbai City,1426,2,6,4,4,16,10,6,22
Kerala Blast,1426,3,6,3,5,12,15,-3,21
NorthEast Un,1426,4,6,2,6,13,13,0,20
Kolkata,1426,5,4,7,3,14,13,1,19
FC Pune City,1426,6,4,3,7,12,16,-4,15
Chennaiyin,1426,7,3,6,5,13,18,-5,15
FC Goa,1426,8,3,4,7,9,16,-7,13
NorthEast Un,1427,1,7,2,5,14,10,4,23
Mumbai City,1427,2,6,4,4,16,10,6,22
Kolkata,1427,3,5,6,3,19,16,3,21
Delhi Dynamo,1427,4,5,5,4,25,18,7,20
Kerala Blast,1427,5,5,3,6,14,18,-4,18
FC Goa,1427,6,5,3,6,13,17,-4,18
FC Pune City,1427,7,4,3,7,14,20,-6,15
Chennaiyin,1427,8,3,6,5,13,19,-6,15
Delhi Dynamo,1428,1,7,5,2,29,15,14,26
Mumbai City,1428,2,6,4,4,17,11,6,22
Kolkata,1428,3,4,8,2,15,13,2,20
Kerala Blast,1428,4,5,4,5,13,15,-2,19
NorthEast Un,1428,5,5,3,6,10,11,-1,18
FC Pune City,1428,6,4,4,6,14,19,-5,16
Chennaiyin,1428,7,3,6,5,15,20,-5,15
FC Goa,1428,8,3,4,7,10,19,-9,13
Mumbai City,1429,1,6,5,3,19,11,8,23
Kolkata,1429,2,5,7,2,18,14,4,22
Delhi Dynamo,1429,3,5,6,3,28,19,9,21
Kerala Blast,1429,4,5,4,5,11,17,-6,19
FC Pune City,1429,5,5,3,6,15,16,-1,18
NorthEast Un,1429,6,5,2,7,11,12,-1,17
Chennaiyin,1429,7,4,5,5,14,18,-4,17
FC Goa,1429,8,4,2,8,10,19,-9,14
Mumbai City,1430,1,6,5,3,17,9,8,23
Kolkata,1430,2,5,7,2,19,13,6,22
Delhi Dynamo,1430,3,5,6,3,25,17,8,21
Kerala Blast,1430,4,5,4,5,13,17,-4,19
FC Pune City,1430,5,5,3,6,14,17,-3,18
Chennaiyin,1430,6,4,5,5,18,21,-3,17
NorthEast Un,1430,7,5,2,7,13,16,-3,17
FC Goa,1430,8,4,2,8,11,20,-9,14
Delhi Dynamo,1431,1,6,5,3,29,18,11,23
Mumbai City,1431,2,6,4,4,17,10,7,22
Kerala Blast,1431,3,6,4,4,17,16,1,22
Kolkata,1431,4,4,7,3,15,13,2,19
NorthEast Un,1431,5,5,3,6,14,13,1,18
FC Goa,1431,6,5,2,7,13,21,-8,17
Chennaiyin,1431,7,3,6,5,14,20,-6,15
FC Pune City,1431,8,4,3,7,12,20,-8,15
Mumbai City,1432,1,7,4,3,19,10,9,25
NorthEast Un,1432,2,6,2,6,13,12,1,20
FC Goa,1432,3,6,2,6,14,16,-2,20
Kolkata,1432,4,4,7,3,16,15,1,19
Kerala Blast,1432,5,5,4,5,13,16,-3,19
Delhi Dynamo,1432,6,4,5,5,24,21,3,17
FC Pune City,1432,7,4,5,5,12,14,-2,17
Chennaiyin,1432,8,3,5,6,15,22,-7,14
Mumbai City,1433,1,7,4,3,18,8,10,25
Delhi Dynamo,1433,2,5,6,3,23,17,6,21
Kolkata,1433,3,4,7,3,16,15,1,19
FC Pune City,1433,4,5,4,5,15,16,-1,19
Kerala Blast,1433,5,5,4,5,11,15,-4,19
FC Goa,1433,6,4,4,6,12,16,-4,16
NorthEast Un,1433,7,4,3,7,9,11,-2,15
Chennaiyin,1433,8,3,6,5,13,19,-6,15
Mumbai City,1434,1,6,5,3,17,9,8,23
NorthEast Un,1434,2,6,3,5,15,11,4,21
Kolkata,1434,3,5,6,3,19,17,2,21
FC Goa,1434,4,6,2,6,15,15,0,20
Kerala Blast,1434,5,5,4,5,13,18,-5,19
Delhi Dynamo,1434,6,4,6,4,23,19,4,18
FC Pune City,1434,7,4,3,7,13,19,-6,15
Chennaiyin,1434,8,3,5,6,14,21,-7,14
Mumbai City,1435,1,6,5,3,18,10,8,23
NorthEast Un,1435,2,7,2,5,17,12,5,23
Delhi Dynamo,1435,3,5,6,3,25,20,5,21
Kolkata,1435,4,5,6,3,16,15,1,21
FC Pune City,1435,5,5,3,6,15,16,-1,18
Kerala Blast,1435,6,5,3,6,12,17,-5,18
Chennaiyin,1435,7,3,6,5,15,20,-5,15
FC Goa,1435,8,3,3,8,8,16,-8,12
Mumbai City,1436,1,7,4,3,18,8,10,25
NorthEast Un,1436,2,7,2,5,16,11,5,23
Delhi Dynamo,1436,3,5,5,4,26,18,8,20
Kolkata,1436,4,4,7,3,18,17,1,19
FC Pune City,1436,5,5,3,6,16,18,-2,18
Kerala Blast,1436,6,5,3,6,12,17,-5,18
FC Goa,1436,7,4,3,7,10,19,-9,15
Chennaiyin,1436,8,3,5,6,15,23,-8,14
Mumbai City,1437,1,7,4,3,17,8,9,25
Delhi Dynamo,1437,2,5,6,3,29,20,9,21
Kolkata,1437,3,5,6,3,18,16,2,21
Kerala Blast,1437,4,6,3,5,16,15,1,21
Chennaiyin,1437,5,4,6,4,15,18,-3,18
NorthEast Un,1437,6,4,4,6,12,15,-3,16
FC Pune City,1437,7,4,3,7,12,19,-7,15
FC Goa,1437,8,4,2,8,14,22,-8,14
Mumbai City,1438,1,7,4,3,22,9,13,25
Kolkata,1438,2,5,6,3,19,18,1,21
Delhi Dynamo,1438,3,5,5,4,24,24,0,20
FC Pune City,1438,4,5,3,6,15,16,-1,18
Chennaiyin,1438,5,4,6,4,15,18,-3,18
Kerala Blast,1438,6,5,3,6,14,20,-6,18
NorthEast Un,1438,7,5,2,7,13,12,1,17
FC Goa,1438,8,4,3,7,12,17,-5,15
Mumbai City,1439,1,7,4,3,18,9,9,25
Kolkata,1439,2,5,6,3,18,14,4,21
NorthEast Un,1439,3,6,2,6,16,15,1,20
Delhi Dynamo,1439,4,4,6,4,25,22,3,18
FC Pune City,1439,5,5,3,6,14,17,-3,18
Kerala Blast,1439,6,5,3,6,12,17,-5,18
Chennaiyin,1439,7,4,5,5,17,19,-2,17
FC Goa,1439,8,4,3,7,11,18,-7,15
Mumbai City,1440,1,7,4,3,19,9,10,25
Kolkata,1440,2,5,7,2,19,13,6,22
Kerala Blast,1440,3,6,3,5,13,18,-5,21
Delhi Dynamo,1440,4,5,5,4,25,19,6,20
Chennaiyin,1440,5,5,5,4,16,17,-1,20
FC Pune City,1440,6,4,3,7,14,18,-4,15
FC Goa,1440,7,4,3,7,10,15,-5,15
NorthEast Un,1440,8,4,2,8,9,16,-7,14
Mumbai City,1441,1,7,4,3,17,8,9,25
Delhi Dynamo,1441,2,5,6,3,25,16,9,21
Kolkata,1441,3,4,7,3,18,16,2,19
NorthEast Un,1441,4,5,4,5,13,12,1,19
Kerala Blast,1441,5,5,4,5,13,16,-3,19
Chennaiyin,1441,6,3,7,4,13,17,-4,16
FC Goa,1441,7,4,3,7,12,18,-6,15
FC Pune City,1441,8,4,3,7,12,20,-8,15
Mumbai City,1442,1,6,5,3,17,9,8,23
NorthEast Un,1442,2,6,3,5,12,10,2,21
Kolkata,1442,3,4,8,2,15,12,3,20
Delhi Dynamo,1442,4,4,7,3,22,16,6,19
FC Pune City,1442,5,5,4,5,17,15,2,19
Kerala Blast,1442,6,4,4,6,10,19,-9,16
Chennaiyin,1442,7,3,6,5,14,19,-5,15
FC Goa,1442,8,4,3,7,9,16,-7,15
Mumbai City,1443,1,7,4,3,19,8,11,25
Kolkata,1443,2,5,6,3,15,16,-1,21
Delhi Dynamo,1443,3,5,5,4,25,21,4,20
FC Pune City,1443,4,5,4,5,17,15,2,19
Kerala Blast,1443,5,5,4,5,15,17,-2,19
NorthEast Un,1443,6,5,3,6,14,15,-1,18
Chennaiyin,1443,7,3,6,5,14,20,-6,15
FC Goa,1443,8,4,2,8,12,19,-7,14
Mumbai City,1444,1,6,5,3,16,8,8,23
Chennaiyin,1444,2,5,5,4,18,20,-2,20
Delhi Dynamo,1444,3,4,7,3,25,20,5,19
FC Pune City,1444,4,5,4,5,15,15,0,19
Kerala Blast,1444,5,5,4,5,12,17,-5,19
FC Goa,1444,6,5,2,7,14,18,-4,17
Kolkata,1444,7,3,7,4,16,17,-1,16
NorthEast Un,1444,8,4,4,6,15,16,-1,16
Mumbai City,1445,1,7,4,3,18,9,9,25
Kolkata,1445,2,6,6,2,24,14,10,24
Delhi Dynamo,1445,3,6,5,3,27,17,10,23
FC Pune City,1445,4,5,3,6,13,16,-3,18
Kerala Blast,1445,5,5,3,6,12,17,-5,18
NorthEast Un,1445,6,4,3,7,11,15,-4,15
Chennaiyin,1445,7,3,6,5,14,20,-6,15
FC Goa,1445,8,4,2,8,11,22,-11,14
Mumbai City,1446,1,6,4,4,16,10,6,22
Delhi Dynamo,1446,2,5,5,4,24,17,7,20
Chennaiyin,1446,3,5,5,4,17,18,-1,20
Kolkata,1446,4,4,7,3,16,16,0,19
FC Pune City,1446,5,5,4,5,15,15,0,19
Kerala Blast,1446,6,5,3,6,13,18,-5,18
NorthEast Un,1446,7,5,2,7,12,14,-2,17
FC Goa,1446,8,5,2,7,12,17,-5,17
Mumbai City,1447,1,7,4,3,17,8,9,25
Kerala Blast,1447,2,6,3,5,12,15,-3,21
Delhi Dynamo,1447,3,4,6,4,23,19,4,18
Kolkata,1447,4,4,6,4,16,16,0,18
FC Goa,1447,5,5,3,6,13,15,-2,18
Chennaiyin,1447,6,4,6,4,14,17,-3,18
FC Pune City,1447,7,5,3,6,13,16,-3,18
NorthEast Un,1447,8,4,3,7,11,13,-2,15
Delhi Dynamo,1448,1,7,5,2,28,17,11,26
Mumbai City,1448,2,6,4,4,18,12,6,22
FC Pune City,1448,3,5,4,5,13,14,-1,19
Kolkata,1448,4,3,8,3,14,14,0,17
NorthEast Un,1448,5,5,2,7,10,12,-2,17
Chennaiyin,1448,6,4,5,5,16,20,-4,17
Kerala Blast,1448,7,4,5,5,10,15,-5,17
FC Goa,1448,8,4,3,7,12,17,-5,15
Mumbai City,1449,1,6,5,3,16,8,8,23
Kolkata,1449,2,5,7,2,16,13,3,22
Delhi Dynamo,1449,3,4,8,2,22,15,7,20
NorthEast Un,1449,4,5,4,5,12,10,2,19
Kerala Blast,1449,5,4,6,4,10,14,-4,18
FC Pune City,1449,6,4,4,6,12,15,-3,16
FC Goa,1449,7,4,3,7,11,16,-5,15
Chennaiyin,1449,8,3,5,6,14,22,-8,14
Delhi Dynamo,1450,1,6,6,2,25,16,9,24
Kolkata,1450,2,6,6,2,21,13,8,24
Mumbai City,1450,3,6,4,4,16,9,7,22
FC Pune City,1450,4,5,3,6,14,16,-2,18
Kerala Blast,1450,5,5,3,6,11,18,-7,18
Chennaiyin,1450,6,4,5,5,15,19,-4,17
NorthEast Un,1450,7,4,3,7,11,14,-3,15
FC Goa,1450,8,4,2,8,10,18,-8,14
Delhi Dynamo,1451,1,6,5,3,26,17,9,23
Mumbai City,1451,2,6,4,4,16,10,6,22
NorthEast Un,1451,3,6,3,5,15,12,3,21
Kolkata,1451,4,4,8,2,15,13,2,20
Chennaiyin,1451,5,4,6,4,16,19,-3,18
Kerala Blast,1451,6,4,5,5,10,15,-5,17
FC Pune City,1451,7,4,4,6,13,16,-3,16
FC Goa,1451,8,3,3,8,9,18,-9,12
Mumbai City,1452,1,7,4,3,18,8,10,25
Kerala Blast,1452,2,6,3,5,12,15,-3,21
Delhi Dynamo,1452,3,5,5,4,25,19,6,20
NorthEast Un,1452,4,6,2,6,12,12,0,20
Kolkata,1452,5,4,7,3,15,14,1,19
Chennaiyin,1452,6,4,6,4,17,19,-2,18
FC Pune City,1452,7,4,3,7,12,16,-4,15
FC Goa,1452,8,3,4,7,11,19,-8,13
Mumbai City,1453,1,7,4,3,17,8,9,25
Kerala Blast,1453,2,6,4,4,14,14,0,22
Kolkata,1453,3,5,6,3,20,15,5,21
Delhi Dynamo,1453,4,5,5,4,23,18,5,20
NorthEast Un,1453,5,5,4,5,14,11,3,19
Chennaiyin,1453,6,3,7,4,17,21,-4,16
FC Pune City,1453,7,4,3,7,12,20,-8,15
FC Goa,1453,8,3,3,8,12,22,-10,12
Mumbai City,1454,1,7,4,3,20,9,11,25
Delhi Dynamo,1454,2,5,5,4,28,24,4,20
Kolkata,1454,3,4,8,2,18,15,3,20
Kerala Blast,1454,4,5,4,5,16,20,-4,19
NorthEast Un,1454,5,5,3,6,14,14,0,18
FC Pune City,1454,6,4,5,5,17,19,-2,17
Chennaiyin,1454,7,3,7,4,15,19,-4,16
FC Goa,1454,8,3,4,7,12,20,-8,13
Mumbai City,1455,1,6,5,3,18,10,8,23
Delhi Dynamo,1455,2,5,7,2,26,18,8,22
Kerala Blast,1455,3,5,5,4,11,14,-3,20
NorthEast Un,1455,4,5,3,6,13,12,1,18
Kolkata,1455,5,3,8,3,15,15,0,17
FC Pune City,1455,6,4,4,6,13,16,-3,16
FC Goa,1455,7,4,4,6,11,16,-5,16
Chennaiyin,1455,8,3,6,5,15,21,-6,15
Mumbai City,1456,1,7,4,3,17,8,9,25
Kerala Blast,1456,2,7,3,4,15,13,2,24
Delhi Dynamo,1456,3,5,6,3,28,17,11,21
Kolkata,1456,4,4,7,3,15,14,1,19
NorthEast Un,1456,5,5,3,6,13,12,1,18
FC Pune City,1456,6,4,4,6,12,17,-5,16
Chennaiyin,1456,7,3,5,6,14,22,-8,14
FC Goa,1456,8,4,2,8,11,22,-11,14
Mumbai City,1457,1,7,4,3,17,8,9,25
NorthEast Un,1457,2,6,3,5,14,10,4,21
FC Pune City,1457,3,6,3,5,15,15,0,21
Delhi Dynamo,1457,4,5,5,4,26,17,9,20
Kolkata,1457,5,4,7,3,17,16,1,19
Chennaiyin,1457,6,4,6,4,15,18,-3,18
Kerala Blast,1457,7,4,3,7,9,17,-8,15
FC Goa,1457,8,3,3,8,10,22,-12,12
Delhi Dynamo,1458,1,6,5,3,24,17,7,23
Mumbai City,1458,2,6,4,4,16,9,7,22
NorthEast Un,1458,3,6,3,5,14,11,3,21
Kerala Blast,1458,4,5,4,5,10,14,-4,19
FC Pune City,1458,5,5,3,6,15,16,-1,18
FC Goa,1458,6,5,2,7,12,17,-5,17
Kolkata,1458,7,3,7,4,14,16,-2,16
Chennaiyin,1458,8,3,6,5,16,21,-5,15
Mumbai City,1459,1,7,4,3,18,8,10,25
Delhi Dynamo,1459,2,6,5,3,26,17,9,23
Kerala Blast,1459,3,5,5,4,13,15,-2,20
Kolkata,1459,4,4,7,3,16,14,2,19
FC Pune City,1459,5,5,4,5,14,15,-1,19
NorthEast Un,1459,6,5,2,7,11,13,-2,17
Chennaiyin,1459,7,3,6,5,14,19,-5,15
FC Goa,1459,8,3,3,8,9,20,-11,12
Delhi Dynamo,1460,1,6,6,2,27,18,9,24
Mumbai City,1460,2,6,5,3,17,9,8,23
NorthEast Un,1460,3,6,2,6,15,12,3,20
Kolkata,1460,4,4,7,3,17,18,-1,19
Kerala Blast,1460,5,5,3,6,14,16,-2,18
FC Pune City,1460,6,5,3,6,13,16,-3,18
FC Goa,1460,7,4,3,7,11,17,-6,15
Chennaiyin,1460,8,3,5,6,13,21,-8,14
Delhi Dynamo,1461,1,6,6,2,27,16,11,24
Mumbai City,1461,2,6,5,3,18,10,8,23
Kerala Blast,1461,3,6,4,4,12,14,-2,22
Kolkata,1461,4,4,6,4,16,17,-1,18
NorthEast Un,1461,5,5,2,7,12,13,-1,17
Chennaiyin,1461,6,4,5,5,16,20,-4,17
FC Pune City,1461,7,4,4,6,13,16,-3,16
FC Goa,1461,8,4,2,8,12,20,-8,14
Mumbai City,1462,1,6,5,3,17,9,8,23
Delhi Dynamo,1462,2,5,6,3,24,18,6,21
NorthEast Un,1462,3,6,2,6,16,11,5,20
Kolkata,1462,4,4,7,3,18,15,3,19
Kerala Blast,1462,5,5,4,5,16,19,-3,19
Chennaiyin,1462,6,4,6,4,16,19,-3,18
FC Pune City,1462,7,5,3,6,15,20,-5,18
FC Goa,1462,8,3,3,8,10,21,-11,12
Mumbai City,1463,1,6,4,4,17,12,5,22
Delhi Dynamo,1463,2,5,6,3,27,19,8,21
FC Pune City,1463,3,6,3,5,15,15,0,21
NorthEast Un,1463,4,6,2,6,15,14,1,20
Kolkata,1463,5,4,6,4,16,16,0,18
FC Goa,1463,6,5,3,6,15,19,-4,18
Chennaiyin,1463,7,4,5,5,20,22,-2,17
Kerala Blast,1463,8,4,3,7,11,19,-8,15
Mumbai City,1464,1,7,4,3,17,8,9,25
NorthEast Un,1464,2,6,3,5,14,11,3,21
Delhi Dynamo,1464,3,5,5,4,23,17,6,20
Kolkata,1464,4,4,7,3,18,14,4,19
FC Goa,1464,5,5,2,7,12,16,-4,17
Kerala Blast,1464,6,4,5,5,10,16,-6,17
FC Pune City,1464,7,4,4,6,14,20,-6,16
Chennaiyin,1464,8,3,6,5,15,21,-6,15
Delhi Dynamo,1465,1,6,5,3,23,16,7,23
NorthEast Un,1465,2,7,2,5,13,9,4,23
Mumbai City,1465,3,6,4,4,16,9,7,22
Kolkata,1465,4,5,6,3,23,14,9,21
FC Pune City,1465,5,4,4,6,13,19,-6,16
Kerala Blast,1465,6,4,4,6,9,19,-10,16
Chennaiyin,1465,7,3,6,5,14,19,-5,15
FC Goa,1465,8,4,3,7,10,16,-6,15
Mumbai City,1466,1,7,4,3,22,9,13,25
NorthEast Un,1466,2,7,2,5,13,9,4,23
Delhi Dynamo,1466,3,5,5,4,25,21,4,20
Kolkata,1466,4,4,7,3,15,14,1,19
Kerala Blast,1466,5,5,3,6,14,18,-4,18
FC Pune City,1466,6,4,4,6,13,18,-5,16
Chennaiyin,1466,7,3,6,5,13,18,-5,15
FC Goa,1466,8,4,3,7,9,17,-8,15
Mumbai City,1467,1,7,4,3,17,8,9,25
Delhi Dynamo,1467,2,6,5,3,28,16,12,23
Kerala Blast,1467,3,5,5,4,10,13,-3,20
Kolkata,1467,4,4,6,4,17,19,-2,18
Chennaiyin,1467,5,4,6,4,16,18,-2,18
FC Pune City,1467,6,4,4,6,13,16,-3,16
NorthEast Un,1467,7,4,4,6,11,14,-3,16
FC Goa,1467,8,4,2,8,13,21,-8,14
Mumbai City,1468,1,6,5,3,18,10,8,23
Delhi Dynamo,1468,2,5,6,3,26,19,7,21
Kolkata,1468,3,4,7,3,18,14,4,19
Kerala Blast,1468,4,5,4,5,14,21,-7,19
NorthEast Un,1468,5,5,3,6,12,13,-1,18
FC Pune City,1468,6,5,3,6,16,18,-2,18
Chennaiyin,1468,7,4,5,5,16,18,-2,17
FC Goa,1468,8,4,3,7,11,18,-7,15
Mumbai City,1469,1,7,4,3,18,8,10,25
NorthEast Un,1469,2,6,3,5,15,13,2,21
Delhi Dynamo,1469,3,5,5,4,25,18,7,20
Kolkata,1469,4,4,7,3,16,16,0,19
Kerala Blast,1469,5,5,4,5,12,17,-5,19
FC Pune City,1469,6,5,3,6,16,16,0,18
Chennaiyin,1469,7,4,5,5,17,21,-4,17
FC Goa,1469,8,3,3,8,10,20,-10,12
Kolkata,1470,1,6,6,2,20,13,7,24
Delhi Dynamo,1470,2,6,5,3,27,17,10,23
Mumbai City,1470,3,6,4,4,17,10,7,22
Chennaiyin,1470,4,5,5,4,19,18,1,20
Kerala Blast,1470,5,5,4,5,11,17,-6,19
NorthEast Un,1470,6,5,2,7,12,15,-3,17
FC Pune City,1470,7,4,4,6,13,16,-3,16
FC Goa,1470,8,3,2,9,9,22,-13,11
Mumbai City,1471,1,6,5,3,17,9,8,23
Delhi Dynamo,1471,2,5,6,3,23,17,6,21
FC Pune City,1471,3,6,3,5,17,14,3,21
Kolkata,1471,4,5,6,3,19,18,1,21
Kerala Blast,1471,5,5,3,6,13,19,-6,18
NorthEast Un,1471,6,5,2,7,11,13,-2,17
FC Goa,1471,7,5,2,7,14,17,-3,17
Chennaiyin,1471,8,3,5,6,14,21,-7,14
Mumbai City,1472,1,6,5,3,16,8,8,23
Kerala Blast,1472,2,6,4,4,14,15,-1,22
Kolkata,1472,3,5,6,3,17,15,2,21
Delhi Dynamo,1472,4,4,8,2,25,18,7,20
Chennaiyin,1472,5,5,5,4,19,19,0,20
NorthEast Un,1472,6,4,4,6,13,16,-3,16
FC Pune City,1472,7,4,3,7,14,18,-4,15
FC Goa,1472,8,3,3,8,11,20,-9,12
Mumbai City,1473,1,6,5,3,18,10,8,23
Delhi Dynamo,1473,2,4,7,3,25,20,5,19
FC Pune City,1473,3,5,4,5,16,17,-1,19
Kerala Blast,1473,4,5,4,5,14,17,-3,19
Kolkata,1473,5,4,6,4,16,16,0,18
NorthEast Un,1473,6,5,3,6,14,14,0,18
Chennaiyin,1473,7,3,7,4,15,19,-4,16
FC Goa,1473,8,4,4,6,10,15,-5,16
Mumbai City,1474,1,7,4,3,18,9,9,25
Kolkata,1474,2,5,6,3,18,14,4,21
NorthEast Un,1474,3,6,2,6,14,14,0,20
Delhi Dynamo,1474,4,4,6,4,23,18,5,18
FC Pune City,1474,5,5,3,6,14,15,-1,18
Kerala Blast,1474,6,5,3,6,11,19,-8,18
Chennaiyin,1474,7,4,5,5,17,20,-3,17
FC Goa,1474,8,4,3,7,10,16,-6,15
Mumbai City,1475,1,7,4,3,20,10,10,25
Kolkata,1475,2,4,8,2,18,15,3,20
Delhi Dynamo,1475,3,4,7,3,24,19,5,19
NorthEast Un,1475,4,5,4,5,12,11,1,19
Chennaiyin,1475,5,4,6,4,15,18,-3,18
Kerala Blast,1475,6,4,5,5,11,16,-5,17
FC Pune City,1475,7,4,4,6,13,17,-4,16
FC Goa,1475,8,3,4,7,10,17,-7,13
Mumbai City,1476,1,7,4,3,18,8,10,25
NorthEast Un,1476,2,6,3,5,15,13,2,21
Kolkata,1476,3,4,8,2,15,13,2,20
Delhi Dynamo,1476,4,4,6,4,22,20,2,18
Kerala Blast,1476,5,5,3,6,11,16,-5,18
FC Pune City,1476,6,4,4,6,13,16,-3,16
FC Goa,1476,7,4,4,6,11,14,-3,16
Chennaiyin,1476,8,3,6,5,15,20,-5,15
Mumbai City,1477,1,6,5,3,18,10,8,23
Delhi Dynamo,1477,2,5,7,2,26,17,9,22
FC Pune City,1477,3,6,3,5,15,15,0,21
NorthEast Un,1477,4,5,4,5,12,11,1,19
Kolkata,1477,5,3,8,3,16,16,0,17
Chennaiyin,1477,6,3,7,4,14,18,-4,16
Kerala Blast,1477,7,4,4,6,11,17,-6,16
FC Goa,1477,8,3,4,7,8,16,-8,13
Mumbai City,1478,1,7,4,3,19,8,11,25
Delhi Dynamo,1478,2,6,5,3,24,17,7,23
Kolkata,1478,3,4,8,2,17,15,2,20
NorthEast Un,1478,4,6,2,6,12,11,1,20
FC Pune City,1478,5,5,3,6,14,16,-2,18
Kerala Blast,1478,6,4,4,6,10,17,-7,16
FC Goa,1478,7,4,3,7,11,16,-5,15
Chennaiyin,1478,8,3,5,6,13,20,-7,14
Delhi Dynamo,1479,1,6,5,3,25,16,9,23
Mumbai City,1479,2,6,4,4,16,9,7,22
Kerala Blast,1479,3,5,5,4,12,14,-2,20
NorthEast Un,1479,4,5,3,6,12,12,0,18
Kolkata,1479,5,4,6,4,14,16,-2,18
Chennaiyin,1479,6,4,6,4,16,19,-3,18
FC Pune City,1479,7,4,4,6,12,15,-3,16
FC Goa,1479,8,4,3,7,12,18,-6,15
Mumbai City,1480,1,7,4,3,18,8,10,25
Kolkata,1480,2,5,6,3,17,14,3,21
Delhi Dynamo,1480,3,5,5,4,23,18,5,20
FC Goa,1480,4,6,2,6,12,15,-3,20
NorthEast Un,1480,5,5,3,6,11,11,0,18
FC Pune City,1480,6,5,3,6,14,17,-3,18
Chennaiyin,1480,7,3,6,5,13,18,-5,15
Kerala Blast,1480,8,4,3,7,10,17,-7,15
Mumbai City,1481,1,6,5,3,17,9,8,23
Kolkata,1481,2,5,6,3,17,14,3,21
FC Pune City,1481,3,6,3,5,15,15,0,21
Delhi Dynamo,1481,4,4,8,2,24,17,7,20
NorthEast Un,1481,5,5,3,6,12,12,0,18
Chennaiyin,1481,6,4,5,5,15,22,-7,17
FC Goa,1481,7,4,3,7,13,16,-3,15
Kerala Blast,1481,8,4,3,7,9,17,-8,15
Mumbai City,1482,1,7,4,3,18,9,9,25
Kolkata,1482,2,6,6,2,18,13,5,24
Kerala Blast,1482,3,6,3,5,14,15,-1,21
Delhi Dynamo,1482,4,4,7,3,24,18,6,19
Chennaiyin,1482,5,4,6,4,15,18,-3,18
NorthEast Un,1482,6,4,3,7,11,14,-3,15
FC Pune City,1482,7,4,3,7,12,17,-5,15
FC Goa,1482,8,3,4,7,9,17,-8,13
Mumbai City,1483,1,6,5,3,16,8,8,23
NorthEast Un,1483,2,6,2,6,17,12,5,20
Delhi Dynamo,1483,3,4,7,3,22,19,3,19
FC Pune City,1483,4,5,4,5,16,15,1,19
Kerala Blast,1483,5,5,4,5,13,17,-4,19
Chennaiyin,1483,6,4,6,4,16,19,-3,18
Kolkata,1483,7,3,7,4,14,18,-4,16
FC Goa,1483,8,3,5,6,11,17,-6,14
Mumbai City,1484,1,6,5,3,17,9,8,23
Kerala Blast,1484,2,6,4,4,14,14,0,22
Delhi Dynamo,1484,3,5,6,3,24,16,8,21
Chennaiyin,1484,4,5,5,4,17,18,-1,20
FC Pune City,1484,5,4,5,5,15,17,-2,17
NorthEast Un,1484,6,5,2,7,10,13,-3,17
Kolkata,1484,7,3,7,4,16,18,-2,16
FC Goa,1484,8,4,2,8,12,20,-8,14
Mumbai City,1485,1,7,4,3,22,10,12,25
Delhi Dynamo,1485,2,5,5,4,26,21,5,20
Kerala Blast,1485,3,5,5,4,12,15,-3,20
Kolkata,1485,4,4,7,3,17,17,0,19
FC Goa,1485,5,5,3,6,12,15,-3,18
FC Pune City,1485,6,4,4,6,15,18,-3,16
Chennaiyin,1485,7,3,7,4,14,18,-4,16
NorthEast Un,1485,8,4,3,7,9,13,-4,15
Mumbai City,1486,1,7,4,3,18,9,9,25
Kerala Blast,1486,2,6,3,5,14,17,-3,21
Delhi Dynamo,1486,3,5,5,4,23,17,6,20
Kolkata,1486,4,4,6,4,17,16,1,18
NorthEast Un,1486,5,5,3,6,10,10,0,18
Chennaiyin,1486,6,4,6,4,16,18,-2,18
FC Pune City,1486,7,5,3,6,15,18,-3,18
FC Goa,1486,8,4,2,8,10,18,-8,14
Mumbai City,1487,1,7,4,3,19,9,10,25
Delhi Dynamo,1487,2,5,6,3,24,18,6,21
Kolkata,1487,3,4,7,3,18,17,1,19
NorthEast Un,1487,4,5,3,6,13,11,2,18
Kerala Blast,1487,5,5,3,6,14,18,-4,18
FC Pune City,1487,6,5,3,6,16,21,-5,18
FC Goa,1487,7,4,4,6,12,17,-5,16
Chennaiyin,1487,8,3,6,5,14,19,-5,15
Delhi Dynamo,1488,1,6,6,2,25,16,9,24
Mumbai City,1488,2,6,4,4,16,9,7,22
Kolkata,1488,3,4,8,2,17,15,2,20
Chennaiyin,1488,4,5,5,4,17,18,-1,20
Kerala Blast,1488,5,4,6,4,12,16,-4,18
FC Pune City,1488,6,4,4,6,15,18,-3,16
NorthEast Un,1488,7,4,3,7,12,15,-3,15
FC Goa,1488,8,3,4,7,9,16,-7,13
Mumbai City,1489,1,7,4,3,20,8,12,25
Kerala Blast,1489,2,6,4,4,17,16,1,22
FC Goa,1489,3,6,2,6,12,14,-2,20
NorthEast Un,1489,4,6,2,6,11,13,-2,20
FC Pune City,1489,5,5,4,5,16,17,-1,19
Delhi Dynamo,1489,6,4,5,5,21,20,1,17
Kolkata,1489,7,3,6,5,13,16,-3,15
Chennaiyin,1489,8,3,5,6,13,19,-6,14
Kerala Blast,1490,1,7,3,4,13,14,-1,24
Mumbai City,1490,2,6,4,4,17,11,6,22
Delhi Dynamo,1490,3,5,5,4,24,17,7,20
NorthEast Un,1490,4,5,3,6,12,12,0,18
FC Goa,1490,5,5,3,6,13,16,-3,18
Kolkata,1490,6,3,7,4,15,17,-2,16
FC Pune City,1490,7,4,4,6,13,16,-3,16
Chennaiyin,1490,8,3,7,4,15,19,-4,16
Delhi Dynamo,1491,1,6,5,3,26,18,8,23
Mumbai City,1491,2,6,4,4,16,9,7,22
NorthEast Un,1491,3,6,3,5,13,10,3,21
FC Pune City,1491,4,6,3,5,15,15,0,21
Kolkata,1491,5,4,7,3,18,13,5,19
Chennaiyin,1491,6,4,5,5,16,20,-4,17
Kerala Blast,1491,7,4,4,6,10,20,-10,16
FC Goa,1491,8,3,3,8,11,20,-9,12
Mumbai City,1492,1,7,4,3,18,8,10,25
Delhi Dynamo,1492,2,5,6,3,27,17,10,21
Kolkata,1492,3,5,6,3,16,14,2,21
Chennaiyin,1492,4,5,5,4,18,18,0,20
FC Pune City,1492,5,5,3,6,13,15,-2,18
Kerala Blast,1492,6,5,3,6,11,15,-4,18
NorthEast Un,1492,7,4,3,7,10,15,-5,15
FC Goa,1492,8,4,2,8,11,22,-11,14
Delhi Dynamo,1493,1,6,6,2,28,17,11,24
Mumbai City,1493,2,6,4,4,17,10,7,22
NorthEast Un,1493,3,6,3,5,15,9,6,21
Kolkata,1493,4,4,7,3,15,14,1,19
FC Pune City,1493,5,5,4,5,13,14,-1,19
Kerala Blast,1493,6,4,5,5,10,15,-5,17
Chennaiyin,1493,7,3,6,5,14,23,-9,15
FC Goa,1493,8,3,3,8,11,21,-10,12
Mumbai City,1494,1,7,4,3,20,10,10,25
FC Goa,1494,2,6,2,6,16,16,0,20
NorthEast Un,1494,3,5,4,5,15,13,2,19
FC Pune City,1494,4,5,4,5,16,17,-1,19
Kolkata,1494,5,4,6,4,17,18,-1,18
Delhi Dynamo,1494,6,4,5,5,25,23,2,17
Kerala Blast,1494,7,4,5,5,12,17,-5,17
Chennaiyin,1494,8,3,6,5,14,21,-7,15
Mumbai City,1495,1,6,4,4,16,9,7,22
Delhi Dynamo,1495,2,5,6,3,22,16,6,21
FC Goa,1495,3,6,2,6,14,14,0,20
Kerala Blast,1495,4,5,4,5,12,16,-4,19
NorthEast Un,1495,5,5,3,6,10,10,0,18
FC Pune City,1495,6,5,3,6,18,20,-2,18
Chennaiyin,1495,7,4,5,5,14,19,-5,17
Kolkata,1495,8,3,7,4,18,20,-2,16
Kolkata,1496,1,6,6,2,19,14,5,24
Mumbai City,1496,2,6,5,3,17,9,8,23
Delhi Dynamo,1496,3,5,7,2,26,18,8,22
Chennaiyin,1496,4,4,6,4,14,17,-3,18
Kerala Blast,1496,5,5,3,6,12,18,-6,18
NorthEast Un,1496,6,5,2,7,12,13,-1,17
FC Pune City,1496,7,4,3,7,12,16,-4,15
FC Goa,1496,8,3,4,7,11,18,-7,13
Mumbai City,1497,1,7,4,3,19,8,11,25
Kerala Blast,1497,2,6,4,4,13,14,-1,22
Delhi Dynamo,1497,3,5,6,3,25,18,7,21
FC Pune City,1497,4,5,4,5,13,14,-1,19
Chennaiyin,1497,5,4,6,4,16,18,-2,18
Kolkata,1497,6,3,7,4,16,17,-1,16
NorthEast Un,1497,7,4,3,7,9,14,-5,15
FC Goa,1497,8,3,4,7,12,20,-8,13
Mumbai City,1498,1,6,5,3,16,8,8,23
Kolkata,1498,2,5,6,3,17,14,3,21
Kerala Blast,1498,3,6,3,5,13,16,-3,21
Chennaiyin,1498,4,5,5,4,17,17,0,20
Delhi Dynamo,1498,5,4,6,4,21,17,4,18
NorthEast Un,1498,6,5,2,7,12,13,-1,17
FC Goa,1498,7,5,2,7,11,17,-6,17
FC Pune City,1498,8,4,3,7,12,17,-5,15
Mumbai City,1499,1,6,5,3,19,11,8,23
Delhi Dynamo,1499,2,5,6,3,28,20,8,21
Kerala Blast,1499,3,5,5,4,11,14,-3,20
NorthEast Un,1499,4,5,4,5,13,12,1,19
FC Pune City,1499,5,5,4,5,14,15,-1,19
Kolkata,1499,6,4,6,4,16,15,1,18
Chennaiyin,1499,7,4,6,4,16,19,-3,18
FC Goa,1499,8,3,2,9,10,21,-11,11
Mumbai City,1500,1,6,5,3,18,10,8,23
Delhi Dynamo,1500,2,5,6,3,27,19,8,21
Kolkata,1500,3,5,6,3,19,14,5,21
Kerala Blast,1500,4,6,3,5,13,16,-3,21
NorthEast Un,1500,5,5,3,6,13,12,1,18
FC Pune City,1500,6,5,3,6,13,15,-2,18
Chennaiyin,1500,7,3,6,5,13,18,-5,15
FC Goa,1500,8,4,2,8,9,21,-12,14
Delhi Dynamo,1501,1,6,6,2,23,14,9,24
Mumbai City,1501,2,6,4,4,16,9,7,22
Kolkata,1501,3,5,7,2,20,15,5,22
Kerala Blast,1501,4,5,4,5,14,16,-2,19
Chennaiyin,1501,5,4,6,4,16,18,-2,18
FC Pune City,1501,6,5,3,6,13,15,-2,18
NorthEast Un,1501,7,4,3,7,10,14,-4,15
FC Goa,1501,8,3,3,8,11,22,-11,12
Kolkata,1502,1,6,6,2,18,12,6,24
Mumbai City,1502,2,6,5,3,17,9,8,23
Delhi Dynamo,1502,3,4,6,4,22,18,4,18
FC Pune City,1502,4,5,3,6,15,17,-2,18
Chennaiyin,1502,5,4,6,4,15,18,-3,18
Kerala Blast,1502,6,5,3,6,11,18,-7,18
NorthEast Un,1502,7,5,2,7,12,12,0,17
FC Goa,1502,8,4,3,7,10,16,-6,15
Mumbai City,1503,1,7,4,3,19,9,10,25
Delhi Dynamo,1503,2,6,5,3,27,20,7,23
Kolkata,1503,3,5,7,2,20,16,4,22
Chennaiyin,1503,4,4,6,4,16,19,-3,18
Kerala Blast,1503,5,5,3,6,14,19,-5,18
NorthEast Un,1503,6,5,2,7,13,13,0,17
FC Pune City,1503,7,4,4,6,14,18,-4,16
FC Goa,1503,8,3,3,8,14,23,-9,12
Mumbai City,1504,1,7,4,3,18,9,9,25
Kerala Blast,1504,2,6,3,5,15,18,-3,21
NorthEast Un,1504,3,6,2,6,13,11,2,20
Chennaiyin,1504,4,4,6,4,15,18,-3,18
FC Goa,1504,5,5,3,6,12,15,-3,18
Delhi Dynamo,1504,6,4,5,5,22,20,2,17
Kolkata,1504,7,3,7,4,15,16,-1,16
FC Pune City,1504,8,4,4,6,13,16,-3,16
Mumbai City,1505,1,6,5,3,16,8,8,23
Delhi Dynamo,1505,2,4,7,3,21,15,6,19
Kolkata,1505,3,4,7,3,15,14,1,19
NorthEast Un,1505,4,5,4,5,11,10,1,19
FC Pune City,1505,5,5,4,5,14,15,-1,19
Kerala Blast,1505,6,4,5,5,10,15,-5,17
FC Goa,1505,7,4,4,6,10,14,-4,16
Chennaiyin,1505,8,3,6,5,13,19,-6,15
Mumbai City,1506,1,7,4,3,19,10,9,25
Kolkata,1506,2,5,7,2,20,14,6,22
Kerala Blast,1506,3,6,3,5,13,17,-4,21
FC Goa,1506,4,5,3,6,11,15,-4,18
Delhi Dynamo,1506,5,4,5,5,24,21,3,17
NorthEast Un,1506,6,5,2,7,11,12,-1,17
Chennaiyin,1506,7,4,5,5,15,18,-3,17
FC Pune City,1506,8,4,3,7,14,20,-6,15
Delhi Dynamo,1507,1,5,7,2,26,17,9,22
Mumbai City,1507,2,6,4,4,16,10,6,22
Kerala Blast,1507,3,6,4,4,12,14,-2,22
NorthEast Un,1507,4,5,3,6,12,12,0,18
FC Goa,1507,5,5,3,6,18,19,-1,18
Kolkata,1507,6,4,6,4,16,19,-3,18
FC Pune City,1507,7,4,4,6,12,15,-3,16
Chennaiyin,1507,8,3,5,6,14,20,-6,14
Mumbai City,1508,1,7,4,3,18,9,9,25
Delhi Dynamo,1508,2,6,5,3,26,17,9,23
Kerala Blast,1508,3,6,4,4,15,14,1,22
Chennaiyin,1508,4,5,5,4,18,19,-1,20
Kolkata,1508,5,4,6,4,14,14,0,18
NorthEast Un,1508,6,4,3,7,11,13,-2,15
FC Pune City,1508,7,4,3,7,12,19,-7,15
FC Goa,1508,8,4,2,8,11,20,-9,14
Mumbai City,1509,1,7,4,3,18,9,9,25
Delhi Dynamo,1509,2,5,6,3,29,17,12,21
Kerala Blast,1509,3,6,3,5,13,16,-3,21
FC Pune City,1509,4,5,3,6,16,17,-1,18
NorthEast Un,1509,5,5,3,6,11,16,-5,18
Chennaiyin,1509,6,3,7,4,14,18,-4,16
FC Goa,1509,7,4,4,6,11,16,-5,16
Kolkata,1509,8,3,6,5,14,17,-3,15
Delhi Dynamo,1510,1,6,6,2,30,17,13,24
Mumbai City,1510,2,6,4,4,18,11,7,22
NorthEast Un,1510,3,6,3,5,14,12,2,21
FC Pune City,1510,4,5,4,5,15,15,0,19
Kerala Blast,1510,5,5,3,6,11,17,-6,18
Kolkata,1510,6,3,7,4,14,16,-2,16
Chennaiyin,1510,7,3,6,5,14,19,-5,15
FC Goa,1510,8,4,3,7,10,19,-9,15
Delhi Dynamo,1511,1,6,6,2,28,18,10,24
Mumbai City,1511,2,6,4,4,17,10,7,22
Kolkata,1511,3,4,7,3,16,15,1,19
FC Pune City,1511,4,5,3,6,15,17,-2,18
Chennaiyin,1511,5,4,6,4,14,17,-3,18
NorthEast Un,1511,6,4,5,5,14,14,0,17
Kerala Blast,1511,7,4,5,5,13,18,-5,17
FC Goa,1511,8,4,2,8,11,19,-8,14
Mumbai City,1512,1,7,4,3,18,9,9,25
Delhi Dynamo,1512,2,5,6,3,25,18,7,21
NorthEast Un,1512,3,5,4,5,12,11,1,19
Kerala Blast,1512,4,5,4,5,13,16,-3,19
Kolkata,1512,5,3,9,2,18,17,1,18
FC Pune City,1512,6,4,4,6,14,18,-4,16
Chennaiyin,1512,7,3,6,5,13,18,-5,15
FC Goa,1512,8,4,3,7,12,18,-6,15
Mumbai City,1513,1,7,4,3,17,8,9,25
Kolkata,1513,2,5,7,2,17,13,4,22
Kerala Blast,1513,3,6,4,4,17,16,1,22
Delhi Dynamo,1513,4,4,6,4,22,20,2,18
Chennaiyin,1513,5,4,6,4,16,19,-3,18
NorthEast Un,1513,6,4,4,6,11,13,-2,16
FC Pune City,1513,7,4,3,7,14,21,-7,15
FC Goa,1513,8,4,2,8,13,17,-4,14
Mumbai City,1514,1,7,4,3,17,8,9,25
Kolkata,1514,2,6,6,2,21,12,9,24
NorthEast Un,1514,3,7,2,5,14,10,4,23
Delhi Dynamo,1514,4,4,6,4,23,18,5,18
Kerala Blast,1514,5,5,3,6,12,18,-6,18
FC Pune City,1514,6,4,3,7,13,17,-4,15
Chennaiyin,1514,7,3,6,5,14,19,-5,15
FC Goa,1514,8,3,4,7,11,23,-12,13
Kolkata,1515,1,6,6,2,20,12,8,24
Mumbai City,1515,2,6,5,3,19,11,8,23
Delhi Dynamo,1515,3,5,7,2,29,17,12,22
Kerala Blast,1515,4,6,3,5,13,16,-3,21
NorthEast Un,1515,5,5,3,6,11,12,-1,18
FC Pune City,1515,6,4,3,7,13,19,-6,15
Chennaiyin,1515,7,3,5,6,14,21,-7,14
FC Goa,1515,8,4,2,8,10,21,-11,14
Mumbai City,1516,1,7,4,3,18,8,10,25
Kerala Blast,1516,2,7,3,4,13,13,0,24
Delhi Dynamo,1516,3,6,5,3,23,16,7,23
Kolkata,1516,4,5,6,3,18,15,3,21
NorthEast Un,1516,5,4,3,7,11,13,-2,15
FC Pune City,1516,6,4,3,7,12,17,-5,15
Chennaiyin,1516,7,3,6,5,15,21,-6,15
FC Goa,1516,8,4,2,8,11,18,-7,14
Mumbai City,1517,1,6,5,3,16,8,8,23
Kolkata,1517,2,4,8,2,19,17,2,20
Kerala Blast,1517,3,5,5,4,12,15,-3,20
Delhi Dynamo,1517,4,4,6,4,22,17,5,18
NorthEast Un,1517,5,5,3,6,11,11,0,18
FC Goa,1517,6,5,3,6,14,18,-4,18
FC Pune City,1517,7,4,4,6,15,18,-3,16
Chennaiyin,1517,8,3,6,5,15,20,-5,15
Delhi Dynamo,1518,1,7,5,2,28,15,13,26
Mumbai City,1518,2,6,4,4,16,10,6,22
Kerala Blast,1518,3,6,3,5,12,14,-2,21
Kolkata,1518,4,4,7,3,20,18,2,19
Chennaiyin,1518,5,4,6,4,16,17,-1,18
FC Pune City,1518,6,5,3,6,15,19,-4,18
NorthEast Un,1518,7,4,3,7,9,12,-3,15
FC Goa,1518,8,3,3,8,11,22,-11,12
Mumbai City,1519,1,7,4,3,18,9,9,25
Kolkata,1519,2,5,6,3,16,14,2,21
FC Pune City,1519,3,6,3,5,15,15,0,21
Delhi Dynamo,1519,4,5,5,4,24,19,5,20
Chennaiyin,1519,5,5,5,4,19,18,1,20
Kerala Blast,1519,6,4,4,6,9,15,-6,16
NorthEast Un,1519,7,4,3,7,10,14,-4,15
FC Goa,1519,8,4,2,8,11,18,-7,14
Delhi Dynamo,1520,1,6,6,2,29,17,12,24
Mumbai City,1520,2,6,5,3,18,10,8,23
Kerala Blast,1520,3,6,3,5,13,16,-3,21
Kolkata,1520,4,4,6,4,16,16,0,18
FC Pune City,1520,5,5,3,6,13,16,-3,18
Chennaiyin,1520,6,4,5,5,16,20,-4,17
FC Goa,1520,7,5,2,7,14,19,-5,17
NorthEast Un,1520,8,4,2,8,10,15,-5,14
Mumbai City,1521,1,7,4,3,18,8,10,25
Kolkata,1521,2,5,6,3,16,14,2,21
NorthEast Un,1521,3,6,2,6,13,12,1,20
Chennaiyin,1521,4,5,5,4,15,17,-2,20
FC Pune City,1521,5,5,3,6,13,15,-2,18
Delhi Dynamo,1521,6,4,5,5,22,21,1,17
FC Goa,1521,7,5,2,7,12,15,-3,17
Kerala Blast,1521,8,4,3,7,11,18,-7,15
Mumbai City,1522,1,7,4,3,19,9,10,25
Kolkata,1522,2,5,7,2,20,13,7,22
Delhi Dynamo,1522,3,5,6,3,24,18,6,21
NorthEast Un,1522,4,5,4,5,14,11,3,19
Chennaiyin,1522,5,4,6,4,14,17,-3,18
Kerala Blast,1522,6,4,5,5,11,18,-7,17
FC Pune City,1522,7,4,4,6,13,17,-4,16
FC Goa,1522,8,3,2,9,9,21,-12,11
Kerala Blast,1523,1,7,3,4,16,17,-1,24
Mumbai City,1523,2,6,5,3,17,9,8,23
Delhi Dynamo,1523,3,5,7,2,26,18,8,22
Kolkata,1523,4,4,7,3,15,14,1,19
Chennaiyin,1523,5,4,5,5,17,24,-7,17
FC Pune City,1523,6,4,4,6,13,16,-3,16
FC Goa,1523,7,4,3,7,17,19,-2,15
NorthEast Un,1523,8,4,2,8,12,16,-4,14
Mumbai City,1524,1,7,4,3,18,9,9,25
Delhi Dynamo,1524,2,5,6,3,27,18,9,21
Chennaiyin,1524,3,5,5,4,18,17,1,20
Kolkata,1524,4,4,7,3,17,15,2,19
Kerala Blast,1524,5,5,4,5,11,15,-4,19
FC Pune City,1524,6,5,3,6,13,16,-3,18
NorthEast Un,1524,7,4,4,6,10,12,-2,16
FC Goa,1524,8,3,3,8,10,22,-12,12
Delhi Dynamo,1525,1,5,7,2,23,15,8,22
Mumbai City,1525,2,6,4,4,16,9,7,22
Kolkata,1525,3,5,6,3,18,16,2,21
Kerala Blast,1525,4,5,4,5,12,14,-2,19
FC Goa,1525,5,5,3,6,13,14,-1,18
NorthEast Un,1525,6,5,3,6,12,13,-1,18
FC Pune City,1525,7,4,4,6,14,18,-4,16
Chennaiyin,1525,8,3,5,6,13,22,-9,14
Mumbai City,1526,1,7,4,3,18,9,9,25
Kolkata,1526,2,5,6,3,16,14,2,21
FC Goa,1526,3,6,2,6,13,14,-1,20
NorthEast Un,1526,4,5,4,5,13,11,2,19
Delhi Dynamo,1526,5,4,5,5,22,19,3,17
Kerala Blast,1526,6,4,5,5,10,15,-5,17
FC Pune City,1526,7,4,4,6,13,17,-4,16
Chennaiyin,1526,8,3,6,5,15,21,-6,15
Mumbai City,1527,1,6,5,3,16,8,8,23
Delhi Dynamo,1527,2,5,7,2,25,17,8,22
Kolkata,1527,3,5,6,3,18,14,4,21
NorthEast Un,1527,4,5,3,6,15,14,1,18
FC Goa,1527,5,5,3,6,13,16,-3,18
Kerala Blast,1527,6,5,3,6,13,20,-7,18
FC Pune City,1527,7,4,3,7,13,18,-5,15
Chennaiyin,1527,8,3,6,5,14,20,-6,15
Mumbai City,1528,1,6,4,4,17,10,7,22
Kolkata,1528,2,5,7,2,20,14,6,22
Delhi Dynamo,1528,3,5,6,3,25,18,7,21
FC Pune City,1528,4,5,4,5,14,15,-1,19
NorthEast Un,1528,5,5,3,6,12,12,0,18
Chennaiyin,1528,6,4,5,5,14,19,-5,17
Kerala Blast,1528,7,4,4,6,10,18,-8,16
FC Goa,1528,8,4,3,7,12,18,-6,15
Mumbai City,1529,1,6,4,4,16,9,7,22
Kolkata,1529,2,5,7,2,19,14,5,22
NorthEast Un,1529,3,6,3,5,16,13,3,21
Delhi Dynamo,1529,4,5,5,4,22,16,6,20
Kerala Blast,1529,5,5,5,4,16,18,-2,20
Chennaiyin,1529,6,3,6,5,14,20,-6,15
FC Pune City,1529,7,4,3,7,12,18,-6,15
FC Goa,1529,8,4,3,7,9,16,-7,15
Mumbai City,1530,1,7,4,3,19,10,9,25
Delhi Dynamo,1530,2,5,6,3,24,17,7,21
FC Pune City,1530,3,6,3,5,14,14,0,21
Kerala Blast,1530,4,6,3,5,14,16,-2,21
Kolkata,1530,5,4,6,4,16,16,0,18
Chennaiyin,1530,6,3,7,4,15,19,-4,16
NorthEast Un,1530,7,4,3,7,11,14,-3,15
FC Goa,1530,8,3,4,7,10,17,-7,13
Mumbai City,1531,1,7,4,3,18,9,9,25
Kolkata,1531,2,6,6,2,16,12,4,24
Chennaiyin,1531,3,5,5,4,19,19,0,20
Delhi Dynamo,1531,4,4,6,4,25,20,5,18
FC Pune City,1531,5,5,3,6,13,15,-2,18
NorthEast Un,1531,6,4,4,6,11,14,-3,16
Kerala Blast,1531,7,4,4,6,10,16,-6,16
FC Goa,1531,8,4,2,8,13,20,-7,14
Delhi Dynamo,1532,1,7,5,2,27,17,10,26
Mumbai City,1532,2,6,4,4,18,11,7,22
Kolkata,1532,3,4,7,3,17,16,1,19
FC Pune City,1532,4,5,4,5,15,16,-1,19
NorthEast Un,1532,5,5,3,6,11,11,0,18
Kerala Blast,1532,6,4,4,6,12,18,-6,16
Chennaiyin,1532,7,3,6,5,14,19,-5,15
FC Goa,1532,8,4,3,7,10,16,-6,15
Mumbai City,1533,1,7,4,3,20,8,12,25
Delhi Dynamo,1533,2,6,5,3,27,19,8,23
Kolkata,1533,3,5,6,3,15,13,2,21
Chennaiyin,1533,4,4,6,4,16,18,-2,18
FC Pune City,1533,5,5,3,6,13,15,-2,18
Kerala Blast,1533,6,5,3,6,10,15,-5,18
FC Goa,1533,7,4,3,7,11,17,-6,15
NorthEast Un,1533,8,4,2,8,9,16,-7,14
Mumbai City,1534,1,7,4,3,18,8,10,25
Delhi Dynamo,1534,2,6,5,3,24,17,7,23
Kolkata,1534,3,5,6,3,17,15,2,21
NorthEast Un,1534,4,5,3,6,14,14,0,18
FC Pune City,1534,5,5,3,6,15,17,-2,18
FC Goa,1534,6,5,2,7,12,17,-5,17
Chennaiyin,1534,7,3,6,5,14,19,-5,15
Kerala Blast,1534,8,4,3,7,13,20,-7,15
Mumbai City,1535,1,7,4,3,19,9,10,25
Kerala Blast,1535,2,6,4,4,17,15,2,22
Delhi Dynamo,1535,3,5,5,4,24,19,5,20
NorthEast Un,1535,4,5,3,6,12,13,-1,18
FC Pune City,1535,5,5,3,6,16,18,-2,18
Kolkata,1535,6,3,8,3,15,17,-2,17
Chennaiyin,1535,7,3,7,4,14,18,-4,16
FC Goa,1535,8,3,4,7,9,17,-8,13
Delhi Dynamo,1536,1,6,6,2,26,16,10,24
Mumbai City,1536,2,6,5,3,17,9,8,23
Kolkata,1536,3,5,7,2,17,12,5,22
Chennaiyin,1536,4,5,5,4,18,18,0,20
Kerala Blast,1536,5,5,4,5,10,14,-4,19
FC Pune City,1536,6,4,4,6,12,15,-3,16
NorthEast Un,1536,7,4,3,7,10,14,-4,15
FC Goa,1536,8,3,2,9,9,21,-12,11
Mumbai City,1537,1,6,5,3,17,9,8,23
NorthEast Un,1537,2,6,3,5,13,11,2,21
Kerala Blast,1537,3,6,3,5,13,15,-2,21
Delhi Dynamo,1537,4,4,7,3,25,19,6,19
FC Goa,1537,5,5,3,6,15,16,-1,18
FC Pune City,1537,6,4,4,6,12,15,-3,16
Kolkata,1537,7,3,7,4,13,17,-4,16
Chennaiyin,1537,8,3,6,5,13,19,-6,15
Mumbai City,1538,1,6,4,4,16,11,5,22
Delhi Dynamo,1538,2,5,6,3,26,18,8,21
Kolkata,1538,3,4,8,2,18,16,2,20
Kerala Blast,1538,4,5,5,4,15,16,-1,20
NorthEast Un,1538,5,5,4,5,15,13,2,19
Chennaiyin,1538,6,4,6,4,18,19,-1,18
FC Pune City,1538,7,4,3,7,13,19,-6,15
FC Goa,1538,8,3,4,7,12,21,-9,13
Delhi Dynamo,1539,1,6,6,2,26,16,10,24
Mumbai City,1539,2,6,4,4,16,10,6,22
Kerala Blast,1539,3,6,4,4,12,14,-2,22
Kolkata,1539,4,4,7,3,18,17,1,19
NorthEast Un,1539,5,5,3,6,12,11,1,18
FC Goa,1539,6,5,2,7,16,17,-1,17
FC Pune City,1539,7,4,3,7,14,18,-4,15
Chennaiyin,1539,8,3,5,6,13,24,-11,14
Delhi Dynamo,1540,1,6,6,2,26,16,10,24
Mumbai City,1540,2,6,4,4,16,9,7,22
Kolkata,1540,3,4,7,3,17,16,1,19
FC Pune City,1540,4,5,4,5,14,15,-1,19
Chennaiyin,1540,5,4,6,4,16,19,-3,18
Kerala Blast,1540,6,4,6,4,10,14,-4,18
NorthEast Un,1540,7,4,5,5,11,11,0,17
FC Goa,1540,8,3,2,9,11,21,-10,11
Mumbai City,1541,1,6,5,3,18,10,8,23
NorthEast Un,1541,2,7,2,5,15,10,5,23
Kolkata,1541,3,4,8,2,19,17,2,20
Delhi Dynamo,1541,4,4,7,3,24,18,6,19
Kerala Blast,1541,5,5,3,6,13,18,-5,18
FC Pune City,1541,6,4,4,6,13,16,-3,16
Chennaiyin,1541,7,3,6,5,13,20,-7,15
FC Goa,1541,8,3,5,6,11,17,-6,14
Mumbai City,1542,1,7,4,3,19,9,10,25
Kerala Blast,1542,2,6,3,5,14,15,-1,21
Kolkata,1542,3,4,8,2,14,12,2,20
NorthEast Un,1542,4,6,2,6,12,13,-1,20
Delhi Dynamo,1542,5,4,6,4,23,19,4,18
FC Pune City,1542,6,4,4,6,13,16,-3,16
FC Goa,1542,7,4,4,6,9,14,-5,16
Chennaiyin,1542,8,3,5,6,13,19,-6,14
Delhi Dynamo,1543,1,7,5,2,29,16,13,26
Mumbai City,1543,2,6,4,4,17,10,7,22
Kolkata,1543,3,4,8,2,20,18,2,20
FC Pune City,1543,4,5,4,5,15,16,-1,19
NorthEast Un,1543,5,5,3,6,13,16,-3,18
FC Goa,1543,6,4,3,7,16,19,-3,15
Kerala Blast,1543,7,4,3,7,11,18,-7,15
Chennaiyin,1543,8,3,6,5,17,25,-8,15
Mumbai City,1544,1,6,5,3,17,9,8,23
Delhi Dynamo,1544,2,5,6,3,24,16,8,21
Kolkata,1544,3,4,7,3,17,16,1,19
FC Pune City,1544,4,5,4,5,17,17,0,19
Kerala Blast,1544,5,5,4,5,14,19,-5,19
NorthEast Un,1544,6,5,3,6,15,15,0,18
Chennaiyin,1544,7,4,6,4,18,21,-3,18
FC Goa,1544,8,3,3,8,10,19,-9,12
Mumbai City,1545,1,7,4,3,17,8,9,25
Kolkata,1545,2,4,8,2,16,14,2,20
Delhi Dynamo,1545,3,4,6,4,22,17,5,18
Chennaiyin,1545,4,4,6,4,19,22,-3,18
Kerala Blast,1545,5,4,6,4,14,18,-4,18
FC Pune City,1545,6,4,5,5,15,17,-2,17
NorthEast Un,1545,7,4,4,6,13,14,-1,16
FC Goa,1545,8,4,3,7,13,19,-6,15
Mumbai City,1546,1,7,4,3,22,8,14,25
Delhi Dynamo,1546,2,6,5,3,26,21,5,23
Kerala Blast,1546,3,6,4,4,15,14,1,22
Kolkata,1546,4,3,9,2,17,16,1,18
Chennaiyin,1546,5,3,7,4,16,20,-4,16
FC Pune City,1546,6,4,4,6,14,20,-6,16
NorthEast Un,1546,7,4,3,7,12,16,-4,15
FC Goa,1546,8,3,4,7,10,17,-7,13
Mumbai City,1547,1,6,5,3,16,8,8,23
Delhi Dynamo,1547,2,5,7,2,27,18,9,22
Kerala Blast,1547,3,6,3,5,13,16,-3,21
Kolkata,1547,4,4,6,4,15,15,0,18
FC Pune City,1547,5,5,3,6,14,15,-1,18
Chennaiyin,1547,6,4,5,5,16,20,-4,17
FC Goa,1547,7,5,2,7,12,18,-6,17
NorthEast Un,1547,8,4,3,7,14,17,-3,15
Mumbai City,1548,1,6,5,3,18,10,8,23
Delhi Dynamo,1548,2,5,6,3,25,17,8,21
Kolkata,1548,3,5,6,3,18,14,4,21
NorthEast Un,1548,4,6,2,6,12,10,2,20
Chennaiyin,1548,5,5,5,4,16,18,-2,20
Kerala Blast,1548,6,5,4,5,10,15,-5,19
FC Pune City,1548,7,4,4,6,12,17,-5,16
FC Goa,1548,8,3,2,9,10,20,-10,11
Mumbai City,1549,1,6,5,3,17,9,8,23
Delhi Dynamo,1549,2,4,8,2,23,16,7,20
Kolkata,1549,3,4,8,2,17,15,2,20
NorthEast Un,1549,4,5,3,6,12,11,1,18
Chennaiyin,1549,5,4,6,4,15,18,-3,18
Kerala Blast,1549,6,4,5,5,11,17,-6,17
FC Pune City,1549,7,4,4,6,13,16,-3,16
FC Goa,1549,8,3,5,6,11,17,-6,14
Mumbai City,1550,1,7,4,3,18,8,10,25
Kolkata,1550,2,5,7,2,18,14,4,22
Kerala Blast,1550,3,6,3,5,14,16,-2,21
Chennaiyin,1550,4,5,5,4,18,18,0,20
Delhi Dynamo,1550,5,4,5,5,24,23,1,17
NorthEast Un,1550,6,5,2,7,14,15,-1,17
FC Pune City,1550,7,4,3,7,13,18,-5,15
FC Goa,1550,8,4,3,7,11,18,-7,15
Delhi Dynamo,1551,1,5,7,2,25,15,10,22
Mumbai City,1551,2,6,4,4,16,11,5,22
Kolkata,1551,3,5,7,2,19,15,4,22
NorthEast Un,1551,4,5,4,5,12,11,1,19
FC Pune City,1551,5,5,3,6,14,15,-1,18
FC Goa,1551,6,4,4,6,12,17,-5,16
Kerala Blast,1551,7,4,4,6,12,20,-8,16
Chennaiyin,1551,8,3,5,6,13,19,-6,14
Mumbai City,1552,1,6,5,3,17,9,8,23
Delhi Dynamo,1552,2,5,7,2,28,19,9,22
Kerala Blast,1552,3,6,3,5,13,15,-2,21
Kolkata,1552,4,4,7,3,17,15,2,19
NorthEast Un,1552,5,5,3,6,15,16,-1,18
FC Pune City,1552,6,5,3,6,13,15,-2,18
Chennaiyin,1552,7,4,5,5,16,20,-4,17
FC Goa,1552,8,3,3,8,11,21,-10,12
Mumbai City,1553,1,7,4,3,18,8,10,25
Delhi Dynamo,1553,2,6,5,3,27,17,10,23
Kolkata,1553,3,5,6,3,16,15,1,21
Kerala Blast,1553,4,5,4,5,13,16,-3,19
FC Goa,1553,5,5,2,7,13,19,-6,17
NorthEast Un,1553,6,4,4,6,10,12,-2,16
Chennaiyin,1553,7,3,6,5,14,19,-5,15
FC Pune City,1553,7,4,3,7,14,19,-5,15
Mumbai City,1554,1,6,4,4,17,11,6,22
Delhi Dynamo,1554,2,5,6,3,27,20,7,21
Chennaiyin,1554,3,5,5,4,17,17,0,20
Kerala Blast,1554,4,5,4,5,12,16,-4,19
NorthEast Un,1554,5,5,3,6,11,13,-2,18
Kolkata,1554,6,3,8,3,15,15,0,17
FC Pune City,1554,7,4,5,5,14,16,-2,17
FC Goa,1554,8,4,3,7,14,19,-5,15
Kolkata,1555,1,6,6,2,19,13,6,24
Delhi Dynamo,1555,2,6,5,3,25,18,7,23
Mumbai City,1555,3,6,4,4,17,11,6,22
Kerala Blast,1555,4,5,4,5,11,16,-5,19
NorthEast Un,1555,5,5,3,6,13,11,2,18
FC Pune City,1555,6,4,4,6,14,18,-4,16
Chennaiyin,1555,7,3,6,5,16,22,-6,15
FC Goa,1555,8,4,2,8,12,18,-6,14
Delhi Dynamo,1556,1,6,6,2,25,15,10,24
Mumbai City,1556,2,6,5,3,17,9,8,23
Kerala Blast,1556,3,5,5,4,13,16,-3,20
Kolkata,1556,4,3,8,3,15,15,0,17
FC Pune City,1556,5,4,5,5,16,18,-2,17
Chennaiyin,1556,6,3,7,4,14,18,-4,16
NorthEast Un,1556,7,4,3,7,9,11,-2,15
FC Goa,1556,8,4,3,7,11,18,-7,15
Mumbai City,1557,1,7,4,3,19,8,11,25
Kolkata,1557,2,5,7,2,18,14,4,22
Kerala Blast,1557,3,6,4,4,14,15,-1,22
Delhi Dynamo,1557,4,5,5,4,23,19,4,20
Chennaiyin,1557,5,4,6,4,14,17,-3,18
NorthEast Un,1557,6,5,2,7,12,12,0,17
FC Pune City,1557,7,4,3,7,13,18,-5,15
FC Goa,1557,8,3,3,8,8,18,-10,12
Mumbai City,1558,1,7,4,3,17,8,9,25
NorthEast Un,1558,2,6,3,5,11,9,2,21
Kolkata,1558,3,5,6,3,18,20,-2,21
Kerala Blast,1558,4,5,4,5,16,16,0,19
FC Pune City,1558,5,5,3,6,16,18,-2,18
Delhi Dynamo,1558,6,4,5,5,22,19,3,17
Chennaiyin,1558,7,3,6,5,15,20,-5,15
FC Goa,1558,8,4,3,7,13,18,-5,15
Delhi Dynamo,1559,1,6,5,3,27,19,8,23
Mumbai City,1559,2,6,4,4,17,10,7,22
NorthEast Un,1559,3,6,2,6,15,13,2,20
Kerala Blast,1559,4,5,4,5,13,17,-4,19
FC Pune City,1559,5,5,3,6,14,16,-2,18
Chennaiyin,1559,6,4,6,4,16,19,-3,18
Kolkata,1559,7,3,7,4,14,15,-1,16
FC Goa,1559,8,4,3,7,11,18,-7,15
Mumbai City,1560,1,7,4,3,18,9,9,25
Delhi Dynamo,1560,2,6,5,3,27,18,9,23
Kerala Blast,1560,3,6,4,4,15,16,-1,22
Kolkata,1560,4,5,6,3,16,14,2,21
NorthEast Un,1560,5,5,3,6,14,14,0,18
FC Pune City,1560,6,4,3,7,12,17,-5,15
Chennaiyin,1560,7,3,5,6,13,20,-7,14
FC Goa,1560,8,4,2,8,10,17,-7,14
Delhi Dynamo,1561,1,7,5,2,27,15,12,26
Mumbai City,1561,2,6,4,4,16,10,6,22
Kerala Blast,1561,3,5,5,4,14,17,-3,20
Kolkata,1561,4,3,9,2,15,14,1,18
FC Pune City,1561,5,4,5,5,14,16,-2,17
Chennaiyin,1561,6,4,5,5,17,22,-5,17
FC Goa,1561,7,4,3,7,13,18,-5,15
NorthEast Un,1561,8,4,2,8,12,16,-4,14
Mumbai City,1562,1,7,4,3,21,8,13,25
Delhi Dynamo,1562,2,6,5,3,28,20,8,23
Kolkata,1562,3,4,7,3,16,14,2,19
Kerala Blast,1562,4,5,4,5,11,16,-5,19
NorthEast Un,1562,5,5,2,7,14,15,-1,17
FC Pune City,1562,6,4,5,5,13,15,-2,17
FC Goa,1562,7,5,2,7,10,17,-7,17
Chennaiyin,1562,8,3,5,6,13,21,-8,14
Kerala Blast,1563,1,7,3,4,13,14,-1,24
Mumbai City,1563,2,6,4,4,17,10,7,22
Delhi Dynamo,1563,3,5,5,4,25,19,6,20
Kolkata,1563,4,4,6,4,17,16,1,18
NorthEast Un,1563,5,5,3,6,12,12,0,18
FC Goa,1563,6,5,3,6,13,16,-3,18
Chennaiyin,1563,7,3,7,4,15,19,-4,16
FC Pune City,1563,8,4,3,7,12,18,-6,15
Delhi Dynamo,1564,1,5,7,2,26,18,8,22
Mumbai City,1564,2,6,4,4,18,11,7,22
Kolkata,1564,3,4,8,2,19,16,3,20
Chennaiyin,1564,4,5,5,4,17,18,-1,20
FC Pune City,1564,5,5,4,5,17,16,1,19
Kerala Blast,1564,6,5,4,5,13,19,-6,19
NorthEast Un,1564,7,4,3,7,13,16,-3,15
FC Goa,1564,8,3,3,8,10,19,-9,12
Mumbai City,1565,1,7,4,3,18,8,10,25
Kerala Blast,1565,2,6,4,4,16,15,1,22
FC Pune City,1565,3,5,4,5,16,16,0,19
Delhi Dynamo,1565,4,4,6,4,23,20,3,18
Kolkata,1565,5,4,6,4,17,18,-1,18
Chennaiyin,1565,6,4,6,4,14,17,-3,18
NorthEast Un,1565,7,5,2,7,13,16,-3,17
FC Goa,1565,8,3,4,7,9,16,-7,13
Delhi Dynamo,1566,1,6,6,2,27,16,11,24
Mumbai City,1566,2,6,4,4,16,9,7,22
Kerala Blast,1566,3,6,4,4,17,14,3,22
Chennaiyin,1566,4,5,5,4,20,19,1,20
FC Pune City,1566,5,5,3,6,14,20,-6,18
Kolkata,1566,6,3,7,4,16,17,-1,16
NorthEast Un,1566,7,4,3,7,10,16,-6,15
FC Goa,1566,8,4,2,8,13,22,-9,14
Mumbai City,1567,1,7,4,3,18,8,10,25
NorthEast Un,1567,2,6,2,6,12,11,1,20
FC Pune City,1567,3,5,4,5,15,15,0,19
Kerala Blast,1567,4,5,4,5,13,18,-5,19
Delhi Dynamo,1567,5,4,5,5,21,18,3,17
Kolkata,1567,6,3,8,3,16,16,0,17
Chennaiyin,1567,7,4,5,5,16,19,-3,17
FC Goa,1567,8,5,2,7,11,17,-6,17
Mumbai City,1568,1,7,4,3,18,8,10,25
Delhi Dynamo,1568,2,6,5,3,24,17,7,23
Kerala Blast,1568,3,6,4,4,14,14,0,22
Kolkata,1568,4,4,7,3,14,13,1,19
NorthEast Un,1568,5,4,4,6,12,13,-1,16
Chennaiyin,1568,6,3,6,5,14,19,-5,15
FC Pune City,1568,7,4,3,7,12,18,-6,15
FC Goa,1568,8,4,3,7,9,15,-6,15
Mumbai City,1569,1,7,4,3,18,8,10,25
Kerala Blast,1569,2,6,4,4,12,13,-1,22
NorthEast Un,1569,3,6,3,5,13,10,3,21
Delhi Dynamo,1569,4,4,6,4,23,20,3,18
Kolkata,1569,5,4,6,4,18,18,0,18
FC Pune City,1569,6,5,3,6,15,18,-3,18
Chennaiyin,1569,7,4,5,5,18,20,-2,17
FC Goa,1569,8,3,3,8,13,23,-10,12
Delhi Dynamo,1570,1,6,5,3,26,16,10,23
Mumbai City,1570,2,6,4,4,16,10,6,22
Kolkata,1570,3,5,6,3,17,14,3,21
FC Pune City,1570,4,6,3,5,15,14,1,21
NorthEast Un,1570,5,6,2,6,13,13,0,20
Chennaiyin,1570,6,4,6,4,16,18,-2,18
Kerala Blast,1570,7,4,3,7,10,18,-8,15
FC Goa,1570,8,3,3,8,9,19,-10,12
Delhi Dynamo,1571,1,6,5,3,29,18,11,23
Mumbai City,1571,2,6,4,4,18,11,7,22
NorthEast Un,1571,3,6,3,5,14,11,3,21
Kolkata,1571,4,4,7,3,15,15,0,19
Kerala Blast,1571,5,5,4,5,13,18,-5,19
FC Pune City,1571,6,5,3,6,16,17,-1,18
Chennaiyin,1571,7,4,6,4,14,17,-3,18
FC Goa,1571,8,3,2,9,9,21,-12,11
Delhi Dynamo,1572,1,7,5,2,31,16,15,26
Mumbai City,1572,2,6,4,4,16,11,5,22
Kerala Blast,1572,3,6,4,4,12,14,-2,22
FC Pune City,1572,4,5,3,6,15,16,-1,18
NorthEast Un,1572,5,4,4,6,11,14,-3,16
Chennaiyin,1572,6,3,7,4,14,18,-4,16
Kolkata,1572,7,3,6,5,14,17,-3,15
FC Goa,1572,8,4,3,7,11,18,-7,15
Mumbai City,1573,1,7,4,3,18,9,9,25
Kolkata,1573,2,6,6,2,20,12,8,24
Kerala Blast,1573,3,6,3,5,12,16,-4,21
Delhi Dynamo,1573,4,5,5,4,24,17,7,20
NorthEast Un,1573,5,5,2,7,11,12,-1,17
Chennaiyin,1573,6,3,6,5,14,20,-6,15
FC Pune City,1573,7,4,3,7,13,19,-6,15
FC Goa,1573,8,4,3,7,10,17,-7,15
Mumbai City,1574,1,7,4,3,19,10,9,25
Kerala Blast,1574,2,6,3,5,15,17,-2,21
Chennaiyin,1574,3,5,5,4,17,17,0,20
NorthEast Un,1574,4,6,2,6,13,13,0,20
FC Pune City,1574,5,5,3,6,15,17,-2,18
Delhi Dynamo,1574,6,4,5,5,23,22,1,17
FC Goa,1574,7,5,2,7,16,16,0,17
Kolkata,1574,8,3,6,5,16,22,-6,15
Delhi Dynamo,1575,1,6,6,2,28,16,12,24
Mumbai City,1575,2,6,5,3,17,9,8,23
Chennaiyin,1575,3,5,5,4,16,17,-1,20
Kerala Blast,1575,4,5,5,4,12,15,-3,20
Kolkata,1575,5,4,7,3,15,15,0,19
FC Pune City,1575,6,4,3,7,14,18,-4,15
NorthEast Un,1575,7,4,3,7,11,15,-4,15
FC Goa,1575,8,4,2,8,10,18,-8,14
Mumbai City,1576,1,7,4,3,17,8,9,25
Kerala Blast,1576,2,6,3,5,12,15,-3,21
Delhi Dynamo,1576,3,5,5,4,25,19,6,20
Kolkata,1576,4,4,7,3,18,16,2,19
FC Pune City,1576,5,5,3,6,13,16,-3,18
NorthEast Un,1576,6,5,2,7,12,14,-2,17
Chennaiyin,1576,7,4,5,5,15,19,-4,17
FC Goa,1576,8,4,3,7,13,18,-5,15
Mumbai City,1577,1,7,4,3,18,9,9,25
Kerala Blast,1577,2,6,4,4,14,16,-2,22
NorthEast Un,1577,3,6,2,6,16,13,3,20
Kolkata,1577,4,4,8,2,15,13,2,20
Delhi Dynamo,1577,5,4,5,5,22,21,1,17
FC Goa,1577,6,4,4,6,11,15,-4,16
FC Pune City,1577,7,4,3,7,13,17,-4,15
Chennaiyin,1577,8,3,6,5,16,21,-5,15
Mumbai City,1578,1,7,4,3,18,9,9,25
Delhi Dynamo,1578,2,6,5,3,25,16,9,23
FC Pune City,1578,3,6,3,5,16,16,0,21
Kolkata,1578,4,4,7,3,16,15,1,19
Chennaiyin,1578,5,4,6,4,15,18,-3,18
NorthEast Un,1578,6,5,2,7,11,12,-1,17
Kerala Blast,1578,7,4,4,6,11,17,-6,16
FC Goa,1578,8,3,3,8,8,17,-9,12
Mumbai City,1579,1,7,4,3,21,10,11,25
Kolkata,1579,2,5,7,2,16,13,3,22
Delhi Dynamo,1579,3,5,6,3,26,21,5,21
NorthEast Un,1579,4,6,2,6,17,13,4,20
FC Pune City,1579,5,5,4,5,14,15,-1,19
Chennaiyin,1579,6,3,6,5,16,21,-5,15
Kerala Blast,1579,7,4,3,7,9,19,-10,15
FC Goa,1579,8,3,4,7,10,17,-7,13
Mumbai City,1580,1,6,4,4,16,9,7,22
Kolkata,1580,2,5,7,2,18,14,4,22
NorthEast Un,1580,3,6,3,5,14,10,4,21
Delhi Dynamo,1580,4,5,5,4,24,18,6,20
FC Pune City,1580,5,5,4,5,16,17,-1,19
FC Goa,1580,6,5,2,7,12,18,-6,17
Chennaiyin,1580,7,3,6,5,14,19,-5,15
Kerala Blast,1580,8,4,3,7,10,19,-9,15
Mumbai City,1581,1,6,4,4,16,9,7,22
Delhi Dynamo,1581,2,5,6,3,24,17,7,21
Kerala Blast,1581,3,6,3,5,14,17,-3,21
Kolkata,1581,4,4,8,2,18,14,4,20
Chennaiyin,1581,5,4,6,4,14,17,-3,18
FC Pune City,1581,6,4,4,6,13,18,-5,16
FC Goa,1581,7,4,4,6,11,16,-5,16
NorthEast Un,1581,8,4,3,7,11,13,-2,15
Mumbai City,1582,1,7,4,3,17,8,9,25
Kerala Blast,1582,2,6,3,5,13,17,-4,21
NorthEast Un,1582,3,6,2,6,15,11,4,20
Kolkata,1582,4,4,7,3,20,19,1,19
Delhi Dynamo,1582,5,4,6,4,21,18,3,18
FC Pune City,1582,6,5,3,6,17,18,-1,18
Chennaiyin,1582,7,4,5,5,17,20,-3,17
FC Goa,1582,8,3,4,7,10,19,-9,13
Mumbai City,1583,1,7,4,3,17,8,9,25
NorthEast Un,1583,2,6,3,5,15,9,6,21
Kolkata,1583,3,4,8,2,16,14,2,20
Kerala Blast,1583,4,5,5,4,11,14,-3,20
FC Goa,1583,5,5,3,6,16,17,-1,18
Delhi Dynamo,1583,6,4,5,5,21,22,-1,17
FC Pune City,1583,7,4,3,7,13,17,-4,15
Chennaiyin,1583,8,3,5,6,14,22,-8,14
Mumbai City,1584,1,6,5,3,17,9,8,23
Kolkata,1584,2,5,7,2,20,14,6,22
Delhi Dynamo,1584,3,5,6,3,24,18,6,21
Kerala Blast,1584,4,6,3,5,12,18,-6,21
NorthEast Un,1584,5,6,2,6,13,11,2,20
Chennaiyin,1584,6,4,5,5,14,18,-4,17
FC Pune City,1584,7,4,4,6,14,17,-3,16
FC Goa,1584,8,3,2,9,9,18,-9,11
Delhi Dynamo,1585,1,7,5,2,28,14,14,26
Mumbai City,1585,2,6,4,4,16,11,5,22
Kolkata,1585,3,5,6,3,15,15,0,21
Kerala Blast,1585,4,5,4,5,12,16,-4,19
Chennaiyin,1585,5,4,6,4,17,20,-3,18
FC Pune City,1585,6,4,4,6,14,17,-3,16
FC Goa,1585,7,4,3,7,13,19,-6,15
NorthEast Un,1585,8,4,2,8,10,13,-3,14
Mumbai City,1586,1,7,4,3,19,9,10,25
Kerala Blast,1586,2,7,3,4,14,14,0,24
FC Goa,1586,3,6,2,6,13,15,-2,20
Delhi Dynamo,1586,4,4,5,5,23,20,3,17
NorthEast Un,1586,5,5,2,7,11,13,-2,17
Chennaiyin,1586,6,4,5,5,15,20,-5,17
Kolkata,1586,7,3,7,4,15,16,-1,16
FC Pune City,1586,8,4,4,6,13,16,-3,16
Mumbai City,1587,1,7,4,3,21,9,12,25
NorthEast Un,1587,2,6,3,5,14,10,4,21
Delhi Dynamo,1587,3,5,5,4,25,23,2,20
Kolkata,1587,4,4,6,4,16,16,0,18
FC Pune City,1587,5,5,3,6,14,16,-2,18
Kerala Blast,1587,6,5,3,6,13,18,-5,18
FC Goa,1587,7,5,2,7,12,18,-6,17
Chennaiyin,1587,8,3,6,5,14,19,-5,15
Delhi Dynamo,1588,1,6,6,2,27,17,10,24
Kolkata,1588,2,6,6,2,20,13,7,24
Mumbai City,1588,3,6,4,4,17,10,7,22
Kerala Blast,1588,4,6,3,5,14,17,-3,21
Chennaiyin,1588,5,4,5,5,15,21,-6,17
NorthEast Un,1588,6,4,3,7,13,15,-2,15
FC Pune City,1588,7,4,3,7,12,19,-7,15
FC Goa,1588,8,4,2,8,12,18,-6,14
Mumbai City,1589,1,7,4,3,17,8,9,25
NorthEast Un,1589,2,6,3,5,16,11,5,21
Kerala Blast,1589,3,5,5,4,15,18,-3,20
Delhi Dynamo,1589,4,4,6,4,24,22,2,18
Kolkata,1589,5,4,6,4,17,18,-1,18
Chennaiyin,1589,6,4,5,5,16,18,-2,17
FC Pune City,1589,7,4,4,6,15,18,-3,16
FC Goa,1589,8,4,3,7,14,21,-7,15
Mumbai City,1590,1,6,5,3,17,9,8,23
Kerala Blast,1590,2,6,4,4,13,14,-1,22
Delhi Dynamo,1590,3,4,7,3,24,20,4,19
Chennaiyin,1590,4,4,6,4,15,17,-2,18
FC Goa,1590,5,5,3,6,12,14,-2,18
Kolkata,1590,6,3,8,3,14,14,0,17
FC Pune City,1590,7,4,4,6,14,17,-3,16
NorthEast Un,1590,8,4,3,7,11,15,-4,15
Delhi Dynamo,1591,1,6,6,2,29,19,10,24
Mumbai City,1591,2,6,5,3,18,10,8,23
FC Pune City,1591,3,5,4,5,14,14,0,19
Kerala Blast,1591,4,5,4,5,13,17,-4,19
Kolkata,1591,5,3,9,2,14,13,1,18
Chennaiyin,1591,6,3,7,4,15,19,-4,16
NorthEast Un,1591,7,4,3,7,12,16,-4,15
FC Goa,1591,8,3,4,7,11,18,-7,13
Mumbai City,1592,1,6,5,3,17,9,8,23
Kerala Blast,1592,2,6,4,4,12,13,-1,22
Delhi Dynamo,1592,3,5,6,3,25,18,7,21
Kolkata,1592,4,4,6,4,17,16,1,18
NorthEast Un,1592,5,5,3,6,12,11,1,18
Chennaiyin,1592,6,4,6,4,14,17,-3,18
FC Pune City,1592,7,4,3,7,13,19,-6,15
FC Goa,1592,8,4,3,7,9,16,-7,15
Mumbai City,1593,1,6,5,3,16,8,8,23
Kolkata,1593,2,5,6,3,18,15,3,21
Kerala Blast,1593,3,6,3,5,12,16,-4,21
Delhi Dynamo,1593,4,4,8,2,23,16,7,20
NorthEast Un,1593,5,5,4,5,13,11,2,19
Chennaiyin,1593,6,3,7,4,13,17,-4,16
FC Pune City,1593,7,4,3,7,13,18,-5,15
FC Goa,1593,8,3,4,7,8,15,-7,13
Mumbai City,1594,1,7,4,3,18,9,9,25
Delhi Dynamo,1594,2,5,6,3,24,17,7,21
Kerala Blast,1594,3,6,3,5,15,15,0,21
Kolkata,1594,4,4,7,3,14,13,1,19
Chennaiyin,1594,5,4,6,4,16,19,-3,18
FC Pune City,1594,6,4,4,6,12,18,-6,16
NorthEast Un,1594,7,4,3,7,12,14,-2,15
FC Goa,1594,8,4,3,7,10,16,-6,15
Mumbai City,1595,1,6,5,3,17,9,8,23
Delhi Dynamo,1595,2,5,6,3,26,20,6,21
Kolkata,1595,3,4,8,2,19,16,3,20
NorthEast Un,1595,4,5,4,5,15,12,3,19
FC Pune City,1595,5,5,4,5,15,16,-1,19
Chennaiyin,1595,6,3,7,4,16,20,-4,16
Kerala Blast,1595,7,4,4,6,9,16,-7,16
FC Goa,1595,8,3,4,7,12,20,-8,13
Mumbai City,1596,1,7,4,3,18,8,10,25
Kolkata,1596,2,5,6,3,20,15,5,21
FC Pune City,1596,3,6,3,5,14,14,0,21
Delhi Dynamo,1596,4,4,6,4,23,20,3,18
NorthEast Un,1596,5,5,3,6,14,13,1,18
Kerala Blast,1596,6,5,3,6,11,18,-7,18
Chennaiyin,1596,7,3,6,5,16,21,-5,15
FC Goa,1596,8,4,3,7,12,19,-7,15
Mumbai City,1597,1,7,4,3,18,9,9,25
Kerala Blast,1597,2,7,3,4,15,15,0,24
Delhi Dynamo,1597,3,4,6,4,24,19,5,18
Kolkata,1597,4,4,6,4,15,17,-2,18
Chennaiyin,1597,5,4,6,4,16,19,-3,18
FC Goa,1597,6,5,2,7,13,16,-3,17
NorthEast Un,1597,7,4,4,6,13,15,-2,16
FC Pune City,1597,8,4,3,7,12,16,-4,15
Mumbai City,1598,1,6,5,3,17,9,8,23
Delhi Dynamo,1598,2,5,6,3,23,16,7,21
Kolkata,1598,3,5,6,3,17,14,3,21
FC Goa,1598,4,6,2,6,12,15,-3,20
Kerala Blast,1598,5,5,4,5,12,15,-3,19
NorthEast Un,1598,6,4,4,6,10,11,-1,16
Chennaiyin,1598,7,3,6,5,15,20,-5,15
FC Pune City,1598,8,4,3,7,14,20,-6,15
Delhi Dynamo,1599,1,6,6,2,27,17,10,24
Kolkata,1599,2,6,6,2,19,14,5,24
Mumbai City,1599,3,6,5,3,18,10,8,23
Kerala Blast,1599,4,6,3,5,14,18,-4,21
NorthEast Un,1599,5,5,2,7,15,15,0,17
FC Pune City,1599,6,4,3,7,13,17,-4,15
FC Goa,1599,7,4,2,8,12,19,-7,14
Chennaiyin,1599,8,3,5,6,14,22,-8,14
Mumbai City,1600,1,6,5,3,17,9,8,23
Delhi Dynamo,1600,2,4,8,2,25,18,7,20
NorthEast Un,1600,3,5,4,5,13,11,2,19
FC Pune City,1600,4,5,4,5,15,16,-1,19
FC Goa,1600,5,5,3,6,15,17,-2,18
Kolkata,1600,6,3,8,3,15,15,0,17
Kerala Blast,1600,7,4,4,6,10,17,-7,16
Chennaiyin,1600,8,3,6,5,14,21,-7,15
Mumbai City,1601,1,7,4,3,20,8,12,25
Kolkata,1601,2,6,6,2,17,12,5,24
Delhi Dynamo,1601,3,4,7,3,23,20,3,19
NorthEast Un,1601,4,5,4,5,14,12,2,19
Chennaiyin,1601,5,4,5,5,17,20,-3,17
Kerala Blast,1601,6,4,5,5,13,19,-6,17
FC Pune City,1601,7,4,4,6,14,17,-3,16
FC Goa,1601,8,3,3,8,10,20,-10,12
Delhi Dynamo,1602,1,6,6,2,25,15,10,24
Mumbai City,1602,2,6,4,4,16,9,7,22
Kolkata,1602,3,5,7,2,19,14,5,22
NorthEast Un,1602,4,6,2,6,12,11,1,20
Kerala Blast,1602,5,5,3,6,12,19,-7,18
FC Pune City,1602,6,4,3,7,13,17,-4,15
Chennaiyin,1602,7,3,6,5,14,20,-6,15
FC Goa,1602,8,3,5,6,11,17,-6,14
Delhi Dynamo,1603,1,7,5,2,27,17,10,26
Mumbai City,1603,2,6,4,4,18,11,7,22
Kolkata,1603,3,4,7,3,17,14,3,19
Kerala Blast,1603,4,5,4,5,12,18,-6,19
FC Pune City,1603,5,5,3,6,13,15,-2,18
Chennaiyin,1603,6,4,5,5,16,19,-3,17
NorthEast Un,1603,7,4,3,7,10,13,-3,15
FC Goa,1603,8,4,3,7,11,17,-6,15
Mumbai City,1604,1,7,4,3,19,8,11,25
NorthEast Un,1604,2,7,2,5,15,11,4,23
Delhi Dynamo,1604,3,5,5,4,25,22,3,20
Kolkata,1604,4,4,7,3,15,15,0,19
Kerala Blast,1604,5,5,4,5,11,15,-4,19
FC Pune City,1604,6,5,3,6,15,16,-1,18
Chennaiyin,1604,7,3,6,5,13,18,-5,15
FC Goa,1604,8,3,3,8,10,18,-8,12
Mumbai City,1605,1,7,4,3,18,8,10,25
Delhi Dynamo,1605,2,6,5,3,26,17,9,23
FC Pune City,1605,3,5,4,5,16,15,1,19
Chennaiyin,1605,4,4,6,4,14,17,-3,18
Kolkata,1605,5,3,8,3,16,16,0,17
Kerala Blast,1605,6,4,5,5,11,18,-7,17
NorthEast Un,1605,7,4,4,6,10,13,-3,16
FC Goa,1605,8,4,2,8,11,18,-7,14
Mumbai City,1606,1,7,4,3,20,9,11,25
Delhi Dynamo,1606,2,6,5,3,24,18,6,23
Kolkata,1606,3,5,6,3,17,15,2,21
NorthEast Un,1606,4,6,2,6,14,10,4,20
FC Goa,1606,5,5,2,7,15,15,0,17
FC Pune City,1606,6,4,4,6,14,18,-4,16
Kerala Blast,1606,7,4,4,6,12,20,-8,16
Chennaiyin,1606,8,3,5,6,13,24,-11,14
Mumbai City,1607,1,7,4,3,18,9,9,25
FC Pune City,1607,2,6,3,5,17,15,2,21
Kolkata,1607,3,4,7,3,16,15,1,19
Delhi Dynamo,1607,4,4,6,4,24,19,5,18
NorthEast Un,1607,5,5,3,6,13,13,0,18
Chennaiyin,1607,6,4,6,4,14,17,-3,18
Kerala Blast,1607,7,4,4,6,12,20,-8,16
FC Goa,1607,8,3,5,6,10,16,-6,14
Mumbai City,1608,1,7,4,3,19,8,11,25
Delhi Dynamo,1608,2,5,5,4,24,20,4,20
Kerala Blast,1608,3,5,5,4,13,16,-3,20
FC Pune City,1608,4,5,4,5,17,16,1,19
Kolkata,1608,5,4,6,4,18,17,1,18
Chennaiyin,1608,6,4,6,4,14,17,-3,18
NorthEast Un,1608,7,4,4,6,12,13,-1,16
FC Goa,1608,8,4,2,8,10,20,-10,14
Mumbai City,1609,1,6,5,3,19,11,8,23
Delhi Dynamo,1609,2,5,7,2,26,18,8,22
Kolkata,1609,3,4,7,3,16,16,0,19
Kerala Blast,1609,4,5,4,5,14,17,-3,19
NorthEast Un,1609,5,4,4,6,11,12,-1,16
Chennaiyin,1609,6,3,7,4,15,19,-4,16
FC Pune City,1609,7,4,4,6,13,17,-4,16
FC Goa,1609,8,4,4,6,11,15,-4,16
Mumbai City,1610,1,7,4,3,19,8,11,25
Kerala Blast,1610,2,7,3,4,14,15,-1,24
Delhi Dynamo,1610,3,5,5,4,23,20,3,20
NorthEast Un,1610,4,6,2,6,13,11,2,20
Kolkata,1610,5,4,6,4,19,16,3,18
FC Pune City,1610,6,5,3,6,15,17,-2,18
Chennaiyin,1610,7,3,5,6,13,19,-6,14
FC Goa,1610,8,4,2,8,9,19,-10,14
Mumbai City,1611,1,6,5,3,17,9,8,23
Delhi Dynamo,1611,2,5,6,3,24,18,6,21
Kerala Blast,1611,3,6,3,5,12,16,-4,21
Chennaiyin,1611,4,5,5,4,16,17,-1,20
Kolkata,1611,5,4,6,4,16,16,0,18
FC Pune City,1611,6,5,3,6,15,16,-1,18
NorthEast Un,1611,7,5,2,7,12,12,0,17
FC Goa,1611,8,4,2,8,9,17,-8,14
Mumbai City,1612,1,7,4,3,17,8,9,25
Kolkata,1612,2,5,7,2,18,14,4,22
Delhi Dynamo,1612,3,5,5,4,28,22,6,20
NorthEast Un,1612,4,6,2,6,18,15,3,20
Kerala Blast,1612,5,5,4,5,12,17,-5,19
FC Pune City,1612,6,5,3,6,15,16,-1,18
FC Goa,1612,7,4,2,8,14,21,-7,14
Chennaiyin,1612,8,3,5,6,13,22,-9,14
Mumbai City,1613,1,6,5,3,16,8,8,23
NorthEast Un,1613,2,7,2,5,17,12,5,23
Delhi Dynamo,1613,3,5,6,3,25,18,7,21
Kolkata,1613,4,4,6,4,14,14,0,18
FC Pune City,1613,5,5,3,6,14,16,-2,18
Kerala Blast,1613,6,5,3,6,11,16,-5,18
Chennaiyin,1613,7,4,5,5,14,20,-6,17
FC Goa,1613,8,4,2,8,9,16,-7,14
Delhi Dynamo,1614,1,6,6,2,26,17,9,24
Mumbai City,1614,2,6,4,4,17,10,7,22
FC Pune City,1614,3,6,3,5,16,15,1,21
Kerala Blast,1614,4,5,4,5,12,16,-4,19
Kolkata,1614,5,4,6,4,17,18,-1,18
NorthEast Un,1614,6,4,5,5,12,12,0,17
Chennaiyin,1614,7,3,7,4,15,19,-4,16
FC Goa,1614,8,3,3,8,10,18,-8,12
Mumbai City,1615,1,7,4,3,18,9,9,25
Kolkata,1615,2,5,7,2,16,12,4,22
Delhi Dynamo,1615,3,5,6,3,24,17,7,21
Kerala Blast,1615,4,5,4,5,12,15,-3,19
NorthEast Un,1615,5,5,3,6,14,14,0,18
Chennaiyin,1615,6,3,7,4,18,22,-4,16
FC Pune City,1615,7,4,3,7,13,18,-5,15
FC Goa,1615,8,3,4,7,10,18,-8,13
Mumbai City,1616,1,6,5,3,17,9,8,23
Delhi Dynamo,1616,2,5,6,3,27,18,9,21
Kolkata,1616,3,4,7,3,18,16,2,19
Kerala Blast,1616,4,5,4,5,16,18,-2,19
Chennaiyin,1616,5,4,6,4,17,17,0,18
FC Pune City,1616,6,4,5,5,17,19,-2,17
NorthEast Un,1616,7,5,2,7,11,18,-7,17
FC Goa,1616,8,4,3,7,11,19,-8,15
Mumbai City,1617,1,7,4,3,17,8,9,25
Delhi Dynamo,1617,2,5,5,4,23,16,7,20
FC Goa,1617,3,6,2,6,12,15,-3,20
FC Pune City,1617,4,5,4,5,16,16,0,19
Kerala Blast,1617,5,5,4,5,12,16,-4,19
Kolkata,1617,6,4,6,4,16,17,-1,18
Chennaiyin,1617,7,4,5,5,16,20,-4,17
NorthEast Un,1617,8,4,2,8,10,14,-4,14
Mumbai City,1618,1,7,4,3,17,8,9,25
Delhi Dynamo,1618,2,6,5,3,25,15,10,23
Kolkata,1618,3,5,6,3,19,16,3,21
NorthEast Un,1618,4,5,3,6,14,12,2,18
FC Pune City,1618,5,5,3,6,14,16,-2,18
Chennaiyin,1618,6,4,6,4,17,20,-3,18
Kerala Blast,1618,7,5,3,6,12,20,-8,18
FC Goa,1618,8,3,2,9,10,21,-11,11
Mumbai City,1619,1,6,5,3,17,9,8,23
Kolkata,1619,2,5,6,3,19,14,5,21
Kerala Blast,1619,3,6,3,5,14,18,-4,21
Delhi Dynamo,1619,4,4,6,4,24,20,4,18
NorthEast Un,1619,5,5,3,6,13,13,0,18
FC Goa,1619,6,5,3,6,14,17,-3,18
Chennaiyin,1619,7,3,7,4,15,19,-4,16
FC Pune City,1619,8,4,3,7,13,19,-6,15
Mumbai City,1620,1,7,4,3,19,10,9,25
Delhi Dynamo,1620,2,6,5,3,27,17,10,23
Kerala Blast,1620,3,6,4,4,14,16,-2,22
Kolkata,1620,4,3,9,2,17,16,1,18
Chennaiyin,1620,5,4,6,4,16,19,-3,18
FC Pune City,1620,6,4,4,6,13,16,-3,16
NorthEast Un,1620,7,4,2,8,9,12,-3,14
FC Goa,1620,8,3,4,7,10,19,-9,13
Mumbai City,1621,1,7,4,3,18,9,9,25
NorthEast Un,1621,2,6,2,6,14,13,1,20
Kolkata,1621,3,4,7,3,15,15,0,19
Kerala Blast,1621,4,5,4,5,12,14,-2,19
Delhi Dynamo,1621,5,4,6,4,23,20,3,18
FC Goa,1621,6,5,3,6,14,15,-1,18
FC Pune City,1621,7,4,5,5,13,15,-2,17
Chennaiyin,1621,8,3,5,6,14,22,-8,14
Mumbai City,1622,1,6,5,3,17,9,8,23
Kolkata,1622,2,5,7,2,19,14,5,22
Delhi Dynamo,1622,3,5,6,3,25,18,7,21
Kerala Blast,1622,4,5,4,5,12,17,-5,19
Chennaiyin,1622,5,4,6,4,15,18,-3,18
FC Pune City,1622,6,4,5,5,14,16,-2,17
NorthEast Un,1622,7,4,3,7,12,14,-2,15
FC Goa,1622,8,4,2,8,11,19,-8,14
Mumbai City,1623,1,6,4,4,17,10,7,22
Delhi Dynamo,1623,2,5,6,3,27,23,4,21
FC Pune City,1623,3,6,3,5,17,15,2,21
Kerala Blast,1623,4,5,4,5,11,17,-6,19
Chennaiyin,1623,5,4,6,4,16,19,-3,18
Kolkata,1623,6,3,7,4,15,16,-1,16
NorthEast Un,1623,7,4,4,6,13,14,-1,16
FC Goa,1623,8,4,4,6,14,16,-2,16
Delhi Dynamo,1624,1,6,6,2,25,15,10,24
Mumbai City,1624,2,6,5,3,17,9,8,23
Kolkata,1624,3,5,6,3,17,13,4,21
Kerala Blast,1624,4,6,3,5,15,15,0,21
Chennaiyin,1624,5,4,6,4,15,18,-3,18
FC Pune City,1624,6,5,3,6,13,16,-3,18
NorthEast Un,1624,7,4,3,7,11,15,-4,15
FC Goa,1624,8,3,2,9,8,20,-12,11
Mumbai City,1625,1,7,4,3,19,8,11,25
Delhi Dynamo,1625,2,6,5,3,23,17,6,23
Kolkata,1625,3,5,6,3,17,14,3,21
Kerala Blast,1625,4,5,4,5,14,15,-1,19
Chennaiyin,1625,5,4,5,5,15,19,-4,17
FC Goa,1625,6,5,2,7,11,16,-5,17
NorthEast Un,1625,7,4,3,7,10,12,-2,15
FC Pune City,1625,8,4,3,7,13,21,-8,15
Mumbai City,1626,1,7,4,3,19,8,11,25
Kolkata,1626,2,5,6,3,20,13,7,21
Delhi Dynamo,1626,3,5,5,4,24,20,4,20
Chennaiyin,1626,4,5,5,4,16,17,-1,20
Kerala Blast,1626,5,5,4,5,11,15,-4,19
NorthEast Un,1626,6,5,3,6,12,12,0,18
FC Pune City,1626,7,4,3,7,13,22,-9,15
FC Goa,1626,8,4,2,8,9,17,-8,14
Mumbai City,1627,1,7,4,3,18,8,10,25
NorthEast Un,1627,2,7,2,5,15,10,5,23
Delhi Dynamo,1627,3,5,5,4,23,17,6,20
Kolkata,1627,4,4,7,3,17,16,1,19
Kerala Blast,1627,5,5,4,5,12,16,-4,19
Chennaiyin,1627,6,4,5,5,15,20,-5,17
FC Pune City,1627,7,4,3,7,12,17,-5,15
FC Goa,1627,8,4,2,8,11,19,-8,14
Mumbai City,1628,1,7,4,3,18,8,10,25
Kolkata,1628,2,5,6,3,17,14,3,21
Kerala Blast,1628,3,6,3,5,11,14,-3,21
Delhi Dynamo,1628,4,5,5,4,24,22,2,20
FC Pune City,1628,5,5,3,6,14,16,-2,18
Chennaiyin,1628,6,4,6,4,16,19,-3,18
NorthEast Un,1628,7,5,2,7,14,11,3,17
FC Goa,1628,8,3,3,8,11,21,-10,12
Mumbai City,1629,1,6,5,3,20,12,8,23
Delhi Dynamo,1629,2,5,6,3,26,19,7,21
Kerala Blast,1629,3,6,3,5,17,17,0,21
Kolkata,1629,4,4,8,2,18,16,2,20
NorthEast Un,1629,5,6,2,6,14,13,1,20
Chennaiyin,1629,6,4,5,5,15,19,-4,17
FC Pune City,1629,7,4,4,6,14,20,-6,16
FC Goa,1629,8,3,3,8,9,17,-8,12
Mumbai City,1630,1,7,4,3,18,8,10,25
Delhi Dynamo,1630,2,5,6,3,26,20,6,21
Kolkata,1630,3,3,9,2,15,14,1,18
NorthEast Un,1630,4,5,2,7,18,18,0,17
FC Pune City,1630,5,4,5,5,15,17,-2,17
Chennaiyin,1630,6,4,5,5,16,21,-5,17
Kerala Blast,1630,7,4,5,5,12,18,-6,17
FC Goa,1630,8,4,4,6,11,15,-4,16
Delhi Dynamo,1631,1,6,6,2,28,16,12,24
Mumbai City,1631,2,6,5,3,17,9,8,23
Kolkata,1631,3,5,6,3,16,13,3,21
Kerala Blast,1631,4,6,3,5,15,15,0,21
Chennaiyin,1631,5,4,6,4,16,19,-3,18
FC Pune City,1631,6,4,3,7,12,17,-5,15
NorthEast Un,1631,7,4,3,7,11,19,-8,15
FC Goa,1631,8,4,2,8,10,17,-7,14
Delhi Dynamo,1632,1,7,5,2,27,16,11,26
Mumbai City,1632,2,6,4,4,16,9,7,22
NorthEast Un,1632,3,6,2,6,15,13,2,20
Kolkata,1632,4,3,8,3,17,18,-1,17
FC Pune City,1632,5,4,5,5,14,16,-2,17
Kerala Blast,1632,6,4,5,5,11,16,-5,17
Chennaiyin,1632,7,4,5,5,15,21,-6,17
FC Goa,1632,8,4,2,8,13,19,-6,14
Mumbai City,1633,1,7,4,3,18,9,9,25
Delhi Dynamo,1633,2,6,5,3,24,16,8,23
NorthEast Un,1633,3,6,2,6,13,11,2,20
Kerala Blast,1633,4,5,4,5,14,18,-4,19
FC Pune City,1633,5,5,3,6,15,18,-3,18
FC Goa,1633,6,5,2,7,14,17,-3,17
Kolkata,1633,7,3,7,4,17,19,-2,16
Chennaiyin,1633,8,3,5,6,13,20,-7,14
Delhi Dynamo,1634,1,6,5,3,30,20,10,23
Mumbai City,1634,2,6,4,4,18,11,7,22
Kerala Blast,1634,3,6,3,5,12,17,-5,21
Kolkata,1634,4,4,8,2,20,15,5,20
Chennaiyin,1634,5,4,6,4,14,17,-3,18
NorthEast Un,1634,6,5,2,7,12,12,0,17
FC Pune City,1634,7,4,4,6,14,18,-4,16
FC Goa,1634,8,3,4,7,10,20,-10,13
Mumbai City,1635,1,7,4,3,18,8,10,25
Delhi Dynamo,1635,2,6,5,3,26,16,10,23
Kolkata,1635,3,5,7,2,19,15,4,22
Kerala Blast,1635,4,5,4,5,15,19,-4,19
FC Pune City,1635,5,5,3,6,15,18,-3,18
NorthEast Un,1635,6,4,3,7,9,12,-3,15
Chennaiyin,1635,7,3,6,5,14,19,-5,15
FC Goa,1635,8,4,2,8,10,19,-9,14
Delhi Dynamo,1636,1,6,6,2,28,15,13,24
Mumbai City,1636,2,6,5,3,16,8,8,23
Kolkata,1636,3,4,8,2,17,14,3,20
Chennaiyin,1636,4,5,5,4,16,18,-2,20
Kerala Blast,1636,5,5,4,5,12,14,-2,19
FC Pune City,1636,6,5,3,6,14,17,-3,18
NorthEast Un,1636,7,4,2,8,11,18,-7,14
FC Goa,1636,8,3,3,8,9,19,-10,12
Mumbai City,1637,1,7,4,3,18,8,10,25
Delhi Dynamo,1637,2,5,6,3,25,19,6,21
FC Pune City,1637,3,6,3,5,19,15,4,21
Chennaiyin,1637,4,5,5,4,18,19,-1,20
Kolkata,1637,5,4,7,3,15,16,-1,19
Kerala Blast,1637,6,5,3,6,13,20,-7,18
NorthEast Un,1637,7,4,3,7,13,15,-2,15
FC Goa,1637,8,3,3,8,10,19,-9,12
Mumbai City,1638,1,7,4,3,19,8,11,25
Kolkata,1638,2,5,7,2,20,14,6,22
Delhi Dynamo,1638,3,5,5,4,23,19,4,20
NorthEast Un,1638,4,6,2,6,12,10,2,20
Kerala Blast,1638,5,5,4,5,12,17,-5,19
FC Pune City,1638,6,4,5,5,16,18,-2,17
Chennaiyin,1638,7,4,5,5,15,18,-3,17
FC Goa,1638,8,3,2,9,8,21,-13,11
Delhi Dynamo,1639,1,6,6,2,25,15,10,24
Kolkata,1639,2,6,6,2,17,12,5,24
Mumbai City,1639,3,6,4,4,16,9,7,22
Kerala Blast,1639,4,5,4,5,10,15,-5,19
Chennaiyin,1639,5,4,6,4,15,18,-3,18
NorthEast Un,1639,6,4,3,7,9,12,-3,15
FC Pune City,1639,7,4,3,7,12,16,-4,15
FC Goa,1639,8,3,4,7,10,17,-7,13
Mumbai City,1640,1,6,5,3,17,9,8,23
Delhi Dynamo,1640,2,5,7,2,25,16,9,22
FC Pune City,1640,3,6,3,5,14,14,0,21
Kerala Blast,1640,4,5,4,5,11,15,-4,19
Kolkata,1640,5,3,8,3,14,14,0,17
NorthEast Un,1640,6,4,4,6,9,10,-1,16
Chennaiyin,1640,7,3,6,5,13,18,-5,15
FC Goa,1640,8,4,3,7,10,17,-7,15
Delhi Dynamo,1641,1,6,5,3,28,19,9,23
Mumbai City,1641,2,6,4,4,18,13,5,22
NorthEast Un,1641,3,6,3,5,13,10,3,21
Kerala Blast,1641,4,5,5,4,12,14,-2,20
Kolkata,1641,5,3,8,3,14,14,0,17
Chennaiyin,1641,6,4,5,5,18,20,-2,17
FC Pune City,1641,7,4,4,6,12,16,-4,16
FC Goa,1641,8,4,2,8,13,22,-9,14
Mumbai City,1642,1,7,4,3,19,8,11,25
Kolkata,1642,2,5,6,3,16,13,3,21
NorthEast Un,1642,3,5,4,5,12,11,1,19
Kerala Blast,1642,4,5,4,5,11,15,-4,19
Delhi Dynamo,1642,5,4,6,4,22,19,3,18
Chennaiyin,1642,6,4,6,4,15,18,-3,18
FC Pune City,1642,7,4,3,7,12,17,-5,15
FC Goa,1642,8,4,3,7,10,16,-6,15
Mumbai City,1643,1,6,5,3,17,9,8,23
Delhi Dynamo,1643,2,5,7,2,29,18,11,22
FC Pune City,1643,3,6,3,5,16,14,2,21
Kolkata,1643,4,4,7,3,16,14,2,19
NorthEast Un,1643,5,5,4,5,15,13,2,19
Chennaiyin,1643,6,4,6,4,15,18,-3,18
Kerala Blast,1643,7,4,3,7,9,20,-11,15
FC Goa,1643,8,3,3,8,9,20,-11,12
Delhi Dynamo,1644,1,6,5,3,26,18,8,23
Mumbai City,1644,2,6,4,4,17,10,7,22
Kerala Blast,1644,3,5,5,4,14,17,-3,20
Kolkata,1644,4,4,7,3,17,15,2,19
FC Pune City,1644,5,5,4,5,13,14,-1,19
Chennaiyin,1644,6,4,6,4,16,19,-3,18
NorthEast Un,1644,7,5,2,7,13,14,-1,17
FC Goa,1644,8,3,3,8,11,20,-9,12
Mumbai City,1645,1,6,5,3,17,9,8,23
Kerala Blast,1645,2,6,4,4,16,17,-1,22
Delhi Dynamo,1645,3,4,7,3,25,20,5,19
NorthEast Un,1645,4,5,4,5,16,13,3,19
Kolkata,1645,5,4,6,4,18,18,0,18
FC Goa,1645,6,5,3,6,14,17,-3,18
FC Pune City,1645,7,4,3,7,14,19,-5,15
Chennaiyin,1645,8,3,6,5,13,20,-7,15
Delhi Dynamo,1646,1,6,6,2,26,14,12,24
Mumbai City,1646,2,6,4,4,16,10,6,22
Kolkata,1646,3,5,7,2,16,13,3,22
NorthEast Un,1646,4,5,2,7,13,16,-3,17
Chennaiyin,1646,5,4,5,5,17,22,-5,17
Kerala Blast,1646,6,4,5,5,11,17,-6,17
FC Pune City,1646,7,4,4,6,13,16,-3,16
FC Goa,1646,8,4,3,7,13,17,-4,15
Delhi Dynamo,1647,1,6,5,3,26,20,6,23
Mumbai City,1647,2,6,4,4,17,10,7,22
Kolkata,1647,3,5,7,2,17,13,4,22
NorthEast Un,1647,4,6,2,6,16,13,3,20
Chennaiyin,1647,5,4,6,4,16,18,-2,18
FC Pune City,1647,6,5,3,6,13,15,-2,18
Kerala Blast,1647,7,4,4,6,11,17,-6,16
FC Goa,1647,8,3,3,8,9,19,-10,12
Delhi Dynamo,1648,1,6,6,2,29,19,10,24
Mumbai City,1648,2,6,4,4,16,10,6,22
Kerala Blast,1648,3,6,4,4,13,15,-2,22
Kolkata,1648,4,4,7,3,16,15,1,19
NorthEast Un,1648,5,5,3,6,12,12,0,18
FC Goa,1648,6,5,2,7,15,19,-4,17
FC Pune City,1648,7,4,3,7,14,18,-4,15
Chennaiyin,1648,8,3,5,6,14,21,-7,14
Mumbai City,1649,1,7,4,3,17,8,9,25
Delhi Dynamo,1649,2,6,5,3,27,15,12,23
Chennaiyin,1649,3,5,5,4,15,17,-2,20
Kolkata,1649,4,4,7,3,17,14,3,19
FC Pune City,1649,5,5,3,6,16,18,-2,18
Kerala Blast,1649,6,4,5,5,13,20,-7,17
NorthEast Un,1649,7,4,3,7,11,15,-4,15
FC Goa,1649,8,4,2,8,9,18,-9,14
Mumbai City,1650,1,7,4,3,18,9,9,25
Delhi Dynamo,1650,2,6,5,3,26,17,9,23
Kolkata,1650,3,5,7,2,19,15,4,22
Kerala Blast,1650,4,5,4,5,17,19,-2,19
Chennaiyin,1650,5,4,5,5,15,21,-6,17
NorthEast Un,1650,6,4,3,7,12,14,-2,15
FC Goa,1650,7,4,3,7,13,18,-5,15
FC Pune City,1650,8,4,3,7,14,21,-7,15
Delhi Dynamo,1651,1,6,5,3,26,17,9,23
Mumbai City,1651,2,6,4,4,18,11,7,22
Kolkata,1651,3,5,6,3,17,13,4,21
NorthEast Un,1651,4,6,3,5,13,11,2,21
FC Pune City,1651,5,6,3,5,15,15,0,21
Chennaiyin,1651,6,4,6,4,16,18,-2,18
Kerala Blast,1651,7,4,3,7,11,19,-8,15
FC Goa,1651,8,3,2,9,8,20,-12,11
Mumbai City,1652,1,7,4,3,19,8,11,25
Kolkata,1652,2,5,6,3,19,14,5,21
Delhi Dynamo,1652,3,5,5,4,25,21,4,20
FC Pune City,1652,4,5,4,5,13,14,-1,19
NorthEast Un,1652,5,5,3,6,13,11,2,18
Chennaiyin,1652,6,4,5,5,16,20,-4,17
Kerala Blast,1652,7,4,5,5,10,16,-6,17
FC Goa,1652,8,4,2,8,11,22,-11,14
Delhi Dynamo,1653,1,6,6,2,23,14,9,24
Mumbai City,1653,2,6,5,3,16,8,8,23
Kolkata,1653,3,5,6,3,23,19,4,21
Kerala Blast,1653,4,6,3,5,13,15,-2,21
NorthEast Un,1653,5,6,2,6,12,11,1,20
FC Pune City,1653,6,4,3,7,13,20,-7,15
FC Goa,1653,7,4,2,8,14,19,-5,14
Chennaiyin,1653,8,3,5,6,14,22,-8,14
Mumbai City,1654,1,7,4,3,19,9,10,25
Delhi Dynamo,1654,2,6,5,3,26,18,8,23
Kolkata,1654,3,5,6,3,15,16,-1,21
NorthEast Un,1654,4,5,3,6,13,12,1,18
Chennaiyin,1654,5,4,6,4,18,19,-1,18
Kerala Blast,1654,6,5,3,6,10,16,-6,18
FC Pune City,1654,7,4,3,7,12,16,-4,15
FC Goa,1654,8,4,2,8,13,20,-7,14
Mumbai City,1655,1,6,4,4,16,10,6,22
Delhi Dynamo,1655,2,5,5,4,24,17,7,20
Kolkata,1655,3,4,7,3,17,15,2,19
FC Pune City,1655,4,5,4,5,14,15,-1,19
Kerala Blast,1655,5,5,4,5,10,15,-5,19
Chennaiyin,1655,6,4,6,4,16,19,-3,18
NorthEast Un,1655,7,5,2,7,11,12,-1,17
FC Goa,1655,8,4,4,6,12,17,-5,16
Delhi Dynamo,1656,1,7,5,2,29,15,14,26
Mumbai City,1656,2,6,4,4,17,11,6,22
FC Pune City,1656,3,5,4,5,16,16,0,19
Kolkata,1656,4,4,7,3,15,15,0,19
Kerala Blast,1656,5,5,3,6,12,17,-5,18
Chennaiyin,1656,6,4,5,5,15,19,-4,17
FC Goa,1656,7,5,2,7,11,17,-6,17
NorthEast Un,1656,8,4,2,8,10,15,-5,14
Mumbai City,1657,1,7,4,3,19,10,9,25
Delhi Dynamo,1657,2,5,5,4,28,22,6,20
Kolkata,1657,3,4,8,2,16,13,3,20
Kerala Blast,1657,4,5,4,5,12,15,-3,19
FC Pune City,1657,5,5,3,6,13,16,-3,18
NorthEast Un,1657,6,5,2,7,12,13,-1,17
Chennaiyin,1657,7,4,5,5,15,19,-4,17
FC Goa,1657,8,4,3,7,12,19,-7,15
Delhi Dynamo,1658,1,7,5,2,26,15,11,26
Mumbai City,1658,2,6,4,4,16,9,7,22
Kolkata,1658,3,4,7,3,17,15,2,19
Kerala Blast,1658,4,5,4,5,12,17,-5,19
FC Pune City,1658,5,5,3,6,16,18,-2,18
NorthEast Un,1658,6,5,2,7,11,12,-1,17
Chennaiyin,1658,7,4,5,5,14,18,-4,17
FC Goa,1658,8,4,2,8,9,17,-8,14
Mumbai City,1659,1,7,4,3,19,8,11,25
Delhi Dynamo,1659,2,5,6,3,27,19,8,21
FC Pune City,1659,3,6,3,5,15,14,1,21
Kerala Blast,1659,4,6,3,5,13,15,-2,21
NorthEast Un,1659,5,5,3,6,13,14,-1,18
Kolkata,1659,6,3,6,5,14,17,-3,15
Chennaiyin,1659,7,3,6,5,16,21,-5,15
FC Goa,1659,8,4,3,7,11,20,-9,15
Mumbai City,1660,1,6,4,4,16,9,7,22
Delhi Dynamo,1660,2,5,6,3,23,16,7,21
Kolkata,1660,3,4,8,2,17,15,2,20
Kerala Blast,1660,4,5,5,4,11,14,-3,20
NorthEast Un,1660,5,5,3,6,10,10,0,18
Chennaiyin,1660,6,4,6,4,14,17,-3,18
FC Pune City,1660,7,4,4,6,14,17,-3,16
FC Goa,1660,8,3,4,7,9,16,-7,13
Mumbai City,1661,1,7,4,3,18,8,10,25
Kerala Blast,1661,2,7,3,4,14,14,0,24
Delhi Dynamo,1661,3,5,5,4,24,19,5,20
Kolkata,1661,4,4,7,3,16,15,1,19
NorthEast Un,1661,5,5,3,6,12,12,0,18
FC Pune City,1661,6,4,4,6,12,15,-3,16
Chennaiyin,1661,7,3,7,4,15,19,-4,16
FC Goa,1661,8,3,3,8,10,19,-9,12
Mumbai City,1662,1,6,4,4,17,11,6,22
Delhi Dynamo,1662,2,5,5,4,25,18,7,20
Kolkata,1662,3,4,8,2,18,15,3,20
NorthEast Un,1662,4,5,4,5,14,13,1,19
Kerala Blast,1662,5,5,4,5,14,18,-4,19
FC Goa,1662,6,5,3,6,13,16,-3,18
FC Pune City,1662,7,4,4,6,13,17,-4,16
Chennaiyin,1662,8,3,6,5,17,23,-6,15
Mumbai City,1663,1,6,5,3,17,9,8,23
Kolkata,1663,2,5,7,2,16,13,3,22
Delhi Dynamo,1663,3,4,7,3,25,19,6,19
NorthEast Un,1663,4,5,3,6,13,14,-1,18
FC Pune City,1663,5,5,3,6,15,17,-2,18
Chennaiyin,1663,6,4,6,4,16,19,-3,18
Kerala Blast,1663,7,5,3,6,13,17,-4,18
FC Goa,1663,8,3,4,7,11,18,-7,13
Mumbai City,1664,1,7,4,3,18,8,10,25
Kolkata,1664,2,5,6,3,15,15,0,21
Kerala Blast,1664,3,6,3,5,12,15,-3,21
FC Goa,1664,4,6,2,6,15,16,-1,20
Delhi Dynamo,1664,5,4,6,4,26,22,4,18
NorthEast Un,1664,6,5,3,6,16,15,1,18
FC Pune City,1664,7,4,3,7,12,16,-4,15
Chennaiyin,1664,8,3,5,6,14,21,-7,14
Mumbai City,1665,1,7,4,3,20,10,10,25
Kolkata,1665,2,6,6,2,16,12,4,24
Delhi Dynamo,1665,3,6,5,3,28,19,9,23
Kerala Blast,1665,4,5,4,5,13,17,-4,19
FC Pune City,1665,5,4,4,6,13,16,-3,16
Chennaiyin,1665,6,3,7,4,15,19,-4,16
NorthEast Un,1665,7,4,3,7,12,15,-3,15
FC Goa,1665,8,3,3,8,10,19,-9,12
Mumbai City,1666,1,6,5,3,17,9,8,23
Delhi Dynamo,1666,2,5,7,2,23,15,8,22
Kolkata,1666,3,5,6,3,16,18,-2,21
FC Pune City,1666,4,5,3,6,13,15,-2,18
Kerala Blast,1666,5,5,3,6,12,17,-5,18
NorthEast Un,1666,6,5,2,7,12,12,0,17
Chennaiyin,1666,7,4,5,5,14,19,-5,17
FC Goa,1666,8,4,3,7,13,15,-2,15
Mumbai City,1667,1,6,4,4,17,11,6,22
Kolkata,1667,2,5,7,2,17,13,4,22
Delhi Dynamo,1667,3,5,5,4,24,19,5,20
Kerala Blast,1667,4,5,4,5,12,15,-3,19
NorthEast Un,1667,5,5,3,6,15,14,1,18
FC Pune City,1667,6,5,3,6,13,16,-3,18
FC Goa,1667,7,5,2,7,13,17,-4,17
Chennaiyin,1667,8,3,6,5,18,24,-6,15
Mumbai City,1668,1,7,4,3,18,9,9,25
Delhi Dynamo,1668,2,5,5,4,26,19,7,20
Kerala Blast,1668,3,5,5,4,16,16,0,20
FC Pune City,1668,4,5,4,5,15,15,0,19
FC Goa,1668,5,5,3,6,13,16,-3,18
Kolkata,1668,6,3,8,3,15,16,-1,17
Chennaiyin,1668,7,3,6,5,15,20,-5,15
NorthEast Un,1668,8,4,3,7,10,17,-7,15
Mumbai City,1669,1,6,5,3,18,10,8,23
Kolkata,1669,2,5,6,3,18,13,5,21
Kerala Blast,1669,3,6,3,5,11,15,-4,21
NorthEast Un,1669,4,6,2,6,13,12,1,20
Delhi Dynamo,1669,5,4,7,3,23,17,6,19
FC Goa,1669,6,4,4,6,10,15,-5,16
Chennaiyin,1669,7,3,6,5,16,21,-5,15
FC Pune City,1669,8,4,3,7,12,18,-6,15
Delhi Dynamo,1670,1,6,5,3,27,15,12,23
Mumbai City,1670,2,6,4,4,16,12,4,22
Kolkata,1670,3,4,8,2,20,17,3,20
Kerala Blast,1670,4,5,5,4,14,15,-1,20
Chennaiyin,1670,5,4,6,4,16,17,-1,18
FC Pune City,1670,6,4,5,5,13,15,-2,17
FC Goa,1670,7,4,3,7,11,18,-7,15
NorthEast Un,1670,8,4,2,8,9,17,-8,14
Mumbai City,1671,1,6,5,3,18,10,8,23
Kerala Blast,1671,2,6,4,4,14,16,-2,22
Delhi Dynamo,1671,3,5,6,3,24,18,6,21
NorthEast Un,1671,4,6,2,6,16,14,2,20
Kolkata,1671,5,4,7,3,17,16,1,19
FC Pune City,1671,6,4,5,5,14,16,-2,17
Chennaiyin,1671,7,4,5,5,16,20,-4,17
FC Goa,1671,8,3,2,9,8,17,-9,11
Mumbai City,1672,1,7,4,3,18,9,9,25
Delhi Dynamo,1672,2,5,6,3,24,17,7,21
Kolkata,1672,3,5,6,3,19,14,5,21
Kerala Blast,1672,4,6,3,5,13,15,-2,21
NorthEast Un,1672,5,5,4,5,12,11,1,19
Chennaiyin,1672,6,3,6,5,15,20,-5,15
FC Pune City,1672,7,4,3,7,12,17,-5,15
FC Goa,1672,8,4,2,8,12,22,-10,14
Delhi Dynamo,1673,1,7,5,2,27,17,10,26
Mumbai City,1673,2,6,4,4,17,10,7,22
FC Pune City,1673,3,6,3,5,17,15,2,21
Kerala Blast,1673,4,5,4,5,12,14,-2,19
Chennaiyin,1673,5,4,5,5,17,22,-5,17
Kolkata,1673,6,3,7,4,14,19,-5,16
NorthEast Un,1673,7,4,3,7,11,13,-2,15
FC Goa,1673,8,4,3,7,13,18,-5,15
Delhi Dynamo,1674,1,7,5,2,27,14,13,26
Mumbai City,1674,2,6,4,4,16,10,6,22
Kolkata,1674,3,5,7,2,17,12,5,22
FC Pune City,1674,4,4,5,5,14,16,-2,17
Kerala Blast,1674,5,4,5,5,11,18,-7,17
NorthEast Un,1674,6,4,4,6,10,11,-1,16
Chennaiyin,1674,7,3,7,4,15,19,-4,16
FC Goa,1674,8,3,3,8,9,19,-10,12
Mumbai City,1675,1,6,4,4,18,11,7,22
Delhi Dynamo,1675,2,5,6,3,27,20,7,21
Kolkata,1675,3,4,7,3,15,14,1,19
Kerala Blast,1675,4,5,4,5,11,15,-4,19
NorthEast Un,1675,5,5,3,6,13,13,0,18
FC Pune City,1675,6,5,3,6,13,15,-2,18
Chennaiyin,1675,7,3,7,4,13,17,-4,16
FC Goa,1675,8,4,4,6,11,16,-5,16
Delhi Dynamo,1676,1,6,5,3,24,16,8,23
Mumbai City,1676,2,6,4,4,16,9,7,22
Kolkata,1676,3,4,7,3,17,16,1,19
Kerala Blast,1676,4,5,4,5,12,15,-3,19
NorthEast Un,1676,5,5,3,6,12,13,-1,18
Chennaiyin,1676,6,4,6,4,16,19,-3,18
FC Pune City,1676,7,5,3,6,14,17,-3,18
FC Goa,1676,8,4,2,8,11,17,-6,14
Delhi Dynamo,1677,1,6,6,2,26,16,10,24
Mumbai City,1677,2,6,4,4,17,10,7,22
Kerala Blast,1677,3,6,3,5,12,15,-3,21
Kolkata,1677,4,4,7,3,15,14,1,19
FC Pune City,1677,5,5,3,6,14,16,-2,18
Chennaiyin,1677,6,3,7,4,14,18,-4,16
NorthEast Un,1677,7,4,3,7,9,12,-3,15
FC Goa,1677,8,3,5,6,11,17,-6,14
Kolkata,1678,1,6,6,2,18,13,5,24
Mumbai City,1678,2,6,5,3,18,10,8,23
NorthEast Un,1678,3,7,2,5,16,10,6,23
Delhi Dynamo,1678,4,4,7,3,24,20,4,19
FC Pune City,1678,5,4,4,6,13,16,-3,16
Kerala Blast,1678,6,4,4,6,9,17,-8,16
FC Goa,1678,7,4,3,7,11,17,-6,15
Chennaiyin,1678,8,3,5,6,15,21,-6,14
Mumbai City,1679,1,7,4,3,19,8,11,25
Delhi Dynamo,1679,2,6,5,3,24,18,6,23
NorthEast Un,1679,3,6,2,6,15,12,3,20
Kolkata,1679,4,4,7,3,17,16,1,19
Kerala Blast,1679,5,5,3,6,14,19,-5,18
FC Pune City,1679,6,4,4,6,13,17,-4,16
FC Goa,1679,7,4,3,7,13,18,-5,15
Chennaiyin,1679,8,3,6,5,15,22,-7,15
Mumbai City,1680,1,7,4,3,19,10,9,25
Kolkata,1680,2,5,7,2,17,14,3,22
Kerala Blast,1680,3,6,4,4,13,14,-1,22
Delhi Dynamo,1680,4,5,5,4,26,20,6,20
Chennaiyin,1680,5,4,5,5,17,19,-2,17
NorthEast Un,1680,6,5,2,7,12,16,-4,17
FC Pune City,1680,7,4,3,7,13,17,-4,15
FC Goa,1680,8,4,2,8,10,17,-7,14
Delhi Dynamo,1681,1,6,5,3,26,17,9,23
Mumbai City,1681,2,6,4,4,17,11,6,22
Kolkata,1681,3,5,6,3,16,14,2,21
Kerala Blast,1681,4,6,3,5,12,16,-4,21
FC Pune City,1681,5,5,3,6,15,15,0,18
Chennaiyin,1681,6,4,6,4,17,19,-2,18
NorthEast Un,1681,7,5,2,7,11,12,-1,17
FC Goa,1681,8,3,3,8,10,20,-10,12
Mumbai City,1682,1,7,4,3,17,8,9,25
NorthEast Un,1682,2,7,2,5,15,10,5,23
Delhi Dynamo,1682,3,5,5,4,24,18,6,20
Kolkata,1682,4,4,7,3,18,15,3,19
Kerala Blast,1682,5,5,3,6,11,18,-7,18
FC Pune City,1682,6,4,4,6,14,18,-4,16
Chennaiyin,1682,7,3,6,5,15,20,-5,15
FC Goa,1682,8,4,3,7,11,18,-7,15
Mumbai City,1683,1,6,5,3,17,9,8,23
Kolkata,1683,2,5,7,2,20,14,6,22
Kerala Blast,1683,3,6,3,5,11,16,-5,21
NorthEast Un,1683,4,6,2,6,14,11,3,20
Delhi Dynamo,1683,5,4,6,4,22,20,2,18
FC Goa,1683,6,5,3,6,15,17,-2,18
FC Pune City,1683,7,4,3,7,12,17,-5,15
Chennaiyin,1683,8,3,5,6,15,22,-7,14
Mumbai City,1684,1,7,4,3,18,8,10,25
Kerala Blast,1684,2,6,3,5,13,15,-2,21
Delhi Dynamo,1684,3,4,7,3,23,18,5,19
Kolkata,1684,4,4,7,3,17,17,0,19
NorthEast Un,1684,5,5,3,6,13,13,0,18
Chennaiyin,1684,6,4,5,5,15,20,-5,17
FC Goa,1684,7,4,4,6,14,18,-4,16
FC Pune City,1684,8,4,3,7,12,16,-4,15
Kerala Blast,1685,1,7,3,4,17,15,2,24
Mumbai City,1685,2,6,5,3,17,9,8,23
Delhi Dynamo,1685,3,4,7,3,24,18,6,19
NorthEast Un,1685,4,5,3,6,14,13,1,18
Kolkata,1685,5,4,6,4,15,16,-1,18
FC Goa,1685,6,5,3,6,11,15,-4,18
FC Pune City,1685,7,4,3,7,13,17,-4,15
Chennaiyin,1685,8,3,6,5,13,21,-8,15
Delhi Dynamo,1686,1,5,7,2,25,16,9,22
Mumbai City,1686,2,6,4,4,17,11,6,22
Kerala Blast,1686,3,6,4,4,13,14,-1,22
FC Pune City,1686,4,5,4,5,13,14,-1,19
Chennaiyin,1686,5,4,5,5,14,19,-5,17
Kolkata,1686,6,3,7,4,15,17,-2,16
FC Goa,1686,7,4,4,6,11,15,-4,16
NorthEast Un,1686,8,4,3,7,10,12,-2,15
Mumbai City,1687,1,6,5,3,16,8,8,23
Delhi Dynamo,1687,2,4,8,2,21,14,7,20
NorthEast Un,1687,3,5,4,5,11,10,1,19
Kerala Blast,1687,4,5,4,5,14,15,-1,19
Kolkata,1687,5,4,6,4,16,16,0,18
FC Pune City,1687,6,5,3,6,13,18,-5,18
Chennaiyin,1687,7,4,5,5,16,20,-4,17
FC Goa,1687,8,4,3,7,11,17,-6,15
Mumbai City,1688,1,7,4,3,19,9,10,25
Delhi Dynamo,1688,2,6,5,3,28,18,10,23
Kerala Blast,1688,3,6,3,5,13,17,-4,21
Kolkata,1688,4,4,6,4,16,16,0,18
FC Pune City,1688,5,5,3,6,16,17,-1,18
Chennaiyin,1688,6,4,5,5,15,19,-4,17
FC Goa,1688,7,5,2,7,11,17,-6,17
NorthEast Un,1688,8,4,2,8,11,16,-5,14
Mumbai City,1689,1,7,4,3,20,9,11,25
FC Pune City,1689,2,6,3,5,18,16,2,21
Kerala Blast,1689,3,6,3,5,13,16,-3,21
Chennaiyin,1689,4,5,5,4,18,19,-1,20
Delhi Dynamo,1689,5,4,7,3,23,19,4,19
Kolkata,1689,6,4,6,4,15,17,-2,18
NorthEast Un,1689,7,4,3,7,9,12,-3,15
FC Goa,1689,8,3,3,8,12,20,-8,12
Mumbai City,1690,1,7,4,3,18,8,10,25
Delhi Dynamo,1690,2,5,6,3,24,18,6,21
Kolkata,1690,3,5,6,3,19,13,6,21
Kerala Blast,1690,4,5,4,5,12,19,-7,19
FC Pune City,1690,5,5,3,6,13,16,-3,18
NorthEast Un,1690,6,4,5,5,12,12,0,17
Chennaiyin,1690,7,3,6,5,15,20,-5,15
FC Goa,1690,8,4,2,8,11,18,-7,14
Delhi Dynamo,1691,1,7,5,2,29,18,11,26
Mumbai City,1691,2,6,4,4,18,11,7,22
Kerala Blast,1691,3,5,5,4,12,15,-3,20
Kolkata,1691,4,4,6,4,17,17,0,18
Chennaiyin,1691,5,4,5,5,16,21,-5,17
FC Goa,1691,6,5,2,7,15,20,-5,17
FC Pune City,1691,7,4,4,6,13,16,-3,16
NorthEast Un,1691,8,4,3,7,11,13,-2,15
Mumbai City,1692,1,7,4,3,20,8,12,25
FC Pune City,1692,2,5,4,5,13,14,-1,19
Kerala Blast,1692,3,5,4,5,11,15,-4,19
Chennaiyin,1692,4,4,6,4,16,18,-2,18
FC Goa,1692,5,5,3,6,15,18,-3,18
Delhi Dynamo,1692,6,4,5,5,24,23,1,17
Kolkata,1692,7,3,8,3,15,16,-1,17
NorthEast Un,1692,8,5,2,7,11,13,-2,17
Mumbai City,1693,1,6,5,3,16,8,8,23
Kerala Blast,1693,2,6,4,4,15,16,-1,22
Delhi Dynamo,1693,3,4,7,3,22,16,6,19
Kolkata,1693,4,3,9,2,17,16,1,18
NorthEast Un,1693,5,5,3,6,13,12,1,18
FC Goa,1693,6,5,3,6,15,17,-2,18
FC Pune City,1693,7,4,4,6,14,17,-3,16
Chennaiyin,1693,8,3,5,6,13,23,-10,14
Mumbai City,1694,1,7,4,3,18,9,9,25
NorthEast Un,1694,2,6,3,5,17,12,5,21
Kerala Blast,1694,3,6,3,5,13,16,-3,21
Delhi Dynamo,1694,4,5,5,4,23,20,3,20
Kolkata,1694,5,4,7,3,17,16,1,19
Chennaiyin,1694,6,4,6,4,17,20,-3,18
FC Pune City,1694,7,4,3,7,14,18,-4,15
FC Goa,1694,8,3,3,8,11,19,-8,12
Mumbai City,1695,1,6,5,3,17,9,8,23
Delhi Dynamo,1695,2,5,7,2,24,16,8,22
Kolkata,1695,3,4,7,3,19,18,1,19
FC Pune City,1695,4,5,4,5,15,16,-1,19
NorthEast Un,1695,5,5,3,6,12,11,1,18
Chennaiyin,1695,6,4,6,4,16,18,-2,18
Kerala Blast,1695,7,4,4,6,11,18,-7,16
FC Goa,1695,8,3,4,7,12,20,-8,13
Mumbai City,1696,1,7,4,3,20,8,12,25
NorthEast Un,1696,2,6,3,5,15,10,5,21
Kolkata,1696,3,5,6,3,15,13,2,21
Kerala Blast,1696,4,6,3,5,13,14,-1,21
Delhi Dynamo,1696,5,4,6,4,22,23,-1,18
Chennaiyin,1696,6,3,6,5,15,20,-5,15
FC Pune City,1696,7,4,3,7,12,18,-6,15
FC Goa,1696,8,4,3,7,11,17,-6,15
Mumbai City,1697,1,7,4,3,18,8,10,25
Kerala Blast,1697,2,7,3,4,13,13,0,24
Delhi Dynamo,1697,3,5,5,4,26,20,6,20
Kolkata,1697,4,4,6,4,14,14,0,18
FC Pune City,1697,5,5,3,6,13,15,-2,18
NorthEast Un,1697,6,5,2,7,11,13,-2,17
Chennaiyin,1697,7,4,5,5,15,18,-3,17
FC Goa,1697,8,4,2,8,11,20,-9,14
Delhi Dynamo,1698,1,6,5,3,24,16,8,23
Mumbai City,1698,2,6,4,4,16,9,7,22
NorthEast Un,1698,3,6,2,6,12,11,1,20
Kerala Blast,1698,4,5,4,5,13,17,-4,19
FC Pune City,1698,5,5,3,6,16,17,-1,18
Kolkata,1698,6,3,8,3,15,16,-1,17
Chennaiyin,1698,7,4,5,5,14,18,-4,17
FC Goa,1698,8,4,3,7,10,16,-6,15
Mumbai City,1699,1,7,4,3,18,9,9,25
Delhi Dynamo,1699,2,4,7,3,23,17,6,19
FC Pune City,1699,3,5,4,5,17,17,0,19
Kolkata,1699,4,4,6,4,16,16,0,18
FC Goa,1699,5,5,3,6,12,16,-4,18
Chennaiyin,1699,6,4,5,5,17,20,-3,17
Kerala Blast,1699,7,4,5,5,12,18,-6,17
NorthEast Un,1699,8,4,4,6,11,13,-2,16
Mumbai City,1700,1,7,4,3,19,8,11,25
Delhi Dynamo,1700,2,5,6,3,24,19,5,21
Chennaiyin,1700,3,5,5,4,17,19,-2,20
Kerala Blast,1700,4,5,4,5,12,16,-4,19
NorthEast Un,1700,5,5,3,6,12,12,0,18
FC Pune City,1700,6,5,3,6,14,16,-2,18
Kolkata,1700,7,3,7,4,15,16,-1,16
FC Goa,1700,8,4,2,8,12,19,-7,14
Delhi Dynamo,1701,1,6,6,2,27,18,9,24
Mumbai City,1701,2,6,5,3,18,10,8,23
Kolkata,1701,3,4,7,3,18,17,1,19
FC Pune City,1701,4,4,5,5,14,16,-2,17
Kerala Blast,1701,5,4,5,5,13,18,-5,17
NorthEast Un,1701,6,4,4,6,9,10,-1,16
Chennaiyin,1701,7,3,7,4,14,18,-4,16
FC Goa,1701,8,4,3,7,12,18,-6,15
Mumbai City,1702,1,7,4,3,18,8,10,25
Delhi Dynamo,1702,2,6,5,3,26,16,10,23
Kolkata,1702,3,5,6,3,16,15,1,21
FC Pune City,1702,4,5,3,6,14,16,-2,18
Kerala Blast,1702,5,5,3,6,11,16,-5,18
NorthEast Un,1702,6,5,2,7,11,13,-2,17
Chennaiyin,1702,7,4,5,5,15,19,-4,17
FC Goa,1702,8,4,2,8,11,19,-8,14
Mumbai City,1703,1,7,4,3,20,9,11,25
Kolkata,1703,2,5,7,2,19,16,3,22
Delhi Dynamo,1703,3,5,5,4,26,24,2,20
Kerala Blast,1703,4,5,4,5,14,18,-4,19
FC Pune City,1703,5,5,3,6,18,19,-1,18
FC Goa,1703,6,5,2,7,18,18,0,17
NorthEast Un,1703,7,4,3,7,11,14,-3,15
Chennaiyin,1703,8,3,6,5,14,22,-8,15
Mumbai City,1704,1,7,4,3,19,8,11,25
Kolkata,1704,2,6,6,2,18,12,6,24
Delhi Dynamo,1704,3,4,7,3,22,18,4,19
NorthEast Un,1704,4,5,4,5,11,10,1,19
Kerala Blast,1704,5,5,4,5,12,15,-3,19
FC Goa,1704,6,4,3,7,9,15,-6,15
FC Pune City,1704,7,4,3,7,12,19,-7,15
Chennaiyin,1704,8,3,5,6,13,19,-6,14
Mumbai City,1705,1,7,4,3,18,8,10,25
Delhi Dynamo,1705,2,5,6,3,26,19,7,21
Kolkata,1705,3,5,6,3,20,18,2,21
NorthEast Un,1705,4,5,4,5,15,14,1,19
FC Pune City,1705,5,5,3,6,16,18,-2,18
FC Goa,1705,6,5,2,7,14,17,-3,17
Kerala Blast,1705,7,4,4,6,13,20,-7,16
Chennaiyin,1705,8,3,5,6,15,23,-8,14
Delhi Dynamo,1706,1,6,6,2,27,15,12,24
Kolkata,1706,2,6,6,2,17,12,5,24
Mumbai City,1706,3,6,4,4,17,10,7,22
Chennaiyin,1706,4,5,5,4,16,18,-2,20
NorthEast Un,1706,5,5,3,6,10,10,0,18
FC Pune City,1706,6,5,3,6,14,17,-3,18
Kerala Blast,1706,7,4,3,7,10,17,-7,15
FC Goa,1706,8,3,2,9,9,21,-12,11
Mumbai City,1707,1,6,5,3,18,10,8,23
Delhi Dynamo,1707,2,5,6,3,29,22,7,21
Kerala Blast,1707,3,6,3,5,13,15,-2,21
FC Goa,1707,4,6,2,6,15,17,-2,20
FC Pune City,1707,5,5,4,5,14,14,0,19
Chennaiyin,1707,6,4,5,5,17,21,-4,17
Kolkata,1707,7,3,7,4,13,16,-3,16
NorthEast Un,1707,8,4,2,8,13,17,-4,14
Mumbai City,1708,1,7,4,3,18,9,9,25
Delhi Dynamo,1708,2,6,5,3,26,17,9,23
Kolkata,1708,3,4,6,4,14,14,0,18
FC Pune City,1708,4,5,3,6,14,16,-2,18
Kerala Blast,1708,5,5,3,6,11,16,-5,18
NorthEast Un,1708,6,5,2,7,11,12,-1,17
Chennaiyin,1708,7,4,5,5,15,20,-5,17
FC Goa,1708,8,5,2,7,12,17,-5,17
Mumbai City,1709,1,6,5,3,16,8,8,23
Delhi Dynamo,1709,2,5,7,2,24,15,9,22
Kolkata,1709,3,5,7,2,17,13,4,22
NorthEast Un,1709,4,5,4,5,10,9,1,19
FC Pune City,1709,5,5,3,6,14,16,-2,18
Kerala Blast,1709,6,4,4,6,10,17,-7,16
Chennaiyin,1709,7,3,6,5,14,19,-5,15
FC Goa,1709,8,4,2,8,11,19,-8,14
Mumbai City,1710,1,6,5,3,18,10,8,23
NorthEast Un,1710,2,6,3,5,13,10,3,21
Kolkata,1710,3,4,8,2,16,13,3,20
Kerala Blast,1710,4,5,4,5,13,16,-3,19
Delhi Dynamo,1710,5,4,6,4,23,18,5,18
Chennaiyin,1710,6,4,6,4,17,19,-2,18
FC Pune City,1710,7,4,3,7,12,19,-7,15
FC Goa,1710,8,4,3,7,10,17,-7,15
Kolkata,1711,1,6,6,2,19,14,5,24
Delhi Dynamo,1711,2,6,5,3,26,20,6,23
Mumbai City,1711,3,6,4,4,17,11,6,22
NorthEast Un,1711,4,6,2,6,16,10,6,20
Kerala Blast,1711,5,5,3,6,11,18,-7,18
Chennaiyin,1711,6,4,5,5,15,20,-5,17
FC Pune City,1711,7,4,3,7,14,19,-5,15
FC Goa,1711,8,4,2,8,13,19,-6,14
Delhi Dynamo,1712,1,6,5,3,26,16,10,23
Kolkata,1712,2,5,7,2,21,15,6,22
Mumbai City,1712,3,6,4,4,16,11,5,22
Chennaiyin,1712,4,5,5,4,18,18,0,20
Kerala Blast,1712,5,5,4,5,15,19,-4,19
FC Pune City,1712,6,4,5,5,13,15,-2,17
NorthEast Un,1712,7,5,2,7,12,17,-5,17
FC Goa,1712,8,3,2,9,9,19,-10,11
Delhi Dynamo,1713,1,6,6,2,27,16,11,24
Kerala Blast,1713,2,7,3,4,15,14,1,24
Mumbai City,1713,3,6,4,4,17,11,6,22
FC Pune City,1713,4,5,3,6,14,16,-2,18
NorthEast Un,1713,5,4,4,6,10,11,-1,16
Chennaiyin,1713,6,3,7,4,13,17,-4,16
FC Goa,1713,7,4,3,7,13,17,-4,15
Kolkata,1713,8,3,6,5,14,21,-7,15
Mumbai City,1714,1,7,4,3,20,9,11,25
FC Goa,1714,2,6,2,6,15,15,0,20
Kolkata,1714,3,4,7,3,15,16,-1,19
Delhi Dynamo,1714,4,4,6,4,23,21,2,18
FC Pune City,1714,5,5,3,6,14,16,-2,18
Chennaiyin,1714,6,4,5,5,16,19,-3,17
Kerala Blast,1714,7,4,5,5,12,17,-5,17
NorthEast Un,1714,8,4,4,6,11,13,-2,16
Mumbai City,1715,1,6,5,3,17,9,8,23
Delhi Dynamo,1715,2,5,6,3,23,16,7,21
Kolkata,1715,3,4,8,2,16,14,2,20
Chennaiyin,1715,4,5,5,4,18,18,0,20
Kerala Blast,1715,5,5,4,5,12,16,-4,19
NorthEast Un,1715,6,5,3,6,10,10,0,18
FC Pune City,1715,7,4,4,6,12,15,-3,16
FC Goa,1715,8,3,3,8,9,19,-10,12
Mumbai City,1716,1,7,4,3,19,9,10,25
Kerala Blast,1716,2,6,4,4,14,15,-1,22
Delhi Dynamo,1716,3,5,5,4,24,20,4,20
Kolkata,1716,4,4,8,2,19,15,4,20
NorthEast Un,1716,5,5,3,6,12,11,1,18
Chennaiyin,1716,6,3,7,4,14,18,-4,16
FC Pune City,1716,7,4,4,6,12,16,-4,16
FC Goa,1716,8,3,3,8,10,20,-10,12
Mumbai City,1717,1,7,4,3,20,10,10,25
Delhi Dynamo,1717,2,5,6,3,27,21,6,21
Kolkata,1717,3,5,6,3,19,14,5,21
NorthEast Un,1717,4,5,4,5,15,13,2,19
Kerala Blast,1717,5,5,3,6,16,21,-5,18
FC Pune City,1717,6,5,3,6,13,19,-6,18
Chennaiyin,1717,7,3,6,5,14,20,-6,15
FC Goa,1717,8,4,2,8,11,17,-6,14
Mumbai City,1718,1,6,5,3,17,9,8,23
Kerala Blast,1718,2,6,4,4,13,14,-1,22
Delhi Dynamo,1718,3,5,6,3,27,21,6,21
NorthEast Un,1718,4,5,4,5,13,10,3,19
Kolkata,1718,5,4,6,4,15,15,0,18
FC Pune City,1718,6,5,3,6,15,18,-3,18
Chennaiyin,1718,7,3,6,5,14,20,-6,15
FC Goa,1718,8,4,2,8,13,20,-7,14
Mumbai City,1719,1,6,5,3,18,10,8,23
Delhi Dynamo,1719,2,5,6,3,25,17,8,21
Chennaiyin,1719,3,5,5,4,17,18,-1,20
Kerala Blast,1719,4,5,5,4,12,14,-2,20
NorthEast Un,1719,5,5,3,6,11,11,0,18
Kolkata,1719,6,3,8,3,14,16,-2,17
FC Pune City,1719,7,4,4,6,14,18,-4,16
FC Goa,1719,8,4,2,8,11,18,-7,14
Mumbai City,1720,1,6,5,3,18,10,8,23
Delhi Dynamo,1720,2,5,7,2,28,19,9,22
Kolkata,1720,3,5,7,2,17,13,4,22
Kerala Blast,1720,4,5,4,5,13,18,-5,19
NorthEast Un,1720,5,4,5,5,13,13,0,17
FC Pune City,1720,6,4,4,6,13,16,-3,16
Chennaiyin,1720,7,3,6,5,13,20,-7,15
FC Goa,1720,8,4,2,8,13,19,-6,14
Mumbai City,1721,1,7,4,3,19,8,11,25
Delhi Dynamo,1721,2,5,6,3,24,19,5,21
FC Pune City,1721,3,6,3,5,15,15,0,21
Kerala Blast,1721,4,5,4,5,11,14,-3,19
Chennaiyin,1721,5,4,6,4,15,18,-3,18
Kolkata,1721,6,3,8,3,15,15,0,17
NorthEast Un,1721,7,4,3,7,11,14,-3,15
FC Goa,1721,8,3,4,7,10,17,-7,13
Mumbai City,1722,1,7,4,3,17,8,9,25
Kolkata,1722,2,5,6,3,21,14,7,21
Chennaiyin,1722,3,5,5,4,17,18,-1,20
Delhi Dynamo,1722,4,4,6,4,22,17,5,18
NorthEast Un,1722,5,5,3,6,12,12,0,18
FC Pune City,1722,6,5,3,6,14,20,-6,18
Kerala Blast,1722,7,4,4,6,11,18,-7,16
FC Goa,1722,8,4,3,7,9,16,-7,15
Mumbai City,1723,1,6,5,3,17,9,8,23
Kolkata,1723,2,5,7,2,16,13,3,22
Delhi Dynamo,1723,3,5,6,3,24,18,6,21
Kerala Blast,1723,4,5,5,4,15,17,-2,20
NorthEast Un,1723,5,5,3,6,13,12,1,18
Chennaiyin,1723,6,4,5,5,15,22,-7,17
FC Pune City,1723,7,4,3,7,14,19,-5,15
FC Goa,1723,8,4,2,8,13,17,-4,14
Delhi Dynamo,1724,1,6,6,2,26,16,10,24
Mumbai City,1724,2,6,4,4,17,10,7,22
NorthEast Un,1724,3,6,3,5,14,10,4,21
FC Pune City,1724,4,5,4,5,16,15,1,19
Kolkata,1724,5,3,8,3,16,18,-2,17
Kerala Blast,1724,6,4,5,5,10,16,-6,17
FC Goa,1724,7,4,3,7,12,17,-5,15
Chennaiyin,1724,8,3,5,6,13,22,-9,14
Delhi Dynamo,1725,1,6,5,3,27,16,11,23
Mumbai City,1725,2,6,4,4,16,9,7,22
NorthEast Un,1725,3,6,3,5,12,10,2,21
Kerala Blast,1725,4,5,4,5,10,14,-4,19
FC Pune City,1725,5,5,3,6,15,17,-2,18
Chennaiyin,1725,6,4,6,4,16,19,-3,18
Kolkata,1725,7,3,7,4,16,19,-3,16
FC Goa,1725,8,4,2,8,14,22,-8,14
Mumbai City,1726,1,7,4,3,17,8,9,25
Delhi Dynamo,1726,2,5,5,4,25,17,8,20
Kolkata,1726,3,4,8,2,16,14,2,20
Kerala Blast,1726,4,5,4,5,14,16,-2,19
NorthEast Un,1726,5,5,3,6,12,12,0,18
Chennaiyin,1726,6,4,6,4,15,18,-3,18
FC Pune City,1726,7,4,4,6,13,18,-5,16
FC Goa,1726,8,3,4,7,11,20,-9,13
Mumbai City,1727,1,6,5,3,18,10,8,23
NorthEast Un,1727,2,7,2,5,17,11,6,23
Delhi Dynamo,1727,3,4,7,3,24,19,5,19
Kolkata,1727,4,4,7,3,16,15,1,19
FC Pune City,1727,5,5,3,6,14,16,-2,18
Kerala Blast,1727,6,5,3,6,14,19,-5,18
FC Goa,1727,7,4,4,6,11,16,-5,16
Chennaiyin,1727,8,3,5,6,13,21,-8,14
Mumbai City,1728,1,6,5,3,17,9,8,23
NorthEast Un,1728,2,6,3,5,13,11,2,21
FC Goa,1728,3,6,2,6,17,16,1,20
Kolkata,1728,4,4,7,3,18,15,3,19
Delhi Dynamo,1728,5,4,6,4,24,20,4,18
FC Pune City,1728,6,4,5,5,13,15,-2,17
Kerala Blast,1728,7,4,4,6,9,17,-8,16
Chennaiyin,1728,8,3,6,5,14,22,-8,15
Mumbai City,1729,1,7,4,3,17,8,9,25
Kolkata,1729,2,5,7,2,19,16,3,22
Delhi Dynamo,1729,3,5,6,3,26,17,9,21
FC Pune City,1729,4,5,4,5,15,16,-1,19
NorthEast Un,1729,5,5,3,6,14,12,2,18
Kerala Blast,1729,6,5,3,6,13,18,-5,18
Chennaiyin,1729,7,4,5,5,14,20,-6,17
FC Goa,1729,8,3,2,9,9,20,-11,11
Mumbai City,1730,1,6,5,3,17,9,8,23
NorthEast Un,1730,2,7,2,5,14,11,3,23
Delhi Dynamo,1730,3,5,6,3,25,18,7,21
FC Pune City,1730,4,6,3,5,15,14,1,21
Kolkata,1730,5,4,6,4,16,17,-1,18
Kerala Blast,1730,6,5,3,6,11,16,-5,18
Chennaiyin,1730,7,4,5,5,15,19,-4,17
FC Goa,1730,8,3,2,9,10,19,-9,11
Mumbai City,1731,1,7,4,3,18,8,10,25
Kerala Blast,1731,2,6,4,4,14,15,-1,22
Delhi Dynamo,1731,3,5,6,3,26,19,7,21
NorthEast Un,1731,4,5,4,5,14,12,2,19
Kolkata,1731,5,4,6,4,16,19,-3,18
FC Goa,1731,6,5,2,7,15,18,-3,17
FC Pune City,1731,7,4,3,7,14,19,-5,15
Chennaiyin,1731,8,3,5,6,13,20,-7,14
Delhi Dynamo,1732,1,5,7,2,24,16,8,22
Mumbai City,1732,2,6,4,4,17,10,7,22
Kerala Blast,1732,3,6,4,4,16,14,2,22
Kolkata,1732,4,4,7,3,16,14,2,19
NorthEast Un,1732,5,5,3,6,11,12,-1,18
FC Pune City,1732,6,5,3,6,13,18,-5,18
FC Goa,1732,7,4,3,7,11,18,-7,15
Chennaiyin,1732,8,3,5,6,15,21,-6,14
Kerala Blast,1733,1,7,3,4,14,14,0,24
Mumbai City,1733,2,6,5,3,16,8,8,23
Delhi Dynamo,1733,3,5,6,3,25,19,6,21
FC Goa,1733,4,6,2,6,13,15,-2,20
Chennaiyin,1733,5,4,5,5,15,19,-4,17
Kolkata,1733,6,3,7,4,13,14,-1,16
FC Pune City,1733,7,4,4,6,13,16,-3,16
NorthEast Un,1733,8,4,2,8,12,16,-4,14
Mumbai City,1734,1,7,4,3,19,9,10,25
Kolkata,1734,2,5,7,2,19,14,5,22
Delhi Dynamo,1734,3,5,5,4,26,20,6,20
Kerala Blast,1734,4,5,4,5,14,18,-4,19
FC Pune City,1734,5,5,3,6,14,16,-2,18
NorthEast Un,1734,6,5,2,7,13,15,-2,17
Chennaiyin,1734,7,4,5,5,17,22,-5,17
FC Goa,1734,8,4,2,8,15,23,-8,14
Mumbai City,1735,1,7,4,3,20,10,10,25
Kerala Blast,1735,2,7,3,4,17,15,2,24
Delhi Dynamo,1735,3,5,5,4,26,22,4,20
Kolkata,1735,4,4,7,3,17,17,0,19
Chennaiyin,1735,5,4,6,4,17,19,-2,18
NorthEast Un,1735,6,5,2,7,12,13,-1,17
FC Pune City,1735,7,4,4,6,13,17,-4,16
FC Goa,1735,8,3,3,8,12,21,-9,12
Mumbai City,1736,1,7,4,3,18,8,10,25
Kerala Blast,1736,2,6,4,4,12,13,-1,22
FC Goa,1736,3,6,2,6,14,17,-3,20
Delhi Dynamo,1736,4,4,6,4,23,19,4,18
FC Pune City,1736,5,5,3,6,13,16,-3,18
Chennaiyin,1736,6,4,5,5,17,20,-3,17
NorthEast Un,1736,7,4,4,6,10,12,-2,16
Kolkata,1736,8,3,6,5,13,15,-2,15
Delhi Dynamo,1737,1,6,5,3,29,15,14,23
Mumbai City,1737,2,6,4,4,16,11,5,22
Kolkata,1737,3,4,7,3,19,18,1,19
Kerala Blast,1737,4,5,4,5,13,18,-5,19
Chennaiyin,1737,5,4,6,4,16,17,-1,18
FC Pune City,1737,6,5,3,6,15,16,-1,18
NorthEast Un,1737,7,5,2,7,10,13,-3,17
FC Goa,1737,8,4,3,7,10,20,-10,15
Mumbai City,1738,1,6,4,4,16,9,7,22
Delhi Dynamo,1738,2,5,5,4,23,18,5,20
Kerala Blast,1738,3,5,5,4,11,14,-3,20
FC Pune City,1738,4,5,4,5,14,15,-1,19
Kolkata,1738,5,4,6,4,16,14,2,18
NorthEast Un,1738,6,5,3,6,13,12,1,18
Chennaiyin,1738,7,4,6,4,17,20,-3,18
FC Goa,1738,8,4,3,7,11,19,-8,15
Mumbai City,1739,1,7,4,3,17,8,9,25
Delhi Dynamo,1739,2,5,6,3,26,18,8,21
Kerala Blast,1739,3,6,3,5,15,15,0,21
Chennaiyin,1739,4,5,5,4,18,17,1,20
NorthEast Un,1739,5,5,3,6,12,15,-3,18
Kolkata,1739,6,3,8,3,16,18,-2,17
FC Pune City,1739,7,4,4,6,13,17,-4,16
FC Goa,1739,8,3,3,8,10,19,-9,12
Mumbai City,1740,1,6,5,3,17,9,8,23
Kolkata,1740,2,4,8,2,17,14,3,20
Chennaiyin,1740,3,5,5,4,17,18,-1,20
FC Pune City,1740,4,5,4,5,16,15,1,19
Delhi Dynamo,1740,5,4,6,4,23,19,4,18
NorthEast Un,1740,6,5,3,6,12,12,0,18
Kerala Blast,1740,7,4,5,5,11,18,-7,17
FC Goa,1740,8,4,2,8,11,19,-8,14
Delhi Dynamo,1741,1,6,6,2,29,15,14,24
Mumbai City,1741,2,6,5,3,17,9,8,23
Chennaiyin,1741,3,5,5,4,18,19,-1,20
Kerala Blast,1741,4,5,5,4,14,17,-3,20
Kolkata,1741,5,4,7,3,19,16,3,19
NorthEast Un,1741,6,4,3,7,13,17,-4,15
FC Pune City,1741,7,4,3,7,14,20,-6,15
FC Goa,1741,8,4,2,8,10,21,-11,14
Mumbai City,1742,1,7,4,3,18,8,10,25
Delhi Dynamo,1742,2,5,6,3,25,19,6,21
Kolkata,1742,3,4,8,2,20,14,6,20
NorthEast Un,1742,4,5,3,6,11,12,-1,18
Chennaiyin,1742,5,4,5,5,16,19,-3,17
Kerala Blast,1742,6,4,5,5,11,16,-5,17
FC Pune City,1742,7,4,4,6,12,19,-7,16
FC Goa,1742,8,4,3,7,12,18,-6,15
Delhi Dynamo,1743,1,6,5,3,25,16,9,23
Mumbai City,1743,2,6,4,4,17,11,6,22
Kerala Blast,1743,3,5,5,4,16,19,-3,20
Kolkata,1743,4,4,7,3,17,16,1,19
NorthEast Un,1743,5,5,4,5,15,14,1,19
FC Goa,1743,6,5,2,7,13,16,-3,17
FC Pune City,1743,7,4,3,7,15,19,-4,15
Chennaiyin,1743,8,3,6,5,15,22,-7,15
Mumbai City,1744,1,7,4,3,17,8,9,25
Delhi Dynamo,1744,2,6,5,3,24,16,8,23
Kolkata,1744,3,4,8,2,19,15,4,20
NorthEast Un,1744,4,5,3,6,13,13,0,18
FC Pune City,1744,5,5,3,6,13,17,-4,18
Chennaiyin,1744,6,3,7,4,14,18,-4,16
Kerala Blast,1744,7,4,4,6,10,16,-6,16
FC Goa,1744,8,3,4,7,11,18,-7,13
Mumbai City,1745,1,7,4,3,21,9,12,25
Delhi Dynamo,1745,2,5,6,3,25,21,4,21
Kolkata,1745,3,4,7,3,17,17,0,19
Kerala Blast,1745,4,5,4,5,13,17,-4,19
NorthEast Un,1745,5,5,2,7,11,12,-1,17
FC Pune City,1745,6,4,5,5,12,14,-2,17
Chennaiyin,1745,7,4,5,5,15,18,-3,17
FC Goa,1745,8,4,3,7,12,18,-6,15
Mumbai City,1746,1,7,4,3,20,8,12,25
NorthEast Un,1746,2,6,3,5,14,11,3,21
Delhi Dynamo,1746,3,5,5,4,24,22,2,20
Kerala Blast,1746,4,5,5,4,10,13,-3,20
Kolkata,1746,5,3,8,3,14,14,0,17
FC Pune City,1746,6,4,5,5,12,14,-2,17
FC Goa,1746,7,4,3,7,13,18,-5,15
Chennaiyin,1746,8,3,5,6,15,22,-7,14
Mumbai City,1747,1,6,5,3,17,9,8,23
Kerala Blast,1747,2,6,4,4,11,13,-2,22
Delhi Dynamo,1747,3,4,7,3,24,18,6,19
Kolkata,1747,4,4,6,4,14,14,0,18
NorthEast Un,1747,5,5,3,6,10,11,-1,18
FC Goa,1747,6,5,3,6,12,16,-4,18
Chennaiyin,1747,7,4,5,5,15,18,-3,17
FC Pune City,1747,8,4,3,7,12,16,-4,15
Mumbai City,1748,1,7,4,3,18,9,9,25
Delhi Dynamo,1748,2,4,7,3,25,19,6,19
NorthEast Un,1748,3,5,4,5,16,14,2,19
Kolkata,1748,4,4,7,3,16,16,0,19
Kerala Blast,1748,5,5,4,5,17,20,-3,19
FC Pune City,1748,6,5,3,6,16,19,-3,18
Chennaiyin,1748,7,3,7,4,16,20,-4,16
FC Goa,1748,8,3,4,7,10,17,-7,13
Mumbai City,1749,1,7,4,3,19,8,11,25
Delhi Dynamo,1749,2,5,6,3,24,18,6,21
FC Pune City,1749,3,5,4,5,15,15,0,19
Kerala Blast,1749,4,5,4,5,12,16,-4,19
Chennaiyin,1749,5,4,6,4,17,19,-2,18
Kolkata,1749,6,3,8,3,16,17,-1,17
NorthEast Un,1749,7,4,4,6,12,14,-2,16
FC Goa,1749,8,3,4,7,11,19,-8,13
Mumbai City,1750,1,6,5,3,18,10,8,23
Kerala Blast,1750,2,6,3,5,14,17,-3,21
FC Goa,1750,3,6,2,6,14,15,-1,20
Delhi Dynamo,1750,4,4,7,3,25,19,6,19
NorthEast Un,1750,5,5,4,5,13,12,1,19
Kolkata,1750,6,4,6,4,18,19,-1,18
FC Pune City,1750,7,4,3,7,14,18,-4,15
Chennaiyin,1750,8,3,6,5,14,20,-6,15
Kerala Blast,1751,1,7,3,4,18,16,2,24
Mumbai City,1751,2,6,5,3,17,9,8,23
Delhi Dynamo,1751,3,4,8,2,25,18,7,20
Chennaiyin,1751,4,5,5,4,17,18,-1,20
Kolkata,1751,5,4,6,4,16,16,0,18
FC Pune City,1751,6,4,3,7,14,18,-4,15
FC Goa,1751,7,4,3,7,12,18,-6,15
NorthEast Un,1751,8,4,3,7,11,17,-6,15
Mumbai City,1752,1,7,4,3,17,8,9,25
NorthEast Un,1752,2,6,3,5,23,12,11,21
FC Pune City,1752,3,5,4,5,14,15,-1,19
Delhi Dynamo,1752,4,4,6,4,23,21,2,18
Chennaiyin,1752,5,4,6,4,15,18,-3,18
Kolkata,1752,6,3,8,3,15,15,0,17
Kerala Blast,1752,7,4,4,6,10,22,-12,16
FC Goa,1752,8,4,3,7,11,17,-6,15
Mumbai City,1753,1,6,5,3,16,8,8,23
NorthEast Un,1753,2,7,2,5,16,12,4,23
Kolkata,1753,3,5,7,2,15,12,3,22
Delhi Dynamo,1753,4,5,6,3,27,19,8,21
FC Pune City,1753,5,5,3,6,16,18,-2,18
Kerala Blast,1753,6,4,4,6,14,20,-6,16
Chennaiyin,1753,7,3,5,6,14,21,-7,14
FC Goa,1753,8,4,2,8,13,21,-8,14
Mumbai City,1754,1,7,4,3,18,8,10,25
FC Goa,1754,2,6,2,6,15,16,-1,20
NorthEast Un,1754,3,5,4,5,12,11,1,19
Delhi Dynamo,1754,4,4,6,4,22,19,3,18
Kolkata,1754,5,4,6,4,16,16,0,18
FC Pune City,1754,6,5,3,6,13,16,-3,18
Kerala Blast,1754,7,5,3,6,12,16,-4,18
Chennaiyin,1754,8,3,6,5,15,21,-6,15
Mumbai City,1755,1,7,4,3,18,9,9,25
Delhi Dynamo,1755,2,6,5,3,24,16,8,23
Kolkata,1755,3,4,8,2,17,13,4,20
FC Pune City,1755,4,5,4,5,15,16,-1,19
NorthEast Un,1755,5,5,3,6,11,11,0,18
Chennaiyin,1755,6,4,5,5,16,19,-3,17
Kerala Blast,1755,7,4,4,6,10,18,-8,16
FC Goa,1755,8,3,3,8,8,17,-9,12
Mumbai City,1756,1,6,5,3,17,9,8,23
NorthEast Un,1756,2,7,2,5,13,9,4,23
Delhi Dynamo,1756,3,5,6,3,24,16,8,21
Kolkata,1756,4,5,6,3,18,16,2,21
FC Pune City,1756,5,6,3,5,16,15,1,21
Chennaiyin,1756,6,4,5,5,14,19,-5,17
Kerala Blast,1756,7,4,3,7,10,17,-7,15
FC Goa,1756,8,3,2,9,8,19,-11,11
Mumbai City,1757,1,7,4,3,19,8,11,25
Kolkata,1757,2,5,7,2,15,12,3,22
NorthEast Un,1757,3,5,3,6,13,14,-1,18
Kerala Blast,1757,4,4,6,4,12,16,-4,18
Delhi Dynamo,1757,5,4,5,5,24,22,2,17
FC Goa,1757,6,5,2,7,14,17,-3,17
Chennaiyin,1757,7,4,5,5,16,21,-5,17
FC Pune City,1757,8,4,4,6,14,17,-3,16
Kolkata,1758,1,6,6,2,18,13,5,24
Delhi Dynamo,1758,2,6,5,3,25,16,9,23
Mumbai City,1758,3,6,4,4,17,11,6,22
Chennaiyin,1758,4,4,6,4,15,18,-3,18
Kerala Blast,1758,5,5,3,6,13,16,-3,18
NorthEast Un,1758,6,5,2,7,12,13,-1,17
FC Goa,1758,7,4,3,7,10,16,-6,15
FC Pune City,1758,8,4,3,7,12,19,-7,15
Mumbai City,1759,1,7,4,3,18,9,9,25
Kolkata,1759,2,5,7,2,18,14,4,22
FC Pune City,1759,3,5,4,5,14,15,-1,19
Delhi Dynamo,1759,4,4,6,4,22,18,4,18
Kerala Blast,1759,5,5,3,6,10,16,-6,18
NorthEast Un,1759,6,5,2,7,14,14,0,17
Chennaiyin,1759,7,4,5,5,17,23,-6,17
FC Goa,1759,8,4,3,7,12,16,-4,15
Mumbai City,1760,1,7,4,3,19,10,9,25
Delhi Dynamo,1760,2,6,5,3,25,17,8,23
Kolkata,1760,3,5,7,2,16,12,4,22
NorthEast Un,1760,4,5,3,6,13,12,1,18
Kerala Blast,1760,5,5,3,6,12,18,-6,18
Chennaiyin,1760,6,3,7,4,16,20,-4,16
FC Pune City,1760,7,4,3,7,12,17,-5,15
FC Goa,1760,8,3,4,7,10,17,-7,13
Mumbai City,1761,1,7,4,3,18,8,10,25
Kerala Blast,1761,2,6,3,5,12,15,-3,21
Kolkata,1761,3,4,7,3,17,16,1,19
Delhi Dynamo,1761,4,4,6,4,21,17,4,18
FC Pune City,1761,5,5,3,6,14,16,-2,18
NorthEast Un,1761,6,5,2,7,12,13,-1,17
Chennaiyin,1761,7,4,5,5,16,21,-5,17
FC Goa,1761,8,4,4,6,13,17,-4,16
Mumbai City,1762,1,6,4,4,17,10,7,22
Delhi Dynamo,1762,2,5,6,3,24,17,7,21
Kerala Blast,1762,3,5,4,5,13,19,-6,19
Kolkata,1762,4,4,6,4,19,19,0,18
FC Goa,1762,5,5,3,6,15,15,0,18
NorthEast Un,1762,6,5,3,6,11,11,0,18
FC Pune City,1762,7,5,3,6,14,16,-2,18
Chennaiyin,1762,8,4,5,5,15,21,-6,17
Mumbai City,1763,1,6,5,3,17,9,8,23
Kolkata,1763,2,5,7,2,16,13,3,22
Delhi Dynamo,1763,3,5,6,3,27,18,9,21
NorthEast Un,1763,4,6,2,6,16,14,2,20
Kerala Blast,1763,5,5,3,6,10,16,-6,18
Chennaiyin,1763,6,4,5,5,16,21,-5,17
FC Pune City,1763,7,4,3,7,12,16,-4,15
FC Goa,1763,8,4,3,7,11,18,-7,15
Mumbai City,1764,1,7,4,3,19,9,10,25
Delhi Dynamo,1764,2,6,5,3,25,18,7,23
Kerala Blast,1764,3,5,4,5,12,15,-3,19
NorthEast Un,1764,4,5,3,6,11,11,0,18
FC Pune City,1764,5,5,3,6,14,16,-2,18
Kolkata,1764,5,4,6,4,14,16,-2,18
Chennaiyin,1764,7,3,6,5,14,19,-5,15
FC Goa,1764,8,4,3,7,12,17,-5,15
Kerala Blast,1765,1,7,3,4,15,15,0,24
Delhi Dynamo,1765,2,6,5,3,25,17,8,23
Mumbai City,1765,3,6,4,4,16,10,6,22
NorthEast Un,1765,4,5,2,7,11,12,-1,17
Chennaiyin,1765,5,4,5,5,15,18,-3,17
FC Goa,1765,6,5,2,7,12,16,-4,17
Kolkata,1765,7,3,7,4,16,18,-2,16
FC Pune City,1765,8,4,4,6,15,19,-4,16
Delhi Dynamo,1766,1,7,5,2,27,15,12,26
Mumbai City,1766,2,6,4,4,16,10,6,22
Kolkata,1766,3,4,7,3,18,16,2,19
Kerala Blast,1766,4,5,4,5,12,19,-7,19
FC Pune City,1766,5,5,3,6,17,17,0,18
Chennaiyin,1766,6,4,5,5,15,20,-5,17
NorthEast Un,1766,7,4,3,7,11,13,-2,15
FC Goa,1766,8,4,3,7,12,18,-6,15
Mumbai City,1767,1,7,4,3,18,8,10,25
NorthEast Un,1767,2,7,2,5,16,9,7,23
Delhi Dynamo,1767,3,5,5,4,25,19,6,20
Kerala Blast,1767,4,5,4,5,14,19,-5,19
FC Pune City,1767,5,5,3,6,16,18,-2,18
Chennaiyin,1767,6,4,5,5,17,19,-2,17
Kolkata,1767,7,3,7,4,17,19,-2,16
FC Goa,1767,8,4,2,8,11,23,-12,14
Mumbai City,1768,1,7,4,3,18,9,9,25
Kolkata,1768,2,5,7,2,19,15,4,22
Delhi Dynamo,1768,3,5,5,4,25,19,6,20
NorthEast Un,1768,4,5,4,5,13,12,1,19
Kerala Blast,1768,5,4,5,5,11,17,-6,17
FC Pune City,1768,6,4,4,6,12,15,-3,16
FC Goa,1768,7,4,3,7,15,18,-3,15
Chennaiyin,1768,8,3,6,5,14,22,-8,15
Mumbai City,1769,1,7,4,3,18,9,9,25
Kerala Blast,1769,2,5,5,4,11,14,-3,20
Kolkata,1769,3,4,7,3,16,15,1,19
NorthEast Un,1769,4,5,4,5,11,10,1,19
Delhi Dynamo,1769,5,4,6,4,22,18,4,18
Chennaiyin,1769,6,4,5,5,18,20,-2,17
FC Pune City,1769,7,4,4,6,14,17,-3,16
FC Goa,1769,8,4,3,7,12,19,-7,15
Delhi Dynamo,1770,1,6,5,3,26,18,8,23
Mumbai City,1770,2,6,4,4,17,10,7,22
NorthEast Un,1770,3,6,3,5,14,12,2,21
Kolkata,1770,4,4,8,2,15,13,2,20
FC Pune City,1770,5,4,5,5,12,14,-2,17
Kerala Blast,1770,6,4,5,5,9,14,-5,17
Chennaiyin,1770,7,3,7,4,17,21,-4,16
FC Goa,1770,8,3,3,8,12,20,-8,12
Kerala Blast,1771,1,7,3,4,14,13,1,24
Mumbai City,1771,2,6,4,4,18,11,7,22
Delhi Dynamo,1771,3,5,5,4,26,21,5,20
NorthEast Un,1771,4,6,2,6,13,13,0,20
Kolkata,1771,5,4,7,3,15,14,1,19
FC Pune City,1771,6,4,4,6,12,15,-3,16
Chennaiyin,1771,7,3,6,5,15,20,-5,15
FC Goa,1771,8,4,3,7,12,18,-6,15
Kerala Blast,1772,1,7,3,4,15,15,0,24
Delhi Dynamo,1772,2,6,5,3,27,17,10,23
Mumbai City,1772,3,6,4,4,16,9,7,22
FC Goa,1772,4,5,3,6,14,16,-2,18
Kolkata,1772,5,3,8,3,17,17,0,17
NorthEast Un,1772,6,5,2,7,13,16,-3,17
FC Pune City,1772,7,4,4,6,16,19,-3,16
Chennaiyin,1772,8,3,5,6,13,22,-9,14
Kolkata,1773,1,6,6,2,18,13,5,24
Mumbai City,1773,2,6,5,3,16,8,8,23
Kerala Blast,1773,3,6,3,5,15,17,-2,21
Delhi Dynamo,1773,4,4,8,2,24,17,7,20
Chennaiyin,1773,5,4,5,5,15,19,-4,17
NorthEast Un,1773,6,4,3,7,12,15,-3,15
FC Pune City,1773,7,4,3,7,15,20,-5,15
FC Goa,1773,8,4,3,7,10,16,-6,15
Delhi Dynamo,1774,1,7,5,2,28,15,13,26
Mumbai City,1774,2,6,4,4,17,10,7,22
Kolkata,1774,3,5,7,2,19,13,6,22
Chennaiyin,1774,4,4,5,5,15,18,-3,17
NorthEast Un,1774,5,5,2,7,12,15,-3,17
Kerala Blast,1774,6,4,5,5,11,16,-5,17
FC Pune City,1774,7,4,4,6,13,18,-5,16
FC Goa,1774,8,4,2,8,9,19,-10,14
Mumbai City,1775,1,7,4,3,19,10,9,25
Delhi Dynamo,1775,2,5,6,3,27,19,8,21
Chennaiyin,1775,3,5,5,4,19,20,-1,20
NorthEast Un,1775,4,5,3,6,13,13,0,18
Kolkata,1775,5,4,6,4,17,18,-1,18
FC Pune City,1775,6,5,3,6,14,16,-2,18
Kerala Blast,1775,7,5,3,6,11,16,-5,18
FC Goa,1775,8,4,2,8,13,21,-8,14
Mumbai City,1776,1,7,4,3,19,8,11,25
NorthEast Un,1776,2,6,2,6,13,13,0,20
Chennaiyin,1776,3,5,5,4,18,19,-1,20
Kolkata,1776,4,4,7,3,20,17,3,19
FC Pune City,1776,5,5,4,5,17,17,0,19
Delhi Dynamo,1776,6,4,5,5,21,19,2,17
FC Goa,1776,7,5,2,7,13,18,-5,17
Kerala Blast,1776,8,4,3,7,11,21,-10,15
Delhi Dynamo,1777,1,6,6,2,26,17,9,24
Mumbai City,1777,2,6,5,3,17,9,8,23
FC Pune City,1777,3,6,3,5,17,15,2,21
Chennaiyin,1777,4,5,5,4,17,17,0,20
Kolkata,1777,5,4,7,3,15,15,0,19
Kerala Blast,1777,6,4,4,6,13,20,-7,16
NorthEast Un,1777,7,4,3,7,12,15,-3,15
FC Goa,1777,8,3,3,8,9,18,-9,12
Mumbai City,1778,1,7,4,3,17,8,9,25
Kolkata,1778,2,5,7,2,18,14,4,22
Kerala Blast,1778,3,5,4,5,10,14,-4,19
FC Goa,1778,4,5,3,6,12,15,-3,18
Delhi Dynamo,1778,5,4,5,5,23,20,3,17
NorthEast Un,1778,6,5,2,7,13,14,-1,17
Chennaiyin,1778,7,4,5,5,15,19,-4,17
FC Pune City,1778,8,4,4,6,13,17,-4,16
Delhi Dynamo,1779,1,6,5,3,27,19,8,23
Mumbai City,1779,2,6,4,4,17,10,7,22
Kolkata,1779,3,5,7,2,17,14,3,22
Kerala Blast,1779,4,6,4,4,13,14,-1,22
Chennaiyin,1779,5,3,7,4,14,18,-4,16
NorthEast Un,1779,6,4,3,7,12,14,-2,15
FC Pune City,1779,7,4,3,7,13,18,-5,15
FC Goa,1779,8,4,3,7,10,16,-6,15
Delhi Dynamo,1780,1,6,6,2,28,16,12,24
Mumbai City,1780,2,6,4,4,16,11,5,22
Kerala Blast,1780,3,6,3,5,16,18,-2,21
FC Goa,1780,4,5,3,6,16,15,1,18
NorthEast Un,1780,5,5,3,6,13,14,-1,18
Kolkata,1780,6,3,7,4,14,17,-3,16
FC Pune City,1780,7,4,4,6,15,19,-4,16
Chennaiyin,1780,8,3,6,5,15,23,-8,15
Mumbai City,1781,1,7,4,3,20,8,12,25
Delhi Dynamo,1781,2,5,6,3,22,18,4,21
Kolkata,1781,3,5,6,3,18,17,1,21
Kerala Blast,1781,4,5,4,5,14,17,-3,19
FC Pune City,1781,5,4,4,6,14,17,-3,16
Chennaiyin,1781,6,3,7,4,13,17,-4,16
FC Goa,1781,7,4,4,6,12,16,-4,16
NorthEast Un,1781,8,4,3,7,9,12,-3,15
Mumbai City,1782,1,7,4,3,20,9,11,25
Delhi Dynamo,1782,2,5,6,3,24,19,5,21
Kolkata,1782,3,5,6,3,17,15,2,21
Chennaiyin,1782,4,4,6,4,14,17,-3,18
Kerala Blast,1782,5,4,5,5,11,16,-5,17
FC Pune City,1782,6,4,4,6,15,19,-4,16
FC Goa,1782,7,4,4,6,11,15,-4,16
NorthEast Un,1782,8,4,3,7,9,11,-2,15
Mumbai City,1783,1,6,5,3,17,9,8,23
Delhi Dynamo,1783,2,5,6,3,27,19,8,21
Kolkata,1783,3,5,6,3,18,15,3,21
Kerala Blast,1783,4,6,3,5,18,17,1,21
NorthEast Un,1783,5,5,3,6,14,15,-1,18
Chennaiyin,1783,6,3,7,4,16,20,-4,16
FC Pune City,1783,7,4,3,7,12,19,-7,15
FC Goa,1783,8,4,3,7,13,21,-8,15
Delhi Dynamo,1784,1,6,5,3,27,18,9,23
Mumbai City,1784,2,6,4,4,18,11,7,22
Kolkata,1784,3,5,7,2,17,14,3,22
FC Pune City,1784,4,5,4,5,15,15,0,19
NorthEast Un,1784,5,5,3,6,12,12,0,18
Kerala Blast,1784,6,4,4,6,10,17,-7,16
Chennaiyin,1784,7,3,6,5,15,21,-6,15
FC Goa,1784,8,4,3,7,11,17,-6,15
Mumbai City,1785,1,7,4,3,18,9,9,25
Delhi Dynamo,1785,2,6,5,3,28,18,10,23
Kolkata,1785,3,5,7,2,16,13,3,22
FC Pune City,1785,4,5,4,5,13,14,-1,19
Kerala Blast,1785,5,5,3,6,11,16,-5,18
Chennaiyin,1785,6,4,5,5,15,20,-5,17
NorthEast Un,1785,7,4,2,8,10,15,-5,14
FC Goa,1785,8,4,2,8,12,18,-6,14
Delhi Dynamo,1786,1,6,6,2,29,19,10,24
Mumbai City,1786,2,6,5,3,19,11,8,23
Kolkata,1786,3,5,6,3,24,16,8,21
NorthEast Un,1786,4,5,3,6,11,11,0,18
Kerala Blast,1786,5,5,3,6,11,21,-10,18
Chennaiyin,1786,6,3,7,4,14,18,-4,16
FC Goa,1786,7,4,3,7,14,19,-5,15
FC Pune City,1786,8,4,3,7,12,19,-7,15
Mumbai City,1787,1,6,5,3,17,9,8,23
Delhi Dynamo,1787,2,5,7,2,25,17,8,22
Kolkata,1787,3,4,8,2,17,13,4,20
Chennaiyin,1787,4,5,5,4,16,17,-1,20
FC Pune City,1787,5,4,5,5,12,14,-2,17
Kerala Blast,1787,6,4,5,5,9,16,-7,17
NorthEast Un,1787,7,4,4,6,11,13,-2,16
FC Goa,1787,8,3,3,8,9,17,-8,12
Mumbai City,1788,1,7,4,3,19,10,9,25
Kerala Blast,1788,2,6,4,4,13,15,-2,22
NorthEast Un,1788,3,5,4,5,12,10,2,19
Delhi Dynamo,1788,4,4,6,4,25,21,4,18
Kolkata,1788,5,3,8,3,16,16,0,17
FC Pune City,1788,6,4,4,6,14,17,-3,16
Chennaiyin,1788,7,3,7,4,14,18,-4,16
FC Goa,1788,8,3,5,6,11,17,-6,14
Mumbai City,1789,1,7,4,3,18,8,10,25
Delhi Dynamo,1789,2,5,6,3,23,17,6,21
Kolkata,1789,3,4,7,3,18,16,2,19
FC Pune City,1789,4,5,4,5,14,15,-1,19
Chennaiyin,1789,5,4,5,5,16,20,-4,17
Kerala Blast,1789,6,4,5,5,11,17,-6,17
FC Goa,1789,7,4,4,6,15,20,-5,16
NorthEast Un,1789,8,4,3,7,10,12,-2,15
Mumbai City,1790,1,6,5,3,16,8,8,23
Delhi Dynamo,1790,2,5,7,2,22,14,8,22
Kolkata,1790,3,5,6,3,17,14,3,21
NorthEast Un,1790,4,5,4,5,10,9,1,19
Chennaiyin,1790,5,3,7,4,14,18,-4,16
FC Pune City,1790,6,4,4,6,13,17,-4,16
Kerala Blast,1790,7,4,4,6,11,17,-6,16
FC Goa,1790,8,4,3,7,10,16,-6,15
Mumbai City,1791,1,7,4,3,18,9,9,25
Delhi Dynamo,1791,2,5,5,4,24,18,6,20
Kolkata,1791,3,4,8,2,20,16,4,20
FC Pune City,1791,4,5,4,5,16,17,-1,19
NorthEast Un,1791,5,5,3,6,12,14,-2,18
Kerala Blast,1791,6,5,3,6,12,17,-5,18
FC Goa,1791,7,4,3,7,11,16,-5,15
Chennaiyin,1791,8,3,6,5,14,20,-6,15
Mumbai City,1792,1,6,5,3,17,9,8,23
NorthEast Un,1792,2,6,3,5,12,10,2,21
Kolkata,1792,3,4,8,2,18,15,3,20
Delhi Dynamo,1792,4,4,7,3,25,19,6,19
Kerala Blast,1792,5,4,5,5,12,17,-5,17
FC Pune City,1792,6,4,4,6,15,19,-4,16
FC Goa,1792,7,4,4,6,13,18,-5,16
Chennaiyin,1792,8,3,6,5,14,19,-5,15
Delhi Dynamo,1793,1,6,6,2,27,16,11,24
Mumbai City,1793,2,6,4,4,17,11,6,22
Kerala Blast,1793,3,6,4,4,13,15,-2,22
Kolkata,1793,4,5,6,3,17,14,3,21
NorthEast Un,1793,5,4,5,5,12,12,0,17
Chennaiyin,1793,6,3,6,5,15,20,-5,15
FC Pune City,1793,7,4,3,7,13,18,-5,15
FC Goa,1793,8,4,2,8,11,19,-8,14
Mumbai City,1794,1,6,5,3,19,11,8,23
Delhi Dynamo,1794,2,5,6,3,28,20,8,21
Kolkata,1794,3,5,6,3,16,14,2,21
NorthEast Un,1794,4,6,2,6,15,14,1,20
FC Pune City,1794,5,5,4,5,13,14,-1,19
Kerala Blast,1794,6,5,4,5,12,16,-4,19
Chennaiyin,1794,7,3,5,6,16,22,-6,14
FC Goa,1794,8,4,2,8,11,19,-8,14
Mumbai City,1795,1,7,4,3,17,8,9,25
NorthEast Un,1795,2,6,3,5,15,11,4,21
FC Goa,1795,3,6,2,6,15,17,-2,20
Kolkata,1795,4,4,7,3,17,15,2,19
Kerala Blast,1795,5,5,4,5,13,15,-2,19
Delhi Dynamo,1795,6,4,5,5,23,22,1,17
Chennaiyin,1795,7,3,6,5,14,19,-5,15
FC Pune City,1795,8,4,3,7,13,20,-7,15
Mumbai City,1796,1,7,4,3,20,9,11,25
Kolkata,1796,2,5,7,2,18,13,5,22
Delhi Dynamo,1796,3,5,5,4,24,20,4,20
NorthEast Un,1796,4,6,2,6,14,10,4,20
Chennaiyin,1796,5,5,5,4,17,18,-1,20
Kerala Blast,1796,6,5,3,6,11,17,-6,18
FC Pune City,1796,7,4,3,7,13,20,-7,15
FC Goa,1796,8,3,3,8,9,19,-10,12
Mumbai City,1797,1,7,4,3,21,8,13,25
Delhi Dynamo,1797,2,5,5,4,22,20,2,20
NorthEast Un,1797,3,6,2,6,12,11,1,20
Kolkata,1797,4,4,7,3,19,16,3,19
Kerala Blast,1797,5,5,3,6,13,20,-7,18
Chennaiyin,1797,6,4,5,5,16,20,-4,17
FC Goa,1797,7,5,2,7,12,17,-5,17
FC Pune City,1797,8,4,4,6,13,16,-3,16
Mumbai City,1798,1,7,4,3,17,8,9,25
Delhi Dynamo,1798,2,6,5,3,24,15,9,23
FC Pune City,1798,3,6,3,5,18,15,3,21
Kolkata,1798,4,4,7,3,18,19,-1,19
NorthEast Un,1798,5,5,3,6,14,12,2,18
Chennaiyin,1798,6,4,6,4,16,19,-3,18
Kerala Blast,1798,7,4,4,6,10,19,-9,16
FC Goa,1798,8,3,2,9,10,20,-10,11
Mumbai City,1799,1,7,4,3,19,10,9,25
Kolkata,1799,2,6,6,2,18,13,5,24
Delhi Dynamo,1799,3,5,5,4,24,20,4,20
NorthEast Un,1799,4,5,4,5,14,11,3,19
Kerala Blast,1799,5,5,4,5,11,15,-4,19
Chennaiyin,1799,6,4,6,4,17,20,-3,18
FC Pune City,1799,7,4,3,7,12,17,-5,15
FC Goa,1799,8,3,2,9,11,20,-9,11
Mumbai City,1800,1,7,4,3,17,8,9,25
Delhi Dynamo,1800,2,5,5,4,25,16,9,20
NorthEast Un,1800,3,6,2,6,11,10,1,20
Kerala Blast,1800,4,5,4,5,12,16,-4,19
Kolkata,1800,5,3,8,3,17,17,0,17
Chennaiyin,1800,6,4,5,5,15,19,-4,17
FC Goa,1800,7,5,2,7,11,19,-8,17
FC Pune City,1800,8,4,4,6,14,17,-3,16
Mumbai City,1801,1,7,4,3,20,11,9,25
Kolkata,1801,2,6,6,2,19,14,5,24
Delhi Dynamo,1801,3,6,5,3,27,18,9,23
NorthEast Un,1801,4,6,2,6,14,12,2,20
Kerala Blast,1801,5,5,3,6,14,19,-5,18
FC Pune City,1801,6,4,3,7,12,17,-5,15
Chennaiyin,1801,7,3,6,5,14,20,-6,15
FC Goa,1801,8,3,3,8,9,18,-9,12
Mumbai City,1802,1,7,4,3,18,9,9,25
Kolkata,1802,2,5,6,3,19,14,5,21
Kerala Blast,1802,3,6,3,5,14,17,-3,21
Delhi Dynamo,1802,4,5,5,4,25,20,5,20
NorthEast Un,1802,5,6,2,6,16,13,3,20
Chennaiyin,1802,6,4,5,5,16,19,-3,17
FC Pune City,1802,7,4,3,7,12,19,-7,15
FC Goa,1802,8,4,2,8,10,19,-9,14
Mumbai City,1803,1,7,4,3,17,8,9,25
Delhi Dynamo,1803,2,6,5,3,25,16,9,23
Kolkata,1803,3,4,6,4,14,14,0,18
NorthEast Un,1803,4,5,3,6,10,10,0,18
FC Pune City,1803,5,5,3,6,13,16,-3,18
Kerala Blast,1803,6,5,3,6,11,15,-4,18
FC Goa,1803,7,5,2,7,11,17,-6,17
Chennaiyin,1803,8,3,6,5,13,18,-5,15
Kolkata,1804,1,6,6,2,17,12,5,24
Mumbai City,1804,2,6,5,3,17,9,8,23
NorthEast Un,1804,3,6,3,5,17,13,4,21
Delhi Dynamo,1804,4,4,8,2,25,18,7,20
FC Pune City,1804,5,5,3,6,14,15,-1,18
FC Goa,1804,6,4,3,7,10,17,-7,15
Kerala Blast,1804,7,4,3,7,10,18,-8,15
Chennaiyin,1804,8,3,5,6,14,22,-8,14
Mumbai City,1805,1,6,5,3,17,9,8,23
NorthEast Un,1805,2,6,3,5,15,12,3,21
Kolkata,1805,3,5,6,3,16,14,2,21
Kerala Blast,1805,4,5,4,5,11,17,-6,19
Delhi Dynamo,1805,5,4,6,4,28,24,4,18
FC Pune City,1805,6,5,3,6,15,15,0,18
Chennaiyin,1805,7,4,5,5,15,18,-3,17
FC Goa,1805,8,4,2,8,14,22,-8,14
Delhi Dynamo,1806,1,6,5,3,24,17,7,23
Mumbai City,1806,2,6,4,4,16,9,7,22
Chennaiyin,1806,3,5,5,4,16,17,-1,20
Kerala Blast,1806,4,5,5,4,15,16,-1,20
NorthEast Un,1806,5,5,3,6,12,11,1,18
Kolkata,1806,6,3,8,3,16,16,0,17
FC Pune City,1806,7,4,4,6,13,18,-5,16
FC Goa,1806,8,4,2,8,10,18,-8,14
Mumbai City,1807,1,6,5,3,19,11,8,23
Delhi Dynamo,1807,2,5,6,3,27,23,4,21
Kolkata,1807,3,5,6,3,15,13,2,21
Kerala Blast,1807,4,6,3,5,12,14,-2,21
NorthEast Un,1807,5,5,3,6,15,11,4,18
FC Goa,1807,6,5,2,7,12,17,-5,17
FC Pune City,1807,7,4,3,7,12,17,-5,15
Chennaiyin,1807,8,3,6,5,14,20,-6,15
Mumbai City,1808,1,7,4,3,17,8,9,25
FC Pune City,1808,2,6,3,5,18,17,1,21
Delhi Dynamo,1808,3,5,5,4,23,17,6,20
FC Goa,1808,4,6,2,6,13,14,-1,20
NorthEast Un,1808,5,5,3,6,13,13,0,18
Kolkata,1808,6,4,6,4,17,18,-1,18
Chennaiyin,1808,7,3,6,5,15,21,-6,15
Kerala Blast,1808,8,4,3,7,10,18,-8,15
Delhi Dynamo,1809,1,6,5,3,25,17,8,23
Mumbai City,1809,2,6,4,4,16,10,6,22
Kolkata,1809,3,5,7,2,18,14,4,22
NorthEast Un,1809,4,6,2,6,15,11,4,20
FC Pune City,1809,5,5,3,6,14,16,-2,18
Chennaiyin,1809,6,4,5,5,14,18,-4,17
FC Goa,1809,7,4,3,7,10,16,-6,15
Kerala Blast,1809,8,4,3,7,11,21,-10,15
Mumbai City,1810,1,7,4,3,19,8,11,25
Kolkata,1810,2,5,6,3,17,13,4,21
Delhi Dynamo,1810,3,5,5,4,23,18,5,20
FC Goa,1810,4,6,2,6,13,14,-1,20
Kerala Blast,1810,5,5,4,5,13,17,-4,19
NorthEast Un,1810,6,5,2,7,12,15,-3,17
FC Pune City,1810,7,4,4,6,13,17,-4,16
Chennaiyin,1810,8,3,5,6,14,22,-8,14
Mumbai City,1811,1,7,4,3,18,8,10,25
Delhi Dynamo,1811,2,5,5,4,25,19,6,20
Chennaiyin,1811,3,5,5,4,20,17,3,20
Kerala Blast,1811,4,5,5,4,14,17,-3,20
FC Pune City,1811,5,5,4,5,16,17,-1,19
Kolkata,1811,6,4,6,4,15,14,1,18
NorthEast Un,1811,7,5,3,6,12,13,-1,18
FC Goa,1811,8,3,2,9,9,24,-15,11
Mumbai City,1812,1,6,5,3,17,9,8,23
Chennaiyin,1812,2,5,5,4,18,19,-1,20
Delhi Dynamo,1812,3,4,7,3,24,18,6,19
Kolkata,1812,4,4,7,3,18,17,1,19
FC Pune City,1812,5,5,4,5,14,15,-1,19
Kerala Blast,1812,6,5,3,6,12,17,-5,18
NorthEast Un,1812,7,5,2,7,13,15,-2,17
FC Goa,1812,8,4,3,7,12,18,-6,15
Mumbai City,1813,1,6,5,3,17,9,8,23
Kolkata,1813,2,4,8,2,17,15,2,20
Chennaiyin,1813,3,5,5,4,18,18,0,20
Delhi Dynamo,1813,4,4,7,3,23,17,6,19
FC Pune City,1813,5,5,4,5,19,16,3,19
NorthEast Un,1813,6,5,3,6,13,14,-1,18
Kerala Blast,1813,7,4,4,6,10,20,-10,16
FC Goa,1813,8,3,4,7,9,17,-8,13
Delhi Dynamo,1814,1,7,5,2,29,16,13,26
Mumbai City,1814,2,6,4,4,16,11,5,22
Kolkata,1814,3,5,6,3,19,13,6,21
Kerala Blast,1814,4,5,4,5,12,16,-4,19
NorthEast Un,1814,5,5,3,6,10,11,-1,18
Chennaiyin,1814,6,4,6,4,14,17,-3,18
FC Pune City,1814,7,4,4,6,14,20,-6,16
FC Goa,1814,8,3,2,9,10,20,-10,11
Mumbai City,1815,1,6,4,4,18,12,6,22
Kerala Blast,1815,2,6,4,4,12,13,-1,22
Delhi Dynamo,1815,3,5,6,3,26,18,8,21
Kolkata,1815,4,5,6,3,16,14,2,21
Chennaiyin,1815,5,4,5,5,16,20,-4,17
FC Goa,1815,6,5,2,7,11,16,-5,17
FC Pune City,1815,7,4,4,6,12,15,-3,16
NorthEast Un,1815,8,4,3,7,12,15,-3,15
Mumbai City,1816,1,7,4,3,17,8,9,25
Delhi Dynamo,1816,2,5,6,3,24,16,8,21
Kolkata,1816,3,4,8,2,17,14,3,20
NorthEast Un,1816,4,6,2,6,13,12,1,20
FC Pune City,1816,5,4,5,5,13,15,-2,17
Kerala Blast,1816,6,4,5,5,11,16,-5,17
Chennaiyin,1816,7,3,6,5,14,20,-6,15
FC Goa,1816,8,3,4,7,10,18,-8,13
Delhi Dynamo,1817,1,6,6,2,25,16,9,24
Mumbai City,1817,2,6,5,3,17,9,8,23
Kolkata,1817,3,5,7,2,20,15,5,22
Chennaiyin,1817,4,5,5,4,15,17,-2,20
FC Pune City,1817,5,5,3,6,14,16,-2,18
Kerala Blast,1817,6,5,3,6,10,17,-7,18
NorthEast Un,1817,7,4,2,8,9,12,-3,14
FC Goa,1817,8,3,3,8,12,20,-8,12
Mumbai City,1818,1,7,4,3,18,9,9,25
Delhi Dynamo,1818,2,5,6,3,26,19,7,21
Kolkata,1818,3,5,6,3,20,17,3,21
NorthEast Un,1818,4,5,4,5,13,12,1,19
Kerala Blast,1818,5,5,4,5,16,19,-3,19
Chennaiyin,1818,6,4,6,4,18,20,-2,18
FC Pune City,1818,7,4,4,6,16,21,-5,16
FC Goa,1818,8,3,2,9,13,23,-10,11
Mumbai City,1819,1,6,4,4,17,10,7,22
Delhi Dynamo,1819,2,5,6,3,25,19,6,21
Kolkata,1819,3,5,6,3,18,15,3,21
Kerala Blast,1819,4,6,3,5,14,17,-3,21
FC Goa,1819,5,5,3,6,12,15,-3,18
NorthEast Un,1819,6,5,2,7,15,16,-1,17
Chennaiyin,1819,7,4,5,5,16,21,-5,17
FC Pune City,1819,8,4,3,7,13,17,-4,15
Mumbai City,1820,1,6,5,3,17,9,8,23
Delhi Dynamo,1820,2,5,7,2,27,16,11,22
Kolkata,1820,3,4,7,3,15,13,2,19
FC Pune City,1820,4,5,3,6,15,16,-1,18
Chennaiyin,1820,5,4,6,4,16,18,-2,18
Kerala Blast,1820,6,4,5,5,10,17,-7,17
NorthEast Un,1820,7,4,4,6,12,14,-2,16
FC Goa,1820,8,4,3,7,9,18,-9,15
Mumbai City,1821,1,6,5,3,18,10,8,23
Delhi Dynamo,1821,2,5,7,2,25,17,8,22
Kerala Blast,1821,3,6,3,5,14,16,-2,21
Kolkata,1821,4,4,7,3,17,15,2,19
FC Goa,1821,5,5,3,6,13,16,-3,18
FC Pune City,1821,6,4,4,6,13,18,-5,16
NorthEast Un,1821,7,4,3,7,10,12,-2,15
Chennaiyin,1821,8,3,6,5,13,19,-6,15
Mumbai City,1822,1,7,4,3,19,8,11,25
Kerala Blast,1822,2,6,3,5,14,18,-4,21
Delhi Dynamo,1822,3,5,5,4,23,19,4,20
FC Pune City,1822,4,5,4,5,16,16,0,19
FC Goa,1822,5,5,3,6,11,15,-4,18
NorthEast Un,1822,6,5,2,7,12,13,-1,17
Kolkata,1822,7,3,7,4,13,14,-1,16
Chennaiyin,1822,8,3,6,5,14,19,-5,15
Delhi Dynamo,1823,1,6,6,2,29,19,10,24
Mumbai City,1823,2,6,4,4,17,10,7,22
Kolkata,1823,3,5,6,3,18,14,4,21
Kerala Blast,1823,4,5,4,5,12,15,-3,19
FC Pune City,1823,5,5,3,6,14,17,-3,18
Chennaiyin,1823,6,4,5,5,14,18,-4,17
NorthEast Un,1823,7,4,4,6,13,14,-1,16
FC Goa,1823,8,4,2,8,10,20,-10,14
Delhi Dynamo,1824,1,6,6,2,26,15,11,24
Mumbai City,1824,2,6,4,4,16,11,5,22
Kerala Blast,1824,3,6,4,4,15,15,0,22
Kolkata,1824,4,4,6,4,15,15,0,18
FC Goa,1824,5,5,2,7,11,16,-5,17
FC Pune City,1824,6,4,4,6,13,16,-3,16
NorthEast Un,1824,7,4,4,6,9,12,-3,16
Chennaiyin,1824,8,3,6,5,13,18,-5,15
Mumbai City,1825,1,6,5,3,17,9,8,23
Delhi Dynamo,1825,2,5,7,2,25,17,8,22
Kolkata,1825,3,5,7,2,19,15,4,22
FC Pune City,1825,4,5,4,5,16,17,-1,19
NorthEast Un,1825,5,5,3,6,12,13,-1,18
Kerala Blast,1825,6,5,3,6,13,17,-4,18
Chennaiyin,1825,7,4,5,5,16,20,-4,17
FC Goa,1825,8,3,2,9,10,20,-10,11
Mumbai City,1826,1,7,4,3,18,8,10,25
Kolkata,1826,2,5,7,2,18,13,5,22
Kerala Blast,1826,3,6,3,5,17,15,2,21
NorthEast Un,1826,4,6,2,6,15,16,-1,20
FC Goa,1826,5,5,3,6,14,16,-2,18
Delhi Dynamo,1826,6,4,5,5,22,19,3,17
FC Pune City,1826,7,4,3,7,12,19,-7,15
Chennaiyin,1826,8,3,5,6,15,25,-10,14
Mumbai City,1827,1,6,5,3,17,9,8,23
NorthEast Un,1827,2,6,3,5,14,12,2,21
FC Goa,1827,3,6,2,6,15,16,-1,20
Delhi Dynamo,1827,4,4,7,3,23,17,6,19
Kolkata,1827,5,4,7,3,17,17,0,19
Kerala Blast,1827,6,5,3,6,14,17,-3,18
FC Pune City,1827,7,4,4,6,14,19,-5,16
Chennaiyin,1827,8,3,5,6,14,21,-7,14
Mumbai City,1828,1,6,5,3,17,9,8,23
Kerala Blast,1828,2,6,4,4,12,14,-2,22
Delhi Dynamo,1828,3,5,6,3,24,18,6,21
Kolkata,1828,4,4,6,4,14,14,0,18
NorthEast Un,1828,5,5,3,6,12,12,0,18
Chennaiyin,1828,6,4,5,5,15,18,-3,17
FC Goa,1828,7,5,2,7,11,16,-5,17
FC Pune City,1828,8,4,3,7,12,16,-4,15
Mumbai City,1829,1,7,4,3,18,9,9,25
Delhi Dynamo,1829,2,5,6,3,25,17,8,21
NorthEast Un,1829,3,5,4,5,12,11,1,19
FC Pune City,1829,4,5,4,5,15,16,-1,19
Kolkata,1829,5,4,6,4,16,16,0,18
Chennaiyin,1829,6,4,5,5,16,18,-2,17
Kerala Blast,1829,7,4,5,5,12,17,-5,17
FC Goa,1829,8,4,2,8,9,19,-10,14
Delhi Dynamo,1830,1,6,5,3,26,19,7,23
Mumbai City,1830,2,6,4,4,17,10,7,22
Kolkata,1830,3,5,6,3,17,14,3,21
Chennaiyin,1830,4,4,6,4,16,18,-2,18
FC Goa,1830,5,5,3,6,13,15,-2,18
Kerala Blast,1830,6,5,3,6,10,17,-7,18
NorthEast Un,1830,7,5,2,7,12,14,-2,17
FC Pune City,1830,8,4,3,7,13,17,-4,15
Mumbai City,1831,1,7,4,3,19,9,10,25
Kerala Blast,1831,2,6,4,4,16,15,1,22
Delhi Dynamo,1831,3,5,6,3,26,19,7,21
Kolkata,1831,4,4,8,2,16,14,2,20
NorthEast Un,1831,5,5,3,6,14,14,0,18
FC Pune City,1831,6,4,3,7,12,18,-6,15
FC Goa,1831,7,4,3,7,11,18,-7,15
Chennaiyin,1831,8,3,5,6,14,21,-7,14
Mumbai City,1832,1,6,5,3,17,9,8,23
FC Pune City,1832,2,6,3,5,17,14,3,21
Kerala Blast,1832,3,6,3,5,14,17,-3,21
NorthEast Un,1832,4,6,2,6,15,11,4,20
Delhi Dynamo,1832,5,4,7,3,25,21,4,19
Kolkata,1832,6,4,6,4,16,19,-3,18
FC Goa,1832,7,4,3,7,13,19,-6,15
Chennaiyin,1832,8,3,5,6,14,21,-7,14
Mumbai City,1833,1,7,4,3,18,8,10,25
Kolkata,1833,2,4,8,2,16,13,3,20
Kerala Blast,1833,3,5,5,4,14,16,-2,20
Delhi Dynamo,1833,4,4,6,4,24,20,4,18
FC Pune City,1833,5,4,5,5,14,16,-2,17
NorthEast Un,1833,6,5,2,7,12,14,-2,17
Chennaiyin,1833,7,4,5,5,14,19,-5,17
FC Goa,1833,8,4,3,7,13,19,-6,15
Mumbai City,1834,1,7,4,3,20,8,12,25
NorthEast Un,1834,2,6,3,5,14,12,2,21
Delhi Dynamo,1834,3,5,5,4,24,20,4,20
Kolkata,1834,4,4,7,3,15,14,1,19
Kerala Blast,1834,5,5,4,5,13,15,-2,19
FC Pune City,1834,6,5,3,6,14,18,-4,18
Chennaiyin,1834,7,3,6,5,16,21,-5,15
FC Goa,1834,8,3,4,7,10,18,-8,13
Mumbai City,1835,1,7,4,3,18,9,9,25
Kolkata,1835,2,4,8,2,16,14,2,20
NorthEast Un,1835,3,5,4,5,13,11,2,19
FC Pune City,1835,4,5,3,6,14,16,-2,18
FC Goa,1835,5,5,3,6,12,16,-4,18
Delhi Dynamo,1835,6,4,5,5,23,20,3,17
Kerala Blast,1835,7,4,5,5,10,15,-5,17
Chennaiyin,1835,8,3,6,5,14,19,-5,15
Mumbai City,1836,1,7,4,3,18,8,10,25
Kerala Blast,1836,2,7,3,4,16,13,3,24
Kolkata,1836,3,5,6,3,17,15,2,21
Delhi Dynamo,1836,4,5,5,4,22,18,4,20
Chennaiyin,1836,5,5,5,4,16,18,-2,20
NorthEast Un,1836,6,5,2,7,11,11,0,17
FC Pune City,1836,7,4,3,7,12,20,-8,15
FC Goa,1836,8,3,2,9,10,19,-9,11
Mumbai City,1837,1,6,5,3,17,9,8,23
Kolkata,1837,2,5,7,2,16,13,3,22
Delhi Dynamo,1837,3,5,6,3,27,21,6,21
NorthEast Un,1837,4,6,2,6,17,13,4,20
Chennaiyin,1837,5,5,5,4,17,19,-2,20
Kerala Blast,1837,6,5,3,6,11,17,-6,18
FC Pune City,1837,7,4,4,6,12,16,-4,16
FC Goa,1837,8,3,2,9,12,21,-9,11
Mumbai City,1838,1,7,4,3,18,8,10,25
Delhi Dynamo,1838,2,5,6,3,26,19,7,21
FC Pune City,1838,3,6,3,5,14,14,0,21
Chennaiyin,1838,4,5,5,4,16,17,-1,20
Kerala Blast,1838,5,4,5,5,10,15,-5,17
Kolkata,1838,6,3,7,4,15,16,-1,16
NorthEast Un,1838,7,4,3,7,12,16,-4,15
FC Goa,1838,8,4,3,7,10,16,-6,15
Delhi Dynamo,1839,1,6,5,3,25,16,9,23
Mumbai City,1839,2,6,4,4,17,10,7,22
Kolkata,1839,3,4,8,2,18,15,3,20
FC Pune City,1839,4,5,4,5,15,16,-1,19
Kerala Blast,1839,5,5,4,5,14,17,-3,19
NorthEast Un,1839,6,5,3,6,12,13,-1,18
Chennaiyin,1839,7,4,6,4,16,19,-3,18
FC Goa,1839,8,3,2,9,10,21,-11,11
Kerala Blast,1840,1,7,3,4,15,14,1,24
Mumbai City,1840,2,6,5,3,17,9,8,23
Delhi Dynamo,1840,3,5,7,2,25,16,9,22
Chennaiyin,1840,4,5,5,4,15,17,-2,20
FC Pune City,1840,5,5,3,6,14,18,-4,18
Kolkata,1840,6,3,7,4,14,15,-1,16
NorthEast Un,1840,7,4,2,8,9,13,-4,14
FC Goa,1840,8,3,4,7,10,17,-7,13
Mumbai City,1841,1,7,4,3,18,8,10,25
Kerala Blast,1841,2,6,4,4,15,15,0,22
Delhi Dynamo,1841,3,5,6,3,23,17,6,21
NorthEast Un,1841,4,5,3,6,13,11,2,18
Chennaiyin,1841,5,4,5,5,17,21,-4,17
Kolkata,1841,6,3,7,4,17,18,-1,16
FC Pune City,1841,7,4,4,6,14,19,-5,16
FC Goa,1841,8,4,3,7,12,20,-8,15
Mumbai City,1842,1,7,4,3,18,8,10,25
Kolkata,1842,2,6,6,2,17,12,5,24
Delhi Dynamo,1842,3,5,6,3,26,18,8,21
Kerala Blast,1842,4,5,4,5,13,16,-3,19
FC Pune City,1842,5,4,4,6,13,16,-3,16
Chennaiyin,1842,6,3,7,4,15,19,-4,16
NorthEast Un,1842,7,4,3,7,11,17,-6,15
FC Goa,1842,8,3,4,7,10,17,-7,13
Mumbai City,1843,1,7,4,3,20,10,10,25
NorthEast Un,1843,2,6,3,5,14,12,2,21
Delhi Dynamo,1843,3,5,5,4,26,21,5,20
Kolkata,1843,4,4,8,2,16,14,2,20
FC Pune City,1843,5,5,4,5,15,16,-1,19
Chennaiyin,1843,6,4,5,5,15,19,-4,17
Kerala Blast,1843,7,4,5,5,12,17,-5,17
FC Goa,1843,8,3,2,9,9,18,-9,11
Mumbai City,1844,1,6,5,3,16,8,8,23
Delhi Dynamo,1844,2,5,6,3,23,16,7,21
Kolkata,1844,3,4,7,3,18,16,2,19
NorthEast Un,1844,4,5,4,5,13,12,1,19
Kerala Blast,1844,5,5,4,5,12,16,-4,19
FC Pune City,1844,6,5,3,6,13,16,-3,18
Chennaiyin,1844,7,3,6,5,14,19,-5,15
FC Goa,1844,8,4,3,7,11,17,-6,15
Mumbai City,1845,1,6,5,3,17,9,8,23
Delhi Dynamo,1845,2,5,7,2,25,16,9,22
Kolkata,1845,3,4,7,3,17,15,2,19
NorthEast Un,1845,4,5,3,6,11,12,-1,18
FC Goa,1845,5,5,3,6,11,15,-4,18
Kerala Blast,1845,6,5,3,6,12,18,-6,18
FC Pune City,1845,7,4,4,6,15,18,-3,16
Chennaiyin,1845,8,3,6,5,13,18,-5,15
Mumbai City,1846,1,7,4,3,17,8,9,25
Kerala Blast,1846,2,6,4,4,14,16,-2,22
Kolkata,1846,3,5,6,3,17,14,3,21
NorthEast Un,1846,4,5,3,6,15,12,3,18
Delhi Dynamo,1846,5,4,5,5,23,22,1,17
FC Goa,1846,6,5,2,7,12,18,-6,17
FC Pune City,1846,7,4,4,6,13,16,-3,16
Chennaiyin,1846,8,3,6,5,14,19,-5,15
Mumbai City,1847,1,7,4,3,17,8,9,25
Kerala Blast,1847,2,6,4,4,12,13,-1,22
Kolkata,1847,3,5,6,3,16,14,2,21
Delhi Dynamo,1847,4,4,7,3,22,16,6,19
Chennaiyin,1847,5,4,6,4,17,18,-1,18
FC Pune City,1847,6,4,4,6,13,16,-3,16
NorthEast Un,1847,7,4,3,7,9,14,-5,15
FC Goa,1847,8,3,4,7,10,17,-7,13
Delhi Dynamo,1848,1,6,5,3,27,17,10,23
Mumbai City,1848,2,6,4,4,17,10,7,22
NorthEast Un,1848,3,6,3,5,12,10,2,21
Kolkata,1848,4,4,7,3,18,18,0,19
FC Pune City,1848,5,5,4,5,16,16,0,19
Kerala Blast,1848,6,5,4,5,12,16,-4,19
Chennaiyin,1848,7,3,5,6,14,20,-6,14
FC Goa,1848,8,4,2,8,11,20,-9,14
Delhi Dynamo,1849,1,7,5,2,29,15,14,26
Mumbai City,1849,2,6,4,4,16,12,4,22
FC Pune City,1849,3,6,3,5,20,19,1,21
Kerala Blast,1849,4,6,3,5,16,17,-1,21
Chennaiyin,1849,5,4,5,5,15,18,-3,17
Kolkata,1849,6,3,7,4,15,18,-3,16
FC Goa,1849,7,4,3,7,9,15,-6,15
NorthEast Un,1849,8,4,2,8,10,16,-6,14
Mumbai City,1850,1,7,4,3,20,11,9,25
Delhi Dynamo,1850,2,5,5,4,26,19,7,20
NorthEast Un,1850,3,6,2,6,12,10,2,20
Kerala Blast,1850,4,5,4,5,11,16,-5,19
FC Pune City,1850,5,5,3,6,16,15,1,18
FC Goa,1850,6,5,2,7,12,16,-4,17
Chennaiyin,1850,7,4,5,5,14,20,-6,17
Kolkata,1850,8,3,7,4,14,18,-4,16
Mumbai City,1851,1,6,5,3,16,8,8,23
FC Pune City,1851,2,6,3,5,16,16,0,21
Delhi Dynamo,1851,3,4,7,3,24,19,5,19
FC Goa,1851,4,5,3,6,19,17,2,18
NorthEast Un,1851,5,4,5,5,11,11,0,17
Kerala Blast,1851,6,4,5,5,12,17,-5,17
Chennaiyin,1851,7,3,7,4,15,19,-4,16
Kolkata,1851,8,3,7,4,14,20,-6,16
Delhi Dynamo,1852,1,6,5,3,27,16,11,23
Mumbai City,1852,2,6,4,4,16,9,7,22
Kolkata,1852,3,4,8,2,15,13,2,20
NorthEast Un,1852,4,6,2,6,14,13,1,20
FC Pune City,1852,5,5,3,6,15,17,-2,18
Chennaiyin,1852,6,4,5,5,15,20,-5,17
Kerala Blast,1852,7,4,4,6,11,17,-6,16
FC Goa,1852,8,4,3,7,10,18,-8,15
Mumbai City,1853,1,7,4,3,19,9,10,25
Delhi Dynamo,1853,2,5,6,3,25,18,7,21
NorthEast Un,1853,3,6,3,5,13,11,2,21
Kolkata,1853,4,4,8,2,17,14,3,20
Kerala Blast,1853,5,5,3,6,12,17,-5,18
Chennaiyin,1853,6,4,5,5,14,18,-4,17
FC Pune City,1853,7,4,4,6,14,18,-4,16
FC Goa,1853,8,3,3,8,8,17,-9,12
Mumbai City,1854,1,6,5,3,17,9,8,23
Delhi Dynamo,1854,2,5,6,3,25,17,8,21
Kolkata,1854,3,5,6,3,18,14,4,21
Kerala Blast,1854,4,6,3,5,12,16,-4,21
NorthEast Un,1854,5,5,3,6,12,12,0,18
FC Pune City,1854,6,5,3,6,14,16,-2,18
Chennaiyin,1854,7,3,6,5,13,22,-9,15
FC Goa,1854,8,4,2,8,13,18,-5,14
Mumbai City,1855,1,7,4,3,18,8,10,25
Kolkata,1855,2,5,7,2,21,18,3,22
Delhi Dynamo,1855,3,5,6,3,27,21,6,21
Kerala Blast,1855,4,5,3,6,13,18,-5,18
NorthEast Un,1855,5,5,2,7,13,14,-1,17
Chennaiyin,1855,6,4,5,5,14,18,-4,17
FC Pune City,1855,7,4,4,6,16,19,-3,16
FC Goa,1855,8,4,3,7,14,20,-6,15
Kolkata,1856,1,6,6,2,19,13,6,24
Mumbai City,1856,2,6,5,3,17,9,8,23
Delhi Dynamo,1856,3,5,6,3,23,16,7,21
Kerala Blast,1856,4,5,4,5,13,17,-4,19
NorthEast Un,1856,5,5,2,7,13,12,1,17
FC Goa,1856,6,5,2,7,13,17,-4,17
FC Pune City,1856,7,4,4,6,14,18,-4,16
Chennaiyin,1856,8,3,5,6,13,23,-10,14
Delhi Dynamo,1857,1,6,6,2,29,19,10,24
Mumbai City,1857,2,6,5,3,18,10,8,23
Kerala Blast,1857,3,5,4,5,12,17,-5,19
NorthEast Un,1857,4,5,3,6,14,13,1,18
FC Pune City,1857,5,5,3,6,13,15,-2,18
Kolkata,1857,6,3,8,3,15,15,0,17
Chennaiyin,1857,7,3,6,5,13,18,-5,15
FC Goa,1857,8,4,3,7,11,18,-7,15
Mumbai City,1858,1,7,4,3,19,10,9,25
Delhi Dynamo,1858,2,5,6,3,28,21,7,21
Kolkata,1858,3,5,6,3,17,14,3,21
Chennaiyin,1858,4,4,6,4,14,17,-3,18
NorthEast Un,1858,5,5,2,7,11,12,-1,17
FC Pune City,1858,6,4,4,6,12,15,-3,16
FC Goa,1858,7,4,4,6,13,18,-5,16
Kerala Blast,1858,8,4,4,6,9,16,-7,16
Mumbai City,1859,1,7,4,3,17,8,9,25
Delhi Dynamo,1859,2,6,5,3,28,17,11,23
Kolkata,1859,3,5,6,3,17,15,2,21
FC Pune City,1859,4,5,4,5,15,16,-1,19
Chennaiyin,1859,5,4,6,4,15,18,-3,18
Kerala Blast,1859,6,4,5,5,12,17,-5,17
NorthEast Un,1859,7,4,4,6,12,14,-2,16
FC Goa,1859,8,3,2,9,9,20,-11,11
Mumbai City,1860,1,6,5,3,18,10,8,23
Kolkata,1860,2,4,7,3,19,17,2,19
FC Pune City,1860,3,5,4,5,14,15,-1,19
Delhi Dynamo,1860,4,4,6,4,25,21,4,18
NorthEast Un,1860,5,5,3,6,13,14,-1,18
Chennaiyin,1860,6,4,6,4,17,19,-2,18
FC Goa,1860,7,5,3,6,16,18,-2,18
Kerala Blast,1860,8,4,4,6,10,18,-8,16
Delhi Dynamo,1861,1,6,6,2,28,17,11,24
Mumbai City,1861,2,6,5,3,19,11,8,23
Kerala Blast,1861,3,5,4,5,13,16,-3,19
FC Pune City,1861,4,5,3,6,15,17,-2,18
NorthEast Un,1861,5,5,2,7,10,12,-2,17
FC Goa,1861,6,5,2,7,12,16,-4,17
Chennaiyin,1861,7,4,5,5,14,19,-5,17
Kolkata,1861,8,3,7,4,14,17,-3,16
Delhi Dynamo,1862,1,6,6,2,25,16,9,24
Kolkata,1862,2,6,6,2,21,15,6,24
Mumbai City,1862,3,6,5,3,17,9,8,23
NorthEast Un,1862,4,5,3,6,12,11,1,18
FC Pune City,1862,5,5,3,6,15,16,-1,18
Chennaiyin,1862,6,4,5,5,15,20,-5,17
Kerala Blast,1862,7,4,4,6,10,17,-7,16
FC Goa,1862,8,3,2,9,10,21,-11,11
Delhi Dynamo,1863,1,6,6,2,25,15,10,24
Mumbai City,1863,2,6,5,3,17,9,8,23
Kolkata,1863,3,5,7,2,19,15,4,22
Kerala Blast,1863,4,6,3,5,12,15,-3,21
Chennaiyin,1863,5,4,6,4,14,17,-3,18
FC Pune City,1863,6,4,4,6,15,19,-4,16
NorthEast Un,1863,7,4,2,8,9,12,-3,14
FC Goa,1863,8,3,3,8,8,17,-9,12
Mumbai City,1864,1,7,4,3,18,8,10,25
Kolkata,1864,2,5,7,2,19,14,5,22
Kerala Blast,1864,3,6,3,5,15,19,-4,21
Delhi Dynamo,1864,4,5,5,4,22,17,5,20
NorthEast Un,1864,5,5,3,6,11,12,-1,18
Chennaiyin,1864,6,4,6,4,16,19,-3,18
FC Pune City,1864,7,4,4,6,13,16,-3,16
FC Goa,1864,8,3,2,9,9,18,-9,11
Delhi Dynamo,1865,1,6,5,3,24,16,8,23
Mumbai City,1865,2,6,4,4,17,10,7,22
NorthEast Un,1865,3,6,3,5,16,13,3,21
Kolkata,1865,4,4,8,2,17,15,2,20
Kerala Blast,1865,5,5,5,4,14,17,-3,20
Chennaiyin,1865,6,4,5,5,16,21,-5,17
FC Pune City,1865,7,4,3,7,13,17,-4,15
FC Goa,1865,8,3,3,8,8,16,-8,12
Mumbai City,1866,1,6,4,4,18,15,3,22
Delhi Dynamo,1866,2,5,6,3,28,17,11,21
FC Goa,1866,3,6,2,6,13,16,-3,20
Kolkata,1866,4,4,7,3,16,14,2,19
FC Pune City,1866,5,5,4,5,13,14,-1,19
Kerala Blast,1866,6,5,3,6,12,18,-6,18
Chennaiyin,1866,7,4,5,5,17,20,-3,17
NorthEast Un,1866,8,4,3,7,12,15,-3,15
Delhi Dynamo,1867,1,6,5,3,27,17,10,23
Mumbai City,1867,2,6,4,4,17,11,6,22
Kolkata,1867,3,4,8,2,15,13,2,20
Kerala Blast,1867,4,5,4,5,10,14,-4,19
NorthEast Un,1867,5,5,3,6,12,12,0,18
FC Pune City,1867,6,5,3,6,13,15,-2,18
Chennaiyin,1867,7,3,6,5,14,19,-5,15
FC Goa,1867,8,4,3,7,10,17,-7,15
Mumbai City,1868,1,7,4,3,18,8,10,25
Kerala Blast,1868,2,6,4,4,14,15,-1,22
Delhi Dynamo,1868,3,5,5,4,23,18,5,20
Kolkata,1868,4,4,8,2,16,13,3,20
NorthEast Un,1868,5,6,2,6,13,13,0,20
FC Pune City,1868,6,4,4,6,12,15,-3,16
Chennaiyin,1868,7,3,5,6,13,19,-6,14
FC Goa,1868,8,4,2,8,9,17,-8,14
Delhi Dynamo,1869,1,6,5,3,27,18,9,23
Mumbai City,1869,2,6,4,4,16,9,7,22
Kolkata,1869,3,4,7,3,17,18,-1,19
NorthEast Un,1869,4,5,3,6,13,13,0,18
FC Pune City,1869,5,5,3,6,15,17,-2,18
Kerala Blast,1869,6,5,3,6,14,18,-4,18
Chennaiyin,1869,7,3,7,4,13,17,-4,16
FC Goa,1869,8,4,4,6,11,16,-5,16
Delhi Dynamo,1870,1,6,5,3,26,17,9,23
Mumbai City,1870,2,6,4,4,16,9,7,22
Kerala Blast,1870,3,5,4,5,15,20,-5,19
NorthEast Un,1870,4,5,3,6,14,14,0,18
Kolkata,1870,5,4,6,4,18,19,-1,18
FC Pune City,1870,6,5,3,6,15,16,-1,18
Chennaiyin,1870,7,4,5,5,16,19,-3,17
FC Goa,1870,8,5,2,7,13,19,-6,17
Delhi Dynamo,1871,1,6,6,2,26,17,9,24
Mumbai City,1871,2,6,4,4,16,9,7,22
Kolkata,1871,3,5,6,3,17,13,4,21
NorthEast Un,1871,4,6,2,6,13,11,2,20
FC Pune City,1871,5,5,3,6,14,16,-2,18
Kerala Blast,1871,6,5,3,6,11,19,-8,18
FC Goa,1871,7,4,3,7,11,17,-6,15
Chennaiyin,1871,8,3,5,6,13,19,-6,14
Kolkata,1872,1,6,6,2,20,12,8,24
Mumbai City,1872,2,6,5,3,17,9,8,23
Delhi Dynamo,1872,3,5,7,2,26,16,10,22
Kerala Blast,1872,4,6,3,5,12,14,-2,21
NorthEast Un,1872,5,5,3,6,12,12,0,18
FC Pune City,1872,6,4,3,7,12,20,-8,15
Chennaiyin,1872,7,3,5,6,16,22,-6,14
FC Goa,1872,8,4,2,8,11,21,-10,14
Mumbai City,1873,1,7,4,3,18,8,10,25
NorthEast Un,1873,2,6,3,5,15,10,5,21
Kerala Blast,1873,3,6,3,5,15,21,-6,21
Delhi Dynamo,1873,4,5,5,4,24,18,6,20
Kolkata,1873,5,4,6,4,18,20,-2,18
FC Goa,1873,6,5,2,7,15,18,-3,17
Chennaiyin,1873,7,3,6,5,15,20,-5,15
FC Pune City,1873,8,4,3,7,13,18,-5,15
Mumbai City,1874,1,7,4,3,19,8,11,25
Delhi Dynamo,1874,2,6,5,3,27,20,7,23
Kolkata,1874,3,5,7,2,21,16,5,22
Chennaiyin,1874,4,5,5,4,21,19,2,20
FC Pune City,1874,5,5,3,6,15,18,-3,18
NorthEast Un,1874,6,5,2,7,14,16,-2,17
Kerala Blast,1874,7,4,3,7,9,19,-10,15
FC Goa,1874,8,3,3,8,13,23,-10,12
Mumbai City,1875,1,7,4,3,19,8,11,25
Delhi Dynamo,1875,2,6,5,3,25,17,8,23
NorthEast Un,1875,3,6,2,6,11,10,1,20
Kolkata,1875,4,4,7,3,17,14,3,19
Kerala Blast,1875,5,5,4,5,12,16,-4,19
FC Pune City,1875,6,4,5,5,15,17,-2,17
Chennaiyin,1875,7,3,5,6,14,21,-7,14
FC Goa,1875,8,4,2,8,11,21,-10,14
Mumbai City,1876,1,6,5,3,18,10,8,23
Kerala Blast,1876,2,6,4,4,15,16,-1,22
Delhi Dynamo,1876,3,4,7,3,23,18,5,19
FC Pune City,1876,4,5,3,6,15,16,-1,18
FC Goa,1876,5,5,3,6,10,14,-4,18
NorthEast Un,1876,6,5,2,7,11,12,-1,17
Chennaiyin,1876,7,4,5,5,14,18,-4,17
Kolkata,1876,8,3,7,4,15,17,-2,16
Delhi Dynamo,1877,1,6,5,3,28,18,10,23
NorthEast Un,1877,2,7,2,5,15,12,3,23
Mumbai City,1877,3,6,4,4,16,10,6,22
Kolkata,1877,4,4,7,3,18,14,4,19
FC Pune City,1877,5,5,4,5,13,14,-1,19
Chennaiyin,1877,6,4,5,5,16,19,-3,17
Kerala Blast,1877,7,4,3,7,10,20,-10,15
FC Goa,1877,8,4,2,8,12,21,-9,14
Delhi Dynamo,1878,1,6,6,2,25,15,10,24
Mumbai City,1878,2,6,4,4,16,9,7,22
FC Pune City,1878,3,6,3,5,17,14,3,21
NorthEast Un,1878,4,5,3,6,14,14,0,18
FC Goa,1878,5,5,3,6,15,16,-1,18
Kolkata,1878,6,4,6,4,15,18,-3,18
Chennaiyin,1878,7,3,6,5,15,22,-7,15
Kerala Blast,1878,8,4,3,7,10,19,-9,15
Mumbai City,1879,1,6,5,3,17,9,8,23
Delhi Dynamo,1879,2,4,8,2,25,18,7,20
Kerala Blast,1879,3,5,5,4,13,16,-3,20
NorthEast Un,1879,4,5,4,5,12,11,1,19
Kolkata,1879,5,4,7,3,16,18,-2,19
FC Pune City,1879,6,5,3,6,17,16,1,18
Chennaiyin,1879,7,4,5,5,16,20,-4,17
FC Goa,1879,8,3,3,8,11,19,-8,12
Mumbai City,1880,1,7,4,3,20,9,11,25
Delhi Dynamo,1880,2,6,5,3,26,18,8,23
Kolkata,1880,3,4,7,3,16,13,3,19
Kerala Blast,1880,4,5,4,5,11,16,-5,19
Chennaiyin,1880,5,4,6,4,16,18,-2,18
NorthEast Un,1880,6,5,2,7,11,13,-2,17
FC Pune City,1880,7,4,4,6,13,18,-5,16
FC Goa,1880,8,3,4,7,9,17,-8,13
Mumbai City,1881,1,7,4,3,19,8,11,25
Kolkata,1881,2,6,6,2,19,13,6,24
Delhi Dynamo,1881,3,5,5,4,24,20,4,20
NorthEast Un,1881,4,5,4,5,11,10,1,19
Kerala Blast,1881,5,5,4,5,10,14,-4,19
Chennaiyin,1881,6,4,6,4,15,17,-2,18
FC Pune City,1881,7,4,3,7,13,19,-6,15
FC Goa,1881,8,3,2,9,9,19,-10,11
Mumbai City,1882,1,6,5,3,18,10,8,23
FC Pune City,1882,2,6,3,5,15,14,1,21
Delhi Dynamo,1882,3,4,7,3,26,21,5,19
NorthEast Un,1882,4,5,4,5,13,12,1,19
Kolkata,1882,5,4,6,4,15,16,-1,18
Chennaiyin,1882,6,4,5,5,14,18,-4,17
FC Goa,1882,7,5,2,7,12,16,-4,17
Kerala Blast,1882,8,4,4,6,9,15,-6,16
Mumbai City,1883,1,6,5,3,19,11,8,23
Kerala Blast,1883,2,5,5,4,12,15,-3,20
Delhi Dynamo,1883,3,4,7,3,25,20,5,19
Kolkata,1883,4,4,7,3,14,13,1,19
Chennaiyin,1883,5,4,6,4,15,18,-3,18
FC Pune City,1883,6,4,5,5,13,15,-2,17
NorthEast Un,1883,7,4,4,6,12,13,-1,16
FC Goa,1883,8,4,3,7,10,15,-5,15
Mumbai City,1884,1,7,4,3,17,8,9,25
Delhi Dynamo,1884,2,4,7,3,21,15,6,19
Kolkata,1884,3,4,6,4,19,17,2,18
NorthEast Un,1884,4,5,3,6,11,11,0,18
Chennaiyin,1884,5,4,6,4,16,19,-3,18
FC Pune City,1884,6,5,3,6,13,18,-5,18
Kerala Blast,1884,7,5,3,6,12,17,-5,18
FC Goa,1884,8,4,4,6,11,15,-4,16
Delhi Dynamo,1885,1,6,5,3,28,17,11,23
Mumbai City,1885,2,6,4,4,16,11,5,22
Kolkata,1885,3,4,8,2,16,14,2,20
NorthEast Un,1885,4,5,4,5,14,13,1,19
FC Pune City,1885,5,5,4,5,15,16,-1,19
Chennaiyin,1885,6,3,7,4,18,22,-4,16
Kerala Blast,1885,7,4,4,6,10,16,-6,16
FC Goa,1885,8,3,4,7,12,20,-8,13
Mumbai City,1886,1,6,4,4,17,11,6,22
Delhi Dynamo,1886,2,5,6,3,25,18,7,21
NorthEast Un,1886,3,6,3,5,13,10,3,21
Kolkata,1886,4,4,7,3,18,16,2,19
Kerala Blast,1886,5,5,4,5,13,16,-3,19
FC Pune City,1886,6,5,3,6,14,17,-3,18
Chennaiyin,1886,7,3,6,5,13,18,-5,15
FC Goa,1886,8,4,3,7,11,18,-7,15
Mumbai City,1887,1,6,4,4,16,9,7,22
Kolkata,1887,2,5,7,2,20,16,4,22
NorthEast Un,1887,3,6,3,5,14,9,5,21
Delhi Dynamo,1887,4,5,5,4,22,17,5,20
Kerala Blast,1887,5,5,4,5,11,15,-4,19
FC Goa,1887,6,5,2,7,13,18,-5,17
FC Pune City,1887,7,4,4,6,14,17,-3,16
Chennaiyin,1887,8,3,5,6,14,23,-9,14
Kerala Blast,1888,1,7,3,4,14,13,1,24
Mumbai City,1888,2,6,4,4,17,10,7,22
Delhi Dynamo,1888,3,5,6,3,26,20,6,21
NorthEast Un,1888,4,5,3,6,12,11,1,18
Kolkata,1888,5,3,8,3,14,14,0,17
Chennaiyin,1888,6,4,5,5,14,19,-5,17
FC Pune City,1888,7,4,4,6,12,17,-5,16
FC Goa,1888,8,4,3,7,13,18,-5,15
Delhi Dynamo,1889,1,6,6,2,31,16,15,24
Mumbai City,1889,2,6,5,3,17,9,8,23
Kerala Blast,1889,3,5,5,4,13,16,-3,20
Kolkata,1889,4,3,9,2,15,14,1,18
FC Pune City,1889,5,4,4,6,13,16,-3,16
Chennaiyin,1889,6,3,7,4,14,18,-4,16
NorthEast Un,1889,7,4,4,6,10,16,-6,16
FC Goa,1889,8,3,4,7,11,19,-8,13
Mumbai City,1890,1,7,4,3,17,8,9,25
FC Goa,1890,2,6,2,6,15,16,-1,20
Kolkata,1890,3,4,7,3,20,19,1,19
Kerala Blast,1890,4,5,4,5,11,16,-5,19
Delhi Dynamo,1890,5,4,6,4,22,18,4,18
NorthEast Un,1890,6,5,3,6,12,11,1,18
FC Pune City,1890,7,4,5,5,14,16,-2,17
Chennaiyin,1890,8,3,5,6,13,20,-7,14
Delhi Dynamo,1891,1,6,6,2,27,14,13,24
Kerala Blast,1891,2,7,3,4,16,14,2,24
Mumbai City,1891,3,6,5,3,16,8,8,23
FC Pune City,1891,4,5,3,6,14,17,-3,18
Chennaiyin,1891,5,4,5,5,15,18,-3,17
Kolkata,1891,6,3,7,4,17,19,-2,16
FC Goa,1891,7,4,3,7,11,19,-8,15
NorthEast Un,1891,8,4,2,8,9,16,-7,14
Mumbai City,1892,1,7,4,3,18,9,9,25
Kolkata,1892,2,6,6,2,21,15,6,24
Kerala Blast,1892,3,6,3,5,13,16,-3,21
Delhi Dynamo,1892,4,5,5,4,27,19,8,20
Chennaiyin,1892,5,5,5,4,17,19,-2,20
NorthEast Un,1892,6,5,2,7,13,15,-2,17
FC Pune City,1892,7,4,3,7,13,17,-4,15
FC Goa,1892,8,3,2,9,10,22,-12,11
Mumbai City,1893,1,7,4,3,19,8,11,25
Delhi Dynamo,1893,2,6,5,3,24,18,6,23
Kerala Blast,1893,3,5,4,5,13,16,-3,19
NorthEast Un,1893,4,5,3,6,15,15,0,18
FC Pune City,1893,5,5,3,6,14,16,-2,18
Kolkata,1893,6,3,8,3,14,15,-1,17
Chennaiyin,1893,7,3,6,5,16,21,-5,15
FC Goa,1893,8,4,3,7,9,15,-6,15
Mumbai City,1894,1,7,4,3,17,8,9,25
NorthEast Un,1894,2,6,3,5,14,12,2,21
Delhi Dynamo,1894,3,5,5,4,23,17,6,20
Kolkata,1894,4,4,7,3,16,14,2,19
Kerala Blast,1894,5,5,4,5,13,17,-4,19
Chennaiyin,1894,6,3,7,4,15,19,-4,16
FC Pune City,1894,7,4,4,6,13,17,-4,16
FC Goa,1894,8,3,4,7,11,18,-7,13
Mumbai City,1895,1,7,4,3,18,9,9,25
Kolkata,1895,2,5,7,2,16,13,3,22
NorthEast Un,1895,3,5,3,6,13,14,-1,18
Chennaiyin,1895,4,4,6,4,16,18,-2,18
Kerala Blast,1895,5,4,6,4,11,15,-4,18
Delhi Dynamo,1895,6,4,5,5,24,20,4,17
FC Pune City,1895,7,4,4,6,14,17,-3,16
FC Goa,1895,8,4,3,7,10,16,-6,15
Delhi Dynamo,1896,1,5,7,2,23,15,8,22
Mumbai City,1896,2,6,4,4,16,9,7,22
FC Pune City,1896,3,6,3,5,14,14,0,21
Kolkata,1896,4,4,7,3,14,13,1,19
NorthEast Un,1896,5,5,4,5,12,11,1,19
FC Goa,1896,6,4,4,6,10,14,-4,16
Kerala Blast,1896,7,4,4,6,9,15,-6,16
Chennaiyin,1896,8,3,5,6,14,21,-7,14
Mumbai City,1897,1,7,4,3,19,9,10,25
Delhi Dynamo,1897,2,6,5,3,27,19,8,23
Kerala Blast,1897,3,6,4,4,13,14,-1,22
NorthEast Un,1897,4,5,3,6,14,14,0,18
Kolkata,1897,5,3,7,4,14,15,-1,16
FC Pune City,1897,6,4,4,6,13,17,-4,16
Chennaiyin,1897,7,3,6,5,14,19,-5,15
FC Goa,1897,8,4,3,7,9,16,-7,15
Mumbai City,1898,1,7,4,3,18,9,9,25
NorthEast Un,1898,2,7,2,5,15,11,4,23
Kerala Blast,1898,3,6,3,5,12,15,-3,21
Delhi Dynamo,1898,4,5,5,4,25,19,6,20
Kolkata,1898,5,4,7,3,15,14,1,19
Chennaiyin,1898,6,4,5,5,14,19,-5,17
FC Pune City,1898,7,4,3,7,12,16,-4,15
FC Goa,1898,8,3,3,8,10,18,-8,12
Mumbai City,1899,1,7,4,3,18,9,9,25
Kerala Blast,1899,2,6,4,4,15,14,1,22
NorthEast Un,1899,3,6,3,5,16,11,5,21
Delhi Dynamo,1899,4,4,6,4,23,20,3,18
Kolkata,1899,5,4,6,4,14,14,0,18
Chennaiyin,1899,6,4,5,5,14,19,-5,17
FC Goa,1899,7,4,3,7,9,15,-6,15
FC Pune City,1899,8,4,3,7,12,19,-7,15
Mumbai City,1900,1,7,4,3,21,12,9,25
Chennaiyin,1900,2,5,5,4,17,19,-2,20
Kerala Blast,1900,3,5,5,4,13,15,-2,20
Kolkata,1900,4,4,7,3,17,15,2,19
Delhi Dynamo,1900,5,4,6,4,26,22,4,18
FC Goa,1900,6,5,2,7,12,16,-4,17
NorthEast Un,1900,7,4,4,6,13,14,-1,16
FC Pune City,1900,8,4,3,7,14,20,-6,15
Delhi Dynamo,1901,1,7,5,2,27,15,12,26
Mumbai City,1901,2,6,4,4,16,11,5,22
NorthEast Un,1901,3,6,2,6,16,13,3,20
Kerala Blast,1901,4,5,4,5,15,21,-6,19
FC Pune City,1901,5,5,3,6,17,19,-2,18
FC Goa,1901,6,5,2,7,11,16,-5,17
Kolkata,1901,7,3,7,4,15,16,-1,16
Chennaiyin,1901,8,3,5,6,15,21,-6,14
Kolkata,1902,1,6,6,2,18,12,6,24
Mumbai City,1902,2,6,5,3,16,8,8,23
Delhi Dynamo,1902,3,4,7,3,25,19,6,19
FC Pune City,1902,4,5,3,6,15,18,-3,18
NorthEast Un,1902,5,4,5,5,13,13,0,17
FC Goa,1902,6,5,2,7,14,18,-4,17
Kerala Blast,1902,7,4,4,6,13,20,-7,16
Chennaiyin,1902,8,3,6,5,14,20,-6,15
Delhi Dynamo,1903,1,7,5,2,28,15,13,26
Mumbai City,1903,2,6,4,4,16,10,6,22
Kerala Blast,1903,3,5,5,4,14,17,-3,20
NorthEast Un,1903,4,5,3,6,13,15,-2,18
FC Pune City,1903,5,4,5,5,13,15,-2,17
Kolkata,1903,6,3,7,4,14,15,-1,16
Chennaiyin,1903,7,3,6,5,14,19,-5,15
FC Goa,1903,8,4,3,7,10,16,-6,15
Mumbai City,1904,1,7,4,3,18,8,10,25
NorthEast Un,1904,2,6,3,5,15,12,3,21
Delhi Dynamo,1904,3,5,5,4,26,21,5,20
Kolkata,1904,4,4,8,2,20,17,3,20
Kerala Blast,1904,5,5,5,4,14,17,-3,20
FC Pune City,1904,6,4,3,7,13,18,-5,15
FC Goa,1904,7,4,3,7,13,20,-7,15
Chennaiyin,1904,8,3,5,6,13,19,-6,14
Mumbai City,1905,1,6,5,3,18,10,8,23
Kerala Blast,1905,2,6,3,5,13,16,-3,21
Delhi Dynamo,1905,3,4,7,3,24,18,6,19
Kolkata,1905,4,4,7,3,17,14,3,19
Chennaiyin,1905,5,4,6,4,16,17,-1,18
NorthEast Un,1905,6,5,2,7,10,14,-4,17
FC Pune City,1905,7,4,4,6,13,17,-4,16
FC Goa,1905,8,4,4,6,10,15,-5,16
Kerala Blast,1906,1,7,3,4,17,14,3,24
Mumbai City,1906,2,6,5,3,18,10,8,23
Delhi Dynamo,1906,3,5,6,3,29,23,6,21
Kolkata,1906,4,5,6,3,16,16,0,21
Chennaiyin,1906,5,4,6,4,17,19,-2,18
FC Pune City,1906,6,4,3,7,13,17,-4,15
NorthEast Un,1906,6,4,3,7,13,17,-4,15
FC Goa,1906,8,4,2,8,14,21,-7,14
Delhi Dynamo,1907,1,5,7,2,25,17,8,22
Kolkata,1907,2,5,7,2,22,15,7,22
Mumbai City,1907,3,6,4,4,17,10,7,22
Kerala Blast,1907,4,5,5,4,16,17,-1,20
Chennaiyin,1907,5,4,6,4,14,17,-3,18
NorthEast Un,1907,6,4,5,5,11,11,0,17
FC Pune City,1907,7,4,3,7,12,21,-9,15
FC Goa,1907,8,3,3,8,11,20,-9,12
Mumbai City,1908,1,7,4,3,22,10,12,25
NorthEast Un,1908,2,6,3,5,15,10,5,21
Delhi Dynamo,1908,3,5,5,4,24,24,0,20
Kerala Blast,1908,4,5,4,5,13,16,-3,19
FC Pune City,1908,5,4,5,5,13,15,-2,17
Kolkata,1908,6,3,7,4,15,19,-4,16
Chennaiyin,1908,7,3,7,4,14,18,-4,16
FC Goa,1908,8,4,3,7,12,16,-4,15
Mumbai City,1909,1,7,4,3,19,9,10,25
Delhi Dynamo,1909,2,5,6,3,25,18,7,21
NorthEast Un,1909,3,5,4,5,11,10,1,19
Kerala Blast,1909,4,5,4,5,14,17,-3,19
Kolkata,1909,5,4,6,4,16,17,-1,18
FC Pune City,1909,6,5,3,6,14,17,-3,18
Chennaiyin,1909,7,4,5,5,15,18,-3,17
FC Goa,1909,8,4,2,8,10,18,-8,14
Mumbai City,1910,1,6,5,3,17,9,8,23
Delhi Dynamo,1910,2,5,6,3,28,16,12,21
NorthEast Un,1910,3,6,2,6,13,11,2,20
Chennaiyin,1910,4,5,5,4,17,19,-2,20
Kolkata,1910,5,4,7,3,16,16,0,19
Kerala Blast,1910,6,5,4,5,13,17,-4,19
FC Pune City,1910,7,4,4,6,12,15,-3,16
FC Goa,1910,8,3,3,8,9,22,-13,12
Mumbai City,1911,1,6,5,3,16,8,8,23
Delhi Dynamo,1911,2,5,7,2,27,18,9,22
Kerala Blast,1911,3,4,6,4,10,14,-4,18
Kolkata,1911,4,3,8,3,15,15,0,17
NorthEast Un,1911,5,4,5,5,12,12,0,17
FC Pune City,1911,6,4,5,5,14,16,-2,17
FC Goa,1911,7,5,2,7,16,21,-5,17
Chennaiyin,1911,8,3,6,5,16,22,-6,15
Mumbai City,1912,1,7,4,3,17,8,9,25
NorthEast Un,1912,2,5,4,5,12,11,1,19
FC Pune City,1912,3,5,4,5,15,15,0,19
Kolkata,1912,4,3,9,2,15,14,1,18
Chennaiyin,1912,5,4,6,4,17,19,-2,18
Delhi Dynamo,1912,6,4,5,5,24,21,3,17
Kerala Blast,1912,7,4,5,5,13,19,-6,17
FC Goa,1912,8,4,3,7,14,20,-6,15
Delhi Dynamo,1913,1,5,7,2,26,17,9,22
Mumbai City,1913,2,6,4,4,17,11,6,22
Kerala Blast,1913,3,6,4,4,13,14,-1,22
FC Pune City,1913,4,5,3,6,17,20,-3,18
Kolkata,1913,5,3,8,3,16,16,0,17
Chennaiyin,1913,6,4,5,5,15,19,-4,17
FC Goa,1913,7,4,4,6,11,16,-5,16
NorthEast Un,1913,8,4,3,7,10,12,-2,15
Mumbai City,1914,1,7,4,3,18,9,9,25
Kolkata,1914,2,5,7,2,19,14,5,22
Delhi Dynamo,1914,3,5,5,4,26,21,5,20
NorthEast Un,1914,4,6,2,6,16,13,3,20
Kerala Blast,1914,5,5,5,4,12,14,-2,20
Chennaiyin,1914,6,4,5,5,16,21,-5,17
FC Pune City,1914,7,4,4,6,13,16,-3,16
FC Goa,1914,8,3,2,9,10,22,-12,11
Mumbai City,1915,1,7,4,3,17,8,9,25
Kerala Blast,1915,2,6,3,5,11,16,-5,21
Delhi Dynamo,1915,3,4,7,3,21,15,6,19
Kolkata,1915,4,4,7,3,18,16,2,19
FC Goa,1915,5,5,3,6,15,18,-3,18
Chennaiyin,1915,6,4,5,5,17,20,-3,17
FC Pune City,1915,7,4,4,6,12,15,-3,16
NorthEast Un,1915,8,4,3,7,9,12,-3,15
Kerala Blast,1916,1,7,3,4,21,17,4,24
Delhi Dynamo,1916,2,6,5,3,25,19,6,23
Mumbai City,1916,3,6,4,4,17,10,7,22
FC Goa,1916,4,6,2,6,15,15,0,20
Kolkata,1916,5,4,6,4,17,18,-1,18
Chennaiyin,1916,6,4,5,5,14,19,-5,17
FC Pune City,1916,7,4,3,7,13,20,-7,15
NorthEast Un,1916,8,4,2,8,10,14,-4,14
Mumbai City,1917,1,7,4,3,20,9,11,25
Delhi Dynamo,1917,2,6,5,3,30,20,10,23
Kerala Blast,1917,3,6,4,4,13,13,0,22
NorthEast Un,1917,4,5,3,6,12,13,-1,18
FC Goa,1917,5,5,2,7,13,21,-8,17
Kolkata,1917,6,3,7,4,15,18,-3,16
FC Pune City,1917,7,4,4,6,13,16,-3,16
Chennaiyin,1917,8,3,5,6,15,21,-6,14
Mumbai City,1918,1,7,4,3,21,9,12,25
Kolkata,1918,2,5,6,3,21,16,5,21
NorthEast Un,1918,3,6,3,5,14,10,4,21
Kerala Blast,1918,4,6,3,5,13,17,-4,21
Delhi Dynamo,1918,5,4,6,4,24,22,2,18
FC Pune City,1918,6,4,3,7,15,21,-6,15
Chennaiyin,1918,7,3,6,5,13,19,-6,15
FC Goa,1918,8,4,3,7,12,19,-7,15
Delhi Dynamo,1919,1,6,5,3,29,17,12,23
NorthEast Un,1919,2,7,2,5,13,9,4,23
Mumbai City,1919,3,6,4,4,16,10,6,22
Kerala Blast,1919,4,5,4,5,11,14,-3,19
Kolkata,1919,5,3,9,2,14,13,1,18
FC Pune City,1919,6,4,4,6,13,17,-4,16
FC Goa,1919,7,4,3,7,11,20,-9,15
Chennaiyin,1919,8,3,5,6,13,20,-7,14
Mumbai City,1920,1,7,4,3,18,9,9,25
Delhi Dynamo,1920,2,6,5,3,27,16,11,23
Kolkata,1920,3,5,6,3,19,17,2,21
Kerala Blast,1920,4,6,3,5,13,16,-3,21
FC Pune City,1920,5,5,3,6,17,17,0,18
NorthEast Un,1920,6,5,2,7,10,14,-4,17
Chennaiyin,1920,7,3,5,6,14,21,-7,14
FC Goa,1920,8,4,2,8,12,20,-8,14
Delhi Dynamo,1921,1,6,6,2,28,18,10,24
Mumbai City,1921,2,6,5,3,17,9,8,23
Kerala Blast,1921,3,6,4,4,14,15,-1,22
Kolkata,1921,4,4,7,3,17,16,1,19
FC Goa,1921,5,5,2,7,16,19,-3,17
Chennaiyin,1921,6,4,5,5,16,21,-5,17
FC Pune City,1921,7,4,3,7,12,18,-6,15
NorthEast Un,1921,8,4,2,8,12,16,-4,14
Delhi Dynamo,1922,1,6,6,2,27,16,11,24
Kerala Blast,1922,2,7,3,4,13,13,0,24
Mumbai City,1922,3,6,4,4,16,11,5,22
FC Goa,1922,4,5,3,6,14,17,-3,18
FC Pune City,1922,4,5,3,6,14,17,-3,18
NorthEast Un,1922,6,5,2,7,11,11,0,17
Kolkata,1922,7,3,6,5,14,17,-3,15
Chennaiyin,1922,8,3,5,6,14,21,-7,14
Mumbai City,1923,1,7,4,3,17,8,9,25
Kerala Blast,1923,2,6,4,4,15,15,0,22
NorthEast Un,1923,3,5,4,5,15,13,2,19
FC Pune City,1923,4,5,3,6,15,18,-3,18
FC Goa,1923,5,5,3,6,14,17,-3,18
Delhi Dynamo,1923,6,4,5,5,24,22,2,17
Kolkata,1923,7,3,7,4,15,17,-2,16
Chennaiyin,1923,8,3,6,5,15,20,-5,15
Mumbai City,1924,1,7,4,3,19,8,11,25
Kerala Blast,1924,2,6,3,5,13,16,-3,21
Delhi Dynamo,1924,3,4,7,3,22,18,4,19
NorthEast Un,1924,4,5,3,6,11,11,0,18
Chennaiyin,1924,5,4,6,4,14,17,-3,18
Kolkata,1924,6,3,8,3,16,16,0,17
FC Pune City,1924,7,4,4,6,14,17,-3,16
FC Goa,1924,8,3,5,6,9,15,-6,14
Delhi Dynamo,1925,1,6,5,3,26,17,9,23
Mumbai City,1925,2,6,4,4,17,10,7,22
Kolkata,1925,3,5,6,3,20,15,5,21
NorthEast Un,1925,4,5,3,6,13,12,1,18
FC Goa,1925,5,5,3,6,11,15,-4,18
FC Pune City,1925,6,5,3,6,14,19,-5,18
Chennaiyin,1925,7,3,7,4,14,18,-4,16
Kerala Blast,1925,8,4,3,7,10,19,-9,15
Mumbai City,1926,1,6,5,3,17,9,8,23
Delhi Dynamo,1926,2,4,8,2,23,16,7,20
Kerala Blast,1926,3,5,5,4,12,15,-3,20
NorthEast Un,1926,4,5,4,5,13,12,1,19
Kolkata,1926,5,4,6,4,16,16,0,18
FC Goa,1926,6,5,3,6,10,14,-4,18
FC Pune City,1926,7,4,4,6,13,16,-3,16
Chennaiyin,1926,8,3,5,6,14,20,-6,14
Delhi Dynamo,1927,1,6,5,3,27,16,11,23
Mumbai City,1927,2,6,4,4,17,10,7,22
Kolkata,1927,3,5,6,3,18,13,5,21
Chennaiyin,1927,4,5,5,4,16,18,-2,20
NorthEast Un,1927,5,5,3,6,11,11,0,18
FC Pune City,1927,6,5,3,6,13,16,-3,18
Kerala Blast,1927,7,4,4,6,10,18,-8,16
FC Goa,1927,8,4,2,8,10,20,-10,14
Delhi Dynamo,1928,1,6,6,2,26,15,11,24
Mumbai City,1928,2,6,4,4,16,9,7,22
Kolkata,1928,3,4,7,3,15,15,0,19
Kerala Blast,1928,4,5,4,5,12,16,-4,19
NorthEast Un,1928,5,5,3,6,13,13,0,18
Chennaiyin,1928,6,4,6,4,17,19,-2,18
FC Pune City,1928,7,4,4,6,13,16,-3,16
FC Goa,1928,8,3,4,7,10,19,-9,13
Mumbai City,1929,1,7,4,3,18,9,9,25
Delhi Dynamo,1929,2,6,5,3,27,16,11,23
FC Pune City,1929,3,6,3,5,16,15,1,21
Kolkata,1929,4,4,7,3,17,15,2,19
NorthEast Un,1929,5,5,2,7,11,11,0,17
Chennaiyin,1929,6,4,5,5,15,19,-4,17
Kerala Blast,1929,7,4,4,6,10,17,-7,16
FC Goa,1929,8,4,2,8,11,23,-12,14
Mumbai City,1930,1,7,4,3,17,8,9,25
FC Pune City,1930,2,6,3,5,15,14,1,21
Kerala Blast,1930,3,6,3,5,13,15,-2,21
Delhi Dynamo,1930,4,5,5,4,24,18,6,20
NorthEast Un,1930,5,6,2,6,12,11,1,20
Kolkata,1930,6,3,7,4,14,17,-3,16
FC Goa,1930,7,4,3,7,15,19,-4,15
Chennaiyin,1930,8,3,5,6,14,22,-8,14
Delhi Dynamo,1931,1,6,6,2,27,17,10,24
Mumbai City,1931,2,6,5,3,18,10,8,23
Kolkata,1931,3,4,8,2,16,13,3,20
Chennaiyin,1931,4,5,5,4,18,19,-1,20
Kerala Blast,1931,5,5,5,4,11,14,-3,20
FC Pune City,1931,6,4,4,6,14,17,-3,16
NorthEast Un,1931,7,4,3,7,11,15,-4,15
FC Goa,1931,8,3,2,9,9,19,-10,11
Mumbai City,1932,1,7,4,3,20,9,11,25
Delhi Dynamo,1932,2,6,5,3,26,18,8,23
Kolkata,1932,3,4,7,3,18,17,1,19
FC Pune City,1932,4,5,4,5,16,17,-1,19
Kerala Blast,1932,5,5,4,5,13,17,-4,19
NorthEast Un,1932,6,5,2,7,12,14,-2,17
Chennaiyin,1932,7,4,5,5,16,20,-4,17
FC Goa,1932,8,3,3,8,8,17,-9,12
Delhi Dynamo,1933,1,6,6,2,28,17,11,24
Mumbai City,1933,2,6,5,3,17,9,8,23
Kerala Blast,1933,3,6,4,4,15,17,-2,22
FC Pune City,1933,4,5,3,6,16,17,-1,18
NorthEast Un,1933,5,4,4,6,12,13,-1,16
Chennaiyin,1933,6,3,7,4,15,19,-4,16
Kolkata,1933,7,3,6,5,14,18,-4,15
FC Goa,1933,8,4,3,7,12,19,-7,15
Mumbai City,1934,1,6,5,3,16,8,8,23
Kolkata,1934,2,5,7,2,16,13,3,22
Kerala Blast,1934,3,6,4,4,16,15,1,22
Delhi Dynamo,1934,4,5,6,3,25,17,8,21
NorthEast Un,1934,5,5,3,6,12,12,0,18
Chennaiyin,1934,6,3,6,5,14,20,-6,15
FC Pune City,1934,7,4,3,7,13,19,-6,15
FC Goa,1934,8,4,2,8,11,19,-8,14
Mumbai City,1935,1,6,5,3,18,10,8,23
Delhi Dynamo,1935,2,5,7,2,27,17,10,22
Kerala Blast,1935,3,6,3,5,12,14,-2,21
Kolkata,1935,4,4,7,3,15,14,1,19
NorthEast Un,1935,5,5,3,6,12,11,1,18
FC Goa,1935,6,5,2,7,11,17,-6,17
FC Pune City,1935,7,4,4,6,13,17,-4,16
Chennaiyin,1935,8,3,5,6,13,21,-8,14
Mumbai City,1936,1,6,5,3,17,9,8,23
Delhi Dynamo,1936,2,4,8,2,23,16,7,20
NorthEast Un,1936,3,5,4,5,12,10,2,19
Kolkata,1936,4,4,7,3,15,14,1,19
FC Pune City,1936,5,5,4,5,16,17,-1,19
Kerala Blast,1936,6,4,5,5,11,17,-6,17
Chennaiyin,1936,7,3,7,4,16,20,-4,16
FC Goa,1936,8,3,4,7,11,18,-7,13
Delhi Dynamo,1937,1,6,5,3,26,19,7,23
Mumbai City,1937,2,6,4,4,17,10,7,22
Kolkata,1937,3,5,6,3,17,14,3,21
NorthEast Un,1937,4,6,3,5,13,10,3,21
FC Pune City,1937,5,5,3,6,15,17,-2,18
FC Goa,1937,6,5,2,7,13,18,-5,17
Chennaiyin,1937,7,3,6,5,14,19,-5,15
Kerala Blast,1937,8,4,3,7,11,19,-8,15
Mumbai City,1938,1,7,4,3,18,9,9,25
Delhi Dynamo,1938,2,6,5,3,28,17,11,23
Kolkata,1938,3,5,6,3,20,17,3,21
NorthEast Un,1938,4,5,3,6,11,12,-1,18
FC Pune City,1938,5,5,3,6,16,18,-2,18
Kerala Blast,1938,6,4,4,6,10,20,-10,16
Chennaiyin,1938,7,3,6,5,15,20,-5,15
FC Goa,1938,8,4,3,7,14,19,-5,15
Mumbai City,1939,1,6,5,3,16,8,8,23
Delhi Dynamo,1939,2,5,7,2,24,16,8,22
Kerala Blast,1939,3,5,5,4,14,15,-1,20
Kolkata,1939,4,4,7,3,16,15,1,19
FC Pune City,1939,5,5,4,5,14,15,-1,19
NorthEast Un,1939,6,5,2,7,14,14,0,17
Chennaiyin,1939,7,3,6,5,14,22,-8,15
FC Goa,1939,8,3,4,7,11,18,-7,13
Delhi Dynamo,1940,1,6,5,3,27,18,9,23
NorthEast Un,1940,2,7,2,5,15,9,6,23
Mumbai City,1940,3,6,4,4,18,11,7,22
Kolkata,1940,4,5,6,3,20,15,5,21
FC Goa,1940,5,5,2,7,11,18,-7,17
FC Pune City,1940,6,4,4,6,14,19,-5,16
Kerala Blast,1940,7,4,4,6,11,20,-9,16
Chennaiyin,1940,8,3,5,6,14,20,-6,14
Mumbai City,1941,1,7,4,3,19,9,10,25
Delhi Dynamo,1941,2,5,6,3,24,17,7,21
Kolkata,1941,3,5,6,3,19,15,4,21
Chennaiyin,1941,4,5,5,4,17,19,-2,20
FC Pune City,1941,5,5,3,6,15,17,-2,18
Kerala Blast,1941,6,5,3,6,12,19,-7,18
FC Goa,1941,7,4,3,7,11,17,-6,15
NorthEast Un,1941,8,4,2,8,10,14,-4,14
NorthEast Un,1942,1,7,2,5,15,11,4,23
Mumbai City,1942,2,6,4,4,16,10,6,22
Delhi Dynamo,1942,3,5,5,4,24,17,7,20
Kolkata,1942,4,4,8,2,19,17,2,20
FC Pune City,1942,5,5,3,6,19,16,3,18
FC Goa,1942,6,5,3,6,13,17,-4,18
Kerala Blast,1942,7,4,4,6,12,23,-11,16
Chennaiyin,1942,8,3,5,6,14,21,-7,14
Mumbai City,1943,1,7,4,3,17,8,9,25
Delhi Dynamo,1943,2,5,5,4,25,18,7,20
NorthEast Un,1943,3,6,2,6,13,12,1,20
Kolkata,1943,4,4,7,3,18,16,2,19
Chennaiyin,1943,5,4,6,4,17,20,-3,18
FC Pune City,1943,6,4,5,5,16,18,-2,17
Kerala Blast,1943,7,4,4,6,14,21,-7,16
FC Goa,1943,8,4,3,7,12,19,-7,15
Mumbai City,1944,1,7,4,3,20,8,12,25
Delhi Dynamo,1944,2,6,5,3,23,18,5,23
Kolkata,1944,3,4,7,3,17,15,2,19
FC Pune City,1944,4,5,4,5,14,15,-1,19
Chennaiyin,1944,5,4,6,4,18,20,-2,18
Kerala Blast,1944,6,5,3,6,14,19,-5,18
FC Goa,1944,7,4,3,7,11,17,-6,15
NorthEast Un,1944,8,4,2,8,12,17,-5,14
Delhi Dynamo,1945,1,6,6,2,26,17,9,24
Mumbai City,1945,2,6,4,4,16,9,7,22
Kolkata,1945,3,4,8,2,17,15,2,20
NorthEast Un,1945,4,5,4,5,13,12,1,19
Kerala Blast,1945,5,5,4,5,13,15,-2,19
Chennaiyin,1945,6,3,7,4,14,18,-4,16
FC Pune City,1945,7,4,3,7,13,19,-6,15
FC Goa,1945,8,3,4,7,10,17,-7,13
Mumbai City,1946,1,7,4,3,18,8,10,25
Delhi Dynamo,1946,2,5,6,3,27,19,8,21
NorthEast Un,1946,3,6,3,5,14,12,2,21
Kolkata,1946,4,4,7,3,20,17,3,19
Kerala Blast,1946,5,5,4,5,13,17,-4,19
Chennaiyin,1946,6,4,5,5,14,18,-4,17
FC Pune City,1946,7,4,4,6,13,18,-5,16
FC Goa,1946,8,3,3,8,10,20,-10,12
Mumbai City,1947,1,7,4,3,19,9,10,25
Kolkata,1947,2,5,6,3,19,15,4,21
NorthEast Un,1947,3,6,3,5,13,11,2,21
Delhi Dynamo,1947,4,4,6,4,24,21,3,18
Kerala Blast,1947,5,5,3,6,11,18,-7,18
Chennaiyin,1947,6,4,5,5,15,19,-4,17
FC Goa,1947,7,5,2,7,13,17,-4,17
FC Pune City,1947,8,4,3,7,14,18,-4,15
Mumbai City,1948,1,7,4,3,18,9,9,25
NorthEast Un,1948,2,6,3,5,11,9,2,21
Kerala Blast,1948,3,5,4,5,14,16,-2,19
Kolkata,1948,4,3,9,2,15,14,1,18
FC Goa,1948,5,5,3,6,17,18,-1,18
Delhi Dynamo,1948,6,4,5,5,25,21,4,17
FC Pune City,1948,7,4,4,6,14,19,-5,16
Chennaiyin,1948,8,3,6,5,14,22,-8,15
Mumbai City,1949,1,7,4,3,18,8,10,25
Delhi Dynamo,1949,2,6,5,3,25,17,8,23
Kolkata,1949,3,4,7,3,18,17,1,19
NorthEast Un,1949,4,5,3,6,14,13,1,18
Kerala Blast,1949,5,4,5,5,13,20,-7,17
FC Pune City,1949,6,4,4,6,13,16,-3,16
Chennaiyin,1949,7,3,7,4,15,19,-4,16
FC Goa,1949,8,4,3,7,11,17,-6,15
Mumbai City,1950,1,7,4,3,17,8,9,25
Delhi Dynamo,1950,2,5,6,3,23,16,7,21
Kolkata,1950,3,5,6,3,20,16,4,21
NorthEast Un,1950,4,5,4,5,13,11,2,19
Kerala Blast,1950,5,5,3,6,13,19,-6,18
Chennaiyin,1950,6,3,7,4,14,18,-4,16
FC Goa,1950,7,4,3,7,11,16,-5,15
FC Pune City,1950,8,4,3,7,13,20,-7,15
Mumbai City,1951,1,7,4,3,17,8,9,25
NorthEast Un,1951,2,7,2,5,16,12,4,23
Kolkata,1951,3,4,7,3,16,15,1,19
FC Pune City,1951,4,5,3,6,14,16,-2,18
Kerala Blast,1951,5,5,3,6,11,16,-5,18
Delhi Dynamo,1951,6,4,5,5,21,19,2,17
FC Goa,1951,7,4,4,6,11,15,-4,16
Chennaiyin,1951,8,3,6,5,15,20,-5,15
Delhi Dynamo,1952,1,6,6,2,28,17,11,24
Mumbai City,1952,2,6,5,3,18,10,8,23
Kolkata,1952,3,5,7,2,19,14,5,22
FC Pune City,1952,4,5,4,5,17,16,1,19
Chennaiyin,1952,5,4,6,4,18,17,1,18
Kerala Blast,1952,6,5,3,6,13,20,-7,18
NorthEast Un,1952,7,4,2,8,10,20,-10,14
FC Goa,1952,8,3,3,8,9,18,-9,12
Mumbai City,1953,1,7,4,3,18,9,9,25
Delhi Dynamo,1953,2,6,5,3,28,16,12,23
Kolkata,1953,3,4,7,3,17,15,2,19
NorthEast Un,1953,4,5,3,6,12,14,-2,18
FC Pune City,1953,5,4,5,5,14,16,-2,17
Kerala Blast,1953,6,4,5,5,12,18,-6,17
Chennaiyin,1953,7,3,6,5,14,19,-5,15
FC Goa,1953,8,4,3,7,11,19,-8,15
Delhi Dynamo,1954,1,6,6,2,25,16,9,24
Mumbai City,1954,2,6,5,3,16,8,8,23
FC Pune City,1954,3,6,3,5,16,16,0,21
Chennaiyin,1954,4,5,5,4,16,17,-1,20
Kolkata,1954,5,4,6,4,18,18,0,18
NorthEast Un,1954,6,5,2,7,12,14,-2,17
Kerala Blast,1954,7,4,3,7,12,19,-7,15
FC Goa,1954,8,4,2,8,12,19,-7,14
Mumbai City,1955,1,6,5,3,17,9,8,23
Delhi Dynamo,1955,2,5,7,2,24,16,8,22
Kolkata,1955,3,5,6,3,18,15,3,21
FC Pune City,1955,4,6,3,5,15,15,0,21
Chennaiyin,1955,5,5,5,4,17,18,-1,20
Kerala Blast,1955,6,5,3,6,13,19,-6,18
NorthEast Un,1955,7,4,2,8,10,13,-3,14
FC Goa,1955,8,3,3,8,11,20,-9,12
Mumbai City,1956,1,6,5,3,17,9,8,23
NorthEast Un,1956,2,7,2,5,14,9,5,23
Kolkata,1956,3,5,7,2,17,14,3,22
Delhi Dynamo,1956,4,4,7,3,22,18,4,19
FC Pune City,1956,5,5,3,6,15,17,-2,18
Chennaiyin,1956,6,4,5,5,14,18,-4,17
Kerala Blast,1956,7,4,4,6,11,17,-6,16
FC Goa,1956,8,3,3,8,8,16,-8,12
Mumbai City,1957,1,6,5,3,17,9,8,23
Delhi Dynamo,1957,2,5,7,2,26,17,9,22
Kolkata,1957,3,4,7,3,17,16,1,19
Kerala Blast,1957,4,5,4,5,13,18,-5,19
FC Pune City,1957,5,5,3,6,15,16,-1,18
NorthEast Un,1957,6,5,3,6,11,12,-1,18
FC Goa,1957,7,4,4,6,15,18,-3,16
Chennaiyin,1957,8,3,5,6,14,22,-8,14
Delhi Dynamo,1958,1,6,6,2,25,16,9,24
Mumbai City,1958,2,6,5,3,17,9,8,23
NorthEast Un,1958,3,6,2,6,14,12,2,20
FC Pune City,1958,4,5,4,5,16,15,1,19
Kolkata,1958,5,3,8,3,15,15,0,17
FC Goa,1958,6,5,2,7,12,15,-3,17
Kerala Blast,1958,7,4,4,6,10,19,-9,16
Chennaiyin,1958,8,3,5,6,14,22,-8,14
Mumbai City,1959,1,7,4,3,18,8,10,25
Delhi Dynamo,1959,2,5,5,4,24,20,4,20
Kerala Blast,1959,3,5,5,4,11,14,-3,20
NorthEast Un,1959,4,5,3,6,14,12,2,18
Kolkata,1959,5,3,8,3,15,15,0,17
FC Pune City,1959,6,4,5,5,14,16,-2,17
FC Goa,1959,7,5,2,7,13,19,-6,17
Chennaiyin,1959,8,3,6,5,16,21,-5,15
Mumbai City,1960,1,7,4,3,17,8,9,25
Kerala Blast,1960,2,6,3,5,17,18,-1,21
Delhi Dynamo,1960,3,5,5,4,26,17,9,20
Kolkata,1960,4,4,8,2,18,16,2,20
Chennaiyin,1960,5,5,5,4,18,19,-1,20
NorthEast Un,1960,6,5,2,7,14,16,-2,17
FC Pune City,1960,7,4,4,6,15,19,-4,16
FC Goa,1960,8,3,3,8,10,22,-12,12
Mumbai City,1961,1,7,4,3,18,8,10,25
Kolkata,1961,2,5,7,2,20,13,7,22
Delhi Dynamo,1961,3,5,5,4,24,18,6,20
NorthEast Un,1961,4,5,3,6,13,14,-1,18
Chennaiyin,1961,5,4,6,4,16,19,-3,18
FC Pune City,1961,6,5,3,6,13,18,-5,18
Kerala Blast,1961,7,5,3,6,12,17,-5,18
FC Goa,1961,8,3,3,8,8,17,-9,12
Mumbai City,1962,1,7,4,3,19,8,11,25
Delhi Dynamo,1962,2,4,7,3,24,20,4,19
FC Pune City,1962,3,5,4,5,13,14,-1,19
NorthEast Un,1962,4,5,3,6,12,13,-1,18
FC Goa,1962,5,5,3,6,11,15,-4,18
Chennaiyin,1962,6,4,5,5,15,18,-3,17
Kerala Blast,1962,7,4,5,5,10,15,-5,17
Kolkata,1962,8,3,7,4,14,15,-1,16
Mumbai City,1963,1,7,4,3,19,10,9,25
Delhi Dynamo,1963,2,5,6,3,26,19,7,21
NorthEast Un,1963,3,6,2,6,14,11,3,20
Kolkata,1963,4,4,7,3,19,18,1,19
Kerala Blast,1963,5,5,4,5,14,19,-5,19
Chennaiyin,1963,6,4,5,5,17,20,-3,17
FC Pune City,1963,7,4,3,7,14,18,-4,15
FC Goa,1963,8,4,3,7,14,22,-8,15
Mumbai City,1964,1,6,4,4,17,10,7,22
Kerala Blast,1964,2,6,4,4,13,13,0,22
Delhi Dynamo,1964,3,5,6,3,26,21,5,21
Chennaiyin,1964,4,4,6,4,16,19,-3,18
NorthEast Un,1964,5,5,2,7,13,12,1,17
FC Pune City,1964,6,4,5,5,13,15,-2,17
Kolkata,1964,7,3,7,4,14,17,-3,16
FC Goa,1964,8,4,4,6,13,18,-5,16
Delhi Dynamo,1965,1,6,5,3,28,17,11,23
NorthEast Un,1965,2,7,2,5,15,11,4,23
Mumbai City,1965,3,6,4,4,17,10,7,22
Kolkata,1965,4,5,6,3,17,14,3,21
FC Pune City,1965,5,5,3,6,13,15,-2,18
Kerala Blast,1965,6,5,3,6,12,17,-5,18
Chennaiyin,1965,7,3,6,5,15,21,-6,15
FC Goa,1965,8,3,3,8,10,22,-12,12
Delhi Dynamo,1966,1,7,5,2,26,15,11,26
Kolkata,1966,2,6,6,2,20,12,8,24
Mumbai City,1966,3,6,4,4,16,10,6,22
Kerala Blast,1966,4,5,4,5,13,17,-4,19
Chennaiyin,1966,5,4,6,4,15,18,-3,18
NorthEast Un,1966,6,4,3,7,12,14,-2,15
FC Pune City,1966,7,4,3,7,12,19,-7,15
FC Goa,1966,8,3,3,8,9,18,-9,12
Mumbai City,1967,1,7,4,3,20,11,9,25
Kolkata,1967,2,5,6,3,16,14,2,21
NorthEast Un,1967,3,6,3,5,13,11,2,21
Delhi Dynamo,1967,4,5,5,4,28,20,8,20
Kerala Blast,1967,5,5,4,5,12,15,-3,19
Chennaiyin,1967,6,4,5,5,15,19,-4,17
FC Pune City,1967,7,4,3,7,12,18,-6,15
FC Goa,1967,8,4,2,8,11,19,-8,14
Mumbai City,1968,1,7,4,3,20,10,10,25
FC Pune City,1968,2,6,3,5,16,16,0,21
Delhi Dynamo,1968,3,5,5,4,27,24,3,20
Kolkata,1968,4,4,6,4,16,16,0,18
Kerala Blast,1968,5,5,3,6,14,17,-3,18
NorthEast Un,1968,6,5,2,7,14,15,-1,17
FC Goa,1968,7,5,2,7,14,17,-3,17
Chennaiyin,1968,8,4,5,5,15,21,-6,17
Delhi Dynamo,1969,1,6,6,2,26,14,12,24
Mumbai City,1969,2,6,4,4,16,9,7,22
Kerala Blast,1969,3,6,3,5,14,17,-3,21
Kolkata,1969,4,4,6,4,18,16,2,18
NorthEast Un,1969,5,5,3,6,11,11,0,18
FC Pune City,1969,6,5,3,6,13,17,-4,18
Chennaiyin,1969,7,4,5,5,15,19,-4,17
FC Goa,1969,8,4,2,8,10,20,-10,14
Mumbai City,1970,1,6,4,4,16,9,7,22
Kerala Blast,1970,2,6,4,4,16,16,0,22
Delhi Dynamo,1970,3,5,6,3,26,20,6,21
Kolkata,1970,4,4,6,4,19,18,1,18
FC Goa,1970,5,5,3,6,15,18,-3,18
NorthEast Un,1970,6,5,2,7,14,16,-2,17
Chennaiyin,1970,7,4,5,5,19,22,-3,17
FC Pune City,1970,8,4,4,6,17,23,-6,16
Mumbai City,1971,1,7,4,3,19,9,10,25
Delhi Dynamo,1971,2,6,5,3,24,17,7,23
Kerala Blast,1971,3,5,5,4,11,14,-3,20
Kolkata,1971,4,4,7,3,16,16,0,19
FC Pune City,1971,5,5,4,5,14,14,0,19
NorthEast Un,1971,6,4,3,7,10,12,-2,15
Chennaiyin,1971,7,3,6,5,14,19,-5,15
FC Goa,1971,8,4,2,8,10,17,-7,14
Mumbai City,1972,1,7,4,3,18,8,10,25
Kerala Blast,1972,2,6,4,4,15,16,-1,22
Delhi Dynamo,1972,3,5,5,4,26,19,7,20
Chennaiyin,1972,4,5,5,4,17,17,0,20
Kolkata,1972,5,4,6,4,15,15,0,18
FC Pune City,1972,6,5,3,6,16,19,-3,18
NorthEast Un,1972,7,4,3,7,10,16,-6,15
FC Goa,1972,8,4,2,8,11,18,-7,14
Mumbai City,1973,1,7,4,3,20,8,12,25
Kolkata,1973,2,5,6,3,18,13,5,21
Delhi Dynamo,1973,3,4,7,3,22,19,3,19
NorthEast Un,1973,4,5,4,5,13,12,1,19
Chennaiyin,1973,5,4,6,4,18,21,-3,18
Kerala Blast,1973,6,5,3,6,12,20,-8,18
FC Pune City,1973,7,4,3,7,13,17,-4,15
FC Goa,1973,8,4,3,7,12,18,-6,15
Mumbai City,1974,1,7,4,3,18,8,10,25
Delhi Dynamo,1974,2,5,6,3,26,18,8,21
Kolkata,1974,3,4,7,3,14,14,0,19
Kerala Blast,1974,4,5,4,5,15,17,-2,19
FC Pune City,1974,5,5,3,6,15,17,-2,18
NorthEast Un,1974,6,4,4,6,12,15,-3,16
Chennaiyin,1974,7,3,7,4,13,17,-4,16
FC Goa,1974,8,4,3,7,10,17,-7,15
Mumbai City,1975,1,6,5,3,17,9,8,23
Delhi Dynamo,1975,2,4,7,3,24,18,6,19
Kolkata,1975,3,4,7,3,18,16,2,19
NorthEast Un,1975,4,5,3,6,12,13,-1,18
FC Goa,1975,5,5,3,6,12,15,-3,18
FC Pune City,1975,6,4,5,5,15,17,-2,17
Chennaiyin,1975,7,4,5,5,15,19,-4,17
Kerala Blast,1975,8,4,5,5,12,18,-6,17
Mumbai City,1976,1,7,4,3,17,8,9,25
Kolkata,1976,2,5,6,3,16,15,1,21
Delhi Dynamo,1976,3,4,7,3,23,17,6,19
Kerala Blast,1976,4,5,4,5,11,16,-5,19
Chennaiyin,1976,5,4,6,4,14,17,-3,18
NorthEast Un,1976,6,4,4,6,11,12,-1,16
FC Pune City,1976,7,4,4,6,13,16,-3,16
FC Goa,1976,8,4,3,7,11,15,-4,15
Mumbai City,1977,1,6,5,3,17,9,8,23
Delhi Dynamo,1977,2,5,7,2,25,17,8,22
Kolkata,1977,3,5,6,3,15,14,1,21
FC Pune City,1977,4,5,4,5,14,14,0,19
Kerala Blast,1977,5,5,4,5,14,15,-1,19
Chennaiyin,1977,6,3,7,4,14,18,-4,16
NorthEast Un,1977,7,4,4,6,13,17,-4,16
FC Goa,1977,8,3,3,8,8,16,-8,12
Mumbai City,1978,1,7,4,3,18,8,10,25
Delhi Dynamo,1978,2,5,5,4,25,20,5,20
NorthEast Un,1978,3,6,2,6,17,15,2,20
FC Pune City,1978,4,5,4,5,16,15,1,19
Kerala Blast,1978,5,5,4,5,12,18,-6,19
Kolkata,1978,6,3,8,3,16,17,-1,17
Chennaiyin,1978,7,3,6,5,17,22,-5,15
FC Goa,1978,8,4,3,7,13,19,-6,15
Mumbai City,1979,1,7,4,3,21,8,13,25
Delhi Dynamo,1979,2,5,5,4,23,24,-1,20
Kerala Blast,1979,3,5,5,4,15,18,-3,20
NorthEast Un,1979,4,5,4,5,17,12,5,19
FC Pune City,1979,5,5,3,6,14,16,-2,18
Chennaiyin,1979,6,4,6,4,15,18,-3,18
Kolkata,1979,7,3,7,4,18,19,-1,16
FC Goa,1979,8,4,2,8,10,18,-8,14
Mumbai City,1980,1,7,4,3,18,8,10,25
Delhi Dynamo,1980,2,6,5,3,24,17,7,23
Kolkata,1980,3,5,6,3,21,14,7,21
Kerala Blast,1980,4,5,4,5,13,17,-4,19
NorthEast Un,1980,5,5,3,6,14,13,1,18
FC Pune City,1980,6,5,3,6,15,18,-3,18
Chennaiyin,1980,7,3,5,6,14,21,-7,14
FC Goa,1980,8,4,2,8,10,21,-11,14
Mumbai City,1981,1,7,4,3,17,8,9,25
Delhi Dynamo,1981,2,6,5,3,24,16,8,23
Kolkata,1981,3,5,6,3,17,17,0,21
FC Pune City,1981,4,5,3,6,20,17,3,18
Chennaiyin,1981,5,4,6,4,14,17,-3,18
Kerala Blast,1981,6,4,4,6,10,21,-11,16
NorthEast Un,1981,7,4,3,7,10,12,-2,15
FC Goa,1981,8,4,3,7,12,16,-4,15
Mumbai City,1982,1,7,4,3,22,8,14,25
Delhi Dynamo,1982,2,5,6,3,24,21,3,21
Kolkata,1982,3,5,6,3,17,15,2,21
FC Goa,1982,4,5,3,6,14,15,-1,18
NorthEast Un,1982,4,5,3,6,14,15,-1,18
FC Pune City,1982,6,5,3,6,15,17,-2,18
Kerala Blast,1982,7,4,3,7,12,19,-7,15
Chennaiyin,1982,8,3,6,5,14,22,-8,15
Delhi Dynamo,1983,1,7,5,2,31,17,14,26
Mumbai City,1983,2,6,4,4,17,11,6,22
Kerala Blast,1983,3,5,5,4,11,14,-3,20
Kolkata,1983,4,4,7,3,16,15,1,19
Chennaiyin,1983,5,4,5,5,15,18,-3,17
NorthEast Un,1983,6,5,2,7,10,14,-4,17
FC Pune City,1983,7,4,4,6,14,17,-3,16
FC Goa,1983,8,4,2,8,12,20,-8,14
Delhi Dynamo,1984,1,6,5,3,31,21,10,23
Mumbai City,1984,2,6,4,4,17,13,4,22
NorthEast Un,1984,3,6,3,5,19,13,6,21
FC Pune City,1984,4,6,3,5,14,14,0,21
Chennaiyin,1984,5,4,6,4,18,20,-2,18
Kolkata,1984,6,3,8,3,15,15,0,17
Kerala Blast,1984,7,4,4,6,11,18,-7,16
FC Goa,1984,8,3,3,8,13,24,-11,12
Mumbai City,1985,1,7,4,3,18,8,10,25
Delhi Dynamo,1985,2,5,5,4,23,18,5,20
Kerala Blast,1985,3,5,5,4,11,14,-3,20
FC Pune City,1985,4,5,4,5,15,16,-1,19
Kolkata,1985,5,4,6,4,15,15,0,18
FC Goa,1985,6,5,2,7,11,15,-4,17
NorthEast Un,1985,7,4,4,6,11,12,-1,16
Chennaiyin,1985,8,3,6,5,14,20,-6,15
Mumbai City,1986,1,6,5,3,21,13,8,23
Delhi Dynamo,1986,2,4,7,3,27,22,5,19
FC Pune City,1986,3,5,4,5,14,15,-1,19
NorthEast Un,1986,4,5,3,6,11,11,0,18
FC Goa,1986,5,5,3,6,14,16,-2,18
Kerala Blast,1986,6,4,6,4,10,14,-4,18
Chennaiyin,1986,7,4,5,5,15,19,-4,17
Kolkata,1986,8,3,7,4,14,16,-2,16
Mumbai City,1987,1,6,5,3,17,9,8,23
FC Goa,1987,2,6,2,6,14,16,-2,20
Kerala Blast,1987,3,5,5,4,12,14,-2,20
Delhi Dynamo,1987,4,4,7,3,23,17,6,19
Kolkata,1987,5,4,6,4,15,16,-1,18
NorthEast Un,1987,6,4,5,5,11,11,0,17
FC Pune City,1987,7,4,4,6,13,16,-3,16
Chennaiyin,1987,8,3,6,5,15,21,-6,15
Mumbai City,1988,1,6,5,3,16,8,8,23
Delhi Dynamo,1988,2,5,7,2,23,15,8,22
Kolkata,1988,3,4,7,3,19,17,2,19
FC Pune City,1988,4,5,4,5,15,15,0,19
NorthEast Un,1988,5,5,3,6,12,12,0,18
Kerala Blast,1988,6,4,5,5,13,20,-7,17
FC Goa,1988,7,4,4,6,13,17,-4,16
Chennaiyin,1988,8,3,5,6,15,22,-7,14
Kolkata,1989,1,6,6,2,19,15,4,24
Delhi Dynamo,1989,2,5,7,2,24,15,9,22
Mumbai City,1989,3,6,4,4,16,10,6,22
FC Pune City,1989,4,5,3,6,14,16,-2,18
Kerala Blast,1989,5,5,3,6,10,15,-5,18
Chennaiyin,1989,6,4,5,5,14,18,-4,17
NorthEast Un,1989,7,4,3,7,10,12,-2,15
FC Goa,1989,8,4,3,7,11,17,-6,15
Delhi Dynamo,1990,1,6,6,2,26,15,11,24
Mumbai City,1990,2,6,5,3,17,9,8,23
FC Pune City,1990,3,6,3,5,15,15,0,21
NorthEast Un,1990,4,5,3,6,14,12,2,18
Chennaiyin,1990,5,4,5,5,16,21,-5,17
Kerala Blast,1990,6,4,5,5,11,16,-5,17
Kolkata,1990,7,3,7,4,18,19,-1,16
FC Goa,1990,8,4,2,8,12,22,-10,14
Mumbai City,1991,1,6,5,3,17,9,8,23
Kolkata,1991,2,5,7,2,18,14,4,22
Kerala Blast,1991,3,6,3,5,11,15,-4,21
Delhi Dynamo,1991,4,4,6,4,23,18,5,18
NorthEast Un,1991,5,5,3,6,10,10,0,18
FC Goa,1991,6,5,2,7,12,17,-5,17
FC Pune City,1991,7,4,4,6,13,16,-3,16
Chennaiyin,1991,8,3,6,5,13,18,-5,15
Mumbai City,1992,1,7,4,3,19,9,10,25
Delhi Dynamo,1992,2,4,7,3,22,17,5,19
FC Pune City,1992,3,5,4,5,15,14,1,19
NorthEast Un,1992,4,5,4,5,13,12,1,19
Kolkata,1992,5,4,6,4,16,18,-2,18
FC Goa,1992,6,5,3,6,12,16,-4,18
Kerala Blast,1992,7,4,5,5,12,17,-5,17
Chennaiyin,1992,8,3,5,6,15,21,-6,14
Mumbai City,1993,1,7,4,3,19,10,9,25
Delhi Dynamo,1993,2,5,6,3,25,18,7,21
NorthEast Un,1993,3,6,3,5,15,11,4,21
Kolkata,1993,4,5,6,3,17,16,1,21
FC Pune City,1993,5,5,3,6,17,18,-1,18
Chennaiyin,1993,6,4,5,5,17,20,-3,17
Kerala Blast,1993,7,4,3,7,12,22,-10,15
FC Goa,1993,8,4,2,8,11,18,-7,14
Mumbai City,1994,1,7,4,3,19,9,10,25
Kerala Blast,1994,2,5,5,4,11,14,-3,20
NorthEast Un,1994,3,5,4,5,10,9,1,19
FC Pune City,1994,4,5,4,5,15,16,-1,19
Kolkata,1994,5,4,6,4,16,15,1,18
Chennaiyin,1994,6,4,6,4,16,17,-1,18
Delhi Dynamo,1994,7,4,5,5,23,20,3,17
FC Goa,1994,8,4,2,8,10,20,-10,14
Mumbai City,1995,1,6,4,4,17,10,7,22
Delhi Dynamo,1995,2,5,6,3,24,17,7,21
Kerala Blast,1995,3,6,3,5,12,17,-5,21
NorthEast Un,1995,4,5,3,6,12,11,1,18
FC Pune City,1995,5,5,3,6,16,16,0,18
Kolkata,1995,6,4,6,4,15,16,-1,18
Chennaiyin,1995,7,4,5,5,16,19,-3,17
FC Goa,1995,8,5,2,7,12,18,-6,17
Mumbai City,1996,1,7,4,3,20,8,12,25
Kolkata,1996,2,5,7,2,18,12,6,22
NorthEast Un,1996,3,6,2,6,15,12,3,20
Kerala Blast,1996,4,5,4,5,12,17,-5,19
Delhi Dynamo,1996,5,4,6,4,23,23,0,18
FC Pune City,1996,6,4,5,5,13,15,-2,17
Chennaiyin,1996,7,3,6,5,15,21,-6,15
FC Goa,1996,8,3,4,7,11,19,-8,13
Mumbai City,1997,1,7,4,3,19,9,10,25
Delhi Dynamo,1997,2,5,6,3,24,18,6,21
NorthEast Un,1997,3,6,3,5,17,13,4,21
Kolkata,1997,4,3,9,2,15,14,1,18
FC Pune City,1997,5,4,5,5,13,15,-2,17
Chennaiyin,1997,6,4,5,5,17,21,-4,17
Kerala Blast,1997,7,4,5,5,10,17,-7,17
FC Goa,1997,8,3,3,8,10,18,-8,12
Kolkata,1998,1,6,6,2,17,13,4,24
Mumbai City,1998,2,6,5,3,17,9,8,23
Delhi Dynamo,1998,3,5,7,2,24,16,8,22
Kerala Blast,1998,4,6,3,5,15,15,0,21
Chennaiyin,1998,5,4,6,4,16,18,-2,18
FC Pune City,1998,6,4,3,7,12,19,-7,15
NorthEast Un,1998,7,4,2,8,10,14,-4,14
FC Goa,1998,8,3,4,7,11,18,-7,13
Mumbai City,1999,1,7,4,3,18,8,10,25
Kolkata,1999,2,5,7,2,19,15,4,22
Delhi Dynamo,1999,3,5,5,4,23,19,4,20
Chennaiyin,1999,4,4,6,4,14,17,-3,18
Kerala Blast,1999,5,5,3,6,11,18,-7,18
NorthEast Un,1999,6,5,2,7,11,12,-1,17
FC Pune City,1999,7,4,4,6,13,16,-3,16
FC Goa,1999,8,4,3,7,12,16,-4,15
Mumbai City,2000,1,7,4,3,19,8,11,25
Delhi Dynamo,2000,2,6,5,3,23,17,6,23
Kerala Blast,2000,3,6,3,5,15,16,-1,21
NorthEast Un,2000,4,6,2,6,13,12,1,20
Kolkata,2000,5,3,8,3,17,18,-1,17
Chennaiyin,2000,6,4,5,5,15,19,-4,17
FC Pune City,2000,7,4,4,6,13,17,-4,16
FC Goa,2000,8,3,3,8,10,18,-8,12
Mumbai City,2001,1,6,4,4,18,12,6,22
Kolkata,2001,2,5,7,2,16,13,3,22
Delhi Dynamo,2001,3,5,6,3,27,19,8,21
Kerala Blast,2001,4,5,4,5,12,15,-3,19
FC Pune City,2001,5,5,3,6,15,17,-2,18
Chennaiyin,2001,6,4,6,4,16,19,-3,18
NorthEast Un,2001,7,4,4,6,11,13,-2,16
FC Goa,2001,8,4,2,8,11,18,-7,14
Kerala Blast,2002,1,7,3,4,15,15,0,24
Delhi Dynamo,2002,2,6,5,3,26,18,8,23
Mumbai City,2002,3,6,4,4,17,10,7,22
NorthEast Un,2002,4,5,3,6,12,13,-1,18
FC Pune City,2002,5,5,3,6,14,16,-2,18
Chennaiyin,2002,6,4,6,4,16,19,-3,18
Kolkata,2002,7,3,6,5,15,17,-2,15
FC Goa,2002,8,4,2,8,12,19,-7,14
Delhi Dynamo,2003,1,7,5,2,25,15,10,26
Mumbai City,2003,2,6,4,4,17,10,7,22
Kolkata,2003,3,5,6,3,17,14,3,21
Kerala Blast,2003,4,5,4,5,11,15,-4,19
NorthEast Un,2003,5,5,3,6,10,10,0,18
FC Pune City,2003,6,5,3,6,14,17,-3,18
Chennaiyin,2003,7,3,6,5,14,19,-5,15
FC Goa,2003,8,3,3,8,9,17,-8,12
Mumbai City,2004,1,7,4,3,20,8,12,25
Kerala Blast,2004,2,7,3,4,16,15,1,24
NorthEast Un,2004,3,5,3,6,14,14,0,18
FC Goa,2004,4,5,3,6,15,16,-1,18
FC Pune City,2004,5,5,3,6,14,16,-2,18
Delhi Dynamo,2004,6,4,5,5,23,23,0,17
Chennaiyin,2004,7,3,7,4,15,19,-4,16
Kolkata,2004,8,3,6,5,13,19,-6,15
Mumbai City,2005,1,7,4,3,19,8,11,25
Kerala Blast,2005,2,6,3,5,12,15,-3,21
FC Goa,2005,3,6,2,6,13,16,-3,20
FC Pune City,2005,4,5,4,5,16,17,-1,19
NorthEast Un,2005,5,5,2,7,12,11,1,17
Delhi Dynamo,2005,6,4,5,5,21,21,0,17
Chennaiyin,2005,7,4,5,5,15,19,-4,17
Kolkata,2005,8,3,7,4,16,17,-1,16
Mumbai City,2006,1,6,5,3,16,8,8,23
Delhi Dynamo,2006,2,5,6,3,24,18,6,21
Kolkata,2006,3,4,8,2,16,13,3,20
Kerala Blast,2006,4,5,5,4,13,16,-3,20
FC Goa,2006,5,5,3,6,15,17,-2,18
Chennaiyin,2006,6,4,5,5,15,20,-5,17
FC Pune City,2006,7,4,4,6,13,17,-4,16
NorthEast Un,2006,8,4,2,8,10,13,-3,14
Kolkata,2007,1,6,6,2,22,15,7,24
Mumbai City,2007,2,6,4,4,17,10,7,22
Chennaiyin,2007,3,5,5,4,19,19,0,20
Delhi Dynamo,2007,4,5,5,4,24,25,-1,20
Kerala Blast,2007,5,5,4,5,11,18,-7,19
NorthEast Un,2007,6,5,3,6,20,14,6,18
FC Pune City,2007,7,4,3,7,13,17,-4,15
FC Goa,2007,8,4,2,8,12,20,-8,14
Mumbai City,2008,1,7,4,3,20,8,12,25
Kolkata,2008,2,6,6,2,22,13,9,24
Delhi Dynamo,2008,3,5,6,3,23,19,4,21
Chennaiyin,2008,4,5,5,4,20,17,3,20
Kerala Blast,2008,5,4,5,5,11,17,-6,17
NorthEast Un,2008,6,4,4,6,10,15,-5,16
FC Pune City,2008,7,4,4,6,14,21,-7,16
FC Goa,2008,8,3,2,9,9,19,-10,11
Delhi Dynamo,2009,1,6,6,2,27,14,13,24
Mumbai City,2009,2,6,4,4,16,11,5,22
NorthEast Un,2009,3,6,3,5,13,10,3,21
Kolkata,2009,4,4,7,3,18,17,1,19
Kerala Blast,2009,5,5,3,6,12,17,-5,18
FC Goa,2009,6,5,2,7,12,18,-6,17
FC Pune City,2009,7,4,4,6,16,19,-3,16
Chennaiyin,2009,8,3,5,6,13,21,-8,14
Mumbai City,2010,1,7,4,3,17,8,9,25
Delhi Dynamo,2010,2,4,7,3,25,19,6,19
Kolkata,2010,3,4,7,3,17,14,3,19
Kerala Blast,2010,4,5,4,5,11,15,-4,19
NorthEast Un,2010,5,5,3,6,15,16,-1,18
Chennaiyin,2010,6,4,6,4,21,23,-2,18
FC Pune City,2010,7,4,5,5,13,15,-2,17
FC Goa,2010,8,3,4,7,14,23,-9,13
Mumbai City,2011,1,7,4,3,19,10,9,25
Chennaiyin,2011,2,5,5,4,16,18,-2,20
FC Pune City,2011,3,5,4,5,16,16,0,19
Kerala Blast,2011,4,5,4,5,12,15,-3,19
Delhi Dynamo,2011,5,4,6,4,25,21,4,18
Kolkata,2011,6,4,6,4,17,18,-1,18
NorthEast Un,2011,7,5,2,7,12,13,-1,17
FC Goa,2011,8,4,3,7,13,19,-6,15
Delhi Dynamo,2012,1,5,7,2,25,16,9,22
Mumbai City,2012,2,6,4,4,18,12,6,22
Kolkata,2012,3,5,6,3,17,14,3,21
Kerala Blast,2012,4,6,3,5,14,17,-3,21
FC Pune City,2012,5,5,3,6,15,17,-2,18
Chennaiyin,2012,6,4,6,4,17,20,-3,18
NorthEast Un,2012,7,4,3,7,10,12,-2,15
FC Goa,2012,8,3,4,7,10,18,-8,13
Mumbai City,2013,1,7,4,3,18,8,10,25
NorthEast Un,2013,2,6,3,5,11,9,2,21
Kolkata,2013,3,5,6,3,16,15,1,21
Kerala Blast,2013,4,5,4,5,10,14,-4,19
Delhi Dynamo,2013,5,4,6,4,21,17,4,18
FC Goa,2013,6,4,4,6,12,16,-4,16
FC Pune City,2013,7,4,3,7,13,17,-4,15
Chennaiyin,2013,8,3,6,5,15,20,-5,15
Delhi Dynamo,2014,1,6,6,2,28,17,11,24
Mumbai City,2014,2,6,4,4,16,10,6,22
Kolkata,2014,3,5,7,2,18,15,3,22
Kerala Blast,2014,4,6,3,5,13,16,-3,21
NorthEast Un,2014,5,5,3,6,12,12,0,18
FC Pune City,2014,6,4,3,7,12,16,-4,15
FC Goa,2014,7,4,3,7,14,21,-7,15
Chennaiyin,2014,8,3,5,6,14,20,-6,14
Delhi Dynamo,2015,1,5,7,2,23,15,8,22
Mumbai City,2015,2,6,4,4,16,9,7,22
Kolkata,2015,3,5,6,3,19,14,5,21
Kerala Blast,2015,4,6,3,5,15,19,-4,21
FC Goa,2015,5,5,3,6,11,15,-4,18
Chennaiyin,2015,6,4,5,5,16,18,-2,17
FC Pune City,2015,7,4,3,7,13,17,-4,15
NorthEast Un,2015,8,4,3,7,9,15,-6,15
Mumbai City,2016,1,6,5,3,19,11,8,23
Delhi Dynamo,2016,2,5,6,3,28,21,7,21
FC Pune City,2016,3,6,3,5,14,14,0,21
NorthEast Un,2016,4,6,2,6,13,12,1,20
Chennaiyin,2016,5,5,5,4,15,17,-2,20
Kolkata,2016,6,4,6,4,16,19,-3,18
Kerala Blast,2016,7,4,3,7,11,18,-7,15
FC Goa,2016,8,4,2,8,13,17,-4,14
Mumbai City,2017,1,7,4,3,18,8,10,25
FC Pune City,2017,2,6,3,5,17,15,2,21
Delhi Dynamo,2017,3,5,5,4,26,22,4,20
Chennaiyin,2017,4,5,5,4,17,18,-1,20
Kolkata,2017,5,4,7,3,18,15,3,19
Kerala Blast,2017,6,4,4,6,11,21,-10,16
NorthEast Un,2017,7,4,3,7,14,17,-3,15
FC Goa,2017,8,4,3,7,12,17,-5,15
Mumbai City,2018,1,7,4,3,17,8,9,25
Kolkata,2018,2,5,7,2,17,13,4,22
Delhi Dynamo,2018,3,4,6,4,24,19,5,18
NorthEast Un,2018,4,5,3,6,10,10,0,18
FC Pune City,2018,5,5,3,6,15,18,-3,18
Kerala Blast,2018,6,5,3,6,12,17,-5,18
Chennaiyin,2018,7,3,7,4,13,17,-4,16
FC Goa,2018,8,3,5,6,12,18,-6,14
Mumbai City,2019,1,7,4,3,18,9,9,25
Delhi Dynamo,2019,2,5,6,3,27,17,10,21
NorthEast Un,2019,3,6,3,5,13,10,3,21
Kolkata,2019,4,5,6,3,17,15,2,21
Kerala Blast,2019,5,6,3,5,12,16,-4,21
Chennaiyin,2019,6,4,5,5,16,20,-4,17
FC Pune City,2019,7,4,3,7,12,16,-4,15
FC Goa,2019,8,3,2,9,11,23,-12,11
Mumbai City,2020,1,7,4,3,18,9,9,25
NorthEast Un,2020,2,6,2,6,14,12,2,20
Kolkata,2020,3,4,7,3,15,15,0,19
Chennaiyin,2020,4,4,6,4,15,17,-2,18
FC Goa,2020,5,5,3,6,11,14,-3,18
Delhi Dynamo,2020,6,4,5,5,23,20,3,17
Kerala Blast,2020,7,4,5,5,11,17,-6,17
FC Pune City,2020,8,4,4,6,15,18,-3,16
Mumbai City,2021,1,7,4,3,19,8,11,25
Kolkata,2021,2,5,6,3,16,15,1,21
Kerala Blast,2021,3,6,3,5,13,15,-2,21
Delhi Dynamo,2021,4,4,6,4,22,19,3,18
NorthEast Un,2021,5,5,3,6,15,13,2,18
FC Pune City,2021,6,5,3,6,14,15,-1,18
FC Goa,2021,7,5,2,7,11,16,-5,17
Chennaiyin,2021,8,3,5,6,15,24,-9,14
Mumbai City,2022,1,7,4,3,17,8,9,25
Kolkata,2022,2,5,7,2,17,14,3,22
NorthEast Un,2022,3,6,3,5,12,10,2,21
Delhi Dynamo,2022,4,5,5,4,22,16,6,20
Kerala Blast,2022,5,4,5,5,11,16,-5,17
FC Pune City,2022,6,4,4,6,12,15,-3,16
FC Goa,2022,7,4,3,7,11,16,-5,15
Chennaiyin,2022,8,3,5,6,13,20,-7,14
Delhi Dynamo,2023,1,6,6,2,27,16,11,24
Mumbai City,2023,2,6,5,3,18,10,8,23
Kolkata,2023,3,5,6,3,19,15,4,21
Kerala Blast,2023,4,5,4,5,13,15,-2,19
NorthEast Un,2023,5,5,3,6,11,12,-1,18
FC Pune City,2023,6,5,3,6,13,17,-4,18
Chennaiyin,2023,7,3,5,6,14,20,-6,14
FC Goa,2023,8,4,2,8,10,20,-10,14
Mumbai City,2024,1,7,4,3,19,10,9,25
Kolkata,2024,2,6,6,2,19,14,5,24
Kerala Blast,2024,3,6,3,5,14,16,-2,21
Chennaiyin,2024,4,4,6,4,16,18,-2,18
Delhi Dynamo,2024,5,4,5,5,26,26,0,17
NorthEast Un,2024,6,5,2,7,13,14,-1,17
FC Goa,2024,7,4,3,7,15,18,-3,15
FC Pune City,2024,8,4,3,7,13,19,-6,15
Delhi Dynamo,2025,1,6,6,2,25,15,10,24
Mumbai City,2025,2,6,4,4,16,10,6,22
Kolkata,2025,3,5,7,2,18,15,3,22
FC Pune City,2025,4,5,4,5,16,16,0,19
Kerala Blast,2025,5,5,3,6,12,18,-6,18
Chennaiyin,2025,6,4,5,5,18,22,-4,17
FC Goa,2025,7,4,3,7,14,18,-4,15
NorthEast Un,2025,8,4,2,8,10,15,-5,14
Kerala Blast,2026,1,7,3,4,15,14,1,24
Mumbai City,2026,2,6,5,3,17,9,8,23
Delhi Dynamo,2026,3,4,8,2,24,17,7,20
Chennaiyin,2026,4,4,6,4,20,20,0,18
Kolkata,2026,5,4,6,4,15,17,-2,18
FC Goa,2026,6,4,4,6,11,16,-5,16
FC Pune City,2026,7,4,3,7,13,17,-4,15
NorthEast Un,2026,8,4,3,7,13,18,-5,15
Delhi Dynamo,2027,1,6,6,2,27,17,10,24
Mumbai City,2027,2,6,4,4,16,10,6,22
Kerala Blast,2027,3,6,3,5,14,16,-2,21
Kolkata,2027,4,4,7,3,15,14,1,19
NorthEast Un,2027,5,5,2,7,11,12,-1,17
Chennaiyin,2027,6,4,5,5,15,19,-4,17
FC Pune City,2027,7,4,4,6,14,18,-4,16
FC Goa,2027,8,4,3,7,13,19,-6,15
Delhi Dynamo,2028,1,7,5,2,26,15,11,26
Mumbai City,2028,2,6,4,4,16,9,7,22
NorthEast Un,2028,3,6,2,6,14,12,2,20
Kolkata,2028,4,4,7,3,18,18,0,19
FC Pune City,2028,5,5,3,6,16,17,-1,18
Chennaiyin,2028,6,4,5,5,15,19,-4,17
Kerala Blast,2028,7,4,4,6,11,19,-8,16
FC Goa,2028,8,4,2,8,10,17,-7,14
Mumbai City,2029,1,6,5,3,17,9,8,23
Delhi Dynamo,2029,2,5,6,3,25,19,6,21
NorthEast Un,2029,3,6,3,5,16,12,4,21
FC Pune City,2029,4,6,3,5,16,15,1,21
Kolkata,2029,5,4,6,4,18,16,2,18
FC Goa,2029,6,5,2,7,11,16,-5,17
Kerala Blast,2029,7,4,4,6,10,19,-9,16
Chennaiyin,2029,8,3,5,6,13,20,-7,14
Mumbai City,2030,1,7,4,3,19,9,10,25
Kolkata,2030,2,5,6,3,21,17,4,21
NorthEast Un,2030,3,6,2,6,12,12,0,20
Chennaiyin,2030,4,5,5,4,17,18,-1,20
Kerala Blast,2030,5,5,3,6,12,18,-6,18
Delhi Dynamo,2030,6,4,5,5,22,19,3,17
FC Goa,2030,7,5,2,7,13,16,-3,17
FC Pune City,2030,8,4,3,7,13,20,-7,15
Mumbai City,2031,1,7,4,3,18,8,10,25
Kerala Blast,2031,2,6,4,4,13,14,-1,22
Delhi Dynamo,2031,3,5,6,3,23,17,6,21
FC Pune City,2031,4,5,3,6,16,17,-1,18
FC Goa,2031,5,5,3,6,14,16,-2,18
Chennaiyin,2031,6,4,5,5,15,20,-5,17
Kolkata,2031,7,3,7,4,14,17,-3,16
NorthEast Un,2031,8,4,2,8,9,13,-4,14
Mumbai City,2032,1,6,5,3,18,10,8,23
Delhi Dynamo,2032,2,4,7,3,24,20,4,19
Kerala Blast,2032,3,5,4,5,11,15,-4,19
NorthEast Un,2032,4,5,3,6,13,11,2,18
Kolkata,2032,5,4,6,4,15,16,-1,18
FC Pune City,2032,6,5,3,6,14,16,-2,18
FC Goa,2032,7,5,3,6,12,15,-3,18
Chennaiyin,2032,8,4,5,5,14,18,-4,17
Delhi Dynamo,2033,1,6,5,3,26,17,9,23
Mumbai City,2033,2,6,4,4,16,9,7,22
Kolkata,2033,3,5,6,3,17,13,4,21
Chennaiyin,2033,4,5,5,4,18,19,-1,20
Kerala Blast,2033,5,5,4,5,13,17,-4,19
NorthEast Un,2033,6,5,3,6,14,15,-1,18
FC Pune City,2033,7,4,3,7,12,18,-6,15
FC Goa,2033,8,4,2,8,11,19,-8,14
Mumbai City,2034,1,6,5,3,17,9,8,23
Kolkata,2034,2,5,7,2,21,18,3,22
Delhi Dynamo,2034,3,5,6,3,24,17,7,21
Kerala Blast,2034,4,6,3,5,15,16,-1,21
NorthEast Un,2034,5,5,3,6,10,11,-1,18
Chennaiyin,2034,6,3,7,4,13,17,-4,16
FC Pune City,2034,7,4,3,7,15,20,-5,15
FC Goa,2034,8,3,4,7,10,17,-7,13
Mumbai City,2035,1,7,4,3,18,8,10,25
Kerala Blast,2035,2,6,4,4,14,16,-2,22
Delhi Dynamo,2035,3,5,6,3,24,18,6,21
NorthEast Un,2035,4,5,3,6,12,12,0,18
Kolkata,2035,5,3,8,3,15,15,0,17
FC Pune City,2035,6,4,5,5,14,16,-2,17
Chennaiyin,2035,7,4,5,5,16,20,-4,17
FC Goa,2035,8,3,3,8,13,21,-8,12
Mumbai City,2036,1,7,4,3,18,9,9,25
NorthEast Un,2036,2,6,3,5,16,13,3,21
Kolkata,2036,3,4,8,2,19,16,3,20
Delhi Dynamo,2036,4,4,6,4,24,19,5,18
FC Pune City,2036,5,4,5,5,12,14,-2,17
Chennaiyin,2036,6,3,7,4,18,22,-4,16
Kerala Blast,2036,7,4,4,6,10,18,-8,16
FC Goa,2036,8,3,5,6,16,22,-6,14
Delhi Dynamo,2037,1,6,6,2,33,18,15,24
Mumbai City,2037,2,6,5,3,17,9,8,23
Kolkata,2037,3,5,7,2,21,16,5,22
Kerala Blast,2037,4,6,3,5,14,18,-4,21
Chennaiyin,2037,5,5,5,4,19,19,0,20
FC Pune City,2037,6,4,3,7,14,18,-4,15
NorthEast Un,2037,7,4,2,8,14,21,-7,14
FC Goa,2037,8,3,3,8,12,25,-13,12
Mumbai City,2038,1,7,4,3,19,9,10,25
Delhi Dynamo,2038,2,6,5,3,27,19,8,23
Kolkata,2038,3,5,6,3,18,16,2,21
Chennaiyin,2038,4,4,6,4,14,17,-3,18
Kerala Blast,2038,5,5,3,6,13,19,-6,18
NorthEast Un,2038,6,5,2,7,11,12,-1,17
FC Pune City,2038,7,4,3,7,13,17,-4,15
FC Goa,2038,8,4,3,7,11,17,-6,15
Mumbai City,2039,1,7,4,3,18,9,9,25
Delhi Dynamo,2039,2,6,5,3,26,18,8,23
Kolkata,2039,3,4,8,2,17,15,2,20
FC Pune City,2039,4,4,5,5,15,17,-2,17
Kerala Blast,2039,5,4,5,5,12,17,-5,17
NorthEast Un,2039,6,4,4,6,11,12,-1,16
Chennaiyin,2039,7,3,7,4,13,17,-4,16
FC Goa,2039,8,3,4,7,11,18,-7,13
Mumbai City,2040,1,7,4,3,18,9,9,25
Kolkata,2040,2,5,7,2,17,13,4,22
Delhi Dynamo,2040,3,4,7,3,26,20,6,19
Kerala Blast,2040,4,5,4,5,12,15,-3,19
Chennaiyin,2040,5,4,6,4,18,18,0,18
NorthEast Un,2040,6,4,4,6,13,17,-4,16
FC Pune City,2040,7,4,3,7,12,18,-6,15
FC Goa,2040,8,3,5,6,10,16,-6,14
Delhi Dynamo,2041,1,6,6,2,28,17,11,24
Mumbai City,2041,2,6,4,4,17,11,6,22
Chennaiyin,2041,3,5,5,4,17,18,-1,20
FC Pune City,2041,4,5,4,5,17,17,0,19
Kolkata,2041,5,4,7,3,15,15,0,19
Kerala Blast,2041,6,4,6,4,12,16,-4,18
NorthEast Un,2041,7,4,4,6,11,12,-1,16
FC Goa,2041,8,3,2,9,10,21,-11,11
Mumbai City,2042,1,6,5,3,17,9,8,23
Delhi Dynamo,2042,2,4,8,2,23,16,7,20
NorthEast Un,2042,3,5,4,5,13,11,2,19
FC Pune City,2042,4,5,4,5,15,15,0,19
Kolkata,2042,5,3,9,2,17,16,1,18
Chennaiyin,2042,6,4,5,5,15,20,-5,17
Kerala Blast,2042,7,4,5,5,12,18,-6,17
FC Goa,2042,8,3,4,7,10,17,-7,13
Delhi Dynamo,2043,1,6,6,2,24,15,9,24
Mumbai City,2043,2,6,4,4,16,9,7,22
Kerala Blast,2043,3,5,4,5,10,15,-5,19
Kolkata,2043,4,4,6,4,16,16,0,18
FC Pune City,2043,5,5,3,6,13,15,-2,18
NorthEast Un,2043,6,4,5,5,11,11,0,17
FC Goa,2043,7,5,2,7,13,17,-4,17
Chennaiyin,2043,8,3,6,5,15,20,-5,15
Mumbai City,2044,1,6,5,3,18,10,8,23
NorthEast Un,2044,2,6,3,5,14,11,3,21
Delhi Dynamo,2044,3,4,7,3,24,18,6,19
Kolkata,2044,4,4,7,3,16,14,2,19
Kerala Blast,2044,5,5,4,5,10,15,-5,19
Chennaiyin,2044,6,4,5,5,16,21,-5,17
FC Pune City,2044,7,4,4,6,13,16,-3,16
FC Goa,2044,8,4,3,7,10,16,-6,15
Mumbai City,2045,1,7,4,3,19,10,9,25
Kolkata,2045,2,5,7,2,18,14,4,22
NorthEast Un,2045,3,6,3,5,15,13,2,21
Delhi Dynamo,2045,4,5,5,4,29,21,8,20
FC Pune City,2045,5,5,4,5,16,17,-1,19
Kerala Blast,2045,6,4,3,7,12,20,-8,15
Chennaiyin,2045,7,3,6,5,18,27,-9,15
FC Goa,2045,8,4,2,8,17,22,-5,14
Mumbai City,2046,1,6,5,3,16,8,8,23
Delhi Dynamo,2046,2,5,7,2,24,15,9,22
Kolkata,2046,3,5,6,3,17,14,3,21
Chennaiyin,2046,4,5,5,4,17,19,-2,20
NorthEast Un,2046,5,5,3,6,10,10,0,18
Kerala Blast,2046,6,5,3,6,11,17,-6,18
FC Pune City,2046,7,4,3,7,14,18,-4,15
FC Goa,2046,8,4,2,8,12,20,-8,14
Mumbai City,2047,1,6,4,4,17,10,7,22
Delhi Dynamo,2047,2,5,6,3,26,19,7,21
Kerala Blast,2047,3,5,4,5,13,16,-3,19
NorthEast Un,2047,4,5,3,6,13,13,0,18
FC Goa,2047,5,5,3,6,16,18,-2,18
FC Pune City,2047,6,5,3,6,15,18,-3,18
Kolkata,2047,7,3,8,3,16,16,0,17
Chennaiyin,2047,8,4,5,5,15,21,-6,17
Mumbai City,2048,1,7,4,3,17,8,9,25
Delhi Dynamo,2048,2,6,5,3,24,16,8,23
Kerala Blast,2048,3,6,3,5,17,21,-4,21
Kolkata,2048,4,4,7,3,16,15,1,19
Chennaiyin,2048,5,4,6,4,16,17,-1,18
NorthEast Un,2048,6,5,2,7,14,16,-2,17
FC Pune City,2048,7,4,3,7,16,20,-4,15
FC Goa,2048,8,3,4,7,8,15,-7,13
Mumbai City,2049,1,6,5,3,17,9,8,23
Kerala Blast,2049,2,6,3,5,16,17,-1,21
FC Pune City,2049,3,5,4,5,15,16,-1,19
Delhi Dynamo,2049,4,4,6,4,23,21,2,18
Chennaiyin,2049,5,4,6,4,16,19,-3,18
Kolkata,2049,6,3,8,3,17,17,0,17
NorthEast Un,2049,7,5,2,7,11,14,-3,17
FC Goa,2049,8,4,4,6,15,17,-2,16
Mumbai City,2050,1,6,4,4,17,10,7,22
Delhi Dynamo,2050,2,5,6,3,23,19,4,21
NorthEast Un,2050,3,6,2,6,16,14,2,20
Kerala Blast,2050,4,5,4,5,12,17,-5,19
FC Pune City,2050,5,5,3,6,14,16,-2,18
Kolkata,2050,6,3,8,3,15,15,0,17
Chennaiyin,2050,7,4,5,5,19,20,-1,17
FC Goa,2050,8,4,4,6,13,18,-5,16
Mumbai City,2051,1,6,4,4,16,11,5,22
Delhi Dynamo,2051,2,5,6,3,25,16,9,21
Kolkata,2051,3,5,6,3,21,18,3,21
NorthEast Un,2051,4,6,2,6,12,11,1,20
Kerala Blast,2051,5,5,4,5,11,17,-6,19
FC Goa,2051,6,4,4,6,13,16,-3,16
FC Pune City,2051,7,4,4,6,13,17,-4,16
Chennaiyin,2051,8,3,6,5,14,19,-5,15
Mumbai City,2052,1,7,4,3,20,8,12,25
Delhi Dynamo,2052,2,6,5,3,25,20,5,23
Kolkata,2052,3,5,7,2,18,13,5,22
Kerala Blast,2052,4,5,4,5,12,17,-5,19
NorthEast Un,2052,5,5,2,7,11,13,-2,17
Chennaiyin,2052,6,4,5,5,14,18,-4,17
FC Pune City,2052,7,4,4,6,13,16,-3,16
FC Goa,2052,8,3,3,8,10,18,-8,12
Mumbai City,2053,1,7,4,3,17,8,9,25
Kerala Blast,2053,2,5,5,4,10,13,-3,20
NorthEast Un,2053,3,5,4,5,13,12,1,19
FC Pune City,2053,4,5,4,5,13,14,-1,19
Delhi Dynamo,2053,5,4,6,4,24,22,2,18
Kolkata,2053,6,4,6,4,15,14,1,18
FC Goa,2053,7,4,3,7,13,17,-4,15
Chennaiyin,2053,8,3,6,5,14,19,-5,15
Mumbai City,2054,1,7,4,3,18,9,9,25
FC Pune City,2054,2,6,3,5,16,15,1,21
Chennaiyin,2054,3,5,5,4,18,19,-1,20
Kerala Blast,2054,4,5,4,5,11,16,-5,19
Delhi Dynamo,2054,5,4,6,4,22,18,4,18
NorthEast Un,2054,6,5,3,6,13,12,1,18
Kolkata,2054,7,3,6,5,15,19,-4,15
FC Goa,2054,8,4,3,7,13,18,-5,15
Mumbai City,2055,1,7,4,3,17,8,9,25
Kolkata,2055,2,5,6,3,16,14,2,21
Kerala Blast,2055,3,6,3,5,14,15,-1,21
Delhi Dynamo,2055,4,5,5,4,27,19,8,20
NorthEast Un,2055,5,6,2,6,15,15,0,20
Chennaiyin,2055,6,4,5,5,17,21,-4,17
FC Pune City,2055,7,4,3,7,13,18,-5,15
FC Goa,2055,8,4,2,8,12,21,-9,14
Mumbai City,2056,1,7,4,3,20,9,11,25
Delhi Dynamo,2056,2,6,5,3,26,18,8,23
Kerala Blast,2056,3,6,4,4,15,16,-1,22
Kolkata,2056,4,4,8,2,19,16,3,20
Chennaiyin,2056,5,4,5,5,15,18,-3,17
NorthEast Un,2056,6,5,2,7,11,15,-4,17
FC Pune City,2056,7,4,3,7,14,19,-5,15
FC Goa,2056,8,3,3,8,10,19,-9,12
Mumbai City,2057,1,7,4,3,19,9,10,25
Kerala Blast,2057,2,7,3,4,15,14,1,24
Delhi Dynamo,2057,3,4,7,3,24,19,5,19
Kolkata,2057,4,4,7,3,16,16,0,19
NorthEast Un,2057,5,5,3,6,13,12,1,18
FC Pune City,2057,6,4,3,7,13,18,-5,15
Chennaiyin,2057,7,3,6,5,14,20,-6,15
FC Goa,2057,8,3,5,6,11,17,-6,14
Mumbai City,2058,1,7,4,3,18,9,9,25
Delhi Dynamo,2058,2,4,7,3,24,18,6,19
FC Pune City,2058,3,5,4,5,16,17,-1,19
FC Goa,2058,4,5,3,6,13,17,-4,18
Kolkata,2058,5,3,8,3,15,15,0,17
Chennaiyin,2058,6,4,5,5,16,18,-2,17
Kerala Blast,2058,7,4,5,5,11,16,-5,17
NorthEast Un,2058,8,4,4,6,9,12,-3,16
Mumbai City,2059,1,7,4,3,17,8,9,25
Delhi Dynamo,2059,2,5,6,3,23,16,7,21
Kolkata,2059,3,4,7,3,15,15,0,19
Kerala Blast,2059,4,5,4,5,11,16,-5,19
FC Goa,2059,5,5,3,6,13,15,-2,18
NorthEast Un,2059,6,5,2,7,12,12,0,17
Chennaiyin,2059,7,4,5,5,15,20,-5,17
FC Pune City,2059,8,4,3,7,12,16,-4,15
Kolkata,2060,1,6,6,2,20,14,6,24
Mumbai City,2060,2,6,5,3,16,8,8,23
Delhi Dynamo,2060,3,5,6,3,25,18,7,21
NorthEast Un,2060,4,6,3,5,15,12,3,21
Kerala Blast,2060,5,4,5,5,12,18,-6,17
FC Pune City,2060,6,4,4,6,15,19,-4,16
Chennaiyin,2060,7,3,6,5,13,18,-5,15
FC Goa,2060,8,3,3,8,9,18,-9,12
Mumbai City,2061,1,7,4,3,19,8,11,25
Kerala Blast,2061,2,6,4,4,14,14,0,22
Delhi Dynamo,2061,3,5,6,3,26,19,7,21
Kolkata,2061,4,3,9,2,15,14,1,18
Chennaiyin,2061,5,4,6,4,15,18,-3,18
FC Pune City,2061,6,4,4,6,14,19,-5,16
NorthEast Un,2061,7,4,3,7,12,14,-2,15
FC Goa,2061,8,3,4,7,9,18,-9,13
Mumbai City,2062,1,7,4,3,17,8,9,25
Kerala Blast,2062,2,6,4,4,15,15,0,22
Kolkata,2062,3,5,6,3,17,15,2,21
Delhi Dynamo,2062,4,5,5,4,26,20,6,20
NorthEast Un,2062,5,5,3,6,14,15,-1,18
Chennaiyin,2062,6,3,7,4,15,19,-4,16
FC Pune City,2062,7,4,4,6,13,17,-4,16
FC Goa,2062,8,3,3,8,10,18,-8,12
Mumbai City,2063,1,7,4,3,18,8,10,25
NorthEast Un,2063,2,6,3,5,16,11,5,21
Delhi Dynamo,2063,3,5,5,4,24,22,2,20
Kolkata,2063,4,4,7,3,18,16,2,19
FC Pune City,2063,5,5,4,5,15,16,-1,19
Kerala Blast,2063,6,5,4,5,14,17,-3,19
Chennaiyin,2063,7,3,6,5,15,20,-5,15
FC Goa,2063,8,3,3,8,11,21,-10,12
Delhi Dynamo,2064,1,6,5,3,25,18,7,23
Mumbai City,2064,2,6,4,4,17,10,7,22
Kerala Blast,2064,3,6,4,4,13,15,-2,22
Kolkata,2064,4,5,6,3,21,16,5,21
NorthEast Un,2064,5,5,4,5,11,9,2,19
FC Pune City,2064,6,4,3,7,14,18,-4,15
Chennaiyin,2064,7,3,6,5,13,18,-5,15
FC Goa,2064,8,4,2,8,11,21,-10,14
Mumbai City,2065,1,6,5,3,16,8,8,23
Delhi Dynamo,2065,2,5,7,2,24,15,9,22
Kerala Blast,2065,3,6,3,5,12,15,-3,21
Kolkata,2065,4,4,7,3,14,13,1,19
FC Pune City,2065,5,5,3,6,14,16,-2,18
Chennaiyin,2065,6,4,6,4,16,19,-3,18
NorthEast Un,2065,7,4,3,7,10,13,-3,15
FC Goa,2065,8,3,4,7,10,17,-7,13
Mumbai City,2066,1,7,4,3,17,8,9,25
Delhi Dynamo,2066,2,6,5,3,27,16,11,23
Kerala Blast,2066,3,6,4,4,16,14,2,22
Kolkata,2066,4,4,8,2,16,13,3,20
Chennaiyin,2066,5,4,6,4,17,19,-2,18
FC Pune City,2066,6,4,4,6,13,20,-7,16
NorthEast Un,2066,7,4,3,7,12,14,-2,15
FC Goa,2066,8,3,2,9,9,23,-14,11
Mumbai City,2067,1,7,4,3,19,10,9,25
Kolkata,2067,2,4,7,3,17,13,4,19
NorthEast Un,2067,3,5,4,5,14,12,2,19
Kerala Blast,2067,4,5,4,5,13,19,-6,19
Delhi Dynamo,2067,5,4,6,4,25,21,4,18
Chennaiyin,2067,6,4,6,4,18,19,-1,18
FC Pune City,2067,7,4,4,6,14,18,-4,16
FC Goa,2067,8,4,3,7,10,18,-8,15
Mumbai City,2068,1,7,4,3,19,9,10,25
NorthEast Un,2068,2,6,3,5,13,9,4,21
FC Pune City,2068,3,5,4,5,15,14,1,19
Kerala Blast,2068,4,5,4,5,10,15,-5,19
Kolkata,2068,5,4,6,4,15,16,-1,18
Delhi Dynamo,2068,6,4,5,5,22,20,2,17
Chennaiyin,2068,7,3,7,4,15,19,-4,16
FC Goa,2068,8,4,3,7,11,18,-7,15
Mumbai City,2069,1,7,4,3,18,8,10,25
NorthEast Un,2069,2,6,3,5,16,13,3,21
Delhi Dynamo,2069,3,5,5,4,24,20,4,20
Kolkata,2069,4,4,8,2,17,15,2,20
FC Pune City,2069,5,5,4,5,14,15,-1,19
Kerala Blast,2069,6,4,4,6,13,19,-6,16
Chennaiyin,2069,7,3,6,5,15,20,-5,15
FC Goa,2069,8,3,4,7,10,17,-7,13
Mumbai City,2070,1,7,4,3,19,10,9,25
Kolkata,2070,2,6,6,2,22,15,7,24
NorthEast Un,2070,3,6,3,5,13,10,3,21
Delhi Dynamo,2070,4,5,5,4,27,21,6,20
FC Pune City,2070,5,5,3,6,15,16,-1,18
Chennaiyin,2070,6,4,5,5,16,19,-3,17
Kerala Blast,2070,7,4,4,6,13,22,-9,16
FC Goa,2070,8,3,2,9,11,23,-12,11
Mumbai City,2071,1,7,4,3,18,9,9,25
NorthEast Un,2071,2,6,3,5,14,9,5,21
Delhi Dynamo,2071,3,5,5,4,23,19,4,20
FC Pune City,2071,4,5,4,5,14,15,-1,19
Kerala Blast,2071,5,5,4,5,12,16,-4,19
Kolkata,2071,6,4,6,4,14,15,-1,18
Chennaiyin,2071,7,3,6,5,13,18,-5,15
FC Goa,2071,8,4,2,8,9,16,-7,14
Mumbai City,2072,1,7,4,3,19,10,9,25
FC Pune City,2072,2,6,3,5,15,15,0,21
NorthEast Un,2072,3,6,2,6,16,11,5,20
Delhi Dynamo,2072,4,5,5,4,24,20,4,20
Kerala Blast,2072,5,5,3,6,12,17,-5,18
FC Goa,2072,6,5,2,7,14,18,-4,17
Chennaiyin,2072,7,4,5,5,17,23,-6,17
Kolkata,2072,8,3,6,5,14,17,-3,15
Mumbai City,2073,1,6,4,4,17,11,6,22
FC Pune City,2073,2,6,3,5,15,14,1,21
Delhi Dynamo,2073,3,5,5,4,26,20,6,20
Kolkata,2073,4,4,6,4,14,15,-1,18
Chennaiyin,2073,5,4,6,4,16,18,-2,18
FC Goa,2073,6,5,3,6,13,16,-3,18
Kerala Blast,2073,7,5,3,6,11,15,-4,18
NorthEast Un,2073,8,5,2,7,11,14,-3,17
Mumbai City,2074,1,6,5,3,19,11,8,23
Kerala Blast,2074,2,6,3,5,11,14,-3,21
Delhi Dynamo,2074,3,4,8,2,26,19,7,20
Kolkata,2074,4,4,7,3,15,14,1,19
FC Pune City,2074,5,5,3,6,13,15,-2,18
NorthEast Un,2074,6,4,4,6,9,10,-1,16
Chennaiyin,2074,7,3,7,4,13,17,-4,16
FC Goa,2074,8,3,5,6,11,17,-6,14
Mumbai City,2075,1,7,4,3,19,9,10,25
Kolkata,2075,2,5,7,2,20,16,4,22
NorthEast Un,2075,3,6,3,5,15,11,4,21
Delhi Dynamo,2075,4,4,7,3,25,20,5,19
Chennaiyin,2075,5,4,5,5,17,19,-2,17
Kerala Blast,2075,6,4,5,5,13,19,-6,17
FC Pune City,2075,7,4,4,6,14,17,-3,16
FC Goa,2075,8,3,3,8,11,23,-12,12
Delhi Dynamo,2076,1,6,6,2,25,15,10,24
Mumbai City,2076,2,6,4,4,16,9,7,22
Kolkata,2076,3,5,6,3,19,16,3,21
Kerala Blast,2076,4,6,3,5,11,16,-5,21
NorthEast Un,2076,5,5,3,6,14,12,2,18
Chennaiyin,2076,6,4,6,4,15,18,-3,18
FC Pune City,2076,7,4,3,7,13,18,-5,15
FC Goa,2076,8,3,3,8,10,19,-9,12
Mumbai City,2077,1,6,5,3,16,8,8,23
Delhi Dynamo,2077,2,5,6,3,24,16,8,21
FC Pune City,2077,3,6,3,5,15,14,1,21
Kolkata,2077,4,4,7,3,15,14,1,19
FC Goa,2077,5,5,3,6,12,14,-2,18
Kerala Blast,2077,6,5,3,6,10,16,-6,18
NorthEast Un,2077,7,5,2,7,12,14,-2,17
Chennaiyin,2077,8,3,5,6,14,22,-8,14
Delhi Dynamo,2078,1,6,6,2,28,16,12,24
Kolkata,2078,2,6,6,2,19,13,6,24
Mumbai City,2078,3,6,4,4,17,11,6,22
Kerala Blast,2078,4,6,3,5,15,18,-3,21
Chennaiyin,2078,5,4,5,5,15,21,-6,17
NorthEast Un,2078,6,4,3,7,11,14,-3,15
FC Pune City,2078,7,4,3,7,14,20,-6,15
FC Goa,2078,8,4,2,8,12,18,-6,14
Mumbai City,2079,1,6,5,3,16,8,8,23
Delhi Dynamo,2079,2,5,6,3,24,17,7,21
Kolkata,2079,3,5,6,3,19,15,4,21
Kerala Blast,2079,4,6,3,5,13,16,-3,21
NorthEast Un,2079,5,6,2,6,15,15,0,20
FC Pune City,2079,6,5,3,6,14,16,-2,18
Chennaiyin,2079,7,3,5,6,15,21,-6,14
FC Goa,2079,8,4,2,8,9,17,-8,14
Mumbai City,2080,1,7,4,3,18,9,9,25
Delhi Dynamo,2080,2,6,5,3,27,17,10,23
NorthEast Un,2080,3,6,2,6,11,10,1,20
Kerala Blast,2080,4,5,4,5,13,17,-4,19
Kolkata,2080,5,3,8,3,15,15,0,17
Chennaiyin,2080,6,4,5,5,17,18,-1,17
FC Pune City,2080,7,4,5,5,15,17,-2,17
FC Goa,2080,8,3,3,8,9,22,-13,12
Kolkata,2081,1,6,6,2,19,14,5,24
Mumbai City,2081,2,6,5,3,17,9,8,23
Delhi Dynamo,2081,3,5,6,3,26,19,7,21
Chennaiyin,2081,4,5,5,4,16,18,-2,20
NorthEast Un,2081,5,5,3,6,12,12,0,18
Kerala Blast,2081,6,4,5,5,10,15,-5,17
FC Pune City,2081,7,4,4,6,14,17,-3,16
FC Goa,2081,8,3,2,9,11,21,-10,11
Delhi Dynamo,2082,1,6,5,3,24,16,8,23
Mumbai City,2082,2,6,4,4,16,9,7,22
Kolkata,2082,3,5,7,2,17,13,4,22
Kerala Blast,2082,4,5,4,5,10,15,-5,19
NorthEast Un,2082,5,5,2,7,11,12,-1,17
Chennaiyin,2082,6,4,5,5,17,20,-3,17
FC Pune City,2082,7,4,4,6,12,15,-3,16
FC Goa,2082,8,4,3,7,12,19,-7,15
Mumbai City,2083,1,7,4,3,21,8,13,25
Kolkata,2083,2,5,6,3,17,15,2,21
NorthEast Un,2083,3,6,2,6,14,12,2,20
Kerala Blast,2083,4,5,4,5,11,15,-4,19
Delhi Dynamo,2083,5,4,6,4,22,23,-1,18
Chennaiyin,2083,6,4,5,5,17,20,-3,17
FC Pune City,2083,7,4,4,6,12,16,-4,16
FC Goa,2083,8,4,3,7,13,18,-5,15
Mumbai City,2084,1,7,4,3,18,8,10,25
Kerala Blast,2084,2,7,3,4,14,14,0,24
Delhi Dynamo,2084,3,6,5,3,25,17,8,23
Kolkata,2084,4,4,6,4,17,17,0,18
NorthEast Un,2084,5,5,2,7,10,13,-3,17
FC Goa,2084,6,5,2,7,14,19,-5,17
FC Pune City,2084,7,4,3,7,14,18,-4,15
Chennaiyin,2084,8,3,5,6,14,20,-6,14
Mumbai City,2085,1,6,4,4,16,10,6,22
Delhi Dynamo,2085,2,5,6,3,24,17,7,21
FC Pune City,2085,3,6,3,5,15,15,0,21
Kolkata,2085,4,4,7,3,20,19,1,19
NorthEast Un,2085,5,5,3,6,11,10,1,18
Chennaiyin,2085,6,4,6,4,16,18,-2,18
Kerala Blast,2085,7,5,3,6,13,18,-5,18
FC Goa,2085,8,3,4,7,12,20,-8,13
Delhi Dynamo,2086,1,5,7,2,26,18,8,22
Mumbai City,2086,2,6,4,4,18,11,7,22
Kolkata,2086,3,5,6,3,21,18,3,21
Kerala Blast,2086,4,6,3,5,15,16,-1,21
NorthEast Un,2086,5,4,4,6,11,14,-3,16
Chennaiyin,2086,6,3,7,4,15,19,-4,16
FC Goa,2086,7,4,4,6,12,17,-5,16
FC Pune City,2086,8,4,3,7,15,20,-5,15
Mumbai City,2087,1,6,5,3,17,9,8,23
Delhi Dynamo,2087,2,5,6,3,23,16,7,21
Kolkata,2087,3,4,8,2,14,12,2,20
Kerala Blast,2087,4,5,5,4,13,16,-3,20
Chennaiyin,2087,5,4,6,4,16,19,-3,18
NorthEast Un,2087,6,4,4,6,13,14,-1,16
FC Pune City,2087,7,4,4,6,12,15,-3,16
FC Goa,2087,8,4,2,8,10,17,-7,14
Mumbai City,2088,1,7,4,3,19,8,11,25
Delhi Dynamo,2088,2,5,6,3,25,20,5,21
Kolkata,2088,3,5,6,3,19,15,4,21
Chennaiyin,2088,4,5,5,4,19,19,0,20
NorthEast Un,2088,5,5,3,6,13,14,-1,18
FC Pune City,2088,6,5,3,6,14,18,-4,18
Kerala Blast,2088,7,5,3,6,11,17,-6,18
FC Goa,2088,8,3,2,9,11,20,-9,11
Delhi Dynamo,2089,1,7,5,2,29,17,12,26
Mumbai City,2089,2,6,4,4,18,11,7,22
Kerala Blast,2089,3,5,4,5,15,17,-2,19
Kolkata,2089,4,4,6,4,18,16,2,18
Chennaiyin,2089,5,4,6,4,16,19,-3,18
FC Pune City,2089,6,5,3,6,15,21,-6,18
NorthEast Un,2089,7,4,3,7,11,13,-2,15
FC Goa,2089,8,4,3,7,11,19,-8,15
Kolkata,2090,1,6,6,2,17,13,4,24
Mumbai City,2090,2,6,5,3,16,8,8,23
NorthEast Un,2090,3,6,3,5,14,11,3,21
Delhi Dynamo,2090,4,4,7,3,23,18,5,19
Kerala Blast,2090,5,5,3,6,11,16,-5,18
Chennaiyin,2090,6,4,5,5,16,21,-5,17
FC Pune City,2090,7,4,3,7,14,18,-4,15
FC Goa,2090,8,4,2,8,12,18,-6,14
Mumbai City,2091,1,7,4,3,18,9,9,25
Kolkata,2091,2,6,6,2,18,13,5,24
NorthEast Un,2091,3,6,2,6,16,13,3,20
FC Pune City,2091,4,5,3,6,13,15,-2,18
Kerala Blast,2091,5,5,3,6,12,17,-5,18
Delhi Dynamo,2091,6,4,5,5,22,21,1,17
FC Goa,2091,7,5,2,7,12,16,-4,17
Chennaiyin,2091,8,3,5,6,15,22,-7,14
Delhi Dynamo,2092,1,6,6,2,27,16,11,24
Mumbai City,2092,2,6,5,3,16,8,8,23
FC Pune City,2092,3,6,3,5,16,14,2,21
NorthEast Un,2092,4,5,3,6,13,13,0,18
FC Goa,2092,5,5,2,7,11,17,-6,17
Kerala Blast,2092,6,4,5,5,10,16,-6,17
Kolkata,2092,7,3,7,4,13,16,-3,16
Chennaiyin,2092,8,3,5,6,13,19,-6,14
Mumbai City,2093,1,6,5,3,18,10,8,23
FC Goa,2093,2,6,2,6,12,14,-2,20
Delhi Dynamo,2093,3,4,7,3,25,19,6,19
Kerala Blast,2093,4,5,4,5,14,18,-4,19
NorthEast Un,2093,5,5,3,6,13,14,-1,18
FC Pune City,2093,6,4,5,5,14,16,-2,17
Chennaiyin,2093,7,4,5,5,15,19,-4,17
Kolkata,2093,8,3,7,4,16,17,-1,16
Kolkata,2094,1,6,6,2,19,12,7,24
Mumbai City,2094,2,6,4,4,16,11,5,22
Delhi Dynamo,2094,3,5,6,3,26,17,9,21
NorthEast Un,2094,4,6,2,6,13,11,2,20
Chennaiyin,2094,5,5,5,4,15,17,-2,20
Kerala Blast,2094,6,5,3,6,12,21,-9,18
FC Pune City,2094,7,4,3,7,14,18,-4,15
FC Goa,2094,8,3,3,8,9,17,-8,12
Mumbai City,2095,1,7,4,3,18,8,10,25
Kerala Blast,2095,2,6,4,4,15,15,0,22
Delhi Dynamo,2095,3,5,6,3,26,17,9,21
Kolkata,2095,4,3,8,3,15,15,0,17
Chennaiyin,2095,5,4,5,5,16,20,-4,17
NorthEast Un,2095,6,4,4,6,13,14,-1,16
FC Pune City,2095,7,4,4,6,13,18,-5,16
FC Goa,2095,8,4,3,7,9,18,-9,15
Mumbai City,2096,1,6,4,4,17,11,6,22
Kolkata,2096,2,5,7,2,18,14,4,22
Delhi Dynamo,2096,3,5,5,4,24,18,6,20
Kerala Blast,2096,4,5,4,5,14,17,-3,19
NorthEast Un,2096,5,5,3,6,11,10,1,18
Chennaiyin,2096,6,4,6,4,15,18,-3,18
FC Goa,2096,7,4,4,6,11,16,-5,16
FC Pune City,2096,8,4,3,7,14,20,-6,15
Mumbai City,2097,1,7,4,3,17,8,9,25
Kerala Blast,2097,2,5,5,4,12,14,-2,20
Kolkata,2097,3,4,7,3,17,16,1,19
NorthEast Un,2097,4,5,4,5,13,12,1,19
Delhi Dynamo,2097,5,4,6,4,22,17,5,18
Chennaiyin,2097,6,4,6,4,17,19,-2,18
FC Pune City,2097,7,4,3,7,12,17,-5,15
FC Goa,2097,8,4,3,7,11,18,-7,15
Mumbai City,2098,1,7,4,3,19,9,10,25
Delhi Dynamo,2098,2,5,6,3,25,19,6,21
NorthEast Un,2098,3,5,4,5,14,11,3,19
FC Pune City,2098,4,5,3,6,17,17,0,18
Kolkata,2098,5,4,6,4,17,21,-4,18
Kerala Blast,2098,6,5,3,6,12,18,-6,18
Chennaiyin,2098,7,3,7,4,16,20,-4,16
FC Goa,2098,8,4,3,7,15,20,-5,15
Mumbai City,2099,1,7,4,3,19,10,9,25
Delhi Dynamo,2099,2,6,5,3,26,17,9,23
Kolkata,2099,3,4,8,2,18,16,2,20
Kerala Blast,2099,4,5,4,5,11,15,-4,19
NorthEast Un,2099,5,5,3,6,12,13,-1,18
Chennaiyin,2099,6,3,7,4,16,20,-4,16
FC Pune City,2099,7,4,3,7,14,18,-4,15
FC Goa,2099,8,3,4,7,10,17,-7,13
Mumbai City,2100,1,7,4,3,18,9,9,25
Delhi Dynamo,2100,2,5,6,3,26,17,9,21
Kolkata,2100,3,5,6,3,18,15,3,21
Chennaiyin,2100,4,5,5,4,17,17,0,20
Kerala Blast,2100,5,5,3,6,10,16,-6,18
NorthEast Un,2100,6,5,2,7,10,14,-4,17
FC Pune City,2100,7,4,3,7,13,17,-4,15
FC Goa,2100,8,4,3,7,11,18,-7,15
Mumbai City,2101,1,7,4,3,17,8,9,25
Kerala Blast,2101,2,6,4,4,14,16,-2,22
Kolkata,2101,3,4,8,2,15,13,2,20
NorthEast Un,2101,4,5,3,6,13,13,0,18
Delhi Dynamo,2101,5,4,5,5,23,20,3,17
Chennaiyin,2101,6,3,7,4,16,20,-4,16
FC Goa,2101,7,4,4,6,13,17,-4,16
FC Pune City,2101,8,4,3,7,13,17,-4,15
Mumbai City,2102,1,7,4,3,22,9,13,25
Kerala Blast,2102,2,7,3,4,12,13,-1,24
Kolkata,2102,3,5,6,3,17,14,3,21
Delhi Dynamo,2102,4,4,7,3,25,23,2,19
Chennaiyin,2102,5,4,6,4,17,19,-2,18
NorthEast Un,2102,6,4,3,7,11,14,-3,15
FC Pune City,2102,7,4,3,7,13,18,-5,15
FC Goa,2102,8,3,4,7,11,18,-7,13
Mumbai City,2103,1,7,4,3,18,8,10,25
Delhi Dynamo,2103,2,5,6,3,25,17,8,21
Kolkata,2103,3,4,8,2,16,14,2,20
NorthEast Un,2103,4,5,4,5,12,10,2,19
Chennaiyin,2103,5,4,6,4,16,18,-2,18
Kerala Blast,2103,6,5,3,6,11,16,-5,18
FC Pune City,2103,7,4,4,6,13,17,-4,16
FC Goa,2103,8,3,3,8,10,21,-11,12
Mumbai City,2104,1,7,4,3,19,10,9,25
Kerala Blast,2104,2,6,4,4,12,13,-1,22
Delhi Dynamo,2104,3,5,6,3,24,17,7,21
Kolkata,2104,4,4,8,2,16,14,2,20
FC Goa,2104,5,4,4,6,10,15,-5,16
NorthEast Un,2104,6,4,3,7,9,11,-2,15
Chennaiyin,2104,7,3,6,5,13,18,-5,15
FC Pune City,2104,7,4,3,7,13,18,-5,15
Mumbai City,2105,1,7,4,3,18,9,9,25
Kolkata,2105,2,6,6,2,22,16,6,24
Delhi Dynamo,2105,3,5,6,3,28,18,10,21
Kerala Blast,2105,4,6,3,5,12,14,-2,21
Chennaiyin,2105,5,4,6,4,16,19,-3,18
NorthEast Un,2105,6,4,4,6,13,14,-1,16
FC Pune City,2105,7,4,3,7,12,19,-7,15
FC Goa,2105,8,3,2,9,12,24,-12,11
Mumbai City,2106,1,7,4,3,19,9,10,25
NorthEast Un,2106,2,7,2,5,14,10,4,23
Kolkata,2106,3,5,7,2,18,13,5,22
Delhi Dynamo,2106,4,4,6,4,24,21,3,18
FC Pune City,2106,5,4,5,5,16,18,-2,17
Chennaiyin,2106,6,4,5,5,16,20,-4,17
Kerala Blast,2106,7,4,4,6,12,19,-7,16
FC Goa,2106,8,3,3,8,11,20,-9,12
Delhi Dynamo,2107,1,6,6,2,23,14,9,24
Mumbai City,2107,2,6,5,3,16,8,8,23
Kolkata,2107,3,5,6,3,18,16,2,21
Kerala Blast,2107,4,6,3,5,12,15,-3,21
FC Pune City,2107,5,5,3,6,14,16,-2,18
Chennaiyin,2107,6,4,5,5,20,22,-2,17
NorthEast Un,2107,7,4,2,8,10,15,-5,14
FC Goa,2107,8,4,2,8,13,20,-7,14
Delhi Dynamo,2108,1,6,6,2,31,20,11,24
Mumbai City,2108,2,6,4,4,19,12,7,22
NorthEast Un,2108,3,5,4,5,14,13,1,19
Kolkata,2108,4,3,9,2,14,13,1,18
Kerala Blast,2108,5,4,6,4,11,15,-4,18
FC Pune City,2108,6,4,5,5,13,15,-2,17
Chennaiyin,2108,7,4,5,5,14,18,-4,17
FC Goa,2108,8,3,3,8,9,19,-10,12
Mumbai City,2109,1,7,4,3,18,8,10,25
Delhi Dynamo,2109,2,5,6,3,25,17,8,21
Kolkata,2109,3,4,7,3,17,15,2,19
NorthEast Un,2109,4,5,3,6,14,15,-1,18
Chennaiyin,2109,5,4,6,4,15,18,-3,18
FC Pune City,2109,6,4,5,5,14,16,-2,17
Kerala Blast,2109,7,4,4,6,12,20,-8,16
FC Goa,2109,8,4,3,7,11,17,-6,15
Mumbai City,2110,1,7,4,3,18,8,10,25
FC Goa,2110,2,6,2,6,15,16,-1,20
NorthEast Un,2110,3,5,3,6,14,12,2,18
Kerala Blast,2110,4,4,6,4,14,18,-4,18
Delhi Dynamo,2110,5,4,5,5,21,20,1,17
Kolkata,2110,6,3,8,3,16,17,-1,17
FC Pune City,2110,7,4,5,5,14,16,-2,17
Chennaiyin,2110,8,4,5,5,16,21,-5,17
Mumbai City,2111,1,7,4,3,17,8,9,25
Kolkata,2111,2,5,7,2,17,14,3,22
Delhi Dynamo,2111,3,4,7,3,22,16,6,19
Kerala Blast,2111,4,5,4,5,12,15,-3,19
NorthEast Un,2111,5,5,3,6,11,12,-1,18
Chennaiyin,2111,6,4,5,5,15,19,-4,17
FC Pune City,2111,7,4,4,6,13,16,-3,16
FC Goa,2111,8,3,4,7,11,18,-7,13
Delhi Dynamo,2112,1,6,5,3,25,17,8,23
Mumbai City,2112,2,6,4,4,17,10,7,22
Kerala Blast,2112,3,5,5,4,12,15,-3,20
NorthEast Un,2112,4,5,3,6,11,11,0,18
FC Goa,2112,5,5,3,6,11,15,-4,18
Kolkata,2112,6,3,8,3,15,15,0,17
FC Pune City,2112,7,4,5,5,13,15,-2,17
Chennaiyin,2112,8,3,5,6,13,19,-6,14
Mumbai City,2113,1,6,5,3,16,8,8,23
Kerala Blast,2113,2,6,3,5,16,16,0,21
FC Goa,2113,3,6,2,6,14,17,-3,20
Delhi Dynamo,2113,4,4,7,3,22,16,6,19
FC Pune City,2113,5,5,4,5,14,15,-1,19
NorthEast Un,2113,6,5,3,6,10,12,-2,18
Kolkata,2113,7,3,7,4,16,18,-2,16
Chennaiyin,2113,8,3,5,6,15,21,-6,14
Mumbai City,2114,1,7,4,3,21,9,12,25
Kolkata,2114,2,5,7,2,16,13,3,22
Kerala Blast,2114,3,6,3,5,12,14,-2,21
NorthEast Un,2114,4,6,2,6,12,11,1,20
Delhi Dynamo,2114,5,4,5,5,22,21,1,17
Chennaiyin,2114,6,4,5,5,16,19,-3,17
FC Pune City,2114,7,4,3,7,13,18,-5,15
FC Goa,2114,8,4,3,7,9,16,-7,15
Kolkata,2115,1,6,6,2,23,17,6,24
Mumbai City,2115,2,6,5,3,17,9,8,23
Delhi Dynamo,2115,3,5,6,3,23,17,6,21
Kerala Blast,2115,4,6,3,5,14,18,-4,21
NorthEast Un,2115,5,6,2,6,16,11,5,20
Chennaiyin,2115,6,4,5,5,14,21,-7,17
FC Pune City,2115,7,4,3,7,15,19,-4,15
FC Goa,2115,8,3,2,9,8,18,-10,11
Delhi Dynamo,2116,1,5,7,2,24,16,8,22
Mumbai City,2116,2,6,4,4,16,9,7,22
Kolkata,2116,3,5,6,3,19,17,2,21
FC Pune City,2116,4,5,3,6,16,17,-1,18
NorthEast Un,2116,5,4,5,5,13,13,0,17
FC Goa,2116,6,4,4,6,14,17,-3,16
Chennaiyin,2116,7,3,7,4,18,22,-4,16
Kerala Blast,2116,8,4,4,6,11,20,-9,16
Mumbai City,2117,1,6,5,3,18,10,8,23
Delhi Dynamo,2117,2,4,7,3,26,20,6,19
Kolkata,2117,3,4,7,3,16,15,1,19
NorthEast Un,2117,4,5,3,6,12,12,0,18
FC Goa,2117,5,5,3,6,13,16,-3,18
Kerala Blast,2117,6,4,6,4,12,16,-4,18
Chennaiyin,2117,7,4,5,5,14,19,-5,17
FC Pune City,2117,8,4,4,6,14,17,-3,16
Mumbai City,2118,1,7,4,3,20,10,10,25
Kerala Blast,2118,2,6,4,4,12,13,-1,22
Kolkata,2118,3,4,8,2,15,13,2,20
Delhi Dynamo,2118,4,4,5,5,24,22,2,17
NorthEast Un,2118,5,5,2,7,11,13,-2,17
Chennaiyin,2118,6,4,5,5,15,19,-4,17
FC Goa,2118,7,5,2,7,13,17,-4,17
FC Pune City,2118,8,4,4,6,12,15,-3,16
Mumbai City,2119,1,7,4,3,18,8,10,25
Kerala Blast,2119,2,6,4,4,16,17,-1,22
Chennaiyin,2119,3,5,5,4,17,17,0,20
Delhi Dynamo,2119,4,4,6,4,27,23,4,18
Kolkata,2119,5,3,9,2,16,15,1,18
FC Pune City,2119,6,4,4,6,15,18,-3,16
NorthEast Un,2119,7,4,3,7,12,17,-5,15
FC Goa,2119,8,4,3,7,12,18,-6,15
Mumbai City,2120,1,7,4,3,17,8,9,25
Kolkata,2120,2,5,7,2,19,15,4,22
Kerala Blast,2120,3,6,4,4,14,15,-1,22
Delhi Dynamo,2120,4,4,7,3,23,17,6,19
Chennaiyin,2120,5,4,6,4,16,19,-3,18
NorthEast Un,2120,6,4,4,6,13,15,-2,16
FC Pune City,2120,7,4,3,7,13,18,-5,15
FC Goa,2120,8,3,3,8,10,18,-8,12
Delhi Dynamo,2121,1,6,6,2,23,14,9,24
Mumbai City,2121,2,6,5,3,16,8,8,23
Chennaiyin,2121,3,5,5,4,17,17,0,20
Kerala Blast,2121,4,5,4,5,11,14,-3,19
FC Pune City,2121,5,5,3,6,14,17,-3,18
NorthEast Un,2121,6,5,2,7,10,11,-1,17
Kolkata,2121,7,3,7,4,14,16,-2,16
FC Goa,2121,8,4,2,8,10,18,-8,14
Delhi Dynamo,2122,1,7,5,2,29,16,13,26
Mumbai City,2122,2,6,4,4,18,12,6,22
Kolkata,2122,3,5,6,3,21,16,5,21
Chennaiyin,2122,4,5,5,4,18,19,-1,20
Kerala Blast,2122,5,5,4,5,12,18,-6,19
FC Pune City,2122,6,5,3,6,14,17,-3,18
NorthEast Un,2122,7,4,3,7,10,14,-4,15
FC Goa,2122,8,3,2,9,10,20,-10,11
Mumbai City,2123,1,7,4,3,17,8,9,25
Delhi Dynamo,2123,2,5,6,3,25,17,8,21
Kolkata,2123,3,4,7,3,17,14,3,19
FC Pune City,2123,4,5,4,5,15,16,-1,19
Chennaiyin,2123,5,4,5,5,15,19,-4,17
Kerala Blast,2123,6,4,5,5,13,20,-7,17
NorthEast Un,2123,7,4,4,6,12,14,-2,16
FC Goa,2123,8,4,3,7,10,16,-6,15
Mumbai City,2124,1,6,5,3,17,9,8,23
Kerala Blast,2124,2,6,3,5,13,14,-1,21
Delhi Dynamo,2124,3,4,8,2,25,18,7,20
Chennaiyin,2124,4,4,6,4,19,20,-1,18
NorthEast Un,2124,5,5,3,6,12,14,-2,18
FC Pune City,2124,6,5,3,6,14,17,-3,18
Kolkata,2124,7,3,7,4,17,19,-2,16
FC Goa,2124,8,3,5,6,15,21,-6,14
Mumbai City,2125,1,7,4,3,18,9,9,25
Kerala Blast,2125,2,7,3,4,17,17,0,24
Delhi Dynamo,2125,3,5,6,3,26,19,7,21
Chennaiyin,2125,4,5,5,4,18,18,0,20
Kolkata,2125,5,4,7,3,17,16,1,19
FC Pune City,2125,6,4,3,7,14,19,-5,15
NorthEast Un,2125,7,4,2,8,11,14,-3,14
FC Goa,2125,8,3,4,7,13,22,-9,13
Mumbai City,2126,1,7,4,3,17,8,9,25
Delhi Dynamo,2126,2,6,5,3,25,15,10,23
Kolkata,2126,3,4,8,2,17,15,2,20
Kerala Blast,2126,4,5,4,5,11,15,-4,19
FC Pune City,2126,5,4,5,5,12,14,-2,17
NorthEast Un,2126,6,5,2,7,10,12,-2,17
FC Goa,2126,7,4,3,7,13,18,-5,15
Chennaiyin,2126,8,3,5,6,13,21,-8,14
Delhi Dynamo,2127,1,6,5,3,28,17,11,23
Mumbai City,2127,2,6,4,4,17,10,7,22
Kolkata,2127,3,5,6,3,19,15,4,21
Kerala Blast,2127,4,5,4,5,14,18,-4,19
Chennaiyin,2127,5,4,6,4,14,17,-3,18
NorthEast Un,2127,6,5,2,7,11,13,-2,17
FC Pune City,2127,7,4,4,6,14,18,-4,16
FC Goa,2127,8,4,3,7,10,19,-9,15
Mumbai City,2128,1,7,4,3,19,9,10,25
Delhi Dynamo,2128,2,5,5,4,23,19,4,20
Kolkata,2128,3,4,8,2,17,15,2,20
Chennaiyin,2128,4,5,5,4,17,18,-1,20
Kerala Blast,2128,5,5,4,5,11,15,-4,19
FC Pune City,2128,6,4,4,6,15,18,-3,16
NorthEast Un,2128,7,4,3,7,10,12,-2,15
FC Goa,2128,8,4,3,7,11,17,-6,15
Delhi Dynamo,2129,1,7,5,2,30,20,10,26
Mumbai City,2129,2,6,4,4,18,11,7,22
Kerala Blast,2129,3,6,4,4,12,14,-2,22
Kolkata,2129,4,4,6,4,14,15,-1,18
FC Pune City,2129,5,4,4,6,12,15,-3,16
Chennaiyin,2129,6,3,7,4,14,18,-4,16
NorthEast Un,2129,7,4,3,7,12,14,-2,15
FC Goa,2129,8,4,3,7,13,18,-5,15
Mumbai City,2130,1,7,4,3,19,9,10,25
Delhi Dynamo,2130,2,6,5,3,25,17,8,23
Kolkata,2130,3,5,6,3,17,13,4,21
NorthEast Un,2130,4,5,3,6,15,15,0,18
FC Pune City,2130,5,5,3,6,13,16,-3,18
FC Goa,2130,6,5,2,7,10,15,-5,17
Chennaiyin,2130,7,3,6,5,15,20,-5,15
Kerala Blast,2130,8,4,3,7,11,20,-9,15
Mumbai City,2131,1,7,4,3,20,9,11,25
Kolkata,2131,2,5,7,2,19,15,4,22
Kerala Blast,2131,3,5,4,5,13,16,-3,19
Delhi Dynamo,2131,4,4,6,4,23,20,3,18
FC Pune City,2131,5,4,5,5,15,17,-2,17
Chennaiyin,2131,6,4,5,5,15,18,-3,17
FC Goa,2131,7,5,2,7,11,17,-6,17
NorthEast Un,2131,8,4,3,7,9,13,-4,15
Delhi Dynamo,2132,1,6,6,2,26,17,9,24
Mumbai City,2132,2,6,5,3,16,8,8,23
Kerala Blast,2132,3,6,3,5,13,14,-1,21
Kolkata,2132,4,4,8,2,15,13,2,20
FC Pune City,2132,5,4,4,6,12,16,-4,16
NorthEast Un,2132,6,4,3,7,11,14,-3,15
FC Goa,2132,7,4,3,7,13,17,-4,15
Chennaiyin,2132,8,3,6,5,13,20,-7,15
Delhi Dynamo,2133,1,6,6,2,24,15,9,24
Mumbai City,2133,2,6,4,4,17,10,7,22
Kerala Blast,2133,3,6,4,4,15,16,-1,22
Chennaiyin,2133,4,5,5,4,17,18,-1,20
Kolkata,2133,5,4,7,3,17,17,0,19
FC Pune City,2133,6,4,3,7,14,18,-4,15
FC Goa,2133,7,4,3,7,10,16,-6,15
NorthEast Un,2133,8,4,2,8,10,14,-4,14
Mumbai City,2134,1,6,4,4,16,10,6,22
Delhi Dynamo,2134,2,5,6,3,26,19,7,21
NorthEast Un,2134,3,6,3,5,15,13,2,21
Kolkata,2134,4,4,7,3,18,17,1,19
FC Pune City,2134,5,5,3,6,15,17,-2,18
Kerala Blast,2134,6,5,3,6,12,17,-5,18
FC Goa,2134,7,4,4,6,13,17,-4,16
Chennaiyin,2134,8,3,6,5,15,20,-5,15
Mumbai City,2135,1,6,4,4,16,9,7,22
Delhi Dynamo,2135,2,5,6,3,24,17,7,21
NorthEast Un,2135,3,5,4,5,12,11,1,19
FC Pune City,2135,4,5,4,5,15,15,0,19
Kerala Blast,2135,5,5,4,5,11,15,-4,19
Chennaiyin,2135,6,4,6,4,15,18,-3,18
FC Goa,2135,7,5,2,7,14,16,-2,17
Kolkata,2135,8,3,6,5,13,19,-6,15
Mumbai City,2136,1,7,4,3,20,9,11,25
Delhi Dynamo,2136,2,5,6,3,23,18,5,21
Kolkata,2136,3,4,7,3,16,16,0,19
Kerala Blast,2136,4,4,6,4,12,16,-4,18
NorthEast Un,2136,5,4,5,5,11,11,0,17
FC Pune City,2136,6,4,4,6,14,17,-3,16
Chennaiyin,2136,7,3,7,4,16,20,-4,16
FC Goa,2136,8,4,3,7,12,17,-5,15
Delhi Dynamo,2137,1,5,7,2,24,16,8,22
Mumbai City,2137,2,6,4,4,16,9,7,22
Kerala Blast,2137,3,6,3,5,13,15,-2,21
Kolkata,2137,4,4,7,3,16,15,1,19
NorthEast Un,2137,5,5,3,6,14,13,1,18
FC Pune City,2137,6,5,3,6,13,16,-3,18
FC Goa,2137,7,4,4,6,10,15,-5,16
Chennaiyin,2137,8,3,5,6,13,20,-7,14
Mumbai City,2138,1,7,4,3,19,9,10,25
NorthEast Un,2138,2,6,3,5,13,11,2,21
Delhi Dynamo,2138,3,5,5,4,25,19,6,20
Kerala Blast,2138,4,5,5,4,13,16,-3,20
Kolkata,2138,5,4,6,4,16,15,1,18
FC Goa,2138,6,5,2,7,11,17,-6,17
FC Pune City,2138,7,4,4,6,13,17,-4,16
Chennaiyin,2138,8,3,5,6,14,20,-6,14
Mumbai City,2139,1,6,5,3,17,9,8,23
NorthEast Un,2139,2,7,2,5,19,12,7,23
Delhi Dynamo,2139,3,5,6,3,25,20,5,21
Kerala Blast,2139,4,6,3,5,16,19,-3,21
Kolkata,2139,5,4,7,3,19,17,2,19
FC Pune City,2139,6,4,3,7,14,20,-6,15
FC Goa,2139,7,4,3,7,13,19,-6,15
Chennaiyin,2139,8,3,5,6,16,23,-7,14
Mumbai City,2140,1,7,4,3,18,8,10,25
Kolkata,2140,2,5,7,2,21,15,6,22
Delhi Dynamo,2140,3,5,6,3,25,18,7,21
Kerala Blast,2140,4,6,3,5,14,17,-3,21
NorthEast Un,2140,5,5,2,7,12,13,-1,17
FC Goa,2140,6,4,4,6,12,16,-4,16
FC Pune City,2140,7,4,3,7,14,21,-7,15
Chennaiyin,2140,8,3,5,6,13,21,-8,14
Delhi Dynamo,2141,1,7,5,2,26,14,12,26
Mumbai City,2141,2,6,4,4,16,9,7,22
Kolkata,2141,3,4,7,3,16,15,1,19
NorthEast Un,2141,4,5,3,6,10,10,0,18
Kerala Blast,2141,5,4,5,5,10,15,-5,17
FC Pune City,2141,6,4,4,6,14,17,-3,16
Chennaiyin,2141,7,3,7,4,14,18,-4,16
FC Goa,2141,8,4,3,7,11,19,-8,15
Mumbai City,2142,1,6,5,3,16,8,8,23
Kerala Blast,2142,2,6,4,4,14,16,-2,22
Kolkata,2142,3,5,6,3,17,15,2,21
NorthEast Un,2142,4,6,2,6,16,11,5,20
Delhi Dynamo,2142,5,4,7,3,22,16,6,19
FC Pune City,2142,6,4,4,6,15,18,-3,16
Chennaiyin,2142,7,3,6,5,13,22,-9,15
FC Goa,2142,8,3,4,7,8,15,-7,13
Mumbai City,2143,1,7,4,3,18,9,9,25
Delhi Dynamo,2143,2,5,6,3,25,18,7,21
FC Pune City,2143,3,6,3,5,16,15,1,21
Kerala Blast,2143,4,6,3,5,14,15,-1,21
Chennaiyin,2143,5,4,6,4,16,19,-3,18
Kolkata,2143,6,3,7,4,14,17,-3,16
NorthEast Un,2143,7,4,3,7,11,14,-3,15
FC Goa,2143,8,3,4,7,11,18,-7,13
Mumbai City,2144,1,6,5,3,16,8,8,23
Kolkata,2144,2,5,6,3,17,14,3,21
NorthEast Un,2144,3,6,3,5,16,14,2,21
Delhi Dynamo,2144,4,4,8,2,25,18,7,20
Kerala Blast,2144,5,5,3,6,13,18,-5,18
Chennaiyin,2144,6,4,5,5,16,20,-4,17
FC Pune City,2144,7,4,3,7,13,18,-5,15
FC Goa,2144,8,4,3,7,12,18,-6,15
Mumbai City,2145,1,7,4,3,17,8,9,25
Delhi Dynamo,2145,2,5,5,4,23,17,6,20
Kolkata,2145,3,4,7,3,17,16,1,19
NorthEast Un,2145,4,5,4,5,12,11,1,19
Kerala Blast,2145,5,5,4,5,13,17,-4,19
FC Pune City,2145,6,5,3,6,14,16,-2,18
Chennaiyin,2145,7,3,7,4,15,19,-4,16
FC Goa,2145,8,3,4,7,10,17,-7,13
Delhi Dynamo,2146,1,6,6,2,31,19,12,24
Mumbai City,2146,2,6,4,4,18,12,6,22
Kerala Blast,2146,3,5,4,5,13,16,-3,19
Kolkata,2146,4,3,9,2,16,15,1,18
NorthEast Un,2146,5,5,2,7,13,16,-3,17
Chennaiyin,2146,6,4,5,5,16,21,-5,17
FC Pune City,2146,7,4,4,6,13,17,-4,16
FC Goa,2146,8,4,4,6,12,16,-4,16
Mumbai City,2147,1,7,4,3,18,8,10,25
Delhi Dynamo,2147,2,6,5,3,26,18,8,23
Kerala Blast,2147,3,6,4,4,11,13,-2,22
Kolkata,2147,4,4,6,4,14,14,0,18
NorthEast Un,2147,5,5,2,7,13,14,-1,17
FC Goa,2147,6,5,2,7,12,18,-6,17
FC Pune City,2147,7,4,4,6,12,15,-3,16
Chennaiyin,2147,8,3,5,6,16,22,-6,14
Delhi Dynamo,2148,1,6,6,2,29,17,12,24
Mumbai City,2148,2,6,4,4,17,10,7,22
FC Pune City,2148,3,5,4,5,15,15,0,19
Kolkata,2148,4,4,6,4,16,18,-2,18
NorthEast Un,2148,5,4,5,5,11,11,0,17
Kerala Blast,2148,6,4,5,5,10,15,-5,17
FC Goa,2148,7,5,2,7,14,21,-7,17
Chennaiyin,2148,8,3,6,5,14,19,-5,15
Mumbai City,2149,1,7,4,3,18,8,10,25
Delhi Dynamo,2149,2,5,6,3,24,18,6,21
Kerala Blast,2149,3,6,3,5,17,17,0,21
FC Pune City,2149,4,5,4,5,16,16,0,19
Kolkata,2149,5,4,7,3,17,18,-1,19
NorthEast Un,2149,6,5,3,6,11,13,-2,18
Chennaiyin,2149,7,3,5,6,15,21,-6,14
FC Goa,2149,8,4,2,8,13,20,-7,14
NorthEast Un,2150,1,7,2,5,16,10,6,23
Mumbai City,2150,2,6,4,4,17,10,7,22
Delhi Dynamo,2150,3,5,6,3,24,20,4,21
Kolkata,2150,4,4,8,2,15,13,2,20
FC Pune City,2150,5,5,4,5,15,15,0,19
Kerala Blast,2150,6,4,4,6,9,16,-7,16
Chennaiyin,2150,7,3,6,5,15,20,-5,15
FC Goa,2150,8,3,4,7,10,17,-7,13
Mumbai City,2151,1,6,4,4,17,11,6,22
Delhi Dynamo,2151,2,5,6,3,26,18,8,21
FC Goa,2151,3,6,2,6,13,16,-3,20
Kerala Blast,2151,4,5,5,4,12,15,-3,20
Kolkata,2151,5,3,8,3,15,15,0,17
NorthEast Un,2151,6,4,5,5,13,13,0,17
FC Pune City,2151,7,4,4,6,14,17,-3,16
Chennaiyin,2151,8,3,6,5,15,20,-5,15
Delhi Dynamo,2152,1,6,5,3,24,16,8,23
Mumbai City,2152,2,6,4,4,17,10,7,22
Kolkata,2152,3,4,8,2,18,16,2,20
Chennaiyin,2152,4,5,5,4,19,19,0,20
FC Pune City,2152,5,5,3,6,17,17,0,18
NorthEast Un,2152,6,5,2,7,12,14,-2,17
Kerala Blast,2152,7,4,4,6,13,21,-8,16
FC Goa,2152,8,4,3,7,11,18,-7,15
Mumbai City,2153,1,6,5,3,19,11,8,23
Delhi Dynamo,2153,2,5,7,2,27,19,8,22
Kolkata,2153,3,5,6,3,16,13,3,21
Kerala Blast,2153,4,6,3,5,16,20,-4,21
Chennaiyin,2153,5,4,6,4,14,17,-3,18
NorthEast Un,2153,6,4,4,6,13,14,-1,16
FC Pune City,2153,7,4,3,7,15,19,-4,15
FC Goa,2153,8,4,2,8,9,16,-7,14
Mumbai City,2154,1,7,4,3,18,9,9,25
NorthEast Un,2154,2,6,2,6,13,17,-4,20
Kolkata,2154,3,4,7,3,15,14,1,19
Delhi Dynamo,2154,4,4,6,4,22,17,5,18
Chennaiyin,2154,5,4,6,4,21,19,2,18
FC Pune City,2154,6,5,3,6,14,15,-1,18
FC Goa,2154,7,4,4,6,12,17,-5,16
Kerala Blast,2154,8,4,4,6,11,18,-7,16
Kerala Blast,2155,1,7,3,4,14,13,1,24
Mumbai City,2155,2,6,4,4,16,10,6,22
Delhi Dynamo,2155,3,5,6,3,24,16,8,21
Kolkata,2155,4,4,7,3,14,13,1,19
FC Goa,2155,5,5,3,6,11,14,-3,18
Chennaiyin,2155,6,4,5,5,16,20,-4,17
NorthEast Un,2155,7,4,3,7,11,15,-4,15
FC Pune City,2155,8,4,3,7,12,17,-5,15
Kolkata,2156,1,6,6,2,23,13,10,24
Delhi Dynamo,2156,2,6,5,3,25,16,9,23
Mumbai City,2156,3,6,4,4,16,9,7,22
FC Pune City,2156,4,5,3,6,16,19,-3,18
Kerala Blast,2156,5,5,3,6,11,19,-8,18
NorthEast Un,2156,6,5,2,7,11,11,0,17
Chennaiyin,2156,7,4,5,5,14,20,-6,17
FC Goa,2156,8,4,2,8,12,21,-9,14
Mumbai City,2157,1,6,5,3,17,9,8,23
Kolkata,2157,2,5,7,2,18,14,4,22
Delhi Dynamo,2157,3,4,8,2,24,17,7,20
Kerala Blast,2157,4,5,4,5,11,16,-5,19
Chennaiyin,2157,5,4,5,5,16,18,-2,17
FC Pune City,2157,6,4,4,6,14,17,-3,16
NorthEast Un,2157,7,4,4,6,10,13,-3,16
FC Goa,2157,8,4,3,7,11,17,-6,15
Mumbai City,2158,1,7,4,3,18,8,10,25
Kolkata,2158,2,5,7,2,19,15,4,22
Delhi Dynamo,2158,3,4,7,3,22,17,5,19
Kerala Blast,2158,4,5,4,5,13,18,-5,19
Chennaiyin,2158,5,4,6,4,16,18,-2,18
FC Pune City,2158,6,4,5,5,14,16,-2,17
NorthEast Un,2158,7,4,3,7,10,13,-3,15
FC Goa,2158,8,3,4,7,11,18,-7,13
Mumbai City,2159,1,7,4,3,17,8,9,25
Kolkata,2159,2,5,6,3,16,14,2,21
Delhi Dynamo,2159,3,5,5,4,23,18,5,20
NorthEast Un,2159,4,5,4,5,12,10,2,19
FC Pune City,2159,5,5,3,6,13,16,-3,18
FC Goa,2159,6,5,2,7,12,16,-4,17
Kerala Blast,2159,7,4,4,6,9,15,-6,16
Chennaiyin,2159,8,3,6,5,14,19,-5,15
Mumbai City,2160,1,7,4,3,17,8,9,25
Delhi Dynamo,2160,2,5,5,4,23,16,7,20
NorthEast Un,2160,3,6,2,6,12,10,2,20
Kolkata,2160,4,4,7,3,16,14,2,19
Kerala Blast,2160,5,5,3,6,10,17,-7,18
Chennaiyin,2160,6,4,5,5,17,22,-5,17
FC Goa,2160,7,5,2,7,14,19,-5,17
FC Pune City,2160,8,4,4,6,13,16,-3,16
Mumbai City,2161,1,7,4,3,18,9,9,25
Kolkata,2161,2,5,6,3,18,15,3,21
Kerala Blast,2161,3,6,3,5,17,15,2,21
Delhi Dynamo,2161,4,5,5,4,23,19,4,20
Chennaiyin,2161,5,4,6,4,16,18,-2,18
FC Pune City,2161,6,5,3,6,14,16,-2,18
NorthEast Un,2161,7,4,3,7,9,14,-5,15
FC Goa,2161,8,4,2,8,12,21,-9,14
Mumbai City,2162,1,6,5,3,17,9,8,23
Delhi Dynamo,2162,2,5,6,3,23,16,7,21
NorthEast Un,2162,3,6,2,6,12,11,1,20
Kerala Blast,2162,4,5,4,5,13,17,-4,19
FC Pune City,2162,5,4,5,5,16,18,-2,17
FC Goa,2162,6,5,2,7,12,15,-3,17
Chennaiyin,2162,7,4,5,5,15,19,-4,17
Kolkata,2162,8,3,7,4,17,20,-3,16
Delhi Dynamo,2163,1,7,5,2,28,15,13,26
Kerala Blast,2163,2,7,3,4,14,15,-1,24
Mumbai City,2163,3,6,4,4,16,11,5,22
Kolkata,2163,4,4,7,3,15,14,1,19
Chennaiyin,2163,5,4,6,4,15,18,-3,18
FC Pune City,2163,6,4,3,7,13,17,-4,15
NorthEast Un,2163,7,4,2,8,10,13,-3,14
FC Goa,2163,8,3,4,7,11,19,-8,13
Mumbai City,2164,1,6,4,4,16,9,7,22
Delhi Dynamo,2164,2,5,6,3,24,18,6,21
Kolkata,2164,3,5,6,3,20,18,2,21
FC Goa,2164,4,6,2,6,18,17,1,20
NorthEast Un,2164,5,5,4,5,12,11,1,19
FC Pune City,2164,6,5,3,6,15,17,-2,18
Kerala Blast,2164,7,4,4,6,13,21,-8,16
Chennaiyin,2164,8,3,5,6,14,21,-7,14
Mumbai City,2165,1,7,4,3,17,8,9,25
Kolkata,2165,2,4,7,3,18,17,1,19
FC Pune City,2165,3,5,4,5,13,14,-1,19
FC Goa,2165,4,5,3,6,14,14,0,18
NorthEast Un,2165,5,5,3,6,12,13,-1,18
Chennaiyin,2165,6,4,6,4,16,18,-2,18
Delhi Dynamo,2165,7,4,5,5,22,20,2,17
Kerala Blast,2165,8,4,4,6,11,19,-8,16
Mumbai City,2166,1,6,5,3,17,9,8,23
Kolkata,2166,2,5,6,3,17,14,3,21
FC Goa,2166,3,6,2,6,14,15,-1,20
Kerala Blast,2166,4,5,4,5,12,16,-4,19
Delhi Dynamo,2166,5,4,6,4,23,18,5,18
NorthEast Un,2166,6,5,3,6,11,11,0,18
FC Pune City,2166,7,4,4,6,12,16,-4,16
Chennaiyin,2166,8,3,6,5,13,20,-7,15
Mumbai City,2167,1,7,4,3,19,8,11,25
Kolkata,2167,2,6,6,2,20,13,7,24
Delhi Dynamo,2167,3,5,6,3,23,18,5,21
Kerala Blast,2167,4,6,3,5,11,16,-5,21
Chennaiyin,2167,5,4,6,4,15,18,-3,18
FC Pune City,2167,6,4,3,7,12,16,-4,15
NorthEast Un,2167,7,4,2,8,10,13,-3,14
FC Goa,2167,8,3,4,7,10,18,-8,13
Mumbai City,2168,1,7,4,3,17,8,9,25
Kolkata,2168,2,6,6,2,19,14,5,24
NorthEast Un,2168,3,6,3,5,16,11,5,21
Delhi Dynamo,2168,4,4,6,4,24,20,4,18
FC Pune City,2168,5,4,4,6,14,17,-3,16
Kerala Blast,2168,6,4,4,6,9,18,-9,16
FC Goa,2168,7,4,3,7,12,17,-5,15
Chennaiyin,2168,8,3,6,5,14,20,-6,15
Delhi Dynamo,2169,1,6,5,3,25,18,7,23
Mumbai City,2169,2,6,4,4,17,10,7,22
Kolkata,2169,3,5,7,2,17,13,4,22
Kerala Blast,2169,4,5,5,4,13,16,-3,20
Chennaiyin,2169,5,4,5,5,18,21,-3,17
NorthEast Un,2169,6,5,2,7,13,16,-3,17
FC Pune City,2169,7,4,4,6,15,18,-3,16
FC Goa,2169,8,4,2,8,12,18,-6,14
Delhi Dynamo,2170,1,6,5,3,24,17,7,23
Mumbai City,2170,2,6,4,4,16,10,6,22
Kerala Blast,2170,3,6,3,5,12,16,-4,21
NorthEast Un,2170,4,6,2,6,15,10,5,20
Kolkata,2170,5,4,8,2,18,14,4,20
FC Pune City,2170,6,4,4,6,13,17,-4,16
Chennaiyin,2170,7,3,6,5,13,20,-7,15
FC Goa,2170,8,3,4,7,9,16,-7,13
Delhi Dynamo,2171,1,6,6,2,26,17,9,24
Mumbai City,2171,2,6,4,4,16,9,7,22
Chennaiyin,2171,3,5,5,4,18,19,-1,20
Kerala Blast,2171,4,5,5,4,11,14,-3,20
FC Pune City,2171,5,4,5,5,14,16,-2,17
Kolkata,2171,6,3,7,4,15,18,-3,16
NorthEast Un,2171,7,4,3,7,13,16,-3,15
FC Goa,2171,8,4,3,7,13,17,-4,15
Mumbai City,2172,1,6,4,4,16,10,6,22
Delhi Dynamo,2172,2,5,5,4,25,18,7,20
FC Goa,2172,3,6,2,6,13,15,-2,20
Kolkata,2172,4,4,7,3,17,15,2,19
Kerala Blast,2172,5,5,4,5,12,15,-3,19
FC Pune City,2172,6,4,5,5,13,15,-2,17
NorthEast Un,2172,7,5,2,7,12,15,-3,17
Chennaiyin,2172,8,4,5,5,14,19,-5,17
Mumbai City,2173,1,6,5,3,17,9,8,23
Kolkata,2173,2,5,7,2,21,16,5,22
Delhi Dynamo,2173,3,5,6,3,27,18,9,21
Kerala Blast,2173,4,6,3,5,17,19,-2,21
NorthEast Un,2173,5,5,3,6,13,14,-1,18
Chennaiyin,2173,6,3,7,4,14,18,-4,16
FC Pune City,2173,7,4,4,6,14,19,-5,16
FC Goa,2173,8,3,3,8,9,19,-10,12
Delhi Dynamo,2174,1,6,5,3,29,19,10,23
Mumbai City,2174,2,6,4,4,17,11,6,22
Kolkata,2174,3,5,7,2,16,13,3,22
NorthEast Un,2174,4,6,3,5,16,12,4,21
Kerala Blast,2174,5,5,4,5,12,16,-4,19
FC Pune City,2174,6,4,3,7,12,16,-4,15
FC Goa,2174,7,4,3,7,13,20,-7,15
Chennaiyin,2174,8,3,5,6,14,22,-8,14
Mumbai City,2175,1,7,4,3,18,9,9,25
Delhi Dynamo,2175,2,6,5,3,26,17,9,23
FC Pune City,2175,3,6,3,5,15,14,1,21
Chennaiyin,2175,4,5,5,4,15,17,-2,20
Kolkata,2175,5,4,7,3,16,15,1,19
NorthEast Un,2175,6,5,2,7,11,12,-1,17
Kerala Blast,2175,7,4,4,6,11,18,-7,16
FC Goa,2175,8,3,2,9,8,18,-10,11
Mumbai City,2176,1,7,4,3,18,8,10,25
Kerala Blast,2176,2,6,4,4,16,17,-1,22
Delhi Dynamo,2176,3,5,6,3,24,18,6,21
NorthEast Un,2176,4,5,3,6,13,14,-1,18
Kolkata,2176,5,4,6,4,16,18,-2,18
Chennaiyin,2176,6,4,5,5,15,18,-3,17
FC Pune City,2176,7,4,4,6,15,18,-3,16
FC Goa,2176,8,4,2,8,11,17,-6,14
Delhi Dynamo,2177,1,6,6,2,25,16,9,24
Kolkata,2177,2,5,7,2,19,12,7,22
Mumbai City,2177,3,6,4,4,17,10,7,22
NorthEast Un,2177,4,6,2,6,12,10,2,20
FC Pune City,2177,5,4,5,5,12,14,-2,17
Kerala Blast,2177,6,4,4,6,9,18,-9,16
Chennaiyin,2177,7,3,6,5,15,20,-5,15
FC Goa,2177,8,3,4,7,11,20,-9,13
Kerala Blast,2178,1,7,3,4,16,14,2,24
Mumbai City,2178,2,6,5,3,18,10,8,23
Delhi Dynamo,2178,3,4,8,2,25,18,7,20
Chennaiyin,2178,4,5,5,4,16,18,-2,20
Kolkata,2178,5,3,8,3,15,16,-1,17
FC Pune City,2178,6,4,4,6,14,17,-3,16
NorthEast Un,2178,7,4,3,7,10,14,-4,15
FC Goa,2178,8,3,4,7,11,18,-7,13
Mumbai City,2179,1,6,5,3,18,10,8,23
Kerala Blast,2179,2,6,4,4,15,13,2,22
NorthEast Un,2179,3,6,2,6,13,13,0,20
Delhi Dynamo,2179,4,4,6,4,25,21,4,18
Kolkata,2179,5,3,9,2,17,16,1,18
FC Goa,2179,6,5,3,6,14,17,-3,18
FC Pune City,2179,7,4,4,6,15,20,-5,16
Chennaiyin,2179,8,3,5,6,14,21,-7,14
Mumbai City,2180,1,6,4,4,17,10,7,22
Delhi Dynamo,2180,2,5,6,3,26,20,6,21
Kerala Blast,2180,3,6,3,5,12,17,-5,21
Chennaiyin,2180,4,5,5,4,19,19,0,20
Kolkata,2180,5,4,7,3,17,14,3,19
FC Pune City,2180,6,5,3,6,14,16,-2,18
NorthEast Un,2180,7,5,2,7,15,16,-1,17
FC Goa,2180,8,3,4,7,10,18,-8,13
Delhi Dynamo,2181,1,6,6,2,27,17,10,24
Mumbai City,2181,2,6,5,3,18,10,8,23
Kolkata,2181,3,4,8,2,19,15,4,20
FC Pune City,2181,4,5,4,5,15,15,0,19
NorthEast Un,2181,5,5,3,6,11,11,0,18
Kerala Blast,2181,6,4,4,6,9,18,-9,16
FC Goa,2181,7,4,3,7,13,19,-6,15
Chennaiyin,2181,8,3,5,6,14,21,-7,14
Mumbai City,2182,1,7,4,3,17,8,9,25
Delhi Dynamo,2182,2,6,5,3,25,16,9,23
Kolkata,2182,3,5,7,2,18,14,4,22
Kerala Blast,2182,4,5,4,5,11,15,-4,19
FC Pune City,2182,5,4,5,5,14,16,-2,17
Chennaiyin,2182,6,3,7,4,13,17,-4,16
NorthEast Un,2182,7,4,3,7,10,12,-2,15
FC Goa,2182,8,3,3,8,9,19,-10,12
Delhi Dynamo,2183,1,6,6,2,25,16,9,24
Mumbai City,2183,2,6,5,3,18,10,8,23
Kerala Blast,2183,3,6,4,4,13,15,-2,22
Kolkata,2183,4,5,6,3,17,13,4,21
Chennaiyin,2183,5,5,5,4,17,18,-1,20
FC Pune City,2183,6,4,4,6,14,19,-5,16
NorthEast Un,2183,7,4,2,8,9,13,-4,14
FC Goa,2183,8,3,2,9,9,18,-9,11
Delhi Dynamo,2184,1,6,6,2,27,17,10,24
Mumbai City,2184,2,6,4,4,17,10,7,22
Kerala Blast,2184,3,6,4,4,11,13,-2,22
NorthEast Un,2184,4,5,3,6,11,12,-1,18
FC Pune City,2184,5,5,3,6,13,15,-2,18
Kolkata,2184,6,3,7,4,13,14,-1,16
FC Goa,2184,7,4,4,6,13,17,-4,16
Chennaiyin,2184,8,3,5,6,15,22,-7,14
Delhi Dynamo,2185,1,5,7,2,25,17,8,22
Mumbai City,2185,2,6,4,4,16,9,7,22
Kolkata,2185,3,5,6,3,19,15,4,21
FC Pune City,2185,4,6,3,5,16,14,2,21
Chennaiyin,2185,5,4,6,4,18,19,-1,18
Kerala Blast,2185,6,5,3,6,10,18,-8,18
NorthEast Un,2185,7,4,4,6,12,13,-1,16
FC Goa,2185,8,3,3,8,11,22,-11,12
Delhi Dynamo,2186,1,6,5,3,26,18,8,23
Mumbai City,2186,2,6,4,4,16,9,7,22
FC Pune City,2186,3,6,3,5,14,14,0,21
FC Goa,2186,4,5,3,6,14,18,-4,18
Kolkata,2186,5,3,8,3,15,15,0,17
Chennaiyin,2186,6,4,5,5,15,19,-4,17
Kerala Blast,2186,7,4,5,5,11,16,-5,17
NorthEast Un,2186,8,4,3,7,11,13,-2,15
NorthEast Un,2187,1,7,2,5,22,12,10,23
Mumbai City,2187,2,6,4,4,16,9,7,22
Delhi Dynamo,2187,3,5,6,3,26,19,7,21
FC Pune City,2187,4,6,3,5,15,15,0,21
Kolkata,2187,5,3,8,3,13,13,0,17
FC Goa,2187,6,4,4,6,12,16,-4,16
Kerala Blast,2187,7,4,4,6,10,18,-8,16
Chennaiyin,2187,8,3,5,6,14,26,-12,14
Mumbai City,2188,1,7,4,3,17,8,9,25
Kerala Blast,2188,2,7,3,4,18,16,2,24
Delhi Dynamo,2188,3,6,5,3,24,16,8,23
Kolkata,2188,4,3,8,3,15,15,0,17
NorthEast Un,2188,5,5,2,7,13,15,-2,17
FC Pune City,2188,6,4,4,6,14,18,-4,16
Chennaiyin,2188,7,3,6,5,14,20,-6,15
FC Goa,2188,8,3,4,7,9,16,-7,13
Delhi Dynamo,2189,1,6,5,3,26,17,9,23
Mumbai City,2189,2,6,4,4,16,10,6,22
FC Pune City,2189,3,6,3,5,14,14,0,21
Kerala Blast,2189,4,5,4,5,14,17,-3,19
NorthEast Un,2189,5,5,3,6,14,13,1,18
Kolkata,2189,6,4,6,4,17,17,0,18
Chennaiyin,2189,7,4,5,5,16,21,-5,17
FC Goa,2189,8,4,2,8,13,21,-8,14
Delhi Dynamo,2190,1,6,6,2,26,17,9,24
Mumbai City,2190,2,6,5,3,17,9,8,23
Kolkata,2190,3,4,7,3,18,17,1,19
FC Pune City,2190,4,5,4,5,13,14,-1,19
Chennaiyin,2190,5,4,5,5,16,19,-3,17
Kerala Blast,2190,6,4,5,5,11,16,-5,17
NorthEast Un,2190,7,4,3,7,9,12,-3,15
FC Goa,2190,8,4,3,7,14,20,-6,15
Mumbai City,2191,1,6,5,3,16,8,8,23
Kerala Blast,2191,2,6,3,5,13,14,-1,21
NorthEast Un,2191,3,6,2,6,14,11,3,20
Chennaiyin,2191,4,5,5,4,17,18,-1,20
Kolkata,2191,5,4,7,3,16,16,0,19
Delhi Dynamo,2191,6,4,6,4,21,20,1,18
FC Pune City,2191,7,4,3,7,13,18,-5,15
FC Goa,2191,8,4,3,7,12,17,-5,15
Mumbai City,2192,1,6,5,3,18,10,8,23
Delhi Dynamo,2192,2,5,7,2,27,18,9,22
Kolkata,2192,3,5,6,3,18,14,4,21
NorthEast Un,2192,4,6,2,6,15,11,4,20
FC Pune City,2192,5,5,3,6,14,16,-2,18
Kerala Blast,2192,6,5,3,6,10,19,-9,18
Chennaiyin,2192,7,4,5,5,15,20,-5,17
FC Goa,2192,8,3,3,8,11,20,-9,12
Mumbai City,2193,1,7,4,3,18,8,10,25
Kolkata,2193,2,5,6,3,22,18,4,21
NorthEast Un,2193,3,6,3,5,15,12,3,21
Delhi Dynamo,2193,4,5,5,4,24,19,5,20
Chennaiyin,2193,5,4,6,4,17,19,-2,18
FC Pune City,2193,6,5,3,6,17,21,-4,18
Kerala Blast,2193,7,5,3,6,16,21,-5,18
FC Goa,2193,8,3,2,9,10,21,-11,11
Delhi Dynamo,2194,1,6,5,3,28,18,10,23
Mumbai City,2194,2,6,4,4,17,10,7,22
Kerala Blast,2194,3,6,3,5,11,14,-3,21
Kolkata,2194,4,4,7,3,15,14,1,19
FC Pune City,2194,5,5,4,5,13,14,-1,19
NorthEast Un,2194,6,5,3,6,13,13,0,18
Chennaiyin,2194,7,3,6,5,17,22,-5,15
FC Goa,2194,8,4,2,8,13,22,-9,14
Mumbai City,2195,1,6,5,3,17,9,8,23
Kolkata,2195,2,5,6,3,16,14,2,21
Delhi Dynamo,2195,3,4,8,2,23,16,7,20
Chennaiyin,2195,4,5,5,4,18,19,-1,20
NorthEast Un,2195,5,5,3,6,10,11,-1,18
FC Pune City,2195,6,4,4,6,13,16,-3,16
Kerala Blast,2195,7,4,4,6,11,17,-6,16
FC Goa,2195,8,4,3,7,12,18,-6,15
Mumbai City,2196,1,7,4,3,17,8,9,25
Kerala Blast,2196,2,6,3,5,12,17,-5,21
Delhi Dynamo,2196,3,5,5,4,25,17,8,20
FC Pune City,2196,4,5,4,5,15,14,1,19
NorthEast Un,2196,5,5,3,6,13,13,0,18
Kolkata,2196,6,3,8,3,15,15,0,17
Chennaiyin,2196,7,3,7,4,17,21,-4,16
FC Goa,2196,8,3,4,7,11,20,-9,13
Delhi Dynamo,2197,1,6,5,3,25,17,8,23
Mumbai City,2197,2,6,4,4,16,9,7,22
Kerala Blast,2197,3,6,3,5,14,16,-2,21
NorthEast Un,2197,4,6,2,6,15,14,1,20
Kolkata,2197,5,4,7,3,14,13,1,19
FC Goa,2197,6,5,2,7,11,15,-4,17
FC Pune City,2197,7,4,4,6,12,17,-5,16
Chennaiyin,2197,8,3,5,6,14,20,-6,14
Mumbai City,2198,1,7,4,3,19,8,11,25
Delhi Dynamo,2198,2,5,6,3,23,18,5,21
Kolkata,2198,3,4,7,3,16,15,1,19
FC Pune City,2198,4,5,4,5,15,16,-1,19
NorthEast Un,2198,5,5,3,6,10,10,0,18
FC Goa,2198,6,5,3,6,13,16,-3,18
Kerala Blast,2198,7,4,4,6,10,16,-6,16
Chennaiyin,2198,8,3,5,6,13,20,-7,14
Mumbai City,2199,1,6,5,3,17,9,8,23
Delhi Dynamo,2199,2,5,7,2,25,16,9,22
Kolkata,2199,3,5,7,2,19,13,6,22
Chennaiyin,2199,4,5,5,4,18,18,0,20
Kerala Blast,2199,5,5,5,4,11,14,-3,20
NorthEast Un,2199,6,4,4,6,9,11,-2,16
FC Pune City,2199,7,4,3,7,14,20,-6,15
FC Goa,2199,8,3,2,9,10,22,-12,11
Delhi Dynamo,2200,1,7,5,2,29,16,13,26
Mumbai City,2200,2,6,4,4,18,11,7,22
Kolkata,2200,3,5,7,2,17,13,4,22
Kerala Blast,2200,4,5,4,5,11,15,-4,19
NorthEast Un,2200,5,5,3,6,10,13,-3,18
FC Pune City,2200,6,4,3,7,12,17,-5,15
FC Goa,2200,7,4,3,7,9,15,-6,15
Chennaiyin,2200,8,3,5,6,13,19,-6,14
Kolkata,2201,1,6,6,2,20,15,5,24
Mumbai City,2201,2,6,5,3,16,8,8,23
Delhi Dynamo,2201,3,4,7,3,23,17,6,19
NorthEast Un,2201,4,5,3,6,11,12,-1,18
FC Pune City,2201,5,5,3,6,14,16,-2,18
Chennaiyin,2201,6,4,5,5,16,19,-3,17
FC Goa,2201,7,5,2,7,13,18,-5,17
Kerala Blast,2201,8,4,3,7,11,19,-8,15
Mumbai City,2202,1,7,4,3,21,8,13,25
Delhi Dynamo,2202,2,5,6,3,25,22,3,21
Kolkata,2202,3,4,7,3,16,15,1,19
NorthEast Un,2202,4,5,3,6,11,11,0,18
FC Pune City,2202,5,5,3,6,15,17,-2,18
Kerala Blast,2202,6,5,3,6,11,16,-5,18
Chennaiyin,2202,7,4,5,5,15,21,-6,17
FC Goa,2202,8,4,3,7,15,19,-4,15
Mumbai City,2203,1,7,4,3,20,8,12,25
FC Pune City,2203,2,6,3,5,17,14,3,21
NorthEast Un,2203,3,6,2,6,17,11,6,20
Delhi Dynamo,2203,4,5,5,4,23,24,-1,20
Kolkata,2203,5,4,7,3,18,16,2,19
Kerala Blast,2203,6,5,3,6,13,21,-8,18
Chennaiyin,2203,7,4,5,5,14,20,-6,17
FC Goa,2203,8,3,3,8,10,18,-8,12
Mumbai City,2204,1,6,5,3,17,9,8,23
Delhi Dynamo,2204,2,5,7,2,26,18,8,22
NorthEast Un,2204,3,6,2,6,15,13,2,20
Kolkata,2204,4,4,7,3,19,19,0,19
FC Pune City,2204,5,5,4,5,14,15,-1,19
Kerala Blast,2204,6,5,3,6,12,17,-5,18
FC Goa,2204,7,4,3,7,14,19,-5,15
Chennaiyin,2204,8,3,5,6,14,21,-7,14
Mumbai City,2205,1,6,5,3,18,10,8,23
Kolkata,2205,2,5,7,2,18,15,3,22
Delhi Dynamo,2205,3,5,6,3,25,18,7,21
NorthEast Un,2205,4,6,2,6,13,10,3,20
Kerala Blast,2205,5,5,3,6,11,17,-6,18
FC Goa,2205,6,5,2,7,14,17,-3,17
FC Pune City,2205,7,4,4,6,13,16,-3,16
Chennaiyin,2205,8,3,5,6,13,22,-9,14
Mumbai City,2206,1,6,5,3,18,10,8,23
FC Pune City,2206,2,6,3,5,17,15,2,21
Delhi Dynamo,2206,3,4,7,3,25,19,6,19
NorthEast Un,2206,4,5,3,6,12,12,0,18
Kolkata,2206,5,4,6,4,15,17,-2,18
Chennaiyin,2206,6,4,6,4,16,19,-3,18
FC Goa,2206,7,4,4,6,12,17,-5,16
Kerala Blast,2206,8,4,4,6,12,18,-6,16
Mumbai City,2207,1,7,4,3,21,10,11,25
Kolkata,2207,2,6,6,2,18,12,6,24
NorthEast Un,2207,3,6,3,5,15,11,4,21
Delhi Dynamo,2207,4,5,5,4,24,21,3,20
Chennaiyin,2207,5,4,5,5,15,20,-5,17
Kerala Blast,2207,6,4,5,5,12,18,-6,17
FC Pune City,2207,7,4,4,6,13,17,-4,16
FC Goa,2207,8,3,2,9,9,18,-9,11
Mumbai City,2208,1,6,5,3,18,10,8,23
Delhi Dynamo,2208,2,4,8,2,24,17,7,20
Kolkata,2208,3,4,7,3,20,15,5,19
NorthEast Un,2208,4,5,4,5,11,9,2,19
FC Pune City,2208,5,5,4,5,15,16,-1,19
FC Goa,2208,6,4,4,6,11,16,-5,16
Kerala Blast,2208,7,4,4,6,10,20,-10,16
Chennaiyin,2208,8,3,6,5,13,19,-6,15
Mumbai City,2209,1,7,4,3,18,8,10,25
NorthEast Un,2209,2,7,2,5,13,9,4,23
Kolkata,2209,3,5,6,3,19,14,5,21
Delhi Dynamo,2209,4,5,5,4,23,18,5,20
Kerala Blast,2209,5,5,3,6,12,18,-6,18
FC Goa,2209,6,5,2,7,13,18,-5,17
FC Pune City,2209,7,4,3,7,13,20,-7,15
Chennaiyin,2209,8,3,5,6,14,20,-6,14
Mumbai City,2210,1,7,4,3,19,10,9,25
Delhi Dynamo,2210,2,5,6,3,27,19,8,21
Kolkata,2210,3,4,8,2,18,13,5,20
NorthEast Un,2210,4,5,3,6,12,13,-1,18
FC Pune City,2210,5,5,3,6,15,19,-4,18
Chennaiyin,2210,6,4,5,5,15,19,-4,17
Kerala Blast,2210,7,4,4,6,12,19,-7,16
FC Goa,2210,8,4,3,7,11,17,-6,15
Mumbai City,2211,1,6,5,3,19,11,8,23
Kolkata,2211,2,5,6,3,16,15,1,21
FC Goa,2211,3,6,2,6,15,15,0,20
Delhi Dynamo,2211,4,4,7,3,26,21,5,19
NorthEast Un,2211,5,5,3,6,14,14,0,18
FC Pune City,2211,6,5,3,6,14,16,-2,18
Chennaiyin,2211,7,4,5,5,17,20,-3,17
Kerala Blast,2211,8,4,3,7,11,20,-9,15
Mumbai City,2212,1,6,4,4,17,10,7,22
Kolkata,2212,2,5,7,2,20,15,5,22
Delhi Dynamo,2212,3,5,6,3,27,20,7,21
NorthEast Un,2212,4,6,2,6,14,15,-1,20
Kerala Blast,2212,5,5,4,5,14,16,-2,19
FC Pune City,2212,6,5,3,6,14,16,-2,18
FC Goa,2212,7,4,3,7,13,21,-8,15
Chennaiyin,2212,8,3,5,6,14,20,-6,14
Mumbai City,2213,1,7,4,3,20,8,12,25
Kolkata,2213,2,5,6,3,19,15,4,21
Kerala Blast,2213,3,6,3,5,12,15,-3,21
Chennaiyin,2213,4,5,5,4,18,17,1,20
Delhi Dynamo,2213,5,4,6,4,22,20,2,18
NorthEast Un,2213,6,5,2,7,11,15,-4,17
FC Pune City,2213,7,4,3,7,13,19,-6,15
FC Goa,2213,8,4,3,7,11,17,-6,15
Kerala Blast,2214,1,7,3,4,13,14,-1,24
Mumbai City,2214,2,6,5,3,17,9,8,23
Delhi Dynamo,2214,3,4,8,2,22,15,7,20
Kolkata,2214,4,4,6,4,17,15,2,18
Chennaiyin,2214,5,4,6,4,19,21,-2,18
FC Goa,2214,6,4,4,6,12,17,-5,16
NorthEast Un,2214,7,4,3,7,11,14,-3,15
FC Pune City,2214,8,4,3,7,13,19,-6,15
Delhi Dynamo,2215,1,5,7,2,26,18,8,22
Mumbai City,2215,2,6,4,4,18,11,7,22
Kolkata,2215,3,4,7,3,17,16,1,19
NorthEast Un,2215,4,5,4,5,13,12,1,19
Kerala Blast,2215,5,5,4,5,13,17,-4,19
FC Goa,2215,6,5,3,6,11,14,-3,18
Chennaiyin,2215,7,3,6,5,13,18,-5,15
FC Pune City,2215,8,4,3,7,12,17,-5,15
Mumbai City,2216,1,6,5,3,17,9,8,23
Delhi Dynamo,2216,2,5,7,2,26,17,9,22
Kolkata,2216,3,5,6,3,18,15,3,21
Chennaiyin,2216,4,4,6,4,17,18,-1,18
FC Pune City,2216,5,5,3,6,13,16,-3,18
Kerala Blast,2216,6,5,3,6,11,16,-5,18
FC Goa,2216,7,4,4,6,12,17,-5,16
NorthEast Un,2216,8,4,2,8,10,16,-6,14
Mumbai City,2217,1,6,5,3,18,10,8,23
Delhi Dynamo,2217,2,5,6,3,26,19,7,21
FC Pune City,2217,3,5,4,5,15,15,0,19
Kerala Blast,2217,4,5,4,5,15,17,-2,19
NorthEast Un,2217,5,5,3,6,13,13,0,18
FC Goa,2217,6,5,3,6,14,17,-3,18
Kolkata,2217,7,3,7,4,16,20,-4,16
Chennaiyin,2217,8,3,6,5,14,20,-6,15
Mumbai City,2218,1,7,4,3,19,9,10,25
Delhi Dynamo,2218,2,5,6,3,25,18,7,21
Kerala Blast,2218,3,6,3,5,11,14,-3,21
NorthEast Un,2218,4,5,4,5,11,10,1,19
Kolkata,2218,5,4,6,4,15,15,0,18
FC Goa,2218,6,5,2,7,11,17,-6,17
FC Pune City,2218,7,4,3,7,12,16,-4,15
Chennaiyin,2218,8,3,6,5,13,18,-5,15
Delhi Dynamo,2219,1,6,6,2,26,15,11,24
Mumbai City,2219,2,6,4,4,16,10,6,22
Kolkata,2219,3,5,7,2,17,13,4,22
NorthEast Un,2219,4,5,3,6,11,12,-1,18
FC Pune City,2219,5,5,3,6,15,17,-2,18
Chennaiyin,2219,6,4,5,5,16,19,-3,17
Kerala Blast,2219,7,4,4,6,9,16,-7,16
FC Goa,2219,8,4,2,8,10,18,-8,14
Delhi Dynamo,2220,1,6,5,3,26,17,9,23
Mumbai City,2220,2,6,4,4,16,11,5,22
NorthEast Un,2220,3,6,3,5,15,10,5,21
FC Pune City,2220,4,6,3,5,15,15,0,21
Kolkata,2220,5,3,8,3,13,13,0,17
Kerala Blast,2220,6,4,5,5,10,15,-5,17
Chennaiyin,2220,7,3,6,5,14,20,-6,15
FC Goa,2220,8,3,4,7,8,16,-8,13
Kolkata,2221,1,6,6,2,20,15,5,24
Delhi Dynamo,2221,2,6,5,3,27,17,10,23
NorthEast Un,2221,3,7,2,5,16,12,4,23
Mumbai City,2221,4,6,4,4,16,10,6,22
FC Pune City,2221,5,5,3,6,17,17,0,18
Chennaiyin,2221,6,4,5,5,15,18,-3,17
Kerala Blast,2221,7,4,3,7,12,22,-10,15
FC Goa,2221,8,3,2,9,9,21,-12,11
Mumbai City,2222,1,7,4,3,19,9,10,25
Kerala Blast,2222,2,6,3,5,15,16,-1,21
Delhi Dynamo,2222,3,5,5,4,26,20,6,20
Chennaiyin,2222,4,5,5,4,18,17,1,20
Kolkata,2222,5,4,7,3,17,16,1,19
NorthEast Un,2222,6,5,2,7,13,15,-2,17
FC Pune City,2222,7,4,4,6,14,19,-5,16
FC Goa,2222,8,4,2,8,10,20,-10,14
Delhi Dynamo,2223,1,7,5,2,26,14,12,26
Mumbai City,2223,2,6,4,4,16,9,7,22
Kolkata,2223,3,5,7,2,19,14,5,22
Kerala Blast,2223,4,5,4,5,13,18,-5,19
Chennaiyin,2223,5,4,5,5,17,22,-5,17
FC Pune City,2223,6,4,4,6,15,19,-4,16
NorthEast Un,2223,7,4,3,7,12,15,-3,15
FC Goa,2223,8,4,2,8,11,18,-7,14
Delhi Dynamo,2224,1,6,6,2,26,15,11,24
Kerala Blast,2224,2,7,3,4,14,14,0,24
Mumbai City,2224,3,6,4,4,17,11,6,22
Chennaiyin,2224,4,5,5,4,15,17,-2,20
FC Pune City,2224,5,5,3,6,15,17,-2,18
Kolkata,2224,6,3,7,4,16,18,-2,16
NorthEast Un,2224,7,4,3,7,9,11,-2,15
FC Goa,2224,8,3,3,8,9,18,-9,12
Delhi Dynamo,2225,1,6,6,2,28,17,11,24
Mumbai City,2225,2,6,5,3,17,9,8,23
Kolkata,2225,3,4,8,2,17,15,2,20
Kerala Blast,2225,4,5,4,5,12,15,-3,19
Chennaiyin,2225,5,4,6,4,17,18,-1,18
NorthEast Un,2225,6,5,2,7,12,17,-5,17
FC Pune City,2225,7,4,3,7,14,19,-5,15
FC Goa,2225,8,3,4,7,11,18,-7,13
Mumbai City,2226,1,7,4,3,17,8,9,25
Kerala Blast,2226,2,7,3,4,15,14,1,24
Delhi Dynamo,2226,3,4,6,4,22,18,4,18
FC Pune City,2226,4,5,3,6,15,16,-1,18
Chennaiyin,2226,5,4,6,4,14,17,-3,18
Kolkata,2226,6,3,7,4,15,18,-3,16
FC Goa,2226,7,4,4,6,11,15,-4,16
NorthEast Un,2226,8,4,3,7,11,14,-3,15
Mumbai City,2227,1,6,5,3,17,9,8,23
Kerala Blast,2227,2,6,3,5,12,16,-4,21
NorthEast Un,2227,3,6,2,6,13,11,2,20
FC Goa,2227,4,6,2,6,16,19,-3,20
Delhi Dynamo,2227,5,4,6,4,23,19,4,18
Kolkata,2227,6,4,6,4,18,17,1,18
Chennaiyin,2227,7,4,5,5,18,21,-3,17
FC Pune City,2227,8,4,3,7,13,18,-5,15
Mumbai City,2228,1,6,4,4,17,10,7,22
Kolkata,2228,2,5,7,2,19,14,5,22
Delhi Dynamo,2228,3,5,6,3,27,20,7,21
Kerala Blast,2228,4,6,3,5,12,15,-3,21
NorthEast Un,2228,5,5,3,6,14,12,2,18
FC Goa,2228,6,5,2,7,15,18,-3,17
FC Pune City,2228,7,4,4,6,14,18,-4,16
Chennaiyin,2228,8,3,5,6,13,24,-11,14
Mumbai City,2229,1,6,5,3,17,9,8,23
Delhi Dynamo,2229,2,5,7,2,27,18,9,22
Kolkata,2229,3,5,6,3,20,15,5,21
Kerala Blast,2229,4,6,3,5,14,17,-3,21
Chennaiyin,2229,5,5,5,4,18,19,-1,20
FC Pune City,2229,6,4,3,7,13,18,-5,15
FC Goa,2229,7,4,3,7,12,18,-6,15
NorthEast Un,2229,8,4,2,8,13,20,-7,14
Delhi Dynamo,2230,1,6,6,2,24,15,9,24
Mumbai City,2230,2,6,5,3,17,9,8,23
Kolkata,2230,3,4,7,3,18,15,3,19
FC Pune City,2230,4,5,4,5,14,15,-1,19
Kerala Blast,2230,5,5,3,6,10,18,-8,18
NorthEast Un,2230,6,5,2,7,12,11,1,17
Chennaiyin,2230,7,4,5,5,14,20,-6,17
FC Goa,2230,8,4,2,8,10,16,-6,14
Delhi Dynamo,2231,1,7,5,2,28,16,12,26
Kolkata,2231,2,6,6,2,20,13,7,24
Mumbai City,2231,3,6,4,4,17,10,7,22
NorthEast Un,2231,4,5,3,6,12,13,-1,18
FC Pune City,2231,5,5,3,6,15,17,-2,18
Chennaiyin,2231,6,4,6,4,16,19,-3,18
Kerala Blast,2231,7,4,3,7,10,19,-9,15
FC Goa,2231,8,3,2,9,9,20,-11,11
Mumbai City,2232,1,6,5,3,17,9,8,23
Kolkata,2232,2,5,6,3,19,13,6,21
NorthEast Un,2232,3,6,3,5,13,11,2,21
Delhi Dynamo,2232,4,4,7,3,24,19,5,19
FC Goa,2232,5,5,3,6,11,14,-3,18
Kerala Blast,2232,6,5,3,6,10,18,-8,18
Chennaiyin,2232,7,3,6,5,13,18,-5,15
FC Pune City,2232,8,4,3,7,12,17,-5,15
Mumbai City,2233,1,7,4,3,17,8,9,25
Delhi Dynamo,2233,2,5,6,3,22,15,7,21
Kolkata,2233,3,4,8,2,17,15,2,20
Kerala Blast,2233,4,4,6,4,9,13,-4,18
NorthEast Un,2233,5,4,5,5,9,9,0,17
FC Pune City,2233,6,4,4,6,13,16,-3,16
Chennaiyin,2233,7,3,6,5,13,18,-5,15
FC Goa,2233,8,4,3,7,11,17,-6,15
Mumbai City,2234,1,6,5,3,17,9,8,23
Delhi Dynamo,2234,2,5,7,2,24,16,8,22
Kolkata,2234,3,5,6,3,17,17,0,21
NorthEast Un,2234,4,5,3,6,12,12,0,18
Chennaiyin,2234,5,4,6,4,15,18,-3,18
Kerala Blast,2234,6,5,3,6,12,17,-5,18
FC Goa,2234,7,4,3,7,13,17,-4,15
FC Pune City,2234,8,4,3,7,12,16,-4,15
Mumbai City,2235,1,7,4,3,18,9,9,25
Kolkata,2235,2,5,7,2,18,14,4,22
NorthEast Un,2235,3,6,2,6,14,12,2,20
Kerala Blast,2235,4,5,4,5,12,16,-4,19
Delhi Dynamo,2235,5,4,6,4,24,20,4,18
Chennaiyin,2235,6,4,5,5,15,20,-5,17
FC Goa,2235,7,4,3,7,13,18,-5,15
FC Pune City,2235,8,4,3,7,12,17,-5,15
Mumbai City,2236,1,6,4,4,16,10,6,22
NorthEast Un,2236,2,6,3,5,15,12,3,21
Kerala Blast,2236,3,6,3,5,11,15,-4,21
Delhi Dynamo,2236,4,5,5,4,30,23,7,20
Kolkata,2236,5,4,7,3,15,14,1,19
Chennaiyin,2236,6,3,7,4,14,18,-4,16
FC Goa,2236,7,4,4,6,15,20,-5,16
FC Pune City,2236,8,4,3,7,12,16,-4,15
Mumbai City,2237,1,6,5,3,16,8,8,23
Kerala Blast,2237,2,6,4,4,14,16,-2,22
FC Goa,2237,3,6,2,6,11,14,-3,20
NorthEast Un,2237,4,5,4,5,17,13,4,19
Delhi Dynamo,2237,5,4,6,4,21,19,2,18
Kolkata,2237,6,3,7,4,15,16,-1,16
FC Pune City,2237,7,4,4,6,14,17,-3,16
Chennaiyin,2237,8,3,6,5,16,21,-5,15
Mumbai City,2238,1,7,4,3,19,10,9,25
NorthEast Un,2238,2,7,2,5,14,10,4,23
Kolkata,2238,3,5,7,2,17,13,4,22
Delhi Dynamo,2238,4,5,5,4,26,19,7,20
Kerala Blast,2238,5,5,3,6,12,17,-5,18
Chennaiyin,2238,6,3,6,5,14,19,-5,15
FC Pune City,2238,7,4,3,7,13,19,-6,15
FC Goa,2238,8,3,4,7,10,18,-8,13
Delhi Dynamo,2239,1,6,5,3,25,16,9,23
Mumbai City,2239,2,6,4,4,16,10,6,22
Kolkata,2239,3,5,6,3,23,15,8,21
Chennaiyin,2239,4,4,6,4,19,20,-1,18
FC Goa,2239,5,5,3,6,15,18,-3,18
Kerala Blast,2239,6,5,3,6,13,23,-10,18
NorthEast Un,2239,7,5,2,7,14,16,-2,17
FC Pune City,2239,8,4,3,7,13,20,-7,15
Delhi Dynamo,2240,1,6,6,2,27,15,12,24
Mumbai City,2240,2,6,4,4,17,11,6,22
NorthEast Un,2240,3,5,4,5,13,12,1,19
Kerala Blast,2240,4,5,4,5,14,17,-3,19
Kolkata,2240,5,3,8,3,18,19,-1,17
FC Goa,2240,6,5,2,7,16,20,-4,17
FC Pune City,2240,7,4,4,6,14,18,-4,16
Chennaiyin,2240,8,3,6,5,15,22,-7,15
Mumbai City,2241,1,7,4,3,21,12,9,25
Delhi Dynamo,2241,2,6,5,3,31,21,10,23
Kolkata,2241,3,4,8,2,16,14,2,20
Chennaiyin,2241,4,5,5,4,17,19,-2,20
Kerala Blast,2241,5,5,5,4,12,15,-3,20
NorthEast Un,2241,6,4,3,7,12,15,-3,15
FC Pune City,2241,7,4,3,7,12,16,-4,15
FC Goa,2241,8,3,3,8,11,20,-9,12
Delhi Dynamo,2242,1,6,6,2,27,15,12,24
Mumbai City,2242,2,6,4,4,16,10,6,22
Kolkata,2242,3,5,6,3,17,15,2,21
NorthEast Un,2242,4,5,4,5,14,12,2,19
Kerala Blast,2242,5,5,4,5,13,18,-5,19
Chennaiyin,2242,6,4,5,5,15,20,-5,17
FC Pune City,2242,7,4,3,7,14,18,-4,15
FC Goa,2242,8,4,2,8,11,19,-8,14
Delhi Dynamo,2243,1,7,5,2,26,15,11,26
Mumbai City,2243,2,6,4,4,17,10,7,22
Kerala Blast,2243,3,6,3,5,14,14,0,21
Chennaiyin,2243,4,5,5,4,19,19,0,20
FC Pune City,2243,5,5,4,5,14,15,-1,19
Kolkata,2243,6,3,7,4,15,17,-2,16
FC Goa,2243,7,4,2,8,12,19,-7,14
NorthEast Un,2243,8,4,2,8,9,17,-8,14
Delhi Dynamo,2244,1,6,5,3,26,16,10,23
Mumbai City,2244,2,6,4,4,16,9,7,22
Kolkata,2244,3,5,6,3,19,15,4,21
NorthEast Un,2244,4,6,3,5,14,11,3,21
Kerala Blast,2244,5,5,3,6,13,19,-6,18
Chennaiyin,2244,6,3,7,4,15,19,-4,16
FC Pune City,2244,7,4,3,7,13,18,-5,15
FC Goa,2244,8,4,3,7,11,20,-9,15
Mumbai City,2245,1,7,4,3,18,9,9,25
Kerala Blast,2245,2,6,4,4,14,15,-1,22
Delhi Dynamo,2245,3,5,5,4,24,18,6,20
Kolkata,2245,4,4,7,3,17,16,1,19
NorthEast Un,2245,5,5,2,7,12,14,-2,17
Chennaiyin,2245,6,4,5,5,15,22,-7,17
FC Pune City,2245,7,4,4,6,13,16,-3,16
FC Goa,2245,8,4,3,7,14,17,-3,15
Mumbai City,2246,1,7,4,3,19,9,10,25
Kerala Blast,2246,2,6,4,4,14,15,-1,22
Delhi Dynamo,2246,3,5,5,4,27,22,5,20
Kolkata,2246,4,3,9,2,17,16,1,18
NorthEast Un,2246,5,5,2,7,14,14,0,17
Chennaiyin,2246,6,4,5,5,15,22,-7,17
FC Pune City,2246,7,4,4,6,14,18,-4,16
FC Goa,2246,8,4,3,7,15,19,-4,15
Mumbai City,2247,1,6,5,3,18,10,8,23
FC Goa,2247,2,6,2,6,11,14,-3,20
Kolkata,2247,3,4,7,3,20,15,5,19
NorthEast Un,2247,4,5,4,5,17,15,2,19
Kerala Blast,2247,5,5,4,5,15,23,-8,19
Delhi Dynamo,2247,6,4,6,4,24,20,4,18
FC Pune City,2247,7,4,4,6,14,17,-3,16
Chennaiyin,2247,8,3,6,5,15,20,-5,15
Mumbai City,2248,1,7,4,3,21,8,13,25
Kerala Blast,2248,2,6,4,4,15,16,-1,22
Delhi Dynamo,2248,3,5,6,3,26,20,6,21
NorthEast Un,2248,4,5,3,6,11,12,-1,18
Kolkata,2248,5,3,8,3,16,17,-1,17
FC Pune City,2248,6,4,4,6,16,19,-3,16
Chennaiyin,2248,7,3,6,5,15,20,-5,15
FC Goa,2248,8,4,3,7,12,20,-8,15
Delhi Dynamo,2249,1,6,6,2,28,17,11,24
Mumbai City,2249,2,6,5,3,18,10,8,23
FC Pune City,2249,3,5,4,5,14,15,-1,19
Kerala Blast,2249,4,5,4,5,11,15,-4,19
Kolkata,2249,5,3,8,3,16,16,0,17
NorthEast Un,2249,6,5,2,7,10,12,-2,17
FC Goa,2249,7,5,2,7,12,18,-6,17
Chennaiyin,2249,8,3,5,6,13,19,-6,14
Mumbai City,2250,1,7,4,3,18,8,10,25
Kolkata,2250,2,5,7,2,16,12,4,22
Delhi Dynamo,2250,3,5,6,3,24,18,6,21
NorthEast Un,2250,4,6,3,5,16,12,4,21
Kerala Blast,2250,5,5,3,6,13,19,-6,18
FC Pune City,2250,6,4,3,7,13,18,-5,15
FC Goa,2250,7,4,3,7,10,16,-6,15
Chennaiyin,2250,8,3,5,6,14,21,-7,14
Mumbai City,2251,1,7,4,3,18,8,10,25
FC Pune City,2251,2,6,3,5,14,14,0,21
Delhi Dynamo,2251,3,4,7,3,24,19,5,19
Kolkata,2251,4,4,7,3,15,14,1,19
Chennaiyin,2251,5,4,5,5,15,18,-3,17
Kerala Blast,2251,6,4,5,5,11,16,-5,17
NorthEast Un,2251,7,4,4,6,11,13,-2,16
FC Goa,2251,8,4,3,7,11,17,-6,15
Mumbai City,2252,1,7,4,3,17,8,9,25
Delhi Dynamo,2252,2,5,5,4,23,16,7,20
Kolkata,2252,3,4,8,2,18,14,4,20
NorthEast Un,2252,4,5,4,5,11,10,1,19
FC Pune City,2252,5,4,5,5,13,15,-2,17
Kerala Blast,2252,6,4,5,5,9,16,-7,17
Chennaiyin,2252,7,3,7,4,15,19,-4,16
FC Goa,2252,8,3,4,7,10,18,-8,13
Mumbai City,2253,1,7,4,3,19,9,10,25
Kolkata,2253,2,5,6,3,23,17,6,21
NorthEast Un,2253,3,5,4,5,13,12,1,19
Delhi Dynamo,2253,4,4,6,4,23,19,4,18
FC Goa,2253,5,5,3,6,13,17,-4,18
FC Pune City,2253,6,4,4,6,16,20,-4,16
Chennaiyin,2253,7,3,7,4,15,19,-4,16
Kerala Blast,2253,8,4,4,6,12,21,-9,16
Mumbai City,2254,1,6,4,4,16,9,7,22
Delhi Dynamo,2254,2,5,6,3,24,17,7,21
Kolkata,2254,3,5,6,3,17,16,1,21
Kerala Blast,2254,4,6,3,5,14,15,-1,21
FC Pune City,2254,5,5,3,6,14,15,-1,18
NorthEast Un,2254,6,5,3,6,12,14,-2,18
Chennaiyin,2254,7,3,6,5,14,19,-5,15
FC Goa,2254,8,4,3,7,13,19,-6,15
Mumbai City,2255,1,7,4,3,18,9,9,25
Delhi Dynamo,2255,2,6,5,3,29,20,9,23
Kerala Blast,2255,3,6,3,5,13,14,-1,21
FC Pune City,2255,4,5,3,6,15,17,-2,18
Kolkata,2255,5,4,6,4,14,16,-2,18
Chennaiyin,2255,6,4,5,5,14,18,-4,17
FC Goa,2255,7,5,2,7,12,18,-6,17
NorthEast Un,2255,8,4,2,8,11,14,-3,14
Mumbai City,2256,1,7,4,3,18,9,9,25
Delhi Dynamo,2256,2,6,5,3,26,18,8,23
Kolkata,2256,3,5,7,2,20,16,4,22
Kerala Blast,2256,4,5,4,5,14,19,-5,19
NorthEast Un,2256,5,5,2,7,16,13,3,17
FC Pune City,2256,6,4,5,5,15,17,-2,17
Chennaiyin,2256,7,3,6,5,14,23,-9,15
FC Goa,2256,8,3,3,8,12,20,-8,12
Delhi Dynamo,2257,1,6,5,3,24,16,8,23
Mumbai City,2257,2,6,4,4,16,9,7,22
Kolkata,2257,3,5,6,3,18,14,4,21
FC Goa,2257,4,6,2,6,14,16,-2,20
NorthEast Un,2257,5,5,3,6,13,13,0,18
Kerala Blast,2257,6,5,3,6,12,19,-7,18
Chennaiyin,2257,7,3,6,5,15,20,-5,15
FC Pune City,2257,8,4,3,7,13,18,-5,15
Kolkata,2258,1,6,6,2,20,15,5,24
Delhi Dynamo,2258,2,6,5,3,24,15,9,23
Mumbai City,2258,3,6,4,4,16,10,6,22
Chennaiyin,2258,4,5,5,4,16,18,-2,20
Kerala Blast,2258,5,5,4,5,15,17,-2,19
NorthEast Un,2258,6,5,3,6,11,11,0,18
FC Pune City,2258,7,4,3,7,14,21,-7,15
FC Goa,2258,8,3,2,9,8,17,-9,11
Delhi Dynamo,2259,1,7,5,2,30,17,13,26
Mumbai City,2259,2,6,4,4,18,11,7,22
NorthEast Un,2259,3,6,2,6,13,12,1,20
Kolkata,2259,4,4,7,3,18,16,2,19
FC Pune City,2259,5,5,4,5,15,16,-1,19
Chennaiyin,2259,6,4,5,5,16,19,-3,17
Kerala Blast,2259,7,4,4,6,12,19,-7,16
FC Goa,2259,8,3,3,8,10,22,-12,12
Mumbai City,2260,1,7,4,3,19,10,9,25
NorthEast Un,2260,2,6,3,5,12,10,2,21
Kolkata,2260,3,4,8,2,16,14,2,20
FC Goa,2260,4,5,3,6,12,14,-2,18
Kerala Blast,2260,5,5,3,6,13,16,-3,18
Delhi Dynamo,2260,6,4,5,5,23,20,3,17
FC Pune City,2260,7,4,4,6,13,18,-5,16
Chennaiyin,2260,8,3,6,5,14,20,-6,15
Mumbai City,2261,1,7,4,3,20,9,11,25
Kolkata,2261,2,6,6,2,19,13,6,24
Kerala Blast,2261,3,6,3,5,12,16,-4,21
NorthEast Un,2261,4,6,2,6,13,12,1,20
Delhi Dynamo,2261,5,4,5,5,22,20,2,17
FC Goa,2261,6,5,2,7,13,17,-4,17
FC Pune City,2261,7,4,3,7,12,16,-4,15
Chennaiyin,2261,8,3,5,6,14,22,-8,14
Delhi Dynamo,2262,1,6,5,3,23,18,5,23
Mumbai City,2262,2,6,4,4,16,9,7,22
FC Pune City,2262,3,6,3,5,17,15,2,21
Kolkata,2262,4,4,7,3,17,17,0,19
Kerala Blast,2262,5,5,4,5,12,17,-5,19
NorthEast Un,2262,6,5,2,7,13,13,0,17
FC Goa,2262,7,5,2,7,16,17,-1,17
Chennaiyin,2262,8,3,5,6,13,21,-8,14
Mumbai City,2263,1,7,4,3,18,8,10,25
Kerala Blast,2263,2,5,5,4,13,16,-3,20
NorthEast Un,2263,3,5,4,5,16,13,3,19
Kolkata,2263,4,4,7,3,15,13,2,19
Delhi Dynamo,2263,5,4,5,5,22,21,1,17
Chennaiyin,2263,6,3,7,4,14,18,-4,16
FC Pune City,2263,7,4,4,6,12,16,-4,16
FC Goa,2263,8,4,4,6,10,15,-5,16
Delhi Dynamo,2264,1,6,6,2,27,15,12,24
Mumbai City,2264,2,6,4,4,17,11,6,22
Kolkata,2264,3,5,6,3,17,14,3,21
NorthEast Un,2264,4,5,4,5,14,11,3,19
Kerala Blast,2264,5,5,4,5,12,17,-5,19
FC Pune City,2264,6,5,3,6,13,15,-2,18
Chennaiyin,2264,7,3,6,5,14,21,-7,15
FC Goa,2264,8,3,3,8,10,20,-10,12
Mumbai City,2265,1,6,5,3,17,9,8,23
NorthEast Un,2265,2,6,2,6,14,14,0,20
Kolkata,2265,3,4,7,3,22,19,3,19
FC Pune City,2265,4,5,4,5,16,17,-1,19
Delhi Dynamo,2265,5,4,6,4,23,20,3,18
FC Goa,2265,6,5,3,6,16,16,0,18
Chennaiyin,2265,7,4,5,5,16,21,-5,17
Kerala Blast,2265,8,4,4,6,15,23,-8,16
Mumbai City,2266,1,7,4,3,18,9,9,25
NorthEast Un,2266,2,6,3,5,17,13,4,21
Kerala Blast,2266,3,5,4,5,14,18,-4,19
Delhi Dynamo,2266,4,4,6,4,24,20,4,18
Kolkata,2266,5,3,9,2,15,14,1,18
Chennaiyin,2266,6,4,6,4,15,18,-3,18
FC Pune City,2266,7,4,4,6,14,18,-4,16
FC Goa,2266,8,3,4,7,10,17,-7,13
Delhi Dynamo,2267,1,6,6,2,30,16,14,24
Mumbai City,2267,2,6,4,4,16,10,6,22
Kolkata,2267,3,5,6,3,17,14,3,21
NorthEast Un,2267,4,5,4,5,14,12,2,19
FC Pune City,2267,5,5,3,6,15,17,-2,18
Chennaiyin,2267,6,4,6,4,15,18,-3,18
Kerala Blast,2267,7,5,3,6,13,19,-6,18
FC Goa,2267,8,3,2,9,10,24,-14,11
Delhi Dynamo,2268,1,6,6,2,28,18,10,24
Mumbai City,2268,2,6,4,4,17,10,7,22
Kerala Blast,2268,3,6,4,4,13,14,-1,22
FC Pune City,2268,4,5,3,6,13,15,-2,18
Chennaiyin,2268,5,4,6,4,15,18,-3,18
NorthEast Un,2268,6,4,4,6,11,12,-1,16
FC Goa,2268,7,4,3,7,14,19,-5,15
Kolkata,2268,8,3,6,5,13,18,-5,15
Mumbai City,2269,1,7,4,3,19,10,9,25
Delhi Dynamo,2269,2,5,5,4,27,21,6,20
Kolkata,2269,3,4,7,3,18,16,2,19
FC Pune City,2269,4,5,4,5,13,14,-1,19
FC Goa,2269,5,5,3,6,16,16,0,18
Chennaiyin,2269,6,4,6,4,16,19,-3,18
Kerala Blast,2269,7,5,3,6,12,19,-7,18
NorthEast Un,2269,8,4,2,8,10,16,-6,14
Mumbai City,2270,1,6,4,4,16,9,7,22
Delhi Dynamo,2270,2,5,6,3,24,18,6,21
Kolkata,2270,3,4,7,3,18,16,2,19
FC Pune City,2270,4,5,4,5,18,18,0,19
Kerala Blast,2270,5,5,4,5,14,20,-6,19
Chennaiyin,2270,6,4,5,5,18,20,-2,17
NorthEast Un,2270,7,5,2,7,14,16,-2,17
FC Goa,2270,8,4,4,6,12,17,-5,16
Mumbai City,2271,1,7,4,3,18,9,9,25
Delhi Dynamo,2271,2,5,6,3,26,17,9,21
Kolkata,2271,3,4,7,3,16,15,1,19
NorthEast Un,2271,4,5,4,5,11,10,1,19
FC Pune City,2271,5,5,4,5,15,15,0,19
Kerala Blast,2271,6,5,3,6,10,16,-6,18
Chennaiyin,2271,7,3,7,4,14,18,-4,16
FC Goa,2271,8,3,3,8,10,20,-10,12
Mumbai City,2272,1,7,4,3,18,8,10,25
Delhi Dynamo,2272,2,6,5,3,26,19,7,23
FC Pune City,2272,3,6,3,5,15,14,1,21
Chennaiyin,2272,4,5,5,4,18,17,1,20
Kolkata,2272,5,3,8,3,17,17,0,17
Kerala Blast,2272,6,4,5,5,11,17,-6,17
NorthEast Un,2272,7,4,3,7,10,15,-5,15
FC Goa,2272,8,3,3,8,12,20,-8,12
Delhi Dynamo,2273,1,7,5,2,29,17,12,26
Mumbai City,2273,2,6,4,4,16,10,6,22
Kolkata,2273,3,5,6,3,17,15,2,21
Kerala Blast,2273,4,5,3,6,11,17,-6,18
FC Goa,2273,5,5,2,7,16,17,-1,17
NorthEast Un,2273,6,5,2,7,14,15,-1,17
Chennaiyin,2273,7,4,5,5,15,22,-7,17
FC Pune City,2273,8,4,3,7,12,17,-5,15
Delhi Dynamo,2274,1,7,5,2,29,14,15,26
Kolkata,2274,2,6,6,2,19,15,4,24
Mumbai City,2274,3,6,4,4,16,11,5,22
Chennaiyin,2274,4,4,6,4,17,19,-2,18
Kerala Blast,2274,5,4,5,5,10,15,-5,17
NorthEast Un,2274,6,4,4,6,11,12,-1,16
FC Pune City,2274,7,4,4,6,13,16,-3,16
FC Goa,2274,8,3,2,9,11,24,-13,11
Delhi Dynamo,2275,1,6,6,2,26,16,10,24
Mumbai City,2275,2,6,4,4,16,9,7,22
FC Pune City,2275,3,6,3,5,17,15,2,21
Kolkata,2275,4,4,6,4,16,16,0,18
NorthEast Un,2275,5,5,3,6,11,12,-1,18
FC Goa,2275,6,5,3,6,14,17,-3,18
Kerala Blast,2275,7,4,4,6,10,19,-9,16
Chennaiyin,2275,8,3,5,6,15,21,-6,14
Mumbai City,2276,1,6,4,4,16,9,7,22
Kolkata,2276,2,5,6,3,18,14,4,21
Delhi Dynamo,2276,3,5,5,4,24,18,6,20
NorthEast Un,2276,4,5,3,6,11,11,0,18
Chennaiyin,2276,5,4,6,4,16,17,-1,18
FC Pune City,2276,6,5,3,6,16,18,-2,18
Kerala Blast,2276,7,5,3,6,13,20,-7,18
FC Goa,2276,8,5,2,7,12,19,-7,17
Mumbai City,2277,1,7,4,3,19,9,10,25
Kolkata,2277,2,6,6,2,21,15,6,24
Delhi Dynamo,2277,3,5,6,3,27,19,8,21
NorthEast Un,2277,4,5,4,5,16,13,3,19
Chennaiyin,2277,5,4,6,4,17,19,-2,18
FC Pune City,2277,6,4,4,6,14,18,-4,16
Kerala Blast,2277,7,4,4,6,11,20,-9,16
FC Goa,2277,8,3,2,9,9,21,-12,11
Mumbai City,2278,1,7,4,3,17,8,9,25
Kolkata,2278,2,6,6,2,19,13,6,24
Delhi Dynamo,2278,3,5,5,4,24,17,7,20
NorthEast Un,2278,4,6,2,6,13,11,2,20
Kerala Blast,2278,5,5,4,5,10,14,-4,19
FC Pune City,2278,6,4,4,6,13,16,-3,16
Chennaiyin,2278,7,3,5,6,16,23,-7,14
FC Goa,2278,8,4,2,8,12,22,-10,14
Mumbai City,2279,1,7,4,3,20,10,10,25
Delhi Dynamo,2279,2,5,6,3,26,20,6,21
FC Pune City,2279,3,5,4,5,16,17,-1,19
Kerala Blast,2279,4,5,4,5,15,18,-3,19
NorthEast Un,2279,5,5,3,6,13,13,0,18
Kolkata,2279,6,3,8,3,15,16,-1,17
FC Goa,2279,7,5,2,7,14,17,-3,17
Chennaiyin,2279,8,3,5,6,14,22,-8,14
Mumbai City,2280,1,6,5,3,17,9,8,23
Delhi Dynamo,2280,2,5,6,3,25,18,7,21
Kolkata,2280,3,5,6,3,20,14,6,21
Chennaiyin,2280,4,4,6,4,16,19,-3,18
FC Goa,2280,5,5,2,7,12,16,-4,17
Kerala Blast,2280,6,4,5,5,10,17,-7,17
NorthEast Un,2280,7,4,4,6,12,14,-2,16
FC Pune City,2280,8,4,4,6,13,18,-5,16
Mumbai City,2281,1,7,4,3,19,10,9,25
Kolkata,2281,2,5,7,2,18,15,3,22
Kerala Blast,2281,3,6,4,4,14,15,-1,22
Delhi Dynamo,2281,4,4,7,3,29,23,6,19
Chennaiyin,2281,5,4,5,5,16,20,-4,17
NorthEast Un,2281,6,4,3,7,13,16,-3,15
FC Pune City,2281,7,4,3,7,13,17,-4,15
FC Goa,2281,8,4,3,7,13,19,-6,15
Mumbai City,2282,1,7,4,3,17,8,9,25
Delhi Dynamo,2282,2,5,5,4,26,19,7,20
Chennaiyin,2282,3,5,5,4,17,19,-2,20
Kerala Blast,2282,4,5,5,4,12,15,-3,20
Kolkata,2282,5,4,7,3,17,15,2,19
NorthEast Un,2282,6,5,3,6,13,12,1,18
FC Pune City,2282,7,4,3,7,15,20,-5,15
FC Goa,2282,8,4,2,8,12,21,-9,14
Delhi Dynamo,2283,1,5,7,2,27,19,8,22
Mumbai City,2283,2,6,4,4,18,11,7,22
Kerala Blast,2283,3,6,4,4,15,14,1,22
Chennaiyin,2283,4,5,5,4,17,19,-2,20
Kolkata,2283,5,4,7,3,15,16,-1,19
FC Pune City,2283,6,5,3,6,17,17,0,18
NorthEast Un,2283,7,4,3,7,12,16,-4,15
FC Goa,2283,8,3,3,8,10,19,-9,12
Mumbai City,2284,1,7,4,3,18,8,10,25
Kolkata,2284,2,5,6,3,17,17,0,21
Kerala Blast,2284,3,6,3,5,15,16,-1,21
Delhi Dynamo,2284,4,4,7,3,25,20,5,19
FC Pune City,2284,5,5,3,6,18,19,-1,18
NorthEast Un,2284,6,4,4,6,13,15,-2,16
Chennaiyin,2284,7,3,7,4,14,18,-4,16
FC Goa,2284,8,3,4,7,10,17,-7,13
Mumbai City,2285,1,6,5,3,19,11,8,23
NorthEast Un,2285,2,7,2,5,15,11,4,23
Kolkata,2285,3,4,8,2,16,14,2,20
Delhi Dynamo,2285,4,4,6,4,25,20,5,18
FC Pune City,2285,5,5,3,6,14,15,-1,18
Chennaiyin,2285,6,4,5,5,15,20,-5,17
Kerala Blast,2285,7,4,4,6,12,19,-7,16
FC Goa,2285,8,4,3,7,10,16,-6,15
Mumbai City,2286,1,7,4,3,17,8,9,25
Delhi Dynamo,2286,2,5,6,3,25,16,9,21
Kolkata,2286,3,4,7,3,16,16,0,19
FC Pune City,2286,4,5,4,5,14,14,0,19
Kerala Blast,2286,5,5,4,5,12,16,-4,19
Chennaiyin,2286,6,4,6,4,16,18,-2,18
NorthEast Un,2286,7,4,3,7,11,14,-3,15
FC Goa,2286,8,3,4,7,10,19,-9,13
Mumbai City,2287,1,7,4,3,17,8,9,25
Kolkata,2287,2,5,6,3,16,14,2,21
Kerala Blast,2287,3,6,3,5,13,15,-2,21
Delhi Dynamo,2287,4,5,5,4,24,16,8,20
FC Pune City,2287,5,5,3,6,15,17,-2,18
NorthEast Un,2287,6,5,2,7,10,13,-3,17
Chennaiyin,2287,7,4,5,5,15,20,-5,17
FC Goa,2287,8,4,2,8,11,18,-7,14
Mumbai City,2288,1,7,4,3,19,8,11,25
Delhi Dynamo,2288,2,6,5,3,26,18,8,23
Kerala Blast,2288,3,6,3,5,12,15,-3,21
FC Pune City,2288,4,5,4,5,14,15,-1,19
Chennaiyin,2288,5,4,6,4,17,20,-3,18
Kolkata,2288,6,3,7,4,15,16,-1,16
FC Goa,2288,7,4,3,7,12,18,-6,15
NorthEast Un,2288,8,4,2,8,12,17,-5,14
Mumbai City,2289,1,7,4,3,18,9,9,25
NorthEast Un,2289,2,7,2,5,16,9,7,23
Delhi Dynamo,2289,3,5,5,4,23,18,5,20
Kolkata,2289,4,4,8,2,14,12,2,20
Kerala Blast,2289,5,5,4,5,13,15,-2,19
FC Pune City,2289,6,4,4,6,12,18,-6,16
FC Goa,2289,7,4,2,8,9,16,-7,14
Chennaiyin,2289,8,3,5,6,13,21,-8,14
Kolkata,2290,1,6,6,2,17,13,4,24
Delhi Dynamo,2290,2,6,5,3,25,18,7,23
Mumbai City,2290,3,6,4,4,16,9,7,22
NorthEast Un,2290,4,5,4,5,15,13,2,19
FC Pune City,2290,5,5,3,6,16,15,1,18
Chennaiyin,2290,6,3,7,4,15,19,-4,16
Kerala Blast,2290,7,4,4,6,11,20,-9,16
FC Goa,2290,8,3,3,8,11,19,-8,12
Mumbai City,2291,1,6,5,3,18,10,8,23
Delhi Dynamo,2291,2,5,7,2,29,17,12,22
Kolkata,2291,3,5,6,3,18,15,3,21
NorthEast Un,2291,4,5,4,5,11,10,1,19
Kerala Blast,2291,5,5,3,6,12,17,-5,18
FC Goa,2291,6,5,2,7,11,20,-9,17
Chennaiyin,2291,7,3,6,5,13,18,-5,15
FC Pune City,2291,7,4,3,7,13,18,-5,15
Mumbai City,2292,1,7,4,3,19,10,9,25
Delhi Dynamo,2292,2,6,5,3,26,18,8,23
Kolkata,2292,3,4,7,3,15,14,1,19
NorthEast Un,2292,4,5,3,6,12,11,1,18
FC Pune City,2292,5,4,5,5,14,16,-2,17
FC Goa,2292,6,5,2,7,12,16,-4,17
Kerala Blast,2292,7,4,4,6,10,17,-7,16
Chennaiyin,2292,8,3,6,5,14,20,-6,15
Kolkata,2293,1,6,6,2,20,13,7,24
Mumbai City,2293,2,6,5,3,17,9,8,23
Delhi Dynamo,2293,3,4,7,3,22,18,4,19
NorthEast Un,2293,4,5,4,5,12,11,1,19
FC Pune City,2293,5,5,3,6,15,20,-5,18
FC Goa,2293,6,5,2,7,14,16,-2,17
Kerala Blast,2293,7,4,4,6,13,19,-6,16
Chennaiyin,2293,8,3,5,6,15,22,-7,14
Mumbai City,2294,1,7,4,3,18,9,9,25
Delhi Dynamo,2294,2,6,5,3,26,17,9,23
Kolkata,2294,3,5,7,2,17,14,3,22
FC Pune City,2294,4,5,3,6,14,16,-2,18
Kerala Blast,2294,5,5,3,6,16,20,-4,18
Chennaiyin,2294,6,3,7,4,15,19,-4,16
NorthEast Un,2294,7,4,3,7,13,16,-3,15
FC Goa,2294,8,3,4,7,9,17,-8,13
Delhi Dynamo,2295,1,7,5,2,26,16,10,26
Mumbai City,2295,2,6,4,4,16,9,7,22
Kerala Blast,2295,3,6,3,5,13,15,-2,21
Kolkata,2295,4,4,6,4,17,18,-1,18
FC Pune City,2295,5,5,3,6,15,18,-3,18
Chennaiyin,2295,6,4,5,5,17,20,-3,17
FC Goa,2295,7,5,2,7,16,19,-3,17
NorthEast Un,2295,8,4,2,8,10,15,-5,14
Mumbai City,2296,1,7,4,3,19,8,11,25
NorthEast Un,2296,2,7,2,5,17,11,6,23
Delhi Dynamo,2296,3,5,5,4,23,21,2,20
Kolkata,2296,4,4,7,3,17,14,3,19
Kerala Blast,2296,5,5,4,5,12,16,-4,19
Chennaiyin,2296,6,3,6,5,18,23,-5,15
FC Pune City,2296,7,4,3,7,13,19,-6,15
FC Goa,2296,8,4,3,7,14,21,-7,15
Mumbai City,2297,1,7,4,3,18,9,9,25
Kolkata,2297,2,5,7,2,19,15,4,22
Delhi Dynamo,2297,3,5,6,3,25,17,8,21
NorthEast Un,2297,4,6,2,6,13,12,1,20
FC Pune City,2297,5,5,4,5,16,17,-1,19
FC Goa,2297,6,4,3,7,13,17,-4,15
Kerala Blast,2297,7,4,3,7,10,18,-8,15
Chennaiyin,2297,8,3,5,6,14,23,-9,14
Kerala Blast,2298,1,7,3,4,14,14,0,24
Mumbai City,2298,2,6,5,3,17,9,8,23
Delhi Dynamo,2298,3,5,6,3,24,16,8,21
Kolkata,2298,4,4,7,3,16,15,1,19
FC Goa,2298,5,5,3,6,14,16,-2,18
NorthEast Un,2298,6,4,3,7,10,13,-3,15
FC Pune City,2298,7,4,3,7,14,19,-5,15
Chennaiyin,2298,8,3,6,5,15,22,-7,15
Mumbai City,2299,1,7,4,3,20,9,11,25
FC Pune City,2299,2,6,3,5,16,15,1,21
Delhi Dynamo,2299,3,5,5,4,28,22,6,20
NorthEast Un,2299,4,5,3,6,13,15,-2,18
Chennaiyin,2299,5,4,5,5,17,19,-2,17
Kerala Blast,2299,6,4,5,5,11,17,-6,17
FC Goa,2299,7,5,2,7,12,19,-7,17
Kolkata,2299,8,3,7,4,13,14,-1,16
Mumbai City,2300,1,7,4,3,20,8,12,25
FC Goa,2300,2,6,2,6,14,16,-2,20
NorthEast Un,2300,3,5,4,5,10,9,1,19
Kolkata,2300,4,4,7,3,18,18,0,19
Delhi Dynamo,2300,5,4,6,4,21,19,2,18
FC Pune City,2300,6,4,5,5,16,18,-2,17
Kerala Blast,2300,7,4,4,6,12,18,-6,16
Chennaiyin,2300,8,3,6,5,14,19,-5,15
Mumbai City,2301,1,6,4,4,16,9,7,22
Delhi Dynamo,2301,2,5,6,3,25,19,6,21
Kerala Blast,2301,3,5,5,4,14,17,-3,20
Kolkata,2301,4,4,7,3,17,16,1,19
NorthEast Un,2301,5,5,3,6,14,13,1,18
Chennaiyin,2301,6,4,6,4,14,17,-3,18
FC Pune City,2301,7,4,5,5,15,17,-2,17
FC Goa,2301,8,3,4,7,10,17,-7,13
Mumbai City,2302,1,7,4,3,18,9,9,25
Delhi Dynamo,2302,2,5,6,3,26,19,7,21
NorthEast Un,2302,3,6,3,5,16,12,4,21
Kolkata,2302,4,4,7,3,18,17,1,19
Kerala Blast,2302,5,5,3,6,13,19,-6,18
FC Pune City,2302,6,4,4,6,13,16,-3,16
FC Goa,2302,7,4,3,7,14,19,-5,15
Chennaiyin,2302,8,3,6,5,14,21,-7,15
Mumbai City,2303,1,7,4,3,18,8,10,25
Delhi Dynamo,2303,2,5,6,3,25,17,8,21
NorthEast Un,2303,3,6,2,6,13,14,-1,20
Kolkata,2303,4,4,7,3,14,13,1,19
FC Pune City,2303,5,5,4,5,13,14,-1,19
FC Goa,2303,6,4,4,6,10,15,-5,16
Kerala Blast,2303,7,4,4,6,10,16,-6,16
Chennaiyin,2303,8,3,5,6,14,20,-6,14
Mumbai City,2304,1,7,4,3,18,9,9,25
Kolkata,2304,2,5,7,2,21,17,4,22
Delhi Dynamo,2304,3,5,5,4,24,18,6,20
FC Goa,2304,4,5,3,6,15,17,-2,18
Kerala Blast,2304,5,4,5,5,12,18,-6,17
NorthEast Un,2304,6,4,4,6,12,13,-1,16
FC Pune City,2304,7,4,4,6,15,18,-3,16
Chennaiyin,2304,8,3,6,5,15,22,-7,15
Mumbai City,2305,1,7,4,3,24,8,16,25
FC Goa,2305,2,6,2,6,16,16,0,20
NorthEast Un,2305,3,5,4,5,12,10,2,19
Kolkata,2305,4,4,7,3,18,18,0,19
Kerala Blast,2305,5,4,6,4,11,15,-4,18
Delhi Dynamo,2305,6,4,5,5,21,25,-4,17
FC Pune City,2305,7,4,4,6,12,16,-4,16
Chennaiyin,2305,8,3,6,5,15,21,-6,15
Mumbai City,2306,1,6,5,3,16,8,8,23
Delhi Dynamo,2306,2,5,7,2,22,14,8,22
Kolkata,2306,3,5,6,3,18,14,4,21
Kerala Blast,2306,4,5,4,5,12,17,-5,19
FC Pune City,2306,5,5,3,6,16,18,-2,18
NorthEast Un,2306,6,4,5,5,9,9,0,17
Chennaiyin,2306,7,3,6,5,13,20,-7,15
FC Goa,2306,8,4,2,8,11,17,-6,14
Delhi Dynamo,2307,1,6,6,2,26,15,11,24
Kolkata,2307,2,6,6,2,19,13,6,24
Mumbai City,2307,3,6,5,3,17,9,8,23
NorthEast Un,2307,4,6,2,6,14,11,3,20
FC Pune City,2307,5,5,3,6,17,15,2,18
Kerala Blast,2307,6,4,3,7,10,24,-14,15
Chennaiyin,2307,7,3,5,6,14,20,-6,14
FC Goa,2307,8,4,2,8,11,21,-10,14
Mumbai City,2308,1,7,4,3,20,9,11,25
Delhi Dynamo,2308,2,6,5,3,27,19,8,23
NorthEast Un,2308,3,6,2,6,12,12,0,20
FC Pune City,2308,4,5,4,5,14,15,-1,19
Kerala Blast,2308,5,5,4,5,10,14,-4,19
Kolkata,2308,6,3,7,4,14,15,-1,16
FC Goa,2308,7,4,3,7,11,16,-5,15
Chennaiyin,2308,8,3,5,6,13,21,-8,14
Mumbai City,2309,1,7,4,3,18,8,10,25
Kerala Blast,2309,2,6,4,4,17,15,2,22
Delhi Dynamo,2309,3,5,5,4,24,18,6,20
Kolkata,2309,4,3,9,2,15,14,1,18
Chennaiyin,2309,5,3,7,4,15,19,-4,16
FC Goa,2309,6,4,4,6,11,16,-5,16
FC Pune City,2309,7,4,4,6,14,21,-7,16
NorthEast Un,2309,8,4,3,7,12,15,-3,15
Kolkata,2310,1,6,6,2,21,13,8,24
Delhi Dynamo,2310,2,6,5,3,25,17,8,23
Mumbai City,2310,3,6,4,4,16,10,6,22
NorthEast Un,2310,4,6,2,6,12,12,0,20
FC Pune City,2310,5,5,3,6,17,18,-1,18
Kerala Blast,2310,6,5,3,6,12,20,-8,18
Chennaiyin,2310,7,4,5,5,15,18,-3,17
FC Goa,2310,8,3,2,9,9,19,-10,11
Mumbai City,2311,1,7,4,3,20,9,11,25
Delhi Dynamo,2311,2,5,5,4,23,20,3,20
NorthEast Un,2311,3,6,2,6,12,11,1,20
Kolkata,2311,4,4,7,3,14,13,1,19
Kerala Blast,2311,5,5,4,5,11,15,-4,19
Chennaiyin,2311,6,4,5,5,16,22,-6,17
FC Pune City,2311,7,4,4,6,13,16,-3,16
FC Goa,2311,8,4,3,7,13,16,-3,15
Mumbai City,2312,1,7,4,3,17,8,9,25
Delhi Dynamo,2312,2,5,6,3,24,15,9,21
Kerala Blast,2312,3,5,5,4,12,15,-3,20
Kolkata,2312,4,3,8,3,14,14,0,17
FC Pune City,2312,5,4,5,5,13,15,-2,17
Chennaiyin,2312,6,4,5,5,17,21,-4,17
FC Goa,2312,7,4,4,6,12,17,-5,16
NorthEast Un,2312,8,4,3,7,11,15,-4,15
Delhi Dynamo,2313,1,6,6,2,26,16,10,24
Mumbai City,2313,2,6,5,3,16,8,8,23
FC Pune City,2313,3,6,3,5,16,16,0,21
NorthEast Un,2313,4,5,3,6,13,11,2,18
Kolkata,2313,5,3,7,4,16,18,-2,16
Chennaiyin,2313,6,3,7,4,13,17,-4,16
Kerala Blast,2313,7,4,4,6,10,18,-8,16
FC Goa,2313,8,4,3,7,13,19,-6,15
Mumbai City,2314,1,6,5,3,17,9,8,23
Delhi Dynamo,2314,2,5,7,2,24,16,8,22
Kerala Blast,2314,3,5,5,4,13,16,-3,20
Kolkata,2314,4,4,6,4,14,16,-2,18
FC Goa,2314,5,5,3,6,13,15,-2,18
NorthEast Un,2314,6,4,4,6,11,12,-1,16
FC Pune City,2314,7,4,4,6,14,17,-3,16
Chennaiyin,2314,8,3,6,5,14,19,-5,15
Mumbai City,2315,1,7,4,3,21,8,13,25
Kerala Blast,2315,2,7,3,4,13,14,-1,24
Delhi Dynamo,2315,3,5,6,3,25,20,5,21
Kolkata,2315,4,4,7,3,17,16,1,19
NorthEast Un,2315,5,5,3,6,12,12,0,18
FC Pune City,2315,6,4,4,6,13,16,-3,16
Chennaiyin,2315,7,3,6,5,14,19,-5,15
FC Goa,2315,8,3,3,8,9,19,-10,12
Delhi Dynamo,2316,1,6,6,2,26,16,10,24
Mumbai City,2316,2,6,5,3,18,10,8,23
FC Pune City,2316,3,6,3,5,18,14,4,21
Kolkata,2316,4,4,6,4,16,19,-3,18
Kerala Blast,2316,5,5,3,6,11,17,-6,18
Chennaiyin,2316,6,4,5,5,18,20,-2,17
NorthEast Un,2316,7,5,2,7,11,15,-4,17
FC Goa,2316,8,4,2,8,11,18,-7,14
Delhi Dynamo,2317,1,6,5,3,26,19,7,23
Kolkata,2317,2,5,7,2,22,15,7,22
Mumbai City,2317,3,6,4,4,18,11,7,22
NorthEast Un,2317,4,6,2,6,12,13,-1,20
Kerala Blast,2317,5,5,3,6,10,19,-9,18
Chennaiyin,2317,6,4,5,5,18,20,-2,17
FC Pune City,2317,7,4,4,6,14,17,-3,16
FC Goa,2317,8,4,2,8,13,19,-6,14
Delhi Dynamo,2318,1,7,5,2,26,16,10,26
Kerala Blast,2318,2,7,3,4,16,14,2,24
Mumbai City,2318,3,6,4,4,16,9,7,22
Kolkata,2318,4,3,8,3,16,17,-1,17
Chennaiyin,2318,5,4,5,5,16,20,-4,17
FC Pune City,2318,6,4,4,6,13,18,-5,16
FC Goa,2318,7,4,3,7,12,18,-6,15
NorthEast Un,2318,8,4,2,8,11,14,-3,14
Delhi Dynamo,2319,1,7,5,2,27,15,12,26
Mumbai City,2319,2,6,4,4,17,10,7,22
Kolkata,2319,3,5,7,2,16,13,3,22
Kerala Blast,2319,4,5,5,4,14,16,-2,20
NorthEast Un,2319,5,4,4,6,12,14,-2,16
Chennaiyin,2319,6,3,7,4,14,18,-4,16
FC Pune City,2319,7,4,3,7,12,17,-5,15
FC Goa,2319,8,3,3,8,10,19,-9,12
Mumbai City,2320,1,7,4,3,18,9,9,25
Delhi Dynamo,2320,2,5,5,4,26,18,8,20
NorthEast Un,2320,3,6,2,6,14,10,4,20
Kolkata,2320,4,4,7,3,15,15,0,19
Chennaiyin,2320,5,4,6,4,14,17,-3,18
FC Pune City,2320,6,4,5,5,14,16,-2,17
Kerala Blast,2320,7,4,4,6,10,18,-8,16
FC Goa,2320,8,4,3,7,10,18,-8,15
Delhi Dynamo,2321,1,7,5,2,29,17,12,26
Mumbai City,2321,2,6,4,4,18,11,7,22
Kerala Blast,2321,3,5,4,5,12,17,-5,19
Kolkata,2321,4,4,6,4,17,17,0,18
FC Pune City,2321,5,5,3,6,16,17,-1,18
Chennaiyin,2321,6,4,5,5,16,19,-3,17
FC Goa,2321,7,5,2,7,13,19,-6,17
NorthEast Un,2321,8,4,3,7,10,14,-4,15
Mumbai City,2322,1,6,5,3,16,8,8,23
Delhi Dynamo,2322,2,5,6,3,24,16,8,21
Kerala Blast,2322,3,6,3,5,15,14,1,21
Kolkata,2322,4,4,7,3,20,16,4,19
FC Pune City,2322,5,5,3,6,14,20,-6,18
Chennaiyin,2322,6,4,5,5,15,19,-4,17
NorthEast Un,2322,7,5,2,7,11,16,-5,17
FC Goa,2322,8,4,3,7,11,17,-6,15
Mumbai City,2323,1,7,4,3,17,8,9,25
Delhi Dynamo,2323,2,5,5,4,24,18,6,20
FC Pune City,2323,3,5,4,5,16,16,0,19
Kolkata,2323,4,4,6,4,17,18,-1,18
Chennaiyin,2323,5,4,6,4,16,18,-2,18
Kerala Blast,2323,6,4,5,5,10,15,-5,17
FC Goa,2323,7,5,2,7,12,18,-6,17
NorthEast Un,2323,8,4,4,6,12,13,-1,16
Delhi Dynamo,2324,1,6,6,2,27,16,11,24
Kolkata,2324,2,6,6,2,18,14,4,24
Mumbai City,2324,3,6,5,3,17,9,8,23
Kerala Blast,2324,4,6,3,5,13,16,-3,21
NorthEast Un,2324,5,5,2,7,13,13,0,17
Chennaiyin,2324,6,4,5,5,15,21,-6,17
FC Pune City,2324,7,4,3,7,13,17,-4,15
FC Goa,2324,8,3,2,9,12,22,-10,11
Mumbai City,2325,1,7,4,3,18,9,9,25
Delhi Dynamo,2325,2,6,5,3,25,17,8,23
Kerala Blast,2325,3,6,4,4,14,14,0,22
Kolkata,2325,4,4,8,2,15,13,2,20
NorthEast Un,2325,5,5,2,7,12,13,-1,17
FC Pune City,2325,6,4,3,7,13,19,-6,15
FC Goa,2325,7,4,3,7,11,17,-6,15
Chennaiyin,2325,8,3,5,6,15,21,-6,14
Delhi Dynamo,2326,1,7,5,2,26,14,12,26
Mumbai City,2326,2,6,4,4,16,10,6,22
Kolkata,2326,3,4,7,3,19,17,2,19
NorthEast Un,2326,4,5,3,6,13,12,1,18
Chennaiyin,2326,5,4,6,4,15,18,-3,18
Kerala Blast,2326,6,4,5,5,12,18,-6,17
FC Pune City,2326,7,4,4,6,15,19,-4,16
FC Goa,2326,8,4,2,8,10,18,-8,14
Mumbai City,2327,1,6,4,4,16,9,7,22
Delhi Dynamo,2327,2,5,6,3,23,17,6,21
FC Pune City,2327,3,5,4,5,17,17,0,19
Kolkata,2327,3,4,7,3,17,17,0,19
Kerala Blast,2327,5,5,4,5,13,16,-3,19
NorthEast Un,2327,6,5,3,6,12,13,-1,18
Chennaiyin,2327,7,4,5,5,16,19,-3,17
FC Goa,2327,8,4,3,7,10,16,-6,15
Mumbai City,2328,1,7,4,3,18,8,10,25
Delhi Dynamo,2328,2,5,6,3,25,19,6,21
Kolkata,2328,3,5,6,3,16,16,0,21
Kerala Blast,2328,4,5,4,5,12,15,-3,19
Chennaiyin,2328,5,4,6,4,17,20,-3,18
FC Goa,2328,6,4,4,6,16,19,-3,16
FC Pune City,2328,7,4,4,6,13,16,-3,16
NorthEast Un,2328,8,4,2,8,11,15,-4,14
Delhi Dynamo,2329,1,6,6,2,27,16,11,24
Mumbai City,2329,2,6,5,3,17,9,8,23
Kerala Blast,2329,3,5,5,4,13,16,-3,20
Kolkata,2329,4,4,7,3,18,17,1,19
NorthEast Un,2329,5,5,3,6,13,12,1,18
FC Pune City,2329,6,4,4,6,13,16,-3,16
FC Goa,2329,7,4,3,7,14,21,-7,15
Chennaiyin,2329,8,3,5,6,14,22,-8,14
Mumbai City,2330,1,6,4,4,16,10,6,22
Delhi Dynamo,2330,2,5,5,4,23,17,6,20
Chennaiyin,2330,3,5,5,4,18,18,0,20
Kerala Blast,2330,4,5,5,4,13,16,-3,20
FC Pune City,2330,5,5,4,5,14,14,0,19
NorthEast Un,2330,6,5,3,6,12,11,1,18
FC Goa,2330,7,5,2,7,11,18,-7,17
Kolkata,2330,8,3,6,5,15,18,-3,15
Delhi Dynamo,2331,1,6,5,3,27,19,8,23
Mumbai City,2331,2,6,4,4,18,11,7,22
Kerala Blast,2331,3,5,4,5,12,16,-4,19
Kolkata,2331,4,4,6,4,17,17,0,18
NorthEast Un,2331,5,5,3,6,11,11,0,18
FC Pune City,2331,6,5,3,6,14,16,-2,18
Chennaiyin,2331,7,4,6,4,14,17,-3,18
FC Goa,2331,8,4,3,7,12,18,-6,15
Mumbai City,2332,1,7,4,3,19,10,9,25
Delhi Dynamo,2332,2,6,5,3,28,19,9,23
Kolkata,2332,3,4,7,3,15,14,1,19
FC Pune City,2332,4,5,4,5,14,15,-1,19
Kerala Blast,2332,5,5,4,5,11,15,-4,19
NorthEast Un,2332,6,4,4,6,10,11,-1,16
Chennaiyin,2332,7,3,7,4,14,18,-4,16
FC Goa,2332,8,3,3,8,11,20,-9,12
Delhi Dynamo,2333,1,6,6,2,25,15,10,24
Mumbai City,2333,2,6,5,3,16,8,8,23
Kolkata,2333,3,5,6,3,23,16,7,21
Kerala Blast,2333,4,5,4,5,13,20,-7,19
Chennaiyin,2333,5,4,5,5,17,21,-4,17
FC Goa,2333,6,5,2,7,14,19,-5,17
FC Pune City,2333,7,4,4,6,14,17,-3,16
NorthEast Un,2333,8,4,2,8,9,15,-6,14
Mumbai City,2334,1,7,4,3,17,8,9,25
Delhi Dynamo,2334,2,6,5,3,26,15,11,23
Kerala Blast,2334,3,5,5,4,14,17,-3,20
Kolkata,2334,4,4,7,3,20,19,1,19
FC Pune City,2334,5,4,5,5,14,16,-2,17
Chennaiyin,2334,6,4,5,5,17,21,-4,17
NorthEast Un,2334,7,4,3,7,12,15,-3,15
FC Goa,2334,8,4,2,8,11,20,-9,14
Delhi Dynamo,2335,1,6,5,3,24,17,7,23
Mumbai City,2335,2,6,4,4,16,9,7,22
NorthEast Un,2335,3,6,2,6,13,11,2,20
FC Pune City,2335,4,5,4,5,18,17,1,19
Kolkata,2335,5,4,7,3,14,15,-1,19
Chennaiyin,2335,6,4,6,4,18,21,-3,18
Kerala Blast,2335,7,4,4,6,12,18,-6,16
FC Goa,2335,8,3,4,7,12,19,-7,13
Mumbai City,2336,1,7,4,3,19,9,10,25
Kolkata,2336,2,5,7,2,19,15,4,22
Kerala Blast,2336,3,6,4,4,13,15,-2,22
NorthEast Un,2336,4,6,2,6,12,11,1,20
Delhi Dynamo,2336,5,4,6,4,23,19,4,18
FC Goa,2336,6,4,3,7,12,16,-4,15
FC Pune City,2336,7,4,3,7,13,18,-5,15
Chennaiyin,2336,8,3,5,6,14,22,-8,14
Mumbai City,2337,1,7,4,3,18,8,10,25
Kolkata,2337,2,6,6,2,21,14,7,24
Chennaiyin,2337,3,5,5,4,15,17,-2,20
NorthEast Un,2337,4,5,3,6,14,10,4,18
Delhi Dynamo,2337,5,4,6,4,22,22,0,18
Kerala Blast,2337,6,4,5,5,12,17,-5,17
FC Pune City,2337,7,4,4,6,15,20,-5,16
FC Goa,2337,8,3,3,8,9,18,-9,12
Mumbai City,2338,1,6,5,3,16,8,8,23
NorthEast Un,2338,2,6,3,5,18,11,7,21
FC Pune City,2338,3,6,3,5,15,15,0,21
Delhi Dynamo,2338,4,4,8,2,23,16,7,20
FC Goa,2338,5,5,3,6,15,16,-1,18
Kolkata,2338,6,3,7,4,15,19,-4,16
Kerala Blast,2338,7,4,4,6,12,20,-8,16
Chennaiyin,2338,8,3,5,6,15,24,-9,14
Mumbai City,2339,1,6,5,3,17,9,8,23
FC Goa,2339,2,6,2,6,13,16,-3,20
Delhi Dynamo,2339,3,4,7,3,24,18,6,19
Kolkata,2339,4,4,7,3,19,15,4,19
FC Pune City,2339,5,5,4,5,15,15,0,19
Chennaiyin,2339,6,4,5,5,16,20,-4,17
NorthEast Un,2339,7,4,4,6,11,12,-1,16
Kerala Blast,2339,8,4,4,6,10,20,-10,16
Mumbai City,2340,1,7,4,3,17,8,9,25
Delhi Dynamo,2340,2,6,5,3,26,16,10,23
Kerala Blast,2340,3,6,4,4,13,15,-2,22
Kolkata,2340,4,5,6,3,17,15,2,21
NorthEast Un,2340,5,5,2,7,14,13,1,17
FC Pune City,2340,6,4,4,6,12,15,-3,16
FC Goa,2340,7,4,2,8,11,19,-8,14
Chennaiyin,2340,8,3,5,6,13,22,-9,14
Mumbai City,2341,1,7,4,3,18,8,10,25
NorthEast Un,2341,2,6,3,5,17,13,4,21
Kerala Blast,2341,3,5,5,4,13,15,-2,20
Kolkata,2341,4,4,7,3,17,17,0,19
Delhi Dynamo,2341,5,4,6,4,22,19,3,18
FC Pune City,2341,6,4,4,6,13,16,-3,16
Chennaiyin,2341,7,3,6,5,15,21,-6,15
FC Goa,2341,8,3,5,6,11,17,-6,14
Mumbai City,2342,1,6,5,3,17,9,8,23
Delhi Dynamo,2342,2,5,7,2,27,19,8,22
Kerala Blast,2342,3,6,3,5,15,19,-4,21
Kolkata,2342,4,4,7,3,18,16,2,19
FC Pune City,2342,5,5,3,6,15,17,-2,18
Chennaiyin,2342,6,4,6,4,15,18,-3,18
NorthEast Un,2342,7,4,4,6,13,14,-1,16
FC Goa,2342,8,3,3,8,10,18,-8,12
Delhi Dynamo,2343,1,6,6,2,29,17,12,24
Mumbai City,2343,2,6,4,4,16,10,6,22
NorthEast Un,2343,3,5,4,5,15,13,2,19
Kolkata,2343,4,4,7,3,15,15,0,19
Kerala Blast,2343,5,5,4,5,12,16,-4,19
FC Pune City,2343,6,5,3,6,15,16,-1,18
FC Goa,2343,7,4,3,7,10,17,-7,15
Chennaiyin,2343,8,3,5,6,13,21,-8,14
Mumbai City,2344,1,7,4,3,19,8,11,25
Delhi Dynamo,2344,2,5,6,3,24,19,5,21
Kerala Blast,2344,3,5,5,4,12,15,-3,20
NorthEast Un,2344,4,5,4,5,12,10,2,19
Kolkata,2344,5,4,7,3,14,13,1,19
Chennaiyin,2344,6,4,5,5,15,20,-5,17
FC Pune City,2344,7,4,3,7,13,17,-4,15
FC Goa,2344,8,4,2,8,12,19,-7,14
Delhi Dynamo,2345,1,6,6,2,29,15,14,24
Mumbai City,2345,2,6,4,4,16,12,4,22
Kolkata,2345,3,4,8,2,15,13,2,20
Kerala Blast,2345,4,5,4,5,12,16,-4,19
Chennaiyin,2345,5,4,6,4,17,19,-2,18
FC Pune City,2345,6,4,5,5,14,16,-2,17
NorthEast Un,2345,7,4,4,6,11,12,-1,16
FC Goa,2345,8,3,3,8,10,21,-11,12
NorthEast Un,2346,1,7,2,5,14,9,5,23
Mumbai City,2346,2,6,4,4,17,11,6,22
Delhi Dynamo,2346,3,5,5,4,24,19,5,20
FC Pune City,2346,4,5,4,5,15,16,-1,19
FC Goa,2346,5,5,3,6,13,16,-3,18
Kerala Blast,2346,6,4,5,5,11,16,-5,17
Kolkata,2346,7,3,7,4,15,17,-2,16
Chennaiyin,2346,8,3,6,5,15,20,-5,15
Mumbai City,2347,1,6,5,3,17,9,8,23
Delhi Dynamo,2347,2,5,7,2,25,16,9,22
Chennaiyin,2347,3,5,5,4,20,18,2,20
Kolkata,2347,4,4,6,4,20,17,3,18
NorthEast Un,2347,5,5,3,6,11,13,-2,18
FC Pune City,2347,6,5,3,6,14,17,-3,18
Kerala Blast,2347,7,5,3,6,13,21,-8,18
FC Goa,2347,8,4,2,8,13,22,-9,14
Delhi Dynamo,2348,1,6,5,3,27,18,9,23
Mumbai City,2348,2,6,4,4,17,11,6,22
Kerala Blast,2348,3,6,3,5,15,14,1,21
NorthEast Un,2348,4,6,2,6,13,14,-1,20
Kolkata,2348,5,4,7,3,17,17,0,19
FC Pune City,2348,6,5,3,6,14,17,-3,18
Chennaiyin,2348,7,3,6,5,13,18,-5,15
FC Goa,2348,8,3,4,7,9,16,-7,13
Mumbai City,2349,1,6,5,3,16,8,8,23
Delhi Dynamo,2349,2,5,6,3,24,18,6,21
NorthEast Un,2349,3,6,3,5,14,10,4,21
Kerala Blast,2349,4,5,5,4,12,15,-3,20
Kolkata,2349,5,4,7,3,17,15,2,19
Chennaiyin,2349,6,4,5,5,16,19,-3,17
FC Pune City,2349,7,4,4,6,14,18,-4,16
FC Goa,2349,8,3,3,8,11,21,-10,12
Mumbai City,2350,1,6,5,3,16,8,8,23
Delhi Dynamo,2350,2,5,7,2,25,14,11,22
Kolkata,2350,3,4,7,3,17,14,3,19
FC Pune City,2350,4,5,4,5,13,14,-1,19
NorthEast Un,2350,5,5,3,6,11,11,0,18
Chennaiyin,2350,6,4,5,5,15,19,-4,17
Kerala Blast,2350,7,4,4,6,10,18,-8,16
FC Goa,2350,8,4,3,7,9,18,-9,15
Mumbai City,2351,1,6,5,3,18,10,8,23
Delhi Dynamo,2351,2,5,7,2,27,18,9,22
Kerala Blast,2351,3,6,4,4,13,15,-2,22
Kolkata,2351,4,4,6,4,15,14,1,18
Chennaiyin,2351,5,4,6,4,16,19,-3,18
NorthEast Un,2351,6,4,4,6,13,15,-2,16
FC Pune City,2351,7,4,3,7,12,17,-5,15
FC Goa,2351,8,4,3,7,11,17,-6,15
Mumbai City,2352,1,7,4,3,18,8,10,25
Kerala Blast,2352,2,6,4,4,13,15,-2,22
Delhi Dynamo,2352,3,5,6,3,24,18,6,21
Kolkata,2352,4,4,7,3,19,17,2,19
FC Goa,2352,5,5,2,7,13,17,-4,17
NorthEast Un,2352,6,4,4,6,11,12,-1,16
FC Pune City,2352,7,4,3,7,13,18,-5,15
Chennaiyin,2352,8,3,6,5,14,20,-6,15
Mumbai City,2353,1,6,5,3,17,9,8,23
Delhi Dynamo,2353,2,4,8,2,25,18,7,20
NorthEast Un,2353,3,5,4,5,12,11,1,19
Kolkata,2353,4,3,9,2,14,13,1,18
Kerala Blast,2353,5,4,6,4,12,16,-4,18
FC Pune City,2353,6,4,5,5,15,17,-2,17
FC Goa,2353,7,4,4,6,12,17,-5,16
Chennaiyin,2353,8,3,5,6,14,20,-6,14
Mumbai City,2354,1,7,4,3,18,9,9,25
FC Pune City,2354,2,6,3,5,16,16,0,21
Kerala Blast,2354,3,6,3,5,15,18,-3,21
Delhi Dynamo,2354,4,4,6,4,25,20,5,18
Chennaiyin,2354,5,4,6,4,14,17,-3,18
NorthEast Un,2354,6,5,2,7,11,12,-1,17
FC Goa,2354,7,4,4,6,13,17,-4,16
Kolkata,2354,8,3,6,5,16,19,-3,15
Mumbai City,2355,1,6,5,3,17,9,8,23
Delhi Dynamo,2355,2,5,7,2,25,16,9,22
Kolkata,2355,3,5,7,2,17,13,4,22
Kerala Blast,2355,4,5,5,4,14,17,-3,20
NorthEast Un,2355,5,5,3,6,13,14,-1,18
FC Goa,2355,6,4,3,7,14,18,-4,15
FC Pune City,2355,7,4,3,7,12,16,-4,15
Chennaiyin,2355,8,3,5,6,14,23,-9,14
Mumbai City,2356,1,7,4,3,18,8,10,25
Kerala Blast,2356,2,6,4,4,12,14,-2,22
Delhi Dynamo,2356,3,4,6,4,22,20,2,18
Kolkata,2356,4,3,9,2,15,14,1,18
NorthEast Un,2356,5,5,2,7,12,11,1,17
Chennaiyin,2356,6,4,5,5,14,18,-4,17
FC Pune City,2356,7,4,4,6,13,16,-3,16
FC Goa,2356,8,4,4,6,10,15,-5,16
Delhi Dynamo,2357,1,6,6,2,27,16,11,24
Mumbai City,2357,2,6,4,4,16,9,7,22
Kerala Blast,2357,3,6,3,5,16,17,-1,21
NorthEast Un,2357,4,5,4,5,14,13,1,19
Chennaiyin,2357,5,4,6,4,17,19,-2,18
FC Pune City,2357,6,5,3,6,14,18,-4,18
Kolkata,2357,7,3,7,4,17,18,-1,16
FC Goa,2357,8,3,3,8,10,21,-11,12
Mumbai City,2358,1,7,4,3,17,8,9,25
Kolkata,2358,2,5,7,2,19,13,6,22
Delhi Dynamo,2358,3,5,6,3,22,15,7,21
Kerala Blast,2358,4,5,4,5,13,17,-4,19
FC Pune City,2358,5,5,3,6,14,16,-2,18
NorthEast Un,2358,6,4,4,6,11,12,-1,16
Chennaiyin,2358,7,3,7,4,14,18,-4,16
FC Goa,2358,8,3,3,8,10,21,-11,12
Delhi Dynamo,2359,1,7,5,2,28,16,12,26
Mumbai City,2359,2,6,4,4,16,10,6,22
Kolkata,2359,3,5,6,3,17,14,3,21
Kerala Blast,2359,4,6,3,5,17,16,1,21
Chennaiyin,2359,5,4,5,5,17,19,-2,17
FC Goa,2359,6,5,2,7,11,17,-6,17
FC Pune City,2359,7,4,3,7,14,22,-8,15
NorthEast Un,2359,8,4,2,8,11,17,-6,14
Mumbai City,2360,1,7,4,3,17,8,9,25
Delhi Dynamo,2360,2,6,5,3,23,15,8,23
Kerala Blast,2360,3,5,5,4,13,15,-2,20
NorthEast Un,2360,4,5,3,6,11,11,0,18
FC Pune City,2360,5,5,3,6,15,16,-1,18
Kolkata,2360,6,3,7,4,14,17,-3,16
Chennaiyin,2360,7,3,6,5,14,19,-5,15
FC Goa,2360,8,4,3,7,10,16,-6,15
Kolkata,2361,1,5,7,2,18,12,6,22
Mumbai City,2361,2,6,4,4,16,10,6,22
Delhi Dynamo,2361,3,5,6,3,24,16,8,21
Kerala Blast,2361,4,5,4,5,11,15,-4,19
FC Pune City,2361,5,5,3,6,14,19,-5,18
FC Goa,2361,6,5,2,7,12,17,-5,17
NorthEast Un,2361,7,4,4,6,13,14,-1,16
Chennaiyin,2361,8,3,6,5,18,23,-5,15
Mumbai City,2362,1,6,5,3,17,9,8,23
Delhi Dynamo,2362,2,4,8,2,22,15,7,20
Kolkata,2362,3,4,7,3,15,16,-1,19
Kerala Blast,2362,4,5,4,5,12,14,-2,19
FC Pune City,2362,5,5,3,6,13,15,-2,18
Chennaiyin,2362,6,4,5,5,16,19,-3,17
NorthEast Un,2362,7,4,4,6,10,12,-2,16
FC Goa,2362,8,4,4,6,10,15,-5,16
Mumbai City,2363,1,6,5,3,17,9,8,23
NorthEast Un,2363,2,7,2,5,15,10,5,23
Kolkata,2363,3,5,7,2,17,13,4,22
Delhi Dynamo,2363,4,4,7,3,24,18,6,19
FC Pune City,2363,5,5,3,6,14,17,-3,18
Chennaiyin,2363,6,4,5,5,18,20,-2,17
Kerala Blast,2363,7,4,4,6,9,17,-8,16
FC Goa,2363,8,3,3,8,11,21,-10,12
Mumbai City,2364,1,7,4,3,18,8,10,25
NorthEast Un,2364,2,7,2,5,12,9,3,23
FC Pune City,2364,3,5,4,5,15,16,-1,19
Delhi Dynamo,2364,4,4,6,4,23,19,4,18
Kerala Blast,2364,5,5,3,6,11,16,-5,18
Kolkata,2364,6,3,7,4,14,15,-1,16
FC Goa,2364,7,4,4,6,11,16,-5,16
Chennaiyin,2364,8,3,6,5,13,18,-5,15
Mumbai City,2365,1,7,4,3,17,8,9,25
Delhi Dynamo,2365,2,6,5,3,27,18,9,23
Kolkata,2365,3,5,6,3,18,17,1,21
Kerala Blast,2365,4,6,3,5,14,17,-3,21
NorthEast Un,2365,5,6,2,6,16,13,3,20
Chennaiyin,2365,6,4,5,5,15,20,-5,17
FC Pune City,2365,7,4,3,7,12,17,-5,15
FC Goa,2365,8,3,2,9,11,20,-9,11
Mumbai City,2366,1,7,4,3,18,8,10,25
Delhi Dynamo,2366,2,5,6,3,23,17,6,21
Kolkata,2366,3,4,8,2,17,14,3,20
Chennaiyin,2366,4,5,5,4,18,18,0,20
Kerala Blast,2366,5,5,5,4,13,15,-2,20
NorthEast Un,2366,6,4,3,7,11,14,-3,15
FC Pune City,2366,7,4,3,7,13,19,-6,15
FC Goa,2366,8,3,4,7,9,17,-8,13
Mumbai City,2367,1,6,4,4,16,9,7,22
Delhi Dynamo,2367,2,5,6,3,24,18,6,21
Kolkata,2367,3,4,8,2,16,12,4,20
NorthEast Un,2367,4,6,2,6,15,13,2,20
Kerala Blast,2367,5,5,4,5,11,15,-4,19
FC Pune City,2367,6,5,3,6,13,17,-4,18
Chennaiyin,2367,7,4,5,5,15,19,-4,17
FC Goa,2367,8,3,4,7,9,16,-7,13
Mumbai City,2368,1,7,4,3,20,10,10,25
Delhi Dynamo,2368,2,6,5,3,26,18,8,23
Kolkata,2368,3,5,7,2,19,15,4,22
NorthEast Un,2368,4,6,2,6,13,10,3,20
FC Pune City,2368,5,5,3,6,16,18,-2,18
Kerala Blast,2368,6,4,4,6,11,19,-8,16
Chennaiyin,2368,7,3,5,6,13,20,-7,14
FC Goa,2368,8,4,2,8,10,18,-8,14
Mumbai City,2369,1,7,4,3,20,10,10,25
Kolkata,2369,2,5,6,3,17,15,2,21
FC Pune City,2369,3,5,4,5,16,17,-1,19
Kerala Blast,2369,4,5,4,5,14,17,-3,19
Delhi Dynamo,2369,5,4,6,4,23,19,4,18
NorthEast Un,2369,6,5,3,6,10,11,-1,18
FC Goa,2369,7,4,3,7,10,15,-5,15
Chennaiyin,2369,8,3,6,5,13,19,-6,15
Delhi Dynamo,2370,1,6,6,2,24,15,9,24
Mumbai City,2370,2,6,4,4,16,9,7,22
Kolkata,2370,3,4,8,2,18,16,2,20
Kerala Blast,2370,4,5,5,4,15,17,-2,20
NorthEast Un,2370,5,4,5,5,12,12,0,17
Chennaiyin,2370,6,3,7,4,13,17,-4,16
FC Pune City,2370,7,4,3,7,14,19,-5,15
FC Goa,2370,8,3,4,7,10,17,-7,13
Mumbai City,2371,1,6,5,3,17,9,8,23
Delhi Dynamo,2371,2,5,6,3,26,17,9,21
FC Pune City,2371,3,6,3,5,15,14,1,21
Kolkata,2371,4,4,6,4,15,15,0,18
NorthEast Un,2371,5,5,3,6,12,14,-2,18
Chennaiyin,2371,6,4,5,5,17,19,-2,17
FC Goa,2371,7,5,2,7,12,19,-7,17
Kerala Blast,2371,8,4,4,6,12,19,-7,16
Kolkata,2372,1,6,6,2,21,16,5,24
Mumbai City,2372,2,6,5,3,18,10,8,23
Delhi Dynamo,2372,3,5,7,2,25,17,8,22
NorthEast Un,2372,4,5,3,6,12,10,2,18
Chennaiyin,2372,5,4,5,5,15,19,-4,17
FC Pune City,2372,6,4,4,6,15,18,-3,16
Kerala Blast,2372,7,4,4,6,11,20,-9,16
FC Goa,2372,8,4,2,8,12,19,-7,14
Mumbai City,2373,1,7,4,3,18,9,9,25
NorthEast Un,2373,2,7,2,5,15,11,4,23
Delhi Dynamo,2373,3,5,5,4,25,18,7,20
Kolkata,2373,4,4,7,3,17,16,1,19
FC Pune City,2373,5,5,3,6,15,17,-2,18
Kerala Blast,2373,6,4,4,6,13,20,-7,16
Chennaiyin,2373,7,3,6,5,13,18,-5,15
FC Goa,2373,8,4,3,7,9,16,-7,15
Mumbai City,2374,1,6,5,3,16,8,8,23
Chennaiyin,2374,2,5,5,4,20,19,1,20
Kerala Blast,2374,3,5,5,4,12,15,-3,20
Delhi Dynamo,2374,4,4,7,3,22,16,6,19
NorthEast Un,2374,5,5,3,6,11,14,-3,18
FC Pune City,2374,6,4,5,5,14,16,-2,17
Kolkata,2374,7,3,7,4,15,18,-3,16
FC Goa,2374,8,4,3,7,13,17,-4,15
Delhi Dynamo,2375,1,6,6,2,27,17,10,24
Mumbai City,2375,2,6,5,3,17,9,8,23
Kolkata,2375,3,5,6,3,18,14,4,21
FC Pune City,2375,4,6,3,5,17,15,2,21
Chennaiyin,2375,5,5,5,4,17,18,-1,20
NorthEast Un,2375,6,5,2,7,11,13,-2,17
Kerala Blast,2375,7,4,3,7,11,21,-10,15
FC Goa,2375,8,3,2,9,10,21,-11,11
Mumbai City,2376,1,7,4,3,20,10,10,25
Kolkata,2376,2,5,7,2,17,14,3,22
Kerala Blast,2376,3,6,4,4,14,14,0,22
Delhi Dynamo,2376,4,5,5,4,24,21,3,20
NorthEast Un,2376,5,5,3,6,12,11,1,18
Chennaiyin,2376,6,4,6,4,16,18,-2,18
FC Pune City,2376,7,4,3,7,12,17,-5,15
FC Goa,2376,8,3,2,9,10,20,-10,11
Delhi Dynamo,2377,1,6,6,2,27,16,11,24
Mumbai City,2377,2,6,5,3,16,8,8,23
Kerala Blast,2377,3,6,3,5,12,15,-3,21
FC Pune City,2377,4,5,4,5,14,15,-1,19
NorthEast Un,2377,5,5,2,7,11,14,-3,17
FC Goa,2377,6,5,2,7,13,17,-4,17
Kolkata,2377,7,3,7,4,15,17,-2,16
Chennaiyin,2377,8,3,5,6,14,20,-6,14
Delhi Dynamo,2378,1,6,6,2,28,15,13,24
Mumbai City,2378,2,6,5,3,16,8,8,23
Kolkata,2378,3,4,8,2,17,15,2,20
FC Pune City,2378,4,5,4,5,15,16,-1,19
Chennaiyin,2378,5,4,5,5,17,20,-3,17
Kerala Blast,2378,6,4,4,6,12,18,-6,16
NorthEast Un,2378,7,4,3,7,11,16,-5,15
FC Goa,2378,8,4,3,7,12,20,-8,15
Mumbai City,2379,1,7,4,3,18,9,9,25
Delhi Dynamo,2379,2,5,6,3,24,17,7,21
NorthEast Un,2379,3,5,4,5,12,10,2,19
Kolkata,2379,4,4,7,3,15,15,0,19
FC Pune City,2379,5,5,3,6,16,17,-1,18
Chennaiyin,2379,6,4,6,4,15,18,-3,18
Kerala Blast,2379,7,5,3,6,11,17,-6,18
FC Goa,2379,8,3,3,8,9,17,-8,12
Mumbai City,2380,1,6,4,4,16,9,7,22
Kerala Blast,2380,2,6,3,5,14,16,-2,21
Delhi Dynamo,2380,3,5,5,4,25,19,6,20
Chennaiyin,2380,4,5,5,4,17,17,0,20
NorthEast Un,2380,5,6,2,6,15,15,0,20
Kolkata,2380,6,4,7,3,16,15,1,19
FC Pune City,2380,7,4,3,7,13,19,-6,15
FC Goa,2380,8,4,3,7,11,17,-6,15
Mumbai City,2381,1,6,4,4,16,9,7,22
Delhi Dynamo,2381,2,5,5,4,22,17,5,20
FC Goa,2381,3,6,2,6,14,15,-1,20
FC Pune City,2381,4,5,4,5,13,14,-1,19
Kolkata,2381,5,4,6,4,16,17,-1,18
NorthEast Un,2381,6,5,3,6,12,14,-2,18
Chennaiyin,2381,7,4,5,5,17,18,-1,17
Kerala Blast,2381,8,4,5,5,10,16,-6,17
Mumbai City,2382,1,7,4,3,18,9,9,25
NorthEast Un,2382,2,6,3,5,17,14,3,21
Delhi Dynamo,2382,3,5,5,4,25,19,6,20
Kolkata,2382,4,4,7,3,17,16,1,19
Kerala Blast,2382,5,5,4,5,13,17,-4,19
Chennaiyin,2382,6,4,5,5,18,22,-4,17
FC Pune City,2382,7,4,4,6,12,16,-4,16
FC Goa,2382,8,4,2,8,12,19,-7,14
Mumbai City,2383,1,7,4,3,20,8,12,25
Kolkata,2383,2,5,7,2,19,14,5,22
Delhi Dynamo,2383,3,5,6,3,24,20,4,21
Kerala Blast,2383,4,6,3,5,14,17,-3,21
NorthEast Un,2383,5,5,3,6,11,11,0,18
FC Pune City,2383,6,4,4,6,14,18,-4,16
Chennaiyin,2383,7,3,5,6,15,21,-6,14
FC Goa,2383,8,4,2,8,12,20,-8,14
Mumbai City,2384,1,7,4,3,18,8,10,25
Kolkata,2384,2,6,6,2,21,13,8,24
Delhi Dynamo,2384,3,4,6,4,21,17,4,18
NorthEast Un,2384,4,5,3,6,13,13,0,18
Chennaiyin,2384,5,4,5,5,15,20,-5,17
Kerala Blast,2384,6,4,5,5,11,17,-6,17
FC Pune City,2384,7,4,4,6,13,17,-4,16
FC Goa,2384,8,4,3,7,10,17,-7,15
Mumbai City,2385,1,7,4,3,17,8,9,25
Delhi Dynamo,2385,2,6,5,3,25,15,10,23
Kolkata,2385,3,5,7,2,22,17,5,22
Kerala Blast,2385,4,6,3,5,18,21,-3,21
FC Pune City,2385,5,4,4,6,14,17,-3,16
NorthEast Un,2385,6,4,3,7,13,16,-3,15
Chennaiyin,2385,7,3,6,5,16,22,-6,15
FC Goa,2385,8,4,2,8,12,21,-9,14
Mumbai City,2386,1,7,4,3,17,8,9,25
Delhi Dynamo,2386,2,5,5,4,23,17,6,20
NorthEast Un,2386,3,6,2,6,14,13,1,20
Kerala Blast,2386,4,5,5,4,13,16,-3,20
Kolkata,2386,5,3,8,3,15,15,0,17
FC Pune City,2386,6,4,5,5,14,16,-2,17
FC Goa,2386,7,5,2,7,11,16,-5,17
Chennaiyin,2386,8,3,5,6,13,19,-6,14
Mumbai City,2387,1,7,4,3,17,8,9,25
Delhi Dynamo,2387,2,6,5,3,24,15,9,23
Kerala Blast,2387,3,6,4,4,15,15,0,22
Kolkata,2387,4,4,8,2,19,15,4,20
Chennaiyin,2387,5,3,7,4,14,18,-4,16
NorthEast Un,2387,6,4,3,7,9,13,-4,15
FC Pune City,2387,7,4,3,7,12,18,-6,15
FC Goa,2387,8,3,4,7,10,18,-8,13
Mumbai City,2388,1,7,4,3,19,10,9,25
Kerala Blast,2388,2,6,4,4,12,14,-2,22
Delhi Dynamo,2388,3,5,6,3,25,18,7,21
Kolkata,2388,4,4,6,4,17,16,1,18
Chennaiyin,2388,5,4,6,4,16,19,-3,18
FC Goa,2388,6,4,4,6,12,17,-5,16
NorthEast Un,2388,7,4,3,7,11,13,-2,15
FC Pune City,2388,8,4,3,7,13,18,-5,15
Delhi Dynamo,2389,1,7,5,2,30,16,14,26
Mumbai City,2389,2,6,4,4,17,10,7,22
Kerala Blast,2389,3,6,4,4,12,13,-1,22
FC Pune City,2389,4,5,3,6,14,15,-1,18
Chennaiyin,2389,5,4,5,5,14,20,-6,17
Kolkata,2389,6,3,7,4,14,17,-3,16
NorthEast Un,2389,7,4,3,7,10,12,-2,15
FC Goa,2389,8,4,3,7,12,20,-8,15
Mumbai City,2390,1,7,4,3,17,8,9,25
Kolkata,2390,2,6,6,2,20,13,7,24
Delhi Dynamo,2390,3,5,6,3,24,17,7,21
Kerala Blast,2390,4,6,3,5,14,16,-2,21
NorthEast Un,2390,5,5,3,6,13,13,0,18
FC Pune City,2390,6,4,3,7,12,19,-7,15
Chennaiyin,2390,7,3,5,6,17,23,-6,14
FC Goa,2390,8,4,2,8,13,21,-8,14
Delhi Dynamo,2391,1,6,6,2,27,17,10,24
Mumbai City,2391,2,6,5,3,18,10,8,23
Kolkata,2391,3,5,6,3,17,15,2,21
Kerala Blast,2391,4,5,4,5,12,16,-4,19
FC Pune City,2391,5,5,3,6,14,16,-2,18
Chennaiyin,2391,6,4,6,4,17,20,-3,18
NorthEast Un,2391,7,4,3,7,10,12,-2,15
FC Goa,2391,8,3,3,8,12,21,-9,12
Mumbai City,2392,1,6,5,3,17,9,8,23
Delhi Dynamo,2392,2,5,6,3,26,18,8,21
FC Pune City,2392,3,6,3,5,15,15,0,21
Chennaiyin,2392,4,5,5,4,18,18,0,20
Kerala Blast,2392,5,5,4,5,14,16,-2,19
Kolkata,2392,6,3,7,4,15,18,-3,16
NorthEast Un,2392,7,4,3,7,10,13,-3,15
FC Goa,2392,8,4,3,7,12,20,-8,15
NorthEast Un,2393,1,7,2,5,19,10,9,23
Mumbai City,2393,2,6,5,3,17,9,8,23
Delhi Dynamo,2393,3,5,6,3,25,21,4,21
Kolkata,2393,4,5,6,3,17,15,2,21
FC Pune City,2393,5,5,3,6,14,16,-2,18
FC Goa,2393,6,5,2,7,12,17,-5,17
Kerala Blast,2393,7,4,3,7,11,18,-7,15
Chennaiyin,2393,8,3,5,6,13,22,-9,14
Mumbai City,2394,1,7,4,3,18,8,10,25
Delhi Dynamo,2394,2,5,6,3,25,18,7,21
NorthEast Un,2394,3,5,4,5,12,10,2,19
FC Pune City,2394,4,5,4,5,14,15,-1,19
Kolkata,2394,5,4,6,4,14,14,0,18
FC Goa,2394,6,5,2,7,12,18,-6,17
Kerala Blast,2394,7,4,4,6,10,17,-7,16
Chennaiyin,2394,8,3,6,5,14,19,-5,15
Delhi Dynamo,2395,1,6,6,2,26,16,10,24
Mumbai City,2395,2,6,4,4,16,10,6,22
Kerala Blast,2395,3,6,3,5,14,17,-3,21
FC Pune City,2395,4,5,4,5,17,17,0,19
FC Goa,2395,5,5,3,6,18,17,1,18
NorthEast Un,2395,6,5,2,7,12,14,-2,17
Kolkata,2395,7,3,7,4,16,17,-1,16
Chennaiyin,2395,8,3,5,6,14,25,-11,14
Mumbai City,2396,1,6,5,3,17,9,8,23
FC Pune City,2396,2,6,3,5,17,16,1,21
Delhi Dynamo,2396,3,4,7,3,22,17,5,19
Kerala Blast,2396,4,5,4,5,12,17,-5,19
FC Goa,2396,5,5,3,6,11,14,-3,18
Kolkata,2396,6,3,7,4,15,16,-1,16
NorthEast Un,2396,7,4,4,6,11,12,-1,16
Chennaiyin,2396,8,3,7,4,13,17,-4,16
Delhi Dynamo,2397,1,7,5,2,27,16,11,26
Mumbai City,2397,2,6,4,4,17,10,7,22
Kolkata,2397,3,5,6,3,18,15,3,21
Chennaiyin,2397,4,4,6,4,19,20,-1,18
FC Pune City,2397,5,5,3,6,15,17,-2,18
Kerala Blast,2397,6,5,3,6,10,16,-6,18
NorthEast Un,2397,7,5,2,7,11,15,-4,17
FC Goa,2397,8,3,3,8,11,19,-8,12
Delhi Dynamo,2398,1,6,6,2,31,18,13,24
Mumbai City,2398,2,6,4,4,18,11,7,22
Kolkata,2398,3,5,7,2,19,15,4,22
Kerala Blast,2398,4,5,5,4,11,14,-3,20
NorthEast Un,2398,5,4,4,6,10,11,-1,16
FC Pune City,2398,6,4,4,6,14,17,-3,16
Chennaiyin,2398,7,3,6,5,14,20,-6,15
FC Goa,2398,8,4,2,8,14,25,-11,14
Kolkata,2399,1,6,6,2,20,13,7,24
Mumbai City,2399,2,6,5,3,17,9,8,23
Delhi Dynamo,2399,3,4,6,4,24,19,5,18
FC Pune City,2399,4,5,3,6,16,16,0,18
NorthEast Un,2399,5,5,3,6,12,13,-1,18
Kerala Blast,2399,6,5,3,6,12,20,-8,18
FC Goa,2399,7,5,2,7,13,17,-4,17
Chennaiyin,2399,8,3,6,5,14,21,-7,15
Mumbai City,2400,1,7,4,3,18,8,10,25
Kerala Blast,2400,2,7,3,4,13,14,-1,24
Delhi Dynamo,2400,3,5,6,3,22,16,6,21
Chennaiyin,2400,4,4,6,4,16,19,-3,18
Kolkata,2400,5,3,7,4,13,14,-1,16
FC Pune City,2400,6,4,4,6,13,16,-3,16
NorthEast Un,2400,7,4,3,7,10,12,-2,15
FC Goa,2400,8,4,3,7,10,16,-6,15
Delhi Dynamo,2401,1,6,6,2,26,17,9,24
Mumbai City,2401,2,6,4,4,17,10,7,22
Kolkata,2401,3,5,6,3,20,14,6,21
FC Pune City,2401,4,6,3,5,16,15,1,21
Chennaiyin,2401,5,5,5,4,16,18,-2,20
NorthEast Un,2401,6,4,4,6,12,13,-1,16
Kerala Blast,2401,7,4,4,6,10,20,-10,16
FC Goa,2401,8,3,2,9,9,19,-10,11
Mumbai City,2402,1,7,4,3,17,8,9,25
Kerala Blast,2402,2,7,3,4,14,14,0,24
Delhi Dynamo,2402,3,5,5,4,23,17,6,20
FC Goa,2402,4,6,2,6,14,16,-2,20
FC Pune City,2402,5,5,3,6,13,16,-3,18
NorthEast Un,2402,6,4,3,7,10,12,-2,15
Kolkata,2402,7,3,6,5,15,18,-3,15
Chennaiyin,2402,8,3,6,5,14,19,-5,15
Mumbai City,2403,1,7,4,3,19,8,11,25
Kolkata,2403,2,5,6,3,17,16,1,21
NorthEast Un,2403,3,5,3,6,14,13,1,18
Chennaiyin,2403,4,4,6,4,17,19,-2,18
FC Pune City,2403,5,5,3,6,14,16,-2,18
FC Goa,2403,6,5,3,6,13,16,-3,18
Delhi Dynamo,2403,7,4,5,5,21,21,0,17
Kerala Blast,2403,8,4,4,6,10,16,-6,16
NorthEast Un,2404,1,7,2,5,17,11,6,23
Mumbai City,2404,2,6,4,4,17,11,6,22
Delhi Dynamo,2404,3,5,6,3,25,17,8,21
FC Pune City,2404,4,5,4,5,16,17,-1,19
FC Goa,2404,5,5,3,6,14,16,-2,18
Kerala Blast,2404,6,4,5,5,13,18,-5,17
Kolkata,2404,7,3,7,4,15,17,-2,16
Chennaiyin,2404,8,3,5,6,15,25,-10,14
Mumbai City,2405,1,6,4,4,17,10,7,22
Delhi Dynamo,2405,2,5,6,3,24,17,7,21
Kolkata,2405,3,4,8,2,19,16,3,20
NorthEast Un,2405,4,5,3,6,13,11,2,18
FC Goa,2405,5,5,3,6,11,15,-4,18
FC Pune City,2405,6,4,5,5,15,17,-2,17
Chennaiyin,2405,7,4,5,5,14,18,-4,17
Kerala Blast,2405,8,4,4,6,11,20,-9,16
Mumbai City,2406,1,7,4,3,17,8,9,25
Kerala Blast,2406,2,6,4,4,14,15,-1,22
Chennaiyin,2406,3,5,5,4,17,18,-1,20
Delhi Dynamo,2406,4,4,7,3,24,18,6,19
Kolkata,2406,5,4,6,4,15,14,1,18
FC Pune City,2406,6,4,4,6,13,17,-4,16
NorthEast Un,2406,7,4,3,7,13,16,-3,15
FC Goa,2406,8,4,3,7,10,17,-7,15
Mumbai City,2407,1,7,4,3,18,8,10,25
Delhi Dynamo,2407,2,5,6,3,24,18,6,21
Kolkata,2407,3,4,8,2,15,13,2,20
NorthEast Un,2407,4,6,2,6,13,12,1,20
Kerala Blast,2407,5,5,4,5,11,15,-4,19
FC Pune City,2407,6,4,4,6,12,15,-3,16
FC Goa,2407,7,4,3,7,12,18,-6,15
Chennaiyin,2407,8,3,5,6,14,20,-6,14
Kolkata,2408,1,6,6,2,18,13,5,24
Mumbai City,2408,2,6,5,3,19,11,8,23
Delhi Dynamo,2408,3,5,7,2,25,17,8,22
Chennaiyin,2408,4,4,6,4,15,18,-3,18
FC Pune City,2408,5,5,3,6,14,17,-3,18
Kerala Blast,2408,6,5,3,6,14,18,-4,18
NorthEast Un,2408,7,4,2,8,12,16,-4,14
FC Goa,2408,8,3,4,7,9,16,-7,13
Mumbai City,2409,1,6,5,3,18,10,8,23
Kerala Blast,2409,2,6,4,4,16,17,-1,22
NorthEast Un,2409,3,6,2,6,15,13,2,20
Delhi Dynamo,2409,4,4,6,4,25,21,4,18
Kolkata,2409,5,3,9,2,17,16,1,18
Chennaiyin,2409,6,4,5,5,14,18,-4,17
FC Pune City,2409,7,4,4,6,15,19,-4,16
FC Goa,2409,8,4,3,7,11,17,-6,15
Mumbai City,2410,1,7,4,3,19,9,10,25
Delhi Dynamo,2410,2,6,5,3,28,20,8,23
Kolkata,2410,3,5,6,3,17,16,1,21
Chennaiyin,2410,4,4,6,4,16,18,-2,18
Kerala Blast,2410,5,5,3,6,11,16,-5,18
NorthEast Un,2410,6,5,2,7,12,15,-3,17
FC Pune City,2410,7,4,3,7,12,16,-4,15
FC Goa,2410,8,4,3,7,13,18,-5,15
Mumbai City,2411,1,7,4,3,17,8,9,25
Kolkata,2411,2,6,6,2,19,15,4,24
Delhi Dynamo,2411,3,6,5,3,27,16,11,23
Chennaiyin,2411,4,5,5,4,16,18,-2,20
Kerala Blast,2411,5,5,3,6,16,20,-4,18
NorthEast Un,2411,6,5,2,7,14,15,-1,17
FC Pune City,2411,7,4,3,7,14,20,-6,15
FC Goa,2411,8,3,2,9,10,21,-11,11
Delhi Dynamo,2412,1,7,5,2,27,15,12,26
Mumbai City,2412,2,6,4,4,17,12,5,22
Chennaiyin,2412,3,5,5,4,16,17,-1,20
Kolkata,2412,4,4,7,3,16,14,2,19
NorthEast Un,2412,5,5,2,7,10,11,-1,17
Kerala Blast,2412,6,4,5,5,10,15,-5,17
FC Pune City,2412,7,4,4,6,12,16,-4,16
FC Goa,2412,8,4,2,8,9,17,-8,14
Delhi Dynamo,2413,1,7,5,2,31,16,15,26
Kerala Blast,2413,2,7,3,4,13,14,-1,24
Mumbai City,2413,3,6,4,4,16,10,6,22
Chennaiyin,2413,4,5,5,4,16,18,-2,20
Kolkata,2413,5,4,6,4,15,15,0,18
FC Pune City,2413,6,5,3,6,15,17,-2,18
NorthEast Un,2413,7,4,2,8,10,15,-5,14
FC Goa,2413,8,3,2,9,10,21,-11,11
Mumbai City,2414,1,6,5,3,17,9,8,23
Kolkata,2414,2,5,7,2,22,16,6,22
Delhi Dynamo,2414,3,4,7,3,25,19,6,19
FC Pune City,2414,4,5,3,6,14,17,-3,18
Kerala Blast,2414,5,5,3,6,12,19,-7,18
NorthEast Un,2414,6,5,2,7,12,14,-2,17
Chennaiyin,2414,7,4,5,5,17,20,-3,17
FC Goa,2414,8,4,4,6,15,20,-5,16
Delhi Dynamo,2415,1,6,6,2,25,15,10,24
Mumbai City,2415,2,6,4,4,16,9,7,22
FC Pune City,2415,3,6,3,5,15,14,1,21
Kerala Blast,2415,4,5,4,5,14,18,-4,19
FC Goa,2415,5,5,3,6,13,15,-2,18
NorthEast Un,2415,6,5,2,7,15,15,0,17
Kolkata,2415,7,3,7,4,15,17,-2,16
Chennaiyin,2415,8,3,5,6,14,24,-10,14
Delhi Dynamo,2416,1,6,5,3,27,22,5,23
Mumbai City,2416,2,6,4,4,17,11,6,22
FC Pune City,2416,3,6,3,5,16,16,0,21
NorthEast Un,2416,4,6,2,6,16,12,4,20
Kolkata,2416,5,4,6,4,18,16,2,18
Chennaiyin,2416,6,4,6,4,15,17,-2,18
FC Goa,2416,7,4,3,7,10,16,-6,15
Kerala Blast,2416,8,4,3,7,11,20,-9,15
Mumbai City,2417,1,7,4,3,18,8,10,25
FC Pune City,2417,2,6,3,5,14,14,0,21
Delhi Dynamo,2417,3,5,5,4,25,19,6,20
NorthEast Un,2417,4,6,2,6,14,14,0,20
Kolkata,2417,5,4,6,4,15,14,1,18
Kerala Blast,2417,6,5,3,6,11,17,-6,18
Chennaiyin,2417,7,4,5,5,16,20,-4,17
FC Goa,2417,8,4,2,8,12,19,-7,14
Delhi Dynamo,2418,1,6,6,2,29,18,11,24
Mumbai City,2418,2,6,5,3,17,9,8,23
Kolkata,2418,3,4,8,2,14,12,2,20
NorthEast Un,2418,4,5,3,6,12,12,0,18
Kerala Blast,2418,5,4,6,4,9,13,-4,18
FC Pune City,2418,6,4,5,5,12,14,-2,17
Chennaiyin,2418,7,3,6,5,14,19,-5,15
FC Goa,2418,8,3,3,8,10,20,-10,12
Mumbai City,2419,1,7,4,3,21,9,12,25
Delhi Dynamo,2419,2,6,5,3,31,22,9,23
Chennaiyin,2419,3,5,5,4,19,21,-2,20
Kerala Blast,2419,4,5,4,5,12,15,-3,19
Kolkata,2419,5,4,6,4,17,19,-2,18
FC Pune City,2419,6,5,3,6,17,20,-3,18
NorthEast Un,2419,7,4,3,7,16,18,-2,15
FC Goa,2419,8,4,2,8,11,20,-9,14
Mumbai City,2420,1,7,4,3,19,9,10,25
Kolkata,2420,2,6,6,2,19,13,6,24
Kerala Blast,2420,3,6,3,5,13,16,-3,21
Delhi Dynamo,2420,4,5,5,4,25,19,6,20
FC Goa,2420,5,5,2,7,14,18,-4,17
Chennaiyin,2420,6,4,5,5,15,21,-6,17
FC Pune City,2420,7,4,3,7,13,17,-4,15
NorthEast Un,2420,8,4,2,8,10,15,-5,14
Mumbai City,2421,1,7,4,3,18,9,9,25
FC Pune City,2421,2,6,3,5,15,14,1,21
Kerala Blast,2421,3,5,4,5,13,14,-1,19
NorthEast Un,2421,4,5,3,6,12,14,-2,18
Chennaiyin,2421,5,4,6,4,16,19,-3,18
Delhi Dynamo,2421,6,4,5,5,23,20,3,17
FC Goa,2421,7,5,2,7,16,19,-3,17
Kolkata,2421,8,3,7,4,15,19,-4,16
Mumbai City,2422,1,6,4,4,16,9,7,22
Kerala Blast,2422,2,6,4,4,14,14,0,22
Delhi Dynamo,2422,3,5,6,3,23,16,7,21
NorthEast Un,2422,4,6,2,6,14,13,1,20
FC Pune City,2422,5,4,5,5,14,16,-2,17
Kolkata,2422,6,3,7,4,14,17,-3,16
FC Goa,2422,7,4,4,6,11,15,-4,16
Chennaiyin,2422,8,3,6,5,15,21,-6,15
Mumbai City,2423,1,7,4,3,18,9,9,25
Kerala Blast,2423,2,7,3,4,15,16,-1,24
Chennaiyin,2423,3,5,5,4,18,19,-1,20
Delhi Dynamo,2423,4,4,5,5,26,22,4,17
Kolkata,2423,5,3,8,3,16,16,0,17
NorthEast Un,2423,6,5,2,7,13,15,-2,17
FC Pune City,2423,7,4,4,6,13,16,-3,16
FC Goa,2423,8,4,3,7,13,19,-6,15
Mumbai City,2424,1,6,5,3,16,8,8,23
Delhi Dynamo,2424,2,5,7,2,23,15,8,22
Kolkata,2424,3,4,7,3,18,14,4,19
NorthEast Un,2424,4,5,4,5,14,13,1,19
Kerala Blast,2424,5,5,4,5,14,21,-7,19
FC Goa,2424,6,5,2,7,13,15,-2,17
FC Pune City,2424,7,4,4,6,12,15,-3,16
Chennaiyin,2424,8,3,5,6,13,22,-9,14
Mumbai City,2425,1,7,4,3,18,8,10,25
Delhi Dynamo,2425,2,5,5,4,25,20,5,20
Kolkata,2425,3,4,8,2,17,13,4,20
Kerala Blast,2425,4,5,5,4,13,15,-2,20
NorthEast Un,2425,5,5,3,6,13,13,0,18
Chennaiyin,2425,6,3,7,4,14,18,-4,16
FC Pune City,2425,7,4,4,6,12,17,-5,16
FC Goa,2425,8,3,4,7,12,20,-8,13
Delhi Dynamo,2426,1,7,5,2,28,17,11,26
Mumbai City,2426,2,6,4,4,16,10,6,22
Kerala Blast,2426,3,5,5,4,11,14,-3,20
Kolkata,2426,4,4,6,4,17,17,0,18
Chennaiyin,2426,5,4,6,4,18,20,-2,18
FC Pune City,2426,6,4,4,6,14,17,-3,16
NorthEast Un,2426,7,4,3,7,11,14,-3,15
FC Goa,2426,8,4,3,7,15,21,-6,15
Mumbai City,2427,1,7,4,3,19,9,10,25
Delhi Dynamo,2427,2,5,6,3,26,18,8,21
Kerala Blast,2427,3,6,3,5,15,15,0,21
Chennaiyin,2427,4,5,5,4,17,17,0,20
Kolkata,2427,5,4,6,4,17,17,0,18
FC Pune City,2427,6,5,3,6,14,20,-6,18
NorthEast Un,2427,7,4,3,7,10,14,-4,15
FC Goa,2427,8,4,2,8,11,19,-8,14
Delhi Dynamo,2428,1,6,5,3,27,17,10,23
Mumbai City,2428,2,6,4,4,17,11,6,22
Kerala Blast,2428,3,6,4,4,13,14,-1,22
Kolkata,2428,4,4,7,3,16,15,1,19
NorthEast Un,2428,5,5,2,7,11,11,0,17
Chennaiyin,2428,6,4,5,5,14,18,-4,17
FC Goa,2428,7,5,2,7,11,17,-6,17
FC Pune City,2428,8,4,3,7,12,18,-6,15
Delhi Dynamo,2429,1,7,5,2,31,18,13,26
Mumbai City,2429,2,6,4,4,18,11,7,22
Kerala Blast,2429,3,6,3,5,14,17,-3,21
Kolkata,2429,4,4,7,3,16,16,0,19
Chennaiyin,2429,5,4,6,4,14,17,-3,18
FC Pune City,2429,6,4,4,6,14,17,-3,16
FC Goa,2429,7,4,3,7,11,18,-7,15
NorthEast Un,2429,8,4,2,8,12,16,-4,14
Mumbai City,2430,1,7,4,3,18,9,9,25
FC Pune City,2430,2,6,3,5,17,15,2,21
Delhi Dynamo,2430,3,4,7,3,24,18,6,19
NorthEast Un,2430,4,5,4,5,13,11,2,19
Kolkata,2430,5,4,6,4,17,18,-1,18
Chennaiyin,2430,6,3,7,4,15,19,-4,16
FC Goa,2430,7,4,4,6,11,16,-5,16
Kerala Blast,2430,8,4,3,7,12,21,-9,15
Delhi Dynamo,2431,1,5,7,2,24,14,10,22
Mumbai City,2431,2,6,4,4,16,11,5,22
Kerala Blast,2431,3,6,3,5,13,16,-3,21
Kolkata,2431,4,4,7,3,17,13,4,19
FC Pune City,2431,5,5,4,5,13,14,-1,19
NorthEast Un,2431,6,4,4,6,12,13,-1,16
Chennaiyin,2431,7,3,6,5,15,21,-6,15
FC Goa,2431,8,4,3,7,11,19,-8,15
Delhi Dynamo,2432,1,7,5,2,30,16,14,26
Mumbai City,2432,2,6,4,4,17,10,7,22
Kerala Blast,2432,3,6,4,4,15,13,2,22
Kolkata,2432,4,4,6,4,15,16,-1,18
NorthEast Un,2432,5,5,3,6,11,12,-1,18
Chennaiyin,2432,6,3,6,5,14,19,-5,15
FC Pune City,2432,7,4,3,7,13,20,-7,15
FC Goa,2432,8,4,3,7,10,19,-9,15
Mumbai City,2433,1,6,5,3,16,8,8,23
Kolkata,2433,2,5,7,2,23,14,9,22
Delhi Dynamo,2433,3,5,7,2,23,15,8,22
Kerala Blast,2433,4,6,3,5,12,17,-5,21
NorthEast Un,2433,5,5,3,6,12,11,1,18
FC Pune City,2433,6,4,4,6,12,15,-3,16
Chennaiyin,2433,7,3,6,5,14,20,-6,15
FC Goa,2433,8,3,3,8,10,22,-12,12
Mumbai City,2434,1,7,4,3,18,8,10,25
Delhi Dynamo,2434,2,6,5,3,24,16,8,23
Kolkata,2434,3,5,6,3,22,15,7,21
FC Pune City,2434,4,5,4,5,15,15,0,19
Chennaiyin,2434,5,4,5,5,18,20,-2,17
NorthEast Un,2434,6,5,2,7,10,14,-4,17
Kerala Blast,2434,7,4,4,6,10,22,-12,16
FC Goa,2434,8,4,2,8,12,19,-7,14
Mumbai City,2435,1,6,4,4,16,9,7,22
Delhi Dynamo,2435,2,5,6,3,23,17,6,21
Kolkata,2435,3,5,6,3,18,15,3,21
FC Goa,2435,4,6,2,6,15,15,0,20
FC Pune City,2435,5,5,3,6,14,15,-1,18
Kerala Blast,2435,6,5,3,6,11,19,-8,18
Chennaiyin,2435,7,4,5,5,14,19,-5,17
NorthEast Un,2435,8,4,3,7,11,13,-2,15
Mumbai City,2436,1,6,5,3,18,10,8,23
Kerala Blast,2436,2,6,3,5,14,18,-4,21
Kolkata,2436,3,4,8,2,19,15,4,20
Delhi Dynamo,2436,4,4,7,3,25,20,5,19
FC Goa,2436,5,5,3,6,15,16,-1,18
NorthEast Un,2436,6,5,3,6,13,14,-1,18
FC Pune City,2436,7,4,4,6,14,17,-3,16
Chennaiyin,2436,8,3,5,6,13,21,-8,14
Delhi Dynamo,2437,1,6,6,2,26,16,10,24
Mumbai City,2437,2,6,4,4,17,10,7,22
Kolkata,2437,3,4,8,2,18,16,2,20
Kerala Blast,2437,4,5,5,4,13,16,-3,20
Chennaiyin,2437,5,4,5,5,17,19,-2,17
FC Pune City,2437,6,4,5,5,15,17,-2,17
NorthEast Un,2437,7,4,3,7,11,15,-4,15
FC Goa,2437,8,4,2,8,9,17,-8,14
Delhi Dynamo,2438,1,6,6,2,27,18,9,24
Mumbai City,2438,2,6,4,4,17,10,7,22
Kolkata,2438,3,4,7,3,15,15,0,19
NorthEast Un,2438,4,5,3,6,13,12,1,18
FC Pune City,2438,5,5,3,6,15,16,-1,18
Chennaiyin,2438,6,4,6,4,14,17,-3,18
Kerala Blast,2438,7,4,4,6,9,17,-8,16
FC Goa,2438,8,4,3,7,11,16,-5,15
Mumbai City,2439,1,7,4,3,18,8,10,25
Kolkata,2439,2,5,7,2,18,13,5,22
NorthEast Un,2439,3,6,2,6,13,12,1,20
Chennaiyin,2439,4,5,5,4,17,18,-1,20
Delhi Dynamo,2439,5,4,6,4,24,20,4,18
FC Pune City,2439,6,4,4,6,15,18,-3,16
Kerala Blast,2439,7,4,4,6,12,21,-9,16
FC Goa,2439,8,3,4,7,12,19,-7,13
Mumbai City,2440,1,6,5,3,18,10,8,23
Kolkata,2440,2,5,6,3,19,17,2,21
NorthEast Un,2440,3,6,2,6,13,10,3,20
Delhi Dynamo,2440,4,4,7,3,24,19,5,19
FC Pune City,2440,5,5,3,6,14,16,-2,18
FC Goa,2440,6,5,3,6,14,18,-4,18
Chennaiyin,2440,7,4,5,5,14,18,-4,17
Kerala Blast,2440,8,4,3,7,9,17,-8,15
Mumbai City,2441,1,7,4,3,18,8,10,25
Kerala Blast,2441,2,6,3,5,14,16,-2,21
Delhi Dynamo,2441,3,5,5,4,26,20,6,20
FC Goa,2441,4,6,2,6,15,17,-2,20
Kolkata,2441,5,4,7,3,16,16,0,19
FC Pune City,2441,6,4,4,6,13,17,-4,16
NorthEast Un,2441,7,4,3,7,11,14,-3,15
Chennaiyin,2441,8,3,6,5,14,19,-5,15
Delhi Dynamo,2442,1,7,5,2,26,16,10,26
Mumbai City,2442,2,6,4,4,17,10,7,22
Kolkata,2442,3,4,7,3,17,17,0,19
FC Pune City,2442,4,5,3,6,14,15,-1,18
Kerala Blast,2442,5,5,3,6,12,17,-5,18
Chennaiyin,2442,6,4,5,5,17,18,-1,17
NorthEast Un,2442,7,5,2,7,11,15,-4,17
FC Goa,2442,8,4,3,7,11,17,-6,15
Mumbai City,2443,1,6,5,3,20,12,8,23
Kolkata,2443,2,5,6,3,18,16,2,21
Delhi Dynamo,2443,3,4,7,3,26,21,5,19
NorthEast Un,2443,4,5,4,5,13,12,1,19
Kerala Blast,2443,5,5,4,5,12,16,-4,19
FC Goa,2443,6,5,3,6,13,15,-2,18
Chennaiyin,2443,7,3,6,5,14,19,-5,15
FC Pune City,2443,7,4,3,7,14,19,-5,15
Mumbai City,2444,1,7,4,3,17,8,9,25
Delhi Dynamo,2444,2,6,5,3,25,15,10,23
Kolkata,2444,3,5,7,2,17,13,4,22
NorthEast Un,2444,4,6,2,6,12,10,2,20
FC Pune City,2444,5,5,3,6,14,15,-1,18
Kerala Blast,2444,6,4,4,6,10,18,-8,16
Chennaiyin,2444,7,3,6,5,16,21,-5,15
FC Goa,2444,8,3,3,8,11,22,-11,12
Delhi Dynamo,2445,1,6,6,2,29,18,11,24
Mumbai City,2445,2,6,4,4,18,12,6,22
Kerala Blast,2445,3,6,3,5,16,17,-1,21
Kolkata,2445,4,4,7,3,15,14,1,19
FC Goa,2445,5,5,2,7,11,17,-6,17
NorthEast Un,2445,6,4,4,6,15,17,-2,16
FC Pune City,2445,7,4,4,6,14,18,-4,16
Chennaiyin,2445,8,3,6,5,16,21,-5,15
Mumbai City,2446,1,7,4,3,17,8,9,25
Kolkata,2446,2,5,6,3,18,15,3,21
Delhi Dynamo,2446,3,5,5,4,23,18,5,20
NorthEast Un,2446,4,6,2,6,13,12,1,20
FC Pune City,2446,5,5,4,5,14,15,-1,19
Chennaiyin,2446,6,4,6,4,16,18,-2,18
Kerala Blast,2446,7,4,4,6,10,16,-6,16
FC Goa,2446,8,3,3,8,11,20,-9,12
Mumbai City,2447,1,7,4,3,18,8,10,25
Kerala Blast,2447,2,6,3,5,12,14,-2,21
Delhi Dynamo,2447,3,5,5,4,24,17,7,20
NorthEast Un,2447,4,6,2,6,12,13,-1,20
FC Goa,2447,5,5,3,6,12,16,-4,18
Kolkata,2447,6,3,8,3,15,16,-1,17
FC Pune City,2447,7,4,4,6,13,16,-3,16
Chennaiyin,2447,8,3,5,6,15,21,-6,14
Mumbai City,2448,1,7,4,3,19,9,10,25
Kolkata,2448,2,4,8,2,19,16,3,20
Kerala Blast,2448,3,5,4,5,14,18,-4,19
NorthEast Un,2448,4,5,3,6,10,11,-1,18
Delhi Dynamo,2448,5,4,5,5,23,20,3,17
FC Pune City,2448,6,4,5,5,15,17,-2,17
Chennaiyin,2448,7,3,7,4,14,18,-4,16
FC Goa,2448,8,4,4,6,11,16,-5,16
Mumbai City,2449,1,7,4,3,18,8,10,25
Kerala Blast,2449,2,6,4,4,14,15,-1,22
Kolkata,2449,3,4,6,4,17,16,1,18
Chennaiyin,2449,4,4,6,4,18,18,0,18
NorthEast Un,2449,5,5,3,6,13,15,-2,18
FC Goa,2449,6,5,3,6,15,19,-4,18
Delhi Dynamo,2449,7,4,5,5,25,23,2,17
FC Pune City,2449,8,4,3,7,12,18,-6,15
Mumbai City,2450,1,7,4,3,19,8,11,25
Delhi Dynamo,2450,2,6,5,3,26,20,6,23
Kolkata,2450,3,5,6,3,18,15,3,21
Chennaiyin,2450,4,4,6,4,18,19,-1,18
FC Pune City,2450,5,5,3,6,15,16,-1,18
Kerala Blast,2450,6,5,3,6,10,17,-7,18
FC Goa,2450,7,4,3,7,15,21,-6,15
NorthEast Un,2450,8,4,2,8,9,14,-5,14
Delhi Dynamo,2451,1,7,5,2,26,15,11,26
Mumbai City,2451,2,6,4,4,16,10,6,22
Kolkata,2451,3,4,8,2,16,13,3,20
Chennaiyin,2451,4,4,6,4,19,20,-1,18
FC Pune City,2451,5,4,5,5,14,16,-2,17
Kerala Blast,2451,6,4,5,5,11,17,-6,17
NorthEast Un,2451,7,4,3,7,11,15,-4,15
FC Goa,2451,8,3,4,7,11,18,-7,13
Delhi Dynamo,2452,1,6,6,2,23,14,9,24
Mumbai City,2452,2,6,4,4,16,9,7,22
Kerala Blast,2452,3,6,4,4,17,16,1,22
Kolkata,2452,4,4,7,3,18,16,2,19
Chennaiyin,2452,5,4,6,4,16,17,-1,18
FC Pune City,2452,6,5,3,6,15,19,-4,18
NorthEast Un,2452,7,4,3,7,10,15,-5,15
FC Goa,2452,8,3,3,8,9,18,-9,12
Mumbai City,2453,1,7,4,3,17,8,9,25
Delhi Dynamo,2453,2,5,6,3,25,18,7,21
Kolkata,2453,3,5,6,3,16,13,3,21
FC Pune City,2453,4,6,3,5,15,15,0,21
NorthEast Un,2453,5,5,3,6,15,15,0,18
Chennaiyin,2453,6,4,6,4,17,20,-3,18
Kerala Blast,2453,7,4,3,7,10,17,-7,15
FC Goa,2453,8,3,3,8,9,18,-9,12
Delhi Dynamo,2454,1,5,7,2,24,15,9,22
Mumbai City,2454,2,6,4,4,16,10,6,22
Kolkata,2454,3,5,6,3,17,13,4,21
Kerala Blast,2454,4,6,3,5,13,17,-4,21
Chennaiyin,2454,5,4,6,4,17,18,-1,18
FC Goa,2454,6,4,4,6,11,16,-5,16
NorthEast Un,2454,7,4,3,7,11,15,-4,15
FC Pune City,2454,8,4,3,7,12,17,-5,15
Mumbai City,2455,1,6,4,4,17,10,7,22
NorthEast Un,2455,2,6,3,5,11,9,2,21
Delhi Dynamo,2455,3,5,5,4,25,19,6,20
FC Pune City,2455,4,5,4,5,13,14,-1,19
Kolkata,2455,5,3,9,2,16,15,1,18
Kerala Blast,2455,6,4,5,5,11,16,-5,17
FC Goa,2455,7,4,4,6,12,17,-5,16
Chennaiyin,2455,8,3,6,5,13,18,-5,15
Kolkata,2456,1,6,6,2,20,13,7,24
Mumbai City,2456,2,6,5,3,17,9,8,23
Delhi Dynamo,2456,3,5,6,3,23,16,7,21
Kerala Blast,2456,4,5,4,5,14,16,-2,19
Chennaiyin,2456,5,4,6,4,17,20,-3,18
NorthEast Un,2456,6,5,2,7,11,15,-4,17
FC Pune City,2456,7,4,4,6,14,17,-3,16
FC Goa,2456,8,3,3,8,10,20,-10,12
Delhi Dynamo,2457,1,6,5,3,27,19,8,23
Mumbai City,2457,2,6,4,4,17,11,6,22
Kolkata,2457,3,5,7,2,18,14,4,22
NorthEast Un,2457,4,6,3,5,16,9,7,21
Chennaiyin,2457,5,4,6,4,14,17,-3,18
FC Pune City,2457,6,4,5,5,13,15,-2,17
Kerala Blast,2457,7,4,4,6,9,17,-8,16
FC Goa,2457,8,3,2,9,9,21,-12,11
Mumbai City,2458,1,7,4,3,18,9,9,25
Kolkata,2458,2,5,7,2,18,15,3,22
Kerala Blast,2458,3,6,3,5,11,14,-3,21
NorthEast Un,2458,4,5,3,6,12,12,0,18
Delhi Dynamo,2458,5,4,5,5,23,22,1,17
FC Goa,2458,6,4,4,6,13,15,-2,16
Chennaiyin,2458,7,3,7,4,14,18,-4,16
FC Pune City,2458,8,4,3,7,14,18,-4,15
Mumbai City,2459,1,7,4,3,18,8,10,25
Delhi Dynamo,2459,2,6,5,3,26,16,10,23
Kerala Blast,2459,3,5,5,4,14,16,-2,20
Kolkata,2459,4,4,7,3,18,16,2,19
FC Pune City,2459,5,5,4,5,15,16,-1,19
NorthEast Un,2459,6,4,3,7,10,15,-5,15
Chennaiyin,2459,7,3,6,5,14,21,-7,15
FC Goa,2459,8,4,2,8,11,18,-7,14
Mumbai City,2460,1,6,5,3,16,8,8,23
Delhi Dynamo,2460,2,5,7,2,26,15,11,22
Kolkata,2460,3,4,7,3,17,17,0,19
FC Pune City,2460,4,5,3,6,16,16,0,18
NorthEast Un,2460,5,4,5,5,12,12,0,17
FC Goa,2460,6,5,2,7,13,20,-7,17
Kerala Blast,2460,7,4,5,5,10,17,-7,17
Chennaiyin,2460,8,3,6,5,16,21,-5,15
Delhi Dynamo,2461,1,6,5,3,25,16,9,23
Mumbai City,2461,2,6,4,4,16,9,7,22
Kerala Blast,2461,3,6,3,5,11,16,-5,21
Kolkata,2461,4,4,8,2,18,14,4,20
NorthEast Un,2461,5,5,3,6,13,13,0,18
FC Pune City,2461,6,4,4,6,12,15,-3,16
Chennaiyin,2461,7,3,7,4,17,21,-4,16
FC Goa,2461,8,3,4,7,12,20,-8,13
Mumbai City,2462,1,7,4,3,18,9,9,25
Kerala Blast,2462,2,6,3,5,11,15,-4,21
Kolkata,2462,3,4,7,3,17,15,2,19
Delhi Dynamo,2462,4,4,6,4,25,20,5,18
NorthEast Un,2462,5,5,3,6,13,13,0,18
FC Pune City,2462,6,5,3,6,14,16,-2,18
FC Goa,2462,7,4,4,6,12,16,-4,16
Chennaiyin,2462,8,3,6,5,14,20,-6,15
Mumbai City,2463,1,6,5,3,17,9,8,23
Delhi Dynamo,2463,2,4,8,2,25,18,7,20
Kolkata,2463,3,4,8,2,16,14,2,20
FC Pune City,2463,4,5,4,5,15,16,-1,19
Kerala Blast,2463,5,5,3,6,15,17,-2,18
Chennaiyin,2463,6,4,6,4,16,19,-3,18
NorthEast Un,2463,7,4,4,6,12,16,-4,16
FC Goa,2463,8,3,4,7,10,17,-7,13
Delhi Dynamo,2464,1,6,6,2,26,14,12,24
Mumbai City,2464,2,6,4,4,16,10,6,22
Kolkata,2464,3,5,6,3,20,15,5,21
NorthEast Un,2464,4,4,5,5,10,10,0,17
FC Goa,2464,5,5,2,7,11,18,-7,17
Kerala Blast,2464,5,4,5,5,11,18,-7,17
FC Pune City,2464,7,4,4,6,12,16,-4,16
Chennaiyin,2464,8,3,6,5,13,18,-5,15
Mumbai City,2465,1,7,4,3,18,9,9,25
NorthEast Un,2465,2,7,2,5,15,11,4,23
Kolkata,2465,3,5,6,3,19,14,5,21
Delhi Dynamo,2465,4,5,5,4,27,18,9,20
FC Goa,2465,5,5,2,7,11,19,-8,17
FC Pune City,2465,6,4,4,6,15,18,-3,16
Kerala Blast,2465,7,4,4,6,13,22,-9,16
Chennaiyin,2465,8,3,5,6,15,22,-7,14
Mumbai City,2466,1,6,5,3,17,9,8,23
Delhi Dynamo,2466,2,5,6,3,24,17,7,21
NorthEast Un,2466,3,6,3,5,13,11,2,21
FC Pune City,2466,4,5,4,5,14,15,-1,19
Kolkata,2466,5,3,8,3,15,15,0,17
Kerala Blast,2466,6,4,5,5,13,18,-5,17
Chennaiyin,2466,7,3,6,5,14,19,-5,15
FC Goa,2466,8,4,3,7,10,16,-6,15
Mumbai City,2467,1,7,4,3,20,9,11,25
Delhi Dynamo,2467,2,5,5,4,24,23,1,20
Kolkata,2467,3,4,7,3,17,14,3,19
FC Goa,2467,4,5,3,6,17,17,0,18
FC Pune City,2467,5,5,3,6,13,17,-4,18
Kerala Blast,2467,6,5,3,6,11,18,-7,18
NorthEast Un,2467,7,5,2,7,15,16,-1,17
Chennaiyin,2467,8,4,5,5,19,22,-3,17
Delhi Dynamo,2468,1,7,5,2,29,17,12,26
Mumbai City,2468,2,6,4,4,18,11,7,22
Kolkata,2468,3,4,7,3,16,15,1,19
FC Pune City,2468,4,5,4,5,13,14,-1,19
Kerala Blast,2468,5,4,5,5,14,19,-5,17
NorthEast Un,2468,6,4,4,6,14,15,-1,16
Chennaiyin,2468,7,3,6,5,14,19,-5,15
FC Goa,2468,8,4,3,7,9,17,-8,15
Kerala Blast,2469,1,7,3,4,16,14,2,24
Mumbai City,2469,2,6,5,3,17,9,8,23
Delhi Dynamo,2469,3,5,6,3,25,17,8,21
Kolkata,2469,4,5,6,3,16,16,0,21
NorthEast Un,2469,5,5,3,6,14,15,-1,18
Chennaiyin,2469,6,3,7,4,19,23,-4,16
FC Pune City,2469,7,4,3,7,14,18,-4,15
FC Goa,2469,8,3,3,8,11,20,-9,12
Mumbai City,2470,1,6,5,3,17,9,8,23
Delhi Dynamo,2470,2,5,7,2,23,15,8,22
Kolkata,2470,3,5,7,2,18,13,5,22
NorthEast Un,2470,4,6,2,6,15,12,3,20
Kerala Blast,2470,5,5,3,6,15,18,-3,18
FC Goa,2470,6,4,4,6,12,15,-3,16
FC Pune City,2470,7,4,3,7,12,20,-8,15
Chennaiyin,2470,8,3,5,6,13,23,-10,14
Delhi Dynamo,2471,1,7,5,2,28,18,10,26
Mumbai City,2471,2,6,4,4,18,11,7,22
NorthEast Un,2471,3,6,2,6,15,13,2,20
Kolkata,2471,4,3,8,3,17,17,0,17
FC Pune City,2471,5,4,5,5,14,16,-2,17
FC Goa,2471,6,5,2,7,12,16,-4,17
Kerala Blast,2471,7,4,5,5,10,16,-6,17
Chennaiyin,2471,8,3,5,6,14,21,-7,14
Mumbai City,2472,1,7,4,3,18,9,9,25
Kolkata,2472,2,5,7,2,19,14,5,22
NorthEast Un,2472,3,5,3,6,12,13,-1,18
Chennaiyin,2472,4,4,6,4,17,19,-2,18
Kerala Blast,2472,5,4,6,4,10,14,-4,18
Delhi Dynamo,2472,6,4,5,5,23,20,3,17
FC Pune City,2472,7,4,4,6,13,17,-4,16
FC Goa,2472,8,4,3,7,13,19,-6,15
Kerala Blast,2473,1,7,3,4,15,14,1,24
Mumbai City,2473,2,6,5,3,18,10,8,23
Delhi Dynamo,2473,3,4,7,3,28,23,5,19
FC Pune City,2473,4,5,3,6,15,17,-2,18
Kolkata,2473,4,4,6,4,15,17,-2,18
Chennaiyin,2473,6,4,5,5,16,18,-2,17
FC Goa,2473,7,5,2,7,14,18,-4,17
NorthEast Un,2473,8,4,3,7,12,16,-4,15
Mumbai City,2474,1,7,4,3,20,8,12,25
Kolkata,2474,2,5,7,2,19,16,3,22
NorthEast Un,2474,3,6,2,6,11,10,1,20
Kerala Blast,2474,4,5,4,5,12,16,-4,19
Delhi Dynamo,2474,5,4,5,5,21,22,-1,17
FC Pune City,2474,6,4,5,5,14,16,-2,17
FC Goa,2474,7,4,3,7,12,16,-4,15
Chennaiyin,2474,8,3,6,5,14,19,-5,15
Delhi Dynamo,2475,1,7,5,2,25,15,10,26
Mumbai City,2475,2,6,4,4,16,9,7,22
Kolkata,2475,3,5,6,3,16,14,2,21
NorthEast Un,2475,4,6,2,6,13,11,2,20
FC Pune City,2475,5,5,4,5,15,16,-1,19
Kerala Blast,2475,6,4,4,6,11,17,-6,16
FC Goa,2475,7,4,2,8,13,17,-4,14
Chennaiyin,2475,8,3,5,6,13,23,-10,14
Mumbai City,2476,1,7,4,3,19,8,11,25
Kerala Blast,2476,2,6,4,4,15,15,0,22
Delhi Dynamo,2476,3,5,5,4,22,18,4,20
NorthEast Un,2476,4,6,2,6,11,10,1,20
Kolkata,2476,5,4,7,3,20,16,4,19
FC Pune City,2476,6,5,3,6,13,17,-4,18
Chennaiyin,2476,7,3,6,5,13,18,-5,15
FC Goa,2476,8,3,3,8,9,20,-11,12
Mumbai City,2477,1,7,4,3,20,10,10,25
Delhi Dynamo,2477,2,6,5,3,27,20,7,23
Kolkata,2477,3,5,7,2,19,13,6,22
Kerala Blast,2477,4,5,4,5,13,18,-5,19
NorthEast Un,2477,5,4,4,6,11,12,-1,16
FC Pune City,2477,6,4,4,6,12,16,-4,16
Chennaiyin,2477,7,3,6,5,14,19,-5,15
FC Goa,2477,8,4,2,8,11,19,-8,14
Mumbai City,2478,1,7,4,3,19,9,10,25
Kerala Blast,2478,2,6,4,4,12,13,-1,22
Delhi Dynamo,2478,3,5,6,3,26,19,7,21
Kolkata,2478,4,4,7,3,15,13,2,19
NorthEast Un,2478,5,5,3,6,11,11,0,18
Chennaiyin,2478,6,4,5,5,14,19,-5,17
FC Pune City,2478,7,4,3,7,12,18,-6,15
FC Goa,2478,8,3,4,7,10,17,-7,13
Mumbai City,2479,1,6,5,3,18,10,8,23
Kolkata,2479,2,5,7,2,18,15,3,22
Delhi Dynamo,2479,3,4,7,3,25,20,5,19
Kerala Blast,2479,4,5,4,5,11,15,-4,19
NorthEast Un,2479,5,5,3,6,11,10,1,18
Chennaiyin,2479,6,4,5,5,15,19,-4,17
FC Goa,2479,7,4,4,6,14,19,-5,16
FC Pune City,2479,8,4,3,7,14,18,-4,15
Mumbai City,2480,1,7,4,3,19,9,10,25
Delhi Dynamo,2480,2,6,5,3,24,17,7,23
Kolkata,2480,3,4,8,2,18,15,3,20
NorthEast Un,2480,4,6,2,6,12,10,2,20
FC Pune City,2480,5,4,5,5,14,16,-2,17
Kerala Blast,2480,6,4,5,5,10,15,-5,17
Chennaiyin,2480,7,3,5,6,13,20,-7,14
FC Goa,2480,8,4,2,8,11,19,-8,14
Mumbai City,2481,1,7,4,3,18,8,10,25
Delhi Dynamo,2481,2,6,5,3,27,18,9,23
Kerala Blast,2481,3,6,3,5,15,15,0,21
Kolkata,2481,4,4,8,2,19,17,2,20
Chennaiyin,2481,5,4,5,5,16,20,-4,17
FC Pune City,2481,6,4,4,6,14,20,-6,16
FC Goa,2481,7,4,3,7,12,19,-7,15
NorthEast Un,2481,8,4,2,8,12,16,-4,14
Mumbai City,2482,1,6,5,3,17,9,8,23
Delhi Dynamo,2482,2,5,6,3,27,20,7,21
Kolkata,2482,3,5,6,3,16,15,1,21
Kerala Blast,2482,4,6,3,5,13,15,-2,21
Chennaiyin,2482,5,4,6,4,16,19,-3,18
FC Goa,2482,6,5,2,7,15,19,-4,17
NorthEast Un,2482,7,4,3,7,12,14,-2,15
FC Pune City,2482,8,4,3,7,13,18,-5,15
Delhi Dynamo,2483,1,6,6,2,28,17,11,24
Kerala Blast,2483,2,7,3,4,15,15,0,24
Mumbai City,2483,3,6,4,4,17,11,6,22
Kolkata,2483,4,5,6,3,19,14,5,21
NorthEast Un,2483,5,5,3,6,14,15,-1,18
Chennaiyin,2483,6,3,6,5,14,19,-5,15
FC Pune City,2483,6,4,3,7,14,19,-5,15
FC Goa,2483,8,3,3,8,8,19,-11,12
Mumbai City,2484,1,7,4,3,17,8,9,25
Delhi Dynamo,2484,2,6,5,3,24,15,9,23
Kerala Blast,2484,3,6,4,4,14,15,-1,22
Kolkata,2484,4,4,6,4,16,21,-5,18
NorthEast Un,2484,5,5,2,7,13,13,0,17
Chennaiyin,2484,6,4,5,5,18,23,-5,17
FC Pune City,2484,7,4,4,6,14,17,-3,16
FC Goa,2484,8,4,2,8,17,21,-4,14
Delhi Dynamo,2485,1,6,6,2,28,18,10,24
Mumbai City,2485,2,6,4,4,16,10,6,22
FC Pune City,2485,3,6,3,5,14,14,0,21
Kolkata,2485,4,4,7,3,17,15,2,19
NorthEast Un,2485,5,4,5,5,11,11,0,17
Kerala Blast,2485,6,4,4,6,10,17,-7,16
FC Goa,2485,7,4,3,7,15,19,-4,15
Chennaiyin,2485,8,3,6,5,14,21,-7,15
Mumbai City,2486,1,6,5,3,16,8,8,23
Delhi Dynamo,2486,2,5,7,2,23,15,8,22
Kerala Blast,2486,3,6,4,4,12,14,-2,22
Kolkata,2486,4,4,6,4,17,16,1,18
Chennaiyin,2486,5,4,6,4,15,18,-3,18
NorthEast Un,2486,6,4,5,5,10,10,0,17
FC Pune City,2486,7,4,3,7,12,18,-6,15
FC Goa,2486,8,4,2,8,11,17,-6,14
Mumbai City,2487,1,6,5,3,17,9,8,23
Delhi Dynamo,2487,2,5,7,2,26,18,8,22
Kolkata,2487,3,5,7,2,17,13,4,22
Kerala Blast,2487,4,5,5,4,13,15,-2,20
NorthEast Un,2487,5,5,3,6,14,14,0,18
Chennaiyin,2487,6,4,5,5,14,19,-5,17
FC Pune City,2487,7,4,4,6,12,16,-4,16
FC Goa,2487,8,3,2,9,9,18,-9,11
Mumbai City,2488,1,6,4,4,17,11,6,22
FC Pune City,2488,2,6,3,5,17,16,1,21
Delhi Dynamo,2488,3,5,5,4,25,20,5,20
NorthEast Un,2488,4,6,2,6,14,11,3,20
Kolkata,2488,5,4,6,4,16,16,0,18
FC Goa,2488,6,5,3,6,13,17,-4,18
Kerala Blast,2488,7,5,3,6,12,18,-6,18
Chennaiyin,2488,8,3,6,5,16,21,-5,15
Mumbai City,2489,1,7,4,3,20,9,11,25
Delhi Dynamo,2489,2,5,6,3,24,19,5,21
Kolkata,2489,3,4,7,3,17,16,1,19
FC Pune City,2489,4,5,4,5,15,16,-1,19
NorthEast Un,2489,5,5,3,6,12,12,0,18
Kerala Blast,2489,6,5,3,6,13,19,-6,18
FC Goa,2489,7,5,2,7,12,15,-3,17
Chennaiyin,2489,8,3,5,6,13,20,-7,14
Mumbai City,2490,1,7,4,3,17,8,9,25
Kolkata,2490,2,4,8,2,16,13,3,20
Kerala Blast,2490,3,5,5,4,12,15,-3,20
Delhi Dynamo,2490,4,4,7,3,25,19,6,19
FC Pune City,2490,5,4,5,5,13,15,-2,17
Chennaiyin,2490,6,4,5,5,15,18,-3,17
NorthEast Un,2490,7,4,3,7,12,15,-3,15
FC Goa,2490,8,4,3,7,10,17,-7,15
Mumbai City,2491,1,7,4,3,19,8,11,25
Kolkata,2491,2,4,7,3,18,15,3,19
NorthEast Un,2491,3,5,4,5,11,9,2,19
FC Pune City,2491,4,5,4,5,15,14,1,19
Delhi Dynamo,2491,5,4,6,4,21,19,2,18
Kerala Blast,2491,6,4,6,4,9,13,-4,18
Chennaiyin,2491,7,3,6,5,13,19,-6,15
FC Goa,2491,8,4,3,7,10,19,-9,15
Mumbai City,2492,1,7,4,3,17,8,9,25
Kolkata,2492,2,5,7,2,18,13,5,22
Kerala Blast,2492,3,6,3,5,13,17,-4,21
Delhi Dynamo,2492,4,5,5,4,24,17,7,20
NorthEast Un,2492,5,6,2,6,15,11,4,20
FC Pune City,2492,6,4,3,7,12,17,-5,15
FC Goa,2492,7,4,3,7,12,18,-6,15
Chennaiyin,2492,8,3,5,6,13,23,-10,14
Mumbai City,2493,1,6,4,4,18,12,6,22
Delhi Dynamo,2493,2,5,6,3,28,20,8,21
Chennaiyin,2493,3,5,5,4,17,19,-2,20
Kerala Blast,2493,4,5,4,5,13,15,-2,19
Kolkata,2493,5,4,6,4,16,18,-2,18
FC Pune City,2493,6,5,3,6,13,18,-5,18
FC Goa,2493,7,5,2,7,17,19,-2,17
NorthEast Un,2493,8,4,4,6,11,12,-1,16
Mumbai City,2494,1,6,5,3,19,11,8,23
FC Pune City,2494,2,6,3,5,16,14,2,21
Kerala Blast,2494,3,6,3,5,13,17,-4,21
Delhi Dynamo,2494,4,4,6,4,24,21,3,18
NorthEast Un,2494,5,5,3,6,15,13,2,18
Chennaiyin,2494,6,4,6,4,16,19,-3,18
Kolkata,2494,7,3,7,4,14,16,-2,16
FC Goa,2494,8,4,3,7,11,17,-6,15
Mumbai City,2495,1,6,5,3,19,11,8,23
Delhi Dynamo,2495,2,5,6,3,25,19,6,21
Kolkata,2495,3,5,6,3,19,15,4,21
NorthEast Un,2495,4,6,2,6,14,11,3,20
FC Pune City,2495,5,5,3,6,14,16,-2,18
Kerala Blast,2495,6,5,3,6,10,19,-9,18
Chennaiyin,2495,7,3,6,5,14,19,-5,15
FC Goa,2495,8,4,3,7,11,16,-5,15
Mumbai City,2496,1,6,5,3,17,9,8,23
Kolkata,2496,2,5,6,3,19,17,2,21
NorthEast Un,2496,3,6,2,6,13,12,1,20
Delhi Dynamo,2496,4,4,6,4,26,22,4,18
FC Goa,2496,5,5,3,6,18,19,-1,18
Chennaiyin,2496,6,4,6,4,16,19,-3,18
Kerala Blast,2496,7,5,3,6,11,16,-5,18
FC Pune City,2496,8,4,3,7,12,18,-6,15
Delhi Dynamo,2497,1,6,5,3,24,16,8,23
Mumbai City,2497,2,6,4,4,16,9,7,22
Kolkata,2497,3,5,6,3,17,16,1,21
Kerala Blast,2497,4,6,3,5,13,15,-2,21
Chennaiyin,2497,5,5,5,4,17,17,0,20
NorthEast Un,2497,6,5,2,7,10,14,-4,17
FC Pune City,2497,7,4,3,7,13,17,-4,15
FC Goa,2497,8,4,2,8,11,17,-6,14
Mumbai City,2498,1,6,5,3,18,10,8,23
FC Pune City,2498,2,6,3,5,16,14,2,21
Kerala Blast,2498,3,5,4,5,11,16,-5,19
Delhi Dynamo,2498,4,4,6,4,24,23,1,18
NorthEast Un,2498,5,5,3,6,13,12,1,18
Chennaiyin,2498,6,4,6,4,15,18,-3,18
FC Goa,2498,7,5,2,7,13,15,-2,17
Kolkata,2498,8,3,7,4,14,16,-2,16
Delhi Dynamo,2499,1,7,5,2,28,15,13,26
Mumbai City,2499,2,6,4,4,17,11,6,22
Kolkata,2499,3,5,7,2,16,13,3,22
FC Pune City,2499,4,4,5,5,13,15,-2,17
Kerala Blast,2499,5,4,5,5,9,14,-5,17
NorthEast Un,2499,6,4,4,6,11,13,-2,16
Chennaiyin,2499,7,3,6,5,15,20,-5,15
FC Goa,2499,8,4,2,8,9,17,-8,14
Mumbai City,2500,1,7,4,3,20,9,11,25
Delhi Dynamo,2500,2,5,6,3,25,20,5,21
FC Pune City,2500,3,6,3,5,18,16,2,21
Kolkata,2500,4,4,7,3,18,17,1,19
Kerala Blast,2500,5,5,4,5,14,18,-4,19
Chennaiyin,2500,6,4,6,4,15,18,-3,18
NorthEast Un,2500,7,4,4,6,11,13,-2,16
FC Goa,2500,8,3,2,9,9,19,-10,11
Mumbai City,2501,1,6,5,3,17,9,8,23
Kolkata,2501,2,5,7,2,15,12,3,22
Delhi Dynamo,2501,3,5,6,3,24,17,7,21
Kerala Blast,2501,4,5,4,5,13,16,-3,19
FC Pune City,2501,5,4,5,5,14,16,-2,17
NorthEast Un,2501,6,5,2,7,10,12,-2,17
FC Goa,2501,7,5,2,7,12,16,-4,17
Chennaiyin,2501,8,3,5,6,13,20,-7,14
Mumbai City,2502,1,6,5,3,18,10,8,23
Delhi Dynamo,2502,2,5,7,2,25,16,9,22
Kerala Blast,2502,3,6,3,5,14,16,-2,21
Kolkata,2502,4,4,7,3,18,17,1,19
FC Pune City,2502,5,5,4,5,16,17,-1,19
Chennaiyin,2502,6,4,6,4,17,18,-1,18
NorthEast Un,2502,7,4,3,7,9,14,-5,15
FC Goa,2502,8,3,3,8,10,19,-9,12
NorthEast Un,2503,1,7,2,5,19,11,8,23
Mumbai City,2503,2,6,4,4,16,9,7,22
Delhi Dynamo,2503,3,5,6,3,25,19,6,21
Kolkata,2503,4,5,6,3,17,14,3,21
FC Pune City,2503,5,5,4,5,14,15,-1,19
Chennaiyin,2503,6,4,5,5,15,20,-5,17
Kerala Blast,2503,7,4,4,6,10,20,-10,16
FC Goa,2503,8,3,3,8,11,19,-8,12
Mumbai City,2504,1,6,4,4,17,10,7,22
Kolkata,2504,2,5,6,3,18,16,2,21
Delhi Dynamo,2504,3,5,5,4,23,18,5,20
NorthEast Un,2504,4,6,2,6,11,11,0,20
Kerala Blast,2504,5,5,4,5,12,15,-3,19
FC Goa,2504,6,5,2,7,12,15,-3,17
Chennaiyin,2504,7,4,5,5,14,18,-4,17
FC Pune City,2504,8,4,4,6,13,17,-4,16
Mumbai City,2505,1,7,4,3,18,8,10,25
Delhi Dynamo,2505,2,5,6,3,23,16,7,21
Kolkata,2505,3,4,8,2,17,15,2,20
Kerala Blast,2505,4,5,5,4,12,15,-3,20
FC Pune City,2505,5,4,5,5,15,17,-2,17
Chennaiyin,2505,6,3,7,4,14,18,-4,16
NorthEast Un,2505,7,4,3,7,10,13,-3,15
FC Goa,2505,8,3,4,7,10,17,-7,13
Kolkata,2506,1,6,6,2,20,14,6,24
Mumbai City,2506,2,6,5,3,18,10,8,23
Kerala Blast,2506,3,5,4,5,11,16,-5,19
Delhi Dynamo,2506,4,4,6,4,23,20,3,18
NorthEast Un,2506,5,5,3,6,13,11,2,18
Chennaiyin,2506,6,4,6,4,18,18,0,18
FC Pune City,2506,7,4,4,6,13,17,-4,16
FC Goa,2506,8,4,2,8,11,21,-10,14
Mumbai City,2507,1,7,4,3,17,8,9,25
Kolkata,2507,2,5,7,2,19,15,4,22
Delhi Dynamo,2507,3,5,5,4,24,18,6,20
Kerala Blast,2507,4,5,4,5,13,17,-4,19
NorthEast Un,2507,5,5,3,6,13,12,1,18
Chennaiyin,2507,6,4,6,4,16,19,-3,18
FC Pune City,2507,7,4,4,6,14,17,-3,16
FC Goa,2507,8,3,3,8,11,21,-10,12
Mumbai City,2508,1,7,4,3,18,9,9,25
Kerala Blast,2508,2,7,3,4,15,13,2,24
FC Goa,2508,3,6,2,6,15,16,-1,20
Delhi Dynamo,2508,4,4,6,4,24,20,4,18
Kolkata,2508,5,4,6,4,17,17,0,18
NorthEast Un,2508,6,5,3,6,11,12,-1,18
FC Pune City,2508,7,4,3,7,12,19,-7,15
Chennaiyin,2508,8,3,5,6,13,19,-6,14
Kolkata,2509,1,6,6,2,21,14,7,24
Delhi Dynamo,2509,2,5,7,2,27,18,9,22
Mumbai City,2509,3,6,4,4,17,11,6,22
NorthEast Un,2509,4,5,3,6,13,13,0,18
Kerala Blast,2509,5,5,3,6,14,18,-4,18
Chennaiyin,2509,6,4,5,5,16,21,-5,17
FC Pune City,2509,7,4,3,7,14,20,-6,15
FC Goa,2509,8,4,3,7,13,20,-7,15
Mumbai City,2510,1,7,4,3,18,9,9,25
Delhi Dynamo,2510,2,5,6,3,26,18,8,21
NorthEast Un,2510,3,6,3,5,15,12,3,21
Kerala Blast,2510,4,6,3,5,13,15,-2,21
Kolkata,2510,5,4,6,4,15,15,0,18
Chennaiyin,2510,6,4,5,5,16,20,-4,17
FC Pune City,2510,7,4,3,7,13,19,-6,15
FC Goa,2510,8,4,2,8,10,18,-8,14
Delhi Dynamo,2511,1,6,6,2,25,16,9,24
Mumbai City,2511,2,6,4,4,17,10,7,22
Kolkata,2511,3,4,8,2,14,12,2,20
Chennaiyin,2511,4,4,6,4,16,18,-2,18
NorthEast Un,2511,5,5,2,7,13,13,0,17
FC Pune City,2511,6,4,5,5,16,18,-2,17
Kerala Blast,2511,7,4,4,6,14,22,-8,16
FC Goa,2511,8,3,5,6,10,16,-6,14
Mumbai City,2512,1,6,4,4,16,9,7,22
Delhi Dynamo,2512,2,5,5,4,23,17,6,20
FC Pune City,2512,3,5,4,5,14,15,-1,19
Kerala Blast,2512,4,5,4,5,13,17,-4,19
Kolkata,2512,5,3,9,2,17,16,1,18
FC Goa,2512,6,5,3,6,12,16,-4,18
NorthEast Un,2512,7,5,2,7,11,12,-1,17
Chennaiyin,2512,8,4,5,5,14,18,-4,17
Delhi Dynamo,2513,1,6,6,2,25,15,10,24
Mumbai City,2513,2,6,4,4,17,10,7,22
Kolkata,2513,3,5,6,3,17,15,2,21
Kerala Blast,2513,4,5,4,5,12,15,-3,19
FC Pune City,2513,5,5,3,6,13,16,-3,18
NorthEast Un,2513,6,4,5,5,10,10,0,17
Chennaiyin,2513,7,3,6,5,13,19,-6,15
FC Goa,2513,8,4,2,8,11,18,-7,14
Mumbai City,2514,1,7,4,3,19,8,11,25
Delhi Dynamo,2514,2,6,5,3,26,19,7,23
FC Pune City,2514,3,6,3,5,15,15,0,21
Kolkata,2514,4,4,7,3,17,16,1,19
Kerala Blast,2514,5,5,3,6,10,15,-5,18
NorthEast Un,2514,6,5,2,7,14,15,-1,17
FC Goa,2514,7,4,3,7,14,20,-6,15
Chennaiyin,2514,8,3,5,6,17,24,-7,14
NorthEast Un,2515,1,7,2,5,17,13,4,23
Mumbai City,2515,2,6,4,4,17,10,7,22
Delhi Dynamo,2515,3,5,6,3,27,20,7,21
Kolkata,2515,4,4,6,4,19,18,1,18
FC Pune City,2515,5,5,3,6,14,18,-4,18
Kerala Blast,2515,6,5,3,6,12,17,-5,18
Chennaiyin,2515,7,4,5,5,16,20,-4,17
FC Goa,2515,8,4,3,7,13,19,-6,15
Mumbai City,2516,1,6,5,3,16,8,8,23
Kolkata,2516,2,5,6,3,17,15,2,21
Delhi Dynamo,2516,3,4,8,2,22,15,7,20
FC Pune City,2516,4,5,3,6,14,15,-1,18
FC Goa,2516,5,5,3,6,13,17,-4,18
Kerala Blast,2516,6,5,3,6,12,18,-6,18
Chennaiyin,2516,7,4,5,5,16,20,-4,17
NorthEast Un,2516,8,4,3,7,11,13,-2,15
Mumbai City,2517,1,6,5,3,16,8,8,23
NorthEast Un,2517,2,6,3,5,13,10,3,21
Delhi Dynamo,2517,3,4,8,2,22,15,7,20
Kerala Blast,2517,4,5,4,5,12,17,-5,19
FC Pune City,2517,5,4,5,5,15,17,-2,17
Kolkata,2517,6,3,7,4,16,18,-2,16
FC Goa,2517,7,4,4,6,14,18,-4,16
Chennaiyin,2517,8,3,6,5,15,20,-5,15
Mumbai City,2518,1,7,4,3,18,8,10,25
Delhi Dynamo,2518,2,5,5,4,24,17,7,20
NorthEast Un,2518,3,6,2,6,12,11,1,20
Kerala Blast,2518,4,5,5,4,11,14,-3,20
Kolkata,2518,5,4,7,3,16,15,1,19
FC Goa,2518,6,5,2,7,13,19,-6,17
FC Pune City,2518,7,4,4,6,14,18,-4,16
Chennaiyin,2518,8,3,5,6,16,22,-6,14
Mumbai City,2519,1,7,4,3,20,8,12,25
Delhi Dynamo,2519,2,6,5,3,27,20,7,23
Kolkata,2519,3,5,7,2,17,14,3,22
FC Pune City,2519,4,5,4,5,13,14,-1,19
NorthEast Un,2519,5,5,3,6,13,13,0,18
Kerala Blast,2519,6,4,4,6,10,16,-6,16
FC Goa,2519,7,4,2,8,15,22,-7,14
Chennaiyin,2519,8,3,5,6,15,23,-8,14
Mumbai City,2520,1,7,4,3,17,8,9,25
Delhi Dynamo,2520,2,5,5,4,23,17,6,20
NorthEast Un,2520,3,6,2,6,13,12,1,20
Chennaiyin,2520,4,5,5,4,16,18,-2,20
Kolkata,2520,5,4,6,4,15,16,-1,18
FC Pune City,2520,6,5,3,6,14,16,-2,18
Kerala Blast,2520,7,5,3,6,12,16,-4,18
FC Goa,2520,8,4,2,8,10,17,-7,14
Mumbai City,2521,1,7,4,3,18,9,9,25
Kerala Blast,2521,2,6,3,5,12,15,-3,21
Chennaiyin,2521,3,5,5,4,15,17,-2,20
FC Pune City,2521,4,5,3,6,15,16,-1,18
Kolkata,2521,5,4,6,4,15,17,-2,18
Delhi Dynamo,2521,6,4,5,5,22,19,3,17
NorthEast Un,2521,7,5,2,7,12,12,0,17
FC Goa,2521,8,5,2,7,11,15,-4,17
Delhi Dynamo,2522,1,6,6,2,27,15,12,24
Mumbai City,2522,2,6,5,3,17,9,8,23
FC Pune City,2522,3,6,3,5,15,14,1,21
NorthEast Un,2522,4,6,2,6,12,11,1,20
FC Goa,2522,5,5,2,7,11,17,-6,17
Kolkata,2522,6,3,7,4,13,14,-1,16
Kerala Blast,2522,7,4,4,6,9,16,-7,16
Chennaiyin,2522,8,3,5,6,13,21,-8,14
Kolkata,2523,1,5,7,2,17,12,5,22
Mumbai City,2523,2,6,4,4,16,12,4,22
Delhi Dynamo,2523,3,5,5,4,27,18,9,20
NorthEast Un,2523,4,5,3,6,12,12,0,18
FC Pune City,2523,5,5,3,6,15,18,-3,18
Kerala Blast,2523,6,5,3,6,12,18,-6,18
Chennaiyin,2523,7,3,7,4,15,19,-4,16
FC Goa,2523,8,4,4,6,11,16,-5,16
Mumbai City,2524,1,6,5,3,16,8,8,23
Delhi Dynamo,2524,2,5,7,2,25,17,8,22
Kolkata,2524,3,5,7,2,19,14,5,22
NorthEast Un,2524,4,5,4,5,13,12,1,19
FC Pune City,2524,5,5,3,6,15,17,-2,18
Chennaiyin,2524,6,4,6,4,16,19,-3,18
Kerala Blast,2524,7,4,4,6,10,17,-7,16
FC Goa,2524,8,3,2,9,12,22,-10,11
Delhi Dynamo,2525,1,6,5,3,24,16,8,23
Mumbai City,2525,2,6,4,4,16,9,7,22
Kerala Blast,2525,3,6,3,5,11,15,-4,21
Kolkata,2525,4,4,7,3,15,13,2,19
NorthEast Un,2525,5,5,2,7,11,12,-1,17
FC Goa,2525,6,5,2,7,11,15,-4,17
Chennaiyin,2525,7,4,5,5,14,19,-5,17
FC Pune City,2525,8,4,4,6,12,15,-3,16
Mumbai City,2526,1,7,4,3,19,10,9,25
Kolkata,2526,2,5,7,2,18,13,5,22
Delhi Dynamo,2526,3,5,6,3,26,19,7,21
NorthEast Un,2526,4,6,2,6,13,11,2,20
Kerala Blast,2526,5,5,4,5,13,17,-4,19
FC Pune City,2526,6,4,3,7,13,18,-5,15
FC Goa,2526,7,4,3,7,13,19,-6,15
Chennaiyin,2526,8,3,5,6,14,22,-8,14
Kerala Blast,2527,1,7,3,4,16,13,3,24
Delhi Dynamo,2527,2,6,5,3,24,18,6,23
Mumbai City,2527,3,6,4,4,16,9,7,22
Chennaiyin,2527,4,5,5,4,19,18,1,20
NorthEast Un,2527,5,5,2,7,13,14,-1,17
Kolkata,2527,6,3,7,4,16,17,-1,16
FC Pune City,2527,7,4,4,6,14,19,-5,16
FC Goa,2527,8,4,2,8,11,21,-10,14
Mumbai City,2528,1,7,4,3,18,9,9,25
Kolkata,2528,2,6,6,2,20,14,6,24
Delhi Dynamo,2528,3,6,5,3,29,17,12,23
Kerala Blast,2528,4,5,4,5,13,17,-4,19
Chennaiyin,2528,5,4,5,5,16,20,-4,17
FC Pune City,2528,6,4,4,6,12,15,-3,16
NorthEast Un,2528,7,4,2,8,11,17,-6,14
FC Goa,2528,8,4,2,8,11,21,-10,14
Mumbai City,2529,1,6,4,4,17,10,7,22
Delhi Dynamo,2529,2,5,6,3,26,19,7,21
Chennaiyin,2529,3,5,5,4,19,18,1,20
FC Pune City,2529,4,5,4,5,16,16,0,19
Kerala Blast,2529,5,5,4,5,12,16,-4,19
Kolkata,2529,6,3,9,2,18,17,1,18
NorthEast Un,2529,7,5,2,7,11,15,-4,17
FC Goa,2529,8,3,4,7,13,21,-8,13
Delhi Dynamo,2530,1,6,5,3,24,16,8,23
Mumbai City,2530,2,6,4,4,16,9,7,22
Kerala Blast,2530,3,6,4,4,14,15,-1,22
Kolkata,2530,4,4,7,3,19,17,2,19
NorthEast Un,2530,5,5,3,6,11,10,1,18
Chennaiyin,2530,6,4,6,4,16,19,-3,18
FC Pune City,2530,7,4,4,6,13,17,-4,16
FC Goa,2530,8,3,3,8,11,21,-10,12
Mumbai City,2531,1,7,4,3,18,8,10,25
Kerala Blast,2531,2,6,4,4,15,14,1,22
FC Goa,2531,3,6,2,6,13,15,-2,20
NorthEast Un,2531,4,5,4,5,12,11,1,19
Kolkata,2531,5,4,6,4,16,16,0,18
Delhi Dynamo,2531,6,4,5,5,21,19,2,17
Chennaiyin,2531,7,3,6,5,14,19,-5,15
FC Pune City,2531,8,4,3,7,12,19,-7,15
Delhi Dynamo,2532,1,7,5,2,28,17,11,26
Mumbai City,2532,2,6,4,4,17,10,7,22
Kerala Blast,2532,3,5,5,4,14,15,-1,20
Kolkata,2532,4,3,9,2,18,17,1,18
Chennaiyin,2532,5,4,5,5,14,18,-4,17
FC Pune City,2532,6,4,4,6,13,18,-5,16
NorthEast Un,2532,7,4,3,7,10,12,-2,15
FC Goa,2532,8,4,3,7,14,21,-7,15
Mumbai City,2533,1,6,4,4,16,10,6,22
Delhi Dynamo,2533,2,5,6,3,24,16,8,21
Kolkata,2533,3,5,6,3,18,15,3,21
FC Goa,2533,4,6,2,6,16,15,1,20
NorthEast Un,2533,5,4,5,5,11,11,0,17
Kerala Blast,2533,6,4,5,5,11,16,-5,17
FC Pune City,2533,7,4,4,6,14,18,-4,16
Chennaiyin,2533,8,3,6,5,13,22,-9,15
Mumbai City,2534,1,7,4,3,19,9,10,25
Delhi Dynamo,2534,2,6,5,3,25,17,8,23
Kolkata,2534,3,5,7,2,19,14,5,22
NorthEast Un,2534,4,6,2,6,14,12,2,20
FC Pune City,2534,5,4,5,5,14,16,-2,17
Chennaiyin,2534,6,4,5,5,15,19,-4,17
Kerala Blast,2534,7,4,4,6,11,20,-9,16
FC Goa,2534,8,3,2,9,9,19,-10,11
Delhi Dynamo,2535,1,6,5,3,27,17,10,23
Mumbai City,2535,2,6,4,4,17,10,7,22
FC Goa,2535,3,6,2,6,16,17,-1,20
NorthEast Un,2535,4,6,2,6,14,15,-1,20
Kolkata,2535,5,4,7,3,16,15,1,19
FC Pune City,2535,6,5,3,6,13,15,-2,18
Kerala Blast,2535,7,4,4,6,12,18,-6,16
Chennaiyin,2535,8,3,5,6,15,23,-8,14
Mumbai City,2536,1,7,4,3,19,10,9,25
Kolkata,2536,2,5,6,3,17,17,0,21
Delhi Dynamo,2536,3,4,7,3,25,19,6,19
NorthEast Un,2536,4,5,4,5,14,11,3,19
Chennaiyin,2536,5,4,6,4,15,18,-3,18
FC Pune City,2536,6,5,3,6,13,16,-3,18
Kerala Blast,2536,7,5,3,6,14,18,-4,18
FC Goa,2536,8,3,3,8,9,17,-8,12
Mumbai City,2537,1,6,4,4,16,9,7,22
Delhi Dynamo,2537,2,5,6,3,24,19,5,21
Chennaiyin,2537,3,5,5,4,18,20,-2,20
FC Pune City,2537,4,5,4,5,15,15,0,19
Kolkata,2537,5,4,7,3,16,17,-1,19
Kerala Blast,2537,6,5,3,6,11,17,-6,18
NorthEast Un,2537,7,5,2,7,16,15,1,17
FC Goa,2537,8,4,3,7,14,18,-4,15
Kerala Blast,2538,1,7,3,4,14,14,0,24
Mumbai City,2538,2,6,4,4,16,9,7,22
Delhi Dynamo,2538,3,5,5,4,25,19,6,20
Kolkata,2538,4,4,7,3,14,13,1,19
FC Goa,2538,5,5,3,6,15,16,-1,18
NorthEast Un,2538,6,5,3,6,13,14,-1,18
FC Pune City,2538,7,4,3,7,13,17,-4,15
Chennaiyin,2538,8,3,6,5,15,23,-8,15
Mumbai City,2539,1,6,5,3,16,8,8,23
Delhi Dynamo,2539,2,5,7,2,27,18,9,22
Kolkata,2539,3,5,7,2,20,12,8,22
Kerala Blast,2539,4,6,4,4,15,14,1,22
Chennaiyin,2539,5,4,5,5,15,18,-3,17
NorthEast Un,2539,6,5,2,7,12,16,-4,17
FC Pune City,2539,7,4,3,7,13,22,-9,15
FC Goa,2539,8,3,3,8,10,20,-10,12
Mumbai City,2540,1,7,4,3,18,8,10,25
Kolkata,2540,2,5,7,2,18,15,3,22
Delhi Dynamo,2540,3,5,5,4,22,17,5,20
Kerala Blast,2540,4,5,5,4,14,15,-1,20
FC Goa,2540,5,5,2,7,13,15,-2,17
Chennaiyin,2540,6,4,5,5,15,22,-7,17
NorthEast Un,2540,7,4,3,7,11,13,-2,15
FC Pune City,2540,8,4,3,7,14,20,-6,15
Mumbai City,2541,1,7,4,3,19,9,10,25
FC Pune City,2541,2,6,3,5,14,14,0,21
Delhi Dynamo,2541,3,5,5,4,25,20,5,20
Kerala Blast,2541,4,5,4,5,12,16,-4,19
Kolkata,2541,5,4,6,4,16,16,0,18
NorthEast Un,2541,6,5,3,6,12,12,0,18
Chennaiyin,2541,7,4,5,5,17,19,-2,17
FC Goa,2541,8,4,2,8,12,21,-9,14
Mumbai City,2542,1,7,4,3,19,9,10,25
Kolkata,2542,2,6,6,2,21,14,7,24
Delhi Dynamo,2542,3,5,5,4,24,19,5,20
NorthEast Un,2542,4,5,3,6,12,14,-2,18
Chennaiyin,2542,5,4,5,5,17,21,-4,17
Kerala Blast,2542,6,4,5,5,12,19,-7,17
FC Pune City,2542,7,4,4,6,16,20,-4,16
FC Goa,2542,8,4,2,8,12,17,-5,14
Mumbai City,2543,1,7,4,3,17,8,9,25
Kolkata,2543,2,5,7,2,19,16,3,22
Delhi Dynamo,2543,3,5,6,3,22,15,7,21
Kerala Blast,2543,4,6,3,5,14,16,-2,21
NorthEast Un,2543,5,4,4,6,11,12,-1,16
FC Pune City,2543,6,4,4,6,16,20,-4,16
Chennaiyin,2543,7,3,6,5,14,21,-7,15
FC Goa,2543,8,4,2,8,12,17,-5,14
Delhi Dynamo,2544,1,6,5,3,26,16,10,23
Mumbai City,2544,2,6,4,4,16,10,6,22
Kolkata,2544,3,5,6,3,17,15,2,21
NorthEast Un,2544,4,6,2,6,16,13,3,20
FC Goa,2544,5,5,3,6,13,16,-3,18
Kerala Blast,2544,6,5,3,6,13,18,-5,18
FC Pune City,2544,7,4,3,7,13,19,-6,15
Chennaiyin,2544,8,3,6,5,15,22,-7,15
Mumbai City,2545,1,6,5,3,17,9,8,23
Delhi Dynamo,2545,2,5,7,2,25,16,9,22
NorthEast Un,2545,3,6,3,5,16,11,5,21
Kolkata,2545,4,5,6,3,19,15,4,21
Kerala Blast,2545,5,5,4,5,13,19,-6,19
Chennaiyin,2545,6,4,5,5,16,20,-4,17
FC Pune City,2545,7,4,4,6,13,16,-3,16
FC Goa,2545,8,3,2,9,8,21,-13,11
Mumbai City,2546,1,7,4,3,19,8,11,25
Kerala Blast,2546,2,5,5,4,13,14,-1,20
NorthEast Un,2546,3,5,3,6,11,11,0,18
Chennaiyin,2546,4,4,6,4,15,18,-3,18
FC Goa,2546,5,5,3,6,13,16,-3,18
Delhi Dynamo,2546,6,4,5,5,22,20,2,17
Kolkata,2546,7,3,8,3,17,18,-1,17
FC Pune City,2546,8,4,4,6,14,19,-5,16
Delhi Dynamo,2547,1,7,5,2,29,16,13,26
Mumbai City,2547,2,6,4,4,18,11,7,22
FC Pune City,2547,3,6,3,5,15,15,0,21
Kerala Blast,2547,4,5,4,5,14,17,-3,19
Kolkata,2547,5,3,8,3,15,15,0,17
Chennaiyin,2547,6,4,5,5,15,19,-4,17
FC Goa,2547,7,4,3,7,10,17,-7,15
NorthEast Un,2547,8,4,2,8,11,17,-6,14
Kolkata,2548,1,6,6,2,22,14,8,24
Mumbai City,2548,2,6,5,3,17,9,8,23
Delhi Dynamo,2548,3,4,8,2,24,17,7,20
NorthEast Un,2548,4,5,4,5,13,12,1,19
Chennaiyin,2548,5,4,5,5,15,19,-4,17
Kerala Blast,2548,6,4,5,5,13,18,-5,17
FC Pune City,2548,7,4,4,6,12,16,-4,16
FC Goa,2548,8,3,3,8,10,21,-11,12
Mumbai City,2549,1,7,4,3,18,8,10,25
Delhi Dynamo,2549,2,5,6,3,26,20,6,21
Kolkata,2549,3,5,6,3,16,14,2,21
FC Pune City,2549,4,5,3,6,14,16,-2,18
FC Goa,2549,5,5,3,6,14,18,-4,18
Kerala Blast,2549,5,5,3,6,14,18,-4,18
Chennaiyin,2549,7,4,5,5,16,19,-3,17
NorthEast Un,2549,8,4,2,8,11,16,-5,14
Mumbai City,2550,1,7,4,3,20,10,10,25
Kolkata,2550,2,5,6,3,18,15,3,21
Kerala Blast,2550,3,6,3,5,12,16,-4,21
NorthEast Un,2550,4,5,3,6,11,11,0,18
Chennaiyin,2550,5,4,6,4,15,18,-3,18
Delhi Dynamo,2550,6,4,5,5,24,21,3,17
FC Goa,2550,7,5,2,7,12,17,-5,17
FC Pune City,2550,8,4,3,7,12,16,-4,15
Mumbai City,2551,1,7,4,3,18,9,9,25
FC Pune City,2551,2,6,3,5,19,16,3,21
Delhi Dynamo,2551,3,4,7,3,24,18,6,19
Kerala Blast,2551,4,5,4,5,17,19,-2,19
Kolkata,2551,4,4,7,3,17,19,-2,19
NorthEast Un,2551,6,5,3,6,12,13,-1,18
Chennaiyin,2551,7,4,5,5,15,19,-4,17
FC Goa,2551,8,3,3,8,9,18,-9,12
Delhi Dynamo,2552,1,6,5,3,27,19,8,23
Mumbai City,2552,2,6,4,4,18,11,7,22
Kolkata,2552,3,4,8,2,15,13,2,20
Kerala Blast,2552,4,5,4,5,12,16,-4,19
FC Goa,2552,5,5,3,6,11,14,-3,18
NorthEast Un,2552,6,4,4,6,11,13,-2,16
FC Pune City,2552,7,4,4,6,12,15,-3,16
Chennaiyin,2552,8,3,6,5,13,18,-5,15
Mumbai City,2553,1,6,4,4,16,9,7,22
Delhi Dynamo,2553,2,5,5,4,23,19,4,20
Kolkata,2553,3,4,8,2,15,13,2,20
FC Pune City,2553,4,5,4,5,15,16,-1,19
Kerala Blast,2553,5,5,4,5,13,16,-3,19
NorthEast Un,2553,6,5,3,6,14,13,1,18
FC Goa,2553,7,5,2,7,12,17,-5,17
Chennaiyin,2553,8,3,6,5,15,20,-5,15
Mumbai City,2554,1,6,5,3,18,10,8,23
Delhi Dynamo,2554,2,5,7,2,25,17,8,22
Kerala Blast,2554,3,6,3,5,18,19,-1,21
Kolkata,2554,4,4,7,3,18,17,1,19
Chennaiyin,2554,5,4,6,4,16,18,-2,18
FC Pune City,2554,6,5,3,6,15,19,-4,18
NorthEast Un,2554,7,4,3,7,12,15,-3,15
FC Goa,2554,8,3,4,7,8,15,-7,13
Delhi Dynamo,2555,1,7,5,2,28,16,12,26
Mumbai City,2555,2,6,4,4,17,10,7,22
Kolkata,2555,3,5,7,2,17,13,4,22
Chennaiyin,2555,4,4,6,4,19,21,-2,18
Kerala Blast,2555,5,4,6,4,12,16,-4,18
FC Pune City,2555,6,4,4,6,13,17,-4,16
NorthEast Un,2555,7,4,3,7,13,16,-3,15
FC Goa,2555,8,3,3,8,10,20,-10,12
Mumbai City,2556,1,7,4,3,18,9,9,25
Delhi Dynamo,2556,2,6,5,3,25,16,9,23
Kolkata,2556,3,5,7,2,17,13,4,22
Kerala Blast,2556,4,5,4,5,13,16,-3,19
NorthEast Un,2556,5,5,3,6,12,12,0,18
Chennaiyin,2556,6,3,6,5,15,20,-5,15
FC Pune City,2556,7,4,3,7,13,18,-5,15
FC Goa,2556,8,4,2,8,9,18,-9,14
Mumbai City,2557,1,7,4,3,19,9,10,25
Kolkata,2557,2,5,6,3,18,16,2,21
Kerala Blast,2557,3,6,3,5,14,17,-3,21
Delhi Dynamo,2557,4,5,5,4,25,20,5,20
NorthEast Un,2557,5,6,2,6,14,14,0,20
FC Goa,2557,6,5,2,7,13,17,-4,17
FC Pune City,2557,7,4,3,7,14,18,-4,15
Chennaiyin,2557,8,3,5,6,14,20,-6,14
Mumbai City,2558,1,7,4,3,19,9,10,25
Kolkata,2558,2,6,6,2,18,12,6,24
NorthEast Un,2558,3,7,2,5,16,9,7,23
Kerala Blast,2558,4,5,3,6,11,16,-5,18
Delhi Dynamo,2558,5,4,5,5,23,22,1,17
Chennaiyin,2558,6,4,5,5,15,20,-5,17
FC Pune City,2558,7,4,3,7,12,19,-7,15
FC Goa,2558,8,4,2,8,11,18,-7,14
Mumbai City,2559,1,7,4,3,18,8,10,25
Delhi Dynamo,2559,2,5,6,3,26,18,8,21
Kolkata,2559,3,5,6,3,18,15,3,21
FC Pune City,2559,4,6,3,5,16,16,0,21
Chennaiyin,2559,5,4,5,5,15,20,-5,17
Kerala Blast,2559,6,4,4,6,11,17,-6,16
NorthEast Un,2559,7,4,3,7,11,15,-4,15
FC Goa,2559,8,4,3,7,13,19,-6,15
Delhi Dynamo,2560,1,6,5,3,25,18,7,23
Mumbai City,2560,2,6,4,4,17,10,7,22
NorthEast Un,2560,3,6,2,6,14,11,3,20
Kerala Blast,2560,4,5,4,5,11,16,-5,19
FC Pune City,2560,5,4,5,5,13,15,-2,17
FC Goa,2560,6,5,2,7,12,16,-4,17
Chennaiyin,2560,7,4,5,5,15,20,-5,17
Kolkata,2560,8,3,7,4,13,14,-1,16
Mumbai City,2561,1,7,4,3,19,10,9,25
Kerala Blast,2561,2,6,4,4,13,14,-1,22
FC Goa,2561,3,6,2,6,14,16,-2,20
Kolkata,2561,4,4,7,3,16,13,3,19
Delhi Dynamo,2561,5,4,6,4,26,21,5,18
NorthEast Un,2561,6,5,3,6,13,14,-1,18
FC Pune City,2561,7,4,3,7,12,18,-6,15
Chennaiyin,2561,8,3,5,6,14,21,-7,14
Delhi Dynamo,2562,1,5,7,2,26,18,8,22
Mumbai City,2562,2,6,4,4,17,10,7,22
Kerala Blast,2562,3,5,4,5,13,16,-3,19
Kolkata,2562,4,4,6,4,15,14,1,18
FC Goa,2562,5,5,3,6,14,17,-3,18
FC Pune City,2562,6,5,3,6,14,18,-4,18
Chennaiyin,2562,7,4,5,5,15,20,-5,17
NorthEast Un,2562,8,4,4,6,10,11,-1,16
Mumbai City,2563,1,7,4,3,18,9,9,25
Delhi Dynamo,2563,2,6,5,3,25,16,9,23
Kolkata,2563,3,5,7,2,18,12,6,22
Kerala Blast,2563,4,5,4,5,13,20,-7,19
FC Pune City,2563,5,4,4,6,13,16,-3,16
Chennaiyin,2563,6,3,7,4,15,19,-4,16
NorthEast Un,2563,7,4,3,7,11,14,-3,15
FC Goa,2563,8,3,4,7,10,17,-7,13
Delhi Dynamo,2564,1,6,6,2,27,17,10,24
Mumbai City,2564,2,6,4,4,18,11,7,22
Kerala Blast,2564,3,6,4,4,15,15,0,22
NorthEast Un,2564,4,5,3,6,15,13,2,18
FC Pune City,2564,5,5,3,6,15,18,-3,18
FC Goa,2564,6,5,2,7,11,16,-5,17
Kolkata,2564,7,3,7,4,14,15,-1,16
Chennaiyin,2564,8,3,5,6,13,23,-10,14
Mumbai City,2565,1,7,4,3,20,9,11,25
Kerala Blast,2565,2,7,3,4,15,13,2,24
Delhi Dynamo,2565,3,5,5,4,26,20,6,20
Chennaiyin,2565,4,5,5,4,16,17,-1,20
FC Pune City,2565,5,5,3,6,13,16,-3,18
NorthEast Un,2565,6,5,2,7,11,12,-1,17
Kolkata,2565,7,3,6,5,13,16,-3,15
FC Goa,2565,8,4,2,8,9,20,-11,14
Mumbai City,2566,1,7,4,3,18,8,10,25
FC Pune City,2566,2,6,3,5,16,15,1,21
Delhi Dynamo,2566,3,5,5,4,23,18,5,20
NorthEast Un,2566,4,5,3,6,12,12,0,18
FC Goa,2566,5,5,3,6,15,18,-3,18
Kolkata,2566,6,3,8,3,15,15,0,17
Kerala Blast,2566,7,4,5,5,10,16,-6,17
Chennaiyin,2566,8,3,5,6,16,23,-7,14
Delhi Dynamo,2567,1,6,6,2,27,16,11,24
Mumbai City,2567,2,6,4,4,17,12,5,22
Kerala Blast,2567,3,5,5,4,17,16,1,20
FC Goa,2567,4,5,3,6,10,14,-4,18
FC Pune City,2567,5,5,3,6,15,21,-6,18
Chennaiyin,2567,6,4,5,5,14,18,-4,17
Kolkata,2567,7,3,7,4,17,18,-1,16
NorthEast Un,2567,8,4,3,7,11,13,-2,15
Delhi Dynamo,2568,1,6,6,2,28,19,9,24
Mumbai City,2568,2,6,4,4,18,11,7,22
Kolkata,2568,3,4,7,3,15,14,1,19
Chennaiyin,2568,4,4,6,4,16,19,-3,18
Kerala Blast,2568,5,4,6,4,11,15,-4,18
FC Pune City,2568,6,4,4,6,13,16,-3,16
FC Goa,2568,7,4,4,6,14,19,-5,16
NorthEast Un,2568,8,4,3,7,9,11,-2,15
Mumbai City,2569,1,7,4,3,18,8,10,25
Kerala Blast,2569,2,5,5,4,13,16,-3,20
FC Pune City,2569,3,5,4,5,16,16,0,19
Delhi Dynamo,2569,4,4,6,4,21,17,4,18
Kolkata,2569,5,4,6,4,16,16,0,18
NorthEast Un,2569,6,5,3,6,12,12,0,18
Chennaiyin,2569,7,4,5,5,14,18,-4,17
FC Goa,2569,8,4,3,7,9,16,-7,15
Mumbai City,2570,1,7,4,3,17,8,9,25
Kolkata,2570,2,4,8,2,15,13,2,20
Delhi Dynamo,2570,3,4,6,4,21,16,5,18
Kerala Blast,2570,4,4,6,4,11,15,-4,18
FC Goa,2570,5,5,3,6,10,14,-4,18
NorthEast Un,2570,6,4,5,5,10,10,0,17
FC Pune City,2570,7,4,4,6,15,18,-3,16
Chennaiyin,2570,8,3,6,5,14,19,-5,15
Delhi Dynamo,2571,1,6,6,2,26,16,10,24
Kolkata,2571,2,6,6,2,23,13,10,24
Mumbai City,2571,3,6,4,4,17,10,7,22
NorthEast Un,2571,4,5,4,5,15,14,1,19
Kerala Blast,2571,5,5,4,5,15,21,-6,19
Chennaiyin,2571,6,3,6,5,16,21,-5,15
FC Pune City,2571,7,4,3,7,14,21,-7,15
FC Goa,2571,8,3,3,8,11,21,-10,12
Mumbai City,2572,1,6,5,3,17,9,8,23
Kolkata,2572,2,4,8,2,20,17,3,20
FC Pune City,2572,3,5,4,5,16,16,0,19
Delhi Dynamo,2572,4,4,6,4,25,20,5,18
NorthEast Un,2572,5,5,3,6,13,15,-2,18
FC Goa,2572,6,5,3,6,15,19,-4,18
Kerala Blast,2572,7,5,3,6,12,17,-5,18
Chennaiyin,2572,8,3,6,5,15,20,-5,15
Mumbai City,2573,1,7,4,3,18,8,10,25
Delhi Dynamo,2573,2,6,5,3,27,19,8,23
Kolkata,2573,3,5,7,2,17,13,4,22
Kerala Blast,2573,4,5,5,4,11,14,-3,20
Chennaiyin,2573,5,4,6,4,16,18,-2,18
NorthEast Un,2573,6,4,4,6,11,13,-2,16
FC Pune City,2573,7,4,3,7,13,18,-5,15
FC Goa,2573,8,3,2,9,11,21,-10,11
Mumbai City,2574,1,7,4,3,18,8,10,25
Kolkata,2574,2,5,6,3,17,17,0,21
Kerala Blast,2574,3,5,4,5,12,16,-4,19
NorthEast Un,2574,4,5,3,6,13,12,1,18
FC Goa,2574,5,5,3,6,14,16,-2,18
Chennaiyin,2574,6,4,6,4,15,18,-3,18
Delhi Dynamo,2574,7,4,5,5,22,20,2,17
FC Pune City,2574,8,4,3,7,12,16,-4,15
Kolkata,2575,1,6,6,2,22,14,8,24
Mumbai City,2575,2,6,5,3,18,10,8,23
Delhi Dynamo,2575,3,4,7,3,26,21,5,19
NorthEast Un,2575,4,5,3,6,13,12,1,18
FC Pune City,2575,5,5,3,6,13,17,-4,18
Chennaiyin,2575,6,4,5,5,14,18,-4,17
Kerala Blast,2575,7,4,4,6,10,16,-6,16
FC Goa,2575,8,4,3,7,11,19,-8,15
Mumbai City,2576,1,7,4,3,17,8,9,25
Delhi Dynamo,2576,2,6,5,3,26,16,10,23
Kolkata,2576,3,4,7,3,18,15,3,19
Chennaiyin,2576,4,4,6,4,18,20,-2,18
FC Pune City,2576,5,5,3,6,14,17,-3,18
Kerala Blast,2576,6,5,3,6,11,17,-6,18
NorthEast Un,2576,7,5,2,7,12,14,-2,17
FC Goa,2576,8,3,4,7,11,20,-9,13
Mumbai City,2577,1,7,4,3,17,8,9,25
Delhi Dynamo,2577,2,5,6,3,24,16,8,21
FC Pune City,2577,3,6,3,5,15,15,0,21
Kolkata,2577,4,4,7,3,14,13,1,19
NorthEast Un,2577,5,5,3,6,10,11,-1,18
Chennaiyin,2577,6,4,6,4,14,17,-3,18
Kerala Blast,2577,7,4,4,6,10,16,-6,16
FC Goa,2577,8,3,3,8,9,17,-8,12
Mumbai City,2578,1,7,4,3,17,8,9,25
Delhi Dynamo,2578,2,5,5,4,24,18,6,20
FC Pune City,2578,3,5,4,5,16,16,0,19
NorthEast Un,2578,4,5,3,6,12,11,1,18
Chennaiyin,2578,5,4,6,4,18,21,-3,18
Kolkata,2578,6,3,8,3,16,17,-1,17
Kerala Blast,2578,7,4,5,5,9,15,-6,17
FC Goa,2578,8,4,3,7,15,21,-6,15
Mumbai City,2579,1,7,4,3,18,8,10,25
Delhi Dynamo,2579,2,5,5,4,24,19,5,20
NorthEast Un,2579,3,6,2,6,15,14,1,20
Kolkata,2579,4,3,8,3,13,13,0,17
FC Pune City,2579,5,4,5,5,12,14,-2,17
Chennaiyin,2579,6,4,5,5,16,20,-4,17
FC Goa,2579,7,5,2,7,12,17,-5,17
Kerala Blast,2579,8,4,5,5,11,16,-5,17
Mumbai City,2580,1,6,5,3,19,11,8,23
NorthEast Un,2580,2,7,2,5,16,10,6,23
Kolkata,2580,3,4,8,2,15,13,2,20
Delhi Dynamo,2580,4,4,7,3,24,20,4,19
FC Pune City,2580,5,5,3,6,14,16,-2,18
Kerala Blast,2580,6,4,4,6,11,17,-6,16
Chennaiyin,2580,7,3,6,5,14,20,-6,15
FC Goa,2580,8,3,5,6,10,16,-6,14
Mumbai City,2581,1,7,4,3,17,8,9,25
Kolkata,2581,2,5,6,3,17,14,3,21
NorthEast Un,2581,3,6,3,5,16,13,3,21
Kerala Blast,2581,4,5,4,5,13,16,-3,19
FC Pune City,2581,5,5,3,6,14,17,-3,18
Delhi Dynamo,2581,6,4,5,5,23,20,3,17
Chennaiyin,2581,7,4,5,5,16,20,-4,17
FC Goa,2581,8,4,2,8,11,19,-8,14
Delhi Dynamo,2582,1,6,5,3,25,18,7,23
Mumbai City,2582,2,6,4,4,16,9,7,22
Kerala Blast,2582,3,6,4,4,15,14,1,22
NorthEast Un,2582,4,6,2,6,13,13,0,20
FC Pune City,2582,5,5,4,5,15,16,-1,19
Chennaiyin,2582,6,4,5,5,17,19,-2,17
Kolkata,2582,7,3,7,4,15,17,-2,16
FC Goa,2582,8,3,3,8,11,21,-10,12
Delhi Dynamo,2583,1,6,6,2,29,18,11,24
Mumbai City,2583,2,6,4,4,19,12,7,22
NorthEast Un,2583,3,5,4,5,12,11,1,19
FC Pune City,2583,4,5,4,5,15,15,0,19
Chennaiyin,2583,5,4,6,4,16,19,-3,18
Kolkata,2583,6,3,8,3,13,13,0,17
Kerala Blast,2583,7,4,4,6,10,17,-7,16
FC Goa,2583,8,4,2,8,10,19,-9,14
Delhi Dynamo,2584,1,6,6,2,27,17,10,24
Mumbai City,2584,2,6,4,4,16,10,6,22
Kerala Blast,2584,3,6,3,5,14,16,-2,21
Chennaiyin,2584,4,5,5,4,16,18,-2,20
Kolkata,2584,5,4,7,3,17,16,1,19
FC Pune City,2584,6,5,3,6,14,16,-2,18
NorthEast Un,2584,7,4,3,7,10,13,-3,15
FC Goa,2584,8,3,3,8,11,19,-8,12
Kolkata,2585,1,6,6,2,19,14,5,24
Mumbai City,2585,2,6,4,4,16,9,7,22
Delhi Dynamo,2585,3,5,6,3,23,16,7,21
NorthEast Un,2585,4,5,4,5,12,11,1,19
Kerala Blast,2585,5,5,4,5,13,17,-4,19
Chennaiyin,2585,6,3,7,4,15,19,-4,16
FC Pune City,2585,7,4,3,7,13,18,-5,15
FC Goa,2585,8,3,4,7,10,17,-7,13
Mumbai City,2586,1,7,4,3,18,9,9,25
Delhi Dynamo,2586,2,5,6,3,25,18,7,21
FC Pune City,2586,3,5,4,5,15,15,0,19
Kolkata,2586,4,3,9,2,17,16,1,18
Kerala Blast,2586,5,4,5,5,13,19,-6,17
NorthEast Un,2586,6,4,4,6,13,14,-1,16
FC Goa,2586,7,4,4,6,12,17,-5,16
Chennaiyin,2586,8,3,6,5,15,20,-5,15
Mumbai City,2587,1,7,4,3,19,8,11,25
Kolkata,2587,2,5,6,3,21,15,6,21
Kerala Blast,2587,3,6,3,5,13,19,-6,21
Chennaiyin,2587,4,5,5,4,18,17,1,20
Delhi Dynamo,2587,5,4,5,5,21,22,-1,17
FC Goa,2587,6,5,2,7,12,15,-3,17
NorthEast Un,2587,7,5,2,7,11,14,-3,17
FC Pune City,2587,8,4,3,7,13,18,-5,15
Delhi Dynamo,2588,1,6,5,3,26,18,8,23
Mumbai City,2588,2,6,4,4,16,9,7,22
Kolkata,2588,3,5,6,3,20,16,4,21
Chennaiyin,2588,4,5,5,4,18,19,-1,20
Kerala Blast,2588,5,5,5,4,13,16,-3,20
NorthEast Un,2588,6,5,3,6,13,14,-1,18
FC Pune City,2588,7,4,4,6,13,17,-4,16
FC Goa,2588,8,3,2,9,11,21,-10,11
Delhi Dynamo,2589,1,6,6,2,24,14,10,24
Mumbai City,2589,2,6,5,3,16,8,8,23
Kerala Blast,2589,3,5,4,5,12,16,-4,19
NorthEast Un,2589,4,5,3,6,11,12,-1,18
FC Pune City,2589,5,5,3,6,14,16,-2,18
Kolkata,2589,6,3,8,3,15,15,0,17
Chennaiyin,2589,7,3,6,5,15,20,-5,15
FC Goa,2589,8,4,3,7,11,17,-6,15
Mumbai City,2590,1,7,4,3,20,11,9,25
Kolkata,2590,2,5,6,3,17,13,4,21
Kerala Blast,2590,3,6,3,5,13,17,-4,21
Chennaiyin,2590,4,5,5,4,18,19,-1,20
Delhi Dynamo,2590,5,4,6,4,27,22,5,18
FC Pune City,2590,6,5,3,6,13,16,-3,18
NorthEast Un,2590,7,5,2,7,15,17,-2,17
FC Goa,2590,8,3,3,8,9,17,-8,12
Mumbai City,2591,1,7,4,3,19,8,11,25
Kolkata,2591,2,5,6,3,17,13,4,21
Delhi Dynamo,2591,3,5,5,4,24,20,4,20
NorthEast Un,2591,4,5,4,5,13,11,2,19
Kerala Blast,2591,5,5,4,5,11,15,-4,19
Chennaiyin,2591,6,4,6,4,15,18,-3,18
FC Pune City,2591,7,5,3,6,13,16,-3,18
FC Goa,2591,8,3,2,9,9,20,-11,11
Delhi Dynamo,2592,1,6,6,2,25,15,10,24
Mumbai City,2592,2,6,5,3,17,9,8,23
Kolkata,2592,3,5,6,3,17,13,4,21
Kerala Blast,2592,4,6,3,5,12,15,-3,21
Chennaiyin,2592,5,4,6,4,16,19,-3,18
NorthEast Un,2592,6,5,2,7,11,12,-1,17
FC Pune City,2592,7,4,3,7,12,18,-6,15
FC Goa,2592,8,3,3,8,10,19,-9,12
Mumbai City,2593,1,7,4,3,20,8,12,25
Kolkata,2593,2,5,7,2,24,18,6,22
Delhi Dynamo,2593,3,5,6,3,25,21,4,21
NorthEast Un,2593,4,6,2,6,13,12,1,20
Kerala Blast,2593,5,5,3,6,13,20,-7,18
FC Pune City,2593,6,4,4,6,13,17,-4,16
Chennaiyin,2593,7,3,6,5,14,19,-5,15
FC Goa,2593,8,3,4,7,13,20,-7,13
Mumbai City,2594,1,7,4,3,22,10,12,25
Delhi Dynamo,2594,2,6,5,3,26,20,6,23
Kolkata,2594,3,4,8,2,14,12,2,20
Kerala Blast,2594,4,5,4,5,10,14,-4,19
NorthEast Un,2594,5,5,3,6,11,11,0,18
Chennaiyin,2594,6,4,5,5,15,19,-4,17
FC Pune City,2594,7,4,4,6,12,15,-3,16
FC Goa,2594,8,3,3,8,8,17,-9,12
Mumbai City,2595,1,7,4,3,18,8,10,25
Kolkata,2595,2,6,6,2,18,12,6,24
Delhi Dynamo,2595,3,6,5,3,26,19,7,23
Chennaiyin,2595,4,5,5,4,20,20,0,20
FC Pune City,2595,5,5,3,6,13,16,-3,18
NorthEast Un,2595,6,5,2,7,15,16,-1,17
Kerala Blast,2595,7,4,3,7,11,19,-8,15
FC Goa,2595,8,3,2,9,11,22,-11,11
Mumbai City,2596,1,7,4,3,18,9,9,25
Kerala Blast,2596,2,6,4,4,14,14,0,22
FC Goa,2596,3,6,2,6,14,16,-2,20
Delhi Dynamo,2596,4,4,6,4,24,19,5,18
FC Pune City,2596,5,5,3,6,14,17,-3,18
Kolkata,2596,6,3,7,4,15,16,-1,16
NorthEast Un,2596,7,4,4,6,12,14,-2,16
Chennaiyin,2596,8,3,6,5,16,22,-6,15
Mumbai City,2597,1,6,5,3,17,9,8,23
FC Goa,2597,2,6,2,6,13,15,-2,20
Kerala Blast,2597,3,5,5,4,13,16,-3,20
Delhi Dynamo,2597,4,4,7,3,25,19,6,19
NorthEast Un,2597,5,4,5,5,15,15,0,17
Kolkata,2597,6,3,8,3,14,15,-1,17
FC Pune City,2597,7,4,4,6,12,15,-3,16
Chennaiyin,2597,8,3,6,5,15,20,-5,15
Mumbai City,2598,1,7,4,3,17,8,9,25
Kolkata,2598,2,5,6,3,20,14,6,21
NorthEast Un,2598,3,6,3,5,14,10,4,21
FC Pune City,2598,4,5,4,5,13,14,-1,19
Delhi Dynamo,2598,5,4,5,5,23,22,1,17
Kerala Blast,2598,6,4,5,5,9,18,-9,17
Chennaiyin,2598,7,3,6,5,14,19,-5,15
FC Goa,2598,8,4,3,7,13,18,-5,15
Mumbai City,2599,1,7,4,3,19,10,9,25
Kolkata,2599,2,5,6,3,19,14,5,21
NorthEast Un,2599,3,6,2,6,14,12,2,20
Kerala Blast,2599,4,5,4,5,12,16,-4,19
Delhi Dynamo,2599,5,4,6,4,25,21,4,18
Chennaiyin,2599,6,4,5,5,15,19,-4,17
FC Pune City,2599,7,4,4,6,15,19,-4,16
FC Goa,2599,8,4,3,7,10,18,-8,15
Kolkata,2600,1,6,6,2,21,15,6,24
Mumbai City,2600,2,6,5,3,17,9,8,23
NorthEast Un,2600,3,7,2,5,13,9,4,23
Delhi Dynamo,2600,4,4,6,4,22,19,3,18
FC Pune City,2600,5,5,3,6,14,18,-4,18
Chennaiyin,2600,6,4,5,5,15,20,-5,17
Kerala Blast,2600,7,4,3,7,11,18,-7,15
FC Goa,2600,8,4,2,8,12,17,-5,14
Delhi Dynamo,2601,1,6,6,2,29,20,9,24
Mumbai City,2601,2,6,5,3,17,9,8,23
Kolkata,2601,3,5,7,2,19,15,4,22
Kerala Blast,2601,4,4,6,4,13,17,-4,18
Chennaiyin,2601,5,4,5,5,17,20,-3,17
FC Pune City,2601,6,4,4,6,14,18,-4,16
NorthEast Un,2601,7,4,3,7,13,16,-3,15
FC Goa,2601,8,4,2,8,13,20,-7,14
Delhi Dynamo,2602,1,7,5,2,27,16,11,26
Mumbai City,2602,2,6,4,4,16,9,7,22
Kerala Blast,2602,3,6,4,4,12,14,-2,22
Kolkata,2602,4,5,6,3,18,14,4,21
Chennaiyin,2602,5,4,5,5,16,19,-3,17
NorthEast Un,2602,6,4,3,7,12,15,-3,15
FC Pune City,2602,7,4,3,7,12,18,-6,15
FC Goa,2602,8,4,2,8,11,19,-8,14
Delhi Dynamo,2603,1,7,5,2,30,18,12,26
Mumbai City,2603,2,6,4,4,18,11,7,22
Kolkata,2603,3,5,7,2,15,12,3,22
NorthEast Un,2603,4,6,2,6,15,14,1,20
Kerala Blast,2603,5,5,4,5,11,15,-4,19
FC Pune City,2603,6,4,3,7,12,16,-4,15
Chennaiyin,2603,7,3,6,5,16,21,-5,15
FC Goa,2603,8,3,3,8,10,20,-10,12
NorthEast Un,2604,1,7,2,5,13,10,3,23
Mumbai City,2604,2,6,4,4,16,9,7,22
Delhi Dynamo,2604,3,5,6,3,25,18,7,21
Kolkata,2604,4,4,8,2,19,15,4,20
FC Pune City,2604,5,5,3,6,15,19,-4,18
Chennaiyin,2604,6,4,5,5,15,19,-4,17
Kerala Blast,2604,7,4,4,6,11,17,-6,16
FC Goa,2604,8,3,4,7,12,19,-7,13
Delhi Dynamo,2605,1,6,5,3,24,15,9,23
Mumbai City,2605,2,6,4,4,16,10,6,22
Kolkata,2605,3,5,7,2,17,14,3,22
NorthEast Un,2605,4,6,3,5,15,11,4,21
FC Pune City,2605,5,5,3,6,15,16,-1,18
Chennaiyin,2605,6,3,7,4,15,19,-4,16
Kerala Blast,2605,7,4,3,7,9,19,-10,15
FC Goa,2605,8,3,4,7,9,16,-7,13
Mumbai City,2606,1,7,4,3,18,8,10,25
NorthEast Un,2606,2,6,3,5,15,9,6,21
FC Pune City,2606,3,6,3,5,18,17,1,21
Delhi Dynamo,2606,4,5,5,4,22,19,3,20
Kolkata,2606,5,4,6,4,19,18,1,18
FC Goa,2606,6,5,2,7,12,17,-5,17
Chennaiyin,2606,7,3,6,5,14,19,-5,15
Kerala Blast,2606,8,4,3,7,11,22,-11,15
Mumbai City,2607,1,6,5,3,16,8,8,23
Delhi Dynamo,2607,2,5,7,2,25,16,9,22
Kolkata,2607,3,5,6,3,17,15,2,21
Chennaiyin,2607,4,5,5,4,19,18,1,20
NorthEast Un,2607,5,5,3,6,14,13,1,18
FC Pune City,2607,6,4,4,6,14,17,-3,16
Kerala Blast,2607,7,4,4,6,13,21,-8,16
FC Goa,2607,8,4,2,8,11,21,-10,14
Delhi Dynamo,2608,1,6,6,2,29,19,10,24
Mumbai City,2608,2,6,5,3,17,9,8,23
Kolkata,2608,3,4,7,3,15,13,2,19
FC Pune City,2608,4,5,4,5,14,15,-1,19
Kerala Blast,2608,5,5,3,6,11,17,-6,18
FC Goa,2608,6,5,2,7,13,18,-5,17
NorthEast Un,2608,7,4,3,7,14,16,-2,15
Chennaiyin,2608,8,3,6,5,16,22,-6,15
Delhi Dynamo,2609,1,6,6,2,27,17,10,24
Mumbai City,2609,2,6,5,3,18,10,8,23
Kerala Blast,2609,3,6,3,5,13,16,-3,21
Kolkata,2609,4,4,8,2,17,14,3,20
Chennaiyin,2609,5,4,5,5,16,21,-5,17
FC Pune City,2609,6,4,4,6,13,16,-3,16
FC Goa,2609,7,4,3,7,13,16,-3,15
NorthEast Un,2609,8,4,2,8,11,18,-7,14
Delhi Dynamo,2610,1,6,6,2,26,14,12,24
Mumbai City,2610,2,6,5,3,16,8,8,23
Kerala Blast,2610,3,6,4,4,13,14,-1,22
Kolkata,2610,4,4,6,4,17,16,1,18
FC Goa,2610,5,5,2,7,11,18,-7,17
NorthEast Un,2610,6,4,4,6,12,14,-2,16
Chennaiyin,2610,7,3,6,5,15,20,-5,15
FC Pune City,2610,8,4,3,7,13,19,-6,15
Mumbai City,2611,1,7,4,3,18,9,9,25
Kolkata,2611,2,5,7,2,18,14,4,22
NorthEast Un,2611,3,5,4,5,12,9,3,19
Chennaiyin,2611,4,4,6,4,18,20,-2,18
Delhi Dynamo,2611,5,4,5,5,22,20,2,17
FC Pune City,2611,6,4,5,5,15,17,-2,17
Kerala Blast,2611,7,4,5,5,10,16,-6,17
FC Goa,2611,8,4,2,8,12,20,-8,14
Mumbai City,2612,1,6,5,3,18,10,8,23
Kerala Blast,2612,2,6,4,4,13,14,-1,22
Delhi Dynamo,2612,3,4,8,2,28,21,7,20
Kolkata,2612,4,4,6,4,16,16,0,18
Chennaiyin,2612,5,4,6,4,16,17,-1,18
NorthEast Un,2612,6,4,4,6,12,14,-2,16
FC Pune City,2612,7,4,4,6,13,16,-3,16
FC Goa,2612,8,4,3,7,13,21,-8,15
Mumbai City,2613,1,6,5,3,16,8,8,23
Delhi Dynamo,2613,2,5,7,2,23,14,9,22
Kolkata,2613,3,5,6,3,16,13,3,21
Kerala Blast,2613,4,6,3,5,12,15,-3,21
NorthEast Un,2613,5,5,3,6,11,11,0,18
FC Pune City,2613,6,5,3,6,13,16,-3,18
Chennaiyin,2613,7,3,6,5,13,18,-5,15
FC Goa,2613,8,3,3,8,8,17,-9,12
Mumbai City,2614,1,7,4,3,18,8,10,25
Delhi Dynamo,2614,2,6,5,3,26,17,9,23
FC Pune City,2614,3,5,4,5,16,16,0,19
Kerala Blast,2614,4,5,4,5,12,16,-4,19
NorthEast Un,2614,5,5,3,6,12,12,0,18
Kolkata,2614,6,4,6,4,17,18,-1,18
Chennaiyin,2614,7,3,6,5,13,19,-6,15
FC Goa,2614,8,4,2,8,12,20,-8,14
Mumbai City,2615,1,7,4,3,19,8,11,25
Kerala Blast,2615,2,6,3,5,14,18,-4,21
Delhi Dynamo,2615,3,5,5,4,23,20,3,20
FC Goa,2615,4,6,2,6,15,15,0,20
NorthEast Un,2615,5,5,3,6,14,12,2,18
FC Pune City,2615,6,5,3,6,15,16,-1,18
Chennaiyin,2615,7,3,6,5,14,19,-5,15
Kolkata,2615,8,3,6,5,13,19,-6,15
Mumbai City,2616,1,7,4,3,17,8,9,25
Kerala Blast,2616,2,6,4,4,13,15,-2,22
Chennaiyin,2616,3,5,5,4,18,18,0,20
Delhi Dynamo,2616,4,4,7,3,24,18,6,19
Kolkata,2616,5,4,7,3,16,15,1,19
NorthEast Un,2616,6,4,4,6,11,13,-2,16
FC Pune City,2616,7,4,4,6,13,16,-3,16
FC Goa,2616,8,3,3,8,13,22,-9,12
Mumbai City,2617,1,6,5,3,17,9,8,23
Delhi Dynamo,2617,2,5,6,3,23,16,7,21
FC Pune City,2617,3,6,3,5,18,15,3,21
Kolkata,2617,4,5,6,3,18,16,2,21
Kerala Blast,2617,5,5,3,6,12,18,-6,18
NorthEast Un,2617,6,5,2,7,12,13,-1,17
Chennaiyin,2617,7,4,5,5,15,20,-5,17
FC Goa,2617,8,4,2,8,9,17,-8,14
Delhi Dynamo,2618,1,6,6,2,28,18,10,24
Mumbai City,2618,2,6,4,4,18,12,6,22
Kerala Blast,2618,3,6,3,5,13,15,-2,21
Kolkata,2618,4,4,7,3,16,15,1,19
FC Pune City,2618,5,5,4,5,15,16,-1,19
Chennaiyin,2618,6,4,5,5,16,20,-4,17
FC Goa,2618,7,4,3,7,11,18,-7,15
NorthEast Un,2618,8,4,2,8,11,14,-3,14
Mumbai City,2619,1,7,4,3,18,9,9,25
Kolkata,2619,2,5,7,2,22,16,6,22
Kerala Blast,2619,3,6,3,5,13,16,-3,21
Delhi Dynamo,2619,4,4,6,4,22,17,5,18
NorthEast Un,2619,5,5,2,7,11,12,-1,17
Chennaiyin,2619,6,4,5,5,17,22,-5,17
FC Goa,2619,7,4,4,6,12,16,-4,16
FC Pune City,2619,8,4,3,7,14,21,-7,15
Mumbai City,2620,1,7,4,3,17,8,9,25
Delhi Dynamo,2620,2,4,6,4,23,19,4,18
Kolkata,2620,3,3,9,2,15,14,1,18
NorthEast Un,2620,4,5,3,6,12,11,1,18
Kerala Blast,2620,5,4,6,4,11,15,-4,18
FC Pune City,2620,6,4,5,5,14,16,-2,17
Chennaiyin,2620,7,4,5,5,15,19,-4,17
FC Goa,2620,8,4,4,6,13,18,-5,16
Mumbai City,2621,1,6,4,4,18,11,7,22
Delhi Dynamo,2621,2,5,6,3,27,21,6,21
FC Pune City,2621,3,6,3,5,16,14,2,21
Kerala Blast,2621,4,5,4,5,11,15,-4,19
Chennaiyin,2621,5,4,6,4,15,18,-3,18
Kolkata,2621,6,3,8,3,14,15,-1,17
NorthEast Un,2621,7,4,4,6,11,13,-2,16
FC Goa,2621,8,4,3,7,13,18,-5,15
Mumbai City,2622,1,7,4,3,17,8,9,25
Kerala Blast,2622,2,7,3,4,14,14,0,24
Delhi Dynamo,2622,3,5,6,3,24,16,8,21
Kolkata,2622,4,5,6,3,17,14,3,21
NorthEast Un,2622,5,4,4,6,12,13,-1,16
Chennaiyin,2622,6,3,6,5,16,21,-5,15
FC Pune City,2622,7,4,3,7,12,17,-5,15
FC Goa,2622,8,4,2,8,10,19,-9,14
Mumbai City,2623,1,7,4,3,17,8,9,25
Kolkata,2623,2,5,7,2,17,14,3,22
Delhi Dynamo,2623,3,5,6,3,24,16,8,21
Chennaiyin,2623,4,5,5,4,19,20,-1,20
Kerala Blast,2623,5,5,4,5,10,14,-4,19
FC Pune City,2623,6,4,4,6,13,16,-3,16
NorthEast Un,2623,7,4,3,7,13,15,-2,15
FC Goa,2623,8,3,3,8,9,19,-10,12
Delhi Dynamo,2624,1,6,5,3,27,18,9,23
NorthEast Un,2624,2,7,2,5,14,10,4,23
Mumbai City,2624,3,6,4,4,18,11,7,22
Kerala Blast,2624,4,5,4,5,13,17,-4,19
Kolkata,2624,5,3,8,3,18,18,0,17
FC Pune City,2624,6,4,5,5,14,16,-2,17
FC Goa,2624,7,4,3,7,11,19,-8,15
Chennaiyin,2624,8,3,5,6,14,20,-6,14
Mumbai City,2625,1,7,4,3,17,8,9,25
Delhi Dynamo,2625,2,5,5,4,25,17,8,20
Kolkata,2625,3,4,8,2,19,16,3,20
NorthEast Un,2625,4,5,4,5,14,13,1,19
Chennaiyin,2625,5,4,6,4,18,21,-3,18
Kerala Blast,2625,6,4,6,4,11,15,-4,18
FC Pune City,2625,7,4,5,5,14,16,-2,17
FC Goa,2625,8,3,2,9,11,23,-12,11
Mumbai City,2626,1,6,5,3,17,9,8,23
Delhi Dynamo,2626,2,5,6,3,26,19,7,21
Kerala Blast,2626,3,5,5,4,16,18,-2,20
FC Goa,2626,4,5,3,6,15,17,-2,18
Kolkata,2626,5,4,6,4,16,19,-3,18
Chennaiyin,2626,6,4,6,4,14,17,-3,18
FC Pune City,2626,7,4,4,6,14,17,-3,16
NorthEast Un,2626,8,4,3,7,12,14,-2,15
Delhi Dynamo,2627,1,6,5,3,26,17,9,23
NorthEast Un,2627,2,7,2,5,16,11,5,23
Mumbai City,2627,3,6,4,4,16,9,7,22
Kolkata,2627,4,4,8,2,15,13,2,20
Kerala Blast,2627,5,4,5,5,12,17,-5,17
FC Pune City,2627,6,4,4,6,13,16,-3,16
FC Goa,2627,7,4,3,7,11,17,-6,15
Chennaiyin,2627,8,3,5,6,13,22,-9,14
Mumbai City,2628,1,7,4,3,18,8,10,25
Kerala Blast,2628,2,6,3,5,12,17,-5,21
Delhi Dynamo,2628,3,5,5,4,22,17,5,20
Chennaiyin,2628,4,5,5,4,19,18,1,20
Kolkata,2628,5,4,7,3,18,14,4,19
FC Pune City,2628,6,5,3,6,13,16,-3,18
NorthEast Un,2628,7,5,2,7,10,14,-4,17
FC Goa,2628,8,3,3,8,10,18,-8,12
Mumbai City,2629,1,6,5,3,17,9,8,23
Delhi Dynamo,2629,2,5,7,2,25,16,9,22
Kolkata,2629,3,5,6,3,20,18,2,21
Chennaiyin,2629,4,5,5,4,16,18,-2,20
Kerala Blast,2629,5,5,4,5,15,20,-5,19
NorthEast Un,2629,6,5,2,7,12,13,-1,17
FC Pune City,2629,7,4,4,6,14,17,-3,16
FC Goa,2629,8,3,3,8,11,19,-8,12
Mumbai City,2630,1,7,4,3,18,8,10,25
Delhi Dynamo,2630,2,5,5,4,23,18,5,20
Kolkata,2630,3,4,7,3,15,15,0,19
Kerala Blast,2630,4,5,4,5,12,16,-4,19
NorthEast Un,2630,5,5,3,6,11,11,0,18
Chennaiyin,2630,6,4,6,4,16,19,-3,18
FC Pune City,2630,7,4,4,6,13,17,-4,16
FC Goa,2630,8,4,3,7,13,17,-4,15
Delhi Dynamo,2631,1,7,5,2,25,14,11,26
Mumbai City,2631,2,6,4,4,16,9,7,22
Kerala Blast,2631,3,6,3,5,11,14,-3,21
NorthEast Un,2631,4,6,2,6,12,10,2,20
Kolkata,2631,5,4,7,3,18,15,3,19
FC Pune City,2631,6,4,4,6,14,17,-3,16
Chennaiyin,2631,7,3,5,6,14,22,-8,14
FC Goa,2631,8,4,2,8,11,20,-9,14
Kolkata,2632,1,6,6,2,17,13,4,24
Mumbai City,2632,2,6,5,3,16,8,8,23
Chennaiyin,2632,3,5,5,4,17,18,-1,20
Delhi Dynamo,2632,4,4,7,3,22,17,5,19
Kerala Blast,2632,5,5,4,5,13,14,-1,19
NorthEast Un,2632,6,5,2,7,11,15,-4,17
FC Pune City,2632,7,4,4,6,12,15,-3,16
FC Goa,2632,8,3,3,8,11,19,-8,12
Mumbai City,2633,1,7,4,3,18,9,9,25
Delhi Dynamo,2633,2,6,5,3,26,17,9,23
Kolkata,2633,3,5,6,3,19,17,2,21
Kerala Blast,2633,4,5,4,5,11,14,-3,19
FC Goa,2633,5,5,2,7,12,17,-5,17
NorthEast Un,2633,6,4,4,6,9,11,-2,16
FC Pune City,2633,7,4,3,7,15,20,-5,15
Chennaiyin,2633,8,3,6,5,13,18,-5,15
Mumbai City,2634,1,6,5,3,16,8,8,23
Kolkata,2634,2,5,7,2,17,13,4,22
Delhi Dynamo,2634,3,5,6,3,24,16,8,21
NorthEast Un,2634,4,6,3,5,15,12,3,21
FC Pune City,2634,5,4,5,5,15,17,-2,17
Kerala Blast,2634,6,4,5,5,13,18,-5,17
Chennaiyin,2634,7,3,5,6,14,21,-7,14
FC Goa,2634,8,4,2,8,10,19,-9,14
Delhi Dynamo,2635,1,6,6,2,26,16,10,24
Mumbai City,2635,2,6,4,4,16,10,6,22
Kerala Blast,2635,3,6,3,5,11,14,-3,21
NorthEast Un,2635,4,5,4,5,13,12,1,19
FC Pune City,2635,5,5,3,6,14,16,-2,18
Chennaiyin,2635,6,4,6,4,17,20,-3,18
Kolkata,2635,7,3,7,4,14,15,-1,16
FC Goa,2635,8,3,3,8,10,18,-8,12
Kolkata,2636,1,6,6,2,16,12,4,24
Mumbai City,2636,2,6,5,3,17,9,8,23
Kerala Blast,2636,3,6,3,5,13,15,-2,21
NorthEast Un,2636,4,6,2,6,15,13,2,20
Delhi Dynamo,2636,5,4,6,4,23,20,3,18
FC Goa,2636,6,5,2,7,13,16,-3,17
FC Pune City,2636,7,4,3,7,13,17,-4,15
Chennaiyin,2636,8,3,5,6,15,23,-8,14
Mumbai City,2637,1,7,4,3,17,8,9,25
Kolkata,2637,2,5,7,2,19,15,4,22
Kerala Blast,2637,3,6,4,4,16,16,0,22
Delhi Dynamo,2637,4,5,6,3,25,17,8,21
Chennaiyin,2637,5,4,6,4,16,19,-3,18
NorthEast Un,2637,6,4,3,7,11,14,-3,15
FC Pune City,2637,7,4,3,7,14,20,-6,15
FC Goa,2637,8,3,3,8,10,19,-9,12
Mumbai City,2638,1,7,4,3,18,9,9,25
Kolkata,2638,2,5,7,2,18,13,5,22
NorthEast Un,2638,3,6,2,6,14,15,-1,20
FC Pune City,2638,4,5,4,5,15,16,-1,19
Delhi Dynamo,2638,5,4,6,4,23,18,5,18
Chennaiyin,2638,6,4,5,5,18,19,-1,17
FC Goa,2638,7,4,3,7,9,15,-6,15
Kerala Blast,2638,8,4,3,7,10,20,-10,15
Mumbai City,2639,1,7,4,3,19,9,10,25
Delhi Dynamo,2639,2,5,6,3,29,20,9,21
Kolkata,2639,3,5,6,3,19,17,2,21
Chennaiyin,2639,4,4,6,4,16,19,-3,18
FC Pune City,2639,5,5,3,6,15,18,-3,18
Kerala Blast,2639,6,5,3,6,14,17,-3,18
NorthEast Un,2639,7,5,3,6,12,15,-3,18
FC Goa,2639,8,3,3,8,11,20,-9,12
Delhi Dynamo,2640,1,6,6,2,26,16,10,24
Mumbai City,2640,2,6,5,3,17,9,8,23
FC Pune City,2640,3,6,3,5,15,14,1,21
Kolkata,2640,4,4,7,3,16,15,1,19
Chennaiyin,2640,5,4,5,5,14,20,-6,17
Kerala Blast,2640,6,4,5,5,12,18,-6,17
NorthEast Un,2640,7,4,3,7,10,12,-2,15
FC Goa,2640,8,4,2,8,12,18,-6,14
Mumbai City,2641,1,6,4,4,16,9,7,22
Delhi Dynamo,2641,2,5,6,3,24,18,6,21
Kolkata,2641,3,4,8,2,15,12,3,20
NorthEast Un,2641,4,5,3,6,14,14,0,18
FC Pune City,2641,5,5,3,6,13,16,-3,18
Chennaiyin,2641,6,4,5,5,15,18,-3,17
Kerala Blast,2641,7,4,5,5,11,16,-5,17
FC Goa,2641,8,4,4,6,10,15,-5,16
Mumbai City,2642,1,6,4,4,17,10,7,22
Kerala Blast,2642,2,6,4,4,14,15,-1,22
Delhi Dynamo,2642,3,5,5,4,23,19,4,20
NorthEast Un,2642,4,6,2,6,14,13,1,20
FC Pune City,2642,5,5,4,5,16,17,-1,19
Kolkata,2642,6,4,6,4,17,16,1,18
FC Goa,2642,7,4,3,7,13,18,-5,15
Chennaiyin,2642,8,3,6,5,16,22,-6,15
Delhi Dynamo,2643,1,6,6,2,26,16,10,24
Mumbai City,2643,2,6,4,4,16,10,6,22
Kolkata,2643,3,5,6,3,16,15,1,21
Kerala Blast,2643,4,6,3,5,12,14,-2,21
NorthEast Un,2643,5,5,3,6,12,13,-1,18
FC Goa,2643,6,5,2,7,14,17,-3,17
FC Pune City,2643,7,4,3,7,12,16,-4,15
Chennaiyin,2643,8,3,5,6,14,21,-7,14
Mumbai City,2644,1,7,4,3,17,8,9,25
FC Pune City,2644,2,6,3,5,15,15,0,21
Chennaiyin,2644,3,5,5,4,17,18,-1,20
Delhi Dynamo,2644,4,4,7,3,22,16,6,19
Kolkata,2644,5,4,7,3,20,18,2,19
Kerala Blast,2644,6,5,3,6,11,17,-6,18
NorthEast Un,2644,7,4,3,7,11,13,-2,15
FC Goa,2644,8,3,4,7,11,19,-8,13
Mumbai City,2645,1,6,5,3,17,9,8,23
Delhi Dynamo,2645,2,5,6,3,26,19,7,21
Kerala Blast,2645,3,6,3,5,11,16,-5,21
Kolkata,2645,4,4,6,4,16,15,1,18
FC Pune City,2645,5,5,3,6,15,17,-2,18
NorthEast Un,2645,6,5,2,7,14,14,0,17
FC Goa,2645,7,5,2,7,14,18,-4,17
Chennaiyin,2645,8,4,5,5,17,22,-5,17
Delhi Dynamo,2646,1,7,5,2,27,16,11,26
Kerala Blast,2646,2,7,3,4,20,17,3,24
Mumbai City,2646,3,6,4,4,16,10,6,22
NorthEast Un,2646,4,5,2,7,14,16,-2,17
Chennaiyin,2646,5,4,5,5,15,20,-5,17
Kolkata,2646,6,3,7,4,16,18,-2,16
FC Pune City,2646,7,4,4,6,16,20,-4,16
FC Goa,2646,8,4,2,8,10,17,-7,14
Delhi Dynamo,2647,1,6,6,2,28,16,12,24
Mumbai City,2647,2,6,4,4,16,10,6,22
Kolkata,2647,3,5,6,3,18,16,2,21
FC Pune City,2647,4,5,3,6,15,16,-1,18
NorthEast Un,2647,5,5,3,6,13,17,-4,18
Chennaiyin,2647,6,4,5,5,19,18,1,17
FC Goa,2647,7,5,2,7,12,19,-7,17
Kerala Blast,2647,8,4,3,7,9,18,-9,15
Mumbai City,2648,1,7,4,3,18,8,10,25
FC Pune City,2648,2,5,4,5,13,14,-1,19
Kerala Blast,2648,3,5,4,5,11,19,-8,19
NorthEast Un,2648,4,5,3,6,16,12,4,18
Kolkata,2648,5,4,6,4,18,15,3,18
Chennaiyin,2648,6,4,6,4,15,18,-3,18
Delhi Dynamo,2648,7,4,5,5,24,26,-2,17
FC Goa,2648,8,5,2,7,15,18,-3,17
Mumbai City,2649,1,7,4,3,19,9,10,25
Delhi Dynamo,2649,2,5,6,3,25,19,6,21
NorthEast Un,2649,3,6,3,5,17,12,5,21
FC Pune City,2649,4,6,3,5,18,17,1,21
Kolkata,2649,5,4,6,4,19,19,0,18
FC Goa,2649,6,5,2,7,17,18,-1,17
Kerala Blast,2649,7,4,3,7,13,25,-12,15
Chennaiyin,2649,8,3,5,6,15,24,-9,14
Mumbai City,2650,1,7,4,3,17,8,9,25
Delhi Dynamo,2650,2,6,5,3,27,17,10,23
Kerala Blast,2650,3,6,4,4,14,16,-2,22
Chennaiyin,2650,4,5,5,4,18,17,1,20
Kolkata,2650,5,3,9,2,18,17,1,18
FC Pune City,2650,6,4,4,6,15,18,-3,16
NorthEast Un,2650,7,4,2,8,11,16,-5,14
FC Goa,2650,8,3,3,8,9,20,-11,12
Mumbai City,2651,1,7,4,3,17,8,9,25
Kolkata,2651,2,5,6,3,17,17,0,21
Delhi Dynamo,2651,3,4,7,3,21,15,6,19
FC Pune City,2651,4,5,4,5,18,17,1,19
NorthEast Un,2651,5,5,3,6,14,14,0,18
Chennaiyin,2651,6,4,5,5,17,21,-4,17
Kerala Blast,2651,7,4,4,6,13,19,-6,16
FC Goa,2651,8,4,3,7,11,17,-6,15
Mumbai City,2652,1,6,4,4,16,10,6,22
Kerala Blast,2652,2,6,4,4,16,17,-1,22
NorthEast Un,2652,3,6,2,6,18,14,4,20
Delhi Dynamo,2652,4,5,5,4,24,21,3,20
Kolkata,2652,5,3,8,3,16,17,-1,17
FC Pune City,2652,6,4,5,5,14,16,-2,17
Chennaiyin,2652,7,4,5,5,16,20,-4,17
FC Goa,2652,8,4,3,7,12,17,-5,15
Mumbai City,2653,1,7,4,3,18,9,9,25
Delhi Dynamo,2653,2,6,5,3,27,16,11,23
Kolkata,2653,3,5,7,2,18,15,3,22
Kerala Blast,2653,4,5,4,5,13,16,-3,19
NorthEast Un,2653,5,5,3,6,12,14,-2,18
Chennaiyin,2653,6,3,6,5,14,19,-5,15
FC Pune City,2653,6,4,3,7,14,19,-5,15
FC Goa,2653,8,4,2,8,9,17,-8,14
Mumbai City,2654,1,6,5,3,18,10,8,23
Delhi Dynamo,2654,2,5,6,3,26,17,9,21
FC Goa,2654,3,6,2,6,13,14,-1,20
Kolkata,2654,4,4,7,3,16,15,1,19
Kerala Blast,2654,5,5,4,5,12,17,-5,19
NorthEast Un,2654,6,5,2,7,11,13,-2,17
Chennaiyin,2654,7,4,5,5,14,19,-5,17
FC Pune City,2654,8,4,3,7,13,18,-5,15
Mumbai City,2655,1,7,4,3,19,10,9,25
Kolkata,2655,2,6,6,2,21,13,8,24
Delhi Dynamo,2655,3,5,6,3,27,20,7,21
NorthEast Un,2655,4,5,3,6,16,15,1,18
FC Pune City,2655,5,5,3,6,13,15,-2,18
Chennaiyin,2655,6,3,6,5,16,21,-5,15
FC Goa,2655,7,4,3,7,11,19,-8,15
Kerala Blast,2655,8,4,3,7,11,21,-10,15
Delhi Dynamo,2656,1,6,6,2,28,17,11,24
Mumbai City,2656,2,6,5,3,18,10,8,23
NorthEast Un,2656,3,6,2,6,15,13,2,20
FC Pune City,2656,4,5,4,5,15,16,-1,19
Kerala Blast,2656,5,5,4,5,12,18,-6,19
Chennaiyin,2656,6,4,5,5,15,19,-4,17
Kolkata,2656,7,3,6,5,14,16,-2,15
FC Goa,2656,8,4,2,8,10,18,-8,14
Mumbai City,2657,1,6,5,3,17,9,8,23
Kerala Blast,2657,2,6,3,5,14,16,-2,21
Delhi Dynamo,2657,3,4,8,2,23,16,7,20
Kolkata,2657,4,4,6,4,17,17,0,18
FC Goa,2657,5,5,3,6,16,17,-1,18
FC Pune City,2657,6,5,3,6,14,16,-2,18
Chennaiyin,2657,7,4,5,5,17,22,-5,17
NorthEast Un,2657,8,4,3,7,10,15,-5,15
Mumbai City,2658,1,6,5,3,16,8,8,23
Kolkata,2658,2,5,6,3,19,15,4,21
Kerala Blast,2658,3,6,3,5,12,16,-4,21
FC Goa,2658,4,6,2,6,13,14,-1,20
Delhi Dynamo,2658,5,4,6,4,21,16,5,18
NorthEast Un,2658,6,5,2,7,12,13,-1,17
Chennaiyin,2658,7,4,5,5,16,21,-5,17
FC Pune City,2658,8,4,3,7,13,19,-6,15
Mumbai City,2659,1,7,4,3,17,8,9,25
Kerala Blast,2659,2,7,3,4,17,15,2,24
Delhi Dynamo,2659,3,6,5,3,25,16,9,23
Kolkata,2659,4,5,6,3,19,16,3,21
Chennaiyin,2659,5,5,5,4,20,18,2,20
FC Pune City,2659,6,4,3,7,15,22,-7,15
NorthEast Un,2659,7,4,2,8,12,18,-6,14
FC Goa,2659,8,3,2,9,8,20,-12,11
Mumbai City,2660,1,7,4,3,18,9,9,25
Kolkata,2660,2,6,6,2,20,13,7,24
Kerala Blast,2660,3,6,3,5,12,16,-4,21
Delhi Dynamo,2660,4,5,5,4,26,19,7,20
Chennaiyin,2660,5,4,6,4,15,18,-3,18
NorthEast Un,2660,6,5,2,7,13,14,-1,17
FC Pune City,2660,7,4,3,7,13,19,-6,15
FC Goa,2660,8,3,3,8,9,18,-9,12
Mumbai City,2661,1,7,4,3,18,9,9,25
FC Goa,2661,2,6,2,6,14,16,-2,20
FC Pune City,2661,3,5,4,5,15,15,0,19
Kerala Blast,2661,4,5,4,5,11,15,-4,19
Kolkata,2661,5,4,6,4,15,16,-1,18
Delhi Dynamo,2661,6,4,5,5,22,19,3,17
NorthEast Un,2661,7,5,2,7,11,13,-2,17
Chennaiyin,2661,8,4,5,5,17,20,-3,17
Mumbai City,2662,1,6,5,3,17,9,8,23
Kerala Blast,2662,2,6,4,4,14,14,0,22
Delhi Dynamo,2662,3,5,6,3,23,17,6,21
Kolkata,2662,4,4,7,3,14,15,-1,19
Chennaiyin,2662,5,4,6,4,16,18,-2,18
FC Pune City,2662,6,4,4,6,12,15,-3,16
NorthEast Un,2662,7,4,3,7,11,13,-2,15
FC Goa,2662,8,4,3,7,10,16,-6,15
Mumbai City,2663,1,6,4,4,16,9,7,22
Delhi Dynamo,2663,2,5,6,3,22,16,6,21
Kolkata,2663,3,4,7,3,19,17,2,19
NorthEast Un,2663,4,5,3,6,15,14,1,18
Chennaiyin,2663,5,4,6,4,18,21,-3,18
FC Goa,2663,6,5,3,6,15,18,-3,18
Kerala Blast,2663,7,4,5,5,14,20,-6,17
FC Pune City,2663,8,4,4,6,13,17,-4,16
Delhi Dynamo,2664,1,7,5,2,28,16,12,26
Mumbai City,2664,2,6,4,4,16,9,7,22
Kerala Blast,2664,3,6,3,5,12,15,-3,21
FC Pune City,2664,4,5,4,5,14,14,0,19
Chennaiyin,2664,5,4,5,5,15,19,-4,17
FC Goa,2664,6,5,2,7,13,17,-4,17
Kolkata,2664,7,3,7,4,13,14,-1,16
NorthEast Un,2664,8,4,2,8,9,16,-7,14
Mumbai City,2665,1,6,4,4,16,10,6,22
Delhi Dynamo,2665,2,5,6,3,23,19,4,21
NorthEast Un,2665,3,5,4,5,15,10,5,19
Kolkata,2665,4,4,7,3,17,16,1,19
Kerala Blast,2665,5,5,4,5,11,16,-5,19
Chennaiyin,2665,6,4,6,4,17,19,-2,18
FC Pune City,2665,7,4,4,6,15,18,-3,16
FC Goa,2665,8,4,3,7,11,17,-6,15
Mumbai City,2666,1,7,4,3,18,8,10,25
Delhi Dynamo,2666,2,5,6,3,25,18,7,21
Kolkata,2666,3,4,8,2,18,16,2,20
Kerala Blast,2666,4,4,6,4,11,15,-4,18
Chennaiyin,2666,5,4,5,5,16,19,-3,17
NorthEast Un,2666,6,4,4,6,12,14,-2,16
FC Pune City,2666,7,4,4,6,15,18,-3,16
FC Goa,2666,8,4,3,7,10,17,-7,15
Mumbai City,2667,1,7,4,3,17,8,9,25
Delhi Dynamo,2667,2,6,5,3,25,16,9,23
NorthEast Un,2667,3,6,2,6,11,11,0,20
FC Pune City,2667,4,5,3,6,16,18,-2,18
Kolkata,2667,4,4,6,4,16,18,-2,18
Kerala Blast,2667,6,5,3,6,13,17,-4,18
Chennaiyin,2667,7,3,6,5,14,19,-5,15
FC Goa,2667,8,4,3,7,13,18,-5,15
Mumbai City,2668,1,7,4,3,21,8,13,25
Kolkata,2668,2,6,6,2,20,15,5,24
Kerala Blast,2668,3,6,3,5,12,16,-4,21
Delhi Dynamo,2668,4,4,7,3,21,19,2,19
NorthEast Un,2668,5,4,4,6,11,12,-1,16
FC Pune City,2668,6,4,3,7,13,17,-4,15
FC Goa,2668,7,4,3,7,12,17,-5,15
Chennaiyin,2668,8,3,6,5,14,20,-6,15
Mumbai City,2669,1,7,4,3,17,8,9,25
NorthEast Un,2669,2,7,2,5,17,13,4,23
Kolkata,2669,3,5,6,3,18,15,3,21
Delhi Dynamo,2669,4,4,6,4,24,20,4,18
FC Goa,2669,5,5,3,6,16,17,-1,18
Kerala Blast,2669,6,5,3,6,13,19,-6,18
FC Pune City,2669,7,4,3,7,12,16,-4,15
Chennaiyin,2669,8,3,5,6,14,23,-9,14
Mumbai City,2670,1,6,5,3,18,10,8,23
Kerala Blast,2670,2,6,4,4,17,16,1,22
Delhi Dynamo,2670,3,5,6,3,27,18,9,21
Kolkata,2670,4,5,6,3,18,16,2,21
NorthEast Un,2670,5,6,3,5,14,12,2,21
Chennaiyin,2670,6,3,6,5,15,20,-5,15
FC Pune City,2670,7,4,3,7,13,20,-7,15
FC Goa,2670,8,3,3,8,9,19,-10,12
Delhi Dynamo,2671,1,7,5,2,32,18,14,26
Mumbai City,2671,2,6,4,4,16,10,6,22
Kerala Blast,2671,3,6,3,5,16,17,-1,21
Chennaiyin,2671,4,4,6,4,18,18,0,18
Kolkata,2671,5,4,6,4,17,17,0,18
FC Pune City,2671,6,5,3,6,13,16,-3,18
FC Goa,2671,7,4,3,7,13,22,-9,15
NorthEast Un,2671,8,4,2,8,12,19,-7,14
Mumbai City,2672,1,7,4,3,17,8,9,25
NorthEast Un,2672,2,7,2,5,19,10,9,23
FC Pune City,2672,3,5,4,5,14,14,0,19
Delhi Dynamo,2672,4,4,6,4,22,19,3,18
Kolkata,2672,5,4,6,4,15,17,-2,18
FC Goa,2672,6,5,3,6,12,15,-3,18
Kerala Blast,2672,7,4,4,6,9,18,-9,16
Chennaiyin,2672,8,3,5,6,13,20,-7,14
Mumbai City,2673,1,6,5,3,17,9,8,23
Delhi Dynamo,2673,2,5,7,2,24,16,8,22
Kolkata,2673,3,4,8,2,17,14,3,20
Chennaiyin,2673,4,5,5,4,17,19,-2,20
NorthEast Un,2673,5,5,3,6,13,12,1,18
FC Pune City,2673,6,4,5,5,12,14,-2,17
Kerala Blast,2673,7,4,4,6,9,17,-8,16
FC Goa,2673,8,3,3,8,11,19,-8,12
Mumbai City,2674,1,7,4,3,18,9,9,25
Kolkata,2674,2,6,6,2,21,15,6,24
Delhi Dynamo,2674,3,5,6,3,26,18,8,21
Kerala Blast,2674,4,5,4,5,13,16,-3,19
NorthEast Un,2674,5,5,2,7,13,15,-2,17
FC Pune City,2674,6,4,4,6,15,19,-4,16
Chennaiyin,2674,7,3,6,5,15,21,-6,15
FC Goa,2674,8,3,4,7,10,18,-8,13
Mumbai City,2675,1,7,4,3,18,8,10,25
Delhi Dynamo,2675,2,6,5,3,23,16,7,23
Kolkata,2675,3,5,6,3,17,15,2,21
Kerala Blast,2675,4,5,4,5,10,14,-4,19
NorthEast Un,2675,5,5,2,7,11,11,0,17
FC Goa,2675,6,5,2,7,11,16,-5,17
FC Pune City,2675,7,4,4,6,14,17,-3,16
Chennaiyin,2675,8,3,5,6,14,21,-7,14
Mumbai City,2676,1,6,4,4,17,11,6,22
Delhi Dynamo,2676,2,5,6,3,25,17,8,21
Kerala Blast,2676,3,6,3,5,16,16,0,21
Chennaiyin,2676,4,5,5,4,19,17,2,20
Kolkata,2676,5,4,7,3,16,17,-1,19
FC Goa,2676,6,5,2,7,12,17,-5,17
FC Pune City,2676,7,4,4,6,14,18,-4,16
NorthEast Un,2676,8,4,3,7,10,16,-6,15
Mumbai City,2677,1,7,4,3,18,8,10,25
Kolkata,2677,2,5,6,3,17,14,3,21
Delhi Dynamo,2677,3,4,7,3,23,18,5,19
FC Goa,2677,4,5,3,6,15,16,-1,18
NorthEast Un,2677,5,5,3,6,12,13,-1,18
Kerala Blast,2677,6,5,3,6,12,15,-3,18
Chennaiyin,2677,7,4,5,5,16,22,-6,17
FC Pune City,2677,8,4,3,7,12,19,-7,15
Mumbai City,2678,1,7,4,3,18,9,9,25
Delhi Dynamo,2678,2,4,7,3,23,17,6,19
NorthEast Un,2678,3,5,4,5,11,10,1,19
FC Pune City,2678,4,5,4,5,15,16,-1,19
Kerala Blast,2678,5,5,4,5,11,15,-4,19
Kolkata,2678,6,4,6,4,18,18,0,18
Chennaiyin,2678,7,3,6,5,14,19,-5,15
FC Goa,2678,8,4,3,7,11,17,-6,15
Mumbai City,2679,1,7,4,3,18,9,9,25
Delhi Dynamo,2679,2,5,6,3,27,18,9,21
FC Pune City,2679,3,6,3,5,16,16,0,21
NorthEast Un,2679,4,6,2,6,13,12,1,20
Kolkata,2679,5,4,7,3,17,16,1,19
Chennaiyin,2679,6,4,5,5,15,20,-5,17
Kerala Blast,2679,7,4,3,7,12,20,-8,15
FC Goa,2679,8,3,4,7,11,18,-7,13
Mumbai City,2680,1,7,4,3,20,11,9,25
Kolkata,2680,2,5,7,2,16,12,4,22
Delhi Dynamo,2680,3,5,6,3,29,22,7,21
NorthEast Un,2680,4,6,2,6,16,15,1,20
Kerala Blast,2680,5,5,3,6,10,16,-6,18
FC Pune City,2680,6,4,3,7,12,16,-4,15
Chennaiyin,2680,7,3,6,5,16,21,-5,15
FC Goa,2680,8,3,5,6,10,16,-6,14
Mumbai City,2681,1,7,4,3,17,8,9,25
NorthEast Un,2681,2,6,3,5,13,9,4,21
Kolkata,2681,3,4,8,2,16,14,2,20
Kerala Blast,2681,4,5,4,5,13,16,-3,19
FC Goa,2681,5,5,3,6,12,15,-3,18
Delhi Dynamo,2681,6,4,5,5,21,19,2,17
FC Pune City,2681,7,4,4,6,13,17,-4,16
Chennaiyin,2681,8,3,5,6,13,20,-7,14
Delhi Dynamo,2682,1,6,6,2,26,17,9,24
Kolkata,2682,2,6,6,2,21,13,8,24
Mumbai City,2682,3,6,4,4,17,10,7,22
NorthEast Un,2682,4,6,2,6,14,12,2,20
Kerala Blast,2682,5,5,3,6,15,20,-5,18
Chennaiyin,2682,6,3,6,5,14,19,-5,15
FC Pune City,2682,7,4,3,7,13,20,-7,15
FC Goa,2682,8,3,4,7,10,19,-9,13
Mumbai City,2683,1,7,4,3,17,8,9,25
Delhi Dynamo,2683,2,5,6,3,24,16,8,21
Kerala Blast,2683,3,6,3,5,12,16,-4,21
NorthEast Un,2683,4,6,2,6,15,14,1,20
FC Pune City,2683,5,5,3,6,16,17,-1,18
Kolkata,2683,6,4,6,4,15,16,-1,18
Chennaiyin,2683,7,4,5,5,17,21,-4,17
FC Goa,2683,8,3,3,8,9,17,-8,12
Mumbai City,2684,1,6,4,4,17,13,4,22
Kerala Blast,2684,2,6,4,4,16,17,-1,22
Delhi Dynamo,2684,3,5,6,3,29,19,10,21
Chennaiyin,2684,4,5,5,4,17,18,-1,20
Kolkata,2684,5,4,7,3,15,15,0,19
NorthEast Un,2684,6,5,2,7,14,15,-1,17
FC Pune City,2684,7,4,4,6,15,18,-3,16
FC Goa,2684,8,3,4,7,10,18,-8,13
Delhi Dynamo,2685,1,6,5,3,27,18,9,23
Mumbai City,2685,2,6,4,4,17,10,7,22
Kolkata,2685,3,5,6,3,20,17,3,21
NorthEast Un,2685,4,5,4,5,12,10,2,19
Kerala Blast,2685,5,5,4,5,11,17,-6,19
FC Goa,2685,6,5,2,7,14,19,-5,17
Chennaiyin,2685,7,3,6,5,13,18,-5,15
FC Pune City,2685,7,4,3,7,13,18,-5,15
Mumbai City,2686,1,6,5,3,18,10,8,23
NorthEast Un,2686,2,7,2,5,15,10,5,23
Delhi Dynamo,2686,3,5,6,3,24,18,6,21
Kolkata,2686,4,4,7,3,15,14,1,19
Kerala Blast,2686,5,5,3,6,12,17,-5,18
FC Pune City,2686,6,4,4,6,13,16,-3,16
Chennaiyin,2686,7,3,6,5,14,20,-6,15
FC Goa,2686,8,4,3,7,9,15,-6,15
Mumbai City,2687,1,7,4,3,20,11,9,25
Delhi Dynamo,2687,2,4,7,3,26,20,6,19
NorthEast Un,2687,3,5,4,5,12,11,1,19
Kerala Blast,2687,4,5,4,5,14,17,-3,19
Chennaiyin,2687,5,4,6,4,16,19,-3,18
Kolkata,2687,6,3,8,3,18,18,0,17
FC Pune City,2687,7,4,4,6,14,18,-4,16
FC Goa,2687,8,4,3,7,15,21,-6,15
Kolkata,2688,1,6,6,2,19,12,7,24
Mumbai City,2688,2,6,4,4,17,11,6,22
Delhi Dynamo,2688,3,5,6,3,24,16,8,21
NorthEast Un,2688,4,5,4,5,14,13,1,19
FC Pune City,2688,5,5,3,6,13,15,-2,18
Kerala Blast,2688,6,4,4,6,12,21,-9,16
Chennaiyin,2688,7,3,6,5,15,20,-5,15
FC Goa,2688,8,4,3,7,10,16,-6,15
Mumbai City,2689,1,6,5,3,16,8,8,23
Delhi Dynamo,2689,2,5,6,3,24,19,5,21
NorthEast Un,2689,3,6,2,6,13,10,3,20
Chennaiyin,2689,4,5,5,4,18,17,1,20
Kerala Blast,2689,5,5,4,5,10,14,-4,19
Kolkata,2689,6,3,8,3,14,16,-2,17
FC Pune City,2689,7,4,4,6,12,15,-3,16
FC Goa,2689,8,4,2,8,14,22,-8,14
Mumbai City,2690,1,7,4,3,18,8,10,25
Delhi Dynamo,2690,2,5,6,3,24,17,7,21
NorthEast Un,2690,3,5,4,5,13,10,3,19
Kerala Blast,2690,4,5,4,5,11,17,-6,19
FC Pune City,2690,5,5,3,6,13,15,-2,18
FC Goa,2690,6,5,2,7,11,16,-5,17
Kolkata,2690,7,3,7,4,14,16,-2,16
Chennaiyin,2690,8,3,6,5,13,18,-5,15
Mumbai City,2691,1,7,4,3,19,9,10,25
Kolkata,2691,2,5,6,3,17,14,3,21
FC Pune City,2691,3,5,4,5,14,15,-1,19
Kerala Blast,2691,4,5,4,5,13,16,-3,19
Delhi Dynamo,2691,5,4,5,5,23,20,3,17
Chennaiyin,2691,6,4,5,5,18,20,-2,17
FC Goa,2691,7,5,2,7,13,16,-3,17
NorthEast Un,2691,8,5,2,7,11,18,-7,17
Mumbai City,2692,1,7,4,3,17,8,9,25
Delhi Dynamo,2692,2,5,6,3,23,16,7,21
Kolkata,2692,3,4,8,2,18,16,2,20
NorthEast Un,2692,4,5,3,6,13,12,1,18
FC Pune City,2692,5,4,5,5,15,17,-2,17
Kerala Blast,2692,6,4,5,5,11,16,-5,17
FC Goa,2692,7,4,4,6,12,17,-5,16
Chennaiyin,2692,8,3,5,6,14,21,-7,14
Mumbai City,2693,1,7,4,3,19,10,9,25
Delhi Dynamo,2693,2,6,5,3,28,17,11,23
FC Pune City,2693,3,5,4,5,14,15,-1,19
Kerala Blast,2693,4,5,4,5,12,16,-4,19
Kolkata,2693,5,4,6,4,15,14,1,18
NorthEast Un,2693,6,5,2,7,11,12,-1,17
Chennaiyin,2693,7,4,5,5,15,20,-5,17
FC Goa,2693,8,4,2,8,10,20,-10,14
Mumbai City,2694,1,7,4,3,18,9,9,25
NorthEast Un,2694,2,6,3,5,14,11,3,21
Kolkata,2694,3,4,7,3,15,16,-1,19
Delhi Dynamo,2694,4,4,6,4,22,17,5,18
Kerala Blast,2694,5,4,5,5,12,18,-6,17
FC Pune City,2694,6,4,4,6,13,16,-3,16
FC Goa,2694,7,4,4,6,11,14,-3,16
Chennaiyin,2694,8,3,7,4,14,18,-4,16
Mumbai City,2695,1,7,4,3,18,9,9,25
Kerala Blast,2695,2,6,4,4,12,14,-2,22
Delhi Dynamo,2695,3,5,5,4,27,19,8,20
NorthEast Un,2695,4,5,3,6,14,14,0,18
Kolkata,2695,5,4,6,4,14,15,-1,18
FC Goa,2695,6,5,2,7,13,18,-5,17
FC Pune City,2695,7,4,4,6,12,15,-3,16
Chennaiyin,2695,8,3,6,5,15,21,-6,15
Mumbai City,2696,1,7,4,3,17,8,9,25
Delhi Dynamo,2696,2,5,5,4,25,19,6,20
Kolkata,2696,3,4,8,2,18,15,3,20
FC Pune City,2696,4,5,4,5,17,17,0,19
Kerala Blast,2696,5,5,4,5,12,17,-5,19
NorthEast Un,2696,6,5,3,6,12,12,0,18
Chennaiyin,2696,7,4,6,4,15,18,-3,18
FC Goa,2696,8,3,2,9,10,20,-10,11
Mumbai City,2697,1,7,4,3,19,9,10,25
Kerala Blast,2697,2,6,3,5,13,15,-2,21
Kolkata,2697,3,4,6,4,17,17,0,18
NorthEast Un,2697,4,5,3,6,11,11,0,18
FC Pune City,2697,5,5,3,6,15,18,-3,18
FC Goa,2697,6,5,3,6,12,15,-3,18
Delhi Dynamo,2697,7,4,5,5,22,20,2,17
Chennaiyin,2697,8,3,7,4,15,19,-4,16
Mumbai City,2698,1,6,5,3,17,9,8,23
Kolkata,2698,2,5,7,2,16,13,3,22
Delhi Dynamo,2698,3,5,6,3,25,17,8,21
FC Pune City,2698,4,5,3,6,14,16,-2,18
FC Goa,2698,5,5,3,6,12,15,-3,18
Kerala Blast,2698,6,5,3,6,12,16,-4,18
Chennaiyin,2698,7,3,6,5,15,20,-5,15
NorthEast Un,2698,8,4,3,7,11,16,-5,15
Mumbai City,2699,1,6,4,4,17,12,5,22
Kolkata,2699,2,5,7,2,18,14,4,22
Delhi Dynamo,2699,3,5,5,4,25,19,6,20
Kerala Blast,2699,4,5,4,5,10,14,-4,19
NorthEast Un,2699,5,5,3,6,12,11,1,18
FC Goa,2699,6,5,3,6,12,16,-4,18
Chennaiyin,2699,7,4,5,5,15,18,-3,17
FC Pune City,2699,8,4,3,7,12,17,-5,15
Mumbai City,2700,1,7,4,3,18,8,10,25
Delhi Dynamo,2700,2,5,6,3,22,16,6,21
Kolkata,2700,3,4,8,2,18,14,4,20
FC Pune City,2700,4,5,4,5,13,14,-1,19
Chennaiyin,2700,5,4,5,5,16,19,-3,17
NorthEast Un,2700,6,4,4,6,11,14,-3,16
Kerala Blast,2700,7,4,4,6,11,19,-8,16
FC Goa,2700,8,4,3,7,12,17,-5,15
Mumbai City,2701,1,6,5,3,18,10,8,23
Kolkata,2701,2,5,7,2,19,15,4,22
Delhi Dynamo,2701,3,4,6,4,23,18,5,18
NorthEast Un,2701,4,5,3,6,12,12,0,18
Chennaiyin,2701,5,4,6,4,16,19,-3,18
FC Pune City,2701,6,5,3,6,14,17,-3,18
FC Goa,2701,7,4,4,6,11,16,-5,16
Kerala Blast,2701,8,4,4,6,11,17,-6,16
Mumbai City,2702,1,6,4,4,16,9,7,22
Delhi Dynamo,2702,2,5,6,3,24,18,6,21
Kolkata,2702,3,4,8,2,17,13,4,20
NorthEast Un,2702,4,6,2,6,16,13,3,20
Kerala Blast,2702,5,5,4,5,13,18,-5,19
FC Pune City,2702,6,5,3,6,15,18,-3,18
FC Goa,2702,7,4,4,6,13,15,-2,16
Chennaiyin,2702,8,3,5,6,14,24,-10,14
Delhi Dynamo,2703,1,6,6,2,26,16,10,24
Mumbai City,2703,2,6,5,3,17,9,8,23
Kolkata,2703,3,5,6,3,20,17,3,21
FC Pune City,2703,4,5,3,6,16,18,-2,18
Kerala Blast,2703,5,5,3,6,14,18,-4,18
NorthEast Un,2703,6,5,2,7,11,14,-3,17
Chennaiyin,2703,7,4,5,5,15,19,-4,17
FC Goa,2703,8,4,2,8,12,20,-8,14
Kerala Blast,2704,1,7,3,4,13,13,0,24
Delhi Dynamo,2704,2,6,5,3,26,17,9,23
Mumbai City,2704,3,6,4,4,17,10,7,22
NorthEast Un,2704,4,6,2,6,12,12,0,20
FC Goa,2704,5,5,2,7,13,17,-4,17
Kolkata,2704,6,3,7,4,14,16,-2,16
FC Pune City,2704,7,4,4,6,13,16,-3,16
Chennaiyin,2704,8,3,5,6,14,21,-7,14
Mumbai City,2705,1,6,5,3,18,10,8,23
Kerala Blast,2705,2,6,3,5,15,17,-2,21
FC Goa,2705,3,6,2,6,13,14,-1,20
Delhi Dynamo,2705,4,4,6,4,23,21,2,18
Kolkata,2705,5,4,6,4,17,17,0,18
FC Pune City,2705,6,5,3,6,17,19,-2,18
NorthEast Un,2705,7,5,2,7,14,14,0,17
Chennaiyin,2705,8,4,5,5,16,21,-5,17
Mumbai City,2706,1,7,4,3,17,8,9,25
Delhi Dynamo,2706,2,5,5,4,24,18,6,20
Kolkata,2706,3,4,8,2,18,15,3,20
NorthEast Un,2706,4,5,3,6,11,11,0,18
Kerala Blast,2706,5,4,6,4,11,15,-4,18
Chennaiyin,2706,6,4,5,5,15,19,-4,17
FC Pune City,2706,7,4,4,6,13,17,-4,16
FC Goa,2706,8,4,3,7,13,19,-6,15
Mumbai City,2707,1,7,4,3,19,8,11,25
Delhi Dynamo,2707,2,5,6,3,27,20,7,21
Kolkata,2707,3,5,6,3,17,15,2,21
Kerala Blast,2707,4,6,3,5,12,16,-4,21
FC Pune City,2707,5,5,3,6,14,15,-1,18
NorthEast Un,2707,6,4,4,6,14,15,-1,16
Chennaiyin,2707,7,3,6,5,15,21,-6,15
FC Goa,2707,8,4,2,8,11,19,-8,14
Mumbai City,2708,1,7,4,3,17,8,9,25
Kolkata,2708,2,5,6,3,18,17,1,21
Kerala Blast,2708,3,6,3,5,15,15,0,21
Chennaiyin,2708,4,5,5,4,15,17,-2,20
Delhi Dynamo,2708,5,4,6,4,22,18,4,18
NorthEast Un,2708,6,5,2,7,12,14,-2,17
FC Pune City,2708,7,4,3,7,13,18,-5,15
FC Goa,2708,8,4,3,7,11,16,-5,15
Mumbai City,2709,1,7,4,3,20,11,9,25
Delhi Dynamo,2709,2,6,5,3,29,20,9,23
Chennaiyin,2709,3,5,5,4,18,20,-2,20
FC Pune City,2709,4,5,4,5,15,15,0,19
NorthEast Un,2709,5,5,2,7,12,11,1,17
Kolkata,2709,6,3,8,3,18,19,-1,17
Kerala Blast,2709,7,4,5,5,9,16,-7,17
FC Goa,2709,8,3,3,8,17,26,-9,12
Mumbai City,2710,1,7,4,3,17,8,9,25
Delhi Dynamo,2710,2,6,5,3,27,16,11,23
Kolkata,2710,3,5,6,3,17,15,2,21
Chennaiyin,2710,4,4,6,4,16,18,-2,18
Kerala Blast,2710,5,5,3,6,15,17,-2,18
NorthEast Un,2710,6,5,3,6,13,15,-2,18
FC Pune City,2710,7,4,3,7,15,22,-7,15
FC Goa,2710,8,4,2,8,9,18,-9,14
Mumbai City,2711,1,7,4,3,18,8,10,25
Delhi Dynamo,2711,2,5,6,3,23,16,7,21
FC Pune City,2711,3,6,3,5,16,15,1,21
Kerala Blast,2711,4,6,3,5,15,18,-3,21
Chennaiyin,2711,5,4,6,4,16,17,-1,18
Kolkata,2711,6,3,7,4,14,16,-2,16
NorthEast Un,2711,7,4,2,8,10,16,-6,14
FC Goa,2711,8,3,5,6,8,14,-6,14
Kerala Blast,2712,1,7,3,4,14,14,0,24
Mumbai City,2712,2,6,5,3,18,10,8,23
Delhi Dynamo,2712,3,5,6,3,25,19,6,21
NorthEast Un,2712,4,6,2,6,13,11,2,20
FC Pune City,2712,5,5,3,6,15,17,-2,18
Kolkata,2712,6,3,6,5,15,18,-3,15
Chennaiyin,2712,7,3,6,5,13,18,-5,15
FC Goa,2712,8,4,3,7,10,16,-6,15
Delhi Dynamo,2713,1,6,6,2,26,15,11,24
Mumbai City,2713,2,6,5,3,16,8,8,23
Kolkata,2713,3,5,6,3,21,15,6,21
Chennaiyin,2713,4,5,5,4,15,17,-2,20
FC Pune City,2713,5,5,3,6,14,18,-4,18
Kerala Blast,2713,6,4,4,6,9,17,-8,16
NorthEast Un,2713,7,4,3,7,10,14,-4,15
FC Goa,2713,8,4,2,8,10,17,-7,14
Mumbai City,2714,1,7,4,3,17,8,9,25
Kolkata,2714,2,6,6,2,18,12,6,24
Delhi Dynamo,2714,3,5,6,3,22,15,7,21
NorthEast Un,2714,4,5,4,5,12,11,1,19
FC Pune City,2714,5,4,4,6,14,17,-3,16
Kerala Blast,2714,6,4,4,6,12,20,-8,16
Chennaiyin,2714,7,3,6,5,16,21,-5,15
FC Goa,2714,8,4,2,8,11,18,-7,14
Mumbai City,2715,1,7,4,3,21,11,10,25
Kerala Blast,2715,2,6,4,4,13,14,-1,22
Delhi Dynamo,2715,3,5,5,4,29,22,7,20
FC Pune City,2715,4,5,4,5,15,16,-1,19
NorthEast Un,2715,5,5,3,6,12,13,-1,18
Chennaiyin,2715,6,3,7,4,17,21,-4,16
Kolkata,2715,7,3,6,5,15,17,-2,15
FC Goa,2715,8,4,3,7,14,22,-8,15
Mumbai City,2716,1,7,4,3,18,9,9,25
Kolkata,2716,2,4,8,2,17,14,3,20
Kerala Blast,2716,3,5,5,4,13,15,-2,20
Chennaiyin,2716,4,4,6,4,16,18,-2,18
Delhi Dynamo,2716,5,4,5,5,22,19,3,17
FC Pune City,2716,6,4,5,5,13,15,-2,17
NorthEast Un,2716,7,5,2,7,10,13,-3,17
FC Goa,2716,8,4,3,7,12,18,-6,15
Mumbai City,2717,1,7,4,3,19,9,10,25
Delhi Dynamo,2717,2,6,5,3,27,18,9,23
FC Pune City,2717,3,6,3,5,15,15,0,21
NorthEast Un,2717,4,5,3,6,13,13,0,18
Kolkata,2717,5,3,8,3,16,16,0,17
Kerala Blast,2717,6,4,4,6,11,19,-8,16
Chennaiyin,2717,7,3,6,5,15,20,-5,15
FC Goa,2717,8,4,3,7,13,19,-6,15
Delhi Dynamo,2718,1,6,6,2,28,16,12,24
Mumbai City,2718,2,6,5,3,18,10,8,23
Kolkata,2718,3,5,7,2,21,16,5,22
Kerala Blast,2718,4,5,3,6,11,16,-5,18
NorthEast Un,2718,5,5,2,7,10,12,-2,17
Chennaiyin,2718,6,4,5,5,15,19,-4,17
FC Pune City,2718,7,4,3,7,13,19,-6,15
FC Goa,2718,8,4,3,7,12,20,-8,15
Mumbai City,2719,1,7,4,3,20,11,9,25
Kerala Blast,2719,2,7,3,4,14,13,1,24
Chennaiyin,2719,3,5,5,4,16,18,-2,20
Delhi Dynamo,2719,4,4,6,4,27,23,4,18
FC Pune City,2719,5,5,3,6,14,17,-3,18
FC Goa,2719,6,5,2,7,15,18,-3,17
NorthEast Un,2719,7,4,3,7,10,12,-2,15
Kolkata,2719,8,3,6,5,13,17,-4,15
Mumbai City,2720,1,7,4,3,17,8,9,25
Kolkata,2720,2,5,7,2,19,14,5,22
Delhi Dynamo,2720,3,5,6,3,24,15,9,21
Kerala Blast,2720,4,6,3,5,14,16,-2,21
NorthEast Un,2720,5,5,3,6,10,12,-2,18
Chennaiyin,2720,6,3,6,5,14,19,-5,15
FC Pune City,2720,6,4,3,7,14,19,-5,15
FC Goa,2720,8,3,4,7,10,19,-9,13
Delhi Dynamo,2721,1,7,5,2,28,18,10,26
Mumbai City,2721,2,6,4,4,18,11,7,22
Kolkata,2721,3,4,7,3,18,18,0,19
Kerala Blast,2721,4,5,4,5,13,19,-6,19
NorthEast Un,2721,5,5,3,6,15,14,1,18
Chennaiyin,2721,6,4,5,5,16,21,-5,17
FC Pune City,2721,7,4,4,6,13,16,-3,16
FC Goa,2721,8,4,2,8,14,18,-4,14
Delhi Dynamo,2722,1,7,5,2,28,17,11,26
Mumbai City,2722,2,6,4,4,19,12,7,22
Kolkata,2722,3,5,7,2,17,13,4,22
NorthEast Un,2722,4,6,2,6,12,11,1,20
FC Pune City,2722,5,5,4,5,14,15,-1,19
Chennaiyin,2722,6,4,5,5,14,18,-4,17
Kerala Blast,2722,7,4,3,7,10,18,-8,15
FC Goa,2722,8,3,2,9,8,18,-10,11
Mumbai City,2723,1,6,4,4,16,9,7,22
Kolkata,2723,2,5,7,2,17,13,4,22
Delhi Dynamo,2723,3,5,6,3,27,20,7,21
Kerala Blast,2723,4,5,4,5,14,17,-3,19
Chennaiyin,2723,5,4,5,5,17,20,-3,17
FC Goa,2723,6,5,2,7,14,20,-6,17
NorthEast Un,2723,7,4,4,6,12,14,-2,16
FC Pune City,2723,8,4,4,6,16,20,-4,16
Mumbai City,2724,1,7,4,3,17,8,9,25
Kolkata,2724,2,5,7,2,17,13,4,22
Chennaiyin,2724,3,5,5,4,19,20,-1,20
Delhi Dynamo,2724,4,4,6,4,23,20,3,18
FC Pune City,2724,5,5,3,6,14,15,-1,18
Kerala Blast,2724,6,5,3,6,12,19,-7,18
NorthEast Un,2724,7,5,2,7,14,14,0,17
FC Goa,2724,8,3,4,7,12,19,-7,13
Mumbai City,2725,1,7,4,3,19,9,10,25
Delhi Dynamo,2725,2,5,6,3,28,20,8,21
FC Pune City,2725,3,6,3,5,18,14,4,21
Kolkata,2725,4,4,7,3,15,16,-1,19
Kerala Blast,2725,5,5,3,6,12,18,-6,18
Chennaiyin,2725,6,4,5,5,16,19,-3,17
NorthEast Un,2725,7,5,2,7,14,17,-3,17
FC Goa,2725,8,3,4,7,10,19,-9,13
Mumbai City,2726,1,7,4,3,18,9,9,25
NorthEast Un,2726,2,6,3,5,12,10,2,21
Delhi Dynamo,2726,3,5,5,4,24,17,7,20
Kolkata,2726,4,4,7,3,19,15,4,19
FC Pune City,2726,5,5,3,6,14,19,-5,18
FC Goa,2726,6,5,2,7,13,17,-4,17
Kerala Blast,2726,7,4,5,5,11,16,-5,17
Chennaiyin,2726,8,3,5,6,14,22,-8,14
Mumbai City,2727,1,7,4,3,17,8,9,25
Delhi Dynamo,2727,2,5,6,3,25,18,7,21
FC Pune City,2727,3,6,3,5,14,14,0,21
Kolkata,2727,4,4,6,4,15,14,1,18
FC Goa,2727,5,5,2,7,15,16,-1,17
Chennaiyin,2727,6,4,5,5,15,22,-7,17
NorthEast Un,2727,7,4,4,6,13,15,-2,16
Kerala Blast,2727,8,4,4,6,11,18,-7,16
Mumbai City,2728,1,7,4,3,17,8,9,25
Delhi Dynamo,2728,2,5,6,3,25,16,9,21
Kolkata,2728,3,5,6,3,18,16,2,21
Chennaiyin,2728,4,4,6,4,14,17,-3,18
NorthEast Un,2728,5,4,5,5,11,11,0,17
Kerala Blast,2728,6,4,5,5,13,18,-5,17
FC Pune City,2728,7,4,4,6,14,17,-3,16
FC Goa,2728,8,4,2,8,9,18,-9,14
Mumbai City,2729,1,7,4,3,17,8,9,25
Delhi Dynamo,2729,2,5,5,4,22,16,6,20
Kolkata,2729,3,4,7,3,15,14,1,19
FC Pune City,2729,4,5,4,5,13,14,-1,19
NorthEast Un,2729,5,5,3,6,11,12,-1,18
Kerala Blast,2729,6,5,3,6,13,17,-4,18
Chennaiyin,2729,7,3,7,4,14,18,-4,16
FC Goa,2729,8,4,3,7,10,16,-6,15
Mumbai City,2730,1,7,4,3,18,9,9,25
Kolkata,2730,2,6,6,2,17,12,5,24
Delhi Dynamo,2730,3,5,6,3,27,16,11,21
Chennaiyin,2730,4,5,5,4,19,19,0,20
NorthEast Un,2730,5,5,2,7,10,17,-7,17
FC Pune City,2730,6,4,4,6,12,16,-4,16
Kerala Blast,2730,7,4,4,6,9,15,-6,16
FC Goa,2730,8,3,3,8,10,18,-8,12
Mumbai City,2731,1,6,5,3,17,9,8,23
Delhi Dynamo,2731,2,5,6,3,23,16,7,21
FC Pune City,2731,3,5,4,5,13,14,-1,19
Kolkata,2731,4,4,6,4,17,17,0,18
NorthEast Un,2731,5,5,3,6,12,12,0,18
FC Goa,2731,6,5,2,7,13,16,-3,17
Chennaiyin,2731,7,4,5,5,15,20,-5,17
Kerala Blast,2731,8,4,5,5,11,17,-6,17
Delhi Dynamo,2732,1,5,7,2,25,16,9,22
Mumbai City,2732,2,6,4,4,16,10,6,22
Kolkata,2732,3,4,8,2,18,16,2,20
Chennaiyin,2732,4,4,6,4,15,17,-2,18
FC Pune City,2732,5,4,5,5,14,16,-2,17
Kerala Blast,2732,6,4,5,5,13,18,-5,17
NorthEast Un,2732,7,4,4,6,10,12,-2,16
FC Goa,2732,8,3,5,6,11,17,-6,14
Mumbai City,2733,1,7,4,3,18,9,9,25
Delhi Dynamo,2733,2,6,5,3,28,16,12,23
Kolkata,2733,3,5,6,3,18,16,2,21
Kerala Blast,2733,4,6,3,5,14,15,-1,21
Chennaiyin,2733,5,5,5,4,18,19,-1,20
FC Pune City,2733,6,5,3,6,14,18,-4,18
NorthEast Un,2733,7,4,2,8,10,16,-6,14
FC Goa,2733,8,3,2,9,10,21,-11,11
Delhi Dynamo,2734,1,6,6,2,25,15,10,24
Mumbai City,2734,2,6,4,4,17,10,7,22
Kolkata,2734,3,4,8,2,17,14,3,20
Kerala Blast,2734,4,5,5,4,11,14,-3,20
Chennaiyin,2734,5,4,6,4,14,17,-3,18
FC Pune City,2734,6,4,4,6,15,18,-3,16
NorthEast Un,2734,7,4,3,7,9,12,-3,15
FC Goa,2734,8,3,4,7,8,16,-8,13
Delhi Dynamo,2735,1,7,5,2,27,17,10,26
Mumbai City,2735,2,6,4,4,17,10,7,22
Kerala Blast,2735,3,6,4,4,14,15,-1,22
Kolkata,2735,4,4,7,3,15,14,1,19
FC Goa,2735,5,5,2,7,13,17,-4,17
NorthEast Un,2735,6,4,3,7,13,15,-2,15
Chennaiyin,2735,7,3,6,5,15,20,-5,15
FC Pune City,2735,8,4,3,7,12,18,-6,15
Mumbai City,2736,1,7,4,3,18,9,9,25
NorthEast Un,2736,2,7,2,5,16,12,4,23
Kolkata,2736,3,4,8,2,17,14,3,20
Delhi Dynamo,2736,4,4,6,4,24,19,5,18
FC Pune City,2736,5,5,3,6,14,17,-3,18
FC Goa,2736,6,4,4,6,12,15,-3,16
Kerala Blast,2736,7,4,4,6,12,19,-7,16
Chennaiyin,2736,8,3,5,6,13,21,-8,14
Delhi Dynamo,2737,1,6,6,2,28,17,11,24
Mumbai City,2737,2,6,5,3,17,9,8,23
Kerala Blast,2737,3,6,3,5,17,16,1,21
FC Pune City,2737,4,6,3,5,15,15,0,21
Kolkata,2737,5,4,6,4,16,17,-1,18
Chennaiyin,2737,6,3,7,4,15,19,-4,16
NorthEast Un,2737,7,4,3,7,10,17,-7,15
FC Goa,2737,8,3,3,8,12,20,-8,12
Mumbai City,2738,1,6,5,3,16,8,8,23
Delhi Dynamo,2738,2,5,7,2,23,14,9,22
Kerala Blast,2738,3,6,4,4,13,14,-1,22
Kolkata,2738,4,4,7,3,15,14,1,19
Chennaiyin,2738,5,4,6,4,15,18,-3,18
NorthEast Un,2738,6,4,3,7,10,12,-2,15
FC Pune City,2738,7,4,3,7,12,17,-5,15
FC Goa,2738,8,4,3,7,9,16,-7,15
Delhi Dynamo,2739,1,6,6,2,27,15,12,24
Kerala Blast,2739,2,7,3,4,14,14,0,24
Mumbai City,2739,3,6,4,4,16,10,6,22
Kolkata,2739,4,4,7,3,14,14,0,19
NorthEast Un,2739,5,5,3,6,11,11,0,18
Chennaiyin,2739,6,4,5,5,16,19,-3,17
FC Pune City,2739,7,4,3,7,13,17,-4,15
FC Goa,2739,8,3,3,8,9,20,-11,12
Mumbai City,2740,1,6,5,3,17,9,8,23
Delhi Dynamo,2740,2,5,7,2,24,16,8,22
Kerala Blast,2740,3,6,3,5,15,16,-1,21
NorthEast Un,2740,4,5,3,6,12,12,0,18
Chennaiyin,2740,5,4,6,4,16,17,-1,18
Kolkata,2740,6,4,6,4,16,18,-2,18
FC Pune City,2740,7,4,3,7,13,19,-6,15
FC Goa,2740,8,4,3,7,12,18,-6,15
Mumbai City,2741,1,7,4,3,18,9,9,25
Delhi Dynamo,2741,2,6,5,3,27,16,11,23
Kerala Blast,2741,3,6,3,5,13,17,-4,21
NorthEast Un,2741,4,6,2,6,13,11,2,20
Kolkata,2741,5,3,8,3,14,14,0,17
FC Pune City,2741,6,4,4,6,13,16,-3,16
Chennaiyin,2741,7,3,6,5,15,20,-5,15
FC Goa,2741,8,3,4,7,9,19,-10,13
Mumbai City,2742,1,7,4,3,17,8,9,25
Delhi Dynamo,2742,2,5,6,3,22,15,7,21
FC Pune City,2742,3,6,3,5,17,17,0,21
Kolkata,2742,4,4,6,4,18,18,0,18
Kerala Blast,2742,5,5,3,6,12,16,-4,18
NorthEast Un,2742,6,4,4,6,12,14,-2,16
Chennaiyin,2742,7,3,7,4,17,21,-4,16
FC Goa,2742,8,4,3,7,12,18,-6,15
Mumbai City,2743,1,7,4,3,20,9,11,25
Kolkata,2743,2,6,6,2,20,13,7,24
Delhi Dynamo,2743,3,5,6,3,24,19,5,21
Kerala Blast,2743,4,6,3,5,14,17,-3,21
NorthEast Un,2743,5,4,3,7,11,14,-3,15
FC Goa,2743,6,4,3,7,11,16,-5,15
Chennaiyin,2743,7,3,6,5,14,20,-6,15
FC Pune City,2743,7,4,3,7,14,20,-6,15
Delhi Dynamo,2744,1,6,6,2,27,18,9,24
Mumbai City,2744,2,6,5,3,18,10,8,23
Kerala Blast,2744,3,6,4,4,20,16,4,22
Kolkata,2744,4,5,7,2,18,15,3,22
NorthEast Un,2744,5,5,2,7,13,17,-4,17
FC Pune City,2744,6,4,3,7,16,21,-5,15
FC Goa,2744,7,4,2,8,11,18,-7,14
Chennaiyin,2744,8,3,5,6,14,22,-8,14
Delhi Dynamo,2745,1,6,6,2,26,17,9,24
Mumbai City,2745,2,6,5,3,18,10,8,23
Kolkata,2745,3,4,7,3,18,18,0,19
Kerala Blast,2745,4,5,4,5,13,18,-5,19
Chennaiyin,2745,5,4,6,4,14,17,-3,18
FC Pune City,2745,6,4,4,6,14,17,-3,16
NorthEast Un,2745,7,4,3,7,12,14,-2,15
FC Goa,2745,8,4,3,7,11,15,-4,15
Mumbai City,2746,1,7,4,3,20,8,12,25
Delhi Dynamo,2746,2,6,5,3,24,18,6,23
Kerala Blast,2746,3,6,3,5,12,19,-7,21
Kolkata,2746,4,4,6,4,21,17,4,18
FC Pune City,2746,5,5,3,6,14,16,-2,18
NorthEast Un,2746,6,5,2,7,11,11,0,17
Chennaiyin,2746,7,3,6,5,16,22,-6,15
FC Goa,2746,8,4,3,7,13,20,-7,15
Mumbai City,2747,1,7,4,3,19,10,9,25
Delhi Dynamo,2747,2,6,5,3,26,17,9,23
Kolkata,2747,3,5,7,2,17,13,4,22
NorthEast Un,2747,4,5,3,6,12,11,1,18
FC Pune City,2747,5,4,5,5,15,17,-2,17
Kerala Blast,2747,6,4,4,6,11,19,-8,16
Chennaiyin,2747,7,3,6,5,15,20,-5,15
FC Goa,2747,8,4,2,8,10,18,-8,14
Mumbai City,2748,1,6,5,3,16,8,8,23
Delhi Dynamo,2748,2,5,6,3,23,16,7,21
FC Pune City,2748,3,5,4,5,14,15,-1,19
Chennaiyin,2748,4,4,6,4,18,20,-2,18
Kerala Blast,2748,5,4,6,4,13,17,-4,18
FC Goa,2748,6,5,2,7,12,18,-6,17
Kolkata,2748,7,3,7,4,16,17,-1,16
NorthEast Un,2748,8,4,4,6,11,12,-1,16
Mumbai City,2749,1,7,4,3,17,8,9,25
Delhi Dynamo,2749,2,6,5,3,27,18,9,23
Kolkata,2749,3,5,7,2,19,15,4,22
Kerala Blast,2749,4,5,4,5,13,16,-3,19
FC Pune City,2749,5,4,4,6,12,16,-4,16
NorthEast Un,2749,6,4,3,7,11,15,-4,15
Chennaiyin,2749,7,3,6,5,14,19,-5,15
FC Goa,2749,8,4,3,7,12,18,-6,15
Delhi Dynamo,2750,1,7,5,2,26,15,11,26
Mumbai City,2750,2,6,4,4,17,10,7,22
Kerala Blast,2750,3,6,4,4,12,14,-2,22
FC Pune City,2750,4,4,5,5,14,16,-2,17
Kolkata,2750,5,3,7,4,15,16,-1,16
Chennaiyin,2750,6,3,7,4,14,18,-4,16
NorthEast Un,2750,7,4,3,7,10,12,-2,15
FC Goa,2750,8,4,3,7,10,17,-7,15
Kolkata,2751,1,6,6,2,17,13,4,24
Mumbai City,2751,2,6,5,3,17,9,8,23
Delhi Dynamo,2751,3,5,6,3,30,20,10,21
NorthEast Un,2751,4,5,4,5,13,11,2,19
Kerala Blast,2751,5,5,4,5,10,14,-4,19
FC Pune City,2751,6,4,3,7,13,17,-4,15
Chennaiyin,2751,7,3,6,5,14,20,-6,15
FC Goa,2751,8,4,2,8,12,22,-10,14
Mumbai City,2752,1,7,4,3,18,9,9,25
Kolkata,2752,2,5,7,2,16,13,3,22
Delhi Dynamo,2752,3,5,5,4,28,21,7,20
NorthEast Un,2752,4,6,2,6,13,12,1,20
FC Pune City,2752,5,5,3,6,13,15,-2,18
Chennaiyin,2752,6,4,5,5,15,20,-5,17
FC Goa,2752,7,4,3,7,14,20,-6,15
Kerala Blast,2752,8,4,3,7,9,16,-7,15
Mumbai City,2753,1,7,4,3,17,8,9,25
FC Pune City,2753,2,6,3,5,18,15,3,21
NorthEast Un,2753,3,6,3,5,13,10,3,21
Delhi Dynamo,2753,4,5,5,4,25,17,8,20
Kolkata,2753,5,4,7,3,17,17,0,19
Kerala Blast,2753,6,4,5,5,12,19,-7,17
Chennaiyin,2753,7,3,5,6,14,21,-7,14
FC Goa,2753,8,4,2,8,11,20,-9,14
Mumbai City,2754,1,6,4,4,16,9,7,22
Kolkata,2754,2,5,7,2,18,13,5,22
Kerala Blast,2754,3,6,4,4,14,14,0,22
Delhi Dynamo,2754,4,5,6,3,24,18,6,21
NorthEast Un,2754,5,6,2,6,15,13,2,20
Chennaiyin,2754,6,4,5,5,15,20,-5,17
FC Pune City,2754,7,4,3,7,12,18,-6,15
FC Goa,2754,8,3,3,8,11,20,-9,12
Mumbai City,2755,1,6,4,4,17,11,6,22
Delhi Dynamo,2755,2,5,6,3,25,17,8,21
Kolkata,2755,3,5,6,3,19,16,3,21
Kerala Blast,2755,4,6,3,5,13,17,-4,21
NorthEast Un,2755,5,6,2,6,12,12,0,20
FC Goa,2755,6,4,4,6,13,16,-3,16
Chennaiyin,2755,7,3,6,5,15,20,-5,15
FC Pune City,2755,8,4,3,7,12,17,-5,15
Mumbai City,2756,1,6,4,4,17,10,7,22
Kerala Blast,2756,2,6,4,4,15,15,0,22
Delhi Dynamo,2756,3,5,6,3,25,18,7,21
NorthEast Un,2756,4,6,2,6,12,13,-1,20
Kolkata,2756,5,3,8,3,17,17,0,17
FC Pune City,2756,6,4,5,5,13,15,-2,17
Chennaiyin,2756,7,3,6,5,14,19,-5,15
FC Goa,2756,8,3,5,6,13,19,-6,14
Delhi Dynamo,2757,1,6,6,2,25,15,10,24
Kerala Blast,2757,2,7,3,4,15,15,0,24
Mumbai City,2757,3,6,4,4,16,10,6,22
Chennaiyin,2757,4,5,5,4,15,17,-2,20
Kolkata,2757,5,4,6,4,14,15,-1,18
NorthEast Un,2757,6,4,3,7,11,13,-2,15
FC Pune City,2757,7,4,3,7,13,17,-4,15
FC Goa,2757,8,4,2,8,9,16,-7,14
Delhi Dynamo,2758,1,7,5,2,26,15,11,26
Mumbai City,2758,2,6,4,4,17,10,7,22
Kerala Blast,2758,3,5,5,4,13,16,-3,20
Chennaiyin,2758,4,4,6,4,16,19,-3,18
Kolkata,2758,5,3,8,3,17,17,0,17
FC Pune City,2758,6,4,5,5,15,17,-2,17
NorthEast Un,2758,7,4,3,7,11,14,-3,15
FC Goa,2758,8,4,2,8,11,18,-7,14
Mumbai City,2759,1,7,4,3,20,9,11,25
Delhi Dynamo,2759,2,5,5,4,24,20,4,20
Chennaiyin,2759,3,5,5,4,17,17,0,20
Kolkata,2759,4,4,7,3,16,13,3,19
Kerala Blast,2759,5,5,4,5,13,19,-6,19
NorthEast Un,2759,6,5,3,6,12,12,0,18
FC Pune City,2759,7,4,4,6,13,16,-3,16
FC Goa,2759,8,4,2,8,10,19,-9,14
Mumbai City,2760,1,6,4,4,16,10,6,22
Delhi Dynamo,2760,2,5,6,3,24,16,8,21
NorthEast Un,2760,3,6,3,5,16,10,6,21
Kerala Blast,2760,4,6,3,5,13,17,-4,21
FC Pune City,2760,5,5,3,6,14,16,-2,18
FC Goa,2760,6,5,3,6,12,15,-3,18
Kolkata,2760,7,3,6,5,14,19,-5,15
Chennaiyin,2760,8,3,6,5,14,20,-6,15
Mumbai City,2761,1,7,4,3,17,8,9,25
Delhi Dynamo,2761,2,6,5,3,27,18,9,23
Kolkata,2761,3,5,6,3,19,16,3,21
Kerala Blast,2761,4,5,4,5,11,15,-4,19
NorthEast Un,2761,5,5,2,7,12,14,-2,17
FC Goa,2761,6,5,2,7,14,19,-5,17
FC Pune City,2761,7,4,4,6,13,16,-3,16
Chennaiyin,2761,8,3,5,6,13,20,-7,14
Mumbai City,2762,1,7,4,3,19,8,11,25
Delhi Dynamo,2762,2,5,6,3,23,18,5,21
NorthEast Un,2762,3,6,3,5,12,10,2,21
Kolkata,2762,4,4,8,2,16,14,2,20
FC Pune City,2762,5,5,3,6,13,15,-2,18
Kerala Blast,2762,6,4,4,6,10,16,-6,16
Chennaiyin,2762,7,3,6,5,15,20,-5,15
FC Goa,2762,8,3,4,7,11,18,-7,13
Mumbai City,2763,1,7,4,3,17,8,9,25
FC Pune City,2763,2,6,3,5,18,15,3,21
Kolkata,2763,3,5,6,3,15,14,1,21
NorthEast Un,2763,4,5,3,6,14,12,2,18
Delhi Dynamo,2763,5,4,5,5,22,21,1,17
FC Goa,2763,6,5,2,7,14,16,-2,17
Chennaiyin,2763,7,4,5,5,16,22,-6,17
Kerala Blast,2763,8,4,4,6,10,18,-8,16
Kerala Blast,2764,1,7,3,4,18,14,4,24
Mumbai City,2764,2,6,5,3,17,9,8,23
Delhi Dynamo,2764,3,5,7,2,27,19,8,22
Chennaiyin,2764,4,5,5,4,19,20,-1,20
Kolkata,2764,5,3,8,3,18,21,-3,17
FC Pune City,2764,6,4,4,6,16,20,-4,16
NorthEast Un,2764,7,4,2,8,12,16,-4,14
FC Goa,2764,8,3,4,7,14,22,-8,13
Mumbai City,2765,1,6,4,4,16,9,7,22
Delhi Dynamo,2765,2,5,6,3,23,16,7,21
Kolkata,2765,3,5,6,3,20,18,2,21
Kerala Blast,2765,4,5,4,5,11,17,-6,19
NorthEast Un,2765,5,5,3,6,12,12,0,18
Chennaiyin,2765,6,4,6,4,17,19,-2,18
FC Pune City,2765,7,4,4,6,13,16,-3,16
FC Goa,2765,8,4,3,7,15,20,-5,15
Mumbai City,2766,1,7,4,3,18,8,10,25
Kolkata,2766,2,6,6,2,20,13,7,24
Delhi Dynamo,2766,3,6,5,3,24,17,7,23
FC Pune City,2766,4,5,3,6,13,15,-2,18
NorthEast Un,2766,5,4,4,6,11,12,-1,16
Chennaiyin,2766,6,3,7,4,16,20,-4,16
Kerala Blast,2766,7,4,4,6,10,16,-6,16
FC Goa,2766,8,3,3,8,12,23,-11,12
Mumbai City,2767,1,7,4,3,18,9,9,25
Kolkata,2767,2,6,6,2,21,13,8,24
Kerala Blast,2767,3,6,3,5,14,16,-2,21
Delhi Dynamo,2767,4,5,5,4,24,18,6,20
Chennaiyin,2767,5,4,6,4,18,21,-3,18
NorthEast Un,2767,6,5,2,7,12,16,-4,17
FC Pune City,2767,7,4,3,7,12,16,-4,15
FC Goa,2767,8,3,3,8,12,22,-10,12
Mumbai City,2768,1,7,4,3,19,10,9,25
Kolkata,2768,2,5,7,2,19,14,5,22
Delhi Dynamo,2768,3,5,5,4,25,19,6,20
Kerala Blast,2768,4,5,4,5,15,17,-2,19
NorthEast Un,2768,5,5,3,6,12,14,-2,18
FC Pune City,2768,6,4,5,5,17,19,-2,17
Chennaiyin,2768,7,3,6,5,14,19,-5,15
FC Goa,2768,8,4,2,8,9,18,-9,14
Mumbai City,2769,1,7,4,3,18,9,9,25
Kolkata,2769,2,5,7,2,16,12,4,22
Delhi Dynamo,2769,3,5,5,4,24,19,5,20
NorthEast Un,2769,4,5,3,6,11,10,1,18
FC Pune City,2769,5,5,3,6,13,15,-2,18
Chennaiyin,2769,6,4,6,4,14,17,-3,18
Kerala Blast,2769,7,4,5,5,9,14,-5,17
FC Goa,2769,8,3,3,8,9,18,-9,12
Mumbai City,2770,1,7,4,3,19,8,11,25
Kolkata,2770,2,5,7,2,18,15,3,22
Delhi Dynamo,2770,3,5,6,3,27,21,6,21
Kerala Blast,2770,4,5,5,4,11,14,-3,20
NorthEast Un,2770,5,4,5,5,14,14,0,17
FC Pune City,2770,6,4,3,7,14,18,-4,15
Chennaiyin,2770,7,3,6,5,14,19,-5,15
FC Goa,2770,8,4,2,8,11,19,-8,14
Delhi Dynamo,2771,1,5,7,2,26,18,8,22
Mumbai City,2771,2,6,4,4,16,9,7,22
Kolkata,2771,3,4,7,3,17,16,1,19
FC Pune City,2771,4,5,4,5,15,16,-1,19
NorthEast Un,2771,5,5,3,6,14,13,1,18
Chennaiyin,2771,6,4,6,4,14,17,-3,18
FC Goa,2771,7,4,4,6,10,15,-5,16
Kerala Blast,2771,8,4,3,7,10,18,-8,15
Mumbai City,2772,1,6,5,3,17,9,8,23
Delhi Dynamo,2772,2,5,7,2,27,18,9,22
Kerala Blast,2772,3,5,4,5,11,16,-5,19
Kolkata,2772,4,4,6,4,17,15,2,18
FC Pune City,2772,5,5,3,6,14,17,-3,18
NorthEast Un,2772,6,4,5,5,11,11,0,17
Chennaiyin,2772,7,3,7,4,15,19,-4,16
FC Goa,2772,8,4,3,7,12,19,-7,15
Mumbai City,2773,1,6,5,3,17,9,8,23
Kerala Blast,2773,2,6,4,4,16,15,1,22
Delhi Dynamo,2773,3,5,6,3,25,17,8,21
NorthEast Un,2773,4,6,3,5,14,11,3,21
Chennaiyin,2773,5,4,5,5,14,18,-4,17
Kolkata,2773,6,3,7,4,15,19,-4,16
FC Pune City,2773,7,4,4,6,13,17,-4,16
FC Goa,2773,8,4,2,8,11,19,-8,14
Mumbai City,2774,1,7,4,3,20,8,12,25
Kerala Blast,2774,2,6,4,4,13,13,0,22
Kolkata,2774,3,5,6,3,19,15,4,21
NorthEast Un,2774,4,5,3,6,11,12,-1,18
Delhi Dynamo,2774,5,4,5,5,21,20,1,17
Chennaiyin,2774,6,3,7,4,15,19,-4,16
FC Pune City,2774,7,4,4,6,13,18,-5,16
FC Goa,2774,8,4,3,7,10,17,-7,15
Mumbai City,2775,1,7,4,3,18,8,10,25
Delhi Dynamo,2775,2,6,5,3,24,16,8,23
Kerala Blast,2775,3,4,6,4,9,13,-4,18
Kolkata,2775,4,3,8,3,15,15,0,17
FC Pune City,2775,5,4,5,5,14,16,-2,17
Chennaiyin,2775,6,4,5,5,14,18,-4,17
FC Goa,2775,7,5,2,7,10,15,-5,17
NorthEast Un,2775,8,4,3,7,9,12,-3,15
Mumbai City,2776,1,6,5,3,17,9,8,23
FC Pune City,2776,2,6,3,5,16,15,1,21
Delhi Dynamo,2776,3,4,7,3,22,16,6,19
NorthEast Un,2776,4,5,3,6,10,10,0,18
Chennaiyin,2776,5,4,6,4,16,19,-3,18
Kerala Blast,2776,6,5,3,6,12,17,-5,18
Kolkata,2776,7,3,7,4,14,16,-2,16
FC Goa,2776,8,4,4,6,12,17,-5,16
Delhi Dynamo,2777,1,6,6,2,27,15,12,24
Mumbai City,2777,2,6,4,4,16,10,6,22
Kerala Blast,2777,3,6,3,5,11,17,-6,21
Kolkata,2777,4,4,8,2,19,14,5,20
Chennaiyin,2777,5,4,6,4,15,18,-3,18
FC Pune City,2777,6,4,4,6,12,15,-3,16
NorthEast Un,2777,7,4,3,7,11,15,-4,15
FC Goa,2777,8,3,4,7,10,17,-7,13
Delhi Dynamo,2778,1,6,5,3,26,16,10,23
Mumbai City,2778,2,6,4,4,16,9,7,22
FC Goa,2778,3,6,2,6,14,17,-3,20
FC Pune City,2778,4,5,4,5,17,17,0,19
Kerala Blast,2778,5,5,4,5,14,18,-4,19
Kolkata,2778,6,3,8,3,16,16,0,17
Chennaiyin,2778,7,3,6,5,15,20,-5,15
NorthEast Un,2778,8,4,3,7,10,15,-5,15
Mumbai City,2779,1,7,4,3,20,10,10,25
Delhi Dynamo,2779,2,5,6,3,26,20,6,21
Kolkata,2779,3,5,6,3,20,16,4,21
NorthEast Un,2779,4,5,3,6,11,10,1,18
Chennaiyin,2779,5,4,6,4,15,17,-2,18
FC Pune City,2779,6,4,4,6,12,16,-4,16
Kerala Blast,2779,7,4,4,6,10,19,-9,16
FC Goa,2779,8,4,3,7,13,19,-6,15
Delhi Dynamo,2780,1,6,6,2,25,15,10,24
Mumbai City,2780,2,6,5,3,16,8,8,23
Kerala Blast,2780,3,6,3,5,11,15,-4,21
Chennaiyin,2780,4,5,5,4,16,17,-1,20
FC Pune City,2780,5,5,3,6,14,15,-1,18
Kolkata,2780,6,4,6,4,14,18,-4,18
FC Goa,2780,7,4,2,8,13,17,-4,14
NorthEast Un,2780,8,4,2,8,10,14,-4,14
Mumbai City,2781,1,7,4,3,20,8,12,25
Delhi Dynamo,2781,2,6,5,3,27,22,5,23
Kerala Blast,2781,3,5,5,4,14,16,-2,20
FC Pune City,2781,4,5,4,5,13,14,-1,19
Chennaiyin,2781,5,4,6,4,18,19,-1,18
Kolkata,2781,6,3,8,3,16,16,0,17
NorthEast Un,2781,7,4,2,8,11,17,-6,14
FC Goa,2781,8,3,4,7,14,21,-7,13
Mumbai City,2782,1,6,5,3,17,9,8,23
Kerala Blast,2782,2,6,4,4,13,14,-1,22
Delhi Dynamo,2782,3,5,6,3,25,17,8,21
Kolkata,2782,4,4,6,4,16,15,1,18
NorthEast Un,2782,5,5,3,6,14,15,-1,18
Chennaiyin,2782,6,3,7,4,19,23,-4,16
FC Pune City,2782,7,4,4,6,12,16,-4,16
FC Goa,2782,8,4,3,7,14,21,-7,15
Delhi Dynamo,2783,1,6,6,2,28,18,10,24
Mumbai City,2783,2,6,5,3,18,10,8,23
Kolkata,2783,3,5,7,2,19,13,6,22
Kerala Blast,2783,4,5,4,5,14,20,-6,19
Chennaiyin,2783,5,4,6,4,18,20,-2,18
FC Pune City,2783,6,4,4,6,13,16,-3,16
NorthEast Un,2783,7,4,3,7,11,14,-3,15
FC Goa,2783,8,3,3,8,12,22,-10,12
Delhi Dynamo,2784,1,6,6,2,26,17,9,24
Mumbai City,2784,2,6,4,4,17,10,7,22
Kolkata,2784,3,5,7,2,18,14,4,22
NorthEast Un,2784,4,5,3,6,12,12,0,18
Chennaiyin,2784,5,4,6,4,15,18,-3,18
FC Pune City,2784,6,4,4,6,12,15,-3,16
Kerala Blast,2784,7,4,4,6,10,17,-7,16
FC Goa,2784,8,3,4,7,12,19,-7,13
Delhi Dynamo,2785,1,6,5,3,27,21,6,23
Kolkata,2785,2,5,7,2,22,14,8,22
Mumbai City,2785,3,6,4,4,17,11,6,22
NorthEast Un,2785,4,6,2,6,14,11,3,20
Chennaiyin,2785,5,4,5,5,15,18,-3,17
FC Pune City,2785,6,4,4,6,13,17,-4,16
Kerala Blast,2785,7,4,4,6,11,21,-10,16
FC Goa,2785,8,4,3,7,12,18,-6,15
Mumbai City,2786,1,6,4,4,17,10,7,22
Delhi Dynamo,2786,2,5,6,3,24,18,6,21
Kolkata,2786,3,4,8,2,18,15,3,20
Kerala Blast,2786,4,5,5,4,12,15,-3,20
Chennaiyin,2786,5,4,6,4,16,18,-2,18
NorthEast Un,2786,6,5,2,7,11,12,-1,17
FC Pune City,2786,7,4,5,5,15,17,-2,17
FC Goa,2786,8,3,4,7,10,18,-8,13
Mumbai City,2787,1,7,4,3,18,9,9,25
Kolkata,2787,2,6,6,2,19,13,6,24
NorthEast Un,2787,3,5,3,6,12,12,0,18
FC Pune City,2787,4,5,3,6,13,17,-4,18
Delhi Dynamo,2787,5,4,5,5,22,19,3,17
Chennaiyin,2787,6,4,5,5,15,19,-4,17
FC Goa,2787,7,5,2,7,12,16,-4,17
Kerala Blast,2787,8,4,4,6,12,18,-6,16
Mumbai City,2788,1,6,4,4,19,12,7,22
Kerala Blast,2788,2,6,4,4,14,15,-1,22
Delhi Dynamo,2788,3,5,6,3,27,21,6,21
NorthEast Un,2788,4,5,4,5,11,9,2,19
FC Goa,2788,5,5,3,6,15,19,-4,18
Kolkata,2788,6,3,7,4,16,17,-1,16
FC Pune City,2788,7,4,4,6,13,17,-4,16
Chennaiyin,2788,8,3,6,5,14,19,-5,15
Mumbai City,2789,1,7,4,3,19,8,11,25
Kolkata,2789,2,6,6,2,18,12,6,24
Delhi Dynamo,2789,3,5,5,4,23,18,5,20
NorthEast Un,2789,4,6,2,6,11,11,0,20
FC Pune City,2789,5,5,3,6,14,17,-3,18
FC Goa,2789,6,5,2,7,13,16,-3,17
Kerala Blast,2789,7,4,3,7,10,17,-7,15
Chennaiyin,2789,8,3,5,6,13,22,-9,14
Mumbai City,2790,1,6,5,3,17,9,8,23
Delhi Dynamo,2790,2,5,6,3,25,17,8,21
FC Pune City,2790,3,6,3,5,15,15,0,21
NorthEast Un,2790,4,5,3,6,10,11,-1,18
Chennaiyin,2790,5,4,5,5,15,19,-4,17
FC Goa,2790,6,5,2,7,15,20,-5,17
Kerala Blast,2790,7,4,5,5,11,16,-5,17
Kolkata,2790,8,3,7,4,19,20,-1,16
Delhi Dynamo,2791,1,6,5,3,23,17,6,23
Mumbai City,2791,2,6,4,4,16,9,7,22
Kolkata,2791,3,5,6,3,17,14,3,21
Chennaiyin,2791,4,5,5,4,16,18,-2,20
Kerala Blast,2791,5,5,4,5,10,14,-4,19
NorthEast Un,2791,6,5,3,6,12,10,2,18
FC Pune City,2791,7,4,3,7,12,18,-6,15
FC Goa,2791,8,4,2,8,11,17,-6,14
Mumbai City,2792,1,7,4,3,17,8,9,25
Kolkata,2792,2,6,6,2,21,14,7,24
Delhi Dynamo,2792,3,5,5,4,24,17,7,20
FC Goa,2792,4,5,2,7,14,17,-3,17
Chennaiyin,2792,5,4,5,5,15,19,-4,17
Kerala Blast,2792,6,4,5,5,13,19,-6,17
FC Pune City,2792,7,4,4,6,15,20,-5,16
NorthEast Un,2792,8,4,3,7,10,15,-5,15
Mumbai City,2793,1,7,4,3,18,9,9,25
Delhi Dynamo,2793,2,5,5,4,24,17,7,20
FC Goa,2793,3,6,2,6,13,16,-3,20
Kolkata,2793,4,4,7,3,19,17,2,19
FC Pune City,2793,5,5,4,5,17,18,-1,19
NorthEast Un,2793,6,5,3,6,11,12,-1,18
Chennaiyin,2793,7,3,6,5,15,20,-5,15
Kerala Blast,2793,8,4,3,7,14,22,-8,15
Delhi Dynamo,2794,1,5,7,2,26,18,8,22
Mumbai City,2794,2,6,4,4,18,11,7,22
NorthEast Un,2794,3,6,3,5,15,12,3,21
Kolkata,2794,4,4,7,3,18,19,-1,19
FC Pune City,2794,5,5,3,6,15,17,-2,18
Chennaiyin,2794,6,4,5,5,15,20,-5,17
Kerala Blast,2794,7,4,4,6,12,19,-7,16
FC Goa,2794,8,4,3,7,13,16,-3,15
Delhi Dynamo,2795,1,6,6,2,26,16,10,24
Mumbai City,2795,2,6,5,3,17,9,8,23
Kerala Blast,2795,3,6,3,5,13,17,-4,21
Kolkata,2795,4,4,6,4,16,15,1,18
FC Pune City,2795,5,5,3,6,13,16,-3,18
Chennaiyin,2795,6,4,5,5,15,18,-3,17
FC Goa,2795,7,5,2,7,11,16,-5,17
NorthEast Un,2795,8,4,2,8,11,15,-4,14
Mumbai City,2796,1,7,4,3,18,8,10,25
Kerala Blast,2796,2,5,5,4,11,13,-2,20
Delhi Dynamo,2796,3,4,7,3,21,16,5,19
Kolkata,2796,4,4,7,3,15,15,0,19
NorthEast Un,2796,5,4,5,5,10,10,0,17
FC Pune City,2796,6,4,5,5,13,15,-2,17
Chennaiyin,2796,7,3,7,4,14,18,-4,16
FC Goa,2796,8,3,4,7,8,15,-7,13
Mumbai City,2797,1,7,4,3,19,9,10,25
Kolkata,2797,2,5,7,2,17,13,4,22
Delhi Dynamo,2797,3,5,6,3,28,19,9,21
Kerala Blast,2797,4,5,5,4,11,14,-3,20
Chennaiyin,2797,5,4,6,4,17,18,-1,18
NorthEast Un,2797,6,4,4,6,11,14,-3,16
FC Pune City,2797,7,4,3,7,12,17,-5,15
FC Goa,2797,8,3,3,8,9,20,-11,12
Mumbai City,2798,1,6,5,3,17,9,8,23
NorthEast Un,2798,2,6,3,5,16,11,5,21
Delhi Dynamo,2798,3,4,7,3,23,17,6,19
Kerala Blast,2798,4,4,6,4,11,15,-4,18
Kolkata,2798,5,3,8,3,15,15,0,17
FC Pune City,2798,6,4,5,5,13,15,-2,17
FC Goa,2798,7,4,4,6,10,15,-5,16
Chennaiyin,2798,8,3,6,5,14,22,-8,15
Delhi Dynamo,2799,1,6,5,3,26,17,9,23
Mumbai City,2799,2,6,4,4,18,11,7,22
FC Pune City,2799,3,6,3,5,15,15,0,21
Kolkata,2799,4,4,7,3,17,16,1,19
Kerala Blast,2799,5,5,4,5,17,20,-3,19
NorthEast Un,2799,6,5,3,6,13,14,-1,18
Chennaiyin,2799,7,4,6,4,15,17,-2,18
FC Goa,2799,8,3,2,9,9,20,-11,11
Mumbai City,2800,1,7,4,3,19,10,9,25
Delhi Dynamo,2800,2,6,5,3,30,18,12,23
FC Pune City,2800,3,5,4,5,14,14,0,19
Kolkata,2800,3,4,7,3,14,14,0,19
Chennaiyin,2800,5,4,5,5,19,22,-3,17
FC Goa,2800,6,5,2,7,15,21,-6,17
Kerala Blast,2800,7,4,4,6,10,17,-7,16
NorthEast Un,2800,8,4,3,7,11,16,-5,15
Mumbai City,2801,1,7,4,3,18,9,9,25
Delhi Dynamo,2801,2,6,5,3,26,18,8,23
Kerala Blast,2801,3,6,3,5,13,16,-3,21
FC Pune City,2801,4,5,4,5,15,16,-1,19
FC Goa,2801,5,5,2,7,15,18,-3,17
Kolkata,2801,6,3,7,4,14,16,-2,16
NorthEast Un,2801,7,4,3,7,10,12,-2,15
Chennaiyin,2801,8,3,6,5,14,20,-6,15
Mumbai City,2802,1,7,4,3,18,9,9,25
Chennaiyin,2802,2,5,5,4,19,19,0,20
Kolkata,2802,3,4,7,3,16,15,1,19
Kerala Blast,2802,4,5,4,5,12,16,-4,19
NorthEast Un,2802,5,5,3,6,13,13,0,18
FC Pune City,2802,6,5,3,6,13,15,-2,18
Delhi Dynamo,2802,7,4,5,5,25,22,3,17
FC Goa,2802,8,4,3,7,14,21,-7,15
Mumbai City,2803,1,6,5,3,17,9,8,23
Delhi Dynamo,2803,2,5,6,3,24,17,7,21
Chennaiyin,2803,3,5,5,4,16,18,-2,20
Kolkata,2803,4,4,7,3,17,16,1,19
Kerala Blast,2803,5,5,4,5,12,17,-5,19
NorthEast Un,2803,6,5,2,7,13,13,0,17
FC Pune City,2803,7,4,5,5,14,16,-2,17
FC Goa,2803,8,4,2,8,11,18,-7,14
Mumbai City,2804,1,6,4,4,16,9,7,22
Kerala Blast,2804,2,6,4,4,17,17,0,22
Delhi Dynamo,2804,3,5,5,4,22,17,5,20
Kolkata,2804,4,4,8,2,19,17,2,20
Chennaiyin,2804,5,4,6,4,16,19,-3,18
NorthEast Un,2804,6,5,2,7,11,13,-2,17
FC Pune City,2804,7,4,4,6,13,16,-3,16
FC Goa,2804,8,4,3,7,13,19,-6,15
Delhi Dynamo,2805,1,6,5,3,27,19,8,23
Mumbai City,2805,2,6,4,4,17,10,7,22
Kolkata,2805,3,5,7,2,15,12,3,22
Kerala Blast,2805,4,5,4,5,11,15,-4,19
NorthEast Un,2805,5,5,3,6,15,15,0,18
Chennaiyin,2805,6,4,6,4,17,19,-2,18
FC Pune City,2805,7,4,3,7,12,16,-4,15
FC Goa,2805,8,3,4,7,9,17,-8,13
Kerala Blast,2806,1,7,3,4,14,13,1,24
Mumbai City,2806,2,6,4,4,16,9,7,22
Delhi Dynamo,2806,3,5,6,3,23,16,7,21
NorthEast Un,2806,4,6,2,6,16,12,4,20
Kolkata,2806,5,3,8,3,13,13,0,17
Chennaiyin,2806,6,4,5,5,16,22,-6,17
FC Pune City,2806,7,4,4,6,12,16,-4,16
FC Goa,2806,8,3,4,7,8,17,-9,13
Mumbai City,2807,1,6,4,4,18,12,6,22
Delhi Dynamo,2807,2,5,6,3,28,21,7,21
Kolkata,2807,3,4,8,2,20,13,7,20
FC Pune City,2807,4,5,4,5,15,15,0,19
NorthEast Un,2807,5,5,3,6,12,12,0,18
Chennaiyin,2807,6,4,6,4,16,19,-3,18
FC Goa,2807,7,4,4,6,13,17,-4,16
Kerala Blast,2807,8,4,3,7,9,22,-13,15
Mumbai City,2808,1,7,4,3,19,8,11,25
Kolkata,2808,2,5,7,2,19,12,7,22
Kerala Blast,2808,3,6,4,4,15,13,2,22
Delhi Dynamo,2808,4,5,6,3,24,18,6,21
NorthEast Un,2808,5,5,3,6,14,15,-1,18
Chennaiyin,2808,6,4,5,5,17,21,-4,17
FC Pune City,2808,7,4,3,7,12,21,-9,15
FC Goa,2808,8,3,2,9,8,20,-12,11
Mumbai City,2809,1,6,5,3,17,9,8,23
Delhi Dynamo,2809,2,5,7,2,24,15,9,22
Kolkata,2809,3,5,7,2,23,14,9,22
FC Pune City,2809,4,5,4,5,14,15,-1,19
NorthEast Un,2809,5,5,3,6,12,13,-1,18
Chennaiyin,2809,6,3,7,4,15,19,-4,16
Kerala Blast,2809,7,4,3,7,10,19,-9,15
FC Goa,2809,8,3,4,7,10,21,-11,13
Delhi Dynamo,2810,1,7,5,2,27,14,13,26
Mumbai City,2810,2,6,4,4,16,9,7,22
Kerala Blast,2810,3,6,4,4,14,14,0,22
NorthEast Un,2810,4,5,2,7,12,13,-1,17
FC Pune City,2810,5,4,5,5,14,16,-2,17
FC Goa,2810,6,5,2,7,12,19,-7,17
Kolkata,2810,7,3,7,4,15,17,-2,16
Chennaiyin,2810,8,3,5,6,14,22,-8,14
Mumbai City,2811,1,7,4,3,19,9,10,25
Delhi Dynamo,2811,2,6,5,3,29,18,11,23
FC Pune City,2811,3,5,4,5,14,14,0,19
Kerala Blast,2811,4,5,4,5,14,17,-3,19
Chennaiyin,2811,5,4,6,4,16,18,-2,18
Kolkata,2811,6,3,8,3,13,15,-2,17
NorthEast Un,2811,7,4,4,6,13,15,-2,16
FC Goa,2811,8,3,3,8,8,20,-12,12
Mumbai City,2812,1,6,5,3,17,9,8,23
Kerala Blast,2812,2,5,5,4,10,13,-3,20
Delhi Dynamo,2812,3,4,7,3,24,18,6,19
Kolkata,2812,4,4,7,3,16,14,2,19
NorthEast Un,2812,5,5,3,6,10,10,0,18
FC Pune City,2812,6,5,3,6,14,16,-2,18
Chennaiyin,2812,7,4,5,5,14,19,-5,17
FC Goa,2812,8,4,3,7,12,18,-6,15
Mumbai City,2813,1,7,4,3,18,8,10,25
Kerala Blast,2813,2,6,4,4,13,15,-2,22
Delhi Dynamo,2813,3,5,5,4,23,18,5,20
Kolkata,2813,4,4,7,3,16,14,2,19
FC Pune City,2813,5,4,5,5,14,16,-2,17
FC Goa,2813,6,5,2,7,13,17,-4,17
Chennaiyin,2813,7,4,5,5,14,20,-6,17
NorthEast Un,2813,8,4,2,8,10,13,-3,14
Mumbai City,2814,1,7,4,3,17,8,9,25
NorthEast Un,2814,2,6,2,6,12,12,0,20
Chennaiyin,2814,3,5,5,4,16,17,-1,20
Kolkata,2814,4,4,7,3,18,14,4,19
FC Pune City,2814,5,5,4,5,15,15,0,19
Delhi Dynamo,2814,6,4,5,5,23,19,4,17
Kerala Blast,2814,7,4,4,6,11,21,-10,16
FC Goa,2814,8,4,3,7,11,17,-6,15
Mumbai City,2815,1,7,4,3,17,8,9,25
Kerala Blast,2815,2,5,5,4,14,16,-2,20
Delhi Dynamo,2815,3,4,6,4,26,21,5,18
Chennaiyin,2815,4,4,6,4,18,20,-2,18
FC Goa,2815,5,5,3,6,15,19,-4,18
Kolkata,2815,6,3,8,3,17,17,0,17
NorthEast Un,2815,7,4,4,6,15,17,-2,16
FC Pune City,2815,8,4,4,6,12,16,-4,16
Mumbai City,2816,1,7,4,3,18,8,10,25
Delhi Dynamo,2816,2,6,5,3,26,19,7,23
Kolkata,2816,3,5,7,2,17,12,5,22
FC Pune City,2816,4,5,3,6,13,15,-2,18
Kerala Blast,2816,5,5,3,6,12,18,-6,18
NorthEast Un,2816,6,5,2,7,12,14,-2,17
Chennaiyin,2816,7,4,5,5,16,20,-4,17
FC Goa,2816,8,3,3,8,12,20,-8,12
Delhi Dynamo,2817,1,7,5,2,28,16,12,26
Mumbai City,2817,2,6,4,4,18,11,7,22
Kolkata,2817,3,5,6,3,22,18,4,21
Kerala Blast,2817,4,5,4,5,14,17,-3,19
NorthEast Un,2817,5,5,3,6,11,13,-2,18
FC Goa,2817,6,5,2,7,15,19,-4,17
FC Pune City,2817,7,4,3,7,13,21,-8,15
Chennaiyin,2817,8,3,5,6,15,21,-6,14
Delhi Dynamo,2818,1,6,6,2,25,16,9,24
Kolkata,2818,2,6,6,2,20,15,5,24
Mumbai City,2818,3,6,4,4,18,11,7,22
NorthEast Un,2818,4,5,3,6,12,12,0,18
Kerala Blast,2818,5,5,3,6,14,19,-5,18
FC Pune City,2818,6,4,3,7,14,18,-4,15
Chennaiyin,2818,7,3,6,5,15,21,-6,15
FC Goa,2818,8,4,3,7,11,17,-6,15
Mumbai City,2819,1,6,5,3,17,9,8,23
Delhi Dynamo,2819,2,5,7,2,23,15,8,22
Kolkata,2819,3,5,6,3,16,14,2,21
FC Pune City,2819,4,5,3,6,17,16,1,18
Chennaiyin,2819,5,4,6,4,16,19,-3,18
NorthEast Un,2819,6,4,4,6,10,11,-1,16
Kerala Blast,2819,7,4,4,6,9,18,-9,16
FC Goa,2819,8,4,3,7,10,16,-6,15
Mumbai City,2820,1,6,4,4,17,12,5,22
Delhi Dynamo,2820,2,5,6,3,25,17,8,21
FC Pune City,2820,3,5,4,5,14,14,0,19
Kolkata,2820,4,4,6,4,16,17,-1,18
NorthEast Un,2820,5,5,3,6,13,15,-2,18
FC Goa,2820,6,5,3,6,12,16,-4,18
Chennaiyin,2820,7,4,5,5,18,19,-1,17
Kerala Blast,2820,8,4,5,5,12,17,-5,17
Mumbai City,2821,1,7,4,3,18,8,10,25
Delhi Dynamo,2821,2,6,5,3,27,19,8,23
Kolkata,2821,3,5,6,3,16,15,1,21
Kerala Blast,2821,4,5,4,5,13,18,-5,19
NorthEast Un,2821,5,5,3,6,15,14,1,18
FC Pune City,2821,6,5,3,6,16,16,0,18
FC Goa,2821,7,4,2,8,12,19,-7,14
Chennaiyin,2821,8,3,5,6,14,22,-8,14
Delhi Dynamo,2822,1,6,6,2,24,14,10,24
Mumbai City,2822,2,6,5,3,16,8,8,23
Kolkata,2822,3,4,8,2,19,13,6,20
Chennaiyin,2822,4,5,5,4,15,17,-2,20
FC Pune City,2822,5,5,4,5,14,15,-1,19
Kerala Blast,2822,6,5,3,6,12,20,-8,18
NorthEast Un,2822,7,4,2,8,10,14,-4,14
FC Goa,2822,8,3,3,8,8,17,-9,12
Mumbai City,2823,1,7,4,3,19,8,11,25
Kolkata,2823,2,5,7,2,19,13,6,22
Delhi Dynamo,2823,3,5,5,4,23,19,4,20
NorthEast Un,2823,4,5,3,6,12,12,0,18
FC Pune City,2823,5,5,3,6,14,18,-4,18
Chennaiyin,2823,6,4,5,5,17,20,-3,17
Kerala Blast,2823,7,4,4,6,9,16,-7,16
FC Goa,2823,8,4,3,7,10,17,-7,15
Mumbai City,2824,1,7,4,3,19,8,11,25
Delhi Dynamo,2824,2,6,5,3,27,19,8,23
Kolkata,2824,3,4,8,2,18,15,3,20
Kerala Blast,2824,4,5,4,5,11,14,-3,19
Chennaiyin,2824,5,4,5,5,16,19,-3,17
NorthEast Un,2824,6,5,2,7,11,15,-4,17
FC Goa,2824,7,4,3,7,13,19,-6,15
FC Pune City,2824,7,4,3,7,13,19,-6,15
Mumbai City,2825,1,7,4,3,18,9,9,25
Kolkata,2825,2,5,6,3,18,15,3,21
Chennaiyin,2825,3,5,5,4,18,17,1,20
FC Pune City,2825,4,5,4,5,14,15,-1,19
Kerala Blast,2825,5,5,4,5,12,16,-4,19
Delhi Dynamo,2825,6,4,5,5,23,21,2,17
NorthEast Un,2825,7,5,2,7,12,14,-2,17
FC Goa,2825,8,4,2,8,10,18,-8,14
Mumbai City,2826,1,7,4,3,19,10,9,25
Kolkata,2826,2,5,7,2,18,14,4,22
Delhi Dynamo,2826,3,5,6,3,25,18,7,21
Chennaiyin,2826,4,5,5,4,17,18,-1,20
FC Pune City,2826,5,5,4,5,15,15,0,19
NorthEast Un,2826,6,5,3,6,12,11,1,18
Kerala Blast,2826,7,4,3,7,9,19,-10,15
FC Goa,2826,8,3,2,9,10,20,-10,11
Mumbai City,2827,1,7,4,3,18,8,10,25
Delhi Dynamo,2827,2,5,6,3,24,17,7,21
FC Pune City,2827,3,6,3,5,15,14,1,21
Kerala Blast,2827,4,6,3,5,13,16,-3,21
Chennaiyin,2827,5,4,6,4,16,19,-3,18
NorthEast Un,2827,6,4,4,6,12,13,-1,16
Kolkata,2827,7,3,7,4,14,16,-2,16
FC Goa,2827,8,3,3,8,10,19,-9,12
Delhi Dynamo,2828,1,6,6,2,24,15,9,24
Mumbai City,2828,2,6,4,4,17,10,7,22
Kolkata,2828,3,4,7,3,15,15,0,19
Kerala Blast,2828,4,5,4,5,14,17,-3,19
NorthEast Un,2828,5,5,3,6,11,12,-1,18
Chennaiyin,2828,6,4,6,4,16,18,-2,18
FC Pune City,2828,7,4,5,5,14,16,-2,17
FC Goa,2828,8,3,3,8,10,18,-8,12
Delhi Dynamo,2829,1,5,7,2,23,15,8,22
Mumbai City,2829,2,6,4,4,16,9,7,22
Kolkata,2829,3,4,7,3,14,14,0,19
FC Pune City,2829,4,5,3,6,14,15,-1,18
FC Goa,2829,5,5,3,6,12,15,-3,18
NorthEast Un,2829,6,4,5,5,13,13,0,17
Kerala Blast,2829,7,4,5,5,12,18,-6,17
Chennaiyin,2829,8,3,6,5,14,19,-5,15
Mumbai City,2830,1,7,4,3,18,9,9,25
Kolkata,2830,2,5,7,2,19,14,5,22
Delhi Dynamo,2830,3,5,6,3,23,16,7,21
Kerala Blast,2830,4,5,4,5,12,17,-5,19
Chennaiyin,2830,5,4,5,5,21,21,0,17
NorthEast Un,2830,6,5,2,7,13,17,-4,17
FC Pune City,2830,7,4,3,7,12,17,-5,15
FC Goa,2830,8,4,3,7,10,17,-7,15
Mumbai City,2831,1,6,4,4,16,9,7,22
Kolkata,2831,2,5,6,3,18,15,3,21
FC Pune City,2831,3,6,3,5,17,17,0,21
Delhi Dynamo,2831,4,5,5,4,22,19,3,20
Chennaiyin,2831,5,5,5,4,16,18,-2,20
Kerala Blast,2831,6,5,3,6,11,17,-6,18
NorthEast Un,2831,7,5,2,7,10,11,-1,17
FC Goa,2831,8,4,2,8,13,17,-4,14
Mumbai City,2832,1,6,5,3,17,9,8,23
Kerala Blast,2832,2,6,4,4,15,16,-1,22
NorthEast Un,2832,3,6,3,5,16,13,3,21
Delhi Dynamo,2832,4,4,7,3,24,18,6,19
Kolkata,2832,5,4,6,4,16,17,-1,18
FC Pune City,2832,6,5,3,6,15,16,-1,18
Chennaiyin,2832,7,3,6,5,15,21,-6,15
FC Goa,2832,8,3,4,7,9,17,-8,13
Mumbai City,2833,1,7,4,3,20,9,11,25
Delhi Dynamo,2833,2,5,6,3,25,19,6,21
NorthEast Un,2833,3,6,3,5,14,11,3,21
FC Pune City,2833,4,5,4,5,14,15,-1,19
Kerala Blast,2833,5,5,3,6,10,16,-6,18
Chennaiyin,2833,6,4,5,5,17,21,-4,17
Kolkata,2833,7,3,7,4,16,17,-1,16
FC Goa,2833,8,4,2,8,13,21,-8,14
Mumbai City,2834,1,6,5,3,18,10,8,23
NorthEast Un,2834,2,6,2,6,12,10,2,20
Kerala Blast,2834,3,5,5,4,10,13,-3,20
FC Pune City,2834,4,5,4,5,13,14,-1,19
Delhi Dynamo,2834,5,4,6,4,24,20,4,18
Chennaiyin,2834,6,4,5,5,14,18,-4,17
FC Goa,2834,7,5,2,7,11,16,-5,17
Kolkata,2834,8,3,7,4,13,14,-1,16
Mumbai City,2835,1,7,4,3,18,9,9,25
Delhi Dynamo,2835,2,6,5,3,28,17,11,23
Kolkata,2835,3,5,7,2,19,14,5,22
FC Pune City,2835,4,5,3,6,16,18,-2,18
Kerala Blast,2835,5,5,3,6,11,18,-7,18
NorthEast Un,2835,6,5,2,7,12,14,-2,17
FC Goa,2835,7,4,3,7,13,19,-6,15
Chennaiyin,2835,8,3,5,6,15,23,-8,14
Mumbai City,2836,1,7,4,3,17,8,9,25
Kolkata,2836,2,5,7,2,18,14,4,22
Chennaiyin,2836,3,5,5,4,17,18,-1,20
Kerala Blast,2836,4,5,4,5,12,15,-3,19
Delhi Dynamo,2836,5,4,6,4,21,16,5,18
FC Pune City,2836,6,5,3,6,16,19,-3,18
NorthEast Un,2836,7,5,2,7,11,14,-3,17
FC Goa,2836,8,3,3,8,8,16,-8,12
Kolkata,2837,1,6,6,2,18,12,6,24
Mumbai City,2837,2,6,5,3,17,9,8,23
Delhi Dynamo,2837,3,5,7,2,25,15,10,22
Kerala Blast,2837,4,6,3,5,14,16,-2,21
NorthEast Un,2837,5,4,4,6,10,13,-3,16
FC Pune City,2837,6,4,3,7,13,17,-4,15
Chennaiyin,2837,7,3,6,5,14,19,-5,15
FC Goa,2837,8,4,2,8,9,19,-10,14
Mumbai City,2838,1,7,4,3,17,8,9,25
NorthEast Un,2838,2,6,2,6,16,12,4,20
Delhi Dynamo,2838,3,5,5,4,23,20,3,20
Kolkata,2838,4,4,7,3,15,14,1,19
FC Pune City,2838,5,5,3,6,13,15,-2,18
Kerala Blast,2838,6,5,3,6,11,17,-6,18
Chennaiyin,2838,7,4,5,5,16,19,-3,17
FC Goa,2838,8,4,3,7,10,16,-6,15
Mumbai City,2839,1,7,4,3,18,9,9,25
Delhi Dynamo,2839,2,6,5,3,31,19,12,23
Chennaiyin,2839,3,5,5,4,17,19,-2,20
Kolkata,2839,4,4,7,3,16,16,0,19
Kerala Blast,2839,5,4,6,4,11,15,-4,18
FC Pune City,2839,6,4,4,6,15,18,-3,16
NorthEast Un,2839,7,4,3,7,12,16,-4,15
FC Goa,2839,8,4,2,8,13,21,-8,14
Delhi Dynamo,2840,1,7,5,2,26,15,11,26
Mumbai City,2840,2,6,4,4,16,9,7,22
FC Pune City,2840,3,6,3,5,16,14,2,21
Kolkata,2840,4,5,6,3,15,15,0,21
NorthEast Un,2840,5,5,2,7,13,14,-1,17
Chennaiyin,2840,6,4,5,5,16,19,-3,17
Kerala Blast,2840,7,4,3,7,10,18,-8,15
FC Goa,2840,8,4,2,8,10,18,-8,14
Mumbai City,2841,1,6,5,3,17,9,8,23
Kerala Blast,2841,2,6,4,4,13,14,-1,22
Delhi Dynamo,2841,3,5,6,3,25,18,7,21
Kolkata,2841,4,4,7,3,16,15,1,19
FC Pune City,2841,5,5,3,6,13,15,-2,18
Chennaiyin,2841,6,4,5,5,19,20,-1,17
NorthEast Un,2841,7,5,2,7,12,17,-5,17
FC Goa,2841,8,4,2,8,12,19,-7,14
Mumbai City,2842,1,7,4,3,18,9,9,25
Delhi Dynamo,2842,2,4,7,3,24,18,6,19
Kolkata,2842,3,4,7,3,17,14,3,19
FC Pune City,2842,4,5,4,5,15,15,0,19
Kerala Blast,2842,5,5,4,5,12,19,-7,19
NorthEast Un,2842,6,4,4,6,12,13,-1,16
FC Goa,2842,7,4,4,6,11,15,-4,16
Chennaiyin,2842,8,3,6,5,14,20,-6,15
Mumbai City,2843,1,7,4,3,18,9,9,25
Kolkata,2843,2,4,8,2,17,14,3,20
NorthEast Un,2843,3,6,2,6,11,10,1,20
FC Pune City,2843,4,5,4,5,14,15,-1,19
Chennaiyin,2843,5,4,6,4,14,17,-3,18
Delhi Dynamo,2843,6,4,5,5,23,19,4,17
Kerala Blast,2843,7,4,4,6,10,16,-6,16
FC Goa,2843,8,4,3,7,10,17,-7,15
Mumbai City,2844,1,7,4,3,19,8,11,25
Kolkata,2844,2,6,6,2,19,14,5,24
Delhi Dynamo,2844,3,5,5,4,23,21,2,20
NorthEast Un,2844,4,5,4,5,14,11,3,19
Kerala Blast,2844,5,5,4,5,12,16,-4,19
Chennaiyin,2844,6,3,6,5,14,19,-5,15
FC Pune City,2844,7,4,3,7,13,18,-5,15
FC Goa,2844,8,4,2,8,11,18,-7,14
NorthEast Un,2845,1,7,2,5,13,10,3,23
Mumbai City,2845,2,6,4,4,16,9,7,22
Delhi Dynamo,2845,3,5,5,4,24,18,6,20
FC Goa,2845,4,6,2,6,17,17,0,20
FC Pune City,2845,5,5,3,6,15,16,-1,18
Kolkata,2845,6,4,6,4,15,18,-3,18
Kerala Blast,2845,7,5,3,6,13,18,-5,18
Chennaiyin,2845,8,3,5,6,15,22,-7,14
Mumbai City,2846,1,6,5,3,16,8,8,23
Delhi Dynamo,2846,2,5,7,2,26,17,9,22
Kerala Blast,2846,3,6,4,4,14,15,-1,22
Kolkata,2846,4,4,8,2,17,15,2,20
Chennaiyin,2846,5,4,5,5,16,20,-4,17
NorthEast Un,2846,6,4,3,7,12,15,-3,15
FC Pune City,2846,7,4,3,7,14,18,-4,15
FC Goa,2846,8,4,3,7,12,19,-7,15
Mumbai City,2847,1,7,4,3,18,8,10,25
Kerala Blast,2847,2,6,3,5,12,16,-4,21
Delhi Dynamo,2847,3,5,5,4,23,17,6,20
NorthEast Un,2847,4,5,3,6,12,12,0,18
Kolkata,2847,5,4,6,4,17,18,-1,18
Chennaiyin,2847,6,4,6,4,18,20,-2,18
FC Pune City,2847,7,5,3,6,15,17,-2,18
FC Goa,2847,8,4,2,8,12,19,-7,14
Mumbai City,2848,1,7,4,3,17,8,9,25
Kerala Blast,2848,2,6,4,4,14,16,-2,22
FC Goa,2848,3,6,2,6,15,16,-1,20
Kolkata,2848,4,4,7,3,17,17,0,19
NorthEast Un,2848,5,5,3,6,14,14,0,18
Delhi Dynamo,2848,6,4,5,5,22,19,3,17
FC Pune City,2848,7,4,3,7,13,17,-4,15
Chennaiyin,2848,8,3,6,5,17,22,-5,15
Delhi Dynamo,2849,1,6,5,3,28,18,10,23
Mumbai City,2849,2,6,4,4,18,11,7,22
NorthEast Un,2849,3,6,3,5,15,12,3,21
Kolkata,2849,4,4,8,2,18,15,3,20
Kerala Blast,2849,5,5,4,5,12,17,-5,19
Chennaiyin,2849,6,3,7,4,15,19,-4,16
FC Pune City,2849,7,4,3,7,13,18,-5,15
FC Goa,2849,8,3,4,7,10,19,-9,13
Mumbai City,2850,1,6,5,3,17,9,8,23
Kerala Blast,2850,2,6,4,4,12,14,-2,22
Delhi Dynamo,2850,3,4,8,2,24,17,7,20
NorthEast Un,2850,4,5,4,5,10,9,1,19
Kolkata,2850,5,4,6,4,17,16,1,18
FC Pune City,2850,6,5,3,6,14,16,-2,18
Chennaiyin,2850,7,3,6,5,14,19,-5,15
FC Goa,2850,8,3,4,7,11,19,-8,13
Mumbai City,2851,1,6,4,4,16,9,7,22
Delhi Dynamo,2851,2,5,6,3,22,17,5,21
Kerala Blast,2851,3,5,4,5,11,17,-6,19
NorthEast Un,2851,4,5,3,6,13,11,2,18
Kolkata,2851,5,3,9,2,14,13,1,18
FC Goa,2851,6,5,3,6,14,14,0,18
Chennaiyin,2851,7,4,5,5,15,21,-6,17
FC Pune City,2851,8,4,4,6,14,17,-3,16
Mumbai City,2852,1,7,4,3,19,10,9,25
Kolkata,2852,2,5,6,3,16,15,1,21
Delhi Dynamo,2852,3,5,5,4,27,21,6,20
NorthEast Un,2852,4,5,4,5,13,12,1,19
Kerala Blast,2852,5,5,4,5,11,15,-4,19
Chennaiyin,2852,6,3,7,4,14,18,-4,16
FC Goa,2852,7,4,3,7,12,16,-4,15
FC Pune City,2852,8,4,3,7,12,17,-5,15
Mumbai City,2853,1,6,5,3,17,9,8,23
Kerala Blast,2853,2,6,4,4,14,15,-1,22
Delhi Dynamo,2853,3,5,6,3,26,18,8,21
NorthEast Un,2853,4,6,3,5,13,11,2,21
Kolkata,2853,5,3,7,4,16,19,-3,16
FC Pune City,2853,6,4,4,6,12,15,-3,16
Chennaiyin,2853,7,3,6,5,15,20,-5,15
FC Goa,2853,8,4,3,7,13,19,-6,15
Mumbai City,2854,1,6,4,4,16,9,7,22
Delhi Dynamo,2854,2,5,6,3,24,17,7,21
Kolkata,2854,3,5,6,3,16,15,1,21
Chennaiyin,2854,4,5,5,4,16,18,-2,20
FC Pune City,2854,5,5,4,5,15,14,1,19
NorthEast Un,2854,6,5,3,6,14,14,0,18
Kerala Blast,2854,7,4,5,5,11,17,-6,17
FC Goa,2854,8,3,3,8,9,17,-8,12
Mumbai City,2855,1,7,4,3,17,8,9,25
Chennaiyin,2855,2,5,5,4,19,18,1,20
Kolkata,2855,3,4,7,3,18,17,1,19
Delhi Dynamo,2855,4,4,6,4,23,19,4,18
FC Pune City,2855,5,5,3,6,18,19,-1,18
FC Goa,2855,6,5,2,7,14,18,-4,17
Kerala Blast,2855,7,4,5,5,12,19,-7,17
NorthEast Un,2855,8,4,4,6,11,14,-3,16
Mumbai City,2856,1,6,4,4,16,10,6,22
Delhi Dynamo,2856,2,5,6,3,25,17,8,21
Kolkata,2856,3,4,8,2,20,18,2,20
FC Pune City,2856,4,5,4,5,18,16,2,19
NorthEast Un,2856,5,5,3,6,14,12,2,18
Chennaiyin,2856,6,4,6,4,14,17,-3,18
FC Goa,2856,7,4,4,6,12,17,-5,16
Kerala Blast,2856,8,4,3,7,10,22,-12,15
Mumbai City,2857,1,7,4,3,17,8,9,25
Kerala Blast,2857,2,6,4,4,16,17,-1,22
Kolkata,2857,3,4,8,2,17,15,2,20
Delhi Dynamo,2857,4,4,6,4,25,20,5,18
Chennaiyin,2857,5,4,6,4,18,18,0,18
FC Pune City,2857,6,4,4,6,16,19,-3,16
FC Goa,2857,7,4,3,7,13,19,-6,15
NorthEast Un,2857,8,4,3,7,11,17,-6,15
Mumbai City,2858,1,6,5,3,16,8,8,23
Kolkata,2858,2,5,6,3,15,14,1,21
NorthEast Un,2858,3,6,2,6,15,14,1,20
Delhi Dynamo,2858,4,4,7,3,24,18,6,19
FC Pune City,2858,5,5,4,5,16,16,0,19
Kerala Blast,2858,6,5,4,5,12,16,-4,19
Chennaiyin,2858,7,3,6,5,18,23,-5,15
FC Goa,2858,8,3,4,7,12,19,-7,13
Delhi Dynamo,2859,1,6,6,2,27,16,11,24
Mumbai City,2859,2,6,5,3,17,9,8,23
Kolkata,2859,3,5,7,2,16,13,3,22
FC Pune City,2859,4,5,3,6,17,19,-2,18
Kerala Blast,2859,5,5,3,6,13,18,-5,18
NorthEast Un,2859,6,5,2,7,12,13,-1,17
Chennaiyin,2859,7,3,6,5,14,19,-5,15
FC Goa,2859,8,3,4,7,8,17,-9,13
Mumbai City,2860,1,7,4,3,19,9,10,25
NorthEast Un,2860,2,6,3,5,15,11,4,21
Kolkata,2860,3,5,6,3,18,16,2,21
FC Pune City,2860,4,5,3,6,16,16,0,18
Delhi Dynamo,2860,5,4,5,5,24,24,0,17
Chennaiyin,2860,6,4,5,5,15,19,-4,17
FC Goa,2860,7,5,2,7,14,18,-4,17
Kerala Blast,2860,8,4,4,6,13,21,-8,16
Mumbai City,2861,1,7,4,3,18,8,10,25
Kolkata,2861,2,6,6,2,20,13,7,24
Delhi Dynamo,2861,3,4,6,4,21,17,4,18
NorthEast Un,2861,4,5,3,6,13,13,0,18
Chennaiyin,2861,5,4,5,5,16,21,-5,17
Kerala Blast,2861,6,4,5,5,12,19,-7,17
FC Pune City,2861,7,4,4,6,13,16,-3,16
FC Goa,2861,8,4,3,7,10,16,-6,15
Mumbai City,2862,1,7,4,3,19,10,9,25
Delhi Dynamo,2862,2,5,6,3,27,19,8,21
Kolkata,2862,3,5,6,3,17,13,4,21
FC Pune City,2862,4,6,3,5,16,15,1,21
Chennaiyin,2862,5,5,5,4,18,20,-2,20
NorthEast Un,2862,6,5,3,6,13,13,0,18
Kerala Blast,2862,7,4,3,7,11,20,-9,15
FC Goa,2862,8,3,2,9,11,22,-11,11
Mumbai City,2863,1,6,5,3,19,11,8,23
Delhi Dynamo,2863,2,5,7,2,29,21,8,22
FC Pune City,2863,3,6,3,5,16,15,1,21
NorthEast Un,2863,4,5,3,6,13,13,0,18
Kolkata,2863,5,4,6,4,17,20,-3,18
Kerala Blast,2863,6,5,3,6,11,17,-6,18
Chennaiyin,2863,7,4,5,5,15,20,-5,17
FC Goa,2863,8,4,2,8,17,20,-3,14
Mumbai City,2864,1,7,4,3,19,8,11,25
Kolkata,2864,2,5,7,2,19,16,3,22
Delhi Dynamo,2864,3,5,6,3,25,20,5,21
Chennaiyin,2864,4,5,5,4,16,18,-2,20
Kerala Blast,2864,5,5,4,5,10,14,-4,19
FC Pune City,2864,6,4,4,6,13,16,-3,16
NorthEast Un,2864,7,4,3,7,12,14,-2,15
FC Goa,2864,8,3,3,8,12,20,-8,12
Mumbai City,2865,1,7,4,3,18,9,9,25
Kolkata,2865,2,6,6,2,21,16,5,24
NorthEast Un,2865,3,6,2,6,11,12,-1,20
Delhi Dynamo,2865,4,4,6,4,24,19,5,18
Kerala Blast,2865,5,5,3,6,11,16,-5,18
Chennaiyin,2865,6,4,5,5,17,20,-3,17
FC Pune City,2865,7,4,3,7,14,18,-4,15
FC Goa,2865,8,4,3,7,14,20,-6,15
Mumbai City,2866,1,6,5,3,16,8,8,23
Delhi Dynamo,2866,2,5,6,3,24,17,7,21
Kerala Blast,2866,3,5,5,4,10,13,-3,20
FC Goa,2866,4,5,3,6,13,16,-3,18
Kolkata,2866,5,3,8,3,13,13,0,17
FC Pune City,2866,6,4,5,5,12,14,-2,17
Chennaiyin,2866,7,4,5,5,15,20,-5,17
NorthEast Un,2866,8,4,3,7,10,12,-2,15
Mumbai City,2867,1,7,4,3,20,9,11,25
Kerala Blast,2867,2,6,3,5,14,17,-3,21
Delhi Dynamo,2867,3,5,5,4,24,20,4,20
FC Goa,2867,4,5,3,6,15,15,0,18
Kolkata,2867,5,4,6,4,16,18,-2,18
Chennaiyin,2867,6,4,6,4,17,20,-3,18
FC Pune City,2867,7,5,3,6,14,17,-3,18
NorthEast Un,2867,8,4,2,8,11,15,-4,14
Mumbai City,2868,1,6,5,3,19,11,8,23
FC Pune City,2868,2,6,3,5,18,15,3,21
Delhi Dynamo,2868,3,4,7,3,25,23,2,19
Kolkata,2868,4,4,7,3,18,17,1,19
NorthEast Un,2868,5,5,3,6,17,13,4,18
Chennaiyin,2868,6,4,6,4,15,18,-3,18
Kerala Blast,2868,7,4,4,6,13,22,-9,16
FC Goa,2868,8,3,5,6,11,17,-6,14
Delhi Dynamo,2869,1,6,5,3,24,15,9,23
Mumbai City,2869,2,6,4,4,16,9,7,22
Kerala Blast,2869,3,6,4,4,13,15,-2,22
Chennaiyin,2869,4,5,5,4,18,17,1,20
Kolkata,2869,5,4,6,4,17,17,0,18
FC Pune City,2869,6,5,3,6,15,16,-1,18
NorthEast Un,2869,7,5,3,6,11,13,-2,18
FC Goa,2869,8,3,2,9,10,22,-12,11
Mumbai City,2870,1,7,4,3,17,8,9,25
Kerala Blast,2870,2,6,4,4,18,17,1,22
Delhi Dynamo,2870,3,4,6,4,21,18,3,18
FC Pune City,2870,4,5,3,6,18,19,-1,18
NorthEast Un,2870,5,5,2,7,14,13,1,17
Chennaiyin,2870,6,4,5,5,15,19,-4,17
Kolkata,2870,6,3,8,3,15,19,-4,17
FC Goa,2870,8,4,4,6,9,14,-5,16
Mumbai City,2871,1,7,4,3,19,10,9,25
Delhi Dynamo,2871,2,6,5,3,28,18,10,23
Kolkata,2871,3,5,7,2,17,12,5,22
FC Pune City,2871,4,5,3,6,16,18,-2,18
NorthEast Un,2871,5,4,4,6,12,14,-2,16
Kerala Blast,2871,6,4,4,6,11,19,-8,16
Chennaiyin,2871,7,3,6,5,16,21,-5,15
FC Goa,2871,8,4,3,7,10,17,-7,15
Delhi Dynamo,2872,1,7,5,2,27,15,12,26
Mumbai City,2872,2,6,4,4,17,10,7,22
Kolkata,2872,3,5,6,3,21,15,6,21
FC Pune City,2872,4,5,3,6,15,17,-2,18
Chennaiyin,2872,5,4,6,4,16,19,-3,18
NorthEast Un,2872,6,5,2,7,12,13,-1,17
FC Goa,2872,7,4,3,7,12,19,-7,15
Kerala Blast,2872,8,4,3,7,10,22,-12,15
Mumbai City,2873,1,7,4,3,18,9,9,25
Kolkata,2873,2,5,7,2,17,12,5,22
Delhi Dynamo,2873,3,5,6,3,23,16,7,21
Kerala Blast,2873,4,6,3,5,13,16,-3,21
NorthEast Un,2873,5,5,2,7,13,14,-1,17
Chennaiyin,2873,6,4,5,5,18,22,-4,17
FC Pune City,2873,7,4,4,6,12,17,-5,16
FC Goa,2873,8,3,3,8,9,17,-8,12
Mumbai City,2874,1,7,4,3,18,8,10,25
Delhi Dynamo,2874,2,6,5,3,26,17,9,23
Kolkata,2874,3,5,6,3,17,14,3,21
Kerala Blast,2874,4,6,3,5,13,14,-1,21
Chennaiyin,2874,5,5,5,4,17,18,-1,20
FC Pune City,2874,6,4,3,7,12,20,-8,15
NorthEast Un,2874,7,4,2,8,10,14,-4,14
FC Goa,2874,8,4,2,8,11,19,-8,14
Mumbai City,2875,1,6,5,3,16,8,8,23
Kolkata,2875,2,5,7,2,16,13,3,22
NorthEast Un,2875,3,6,3,5,14,10,4,21
Kerala Blast,2875,4,5,5,4,11,14,-3,20
Delhi Dynamo,2875,5,4,7,3,21,15,6,19
Chennaiyin,2875,6,4,5,5,14,20,-6,17
FC Pune City,2875,7,4,3,7,13,17,-4,15
FC Goa,2875,8,3,3,8,8,16,-8,12
Mumbai City,2876,1,7,4,3,20,8,12,25
Kolkata,2876,2,5,6,3,20,16,4,21
Kerala Blast,2876,3,6,3,5,12,14,-2,21
Delhi Dynamo,2876,4,5,5,4,26,21,5,20
FC Goa,2876,5,6,2,6,17,18,-1,20
NorthEast Un,2876,6,4,3,7,10,15,-5,15
Chennaiyin,2876,7,3,6,5,15,21,-6,15
FC Pune City,2876,8,4,3,7,13,20,-7,15
Mumbai City,2877,1,6,5,3,18,10,8,23
Delhi Dynamo,2877,2,5,6,3,25,20,5,21
Kerala Blast,2877,3,5,5,4,13,15,-2,20
NorthEast Un,2877,4,5,4,5,14,11,3,19
Kolkata,2877,5,4,7,3,18,17,1,19
FC Goa,2877,6,5,2,7,13,18,-5,17
Chennaiyin,2877,7,3,6,5,14,19,-5,15
FC Pune City,2877,8,4,3,7,13,18,-5,15
Mumbai City,2878,1,7,4,3,20,9,11,25
FC Goa,2878,2,6,2,6,16,17,-1,20
Kolkata,2878,3,4,7,3,16,17,-1,19
Delhi Dynamo,2878,4,4,6,4,26,23,3,18
FC Pune City,2878,5,4,5,5,15,17,-2,17
Chennaiyin,2878,6,4,5,5,16,19,-3,17
Kerala Blast,2878,7,4,5,5,10,15,-5,17
NorthEast Un,2878,8,4,4,6,11,13,-2,16
Mumbai City,2879,1,6,5,3,18,10,8,23
Delhi Dynamo,2879,2,5,6,3,29,21,8,21
Kolkata,2879,3,5,6,3,21,15,6,21
NorthEast Un,2879,4,6,2,6,15,12,3,20
FC Pune City,2879,5,5,3,6,16,18,-2,18
Kerala Blast,2879,6,5,3,6,10,19,-9,18
FC Goa,2879,7,5,2,7,12,20,-8,17
Chennaiyin,2879,8,3,5,6,14,20,-6,14
Delhi Dynamo,2880,1,6,6,2,28,17,11,24
Mumbai City,2880,2,6,4,4,17,12,5,22
NorthEast Un,2880,3,6,3,5,12,10,2,21
Kolkata,2880,4,4,8,2,17,14,3,20
FC Pune City,2880,5,5,4,5,14,14,0,19
Kerala Blast,2880,6,4,4,6,11,18,-7,16
Chennaiyin,2880,7,3,6,5,15,20,-5,15
FC Goa,2880,8,3,3,8,11,20,-9,12
Mumbai City,2881,1,7,4,3,17,8,9,25
NorthEast Un,2881,2,6,3,5,16,11,5,21
FC Pune City,2881,3,6,3,5,19,17,2,21
Delhi Dynamo,2881,4,5,5,4,26,19,7,20
Kolkata,2881,5,4,6,4,19,18,1,18
Chennaiyin,2881,6,4,5,5,15,20,-5,17
Kerala Blast,2881,7,4,4,6,11,20,-9,16
FC Goa,2881,8,4,2,8,11,21,-10,14
Mumbai City,2882,1,6,5,3,17,9,8,23
FC Pune City,2882,2,6,3,5,17,14,3,21
Chennaiyin,2882,3,5,5,4,19,20,-1,20
Delhi Dynamo,2882,4,4,7,3,23,18,5,19
Kolkata,2882,5,4,7,3,17,17,0,19
NorthEast Un,2882,6,5,3,6,13,13,0,18
Kerala Blast,2882,7,4,4,6,11,19,-8,16
FC Goa,2882,8,3,4,7,13,20,-7,13
Mumbai City,2883,1,6,5,3,16,8,8,23
Kerala Blast,2883,2,6,3,5,15,17,-2,21
NorthEast Un,2883,3,6,2,6,14,16,-2,20
Delhi Dynamo,2883,4,4,7,3,23,18,5,19
Kolkata,2883,5,4,6,4,19,18,1,18
Chennaiyin,2883,6,4,6,4,18,17,1,18
FC Goa,2883,7,4,4,6,12,17,-5,16
FC Pune City,2883,8,4,3,7,14,20,-6,15
Mumbai City,2884,1,7,4,3,20,10,10,25
Delhi Dynamo,2884,2,5,6,3,28,22,6,21
NorthEast Un,2884,3,6,2,6,12,11,1,20
FC Pune City,2884,4,5,4,5,16,16,0,19
Kerala Blast,2884,5,4,5,5,11,16,-5,17
Kolkata,2884,6,3,7,4,15,18,-3,16
FC Goa,2884,7,4,4,6,13,17,-4,16
Chennaiyin,2884,8,3,6,5,13,18,-5,15
Kolkata,2885,1,6,6,2,21,13,8,24
Mumbai City,2885,2,6,5,3,17,9,8,23
Delhi Dynamo,2885,3,5,6,3,27,17,10,21
NorthEast Un,2885,4,6,3,5,12,10,2,21
FC Pune City,2885,5,5,3,6,15,20,-5,18
Kerala Blast,2885,6,4,4,6,10,16,-6,16
Chennaiyin,2885,7,3,5,6,15,22,-7,14
FC Goa,2885,8,4,2,8,12,22,-10,14
Kerala Blast,2886,1,7,3,4,16,14,2,24
Mumbai City,2886,2,6,5,3,17,9,8,23
NorthEast Un,2886,3,6,2,6,14,12,2,20
Delhi Dynamo,2886,4,4,6,4,23,18,5,18
FC Goa,2886,5,5,3,6,10,14,-4,18
Kolkata,2886,6,3,7,4,13,15,-2,16
FC Pune City,2886,7,4,4,6,13,18,-5,16
Chennaiyin,2886,8,3,6,5,14,20,-6,15
Mumbai City,2887,1,7,4,3,18,9,9,25
Delhi Dynamo,2887,2,5,6,3,26,18,8,21
Kolkata,2887,3,5,6,3,18,15,3,21
Kerala Blast,2887,4,5,5,4,10,13,-3,20
NorthEast Un,2887,5,5,4,5,11,10,1,19
Chennaiyin,2887,6,4,5,5,15,18,-3,17
FC Pune City,2887,7,4,4,6,13,17,-4,16
FC Goa,2887,8,3,2,9,10,21,-11,11
Delhi Dynamo,2888,1,6,5,3,25,15,10,23
Mumbai City,2888,2,6,4,4,16,10,6,22
FC Pune City,2888,3,5,4,5,14,15,-1,19
Kerala Blast,2888,4,5,4,5,15,17,-2,19
Chennaiyin,2888,5,4,6,4,16,18,-2,18
NorthEast Un,2888,6,5,2,7,11,14,-3,17
Kolkata,2888,7,3,7,4,14,17,-3,16
FC Goa,2888,8,4,4,6,10,15,-5,16
Mumbai City,2889,1,7,4,3,18,9,9,25
Delhi Dynamo,2889,2,5,5,4,24,20,4,20
NorthEast Un,2889,3,5,4,5,13,10,3,19
Kolkata,2889,4,4,7,3,18,19,-1,19
Chennaiyin,2889,5,4,6,4,14,17,-3,18
FC Pune City,2889,5,5,3,6,14,17,-3,18
Kerala Blast,2889,7,4,5,5,10,16,-6,17
FC Goa,2889,8,4,2,8,14,17,-3,14
Mumbai City,2890,1,7,4,3,18,8,10,25
Delhi Dynamo,2890,2,6,5,3,24,17,7,23
Kolkata,2890,3,5,7,2,17,12,5,22
NorthEast Un,2890,4,6,2,6,12,11,1,20
FC Pune City,2890,5,5,3,6,15,16,-1,18
Chennaiyin,2890,6,4,5,5,14,18,-4,17
Kerala Blast,2890,7,4,3,7,11,21,-10,15
FC Goa,2890,8,3,3,8,9,17,-8,12
Mumbai City,2891,1,6,5,3,18,10,8,23
Kerala Blast,2891,2,6,4,4,16,16,0,22
Kolkata,2891,3,4,8,2,17,15,2,20
NorthEast Un,2891,4,6,2,6,13,13,0,20
Delhi Dynamo,2891,5,4,7,3,25,19,6,19
FC Goa,2891,6,4,4,6,15,18,-3,16
FC Pune City,2891,7,4,3,7,14,19,-5,15
Chennaiyin,2891,8,3,5,6,15,23,-8,14
Mumbai City,2892,1,6,4,4,18,11,7,22
Kerala Blast,2892,2,6,4,4,14,15,-1,22
Delhi Dynamo,2892,3,5,5,4,25,20,5,20
NorthEast Un,2892,4,6,2,6,12,11,1,20
Kolkata,2892,5,4,6,4,15,16,-1,18
Chennaiyin,2892,6,4,5,5,14,18,-4,17
FC Goa,2892,7,5,2,7,11,15,-4,17
FC Pune City,2892,8,4,4,6,13,16,-3,16
Mumbai City,2893,1,7,4,3,20,9,11,25
Delhi Dynamo,2893,2,6,5,3,26,18,8,23
Kolkata,2893,3,4,7,3,16,15,1,19
FC Pune City,2893,4,5,4,5,13,14,-1,19
Kerala Blast,2893,5,5,4,5,12,16,-4,19
Chennaiyin,2893,6,4,6,4,17,19,-2,18
NorthEast Un,2893,7,4,2,8,11,15,-4,14
FC Goa,2893,8,3,4,7,10,19,-9,13
Kolkata,2894,1,6,6,2,21,13,8,24
Mumbai City,2894,2,6,4,4,16,9,7,22
Delhi Dynamo,2894,3,5,6,3,23,16,7,21
NorthEast Un,2894,4,5,3,6,11,12,-1,18
Chennaiyin,2894,5,4,6,4,16,18,-2,18
FC Pune City,2894,6,5,3,6,14,17,-3,18
FC Goa,2894,7,4,3,7,10,17,-7,15
Kerala Blast,2894,8,4,3,7,10,19,-9,15
Mumbai City,2895,1,7,4,3,19,10,9,25
Kolkata,2895,2,5,6,3,18,14,4,21
Delhi Dynamo,2895,3,5,5,4,27,19,8,20
Kerala Blast,2895,4,5,4,5,11,16,-5,19
NorthEast Un,2895,5,5,3,6,10,10,0,18
FC Goa,2895,6,5,2,7,13,20,-7,17
FC Pune City,2895,7,4,4,6,13,17,-4,16
Chennaiyin,2895,8,3,6,5,14,19,-5,15
Mumbai City,2896,1,7,4,3,19,9,10,25
NorthEast Un,2896,2,7,2,5,15,9,6,23
Kerala Blast,2896,3,6,3,5,13,17,-4,21
Delhi Dynamo,2896,4,5,5,4,25,20,5,20
Kolkata,2896,5,3,8,3,16,16,0,17
FC Pune City,2896,6,4,4,6,15,18,-3,16
Chennaiyin,2896,7,3,6,5,14,20,-6,15
FC Goa,2896,8,3,4,7,10,18,-8,13
Mumbai City,2897,1,7,4,3,17,8,9,25
Delhi Dynamo,2897,2,5,6,3,24,16,8,21
NorthEast Un,2897,3,6,3,5,12,10,2,21
FC Pune City,2897,4,5,4,5,16,15,1,19
Kerala Blast,2897,5,5,4,5,12,16,-4,19
Kolkata,2897,6,4,6,4,16,17,-1,18
Chennaiyin,2897,7,4,5,5,17,19,-2,17
FC Goa,2897,8,3,2,9,9,22,-13,11
Mumbai City,2898,1,7,4,3,17,8,9,25
Kerala Blast,2898,2,6,4,4,15,17,-2,22
Delhi Dynamo,2898,3,5,5,4,24,17,7,20
Chennaiyin,2898,4,5,5,4,17,18,-1,20
Kolkata,2898,5,4,6,4,20,18,2,18
NorthEast Un,2898,6,5,2,7,13,15,-2,17
FC Pune City,2898,7,4,4,6,14,19,-5,16
FC Goa,2898,8,4,2,8,10,18,-8,14
Mumbai City,2899,1,6,5,3,16,8,8,23
Kolkata,2899,2,5,6,3,17,14,3,21
Kerala Blast,2899,3,6,3,5,14,18,-4,21
NorthEast Un,2899,4,6,2,6,13,10,3,20
Chennaiyin,2899,5,5,5,4,16,18,-2,20
Delhi Dynamo,2899,6,4,6,4,22,17,5,18
FC Pune City,2899,7,4,3,7,14,20,-6,15
FC Goa,2899,8,4,2,8,11,18,-7,14
Delhi Dynamo,2900,1,6,5,3,26,16,10,23
Mumbai City,2900,2,6,4,4,17,10,7,22
Kolkata,2900,3,5,6,3,18,14,4,21
Kerala Blast,2900,4,6,3,5,14,16,-2,21
Chennaiyin,2900,5,4,5,5,16,19,-3,17
NorthEast Un,2900,6,5,2,7,10,13,-3,17
FC Goa,2900,7,5,2,7,11,18,-7,17
FC Pune City,2900,8,4,3,7,13,19,-6,15
NorthEast Un,2901,1,7,2,5,17,11,6,23
Mumbai City,2901,2,6,4,4,17,11,6,22
Delhi Dynamo,2901,3,5,6,3,25,19,6,21
Kolkata,2901,4,4,8,2,19,17,2,20
FC Pune City,2901,5,4,5,5,15,17,-2,17
Chennaiyin,2901,6,4,5,5,17,21,-4,17
Kerala Blast,2901,7,4,5,5,14,19,-5,17
FC Goa,2901,8,3,3,8,12,21,-9,12
Mumbai City,2902,1,7,4,3,19,9,10,25
Kolkata,2902,2,5,7,2,17,12,5,22
Kerala Blast,2902,3,5,5,4,12,15,-3,20
Delhi Dynamo,2902,4,4,6,4,24,20,4,18
NorthEast Un,2902,5,5,3,6,12,12,0,18
Chennaiyin,2902,6,4,5,5,15,18,-3,17
FC Pune City,2902,7,4,4,6,13,16,-3,16
FC Goa,2902,8,4,2,8,10,20,-10,14
Mumbai City,2903,1,7,4,3,19,8,11,25
NorthEast Un,2903,2,6,2,6,15,11,4,20
Kolkata,2903,3,4,8,2,15,13,2,20
FC Goa,2903,4,5,3,6,12,15,-3,18
Kerala Blast,2903,5,5,3,6,11,17,-6,18
Delhi Dynamo,2903,6,4,5,5,22,23,-1,17
Chennaiyin,2903,7,4,5,5,14,18,-4,17
FC Pune City,2903,8,4,4,6,13,16,-3,16
Mumbai City,2904,1,6,5,3,18,10,8,23
Delhi Dynamo,2904,2,5,6,3,26,20,6,21
Kolkata,2904,3,4,8,2,16,14,2,20
Kerala Blast,2904,4,5,5,4,12,14,-2,20
NorthEast Un,2904,5,5,3,6,13,11,2,18
Chennaiyin,2904,6,4,6,4,15,18,-3,18
FC Pune City,2904,7,4,4,6,14,18,-4,16
FC Goa,2904,8,3,3,8,10,19,-9,12
Kolkata,2905,1,6,6,2,19,13,6,24
Mumbai City,2905,2,6,5,3,16,8,8,23
Delhi Dynamo,2905,3,4,8,2,23,16,7,20
NorthEast Un,2905,4,5,4,5,13,11,2,19
Kerala Blast,2905,5,5,4,5,12,17,-5,19
FC Pune City,2905,6,4,3,7,12,17,-5,15
FC Goa,2905,7,4,3,7,12,18,-6,15
Chennaiyin,2905,8,3,5,6,13,20,-7,14
Mumbai City,2906,1,7,4,3,20,9,11,25
Kerala Blast,2906,2,6,4,4,11,13,-2,22
NorthEast Un,2906,3,6,3,5,12,9,3,21
Delhi Dynamo,2906,4,5,5,4,25,20,5,20
FC Pune City,2906,5,5,3,6,14,15,-1,18
FC Goa,2906,6,5,2,7,11,17,-6,17
Kolkata,2906,7,3,6,5,13,16,-3,15
Chennaiyin,2906,8,3,5,6,13,20,-7,14
Delhi Dynamo,2907,1,6,5,3,28,19,9,23
Mumbai City,2907,2,6,4,4,18,11,7,22
NorthEast Un,2907,3,6,3,5,13,10,3,21
Kolkata,2907,4,4,7,3,18,17,1,19
FC Pune City,2907,5,5,3,6,15,16,-1,18
Kerala Blast,2907,6,5,3,6,12,19,-7,18
Chennaiyin,2907,7,3,6,5,13,18,-5,15
FC Goa,2907,8,4,3,7,13,20,-7,15
Mumbai City,2908,1,7,4,3,21,8,13,25
Kolkata,2908,2,5,6,3,20,16,4,21
NorthEast Un,2908,3,6,3,5,12,9,3,21
FC Goa,2908,4,6,2,6,17,16,1,20
Delhi Dynamo,2908,5,4,6,4,21,22,-1,18
FC Pune City,2908,6,4,4,6,13,17,-4,16
Kerala Blast,2908,7,4,4,6,13,21,-8,16
Chennaiyin,2908,8,3,5,6,15,23,-8,14
Mumbai City,2909,1,7,4,3,18,9,9,25
Delhi Dynamo,2909,2,5,5,4,25,18,7,20
Kolkata,2909,3,4,7,3,19,15,4,19
Kerala Blast,2909,4,5,4,5,16,16,0,19
NorthEast Un,2909,5,5,3,6,12,13,-1,18
FC Goa,2909,6,5,3,6,12,16,-4,18
Chennaiyin,2909,7,3,7,4,16,20,-4,16
FC Pune City,2909,8,4,3,7,12,23,-11,15
Delhi Dynamo,2910,1,6,6,2,26,14,12,24
Kolkata,2910,2,6,6,2,20,13,7,24
Mumbai City,2910,3,6,5,3,16,8,8,23
FC Pune City,2910,4,5,3,6,13,15,-2,18
Chennaiyin,2910,5,4,6,4,16,19,-3,18
Kerala Blast,2910,6,5,3,6,11,17,-6,18
NorthEast Un,2910,7,4,2,8,10,16,-6,14
FC Goa,2910,8,3,3,8,9,19,-10,12
Mumbai City,2911,1,6,5,3,18,10,8,23
Delhi Dynamo,2911,2,5,6,3,26,20,6,21
FC Pune City,2911,3,6,3,5,17,16,1,21
Kolkata,2911,4,4,7,3,16,16,0,19
NorthEast Un,2911,5,5,3,6,12,11,1,18
Chennaiyin,2911,6,4,5,5,15,19,-4,17
Kerala Blast,2911,7,4,5,5,10,15,-5,17
FC Goa,2911,8,4,2,8,12,19,-7,14
Mumbai City,2912,1,7,4,3,18,8,10,25
Delhi Dynamo,2912,2,6,5,3,23,16,7,23
Kolkata,2912,3,5,6,3,22,13,9,21
NorthEast Un,2912,4,5,3,6,11,10,1,18
FC Pune City,2912,5,5,3,6,13,21,-8,18
Chennaiyin,2912,6,3,7,4,14,18,-4,16
FC Goa,2912,7,4,3,7,10,16,-6,15
Kerala Blast,2912,8,4,3,7,9,18,-9,15
Mumbai City,2913,1,6,4,4,16,9,7,22
Kerala Blast,2913,2,6,3,5,14,17,-3,21
Delhi Dynamo,2913,3,5,5,4,22,18,4,20
FC Goa,2913,4,6,2,6,15,17,-2,20
Kolkata,2913,5,4,6,4,16,16,0,18
FC Pune City,2913,6,5,3,6,15,15,0,18
NorthEast Un,2913,7,5,3,6,13,14,-1,18
Chennaiyin,2913,8,3,6,5,15,20,-5,15
Mumbai City,2914,1,7,4,3,17,8,9,25
NorthEast Un,2914,2,7,2,5,18,10,8,23
Kolkata,2914,3,5,7,2,17,14,3,22
Delhi Dynamo,2914,4,5,5,4,24,22,2,20
FC Pune City,2914,5,4,4,6,13,16,-3,16
Kerala Blast,2914,6,4,4,6,11,17,-6,16
Chennaiyin,2914,7,3,6,5,14,20,-6,15
FC Goa,2914,8,3,4,7,11,18,-7,13
Delhi Dynamo,2915,1,6,6,2,29,17,12,24
Kolkata,2915,2,6,6,2,17,13,4,24
Mumbai City,2915,3,6,5,3,17,9,8,23
NorthEast Un,2915,4,5,3,6,12,14,-2,18
Kerala Blast,2915,5,5,3,6,13,17,-4,18
FC Pune City,2915,6,4,3,7,12,17,-5,15
Chennaiyin,2915,7,3,6,5,14,20,-6,15
FC Goa,2915,8,4,2,8,12,19,-7,14
Delhi Dynamo,2916,1,7,5,2,31,18,13,26
Kolkata,2916,2,6,6,2,18,14,4,24
Mumbai City,2916,3,6,4,4,16,10,6,22
NorthEast Un,2916,4,6,2,6,15,16,-1,20
FC Pune City,2916,5,4,4,6,12,15,-3,16
Kerala Blast,2916,6,4,4,6,11,17,-6,16
FC Goa,2916,7,4,2,8,15,21,-6,14
Chennaiyin,2916,8,3,5,6,16,23,-7,14
Delhi Dynamo,2917,1,7,5,2,27,15,12,26
Mumbai City,2917,2,6,4,4,16,10,6,22
Kerala Blast,2917,3,6,3,5,13,16,-3,21
Kolkata,2917,4,4,6,4,16,16,0,18
FC Pune City,2917,5,5,3,6,14,16,-2,18
Chennaiyin,2917,6,4,5,5,15,19,-4,17
FC Goa,2917,7,5,2,7,11,17,-6,17
NorthEast Un,2917,8,4,2,8,11,14,-3,14
Mumbai City,2918,1,6,5,3,16,8,8,23
Delhi Dynamo,2918,2,5,6,3,25,18,7,21
FC Pune City,2918,3,6,3,5,17,14,3,21
Kerala Blast,2918,4,6,3,5,13,19,-6,21
FC Goa,2918,5,6,2,6,14,15,-1,20
NorthEast Un,2918,6,5,2,7,12,14,-2,17
Kolkata,2918,7,3,6,5,15,18,-3,15
Chennaiyin,2918,8,3,5,6,14,20,-6,14
Mumbai City,2919,1,7,4,3,18,8,10,25
Kolkata,2919,2,6,6,2,19,15,4,24
Delhi Dynamo,2919,3,5,5,4,24,18,6,20
NorthEast Un,2919,4,6,2,6,14,14,0,20
Chennaiyin,2919,5,5,5,4,17,18,-1,20
FC Pune City,2919,6,4,4,6,15,18,-3,16
Kerala Blast,2919,7,4,4,6,11,17,-6,16
FC Goa,2919,8,3,2,9,9,19,-10,11
Mumbai City,2920,1,7,4,3,19,8,11,25
Kerala Blast,2920,2,6,4,4,16,18,-2,22
Delhi Dynamo,2920,3,5,6,3,24,18,6,21
Kolkata,2920,4,4,6,4,16,16,0,18
Chennaiyin,2920,5,4,6,4,17,20,-3,18
FC Pune City,2920,6,4,4,6,16,20,-4,16
NorthEast Un,2920,7,4,3,7,11,13,-2,15
FC Goa,2920,8,4,3,7,14,20,-6,15
Mumbai City,2921,1,7,4,3,19,8,11,25
Kerala Blast,2921,2,6,4,4,14,15,-1,22
Kolkata,2921,3,4,8,2,19,17,2,20
FC Goa,2921,4,5,3,6,14,18,-4,18
Delhi Dynamo,2921,5,4,5,5,23,21,2,17
NorthEast Un,2921,6,5,2,7,14,15,-1,17
Chennaiyin,2921,7,4,5,5,16,20,-4,17
FC Pune City,2921,8,4,3,7,13,18,-5,15
Delhi Dynamo,2922,1,5,7,2,24,16,8,22
Mumbai City,2922,2,6,4,4,17,10,7,22
Kerala Blast,2922,3,6,3,5,14,15,-1,21
Chennaiyin,2922,4,5,5,4,19,18,1,20
Kolkata,2922,5,4,7,3,18,17,1,19
NorthEast Un,2922,6,5,3,6,10,12,-2,18
FC Pune City,2922,7,4,3,7,13,19,-6,15
FC Goa,2922,8,3,4,7,12,20,-8,13
Delhi Dynamo,2923,1,7,5,2,25,14,11,26
Mumbai City,2923,2,6,4,4,16,9,7,22
Kerala Blast,2923,3,6,4,4,11,13,-2,22
FC Pune City,2923,4,5,4,5,14,15,-1,19
Chennaiyin,2923,5,4,5,5,18,22,-4,17
FC Goa,2923,6,5,2,7,13,17,-4,17
Kolkata,2923,7,3,6,5,15,17,-2,15
NorthEast Un,2923,8,4,2,8,11,16,-5,14
Mumbai City,2924,1,6,5,3,17,9,8,23
Delhi Dynamo,2924,2,5,6,3,24,18,6,21
Kolkata,2924,3,5,6,3,17,14,3,21
NorthEast Un,2924,4,6,2,6,13,11,2,20
Chennaiyin,2924,5,5,5,4,16,18,-2,20
Kerala Blast,2924,6,5,3,6,10,16,-6,18
FC Pune City,2924,7,4,3,7,12,17,-5,15
FC Goa,2924,8,4,2,8,11,17,-6,14
Mumbai City,2925,1,7,4,3,18,8,10,25
Kolkata,2925,2,5,7,2,17,13,4,22
Kerala Blast,2925,3,6,3,5,14,16,-2,21
NorthEast Un,2925,4,6,2,6,15,10,5,20
Delhi Dynamo,2925,5,5,5,4,23,20,3,20
Chennaiyin,2925,6,4,5,5,15,20,-5,17
FC Pune City,2925,7,4,4,6,13,17,-4,16
FC Goa,2925,8,3,2,9,9,20,-11,11
Mumbai City,2926,1,7,4,3,19,8,11,25
Kerala Blast,2926,2,7,3,4,14,13,1,24
NorthEast Un,2926,3,5,3,6,12,12,0,18
Chennaiyin,2926,4,4,6,4,15,18,-3,18
FC Pune City,2926,5,5,3,6,14,18,-4,18
Delhi Dynamo,2926,6,4,5,5,22,20,2,17
FC Goa,2926,7,5,2,7,11,15,-4,17
Kolkata,2926,8,3,6,5,14,17,-3,15
Mumbai City,2927,1,6,5,3,16,8,8,23
Delhi Dynamo,2927,2,5,6,3,23,16,7,21
Kolkata,2927,3,4,7,3,18,16,2,19
NorthEast Un,2927,4,5,3,6,12,12,0,18
FC Goa,2927,5,5,3,6,10,14,-4,18
FC Pune City,2927,6,4,5,5,14,16,-2,17
Kerala Blast,2927,7,4,5,5,11,17,-6,17
Chennaiyin,2927,8,3,6,5,13,18,-5,15
Mumbai City,2928,1,7,4,3,18,9,9,25
Delhi Dynamo,2928,2,5,6,3,26,18,8,21
Kolkata,2928,3,4,8,2,17,15,2,20
Kerala Blast,2928,4,5,5,4,14,16,-2,20
Chennaiyin,2928,5,4,5,5,15,19,-4,17
NorthEast Un,2928,6,4,4,6,12,13,-1,16
FC Pune City,2928,7,4,4,6,14,18,-4,16
FC Goa,2928,8,4,2,8,11,19,-8,14
Mumbai City,2929,1,6,5,3,17,9,8,23
Kerala Blast,2929,2,6,4,4,11,13,-2,22
NorthEast Un,2929,3,6,2,6,11,10,1,20
Delhi Dynamo,2929,4,4,7,3,22,16,6,19
FC Pune City,2929,5,5,3,6,13,15,-2,18
Kolkata,2929,6,3,8,3,14,14,0,17
FC Goa,2929,7,4,4,6,11,15,-4,16
Chennaiyin,2929,8,3,5,6,13,20,-7,14
Mumbai City,2930,1,6,5,3,17,9,8,23
NorthEast Un,2930,2,6,3,5,14,11,3,21
Delhi Dynamo,2930,3,4,7,3,24,18,6,19
Kolkata,2930,4,4,7,3,17,17,0,19
Kerala Blast,2930,5,5,4,5,14,19,-5,19
FC Goa,2930,6,4,4,6,16,19,-3,16
Chennaiyin,2930,7,3,7,4,15,19,-4,16
FC Pune City,2930,8,4,3,7,13,18,-5,15
Mumbai City,2931,1,6,5,3,18,10,8,23
Delhi Dynamo,2931,2,5,6,3,28,21,7,21
Kolkata,2931,3,5,6,3,19,15,4,21
Kerala Blast,2931,4,6,3,5,16,17,-1,21
NorthEast Un,2931,5,6,2,6,17,15,2,20
FC Goa,2931,6,5,2,7,12,18,-6,17
FC Pune City,2931,7,4,3,7,14,22,-8,15
Chennaiyin,2931,8,3,5,6,16,22,-6,14
Delhi Dynamo,2932,1,6,6,2,27,17,10,24
Mumbai City,2932,2,6,4,4,16,10,6,22
Kolkata,2932,3,5,6,3,15,13,2,21
NorthEast Un,2932,4,6,2,6,13,10,3,20
FC Pune City,2932,5,5,4,5,14,15,-1,19
Kerala Blast,2932,6,4,4,6,10,18,-8,16
FC Goa,2932,7,4,3,7,14,19,-5,15
Chennaiyin,2932,8,3,5,6,14,21,-7,14
Kerala Blast,2933,1,7,3,4,16,16,0,24
Mumbai City,2933,2,6,4,4,17,10,7,22
Delhi Dynamo,2933,3,5,6,3,24,18,6,21
NorthEast Un,2933,4,5,3,6,13,12,1,18
Kolkata,2933,5,3,8,3,16,17,-1,17
FC Pune City,2933,6,4,4,6,13,16,-3,16
FC Goa,2933,7,4,4,6,12,17,-5,16
Chennaiyin,2933,8,3,6,5,16,21,-5,15
Delhi Dynamo,2934,1,5,7,2,23,15,8,22
Mumbai City,2934,2,6,4,4,16,9,7,22
Kolkata,2934,3,4,8,2,18,15,3,20
Chennaiyin,2934,4,5,5,4,16,17,-1,20
FC Pune City,2934,5,5,4,5,17,15,2,19
NorthEast Un,2934,6,4,4,6,10,11,-1,16
Kerala Blast,2934,7,4,4,6,11,21,-10,16
FC Goa,2934,8,3,4,7,8,16,-8,13
Mumbai City,2935,1,7,4,3,18,9,9,25
Kerala Blast,2935,2,6,4,4,14,13,1,22
Kolkata,2935,3,4,8,2,15,13,2,20
Delhi Dynamo,2935,4,4,6,4,24,19,5,18
Chennaiyin,2935,5,4,5,5,15,19,-4,17
NorthEast Un,2935,6,5,2,7,11,15,-4,17
FC Goa,2935,7,4,4,6,12,16,-4,16
FC Pune City,2935,8,4,3,7,12,17,-5,15
Delhi Dynamo,2936,1,7,5,2,29,16,13,26
Mumbai City,2936,2,6,4,4,16,11,5,22
Kolkata,2936,3,5,6,3,18,16,2,21
NorthEast Un,2936,4,6,2,6,15,13,2,20
FC Pune City,2936,5,5,4,5,15,16,-1,19
Kerala Blast,2936,6,4,4,6,11,19,-8,16
Chennaiyin,2936,7,3,6,5,14,19,-5,15
FC Goa,2936,8,3,3,8,10,18,-8,12
Delhi Dynamo,2937,1,6,5,3,25,16,9,23
Mumbai City,2937,2,6,4,4,17,10,7,22
Kerala Blast,2937,3,6,4,4,14,16,-2,22
FC Pune City,2937,4,5,3,6,16,16,0,18
NorthEast Un,2937,5,5,3,6,12,12,0,18
Chennaiyin,2937,6,4,5,5,16,20,-4,17
Kolkata,2937,7,3,7,4,15,18,-3,16
FC Goa,2937,8,4,3,7,11,18,-7,15
Mumbai City,2938,1,6,4,4,16,10,6,22
Delhi Dynamo,2938,2,5,5,4,25,19,6,20
Kolkata,2938,3,4,8,2,17,14,3,20
Kerala Blast,2938,4,5,4,5,14,15,-1,19
Chennaiyin,2938,5,4,6,4,14,17,-3,18
FC Pune City,2938,5,5,3,6,14,17,-3,18
NorthEast Un,2938,7,5,2,7,11,15,-4,17
FC Goa,2938,8,4,4,6,13,17,-4,16
Kolkata,2939,1,6,6,2,19,12,7,24
Mumbai City,2939,2,6,4,4,16,10,6,22
Delhi Dynamo,2939,3,5,6,3,23,15,8,21
Kerala Blast,2939,4,6,3,5,13,16,-3,21
NorthEast Un,2939,5,6,2,6,11,11,0,20
Chennaiyin,2939,6,4,5,5,15,19,-4,17
FC Pune City,2939,7,4,3,7,12,18,-6,15
FC Goa,2939,8,3,3,8,9,17,-8,12
Kolkata,2940,1,6,6,2,18,12,6,24
Delhi Dynamo,2940,2,6,5,3,25,18,7,23
Mumbai City,2940,3,6,4,4,16,9,7,22
NorthEast Un,2940,4,5,3,6,12,12,0,18
Chennaiyin,2940,5,4,6,4,15,17,-2,18
FC Pune City,2940,6,5,3,6,13,15,-2,18
Kerala Blast,2940,7,4,4,6,9,15,-6,16
FC Goa,2940,8,3,3,8,9,19,-10,12
Mumbai City,2941,1,7,4,3,20,10,10,25
Kolkata,2941,2,6,6,2,18,12,6,24
Delhi Dynamo,2941,3,5,5,4,27,20,7,20
FC Pune City,2941,4,5,3,6,14,17,-3,18
Kerala Blast,2941,5,5,3,6,11,17,-6,18
FC Goa,2941,6,5,2,7,13,17,-4,17
Chennaiyin,2941,7,4,5,5,16,21,-5,17
NorthEast Un,2941,8,4,2,8,10,15,-5,14
Mumbai City,2942,1,6,5,3,16,8,8,23
Kerala Blast,2942,2,6,4,4,15,15,0,22
Delhi Dynamo,2942,3,4,7,3,22,16,6,19
Kolkata,2942,4,4,7,3,16,16,0,19
Chennaiyin,2942,5,4,6,4,16,19,-3,18
NorthEast Un,2942,6,4,4,6,12,13,-1,16
FC Pune City,2942,7,4,4,6,13,17,-4,16
FC Goa,2942,8,4,3,7,10,16,-6,15
Delhi Dynamo,2943,1,7,5,2,26,16,10,26
Mumbai City,2943,2,6,4,4,16,9,7,22
NorthEast Un,2943,3,6,2,6,15,13,2,20
Kolkata,2943,4,4,7,3,17,15,2,19
FC Pune City,2943,5,5,4,5,14,15,-1,19
Chennaiyin,2943,6,4,5,5,15,20,-5,17
Kerala Blast,2943,7,4,3,7,10,19,-9,15
FC Goa,2943,8,4,2,8,11,17,-6,14
Mumbai City,2944,1,7,4,3,18,9,9,25
Kerala Blast,2944,2,6,3,5,14,15,-1,21
Kolkata,2944,3,4,8,2,15,13,2,20
FC Goa,2944,4,5,3,6,13,16,-3,18
Delhi Dynamo,2944,5,4,5,5,23,20,3,17
NorthEast Un,2944,6,5,2,7,12,13,-1,17
Chennaiyin,2944,7,4,5,5,17,21,-4,17
FC Pune City,2944,8,4,4,6,12,17,-5,16
Mumbai City,2945,1,7,4,3,20,8,12,25
Kolkata,2945,2,5,6,3,18,18,0,21
Delhi Dynamo,2945,3,4,7,3,24,21,3,19
NorthEast Un,2945,4,5,4,5,13,12,1,19
FC Goa,2945,5,5,3,6,14,15,-1,18
Kerala Blast,2945,6,5,3,6,13,17,-4,18
Chennaiyin,2945,7,3,6,5,14,19,-5,15
FC Pune City,2945,8,4,3,7,12,18,-6,15
Mumbai City,2946,1,7,4,3,21,10,11,25
Kolkata,2946,2,5,7,2,18,13,5,22
Delhi Dynamo,2946,3,5,5,4,27,23,4,20
Chennaiyin,2946,4,5,5,4,18,19,-1,20
FC Pune City,2946,5,5,3,6,14,17,-3,18
NorthEast Un,2946,6,5,2,7,11,12,-1,17
FC Goa,2946,7,4,3,7,14,21,-7,15
Kerala Blast,2946,8,4,3,7,10,18,-8,15
Delhi Dynamo,2947,1,7,5,2,26,16,10,26
Mumbai City,2947,2,6,4,4,17,10,7,22
FC Pune City,2947,3,6,3,5,17,17,0,21
Kolkata,2947,4,4,6,4,18,18,0,18
Kerala Blast,2947,5,5,3,6,13,18,-5,18
FC Goa,2947,6,5,2,7,12,17,-5,17
NorthEast Un,2947,7,4,3,7,10,12,-2,15
Chennaiyin,2947,8,3,6,5,13,18,-5,15
Delhi Dynamo,2948,1,6,6,2,26,17,9,24
Mumbai City,2948,2,6,4,4,17,10,7,22
Kerala Blast,2948,3,6,4,4,19,20,-1,22
Kolkata,2948,4,4,6,4,17,19,-2,18
Chennaiyin,2948,5,4,6,4,15,18,-3,18
NorthEast Un,2948,6,4,4,6,14,15,-1,16
FC Pune City,2948,7,4,3,7,15,19,-4,15
FC Goa,2948,8,4,3,7,11,16,-5,15
Mumbai City,2949,1,7,4,3,20,8,12,25
NorthEast Un,2949,2,7,2,5,15,12,3,23
Kerala Blast,2949,3,5,4,5,14,17,-3,19
Delhi Dynamo,2949,4,4,5,5,23,22,1,17
FC Pune City,2949,5,4,5,5,12,14,-2,17
Chennaiyin,2949,6,4,5,5,14,18,-4,17
FC Goa,2949,7,5,2,7,12,16,-4,17
Kolkata,2949,8,3,7,4,14,17,-3,16
Mumbai City,2950,1,7,4,3,19,8,11,25
Delhi Dynamo,2950,2,5,5,4,25,20,5,20
Kolkata,2950,3,4,7,3,14,14,0,19
NorthEast Un,2950,4,5,3,6,16,16,0,18
FC Goa,2950,5,5,3,6,13,16,-3,18
FC Pune City,2950,6,4,5,5,13,15,-2,17
Kerala Blast,2950,7,4,5,5,11,16,-5,17
Chennaiyin,2950,8,3,6,5,17,23,-6,15
Mumbai City,2951,1,7,4,3,19,8,11,25
Delhi Dynamo,2951,2,5,6,3,24,18,6,21
Kerala Blast,2951,3,6,3,5,12,16,-4,21
Kolkata,2951,4,4,7,3,17,15,2,19
FC Pune City,2951,5,5,4,5,17,17,0,19
Chennaiyin,2951,6,4,5,5,16,22,-6,17
NorthEast Un,2951,7,4,3,7,11,13,-2,15
FC Goa,2951,8,4,2,8,12,19,-7,14
Mumbai City,2952,1,6,5,3,16,8,8,23
NorthEast Un,2952,2,6,3,5,13,9,4,21
Delhi Dynamo,2952,3,4,7,3,22,17,5,19
Kerala Blast,2952,4,5,4,5,11,14,-3,19
Kolkata,2952,5,4,6,4,18,15,3,18
FC Goa,2952,6,5,3,6,11,15,-4,18
FC Pune City,2952,7,5,3,6,13,19,-6,18
Chennaiyin,2952,8,3,5,6,13,20,-7,14
Mumbai City,2953,1,7,4,3,18,8,10,25
Kolkata,2953,2,6,6,2,18,13,5,24
Delhi Dynamo,2953,3,5,5,4,23,19,4,20
Kerala Blast,2953,4,5,4,5,12,15,-3,19
NorthEast Un,2953,5,5,3,6,12,11,1,18
Chennaiyin,2953,6,4,5,5,15,19,-4,17
FC Pune City,2953,7,4,3,7,12,18,-6,15
FC Goa,2953,8,4,2,8,12,19,-7,14
Delhi Dynamo,2954,1,7,5,2,27,16,11,26
Mumbai City,2954,2,6,4,4,16,9,7,22
Kolkata,2954,3,5,7,2,17,14,3,22
Kerala Blast,2954,4,6,3,5,14,16,-2,21
Chennaiyin,2954,5,4,5,5,15,18,-3,17
FC Pune City,2954,6,4,3,7,13,18,-5,15
FC Goa,2954,7,4,3,7,12,19,-7,15
NorthEast Un,2954,8,4,2,8,9,13,-4,14
Mumbai City,2955,1,6,5,3,18,10,8,23
Delhi Dynamo,2955,2,5,7,2,26,17,9,22
Chennaiyin,2955,3,5,5,4,17,18,-1,20
Kerala Blast,2955,4,5,5,4,11,14,-3,20
Kolkata,2955,5,4,6,4,15,15,0,18
NorthEast Un,2955,6,4,4,6,10,12,-2,16
FC Pune City,2955,7,4,4,6,14,17,-3,16
FC Goa,2955,8,4,2,8,10,18,-8,14
Mumbai City,2956,1,6,5,3,17,9,8,23
NorthEast Un,2956,2,7,2,5,16,9,7,23
Delhi Dynamo,2956,3,5,6,3,24,17,7,21
FC Pune City,2956,4,5,4,5,14,15,-1,19
Kerala Blast,2956,5,5,4,5,11,17,-6,19
Kolkata,2956,6,4,6,4,14,14,0,18
Chennaiyin,2956,7,3,6,5,15,21,-6,15
FC Goa,2956,8,3,3,8,10,19,-9,12
Delhi Dynamo,2957,1,6,6,2,30,18,12,24
Mumbai City,2957,2,6,4,4,17,13,4,22
NorthEast Un,2957,3,6,3,5,16,13,3,21
Kolkata,2957,4,5,6,3,17,15,2,21
Kerala Blast,2957,5,5,3,6,12,17,-5,18
Chennaiyin,2957,6,3,6,5,16,21,-5,15
FC Pune City,2957,7,4,3,7,12,17,-5,15
FC Goa,2957,8,4,3,7,14,20,-6,15
Mumbai City,2958,1,6,5,3,17,9,8,23
Delhi Dynamo,2958,2,5,6,3,23,19,4,21
Kerala Blast,2958,3,5,4,5,11,15,-4,19
NorthEast Un,2958,4,5,3,6,14,12,2,18
Kolkata,2958,5,4,6,4,15,16,-1,18
Chennaiyin,2958,6,4,6,4,16,18,-2,18
FC Pune City,2958,7,5,3,6,13,15,-2,18
FC Goa,2958,8,4,3,7,12,17,-5,15
Mumbai City,2959,1,7,4,3,18,9,9,25
Delhi Dynamo,2959,2,5,5,4,25,18,7,20
Kolkata,2959,3,4,7,3,16,15,1,19
NorthEast Un,2959,4,5,4,5,11,10,1,19
FC Pune City,2959,5,5,4,5,14,14,0,19
Kerala Blast,2959,6,4,5,5,11,17,-6,17
Chennaiyin,2959,7,3,7,4,14,18,-4,16
FC Goa,2959,8,3,4,7,10,18,-8,13
Kolkata,2960,1,6,6,2,18,12,6,24
Mumbai City,2960,2,6,4,4,17,10,7,22
Delhi Dynamo,2960,3,5,6,3,25,18,7,21
Kerala Blast,2960,4,6,3,5,11,15,-4,21
NorthEast Un,2960,5,5,3,6,13,12,1,18
Chennaiyin,2960,6,4,5,5,15,19,-4,17
FC Pune City,2960,7,4,3,7,12,17,-5,15
FC Goa,2960,8,4,2,8,9,17,-8,14
Mumbai City,2961,1,7,4,3,17,8,9,25
Delhi Dynamo,2961,2,5,5,4,24,17,7,20
FC Pune City,2961,3,5,4,5,14,15,-1,19
FC Goa,2961,4,5,3,6,14,18,-4,18
Kerala Blast,2961,5,4,6,4,10,14,-4,18
Kolkata,2961,6,3,7,4,14,15,-1,16
NorthEast Un,2961,7,4,4,6,11,13,-2,16
Chennaiyin,2961,8,3,7,4,17,21,-4,16
Mumbai City,2962,1,6,5,3,17,9,8,23
FC Pune City,2962,2,6,3,5,14,14,0,21
Kolkata,2962,3,4,7,3,16,14,2,19
Delhi Dynamo,2962,4,4,6,4,23,19,4,18
NorthEast Un,2962,5,5,3,6,11,10,1,18
Kerala Blast,2962,6,5,3,6,10,16,-6,18
Chennaiyin,2962,7,3,7,4,15,19,-4,16
FC Goa,2962,8,4,4,6,13,18,-5,16
Mumbai City,2963,1,7,4,3,20,11,9,25
Delhi Dynamo,2963,2,6,5,3,31,19,12,23
FC Pune City,2963,3,5,4,5,13,14,-1,19
Kerala Blast,2963,4,5,4,5,14,16,-2,19
Kolkata,2963,5,4,6,4,16,15,1,18
NorthEast Un,2963,6,5,2,7,11,16,-5,17
Chennaiyin,2963,7,3,6,5,14,19,-5,15
FC Goa,2963,8,4,3,7,10,19,-9,15
Mumbai City,2964,1,6,5,3,17,9,8,23
NorthEast Un,2964,2,6,3,5,14,10,4,21
FC Goa,2964,3,6,2,6,14,16,-2,20
Kolkata,2964,4,4,7,3,18,16,2,19
Delhi Dynamo,2964,5,4,6,4,22,17,5,18
FC Pune City,2964,6,4,5,5,14,16,-2,17
Kerala Blast,2964,7,4,5,5,9,15,-6,17
Chennaiyin,2964,8,3,5,6,15,24,-9,14
Mumbai City,2965,1,7,4,3,19,9,10,25
Kerala Blast,2965,2,7,3,4,19,16,3,24
Delhi Dynamo,2965,3,5,5,4,25,21,4,20
Chennaiyin,2965,4,5,5,4,16,18,-2,20
Kolkata,2965,5,4,7,3,17,18,-1,19
NorthEast Un,2965,6,5,2,7,14,15,-1,17
FC Pune City,2965,7,4,3,7,14,18,-4,15
FC Goa,2965,8,3,3,8,8,17,-9,12
Kolkata,2966,1,6,6,2,18,12,6,24
Delhi Dynamo,2966,2,6,5,3,25,17,8,23
Mumbai City,2966,3,6,4,4,16,9,7,22
NorthEast Un,2966,4,6,2,6,13,11,2,20
Kerala Blast,2966,5,5,4,5,13,18,-5,19
FC Pune City,2966,6,4,4,6,15,19,-4,16
Chennaiyin,2966,7,3,5,6,15,21,-6,14
FC Goa,2966,8,4,2,8,11,19,-8,14
Mumbai City,2967,1,7,4,3,18,9,9,25
Kolkata,2967,2,6,6,2,24,14,10,24
Delhi Dynamo,2967,3,5,5,4,23,17,6,20
Chennaiyin,2967,4,5,5,4,18,17,1,20
Kerala Blast,2967,5,5,4,5,14,21,-7,19
NorthEast Un,2967,6,5,2,7,10,14,-4,17
FC Pune City,2967,7,4,4,6,14,19,-5,16
FC Goa,2967,8,3,2,9,9,19,-10,11
Mumbai City,2968,1,6,5,3,17,9,8,23
Delhi Dynamo,2968,2,5,7,2,25,17,8,22
Kerala Blast,2968,3,6,3,5,12,16,-4,21
Kolkata,2968,4,4,6,4,15,16,-1,18
FC Pune City,2968,5,5,3,6,15,17,-2,18
NorthEast Un,2968,6,4,4,6,11,12,-1,16
Chennaiyin,2968,7,3,7,4,17,21,-4,16
FC Goa,2968,8,4,3,7,15,19,-4,15
Mumbai City,2969,1,6,5,3,16,8,8,23
Delhi Dynamo,2969,2,5,7,2,22,14,8,22
Kerala Blast,2969,3,6,4,4,11,13,-2,22
Chennaiyin,2969,4,5,5,4,16,17,-1,20
Kolkata,2969,5,4,7,3,14,14,0,19
FC Pune City,2969,6,4,3,7,12,16,-4,15
FC Goa,2969,7,4,3,7,10,16,-6,15
NorthEast Un,2969,8,4,2,8,9,12,-3,14
Delhi Dynamo,2970,1,6,6,2,26,17,9,24
Mumbai City,2970,2,6,5,3,18,10,8,23
FC Pune City,2970,3,5,4,5,15,16,-1,19
Kolkata,2970,4,3,8,3,14,14,0,17
NorthEast Un,2970,4,5,2,7,14,14,0,17
Chennaiyin,2970,6,4,5,5,17,21,-4,17
FC Goa,2970,7,5,2,7,11,16,-5,17
Kerala Blast,2970,8,4,4,6,10,17,-7,16
Delhi Dynamo,2971,1,5,7,2,25,17,8,22
Mumbai City,2971,2,6,4,4,17,10,7,22
Kolkata,2971,3,5,6,3,17,14,3,21
NorthEast Un,2971,4,5,4,5,12,10,2,19
Kerala Blast,2971,5,5,4,5,12,17,-5,19
FC Goa,2971,6,5,3,6,13,16,-3,18
FC Pune City,2971,7,4,3,7,14,19,-5,15
Chennaiyin,2971,8,3,5,6,14,21,-7,14
Mumbai City,2972,1,6,5,3,17,9,8,23
Kolkata,2972,2,5,7,2,19,16,3,22
Delhi Dynamo,2972,3,4,8,2,26,19,7,20
FC Pune City,2972,4,5,3,6,15,16,-1,18
NorthEast Un,2972,5,5,3,6,12,14,-2,18
Kerala Blast,2972,6,5,3,6,13,17,-4,18
FC Goa,2972,7,4,4,6,16,18,-2,16
Chennaiyin,2972,8,3,5,6,13,22,-9,14
Delhi Dynamo,2973,1,6,6,2,26,17,9,24
Mumbai City,2973,2,6,4,4,17,10,7,22
Kolkata,2973,3,4,7,3,16,16,0,19
Chennaiyin,2973,4,4,6,4,14,17,-3,18
NorthEast Un,2973,5,5,2,7,13,13,0,17
Kerala Blast,2973,6,4,5,5,11,17,-6,17
FC Pune City,2973,7,4,4,6,14,17,-3,16
FC Goa,2973,8,4,4,6,10,14,-4,16
Delhi Dynamo,2974,1,6,6,2,25,15,10,24
Mumbai City,2974,2,6,4,4,17,10,7,22
Kolkata,2974,3,5,6,3,16,15,1,21
Kerala Blast,2974,4,5,4,5,12,17,-5,19
NorthEast Un,2974,5,5,3,6,12,11,1,18
FC Pune City,2974,6,4,4,6,14,17,-3,16
Chennaiyin,2974,7,3,7,4,13,17,-4,16
FC Goa,2974,8,3,4,7,8,15,-7,13
Mumbai City,2975,1,7,4,3,18,9,9,25
Kolkata,2975,2,5,7,2,20,13,7,22
NorthEast Un,2975,3,6,3,5,13,11,2,21
Delhi Dynamo,2975,4,4,6,4,23,18,5,18
FC Goa,2975,5,5,3,6,14,15,-1,18
FC Pune City,2975,6,4,4,6,13,17,-4,16
Kerala Blast,2975,7,4,4,6,11,20,-9,16
Chennaiyin,2975,8,3,5,6,13,22,-9,14
Mumbai City,2976,1,7,4,3,18,8,10,25
Delhi Dynamo,2976,2,6,5,3,25,18,7,23
Kolkata,2976,3,4,8,2,16,14,2,20
FC Pune City,2976,4,5,4,5,15,15,0,19
NorthEast Un,2976,5,5,3,6,12,12,0,18
Kerala Blast,2976,6,4,4,6,10,17,-7,16
Chennaiyin,2976,7,3,6,5,14,19,-5,15
FC Goa,2976,8,3,4,7,11,18,-7,13
Mumbai City,2977,1,6,5,3,17,9,8,23
Delhi Dynamo,2977,2,5,7,2,24,15,9,22
Kolkata,2977,3,4,7,3,19,15,4,19
Kerala Blast,2977,4,4,6,4,12,16,-4,18
NorthEast Un,2977,5,4,5,5,10,10,0,17
Chennaiyin,2977,6,3,7,4,14,18,-4,16
FC Pune City,2977,7,4,4,6,15,21,-6,16
FC Goa,2977,8,4,3,7,11,18,-7,15
Mumbai City,2978,1,7,4,3,17,8,9,25
Kerala Blast,2978,2,7,3,4,15,15,0,24
Delhi Dynamo,2978,3,5,6,3,25,16,9,21
Kolkata,2978,4,5,6,3,17,14,3,21
Chennaiyin,2978,5,4,6,4,16,18,-2,18
FC Pune City,2978,6,4,3,7,14,18,-4,15
NorthEast Un,2978,7,4,3,7,11,15,-4,15
FC Goa,2978,8,3,3,8,9,20,-11,12
Mumbai City,2979,1,7,4,3,18,9,9,25
NorthEast Un,2979,2,6,3,5,16,11,5,21
Kerala Blast,2979,3,6,3,5,13,15,-2,21
Delhi Dynamo,2979,4,5,5,4,24,21,3,20
Kolkata,2979,5,4,7,3,17,17,0,19
FC Pune City,2979,6,4,3,7,13,17,-4,15
Chennaiyin,2979,7,3,6,5,14,19,-5,15
FC Goa,2979,8,4,3,7,12,18,-6,15
Mumbai City,2980,1,7,4,3,17,8,9,25
Kerala Blast,2980,2,6,3,5,13,15,-2,21
NorthEast Un,2980,3,6,2,6,16,12,4,20
Kolkata,2980,4,4,6,4,17,18,-1,18
FC Pune City,2980,5,5,3,6,14,17,-3,18
Delhi Dynamo,2980,6,4,5,5,21,19,2,17
FC Goa,2980,7,5,2,7,12,16,-4,17
Chennaiyin,2980,8,4,5,5,16,21,-5,17
Mumbai City,2981,1,7,4,3,18,9,9,25
Delhi Dynamo,2981,2,6,5,3,27,17,10,23
Kerala Blast,2981,3,6,3,5,15,16,-1,21
NorthEast Un,2981,4,6,2,6,14,11,3,20
Kolkata,2981,5,3,7,4,14,17,-3,16
FC Pune City,2981,6,4,4,6,12,18,-6,16
Chennaiyin,2981,7,3,6,5,15,21,-6,15
FC Goa,2981,8,4,3,7,14,20,-6,15
Kolkata,2982,1,6,6,2,17,13,4,24
Mumbai City,2982,2,6,5,3,17,9,8,23
Delhi Dynamo,2982,3,5,7,2,25,16,9,22
FC Pune City,2982,4,5,3,6,13,15,-2,18
Kerala Blast,2982,4,5,3,6,13,15,-2,18
NorthEast Un,2982,6,5,3,6,11,14,-3,18
Chennaiyin,2982,7,3,5,6,14,20,-6,14
FC Goa,2982,8,4,2,8,11,19,-8,14
Mumbai City,2983,1,7,4,3,18,9,9,25
Delhi Dynamo,2983,2,5,5,4,24,18,6,20
NorthEast Un,2983,3,6,2,6,11,11,0,20
Kolkata,2983,4,4,7,3,18,16,2,19
FC Pune City,2983,5,5,3,6,14,17,-3,18
Kerala Blast,2983,6,5,3,6,10,15,-5,18
Chennaiyin,2983,7,4,5,5,16,19,-3,17
FC Goa,2983,8,4,3,7,13,19,-6,15
Delhi Dynamo,2984,1,6,6,2,25,15,10,24
Mumbai City,2984,2,6,4,4,16,10,6,22
Kolkata,2984,3,5,6,3,17,15,2,21
Chennaiyin,2984,4,4,6,4,16,17,-1,18
FC Pune City,2984,5,5,3,6,16,18,-2,18
Kerala Blast,2984,6,5,3,6,11,16,-5,18
FC Goa,2984,7,4,4,6,10,15,-5,16
NorthEast Un,2984,8,4,2,8,9,14,-5,14
Mumbai City,2985,1,7,4,3,18,9,9,25
Delhi Dynamo,2985,2,5,5,4,24,18,6,20
Kerala Blast,2985,3,5,5,4,10,13,-3,20
Kolkata,2985,4,4,7,3,16,13,3,19
NorthEast Un,2985,5,5,4,5,12,11,1,19
Chennaiyin,2985,6,4,6,4,17,19,-2,18
FC Pune City,2985,7,5,3,6,13,15,-2,18
FC Goa,2985,8,3,2,9,9,21,-12,11
Delhi Dynamo,2986,1,6,6,2,26,14,12,24
Mumbai City,2986,2,6,4,4,16,10,6,22
Kolkata,2986,3,4,8,2,18,16,2,20
FC Pune City,2986,4,5,3,6,16,16,0,18
NorthEast Un,2986,5,5,3,6,13,14,-1,18
Chennaiyin,2986,6,4,6,4,17,19,-2,18
Kerala Blast,2986,7,4,4,6,12,21,-9,16
FC Goa,2986,8,3,4,7,10,18,-8,13
Mumbai City,2987,1,7,4,3,18,9,9,25
Delhi Dynamo,2987,2,5,6,3,24,16,8,21
Kolkata,2987,3,4,8,2,18,16,2,20
Kerala Blast,2987,4,5,5,4,16,17,-1,20
Chennaiyin,2987,5,4,5,5,15,20,-5,17
NorthEast Un,2987,6,4,4,6,11,13,-2,16
FC Goa,2987,7,4,3,7,12,17,-5,15
FC Pune City,2987,8,4,3,7,13,19,-6,15
Mumbai City,2988,1,7,4,3,18,9,9,25
Kerala Blast,2988,2,6,4,4,13,13,0,22
Delhi Dynamo,2988,3,5,6,3,24,17,7,21
Kolkata,2988,4,4,7,3,18,15,3,19
Chennaiyin,2988,5,4,6,4,15,18,-3,18
NorthEast Un,2988,6,4,4,6,10,13,-3,16
FC Pune City,2988,7,4,4,6,12,17,-5,16
FC Goa,2988,8,3,3,8,11,19,-8,12
Delhi Dynamo,2989,1,6,5,3,27,17,10,23
Mumbai City,2989,2,6,4,4,16,10,6,22
NorthEast Un,2989,3,6,3,5,14,11,3,21
Kerala Blast,2989,4,5,5,4,11,14,-3,20
Kolkata,2989,5,3,8,3,13,13,0,17
FC Goa,2989,6,5,2,7,12,18,-6,17
FC Pune City,2989,7,4,4,6,12,15,-3,16
Chennaiyin,2989,8,3,5,6,14,21,-7,14
Mumbai City,2990,1,6,4,4,17,10,7,22
Delhi Dynamo,2990,2,5,6,3,24,18,6,21
NorthEast Un,2990,3,6,3,5,14,11,3,21
Kolkata,2990,4,5,6,3,17,16,1,21
FC Goa,2990,5,5,3,6,14,16,-2,18
Kerala Blast,2990,6,5,3,6,10,16,-6,18
FC Pune City,2990,7,4,3,7,13,17,-4,15
Chennaiyin,2990,8,3,6,5,16,21,-5,15
Delhi Dynamo,2991,1,7,5,2,28,16,12,26
Mumbai City,2991,2,6,4,4,18,11,7,22
FC Goa,2991,3,5,2,7,17,18,-1,17
FC Pune City,2991,4,4,5,5,15,17,-2,17
NorthEast Un,2991,5,5,2,7,11,13,-2,17
Kolkata,2991,6,3,8,3,15,19,-4,17
Chennaiyin,2991,7,4,5,5,17,22,-5,17
Kerala Blast,2991,8,4,5,5,10,15,-5,17
Delhi Dynamo,2992,1,6,6,2,25,16,9,24
Mumbai City,2992,2,6,5,3,16,8,8,23
Kolkata,2992,3,4,7,3,15,17,-2,19
Kerala Blast,2992,4,5,4,5,10,15,-5,19
FC Goa,2992,5,5,2,7,16,16,0,17
NorthEast Un,2992,6,5,2,7,11,12,-1,17
FC Pune City,2992,7,4,5,5,12,14,-2,17
Chennaiyin,2992,8,3,5,6,13,20,-7,14
Mumbai City,2993,1,7,4,3,18,8,10,25
Delhi Dynamo,2993,2,6,5,3,28,20,8,23
Kolkata,2993,3,5,7,2,15,12,3,22
Kerala Blast,2993,4,6,4,4,13,13,0,22
NorthEast Un,2993,5,5,2,7,14,17,-3,17
FC Pune City,2993,6,4,3,7,12,16,-4,15
Chennaiyin,2993,7,3,5,6,15,22,-7,14
FC Goa,2993,8,4,2,8,12,19,-7,14
Mumbai City,2994,1,7,4,3,18,9,9,25
Delhi Dynamo,2994,2,5,6,3,25,17,8,21
Kolkata,2994,3,4,6,4,16,16,0,18
NorthEast Un,2994,4,5,3,6,11,11,0,18
Chennaiyin,2994,5,4,6,4,14,17,-3,18
FC Pune City,2994,5,5,3,6,14,17,-3,18
Kerala Blast,2994,7,5,3,6,12,16,-4,18
FC Goa,2994,8,4,3,7,11,18,-7,15
Delhi Dynamo,2995,1,6,5,3,27,18,9,23
Mumbai City,2995,2,6,4,4,17,11,6,22
Kerala Blast,2995,3,6,3,5,13,14,-1,21
NorthEast Un,2995,4,6,2,6,13,12,1,20
Kolkata,2995,5,4,6,4,17,17,0,18
FC Pune City,2995,6,5,3,6,14,17,-3,18
Chennaiyin,2995,7,4,5,5,15,20,-5,17
FC Goa,2995,8,4,2,8,12,19,-7,14
Mumbai City,2996,1,7,4,3,19,8,11,25
Kolkata,2996,2,6,6,2,21,15,6,24
Delhi Dynamo,2996,3,5,6,3,24,17,7,21
Kerala Blast,2996,4,6,3,5,14,15,-1,21
NorthEast Un,2996,5,5,3,6,11,12,-1,18
FC Pune City,2996,6,4,3,7,15,21,-6,15
FC Goa,2996,7,4,2,8,13,20,-7,14
Chennaiyin,2996,8,3,5,6,14,23,-9,14
Mumbai City,2997,1,7,4,3,18,8,10,25
FC Pune City,2997,2,6,3,5,16,16,0,21
FC Goa,2997,3,6,2,6,15,17,-2,20
Delhi Dynamo,2997,4,4,6,4,24,20,4,18
Kolkata,2997,5,4,6,4,17,17,0,18
Chennaiyin,2997,6,4,5,5,14,19,-5,17
NorthEast Un,2997,7,4,4,6,13,14,-1,16
Kerala Blast,2997,8,4,4,6,12,18,-6,16
Delhi Dynamo,2998,1,6,5,3,27,16,11,23
Mumbai City,2998,2,6,4,4,16,10,6,22
Kolkata,2998,3,4,7,3,15,14,1,19
Kerala Blast,2998,4,5,4,5,10,14,-4,19
NorthEast Un,2998,5,5,3,6,11,11,0,18
FC Pune City,2998,6,5,3,6,13,15,-2,18
Chennaiyin,2998,7,4,6,4,15,18,-3,18
FC Goa,2998,8,3,4,7,10,19,-9,13
Delhi Dynamo,2999,1,7,5,2,25,15,10,26
Mumbai City,2999,2,6,4,4,16,9,7,22
Kerala Blast,2999,3,6,4,4,16,17,-1,22
Kolkata,2999,4,5,6,3,18,16,2,21
FC Pune City,2999,5,4,4,6,17,20,-3,16
NorthEast Un,2999,6,4,3,7,12,15,-3,15
Chennaiyin,2999,7,3,6,5,16,21,-5,15
FC Goa,2999,8,4,2,8,12,19,-7,14
Mumbai City,3000,1,7,4,3,20,10,10,25
Kolkata,3000,2,6,6,2,20,15,5,24
Delhi Dynamo,3000,3,6,5,3,28,21,7,23
Kerala Blast,3000,4,5,3,6,13,17,-4,18
NorthEast Un,3000,5,5,2,7,13,15,-2,17
Chennaiyin,3000,6,4,5,5,15,18,-3,17
FC Pune City,3000,7,4,3,7,13,18,-5,15
FC Goa,3000,8,4,2,8,11,19,-8,14
Mumbai City,3001,1,7,4,3,19,8,11,25
Delhi Dynamo,3001,2,5,6,3,22,17,5,21
Kerala Blast,3001,3,6,3,5,15,15,0,21
Kolkata,3001,4,4,7,3,16,16,0,19
NorthEast Un,3001,5,5,3,6,10,13,-3,18
FC Goa,3001,6,5,2,7,13,15,-2,17
FC Pune City,3001,7,4,4,6,15,18,-3,16
Chennaiyin,3001,8,3,5,6,13,21,-8,14
Mumbai City,3002,1,6,5,3,18,10,8,23
Delhi Dynamo,3002,2,5,6,3,25,18,7,21
Kolkata,3002,3,5,6,3,16,14,2,21
NorthEast Un,3002,4,5,4,5,12,10,2,19
Kerala Blast,3002,5,5,4,5,11,17,-6,19
FC Pune City,3002,6,5,3,6,15,15,0,18
Chennaiyin,3002,7,3,6,5,14,21,-7,15
FC Goa,3002,8,4,2,8,11,17,-6,14
Mumbai City,3003,1,7,4,3,19,9,10,25
Kerala Blast,3003,2,6,4,4,15,17,-2,22
Delhi Dynamo,3003,3,5,5,4,25,19,6,20
Kolkata,3003,4,4,8,2,17,14,3,20
NorthEast Un,3003,5,5,2,7,13,14,-1,17
FC Goa,3003,6,5,2,7,11,17,-6,17
FC Pune City,3003,7,4,4,6,15,18,-3,16
Chennaiyin,3003,8,3,5,6,14,21,-7,14
Delhi Dynamo,3004,1,6,5,3,27,16,11,23
Mumbai City,3004,2,6,4,4,16,12,4,22
Kolkata,3004,3,5,6,3,21,14,7,21
NorthEast Un,3004,4,6,2,6,12,11,1,20
Kerala Blast,3004,5,5,3,6,13,20,-7,18
FC Goa,3004,6,5,2,7,13,17,-4,17
Chennaiyin,3004,7,4,5,5,14,19,-5,17
FC Pune City,3004,8,4,3,7,13,20,-7,15
Mumbai City,3005,1,7,4,3,18,9,9,25
Kolkata,3005,2,5,7,2,16,13,3,22
NorthEast Un,3005,3,6,3,5,14,11,3,21
Delhi Dynamo,3005,4,5,5,4,25,19,6,20
Chennaiyin,3005,5,4,5,5,15,20,-5,17
Kerala Blast,3005,6,4,5,5,10,15,-5,17
FC Pune City,3005,7,4,4,6,13,16,-3,16
FC Goa,3005,8,3,3,8,10,18,-8,12
Kolkata,3006,1,6,6,2,22,13,9,24
Mumbai City,3006,2,6,5,3,17,9,8,23
Delhi Dynamo,3006,3,5,7,2,27,17,10,22
NorthEast Un,3006,4,5,3,6,15,14,1,18
FC Pune City,3006,5,5,3,6,13,17,-4,18
Kerala Blast,3006,6,5,3,6,13,19,-6,18
Chennaiyin,3006,7,3,5,6,13,20,-7,14
FC Goa,3006,8,4,2,8,11,22,-11,14
Mumbai City,3007,1,6,5,3,17,9,8,23
NorthEast Un,3007,2,6,3,5,12,10,2,21
Delhi Dynamo,3007,3,4,8,2,24,17,7,20
FC Pune City,3007,4,5,4,5,14,15,-1,19
Kolkata,3007,5,4,6,4,16,16,0,18
FC Goa,3007,6,5,3,6,13,17,-4,18
Kerala Blast,3007,7,4,4,6,9,15,-6,16
Chennaiyin,3007,8,3,5,6,14,20,-6,14
Delhi Dynamo,3008,1,6,6,2,28,17,11,24
Mumbai City,3008,2,6,4,4,17,10,7,22
NorthEast Un,3008,3,5,4,5,13,12,1,19
FC Pune City,3008,4,5,4,5,13,14,-1,19
Chennaiyin,3008,5,4,6,4,15,18,-3,18
Kerala Blast,3008,6,4,5,5,10,15,-5,17
Kolkata,3008,7,3,7,4,14,15,-1,16
FC Goa,3008,8,4,2,8,9,18,-9,14
Delhi Dynamo,3009,1,6,5,3,27,17,10,23
Mumbai City,3009,2,6,4,4,17,10,7,22
Kerala Blast,3009,3,6,4,4,15,17,-2,22
NorthEast Un,3009,4,5,3,6,13,13,0,18
Chennaiyin,3009,5,4,6,4,14,17,-3,18
Kolkata,3009,6,3,7,4,15,16,-1,16
FC Pune City,3009,7,4,4,6,13,16,-3,16
FC Goa,3009,8,4,3,7,10,18,-8,15
NorthEast Un,3010,1,7,2,5,14,9,5,23
Mumbai City,3010,2,6,4,4,17,11,6,22
Delhi Dynamo,3010,3,5,6,3,24,16,8,21
Kolkata,3010,4,4,6,4,18,16,2,18
FC Pune City,3010,5,5,3,6,14,16,-2,18
FC Goa,3010,6,5,3,6,11,15,-4,18
Kerala Blast,3010,7,5,3,6,10,19,-9,18
Chennaiyin,3010,8,3,5,6,13,19,-6,14
Mumbai City,3011,1,6,4,4,16,11,5,22
Delhi Dynamo,3011,2,5,6,3,30,21,9,21
FC Pune City,3011,3,6,3,5,15,15,0,21
Kolkata,3011,4,4,6,4,17,17,0,18
FC Goa,3011,5,5,3,6,15,18,-3,18
Kerala Blast,3011,6,5,3,6,11,16,-5,18
Chennaiyin,3011,7,4,5,5,17,20,-3,17
NorthEast Un,3011,8,5,2,7,14,17,-3,17
Mumbai City,3012,1,7,4,3,18,9,9,25
NorthEast Un,3012,2,7,2,5,15,11,4,23
Delhi Dynamo,3012,3,5,5,4,26,20,6,20
Kolkata,3012,4,4,8,2,16,14,2,20
FC Pune City,3012,5,5,3,6,16,18,-2,18
Chennaiyin,3012,6,4,5,5,17,20,-3,17
Kerala Blast,3012,7,4,4,6,10,16,-6,16
FC Goa,3012,8,3,3,8,10,20,-10,12
Mumbai City,3013,1,7,4,3,18,8,10,25
Delhi Dynamo,3013,2,5,6,3,24,17,7,21
Kolkata,3013,3,4,7,3,16,15,1,19
Kerala Blast,3013,4,5,4,5,13,17,-4,19
NorthEast Un,3013,5,5,3,6,11,12,-1,18
FC Goa,3013,6,5,3,6,14,16,-2,18
FC Pune City,3013,7,4,4,6,14,18,-4,16
Chennaiyin,3013,8,3,5,6,14,21,-7,14
Mumbai City,3014,1,7,4,3,17,8,9,25
FC Pune City,3014,2,6,3,5,15,14,1,21
Delhi Dynamo,3014,3,5,5,4,24,20,4,20
NorthEast Un,3014,4,5,3,6,14,12,2,18
Chennaiyin,3014,5,4,6,4,15,18,-3,18
Kerala Blast,3014,6,4,5,5,9,14,-5,17
Kolkata,3014,7,3,7,4,14,16,-2,16
FC Goa,3014,8,4,3,7,11,17,-6,15
Mumbai City,3015,1,7,4,3,18,8,10,25
Kolkata,3015,2,5,7,2,21,15,6,22
Kerala Blast,3015,3,5,5,4,12,15,-3,20
Delhi Dynamo,3015,4,4,7,3,23,18,5,19
Chennaiyin,3015,5,4,6,4,17,19,-2,18
NorthEast Un,3015,6,4,5,5,13,13,0,17
FC Pune City,3015,7,4,3,7,14,19,-5,15
FC Goa,3015,8,3,3,8,9,20,-11,12
Mumbai City,3016,1,7,4,3,20,10,10,25
Kolkata,3016,2,5,6,3,17,15,2,21
NorthEast Un,3016,3,6,2,6,13,12,1,20
FC Goa,3016,4,6,2,6,14,16,-2,20
FC Pune City,3016,5,5,3,6,15,18,-3,18
Kerala Blast,3016,6,5,3,6,11,16,-5,18
Delhi Dynamo,3016,7,4,5,5,26,23,3,17
Chennaiyin,3016,8,3,5,6,14,20,-6,14
Mumbai City,3017,1,7,4,3,17,8,9,25
FC Pune City,3017,2,6,3,5,15,15,0,21
Kerala Blast,3017,2,6,3,5,15,15,0,21
Delhi Dynamo,3017,4,5,5,4,23,20,3,20
NorthEast Un,3017,5,6,2,6,17,14,3,20
FC Goa,3017,6,4,3,7,13,17,-4,15
Kolkata,3017,7,3,6,5,14,19,-5,15
Chennaiyin,3017,8,3,6,5,15,21,-6,15
Mumbai City,3018,1,6,5,3,18,10,8,23
Kerala Blast,3018,2,6,3,5,15,17,-2,21
Chennaiyin,3018,3,5,5,4,17,18,-1,20
Delhi Dynamo,3018,4,4,6,4,26,22,4,18
Kolkata,3018,5,4,6,4,16,17,-1,18
FC Pune City,3018,6,5,3,6,17,19,-2,18
NorthEast Un,3018,7,5,2,7,11,13,-2,17
FC Goa,3018,8,5,2,7,16,20,-4,17
Mumbai City,3019,1,7,4,3,18,8,10,25
Delhi Dynamo,3019,2,6,5,3,26,17,9,23
Kolkata,3019,3,5,7,2,20,13,7,22
Kerala Blast,3019,4,5,5,4,13,14,-1,20
NorthEast Un,3019,5,5,3,6,11,12,-1,18
Chennaiyin,3019,6,3,6,5,15,20,-5,15
FC Pune City,3019,7,4,3,7,12,21,-9,15
FC Goa,3019,8,3,3,8,10,20,-10,12
Mumbai City,3020,1,7,4,3,21,9,12,25
Kerala Blast,3020,2,6,3,5,12,15,-3,21
NorthEast Un,3020,3,6,2,6,14,11,3,20
Chennaiyin,3020,4,5,5,4,16,17,-1,20
Kolkata,3020,5,4,6,4,16,17,-1,18
Delhi Dynamo,3020,6,4,5,5,23,24,-1,17
FC Goa,3020,7,5,2,7,12,17,-5,17
FC Pune City,3020,8,4,3,7,13,17,-4,15
Mumbai City,3021,1,7,4,3,19,9,10,25
Delhi Dynamo,3021,2,5,6,3,28,21,7,21
Kolkata,3021,3,5,6,3,19,16,3,21
Kerala Blast,3021,4,6,3,5,14,17,-3,21
Chennaiyin,3021,5,4,6,4,14,17,-3,18
NorthEast Un,3021,6,4,3,7,11,14,-3,15
FC Goa,3021,7,4,3,7,13,18,-5,15
FC Pune City,3021,8,4,3,7,14,20,-6,15
Mumbai City,3022,1,7,4,3,18,9,9,25
Kolkata,3022,2,5,6,3,20,16,4,21
Delhi Dynamo,3022,3,5,5,4,25,17,8,20
NorthEast Un,3022,4,6,2,6,14,12,2,20
Kerala Blast,3022,5,5,4,5,11,18,-7,19
Chennaiyin,3022,6,4,5,5,16,21,-5,17
FC Pune City,3022,7,4,4,6,13,17,-4,16
FC Goa,3022,8,4,2,8,12,19,-7,14
Delhi Dynamo,3023,1,6,5,3,27,16,11,23
Mumbai City,3023,2,6,4,4,17,11,6,22
Chennaiyin,3023,3,5,5,4,15,17,-2,20
Kolkata,3023,4,4,7,3,17,16,1,19
Kerala Blast,3023,5,5,4,5,13,16,-3,19
FC Pune City,3023,6,4,5,5,15,17,-2,17
NorthEast Un,3023,7,5,2,7,10,12,-2,17
FC Goa,3023,8,4,2,8,11,20,-9,14
Delhi Dynamo,3024,1,6,5,3,26,19,7,23
Mumbai City,3024,2,6,4,4,16,9,7,22
Kolkata,3024,3,5,7,2,16,13,3,22
NorthEast Un,3024,4,5,4,5,14,10,4,19
FC Pune City,3024,5,5,4,5,14,14,0,19
Chennaiyin,3024,6,4,6,4,16,18,-2,18
Kerala Blast,3024,7,4,4,6,9,16,-7,16
FC Goa,3024,8,3,2,9,10,22,-12,11
Mumbai City,3025,1,7,4,3,21,8,13,25
Delhi Dynamo,3025,2,5,5,4,24,21,3,20
Kerala Blast,3025,3,5,5,4,15,15,0,20
NorthEast Un,3025,4,5,4,5,13,12,1,19
FC Pune City,3025,5,5,4,5,16,17,-1,19
Chennaiyin,3025,6,3,7,4,16,20,-4,16
Kolkata,3025,7,3,6,5,14,20,-6,15
FC Goa,3025,8,4,3,7,11,17,-6,15
Mumbai City,3026,1,6,4,4,17,10,7,22
Kolkata,3026,2,5,7,2,21,15,6,22
Delhi Dynamo,3026,3,5,6,3,24,18,6,21
NorthEast Un,3026,4,5,3,6,13,11,2,18
Chennaiyin,3026,5,4,6,4,14,17,-3,18
FC Pune City,3026,6,5,3,6,13,17,-4,18
Kerala Blast,3026,7,4,4,6,11,19,-8,16
FC Goa,3026,8,4,3,7,11,17,-6,15
Delhi Dynamo,3027,1,6,6,2,27,17,10,24
Mumbai City,3027,2,6,4,4,17,10,7,22
Kolkata,3027,3,5,6,3,19,17,2,21
NorthEast Un,3027,4,6,3,5,12,10,2,21
Kerala Blast,3027,5,5,3,6,12,17,-5,18
Chennaiyin,3027,6,4,5,5,15,19,-4,17
FC Pune City,3027,7,4,3,7,12,17,-5,15
FC Goa,3027,8,4,2,8,14,21,-7,14
Mumbai City,3028,1,7,4,3,17,8,9,25
Delhi Dynamo,3028,2,5,6,3,27,19,8,21
NorthEast Un,3028,3,5,4,5,12,11,1,19
FC Pune City,3028,4,5,3,6,16,15,1,18
Kolkata,3028,5,4,6,4,14,14,0,18
Chennaiyin,3028,6,4,6,4,15,18,-3,18
Kerala Blast,3028,7,5,3,6,10,18,-8,18
FC Goa,3028,8,4,2,8,12,20,-8,14
Mumbai City,3029,1,7,4,3,19,8,11,25
Kerala Blast,3029,2,6,4,4,12,14,-2,22
Delhi Dynamo,3029,3,5,6,3,24,17,7,21
Kolkata,3029,4,4,7,3,14,13,1,19
NorthEast Un,3029,5,5,3,6,11,11,0,18
FC Pune City,3029,6,4,5,5,12,14,-2,17
Chennaiyin,3029,7,3,6,5,14,19,-5,15
FC Goa,3029,8,3,3,8,9,19,-10,12
Mumbai City,3030,1,7,4,3,17,8,9,25
Delhi Dynamo,3030,2,6,5,3,24,15,9,23
Kerala Blast,3030,3,6,4,4,12,13,-1,22
FC Pune City,3030,4,5,3,6,16,17,-1,18
Kolkata,3030,4,4,6,4,16,17,-1,18
Chennaiyin,3030,6,4,6,4,15,18,-3,18
NorthEast Un,3030,7,4,3,7,9,11,-2,15
FC Goa,3030,8,3,3,8,9,19,-10,12
Mumbai City,3031,1,7,4,3,18,8,10,25
Kolkata,3031,2,5,6,3,18,16,2,21
Delhi Dynamo,3031,3,5,5,4,24,18,6,20
Kerala Blast,3031,4,5,4,5,12,16,-4,19
NorthEast Un,3031,5,5,3,6,13,14,-1,18
FC Goa,3031,6,5,2,7,13,16,-3,17
Chennaiyin,3031,7,4,5,5,16,20,-4,17
FC Pune City,3031,8,4,3,7,12,18,-6,15
Mumbai City,3032,1,7,4,3,17,8,9,25
NorthEast Un,3032,2,6,3,5,15,11,4,21
Delhi Dynamo,3032,3,5,5,4,23,17,6,20
Kerala Blast,3032,4,5,5,4,13,15,-2,20
Kolkata,3032,5,4,7,3,16,16,0,19
FC Pune City,3032,6,4,4,6,13,16,-3,16
FC Goa,3032,7,4,3,7,11,17,-6,15
Chennaiyin,3032,8,3,5,6,15,23,-8,14
Delhi Dynamo,3033,1,6,6,2,28,15,13,24
Kolkata,3033,2,5,7,2,18,12,6,22
Mumbai City,3033,3,6,4,4,16,10,6,22
Chennaiyin,3033,4,5,5,4,16,17,-1,20
Kerala Blast,3033,5,5,4,5,11,17,-6,19
NorthEast Un,3033,6,4,4,6,9,10,-1,16
FC Pune City,3033,7,4,3,7,13,18,-5,15
FC Goa,3033,8,3,3,8,9,21,-12,12
Delhi Dynamo,3034,1,6,5,3,25,17,8,23
Mumbai City,3034,2,6,4,4,16,9,7,22
NorthEast Un,3034,3,6,2,6,12,12,0,20
Kolkata,3034,4,4,7,3,18,17,1,19
FC Pune City,3034,5,5,4,5,17,16,1,19
Chennaiyin,3034,6,4,5,5,15,18,-3,17
FC Goa,3034,7,5,2,7,12,17,-5,17
Kerala Blast,3034,8,4,3,7,10,19,-9,15
Delhi Dynamo,3035,1,6,5,3,27,19,8,23
Mumbai City,3035,2,6,4,4,17,10,7,22
Kerala Blast,3035,3,5,5,4,14,15,-1,20
NorthEast Un,3035,4,6,2,6,12,13,-1,20
Kolkata,3035,5,4,7,3,17,15,2,19
FC Pune City,3035,6,5,4,5,15,16,-1,19
Chennaiyin,3035,7,4,5,5,14,18,-4,17
FC Goa,3035,8,3,2,9,10,20,-10,11
Mumbai City,3036,1,7,4,3,20,9,11,25
Delhi Dynamo,3036,2,5,6,3,23,18,5,21
Kerala Blast,3036,3,6,3,5,14,17,-3,21
NorthEast Un,3036,4,5,4,5,12,11,1,19
Kolkata,3036,5,3,8,3,15,15,0,17
FC Pune City,3036,6,4,4,6,14,17,-3,16
Chennaiyin,3036,7,3,7,4,18,22,-4,16
FC Goa,3036,8,3,4,7,12,19,-7,13
Mumbai City,3037,1,7,4,3,19,8,11,25
NorthEast Un,3037,2,7,2,5,14,11,3,23
Kolkata,3037,3,5,7,2,18,15,3,22
FC Pune City,3037,4,5,4,5,14,15,-1,19
Delhi Dynamo,3037,5,4,5,5,24,22,2,17
FC Goa,3037,6,5,2,7,14,19,-5,17
Kerala Blast,3037,7,4,3,7,10,17,-7,15
Chennaiyin,3037,8,3,5,6,15,21,-6,14
Delhi Dynamo,3038,1,6,6,2,25,16,9,24
Mumbai City,3038,2,6,5,3,16,8,8,23
Kolkata,3038,3,4,7,3,16,20,-4,19
FC Pune City,3038,4,5,3,6,13,15,-2,18
Kerala Blast,3038,5,4,5,5,12,17,-5,17
NorthEast Un,3038,6,4,4,6,11,12,-1,16
Chennaiyin,3038,7,3,7,4,14,18,-4,16
FC Goa,3038,8,4,3,7,16,17,-1,15
Mumbai City,3039,1,6,5,3,17,9,8,23
NorthEast Un,3039,2,7,2,5,17,11,6,23
Delhi Dynamo,3039,3,5,6,3,24,17,7,21
Kolkata,3039,4,4,7,3,15,16,-1,19
Kerala Blast,3039,5,5,3,6,10,17,-7,18
FC Pune City,3039,6,4,4,6,12,15,-3,16
FC Goa,3039,7,4,3,7,12,15,-3,15
Chennaiyin,3039,8,3,6,5,14,21,-7,15
Mumbai City,3040,1,7,4,3,19,9,10,25
Kolkata,3040,2,5,7,2,18,14,4,22
NorthEast Un,3040,3,6,3,5,13,11,2,21
Delhi Dynamo,3040,4,4,6,4,24,21,3,18
FC Pune City,3040,5,5,3,6,16,17,-1,18
FC Goa,3040,6,5,2,7,13,17,-4,17
Kerala Blast,3040,7,4,4,6,11,19,-8,16
Chennaiyin,3040,8,3,5,6,14,20,-6,14
Delhi Dynamo,3041,1,6,5,3,24,16,8,23
Mumbai City,3041,2,6,4,4,16,9,7,22
Kolkata,3041,3,5,6,3,17,15,2,21
NorthEast Un,3041,4,6,2,6,16,13,3,20
Chennaiyin,3041,5,5,5,4,16,18,-2,20
Kerala Blast,3041,6,5,3,6,13,18,-5,18
FC Pune City,3041,7,4,3,7,12,18,-6,15
FC Goa,3041,8,4,2,8,11,18,-7,14
Delhi Dynamo,3042,1,6,5,3,23,16,7,23
Mumbai City,3042,2,6,4,4,16,9,7,22
Kolkata,3042,3,5,6,3,20,14,6,21
FC Goa,3042,4,6,2,6,12,14,-2,20
Kerala Blast,3042,5,5,4,5,12,18,-6,19
NorthEast Un,3042,6,4,4,6,11,12,-1,16
Chennaiyin,3042,7,3,6,5,15,20,-5,15
FC Pune City,3042,8,4,3,7,15,21,-6,15
Mumbai City,3043,1,6,5,3,19,11,8,23
Delhi Dynamo,3043,2,5,6,3,27,19,8,21
NorthEast Un,3043,3,6,2,6,13,11,2,20
Kolkata,3043,4,4,7,3,16,17,-1,19
FC Pune City,3043,5,5,4,5,14,15,-1,19
Kerala Blast,3043,6,5,3,6,10,15,-5,18
FC Goa,3043,7,5,2,7,14,17,-3,17
Chennaiyin,3043,8,3,5,6,13,21,-8,14
Mumbai City,3044,1,7,4,3,22,8,14,25
Delhi Dynamo,3044,2,5,6,3,23,20,3,21
Kolkata,3044,3,5,6,3,18,15,3,21
NorthEast Un,3044,4,5,4,5,10,9,1,19
FC Pune City,3044,5,5,3,6,15,17,-2,18
Kerala Blast,3044,6,4,4,6,11,18,-7,16
Chennaiyin,3044,7,3,6,5,13,18,-5,15
FC Goa,3044,8,4,3,7,9,16,-7,15
Delhi Dynamo,3045,1,6,6,2,25,16,9,24
Mumbai City,3045,2,6,4,4,17,10,7,22
FC Pune City,3045,3,6,3,5,16,16,0,21
NorthEast Un,3045,4,4,5,5,11,11,0,17
Kerala Blast,3045,5,4,5,5,11,16,-5,17
FC Goa,3045,6,5,2,7,10,15,-5,17
Kolkata,3045,7,3,7,4,14,15,-1,16
Chennaiyin,3045,8,3,6,5,13,18,-5,15
Mumbai City,3046,1,6,5,3,17,9,8,23
Delhi Dynamo,3046,2,5,6,3,26,20,6,21
NorthEast Un,3046,3,6,2,6,17,11,6,20
Kolkata,3046,4,4,7,3,17,16,1,19
Kerala Blast,3046,5,5,4,5,13,19,-6,19
Chennaiyin,3046,6,4,6,4,16,19,-3,18
FC Pune City,3046,7,4,4,6,15,18,-3,16
FC Goa,3046,8,3,4,7,11,20,-9,13
Mumbai City,3047,1,7,4,3,18,9,9,25
Delhi Dynamo,3047,2,5,6,3,25,18,7,21
Kolkata,3047,3,5,6,3,17,14,3,21
FC Goa,3047,4,5,3,6,13,17,-4,18
Kerala Blast,3047,5,5,3,6,12,18,-6,18
NorthEast Un,3047,6,5,2,7,13,13,0,17
Chennaiyin,3047,7,4,5,5,16,20,-4,17
FC Pune City,3047,8,4,3,7,12,17,-5,15
Mumbai City,3048,1,7,4,3,19,8,11,25
Delhi Dynamo,3048,2,5,6,3,23,18,5,21
Kolkata,3048,3,4,7,3,18,18,0,19
FC Pune City,3048,4,5,4,5,15,15,0,19
Kerala Blast,3048,5,4,6,4,11,15,-4,18
NorthEast Un,3048,6,4,4,6,9,10,-1,16
Chennaiyin,3048,7,3,6,5,13,18,-5,15
FC Goa,3048,8,4,3,7,11,17,-6,15
Mumbai City,3049,1,6,5,3,17,9,8,23
Kolkata,3049,2,5,7,2,18,14,4,22
Delhi Dynamo,3049,3,5,6,3,26,20,6,21
NorthEast Un,3049,4,6,3,5,14,10,4,21
FC Pune City,3049,5,5,4,5,15,16,-1,19
Chennaiyin,3049,6,4,6,4,16,18,-2,18
Kerala Blast,3049,7,4,3,7,10,18,-8,15
FC Goa,3049,8,3,2,9,11,22,-11,11
Mumbai City,3050,1,6,4,4,16,9,7,22
NorthEast Un,3050,2,6,3,5,13,10,3,21
Delhi Dynamo,3050,3,5,5,4,23,18,5,20
Kerala Blast,3050,4,5,5,4,11,14,-3,20
Kolkata,3050,5,4,7,3,15,15,0,19
FC Goa,3050,6,5,3,6,12,15,-3,18
FC Pune City,3050,7,4,3,7,12,16,-4,15
Chennaiyin,3050,8,3,6,5,14,19,-5,15
Delhi Dynamo,3051,1,6,5,3,23,15,8,23
Mumbai City,3051,2,6,4,4,16,9,7,22
NorthEast Un,3051,3,6,3,5,11,9,2,21
Kolkata,3051,4,4,7,3,14,13,1,19
FC Pune City,3051,5,5,4,5,14,15,-1,19
Chennaiyin,3051,6,3,7,4,15,19,-4,16
Kerala Blast,3051,7,4,4,6,10,16,-6,16
FC Goa,3051,8,3,4,7,10,17,-7,13
Mumbai City,3052,1,6,5,3,18,10,8,23
Kolkata,3052,2,5,7,2,17,13,4,22
NorthEast Un,3052,3,6,2,6,13,12,1,20
Delhi Dynamo,3052,4,4,6,4,25,20,5,18
Kerala Blast,3052,5,5,3,6,13,18,-5,18
FC Goa,3052,6,5,2,7,13,17,-4,17
Chennaiyin,3052,7,4,5,5,14,19,-5,17
FC Pune City,3052,8,4,4,6,13,17,-4,16
Mumbai City,3053,1,6,5,3,17,9,8,23
Kolkata,3053,2,5,7,2,17,14,3,22
Kerala Blast,3053,3,5,5,4,13,15,-2,20
Delhi Dynamo,3053,4,4,7,3,25,20,5,19
NorthEast Un,3053,5,5,4,5,14,13,1,19
Chennaiyin,3053,6,4,5,5,16,19,-3,17
FC Pune City,3053,7,4,3,7,12,17,-5,15
FC Goa,3053,8,4,2,8,12,19,-7,14
Delhi Dynamo,3054,1,6,6,2,26,17,9,24
Mumbai City,3054,2,6,4,4,18,11,7,22
Kerala Blast,3054,3,6,3,5,13,17,-4,21
Kolkata,3054,4,4,6,4,17,17,0,18
NorthEast Un,3054,5,5,3,6,13,13,0,18
FC Pune City,3054,6,5,3,6,14,15,-1,18
Chennaiyin,3054,7,4,6,4,17,19,-2,18
FC Goa,3054,8,3,3,8,11,20,-9,12
Mumbai City,3055,1,7,4,3,17,8,9,25
FC Pune City,3055,2,6,3,5,14,14,0,21
Kerala Blast,3055,2,6,3,5,14,14,0,21
Delhi Dynamo,3055,4,5,5,4,23,17,6,20
NorthEast Un,3055,5,6,2,6,13,13,0,20
Kolkata,3055,6,3,7,4,14,16,-2,16
FC Goa,3055,7,4,3,7,12,17,-5,15
Chennaiyin,3055,8,3,5,6,14,22,-8,14
Mumbai City,3056,1,7,4,3,19,10,9,25
Delhi Dynamo,3056,2,5,5,4,25,20,5,20
NorthEast Un,3056,3,6,2,6,13,10,3,20
FC Pune City,3056,4,5,4,5,17,16,1,19
Kerala Blast,3056,5,5,4,5,11,15,-4,19
Kolkata,3056,6,4,6,4,15,17,-2,18
FC Goa,3056,7,5,2,7,11,16,-5,17
Chennaiyin,3056,8,3,5,6,13,20,-7,14
Mumbai City,3057,1,7,4,3,18,9,9,25
Delhi Dynamo,3057,2,5,6,3,24,17,7,21
Kerala Blast,3057,3,5,5,4,12,15,-3,20
FC Pune City,3057,4,5,4,5,16,15,1,19
Chennaiyin,3057,5,4,6,4,16,18,-2,18
Kolkata,3057,6,3,7,4,14,17,-3,16
NorthEast Un,3057,7,4,3,7,9,12,-3,15
FC Goa,3057,8,3,5,6,10,16,-6,14
Mumbai City,3058,1,7,4,3,18,8,10,25
Kerala Blast,3058,2,6,4,4,14,15,-1,22
Chennaiyin,3058,3,5,5,4,17,18,-1,20
Kolkata,3058,4,4,7,3,15,15,0,19
Delhi Dynamo,3058,5,4,6,4,21,18,3,18
FC Goa,3058,6,5,2,7,12,16,-4,17
NorthEast Un,3058,7,4,3,7,11,14,-3,15
FC Pune City,3058,8,4,3,7,12,16,-4,15
Mumbai City,3059,1,7,4,3,19,8,11,25
Kolkata,3059,2,5,6,3,20,15,5,21
NorthEast Un,3059,3,6,3,5,17,12,5,21
FC Pune City,3059,4,5,3,6,13,15,-2,18
Delhi Dynamo,3059,5,4,5,5,23,22,1,17
FC Goa,3059,6,5,2,7,12,16,-4,17
Chennaiyin,3059,7,4,5,5,16,22,-6,17
Kerala Blast,3059,8,4,4,6,10,20,-10,16
Mumbai City,3060,1,6,5,3,17,9,8,23
Delhi Dynamo,3060,2,5,7,2,23,15,8,22
Chennaiyin,3060,3,5,5,4,16,18,-2,20
Kolkata,3060,4,4,7,3,18,18,0,19
Kerala Blast,3060,5,5,4,5,13,18,-5,19
FC Pune City,3060,6,5,3,6,17,17,0,18
NorthEast Un,3060,7,4,4,6,11,12,-1,16
FC Goa,3060,8,3,3,8,9,17,-8,12
Mumbai City,3061,1,7,4,3,19,8,11,25
Delhi Dynamo,3061,2,5,6,3,24,19,5,21
Kolkata,3061,3,5,6,3,19,16,3,21
FC Pune City,3061,4,5,3,6,14,16,-2,18
NorthEast Un,3061,5,4,5,5,11,11,0,17
FC Goa,3061,6,5,2,7,14,19,-5,17
Kerala Blast,3061,7,4,4,6,10,17,-7,16
Chennaiyin,3061,8,3,6,5,14,19,-5,15
Mumbai City,3062,1,7,4,3,18,8,10,25
Delhi Dynamo,3062,2,6,5,3,26,18,8,23
Kerala Blast,3062,3,5,5,4,14,17,-3,20
FC Pune City,3062,4,5,3,6,15,16,-1,18
Chennaiyin,3062,5,4,5,5,15,19,-4,17
FC Goa,3062,6,5,2,7,12,18,-6,17
Kolkata,3062,7,3,7,4,15,17,-2,16
NorthEast Un,3062,8,4,3,7,13,15,-2,15
Delhi Dynamo,3063,1,6,5,3,25,16,9,23
Mumbai City,3063,2,6,4,4,16,9,7,22
Kerala Blast,3063,3,6,4,4,15,14,1,22
Kolkata,3063,4,4,6,4,16,15,1,18
NorthEast Un,3063,5,5,2,7,10,13,-3,17
Chennaiyin,3063,6,4,5,5,15,19,-4,17
FC Goa,3063,7,5,2,7,12,18,-6,17
FC Pune City,3063,8,4,4,6,13,18,-5,16
Mumbai City,3064,1,7,4,3,17,8,9,25
Kerala Blast,3064,2,7,3,4,15,15,0,24
Delhi Dynamo,3064,3,5,5,4,23,17,6,20
Kolkata,3064,4,3,8,3,17,17,0,17
NorthEast Un,3064,5,5,2,7,11,13,-2,17
FC Pune City,3064,6,4,4,6,15,18,-3,16
FC Goa,3064,7,4,4,6,11,16,-5,16
Chennaiyin,3064,8,3,6,5,14,19,-5,15
Delhi Dynamo,3065,1,6,5,3,24,16,8,23
Mumbai City,3065,2,6,4,4,17,10,7,22
Kerala Blast,3065,3,6,3,5,16,16,0,21
FC Pune City,3065,4,5,4,5,13,14,-1,19
NorthEast Un,3065,5,5,3,6,13,15,-2,18
FC Goa,3065,6,5,2,7,11,15,-4,17
Kolkata,3065,7,3,7,4,14,16,-2,16
Chennaiyin,3065,8,3,6,5,15,21,-6,15
Mumbai City,3066,1,7,4,3,19,10,9,25
Delhi Dynamo,3066,2,6,5,3,27,17,10,23
Kolkata,3066,3,4,8,2,15,13,2,20
Chennaiyin,3066,4,5,5,4,16,17,-1,20
Kerala Blast,3066,5,5,5,4,11,14,-3,20
FC Pune City,3066,6,4,5,5,13,15,-2,17
NorthEast Un,3066,7,4,2,8,10,13,-3,14
FC Goa,3066,8,3,2,9,8,20,-12,11
Mumbai City,3067,1,7,4,3,17,8,9,25
NorthEast Un,3067,2,6,3,5,19,11,8,21
Delhi Dynamo,3067,3,5,5,4,24,19,5,20
Kolkata,3067,4,4,7,3,17,14,3,19
FC Pune City,3067,5,5,4,5,14,15,-1,19
Kerala Blast,3067,6,4,5,5,11,18,-7,17
Chennaiyin,3067,7,3,6,5,14,24,-10,15
FC Goa,3067,8,3,4,7,9,16,-7,13
Mumbai City,3068,1,7,4,3,17,8,9,25
Delhi Dynamo,3068,2,5,5,4,25,16,9,20
Kolkata,3068,3,4,7,3,19,18,1,19
Kerala Blast,3068,4,5,4,5,15,19,-4,19
FC Pune City,3068,5,5,3,6,15,17,-2,18
NorthEast Un,3068,6,5,3,6,12,15,-3,18
Chennaiyin,3068,7,4,5,5,15,18,-3,17
FC Goa,3068,8,4,3,7,11,18,-7,15
Mumbai City,3069,1,7,4,3,19,10,9,25
Delhi Dynamo,3069,2,5,5,4,26,20,6,20
Kolkata,3069,3,4,8,2,16,14,2,20
Chennaiyin,3069,4,5,5,4,17,18,-1,20
NorthEast Un,3069,5,5,3,6,12,12,0,18
Kerala Blast,3069,6,4,6,4,13,17,-4,18
FC Pune City,3069,7,4,5,5,13,15,-2,17
FC Goa,3069,8,3,2,9,10,20,-10,11
Mumbai City,3070,1,7,4,3,19,10,9,25
Kolkata,3070,2,5,7,2,16,12,4,22
Delhi Dynamo,3070,3,5,6,3,26,18,8,21
Kerala Blast,3070,4,5,4,5,13,18,-5,19
NorthEast Un,3070,5,5,3,6,13,12,1,18
FC Pune City,3070,6,4,4,6,14,17,-3,16
FC Goa,3070,7,4,3,7,12,17,-5,15
Chennaiyin,3070,8,3,5,6,14,23,-9,14
Delhi Dynamo,3071,1,5,7,2,26,18,8,22
Mumbai City,3071,2,6,4,4,17,10,7,22
Kerala Blast,3071,3,6,3,5,16,15,1,21
FC Pune City,3071,4,5,4,5,13,14,-1,19
FC Goa,3071,5,5,3,6,15,18,-3,18
Chennaiyin,3071,6,4,5,5,19,21,-2,17
Kolkata,3071,7,3,7,4,15,19,-4,16
NorthEast Un,3071,8,4,3,7,12,18,-6,15
Mumbai City,3072,1,7,4,3,18,9,9,25
Kerala Blast,3072,2,6,4,4,14,15,-1,22
Delhi Dynamo,3072,3,4,7,3,27,21,6,19
NorthEast Un,3072,4,5,3,6,13,13,0,18
FC Pune City,3072,5,5,3,6,14,17,-3,18
Chennaiyin,3072,6,4,5,5,18,18,0,17
Kolkata,3072,7,3,7,4,15,16,-1,16
FC Goa,3072,8,4,3,7,12,22,-10,15
Mumbai City,3073,1,7,4,3,18,9,9,25
Kolkata,3073,2,6,6,2,21,13,8,24
Delhi Dynamo,3073,3,5,5,4,25,19,6,20
NorthEast Un,3073,4,5,4,5,13,10,3,19
Kerala Blast,3073,5,5,4,5,11,16,-5,19
Chennaiyin,3073,6,3,7,4,15,19,-4,16
FC Pune City,3073,7,4,3,7,13,19,-6,15
FC Goa,3073,8,3,3,8,9,20,-11,12
Delhi Dynamo,3074,1,6,6,2,24,14,10,24
Mumbai City,3074,2,6,5,3,16,8,8,23
Kolkata,3074,3,4,8,2,19,16,3,20
Chennaiyin,3074,4,5,5,4,17,18,-1,20
Kerala Blast,3074,5,5,4,5,17,18,-1,19
FC Pune City,3074,6,4,4,6,12,19,-7,16
NorthEast Un,3074,7,4,3,7,12,15,-3,15
FC Goa,3074,8,3,3,8,11,20,-9,12
Mumbai City,3075,1,6,5,3,18,10,8,23
Delhi Dynamo,3075,2,5,7,2,28,18,10,22
Kolkata,3075,3,4,7,3,19,17,2,19
Kerala Blast,3075,4,5,4,5,12,15,-3,19
FC Pune City,3075,5,5,3,6,13,17,-4,18
Chennaiyin,3075,6,4,5,5,14,18,-4,17
NorthEast Un,3075,7,4,4,6,11,12,-1,16
FC Goa,3075,8,4,3,7,11,19,-8,15
Mumbai City,3076,1,7,4,3,17,8,9,25
Kerala Blast,3076,2,6,4,4,13,14,-1,22
Kolkata,3076,3,5,6,3,16,14,2,21
Delhi Dynamo,3076,4,5,5,4,25,17,8,20
NorthEast Un,3076,5,5,4,5,12,11,1,19
Chennaiyin,3076,6,3,7,4,13,17,-4,16
FC Pune City,3076,7,4,3,7,12,16,-4,15
FC Goa,3076,8,3,3,8,8,19,-11,12
Delhi Dynamo,3077,1,6,6,2,26,15,11,24
Mumbai City,3077,2,6,4,4,17,10,7,22
Kolkata,3077,3,5,7,2,21,15,6,22
Kerala Blast,3077,4,6,3,5,16,19,-3,21
NorthEast Un,3077,5,5,3,6,11,11,0,18
FC Pune City,3077,6,4,4,6,15,18,-3,16
Chennaiyin,3077,7,3,5,6,13,20,-7,14
FC Goa,3077,8,4,2,8,10,21,-11,14
Delhi Dynamo,3078,1,6,6,2,23,14,9,24
Mumbai City,3078,2,6,5,3,16,8,8,23
Chennaiyin,3078,3,5,5,4,18,18,0,20
Kolkata,3078,4,4,7,3,17,17,0,19
FC Pune City,3078,5,5,3,6,16,17,-1,18
Kerala Blast,3078,6,5,3,6,13,18,-5,18
NorthEast Un,3078,7,5,2,7,11,13,-2,17
FC Goa,3078,8,3,3,8,11,20,-9,12
Mumbai City,3079,1,7,4,3,20,10,10,25
Delhi Dynamo,3079,2,5,5,4,25,21,4,20
Kolkata,3079,3,4,8,2,18,15,3,20
NorthEast Un,3079,4,5,3,6,13,12,1,18
Kerala Blast,3079,5,4,6,4,12,16,-4,18
FC Goa,3079,6,4,4,6,13,17,-4,16
FC Pune City,3079,6,4,4,6,13,17,-4,16
Chennaiyin,3079,8,3,6,5,14,20,-6,15
Mumbai City,3080,1,7,4,3,17,8,9,25
Kolkata,3080,2,5,6,3,15,13,2,21
Delhi Dynamo,3080,3,4,7,3,23,17,6,19
Kerala Blast,3080,4,5,4,5,12,15,-3,19
NorthEast Un,3080,5,4,5,5,13,13,0,17
Chennaiyin,3080,6,3,7,4,15,19,-4,16
FC Goa,3080,7,4,4,6,10,15,-5,16
FC Pune City,3080,8,4,3,7,12,17,-5,15
Mumbai City,3081,1,7,4,3,20,8,12,25
Delhi Dynamo,3081,2,6,5,3,29,19,10,23
FC Pune City,3081,3,6,3,5,16,15,1,21
Kolkata,3081,4,4,7,3,17,17,0,19
Chennaiyin,3081,5,4,6,4,16,19,-3,18
NorthEast Un,3081,6,5,2,7,11,12,-1,17
Kerala Blast,3081,7,4,4,6,12,18,-6,16
FC Goa,3081,8,3,3,8,11,24,-13,12
Mumbai City,3082,1,6,5,3,16,8,8,23
Delhi Dynamo,3082,2,4,7,3,23,18,5,19
FC Pune City,3082,3,5,4,5,18,17,1,19
Kerala Blast,3082,4,5,4,5,13,19,-6,19
FC Goa,3082,5,5,3,6,13,17,-4,18
Kolkata,3082,6,3,8,3,17,17,0,17
NorthEast Un,3082,7,5,2,7,13,13,0,17
Chennaiyin,3082,8,4,5,5,15,19,-4,17
Mumbai City,3083,1,7,4,3,17,8,9,25
Kolkata,3083,2,5,7,2,19,16,3,22
NorthEast Un,3083,3,6,3,5,15,12,3,21
Delhi Dynamo,3083,4,4,6,4,26,21,5,18
Chennaiyin,3083,5,4,6,4,16,19,-3,18
Kerala Blast,3083,6,5,3,6,13,18,-5,18
FC Pune City,3083,7,4,3,7,12,17,-5,15
FC Goa,3083,8,3,4,7,14,21,-7,13
Mumbai City,3084,1,7,4,3,17,8,9,25
Kerala Blast,3084,2,6,4,4,14,16,-2,22
Delhi Dynamo,3084,3,5,6,3,22,15,7,21
FC Pune City,3084,4,5,3,6,13,15,-2,18
Chennaiyin,3084,5,4,5,5,17,20,-3,17
FC Goa,3084,6,5,2,7,12,16,-4,17
NorthEast Un,3084,7,4,4,6,11,13,-2,16
Kolkata,3084,8,3,6,5,15,18,-3,15
Delhi Dynamo,3085,1,6,6,2,26,16,10,24
Mumbai City,3085,2,6,5,3,18,10,8,23
FC Pune City,3085,3,6,3,5,15,15,0,21
Kolkata,3085,4,4,6,4,17,17,0,18
Chennaiyin,3085,5,4,6,4,16,18,-2,18
Kerala Blast,3085,6,5,3,6,12,19,-7,18
FC Goa,3085,7,4,3,7,13,18,-5,15
NorthEast Un,3085,8,4,2,8,10,14,-4,14
Mumbai City,3086,1,6,5,3,17,9,8,23
Kolkata,3086,2,4,8,2,16,14,2,20
Delhi Dynamo,3086,3,4,7,3,24,19,5,19
Kerala Blast,3086,4,5,4,5,13,16,-3,19
FC Pune City,3086,5,5,3,6,14,16,-2,18
Chennaiyin,3086,6,4,6,4,16,19,-3,18
NorthEast Un,3086,7,5,2,7,13,14,-1,17
FC Goa,3086,8,3,5,6,11,17,-6,14
Delhi Dynamo,3087,1,6,5,3,24,15,9,23
Mumbai City,3087,2,6,4,4,16,9,7,22
Kerala Blast,3087,3,6,4,4,14,14,0,22
Kolkata,3087,4,5,6,3,18,15,3,21
NorthEast Un,3087,5,5,4,5,12,11,1,19
Chennaiyin,3087,6,3,7,4,15,19,-4,16
FC Pune City,3087,7,4,3,7,13,20,-7,15
FC Goa,3087,8,3,3,8,10,19,-9,12
Mumbai City,3088,1,7,4,3,17,8,9,25
Kolkata,3088,2,6,6,2,18,14,4,24
Delhi Dynamo,3088,3,6,5,3,27,19,8,23
Kerala Blast,3088,4,6,3,5,14,17,-3,21
Chennaiyin,3088,5,5,5,4,17,19,-2,20
FC Pune City,3088,6,4,3,7,14,18,-4,15
NorthEast Un,3088,7,4,2,8,14,17,-3,14
FC Goa,3088,8,3,2,9,10,19,-9,11
Mumbai City,3089,1,6,4,4,16,9,7,22
Kolkata,3089,2,5,7,2,17,14,3,22
Kerala Blast,3089,3,6,4,4,13,13,0,22
Delhi Dynamo,3089,4,5,6,3,25,18,7,21
Chennaiyin,3089,5,4,6,4,15,18,-3,18
NorthEast Un,3089,6,4,4,6,10,11,-1,16
FC Pune City,3089,7,4,3,7,13,19,-6,15
FC Goa,3089,8,4,2,8,13,20,-7,14
Delhi Dynamo,3090,1,6,6,2,28,16,12,24
Mumbai City,3090,2,6,5,3,17,9,8,23
Kolkata,3090,3,5,7,2,17,14,3,22
Chennaiyin,3090,4,4,6,4,15,18,-3,18
Kerala Blast,3090,5,5,3,6,14,17,-3,18
NorthEast Un,3090,6,5,2,7,11,12,-1,17
FC Pune City,3090,7,4,3,7,12,18,-6,15
FC Goa,3090,8,3,4,7,11,21,-10,13
Mumbai City,3091,1,6,5,3,16,8,8,23
Kolkata,3091,2,5,6,3,22,15,7,21
Kerala Blast,3091,3,5,4,5,14,20,-6,19
Delhi Dynamo,3091,4,4,6,4,21,20,1,18
NorthEast Un,3091,5,5,3,6,12,11,1,18
Chennaiyin,3091,6,4,6,4,17,18,-1,18
FC Goa,3091,7,5,2,7,13,18,-5,17
FC Pune City,3091,8,4,4,6,15,20,-5,16
Mumbai City,3092,1,6,5,3,17,9,8,23
FC Pune City,3092,2,6,3,5,15,14,1,21
Kerala Blast,3092,3,6,3,5,16,20,-4,21
Delhi Dynamo,3092,4,4,7,3,24,19,5,19
NorthEast Un,3092,5,5,3,6,15,14,1,18
FC Goa,3092,6,5,3,6,15,17,-2,18
Kolkata,3092,7,3,6,5,16,19,-3,15
Chennaiyin,3092,8,3,6,5,16,22,-6,15
Delhi Dynamo,3093,1,6,6,2,26,17,9,24
Mumbai City,3093,2,6,4,4,16,9,7,22
Kolkata,3093,3,4,8,2,17,15,2,20
Kerala Blast,3093,4,5,4,5,13,15,-2,19
Chennaiyin,3093,5,4,6,4,16,18,-2,18
NorthEast Un,3093,6,4,5,5,12,12,0,17
FC Pune City,3093,7,4,4,6,14,19,-5,16
FC Goa,3093,8,3,3,8,11,20,-9,12
Mumbai City,3094,1,6,5,3,17,9,8,23
Delhi Dynamo,3094,2,5,7,2,26,18,8,22
FC Pune City,3094,3,6,3,5,17,16,1,21
Chennaiyin,3094,4,5,5,4,19,19,0,20
Kolkata,3094,5,4,7,3,18,17,1,19
Kerala Blast,3094,6,4,4,6,12,19,-7,16
NorthEast Un,3094,7,4,3,7,14,17,-3,15
FC Goa,3094,8,3,4,7,10,18,-8,13
Kerala Blast,3095,1,7,3,4,16,14,2,24
Mumbai City,3095,2,6,5,3,18,10,8,23
Delhi Dynamo,3095,3,5,6,3,25,18,7,21
Kolkata,3095,4,4,6,4,17,17,0,18
FC Pune City,3095,5,5,3,6,15,17,-2,18
NorthEast Un,3095,6,5,2,7,13,15,-2,17
FC Goa,3095,7,5,2,7,10,17,-7,17
Chennaiyin,3095,8,3,5,6,14,20,-6,14
Mumbai City,3096,1,7,4,3,19,8,11,25
Kolkata,3096,2,6,6,2,22,15,7,24
NorthEast Un,3096,3,7,2,5,17,11,6,23
Kerala Blast,3096,4,5,3,6,12,20,-8,18
Delhi Dynamo,3096,5,4,5,5,22,20,2,17
FC Goa,3096,6,5,2,7,13,18,-5,17
FC Pune City,3096,7,4,3,7,14,18,-4,15
Chennaiyin,3096,8,3,5,6,16,25,-9,14
Mumbai City,3097,1,6,5,3,17,9,8,23
Delhi Dynamo,3097,2,5,7,2,26,18,8,22
FC Pune City,3097,3,5,4,5,15,16,-1,19
Kerala Blast,3097,4,5,4,5,11,15,-4,19
Chennaiyin,3097,5,4,6,4,17,20,-3,18
Kolkata,3097,6,3,8,3,17,17,0,17
NorthEast Un,3097,7,4,4,6,10,11,-1,16
FC Goa,3097,8,3,4,7,14,21,-7,13
Mumbai City,3098,1,7,4,3,17,8,9,25
Kolkata,3098,2,6,6,2,19,13,6,24
Delhi Dynamo,3098,3,6,5,3,25,16,9,23
FC Pune City,3098,4,5,3,6,13,16,-3,18
NorthEast Un,3098,5,4,4,6,11,12,-1,16
Kerala Blast,3098,6,4,4,6,10,17,-7,16
Chennaiyin,3098,7,3,6,5,13,18,-5,15
FC Goa,3098,8,4,2,8,10,18,-8,14
Delhi Dynamo,3099,1,7,5,2,26,16,10,26
Mumbai City,3099,2,6,4,4,16,9,7,22
Kolkata,3099,3,5,7,2,19,13,6,22
FC Pune City,3099,4,5,4,5,15,16,-1,19
Kerala Blast,3099,5,5,3,6,12,18,-6,18
Chennaiyin,3099,6,4,5,5,17,19,-2,17
NorthEast Un,3099,7,4,2,8,10,15,-5,14
FC Goa,3099,8,4,2,8,12,21,-9,14
Mumbai City,3100,1,7,4,3,17,8,9,25
Delhi Dynamo,3100,2,5,6,3,26,18,8,21
NorthEast Un,3100,3,6,3,5,16,12,4,21
Kolkata,3100,4,4,7,3,20,15,5,19
Kerala Blast,3100,5,5,4,5,13,17,-4,19
Chennaiyin,3100,6,4,5,5,16,22,-6,17
FC Pune City,3100,7,4,3,7,13,21,-8,15
FC Goa,3100,8,4,2,8,13,21,-8,14
Delhi Dynamo,3101,1,5,7,2,25,15,10,22
Mumbai City,3101,2,6,4,4,16,11,5,22
FC Pune City,3101,3,5,4,5,17,16,1,19
Kolkata,3101,3,4,7,3,17,16,1,19
Kerala Blast,3101,5,5,4,5,12,18,-6,19
NorthEast Un,3101,6,4,5,5,10,10,0,17
Chennaiyin,3101,7,3,7,4,13,17,-4,16
FC Goa,3101,8,3,4,7,9,16,-7,13
Mumbai City,3102,1,7,4,3,19,8,11,25
Delhi Dynamo,3102,2,5,6,3,27,18,9,21
NorthEast Un,3102,3,6,3,5,14,12,2,21
FC Pune City,3102,4,5,4,5,16,17,-1,19
Kerala Blast,3102,5,5,3,6,12,16,-4,18
Kolkata,3102,6,3,7,4,16,19,-3,16
Chennaiyin,3102,7,3,6,5,16,21,-5,15
FC Goa,3102,8,4,3,7,12,21,-9,15
Delhi Dynamo,3103,1,6,5,3,26,18,8,23
NorthEast Un,3103,2,7,2,5,17,12,5,23
Mumbai City,3103,3,6,4,4,16,9,7,22
Kolkata,3103,4,4,7,3,16,16,0,19
FC Pune City,3103,5,5,4,5,16,17,-1,19
Chennaiyin,3103,6,4,5,5,16,20,-4,17
Kerala Blast,3103,7,4,3,7,13,22,-9,15
FC Goa,3103,8,4,2,8,13,19,-6,14
Mumbai City,3104,1,6,5,3,17,9,8,23
Delhi Dynamo,3104,2,5,6,3,24,18,6,21
Kerala Blast,3104,3,5,5,4,15,16,-1,20
NorthEast Un,3104,4,5,4,5,15,12,3,19
Kolkata,3104,5,4,7,3,19,18,1,19
Chennaiyin,3104,6,4,6,4,17,19,-2,18
FC Pune City,3104,7,4,3,7,14,21,-7,15
FC Goa,3104,8,4,2,8,10,18,-8,14
Mumbai City,3105,1,7,4,3,18,8,10,25
Delhi Dynamo,3105,2,5,6,3,25,18,7,21
NorthEast Un,3105,3,6,2,6,15,14,1,20
FC Pune City,3105,4,5,3,6,16,16,0,18
Kolkata,3105,5,4,6,4,17,21,-4,18
Kerala Blast,3105,6,5,3,6,11,16,-5,18
Chennaiyin,3105,7,4,5,5,17,22,-5,17
FC Goa,3105,8,4,3,7,14,18,-4,15
Mumbai City,3106,1,7,4,3,18,8,10,25
Delhi Dynamo,3106,2,5,6,3,23,17,6,21
Kerala Blast,3106,3,6,3,5,13,16,-3,21
Kolkata,3106,4,4,8,2,17,13,4,20
NorthEast Un,3106,5,5,2,7,11,12,-1,17
Chennaiyin,3106,6,4,5,5,15,20,-5,17
FC Pune City,3106,7,4,4,6,13,17,-4,16
FC Goa,3106,8,3,4,7,10,17,-7,13
Mumbai City,3107,1,7,4,3,17,8,9,25
Delhi Dynamo,3107,2,5,6,3,23,16,7,21
Kerala Blast,3107,3,5,5,4,14,15,-1,20
Kolkata,3107,4,4,7,3,17,16,1,19
FC Pune City,3107,5,5,4,5,16,16,0,19
Chennaiyin,3107,6,4,6,4,18,18,0,18
NorthEast Un,3107,7,4,2,8,10,18,-8,14
FC Goa,3107,8,3,4,7,9,17,-8,13
Mumbai City,3108,1,7,4,3,20,8,12,25
Kolkata,3108,2,5,7,2,17,14,3,22
Delhi Dynamo,3108,3,5,6,3,24,20,4,21
NorthEast Un,3108,4,6,2,6,16,13,3,20
Kerala Blast,3108,5,5,3,6,11,17,-6,18
FC Goa,3108,6,4,4,6,12,15,-3,16
FC Pune City,3108,7,4,3,7,14,18,-4,15
Chennaiyin,3108,8,3,5,6,14,23,-9,14
Mumbai City,3109,1,7,4,3,17,8,9,25
Delhi Dynamo,3109,2,6,5,3,25,16,9,23
Kolkata,3109,3,5,7,2,20,15,5,22
Kerala Blast,3109,4,6,3,5,14,17,-3,21
NorthEast Un,3109,5,4,3,7,11,14,-3,15
FC Goa,3109,6,4,3,7,15,20,-5,15
FC Pune City,3109,7,4,3,7,13,18,-5,15
Chennaiyin,3109,8,3,6,5,15,22,-7,15
Mumbai City,3110,1,7,4,3,19,9,10,25
Kolkata,3110,2,5,7,2,17,13,4,22
Delhi Dynamo,3110,3,5,6,3,24,17,7,21
Kerala Blast,3110,4,5,3,6,12,17,-5,18
NorthEast Un,3110,5,5,2,7,13,15,-2,17
Chennaiyin,3110,6,4,5,5,17,21,-4,17
FC Goa,3110,7,4,4,6,10,15,-5,16
FC Pune City,3110,8,4,3,7,13,18,-5,15
Mumbai City,3111,1,7,4,3,19,9,10,25
FC Pune City,3111,2,6,3,5,18,16,2,21
NorthEast Un,3111,3,5,4,5,14,13,1,19
FC Goa,3111,4,5,3,6,13,15,-2,18
Delhi Dynamo,3111,5,4,5,5,23,21,2,17
Kerala Blast,3111,6,4,5,5,12,18,-6,17
Kolkata,3111,7,3,7,4,15,18,-3,16
Chennaiyin,3111,8,3,7,4,16,20,-4,16
Delhi Dynamo,3112,1,6,5,3,27,17,10,23
Mumbai City,3112,2,6,4,4,16,9,7,22
FC Pune City,3112,3,6,3,5,19,16,3,21
Chennaiyin,3112,4,4,6,4,16,18,-2,18
Kolkata,3112,5,4,6,4,15,17,-2,18
Kerala Blast,3112,6,5,3,6,12,18,-6,18
NorthEast Un,3112,7,5,2,7,11,13,-2,17
FC Goa,3112,8,4,3,7,12,20,-8,15
Mumbai City,3113,1,6,5,3,16,8,8,23
Kerala Blast,3113,2,6,4,4,13,15,-2,22
Delhi Dynamo,3113,3,4,7,3,23,17,6,19
NorthEast Un,3113,4,5,4,5,12,11,1,19
Kolkata,3113,5,4,6,4,16,15,1,18
FC Goa,3113,6,5,3,6,13,17,-4,18
Chennaiyin,3113,7,3,6,5,14,19,-5,15
FC Pune City,3113,8,4,3,7,13,18,-5,15
Delhi Dynamo,3114,1,7,5,2,29,16,13,26
Mumbai City,3114,2,6,4,4,16,9,7,22
Kolkata,3114,3,5,7,2,16,13,3,22
FC Pune City,3114,4,5,3,6,16,16,0,18
Chennaiyin,3114,5,4,6,4,17,20,-3,18
NorthEast Un,3114,6,5,2,7,11,13,-2,17
Kerala Blast,3114,7,4,4,6,11,19,-8,16
FC Goa,3114,8,3,3,8,12,22,-10,12
Mumbai City,3115,1,6,5,3,17,9,8,23
Delhi Dynamo,3115,2,5,6,3,25,19,6,21
NorthEast Un,3115,3,6,3,5,13,10,3,21
Kerala Blast,3115,4,5,5,4,11,14,-3,20
Kolkata,3115,5,4,7,3,20,16,4,19
FC Pune City,3115,6,4,4,6,13,19,-6,16
FC Goa,3115,7,4,3,7,14,19,-5,15
Chennaiyin,3115,8,3,5,6,13,20,-7,14
Mumbai City,3116,1,7,4,3,19,9,10,25
Kolkata,3116,2,5,6,3,18,14,4,21
Kerala Blast,3116,3,6,3,5,12,14,-2,21
Delhi Dynamo,3116,4,5,5,4,23,19,4,20
Chennaiyin,3116,5,4,6,4,16,18,-2,18
FC Pune City,3116,6,5,3,6,14,18,-4,18
NorthEast Un,3116,7,5,2,7,11,13,-2,17
FC Goa,3116,8,3,3,8,9,17,-8,12
Mumbai City,3117,1,7,4,3,19,10,9,25
Delhi Dynamo,3117,2,5,6,3,26,18,8,21
Kolkata,3117,3,5,6,3,20,16,4,21
FC Pune City,3117,4,6,3,5,15,15,0,21
Kerala Blast,3117,5,5,3,6,14,18,-4,18
NorthEast Un,3117,6,5,2,7,11,16,-5,17
FC Goa,3117,7,4,3,7,12,18,-6,15
Chennaiyin,3117,8,3,5,6,15,21,-6,14
Mumbai City,3118,1,7,4,3,17,8,9,25
Kerala Blast,3118,2,6,3,5,14,16,-2,21
Delhi Dynamo,3118,3,5,5,4,28,17,11,20
Kolkata,3118,4,4,7,3,18,18,0,19
NorthEast Un,3118,5,5,3,6,12,12,0,18
Chennaiyin,3118,6,4,6,4,17,20,-3,18
FC Pune City,3118,7,4,4,6,14,18,-4,16
FC Goa,3118,8,4,2,8,12,23,-11,14
Mumbai City,3119,1,6,5,3,19,11,8,23
Kerala Blast,3119,2,6,3,5,14,15,-1,21
FC Goa,3119,3,6,2,6,12,15,-3,20
Delhi Dynamo,3119,4,4,7,3,24,18,6,19
Kolkata,3119,5,4,7,3,15,14,1,19
NorthEast Un,3119,6,5,3,6,10,12,-2,18
FC Pune City,3119,7,4,4,6,13,16,-3,16
Chennaiyin,3119,8,3,5,6,13,19,-6,14
Mumbai City,3120,1,7,4,3,17,8,9,25
Kerala Blast,3120,2,6,4,4,19,17,2,22
Delhi Dynamo,3120,3,5,6,3,26,18,8,21
Kolkata,3120,4,3,9,2,16,15,1,18
FC Pune City,3120,5,4,4,6,15,18,-3,16
NorthEast Un,3120,6,4,4,6,12,17,-5,16
Chennaiyin,3120,7,3,6,5,14,19,-5,15
FC Goa,3120,8,4,3,7,10,17,-7,15
Mumbai City,3121,1,7,4,3,17,8,9,25
Delhi Dynamo,3121,2,6,5,3,23,15,8,23
Kolkata,3121,3,4,8,2,17,15,2,20
FC Pune City,3121,4,5,4,5,14,15,-1,19
NorthEast Un,3121,5,5,3,6,12,12,0,18
Chennaiyin,3121,6,4,5,5,16,20,-4,17
Kerala Blast,3121,7,4,4,6,11,17,-6,16
FC Goa,3121,8,3,3,8,10,18,-8,12
Mumbai City,3122,1,7,4,3,18,8,10,25
Delhi Dynamo,3122,2,5,5,4,22,19,3,20
Kolkata,3122,3,4,8,2,17,15,2,20
NorthEast Un,3122,4,5,4,5,14,11,3,19
FC Pune City,3122,5,5,4,5,17,17,0,19
Chennaiyin,3122,6,4,6,4,17,18,-1,18
Kerala Blast,3122,7,4,4,6,11,18,-7,16
FC Goa,3122,8,3,3,8,9,19,-10,12
Mumbai City,3123,1,7,4,3,18,9,9,25
NorthEast Un,3123,2,7,2,5,15,9,6,23
FC Pune City,3123,3,5,4,5,17,15,2,19
Kolkata,3123,4,3,9,2,16,15,1,18
Delhi Dynamo,3123,5,4,5,5,23,22,1,17
FC Goa,3123,6,4,4,6,15,19,-4,16
Kerala Blast,3123,7,4,4,6,11,21,-10,16
Chennaiyin,3123,8,3,6,5,15,20,-5,15
Delhi Dynamo,3124,1,6,5,3,25,17,8,23
Mumbai City,3124,2,6,4,4,17,10,7,22
Kolkata,3124,3,5,7,2,17,14,3,22
Kerala Blast,3124,4,5,4,5,13,16,-3,19
Chennaiyin,3124,5,4,6,4,15,18,-3,18
NorthEast Un,3124,6,5,2,7,12,14,-2,17
FC Pune City,3124,7,4,4,6,14,17,-3,16
FC Goa,3124,8,3,4,7,10,17,-7,13
Delhi Dynamo,3125,1,7,5,2,28,16,12,26
Mumbai City,3125,2,6,4,4,18,11,7,22
Kerala Blast,3125,3,6,4,4,13,13,0,22
Chennaiyin,3125,4,4,6,4,18,19,-1,18
Kolkata,3125,5,3,8,3,16,17,-1,17
FC Pune City,3125,6,4,5,5,13,15,-2,17
NorthEast Un,3125,7,4,2,8,10,17,-7,14
FC Goa,3125,8,3,4,7,11,19,-8,13
Delhi Dynamo,3126,1,6,6,2,27,16,11,24
Mumbai City,3126,2,6,5,3,17,9,8,23
Kolkata,3126,3,5,7,2,20,16,4,22
Kerala Blast,3126,4,5,4,5,13,18,-5,19
NorthEast Un,3126,5,4,4,6,12,13,-1,16
FC Pune City,3126,6,4,3,7,15,19,-4,15
FC Goa,3126,7,4,3,7,12,18,-6,15
Chennaiyin,3126,8,3,6,5,14,21,-7,15
Kolkata,3127,1,6,6,2,21,14,7,24
Mumbai City,3127,2,6,5,3,18,10,8,23
Delhi Dynamo,3127,3,5,7,2,24,16,8,22
Kerala Blast,3127,4,6,3,5,17,19,-2,21
NorthEast Un,3127,5,5,3,6,11,12,-1,18
Chennaiyin,3127,6,4,5,5,15,19,-4,17
FC Pune City,3127,7,4,3,7,14,21,-7,15
FC Goa,3127,8,3,2,9,9,18,-9,11
Mumbai City,3128,1,6,4,4,17,10,7,22
Kolkata,3128,2,5,7,2,17,14,3,22
Delhi Dynamo,3128,3,5,6,3,25,19,6,21
NorthEast Un,3128,4,6,3,5,16,12,4,21
Chennaiyin,3128,5,4,6,4,18,20,-2,18
Kerala Blast,3128,6,4,5,5,11,17,-6,17
FC Pune City,3128,7,4,4,6,14,17,-3,16
FC Goa,3128,8,3,3,8,12,21,-9,12
Delhi Dynamo,3129,1,6,6,2,28,16,12,24
Kolkata,3129,2,6,6,2,24,14,10,24
Mumbai City,3129,3,6,4,4,16,11,5,22
Kerala Blast,3129,4,5,4,5,12,18,-6,19
Chennaiyin,3129,5,4,5,5,18,20,-2,17
NorthEast Un,3129,6,4,4,6,14,17,-3,16
FC Pune City,3129,7,4,3,7,13,18,-5,15
FC Goa,3129,8,4,2,8,9,20,-11,14
Mumbai City,3130,1,6,5,3,17,9,8,23
Delhi Dynamo,3130,2,5,6,3,25,17,8,21
Kolkata,3130,3,4,7,3,19,16,3,19
FC Pune City,3130,4,5,4,5,15,15,0,19
Kerala Blast,3130,5,5,3,6,13,21,-8,18
NorthEast Un,3130,6,5,2,7,13,15,-2,17
Chennaiyin,3130,7,4,5,5,16,20,-4,17
FC Goa,3130,8,5,2,7,11,16,-5,17
Mumbai City,3131,1,6,5,3,17,9,8,23
Kerala Blast,3131,2,6,4,4,14,15,-1,22
NorthEast Un,3131,3,6,2,6,13,12,1,20
Delhi Dynamo,3131,4,4,7,3,23,18,5,19
FC Pune City,3131,5,5,3,6,16,18,-2,18
Kolkata,3131,6,3,8,3,18,18,0,17
Chennaiyin,3131,7,3,6,5,14,19,-5,15
FC Goa,3131,8,3,5,6,11,17,-6,14
Mumbai City,3132,1,7,4,3,17,8,9,25
NorthEast Un,3132,2,6,3,5,13,11,2,21
Kerala Blast,3132,3,5,4,5,12,15,-3,19
Delhi Dynamo,3132,4,4,6,4,22,17,5,18
FC Goa,3132,5,5,3,6,12,14,-2,18
FC Pune City,3132,6,5,3,6,14,17,-3,18
Kolkata,3132,7,3,7,4,14,15,-1,16
Chennaiyin,3132,8,3,6,5,13,20,-7,15
Mumbai City,3133,1,6,5,3,17,9,8,23
Delhi Dynamo,3133,2,5,7,2,26,18,8,22
Kolkata,3133,3,5,6,3,19,16,3,21
NorthEast Un,3133,4,5,3,6,17,16,1,18
FC Pune City,3133,5,5,3,6,15,16,-1,18
Kerala Blast,3133,6,5,3,6,12,20,-8,18
FC Goa,3133,7,5,2,7,13,17,-4,17
Chennaiyin,3133,8,3,5,6,15,22,-7,14
Mumbai City,3134,1,7,4,3,18,9,9,25
Kolkata,3134,2,6,6,2,19,14,5,24
Kerala Blast,3134,3,6,3,5,16,16,0,21
Delhi Dynamo,3134,4,4,6,4,24,20,4,18
NorthEast Un,3134,5,5,3,6,12,12,0,18
Chennaiyin,3134,6,3,7,4,14,18,-4,16
FC Pune City,3134,7,4,3,7,14,21,-7,15
FC Goa,3134,8,3,4,7,10,17,-7,13
Delhi Dynamo,3135,1,6,6,2,23,14,9,24
Mumbai City,3135,2,6,4,4,16,9,7,22
Kolkata,3135,3,4,7,3,15,14,1,19
Kerala Blast,3135,4,5,4,5,15,17,-2,19
NorthEast Un,3135,5,5,3,6,11,12,-1,18
FC Pune City,3135,6,4,5,5,14,16,-2,17
Chennaiyin,3135,7,4,5,5,15,19,-4,17
FC Goa,3135,8,4,2,8,9,17,-8,14
Mumbai City,3136,1,6,5,3,17,9,8,23
Delhi Dynamo,3136,2,5,6,3,25,17,8,21
Kolkata,3136,3,5,6,3,18,16,2,21
Kerala Blast,3136,4,5,4,5,15,19,-4,19
NorthEast Un,3136,5,5,3,6,13,14,-1,18
Chennaiyin,3136,6,4,5,5,16,19,-3,17
FC Goa,3136,7,5,2,7,12,18,-6,17
FC Pune City,3136,8,4,3,7,13,17,-4,15
Delhi Dynamo,3137,1,6,5,3,26,17,9,23
NorthEast Un,3137,2,7,2,5,14,10,4,23
Mumbai City,3137,3,6,4,4,18,11,7,22
Kerala Blast,3137,4,6,3,5,11,15,-4,21
Kolkata,3137,5,4,7,3,15,14,1,19
FC Pune City,3137,6,4,4,6,12,15,-3,16
Chennaiyin,3137,7,3,6,5,15,20,-5,15
FC Goa,3137,8,3,3,8,10,19,-9,12
Mumbai City,3138,1,7,4,3,18,8,10,25
Delhi Dynamo,3138,2,5,6,3,22,16,6,21
NorthEast Un,3138,3,5,4,5,13,12,1,19
FC Pune City,3138,4,5,4,5,15,16,-1,19
Kerala Blast,3138,5,5,4,5,13,17,-4,19
FC Goa,3138,6,5,2,7,12,16,-4,17
Kolkata,3138,7,3,7,4,17,19,-2,16
Chennaiyin,3138,8,3,5,6,14,20,-6,14
Mumbai City,3139,1,7,4,3,17,8,9,25
Delhi Dynamo,3139,2,5,6,3,23,16,7,21
Kolkata,3139,3,5,6,3,20,16,4,21
FC Pune City,3139,4,6,3,5,18,17,1,21
NorthEast Un,3139,5,5,3,6,15,12,3,18
Kerala Blast,3139,6,5,3,6,11,18,-7,18
Chennaiyin,3139,7,4,5,5,14,21,-7,17
FC Goa,3139,8,3,2,9,8,18,-10,11
Mumbai City,3140,1,7,4,3,18,8,10,25
Kerala Blast,3140,2,6,4,4,15,16,-1,22
Delhi Dynamo,3140,3,5,5,4,22,19,3,20
NorthEast Un,3140,4,5,3,6,13,11,2,18
Chennaiyin,3140,5,4,6,4,16,19,-3,18
Kolkata,3140,5,4,6,4,16,19,-3,18
FC Pune City,3140,7,4,4,6,16,19,-3,16
FC Goa,3140,8,4,2,8,13,18,-5,14
Delhi Dynamo,3141,1,7,5,2,26,14,12,26
Mumbai City,3141,2,6,4,4,16,9,7,22
FC Pune City,3141,3,6,3,5,17,16,1,21
Kolkata,3141,4,4,7,3,18,15,3,19
NorthEast Un,3141,5,5,3,6,13,11,2,18
Kerala Blast,3141,6,4,5,5,9,15,-6,17
Chennaiyin,3141,7,3,6,5,15,22,-7,15
FC Goa,3141,8,3,3,8,9,21,-12,12
Delhi Dynamo,3142,1,6,5,3,26,17,9,23
Kolkata,3142,2,5,7,2,22,16,6,22
Mumbai City,3142,3,6,4,4,16,10,6,22
NorthEast Un,3142,4,6,3,5,13,11,2,21
FC Pune City,3142,5,5,3,6,16,20,-4,18
FC Goa,3142,6,4,3,7,13,18,-5,15
Chennaiyin,3142,7,3,6,5,14,20,-6,15
Kerala Blast,3142,8,4,3,7,10,18,-8,15
Mumbai City,3143,1,7,4,3,19,8,11,25
Kolkata,3143,2,5,6,3,20,15,5,21
FC Pune City,3143,3,6,3,5,16,15,1,21
Delhi Dynamo,3143,4,4,6,4,21,19,2,18
NorthEast Un,3143,5,5,3,6,14,14,0,18
Chennaiyin,3143,6,4,6,4,18,21,-3,18
Kerala Blast,3143,7,5,3,6,12,19,-7,18
FC Goa,3143,8,3,3,8,10,19,-9,12
Mumbai City,3144,1,7,4,3,19,8,11,25
NorthEast Un,3144,2,6,3,5,15,12,3,21
Delhi Dynamo,3144,3,5,5,4,24,19,5,20
Kolkata,3144,4,4,7,3,15,15,0,19
Kerala Blast,3144,5,5,4,5,12,16,-4,19
FC Goa,3144,6,5,2,7,14,17,-3,17
FC Pune City,3144,7,4,4,6,12,16,-4,16
Chennaiyin,3144,8,3,5,6,15,23,-8,14
Mumbai City,3145,1,6,5,3,16,8,8,23
Delhi Dynamo,3145,2,5,7,2,25,17,8,22
Kerala Blast,3145,3,6,4,4,14,14,0,22
NorthEast Un,3145,4,5,3,6,14,14,0,18
FC Pune City,3145,5,5,3,6,17,19,-2,18
Chennaiyin,3145,6,4,5,5,16,20,-4,17
Kolkata,3145,7,3,7,4,14,17,-3,16
FC Goa,3145,8,4,2,8,10,17,-7,14
Delhi Dynamo,3146,1,6,6,2,27,16,11,24
Mumbai City,3146,2,6,4,4,17,11,6,22
Kolkata,3146,3,5,6,3,16,13,3,21
Kerala Blast,3146,4,6,3,5,12,14,-2,21
NorthEast Un,3146,5,5,3,6,14,13,1,18
FC Pune City,3146,6,5,3,6,13,15,-2,18
FC Goa,3146,7,4,2,8,13,19,-6,14
Chennaiyin,3146,8,3,5,6,15,26,-11,14
Mumbai City,3147,1,7,4,3,18,9,9,25
Kerala Blast,3147,2,7,3,4,14,13,1,24
Delhi Dynamo,3147,3,4,7,3,23,17,6,19
Kolkata,3147,4,4,7,3,16,16,0,19
Chennaiyin,3147,5,4,5,5,15,19,-4,17
FC Pune City,3147,6,4,4,6,13,17,-4,16
NorthEast Un,3147,7,4,3,7,9,11,-2,15
FC Goa,3147,8,4,3,7,12,18,-6,15
Mumbai City,3148,1,7,4,3,19,8,11,25
NorthEast Un,3148,2,6,3,5,13,10,3,21
Kolkata,3148,3,4,7,3,16,14,2,19
Kerala Blast,3148,4,5,4,5,10,15,-5,19
Delhi Dynamo,3148,5,4,6,4,22,20,2,18
Chennaiyin,3148,6,4,5,5,16,20,-4,17
FC Pune City,3148,7,4,4,6,13,16,-3,16
FC Goa,3148,8,4,3,7,11,17,-6,15
Mumbai City,3149,1,7,4,3,17,8,9,25
Kolkata,3149,2,5,6,3,17,15,2,21
NorthEast Un,3149,3,5,4,5,14,11,3,19
Kerala Blast,3149,4,5,4,5,10,15,-5,19
FC Goa,3149,5,5,3,6,12,15,-3,18
Delhi Dynamo,3149,6,4,5,5,21,19,2,17
Chennaiyin,3149,7,3,7,4,16,20,-4,16
FC Pune City,3149,8,4,3,7,13,17,-4,15
Mumbai City,3150,1,7,4,3,17,8,9,25
Kolkata,3150,2,5,7,2,19,14,5,22
Delhi Dynamo,3150,3,5,6,3,25,18,7,21
Kerala Blast,3150,4,6,3,5,13,17,-4,21
NorthEast Un,3150,5,5,3,6,15,14,1,18
FC Pune City,3150,6,4,3,7,14,18,-4,15
FC Goa,3150,7,4,3,7,12,18,-6,15
Chennaiyin,3150,8,3,5,6,15,23,-8,14
Kolkata,3151,1,6,6,2,22,17,5,24
Mumbai City,3151,2,6,4,4,17,10,7,22
Delhi Dynamo,3151,3,5,6,3,24,18,6,21
NorthEast Un,3151,4,5,4,5,11,10,1,19
FC Pune City,3151,5,5,3,6,17,19,-2,18
Chennaiyin,3151,6,3,7,4,15,19,-4,16
FC Goa,3151,7,4,3,7,14,20,-6,15
Kerala Blast,3151,8,4,3,7,12,19,-7,15
Mumbai City,3152,1,7,4,3,18,9,9,25
Kolkata,3152,2,6,6,2,20,16,4,24
Delhi Dynamo,3152,3,5,6,3,24,17,7,21
NorthEast Un,3152,4,6,3,5,14,10,4,21
Kerala Blast,3152,5,5,3,6,11,18,-7,18
FC Pune City,3152,6,4,3,7,14,18,-4,15
Chennaiyin,3152,7,3,6,5,13,18,-5,15
FC Goa,3152,8,3,3,8,9,17,-8,12
Mumbai City,3153,1,7,4,3,18,8,10,25
Kerala Blast,3153,2,6,4,4,17,16,1,22
NorthEast Un,3153,3,5,4,5,17,15,2,19
FC Pune City,3153,4,5,3,6,17,19,-2,18
Kolkata,3153,5,4,6,4,18,21,-3,18
Delhi Dynamo,3153,6,4,5,5,25,23,2,17
Chennaiyin,3153,7,3,7,4,16,20,-4,16
FC Goa,3153,8,4,3,7,14,20,-6,15
Delhi Dynamo,3154,1,6,5,3,24,17,7,23
Mumbai City,3154,2,6,4,4,17,10,7,22
FC Goa,3154,3,6,2,6,13,14,-1,20
Kolkata,3154,4,4,6,4,16,16,0,18
NorthEast Un,3154,5,5,3,6,10,10,0,18
FC Pune City,3154,6,5,3,6,16,17,-1,18
Kerala Blast,3154,7,5,3,6,12,18,-6,18
Chennaiyin,3154,8,3,6,5,13,19,-6,15
Mumbai City,3155,1,7,4,3,18,9,9,25
Delhi Dynamo,3155,2,5,6,3,26,16,10,21
NorthEast Un,3155,3,5,4,5,12,11,1,19
Kerala Blast,3155,4,5,4,5,12,16,-4,19
Kolkata,3155,5,4,6,4,16,15,1,18
FC Pune City,3155,6,5,3,6,13,16,-3,18
FC Goa,3155,7,5,2,7,11,18,-7,17
Chennaiyin,3155,8,3,5,6,14,21,-7,14
Mumbai City,3156,1,7,4,3,17,8,9,25
Kolkata,3156,2,6,6,2,19,12,7,24
Kerala Blast,3156,3,6,3,5,12,17,-5,21
Chennaiyin,3156,4,5,5,4,16,17,-1,20
Delhi Dynamo,3156,5,4,5,5,22,18,4,17
NorthEast Un,3156,6,5,2,7,12,14,-2,17
FC Pune City,3156,7,4,3,7,12,17,-5,15
FC Goa,3156,8,4,2,8,9,16,-7,14
Delhi Dynamo,3157,1,6,5,3,25,17,8,23
Mumbai City,3157,2,6,4,4,16,9,7,22
FC Pune City,3157,3,6,3,5,16,15,1,21
Kerala Blast,3157,4,6,3,5,12,15,-3,21
Kolkata,3157,5,4,6,4,14,15,-1,18
NorthEast Un,3157,6,5,2,7,12,12,0,17
Chennaiyin,3157,7,4,5,5,15,19,-4,17
FC Goa,3157,8,4,2,8,10,18,-8,14
Delhi Dynamo,3158,1,6,6,2,26,16,10,24
Mumbai City,3158,2,6,5,3,17,9,8,23
Chennaiyin,3158,3,5,5,4,19,20,-1,20
Kolkata,3158,4,4,7,3,18,14,4,19
FC Pune City,3158,5,5,4,5,14,14,0,19
Kerala Blast,3158,6,5,3,6,11,19,-8,18
NorthEast Un,3158,7,4,2,8,9,15,-6,14
FC Goa,3158,8,4,2,8,14,21,-7,14
Delhi Dynamo,3159,1,6,6,2,27,17,10,24
Mumbai City,3159,2,6,4,4,16,10,6,22
Chennaiyin,3159,3,5,5,4,15,17,-2,20
FC Pune City,3159,4,5,4,5,16,16,0,19
Kolkata,3159,5,4,6,4,15,17,-2,18
NorthEast Un,3159,6,5,2,7,12,12,0,17
Kerala Blast,3159,7,4,4,6,12,19,-7,16
FC Goa,3159,8,4,3,7,12,17,-5,15
Mumbai City,3160,1,7,4,3,19,8,11,25
Kolkata,3160,2,6,6,2,21,14,7,24
Kerala Blast,3160,3,6,3,5,14,17,-3,21
Delhi Dynamo,3160,4,4,6,4,22,19,3,18
NorthEast Un,3160,5,5,2,7,12,15,-3,17
Chennaiyin,3160,6,4,5,5,16,20,-4,17
FC Pune City,3160,7,4,3,7,13,18,-5,15
FC Goa,3160,8,4,3,7,11,17,-6,15
Delhi Dynamo,3161,1,7,5,2,28,16,12,26
Mumbai City,3161,2,6,4,4,16,9,7,22
Kerala Blast,3161,3,6,4,4,15,17,-2,22
Chennaiyin,3161,4,5,5,4,17,18,-1,20
Kolkata,3161,5,3,9,2,19,18,1,18
FC Pune City,3161,6,4,4,6,15,18,-3,16
NorthEast Un,3161,7,4,2,8,12,15,-3,14
FC Goa,3161,8,3,3,8,11,22,-11,12
Mumbai City,3162,1,7,4,3,19,10,9,25
Kolkata,3162,2,5,7,2,20,14,6,22
Kerala Blast,3162,3,5,4,5,12,15,-3,19
Delhi Dynamo,3162,4,4,6,4,25,20,5,18
FC Pune City,3162,5,5,3,6,15,17,-2,18
FC Goa,3162,6,5,2,7,15,23,-8,17
NorthEast Un,3162,7,4,4,6,9,11,-2,16
Chennaiyin,3162,8,3,6,5,15,20,-5,15
Delhi Dynamo,3163,1,7,5,2,27,15,12,26
Mumbai City,3163,2,6,4,4,16,10,6,22
Kerala Blast,3163,3,5,5,4,12,15,-3,20
FC Pune City,3163,4,5,4,5,14,14,0,19
Kolkata,3163,5,4,6,4,16,16,0,18
NorthEast Un,3163,6,5,3,6,12,13,-1,18
Chennaiyin,3163,7,3,6,5,14,19,-5,15
FC Goa,3163,8,3,3,8,9,18,-9,12
Mumbai City,3164,1,7,4,3,18,8,10,25
Kolkata,3164,2,5,6,3,22,15,7,21
Delhi Dynamo,3164,3,5,5,4,24,18,6,20
FC Goa,3164,4,6,2,6,15,15,0,20
FC Pune City,3164,5,5,3,6,16,18,-2,18
NorthEast Un,3164,6,4,4,6,10,12,-2,16
Kerala Blast,3164,7,4,4,6,10,21,-11,16
Chennaiyin,3164,8,3,6,5,13,21,-8,15
Delhi Dynamo,3165,1,7,5,2,27,17,10,26
Mumbai City,3165,2,6,4,4,17,10,7,22
Kolkata,3165,3,4,8,2,17,15,2,20
NorthEast Un,3165,4,6,2,6,13,11,2,20
Kerala Blast,3165,5,5,4,5,13,18,-5,19
FC Pune City,3165,6,4,3,7,13,17,-4,15
Chennaiyin,3165,7,3,6,5,13,18,-5,15
FC Goa,3165,8,3,4,7,10,17,-7,13
Mumbai City,3166,1,7,4,3,17,8,9,25
Kerala Blast,3166,2,7,3,4,13,14,-1,24
Delhi Dynamo,3166,3,4,7,3,25,19,6,19
NorthEast Un,3166,4,5,3,6,14,14,0,18
Kolkata,3166,5,3,7,4,14,15,-1,16
FC Pune City,3166,6,4,4,6,13,16,-3,16
FC Goa,3166,7,4,4,6,13,18,-5,16
Chennaiyin,3166,8,3,6,5,16,21,-5,15
Mumbai City,3167,1,6,5,3,17,9,8,23
Delhi Dynamo,3167,2,5,6,3,26,19,7,21
Kolkata,3167,3,4,7,3,19,18,1,19
FC Pune City,3167,4,5,4,5,15,15,0,19
Kerala Blast,3167,5,5,4,5,13,18,-5,19
NorthEast Un,3167,6,5,3,6,14,14,0,18
Chennaiyin,3167,7,3,7,4,16,20,-4,16
FC Goa,3167,8,3,4,7,12,19,-7,13
Delhi Dynamo,3168,1,6,6,2,27,16,11,24
Mumbai City,3168,2,6,4,4,16,10,6,22
FC Pune City,3168,3,6,3,5,16,15,1,21
Chennaiyin,3168,4,5,5,4,18,18,0,20
Kolkata,3168,5,4,6,4,17,18,-1,18
Kerala Blast,3168,6,5,3,6,13,19,-6,18
NorthEast Un,3168,7,5,2,7,12,15,-3,17
FC Goa,3168,8,3,3,8,11,19,-8,12
Delhi Dynamo,3169,1,7,5,2,29,15,14,26
Mumbai City,3169,2,6,4,4,16,11,5,22
Kolkata,3169,3,5,6,3,16,13,3,21
Kerala Blast,3169,4,5,5,4,11,14,-3,20
NorthEast Un,3169,5,5,3,6,14,13,1,18
FC Pune City,3169,6,4,4,6,12,16,-4,16
Chennaiyin,3169,7,3,6,5,14,21,-7,15
FC Goa,3169,8,3,3,8,9,18,-9,12
Mumbai City,3170,1,6,5,3,17,9,8,23
Kerala Blast,3170,2,6,4,4,14,15,-1,22
Delhi Dynamo,3170,3,5,6,3,23,16,7,21
Chennaiyin,3170,4,5,5,4,19,18,1,20
Kolkata,3170,5,4,7,3,17,15,2,19
FC Pune City,3170,6,5,3,6,13,16,-3,18
NorthEast Un,3170,7,5,2,7,11,13,-2,17
FC Goa,3170,8,3,2,9,10,22,-12,11
Mumbai City,3171,1,6,5,3,16,8,8,23
FC Pune City,3171,2,6,3,5,15,15,0,21
Kerala Blast,3171,3,6,3,5,12,14,-2,21
Delhi Dynamo,3171,4,4,8,2,25,18,7,20
Kolkata,3171,5,4,6,4,17,16,1,18
NorthEast Un,3171,6,5,3,6,11,12,-1,18
Chennaiyin,3171,7,4,5,5,16,19,-3,17
FC Goa,3171,8,3,3,8,13,23,-10,12
NorthEast Un,3172,1,7,2,5,16,11,5,23
Mumbai City,3172,2,6,4,4,17,10,7,22
Delhi Dynamo,3172,3,5,6,3,24,18,6,21
Kerala Blast,3172,4,6,3,5,13,16,-3,21
Kolkata,3172,5,4,7,3,19,18,1,19
FC Goa,3172,6,4,4,6,15,17,-2,16
FC Pune City,3172,7,4,3,7,16,21,-5,15
Chennaiyin,3172,8,3,5,6,16,25,-9,14
Mumbai City,3173,1,7,4,3,19,9,10,25
NorthEast Un,3173,2,6,2,6,14,14,0,20
Kerala Blast,3173,3,5,4,5,11,15,-4,19
Delhi Dynamo,3173,4,4,6,4,25,21,4,18
FC Goa,3173,5,5,3,6,14,16,-2,18
FC Pune City,3173,6,4,5,5,12,14,-2,17
Chennaiyin,3173,7,4,5,5,16,19,-3,17
Kolkata,3173,8,3,7,4,15,18,-3,16
Mumbai City,3174,1,7,4,3,19,8,11,25
Kolkata,3174,2,6,6,2,19,14,5,24
Delhi Dynamo,3174,3,5,5,4,23,19,4,20
NorthEast Un,3174,4,5,3,6,12,11,1,18
FC Pune City,3174,5,5,3,6,16,16,0,18
FC Goa,3174,6,5,2,7,12,17,-5,17
Kerala Blast,3174,7,4,4,6,11,20,-9,16
Chennaiyin,3174,8,3,5,6,14,21,-7,14
Mumbai City,3175,1,7,4,3,19,9,10,25
Kolkata,3175,2,5,6,3,17,17,0,21
FC Goa,3175,3,6,2,6,19,14,5,20
FC Pune City,3175,4,5,3,6,15,17,-2,18
Kerala Blast,3175,5,5,3,6,14,17,-3,18
Delhi Dynamo,3175,6,4,5,5,22,23,-1,17
Chennaiyin,3175,7,4,5,5,18,21,-3,17
NorthEast Un,3175,8,5,2,7,12,18,-6,17
Mumbai City,3176,1,7,4,3,19,10,9,25
Kolkata,3176,2,5,7,2,17,14,3,22
Delhi Dynamo,3176,3,5,5,4,29,20,9,20
Chennaiyin,3176,4,5,5,4,16,17,-1,20
Kerala Blast,3176,5,5,4,5,12,16,-4,19
FC Pune City,3176,6,4,5,5,13,15,-2,17
NorthEast Un,3176,7,5,2,7,12,14,-2,17
FC Goa,3176,8,3,2,9,9,21,-12,11
Mumbai City,3177,1,7,4,3,19,9,10,25
Delhi Dynamo,3177,2,6,5,3,26,19,7,23
Kerala Blast,3177,3,6,4,4,15,17,-2,22
Kolkata,3177,4,5,6,3,20,16,4,21
Chennaiyin,3177,5,5,5,4,16,18,-2,20
FC Pune City,3177,6,4,4,6,13,17,-4,16
NorthEast Un,3177,7,4,2,8,12,15,-3,14
FC Goa,3177,8,3,2,9,10,20,-10,11
Mumbai City,3178,1,7,4,3,18,8,10,25
Kerala Blast,3178,2,7,3,4,15,15,0,24
Delhi Dynamo,3178,3,5,5,4,23,18,5,20
Kolkata,3178,4,4,6,4,19,17,2,18
NorthEast Un,3178,5,5,2,7,11,12,-1,17
Chennaiyin,3178,6,4,5,5,14,18,-4,17
FC Goa,3178,7,5,2,7,13,18,-5,17
FC Pune City,3178,8,4,3,7,14,21,-7,15
Delhi Dynamo,3179,1,6,5,3,26,17,9,23
Mumbai City,3179,2,6,4,4,16,9,7,22
Kolkata,3179,3,5,7,2,18,14,4,22
Chennaiyin,3179,4,5,5,4,17,17,0,20
Kerala Blast,3179,5,5,4,5,13,17,-4,19
NorthEast Un,3179,6,5,2,7,12,13,-1,17
FC Pune City,3179,7,4,4,6,13,17,-4,16
FC Goa,3179,8,3,3,8,8,19,-11,12
Delhi Dynamo,3180,1,7,5,2,28,14,14,26
Mumbai City,3180,2,6,4,4,16,12,4,22
Kolkata,3180,3,4,8,2,16,14,2,20
FC Pune City,3180,4,5,4,5,15,14,1,19
Chennaiyin,3180,5,4,6,4,18,19,-1,18
Kerala Blast,3180,6,5,3,6,11,18,-7,18
NorthEast Un,3180,7,4,2,8,10,15,-5,14
FC Goa,3180,8,3,4,7,10,18,-8,13
Kerala Blast,3181,1,7,3,4,13,14,-1,24
Delhi Dynamo,3181,2,6,5,3,25,18,7,23
Mumbai City,3181,3,6,4,4,17,10,7,22
Kolkata,3181,4,5,6,3,16,14,2,21
NorthEast Un,3181,5,6,2,6,13,11,2,20
FC Pune City,3181,6,4,3,7,12,16,-4,15
Chennaiyin,3181,7,3,5,6,13,19,-6,14
FC Goa,3181,8,4,2,8,11,18,-7,14
Mumbai City,3182,1,6,5,3,17,9,8,23
Delhi Dynamo,3182,2,5,6,3,24,17,7,21
Kolkata,3182,3,4,7,3,16,15,1,19
Kerala Blast,3182,4,5,4,5,13,16,-3,19
FC Pune City,3182,5,5,3,6,14,17,-3,18
FC Goa,3182,6,5,3,6,12,15,-3,18
NorthEast Un,3182,7,4,4,6,11,13,-2,16
Chennaiyin,3182,8,3,6,5,15,20,-5,15
Mumbai City,3183,1,6,5,3,17,9,8,23
Kerala Blast,3183,2,6,4,4,14,15,-1,22
NorthEast Un,3183,3,6,3,5,13,10,3,21
Delhi Dynamo,3183,4,4,6,4,23,18,5,18
Kolkata,3183,5,3,8,3,14,14,0,17
Chennaiyin,3183,6,4,5,5,16,21,-5,17
FC Pune City,3183,7,4,4,6,15,19,-4,16
FC Goa,3183,8,4,3,7,11,17,-6,15
Mumbai City,3184,1,6,5,3,17,9,8,23
Delhi Dynamo,3184,2,5,6,3,27,19,8,21
Kolkata,3184,3,4,8,2,17,14,3,20
NorthEast Un,3184,4,6,2,6,16,14,2,20
FC Pune City,3184,5,5,4,5,15,16,-1,19
Kerala Blast,3184,6,5,3,6,13,18,-5,18
FC Goa,3184,7,4,3,7,13,20,-7,15
Chennaiyin,3184,8,3,5,6,15,23,-8,14
Mumbai City,3185,1,7,4,3,22,9,13,25
Kerala Blast,3185,2,6,4,4,16,13,3,22
Delhi Dynamo,3185,3,5,5,4,23,22,1,20
Kolkata,3185,4,4,7,3,16,15,1,19
NorthEast Un,3185,5,4,4,6,9,10,-1,16
Chennaiyin,3185,6,3,7,4,14,18,-4,16
FC Pune City,3185,7,4,4,6,13,20,-7,16
FC Goa,3185,8,4,3,7,11,17,-6,15
Mumbai City,3186,1,7,4,3,17,8,9,25
Kolkata,3186,2,4,8,2,21,15,6,20
NorthEast Un,3186,3,6,2,6,13,11,2,20
Kerala Blast,3186,4,5,4,5,12,17,-5,19
FC Pune City,3186,5,5,3,6,15,20,-5,18
Delhi Dynamo,3186,6,4,5,5,22,19,3,17
FC Goa,3186,7,4,4,6,14,19,-5,16
Chennaiyin,3186,8,3,6,5,16,21,-5,15
Kolkata,3187,1,6,6,2,19,15,4,24
Mumbai City,3187,2,6,5,3,17,9,8,23
Delhi Dynamo,3187,3,5,7,2,25,17,8,22
Kerala Blast,3187,4,5,4,5,12,15,-3,19
Chennaiyin,3187,5,4,6,4,16,19,-3,18
NorthEast Un,3187,6,4,4,6,10,11,-1,16
FC Pune City,3187,7,4,3,7,15,20,-5,15
FC Goa,3187,8,3,3,8,12,20,-8,12
Delhi Dynamo,3188,1,6,6,2,24,15,9,24
Mumbai City,3188,2,6,5,3,17,9,8,23
Kolkata,3188,3,4,8,2,17,13,4,20
FC Pune City,3188,4,5,4,5,14,14,0,19
Kerala Blast,3188,5,5,4,5,11,16,-5,19
NorthEast Un,3188,6,5,2,7,10,11,-1,17
Chennaiyin,3188,7,3,5,6,13,20,-7,14
FC Goa,3188,8,4,2,8,10,18,-8,14
Kolkata,3189,1,6,6,2,21,12,9,24
Delhi Dynamo,3189,2,6,5,3,25,16,9,23
Mumbai City,3189,3,6,4,4,16,11,5,22
Chennaiyin,3189,4,4,6,4,16,18,-2,18
Kerala Blast,3189,5,4,5,5,9,15,-6,17
FC Pune City,3189,6,4,4,6,12,18,-6,16
NorthEast Un,3189,7,4,3,7,10,13,-3,15
FC Goa,3189,8,4,3,7,10,16,-6,15
Mumbai City,3190,1,7,4,3,19,9,10,25
Kerala Blast,3190,2,6,4,4,14,14,0,22
Delhi Dynamo,3190,3,4,7,3,25,20,5,19
FC Pune City,3190,4,5,4,5,15,15,0,19
Kolkata,3190,5,4,6,4,17,18,-1,18
NorthEast Un,3190,6,5,3,6,14,15,-1,18
FC Goa,3190,7,4,3,7,13,17,-4,15
Chennaiyin,3190,8,3,5,6,14,23,-9,14
Delhi Dynamo,3191,1,6,6,2,25,16,9,24
Mumbai City,3191,2,6,4,4,16,9,7,22
FC Pune City,3191,3,6,3,5,18,15,3,21
Kolkata,3191,4,4,6,4,15,16,-1,18
Chennaiyin,3191,5,4,6,4,15,17,-2,18
Kerala Blast,3191,6,5,3,6,13,21,-8,18
FC Goa,3191,7,4,4,6,12,16,-4,16
NorthEast Un,3191,8,4,2,8,10,14,-4,14
Mumbai City,3192,1,7,4,3,19,8,11,25
Delhi Dynamo,3192,2,5,6,3,26,19,7,21
NorthEast Un,3192,3,6,3,5,13,10,3,21
Kolkata,3192,4,4,7,3,16,16,0,19
Kerala Blast,3192,5,5,4,5,15,15,0,19
Chennaiyin,3192,6,3,6,5,14,20,-6,15
FC Goa,3192,7,4,3,7,13,20,-7,15
FC Pune City,3192,8,4,3,7,12,20,-8,15
Mumbai City,3193,1,7,4,3,18,9,9,25
Kolkata,3193,2,5,6,3,16,13,3,21
NorthEast Un,3193,3,5,4,5,16,14,2,19
Delhi Dynamo,3193,4,4,6,4,24,21,3,18
FC Goa,3193,5,5,3,6,14,16,-2,18
Kerala Blast,3193,6,4,5,5,10,15,-5,17
FC Pune City,3193,7,4,4,6,12,16,-4,16
Chennaiyin,3193,8,3,6,5,17,23,-6,15
Mumbai City,3194,1,7,4,3,17,8,9,25
Kerala Blast,3194,2,5,5,4,11,14,-3,20
Delhi Dynamo,3194,3,4,7,3,21,15,6,19
FC Pune City,3194,4,5,4,5,14,15,-1,19
Chennaiyin,3194,5,4,6,4,16,18,-2,18
Kolkata,3194,6,3,7,4,15,16,-1,16
NorthEast Un,3194,7,4,4,6,10,12,-2,16
FC Goa,3194,8,3,5,6,10,16,-6,14
Mumbai City,3195,1,7,4,3,17,8,9,25
Delhi Dynamo,3195,2,5,5,4,23,18,5,20
Chennaiyin,3195,3,5,5,4,17,17,0,20
NorthEast Un,3195,4,6,2,6,13,13,0,20
Kerala Blast,3195,5,5,4,5,14,18,-4,19
Kolkata,3195,6,4,6,4,17,16,1,18
FC Pune City,3195,7,4,4,6,14,19,-5,16
FC Goa,3195,8,4,2,8,11,17,-6,14
Mumbai City,3196,1,6,4,4,17,10,7,22
Kolkata,3196,2,5,6,3,16,14,2,21
Delhi Dynamo,3196,3,5,5,4,24,20,4,20
Kerala Blast,3196,4,5,5,4,12,15,-3,20
NorthEast Un,3196,5,5,3,6,15,13,2,18
Chennaiyin,3196,6,4,6,4,15,18,-3,18
FC Pune City,3196,7,4,4,6,13,16,-3,16
FC Goa,3196,8,4,3,7,10,16,-6,15
Mumbai City,3197,1,7,4,3,18,9,9,25
Delhi Dynamo,3197,2,6,5,3,25,16,9,23
Kolkata,3197,3,4,8,2,18,16,2,20
NorthEast Un,3197,4,6,2,6,13,12,1,20
Kerala Blast,3197,5,5,4,5,13,16,-3,19
FC Pune City,3197,6,4,3,7,14,19,-5,15
FC Goa,3197,7,4,3,7,12,18,-6,15
Chennaiyin,3197,8,3,5,6,15,22,-7,14
Mumbai City,3198,1,7,4,3,19,9,10,25
Delhi Dynamo,3198,2,5,5,4,24,18,6,20
Kolkata,3198,3,4,8,2,15,12,3,20
NorthEast Un,3198,4,6,2,6,12,11,1,20
Kerala Blast,3198,5,5,3,6,11,16,-5,18
Chennaiyin,3198,6,4,5,5,16,20,-4,17
FC Pune City,3198,7,4,4,6,12,16,-4,16
FC Goa,3198,8,4,3,7,10,17,-7,15
Mumbai City,3199,1,6,4,4,17,10,7,22
Delhi Dynamo,3199,2,5,6,3,24,19,5,21
Kolkata,3199,3,4,8,2,19,15,4,20
NorthEast Un,3199,4,5,4,5,15,12,3,19
Chennaiyin,3199,5,4,6,4,16,18,-2,18
FC Pune City,3199,5,5,3,6,16,18,-2,18
Kerala Blast,3199,7,4,5,5,13,20,-7,17
FC Goa,3199,8,3,4,7,9,17,-8,13
Mumbai City,3200,1,7,4,3,17,8,9,25
Kerala Blast,3200,2,6,4,4,14,15,-1,22
Chennaiyin,3200,3,5,5,4,19,18,1,20
Kolkata,3200,4,4,7,3,15,14,1,19
Delhi Dynamo,3200,5,4,5,5,22,19,3,17
NorthEast Un,3200,6,5,2,7,13,15,-2,17
FC Goa,3200,7,5,2,7,11,17,-6,17
FC Pune City,3200,8,4,3,7,12,17,-5,15
Kerala Blast,3201,1,7,3,4,15,13,2,24
Mumbai City,3201,2,6,5,3,17,9,8,23
Delhi Dynamo,3201,3,5,6,3,24,17,7,21
Kolkata,3201,4,5,6,3,17,16,1,21
NorthEast Un,3201,5,6,2,6,13,12,1,20
FC Pune City,3201,6,4,3,7,12,17,-5,15
Chennaiyin,3201,7,3,5,6,17,23,-6,14
FC Goa,3201,8,4,2,8,12,20,-8,14
Mumbai City,3202,1,7,4,3,18,8,10,25
Kolkata,3202,2,5,7,2,15,12,3,22
NorthEast Un,3202,3,6,3,5,11,9,2,21
FC Pune City,3202,4,5,4,5,14,15,-1,19
Delhi Dynamo,3202,5,4,6,4,22,18,4,18
FC Goa,3202,6,4,3,7,11,16,-5,15
Chennaiyin,3202,7,3,6,5,13,19,-6,15
Kerala Blast,3202,8,4,3,7,10,17,-7,15
Mumbai City,3203,1,7,4,3,18,9,9,25
Delhi Dynamo,3203,2,5,5,4,23,18,5,20
Kolkata,3203,3,4,8,2,14,12,2,20
Chennaiyin,3203,4,4,6,4,17,18,-1,18
NorthEast Un,3203,5,5,3,6,13,14,-1,18
Kerala Blast,3203,6,4,6,4,12,16,-4,18
FC Pune City,3203,7,4,5,5,13,15,-2,17
FC Goa,3203,8,3,3,8,9,17,-8,12
Mumbai City,3204,1,7,4,3,19,9,10,25
Delhi Dynamo,3204,2,5,6,3,24,18,6,21
Kolkata,3204,3,4,7,3,18,16,2,19
Kerala Blast,3204,4,5,4,5,13,16,-3,19
Chennaiyin,3204,5,4,6,4,18,18,0,18
FC Pune City,3204,6,5,3,6,15,18,-3,18
FC Goa,3204,7,4,4,6,12,17,-5,16
NorthEast Un,3204,8,4,2,8,9,16,-7,14
Mumbai City,3205,1,6,4,4,18,12,6,22
Kolkata,3205,2,5,7,2,16,13,3,22
Delhi Dynamo,3205,3,5,5,4,27,20,7,20
NorthEast Un,3205,4,5,3,6,12,12,0,18
FC Pune City,3205,5,5,3,6,15,17,-2,18
FC Goa,3205,6,5,3,6,11,15,-4,18
Kerala Blast,3205,7,5,3,6,12,17,-5,18
Chennaiyin,3205,8,3,6,5,13,18,-5,15
Delhi Dynamo,3206,1,6,5,3,25,17,8,23
Mumbai City,3206,2,6,4,4,17,10,7,22
Kerala Blast,3206,3,6,4,4,13,14,-1,22
NorthEast Un,3206,4,6,2,6,12,11,1,20
FC Pune City,3206,5,4,5,5,14,16,-2,17
Chennaiyin,3206,6,4,5,5,17,20,-3,17
Kolkata,3206,7,3,7,4,14,16,-2,16
FC Goa,3206,8,4,2,8,11,19,-8,14
Mumbai City,3207,1,7,4,3,19,10,9,25
Delhi Dynamo,3207,2,6,5,3,27,18,9,23
Kolkata,3207,3,4,8,2,15,13,2,20
NorthEast Un,3207,4,5,3,6,12,13,-1,18
Chennaiyin,3207,5,4,6,4,15,18,-3,18
Kerala Blast,3207,6,4,5,5,12,17,-5,17
FC Pune City,3207,7,4,4,6,13,16,-3,16
FC Goa,3207,8,3,3,8,9,17,-8,12
Delhi Dynamo,3208,1,6,5,3,25,17,8,23
Mumbai City,3208,2,6,4,4,17,11,6,22
Kerala Blast,3208,3,6,3,5,16,19,-3,21
Kolkata,3208,4,4,8,2,19,16,3,20
NorthEast Un,3208,5,5,2,7,12,13,-1,17
FC Pune City,3208,6,4,4,6,14,17,-3,16
FC Goa,3208,7,4,4,6,12,16,-4,16
Chennaiyin,3208,8,3,6,5,14,20,-6,15
Delhi Dynamo,3209,1,6,5,3,26,17,9,23
Mumbai City,3209,2,6,4,4,17,11,6,22
Kolkata,3209,3,5,6,3,18,14,4,21
NorthEast Un,3209,4,6,3,5,14,12,2,21
Kerala Blast,3209,5,5,3,6,14,20,-6,18
Chennaiyin,3209,6,3,7,4,15,19,-4,16
FC Pune City,3209,7,4,3,7,14,19,-5,15
FC Goa,3209,8,4,3,7,11,17,-6,15
Mumbai City,3210,1,7,4,3,18,8,10,25
Kerala Blast,3210,2,6,3,5,14,15,-1,21
Delhi Dynamo,3210,3,5,5,4,24,21,3,20
NorthEast Un,3210,4,6,2,6,18,16,2,20
Kolkata,3210,5,4,7,3,16,15,1,19
FC Pune City,3210,6,4,4,6,13,17,-4,16
Chennaiyin,3210,7,3,6,5,17,22,-5,15
FC Goa,3210,8,4,3,7,12,18,-6,15
Kolkata,3211,1,6,6,2,20,13,7,24
Mumbai City,3211,2,6,5,3,18,10,8,23
Delhi Dynamo,3211,3,5,7,2,26,18,8,22
NorthEast Un,3211,4,5,3,6,11,10,1,18
FC Pune City,3211,5,5,3,6,14,17,-3,18
Kerala Blast,3211,6,4,4,6,10,18,-8,16
FC Goa,3211,7,4,3,7,13,17,-4,15
Chennaiyin,3211,8,3,5,6,13,22,-9,14
Kolkata,3212,1,6,6,2,19,13,6,24
Mumbai City,3212,2,6,4,4,16,9,7,22
NorthEast Un,3212,3,6,3,5,14,11,3,21
Delhi Dynamo,3212,4,5,5,4,25,20,5,20
FC Pune City,3212,5,5,3,6,13,15,-2,18
Kerala Blast,3212,6,4,4,6,11,19,-8,16
FC Goa,3212,7,4,3,7,15,20,-5,15
Chennaiyin,3212,8,3,6,5,14,20,-6,15
Mumbai City,3213,1,6,5,3,17,9,8,23
Delhi Dynamo,3213,2,5,6,3,24,16,8,21
NorthEast Un,3213,3,6,3,5,13,10,3,21
FC Pune City,3213,4,5,4,5,16,15,1,19
Kerala Blast,3213,5,5,4,5,13,17,-4,19
Kolkata,3213,6,3,7,4,16,20,-4,16
Chennaiyin,3213,7,3,7,4,15,19,-4,16
FC Goa,3213,8,3,4,7,11,19,-8,13
Mumbai City,3214,1,7,4,3,18,8,10,25
Kerala Blast,3214,2,6,4,4,14,13,1,22
Kolkata,3214,3,4,7,3,17,17,0,19
Delhi Dynamo,3214,4,4,6,4,23,20,3,18
FC Goa,3214,5,5,3,6,14,17,-3,18
NorthEast Un,3214,6,4,5,5,12,12,0,17
Chennaiyin,3214,7,3,6,5,16,21,-5,15
FC Pune City,3214,8,4,3,7,14,20,-6,15
Mumbai City,3215,1,6,5,3,17,9,8,23
Delhi Dynamo,3215,2,5,7,2,26,16,10,22
Kolkata,3215,3,5,7,2,16,13,3,22
NorthEast Un,3215,4,6,3,5,16,10,6,21
FC Pune City,3215,5,5,3,6,15,17,-2,18
Chennaiyin,3215,6,4,5,5,16,20,-4,17
Kerala Blast,3215,7,4,3,7,10,19,-9,15
FC Goa,3215,8,3,3,8,8,20,-12,12
Mumbai City,3216,1,7,4,3,19,8,11,25
Kolkata,3216,2,5,7,2,16,13,3,22
Delhi Dynamo,3216,3,5,5,4,24,20,4,20
Chennaiyin,3216,4,5,5,4,19,19,0,20
Kerala Blast,3216,5,5,4,5,13,15,-2,19
FC Pune City,3216,6,5,3,6,14,16,-2,18
NorthEast Un,3216,7,5,2,7,13,17,-4,17
FC Goa,3216,8,3,2,9,10,20,-10,11
Mumbai City,3217,1,6,5,3,16,8,8,23
Kolkata,3217,2,5,7,2,20,16,4,22
Kerala Blast,3217,3,5,4,5,12,17,-5,19
Delhi Dynamo,3217,4,4,6,4,23,18,5,18
NorthEast Un,3217,5,5,3,6,12,12,0,18
Chennaiyin,3217,6,4,5,5,16,20,-4,17
FC Goa,3217,7,5,2,7,15,20,-5,17
FC Pune City,3217,8,4,4,6,13,16,-3,16
Mumbai City,3218,1,7,4,3,18,8,10,25
Kolkata,3218,2,6,6,2,16,12,4,24
Delhi Dynamo,3218,3,4,6,4,23,20,3,18
NorthEast Un,3218,4,5,3,6,13,14,-1,18
Chennaiyin,3218,5,4,5,5,18,21,-3,17
FC Goa,3218,6,5,2,7,13,17,-4,17
FC Pune City,3218,7,4,4,6,12,15,-3,16
Kerala Blast,3218,8,4,4,6,9,15,-6,16
Delhi Dynamo,3219,1,6,5,3,25,17,8,23
Mumbai City,3219,2,6,4,4,17,10,7,22
Chennaiyin,3219,3,5,5,4,18,19,-1,20
Kerala Blast,3219,4,5,5,4,13,16,-3,20
Kolkata,3219,5,4,7,3,17,15,2,19
NorthEast Un,3219,6,5,3,6,13,12,1,18
FC Pune City,3219,7,4,4,6,13,17,-4,16
FC Goa,3219,8,3,3,8,10,20,-10,12
Delhi Dynamo,3220,1,7,5,2,26,16,10,26
Mumbai City,3220,2,6,4,4,18,11,7,22
Kerala Blast,3220,3,6,3,5,16,15,1,21
Kolkata,3220,4,4,7,3,17,18,-1,19
FC Pune City,3220,5,5,4,5,15,16,-1,19
NorthEast Un,3220,6,4,3,7,9,13,-4,15
Chennaiyin,3220,7,3,6,5,14,19,-5,15
FC Goa,3220,8,4,2,8,12,19,-7,14
Delhi Dynamo,3221,1,6,6,2,27,14,13,24
Mumbai City,3221,2,6,4,4,16,10,6,22
Kerala Blast,3221,3,5,4,5,11,15,-4,19
Kolkata,3221,4,4,6,4,17,18,-1,18
FC Pune City,3221,5,5,3,6,15,16,-1,18
NorthEast Un,3221,6,4,5,5,11,11,0,17
FC Goa,3221,7,5,2,7,12,19,-7,17
Chennaiyin,3221,8,3,6,5,15,21,-6,15
Mumbai City,3222,1,6,5,3,17,9,8,23
Delhi Dynamo,3222,2,5,6,3,24,20,4,21
Kolkata,3222,3,5,6,3,21,17,4,21
FC Pune City,3222,4,5,4,5,15,16,-1,19
Kerala Blast,3222,5,5,4,5,14,17,-3,19
Chennaiyin,3222,6,4,6,4,17,18,-1,18
NorthEast Un,3222,7,5,2,7,15,17,-2,17
FC Goa,3222,8,3,3,8,9,18,-9,12
Mumbai City,3223,1,7,4,3,18,9,9,25
Delhi Dynamo,3223,2,6,5,3,28,19,9,23
Kolkata,3223,3,5,6,3,16,14,2,21
NorthEast Un,3223,4,6,2,6,15,14,1,20
Kerala Blast,3223,5,5,3,6,12,18,-6,18
FC Goa,3223,6,5,2,7,12,16,-4,17
FC Pune City,3223,7,4,3,7,13,17,-4,15
Chennaiyin,3223,8,3,5,6,14,21,-7,14
Delhi Dynamo,3224,1,6,6,2,26,17,9,24
Kolkata,3224,2,6,6,2,19,13,6,24
Mumbai City,3224,3,6,4,4,16,9,7,22
NorthEast Un,3224,4,5,4,5,13,12,1,19
Kerala Blast,3224,5,5,4,5,12,16,-4,19
FC Pune City,3224,6,4,3,7,12,17,-5,15
Chennaiyin,3224,7,3,5,6,13,19,-6,14
FC Goa,3224,8,4,2,8,11,19,-8,14
Mumbai City,3225,1,7,4,3,20,8,12,25
Delhi Dynamo,3225,2,5,5,4,25,21,4,20
Chennaiyin,3225,3,5,5,4,18,20,-2,20
Kerala Blast,3225,4,5,4,5,13,17,-4,19
Kolkata,3225,5,4,6,4,20,18,2,18
NorthEast Un,3225,6,5,3,6,14,14,0,18
FC Pune City,3225,7,5,3,6,14,19,-5,18
FC Goa,3225,8,4,2,8,14,21,-7,14
Delhi Dynamo,3226,1,6,5,3,26,17,9,23
NorthEast Un,3226,2,7,2,5,13,10,3,23
Mumbai City,3226,3,6,4,4,17,10,7,22
Kerala Blast,3226,4,6,3,5,11,14,-3,21
Kolkata,3226,5,4,7,3,17,14,3,19
FC Goa,3226,6,4,3,7,12,17,-5,15
FC Pune City,3226,7,4,3,7,12,18,-6,15
Chennaiyin,3226,8,3,5,6,13,21,-8,14
Delhi Dynamo,3227,1,6,6,2,26,15,11,24
Mumbai City,3227,2,6,4,4,16,9,7,22
FC Pune City,3227,3,6,3,5,16,14,2,21
Chennaiyin,3227,4,4,6,4,16,17,-1,18
Kerala Blast,3227,5,4,5,5,10,15,-5,17
Kolkata,3227,6,3,7,4,15,18,-3,16
NorthEast Un,3227,7,4,4,6,9,12,-3,16
FC Goa,3227,8,4,3,7,11,19,-8,15
Mumbai City,3228,1,7,4,3,18,9,9,25
Delhi Dynamo,3228,2,6,5,3,28,18,10,23
Kolkata,3228,3,4,8,2,17,15,2,20
FC Pune City,3228,4,5,4,5,16,16,0,19
NorthEast Un,3228,5,5,2,7,12,13,-1,17
Chennaiyin,3228,6,4,5,5,15,19,-4,17
Kerala Blast,3228,7,4,4,6,11,18,-7,16
FC Goa,3228,8,4,2,8,11,20,-9,14
Mumbai City,3229,1,6,5,3,17,9,8,23
Kolkata,3229,2,5,7,2,21,15,6,22
NorthEast Un,3229,3,6,2,6,15,11,4,20
Chennaiyin,3229,4,5,5,4,17,18,-1,20
Delhi Dynamo,3229,5,4,7,3,24,18,6,19
FC Pune City,3229,6,5,3,6,14,18,-4,18
Kerala Blast,3229,7,4,3,7,11,22,-11,15
FC Goa,3229,8,3,4,7,12,20,-8,13
Mumbai City,3230,1,7,4,3,18,9,9,25
Kolkata,3230,2,5,7,2,17,14,3,22
NorthEast Un,3230,3,6,2,6,13,12,1,20
FC Pune City,3230,4,5,4,5,14,15,-1,19
Delhi Dynamo,3230,5,4,6,4,23,18,5,18
Kerala Blast,3230,6,5,3,6,11,16,-5,18
FC Goa,3230,7,4,3,7,13,17,-4,15
Chennaiyin,3230,8,3,5,6,14,22,-8,14
Delhi Dynamo,3231,1,7,5,2,29,18,11,26
Mumbai City,3231,2,6,4,4,16,9,7,22
Kerala Blast,3231,3,5,5,4,15,18,-3,20
Kolkata,3231,4,4,7,3,18,16,2,19
FC Pune City,3231,5,5,3,6,16,18,-2,18
NorthEast Un,3231,6,4,4,6,12,14,-2,16
Chennaiyin,3231,7,3,7,4,14,18,-4,16
FC Goa,3231,8,3,3,8,11,20,-9,12
Mumbai City,3232,1,6,5,3,17,9,8,23
Kolkata,3232,2,5,7,2,18,14,4,22
Kerala Blast,3232,3,5,5,4,13,16,-3,20
Delhi Dynamo,3232,4,4,7,3,24,18,6,19
Chennaiyin,3232,5,4,6,4,15,18,-3,18
NorthEast Un,3232,6,4,5,5,11,11,0,17
FC Pune City,3232,7,4,3,7,14,19,-5,15
FC Goa,3232,8,4,2,8,11,18,-7,14
Mumbai City,3233,1,7,4,3,18,9,9,25
Delhi Dynamo,3233,2,6,5,3,28,16,12,23
Kolkata,3233,3,5,6,3,18,16,2,21
Chennaiyin,3233,4,5,5,4,18,18,0,20
Kerala Blast,3233,5,5,3,6,14,18,-4,18
NorthEast Un,3233,6,5,2,7,12,16,-4,17
FC Pune City,3233,7,4,3,7,13,20,-7,15
FC Goa,3233,8,4,2,8,11,19,-8,14
Delhi Dynamo,3234,1,6,5,3,24,18,6,23
Mumbai City,3234,2,6,4,4,16,9,7,22
Kolkata,3234,3,5,6,3,19,13,6,21
NorthEast Un,3234,4,6,3,5,14,10,4,21
Kerala Blast,3234,5,5,4,5,12,16,-4,19
FC Pune City,3234,6,5,3,6,14,19,-5,18
Chennaiyin,3234,7,3,5,6,14,20,-6,14
FC Goa,3234,8,4,2,8,11,19,-8,14
Mumbai City,3235,1,7,4,3,18,8,10,25
Kolkata,3235,2,5,7,2,15,12,3,22
Delhi Dynamo,3235,3,5,5,4,24,18,6,20
NorthEast Un,3235,4,6,2,6,11,11,0,20
Kerala Blast,3235,5,5,4,5,11,14,-3,19
FC Pune City,3235,6,4,5,5,12,14,-2,17
Chennaiyin,3235,7,3,5,6,13,19,-6,14
FC Goa,3235,8,4,2,8,10,18,-8,14
Kerala Blast,3236,1,7,3,4,15,14,1,24
Mumbai City,3236,2,6,5,3,16,8,8,23
Delhi Dynamo,3236,3,5,6,3,23,17,6,21
NorthEast Un,3236,4,6,2,6,14,11,3,20
Kolkata,3236,5,4,7,3,15,15,0,19
FC Pune City,3236,6,4,3,7,13,18,-5,15
FC Goa,3236,7,4,3,7,12,18,-6,15
Chennaiyin,3236,8,3,5,6,15,22,-7,14
Kerala Blast,3237,1,7,3,4,13,14,-1,24
Delhi Dynamo,3237,2,6,5,3,27,20,7,23
Mumbai City,3237,3,6,4,4,16,9,7,22
Kolkata,3237,4,5,6,3,17,15,2,21
Chennaiyin,3237,5,5,5,4,15,17,-2,20
NorthEast Un,3237,6,5,2,7,14,13,1,17
FC Pune City,3237,7,4,3,7,13,17,-4,15
FC Goa,3237,8,3,2,9,9,19,-10,11
Mumbai City,3238,1,6,5,3,18,10,8,23
Kerala Blast,3238,2,6,3,5,12,15,-3,21
Chennaiyin,3238,3,5,5,4,15,17,-2,20
Delhi Dynamo,3238,4,4,6,4,25,20,5,18
Kolkata,3238,5,4,6,4,17,16,1,18
FC Pune City,3238,6,5,3,6,14,17,-3,18
NorthEast Un,3238,7,5,2,7,13,14,-1,17
FC Goa,3238,8,5,2,7,11,16,-5,17
Mumbai City,3239,1,7,4,3,18,9,9,25
Kerala Blast,3239,2,5,4,5,13,17,-4,19
Delhi Dynamo,3239,3,4,6,4,24,19,5,18
NorthEast Un,3239,4,5,3,6,14,14,0,18
Kolkata,3239,5,4,6,4,17,18,-1,18
FC Pune City,3239,6,5,3,6,15,16,-1,18
FC Goa,3239,7,5,3,6,12,15,-3,18
Chennaiyin,3239,8,4,5,5,15,20,-5,17
Delhi Dynamo,3240,1,6,5,3,27,18,9,23
Mumbai City,3240,2,6,4,4,16,10,6,22
Kerala Blast,3240,3,6,4,4,12,14,-2,22
Kolkata,3240,4,5,6,3,17,15,2,21
NorthEast Un,3240,5,6,3,5,12,10,2,21
FC Pune City,3240,6,4,3,7,14,18,-4,15
FC Goa,3240,7,4,2,8,14,19,-5,14
Chennaiyin,3240,8,3,5,6,13,21,-8,14
Mumbai City,3241,1,6,5,3,17,9,8,23
Kolkata,3241,2,5,6,3,18,13,5,21
NorthEast Un,3241,3,6,2,6,12,12,0,20
Delhi Dynamo,3241,4,4,7,3,24,18,6,19
FC Goa,3241,5,5,3,6,13,16,-3,18
Kerala Blast,3241,6,5,3,6,11,16,-5,18
Chennaiyin,3241,7,4,5,5,16,20,-4,17
FC Pune City,3241,8,4,3,7,12,19,-7,15
Mumbai City,3242,1,7,4,3,19,8,11,25
NorthEast Un,3242,2,7,2,5,18,12,6,23
Kolkata,3242,3,4,7,3,16,15,1,19
FC Pune City,3242,4,5,4,5,14,15,-1,19
FC Goa,3242,5,5,3,6,12,15,-3,18
Delhi Dynamo,3242,6,4,5,5,21,21,0,17
Kerala Blast,3242,7,4,4,6,12,19,-7,16
Chennaiyin,3242,8,3,5,6,15,22,-7,14
Mumbai City,3243,1,7,4,3,18,8,10,25
Delhi Dynamo,3243,2,5,6,3,26,20,6,21
Kolkata,3243,3,5,6,3,16,13,3,21
Chennaiyin,3243,4,5,5,4,18,19,-1,20
FC Pune City,3243,5,5,4,5,13,14,-1,19
Kerala Blast,3243,6,4,5,5,11,17,-6,17
NorthEast Un,3243,7,4,3,7,15,17,-2,15
FC Goa,3243,8,3,3,8,10,19,-9,12
Mumbai City,3244,1,7,4,3,18,9,9,25
Delhi Dynamo,3244,2,6,5,3,26,16,10,23
Kerala Blast,3244,3,6,3,5,14,17,-3,21
Kolkata,3244,4,4,8,2,19,17,2,20
NorthEast Un,3244,5,5,2,7,13,13,0,17
FC Pune City,3244,6,4,4,6,14,17,-3,16
Chennaiyin,3244,7,3,6,5,13,19,-6,15
FC Goa,3244,8,3,4,7,10,19,-9,13
Delhi Dynamo,3245,1,6,5,3,26,16,10,23
Mumbai City,3245,2,6,4,4,16,9,7,22
NorthEast Un,3245,3,6,3,5,12,10,2,21
Kerala Blast,3245,4,5,4,5,12,15,-3,19
Chennaiyin,3245,5,4,6,4,14,17,-3,18
Kolkata,3245,6,3,8,3,15,15,0,17
FC Pune City,3245,7,4,4,6,14,18,-4,16
FC Goa,3245,8,4,2,8,10,19,-9,14
Delhi Dynamo,3246,1,6,5,3,24,17,7,23
Mumbai City,3246,2,6,4,4,16,9,7,22
NorthEast Un,3246,3,6,2,6,12,11,1,20
Kolkata,3246,4,4,7,3,14,14,0,19
FC Pune City,3246,5,5,3,6,14,16,-2,18
FC Goa,3246,6,5,3,6,12,14,-2,18
Kerala Blast,3246,7,5,3,6,11,15,-4,18
Chennaiyin,3246,8,3,5,6,13,20,-7,14
Mumbai City,3247,1,7,4,3,19,8,11,25
Delhi Dynamo,3247,2,5,6,3,23,18,5,21
Kolkata,3247,3,5,6,3,18,15,3,21
NorthEast Un,3247,4,4,5,5,10,10,0,17
Kerala Blast,3247,5,4,5,5,12,18,-6,17
FC Pune City,3247,6,4,4,6,14,17,-3,16
Chennaiyin,3247,7,3,7,4,14,18,-4,16
FC Goa,3247,8,4,3,7,11,17,-6,15
Mumbai City,3248,1,6,5,3,18,10,8,23
Delhi Dynamo,3248,2,5,7,2,25,17,8,22
FC Pune City,3248,3,5,4,5,17,15,2,19
Kolkata,3248,4,4,7,3,20,20,0,19
Chennaiyin,3248,5,4,6,4,18,21,-3,18
Kerala Blast,3248,6,4,5,5,9,16,-7,17
NorthEast Un,3248,7,4,4,6,11,12,-1,16
FC Goa,3248,8,3,4,7,14,21,-7,13
Mumbai City,3249,1,7,4,3,22,9,13,25
NorthEast Un,3249,2,7,2,5,15,10,5,23
FC Pune City,3249,3,5,4,5,16,15,1,19
Kolkata,3249,4,4,7,3,15,14,1,19
FC Goa,3249,5,5,3,6,11,15,-4,18
Delhi Dynamo,3249,6,4,5,5,23,24,-1,17
Chennaiyin,3249,7,3,6,5,13,19,-6,15
Kerala Blast,3249,8,4,3,7,10,19,-9,15
Mumbai City,3250,1,7,4,3,19,8,11,25
Kolkata,3250,2,5,6,3,19,15,4,21
NorthEast Un,3250,3,6,3,5,14,10,4,21
Delhi Dynamo,3250,4,4,6,4,22,21,1,18
Chennaiyin,3250,5,4,5,5,15,19,-4,17
Kerala Blast,3250,6,4,5,5,11,16,-5,17
FC Pune City,3250,7,4,4,6,13,19,-6,16
FC Goa,3250,8,4,3,7,13,18,-5,15
Mumbai City,3251,1,7,4,3,19,9,10,25
Delhi Dynamo,3251,2,5,6,3,27,18,9,21
Kerala Blast,3251,3,6,3,5,11,14,-3,21
NorthEast Un,3251,4,5,4,5,12,11,1,19
FC Pune City,3251,5,5,3,6,13,15,-2,18
Chennaiyin,3251,6,4,6,4,16,19,-3,18
Kolkata,3251,7,3,7,4,15,16,-1,16
FC Goa,3251,8,3,3,8,11,22,-11,12
Delhi Dynamo,3252,1,6,5,3,25,17,8,23
NorthEast Un,3252,2,7,2,5,12,9,3,23
Mumbai City,3252,3,6,4,4,17,10,7,22
Kolkata,3252,4,5,7,2,18,14,4,22
Kerala Blast,3252,5,5,3,6,11,16,-5,18
FC Pune City,3252,6,4,4,6,13,16,-3,16
FC Goa,3252,7,4,2,8,13,19,-6,14
Chennaiyin,3252,8,3,5,6,14,22,-8,14
Mumbai City,3253,1,7,4,3,17,8,9,25
NorthEast Un,3253,2,7,2,5,17,11,6,23
Kolkata,3253,3,5,6,3,18,18,0,21
Delhi Dynamo,3253,4,5,5,4,26,18,8,20
FC Pune City,3253,5,4,4,6,13,17,-4,16
Kerala Blast,3253,6,4,4,6,10,19,-9,16
Chennaiyin,3253,7,3,6,5,15,20,-5,15
FC Goa,3253,7,4,3,7,15,20,-5,15
Mumbai City,3254,1,6,5,3,16,8,8,23
Kerala Blast,3254,2,6,4,4,15,15,0,22
Delhi Dynamo,3254,3,4,7,3,21,15,6,19
FC Goa,3254,4,5,3,6,12,15,-3,18
FC Pune City,3254,5,5,3,6,15,19,-4,18
Chennaiyin,3254,6,4,5,5,17,19,-2,17
NorthEast Un,3254,7,5,2,7,11,15,-4,17
Kolkata,3254,8,3,7,4,17,18,-1,16
Mumbai City,3255,1,7,4,3,19,9,10,25
Delhi Dynamo,3255,2,6,5,3,25,18,7,23
Kerala Blast,3255,3,6,3,5,13,18,-5,21
Kolkata,3255,4,4,6,4,16,16,0,18
Chennaiyin,3255,5,4,6,4,18,20,-2,18
FC Pune City,3255,6,5,3,6,14,16,-2,18
NorthEast Un,3255,7,4,3,7,12,14,-2,15
FC Goa,3255,8,4,2,8,13,19,-6,14
Mumbai City,3256,1,6,5,3,18,10,8,23
Kerala Blast,3256,2,6,4,4,16,17,-1,22
Delhi Dynamo,3256,3,4,7,3,25,19,6,19
NorthEast Un,3256,4,5,3,6,14,13,1,18
Kolkata,3256,5,3,8,3,16,16,0,17
Chennaiyin,3256,6,4,5,5,15,19,-4,17
FC Goa,3256,7,5,2,7,12,18,-6,17
FC Pune City,3256,8,4,4,6,12,16,-4,16
Mumbai City,3257,1,7,4,3,18,8,10,25
Delhi Dynamo,3257,2,5,5,4,24,20,4,20
Kolkata,3257,3,4,8,2,15,13,2,20
Chennaiyin,3257,4,5,5,4,16,18,-2,20
Kerala Blast,3257,5,5,5,4,11,13,-2,20
NorthEast Un,3257,6,5,3,6,12,10,2,18
FC Pune City,3257,7,4,3,7,13,18,-5,15
FC Goa,3257,8,3,3,8,10,19,-9,12
Delhi Dynamo,3258,1,6,6,2,27,17,10,24
Mumbai City,3258,2,6,4,4,16,10,6,22
Kerala Blast,3258,3,6,3,5,12,15,-3,21
Kolkata,3258,4,4,8,2,16,14,2,20
Chennaiyin,3258,5,5,5,4,18,20,-2,20
FC Pune City,3258,6,4,4,6,13,16,-3,16
NorthEast Un,3258,7,4,2,8,13,16,-3,14
FC Goa,3258,8,3,4,7,12,19,-7,13
Mumbai City,3259,1,7,4,3,18,8,10,25
Delhi Dynamo,3259,2,6,5,3,24,16,8,23
Kolkata,3259,3,4,8,2,16,14,2,20
Kerala Blast,3259,4,4,6,4,12,16,-4,18
NorthEast Un,3259,5,4,4,6,11,12,-1,16
FC Pune City,3259,6,4,4,6,12,15,-3,16
Chennaiyin,3259,7,3,6,5,14,20,-6,15
FC Goa,3259,8,4,3,7,12,18,-6,15
Mumbai City,3260,1,7,4,3,17,8,9,25
Kerala Blast,3260,2,6,3,5,17,19,-2,21
Delhi Dynamo,3260,3,4,6,4,23,19,4,18
Kolkata,3260,4,4,6,4,16,16,0,18
NorthEast Un,3260,5,5,3,6,15,15,0,18
Chennaiyin,3260,6,4,6,4,16,18,-2,18
FC Pune City,3260,6,5,3,6,16,18,-2,18
FC Goa,3260,8,4,3,7,10,17,-7,15
Mumbai City,3261,1,7,4,3,19,8,11,25
Kerala Blast,3261,2,6,3,5,18,17,1,21
Kolkata,3261,2,5,6,3,18,17,1,21
Delhi Dynamo,3261,4,5,5,4,23,18,5,20
NorthEast Un,3261,5,5,3,6,11,13,-2,18
FC Pune City,3261,6,5,3,6,15,18,-3,18
Chennaiyin,3261,7,3,6,5,14,19,-5,15
FC Goa,3261,8,4,2,8,10,18,-8,14
Mumbai City,3262,1,6,5,3,16,8,8,23
Kerala Blast,3262,2,6,3,5,13,16,-3,21
Delhi Dynamo,3262,3,4,7,3,23,17,6,19
Kolkata,3262,4,4,7,3,18,16,2,19
FC Goa,3262,5,5,3,6,16,17,-1,18
NorthEast Un,3262,6,5,3,6,11,12,-1,18
FC Pune City,3262,7,4,4,6,13,16,-3,16
Chennaiyin,3262,8,3,6,5,14,22,-8,15
Mumbai City,3263,1,7,4,3,17,8,9,25
Kerala Blast,3263,2,6,4,4,14,14,0,22
Delhi Dynamo,3263,3,5,5,4,22,17,5,20
Chennaiyin,3263,4,5,5,4,19,18,1,20
Kolkata,3263,5,4,7,3,20,17,3,19
FC Pune City,3263,6,5,3,6,16,18,-2,18
NorthEast Un,3263,7,5,2,7,12,17,-5,17
FC Goa,3263,8,3,2,9,8,19,-11,11
Mumbai City,3264,1,7,4,3,18,9,9,25
NorthEast Un,3264,2,7,2,5,18,14,4,23
FC Pune City,3264,3,6,3,5,15,15,0,21
Delhi Dynamo,3264,4,5,5,4,30,21,9,20
Kolkata,3264,5,4,6,4,15,14,1,18
Kerala Blast,3264,6,5,3,6,12,17,-5,18
Chennaiyin,3264,7,4,5,5,16,21,-5,17
FC Goa,3264,8,3,2,9,10,23,-13,11
Mumbai City,3265,1,7,4,3,18,8,10,25
Delhi Dynamo,3265,2,6,5,3,27,19,8,23
Kolkata,3265,3,5,7,2,17,13,4,22
Chennaiyin,3265,4,5,5,4,16,18,-2,20
Kerala Blast,3265,5,5,3,6,13,19,-6,18
NorthEast Un,3265,6,5,2,7,13,15,-2,17
FC Pune City,3265,7,4,4,6,15,18,-3,16
FC Goa,3265,8,3,2,9,10,19,-9,11
Delhi Dynamo,3266,1,6,5,3,25,17,8,23
NorthEast Un,3266,2,7,2,5,14,10,4,23
Mumbai City,3266,3,6,4,4,17,10,7,22
Kerala Blast,3266,4,5,4,5,11,15,-4,19
FC Pune City,3266,5,5,3,6,13,15,-2,18
Chennaiyin,3266,6,4,5,5,16,19,-3,17
Kolkata,3266,7,3,7,4,15,16,-1,16
FC Goa,3266,8,4,2,8,10,19,-9,14
Mumbai City,3267,1,7,4,3,19,9,10,25
Kolkata,3267,2,5,7,2,17,13,4,22
Kerala Blast,3267,3,5,4,5,12,15,-3,19
Delhi Dynamo,3267,4,4,6,4,22,18,4,18
NorthEast Un,3267,5,5,3,6,10,12,-2,18
Chennaiyin,3267,6,4,5,5,16,20,-4,17
FC Pune City,3267,7,4,4,6,12,17,-5,16
FC Goa,3267,8,4,3,7,12,16,-4,15
Mumbai City,3268,1,7,4,3,18,9,9,25
Delhi Dynamo,3268,2,5,5,4,27,18,9,20
Kerala Blast,3268,3,5,5,4,11,14,-3,20
Kolkata,3268,4,4,7,3,18,15,3,19
NorthEast Un,3268,5,5,4,5,11,10,1,19
Chennaiyin,3268,6,3,7,4,14,18,-4,16
FC Pune City,3268,7,4,4,6,13,18,-5,16
FC Goa,3268,8,3,4,7,11,21,-10,13
Delhi Dynamo,3269,1,7,5,2,26,14,12,26
Mumbai City,3269,2,6,4,4,16,9,7,22
Kerala Blast,3269,3,6,3,5,14,15,-1,21
FC Pune City,3269,4,5,3,6,15,18,-3,18
Chennaiyin,3269,5,4,5,5,17,20,-3,17
NorthEast Un,3269,6,5,2,7,11,16,-5,17
Kolkata,3269,7,3,7,4,17,19,-2,16
FC Goa,3269,8,4,3,7,13,18,-5,15
Mumbai City,3270,1,7,4,3,20,11,9,25
Kerala Blast,3270,2,6,4,4,15,14,1,22
Kolkata,3270,3,5,6,3,18,17,1,21
Delhi Dynamo,3270,4,5,5,4,28,21,7,20
NorthEast Un,3270,5,5,4,5,12,11,1,19
Chennaiyin,3270,6,4,6,4,16,19,-3,18
FC Pune City,3270,7,4,3,7,13,19,-6,15
FC Goa,3270,8,3,2,9,11,21,-10,11
Mumbai City,3271,1,6,5,3,17,9,8,23
Kolkata,3271,2,5,7,2,18,13,5,22
Delhi Dynamo,3271,3,5,6,3,25,17,8,21
Kerala Blast,3271,4,6,3,5,14,17,-3,21
Chennaiyin,3271,5,4,6,4,18,19,-1,18
NorthEast Un,3271,6,5,2,7,13,17,-4,17
FC Pune City,3271,7,4,4,6,13,17,-4,16
FC Goa,3271,8,3,3,8,9,18,-9,12
Mumbai City,3272,1,7,4,3,18,9,9,25
Kolkata,3272,2,5,6,3,22,15,7,21
Delhi Dynamo,3272,3,5,5,4,27,22,5,20
NorthEast Un,3272,4,5,4,5,13,10,3,19
Chennaiyin,3272,5,4,6,4,16,17,-1,18
FC Pune City,3272,6,5,3,6,14,19,-5,18
Kerala Blast,3272,7,4,4,6,12,20,-8,16
FC Goa,3272,8,4,2,8,11,21,-10,14
Mumbai City,3273,1,6,5,3,17,9,8,23
Chennaiyin,3273,2,5,5,4,18,19,-1,20
Delhi Dynamo,3273,3,4,7,3,23,18,5,19
Kolkata,3273,4,4,7,3,17,17,0,19
Kerala Blast,3273,5,5,4,5,11,15,-4,19
FC Pune City,3273,6,4,5,5,13,15,-2,17
FC Goa,3273,7,5,2,7,15,19,-4,17
NorthEast Un,3273,8,4,3,7,10,12,-2,15
Mumbai City,3274,1,6,5,3,16,8,8,23
Delhi Dynamo,3274,2,5,7,2,23,15,8,22
NorthEast Un,3274,3,5,4,5,14,12,2,19
Kerala Blast,3274,4,5,4,5,12,17,-5,19
FC Pune City,3274,5,5,3,6,13,15,-2,18
Kolkata,3274,6,3,7,4,13,16,-3,16
Chennaiyin,3274,7,3,7,4,15,19,-4,16
FC Goa,3274,8,4,3,7,13,17,-4,15
Delhi Dynamo,3275,1,5,7,2,24,16,8,22
Mumbai City,3275,2,6,4,4,16,9,7,22
Kerala Blast,3275,3,6,3,5,12,16,-4,21
Kolkata,3275,4,4,6,4,17,17,0,18
NorthEast Un,3275,5,5,3,6,13,13,0,18
FC Pune City,3275,6,5,3,6,15,16,-1,18
FC Goa,3275,7,4,4,6,12,17,-5,16
Chennaiyin,3275,8,3,6,5,16,21,-5,15
Mumbai City,3276,1,7,4,3,17,8,9,25
Kerala Blast,3276,2,7,3,4,14,13,1,24
Delhi Dynamo,3276,3,5,5,4,26,20,6,20
NorthEast Un,3276,4,6,2,6,15,14,1,20
FC Pune City,3276,5,5,3,6,14,17,-3,18
Kolkata,3276,6,3,6,5,15,17,-2,15
Chennaiyin,3276,7,3,6,5,15,20,-5,15
FC Goa,3276,8,4,3,7,12,19,-7,15
Mumbai City,3277,1,7,4,3,17,8,9,25
NorthEast Un,3277,2,6,2,6,15,12,3,20
FC Goa,3277,3,6,2,6,15,16,-1,20
FC Pune City,3277,4,5,4,5,14,15,-1,19
Kerala Blast,3277,5,5,4,5,11,14,-3,19
Delhi Dynamo,3277,6,4,5,5,24,21,3,17
Kolkata,3277,7,3,8,3,14,16,-2,17
Chennaiyin,3277,8,3,5,6,13,21,-8,14
Mumbai City,3278,1,6,5,3,17,9,8,23
NorthEast Un,3278,2,7,2,5,16,11,5,23
Delhi Dynamo,3278,3,5,6,3,26,19,7,21
Kerala Blast,3278,4,6,3,5,13,16,-3,21
Kolkata,3278,5,4,7,3,18,16,2,19
FC Goa,3278,6,4,3,7,14,19,-5,15
FC Pune City,3278,7,4,3,7,12,17,-5,15
Chennaiyin,3278,8,3,5,6,15,24,-9,14
Mumbai City,3279,1,6,4,4,17,10,7,22
Kolkata,3279,2,5,7,2,18,13,5,22
Delhi Dynamo,3279,3,5,5,4,23,19,4,20
NorthEast Un,3279,4,5,3,6,11,11,0,18
Chennaiyin,3279,5,4,6,4,17,18,-1,18
FC Pune City,3279,6,5,3,6,13,17,-4,18
Kerala Blast,3279,7,5,3,6,10,15,-5,18
FC Goa,3279,8,4,3,7,12,18,-6,15
Mumbai City,3280,1,7,4,3,18,9,9,25
Kolkata,3280,2,5,7,2,19,14,5,22
Kerala Blast,3280,3,6,4,4,15,14,1,22
Delhi Dynamo,3280,4,5,6,3,26,19,7,21
Chennaiyin,3280,5,4,6,4,15,18,-3,18
NorthEast Un,3280,6,4,3,7,11,14,-3,15
FC Pune City,3280,7,4,3,7,12,20,-8,15
FC Goa,3280,8,3,3,8,11,19,-8,12
Mumbai City,3281,1,7,4,3,18,9,9,25
Kolkata,3281,2,5,7,2,18,15,3,22
NorthEast Un,3281,3,6,3,5,16,13,3,21
Delhi Dynamo,3281,4,5,5,4,27,21,6,20
FC Pune City,3281,5,4,4,6,13,16,-3,16
Kerala Blast,3281,6,4,4,6,10,17,-7,16
Chennaiyin,3281,7,3,6,5,14,19,-5,15
FC Goa,3281,8,4,3,7,13,19,-6,15
Mumbai City,3282,1,7,4,3,18,9,9,25
Delhi Dynamo,3282,2,6,5,3,28,17,11,23
Kolkata,3282,3,4,8,2,18,14,4,20
Kerala Blast,3282,4,4,6,4,10,14,-4,18
Chennaiyin,3282,5,4,5,5,16,22,-6,17
FC Pune City,3282,6,4,4,6,12,17,-5,16
FC Goa,3282,7,4,3,7,14,18,-4,15
NorthEast Un,3282,8,4,3,7,10,15,-5,15
Mumbai City,3283,1,7,4,3,20,10,10,25
Delhi Dynamo,3283,2,5,6,3,26,20,6,21
Kerala Blast,3283,3,5,5,4,12,15,-3,20
FC Pune City,3283,4,5,4,5,16,17,-1,19
NorthEast Un,3283,5,4,4,6,11,12,-1,16
Kolkata,3283,6,3,7,4,16,18,-2,16
Chennaiyin,3283,7,3,7,4,15,19,-4,16
FC Goa,3283,8,4,3,7,12,17,-5,15
Mumbai City,3284,1,7,4,3,18,9,9,25
Delhi Dynamo,3284,2,6,5,3,28,19,9,23
Chennaiyin,3284,3,5,5,4,18,18,0,20
FC Pune City,3284,4,5,4,5,15,15,0,19
Kolkata,3284,5,3,8,3,17,18,-1,17
NorthEast Un,3284,6,5,2,7,12,15,-3,17
Kerala Blast,3284,7,4,5,5,13,18,-5,17
FC Goa,3284,8,3,3,8,11,20,-9,12
Mumbai City,3285,1,7,4,3,17,8,9,25
Delhi Dynamo,3285,2,6,5,3,24,15,9,23
Kerala Blast,3285,3,5,4,5,11,15,-4,19
Kolkata,3285,4,4,6,4,17,16,1,18
NorthEast Un,3285,5,5,3,6,10,10,0,18
Chennaiyin,3285,6,3,7,4,14,18,-4,16
FC Pune City,3285,7,4,4,6,12,16,-4,16
FC Goa,3285,8,4,3,7,11,18,-7,15
Mumbai City,3286,1,7,4,3,17,8,9,25
FC Goa,3286,2,6,2,6,12,14,-2,20
FC Pune City,3286,3,5,4,5,14,15,-1,19
Kerala Blast,3286,4,5,4,5,12,16,-4,19
Kolkata,3286,5,4,6,4,14,15,-1,18
Delhi Dynamo,3286,6,4,5,5,23,19,4,17
NorthEast Un,3286,7,5,2,7,15,17,-2,17
Chennaiyin,3286,8,4,5,5,17,20,-3,17
Mumbai City,3287,1,6,5,3,18,10,8,23
Delhi Dynamo,3287,2,5,6,3,25,17,8,21
FC Pune City,3287,3,5,4,5,13,14,-1,19
Kolkata,3287,4,3,9,2,17,16,1,18
NorthEast Un,3287,5,5,3,6,12,12,0,18
FC Goa,3287,6,5,3,6,13,17,-4,18
Kerala Blast,3287,7,4,4,6,10,17,-7,16
Chennaiyin,3287,8,3,6,5,14,19,-5,15
Mumbai City,3288,1,6,5,3,17,9,8,23
Delhi Dynamo,3288,2,5,6,3,27,18,9,21
Kolkata,3288,3,5,6,3,19,15,4,21
Chennaiyin,3288,4,5,5,4,17,18,-1,20
NorthEast Un,3288,5,5,3,6,12,12,0,18
FC Pune City,3288,6,5,3,6,15,17,-2,18
Kerala Blast,3288,7,4,4,6,10,18,-8,16
FC Goa,3288,8,4,2,8,11,21,-10,14
Mumbai City,3289,1,7,4,3,17,8,9,25
Delhi Dynamo,3289,2,6,5,3,23,15,8,23
Kerala Blast,3289,3,5,5,4,11,14,-3,20
FC Pune City,3289,4,5,3,6,15,15,0,18
Chennaiyin,3289,5,4,6,4,17,19,-2,18
Kolkata,3289,6,3,7,4,16,20,-4,16
NorthEast Un,3289,7,4,3,7,9,12,-3,15
FC Goa,3289,8,4,3,7,14,19,-5,15
Delhi Dynamo,3290,1,7,5,2,29,15,14,26
Mumbai City,3290,2,6,4,4,17,11,6,22
Kerala Blast,3290,3,6,4,4,12,14,-2,22
FC Pune City,3290,4,5,3,6,14,15,-1,18
NorthEast Un,3290,5,5,2,7,11,13,-2,17
Chennaiyin,3290,6,4,5,5,15,19,-4,17
Kolkata,3290,7,3,7,4,14,18,-4,16
FC Goa,3290,8,4,2,8,11,18,-7,14
Mumbai City,3291,1,6,4,4,16,9,7,22
Kolkata,3291,2,5,7,2,17,14,3,22
Delhi Dynamo,3291,3,5,6,3,24,17,7,21
NorthEast Un,3291,4,6,3,5,13,11,2,21
Kerala Blast,3291,5,5,3,6,11,16,-5,18
Chennaiyin,3291,6,4,5,5,16,20,-4,17
FC Pune City,3291,7,4,3,7,13,17,-4,15
FC Goa,3291,8,4,3,7,11,17,-6,15
Mumbai City,3292,1,7,4,3,17,8,9,25
Delhi Dynamo,3292,2,6,5,3,24,16,8,23
Kolkata,3292,3,5,7,2,20,14,6,22
Kerala Blast,3292,4,5,4,5,10,16,-6,19
NorthEast Un,3292,5,5,3,6,11,11,0,18
Chennaiyin,3292,6,4,5,5,14,18,-4,17
FC Pune City,3292,7,4,3,7,13,18,-5,15
FC Goa,3292,8,3,3,8,9,17,-8,12
Mumbai City,3293,1,7,4,3,19,8,11,25
Delhi Dynamo,3293,2,5,6,3,23,17,6,21
Kerala Blast,3293,3,5,4,5,13,17,-4,19
NorthEast Un,3293,4,5,3,6,12,11,1,18
FC Pune City,3293,5,4,5,5,17,19,-2,17
Chennaiyin,3293,6,4,5,5,16,20,-4,17
FC Goa,3293,7,5,2,7,12,18,-6,17
Kolkata,3293,8,3,7,4,17,19,-2,16
Mumbai City,3294,1,7,4,3,19,8,11,25
Delhi Dynamo,3294,2,5,5,4,25,19,6,20
FC Pune City,3294,3,5,4,5,14,15,-1,19
Kerala Blast,3294,4,5,4,5,11,17,-6,19
Kolkata,3294,5,4,6,4,17,15,2,18
NorthEast Un,3294,6,5,3,6,11,10,1,18
Chennaiyin,3294,7,3,7,4,16,20,-4,16
FC Goa,3294,8,4,3,7,13,22,-9,15
Mumbai City,3295,1,7,4,3,19,9,10,25
Delhi Dynamo,3295,2,5,5,4,26,19,7,20
NorthEast Un,3295,3,6,2,6,13,12,1,20
Kerala Blast,3295,4,5,4,5,14,16,-2,19
Kolkata,3295,5,3,8,3,16,18,-2,17
FC Goa,3295,6,5,2,7,13,17,-4,17
Chennaiyin,3295,7,4,5,5,15,20,-5,17
FC Pune City,3295,8,4,4,6,13,18,-5,16
Delhi Dynamo,3296,1,6,6,2,29,19,10,24
Mumbai City,3296,2,6,4,4,19,12,7,22
Kolkata,3296,3,5,6,3,19,17,2,21
Kerala Blast,3296,4,6,3,5,13,17,-4,21
NorthEast Un,3296,5,5,3,6,11,11,0,18
FC Goa,3296,6,5,2,7,15,19,-4,17
FC Pune City,3296,7,4,3,7,13,17,-4,15
Chennaiyin,3296,8,3,5,6,14,21,-7,14
Delhi Dynamo,3297,1,6,5,3,24,16,8,23
Mumbai City,3297,2,6,4,4,16,9,7,22
Kerala Blast,3297,3,6,4,4,16,17,-1,22
Kolkata,3297,4,4,8,2,17,15,2,20
Chennaiyin,3297,5,4,6,4,17,18,-1,18
FC Goa,3297,6,4,4,6,11,16,-5,16
FC Pune City,3297,7,4,3,7,13,18,-5,15
NorthEast Un,3297,8,4,2,8,11,16,-5,14
Delhi Dynamo,3298,1,7,5,2,26,15,11,26
Mumbai City,3298,2,6,4,4,17,10,7,22
NorthEast Un,3298,3,6,2,6,13,11,2,20
Kolkata,3298,4,3,8,3,16,16,0,17
FC Pune City,3298,5,4,5,5,13,15,-2,17
Kerala Blast,3298,6,4,5,5,12,18,-6,17
Chennaiyin,3298,7,3,6,5,14,19,-5,15
FC Goa,3298,8,4,3,7,10,17,-7,15
Mumbai City,3299,1,7,4,3,17,8,9,25
Kolkata,3299,2,4,8,2,19,15,4,20
Delhi Dynamo,3299,3,4,6,4,25,21,4,18
NorthEast Un,3299,4,5,3,6,14,14,0,18
FC Goa,3299,5,5,3,6,15,18,-3,18
Kerala Blast,3299,6,5,3,6,13,20,-7,18
Chennaiyin,3299,7,4,5,5,16,19,-3,17
FC Pune City,3299,8,4,4,6,13,17,-4,16
Mumbai City,3300,1,7,4,3,20,11,9,25
Delhi Dynamo,3300,2,6,5,3,29,18,11,23
Kerala Blast,3300,3,6,4,4,17,14,3,22
Kolkata,3300,4,4,7,3,17,15,2,19
Chennaiyin,3300,5,4,6,4,17,19,-2,18
NorthEast Un,3300,6,4,3,7,11,17,-6,15
FC Pune City,3300,7,4,3,7,12,22,-10,15
FC Goa,3300,8,3,4,7,8,15,-7,13
Mumbai City,3301,1,7,4,3,18,8,10,25
Delhi Dynamo,3301,2,6,5,3,25,18,7,23
NorthEast Un,3301,3,6,2,6,14,12,2,20
Kolkata,3301,4,4,7,3,17,15,2,19
FC Goa,3301,5,5,2,7,13,18,-5,17
Kerala Blast,3301,6,4,5,5,12,18,-6,17
FC Pune City,3301,7,4,4,6,13,17,-4,16
Chennaiyin,3301,8,3,5,6,14,20,-6,14
Delhi Dynamo,3302,1,6,6,2,25,16,9,24
Mumbai City,3302,2,6,5,3,17,9,8,23
FC Pune City,3302,3,6,3,5,15,15,0,21
NorthEast Un,3302,4,5,3,6,13,13,0,18
Chennaiyin,3302,5,4,6,4,18,19,-1,18
Kerala Blast,3302,6,5,3,6,12,16,-4,18
Kolkata,3302,7,3,6,5,15,18,-3,15
FC Goa,3302,8,4,2,8,9,18,-9,14
Mumbai City,3303,1,7,4,3,19,8,11,25
Delhi Dynamo,3303,2,5,5,4,24,20,4,20
Kolkata,3303,3,4,8,2,17,14,3,20
FC Pune City,3303,4,5,4,5,14,15,-1,19
Chennaiyin,3303,5,4,6,4,16,19,-3,18
Kerala Blast,3303,6,5,3,6,12,18,-6,18
NorthEast Un,3303,7,5,2,7,12,12,0,17
FC Goa,3303,8,3,4,7,11,19,-8,13
Mumbai City,3304,1,6,5,3,16,8,8,23
Kerala Blast,3304,2,5,5,4,13,15,-2,20
Delhi Dynamo,3304,3,4,6,4,21,18,3,18
NorthEast Un,3304,4,5,3,6,12,11,1,18
Chennaiyin,3304,5,4,6,4,15,17,-2,18
FC Pune City,3304,6,5,3,6,16,19,-3,18
FC Goa,3304,7,5,3,6,11,15,-4,18
Kolkata,3304,8,3,7,4,15,16,-1,16
Mumbai City,3305,1,6,5,3,16,8,8,23
Delhi Dynamo,3305,2,5,6,3,24,16,8,21
FC Goa,3305,3,6,2,6,15,14,1,20
Kerala Blast,3305,4,5,4,5,12,16,-4,19
Kolkata,3305,5,4,6,4,15,16,-1,18
FC Pune City,3305,6,5,3,6,15,17,-2,18
Chennaiyin,3305,7,4,5,5,17,21,-4,17
NorthEast Un,3305,8,4,3,7,10,16,-6,15
Mumbai City,3306,1,7,4,3,20,9,11,25
Delhi Dynamo,3306,2,6,5,3,27,19,8,23
NorthEast Un,3306,3,6,2,6,14,13,1,20
Kolkata,3306,4,4,7,3,16,17,-1,19
Kerala Blast,3306,5,5,3,6,13,18,-5,18
FC Goa,3306,6,5,2,7,16,19,-3,17
FC Pune City,3306,7,4,4,6,14,18,-4,16
Chennaiyin,3306,8,3,5,6,15,22,-7,14
Mumbai City,3307,1,6,4,4,16,11,5,22
Delhi Dynamo,3307,2,5,6,3,26,18,8,21
NorthEast Un,3307,3,6,2,6,16,12,4,20
Kolkata,3307,4,4,7,3,16,16,0,19
Kerala Blast,3307,5,5,4,5,15,20,-5,19
FC Goa,3307,6,5,3,6,13,15,-2,18
Chennaiyin,3307,7,4,5,5,14,19,-5,17
FC Pune City,3307,8,4,3,7,13,18,-5,15
Mumbai City,3308,1,7,4,3,18,9,9,25
FC Pune City,3308,2,6,3,5,16,16,0,21
Kerala Blast,3308,3,6,3,5,14,16,-2,21
Chennaiyin,3308,4,5,5,4,15,17,-2,20
Delhi Dynamo,3308,5,4,6,4,22,17,5,18
NorthEast Un,3308,6,5,2,7,10,12,-2,17
Kolkata,3308,7,3,6,5,16,19,-3,15
FC Goa,3308,8,4,3,7,11,16,-5,15
Mumbai City,3309,1,7,4,3,19,8,11,25
Kolkata,3309,2,5,6,3,21,17,4,21
FC Goa,3309,3,6,2,6,11,14,-3,20
NorthEast Un,3309,4,5,4,5,14,13,1,19
Kerala Blast,3309,5,5,4,5,16,21,-5,19
Delhi Dynamo,3309,6,4,5,5,22,20,2,17
FC Pune City,3309,7,4,3,7,14,19,-5,15
Chennaiyin,3309,8,3,6,5,13,18,-5,15
Delhi Dynamo,3310,1,7,5,2,29,17,12,26
Mumbai City,3310,2,6,4,4,16,9,7,22
Kolkata,3310,3,4,7,3,17,16,1,19
NorthEast Un,3310,4,5,3,6,14,13,1,18
FC Goa,3310,5,5,2,7,12,18,-6,17
Kerala Blast,3310,5,4,5,5,12,18,-6,17
FC Pune City,3310,7,4,4,6,13,17,-4,16
Chennaiyin,3310,8,3,6,5,14,19,-5,15
Mumbai City,3311,1,6,5,3,17,9,8,23
FC Goa,3311,2,6,2,6,15,16,-1,20
NorthEast Un,3311,3,5,4,5,14,12,2,19
FC Pune City,3311,4,5,4,5,15,16,-1,19
Delhi Dynamo,3311,5,4,6,4,23,21,2,18
Kolkata,3311,6,4,6,4,17,17,0,18
Kerala Blast,3311,7,4,5,5,13,18,-5,17
Chennaiyin,3311,8,3,6,5,14,19,-5,15
Delhi Dynamo,3312,1,6,6,2,25,16,9,24
Mumbai City,3312,2,6,5,3,16,8,8,23
Kolkata,3312,3,5,6,3,18,19,-1,21
FC Pune City,3312,4,5,3,6,15,16,-1,18
Kerala Blast,3312,5,5,3,6,13,19,-6,18
FC Goa,3312,6,5,2,7,15,17,-2,17
Chennaiyin,3312,7,4,5,5,15,19,-4,17
NorthEast Un,3312,8,4,2,8,11,14,-3,14
Mumbai City,3313,1,7,4,3,17,8,9,25
Delhi Dynamo,3313,2,5,6,3,24,15,9,21
Kolkata,3313,3,4,7,3,17,15,2,19
NorthEast Un,3313,4,5,4,5,12,11,1,19
FC Pune City,3313,5,5,4,5,14,15,-1,19
Kerala Blast,3313,6,4,5,5,11,17,-6,17
FC Goa,3313,7,4,3,7,12,19,-7,15
Chennaiyin,3313,8,3,5,6,14,21,-7,14
Mumbai City,3314,1,7,4,3,19,10,9,25
Delhi Dynamo,3314,2,6,5,3,25,17,8,23
Kerala Blast,3314,3,6,4,4,15,16,-1,22
Chennaiyin,3314,4,4,6,4,16,17,-1,18
FC Pune City,3314,5,4,5,5,14,16,-2,17
Kolkata,3314,6,3,7,4,15,16,-1,16
NorthEast Un,3314,7,4,3,7,10,13,-3,15
FC Goa,3314,8,4,2,8,9,18,-9,14
Mumbai City,3315,1,7,4,3,17,8,9,25
Kolkata,3315,2,5,7,2,20,14,6,22
Delhi Dynamo,3315,3,5,6,3,25,16,9,21
Kerala Blast,3315,4,5,4,5,10,14,-4,19
Chennaiyin,3315,5,4,5,5,17,21,-4,17
FC Goa,3315,6,4,4,6,13,18,-5,16
NorthEast Un,3315,7,4,3,7,11,15,-4,15
FC Pune City,3315,8,4,3,7,12,19,-7,15
Mumbai City,3316,1,7,4,3,18,8,10,25
Kolkata,3316,2,5,7,2,19,15,4,22
NorthEast Un,3316,3,6,3,5,14,11,3,21
Delhi Dynamo,3316,4,5,5,4,23,18,5,20
Chennaiyin,3316,5,4,6,4,16,19,-3,18
FC Pune City,3316,6,4,5,5,13,15,-2,17
Kerala Blast,3316,7,4,4,6,14,21,-7,16
FC Goa,3316,8,3,2,9,9,19,-10,11
Delhi Dynamo,3317,1,6,6,2,28,16,12,24
Kerala Blast,3317,2,7,3,4,14,15,-1,24
Mumbai City,3317,3,6,5,3,17,9,8,23
Kolkata,3317,4,4,7,3,18,15,3,19
NorthEast Un,3317,5,5,2,7,13,12,1,17
FC Pune City,3317,6,4,3,7,12,18,-6,15
FC Goa,3317,7,4,3,7,12,21,-9,15
Chennaiyin,3317,8,3,5,6,14,22,-8,14
Mumbai City,3318,1,6,5,3,18,10,8,23
Delhi Dynamo,3318,2,5,7,2,25,16,9,22
Kolkata,3318,3,4,7,3,22,17,5,19
FC Pune City,3318,4,5,4,5,16,17,-1,19
NorthEast Un,3318,5,5,3,6,10,10,0,18
Kerala Blast,3318,6,5,3,6,10,19,-9,18
FC Goa,3318,7,5,2,7,14,18,-4,17
Chennaiyin,3318,8,3,5,6,14,22,-8,14
Mumbai City,3319,1,6,4,4,18,11,7,22
Delhi Dynamo,3319,2,5,6,3,25,18,7,21
Kolkata,3319,3,4,8,2,18,15,3,20
Chennaiyin,3319,4,5,5,4,16,18,-2,20
FC Pune City,3319,5,5,4,5,14,15,-1,19
Kerala Blast,3319,6,5,3,6,11,17,-6,18
NorthEast Un,3319,7,5,2,7,12,13,-1,17
FC Goa,3319,8,3,4,7,11,18,-7,13
Mumbai City,3320,1,7,4,3,19,10,9,25
Kerala Blast,3320,2,6,4,4,14,15,-1,22
Kolkata,3320,3,4,8,2,15,13,2,20
NorthEast Un,3320,3,6,2,6,15,13,2,20
Delhi Dynamo,3320,5,4,5,5,23,22,1,17
Chennaiyin,3320,6,4,5,5,15,19,-4,17
FC Pune City,3320,7,4,3,7,12,16,-4,15
FC Goa,3320,8,4,3,7,10,15,-5,15
Delhi Dynamo,3321,1,6,6,2,26,15,11,24
Mumbai City,3321,2,6,4,4,16,11,5,22
Chennaiyin,3321,3,5,5,4,18,18,0,20
Kolkata,3321,4,4,7,3,15,16,-1,19
Kerala Blast,3321,5,5,4,5,14,16,-2,19
FC Pune City,3321,6,5,3,6,14,16,-2,18
NorthEast Un,3321,7,4,3,7,10,14,-4,15
FC Goa,3321,8,3,4,7,11,18,-7,13
Mumbai City,3322,1,6,5,3,16,8,8,23
NorthEast Un,3322,2,6,3,5,13,11,2,21
FC Pune City,3322,3,6,3,5,16,15,1,21
Delhi Dynamo,3322,4,4,8,2,22,15,7,20
Kolkata,3322,5,4,6,4,15,17,-2,18
FC Goa,3322,6,4,4,6,12,16,-4,16
Chennaiyin,3322,7,3,6,5,14,19,-5,15
Kerala Blast,3322,8,4,3,7,11,18,-7,15
Mumbai City,3323,1,6,5,3,16,8,8,23
Delhi Dynamo,3323,2,5,7,2,25,16,9,22
Kerala Blast,3323,3,6,4,4,17,17,0,22
Kolkata,3323,4,4,7,3,16,15,1,19
Chennaiyin,3323,5,4,6,4,18,17,1,18
FC Pune City,3323,6,4,5,5,14,16,-2,17
NorthEast Un,3323,7,4,3,7,12,20,-8,15
FC Goa,3323,8,3,3,8,9,18,-9,12
Mumbai City,3324,1,7,4,3,19,8,11,25
Delhi Dynamo,3324,2,6,5,3,29,21,8,23
Kolkata,3324,3,5,6,3,21,15,6,21
NorthEast Un,3324,4,5,3,6,10,10,0,18
Chennaiyin,3324,5,4,6,4,15,18,-3,18
Kerala Blast,3324,6,5,3,6,11,17,-6,18
FC Pune City,3324,7,4,3,7,15,22,-7,15
FC Goa,3324,8,4,2,8,14,23,-9,14
Mumbai City,3325,1,6,5,3,18,10,8,23
Delhi Dynamo,3325,2,5,6,3,24,18,6,21
FC Goa,3325,3,6,2,6,15,15,0,20
Kolkata,3325,4,4,7,3,19,17,2,19
FC Pune City,3325,5,5,4,5,15,16,-1,19
Chennaiyin,3325,6,4,5,5,16,19,-3,17
NorthEast Un,3325,7,5,2,7,10,13,-3,17
Kerala Blast,3325,8,4,3,7,9,18,-9,15
Kolkata,3326,1,6,6,2,18,13,5,24
Mumbai City,3326,2,6,5,3,17,9,8,23
Delhi Dynamo,3326,3,5,7,2,26,18,8,22
NorthEast Un,3326,4,5,4,5,13,12,1,19
Chennaiyin,3326,5,4,6,4,17,20,-3,18
Kerala Blast,3326,6,5,3,6,11,16,-5,18
FC Pune City,3326,7,4,3,7,12,16,-4,15
FC Goa,3326,8,3,2,9,11,21,-10,11
Mumbai City,3327,1,7,4,3,18,8,10,25
Kerala Blast,3327,2,7,3,4,15,15,0,24
Delhi Dynamo,3327,3,5,5,4,24,17,7,20
NorthEast Un,3327,4,6,2,6,13,12,1,20
Kolkata,3327,5,4,7,3,18,15,3,19
Chennaiyin,3327,6,4,5,5,15,19,-4,17
FC Pune City,3327,7,4,3,7,12,18,-6,15
FC Goa,3327,8,3,3,8,9,20,-11,12
Mumbai City,3328,1,6,5,3,16,8,8,23
Delhi Dynamo,3328,2,5,7,2,24,15,9,22
FC Pune City,3328,3,5,4,5,15,16,-1,19
Kerala Blast,3328,4,5,4,5,11,15,-4,19
Kolkata,3328,5,3,9,2,15,14,1,18
NorthEast Un,3328,6,5,3,6,13,12,1,18
Chennaiyin,3328,7,4,5,5,16,21,-5,17
FC Goa,3328,8,3,3,8,10,19,-9,12
Mumbai City,3329,1,7,4,3,17,8,9,25
Kolkata,3329,2,5,7,2,19,13,6,22
Delhi Dynamo,3329,3,5,6,3,24,17,7,21
Kerala Blast,3329,4,5,4,5,14,17,-3,19
Chennaiyin,3329,5,4,5,5,15,18,-3,17
FC Pune City,3329,6,4,4,6,13,18,-5,16
FC Goa,3329,7,4,4,6,11,16,-5,16
NorthEast Un,3329,8,4,2,8,11,17,-6,14
Mumbai City,3330,1,6,5,3,16,8,8,23
Delhi Dynamo,3330,2,5,7,2,25,17,8,22
FC Pune City,3330,3,6,3,5,16,16,0,21
Kolkata,3330,4,4,6,4,16,16,0,18
NorthEast Un,3330,5,5,3,6,14,14,0,18
FC Goa,3330,6,5,2,7,13,16,-3,17
Chennaiyin,3330,7,4,5,5,14,20,-6,17
Kerala Blast,3330,8,4,3,7,11,18,-7,15
Mumbai City,3331,1,6,5,3,16,8,8,23
Kolkata,3331,2,5,7,2,17,13,4,22
Delhi Dynamo,3331,3,5,6,3,22,16,6,21
Chennaiyin,3331,4,5,5,4,17,18,-1,20
Kerala Blast,3331,5,5,4,5,12,17,-5,19
NorthEast Un,3331,6,5,3,6,13,13,0,18
FC Pune City,3331,7,4,3,7,13,17,-4,15
FC Goa,3331,8,3,3,8,9,17,-8,12
Mumbai City,3332,1,7,4,3,18,8,10,25
Kolkata,3332,2,5,7,2,20,14,6,22
Delhi Dynamo,3332,3,5,6,3,23,17,6,21
Chennaiyin,3332,4,4,6,4,16,18,-2,18
FC Pune City,3332,5,5,3,6,15,17,-2,18
NorthEast Un,3332,6,5,2,7,12,14,-2,17
Kerala Blast,3332,7,4,4,6,13,20,-7,16
FC Goa,3332,8,3,4,7,9,18,-9,13
Mumbai City,3333,1,7,4,3,18,8,10,25
NorthEast Un,3333,2,6,3,5,13,10,3,21
Kolkata,3333,3,4,7,3,17,15,2,19
Kerala Blast,3333,4,5,4,5,14,19,-5,19
FC Pune City,3333,5,5,3,6,18,20,-2,18
Delhi Dynamo,3333,6,4,5,5,21,19,2,17
Chennaiyin,3333,7,4,5,5,15,18,-3,17
FC Goa,3333,8,4,3,7,10,17,-7,15
Mumbai City,3334,1,7,4,3,19,8,11,25
Delhi Dynamo,3334,2,5,6,3,22,17,5,21
NorthEast Un,3334,3,6,2,6,16,13,3,20
Kolkata,3334,4,4,8,2,17,15,2,20
FC Pune City,3334,5,5,4,5,15,16,-1,19
FC Goa,3334,6,4,4,6,11,16,-5,16
Kerala Blast,3334,7,4,3,7,12,20,-8,15
Chennaiyin,3334,8,3,5,6,16,23,-7,14
Mumbai City,3335,1,7,4,3,20,8,12,25
Delhi Dynamo,3335,2,5,5,4,22,19,3,20
NorthEast Un,3335,3,5,3,6,11,12,-1,18
Kerala Blast,3335,4,4,6,4,11,15,-4,18
Kolkata,3335,5,3,8,3,15,15,0,17
FC Goa,3335,6,5,2,7,14,16,-2,17
FC Pune City,3335,7,4,5,5,12,14,-2,17
Chennaiyin,3335,8,4,5,5,15,21,-6,17
Mumbai City,3336,1,6,5,3,17,9,8,23
Kerala Blast,3336,2,5,5,4,12,15,-3,20
Delhi Dynamo,3336,3,4,7,3,22,16,6,19
FC Pune City,3336,4,5,4,5,17,15,2,19
FC Goa,3336,5,5,3,6,12,14,-2,18
NorthEast Un,3336,6,5,2,7,10,11,-1,17
Chennaiyin,3336,7,4,5,5,14,19,-5,17
Kolkata,3336,8,3,7,4,14,19,-5,16
Delhi Dynamo,3337,1,6,6,2,27,15,12,24
Mumbai City,3337,2,6,4,4,16,9,7,22
Kolkata,3337,3,5,7,2,19,14,5,22
Kerala Blast,3337,4,6,3,5,12,15,-3,21
Chennaiyin,3337,5,4,6,4,16,18,-2,18
FC Pune City,3337,6,4,4,6,12,15,-3,16
NorthEast Un,3337,7,4,3,7,11,17,-6,15
FC Goa,3337,8,3,3,8,10,20,-10,12
Mumbai City,3338,1,7,4,3,17,8,9,25
Delhi Dynamo,3338,2,5,5,4,25,19,6,20
Kolkata,3338,3,4,8,2,18,14,4,20
Chennaiyin,3338,4,5,5,4,16,18,-2,20
FC Pune City,3338,5,5,4,5,13,14,-1,19
Kerala Blast,3338,6,5,3,6,11,18,-7,18
NorthEast Un,3338,7,5,2,7,13,12,1,17
FC Goa,3338,8,3,3,8,10,20,-10,12
Mumbai City,3339,1,6,5,3,17,9,8,23
Kolkata,3339,2,5,7,2,17,13,4,22
Delhi Dynamo,3339,3,5,6,3,24,16,8,21
Chennaiyin,3339,4,5,5,4,17,18,-1,20
Kerala Blast,3339,5,5,5,4,11,14,-3,20
FC Pune City,3339,6,4,3,7,14,18,-4,15
NorthEast Un,3339,7,4,3,7,9,13,-4,15
FC Goa,3339,8,4,2,8,10,18,-8,14
Mumbai City,3340,1,7,4,3,17,8,9,25
Kerala Blast,3340,2,7,3,4,19,14,5,24
Delhi Dynamo,3340,3,6,5,3,27,15,12,23
Kolkata,3340,4,4,7,3,17,17,0,19
NorthEast Un,3340,5,4,3,7,10,14,-4,15
Chennaiyin,3340,6,3,6,5,14,20,-6,15
FC Pune City,3340,7,4,3,7,12,19,-7,15
FC Goa,3340,8,4,3,7,12,21,-9,15
Delhi Dynamo,3341,1,6,6,2,27,16,11,24
Mumbai City,3341,2,6,5,3,18,10,8,23
Kerala Blast,3341,3,6,4,4,15,15,0,22
FC Pune City,3341,4,5,3,6,16,19,-3,18
Chennaiyin,3341,5,4,5,5,20,19,1,17
FC Goa,3341,6,5,2,7,12,19,-7,17
Kolkata,3341,7,3,7,4,16,18,-2,16
NorthEast Un,3341,8,4,2,8,9,17,-8,14
Kolkata,3342,1,6,6,2,20,14,6,24
Mumbai City,3342,2,6,5,3,16,8,8,23
Delhi Dynamo,3342,3,5,6,3,23,16,7,21
Kerala Blast,3342,4,6,3,5,13,17,-4,21
NorthEast Un,3342,5,5,3,6,13,13,0,18
FC Pune City,3342,6,4,3,7,13,17,-4,15
Chennaiyin,3342,7,3,6,5,15,21,-6,15
FC Goa,3342,8,4,2,8,10,17,-7,14
Mumbai City,3343,1,6,5,3,16,8,8,23
Delhi Dynamo,3343,2,5,6,3,24,19,5,21
Kolkata,3343,3,5,6,3,17,16,1,21
FC Goa,3343,4,6,2,6,17,14,3,20
Kerala Blast,3343,5,5,4,5,12,16,-4,19
FC Pune City,3343,6,4,4,6,15,18,-3,16
NorthEast Un,3343,7,4,3,7,12,14,-2,15
Chennaiyin,3343,8,3,6,5,13,21,-8,15
Mumbai City,3344,1,7,4,3,20,9,11,25
Delhi Dynamo,3344,2,5,6,3,26,20,6,21
Kerala Blast,3344,3,5,5,4,12,15,-3,20
FC Pune City,3344,4,5,4,5,14,15,-1,19
Chennaiyin,3344,5,4,6,4,15,18,-3,18
Kolkata,3344,6,3,7,4,14,15,-1,16
NorthEast Un,3344,7,4,3,7,12,14,-2,15
FC Goa,3344,8,4,3,7,11,18,-7,15
Delhi Dynamo,3345,1,6,5,3,28,19,9,23
Mumbai City,3345,2,6,4,4,17,11,6,22
NorthEast Un,3345,3,5,3,6,12,13,-1,18
Chennaiyin,3345,4,4,6,4,15,17,-2,18
Kerala Blast,3345,5,4,6,4,10,14,-4,18
Kolkata,3345,6,3,8,3,14,14,0,17
FC Pune City,3345,7,4,5,5,13,15,-2,17
FC Goa,3345,8,4,3,7,11,17,-6,15
Mumbai City,3346,1,7,4,3,17,8,9,25
Delhi Dynamo,3346,2,6,5,3,26,17,9,23
Kerala Blast,3346,3,6,4,4,15,17,-2,22
Kolkata,3346,4,5,6,3,18,15,3,21
NorthEast Un,3346,5,5,2,7,14,14,0,17
Chennaiyin,3346,6,4,5,5,16,21,-5,17
FC Pune City,3346,7,4,4,6,13,16,-3,16
FC Goa,3346,8,3,2,9,10,21,-11,11
Mumbai City,3347,1,6,5,3,17,9,8,23
Delhi Dynamo,3347,2,5,7,2,25,17,8,22
Chennaiyin,3347,3,5,5,4,19,19,0,20
Kolkata,3347,4,4,7,3,16,17,-1,19
Kerala Blast,3347,5,5,4,5,13,17,-4,19
FC Pune City,3347,6,5,3,6,15,17,-2,18
NorthEast Un,3347,7,4,3,7,12,16,-4,15
FC Goa,3347,8,4,2,8,13,18,-5,14
Delhi Dynamo,3348,1,7,5,2,28,16,12,26
Mumbai City,3348,2,6,4,4,17,10,7,22
Kolkata,3348,3,4,7,3,20,16,4,19
NorthEast Un,3348,4,5,3,6,11,12,-1,18
FC Pune City,3348,5,5,3,6,14,18,-4,18
Kerala Blast,3348,6,4,5,5,10,16,-6,17
Chennaiyin,3348,7,3,6,5,14,20,-6,15
FC Goa,3348,8,4,3,7,13,19,-6,15
Delhi Dynamo,3349,1,6,6,2,27,16,11,24
Mumbai City,3349,2,6,5,3,18,10,8,23
Kerala Blast,3349,3,5,4,5,12,17,-5,19
FC Pune City,3349,4,4,5,5,14,16,-2,17
NorthEast Un,3349,5,5,2,7,11,13,-2,17
Chennaiyin,3349,6,4,5,5,16,20,-4,17
FC Goa,3349,7,5,2,7,13,18,-5,17
Kolkata,3349,8,3,7,4,16,17,-1,16
Delhi Dynamo,3350,1,6,6,2,27,16,11,24
Mumbai City,3350,2,6,5,3,17,9,8,23
Kolkata,3350,3,5,7,2,17,12,5,22
NorthEast Un,3350,4,6,2,6,15,13,2,20
Kerala Blast,3350,5,5,3,6,12,17,-5,18
FC Pune City,3350,6,4,3,7,12,18,-6,15
FC Goa,3350,7,4,3,7,9,17,-8,15
Chennaiyin,3350,8,3,5,6,13,20,-7,14
Delhi Dynamo,3351,1,6,5,3,27,19,8,23
Mumbai City,3351,2,6,4,4,16,9,7,22
Kolkata,3351,3,5,6,3,17,13,4,21
NorthEast Un,3351,4,6,3,5,17,14,3,21
FC Pune City,3351,5,5,4,5,15,16,-1,19
Chennaiyin,3351,6,3,7,4,14,18,-4,16
Kerala Blast,3351,7,4,4,6,13,21,-8,16
FC Goa,3351,8,3,3,8,9,18,-9,12
Delhi Dynamo,3352,1,6,6,2,27,16,11,24
Mumbai City,3352,2,6,4,4,18,11,7,22
FC Pune City,3352,3,5,4,5,17,18,-1,19
Kolkata,3352,4,3,9,2,17,16,1,18
Kerala Blast,3352,5,4,5,5,16,21,-5,17
NorthEast Un,3352,6,4,4,6,13,16,-3,16
FC Goa,3352,7,4,4,6,12,17,-5,16
Chennaiyin,3352,8,3,6,5,15,20,-5,15
Mumbai City,3353,1,7,4,3,17,8,9,25
Kerala Blast,3353,2,6,4,4,13,14,-1,22
Delhi Dynamo,3353,3,5,6,3,25,18,7,21
Kolkata,3353,4,4,7,3,15,14,1,19
FC Goa,3353,5,5,3,6,14,17,-3,18
NorthEast Un,3353,6,5,2,7,11,13,-2,17
FC Pune City,3353,7,4,3,7,14,18,-4,15
Chennaiyin,3353,8,3,5,6,14,21,-7,14
Mumbai City,3354,1,7,4,3,19,8,11,25
Delhi Dynamo,3354,2,5,6,3,23,18,5,21
Kolkata,3354,3,5,6,3,17,13,4,21
NorthEast Un,3354,4,5,3,6,12,12,0,18
Chennaiyin,3354,5,4,6,4,15,18,-3,18
FC Pune City,3354,6,5,3,6,14,18,-4,18
FC Goa,3354,7,4,3,7,10,16,-6,15
Kerala Blast,3354,8,4,3,7,11,18,-7,15
Mumbai City,3355,1,7,4,3,20,10,10,25
Delhi Dynamo,3355,2,6,5,3,26,18,8,23
Kolkata,3355,3,4,8,2,18,15,3,20
NorthEast Un,3355,4,5,3,6,12,11,1,18
Chennaiyin,3355,5,4,6,4,15,18,-3,18
Kerala Blast,3355,6,4,5,5,10,17,-7,17
FC Pune City,3355,7,4,4,6,15,19,-4,16
FC Goa,3355,8,3,3,8,10,18,-8,12
Mumbai City,3356,1,7,4,3,17,8,9,25
NorthEast Un,3356,2,7,2,5,12,9,3,23
Kolkata,3356,3,4,7,3,16,16,0,19
Delhi Dynamo,3356,4,4,6,4,22,17,5,18
FC Goa,3356,5,5,3,6,13,16,-3,18
Kerala Blast,3356,6,5,3,6,11,16,-5,18
FC Pune City,3356,7,4,4,6,13,16,-3,16
Chennaiyin,3356,8,3,5,6,14,20,-6,14
Mumbai City,3357,1,7,4,3,17,8,9,25
Kolkata,3357,2,5,7,2,15,12,3,22
Delhi Dynamo,3357,3,4,6,4,21,17,4,18
FC Pune City,3357,4,5,3,6,13,15,-2,18
FC Goa,3357,5,5,3,6,12,15,-3,18
Kerala Blast,3357,6,5,3,6,10,15,-5,18
Chennaiyin,3357,7,4,5,5,16,19,-3,17
NorthEast Un,3357,8,4,3,7,9,12,-3,15
Mumbai City,3358,1,7,4,3,19,8,11,25
Kerala Blast,3358,2,7,3,4,15,13,2,24
Delhi Dynamo,3358,3,5,6,3,25,20,5,21
Kolkata,3358,4,4,6,4,15,16,-1,18
Chennaiyin,3358,5,4,6,4,15,18,-3,18
FC Pune City,3358,6,5,3,6,13,16,-3,18
NorthEast Un,3358,7,4,4,6,11,13,-2,16
FC Goa,3358,8,3,2,9,11,20,-9,11
Mumbai City,3359,1,7,4,3,19,8,11,25
Delhi Dynamo,3359,2,5,6,3,27,20,7,21
Kolkata,3359,3,4,8,2,19,16,3,20
Kerala Blast,3359,4,5,5,4,14,17,-3,20
Chennaiyin,3359,5,4,6,4,18,20,-2,18
NorthEast Un,3359,6,4,4,6,12,15,-3,16
FC Pune City,3359,7,4,3,7,12,17,-5,15
FC Goa,3359,8,3,4,7,13,21,-8,13
Mumbai City,3360,1,7,4,3,19,9,10,25
Kerala Blast,3360,2,6,3,5,14,16,-2,21
FC Goa,3360,3,6,2,6,12,15,-3,20
Delhi Dynamo,3360,4,4,6,4,24,20,4,18
Kolkata,3360,5,4,6,4,16,16,0,18
NorthEast Un,3360,6,5,3,6,13,14,-1,18
FC Pune City,3360,7,5,3,6,15,17,-2,18
Chennaiyin,3360,8,3,5,6,13,19,-6,14
Mumbai City,3361,1,6,5,3,16,8,8,23
Delhi Dynamo,3361,2,5,6,3,25,18,7,21
NorthEast Un,3361,3,6,3,5,13,11,2,21
Kerala Blast,3361,4,5,4,5,12,15,-3,19
FC Pune City,3361,5,5,3,6,15,17,-2,18
FC Goa,3361,6,5,2,7,13,18,-5,17
Kolkata,3361,7,3,7,4,15,17,-2,16
Chennaiyin,3361,8,3,6,5,15,20,-5,15
Mumbai City,3362,1,7,4,3,19,8,11,25
Kerala Blast,3362,2,6,4,4,13,14,-1,22
Delhi Dynamo,3362,3,5,5,4,23,19,4,20
Kolkata,3362,4,4,8,2,14,12,2,20
NorthEast Un,3362,5,5,2,7,12,13,-1,17
Chennaiyin,3362,6,4,5,5,15,19,-4,17
FC Pune City,3362,7,4,3,7,12,17,-5,15
FC Goa,3362,8,4,3,7,10,16,-6,15
Mumbai City,3363,1,7,4,3,17,8,9,25
Delhi Dynamo,3363,2,5,6,3,22,15,7,21
NorthEast Un,3363,3,6,2,6,13,10,3,20
FC Pune City,3363,4,5,4,5,13,14,-1,19
Kolkata,3363,5,4,6,4,16,16,0,18
Chennaiyin,3363,6,4,5,5,14,20,-6,17
Kerala Blast,3363,7,4,4,6,11,17,-6,16
FC Goa,3363,8,4,3,7,9,15,-6,15
Mumbai City,3364,1,7,4,3,20,9,11,25
Kolkata,3364,2,5,6,3,15,13,2,21
Kerala Blast,3364,3,5,4,5,12,16,-4,19
Delhi Dynamo,3364,4,4,6,4,23,21,2,18
NorthEast Un,3364,5,5,3,6,16,15,1,18
FC Pune City,3364,6,4,4,6,12,15,-3,16
Chennaiyin,3364,7,3,7,4,16,20,-4,16
FC Goa,3364,8,4,4,6,10,15,-5,16
Mumbai City,3365,1,6,4,4,16,9,7,22
Delhi Dynamo,3365,2,5,6,3,23,16,7,21
Kolkata,3365,3,5,6,3,20,15,5,21
Chennaiyin,3365,4,4,6,4,16,19,-3,18
FC Pune City,3365,5,5,3,6,14,17,-3,18
NorthEast Un,3365,6,4,5,5,13,13,0,17
FC Goa,3365,7,5,2,7,11,15,-4,17
Kerala Blast,3365,8,4,4,6,11,20,-9,16
Delhi Dynamo,3366,1,6,5,3,27,16,11,23
Mumbai City,3366,2,6,4,4,17,11,6,22
NorthEast Un,3366,3,6,2,6,11,10,1,20
Kolkata,3366,4,4,7,3,15,16,-1,19
Kerala Blast,3366,5,5,3,6,10,15,-5,18
Chennaiyin,3366,6,4,5,5,15,19,-4,17
FC Goa,3366,7,5,2,7,14,19,-5,17
FC Pune City,3366,8,4,4,6,12,15,-3,16
Mumbai City,3367,1,6,5,3,17,9,8,23
NorthEast Un,3367,2,7,2,5,14,10,4,23
Kolkata,3367,3,5,6,3,20,16,4,21
FC Pune City,3367,4,6,3,5,16,16,0,21
Delhi Dynamo,3367,5,4,7,3,23,17,6,19
Chennaiyin,3367,6,4,5,5,14,19,-5,17
Kerala Blast,3367,7,4,3,7,10,19,-9,15
FC Goa,3367,8,3,3,8,10,18,-8,12
Mumbai City,3368,1,7,4,3,18,9,9,25
Delhi Dynamo,3368,2,6,5,3,26,18,8,23
Kerala Blast,3368,3,6,3,5,13,15,-2,21
Kolkata,3368,4,4,7,3,16,14,2,19
FC Pune City,3368,5,5,4,5,14,15,-1,19
Chennaiyin,3368,6,4,5,5,15,19,-4,17
NorthEast Un,3368,7,4,2,8,12,16,-4,14
FC Goa,3368,8,4,2,8,10,18,-8,14
Mumbai City,3369,1,7,4,3,18,8,10,25
Delhi Dynamo,3369,2,5,6,3,24,18,6,21
Kolkata,3369,3,4,8,2,19,14,5,20
FC Pune City,3369,4,5,4,5,15,16,-1,19
Chennaiyin,3369,5,4,6,4,15,18,-3,18
Kerala Blast,3369,6,5,3,6,11,19,-8,18
NorthEast Un,3369,7,4,4,6,10,11,-1,16
FC Goa,3369,8,3,3,8,11,19,-8,12
Mumbai City,3370,1,7,4,3,19,10,9,25
Kolkata,3370,2,5,6,3,16,14,2,21
FC Pune City,3370,3,6,3,5,14,14,0,21
Delhi Dynamo,3370,4,5,5,4,24,18,6,20
NorthEast Un,3370,5,5,4,5,11,10,1,19
Kerala Blast,3370,6,4,4,6,10,16,-6,16
Chennaiyin,3370,7,3,6,5,14,20,-6,15
FC Goa,3370,8,4,2,8,10,16,-6,14
Mumbai City,3371,1,6,5,3,16,8,8,23
Kolkata,3371,2,5,6,3,16,15,1,21
Kerala Blast,3371,3,6,3,5,14,16,-2,21
NorthEast Un,3371,4,5,3,6,13,10,3,18
Delhi Dynamo,3371,5,4,6,4,21,19,2,18
FC Pune City,3371,6,5,3,6,15,17,-2,18
FC Goa,3371,7,5,2,7,11,16,-5,17
Chennaiyin,3371,8,3,6,5,14,19,-5,15
Mumbai City,3372,1,7,4,3,19,9,10,25
Kerala Blast,3372,2,6,4,4,16,14,2,22
Delhi Dynamo,3372,3,5,6,3,27,21,6,21
FC Pune City,3372,4,5,3,6,15,18,-3,18
Kolkata,3372,5,3,8,3,16,16,0,17
Chennaiyin,3372,6,4,5,5,15,19,-4,17
FC Goa,3372,7,4,4,6,14,19,-5,16
NorthEast Un,3372,8,4,2,8,11,17,-6,14
Delhi Dynamo,3373,1,6,6,2,27,16,11,24
Mumbai City,3373,2,6,5,3,17,9,8,23
Kolkata,3373,3,5,6,3,18,13,5,21
FC Pune City,3373,4,6,3,5,16,14,2,21
NorthEast Un,3373,5,6,2,6,15,13,2,20
Chennaiyin,3373,6,4,5,5,14,19,-5,17
Kerala Blast,3373,7,4,3,7,10,21,-11,15
FC Goa,3373,8,3,2,9,8,20,-12,11
Delhi Dynamo,3374,1,6,6,2,25,16,9,24
Mumbai City,3374,2,6,5,3,17,9,8,23
NorthEast Un,3374,3,6,2,6,15,14,1,20
Kerala Blast,3374,4,5,4,5,14,16,-2,19
Kolkata,3374,5,3,9,2,14,13,1,18
FC Pune City,3374,6,4,4,6,12,17,-5,16
Chennaiyin,3374,7,3,6,5,16,21,-5,15
FC Goa,3374,8,3,4,7,11,18,-7,13
Mumbai City,3375,1,6,5,3,16,8,8,23
Delhi Dynamo,3375,2,4,7,3,21,15,6,19
Kolkata,3375,3,4,7,3,16,15,1,19
FC Pune City,3375,4,5,4,5,14,15,-1,19
Kerala Blast,3375,5,5,4,5,12,15,-3,19
Chennaiyin,3375,6,4,6,4,16,18,-2,18
NorthEast Un,3375,7,4,5,5,11,11,0,17
FC Goa,3375,8,4,2,8,9,18,-9,14
Mumbai City,3376,1,7,4,3,18,9,9,25
NorthEast Un,3376,2,6,3,5,16,10,6,21
Kolkata,3376,3,5,6,3,20,15,5,21
Kerala Blast,3376,4,5,4,5,12,19,-7,19
Delhi Dynamo,3376,5,4,6,4,24,22,2,18
Chennaiyin,3376,6,4,5,5,16,19,-3,17
FC Pune City,3376,7,4,3,7,15,19,-4,15
FC Goa,3376,8,4,3,7,11,19,-8,15
Mumbai City,3377,1,6,5,3,17,9,8,23
Delhi Dynamo,3377,2,5,6,3,24,16,8,21
Kerala Blast,3377,3,5,5,4,13,16,-3,20
Kolkata,3377,4,4,7,3,17,16,1,19
NorthEast Un,3377,5,5,3,6,11,11,0,18
FC Goa,3377,6,5,2,7,12,17,-5,17
FC Pune City,3377,7,4,4,6,13,17,-4,16
Chennaiyin,3377,8,3,6,5,13,18,-5,15
Mumbai City,3378,1,6,5,3,18,10,8,23
Delhi Dynamo,3378,2,5,6,3,27,18,9,21
Chennaiyin,3378,3,5,5,4,18,17,1,20
Kerala Blast,3378,4,5,5,4,12,15,-3,20
NorthEast Un,3378,5,5,3,6,11,13,-2,18
Kolkata,3378,6,3,8,3,18,18,0,17
FC Pune City,3378,7,4,4,6,15,18,-3,16
FC Goa,3378,8,4,2,8,11,21,-10,14
Mumbai City,3379,1,7,4,3,17,8,9,25
Delhi Dynamo,3379,2,5,6,3,26,18,8,21
Kerala Blast,3379,3,5,5,4,15,18,-3,20
Chennaiyin,3379,4,4,6,4,15,17,-2,18
FC Pune City,3379,5,4,5,5,16,18,-2,17
Kolkata,3379,6,3,7,4,15,18,-3,16
FC Goa,3379,7,4,4,6,13,16,-3,16
NorthEast Un,3379,8,4,3,7,13,17,-4,15
Mumbai City,3380,1,6,5,3,17,9,8,23
Delhi Dynamo,3380,2,5,7,2,26,18,8,22
Kolkata,3380,3,5,6,3,17,16,1,21
Kerala Blast,3380,4,6,3,5,13,16,-3,21
FC Pune City,3380,5,5,3,6,14,15,-1,18
Chennaiyin,3380,6,4,6,4,17,19,-2,18
NorthEast Un,3380,7,4,4,6,9,10,-1,16
FC Goa,3380,8,3,2,9,14,24,-10,11
Mumbai City,3381,1,7,4,3,19,10,9,25
NorthEast Un,3381,2,6,3,5,14,10,4,21
Kolkata,3381,3,5,6,3,16,13,3,21
Delhi Dynamo,3381,4,4,6,4,25,22,3,18
FC Goa,3381,5,5,3,6,12,15,-3,18
Kerala Blast,3381,6,5,3,6,12,16,-4,18
Chennaiyin,3381,7,3,6,5,13,19,-6,15
FC Pune City,3381,7,4,3,7,13,19,-6,15
Mumbai City,3382,1,7,4,3,19,9,10,25
Kerala Blast,3382,2,6,4,4,12,14,-2,22
Delhi Dynamo,3382,3,4,7,3,25,20,5,19
Kolkata,3382,4,4,7,3,15,13,2,19
NorthEast Un,3382,5,5,4,5,13,12,1,19
Chennaiyin,3382,6,4,5,5,16,20,-4,17
FC Pune City,3382,7,4,4,6,12,15,-3,16
FC Goa,3382,8,3,3,8,11,20,-9,12
Mumbai City,3383,1,6,5,3,18,10,8,23
Kolkata,3383,2,5,6,3,15,13,2,21
Delhi Dynamo,3383,3,4,8,2,24,17,7,20
NorthEast Un,3383,4,5,4,5,12,9,3,19
Kerala Blast,3383,5,4,5,5,11,16,-5,17
FC Pune City,3383,6,4,4,6,14,17,-3,16
FC Goa,3383,7,4,4,6,10,15,-5,16
Chennaiyin,3383,8,3,6,5,13,20,-7,15
Mumbai City,3384,1,7,4,3,17,8,9,25
Delhi Dynamo,3384,2,5,6,3,24,16,8,21
FC Pune City,3384,3,6,3,5,17,15,2,21
Kolkata,3384,4,4,6,4,19,18,1,18
NorthEast Un,3384,5,5,3,6,12,11,1,18
Kerala Blast,3384,6,5,3,6,10,19,-9,18
Chennaiyin,3384,7,4,5,5,15,19,-4,17
FC Goa,3384,8,4,2,8,10,18,-8,14
Mumbai City,3385,1,7,4,3,17,8,9,25
Kerala Blast,3385,2,5,5,4,13,16,-3,20
Delhi Dynamo,3385,3,4,7,3,23,17,6,19
Kolkata,3385,4,4,7,3,15,14,1,19
NorthEast Un,3385,5,5,4,5,13,12,1,19
Chennaiyin,3385,6,4,5,5,15,19,-4,17
FC Pune City,3385,7,4,3,7,13,17,-4,15
FC Goa,3385,8,4,3,7,12,18,-6,15
Mumbai City,3386,1,6,5,3,18,10,8,23
Kolkata,3386,2,4,8,2,17,14,3,20
Delhi Dynamo,3386,3,4,7,3,24,18,6,19
NorthEast Un,3386,4,5,4,5,15,13,2,19
FC Goa,3386,5,5,3,6,11,15,-4,18
FC Pune City,3386,6,4,5,5,14,16,-2,17
Kerala Blast,3386,7,4,4,6,11,19,-8,16
Chennaiyin,3386,8,3,6,5,15,20,-5,15
Delhi Dynamo,3387,1,7,5,2,32,15,17,26
Mumbai City,3387,2,6,4,4,16,12,4,22
Kolkata,3387,3,5,6,3,20,16,4,21
Kerala Blast,3387,4,5,4,5,13,16,-3,19
NorthEast Un,3387,5,5,3,6,12,13,-1,18
FC Goa,3387,6,5,2,7,12,20,-8,17
FC Pune City,3387,7,4,3,7,13,20,-7,15
Chennaiyin,3387,8,3,5,6,14,20,-6,14
Delhi Dynamo,3388,1,6,6,2,28,17,11,24
Mumbai City,3388,2,6,4,4,16,10,6,22
Kolkata,3388,3,5,7,2,15,12,3,22
Kerala Blast,3388,4,5,4,5,14,15,-1,19
NorthEast Un,3388,5,4,5,5,13,13,0,17
Chennaiyin,3388,6,3,7,4,15,19,-4,16
FC Pune City,3388,7,4,4,6,12,18,-6,16
FC Goa,3388,8,3,3,8,10,19,-9,12
Delhi Dynamo,3389,1,6,5,3,26,18,8,23
Kolkata,3389,2,5,7,2,20,14,6,22
Mumbai City,3389,3,6,4,4,16,10,6,22
NorthEast Un,3389,4,5,3,6,13,12,1,18
Chennaiyin,3389,5,4,6,4,17,19,-2,18
Kerala Blast,3389,6,5,3,6,14,19,-5,18
FC Goa,3389,7,4,3,7,13,19,-6,15
FC Pune City,3389,8,4,3,7,12,20,-8,15
Mumbai City,3390,1,7,4,3,19,9,10,25
Delhi Dynamo,3390,2,5,6,3,27,19,8,21
Kolkata,3390,3,5,6,3,16,15,1,21
Kerala Blast,3390,4,6,3,5,14,15,-1,21
NorthEast Un,3390,5,5,4,5,13,12,1,19
Chennaiyin,3390,6,4,6,4,16,18,-2,18
FC Pune City,3390,7,4,3,7,12,16,-4,15
FC Goa,3390,8,3,2,9,9,22,-13,11
Delhi Dynamo,3391,1,6,5,3,25,17,8,23
Mumbai City,3391,2,6,4,4,16,9,7,22
Kolkata,3391,3,5,6,3,18,14,4,21
NorthEast Un,3391,4,6,3,5,13,11,2,21
Kerala Blast,3391,5,5,3,6,12,17,-5,18
FC Goa,3391,6,5,2,7,14,17,-3,17
FC Pune City,3391,7,4,3,7,13,19,-6,15
Chennaiyin,3391,8,3,6,5,14,21,-7,15
Mumbai City,3392,1,6,5,3,20,12,8,23
Delhi Dynamo,3392,2,5,7,2,29,18,11,22
Kerala Blast,3392,3,6,4,4,12,13,-1,22
FC Pune City,3392,4,5,3,6,14,16,-2,18
Chennaiyin,3392,5,4,6,4,15,18,-3,18
NorthEast Un,3392,6,4,4,6,10,14,-4,16
Kolkata,3392,7,3,6,5,14,17,-3,15
FC Goa,3392,8,4,3,7,10,16,-6,15
Mumbai City,3393,1,6,5,3,17,9,8,23
Kerala Blast,3393,2,6,4,4,12,14,-2,22
Delhi Dynamo,3393,3,5,6,3,28,16,12,21
Kolkata,3393,4,4,7,3,17,15,2,19
FC Pune City,3393,5,4,5,5,14,16,-2,17
NorthEast Un,3393,6,5,2,7,10,12,-2,17
Chennaiyin,3393,7,4,5,5,15,18,-3,17
FC Goa,3393,8,4,2,8,10,23,-13,14
Delhi Dynamo,3394,1,6,6,2,29,15,14,24
Mumbai City,3394,2,6,4,4,17,10,7,22
Kolkata,3394,3,5,7,2,17,14,3,22
Kerala Blast,3394,4,6,4,4,13,14,-1,22
FC Pune City,3394,5,4,3,7,13,17,-4,15
Chennaiyin,3394,6,3,6,5,13,18,-5,15
FC Goa,3394,7,4,3,7,9,15,-6,15
NorthEast Un,3394,8,4,3,7,9,17,-8,15
Mumbai City,3395,1,7,4,3,17,8,9,25
Kolkata,3395,2,6,6,2,20,13,7,24
Delhi Dynamo,3395,3,5,5,4,25,18,7,20
NorthEast Un,3395,4,6,2,6,17,15,2,20
Kerala Blast,3395,5,5,3,6,13,23,-10,18
Chennaiyin,3395,6,4,5,5,17,19,-2,17
FC Pune City,3395,7,4,3,7,15,19,-4,15
FC Goa,3395,8,4,2,8,9,18,-9,14
Mumbai City,3396,1,7,4,3,18,8,10,25
Delhi Dynamo,3396,2,6,5,3,24,17,7,23
Kerala Blast,3396,3,6,4,4,13,15,-2,22
Kolkata,3396,4,3,8,3,16,17,-1,17
FC Pune City,3396,5,4,4,6,15,18,-3,16
Chennaiyin,3396,6,3,7,4,17,21,-4,16
NorthEast Un,3396,7,4,3,7,12,14,-2,15
FC Goa,3396,8,4,3,7,12,17,-5,15
Mumbai City,3397,1,7,4,3,19,8,11,25
Kolkata,3397,2,5,7,2,15,12,3,22
Delhi Dynamo,3397,3,5,5,4,24,20,4,20
Kerala Blast,3397,4,5,5,4,14,17,-3,20
FC Goa,3397,5,5,2,7,14,17,-3,17
FC Pune City,3397,6,4,4,6,15,18,-3,16
NorthEast Un,3397,7,4,3,7,10,12,-2,15
Chennaiyin,3397,8,3,6,5,13,20,-7,15
Mumbai City,3398,1,6,5,3,18,10,8,23
Kolkata,3398,2,5,6,3,19,13,6,21
Delhi Dynamo,3398,3,4,7,3,24,18,6,19
Kerala Blast,3398,4,5,4,5,14,18,-4,19
Chennaiyin,3398,5,4,6,4,17,18,-1,18
FC Pune City,3398,6,5,3,6,14,18,-4,18
NorthEast Un,3398,7,4,5,5,12,12,0,17
FC Goa,3398,8,4,2,8,9,20,-11,14
Mumbai City,3399,1,6,4,4,17,11,6,22
Delhi Dynamo,3399,2,5,5,4,25,18,7,20
Kerala Blast,3399,3,5,5,4,13,15,-2,20
Kolkata,3399,4,4,7,3,16,15,1,19
NorthEast Un,3399,5,5,4,5,13,12,1,19
FC Pune City,3399,6,5,3,6,13,16,-3,18
Chennaiyin,3399,7,3,7,4,16,20,-4,16
FC Goa,3399,8,4,3,7,12,18,-6,15
Delhi Dynamo,3400,1,6,6,2,25,16,9,24
Mumbai City,3400,2,6,5,3,16,8,8,23
Kolkata,3400,3,5,7,2,18,15,3,22
Chennaiyin,3400,4,5,5,4,19,18,1,20
Kerala Blast,3400,5,5,3,6,12,17,-5,18
NorthEast Un,3400,6,5,2,7,13,15,-2,17
FC Pune City,3400,7,4,4,6,15,18,-3,16
FC Goa,3400,8,3,2,9,10,21,-11,11
Delhi Dynamo,3401,1,6,6,2,28,15,13,24
Mumbai City,3401,2,6,5,3,17,9,8,23
Kolkata,3401,3,4,7,3,15,15,0,19
Kerala Blast,3401,4,5,4,5,13,16,-3,19
NorthEast Un,3401,5,5,3,6,12,12,0,18
FC Goa,3401,6,5,2,7,13,21,-8,17
FC Pune City,3401,7,4,4,6,13,17,-4,16
Chennaiyin,3401,8,3,5,6,15,21,-6,14
Mumbai City,3402,1,7,4,3,18,8,10,25
Delhi Dynamo,3402,2,5,6,3,25,19,6,21
NorthEast Un,3402,3,5,4,5,16,13,3,19
Kerala Blast,3402,4,5,4,5,13,19,-6,19
Kolkata,3402,5,4,6,4,18,16,2,18
Chennaiyin,3402,6,4,6,4,16,19,-3,18
FC Pune City,3402,7,4,4,6,13,18,-5,16
FC Goa,3402,8,4,2,8,12,19,-7,14
Mumbai City,3403,1,6,5,3,18,10,8,23
Chennaiyin,3403,2,5,5,4,15,17,-2,20
Delhi Dynamo,3403,3,4,7,3,24,19,5,19
Kerala Blast,3403,4,5,4,5,12,15,-3,19
Kolkata,3403,5,4,6,4,15,15,0,18
FC Pune City,3403,6,5,3,6,14,17,-3,18
FC Goa,3403,7,5,2,7,11,15,-4,17
NorthEast Un,3403,8,4,4,6,11,12,-1,16
Mumbai City,3404,1,6,5,3,18,10,8,23
NorthEast Un,3404,2,6,3,5,14,12,2,21
Delhi Dynamo,3404,3,4,7,3,26,20,6,19
FC Pune City,3404,4,5,4,5,14,15,-1,19
Kolkata,3404,4,4,7,3,14,15,-1,19
Kerala Blast,3404,6,5,3,6,14,17,-3,18
FC Goa,3404,7,5,2,7,11,16,-5,17
Chennaiyin,3404,8,3,5,6,13,19,-6,14
Delhi Dynamo,3405,1,6,5,3,27,20,7,23
Mumbai City,3405,2,6,4,4,18,12,6,22
Kolkata,3405,3,5,6,3,20,16,4,21
Chennaiyin,3405,4,5,5,4,22,17,5,20
Kerala Blast,3405,5,5,4,5,12,17,-5,19
NorthEast Un,3405,6,5,3,6,14,16,-2,18
FC Pune City,3405,7,4,3,7,14,20,-6,15
FC Goa,3405,8,4,2,8,10,19,-9,14
Mumbai City,3406,1,7,4,3,18,8,10,25
Kolkata,3406,2,6,6,2,19,14,5,24
Delhi Dynamo,3406,3,5,5,4,25,17,8,20
Kerala Blast,3406,4,5,4,5,16,18,-2,19
NorthEast Un,3406,5,5,3,6,11,13,-2,18
FC Pune City,3406,6,4,4,6,14,18,-4,16
Chennaiyin,3406,7,3,6,5,13,19,-6,15
FC Goa,3406,8,4,2,8,11,20,-9,14
Mumbai City,3407,1,7,4,3,17,8,9,25
Kolkata,3407,2,6,6,2,19,13,6,24
Delhi Dynamo,3407,3,5,5,4,24,18,6,20
NorthEast Un,3407,4,5,3,6,12,13,-1,18
FC Pune City,3407,5,5,3,6,14,16,-2,18
Chennaiyin,3407,6,4,5,5,17,19,-2,17
Kerala Blast,3407,7,4,4,6,12,20,-8,16
FC Goa,3407,8,4,2,8,11,19,-8,14
Mumbai City,3408,1,7,4,3,18,8,10,25
Delhi Dynamo,3408,2,6,5,3,26,17,9,23
Kerala Blast,3408,3,6,4,4,16,16,0,22
Kolkata,3408,4,4,8,2,19,15,4,20
Chennaiyin,3408,5,4,6,4,16,19,-3,18
FC Pune City,3408,6,4,4,6,14,18,-4,16
NorthEast Un,3408,7,4,2,8,10,16,-6,14
FC Goa,3408,8,3,3,8,10,20,-10,12
Kerala Blast,3409,1,7,3,4,12,13,-1,24
Mumbai City,3409,2,6,5,3,16,8,8,23
Delhi Dynamo,3409,3,5,6,3,24,16,8,21
NorthEast Un,3409,4,5,3,6,13,13,0,18
Kolkata,3409,5,3,7,4,14,17,-3,16
FC Pune City,3409,6,4,4,6,13,16,-3,16
Chennaiyin,3409,7,3,7,4,16,20,-4,16
FC Goa,3409,8,4,3,7,12,17,-5,15
Mumbai City,3410,1,6,5,3,17,9,8,23
Kolkata,3410,2,5,7,2,21,17,4,22
Delhi Dynamo,3410,3,4,8,2,23,16,7,20
Kerala Blast,3410,4,5,5,4,13,16,-3,20
NorthEast Un,3410,5,5,4,5,14,13,1,19
Chennaiyin,3410,6,4,5,5,16,20,-4,17
FC Pune City,3410,7,4,3,7,13,18,-5,15
FC Goa,3410,8,3,3,8,10,18,-8,12
Mumbai City,3411,1,7,4,3,20,8,12,25
Delhi Dynamo,3411,2,5,6,3,26,21,5,21
Kolkata,3411,3,4,7,3,17,16,1,19
Kerala Blast,3411,4,5,4,5,13,17,-4,19
FC Pune City,3411,5,5,3,6,15,17,-2,18
Chennaiyin,3411,6,4,6,4,15,18,-3,18
NorthEast Un,3411,7,4,4,6,14,15,-1,16
FC Goa,3411,8,3,4,7,11,19,-8,13
Mumbai City,3412,1,6,4,4,17,10,7,22
Delhi Dynamo,3412,2,5,6,3,25,18,7,21
Kolkata,3412,3,5,6,3,19,17,2,21
Chennaiyin,3412,4,5,5,4,17,17,0,20
FC Pune City,3412,5,5,4,5,17,17,0,19
Kerala Blast,3412,6,5,4,5,12,16,-4,19
NorthEast Un,3412,7,5,2,7,11,14,-3,17
FC Goa,3412,8,3,3,8,10,19,-9,12
Delhi Dynamo,3413,1,6,5,3,26,17,9,23
Mumbai City,3413,2,6,4,4,17,10,7,22
NorthEast Un,3413,3,6,3,5,15,11,4,21
Kolkata,3413,4,5,6,3,16,13,3,21
Kerala Blast,3413,5,5,5,4,12,15,-3,20
Chennaiyin,3413,6,4,5,5,15,21,-6,17
FC Pune City,3413,7,4,4,6,13,17,-4,16
FC Goa,3413,8,3,2,9,9,19,-10,11
Mumbai City,3414,1,7,4,3,21,10,11,25
Delhi Dynamo,3414,2,4,7,3,23,19,4,19
Kolkata,3414,3,4,7,3,17,14,3,19
NorthEast Un,3414,4,5,3,6,12,12,0,18
Chennaiyin,3414,5,4,6,4,15,18,-3,18
FC Pune City,3414,6,5,3,6,14,18,-4,18
FC Goa,3414,7,4,4,6,9,14,-5,16
Kerala Blast,3414,8,4,4,6,10,16,-6,16
Mumbai City,3415,1,7,4,3,18,8,10,25
Delhi Dynamo,3415,2,6,5,3,27,18,9,23
FC Pune City,3415,3,6,3,5,15,15,0,21
Chennaiyin,3415,4,5,5,4,15,17,-2,20
Kolkata,3415,5,4,7,3,16,15,1,19
Kerala Blast,3415,6,5,4,5,14,17,-3,19
NorthEast Un,3415,7,4,2,8,13,17,-4,14
FC Goa,3415,8,3,2,9,8,19,-11,11
Mumbai City,3416,1,7,4,3,17,8,9,25
Kolkata,3416,2,5,6,3,17,15,2,21
Kerala Blast,3416,3,6,3,5,15,16,-1,21
Delhi Dynamo,3416,4,5,5,4,22,17,5,20
NorthEast Un,3416,5,6,2,6,15,15,0,20
Chennaiyin,3416,6,4,5,5,17,20,-3,17
FC Pune City,3416,7,4,3,7,13,17,-4,15
FC Goa,3416,8,4,2,8,9,17,-8,14
Delhi Dynamo,3417,1,6,5,3,27,18,9,23
Mumbai City,3417,2,6,4,4,16,10,6,22
NorthEast Un,3417,3,6,3,5,14,11,3,21
Kolkata,3417,4,4,8,2,15,12,3,20
FC Pune City,3417,5,5,3,6,14,17,-3,18
Kerala Blast,3417,6,4,5,5,10,15,-5,17
FC Goa,3417,7,4,3,7,11,17,-6,15
Chennaiyin,3417,8,3,5,6,14,21,-7,14
Mumbai City,3418,1,7,4,3,19,8,11,25
Kerala Blast,3418,2,6,3,5,12,16,-4,21
NorthEast Un,3418,3,6,2,6,15,10,5,20
Chennaiyin,3418,4,5,5,4,15,17,-2,20
Delhi Dynamo,3418,5,4,6,4,22,21,1,18
Kolkata,3418,6,4,6,4,16,15,1,18
FC Pune City,3418,7,4,3,7,13,19,-6,15
FC Goa,3418,8,4,3,7,10,16,-6,15
Mumbai City,3419,1,7,4,3,18,9,9,25
FC Pune City,3419,2,6,3,5,17,14,3,21
Kerala Blast,3419,3,6,3,5,14,17,-3,21
Delhi Dynamo,3419,4,5,5,4,23,17,6,20
NorthEast Un,3419,5,6,2,6,13,13,0,20
Kolkata,3419,6,3,7,4,16,19,-3,16
FC Goa,3419,7,4,3,7,13,17,-4,15
Chennaiyin,3419,8,3,5,6,14,22,-8,14
Delhi Dynamo,3420,1,6,5,3,25,16,9,23
Mumbai City,3420,2,6,4,4,16,9,7,22
Kerala Blast,3420,3,6,4,4,13,14,-1,22
Kolkata,3420,4,5,6,3,17,15,2,21
NorthEast Un,3420,5,5,3,6,12,12,0,18
Chennaiyin,3420,6,4,6,4,15,17,-2,18
FC Pune City,3420,7,4,3,7,13,18,-5,15
FC Goa,3420,8,3,3,8,9,19,-10,12
Mumbai City,3421,1,7,4,3,19,9,10,25
Delhi Dynamo,3421,2,6,5,3,27,18,9,23
Kerala Blast,3421,3,6,3,5,14,16,-2,21
NorthEast Un,3421,4,6,2,6,13,13,0,20
Kolkata,3421,5,4,6,4,16,18,-2,18
Chennaiyin,3421,6,4,5,5,20,21,-1,17
FC Pune City,3421,7,4,3,7,13,18,-5,15
FC Goa,3421,8,4,2,8,14,23,-9,14
Kerala Blast,3422,1,7,3,4,15,15,0,24
Mumbai City,3422,2,6,5,3,17,9,8,23
Delhi Dynamo,3422,3,5,7,2,26,17,9,22
Kolkata,3422,4,5,6,3,20,15,5,21
Chennaiyin,3422,5,4,6,4,16,17,-1,18
FC Pune City,3422,6,4,3,7,14,21,-7,15
NorthEast Un,3422,7,4,2,8,9,16,-7,14
FC Goa,3422,8,3,4,7,10,17,-7,13
Delhi Dynamo,3423,1,6,6,2,26,15,11,24
Mumbai City,3423,2,6,4,4,16,10,6,22
Kerala Blast,3423,3,6,4,4,17,17,0,22
Kolkata,3423,4,4,7,3,17,15,2,19
NorthEast Un,3423,5,5,3,6,14,14,0,18
FC Pune City,3423,6,5,3,6,13,17,-4,18
Chennaiyin,3423,7,3,6,5,15,20,-5,15
FC Goa,3423,8,3,3,8,9,19,-10,12
Mumbai City,3424,1,7,4,3,18,8,10,25
Kerala Blast,3424,2,7,3,4,17,16,1,24
Delhi Dynamo,3424,3,6,5,3,25,16,9,23
Kolkata,3424,4,4,7,3,14,14,0,19
NorthEast Un,3424,5,5,2,7,11,14,-3,17
FC Pune City,3424,6,4,3,7,14,18,-4,15
FC Goa,3424,7,4,3,7,9,16,-7,15
Chennaiyin,3424,8,3,5,6,13,19,-6,14
Delhi Dynamo,3425,1,6,6,2,30,18,12,24
Mumbai City,3425,2,6,4,4,18,12,6,22
Kolkata,3425,3,4,7,3,18,17,1,19
NorthEast Un,3425,4,5,4,5,14,13,1,19
Kerala Blast,3425,5,5,4,5,11,17,-6,19
FC Goa,3425,6,5,2,7,12,17,-5,17
FC Pune City,3425,7,4,4,6,14,17,-3,16
Chennaiyin,3425,8,3,5,6,14,20,-6,14
Mumbai City,3426,1,7,4,3,18,9,9,25
Kerala Blast,3426,2,6,4,4,15,17,-2,22
Kolkata,3426,3,5,6,3,20,15,5,21
Delhi Dynamo,3426,4,5,5,4,24,18,6,20
Chennaiyin,3426,5,5,5,4,17,17,0,20
NorthEast Un,3426,6,5,3,6,12,14,-2,18
FC Pune City,3426,7,4,3,7,13,19,-6,15
FC Goa,3426,8,3,2,9,8,18,-10,11
Mumbai City,3427,1,7,4,3,18,8,10,25
NorthEast Un,3427,2,6,3,5,14,12,2,21
Delhi Dynamo,3427,3,5,5,4,26,18,8,20
Kolkata,3427,4,4,7,3,17,14,3,19
FC Pune City,3427,5,5,4,5,15,16,-1,19
Kerala Blast,3427,6,4,5,5,11,18,-7,17
Chennaiyin,3427,7,3,6,5,17,22,-5,15
FC Goa,3427,8,3,4,7,11,21,-10,13
Mumbai City,3428,1,7,4,3,19,8,11,25
Delhi Dynamo,3428,2,6,5,3,26,19,7,23
Kolkata,3428,3,5,7,2,18,14,4,22
NorthEast Un,3428,4,6,2,6,12,12,0,20
Kerala Blast,3428,5,4,5,5,11,16,-5,17
FC Pune City,3428,6,4,4,6,13,17,-4,16
FC Goa,3428,7,4,2,8,13,19,-6,14
Chennaiyin,3428,8,3,5,6,14,21,-7,14
Mumbai City,3429,1,6,4,4,17,11,6,22
Delhi Dynamo,3429,2,5,6,3,25,18,7,21
Kolkata,3429,3,5,6,3,19,14,5,21
FC Pune City,3429,4,6,3,5,17,16,1,21
NorthEast Un,3429,5,4,5,5,12,12,0,17
FC Goa,3429,6,5,2,7,12,16,-4,17
Kerala Blast,3429,7,4,4,6,12,22,-10,16
Chennaiyin,3429,8,3,6,5,14,19,-5,15
Mumbai City,3430,1,7,4,3,17,8,9,25
Delhi Dynamo,3430,2,5,5,4,24,19,5,20
NorthEast Un,3430,3,5,4,5,14,11,3,19
FC Pune City,3430,4,5,4,5,16,17,-1,19
Kolkata,3430,5,3,9,2,18,17,1,18
Kerala Blast,3430,6,4,5,5,13,18,-5,17
FC Goa,3430,7,4,3,7,13,18,-5,15
Chennaiyin,3430,8,3,6,5,14,21,-7,15
Delhi Dynamo,3431,1,7,5,2,31,16,15,26
Mumbai City,3431,2,6,4,4,17,14,3,22
Kolkata,3431,3,5,6,3,15,14,1,21
FC Pune City,3431,4,5,3,6,15,16,-1,18
Kerala Blast,3431,5,5,3,6,12,17,-5,18
NorthEast Un,3431,6,5,2,7,10,12,-2,17
Chennaiyin,3431,7,4,5,5,14,18,-4,17
FC Goa,3431,8,4,2,8,10,17,-7,14
Mumbai City,3432,1,7,4,3,21,9,12,25
Kerala Blast,3432,2,7,3,4,14,14,0,24
NorthEast Un,3432,3,6,2,6,14,12,2,20
Delhi Dynamo,3432,4,5,5,4,26,25,1,20
Kolkata,3432,5,4,7,3,19,15,4,19
FC Goa,3432,6,4,3,7,12,18,-6,15
FC Pune City,3432,7,4,3,7,14,21,-7,15
Chennaiyin,3432,8,3,5,6,13,19,-6,14
Delhi Dynamo,3433,1,6,5,3,27,20,7,23
Mumbai City,3433,2,6,4,4,18,11,7,22
Kolkata,3433,3,5,6,3,20,17,3,21
Kerala Blast,3433,4,5,5,4,15,16,-1,20
NorthEast Un,3433,5,4,4,6,10,12,-2,16
Chennaiyin,3433,6,3,7,4,14,18,-4,16
FC Pune City,3433,7,4,4,6,15,20,-5,16
FC Goa,3433,8,4,3,7,14,19,-5,15
Mumbai City,3434,1,6,5,3,17,9,8,23
Kolkata,3434,2,5,7,2,16,12,4,22
Delhi Dynamo,3434,3,5,6,3,24,16,8,21
Chennaiyin,3434,4,5,5,4,17,18,-1,20
NorthEast Un,3434,5,5,3,6,10,11,-1,18
FC Pune City,3434,6,5,3,6,13,16,-3,18
Kerala Blast,3434,7,4,5,5,9,14,-5,17
FC Goa,3434,8,3,2,9,9,19,-10,11
Mumbai City,3435,1,7,4,3,18,9,9,25
NorthEast Un,3435,2,7,2,5,15,9,6,23
Delhi Dynamo,3435,3,5,5,4,23,18,5,20
Kolkata,3435,4,4,7,3,16,15,1,19
FC Pune City,3435,5,5,3,6,15,16,-1,18
Kerala Blast,3435,6,5,3,6,11,17,-6,18
Chennaiyin,3435,7,4,5,5,15,20,-5,17
FC Goa,3435,8,3,3,8,9,18,-9,12
Delhi Dynamo,3436,1,5,7,2,25,17,8,22
Mumbai City,3436,2,6,4,4,16,9,7,22
NorthEast Un,3436,3,6,3,5,14,11,3,21
Kolkata,3436,4,4,8,2,16,14,2,20
FC Pune City,3436,5,5,4,5,14,15,-1,19
Chennaiyin,3436,6,4,5,5,15,20,-5,17
Kerala Blast,3436,7,4,3,7,11,18,-7,15
FC Goa,3436,8,3,4,7,11,18,-7,13
Mumbai City,3437,1,6,5,3,16,8,8,23
Delhi Dynamo,3437,2,5,6,3,24,15,9,21
Kolkata,3437,3,5,6,3,18,16,2,21
Kerala Blast,3437,4,6,3,5,14,15,-1,21
Chennaiyin,3437,5,5,5,4,16,18,-2,20
NorthEast Un,3437,6,5,2,7,11,14,-3,17
FC Pune City,3437,7,4,3,7,12,19,-7,15
FC Goa,3437,8,4,2,8,12,18,-6,14
Mumbai City,3438,1,7,4,3,18,8,10,25
FC Goa,3438,2,6,2,6,18,16,2,20
FC Pune City,3438,3,5,4,5,15,16,-1,19
Kerala Blast,3438,4,5,4,5,12,16,-4,19
Delhi Dynamo,3438,5,4,6,4,23,20,3,18
NorthEast Un,3438,6,5,3,6,13,12,1,18
Kolkata,3438,7,4,6,4,16,20,-4,18
Chennaiyin,3438,8,3,5,6,15,22,-7,14
Mumbai City,3439,1,7,4,3,17,8,9,25
Delhi Dynamo,3439,2,5,6,3,25,18,7,21
FC Pune City,3439,3,6,3,5,16,14,2,21
Chennaiyin,3439,4,5,5,4,18,17,1,20
Kolkata,3439,5,4,6,4,15,15,0,18
Kerala Blast,3439,6,4,4,6,9,17,-8,16
NorthEast Un,3439,7,4,3,7,10,13,-3,15
FC Goa,3439,8,4,3,7,11,19,-8,15
Mumbai City,3440,1,6,5,3,17,9,8,23
NorthEast Un,3440,2,7,2,5,14,9,5,23
Delhi Dynamo,3440,3,5,6,3,25,18,7,21
FC Pune City,3440,4,5,4,5,13,14,-1,19
Kerala Blast,3440,5,5,4,5,10,15,-5,19
Kolkata,3440,6,3,7,4,14,15,-1,16
Chennaiyin,3440,7,3,6,5,14,19,-5,15
FC Goa,3440,8,3,4,7,11,19,-8,13
Mumbai City,3441,1,7,4,3,19,10,9,25
Kolkata,3441,2,5,7,2,20,13,7,22
Chennaiyin,3441,3,5,5,4,18,18,0,20
NorthEast Un,3441,4,5,3,6,11,12,-1,18
FC Pune City,3441,5,5,3,6,14,16,-2,18
Delhi Dynamo,3441,6,4,5,5,24,20,4,17
Kerala Blast,3441,7,4,4,6,9,19,-10,16
FC Goa,3441,8,4,3,7,11,18,-7,15
Delhi Dynamo,3442,1,6,6,2,25,15,10,24
Mumbai City,3442,2,6,4,4,16,10,6,22
Kolkata,3442,3,4,8,2,17,15,2,20
NorthEast Un,3442,4,5,3,6,10,10,0,18
Kerala Blast,3442,5,5,3,6,11,16,-5,18
FC Goa,3442,6,4,4,6,13,16,-3,16
FC Pune City,3442,6,4,4,6,13,16,-3,16
Chennaiyin,3442,8,3,6,5,13,20,-7,15
Delhi Dynamo,3443,1,6,6,2,31,17,14,24
Mumbai City,3443,2,6,5,3,18,10,8,23
Kolkata,3443,3,5,7,2,17,13,4,22
Chennaiyin,3443,4,4,5,5,15,18,-3,17
NorthEast Un,3443,5,5,2,7,13,18,-5,17
Kerala Blast,3443,6,4,5,5,12,17,-5,17
FC Pune City,3443,7,4,4,6,13,17,-4,16
FC Goa,3443,8,4,2,8,10,19,-9,14
Mumbai City,3444,1,7,4,3,20,10,10,25
Kolkata,3444,2,5,7,2,19,16,3,22
Delhi Dynamo,3444,3,5,6,3,24,18,6,21
Kerala Blast,3444,4,5,4,5,13,17,-4,19
Chennaiyin,3444,5,4,5,5,16,22,-6,17
FC Goa,3444,6,4,4,6,16,18,-2,16
FC Pune City,3444,7,4,4,6,13,16,-3,16
NorthEast Un,3444,8,4,2,8,10,14,-4,14
Mumbai City,3445,1,7,4,3,19,10,9,25
Kerala Blast,3445,2,7,3,4,18,15,3,24
Delhi Dynamo,3445,3,5,6,3,24,17,7,21
Kolkata,3445,4,3,8,3,18,19,-1,17
NorthEast Un,3445,5,4,4,6,10,12,-2,16
Chennaiyin,3445,6,3,7,4,15,19,-4,16
FC Pune City,3445,7,4,4,6,15,20,-5,16
FC Goa,3445,8,3,4,7,11,18,-7,13
Delhi Dynamo,3446,1,6,5,3,31,16,15,23
Mumbai City,3446,2,6,4,4,16,14,2,22
Kerala Blast,3446,3,6,3,5,13,16,-3,21
NorthEast Un,3446,4,6,2,6,13,12,1,20
Kolkata,3446,5,4,7,3,15,17,-2,19
FC Pune City,3446,6,4,4,6,13,17,-4,16
FC Goa,3446,7,4,3,7,13,17,-4,15
Chennaiyin,3446,8,3,6,5,14,19,-5,15
Mumbai City,3447,1,7,4,3,18,9,9,25
Kerala Blast,3447,2,6,3,5,15,15,0,21
Delhi Dynamo,3447,3,5,5,4,26,17,9,20
Kolkata,3447,4,4,8,2,17,15,2,20
NorthEast Un,3447,5,5,3,6,12,13,-1,18
FC Pune City,3447,6,4,4,6,12,17,-5,16
Chennaiyin,3447,7,3,6,5,16,21,-5,15
FC Goa,3447,8,4,3,7,12,21,-9,15
Mumbai City,3448,1,7,4,3,17,8,9,25
Delhi Dynamo,3448,2,5,6,3,25,15,10,21
Kolkata,3448,3,4,8,2,15,13,2,20
FC Pune City,3448,4,5,4,5,14,15,-1,19
Kerala Blast,3448,5,5,4,5,11,14,-3,19
Chennaiyin,3448,6,4,6,4,15,18,-3,18
NorthEast Un,3448,7,4,3,7,9,12,-3,15
FC Goa,3448,8,3,3,8,9,20,-11,12
Mumbai City,3449,1,7,4,3,18,8,10,25
Kerala Blast,3449,2,7,3,4,16,14,2,24
NorthEast Un,3449,3,6,2,6,14,10,4,20
Kolkata,3449,4,4,6,4,15,17,-2,18
FC Goa,3449,5,5,3,6,13,16,-3,18
Delhi Dynamo,3449,6,4,5,5,22,22,0,17
Chennaiyin,3449,7,3,6,5,14,19,-5,15
FC Pune City,3449,8,4,3,7,14,20,-6,15
Mumbai City,3450,1,7,4,3,19,9,10,25
Kolkata,3450,2,6,6,2,20,15,5,24
Delhi Dynamo,3450,3,5,6,3,25,17,8,21
Chennaiyin,3450,4,5,5,4,17,18,-1,20
FC Pune City,3450,5,5,3,6,15,17,-2,18
NorthEast Un,3450,6,4,4,6,10,12,-2,16
Kerala Blast,3450,7,4,4,6,11,18,-7,16
FC Goa,3450,8,3,2,9,10,21,-11,11
Mumbai City,3451,1,7,4,3,20,8,12,25
Kolkata,3451,2,5,6,3,21,15,6,21
Delhi Dynamo,3451,3,5,6,3,24,20,4,21
NorthEast Un,3451,4,6,2,6,14,11,3,20
FC Pune City,3451,5,5,3,6,13,17,-4,18
Kerala Blast,3451,6,5,3,6,12,16,-4,18
FC Goa,3451,7,4,3,7,11,19,-8,15
Chennaiyin,3451,8,3,5,6,13,22,-9,14
Mumbai City,3452,1,7,4,3,17,8,9,25
NorthEast Un,3452,2,7,2,5,14,11,3,23
Kolkata,3452,3,5,6,3,19,16,3,21
Delhi Dynamo,3452,4,5,5,4,24,17,7,20
Kerala Blast,3452,5,5,4,5,13,16,-3,19
FC Pune City,3452,6,4,4,6,13,17,-4,16
Chennaiyin,3452,7,3,5,6,16,22,-6,14
FC Goa,3452,8,4,2,8,12,21,-9,14
Mumbai City,3453,1,7,4,3,17,8,9,25
Kolkata,3453,2,5,6,3,20,19,1,21
Delhi Dynamo,3453,3,5,5,4,23,18,5,20
Kerala Blast,3453,4,5,4,5,12,17,-5,19
FC Pune City,3453,5,5,3,6,18,17,1,18
FC Goa,3453,6,5,2,7,14,17,-3,17
NorthEast Un,3453,7,4,4,6,11,12,-1,16
Chennaiyin,3453,8,3,6,5,14,21,-7,15
Mumbai City,3454,1,6,4,4,16,10,6,22
Delhi Dynamo,3454,2,5,5,4,25,18,7,20
Kerala Blast,3454,3,5,5,4,17,17,0,20
NorthEast Un,3454,4,5,3,6,13,13,0,18
Kolkata,3454,5,4,6,4,16,18,-2,18
Chennaiyin,3454,6,4,6,4,17,20,-3,18
FC Goa,3454,7,5,3,6,13,17,-4,18
FC Pune City,3454,8,4,4,6,14,18,-4,16
Mumbai City,3455,1,7,4,3,19,10,9,25
Kolkata,3455,2,5,7,2,16,12,4,22
Kerala Blast,3455,3,6,3,5,13,15,-2,21
Delhi Dynamo,3455,4,5,5,4,26,19,7,20
NorthEast Un,3455,5,6,2,6,13,13,0,20
Chennaiyin,3455,6,4,5,5,16,20,-4,17
FC Pune City,3455,7,4,4,6,12,16,-4,16
FC Goa,3455,8,3,2,9,9,19,-10,11
Mumbai City,3456,1,7,4,3,18,9,9,25
Delhi Dynamo,3456,2,5,6,3,28,20,8,21
Kerala Blast,3456,3,5,5,4,13,15,-2,20
FC Goa,3456,4,5,3,6,17,18,-1,18
FC Pune City,3456,5,5,3,6,14,17,-3,18
Kolkata,3456,6,3,7,4,16,18,-2,16
NorthEast Un,3456,7,4,4,6,12,14,-2,16
Chennaiyin,3456,8,3,6,5,14,21,-7,15
Mumbai City,3457,1,7,4,3,19,10,9,25
Kolkata,3457,2,5,6,3,17,15,2,21
FC Pune City,3457,3,6,3,5,17,16,1,21
Delhi Dynamo,3457,4,5,5,4,24,18,6,20
Kerala Blast,3457,5,5,3,6,12,18,-6,18
NorthEast Un,3457,6,5,2,7,11,12,-1,17
Chennaiyin,3457,7,4,5,5,15,21,-6,17
FC Goa,3457,8,4,2,8,12,17,-5,14
Mumbai City,3458,1,7,4,3,19,8,11,25
Delhi Dynamo,3458,2,6,5,3,27,17,10,23
Kolkata,3458,3,4,8,2,18,14,4,20
Kerala Blast,3458,4,5,5,4,12,15,-3,20
FC Pune City,3458,5,4,4,6,13,18,-5,16
NorthEast Un,3458,6,4,3,7,10,13,-3,15
Chennaiyin,3458,7,3,6,5,14,19,-5,15
FC Goa,3458,8,4,3,7,10,19,-9,15
Mumbai City,3459,1,7,4,3,18,8,10,25
NorthEast Un,3459,2,6,2,6,15,15,0,20
Kolkata,3459,3,4,7,3,16,16,0,19
Delhi Dynamo,3459,4,4,6,4,25,21,4,18
Chennaiyin,3459,5,4,6,4,18,19,-1,18
Kerala Blast,3459,6,4,5,5,11,17,-6,17
FC Pune City,3459,7,4,4,6,14,17,-3,16
FC Goa,3459,8,4,4,6,13,17,-4,16
Mumbai City,3460,1,7,4,3,19,10,9,25
Kerala Blast,3460,2,5,5,4,17,18,-1,20
FC Goa,3460,3,6,2,6,12,15,-3,20
Kolkata,3460,4,4,7,3,19,15,4,19
NorthEast Un,3460,5,5,4,5,15,14,1,19
Delhi Dynamo,3460,6,4,5,5,23,19,4,17
Chennaiyin,3460,7,3,6,5,16,21,-5,15
FC Pune City,3460,8,4,3,7,14,23,-9,15
Mumbai City,3461,1,6,4,4,17,10,7,22
Delhi Dynamo,3461,2,5,5,4,24,18,6,20
NorthEast Un,3461,3,6,2,6,12,12,0,20
FC Goa,3461,4,6,2,6,13,15,-2,20
FC Pune City,3461,5,5,4,5,15,16,-1,19
Kerala Blast,3461,6,5,3,6,12,17,-5,18
Chennaiyin,3461,7,4,5,5,15,19,-4,17
Kolkata,3461,8,3,7,4,14,15,-1,16
Mumbai City,3462,1,7,4,3,18,9,9,25
Delhi Dynamo,3462,2,5,5,4,28,21,7,20
FC Pune City,3462,3,5,4,5,15,16,-1,19
Chennaiyin,3462,4,4,6,4,17,19,-2,18
Kerala Blast,3462,5,4,6,4,13,17,-4,18
FC Goa,3462,6,5,2,7,14,19,-5,17
Kolkata,3462,7,3,7,4,14,15,-1,16
NorthEast Un,3462,8,4,4,6,12,15,-3,16
Mumbai City,3463,1,6,5,3,17,9,8,23
Kerala Blast,3463,2,6,4,4,16,16,0,22
Chennaiyin,3463,3,5,5,4,15,17,-2,20
Delhi Dynamo,3463,4,4,7,3,22,17,5,19
FC Pune City,3463,5,5,3,6,13,16,-3,18
NorthEast Un,3463,6,5,2,7,13,14,-1,17
Kolkata,3463,7,3,7,4,14,18,-4,16
FC Goa,3463,8,4,3,7,12,15,-3,15
Kerala Blast,3464,1,7,3,4,16,17,-1,24
Delhi Dynamo,3464,2,6,5,3,25,16,9,23
Mumbai City,3464,3,6,4,4,16,10,6,22
FC Pune City,3464,4,5,3,6,16,18,-2,18
NorthEast Un,3464,5,5,2,7,12,12,0,17
Chennaiyin,3464,6,4,5,5,15,20,-5,17
FC Goa,3464,7,5,2,7,12,17,-5,17
Kolkata,3464,8,3,6,5,15,17,-2,15
Mumbai City,3465,1,6,5,3,17,9,8,23
FC Goa,3465,2,6,2,6,17,14,3,20
Delhi Dynamo,3465,3,4,7,3,23,20,3,19
Kolkata,3465,4,4,7,3,17,16,1,19
NorthEast Un,3465,5,5,4,5,11,10,1,19
Kerala Blast,3465,6,5,4,5,12,16,-4,19
FC Pune City,3465,7,4,4,6,13,17,-4,16
Chennaiyin,3465,8,3,5,6,13,21,-8,14
Mumbai City,3466,1,6,5,3,17,9,8,23
Delhi Dynamo,3466,2,5,6,3,23,18,5,21
FC Pune City,3466,3,5,4,5,15,15,0,19
NorthEast Un,3466,4,5,3,6,13,11,2,18
Kolkata,3466,5,4,6,4,14,16,-2,18
Chennaiyin,3466,6,4,6,4,15,18,-3,18
Kerala Blast,3466,7,4,5,5,10,15,-5,17
FC Goa,3466,8,4,3,7,10,15,-5,15
Kerala Blast,3467,1,7,3,4,14,13,1,24
Delhi Dynamo,3467,2,6,5,3,26,18,8,23
Mumbai City,3467,3,6,4,4,16,9,7,22
Chennaiyin,3467,4,4,6,4,16,18,-2,18
NorthEast Un,3467,5,5,2,7,11,13,-2,17
Kolkata,3467,6,3,7,4,14,15,-1,16
FC Pune City,3467,7,4,4,6,13,18,-5,16
FC Goa,3467,8,4,3,7,12,18,-6,15
Mumbai City,3468,1,7,4,3,19,10,9,25
Kolkata,3468,2,6,6,2,21,14,7,24
Delhi Dynamo,3468,3,5,5,4,24,18,6,20
NorthEast Un,3468,4,6,2,6,12,10,2,20
Kerala Blast,3468,5,5,3,6,11,17,-6,18
Chennaiyin,3468,6,4,5,5,15,20,-5,17
FC Pune City,3468,7,4,3,7,13,19,-6,15
FC Goa,3468,8,4,2,8,12,19,-7,14
Mumbai City,3469,1,7,4,3,18,8,10,25
Kolkata,3469,2,5,7,2,15,12,3,22
Delhi Dynamo,3469,3,5,6,3,24,18,6,21
FC Pune City,3469,4,5,4,5,15,15,0,19
Chennaiyin,3469,5,4,5,5,16,21,-5,17
Kerala Blast,3469,6,4,4,6,11,18,-7,16
NorthEast Un,3469,7,4,3,7,12,14,-2,15
FC Goa,3469,8,4,3,7,12,17,-5,15
Delhi Dynamo,3470,1,6,6,2,28,19,9,24
Mumbai City,3470,2,6,5,3,17,9,8,23
Kolkata,3470,3,5,6,3,17,14,3,21
Chennaiyin,3470,4,5,5,4,18,18,0,20
FC Pune City,3470,5,5,3,6,14,15,-1,18
Kerala Blast,3470,6,5,3,6,10,16,-6,18
NorthEast Un,3470,7,5,2,7,13,14,-1,17
FC Goa,3470,8,3,2,9,10,22,-12,11
Delhi Dynamo,3471,1,6,6,2,28,17,11,24
Mumbai City,3471,2,6,5,3,18,10,8,23
Kolkata,3471,3,4,8,2,15,13,2,20
Kerala Blast,3471,4,5,5,4,12,14,-2,20
NorthEast Un,3471,5,4,4,6,10,11,-1,16
Chennaiyin,3471,6,3,7,4,15,19,-4,16
FC Pune City,3471,7,4,3,7,13,18,-5,15
FC Goa,3471,8,3,4,7,11,20,-9,13
Delhi Dynamo,3472,1,6,6,2,26,15,11,24
Mumbai City,3472,2,6,4,4,16,9,7,22
NorthEast Un,3472,3,6,2,6,12,13,-1,20
Kolkata,3472,4,4,7,3,17,18,-1,19
FC Goa,3472,5,5,3,6,13,15,-2,18
FC Pune City,3472,6,4,5,5,17,19,-2,17
Kerala Blast,3472,7,4,4,6,11,17,-6,16
Chennaiyin,3472,8,3,5,6,14,20,-6,14
Mumbai City,3473,1,6,5,3,17,9,8,23
FC Pune City,3473,2,6,3,5,17,15,2,21
Delhi Dynamo,3473,3,4,8,2,26,19,7,20
Chennaiyin,3473,4,5,5,4,18,18,0,20
Kolkata,3473,5,4,7,3,17,15,2,19
NorthEast Un,3473,6,5,3,6,11,13,-2,18
Kerala Blast,3473,7,4,3,7,10,20,-10,15
FC Goa,3473,8,3,4,7,13,20,-7,13
Delhi Dynamo,3474,1,6,6,2,24,15,9,24
Mumbai City,3474,2,6,4,4,17,10,7,22
Kolkata,3474,3,5,7,2,17,12,5,22
Kerala Blast,3474,4,6,3,5,14,18,-4,21
NorthEast Un,3474,5,5,3,6,13,12,1,18
FC Pune City,3474,6,4,3,7,12,17,-5,15
Chennaiyin,3474,7,3,6,5,14,20,-6,15
FC Goa,3474,8,3,4,7,9,16,-7,13
Mumbai City,3475,1,6,5,3,18,10,8,23
Delhi Dynamo,3475,2,5,6,3,27,19,8,21
Kolkata,3475,3,5,6,3,17,15,2,21
NorthEast Un,3475,4,5,4,5,14,12,2,19
Kerala Blast,3475,5,5,4,5,13,18,-5,19
FC Pune City,3475,6,5,3,6,14,15,-1,18
Chennaiyin,3475,7,4,6,4,15,18,-3,18
FC Goa,3475,8,3,2,9,10,21,-11,11
Mumbai City,3476,1,6,5,3,17,9,8,23
Delhi Dynamo,3476,2,5,6,3,24,19,5,21
Kerala Blast,3476,3,6,3,5,13,16,-3,21
FC Pune City,3476,4,5,3,6,18,17,1,18
Kolkata,3476,5,4,6,4,15,18,-3,18
NorthEast Un,3476,6,5,2,7,12,14,-2,17
Chennaiyin,3476,7,4,5,5,15,18,-3,17
FC Goa,3476,8,5,2,7,12,15,-3,17
Delhi Dynamo,3477,1,7,5,2,27,16,11,26
Mumbai City,3477,2,6,4,4,17,11,6,22
Kerala Blast,3477,3,5,5,4,14,15,-1,20
Kolkata,3477,4,4,6,4,15,17,-2,18
Chennaiyin,3477,5,4,5,5,15,19,-4,17
FC Goa,3477,6,5,2,7,12,17,-5,17
FC Pune City,3477,7,4,4,6,13,16,-3,16
NorthEast Un,3477,8,4,3,7,11,13,-2,15
Mumbai City,3478,1,6,4,4,16,9,7,22
Delhi Dynamo,3478,2,5,5,4,22,16,6,20
Kolkata,3478,3,4,7,3,17,15,2,19
FC Pune City,3478,4,5,4,5,17,17,0,19
Chennaiyin,3478,5,4,6,4,14,17,-3,18
FC Goa,3478,6,5,3,6,11,14,-3,18
Kerala Blast,3478,7,5,3,6,14,22,-8,18
NorthEast Un,3478,8,5,2,7,12,13,-1,17
Mumbai City,3479,1,6,5,3,17,9,8,23
Kolkata,3479,2,5,6,3,16,14,2,21
Delhi Dynamo,3479,3,4,7,3,23,17,6,19
FC Pune City,3479,4,5,4,5,14,15,-1,19
Chennaiyin,3479,5,4,5,5,16,20,-4,17
FC Goa,3479,6,5,2,7,12,17,-5,17
Kerala Blast,3479,7,4,5,5,10,15,-5,17
NorthEast Un,3479,8,4,4,6,11,12,-1,16
Mumbai City,3480,1,6,5,3,16,8,8,23
FC Pune City,3480,2,6,3,5,20,15,5,21
Chennaiyin,3480,3,5,5,4,16,17,-1,20
Delhi Dynamo,3480,4,4,7,3,23,17,6,19
Kolkata,3480,5,4,7,3,19,16,3,19
NorthEast Un,3480,6,4,4,6,10,11,-1,16
Kerala Blast,3480,7,4,4,6,10,23,-13,16
FC Goa,3480,8,4,3,7,12,19,-7,15
Mumbai City,3481,1,7,4,3,19,8,11,25
Delhi Dynamo,3481,2,6,5,3,26,18,8,23
Kolkata,3481,3,4,7,3,17,16,1,19
Kerala Blast,3481,4,5,4,5,11,15,-4,19
NorthEast Un,3481,5,5,3,6,11,12,-1,18
FC Pune City,3481,6,5,3,6,15,17,-2,18
Chennaiyin,3481,7,3,6,5,14,20,-6,15
FC Goa,3481,8,4,2,8,11,18,-7,14
Delhi Dynamo,3482,1,6,6,2,26,16,10,24
Mumbai City,3482,2,6,5,3,16,8,8,23
Kolkata,3482,3,4,7,3,15,14,1,19
FC Pune City,3482,4,5,4,5,15,15,0,19
NorthEast Un,3482,5,5,3,6,13,13,0,18
Chennaiyin,3482,6,3,7,4,13,17,-4,16
FC Goa,3482,7,4,3,7,11,17,-6,15
Kerala Blast,3482,8,4,3,7,11,20,-9,15
Mumbai City,3483,1,7,4,3,17,8,9,25
Kolkata,3483,2,6,6,2,23,13,10,24
Delhi Dynamo,3483,3,4,6,4,21,18,3,18
NorthEast Un,3483,4,5,3,6,11,11,0,18
FC Pune City,3483,5,5,3,6,13,17,-4,18
Kerala Blast,3483,6,5,3,6,11,18,-7,18
Chennaiyin,3483,7,3,6,5,14,19,-5,15
FC Goa,3483,8,4,3,7,13,19,-6,15
Mumbai City,3484,1,7,4,3,20,11,9,25
Kolkata,3484,2,5,7,2,18,13,5,22
Delhi Dynamo,3484,3,4,6,4,25,21,4,18
NorthEast Un,3484,4,5,3,6,14,14,0,18
Chennaiyin,3484,5,4,6,4,16,19,-3,18
Kerala Blast,3484,6,5,3,6,13,18,-5,18
FC Pune City,3484,7,4,4,6,12,17,-5,16
FC Goa,3484,8,4,3,7,11,16,-5,15
Mumbai City,3485,1,6,4,4,16,9,7,22
Delhi Dynamo,3485,2,5,6,3,23,16,7,21
Kolkata,3485,3,4,8,2,17,15,2,20
Kerala Blast,3485,4,5,5,4,14,16,-2,20
NorthEast Un,3485,5,5,4,5,13,12,1,19
FC Goa,3485,6,4,4,6,14,17,-3,16
FC Pune City,3485,7,4,3,7,13,18,-5,15
Chennaiyin,3485,8,3,6,5,15,22,-7,15
Delhi Dynamo,3486,1,6,5,3,27,15,12,23
Mumbai City,3486,2,6,4,4,16,11,5,22
Kolkata,3486,3,4,8,2,18,15,3,20
NorthEast Un,3486,4,5,4,5,11,10,1,19
FC Pune City,3486,5,5,4,5,15,16,-1,19
Chennaiyin,3486,6,3,7,4,15,19,-4,16
Kerala Blast,3486,7,4,4,6,9,16,-7,16
FC Goa,3486,8,3,4,7,10,19,-9,13
Delhi Dynamo,3487,1,6,6,2,30,17,13,24
Mumbai City,3487,2,6,4,4,16,10,6,22
Kerala Blast,3487,3,6,4,4,13,15,-2,22
Kolkata,3487,4,4,7,3,19,17,2,19
NorthEast Un,3487,5,5,3,6,12,12,0,18
Chennaiyin,3487,6,3,6,5,14,19,-5,15
FC Pune City,3487,7,4,3,7,13,18,-5,15
FC Goa,3487,8,4,3,7,12,21,-9,15
Mumbai City,3488,1,7,4,3,17,8,9,25
Kerala Blast,3488,2,5,5,4,12,15,-3,20
NorthEast Un,3488,3,5,4,5,12,10,2,19
Kolkata,3488,4,4,6,4,15,16,-1,18
FC Goa,3488,5,5,3,6,12,15,-3,18
Delhi Dynamo,3488,6,4,5,5,22,19,3,17
FC Pune City,3488,7,4,4,6,14,17,-3,16
Chennaiyin,3488,8,3,7,4,13,17,-4,16
Delhi Dynamo,3489,1,6,6,2,24,14,10,24
Kolkata,3489,2,6,6,2,17,12,5,24
Mumbai City,3489,3,6,4,4,16,10,6,22
NorthEast Un,3489,4,6,2,6,15,13,2,20
FC Pune City,3489,5,4,4,6,13,17,-4,16
Kerala Blast,3489,6,4,4,6,11,17,-6,16
Chennaiyin,3489,7,3,6,5,17,23,-6,15
FC Goa,3489,8,3,4,7,10,17,-7,13
Delhi Dynamo,3490,1,5,7,2,24,16,8,22
Mumbai City,3490,2,6,4,4,16,9,7,22
Kolkata,3490,3,4,7,3,16,19,-3,19
FC Goa,3490,4,5,3,6,21,16,5,18
NorthEast Un,3490,5,5,3,6,12,12,0,18
FC Pune City,3490,6,4,5,5,14,16,-2,17
Chennaiyin,3490,7,4,5,5,15,22,-7,17
Kerala Blast,3490,8,4,4,6,12,20,-8,16
Delhi Dynamo,3491,1,6,6,2,27,17,10,24
Mumbai City,3491,2,6,5,3,18,10,8,23
Kerala Blast,3491,3,6,3,5,13,15,-2,21
Kolkata,3491,4,4,6,4,15,16,-1,18
FC Pune City,3491,5,5,3,6,14,16,-2,18
Chennaiyin,3491,6,4,5,5,14,18,-4,17
FC Goa,3491,7,5,2,7,10,16,-6,17
NorthEast Un,3491,8,4,2,8,10,13,-3,14
Delhi Dynamo,3492,1,7,5,2,29,19,10,26
Mumbai City,3492,2,6,4,4,17,10,7,22
Kerala Blast,3492,3,6,3,5,14,16,-2,21
Kolkata,3492,4,4,8,2,16,14,2,20
Chennaiyin,3492,5,3,7,4,15,19,-4,16
FC Pune City,3492,6,4,4,6,13,17,-4,16
NorthEast Un,3492,7,4,3,7,13,15,-2,15
FC Goa,3492,8,3,4,7,13,20,-7,13
NorthEast Un,3493,1,7,2,5,20,10,10,23
Delhi Dynamo,3493,2,6,5,3,27,20,7,23
Mumbai City,3493,3,6,4,4,17,10,7,22
Kolkata,3493,4,5,6,3,19,15,4,21
FC Pune City,3493,5,4,4,6,15,21,-6,16
Kerala Blast,3493,6,4,4,6,12,19,-7,16
FC Goa,3493,7,4,3,7,12,19,-7,15
Chennaiyin,3493,8,3,6,5,14,22,-8,15
Mumbai City,3494,1,7,4,3,17,8,9,25
Delhi Dynamo,3494,2,5,6,3,23,16,7,21
FC Pune City,3494,3,6,3,5,15,14,1,21
Kerala Blast,3494,4,6,3,5,16,18,-2,21
Chennaiyin,3494,5,5,5,4,17,17,0,20
Kolkata,3494,6,3,7,4,15,17,-2,16
NorthEast Un,3494,7,4,2,8,12,16,-4,14
FC Goa,3494,8,3,4,7,11,20,-9,13
Mumbai City,3495,1,7,4,3,20,9,11,25
Kolkata,3495,2,5,7,2,18,13,5,22
Delhi Dynamo,3495,3,5,6,3,25,19,6,21
Chennaiyin,3495,4,5,5,4,15,17,-2,20
Kerala Blast,3495,5,5,4,5,12,16,-4,19
NorthEast Un,3495,6,5,2,7,11,13,-2,17
FC Pune City,3495,7,4,3,7,12,16,-4,15
FC Goa,3495,8,3,3,8,9,19,-10,12
Delhi Dynamo,3496,1,6,5,3,23,18,5,23
Mumbai City,3496,2,6,4,4,16,9,7,22
FC Pune City,3496,3,6,3,5,15,15,0,21
NorthEast Un,3496,4,6,2,6,16,18,-2,20
Kerala Blast,3496,5,5,3,6,14,19,-5,18
Chennaiyin,3496,6,4,5,5,21,20,1,17
Kolkata,3496,7,3,7,4,15,16,-1,16
FC Goa,3496,8,4,3,7,10,15,-5,15
Mumbai City,3497,1,7,4,3,18,9,9,25
Kerala Blast,3497,2,7,3,4,15,13,2,24
Delhi Dynamo,3497,3,5,5,4,25,19,6,20
Kolkata,3497,4,4,7,3,15,15,0,19
FC Goa,3497,5,5,3,6,13,16,-3,18
NorthEast Un,3497,6,4,3,7,10,13,-3,15
FC Pune City,3497,7,4,3,7,12,17,-5,15
Chennaiyin,3497,8,3,6,5,13,19,-6,15
Mumbai City,3498,1,7,4,3,17,8,9,25
FC Pune City,3498,2,6,3,5,15,15,0,21
Delhi Dynamo,3498,3,4,7,3,21,15,6,19
Kolkata,3498,4,4,7,3,17,15,2,19
NorthEast Un,3498,5,5,3,6,12,15,-3,18
Chennaiyin,3498,6,4,5,5,18,19,-1,17
Kerala Blast,3498,7,4,4,6,13,19,-6,16
FC Goa,3498,8,4,3,7,11,18,-7,15
Mumbai City,3499,1,7,4,3,20,10,10,25
Delhi Dynamo,3499,2,6,5,3,30,21,9,23
Kolkata,3499,3,4,7,3,17,16,1,19
FC Pune City,3499,4,5,4,5,16,17,-1,19
Kerala Blast,3499,5,5,4,5,14,18,-4,19
NorthEast Un,3499,6,5,2,7,14,16,-2,17
FC Goa,3499,7,4,3,7,13,17,-4,15
Chennaiyin,3499,8,3,5,6,13,22,-9,14
Mumbai City,3500,1,7,4,3,17,8,9,25
Delhi Dynamo,3500,2,5,6,3,24,16,8,21
FC Pune City,3500,3,6,3,5,18,18,0,21
Kolkata,3500,4,4,7,3,18,16,2,19
Chennaiyin,3500,5,4,6,4,18,19,-1,18
Kerala Blast,3500,6,4,5,5,12,17,-5,17
NorthEast Un,3500,7,4,4,6,10,13,-3,16
FC Goa,3500,8,3,3,8,10,20,-10,12
Mumbai City,3501,1,7,4,3,18,9,9,25
Kolkata,3501,2,5,7,2,23,15,8,22
Delhi Dynamo,3501,3,4,7,3,26,20,6,19
Kerala Blast,3501,4,4,6,4,13,17,-4,18
NorthEast Un,3501,5,4,5,5,14,14,0,17
Chennaiyin,3501,6,3,7,4,15,19,-4,16
FC Pune City,3501,7,4,4,6,13,20,-7,16
FC Goa,3501,8,3,4,7,11,19,-8,13
Mumbai City,3502,1,7,4,3,17,8,9,25
Delhi Dynamo,3502,2,4,7,3,22,16,6,19
NorthEast Un,3502,3,5,4,5,13,12,1,19
FC Pune City,3502,4,5,4,5,13,14,-1,19
Kolkata,3502,5,4,6,4,18,15,3,18
Chennaiyin,3502,6,4,5,5,15,19,-4,17
Kerala Blast,3502,7,4,5,5,10,18,-8,17
FC Goa,3502,8,4,3,7,10,16,-6,15
Delhi Dynamo,3503,1,6,6,2,26,15,11,24
Mumbai City,3503,2,6,5,3,17,9,8,23
Kolkata,3503,3,5,7,2,23,17,6,22
Kerala Blast,3503,4,5,4,5,14,21,-7,19
Chennaiyin,3503,5,4,6,4,15,18,-3,18
NorthEast Un,3503,6,4,4,6,11,12,-1,16
FC Pune City,3503,7,4,4,6,16,19,-3,16
FC Goa,3503,8,3,2,9,10,21,-11,11
Mumbai City,3504,1,6,5,3,16,8,8,23
NorthEast Un,3504,2,5,4,5,15,11,4,19
Delhi Dynamo,3504,3,4,7,3,21,18,3,19
Kolkata,3504,4,4,7,3,19,17,2,19
Kerala Blast,3504,5,4,6,4,14,18,-4,18
Chennaiyin,3504,6,3,7,4,16,20,-4,16
FC Goa,3504,7,4,4,6,13,17,-4,16
FC Pune City,3504,8,4,4,6,14,19,-5,16
Mumbai City,3505,1,7,4,3,19,10,9,25
Delhi Dynamo,3505,2,6,5,3,27,17,10,23
NorthEast Un,3505,3,6,2,6,13,10,3,20
Kolkata,3505,4,4,7,3,14,13,1,19
FC Pune City,3505,5,5,4,5,14,14,0,19
Kerala Blast,3505,6,5,3,6,10,16,-6,18
Chennaiyin,3505,7,4,5,5,16,20,-4,17
FC Goa,3505,8,3,2,9,8,21,-13,11
Mumbai City,3506,1,6,5,3,18,10,8,23
Delhi Dynamo,3506,2,5,6,3,25,18,7,21
NorthEast Un,3506,3,6,3,5,14,11,3,21
FC Pune City,3506,4,5,4,5,16,16,0,19
Kerala Blast,3506,5,4,6,4,12,16,-4,18
Kolkata,3506,6,3,8,3,16,17,-1,17
FC Goa,3506,7,4,3,7,12,17,-5,15
Chennaiyin,3506,8,3,5,6,14,22,-8,14
Mumbai City,3507,1,7,4,3,17,8,9,25
Kolkata,3507,2,5,7,2,20,13,7,22
Delhi Dynamo,3507,3,5,5,4,24,18,6,20
NorthEast Un,3507,4,6,2,6,12,10,2,20
Chennaiyin,3507,5,4,6,4,15,18,-3,18
FC Pune City,3507,6,5,3,6,14,19,-5,18
Kerala Blast,3507,7,4,3,7,10,19,-9,15
FC Goa,3507,8,3,4,7,12,19,-7,13
Mumbai City,3508,1,7,4,3,19,9,10,25
NorthEast Un,3508,2,6,3,5,14,11,3,21
Delhi Dynamo,3508,3,5,5,4,23,19,4,20
Kolkata,3508,4,4,7,3,16,15,1,19
Kerala Blast,3508,5,5,4,5,14,15,-1,19
Chennaiyin,3508,6,4,6,4,17,20,-3,18
FC Pune City,3508,7,5,3,6,14,18,-4,18
FC Goa,3508,8,3,2,9,9,19,-10,11
Mumbai City,3509,1,6,5,3,16,8,8,23
Delhi Dynamo,3509,2,5,7,2,24,15,9,22
Kolkata,3509,3,5,7,2,18,14,4,22
Kerala Blast,3509,4,6,3,5,14,16,-2,21
Chennaiyin,3509,5,5,5,4,17,18,-1,20
NorthEast Un,3509,6,4,3,7,11,13,-2,15
FC Pune City,3509,7,4,3,7,13,19,-6,15
FC Goa,3509,8,3,3,8,10,20,-10,12
Mumbai City,3510,1,6,5,3,17,9,8,23
Delhi Dynamo,3510,2,5,7,2,24,16,8,22
Kolkata,3510,3,4,8,2,16,13,3,20
NorthEast Un,3510,4,5,4,5,11,10,1,19
Kerala Blast,3510,5,5,4,5,10,14,-4,19
Chennaiyin,3510,6,4,6,4,16,18,-2,18
FC Pune City,3510,7,4,3,7,13,18,-5,15
FC Goa,3510,8,3,3,8,9,18,-9,12
Mumbai City,3511,1,7,4,3,19,8,11,25
Kolkata,3511,2,5,7,2,15,12,3,22
Delhi Dynamo,3511,3,5,5,4,24,21,3,20
FC Goa,3511,4,5,3,6,14,15,-1,18
Chennaiyin,3511,5,4,5,5,14,19,-5,17
Kerala Blast,3511,6,4,5,5,10,15,-5,17
FC Pune City,3511,7,4,4,6,12,15,-3,16
NorthEast Un,3511,8,4,3,7,10,13,-3,15
Mumbai City,3512,1,7,4,3,18,8,10,25
Delhi Dynamo,3512,2,5,5,4,23,19,4,20
Kolkata,3512,3,4,7,3,16,16,0,19
Kerala Blast,3512,4,5,4,5,11,15,-4,19
NorthEast Un,3512,5,5,3,6,11,11,0,18
FC Pune City,3512,6,5,3,6,16,17,-1,18
Chennaiyin,3512,7,4,5,5,15,18,-3,17
FC Goa,3512,8,4,3,7,11,17,-6,15
Delhi Dynamo,3513,1,6,6,2,28,15,13,24
Mumbai City,3513,2,6,5,3,17,9,8,23
Kerala Blast,3513,3,6,3,5,13,14,-1,21
FC Pune City,3513,4,5,4,5,14,15,-1,19
Chennaiyin,3513,5,4,6,4,15,18,-3,18
Kolkata,3513,6,3,7,4,15,19,-4,16
NorthEast Un,3513,7,4,3,7,10,12,-2,15
FC Goa,3513,8,4,2,8,11,21,-10,14
Mumbai City,3514,1,7,4,3,19,9,10,25
Kolkata,3514,2,6,6,2,19,15,4,24
Delhi Dynamo,3514,3,4,7,3,24,19,5,19
Kerala Blast,3514,4,5,4,5,11,14,-3,19
NorthEast Un,3514,5,4,5,5,15,15,0,17
FC Pune City,3514,6,4,3,7,14,19,-5,15
FC Goa,3514,7,4,3,7,11,16,-5,15
Chennaiyin,3514,8,3,6,5,17,23,-6,15
Mumbai City,3515,1,6,5,3,17,9,8,23
Delhi Dynamo,3515,2,5,6,3,24,17,7,21
FC Pune City,3515,3,5,4,5,15,16,-1,19
Kerala Blast,3515,4,5,4,5,11,14,-3,19
Kolkata,3515,5,4,6,4,17,17,0,18
Chennaiyin,3515,6,4,6,4,17,19,-2,18
NorthEast Un,3515,7,5,2,7,10,13,-3,17
FC Goa,3515,8,4,3,7,13,19,-6,15
Mumbai City,3516,1,7,4,3,19,8,11,25
Kerala Blast,3516,2,7,3,4,13,14,-1,24
Delhi Dynamo,3516,3,4,7,3,21,17,4,19
Kolkata,3516,4,4,6,4,16,18,-2,18
FC Goa,3516,5,5,3,6,14,16,-2,18
Chennaiyin,3516,6,4,5,5,16,19,-3,17
NorthEast Un,3516,7,4,3,7,10,13,-3,15
FC Pune City,3516,8,4,3,7,13,17,-4,15
Delhi Dynamo,3517,1,7,5,2,28,14,14,26
Mumbai City,3517,2,6,4,4,16,10,6,22
Kolkata,3517,3,5,6,3,15,13,2,21
NorthEast Un,3517,4,5,3,6,12,12,0,18
Chennaiyin,3517,5,4,6,4,17,19,-2,18
FC Pune City,3517,6,5,3,6,13,15,-2,18
Kerala Blast,3517,7,5,3,6,10,16,-6,18
FC Goa,3517,8,3,2,9,9,21,-12,11
Mumbai City,3518,1,7,4,3,18,8,10,25
Delhi Dynamo,3518,2,5,6,3,23,17,6,21
Kerala Blast,3518,3,5,5,4,12,14,-2,20
Kolkata,3518,4,4,7,3,17,15,2,19
NorthEast Un,3518,5,5,3,6,14,11,3,18
FC Goa,3518,6,4,4,6,10,15,-5,16
FC Pune City,3518,7,4,3,7,15,21,-6,15
Chennaiyin,3518,8,3,6,5,14,22,-8,15
Mumbai City,3519,1,7,4,3,17,8,9,25
Kerala Blast,3519,2,7,3,4,16,16,0,24
Kolkata,3519,3,5,6,3,17,16,1,21
Delhi Dynamo,3519,4,4,6,4,24,19,5,18
NorthEast Un,3519,5,5,3,6,12,12,0,18
FC Goa,3519,6,5,2,7,13,18,-5,17
FC Pune City,3519,7,4,3,7,13,17,-4,15
Chennaiyin,3519,8,3,5,6,15,21,-6,14
Delhi Dynamo,3520,1,6,5,3,25,17,8,23
Mumbai City,3520,2,6,4,4,16,9,7,22
Kolkata,3520,3,5,7,2,17,13,4,22
Chennaiyin,3520,4,4,6,4,16,18,-2,18
NorthEast Un,3520,5,5,2,7,10,12,-2,17
Kerala Blast,3520,6,4,5,5,9,14,-5,17
FC Pune City,3520,7,4,4,6,12,16,-4,16
FC Goa,3520,8,4,3,7,13,19,-6,15
Kolkata,3521,1,6,6,2,20,12,8,24
Mumbai City,3521,2,6,5,3,17,9,8,23
NorthEast Un,3521,3,6,3,5,18,12,6,21
Delhi Dynamo,3521,4,5,6,3,25,20,5,21
Kerala Blast,3521,5,5,3,6,11,19,-8,18
Chennaiyin,3521,6,3,6,5,15,20,-5,15
FC Pune City,3521,7,4,3,7,13,19,-6,15
FC Goa,3521,8,4,2,8,10,18,-8,14
Delhi Dynamo,3522,1,7,5,2,28,14,14,26
Kolkata,3522,2,6,6,2,18,14,4,24
Mumbai City,3522,3,6,4,4,16,10,6,22
NorthEast Un,3522,4,5,3,6,11,12,-1,18
FC Pune City,3522,5,4,4,6,12,15,-3,16
Chennaiyin,3522,6,3,7,4,16,20,-4,16
Kerala Blast,3522,7,4,4,6,11,17,-6,16
FC Goa,3522,8,3,3,8,12,22,-10,12
Mumbai City,3523,1,7,4,3,20,9,11,25
Delhi Dynamo,3523,2,6,5,3,27,18,9,23
Kolkata,3523,3,4,7,3,19,17,2,19
FC Pune City,3523,4,5,4,5,14,15,-1,19
Chennaiyin,3523,5,4,6,4,15,18,-3,18
NorthEast Un,3523,6,5,2,7,10,13,-3,17
Kerala Blast,3523,7,4,4,6,10,17,-7,16
FC Goa,3523,8,3,4,7,11,19,-8,13
Mumbai City,3524,1,7,4,3,18,8,10,25
Chennaiyin,3524,2,5,5,4,16,18,-2,20
FC Pune City,3524,3,5,4,5,15,16,-1,19
Delhi Dynamo,3524,4,4,6,4,25,23,2,18
NorthEast Un,3524,5,5,3,6,15,13,2,18
Kolkata,3524,6,4,6,4,14,15,-1,18
FC Goa,3524,7,5,2,7,15,17,-2,17
Kerala Blast,3524,8,4,4,6,11,19,-8,16
Mumbai City,3525,1,7,4,3,19,9,10,25
Kolkata,3525,2,6,6,2,20,15,5,24
Delhi Dynamo,3525,3,6,5,3,30,17,13,23
Kerala Blast,3525,4,5,4,5,12,15,-3,19
NorthEast Un,3525,5,5,3,6,12,12,0,18
FC Pune City,3525,6,4,3,7,14,19,-5,15
Chennaiyin,3525,7,3,5,6,14,21,-7,14
FC Goa,3525,8,4,2,8,11,24,-13,14
Mumbai City,3526,1,7,4,3,17,8,9,25
NorthEast Un,3526,2,7,2,5,16,11,5,23
Kolkata,3526,3,5,6,3,17,15,2,21
Delhi Dynamo,3526,4,5,5,4,26,20,6,20
FC Pune City,3526,5,5,4,5,15,15,0,19
Chennaiyin,3526,6,4,5,5,17,20,-3,17
Kerala Blast,3526,7,4,4,6,10,16,-6,16
FC Goa,3526,8,3,2,9,11,24,-13,11
Mumbai City,3527,1,7,4,3,18,8,10,25
Kolkata,3527,2,5,7,2,17,13,4,22
NorthEast Un,3527,3,6,2,6,16,11,5,20
FC Pune City,3527,4,5,3,6,14,15,-1,18
FC Goa,3527,5,5,3,6,13,16,-3,18
Kerala Blast,3527,6,5,3,6,11,18,-7,18
Delhi Dynamo,3527,7,4,5,5,22,21,1,17
Chennaiyin,3527,8,3,5,6,13,22,-9,14
Mumbai City,3528,1,6,5,3,17,9,8,23
Delhi Dynamo,3528,2,5,7,2,26,18,8,22
Kolkata,3528,3,5,7,2,17,14,3,22
Kerala Blast,3528,4,6,3,5,13,16,-3,21
NorthEast Un,3528,5,4,4,6,11,12,-1,16
FC Pune City,3528,6,4,3,7,13,17,-4,15
Chennaiyin,3528,7,3,6,5,14,19,-5,15
FC Goa,3528,8,4,3,7,12,18,-6,15
Delhi Dynamo,3529,1,6,6,2,27,16,11,24
Mumbai City,3529,2,6,4,4,17,11,6,22
Kolkata,3529,3,5,7,2,18,13,5,22
Kerala Blast,3529,4,5,4,5,10,16,-6,19
FC Pune City,3529,5,5,3,6,15,16,-1,18
Chennaiyin,3529,6,4,5,5,15,20,-5,17
NorthEast Un,3529,7,4,3,7,11,13,-2,15
FC Goa,3529,8,4,2,8,11,19,-8,14
Mumbai City,3530,1,7,4,3,20,8,12,25
Kerala Blast,3530,2,6,3,5,14,17,-3,21
Delhi Dynamo,3530,3,5,5,4,25,21,4,20
NorthEast Un,3530,4,6,2,6,15,13,2,20
Kolkata,3530,5,4,7,3,18,17,1,19
FC Pune City,3530,6,5,3,6,15,17,-2,18
Chennaiyin,3530,7,3,6,5,15,21,-6,15
FC Goa,3530,8,3,4,7,10,18,-8,13
Delhi Dynamo,3531,1,6,5,3,25,17,8,23
Mumbai City,3531,2,6,4,4,17,10,7,22
Kerala Blast,3531,3,6,4,4,13,15,-2,22
FC Pune City,3531,4,5,4,5,16,17,-1,19
Kolkata,3531,5,4,6,4,17,16,1,18
Chennaiyin,3531,6,4,6,4,15,18,-3,18
FC Goa,3531,7,4,3,7,11,18,-7,15
NorthEast Un,3531,8,4,2,8,10,13,-3,14
Mumbai City,3532,1,7,4,3,18,9,9,25
FC Pune City,3532,2,6,3,5,19,17,2,21
Kolkata,3532,3,4,7,3,17,16,1,19
Delhi Dynamo,3532,4,4,6,4,23,19,4,18
NorthEast Un,3532,5,5,3,6,13,12,1,18
Kerala Blast,3532,6,5,3,6,15,22,-7,18
Chennaiyin,3532,7,3,7,4,14,18,-4,16
FC Goa,3532,8,3,5,6,11,17,-6,14
Mumbai City,3533,1,7,4,3,20,8,12,25
Kolkata,3533,2,5,7,2,18,13,5,22
Delhi Dynamo,3533,3,5,5,4,23,20,3,20
Chennaiyin,3533,4,5,5,4,18,18,0,20
Kerala Blast,3533,5,5,4,5,13,19,-6,19
NorthEast Un,3533,6,5,3,6,13,13,0,18
FC Pune City,3533,7,4,4,6,14,17,-3,16
FC Goa,3533,8,3,2,9,9,20,-11,11
Delhi Dynamo,3534,1,6,6,2,27,18,9,24
Mumbai City,3534,2,6,4,4,16,9,7,22
Kerala Blast,3534,3,6,4,4,15,14,1,22
Kolkata,3534,4,5,6,3,17,16,1,21
NorthEast Un,3534,5,5,4,5,16,13,3,19
Chennaiyin,3534,6,4,5,5,18,23,-5,17
FC Pune City,3534,7,4,3,7,12,18,-6,15
FC Goa,3534,8,3,2,9,11,21,-10,11
Mumbai City,3535,1,7,4,3,19,10,9,25
Delhi Dynamo,3535,2,5,6,3,27,20,7,21
Kolkata,3535,3,5,6,3,17,15,2,21
Kerala Blast,3535,4,6,3,5,18,17,1,21
Chennaiyin,3535,5,4,6,4,16,19,-3,18
FC Pune City,3535,6,4,3,7,13,18,-5,15
FC Goa,3535,7,4,3,7,12,17,-5,15
NorthEast Un,3535,8,4,3,7,14,20,-6,15
Delhi Dynamo,3536,1,7,5,2,27,15,12,26
Mumbai City,3536,2,6,4,4,16,9,7,22
Kerala Blast,3536,3,5,4,5,12,15,-3,19
Kolkata,3536,4,3,8,3,15,15,0,17
FC Goa,3536,5,5,2,7,13,16,-3,17
NorthEast Un,3536,6,5,2,7,12,15,-3,17
Chennaiyin,3536,7,4,5,5,16,22,-6,17
FC Pune City,3536,8,4,4,6,15,19,-4,16
Mumbai City,3537,1,7,4,3,17,8,9,25
Delhi Dynamo,3537,2,6,5,3,24,16,8,23
Chennaiyin,3537,3,5,5,4,17,19,-2,20
Kerala Blast,3537,4,5,5,4,12,15,-3,20
Kolkata,3537,5,3,8,3,15,16,-1,17
FC Pune City,3537,6,4,5,5,14,16,-2,17
NorthEast Un,3537,7,4,2,8,11,14,-3,14
FC Goa,3537,8,4,2,8,13,19,-6,14
Mumbai City,3538,1,7,4,3,18,8,10,25
Kolkata,3538,2,5,7,2,17,13,4,22
Delhi Dynamo,3538,3,5,5,4,24,21,3,20
Kerala Blast,3538,4,5,4,5,12,17,-5,19
NorthEast Un,3538,5,5,2,7,14,13,1,17
FC Pune City,3538,6,4,5,5,13,15,-2,17
Chennaiyin,3538,7,4,5,5,15,22,-7,17
FC Goa,3538,8,4,2,8,15,19,-4,14
Mumbai City,3539,1,7,4,3,17,8,9,25
Delhi Dynamo,3539,2,5,6,3,25,17,8,21
FC Pune City,3539,3,6,3,5,16,15,1,21
NorthEast Un,3539,4,5,3,6,12,12,0,18
Kolkata,3539,5,4,6,4,15,16,-1,18
Kerala Blast,3539,6,5,3,6,12,17,-5,18
Chennaiyin,3539,7,4,5,5,14,19,-5,17
FC Goa,3539,8,4,2,8,12,19,-7,14
Delhi Dynamo,3540,1,6,6,2,28,18,10,24
Mumbai City,3540,2,6,5,3,16,8,8,23
FC Pune City,3540,3,5,4,5,15,14,1,19
Kolkata,3540,4,4,6,4,16,19,-3,18
Kerala Blast,3540,5,4,5,5,11,16,-5,17
NorthEast Un,3540,6,4,4,6,13,14,-1,16
Chennaiyin,3540,7,3,7,4,16,20,-4,16
FC Goa,3540,8,4,3,7,13,19,-6,15
Delhi Dynamo,3541,1,6,6,2,25,15,10,24
Mumbai City,3541,2,6,4,4,17,10,7,22
Kolkata,3541,3,5,6,3,17,14,3,21
NorthEast Un,3541,4,6,3,5,13,11,2,21
FC Pune City,3541,5,5,3,6,14,15,-1,18
Chennaiyin,3541,6,4,5,5,19,22,-3,17
Kerala Blast,3541,7,4,3,7,9,18,-9,15
FC Goa,3541,8,4,2,8,12,21,-9,14
Delhi Dynamo,3542,1,6,6,2,26,15,11,24
Mumbai City,3542,2,6,4,4,16,11,5,22
FC Pune City,3542,3,5,4,5,16,16,0,19
Chennaiyin,3542,4,4,6,4,17,18,-1,18
Kolkata,3542,5,3,8,3,14,17,-3,17
NorthEast Un,3542,6,5,2,7,11,14,-3,17
FC Goa,3542,7,4,4,6,13,15,-2,16
Kerala Blast,3542,8,4,4,6,10,17,-7,16
Mumbai City,3543,1,6,5,3,16,8,8,23
Delhi Dynamo,3543,2,4,7,3,24,18,6,19
Kolkata,3543,3,4,7,3,15,13,2,19
NorthEast Un,3543,4,5,3,6,12,12,0,18
Chennaiyin,3543,5,4,6,4,14,17,-3,18
Kerala Blast,3543,6,4,6,4,11,15,-4,18
FC Pune City,3543,7,4,4,6,14,18,-4,16
FC Goa,3543,8,4,4,6,10,15,-5,16
Mumbai City,3544,1,6,4,4,16,10,6,22
Delhi Dynamo,3544,2,5,5,4,24,17,7,20
NorthEast Un,3544,3,5,4,5,12,11,1,19
Kerala Blast,3544,4,5,4,5,11,15,-4,19
Kolkata,3544,5,4,6,4,17,16,1,18
Chennaiyin,3544,6,4,6,4,15,17,-2,18
FC Pune City,3544,7,5,3,6,13,16,-3,18
FC Goa,3544,8,5,2,7,12,18,-6,17
Mumbai City,3545,1,7,4,3,18,9,9,25
Kolkata,3545,2,6,6,2,22,13,9,24
Delhi Dynamo,3545,3,6,5,3,25,16,9,23
Kerala Blast,3545,4,6,3,5,15,16,-1,21
Chennaiyin,3545,5,4,6,4,17,19,-2,18
FC Pune City,3545,6,4,3,7,12,22,-10,15
NorthEast Un,3545,7,4,2,8,10,14,-4,14
FC Goa,3545,8,3,3,8,9,19,-10,12
Mumbai City,3546,1,7,4,3,18,8,10,25
NorthEast Un,3546,2,6,3,5,14,12,2,21
Kerala Blast,3546,3,6,3,5,13,16,-3,21
Delhi Dynamo,3546,4,5,5,4,23,18,5,20
Kolkata,3546,5,4,6,4,15,15,0,18
FC Pune City,3546,6,5,3,6,14,16,-2,18
Chennaiyin,3546,7,3,7,4,14,18,-4,16
FC Goa,3546,8,3,3,8,9,17,-8,12
Delhi Dynamo,3547,1,6,6,2,25,15,10,24
Mumbai City,3547,2,6,5,3,17,9,8,23
Kolkata,3547,3,5,6,3,18,15,3,21
FC Pune City,3547,4,5,3,6,14,17,-3,18
FC Goa,3547,5,5,2,7,14,17,-3,17
NorthEast Un,3547,6,4,4,6,10,11,-1,16
Kerala Blast,3547,7,4,4,6,10,17,-7,16
Chennaiyin,3547,8,3,6,5,14,21,-7,15
Kerala Blast,3548,1,7,3,4,13,14,-1,24
Mumbai City,3548,2,6,4,4,17,10,7,22
Delhi Dynamo,3548,3,5,6,3,25,18,7,21
Kolkata,3548,4,5,6,3,17,14,3,21
NorthEast Un,3548,5,5,2,7,11,13,-2,17
Chennaiyin,3548,6,4,5,5,15,18,-3,17
FC Pune City,3548,7,4,3,7,12,16,-4,15
FC Goa,3548,8,4,3,7,10,17,-7,15
Kolkata,3549,1,6,6,2,20,13,7,24
Mumbai City,3549,2,6,5,3,17,9,8,23
NorthEast Un,3549,3,6,3,5,13,11,2,21
Delhi Dynamo,3549,4,4,6,4,23,19,4,18
Kerala Blast,3549,5,5,3,6,10,16,-6,18
FC Goa,3549,6,5,2,7,12,16,-4,17
FC Pune City,3549,7,4,3,7,13,18,-5,15
Chennaiyin,3549,8,3,6,5,14,20,-6,15
Delhi Dynamo,3550,1,5,7,2,25,17,8,22
Mumbai City,3550,2,6,4,4,16,9,7,22
Kerala Blast,3550,3,6,4,4,12,14,-2,22
Kolkata,3550,4,4,6,4,16,18,-2,18
FC Goa,3550,5,5,3,6,14,16,-2,18
Chennaiyin,3550,6,4,5,5,15,19,-4,17
NorthEast Un,3550,7,4,4,6,12,13,-1,16
FC Pune City,3550,8,4,3,7,14,18,-4,15
Delhi Dynamo,3551,1,5,7,2,27,18,9,22
Mumbai City,3551,2,6,4,4,17,11,6,22
Kolkata,3551,3,5,6,3,19,14,5,21
Kerala Blast,3551,4,5,4,5,12,16,-4,19
FC Goa,3551,5,5,3,6,13,17,-4,18
Chennaiyin,3551,6,4,5,5,14,18,-4,17
FC Pune City,3551,7,4,4,6,13,18,-5,16
NorthEast Un,3551,8,4,3,7,10,13,-3,15
Mumbai City,3552,1,7,4,3,21,9,12,25
Delhi Dynamo,3552,2,6,5,3,25,19,6,23
Kerala Blast,3552,3,5,5,4,12,15,-3,20
Chennaiyin,3552,4,4,6,4,18,18,0,18
Kolkata,3552,5,3,8,3,15,15,0,17
NorthEast Un,3552,6,4,4,6,11,12,-1,16
FC Pune City,3552,7,4,4,6,13,16,-3,16
FC Goa,3552,8,4,2,8,9,20,-11,14
Mumbai City,3553,1,7,4,3,18,8,10,25
Kerala Blast,3553,2,6,4,4,15,14,1,22
Delhi Dynamo,3553,3,4,6,4,21,19,2,18
Kolkata,3553,4,3,9,2,14,13,1,18
FC Goa,3553,5,5,3,6,12,14,-2,18
Chennaiyin,3553,6,4,5,5,17,18,-1,17
FC Pune City,3553,7,4,4,6,12,17,-5,16
NorthEast Un,3553,8,4,3,7,9,15,-6,15
Delhi Dynamo,3554,1,7,5,2,26,14,12,26
Mumbai City,3554,2,6,4,4,16,10,6,22
Kerala Blast,3554,3,6,3,5,14,19,-5,21
Kolkata,3554,4,4,6,4,18,16,2,18
FC Pune City,3554,5,5,3,6,15,17,-2,18
Chennaiyin,3554,6,4,6,4,16,19,-3,18
FC Goa,3554,7,4,3,7,10,16,-6,15
NorthEast Un,3554,8,4,2,8,11,15,-4,14
Mumbai City,3555,1,6,5,3,17,9,8,23
Delhi Dynamo,3555,2,5,7,2,24,16,8,22
Kolkata,3555,3,5,7,2,16,13,3,22
Kerala Blast,3555,4,6,3,5,14,15,-1,21
Chennaiyin,3555,5,5,5,4,16,18,-2,20
FC Pune City,3555,6,4,3,7,14,19,-5,15
NorthEast Un,3555,7,4,2,8,9,13,-4,14
FC Goa,3555,8,3,4,7,10,17,-7,13
Mumbai City,3556,1,6,5,3,17,9,8,23
Delhi Dynamo,3556,2,5,6,3,25,19,6,21
FC Pune City,3556,3,6,3,5,16,15,1,21
NorthEast Un,3556,4,5,3,6,12,12,0,18
Chennaiyin,3556,5,4,5,5,15,18,-3,17
FC Goa,3556,6,5,2,7,13,16,-3,17
Kerala Blast,3556,7,4,5,5,11,16,-5,17
Kolkata,3556,8,3,7,4,14,18,-4,16
Mumbai City,3557,1,7,4,3,17,8,9,25
Delhi Dynamo,3557,2,5,6,3,23,16,7,21
Kolkata,3557,3,4,6,4,18,18,0,18
NorthEast Un,3557,4,5,3,6,11,11,0,18
FC Pune City,3557,5,5,3,6,16,17,-1,18
Kerala Blast,3557,6,5,3,6,11,18,-7,18
Chennaiyin,3557,7,4,5,5,15,19,-4,17
FC Goa,3557,8,5,2,7,13,17,-4,17
Mumbai City,3558,1,6,5,3,16,8,8,23
Kolkata,3558,2,5,6,3,19,14,5,21
NorthEast Un,3558,3,6,2,6,13,12,1,20
Delhi Dynamo,3558,4,4,7,3,22,18,4,19
Chennaiyin,3558,5,4,6,4,17,18,-1,18
FC Pune City,3558,6,4,4,6,14,17,-3,16
FC Goa,3558,7,4,4,6,11,16,-5,16
Kerala Blast,3558,8,4,4,6,10,19,-9,16
Mumbai City,3559,1,7,4,3,19,9,10,25
Kerala Blast,3559,2,6,4,4,11,13,-2,22
Delhi Dynamo,3559,3,4,7,3,24,19,5,19
Kolkata,3559,4,4,6,4,16,16,0,18
FC Goa,3559,5,5,3,6,13,17,-4,18
NorthEast Un,3559,6,4,5,5,11,11,0,17
FC Pune City,3559,7,4,3,7,13,17,-4,15
Chennaiyin,3559,8,3,6,5,15,20,-5,15
Mumbai City,3560,1,7,4,3,17,8,9,25
Delhi Dynamo,3560,2,6,5,3,25,17,8,23
Kolkata,3560,3,4,8,2,20,15,5,20
FC Pune City,3560,4,5,4,5,15,16,-1,19
NorthEast Un,3560,5,5,3,6,12,11,1,18
Kerala Blast,3560,6,4,4,6,11,20,-9,16
Chennaiyin,3560,7,3,6,5,13,19,-6,15
FC Goa,3560,8,3,4,7,10,17,-7,13
Mumbai City,3561,1,7,4,3,19,9,10,25
FC Pune City,3561,2,6,3,5,15,14,1,21
Delhi Dynamo,3561,3,5,5,4,26,20,6,20
Chennaiyin,3561,4,5,5,4,17,19,-2,20
Kerala Blast,3561,5,5,4,5,13,17,-4,19
Kolkata,3561,6,4,6,4,15,15,0,18
NorthEast Un,3561,6,5,3,6,15,15,0,18
FC Goa,3561,8,3,2,9,10,21,-11,11
Mumbai City,3562,1,7,4,3,19,8,11,25
Delhi Dynamo,3562,2,6,5,3,26,18,8,23
Kerala Blast,3562,3,5,5,4,13,15,-2,20
Kolkata,3562,4,3,9,2,17,16,1,18
Chennaiyin,3562,5,4,5,5,15,19,-4,17
FC Pune City,3562,6,4,4,6,14,18,-4,16
NorthEast Un,3562,7,4,3,7,11,14,-3,15
FC Goa,3562,8,4,3,7,11,18,-7,15
Mumbai City,3563,1,7,4,3,17,8,9,25
FC Pune City,3563,2,6,3,5,16,14,2,21
NorthEast Un,3563,3,6,2,6,12,10,2,20
Chennaiyin,3563,4,5,5,4,17,17,0,20
Kerala Blast,3563,5,5,3,6,11,17,-6,18
Delhi Dynamo,3563,6,4,5,5,21,17,4,17
FC Goa,3563,7,5,2,7,14,20,-6,17
Kolkata,3563,8,3,6,5,17,22,-5,15
Delhi Dynamo,3564,1,6,6,2,26,15,11,24
Mumbai City,3564,2,6,5,3,16,8,8,23
Kolkata,3564,3,5,6,3,20,16,4,21
Kerala Blast,3564,4,6,3,5,15,17,-2,21
Chennaiyin,3564,5,4,5,5,16,19,-3,17
FC Goa,3564,6,5,2,7,12,18,-6,17
FC Pune City,3564,7,4,3,7,12,18,-6,15
NorthEast Un,3564,8,4,2,8,9,15,-6,14
Kolkata,3565,1,6,6,2,20,15,5,24
Mumbai City,3565,2,6,5,3,16,8,8,23
Delhi Dynamo,3565,3,5,7,2,23,15,8,22
NorthEast Un,3565,4,6,3,5,11,9,2,21
FC Pune City,3565,5,5,3,6,16,18,-2,18
Chennaiyin,3565,6,3,6,5,15,20,-5,15
Kerala Blast,3565,7,4,3,7,11,18,-7,15
FC Goa,3565,8,3,3,8,11,20,-9,12
Mumbai City,3566,1,7,4,3,22,9,13,25
NorthEast Un,3566,2,7,2,5,15,9,6,23
Kolkata,3566,3,4,7,3,16,14,2,19
FC Pune City,3566,4,5,3,6,14,16,-2,18
Kerala Blast,3566,5,5,3,6,12,19,-7,18
Delhi Dynamo,3566,6,4,5,5,23,25,-2,17
FC Goa,3566,7,4,4,6,12,17,-5,16
Chennaiyin,3566,8,3,6,5,15,20,-5,15
Mumbai City,3567,1,7,4,3,19,8,11,25
Delhi Dynamo,3567,2,6,5,3,26,17,9,23
Kerala Blast,3567,3,6,3,5,11,14,-3,21
Kolkata,3567,4,4,7,3,14,13,1,19
NorthEast Un,3567,5,5,2,7,10,12,-2,17
Chennaiyin,3567,6,4,5,5,15,19,-4,17
FC Pune City,3567,7,4,4,6,12,15,-3,16
FC Goa,3567,8,4,2,8,10,19,-9,14
Mumbai City,3568,1,7,4,3,19,8,11,25
Delhi Dynamo,3568,2,6,5,3,27,19,8,23
Kerala Blast,3568,3,5,5,4,13,16,-3,20
Kolkata,3568,4,3,8,3,15,15,0,17
FC Pune City,3568,5,4,5,5,14,16,-2,17
NorthEast Un,3568,6,4,4,6,12,15,-3,16
Chennaiyin,3568,7,3,7,4,16,20,-4,16
FC Goa,3568,8,3,4,7,11,18,-7,13
Mumbai City,3569,1,6,4,4,18,12,6,22
Delhi Dynamo,3569,2,5,6,3,25,17,8,21
NorthEast Un,3569,3,5,4,5,11,10,1,19
Chennaiyin,3569,4,4,6,4,15,18,-3,18
Kerala Blast,3569,5,4,6,4,12,16,-4,18
Kolkata,3569,6,3,8,3,17,17,0,17
FC Pune City,3569,7,4,5,5,14,16,-2,17
FC Goa,3569,8,4,3,7,12,18,-6,15
Mumbai City,3570,1,7,4,3,19,8,11,25
Delhi Dynamo,3570,2,5,6,3,26,19,7,21
Kolkata,3570,3,4,8,2,16,14,2,20
Chennaiyin,3570,4,5,5,4,17,19,-2,20
FC Pune City,3570,5,5,4,5,15,16,-1,19
NorthEast Un,3570,6,5,3,6,12,12,0,18
Kerala Blast,3570,7,4,3,7,10,17,-7,15
FC Goa,3570,8,3,3,8,11,21,-10,12
Mumbai City,3571,1,7,4,3,18,8,10,25
NorthEast Un,3571,2,6,3,5,13,9,4,21
Kerala Blast,3571,3,5,4,5,11,16,-5,19
Delhi Dynamo,3571,4,4,6,4,22,18,4,18
FC Goa,3571,5,5,3,6,14,17,-3,18
FC Pune City,3571,6,4,5,5,13,15,-2,17
Kolkata,3571,7,3,7,4,13,15,-2,16
Chennaiyin,3571,8,3,6,5,15,21,-6,15
Kerala Blast,3572,1,7,3,4,14,13,1,24
Delhi Dynamo,3572,2,6,5,3,28,22,6,23
Mumbai City,3572,3,6,4,4,17,11,6,22
Kolkata,3572,4,5,6,3,18,14,4,21
NorthEast Un,3572,5,5,3,6,15,12,3,18
Chennaiyin,3572,6,3,6,5,16,21,-5,15
FC Pune City,3572,7,4,3,7,12,18,-6,15
FC Goa,3572,8,4,2,8,13,22,-9,14
Delhi Dynamo,3573,1,7,5,2,26,15,11,26
Mumbai City,3573,2,6,4,4,16,10,6,22
Kolkata,3573,3,5,7,2,20,15,5,22
NorthEast Un,3573,4,6,2,6,12,10,2,20
FC Pune City,3573,5,5,3,6,15,17,-2,18
Kerala Blast,3573,6,4,4,6,11,18,-7,16
Chennaiyin,3573,7,3,5,6,14,21,-7,14
FC Goa,3573,8,4,2,8,11,19,-8,14
Mumbai City,3574,1,6,5,3,17,9,8,23
Kerala Blast,3574,2,5,5,4,15,15,0,20
Delhi Dynamo,3574,3,4,7,3,22,16,6,19
Kolkata,3574,4,3,9,2,16,15,1,18
FC Pune City,3574,5,4,5,5,14,16,-2,17
Chennaiyin,3574,6,3,7,4,14,18,-4,16
NorthEast Un,3574,7,4,4,6,10,14,-4,16
FC Goa,3574,8,4,4,6,10,15,-5,16
Kerala Blast,3575,1,7,3,4,17,17,0,24
Mumbai City,3575,2,6,4,4,18,13,5,22
Delhi Dynamo,3575,3,5,5,4,27,21,6,20
Chennaiyin,3575,4,5,5,4,17,17,0,20
Kolkata,3575,5,4,6,4,18,18,0,18
NorthEast Un,3575,6,5,2,7,13,14,-1,17
FC Goa,3575,7,5,2,7,11,17,-6,17
FC Pune City,3575,8,4,3,7,15,19,-4,15
Mumbai City,3576,1,7,4,3,19,10,9,25
Delhi Dynamo,3576,2,5,5,4,26,20,6,20
NorthEast Un,3576,3,5,4,5,14,12,2,19
FC Pune City,3576,4,5,4,5,16,16,0,19
Kolkata,3576,5,4,7,3,16,17,-1,19
Chennaiyin,3576,6,3,7,4,16,20,-4,16
Kerala Blast,3576,7,4,4,6,10,17,-7,16
FC Goa,3576,8,4,3,7,13,18,-5,15
Mumbai City,3577,1,7,4,3,17,8,9,25
NorthEast Un,3577,2,7,2,5,13,10,3,23
Delhi Dynamo,3577,3,5,5,4,24,17,7,20
Kolkata,3577,4,4,7,3,15,13,2,19
FC Pune City,3577,5,5,3,6,13,16,-3,18
Kerala Blast,3577,6,5,3,6,11,16,-5,18
FC Goa,3577,7,4,3,7,11,17,-6,15
Chennaiyin,3577,8,3,5,6,14,21,-7,14
Delhi Dynamo,3578,1,5,7,2,26,16,10,22
Mumbai City,3578,2,6,4,4,16,11,5,22
Kolkata,3578,3,5,7,2,18,14,4,22
Kerala Blast,3578,4,5,3,6,16,17,-1,18
FC Pune City,3578,5,5,3,6,16,19,-3,18
Chennaiyin,3578,6,3,7,4,16,20,-4,16
NorthEast Un,3578,7,4,4,6,12,17,-5,16
FC Goa,3578,8,3,5,6,11,17,-6,14
Mumbai City,3579,1,7,4,3,18,9,9,25
Kerala Blast,3579,2,6,3,5,16,17,-1,21
Delhi Dynamo,3579,3,5,5,4,25,20,5,20
Chennaiyin,3579,4,5,5,4,16,18,-2,20
FC Pune City,3579,5,5,4,5,14,15,-1,19
NorthEast Un,3579,6,5,2,7,13,13,0,17
Kolkata,3579,7,3,8,3,14,16,-2,17
FC Goa,3579,8,3,3,8,10,18,-8,12
Delhi Dynamo,3580,1,6,6,2,24,15,9,24
Mumbai City,3580,2,6,5,3,17,9,8,23
Kerala Blast,3580,3,5,5,4,11,13,-2,20
FC Pune City,3580,4,5,4,5,14,15,-1,19
FC Goa,3580,5,5,2,7,14,18,-4,17
Kolkata,3580,6,3,7,4,15,16,-1,16
NorthEast Un,3580,7,4,3,7,9,12,-3,15
Chennaiyin,3580,8,3,6,5,15,21,-6,15
Delhi Dynamo,3581,1,6,5,3,28,19,9,23
Mumbai City,3581,2,6,4,4,18,12,6,22
NorthEast Un,3581,3,6,3,5,11,9,2,21
Kerala Blast,3581,4,5,4,5,13,16,-3,19
Kolkata,3581,5,4,6,4,18,19,-1,18
FC Pune City,3581,6,4,4,6,14,18,-4,16
Chennaiyin,3581,7,3,7,4,13,17,-4,16
FC Goa,3581,8,4,3,7,13,18,-5,15
Mumbai City,3582,1,6,5,3,16,8,8,23
Delhi Dynamo,3582,2,5,6,3,25,16,9,21
Kolkata,3582,3,4,7,3,17,14,3,19
FC Pune City,3582,4,5,4,5,15,14,1,19
Kerala Blast,3582,5,5,4,5,12,18,-6,19
NorthEast Un,3582,6,5,3,6,12,12,0,18
Chennaiyin,3582,7,4,6,4,16,19,-3,18
FC Goa,3582,8,3,3,8,10,22,-12,12
Mumbai City,3583,1,7,4,3,17,8,9,25
Kolkata,3583,2,5,6,3,15,13,2,21
FC Goa,3583,3,6,2,6,11,14,-3,20
Kerala Blast,3583,4,5,4,5,14,16,-2,19
Delhi Dynamo,3583,5,4,5,5,22,18,4,17
NorthEast Un,3583,6,5,2,7,11,14,-3,17
Chennaiyin,3583,7,4,5,5,14,18,-4,17
FC Pune City,3583,8,4,4,6,14,17,-3,16
Mumbai City,3584,1,6,5,3,17,9,8,23
Kerala Blast,3584,2,6,3,5,15,16,-1,21
NorthEast Un,3584,3,6,2,6,12,12,0,20
FC Goa,3584,4,6,2,6,15,16,-1,20
Kolkata,3584,5,4,7,3,17,16,1,19
Delhi Dynamo,3584,6,4,6,4,23,19,4,18
FC Pune City,3584,7,4,4,6,13,18,-5,16
Chennaiyin,3584,8,3,5,6,15,21,-6,14
Mumbai City,3585,1,7,4,3,17,8,9,25
Delhi Dynamo,3585,2,6,5,3,27,15,12,23
Kolkata,3585,3,4,8,2,19,16,3,20
Kerala Blast,3585,4,5,5,4,14,15,-1,20
NorthEast Un,3585,5,5,3,6,10,11,-1,18
Chennaiyin,3585,6,4,5,5,15,18,-3,17
FC Pune City,3585,7,4,3,7,14,21,-7,15
FC Goa,3585,8,3,3,8,10,22,-12,12
Mumbai City,3586,1,7,4,3,18,9,9,25
Kerala Blast,3586,2,6,4,4,15,15,0,22
Kolkata,3586,3,5,6,3,18,15,3,21
Delhi Dynamo,3586,4,5,5,4,24,18,6,20
NorthEast Un,3586,5,5,4,5,11,10,1,19
Chennaiyin,3586,6,3,6,5,14,20,-6,15
FC Pune City,3586,6,4,3,7,14,20,-6,15
FC Goa,3586,8,4,2,8,11,18,-7,14
Mumbai City,3587,1,7,4,3,17,8,9,25
Delhi Dynamo,3587,2,4,7,3,22,16,6,19
Kolkata,3587,3,4,7,3,17,15,2,19
NorthEast Un,3587,4,5,4,5,11,10,1,19
Kerala Blast,3587,5,5,4,5,11,14,-3,19
FC Pune City,3587,6,5,3,6,13,17,-4,18
Chennaiyin,3587,7,4,5,5,15,18,-3,17
FC Goa,3587,8,3,4,7,9,17,-8,13
Mumbai City,3588,1,7,4,3,18,9,9,25
Kolkata,3588,2,5,6,3,17,14,3,21
Delhi Dynamo,3588,3,4,7,3,23,17,6,19
Kerala Blast,3588,4,5,4,5,13,17,-4,19
Chennaiyin,3588,5,4,6,4,18,20,-2,18
FC Pune City,3588,6,5,3,6,14,16,-2,18
NorthEast Un,3588,7,4,5,5,12,12,0,17
FC Goa,3588,8,3,3,8,10,20,-10,12
Delhi Dynamo,3589,1,7,5,2,27,16,11,26
Mumbai City,3589,2,6,4,4,17,10,7,22
Kerala Blast,3589,3,6,4,4,15,16,-1,22
Kolkata,3589,4,3,9,2,15,14,1,18
FC Pune City,3589,5,4,4,6,14,18,-4,16
NorthEast Un,3589,6,4,3,7,12,14,-2,15
Chennaiyin,3589,7,3,6,5,16,21,-5,15
FC Goa,3589,8,4,3,7,11,18,-7,15
Mumbai City,3590,1,7,4,3,19,9,10,25
Kolkata,3590,2,5,7,2,17,14,3,22
NorthEast Un,3590,3,6,2,6,13,12,1,20
Kerala Blast,3590,4,5,4,5,12,15,-3,19
Chennaiyin,3590,5,4,6,4,15,18,-3,18
Delhi Dynamo,3590,6,4,5,5,23,20,3,17
FC Pune City,3590,7,4,3,7,13,18,-5,15
FC Goa,3590,8,4,3,7,9,15,-6,15
Delhi Dynamo,3591,1,6,6,2,25,16,9,24
Mumbai City,3591,2,6,5,3,17,9,8,23
Kerala Blast,3591,3,6,3,5,13,15,-2,21
Kolkata,3591,4,4,8,2,16,14,2,20
Chennaiyin,3591,5,4,6,4,15,18,-3,18
FC Pune City,3591,6,4,4,6,13,17,-4,16
NorthEast Un,3591,7,4,2,8,10,13,-3,14
FC Goa,3591,8,3,4,7,11,18,-7,13
Mumbai City,3592,1,7,4,3,20,10,10,25
Delhi Dynamo,3592,2,5,6,3,28,19,9,21
FC Pune City,3592,3,6,3,5,17,15,2,21
Chennaiyin,3592,4,5,5,4,16,18,-2,20
Kerala Blast,3592,5,4,5,5,10,16,-6,17
NorthEast Un,3592,6,4,4,6,11,12,-1,16
Kolkata,3592,7,3,7,4,16,18,-2,16
FC Goa,3592,8,4,2,8,10,20,-10,14
Delhi Dynamo,3593,1,6,5,3,26,17,9,23
Mumbai City,3593,2,6,4,4,16,10,6,22
NorthEast Un,3593,3,6,2,6,13,12,1,20
Chennaiyin,3593,4,5,5,4,16,17,-1,20
FC Pune City,3593,5,5,4,5,13,14,-1,19
Kerala Blast,3593,6,5,3,6,11,16,-5,18
Kolkata,3593,7,3,7,4,15,16,-1,16
FC Goa,3593,8,4,2,8,12,20,-8,14
Mumbai City,3594,1,6,5,3,18,10,8,23
NorthEast Un,3594,2,6,3,5,13,10,3,21
Kerala Blast,3594,3,6,3,5,14,16,-2,21
Delhi Dynamo,3594,4,4,7,3,24,19,5,19
FC Goa,3594,5,5,3,6,12,15,-3,18
Kolkata,3594,6,3,8,3,16,17,-1,17
FC Pune City,3594,7,4,4,6,16,19,-3,16
Chennaiyin,3594,8,3,5,6,13,20,-7,14
Mumbai City,3595,1,6,4,4,16,9,7,22
Delhi Dynamo,3595,2,5,6,3,22,15,7,21
Kerala Blast,3595,3,6,3,5,18,16,2,21
Kolkata,3595,4,4,8,2,16,14,2,20
FC Goa,3595,5,5,3,6,11,15,-4,18
NorthEast Un,3595,6,4,4,6,12,15,-3,16
FC Pune City,3595,7,4,4,6,15,21,-6,16
Chennaiyin,3595,8,3,6,5,16,21,-5,15
Mumbai City,3596,1,7,4,3,20,11,9,25
Delhi Dynamo,3596,2,5,5,4,26,21,5,20
Kolkata,3596,3,4,7,3,16,14,2,19
FC Pune City,3596,4,5,4,5,15,15,0,19
FC Goa,3596,5,5,3,6,13,15,-2,18
Kerala Blast,3596,6,4,5,5,10,17,-7,17
NorthEast Un,3596,7,4,4,6,9,11,-2,16
Chennaiyin,3596,8,3,6,5,14,19,-5,15
Delhi Dynamo,3597,1,7,5,2,25,15,10,26
Mumbai City,3597,2,6,4,4,16,9,7,22
Kerala Blast,3597,3,6,3,5,13,17,-4,21
Chennaiyin,3597,4,5,5,4,17,18,-1,20
Kolkata,3597,5,4,6,4,17,15,2,18
FC Pune City,3597,6,5,3,6,15,18,-3,18
NorthEast Un,3597,7,4,2,8,10,13,-3,14
FC Goa,3597,8,4,2,8,10,18,-8,14
Mumbai City,3598,1,7,4,3,18,8,10,25
Delhi Dynamo,3598,2,6,5,3,25,17,8,23
Kolkata,3598,3,5,6,3,16,16,0,21
Kerala Blast,3598,4,6,3,5,12,14,-2,21
Chennaiyin,3598,5,4,5,5,15,18,-3,17
FC Goa,3598,6,5,2,7,12,16,-4,17
FC Pune City,3598,7,4,3,7,13,17,-4,15
NorthEast Un,3598,8,4,2,8,10,15,-5,14
Delhi Dynamo,3599,1,7,5,2,24,14,10,26
Mumbai City,3599,2,6,4,4,16,9,7,22
Kolkata,3599,3,5,6,3,16,14,2,21
NorthEast Un,3599,4,6,2,6,12,11,1,20
FC Pune City,3599,5,5,3,6,14,16,-2,18
FC Goa,3599,6,5,2,7,11,16,-5,17
Kerala Blast,3599,7,4,3,7,11,18,-7,15
Chennaiyin,3599,8,3,5,6,13,19,-6,14
Mumbai City,3600,1,7,4,3,17,8,9,25
Delhi Dynamo,3600,2,5,6,3,23,16,7,21
Chennaiyin,3600,3,5,5,4,17,19,-2,20
FC Pune City,3600,4,5,4,5,14,15,-1,19
Kerala Blast,3600,5,5,4,5,12,15,-3,19
NorthEast Un,3600,6,5,2,7,11,12,-1,17
Kolkata,3600,7,3,6,5,14,17,-3,15
FC Goa,3600,8,4,3,7,12,18,-6,15
Delhi Dynamo,3601,1,6,5,3,25,17,8,23
Mumbai City,3601,2,6,4,4,18,11,7,22
FC Pune City,3601,3,6,3,5,17,16,1,21
FC Goa,3601,4,6,2,6,12,14,-2,20
Kolkata,3601,5,4,6,4,16,15,1,18
Kerala Blast,3601,6,5,3,6,15,22,-7,18
NorthEast Un,3601,7,4,3,7,14,16,-2,15
Chennaiyin,3601,8,3,6,5,16,22,-6,15
Mumbai City,3602,1,7,4,3,18,9,9,25
Kerala Blast,3602,2,7,3,4,14,15,-1,24
Delhi Dynamo,3602,3,5,6,3,26,19,7,21
FC Pune City,3602,4,5,3,6,15,16,-1,18
Chennaiyin,3602,5,4,6,4,17,19,-2,18
NorthEast Un,3602,6,4,3,7,11,13,-2,15
Kolkata,3602,7,3,6,5,14,17,-3,15
FC Goa,3602,8,4,3,7,12,19,-7,15
Delhi Dynamo,3603,1,6,6,2,24,15,9,24
Mumbai City,3603,2,6,5,3,17,9,8,23
Kerala Blast,3603,3,6,4,4,17,17,0,22
NorthEast Un,3603,4,5,3,6,12,11,1,18
FC Pune City,3603,5,5,3,6,18,19,-1,18
Kolkata,3603,6,4,6,4,19,22,-3,18
Chennaiyin,3603,7,4,5,5,18,22,-4,17
FC Goa,3603,8,3,2,9,11,21,-10,11
Mumbai City,3604,1,7,4,3,18,9,9,25
Delhi Dynamo,3604,2,6,5,3,27,16,11,23
Kerala Blast,3604,3,6,4,4,17,16,1,22
Chennaiyin,3604,4,4,6,4,17,18,-1,18
FC Pune City,3604,5,5,3,6,14,18,-4,18
Kolkata,3604,6,3,7,4,15,16,-1,16
NorthEast Un,3604,7,4,3,7,10,14,-4,15
FC Goa,3604,8,4,2,8,9,20,-11,14
Delhi Dynamo,3605,1,6,5,3,27,19,8,23
Mumbai City,3605,2,6,4,4,17,10,7,22
FC Pune City,3605,3,5,4,5,16,17,-1,19
Kerala Blast,3605,4,5,4,5,13,17,-4,19
NorthEast Un,3605,5,5,2,7,13,14,-1,17
Kolkata,3605,6,3,8,3,16,18,-2,17
FC Goa,3605,7,5,2,7,14,17,-3,17
Chennaiyin,3605,8,4,5,5,15,19,-4,17
Mumbai City,3606,1,7,4,3,23,9,14,25
Chennaiyin,3606,2,5,5,4,21,18,3,20
Delhi Dynamo,3606,3,5,5,4,24,24,0,20
Kerala Blast,3606,4,4,6,4,10,14,-4,18
Kolkata,3606,5,3,8,3,13,13,0,17
FC Pune City,3606,6,4,5,5,12,14,-2,17
FC Goa,3606,7,5,2,7,11,17,-6,17
NorthEast Un,3606,8,4,3,7,12,17,-5,15
Mumbai City,3607,1,6,5,3,17,9,8,23
Delhi Dynamo,3607,2,5,6,3,25,19,6,21
FC Pune City,3607,3,6,3,5,17,14,3,21
Kolkata,3607,4,4,7,3,14,14,0,19
Kerala Blast,3607,5,5,3,6,11,17,-6,18
NorthEast Un,3607,6,5,2,7,12,13,-1,17
Chennaiyin,3607,7,4,5,5,16,21,-5,17
FC Goa,3607,8,4,3,7,13,18,-5,15
Mumbai City,3608,1,6,5,3,18,10,8,23
NorthEast Un,3608,2,6,2,6,15,12,3,20
Kolkata,3608,3,4,7,3,16,15,1,19
Kerala Blast,3608,4,5,4,5,14,17,-3,19
Delhi Dynamo,3608,5,4,6,4,24,22,2,18
Chennaiyin,3608,6,4,6,4,16,18,-2,18
FC Goa,3608,7,5,3,6,13,15,-2,18
FC Pune City,3608,8,4,3,7,13,20,-7,15
Mumbai City,3609,1,7,4,3,19,8,11,25
NorthEast Un,3609,2,7,2,5,15,12,3,23
Delhi Dynamo,3609,3,5,5,4,24,20,4,20
Kolkata,3609,4,4,8,2,17,15,2,20
Kerala Blast,3609,5,5,4,5,13,17,-4,19
Chennaiyin,3609,6,4,5,5,14,18,-4,17
FC Pune City,3609,7,4,4,6,13,16,-3,16
FC Goa,3609,8,3,2,9,10,19,-9,11
Mumbai City,3610,1,7,4,3,18,9,9,25
Delhi Dynamo,3610,2,6,5,3,25,16,9,23
Kolkata,3610,3,5,7,2,18,14,4,22
NorthEast Un,3610,4,6,2,6,13,12,1,20
FC Pune City,3610,5,5,3,6,14,17,-3,18
Kerala Blast,3610,6,4,4,6,9,16,-7,16
FC Goa,3610,7,4,2,8,12,18,-6,14
Chennaiyin,3610,8,3,5,6,15,22,-7,14
Delhi Dynamo,3611,1,7,5,2,28,15,13,26
Mumbai City,3611,2,6,4,4,17,10,7,22
Kerala Blast,3611,3,6,4,4,15,14,1,22
Chennaiyin,3611,4,5,5,4,17,18,-1,20
Kolkata,3611,5,3,8,3,14,15,-1,17
FC Pune City,3611,6,4,4,6,12,16,-4,16
NorthEast Un,3611,7,4,2,8,9,16,-7,14
FC Goa,3611,8,4,2,8,11,19,-8,14
Delhi Dynamo,3612,1,6,6,2,24,15,9,24
Mumbai City,3612,2,6,4,4,16,9,7,22
Kolkata,3612,3,5,6,3,18,16,2,21
Chennaiyin,3612,4,5,5,4,18,19,-1,20
Kerala Blast,3612,5,4,5,5,11,16,-5,17
NorthEast Un,3612,6,4,4,6,11,13,-2,16
FC Pune City,3612,7,4,4,6,14,17,-3,16
FC Goa,3612,8,4,2,8,11,18,-7,14
Delhi Dynamo,3613,1,7,5,2,27,16,11,26
Mumbai City,3613,2,6,4,4,16,9,7,22
Kolkata,3613,3,5,7,2,18,14,4,22
Kerala Blast,3613,4,6,3,5,13,16,-3,21
Chennaiyin,3613,5,5,5,4,16,17,-1,20
FC Pune City,3613,6,4,4,6,14,18,-4,16
NorthEast Un,3613,7,4,2,8,12,15,-3,14
FC Goa,3613,8,3,2,9,8,19,-11,11
Delhi Dynamo,3614,1,5,7,2,25,17,8,22
Mumbai City,3614,2,6,4,4,17,10,7,22
Kerala Blast,3614,3,6,3,5,17,17,0,21
FC Pune City,3614,4,5,4,5,17,17,0,19
NorthEast Un,3614,5,5,3,6,11,13,-2,18
FC Goa,3614,6,5,3,6,13,16,-3,18
Kolkata,3614,7,3,7,4,15,18,-3,16
Chennaiyin,3614,8,3,5,6,13,20,-7,14
Mumbai City,3615,1,6,5,3,18,10,8,23
Kolkata,3615,2,5,7,2,16,13,3,22
Delhi Dynamo,3615,3,4,7,3,25,19,6,19
NorthEast Un,3615,4,5,3,6,11,11,0,18
FC Pune City,3615,5,5,3,6,14,16,-2,18
Kerala Blast,3615,6,5,3,6,11,16,-5,18
Chennaiyin,3615,7,4,5,5,17,19,-2,17
FC Goa,3615,8,4,3,7,12,20,-8,15
Mumbai City,3616,1,7,4,3,17,8,9,25
Delhi Dynamo,3616,2,6,5,3,26,15,11,23
Kolkata,3616,3,5,6,3,16,16,0,21
Kerala Blast,3616,4,5,5,4,14,15,-1,20
NorthEast Un,3616,5,5,3,6,13,12,1,18
FC Pune City,3616,6,4,4,6,14,17,-3,16
Chennaiyin,3616,7,3,6,5,16,23,-7,15
FC Goa,3616,8,3,3,8,11,21,-10,12
Delhi Dynamo,3617,1,6,5,3,29,19,10,23
Mumbai City,3617,2,6,4,4,16,10,6,22
Chennaiyin,3617,3,5,5,4,17,18,-1,20
Kolkata,3617,4,4,7,3,19,16,3,19
Kerala Blast,3617,5,5,4,5,14,21,-7,19
FC Pune City,3617,6,5,3,6,18,19,-1,18
NorthEast Un,3617,7,5,3,6,15,16,-1,18
FC Goa,3617,8,3,3,8,10,19,-9,12
Mumbai City,3618,1,7,4,3,17,8,9,25
FC Goa,3618,2,6,2,6,16,17,-1,20
Kolkata,3618,3,4,7,3,19,17,2,19
Delhi Dynamo,3618,4,4,6,4,21,16,5,18
NorthEast Un,3618,5,5,3,6,11,11,0,18
Kerala Blast,3618,6,5,3,6,12,18,-6,18
Chennaiyin,3618,7,4,5,5,16,22,-6,17
FC Pune City,3618,8,4,4,6,12,15,-3,16
Delhi Dynamo,3619,1,6,6,2,26,16,10,24
Mumbai City,3619,2,6,5,3,18,10,8,23
Kolkata,3619,3,4,7,3,19,17,2,19
FC Pune City,3619,4,5,4,5,17,17,0,19
Kerala Blast,3619,5,5,3,6,10,17,-7,18
NorthEast Un,3619,6,5,2,7,11,12,-1,17
Chennaiyin,3619,7,4,5,5,15,18,-3,17
FC Goa,3619,8,4,2,8,10,19,-9,14
Delhi Dynamo,3620,1,6,5,3,27,16,11,23
Mumbai City,3620,2,6,4,4,16,11,5,22
Kolkata,3620,3,5,6,3,20,15,5,21
FC Goa,3620,4,6,2,6,14,16,-2,20
Kerala Blast,3620,5,4,5,5,10,18,-8,17
NorthEast Un,3620,6,4,4,6,10,12,-2,16
FC Pune City,3620,7,4,4,6,13,17,-4,16
Chennaiyin,3620,8,3,6,5,14,19,-5,15
Delhi Dynamo,3621,1,6,6,2,25,16,9,24
Mumbai City,3621,2,6,5,3,18,10,8,23
Kolkata,3621,3,5,7,2,17,14,3,22
Kerala Blast,3621,4,6,3,5,16,15,1,21
Chennaiyin,3621,5,5,5,4,17,17,0,20
FC Pune City,3621,6,4,3,7,14,20,-6,15
NorthEast Un,3621,7,4,2,8,9,16,-7,14
FC Goa,3621,8,3,3,8,9,17,-8,12
Mumbai City,3622,1,7,4,3,18,8,10,25
Delhi Dynamo,3622,2,6,5,3,25,18,7,23
FC Pune City,3622,3,6,3,5,16,16,0,21
Kerala Blast,3622,4,5,4,5,14,17,-3,19
FC Goa,3622,5,5,2,7,11,16,-5,17
Kolkata,3622,6,3,7,4,15,16,-1,16
NorthEast Un,3622,7,4,3,7,12,15,-3,15
Chennaiyin,3622,8,3,6,5,14,19,-5,15
Delhi Dynamo,3623,1,6,6,2,26,16,10,24
Mumbai City,3623,2,6,5,3,18,10,8,23
Kolkata,3623,3,5,7,2,18,14,4,22
Kerala Blast,3623,4,6,3,5,14,16,-2,21
Chennaiyin,3623,5,4,6,4,18,21,-3,18
FC Pune City,3623,6,4,3,7,12,17,-5,15
NorthEast Un,3623,7,4,2,8,11,16,-5,14
FC Goa,3623,8,3,4,7,11,18,-7,13
Mumbai City,3624,1,7,4,3,20,9,11,25
Kerala Blast,3624,2,6,4,4,13,15,-2,22
Delhi Dynamo,3624,3,5,5,4,26,20,6,20
Kolkata,3624,4,3,8,3,15,15,0,17
NorthEast Un,3624,5,5,2,7,11,12,-1,17
FC Pune City,3624,6,4,5,5,13,15,-2,17
Chennaiyin,3624,7,4,5,5,14,21,-7,17
FC Goa,3624,8,4,3,7,13,18,-5,15
Delhi Dynamo,3625,1,6,6,2,23,14,9,24
Mumbai City,3625,2,6,5,3,16,8,8,23
Kolkata,3625,3,5,6,3,16,16,0,21
NorthEast Un,3625,4,5,3,6,10,10,0,18
FC Goa,3625,5,5,2,7,13,15,-2,17
Kerala Blast,3625,6,4,5,5,11,16,-5,17
FC Pune City,3625,7,4,4,6,13,16,-3,16
Chennaiyin,3625,8,3,5,6,13,20,-7,14
Mumbai City,3626,1,7,4,3,17,8,9,25
Delhi Dynamo,3626,2,6,5,3,27,19,8,23
FC Pune City,3626,3,6,3,5,15,14,1,21
Kerala Blast,3626,4,5,4,5,10,15,-5,19
Chennaiyin,3626,5,4,6,4,17,20,-3,18
NorthEast Un,3626,6,4,4,6,13,14,-1,16
Kolkata,3626,7,3,6,5,13,15,-2,15
FC Goa,3626,8,4,2,8,12,19,-7,14
Mumbai City,3627,1,6,5,3,17,9,8,23
Delhi Dynamo,3627,2,5,6,3,24,17,7,21
FC Goa,3627,3,6,2,6,13,14,-1,20
Kerala Blast,3627,4,5,4,5,14,15,-1,19
Kolkata,3627,5,4,6,4,16,18,-2,18
FC Pune City,3627,6,5,3,6,13,17,-4,18
Chennaiyin,3627,7,4,5,5,14,19,-5,17
NorthEast Un,3627,8,4,3,7,11,13,-2,15
Delhi Dynamo,3628,1,6,6,2,27,16,11,24
Mumbai City,3628,2,6,4,4,17,10,7,22
Kolkata,3628,3,5,6,3,16,13,3,21
NorthEast Un,3628,4,5,3,6,13,12,1,18
Kerala Blast,3628,5,5,3,6,16,18,-2,18
Chennaiyin,3628,6,4,6,4,15,18,-3,18
FC Goa,3628,7,4,3,7,10,18,-8,15
FC Pune City,3628,8,4,3,7,13,22,-9,15
Mumbai City,3629,1,6,5,3,18,10,8,23
Kerala Blast,3629,2,6,3,5,12,15,-3,21
NorthEast Un,3629,3,6,2,6,15,13,2,20
Kolkata,3629,4,4,7,3,16,15,1,19
Delhi Dynamo,3629,5,4,6,4,26,22,4,18
FC Pune City,3629,6,5,3,6,13,15,-2,18
FC Goa,3629,7,5,3,6,14,17,-3,18
Chennaiyin,3629,8,3,5,6,13,20,-7,14
Mumbai City,3630,1,7,4,3,19,10,9,25
NorthEast Un,3630,2,5,4,5,18,16,2,19
Kerala Blast,3630,3,5,4,5,13,17,-4,19
Delhi Dynamo,3630,4,4,6,4,26,22,4,18
FC Pune City,3630,5,5,3,6,17,16,1,18
Kolkata,3630,6,4,6,4,15,19,-4,18
Chennaiyin,3630,7,3,7,4,17,21,-4,16
FC Goa,3630,8,4,4,6,13,17,-4,16
Mumbai City,3631,1,7,4,3,18,9,9,25
Kerala Blast,3631,2,6,4,4,14,14,0,22
Delhi Dynamo,3631,3,5,6,3,24,17,7,21
FC Goa,3631,4,5,3,6,13,15,-2,18
Kolkata,3631,5,3,8,3,15,15,0,17
Chennaiyin,3631,6,4,5,5,16,20,-4,17
FC Pune City,3631,7,4,4,6,13,16,-3,16
NorthEast Un,3631,8,4,2,8,9,16,-7,14
Mumbai City,3632,1,7,4,3,19,9,10,25
NorthEast Un,3632,2,7,2,5,14,10,4,23
Delhi Dynamo,3632,3,5,5,4,25,19,6,20
Kolkata,3632,4,4,8,2,19,16,3,20
Kerala Blast,3632,5,5,4,5,12,17,-5,19
FC Pune City,3632,6,4,4,6,14,17,-3,16
Chennaiyin,3632,7,3,5,6,13,19,-6,14
FC Goa,3632,8,4,2,8,11,20,-9,14
Mumbai City,3633,1,6,5,3,16,8,8,23
Kerala Blast,3633,2,6,4,4,12,13,-1,22
Delhi Dynamo,3633,3,5,6,3,25,17,8,21
NorthEast Un,3633,4,6,3,5,12,9,3,21
FC Pune City,3633,5,5,3,6,15,15,0,18
Kolkata,3633,6,4,6,4,16,19,-3,18
Chennaiyin,3633,7,3,6,5,14,19,-5,15
FC Goa,3633,8,3,3,8,12,22,-10,12
Kolkata,3634,1,6,6,2,21,14,7,24
Delhi Dynamo,3634,2,6,5,3,26,19,7,23
Mumbai City,3634,3,6,4,4,17,10,7,22
NorthEast Un,3634,4,5,4,5,13,11,2,19
Chennaiyin,3634,5,4,6,4,15,18,-3,18
Kerala Blast,3634,6,4,5,5,12,18,-6,17
FC Pune City,3634,7,4,4,6,13,17,-4,16
FC Goa,3634,8,3,2,9,11,21,-10,11
Delhi Dynamo,3635,1,6,6,2,27,17,10,24
Mumbai City,3635,2,6,4,4,16,10,6,22
Kolkata,3635,3,4,7,3,15,15,0,19
NorthEast Un,3635,4,5,3,6,13,14,-1,18
Chennaiyin,3635,5,4,6,4,17,19,-2,18
FC Pune City,3635,6,5,3,6,14,16,-2,18
Kerala Blast,3635,7,5,3,6,14,18,-4,18
FC Goa,3635,8,3,4,7,12,19,-7,13
Delhi Dynamo,3636,1,6,6,2,27,15,12,24
Mumbai City,3636,2,6,4,4,17,11,6,22
Kolkata,3636,3,5,6,3,17,13,4,21
Kerala Blast,3636,4,5,4,5,12,16,-4,19
NorthEast Un,3636,5,4,4,6,11,13,-2,16
Chennaiyin,3636,6,3,7,4,15,19,-4,16
FC Pune City,3636,7,4,4,6,13,17,-4,16
FC Goa,3636,8,4,3,7,9,17,-8,15
Kolkata,3637,1,5,7,2,20,14,6,22
Mumbai City,3637,2,6,4,4,17,11,6,22
Delhi Dynamo,3637,3,5,6,3,25,19,6,21
NorthEast Un,3637,4,6,2,6,14,12,2,20
Kerala Blast,3637,5,5,4,5,12,16,-4,19
Chennaiyin,3637,6,4,5,5,16,21,-5,17
FC Goa,3637,7,4,3,7,13,18,-5,15
FC Pune City,3637,8,4,3,7,13,19,-6,15
Mumbai City,3638,1,7,4,3,19,9,10,25
Delhi Dynamo,3638,2,6,5,3,26,17,9,23
Kolkata,3638,3,4,8,2,16,13,3,20
FC Pune City,3638,4,5,4,5,13,14,-1,19
Kerala Blast,3638,5,5,3,6,11,17,-6,18
Chennaiyin,3638,6,4,5,5,15,20,-5,17
FC Goa,3638,7,4,3,7,12,17,-5,15
NorthEast Un,3638,8,4,2,8,10,15,-5,14
Delhi Dynamo,3639,1,6,6,2,25,14,11,24
Mumbai City,3639,2,6,5,3,16,8,8,23
Kerala Blast,3639,3,6,3,5,15,18,-3,21
Kolkata,3639,4,4,7,3,17,16,1,19
Chennaiyin,3639,5,4,6,4,18,19,-1,18
FC Pune City,3639,6,4,4,6,16,19,-3,16
FC Goa,3639,7,4,3,7,11,19,-8,15
NorthEast Un,3639,8,4,2,8,10,15,-5,14
Mumbai City,3640,1,7,4,3,20,9,11,25
Kerala Blast,3640,2,6,4,4,14,16,-2,22
Delhi Dynamo,3640,3,5,6,3,24,19,5,21
Kolkata,3640,4,4,7,3,17,16,1,19
FC Goa,3640,5,5,3,6,14,18,-4,18
Chennaiyin,3640,6,4,5,5,16,19,-3,17
FC Pune City,3640,7,4,3,7,14,18,-4,15
NorthEast Un,3640,8,4,2,8,9,13,-4,14
Mumbai City,3641,1,6,5,3,17,9,8,23
Kerala Blast,3641,2,6,4,4,16,16,0,22
Delhi Dynamo,3641,3,5,6,3,23,17,6,21
FC Pune City,3641,4,5,3,6,14,15,-1,18
NorthEast Un,3641,5,5,3,6,13,14,-1,18
Chennaiyin,3641,6,4,6,4,16,19,-3,18
Kolkata,3641,7,3,7,4,17,19,-2,16
FC Goa,3641,8,4,2,8,12,19,-7,14
Mumbai City,3642,1,6,5,3,18,10,8,23
NorthEast Un,3642,2,6,3,5,12,10,2,21
Kolkata,3642,3,4,8,2,16,13,3,20
Kerala Blast,3642,4,5,5,4,11,14,-3,20
Delhi Dynamo,3642,5,4,7,3,23,17,6,19
Chennaiyin,3642,6,4,5,5,15,19,-4,17
FC Pune City,3642,7,4,4,6,14,17,-3,16
FC Goa,3642,8,3,3,8,8,17,-9,12
Delhi Dynamo,3643,1,6,5,3,25,16,9,23
Mumbai City,3643,2,6,4,4,16,9,7,22
FC Pune City,3643,3,6,3,5,14,14,0,21
Kerala Blast,3643,4,5,4,5,11,15,-4,19
Chennaiyin,3643,5,4,6,4,17,19,-2,18
FC Goa,3643,6,5,3,6,13,17,-4,18
Kolkata,3643,7,3,7,4,14,15,-1,16
NorthEast Un,3643,8,4,2,8,9,14,-5,14
Mumbai City,3644,1,7,4,3,17,8,9,25
Delhi Dynamo,3644,2,5,5,4,22,17,5,20
Kolkata,3644,3,4,8,2,16,14,2,20
Kerala Blast,3644,4,5,4,5,12,17,-5,19
NorthEast Un,3644,5,5,3,6,11,10,1,18
FC Goa,3644,6,5,2,7,11,15,-4,17
FC Pune City,3644,7,4,4,6,14,17,-3,16
Chennaiyin,3644,8,3,6,5,13,18,-5,15
Mumbai City,3645,1,7,4,3,18,8,10,25
Delhi Dynamo,3645,2,5,5,4,22,17,5,20
Kolkata,3645,3,4,8,2,15,13,2,20
Kerala Blast,3645,4,5,5,4,12,15,-3,20
FC Goa,3645,5,5,3,6,12,15,-3,18
NorthEast Un,3645,6,5,2,7,10,11,-1,17
FC Pune City,3645,7,4,4,6,15,18,-3,16
Chennaiyin,3645,8,3,5,6,14,21,-7,14
Mumbai City,3646,1,7,4,3,18,9,9,25
Delhi Dynamo,3646,2,6,5,3,25,16,9,23
FC Pune City,3646,3,6,3,5,15,14,1,21
Kerala Blast,3646,4,5,4,5,12,17,-5,19
Kolkata,3646,5,3,7,4,16,17,-1,16
NorthEast Un,3646,6,4,4,6,10,11,-1,16
Chennaiyin,3646,7,3,6,5,15,20,-5,15
FC Goa,3646,8,4,3,7,11,18,-7,15
Mumbai City,3647,1,7,4,3,18,8,10,25
Delhi Dynamo,3647,2,5,5,4,23,18,5,20
Kerala Blast,3647,3,5,5,4,13,14,-1,20
NorthEast Un,3647,4,5,3,6,11,12,-1,18
Kolkata,3647,5,3,8,3,14,14,0,17
Chennaiyin,3647,6,4,5,5,16,19,-3,17
FC Goa,3647,7,5,2,7,11,16,-5,17
FC Pune City,3647,8,4,4,6,12,17,-5,16
Mumbai City,3648,1,7,4,3,20,11,9,25
Kolkata,3648,2,6,6,2,19,13,6,24
Kerala Blast,3648,3,6,3,5,12,15,-3,21
Delhi Dynamo,3648,4,4,6,4,24,20,4,18
NorthEast Un,3648,5,5,3,6,11,10,1,18
FC Pune City,3648,6,4,3,7,12,16,-4,15
Chennaiyin,3648,7,3,6,5,13,19,-6,15
FC Goa,3648,8,4,3,7,10,17,-7,15
Mumbai City,3649,1,7,4,3,18,9,9,25
Kerala Blast,3649,2,6,4,4,16,15,1,22
FC Goa,3649,3,6,2,6,18,20,-2,20
Delhi Dynamo,3649,4,4,5,5,23,21,2,17
FC Pune City,3649,5,4,5,5,15,17,-2,17
NorthEast Un,3649,6,5,2,7,12,14,-2,17
Chennaiyin,3649,7,4,5,5,16,20,-4,17
Kolkata,3649,8,3,7,4,19,21,-2,16
Delhi Dynamo,3650,1,6,5,3,29,18,11,23
Mumbai City,3650,2,6,4,4,16,12,4,22
Kerala Blast,3650,3,6,4,4,14,16,-2,22
Kolkata,3650,4,3,9,2,17,16,1,18
FC Goa,3650,5,5,3,6,14,17,-3,18
Chennaiyin,3650,6,4,5,5,17,20,-3,17
FC Pune City,3650,7,4,4,6,13,16,-3,16
NorthEast Un,3650,8,4,2,8,12,17,-5,14
Mumbai City,3651,1,6,4,4,16,11,5,22
Delhi Dynamo,3651,2,5,6,3,25,17,8,21
Kolkata,3651,3,4,8,2,15,13,2,20
Chennaiyin,3651,4,5,5,4,15,17,-2,20
FC Pune City,3651,5,5,4,5,13,14,-1,19
NorthEast Un,3651,6,5,3,6,13,12,1,18
Kerala Blast,3651,7,4,4,6,11,17,-6,16
FC Goa,3651,8,3,4,7,8,15,-7,13
Mumbai City,3652,1,7,4,3,20,11,9,25
Kerala Blast,3652,2,6,4,4,12,13,-1,22
Delhi Dynamo,3652,3,5,6,3,28,19,9,21
Chennaiyin,3652,4,4,5,5,19,21,-2,17
FC Pune City,3652,5,4,5,5,13,15,-2,17
FC Goa,3652,6,5,2,7,13,19,-6,17
Kolkata,3652,7,3,7,4,15,17,-2,16
NorthEast Un,3652,8,4,3,7,11,16,-5,15
Mumbai City,3653,1,7,4,3,19,9,10,25
Delhi Dynamo,3653,2,6,5,3,25,18,7,23
Kerala Blast,3653,3,6,4,4,14,14,0,22
Kolkata,3653,4,4,6,4,15,16,-1,18
FC Goa,3653,5,5,2,7,12,17,-5,17
FC Pune City,3653,6,4,4,6,13,16,-3,16
NorthEast Un,3653,7,4,3,7,11,14,-3,15
Chennaiyin,3653,8,3,6,5,15,20,-5,15
Mumbai City,3654,1,7,4,3,17,8,9,25
Delhi Dynamo,3654,2,5,5,4,26,19,7,20
NorthEast Un,3654,3,6,2,6,15,14,1,20
Kolkata,3654,4,4,7,3,16,15,1,19
FC Pune City,3654,5,4,5,5,14,16,-2,17
Chennaiyin,3654,6,4,5,5,14,18,-4,17
FC Goa,3654,7,5,2,7,12,18,-6,17
Kerala Blast,3654,8,4,4,6,12,18,-6,16
Mumbai City,3655,1,7,4,3,19,8,11,25
Kerala Blast,3655,2,6,4,4,19,16,3,22
Delhi Dynamo,3655,3,5,5,4,24,18,6,20
FC Pune City,3655,4,5,4,5,15,16,-1,19
Chennaiyin,3655,5,4,6,4,18,18,0,18
Kolkata,3655,5,4,6,4,18,18,0,18
FC Goa,3655,7,4,3,7,10,16,-6,15
NorthEast Un,3655,8,4,2,8,10,23,-13,14
Mumbai City,3656,1,7,4,3,19,8,11,25
Delhi Dynamo,3656,2,5,6,3,25,19,6,21
Kerala Blast,3656,3,6,3,5,13,16,-3,21
Chennaiyin,3656,4,5,5,4,17,19,-2,20
Kolkata,3656,5,4,6,4,15,14,1,18
FC Pune City,3656,6,5,3,6,14,17,-3,18
FC Goa,3656,7,4,3,7,12,18,-6,15
NorthEast Un,3656,8,4,2,8,11,15,-4,14
Mumbai City,3657,1,6,5,3,16,8,8,23
Delhi Dynamo,3657,2,5,7,2,24,16,8,22
Kolkata,3657,3,5,7,2,18,13,5,22
NorthEast Un,3657,4,5,3,6,12,11,1,18
Kerala Blast,3657,5,5,3,6,11,16,-5,18
Chennaiyin,3657,6,3,7,4,13,17,-4,16
FC Pune City,3657,7,4,3,7,12,19,-7,15
FC Goa,3657,8,3,5,6,10,16,-6,14
Mumbai City,3658,1,7,4,3,17,8,9,25
Delhi Dynamo,3658,2,6,5,3,24,16,8,23
Kolkata,3658,3,5,7,2,21,15,6,22
FC Pune City,3658,4,5,3,6,13,16,-3,18
Kerala Blast,3658,5,5,3,6,11,18,-7,18
NorthEast Un,3658,6,5,2,7,10,11,-1,17
Chennaiyin,3658,7,3,6,5,14,19,-5,15
FC Goa,3658,8,3,4,7,12,19,-7,13
Mumbai City,3659,1,6,5,3,17,9,8,23
Delhi Dynamo,3659,2,5,7,2,26,18,8,22
Kolkata,3659,3,5,7,2,18,13,5,22
Kerala Blast,3659,4,5,4,5,11,17,-6,19
NorthEast Un,3659,5,5,3,6,15,12,3,18
FC Pune City,3659,6,4,4,6,13,16,-3,16
Chennaiyin,3659,7,3,6,5,14,22,-8,15
FC Goa,3659,8,3,4,7,11,18,-7,13
Mumbai City,3660,1,7,4,3,20,8,12,25
Delhi Dynamo,3660,2,6,5,3,27,20,7,23
Kolkata,3660,3,4,7,3,19,17,2,19
FC Pune City,3660,4,5,4,5,18,18,0,19
Kerala Blast,3660,5,5,4,5,15,21,-6,19
Chennaiyin,3660,6,4,5,5,16,18,-2,17
NorthEast Un,3660,7,5,2,7,12,14,-2,17
FC Goa,3660,8,3,3,8,10,21,-11,12
Mumbai City,3661,1,6,5,3,17,9,8,23
Delhi Dynamo,3661,2,4,8,2,23,16,7,20
Kerala Blast,3661,3,5,4,5,12,17,-5,19
NorthEast Un,3661,4,5,3,6,11,11,0,18
Chennaiyin,3661,5,4,6,4,16,18,-2,18
FC Pune City,3661,6,4,5,5,14,16,-2,17
Kolkata,3661,7,3,7,4,14,15,-1,16
FC Goa,3661,8,4,4,6,12,17,-5,16
Mumbai City,3662,1,6,4,4,17,10,7,22
Delhi Dynamo,3662,2,5,6,3,25,19,6,21
NorthEast Un,3662,3,6,3,5,14,10,4,21
Kolkata,3662,4,5,6,3,18,16,2,21
Kerala Blast,3662,5,6,3,5,12,15,-3,21
Chennaiyin,3662,6,4,5,5,15,19,-4,17
FC Pune City,3662,7,4,3,7,14,19,-5,15
FC Goa,3662,8,4,2,8,12,19,-7,14
Mumbai City,3663,1,7,4,3,17,8,9,25
NorthEast Un,3663,2,5,4,5,11,10,1,19
Kolkata,3663,3,4,7,3,15,16,-1,19
Kerala Blast,3663,4,5,4,5,11,15,-4,19
FC Pune City,3663,5,5,3,6,15,15,0,18
Delhi Dynamo,3663,6,4,5,5,21,17,4,17
Chennaiyin,3663,7,3,7,4,16,20,-4,16
FC Goa,3663,8,4,4,6,11,16,-5,16
Mumbai City,3664,1,7,4,3,19,8,11,25
Kerala Blast,3664,2,5,5,4,12,15,-3,20
Delhi Dynamo,3664,3,4,7,3,23,19,4,19
NorthEast Un,3664,4,5,4,5,12,11,1,19
Kolkata,3664,5,4,7,3,15,15,0,19
Chennaiyin,3664,6,4,5,5,14,18,-4,17
FC Pune City,3664,7,4,3,7,12,16,-4,15
FC Goa,3664,8,4,3,7,11,16,-5,15
Mumbai City,3665,1,7,4,3,17,8,9,25
Kolkata,3665,2,5,7,2,19,14,5,22
Delhi Dynamo,3665,3,5,6,3,25,18,7,21
NorthEast Un,3665,4,6,3,5,14,11,3,21
Kerala Blast,3665,5,4,5,5,11,17,-6,17
FC Pune City,3665,6,4,4,6,15,19,-4,16
Chennaiyin,3665,7,3,5,6,15,21,-6,14
FC Goa,3665,8,4,2,8,13,21,-8,14
Mumbai City,3666,1,6,5,3,18,10,8,23
Kolkata,3666,2,5,6,3,18,15,3,21
Delhi Dynamo,3666,3,4,7,3,24,19,5,19
NorthEast Un,3666,4,5,4,5,13,11,2,19
FC Pune City,3666,5,5,3,6,13,16,-3,18
FC Goa,3666,6,5,3,6,13,17,-4,18
Kerala Blast,3666,7,4,4,6,10,16,-6,16
Chennaiyin,3666,8,3,6,5,16,21,-5,15
Delhi Dynamo,3667,1,6,5,3,25,16,9,23
Mumbai City,3667,2,6,4,4,16,10,6,22
Kerala Blast,3667,3,5,5,4,11,14,-3,20
FC Pune City,3667,4,5,4,5,15,16,-1,19
FC Goa,3667,5,5,2,7,17,16,1,17
NorthEast Un,3667,6,5,2,7,12,15,-3,17
Chennaiyin,3667,7,4,5,5,18,22,-4,17
Kolkata,3667,8,3,7,4,14,19,-5,16
Mumbai City,3668,1,7,4,3,19,10,9,25
NorthEast Un,3668,2,6,3,5,14,12,2,21
Kolkata,3668,3,4,7,3,15,13,2,19
FC Goa,3668,4,5,3,6,13,17,-4,18
Kerala Blast,3668,5,4,6,4,12,16,-4,18
Delhi Dynamo,3668,6,4,5,5,25,21,4,17
FC Pune City,3668,7,4,4,6,13,17,-4,16
Chennaiyin,3668,8,3,6,5,15,20,-5,15
Mumbai City,3669,1,6,4,4,16,10,6,22
Delhi Dynamo,3669,2,5,6,3,25,17,8,21
FC Pune City,3669,3,6,3,5,17,15,2,21
NorthEast Un,3669,4,6,3,5,13,11,2,21
Kerala Blast,3669,5,5,4,5,13,17,-4,19
FC Goa,3669,6,5,3,6,14,17,-3,18
Kolkata,3669,7,3,6,5,13,18,-5,15
Chennaiyin,3669,8,3,5,6,14,20,-6,14
Mumbai City,3670,1,7,4,3,17,8,9,25
Kerala Blast,3670,2,6,4,4,13,14,-1,22
Delhi Dynamo,3670,3,5,6,3,23,16,7,21
Kolkata,3670,4,4,8,2,17,13,4,20
NorthEast Un,3670,5,5,3,6,10,11,-1,18
Chennaiyin,3670,6,4,5,5,14,18,-4,17
FC Pune City,3670,7,4,4,6,14,17,-3,16
FC Goa,3670,8,3,2,9,9,20,-11,11
Mumbai City,3671,1,7,4,3,17,8,9,25
Delhi Dynamo,3671,2,5,6,3,25,18,7,21
NorthEast Un,3671,3,5,4,5,12,11,1,19
Kerala Blast,3671,4,5,4,5,12,16,-4,19
FC Pune City,3671,5,4,5,5,15,17,-2,17
FC Goa,3671,6,5,2,7,11,16,-5,17
Kolkata,3671,7,3,7,4,16,17,-1,16
Chennaiyin,3671,8,3,6,5,13,18,-5,15
Delhi Dynamo,3672,1,6,6,2,27,15,12,24
Mumbai City,3672,2,6,5,3,17,9,8,23
Kolkata,3672,3,5,6,3,18,14,4,21
Kerala Blast,3672,4,5,4,5,13,17,-4,19
Chennaiyin,3672,5,4,6,4,17,17,0,18
FC Pune City,3672,6,5,3,6,14,15,-1,18
NorthEast Un,3672,7,4,3,7,12,18,-6,15
FC Goa,3672,8,3,3,8,8,21,-13,12
Mumbai City,3673,1,7,4,3,18,9,9,25
Delhi Dynamo,3673,2,6,5,3,26,18,8,23
Kolkata,3673,3,4,8,2,18,16,2,20
NorthEast Un,3673,4,5,2,7,12,12,0,17
Chennaiyin,3673,5,4,5,5,15,20,-5,17
Kerala Blast,3673,6,4,5,5,10,16,-6,17
FC Pune City,3673,7,4,4,6,14,17,-3,16
FC Goa,3673,8,4,3,7,13,18,-5,15
Mumbai City,3674,1,6,4,4,17,10,7,22
Delhi Dynamo,3674,2,5,6,3,26,21,5,21
NorthEast Un,3674,3,6,3,5,14,12,2,21
Kolkata,3674,4,4,8,2,17,15,2,20
Kerala Blast,3674,5,5,4,5,12,15,-3,19
FC Goa,3674,6,4,4,6,12,15,-3,16
Chennaiyin,3674,7,3,6,5,13,18,-5,15
FC Pune City,3674,7,4,3,7,13,18,-5,15
Mumbai City,3675,1,6,5,3,17,9,8,23
Kolkata,3675,2,5,7,2,22,16,6,22
Kerala Blast,3675,3,6,4,4,19,17,2,22
Delhi Dynamo,3675,4,4,7,3,22,16,6,19
Chennaiyin,3675,5,4,6,4,14,17,-3,18
NorthEast Un,3675,6,4,4,6,10,11,-1,16
FC Pune City,3675,7,4,3,7,13,22,-9,15
FC Goa,3675,8,4,2,8,11,20,-9,14
NorthEast Un,3676,1,7,2,5,18,11,7,23
Mumbai City,3676,2,6,4,4,17,10,7,22
Kolkata,3676,3,5,7,2,22,16,6,22
Delhi Dynamo,3676,4,5,5,4,23,19,4,20
Kerala Blast,3676,5,5,3,6,12,19,-7,18
Chennaiyin,3676,6,4,5,5,17,21,-4,17
FC Pune City,3676,7,4,4,6,14,18,-4,16
FC Goa,3676,8,4,2,8,11,20,-9,14
Mumbai City,3677,1,7,4,3,17,8,9,25
Kerala Blast,3677,2,5,5,4,17,18,-1,20
NorthEast Un,3677,3,5,4,5,17,15,2,19
Kolkata,3677,4,4,7,3,16,18,-2,19
Delhi Dynamo,3677,5,4,6,4,23,18,5,18
Chennaiyin,3677,6,4,5,5,21,21,0,17
FC Goa,3677,7,5,2,7,15,22,-7,17
FC Pune City,3677,8,4,3,7,13,19,-6,15
Mumbai City,3678,1,7,4,3,18,9,9,25
Delhi Dynamo,3678,2,5,6,3,23,16,7,21
Kolkata,3678,3,5,6,3,17,14,3,21
NorthEast Un,3678,4,5,3,6,10,12,-2,18
FC Pune City,3678,5,5,3,6,14,17,-3,18
Chennaiyin,3678,6,4,5,5,16,18,-2,17
FC Goa,3678,7,5,2,7,10,15,-5,17
Kerala Blast,3678,8,4,3,7,9,16,-7,15
Mumbai City,3679,1,6,5,3,17,9,8,23
NorthEast Un,3679,2,7,2,5,14,9,5,23
Delhi Dynamo,3679,3,5,6,3,24,18,6,21
Kolkata,3679,4,4,7,3,17,16,1,19
Kerala Blast,3679,5,5,4,5,12,16,-4,19
FC Pune City,3679,6,5,3,6,15,16,-1,18
Chennaiyin,3679,7,4,5,5,15,18,-3,17
FC Goa,3679,8,3,2,9,9,21,-12,11
Delhi Dynamo,3680,1,6,6,2,26,17,9,24
Mumbai City,3680,2,6,5,3,18,10,8,23
Kolkata,3680,3,4,6,4,18,18,0,18
NorthEast Un,3680,4,5,3,6,11,11,0,18
FC Pune City,3680,5,5,3,6,13,15,-2,18
Kerala Blast,3680,6,5,3,6,14,20,-6,18
Chennaiyin,3680,7,3,7,4,14,18,-4,16
FC Goa,3680,8,4,3,7,12,17,-5,15
Delhi Dynamo,3681,1,6,6,2,29,16,13,24
Mumbai City,3681,2,6,5,3,17,9,8,23
FC Pune City,3681,3,6,3,5,14,14,0,21
Kerala Blast,3681,4,6,3,5,14,15,-1,21
Kolkata,3681,5,3,7,4,15,16,-1,16
Chennaiyin,3681,6,3,6,5,15,20,-5,15
NorthEast Un,3681,7,4,3,7,10,16,-6,15
FC Goa,3681,8,4,3,7,12,20,-8,15
Delhi Dynamo,3682,1,6,5,3,24,16,8,23
Mumbai City,3682,2,6,4,4,17,10,7,22
Kolkata,3682,3,5,7,2,18,15,3,22
NorthEast Un,3682,4,5,3,6,12,12,0,18
FC Pune City,3682,5,5,3,6,14,16,-2,18
FC Goa,3682,6,5,2,7,13,17,-4,17
Kerala Blast,3682,7,4,4,6,10,16,-6,16
Chennaiyin,3682,8,3,6,5,16,22,-6,15
Mumbai City,3683,1,7,4,3,18,9,9,25
Kerala Blast,3683,2,6,4,4,15,16,-1,22
Delhi Dynamo,3683,3,5,6,3,25,16,9,21
FC Pune City,3683,4,5,4,5,15,16,-1,19
Chennaiyin,3683,5,4,5,5,15,19,-4,17
FC Goa,3683,6,5,2,7,12,17,-5,17
NorthEast Un,3683,7,4,3,7,10,13,-3,15
Kolkata,3683,8,3,6,5,14,18,-4,15
Mumbai City,3684,1,6,5,3,18,10,8,23
Delhi Dynamo,3684,2,5,6,3,24,18,6,21
NorthEast Un,3684,3,6,3,5,14,11,3,21
Kerala Blast,3684,4,6,3,5,15,15,0,21
FC Pune City,3684,5,5,3,6,13,17,-4,18
Chennaiyin,3684,6,3,7,4,15,19,-4,16
Kolkata,3684,7,3,6,5,15,18,-3,15
FC Goa,3684,8,4,3,7,10,16,-6,15
Delhi Dynamo,3685,1,6,6,2,26,17,9,24
Mumbai City,3685,2,6,5,3,18,10,8,23
Kolkata,3685,3,4,8,2,15,13,2,20
FC Pune City,3685,4,5,4,5,16,15,1,19
Kerala Blast,3685,5,5,3,6,10,17,-7,18
Chennaiyin,3685,6,4,5,5,15,20,-5,17
FC Goa,3685,7,4,3,7,12,16,-4,15
NorthEast Un,3685,8,4,2,8,9,13,-4,14
Mumbai City,3686,1,6,5,3,16,8,8,23
Delhi Dynamo,3686,2,5,6,3,24,18,6,21
Kolkata,3686,3,5,6,3,18,16,2,21
Chennaiyin,3686,4,5,5,4,17,18,-1,20
Kerala Blast,3686,5,5,4,5,13,15,-2,19
NorthEast Un,3686,6,5,3,6,12,12,0,18
FC Pune City,3686,7,4,3,7,12,20,-8,15
FC Goa,3686,8,4,2,8,13,18,-5,14
Mumbai City,3687,1,7,4,3,18,9,9,25
Kerala Blast,3687,2,6,4,4,15,13,2,22
Kolkata,3687,3,4,8,2,17,14,3,20
Delhi Dynamo,3687,4,4,6,4,25,20,5,18
NorthEast Un,3687,5,5,3,6,12,12,0,18
FC Pune City,3687,6,4,4,6,13,20,-7,16
Chennaiyin,3687,7,3,6,5,15,20,-5,15
FC Goa,3687,8,4,3,7,13,20,-7,15
Delhi Dynamo,3688,1,6,6,2,25,16,9,24
Mumbai City,3688,2,6,4,4,17,10,7,22
Kolkata,3688,3,5,7,2,18,14,4,22
Kerala Blast,3688,4,6,3,5,13,17,-4,21
Chennaiyin,3688,5,4,5,5,15,19,-4,17
NorthEast Un,3688,6,4,3,7,12,14,-2,15
FC Pune City,3688,7,4,3,7,13,17,-4,15
FC Goa,3688,8,4,3,7,11,17,-6,15
Mumbai City,3689,1,7,4,3,17,8,9,25
FC Goa,3689,2,6,2,6,16,17,-1,20
FC Pune City,3689,3,5,4,5,15,15,0,19
Delhi Dynamo,3689,4,4,6,4,25,20,5,18
NorthEast Un,3689,5,5,3,6,13,14,-1,18
Kolkata,3689,6,3,8,3,15,16,-1,17
Chennaiyin,3689,7,4,5,5,16,20,-4,17
Kerala Blast,3689,8,4,4,6,11,18,-7,16
Mumbai City,3690,1,7,4,3,19,9,10,25
Kolkata,3690,2,5,6,3,18,16,2,21
Delhi Dynamo,3690,3,5,5,4,26,21,5,20
NorthEast Un,3690,4,6,2,6,14,12,2,20
Kerala Blast,3690,5,5,4,5,12,17,-5,19
FC Goa,3690,6,5,2,7,12,16,-4,17
FC Pune City,3690,7,4,4,6,14,17,-3,16
Chennaiyin,3690,8,3,5,6,13,20,-7,14
Delhi Dynamo,3691,1,7,5,2,28,15,13,26
Mumbai City,3691,2,6,4,4,17,11,6,22
Kerala Blast,3691,3,6,4,4,16,17,-1,22
Kolkata,3691,4,3,8,3,14,14,0,17
NorthEast Un,3691,5,5,2,7,14,15,-1,17
FC Pune City,3691,6,4,5,5,14,16,-2,17
Chennaiyin,3691,7,4,5,5,16,20,-4,17
FC Goa,3691,8,3,3,8,9,20,-11,12
Mumbai City,3692,1,6,5,3,17,9,8,23
Delhi Dynamo,3692,2,5,6,3,24,17,7,21
NorthEast Un,3692,3,6,2,6,15,13,2,20
Chennaiyin,3692,4,5,5,4,18,19,-1,20
Kolkata,3692,5,4,7,3,16,14,2,19
FC Pune City,3692,6,5,4,5,15,16,-1,19
Kerala Blast,3692,7,4,4,6,12,20,-8,16
FC Goa,3692,8,3,3,8,8,17,-9,12
Mumbai City,3693,1,7,4,3,19,8,11,25
Kerala Blast,3693,2,6,3,5,14,15,-1,21
Delhi Dynamo,3693,3,4,7,3,24,20,4,19
NorthEast Un,3693,4,5,3,6,14,13,1,18
Kolkata,3693,5,4,6,4,17,18,-1,18
FC Goa,3693,6,5,3,6,12,15,-3,18
FC Pune City,3693,7,5,3,6,14,18,-4,18
Chennaiyin,3693,8,3,5,6,13,20,-7,14
Delhi Dynamo,3694,1,6,6,2,27,16,11,24
Mumbai City,3694,2,6,5,3,18,10,8,23
Kerala Blast,3694,3,6,4,4,13,15,-2,22
FC Pune City,3694,4,5,4,5,13,14,-1,19
NorthEast Un,3694,5,5,2,7,13,13,0,17
Kolkata,3694,6,3,6,5,14,18,-4,15
Chennaiyin,3694,7,3,6,5,16,22,-6,15
FC Goa,3694,8,4,3,7,13,19,-6,15
Delhi Dynamo,3695,1,6,6,2,26,16,10,24
Kerala Blast,3695,2,7,3,4,17,17,0,24
Mumbai City,3695,3,6,4,4,16,9,7,22
Kolkata,3695,4,4,6,4,19,18,1,18
FC Pune City,3695,5,5,3,6,16,18,-2,18
NorthEast Un,3695,6,4,4,6,12,13,-1,16
Chennaiyin,3695,7,3,7,4,16,20,-4,16
FC Goa,3695,8,3,3,8,10,21,-11,12
Mumbai City,3696,1,7,4,3,19,10,9,25
Delhi Dynamo,3696,2,5,5,4,27,21,6,20
Kolkata,3696,3,4,8,2,18,14,4,20
Kerala Blast,3696,4,5,4,5,11,17,-6,19
Chennaiyin,3696,5,4,6,4,19,19,0,18
FC Pune City,3696,6,4,5,5,13,15,-2,17
NorthEast Un,3696,7,5,2,7,13,17,-4,17
FC Goa,3696,8,3,4,7,12,19,-7,13
Mumbai City,3697,1,7,4,3,17,8,9,25
FC Pune City,3697,2,5,4,5,14,15,-1,19
Delhi Dynamo,3697,3,4,6,4,24,19,5,18
NorthEast Un,3697,4,5,3,6,13,14,-1,18
FC Goa,3697,5,5,3,6,15,17,-2,18
Kolkata,3697,6,3,8,3,14,15,-1,17
Chennaiyin,3697,7,4,5,5,16,20,-4,17
Kerala Blast,3697,8,4,5,5,11,16,-5,17
Mumbai City,3698,1,7,4,3,19,8,11,25
Kolkata,3698,2,5,6,3,23,16,7,21
NorthEast Un,3698,3,6,2,6,12,13,-1,20
Delhi Dynamo,3698,4,4,6,4,22,19,3,18
Chennaiyin,3698,5,4,6,4,17,18,-1,18
FC Goa,3698,6,4,4,6,13,18,-5,16
FC Pune City,3698,7,4,4,6,15,22,-7,16
Kerala Blast,3698,8,4,4,6,12,19,-7,16
Mumbai City,3699,1,7,4,3,20,8,12,25
Delhi Dynamo,3699,2,4,7,3,22,19,3,19
NorthEast Un,3699,3,5,4,5,15,12,3,19
Kolkata,3699,4,4,7,3,16,15,1,19
FC Pune City,3699,5,5,3,6,14,16,-2,18
Kerala Blast,3699,6,5,3,6,11,18,-7,18
FC Goa,3699,7,4,4,6,13,18,-5,16
Chennaiyin,3699,8,3,6,5,17,22,-5,15
Mumbai City,3700,1,7,4,3,21,8,13,25
Kolkata,3700,2,6,6,2,21,15,6,24
Delhi Dynamo,3700,3,5,5,4,22,20,2,20
Kerala Blast,3700,4,5,4,5,13,17,-4,19
NorthEast Un,3700,5,5,3,6,12,12,0,18
Chennaiyin,3700,6,4,5,5,15,20,-5,17
FC Pune City,3700,7,4,3,7,14,20,-6,15
FC Goa,3700,8,4,2,8,12,18,-6,14
Delhi Dynamo,3701,1,7,5,2,28,15,13,26
Mumbai City,3701,2,6,4,4,17,10,7,22
Kolkata,3701,3,5,6,3,21,16,5,21
Kerala Blast,3701,4,6,3,5,17,18,-1,21
Chennaiyin,3701,5,4,6,4,14,17,-3,18
FC Pune City,3701,6,4,3,7,14,21,-7,15
FC Goa,3701,7,4,3,7,9,17,-8,15
NorthEast Un,3701,8,4,2,8,9,15,-6,14
Delhi Dynamo,3702,1,6,6,2,29,18,11,24
Mumbai City,3702,2,6,4,4,17,11,6,22
Kolkata,3702,3,5,6,3,18,17,1,21
Kerala Blast,3702,4,5,4,5,13,16,-3,19
Chennaiyin,3702,5,4,6,4,16,19,-3,18
NorthEast Un,3702,6,4,5,5,12,12,0,17
FC Pune City,3702,7,4,3,7,12,17,-5,15
FC Goa,3702,8,4,2,8,13,20,-7,14
Mumbai City,3703,1,6,5,3,17,9,8,23
Kerala Blast,3703,2,5,5,4,11,14,-3,20
Delhi Dynamo,3703,3,4,7,3,24,20,4,19
Kolkata,3703,4,3,9,2,16,15,1,18
Chennaiyin,3703,5,4,6,4,16,18,-2,18
FC Pune City,3703,6,4,5,5,15,17,-2,17
FC Goa,3703,7,4,4,6,12,15,-3,16
NorthEast Un,3703,8,4,3,7,12,15,-3,15
Delhi Dynamo,3704,1,6,5,3,25,16,9,23
Mumbai City,3704,2,6,4,4,16,10,6,22
Kolkata,3704,3,5,6,3,16,14,2,21
FC Pune City,3704,4,6,3,5,15,15,0,21
Kerala Blast,3704,5,5,3,6,13,16,-3,18
FC Goa,3704,6,5,2,7,11,16,-5,17
NorthEast Un,3704,7,4,3,7,10,14,-4,15
Chennaiyin,3704,8,3,6,5,13,18,-5,15
Mumbai City,3705,1,7,4,3,19,10,9,25
FC Pune City,3705,2,6,3,5,18,15,3,21
NorthEast Un,3705,3,5,4,5,12,11,1,19
Kolkata,3705,4,4,7,3,16,16,0,19
Delhi Dynamo,3705,5,4,6,4,24,20,4,18
Chennaiyin,3705,6,4,6,4,16,19,-3,18
FC Goa,3705,7,4,3,7,12,17,-5,15
Kerala Blast,3705,8,4,3,7,11,20,-9,15
Mumbai City,3706,1,7,4,3,18,9,9,25
Delhi Dynamo,3706,2,6,5,3,26,18,8,23
Chennaiyin,3706,3,5,5,4,15,17,-2,20
Kolkata,3706,4,4,7,3,16,15,1,19
Kerala Blast,3706,5,4,6,4,12,16,-4,18
FC Pune City,3706,6,4,4,6,14,17,-3,16
NorthEast Un,3706,7,4,3,7,11,13,-2,15
FC Goa,3706,8,4,2,8,10,17,-7,14
Delhi Dynamo,3707,1,7,5,2,27,14,13,26
Mumbai City,3707,2,6,4,4,16,9,7,22
Kerala Blast,3707,3,6,4,4,14,15,-1,22
FC Pune City,3707,4,5,3,6,14,17,-3,18
Kolkata,3707,5,3,7,4,15,17,-2,16
Chennaiyin,3707,6,3,7,4,15,19,-4,16
NorthEast Un,3707,7,4,3,7,11,13,-2,15
FC Goa,3707,8,4,3,7,11,19,-8,15
Mumbai City,3708,1,7,4,3,19,9,10,25
Delhi Dynamo,3708,2,5,5,4,28,21,7,20
NorthEast Un,3708,3,6,2,6,14,13,1,20
FC Pune City,3708,4,5,4,5,15,16,-1,19
Kerala Blast,3708,5,5,3,6,13,17,-4,18
Chennaiyin,3708,6,4,5,5,17,22,-5,17
FC Goa,3708,7,5,2,7,15,20,-5,17
Kolkata,3708,8,3,7,4,15,18,-3,16
Mumbai City,3709,1,7,4,3,17,8,9,25
Kerala Blast,3709,2,6,4,4,12,13,-1,22
FC Pune City,3709,3,5,4,5,15,16,-1,19
FC Goa,3709,4,5,3,6,17,18,-1,18
Chennaiyin,3709,5,4,6,4,17,19,-2,18
Delhi Dynamo,3709,6,4,5,5,22,21,1,17
NorthEast Un,3709,7,5,2,7,10,12,-2,17
Kolkata,3709,8,3,6,5,16,19,-3,15
Mumbai City,3710,1,6,5,3,16,8,8,23
Kolkata,3710,2,5,7,2,16,13,3,22
Chennaiyin,3710,3,5,5,4,18,20,-2,20
Delhi Dynamo,3710,4,4,7,3,23,17,6,19
Kerala Blast,3710,5,5,4,5,10,14,-4,19
NorthEast Un,3710,6,5,3,6,12,12,0,18
FC Pune City,3710,7,4,3,7,12,16,-4,15
FC Goa,3710,8,3,4,7,12,19,-7,13
Delhi Dynamo,3711,1,6,6,2,25,16,9,24
Mumbai City,3711,2,6,5,3,17,9,8,23
Kolkata,3711,3,4,8,2,17,14,3,20
FC Pune City,3711,4,5,4,5,17,16,1,19
Chennaiyin,3711,5,4,6,4,15,18,-3,18
NorthEast Un,3711,6,5,2,7,11,12,-1,17
Kerala Blast,3711,7,4,3,7,10,20,-10,15
FC Goa,3711,8,3,4,7,10,17,-7,13
Mumbai City,3712,1,7,4,3,20,8,12,25
Kolkata,3712,2,5,6,3,18,15,3,21
Kerala Blast,3712,3,6,3,5,13,15,-2,21
Delhi Dynamo,3712,4,5,5,4,23,19,4,20
Chennaiyin,3712,5,4,6,4,14,17,-3,18
NorthEast Un,3712,6,5,2,7,10,11,-1,17
FC Pune City,3712,7,4,3,7,12,18,-6,15
FC Goa,3712,8,4,3,7,10,17,-7,15
Mumbai City,3713,1,7,4,3,17,8,9,25
Kolkata,3713,2,5,7,2,19,15,4,22
Delhi Dynamo,3713,3,5,6,3,23,16,7,21
Chennaiyin,3713,4,5,5,4,16,18,-2,20
FC Pune City,3713,5,5,3,6,15,18,-3,18
Kerala Blast,3713,6,5,3,6,13,18,-5,18
NorthEast Un,3713,7,4,3,7,10,12,-2,15
FC Goa,3713,8,3,3,8,9,17,-8,12
Delhi Dynamo,3714,1,7,5,2,25,15,10,26
Mumbai City,3714,2,6,4,4,16,9,7,22
Kolkata,3714,3,5,7,2,20,14,6,22
FC Pune City,3714,4,5,4,5,17,18,-1,19
NorthEast Un,3714,5,5,3,6,13,13,0,18
Chennaiyin,3714,6,4,6,4,15,18,-3,18
Kerala Blast,3714,7,4,3,7,12,21,-9,15
FC Goa,3714,8,3,2,9,8,18,-10,11
Mumbai City,3715,1,7,4,3,18,9,9,25
Delhi Dynamo,3715,2,5,5,4,27,18,9,20
Kolkata,3715,3,4,7,3,18,16,2,19
NorthEast Un,3715,4,5,4,5,13,11,2,19
FC Pune City,3715,5,5,3,6,14,17,-3,18
Kerala Blast,3715,6,4,5,5,11,16,-5,17
Chennaiyin,3715,7,3,7,4,14,18,-4,16
FC Goa,3715,8,4,3,7,10,20,-10,15
Mumbai City,3716,1,7,4,3,18,8,10,25
Kerala Blast,3716,2,5,5,4,16,16,0,20
NorthEast Un,3716,3,6,2,6,14,15,-1,20
FC Goa,3716,4,5,3,6,13,17,-4,18
Delhi Dynamo,3716,5,4,5,5,26,24,2,17
Kolkata,3716,6,3,8,3,15,15,0,17
FC Pune City,3716,7,4,5,5,17,19,-2,17
Chennaiyin,3716,8,3,6,5,13,18,-5,15
Mumbai City,3717,1,7,4,3,17,8,9,25
Kolkata,3717,2,5,7,2,19,16,3,22
Kerala Blast,3717,3,6,4,4,18,15,3,22
Chennaiyin,3717,4,4,6,4,19,18,1,18
NorthEast Un,3717,5,5,3,6,14,14,0,18
Delhi Dynamo,3717,6,4,5,5,23,20,3,17
FC Pune City,3717,7,4,3,7,12,20,-8,15
FC Goa,3717,8,4,2,8,13,24,-11,14
Delhi Dynamo,3718,1,5,7,2,26,18,8,22
Mumbai City,3718,2,6,4,4,17,10,7,22
Kolkata,3718,3,5,7,2,18,15,3,22
Chennaiyin,3718,4,5,5,4,18,17,1,20
Kerala Blast,3718,5,5,4,5,13,16,-3,19
NorthEast Un,3718,6,4,4,6,11,13,-2,16
FC Pune City,3718,7,4,3,7,12,17,-5,15
FC Goa,3718,8,3,4,7,12,21,-9,13
Mumbai City,3719,1,7,4,3,19,8,11,25
Kolkata,3719,2,5,7,2,19,12,7,22
NorthEast Un,3719,3,6,2,6,13,12,1,20
FC Pune City,3719,4,5,4,5,14,14,0,19
Chennaiyin,3719,5,4,6,4,15,18,-3,18
Delhi Dynamo,3719,6,4,5,5,24,23,1,17
FC Goa,3719,7,4,3,7,12,20,-8,15
Kerala Blast,3719,8,4,3,7,9,18,-9,15
Delhi Dynamo,3720,1,5,7,2,24,16,8,22
Mumbai City,3720,2,6,4,4,18,11,7,22
FC Pune City,3720,3,6,3,5,18,15,3,21
NorthEast Un,3720,4,5,4,5,12,11,1,19
Kerala Blast,3720,5,5,4,5,14,19,-5,19
Kolkata,3720,6,3,7,4,17,20,-3,16
Chennaiyin,3720,7,3,6,5,15,20,-5,15
FC Goa,3720,8,3,5,6,11,17,-6,14
Mumbai City,3721,1,6,5,3,17,9,8,23
NorthEast Un,3721,2,6,3,5,15,12,3,21
Kerala Blast,3721,3,6,3,5,17,15,2,21
Kolkata,3721,4,5,6,3,17,17,0,21
Delhi Dynamo,3721,5,4,6,4,24,20,4,18
FC Goa,3721,6,5,2,7,13,18,-5,17
Chennaiyin,3721,7,3,6,5,15,20,-5,15
FC Pune City,3721,8,4,3,7,12,19,-7,15
Mumbai City,3722,1,7,4,3,18,8,10,25
FC Pune City,3722,2,6,3,5,15,14,1,21
Delhi Dynamo,3722,3,5,5,4,22,17,5,20
Kerala Blast,3722,4,5,4,5,12,14,-2,19
NorthEast Un,3722,5,5,3,6,11,13,-2,18
FC Goa,3722,6,5,2,7,14,17,-3,17
Kolkata,3722,7,3,7,4,14,17,-3,16
Chennaiyin,3722,8,3,6,5,15,21,-6,15
Mumbai City,3723,1,7,4,3,17,8,9,25
Kolkata,3723,2,5,7,2,17,13,4,22
Delhi Dynamo,3723,3,5,6,3,23,15,8,21
Chennaiyin,3723,4,5,5,4,16,18,-2,20
FC Pune City,3723,5,5,4,5,14,15,-1,19
NorthEast Un,3723,6,5,3,6,11,10,1,18
Kerala Blast,3723,7,4,3,7,9,18,-9,15
FC Goa,3723,8,3,2,9,9,19,-10,11
Delhi Dynamo,3724,1,6,6,2,26,17,9,24
Mumbai City,3724,2,6,5,3,17,9,8,23
Kolkata,3724,3,4,8,2,15,12,3,20
NorthEast Un,3724,4,5,2,7,12,13,-1,17
FC Pune City,3724,5,4,5,5,13,15,-2,17
Chennaiyin,3724,6,4,5,5,14,18,-4,17
Kerala Blast,3724,7,4,4,6,10,17,-7,16
FC Goa,3724,8,4,3,7,9,15,-6,15
Mumbai City,3725,1,6,5,3,17,9,8,23
FC Pune City,3725,2,6,3,5,16,15,1,21
NorthEast Un,3725,3,6,2,6,12,10,2,20
Delhi Dynamo,3725,4,4,6,4,23,20,3,18
Kolkata,3725,5,4,6,4,17,17,0,18
Kerala Blast,3725,6,5,3,6,10,16,-6,18
Chennaiyin,3725,7,4,5,5,15,19,-4,17
FC Goa,3725,8,5,2,7,14,18,-4,17
Delhi Dynamo,3726,1,6,5,3,28,18,10,23
Mumbai City,3726,2,6,4,4,17,12,5,22
Kerala Blast,3726,3,5,4,5,11,15,-4,19
NorthEast Un,3726,4,5,3,6,12,12,0,18
FC Pune City,3726,5,5,3,6,14,16,-2,18
Chennaiyin,3726,6,4,6,4,15,18,-3,18
Kolkata,3726,7,3,8,3,17,17,0,17
FC Goa,3726,8,4,3,7,12,18,-6,15
Mumbai City,3727,1,7,4,3,19,9,10,25
Delhi Dynamo,3727,2,5,5,4,27,21,6,20
FC Goa,3727,3,6,2,6,17,16,1,20
Kerala Blast,3727,4,5,4,5,12,16,-4,19
Kolkata,3727,5,4,6,4,20,16,4,18
NorthEast Un,3727,6,5,2,7,10,14,-4,17
Chennaiyin,3727,7,4,5,5,14,20,-6,17
FC Pune City,3727,8,4,4,6,13,20,-7,16
Kerala Blast,3728,1,7,3,4,20,14,6,24
Mumbai City,3728,2,6,5,3,19,11,8,23
Delhi Dynamo,3728,3,5,6,3,30,23,7,21
Kolkata,3728,4,5,6,3,21,21,0,21
NorthEast Un,3728,5,5,3,6,14,13,1,18
Chennaiyin,3728,6,3,6,5,14,19,-5,15
FC Pune City,3728,7,4,3,7,14,23,-9,15
FC Goa,3728,8,4,2,8,12,20,-8,14
Mumbai City,3729,1,7,4,3,17,8,9,25
Kerala Blast,3729,2,7,3,4,12,13,-1,24
Delhi Dynamo,3729,3,5,5,4,23,17,6,20
FC Pune City,3729,4,5,3,6,13,15,-2,18
NorthEast Un,3729,5,5,2,7,11,11,0,17
FC Goa,3729,6,5,2,7,15,17,-2,17
Chennaiyin,3729,7,4,5,5,14,19,-5,17
Kolkata,3729,8,3,6,5,14,19,-5,15
Mumbai City,3730,1,6,5,3,16,8,8,23
Kolkata,3730,2,5,6,3,18,16,2,21
Chennaiyin,3730,3,5,5,4,20,17,3,20
NorthEast Un,3730,4,6,2,6,12,13,-1,20
Delhi Dynamo,3730,5,4,7,3,24,18,6,19
Kerala Blast,3730,6,5,3,6,11,17,-6,18
FC Pune City,3730,7,4,3,7,12,17,-5,15
FC Goa,3730,8,4,3,7,13,20,-7,15
Mumbai City,3731,1,6,4,4,16,9,7,22
Delhi Dynamo,3731,2,5,6,3,23,16,7,21
Kerala Blast,3731,3,6,3,5,16,18,-2,21
FC Pune City,3731,4,5,4,5,14,15,-1,19
NorthEast Un,3731,5,5,3,6,13,14,-1,18
FC Goa,3731,6,5,3,6,11,15,-4,18
Kolkata,3731,7,3,8,3,15,15,0,17
Chennaiyin,3731,8,3,5,6,15,21,-6,14
Mumbai City,3732,1,7,4,3,19,8,11,25
Delhi Dynamo,3732,2,5,6,3,24,18,6,21
Kolkata,3732,3,5,6,3,16,13,3,21
Kerala Blast,3732,4,5,4,5,10,15,-5,19
FC Pune City,3732,5,5,3,6,14,16,-2,18
NorthEast Un,3732,6,4,5,5,10,10,0,17
Chennaiyin,3732,7,3,6,5,14,20,-6,15
FC Goa,3732,8,4,2,8,11,18,-7,14
Mumbai City,3733,1,7,4,3,18,9,9,25
Delhi Dynamo,3733,2,5,6,3,24,17,7,21
FC Pune City,3733,3,6,3,5,15,15,0,21
Kolkata,3733,4,4,7,3,14,13,1,19
Kerala Blast,3733,5,5,4,5,12,16,-4,19
Chennaiyin,3733,6,4,6,4,16,19,-3,18
NorthEast Un,3733,7,4,4,6,12,13,-1,16
FC Goa,3733,8,3,2,9,9,18,-9,11
Mumbai City,3734,1,7,4,3,18,8,10,25
FC Pune City,3734,2,5,4,5,14,15,-1,19
Kerala Blast,3734,3,5,4,5,12,15,-3,19
Delhi Dynamo,3734,4,4,6,4,23,19,4,18
FC Goa,3734,5,5,3,6,13,17,-4,18
Kolkata,3734,6,3,8,3,15,15,0,17
NorthEast Un,3734,7,5,2,7,12,14,-2,17
Chennaiyin,3734,8,4,5,5,17,21,-4,17
Mumbai City,3735,1,6,5,3,17,9,8,23
Kolkata,3735,2,5,6,3,18,16,2,21
Delhi Dynamo,3735,3,4,8,2,25,18,7,20
NorthEast Un,3735,4,5,3,6,13,13,0,18
FC Pune City,3735,5,5,3,6,16,18,-2,18
Kerala Blast,3735,6,5,3,6,12,19,-7,18
FC Goa,3735,7,4,4,6,14,17,-3,16
Chennaiyin,3735,8,3,6,5,15,20,-5,15
Mumbai City,3736,1,7,4,3,19,9,10,25
NorthEast Un,3736,2,6,2,6,15,10,5,20
Delhi Dynamo,3736,3,5,5,4,23,20,3,20
Chennaiyin,3736,4,5,5,4,15,17,-2,20
Kolkata,3736,5,4,7,3,15,14,1,19
FC Pune City,3736,6,5,3,6,15,17,-2,18
Kerala Blast,3736,7,4,4,6,11,19,-8,16
FC Goa,3736,8,4,2,8,10,17,-7,14
Mumbai City,3737,1,6,4,4,16,9,7,22
Delhi Dynamo,3737,2,5,6,3,23,16,7,21
Kerala Blast,3737,3,6,3,5,14,16,-2,21
Chennaiyin,3737,4,5,5,4,20,18,2,20
Kolkata,3737,5,4,6,4,18,17,1,18
FC Pune City,3737,6,5,3,6,14,19,-5,18
NorthEast Un,3737,7,5,2,7,12,15,-3,17
FC Goa,3737,8,4,3,7,10,17,-7,15
Mumbai City,3738,1,7,4,3,19,8,11,25
Kerala Blast,3738,2,5,5,4,13,15,-2,20
Kolkata,3738,3,4,7,3,16,15,1,19
NorthEast Un,3738,4,5,3,6,14,14,0,18
Delhi Dynamo,3738,5,4,5,5,23,22,1,17
FC Pune City,3738,6,4,5,5,14,16,-2,17
Chennaiyin,3738,7,4,5,5,17,20,-3,17
FC Goa,3738,8,5,2,7,12,18,-6,17
Delhi Dynamo,3739,1,6,5,3,24,15,9,23
Mumbai City,3739,2,6,4,4,16,9,7,22
FC Pune City,3739,3,6,3,5,18,17,1,21
Kolkata,3739,4,4,7,3,16,15,1,19
NorthEast Un,3739,5,5,3,6,12,12,0,18
Kerala Blast,3739,6,5,3,6,12,18,-6,18
Chennaiyin,3739,7,3,6,5,16,21,-5,15
FC Goa,3739,8,4,3,7,11,18,-7,15
Mumbai City,3740,1,6,4,4,16,11,5,22
Delhi Dynamo,3740,2,5,6,3,27,19,8,21
NorthEast Un,3740,3,6,3,5,15,11,4,21
FC Pune City,3740,4,6,3,5,14,14,0,21
Kerala Blast,3740,5,5,4,5,12,16,-4,19
Chennaiyin,3740,6,4,5,5,16,21,-5,17
Kolkata,3740,7,3,7,4,14,15,-1,16
FC Goa,3740,8,3,4,7,12,19,-7,13
Delhi Dynamo,3741,1,6,6,2,26,16,10,24
Kolkata,3741,2,6,6,2,19,12,7,24
Mumbai City,3741,3,6,4,4,16,10,6,22
Chennaiyin,3741,4,4,5,5,16,18,-2,17
Kerala Blast,3741,5,4,5,5,11,18,-7,17
FC Pune City,3741,6,4,4,6,13,17,-4,16
NorthEast Un,3741,7,4,3,7,10,14,-4,15
FC Goa,3741,8,4,3,7,11,17,-6,15
Mumbai City,3742,1,6,4,4,18,11,7,22
Kerala Blast,3742,2,6,4,4,12,14,-2,22
Delhi Dynamo,3742,3,5,5,4,26,21,5,20
NorthEast Un,3742,4,6,2,6,13,12,1,20
Kolkata,3742,5,3,9,2,17,16,1,18
Chennaiyin,3742,6,4,5,5,16,20,-4,17
FC Pune City,3742,7,4,4,6,12,15,-3,16
FC Goa,3742,8,4,3,7,15,20,-5,15
Mumbai City,3743,1,6,5,3,18,10,8,23
Delhi Dynamo,3743,2,4,8,2,26,19,7,20
Kolkata,3743,3,4,7,3,16,15,1,19
NorthEast Un,3743,4,5,3,6,12,13,-1,18
FC Goa,3743,5,5,3,6,11,15,-4,18
FC Pune City,3743,6,4,5,5,13,15,-2,17
Chennaiyin,3743,7,4,5,5,15,18,-3,17
Kerala Blast,3743,8,4,4,6,10,16,-6,16
Mumbai City,3744,1,6,5,3,17,9,8,23
Delhi Dynamo,3744,2,5,7,2,26,17,9,22
Kerala Blast,3744,3,6,4,4,16,16,0,22
Kolkata,3744,4,4,7,3,19,18,1,19
Chennaiyin,3744,5,3,7,4,14,18,-4,16
FC Goa,3744,6,4,4,6,13,18,-5,16
NorthEast Un,3744,7,4,3,7,11,15,-4,15
FC Pune City,3744,8,4,3,7,13,18,-5,15
Mumbai City,3745,1,7,4,3,17,8,9,25
Kolkata,3745,2,5,6,3,17,14,3,21
Kerala Blast,3745,3,6,3,5,16,17,-1,21
Delhi Dynamo,3745,4,5,5,4,24,17,7,20
NorthEast Un,3745,5,5,3,6,12,13,-1,18
Chennaiyin,3745,6,4,6,4,15,17,-2,18
FC Pune City,3745,7,5,3,6,16,19,-3,18
FC Goa,3745,8,3,2,9,8,20,-12,11
Mumbai City,3746,1,7,4,3,17,8,9,25
NorthEast Un,3746,2,6,3,5,15,10,5,21
Kolkata,3746,3,4,8,2,15,13,2,20
Kerala Blast,3746,4,5,5,4,12,14,-2,20
FC Goa,3746,5,5,3,6,13,16,-3,18
Delhi Dynamo,3746,6,4,5,5,21,19,2,17
FC Pune City,3746,7,4,3,7,12,17,-5,15
Chennaiyin,3746,8,3,5,6,14,22,-8,14
Kerala Blast,3747,1,7,3,4,15,14,1,24
Mumbai City,3747,2,6,5,3,17,9,8,23
Delhi Dynamo,3747,3,5,6,3,24,18,6,21
Kolkata,3747,4,4,6,4,17,20,-3,18
NorthEast Un,3747,5,5,2,7,12,12,0,17
FC Goa,3747,6,5,2,7,14,17,-3,17
Chennaiyin,3747,7,4,5,5,16,20,-4,17
FC Pune City,3747,8,4,3,7,13,18,-5,15
Delhi Dynamo,3748,1,6,6,2,30,18,12,24
Mumbai City,3748,2,6,4,4,17,13,4,22
Kolkata,3748,3,4,7,3,14,13,1,19
FC Pune City,3748,4,5,4,5,14,14,0,19
NorthEast Un,3748,5,5,3,6,13,13,0,18
FC Goa,3748,6,5,3,6,12,16,-4,18
Chennaiyin,3748,7,3,6,5,15,20,-5,15
Kerala Blast,3748,8,4,3,7,9,17,-8,15
Mumbai City,3749,1,7,4,3,17,8,9,25
Delhi Dynamo,3749,2,4,7,3,25,19,6,19
Kolkata,3749,3,4,7,3,18,17,1,19
Kerala Blast,3749,4,5,4,5,14,18,-4,19
NorthEast Un,3749,5,5,3,6,14,14,0,18
FC Pune City,3749,6,4,5,5,16,18,-2,17
FC Goa,3749,7,4,4,6,11,16,-5,16
Chennaiyin,3749,8,3,6,5,15,20,-5,15
Delhi Dynamo,3750,1,6,5,3,26,17,9,23
Mumbai City,3750,2,6,4,4,17,11,6,22
Kolkata,3750,3,5,6,3,16,15,1,21
Chennaiyin,3750,4,5,5,4,18,19,-1,20
FC Pune City,3750,5,5,3,6,14,16,-2,18
Kerala Blast,3750,6,5,3,6,12,17,-5,18
FC Goa,3750,7,5,2,7,14,17,-3,17
NorthEast Un,3750,8,4,2,8,10,15,-5,14
Mumbai City,3751,1,7,4,3,18,9,9,25
NorthEast Un,3751,2,7,2,5,15,10,5,23
Delhi Dynamo,3751,3,5,5,4,26,20,6,20
Kolkata,3751,4,4,8,2,21,16,5,20
Kerala Blast,3751,5,5,3,6,11,18,-7,18
FC Pune City,3751,6,4,4,6,13,17,-4,16
FC Goa,3751,7,4,3,7,14,20,-6,15
Chennaiyin,3751,8,3,5,6,13,21,-8,14
Mumbai City,3752,1,7,4,3,17,8,9,25
Kerala Blast,3752,2,7,3,4,14,13,1,24
Delhi Dynamo,3752,3,5,5,4,24,18,6,20
Chennaiyin,3752,4,5,5,4,17,17,0,20
Kolkata,3752,5,3,8,3,16,16,0,17
NorthEast Un,3752,6,5,2,7,11,14,-3,17
FC Pune City,3752,7,4,4,6,14,18,-4,16
FC Goa,3752,8,3,3,8,10,19,-9,12
Mumbai City,3753,1,7,4,3,20,11,9,25
NorthEast Un,3753,2,6,2,6,12,11,1,20
Kolkata,3753,3,4,7,3,18,16,2,19
Delhi Dynamo,3753,4,4,6,4,25,20,5,18
Chennaiyin,3753,5,4,6,4,15,18,-3,18
FC Pune City,3753,5,5,3,6,15,18,-3,18
FC Goa,3753,7,4,4,6,12,16,-4,16
Kerala Blast,3753,8,4,4,6,9,16,-7,16
Delhi Dynamo,3754,1,6,6,2,26,16,10,24
Mumbai City,3754,2,6,5,3,16,8,8,23
FC Pune City,3754,3,6,3,5,16,14,2,21
NorthEast Un,3754,4,5,3,6,14,15,-1,18
Kolkata,3754,5,4,6,4,15,17,-2,18
FC Goa,3754,6,5,2,7,14,18,-4,17
Chennaiyin,3754,7,3,6,5,16,21,-5,15
Kerala Blast,3754,8,4,3,7,12,20,-8,15
Mumbai City,3755,1,6,5,3,18,10,8,23
Delhi Dynamo,3755,2,4,8,2,24,17,7,20
Kolkata,3755,3,4,8,2,23,18,5,20
NorthEast Un,3755,4,5,4,5,11,10,1,19
Kerala Blast,3755,5,5,4,5,11,18,-7,19
FC Pune City,3755,6,4,4,6,16,19,-3,16
Chennaiyin,3755,7,3,6,5,15,20,-5,15
FC Goa,3755,8,3,5,6,13,19,-6,14
Mumbai City,3756,1,7,4,3,19,10,9,25
Delhi Dynamo,3756,2,5,5,4,25,19,6,20
Kolkata,3756,3,4,8,2,17,15,2,20
NorthEast Un,3756,4,5,4,5,14,13,1,19
Kerala Blast,3756,5,4,6,4,11,15,-4,18
FC Pune City,3756,6,4,5,5,15,17,-2,17
Chennaiyin,3756,7,3,7,4,17,21,-4,16
FC Goa,3756,8,3,3,8,9,17,-8,12
Delhi Dynamo,3757,1,6,5,3,25,17,8,23
Mumbai City,3757,2,6,4,4,16,9,7,22
Kolkata,3757,3,4,8,2,14,12,2,20
FC Pune City,3757,4,5,4,5,15,16,-1,19
Kerala Blast,3757,5,5,4,5,14,17,-3,19
NorthEast Un,3757,6,5,2,7,14,15,-1,17
Chennaiyin,3757,7,3,6,5,14,20,-6,15
FC Goa,3757,8,4,3,7,10,16,-6,15
Mumbai City,3758,1,6,5,3,17,9,8,23
Delhi Dynamo,3758,2,5,7,2,28,17,11,22
Kolkata,3758,3,5,6,3,18,16,2,21
NorthEast Un,3758,4,5,4,5,15,13,2,19
Kerala Blast,3758,5,5,4,5,13,17,-4,19
FC Pune City,3758,6,5,3,6,16,18,-2,18
Chennaiyin,3758,7,3,6,5,13,19,-6,15
FC Goa,3758,8,3,3,8,9,20,-11,12
Mumbai City,3759,1,7,4,3,18,9,9,25
Delhi Dynamo,3759,2,6,5,3,28,18,10,23
Kolkata,3759,3,5,7,2,15,12,3,22
Kerala Blast,3759,4,5,4,5,10,14,-4,19
Chennaiyin,3759,5,4,6,4,17,19,-2,18
NorthEast Un,3759,6,4,3,7,11,14,-3,15
FC Pune City,3759,7,4,3,7,12,16,-4,15
FC Goa,3759,8,3,4,7,10,19,-9,13
Mumbai City,3760,1,7,4,3,19,9,10,25
Delhi Dynamo,3760,2,5,6,3,26,20,6,21
Kerala Blast,3760,3,5,5,4,13,16,-3,20
FC Pune City,3760,4,5,4,5,14,15,-1,19
NorthEast Un,3760,5,5,2,7,13,12,1,17
Kolkata,3760,6,3,7,4,16,18,-2,16
FC Goa,3760,7,4,4,6,13,17,-4,16
Chennaiyin,3760,8,3,6,5,13,20,-7,15
Mumbai City,3761,1,6,5,3,16,8,8,23
Kolkata,3761,2,5,7,2,17,14,3,22
Chennaiyin,3761,3,5,5,4,15,17,-2,20
Delhi Dynamo,3761,4,4,7,3,21,16,5,19
FC Pune City,3761,5,4,5,5,16,18,-2,17
Kerala Blast,3761,6,4,5,5,13,18,-5,17
NorthEast Un,3761,7,4,4,6,11,12,-1,16
FC Goa,3761,8,4,2,8,10,16,-6,14
Mumbai City,3762,1,6,5,3,18,10,8,23
Kerala Blast,3762,2,6,3,5,11,14,-3,21
NorthEast Un,3762,3,6,2,6,13,12,1,20
Delhi Dynamo,3762,4,4,7,3,26,20,6,19
FC Pune City,3762,5,5,4,5,13,14,-1,19
Kolkata,3762,6,3,8,3,14,14,0,17
Chennaiyin,3762,7,3,6,5,14,19,-5,15
FC Goa,3762,8,3,5,6,11,17,-6,14
Delhi Dynamo,3763,1,6,5,3,27,17,10,23
Mumbai City,3763,2,6,4,4,16,10,6,22
Kolkata,3763,3,5,6,3,17,14,3,21
FC Goa,3763,4,6,2,6,14,15,-1,20
NorthEast Un,3763,5,5,3,6,15,17,-2,18
Kerala Blast,3763,6,5,3,6,15,19,-4,18
Chennaiyin,3763,7,3,6,5,16,22,-6,15
FC Pune City,3763,8,4,3,7,13,19,-6,15
Mumbai City,3764,1,7,4,3,17,8,9,25
Delhi Dynamo,3764,2,6,5,3,25,16,9,23
Kerala Blast,3764,3,5,5,4,14,16,-2,20
Kolkata,3764,4,4,6,4,16,16,0,18
FC Goa,3764,5,5,2,7,12,18,-6,17
NorthEast Un,3764,6,4,4,6,10,11,-1,16
FC Pune City,3764,7,4,4,6,14,18,-4,16
Chennaiyin,3764,8,3,6,5,13,18,-5,15
NorthEast Un,3765,1,7,2,5,13,9,4,23
Mumbai City,3765,2,6,4,4,17,10,7,22
Kolkata,3765,3,5,6,3,16,14,2,21
Delhi Dynamo,3765,4,5,5,4,23,20,3,20
Kerala Blast,3765,5,5,4,5,12,16,-4,19
FC Goa,3765,6,5,2,7,14,16,-2,17
FC Pune City,3765,7,4,4,6,13,16,-3,16
Chennaiyin,3765,8,3,5,6,14,21,-7,14
Delhi Dynamo,3766,1,7,5,2,28,17,11,26
Mumbai City,3766,2,6,4,4,17,10,7,22
Kolkata,3766,3,5,7,2,19,14,5,22
NorthEast Un,3766,4,5,3,6,10,10,0,18
Chennaiyin,3766,5,4,6,4,15,18,-3,18
Kerala Blast,3766,6,5,3,6,10,17,-7,18
FC Pune City,3766,7,4,3,7,13,17,-4,15
FC Goa,3766,8,3,3,8,12,21,-9,12
NorthEast Un,3767,1,7,2,5,18,10,8,23
Delhi Dynamo,3767,2,6,5,3,27,20,7,23
Mumbai City,3767,3,6,4,4,17,10,7,22
Kolkata,3767,4,4,7,3,17,16,1,19
Kerala Blast,3767,5,5,4,5,13,17,-4,19
FC Goa,3767,6,5,2,7,14,19,-5,17
FC Pune City,3767,7,4,3,7,13,18,-5,15
Chennaiyin,3767,8,3,5,6,13,22,-9,14
Mumbai City,3768,1,6,4,4,16,12,4,22
Delhi Dynamo,3768,2,5,5,4,26,18,8,20
FC Goa,3768,3,6,2,6,13,14,-1,20
FC Pune City,3768,4,5,4,5,14,15,-1,19
Kerala Blast,3768,5,5,4,5,13,17,-4,19
NorthEast Un,3768,6,5,3,6,11,11,0,18
Kolkata,3768,7,4,6,4,16,17,-1,18
Chennaiyin,3768,8,3,6,5,13,18,-5,15
Delhi Dynamo,3769,1,6,6,2,27,17,10,24
Mumbai City,3769,2,6,4,4,17,11,6,22
Kolkata,3769,3,4,7,3,15,15,0,19
Kerala Blast,3769,4,5,4,5,10,16,-6,19
FC Goa,3769,5,5,3,6,13,16,-3,18
NorthEast Un,3769,6,5,2,7,13,12,1,17
Chennaiyin,3769,7,4,5,5,15,19,-4,17
FC Pune City,3769,8,4,3,7,13,17,-4,15
Mumbai City,3770,1,7,4,3,19,10,9,25
Kerala Blast,3770,2,7,3,4,19,17,2,24
Delhi Dynamo,3770,3,6,5,3,28,19,9,23
Kolkata,3770,4,4,6,4,17,17,0,18
FC Pune City,3770,5,5,3,6,16,19,-3,18
NorthEast Un,3770,6,4,3,7,12,16,-4,15
Chennaiyin,3770,7,3,6,5,16,22,-6,15
FC Goa,3770,8,4,2,8,14,21,-7,14
Mumbai City,3771,1,6,5,3,18,10,8,23
Delhi Dynamo,3771,2,5,7,2,26,18,8,22
Kolkata,3771,3,5,6,3,17,14,3,21
Kerala Blast,3771,4,5,5,4,10,13,-3,20
Chennaiyin,3771,5,4,6,4,18,18,0,18
FC Pune City,3771,6,4,4,6,12,15,-3,16
NorthEast Un,3771,7,4,4,6,11,15,-4,16
FC Goa,3771,8,3,3,8,10,19,-9,12
Mumbai City,3772,1,6,5,3,18,10,8,23
Kerala Blast,3772,2,6,4,4,12,14,-2,22
Chennaiyin,3772,3,5,5,4,18,20,-2,20
Delhi Dynamo,3772,4,4,6,4,23,19,4,18
NorthEast Un,3772,5,5,3,6,14,13,1,18
Kolkata,3772,6,4,6,4,15,15,0,18
FC Pune City,3772,7,5,3,6,13,15,-2,18
FC Goa,3772,8,4,2,8,11,18,-7,14
Delhi Dynamo,3773,1,6,6,2,29,17,12,24
Mumbai City,3773,2,6,5,3,18,10,8,23
Kerala Blast,3773,3,6,4,4,16,15,1,22
Kolkata,3773,4,4,7,3,18,16,2,19
Chennaiyin,3773,5,4,6,4,17,20,-3,18
NorthEast Un,3773,6,4,3,7,11,13,-2,15
FC Pune City,3773,7,4,3,7,13,21,-8,15
FC Goa,3773,8,3,4,7,12,22,-10,13
Mumbai City,3774,1,6,5,3,16,8,8,23
NorthEast Un,3774,2,7,2,5,15,10,5,23
Kolkata,3774,3,5,6,3,16,14,2,21
Delhi Dynamo,3774,4,4,7,3,23,17,6,19
FC Goa,3774,5,5,3,6,15,16,-1,18
Kerala Blast,3774,6,5,3,6,12,19,-7,18
FC Pune City,3774,7,4,3,7,14,18,-4,15
Chennaiyin,3774,8,3,5,6,14,23,-9,14
Mumbai City,3775,1,7,4,3,19,8,11,25
Kolkata,3775,2,5,6,3,20,14,6,21
NorthEast Un,3775,3,6,3,5,16,14,2,21
Kerala Blast,3775,4,6,3,5,13,16,-3,21
Delhi Dynamo,3775,5,4,7,3,22,18,4,19
Chennaiyin,3775,6,3,6,5,16,21,-5,15
FC Pune City,3775,7,4,3,7,12,18,-6,15
FC Goa,3775,8,3,4,7,8,17,-9,13
Mumbai City,3776,1,6,5,3,17,9,8,23
Delhi Dynamo,3776,2,5,6,3,28,18,10,21
FC Pune City,3776,3,6,3,5,15,15,0,21
FC Goa,3776,4,5,3,6,16,18,-2,18
Chennaiyin,3776,5,4,6,4,16,19,-3,18
Kerala Blast,3776,6,5,3,6,13,16,-3,18
NorthEast Un,3776,7,5,2,7,11,15,-4,17
Kolkata,3776,8,3,6,5,16,22,-6,15
Delhi Dynamo,3777,1,6,5,3,25,16,9,23
Mumbai City,3777,2,6,4,4,16,9,7,22
Kerala Blast,3777,3,6,4,4,14,14,0,22
Kolkata,3777,4,4,7,3,15,13,2,19
NorthEast Un,3777,5,5,3,6,13,14,-1,18
FC Pune City,3777,6,5,3,6,13,16,-3,18
Chennaiyin,3777,7,3,7,4,15,19,-4,16
FC Goa,3777,8,3,3,8,9,19,-10,12
Mumbai City,3778,1,6,4,4,16,10,6,22
NorthEast Un,3778,2,6,3,5,13,11,2,21
Kerala Blast,3778,3,6,3,5,14,15,-1,21
Delhi Dynamo,3778,4,5,5,4,25,19,6,20
FC Goa,3778,5,5,3,6,13,16,-3,18
Kolkata,3778,6,3,7,4,14,16,-2,16
Chennaiyin,3778,7,3,7,4,14,18,-4,16
FC Pune City,3778,8,4,4,6,13,17,-4,16
Mumbai City,3779,1,7,4,3,18,9,9,25
NorthEast Un,3779,2,6,3,5,17,11,6,21
Delhi Dynamo,3779,3,5,5,4,24,21,3,20
FC Pune City,3779,4,5,3,6,17,18,-1,18
Kolkata,3779,5,4,6,4,18,20,-2,18
Kerala Blast,3779,6,5,3,6,11,18,-7,18
FC Goa,3779,7,5,2,7,16,16,0,17
Chennaiyin,3779,8,3,6,5,15,23,-8,15
Delhi Dynamo,3780,1,6,6,2,28,15,13,24
Mumbai City,3780,2,6,5,3,17,9,8,23
Kolkata,3780,3,5,6,3,16,15,1,21
NorthEast Un,3780,4,5,2,7,10,13,-3,17
Chennaiyin,3780,5,4,5,5,14,19,-5,17
FC Goa,3780,6,5,2,7,13,18,-5,17
FC Pune City,3780,7,4,4,6,13,16,-3,16
Kerala Blast,3780,8,4,4,6,10,16,-6,16
Mumbai City,3781,1,7,4,3,18,8,10,25
Delhi Dynamo,3781,2,5,6,3,26,19,7,21
FC Pune City,3781,3,6,3,5,16,14,2,21
Kolkata,3781,4,4,7,3,16,15,1,19
NorthEast Un,3781,5,5,4,5,11,10,1,19
Kerala Blast,3781,6,4,4,6,9,17,-8,16
FC Goa,3781,7,4,3,7,12,19,-7,15
Chennaiyin,3781,8,3,5,6,13,19,-6,14
Mumbai City,3782,1,6,5,3,16,8,8,23
FC Pune City,3782,2,6,3,5,15,14,1,21
Delhi Dynamo,3782,3,4,7,3,21,17,4,19
NorthEast Un,3782,4,5,4,5,12,11,1,19
FC Goa,3782,5,5,3,6,14,15,-1,18
Kolkata,3782,6,4,6,4,14,16,-2,18
Kerala Blast,3782,7,4,4,6,11,17,-6,16
Chennaiyin,3782,8,3,6,5,14,19,-5,15
Kolkata,3783,1,6,6,2,20,15,5,24
Mumbai City,3783,2,6,5,3,17,9,8,23
Delhi Dynamo,3783,3,5,7,2,25,15,10,22
Kerala Blast,3783,4,5,4,5,13,18,-5,19
Chennaiyin,3783,5,4,5,5,17,18,-1,17
FC Pune City,3783,6,4,4,6,14,17,-3,16
NorthEast Un,3783,7,4,3,7,10,15,-5,15
FC Goa,3783,8,4,2,8,10,19,-9,14
Mumbai City,3784,1,7,4,3,19,9,10,25
Delhi Dynamo,3784,2,5,6,3,24,18,6,21
Kolkata,3784,3,4,8,2,18,16,2,20
NorthEast Un,3784,4,5,4,5,11,10,1,19
Chennaiyin,3784,5,4,6,4,15,18,-3,18
Kerala Blast,3784,6,5,3,6,12,17,-5,18
FC Pune City,3784,7,4,4,6,14,17,-3,16
FC Goa,3784,8,3,3,8,11,19,-8,12
Mumbai City,3785,1,7,4,3,18,8,10,25
Kolkata,3785,2,5,7,2,19,15,4,22
Delhi Dynamo,3785,3,5,6,3,24,18,6,21
Kerala Blast,3785,4,5,4,5,11,16,-5,19
Chennaiyin,3785,5,4,6,4,16,17,-1,18
FC Pune City,3785,6,4,4,6,13,16,-3,16
NorthEast Un,3785,7,4,4,6,10,13,-3,16
FC Goa,3785,8,3,3,8,10,18,-8,12
Delhi Dynamo,3786,1,6,5,3,27,16,11,23
Mumbai City,3786,2,6,4,4,16,10,6,22
Kolkata,3786,3,5,6,3,16,14,2,21
Kerala Blast,3786,4,6,3,5,14,17,-3,21
NorthEast Un,3786,5,5,3,6,11,13,-2,18
FC Goa,3786,6,5,2,7,10,15,-5,17
FC Pune City,3786,7,4,3,7,14,18,-4,15
Chennaiyin,3786,8,3,6,5,13,18,-5,15
Mumbai City,3787,1,6,5,3,17,9,8,23
Delhi Dynamo,3787,2,5,7,2,29,19,10,22
Chennaiyin,3787,3,5,5,4,15,17,-2,20
Kolkata,3787,4,4,7,3,15,16,-1,19
Kerala Blast,3787,5,5,4,5,12,15,-3,19
FC Pune City,3787,6,4,5,5,14,16,-2,17
NorthEast Un,3787,7,4,3,7,12,15,-3,15
FC Goa,3787,8,4,2,8,12,19,-7,14
Mumbai City,3788,1,7,4,3,17,8,9,25
Kerala Blast,3788,2,6,4,4,15,14,1,22
Delhi Dynamo,3788,3,4,7,3,22,16,6,19
Kolkata,3788,4,4,7,3,18,15,3,19
NorthEast Un,3788,5,5,3,6,12,12,0,18
FC Goa,3788,6,5,3,6,13,15,-2,18
FC Pune City,3788,7,4,3,7,13,22,-9,15
Chennaiyin,3788,8,3,5,6,13,21,-8,14
Delhi Dynamo,3789,1,5,7,2,25,17,8,22
Mumbai City,3789,2,6,4,4,18,11,7,22
Kolkata,3789,3,5,7,2,18,14,4,22
FC Pune City,3789,4,5,3,6,15,17,-2,18
NorthEast Un,3789,5,4,5,5,11,11,0,17
Kerala Blast,3789,6,4,5,5,11,17,-6,17
Chennaiyin,3789,7,3,6,5,13,18,-5,15
FC Goa,3789,8,4,3,7,9,15,-6,15
Mumbai City,3790,1,6,5,3,17,9,8,23
FC Pune City,3790,2,6,3,5,16,16,0,21
Delhi Dynamo,3790,3,4,7,3,24,18,6,19
Kolkata,3790,4,4,6,4,15,15,0,18
Chennaiyin,3790,5,4,6,4,16,19,-3,18
NorthEast Un,3790,6,4,5,5,12,12,0,17
FC Goa,3790,7,5,2,7,12,17,-5,17
Kerala Blast,3790,8,4,4,6,11,17,-6,16
Mumbai City,3791,1,7,4,3,19,8,11,25
Delhi Dynamo,3791,2,5,5,4,24,19,5,20
Kerala Blast,3791,3,5,5,4,16,18,-2,20
NorthEast Un,3791,4,5,4,5,11,10,1,19
FC Pune City,3791,5,5,4,5,17,18,-1,19
FC Goa,3791,6,5,2,7,12,17,-5,17
Kolkata,3791,7,3,6,5,17,21,-4,15
Chennaiyin,3791,8,3,6,5,13,18,-5,15
Mumbai City,3792,1,6,5,3,16,8,8,23
Kolkata,3792,2,4,8,2,16,14,2,20
Kerala Blast,3792,3,5,5,4,14,17,-3,20
Delhi Dynamo,3792,4,4,7,3,21,15,6,19
NorthEast Un,3792,5,5,3,6,11,11,0,18
FC Pune City,3792,6,4,4,6,14,17,-3,16
FC Goa,3792,7,4,4,6,10,14,-4,16
Chennaiyin,3792,8,3,6,5,14,20,-6,15
Mumbai City,3793,1,7,4,3,17,8,9,25
Delhi Dynamo,3793,2,5,5,4,24,20,4,20
Kolkata,3793,3,4,8,2,16,13,3,20
Chennaiyin,3793,4,5,5,4,18,18,0,20
NorthEast Un,3793,5,5,3,6,14,13,1,18
Kerala Blast,3793,6,4,6,4,10,14,-4,18
FC Pune City,3793,7,4,5,5,13,15,-2,17
FC Goa,3793,8,3,2,9,10,21,-11,11
Delhi Dynamo,3794,1,6,6,2,26,17,9,24
Mumbai City,3794,2,6,4,4,16,9,7,22
Kolkata,3794,3,4,8,2,18,15,3,20
Chennaiyin,3794,4,5,5,4,17,17,0,20
Kerala Blast,3794,5,5,5,4,11,14,-3,20
FC Pune City,3794,6,4,5,5,13,15,-2,17
NorthEast Un,3794,7,4,2,8,10,13,-3,14
FC Goa,3794,8,3,3,8,11,22,-11,12
Mumbai City,3795,1,7,4,3,19,9,10,25
Kolkata,3795,2,5,6,3,17,15,2,21
NorthEast Un,3795,3,6,3,5,13,11,2,21
Delhi Dynamo,3795,4,5,5,4,24,19,5,20
FC Pune City,3795,5,4,4,6,13,16,-3,16
Chennaiyin,3795,6,3,7,4,14,18,-4,16
Kerala Blast,3795,7,4,4,6,12,18,-6,16
FC Goa,3795,8,4,3,7,11,17,-6,15
Mumbai City,3796,1,6,5,3,16,8,8,23
Delhi Dynamo,3796,2,5,7,2,24,15,9,22
FC Pune City,3796,3,5,4,5,16,15,1,19
Kerala Blast,3796,4,5,4,5,12,17,-5,19
Kolkata,3796,5,4,6,4,16,16,0,18
Chennaiyin,3796,6,4,5,5,17,21,-4,17
FC Goa,3796,7,5,2,7,12,16,-4,17
NorthEast Un,3796,8,4,3,7,11,16,-5,15
Mumbai City,3797,1,7,4,3,19,8,11,25
Chennaiyin,3797,2,5,5,4,18,20,-2,20
Delhi Dynamo,3797,3,4,7,3,22,18,4,19
Kolkata,3797,4,4,7,3,18,17,1,19
Kerala Blast,3797,5,4,6,4,12,16,-4,18
NorthEast Un,3797,6,4,4,6,11,12,-1,16
FC Pune City,3797,7,4,4,6,13,17,-4,16
FC Goa,3797,8,4,3,7,13,18,-5,15
Mumbai City,3798,1,7,4,3,19,8,11,25
Delhi Dynamo,3798,2,5,6,3,25,20,5,21
FC Pune City,3798,3,5,4,5,14,15,-1,19
Chennaiyin,3798,4,4,6,4,14,17,-3,18
NorthEast Un,3798,5,5,2,7,12,13,-1,17
Kerala Blast,3798,6,4,5,5,10,15,-5,17
Kolkata,3798,7,3,7,4,13,14,-1,16
FC Goa,3798,8,4,4,6,10,15,-5,16
Mumbai City,3799,1,7,4,3,17,8,9,25
Kerala Blast,3799,2,7,3,4,15,13,2,24
Delhi Dynamo,3799,3,5,6,3,25,16,9,21
FC Pune City,3799,4,5,3,6,14,16,-2,18
NorthEast Un,3799,5,5,2,7,12,16,-4,17
Chennaiyin,3799,6,4,5,5,14,20,-6,17
Kolkata,3799,7,3,6,5,14,18,-4,15
FC Goa,3799,8,4,3,7,12,16,-4,15
Kerala Blast,3800,1,7,3,4,14,14,0,24
Mumbai City,3800,2,6,5,3,17,9,8,23
Delhi Dynamo,3800,3,4,7,3,23,17,6,19
Kolkata,3800,4,4,7,3,15,15,0,19
NorthEast Un,3800,5,5,3,6,12,12,0,18
Chennaiyin,3800,6,4,5,5,17,20,-3,17
FC Pune City,3800,7,4,3,7,13,17,-4,15
FC Goa,3800,8,4,3,7,11,18,-7,15
Mumbai City,3801,1,6,5,3,17,9,8,23
Delhi Dynamo,3801,2,5,7,2,26,18,8,22
Kolkata,3801,3,5,6,3,18,14,4,21
FC Goa,3801,4,5,3,6,13,16,-3,18
FC Pune City,3801,5,5,3,6,13,18,-5,18
Chennaiyin,3801,6,4,5,5,18,18,0,17
Kerala Blast,3801,7,4,4,6,10,16,-6,16
NorthEast Un,3801,8,4,3,7,11,17,-6,15
Delhi Dynamo,3802,1,6,5,3,24,18,6,23
Mumbai City,3802,2,6,4,4,17,10,7,22
Kolkata,3802,3,5,6,3,17,15,2,21
Kerala Blast,3802,4,5,4,5,14,16,-2,19
NorthEast Un,3802,5,5,3,6,15,14,1,18
Chennaiyin,3802,6,4,6,4,18,20,-2,18
FC Goa,3802,7,4,3,7,13,18,-5,15
FC Pune City,3802,8,4,3,7,12,19,-7,15
Mumbai City,3803,1,6,5,3,17,9,8,23
NorthEast Un,3803,2,7,2,5,16,10,6,23
Delhi Dynamo,3803,3,5,6,3,29,19,10,21
Kerala Blast,3803,4,6,3,5,13,15,-2,21
Kolkata,3803,5,4,7,3,16,16,0,19
FC Pune City,3803,6,4,3,7,13,18,-5,15
FC Goa,3803,7,4,3,7,12,22,-10,15
Chennaiyin,3803,8,3,5,6,14,21,-7,14
Kolkata,3804,1,6,6,2,21,12,9,24
Mumbai City,3804,2,6,5,3,16,8,8,23
Delhi Dynamo,3804,3,5,6,3,23,16,7,21
NorthEast Un,3804,4,6,2,6,12,10,2,20
Chennaiyin,3804,5,4,6,4,17,20,-3,18
Kerala Blast,3804,6,5,3,6,10,19,-9,18
FC Pune City,3804,7,4,3,7,12,16,-4,15
FC Goa,3804,8,3,3,8,12,22,-10,12
Delhi Dynamo,3805,1,6,6,2,27,18,9,24
Mumbai City,3805,2,6,4,4,16,9,7,22
Kolkata,3805,3,5,6,3,16,13,3,21
NorthEast Un,3805,4,5,4,5,19,14,5,19
Kerala Blast,3805,5,5,3,6,10,20,-10,18
Chennaiyin,3805,6,3,7,4,15,19,-4,16
FC Pune City,3805,7,4,3,7,12,16,-4,15
FC Goa,3805,8,4,3,7,10,16,-6,15
Mumbai City,3806,1,7,4,3,19,8,11,25
Kolkata,3806,2,5,7,2,18,15,3,22
Delhi Dynamo,3806,3,5,6,3,25,20,5,21
NorthEast Un,3806,4,6,2,6,18,14,4,20
Kerala Blast,3806,5,5,4,5,13,18,-5,19
FC Pune City,3806,6,4,3,7,13,18,-5,15
Chennaiyin,3806,7,3,6,5,17,23,-6,15
FC Goa,3806,8,3,4,7,11,18,-7,13
Mumbai City,3807,1,6,5,3,16,8,8,23
Kerala Blast,3807,2,6,3,5,12,16,-4,21
NorthEast Un,3807,3,6,2,6,13,13,0,20
Delhi Dynamo,3807,4,4,7,3,23,17,6,19
Kolkata,3807,5,4,7,3,16,13,3,19
Chennaiyin,3807,6,4,5,5,17,19,-2,17
FC Goa,3807,7,4,4,6,11,16,-5,16
FC Pune City,3807,8,4,3,7,13,19,-6,15
Mumbai City,3808,1,7,4,3,19,8,11,25
Delhi Dynamo,3808,2,5,6,3,23,18,5,21
Kerala Blast,3808,3,5,4,5,13,17,-4,19
Kolkata,3808,4,4,6,4,15,15,0,18
FC Pune City,3808,5,5,3,6,15,17,-2,18
NorthEast Un,3808,6,4,5,5,11,11,0,17
FC Goa,3808,7,5,2,7,14,19,-5,17
Chennaiyin,3808,8,3,6,5,16,21,-5,15
Delhi Dynamo,3809,1,6,6,2,25,16,9,24
Mumbai City,3809,2,6,5,3,17,9,8,23
Kolkata,3809,3,5,7,2,17,13,4,22
NorthEast Un,3809,4,6,2,6,16,12,4,20
FC Pune City,3809,5,5,3,6,15,17,-2,18
Chennaiyin,3809,6,3,6,5,13,20,-7,15
Kerala Blast,3809,7,4,3,7,12,21,-9,15
FC Goa,3809,8,3,4,7,9,16,-7,13
Mumbai City,3810,1,7,4,3,19,8,11,25
Kolkata,3810,2,5,7,2,16,13,3,22
Delhi Dynamo,3810,3,5,5,4,24,21,3,20
Kerala Blast,3810,4,5,5,4,12,14,-2,20
NorthEast Un,3810,5,4,4,6,12,13,-1,16
Chennaiyin,3810,6,3,7,4,14,18,-4,16
FC Pune City,3810,7,4,3,7,14,19,-5,15
FC Goa,3810,8,4,3,7,10,15,-5,15
Mumbai City,3811,1,7,4,3,17,8,9,25
Kerala Blast,3811,2,6,3,5,12,17,-5,21
Kolkata,3811,3,4,7,3,19,16,3,19
FC Pune City,3811,4,5,4,5,16,15,1,19
Delhi Dynamo,3811,5,4,6,4,22,17,5,18
NorthEast Un,3811,6,5,2,7,11,13,-2,17
Chennaiyin,3811,7,4,5,5,16,19,-3,17
FC Goa,3811,8,4,3,7,11,19,-8,15
Mumbai City,3812,1,7,4,3,18,9,9,25
Kolkata,3812,2,5,7,2,17,12,5,22
Kerala Blast,3812,3,5,5,4,10,13,-3,20
Delhi Dynamo,3812,4,4,6,4,22,18,4,18
NorthEast Un,3812,5,5,3,6,11,11,0,18
Chennaiyin,3812,6,4,6,4,16,18,-2,18
FC Pune City,3812,7,4,3,7,12,18,-6,15
FC Goa,3812,8,3,4,7,9,16,-7,13
Mumbai City,3813,1,7,4,3,17,8,9,25
Delhi Dynamo,3813,2,5,6,3,23,16,7,21
NorthEast Un,3813,3,5,4,5,14,13,1,19
Kerala Blast,3813,4,5,4,5,15,18,-3,19
Kolkata,3813,5,4,6,4,16,16,0,18
FC Pune City,3813,6,5,3,6,14,17,-3,18
Chennaiyin,3813,7,4,5,5,15,19,-4,17
FC Goa,3813,8,4,2,8,10,17,-7,14
Delhi Dynamo,3814,1,6,6,2,27,17,10,24
Kolkata,3814,2,6,6,2,17,13,4,24
Mumbai City,3814,3,6,4,4,17,10,7,22
NorthEast Un,3814,4,6,3,5,12,10,2,21
Kerala Blast,3814,5,5,3,6,10,15,-5,18
FC Pune City,3814,6,4,3,7,12,16,-4,15
Chennaiyin,3814,7,3,5,6,14,20,-6,14
FC Goa,3814,8,4,2,8,12,20,-8,14
Mumbai City,3815,1,6,5,3,17,9,8,23
Kolkata,3815,2,5,7,2,16,13,3,22
NorthEast Un,3815,3,6,3,5,12,10,2,21
Delhi Dynamo,3815,4,4,6,4,23,18,5,18
FC Pune City,3815,5,5,3,6,14,16,-2,18
Chennaiyin,3815,6,4,6,4,15,18,-3,18
FC Goa,3815,7,4,3,7,10,16,-6,15
Kerala Blast,3815,8,4,3,7,9,16,-7,15
Mumbai City,3816,1,7,4,3,18,8,10,25
Delhi Dynamo,3816,2,5,5,4,23,17,6,20
Kerala Blast,3816,3,5,5,4,12,14,-2,20
Kolkata,3816,4,4,7,3,18,18,0,19
FC Pune City,3816,5,5,4,5,15,15,0,19
Chennaiyin,3816,6,4,6,4,15,18,-3,18
NorthEast Un,3816,7,5,2,7,10,12,-2,17
FC Goa,3816,8,3,3,8,11,20,-9,12
Mumbai City,3817,1,7,4,3,18,9,9,25
Delhi Dynamo,3817,2,6,5,3,24,16,8,23
Chennaiyin,3817,3,5,5,4,19,17,2,20
FC Pune City,3817,4,5,4,5,19,20,-1,19
Kerala Blast,3817,5,5,4,5,14,17,-3,19
Kolkata,3817,6,4,6,4,17,17,0,18
FC Goa,3817,7,4,2,8,9,16,-7,14
NorthEast Un,3817,8,4,2,8,9,17,-8,14
Mumbai City,3818,1,6,5,3,19,11,8,23
Delhi Dynamo,3818,2,5,6,3,29,21,8,21
Kolkata,3818,3,5,6,3,18,15,3,21
FC Pune City,3818,4,6,3,5,17,14,3,21
NorthEast Un,3818,5,5,3,6,11,10,1,18
Chennaiyin,3818,6,4,6,4,15,17,-2,18
Kerala Blast,3818,7,5,3,6,11,19,-8,18
FC Goa,3818,8,3,2,9,11,24,-13,11
Mumbai City,3819,1,7,4,3,18,9,9,25
NorthEast Un,3819,2,7,2,5,14,10,4,23
Delhi Dynamo,3819,3,4,6,4,22,17,5,18
FC Goa,3819,4,5,3,6,15,16,-1,18
Kolkata,3819,5,4,6,4,17,19,-2,18
FC Pune City,3819,6,5,3,6,15,17,-2,18
Kerala Blast,3819,7,5,3,6,13,19,-6,18
Chennaiyin,3819,8,3,5,6,14,21,-7,14
Mumbai City,3820,1,6,5,3,17,9,8,23
Kolkata,3820,2,5,7,2,18,13,5,22
NorthEast Un,3820,3,6,3,5,15,13,2,21
Delhi Dynamo,3820,4,4,7,3,24,18,6,19
FC Pune City,3820,5,5,3,6,15,17,-2,18
Kerala Blast,3820,6,4,5,5,12,18,-6,17
FC Goa,3820,7,4,3,7,11,18,-7,15
Chennaiyin,3820,8,3,5,6,16,22,-6,14
Kerala Blast,3821,1,7,3,4,17,16,1,24
Mumbai City,3821,2,6,4,4,17,10,7,22
Delhi Dynamo,3821,3,5,6,3,24,17,7,21
Kolkata,3821,4,4,7,3,20,18,2,19
NorthEast Un,3821,5,5,3,6,10,11,-1,18
FC Goa,3821,6,4,4,6,12,17,-5,16
Chennaiyin,3821,7,3,6,5,13,18,-5,15
FC Pune City,3821,8,4,3,7,14,20,-6,15
Mumbai City,3822,1,6,4,4,16,10,6,22
Delhi Dynamo,3822,2,5,6,3,26,19,7,21
Kerala Blast,3822,3,5,5,4,12,15,-3,20
NorthEast Un,3822,4,5,4,5,12,10,2,19
Kolkata,3822,5,3,8,3,17,17,0,17
FC Pune City,3822,6,4,5,5,15,17,-2,17
Chennaiyin,3822,7,3,7,4,15,19,-4,16
FC Goa,3822,8,3,5,6,13,19,-6,14
Mumbai City,3823,1,7,4,3,17,8,9,25
Delhi Dynamo,3823,2,5,5,4,25,19,6,20
Kerala Blast,3823,3,5,5,4,14,17,-3,20
NorthEast Un,3823,4,5,4,5,13,11,2,19
Kolkata,3823,5,4,7,3,17,16,1,19
FC Pune City,3823,6,5,3,6,14,16,-2,18
Chennaiyin,3823,7,3,6,5,15,20,-5,15
FC Goa,3823,8,4,2,8,13,21,-8,14
Mumbai City,3824,1,7,4,3,18,9,9,25
Delhi Dynamo,3824,2,6,5,3,29,19,10,23
Kolkata,3824,3,5,7,2,16,13,3,22
Kerala Blast,3824,4,5,5,4,12,15,-3,20
Chennaiyin,3824,5,4,6,4,15,18,-3,18
FC Pune City,3824,6,4,4,6,12,15,-3,16
NorthEast Un,3824,7,4,2,8,12,15,-3,14
FC Goa,3824,8,3,3,8,10,20,-10,12
Mumbai City,3825,1,7,4,3,19,9,10,25
Kerala Blast,3825,2,7,3,4,17,16,1,24
Delhi Dynamo,3825,3,5,5,4,25,20,5,20
Chennaiyin,3825,4,5,5,4,17,18,-1,20
Kolkata,3825,5,4,6,4,15,16,-1,18
FC Pune City,3825,6,5,3,6,15,17,-2,18
NorthEast Un,3825,7,5,2,7,13,15,-2,17
FC Goa,3825,8,3,2,9,8,18,-10,11
Kolkata,3826,1,6,6,2,18,13,5,24
Delhi Dynamo,3826,2,6,5,3,25,16,9,23
Mumbai City,3826,3,6,4,4,16,10,6,22
NorthEast Un,3826,4,5,3,6,13,13,0,18
FC Pune City,3826,5,5,3,6,14,15,-1,18
Chennaiyin,3826,6,4,6,4,17,20,-3,18
Kerala Blast,3826,7,4,4,6,10,18,-8,16
FC Goa,3826,8,3,3,8,11,19,-8,12
Delhi Dynamo,3827,1,6,5,3,28,17,11,23
Mumbai City,3827,2,6,4,4,16,9,7,22
FC Pune City,3827,3,6,3,5,16,15,1,21
Chennaiyin,3827,4,4,6,4,15,18,-3,18
Kolkata,3827,5,3,8,3,17,17,0,17
Kerala Blast,3827,6,4,5,5,12,18,-6,17
FC Goa,3827,7,4,4,6,13,17,-4,16
NorthEast Un,3827,8,4,3,7,10,16,-6,15
Delhi Dynamo,3828,1,7,5,2,29,16,13,26
Mumbai City,3828,2,6,4,4,16,10,6,22
Kerala Blast,3828,3,6,4,4,13,14,-1,22
Kolkata,3828,4,4,7,3,16,14,2,19
Chennaiyin,3828,5,3,7,4,14,18,-4,16
NorthEast Un,3828,6,4,3,7,11,13,-2,15
FC Pune City,3828,7,4,3,7,13,19,-6,15
FC Goa,3828,8,4,3,7,11,19,-8,15
Mumbai City,3829,1,7,4,3,23,9,14,25
Chennaiyin,3829,2,5,5,4,19,20,-1,20
Kerala Blast,3829,3,5,5,4,11,13,-2,20
Delhi Dynamo,3829,4,4,6,4,23,23,0,18
NorthEast Un,3829,5,5,3,6,12,13,-1,18
Kolkata,3829,6,3,8,3,14,14,0,17
FC Pune City,3829,7,4,4,6,13,17,-4,16
FC Goa,3829,8,4,3,7,11,17,-6,15
Mumbai City,3830,1,7,4,3,19,9,10,25
Kolkata,3830,2,5,6,3,16,14,2,21
NorthEast Un,3830,3,6,3,5,13,11,2,21
Kerala Blast,3830,4,5,5,4,11,14,-3,20
Delhi Dynamo,3830,5,4,6,4,23,19,4,18
FC Pune City,3830,6,4,4,6,12,15,-3,16
FC Goa,3830,7,4,3,7,12,18,-6,15
Chennaiyin,3830,8,3,5,6,15,21,-6,14
Mumbai City,3831,1,7,4,3,18,9,9,25
Delhi Dynamo,3831,2,5,5,4,26,21,5,20
Chennaiyin,3831,3,5,5,4,15,17,-2,20
Kerala Blast,3831,4,5,4,5,11,15,-4,19
NorthEast Un,3831,5,5,3,6,13,11,2,18
Kolkata,3831,6,4,6,4,18,17,1,18
FC Pune City,3831,7,5,3,6,14,17,-3,18
FC Goa,3831,8,4,2,8,12,20,-8,14
Delhi Dynamo,3832,1,6,5,3,26,17,9,23
Mumbai City,3832,2,6,4,4,16,10,6,22
Kolkata,3832,3,5,7,2,17,12,5,22
Kerala Blast,3832,4,5,5,4,12,14,-2,20
NorthEast Un,3832,5,5,4,5,12,11,1,19
Chennaiyin,3832,6,4,6,4,17,19,-2,18
FC Pune City,3832,7,4,3,7,12,18,-6,15
FC Goa,3832,8,3,2,9,11,22,-11,11
Mumbai City,3833,1,7,4,3,18,8,10,25
Delhi Dynamo,3833,2,6,5,3,25,17,8,23
Kolkata,3833,3,4,7,3,14,13,1,19
Kerala Blast,3833,4,5,4,5,12,16,-4,19
Chennaiyin,3833,5,4,6,4,17,19,-2,18
FC Pune City,3833,6,4,4,6,12,15,-3,16
NorthEast Un,3833,7,4,3,7,13,17,-4,15
FC Goa,3833,8,4,3,7,10,16,-6,15
Kolkata,3834,1,6,6,2,21,15,6,24
Mumbai City,3834,2,6,4,4,17,12,5,22
Delhi Dynamo,3834,3,5,6,3,27,21,6,21
Kerala Blast,3834,4,6,3,5,14,18,-4,21
NorthEast Un,3834,5,5,3,6,13,13,0,18
FC Goa,3834,6,4,3,7,16,19,-3,15
Chennaiyin,3834,7,3,6,5,16,21,-5,15
FC Pune City,3834,8,4,3,7,15,20,-5,15
Mumbai City,3835,1,6,5,3,17,9,8,23
Delhi Dynamo,3835,2,5,6,3,24,17,7,21
Kolkata,3835,3,5,6,3,17,13,4,21
Chennaiyin,3835,4,5,5,4,18,18,0,20
FC Pune City,3835,5,5,3,6,14,16,-2,18
NorthEast Un,3835,6,5,2,7,13,12,1,17
FC Goa,3835,7,5,2,7,11,18,-7,17
Kerala Blast,3835,8,4,3,7,10,21,-11,15
Mumbai City,3836,1,7,4,3,17,8,9,25
Kerala Blast,3836,2,6,4,4,12,14,-2,22
Delhi Dynamo,3836,3,5,5,4,23,17,6,20
NorthEast Un,3836,4,6,2,6,12,11,1,20
FC Pune City,3836,5,5,4,5,14,14,0,19
FC Goa,3836,6,5,2,7,12,17,-5,17
Kolkata,3836,7,3,6,5,16,19,-3,15
Chennaiyin,3836,8,3,5,6,13,19,-6,14
Mumbai City,3837,1,7,4,3,17,8,9,25
NorthEast Un,3837,2,7,2,5,15,10,5,23
Delhi Dynamo,3837,3,5,5,4,26,16,10,20
Kolkata,3837,4,4,8,2,16,14,2,20
FC Pune City,3837,5,5,4,5,15,16,-1,19
Chennaiyin,3837,6,4,5,5,15,20,-5,17
Kerala Blast,3837,7,4,3,7,11,19,-8,15
FC Goa,3837,8,3,3,8,10,22,-12,12
Mumbai City,3838,1,7,4,3,19,8,11,25
Delhi Dynamo,3838,2,5,6,3,26,21,5,21
Kerala Blast,3838,3,6,3,5,14,16,-2,21
Chennaiyin,3838,4,5,5,4,16,18,-2,20
FC Pune City,3838,5,5,3,6,15,16,-1,18
Kolkata,3838,5,4,6,4,15,16,-1,18
NorthEast Un,3838,7,4,3,7,13,16,-3,15
FC Goa,3838,8,4,2,8,10,17,-7,14
Mumbai City,3839,1,7,4,3,18,8,10,25
Delhi Dynamo,3839,2,5,5,4,24,20,4,20
Kolkata,3839,3,4,8,2,14,12,2,20
Kerala Blast,3839,4,5,5,4,14,15,-1,20
NorthEast Un,3839,5,5,3,6,14,15,-1,18
Chennaiyin,3839,6,4,6,4,16,19,-3,18
FC Pune City,3839,7,4,5,5,14,16,-2,17
FC Goa,3839,8,3,2,9,9,18,-9,11
Mumbai City,3840,1,6,4,4,16,10,6,22
Delhi Dynamo,3840,2,5,6,3,26,18,8,21
Kerala Blast,3840,3,5,5,4,15,15,0,20
Kolkata,3840,4,4,7,3,17,15,2,19
NorthEast Un,3840,5,5,4,5,13,12,1,19
FC Goa,3840,6,5,3,6,14,17,-3,18
Chennaiyin,3840,7,3,6,5,14,20,-6,15
FC Pune City,3840,8,4,3,7,12,20,-8,15
Mumbai City,3841,1,7,4,3,19,9,10,25
Kerala Blast,3841,2,7,3,4,13,14,-1,24
Delhi Dynamo,3841,3,4,6,4,23,19,4,18
Kolkata,3841,4,4,6,4,17,15,2,18
Chennaiyin,3841,5,4,6,4,16,19,-3,18
NorthEast Un,3841,6,5,2,7,11,12,-1,17
FC Goa,3841,7,4,4,6,12,17,-5,16
FC Pune City,3841,8,4,3,7,13,19,-6,15
Delhi Dynamo,3842,1,7,5,2,29,16,13,26
Mumbai City,3842,2,6,4,4,18,11,7,22
Kolkata,3842,3,4,8,2,16,13,3,20
NorthEast Un,3842,4,5,3,6,13,12,1,18
Kerala Blast,3842,5,5,3,6,14,19,-5,18
FC Pune City,3842,6,4,4,6,12,17,-5,16
Chennaiyin,3842,7,3,6,5,13,19,-6,15
FC Goa,3842,8,4,3,7,11,19,-8,15
Mumbai City,3843,1,7,4,3,17,8,9,25
Kolkata,3843,2,5,7,2,21,15,6,22
Delhi Dynamo,3843,3,5,6,3,24,17,7,21
Chennaiyin,3843,4,4,6,4,16,18,-2,18
Kerala Blast,3843,5,5,3,6,11,19,-8,18
NorthEast Un,3843,6,5,2,7,12,14,-2,17
FC Pune City,3843,7,4,3,7,13,17,-4,15
FC Goa,3843,8,3,5,6,12,18,-6,14
Mumbai City,3844,1,6,5,3,17,9,8,23
Kolkata,3844,2,4,8,2,15,13,2,20
Delhi Dynamo,3844,3,4,7,3,23,17,6,19
Chennaiyin,3844,4,4,6,4,15,18,-3,18
FC Pune City,3844,5,4,5,5,12,14,-2,17
Kerala Blast,3844,6,4,5,5,10,15,-5,17
NorthEast Un,3844,7,4,4,6,12,13,-1,16
FC Goa,3844,8,4,4,6,10,15,-5,16
Mumbai City,3845,1,6,4,4,16,11,5,22
Delhi Dynamo,3845,2,5,5,4,24,16,8,20
Chennaiyin,3845,3,5,5,4,20,18,2,20
Kerala Blast,3845,4,5,5,4,12,14,-2,20
NorthEast Un,3845,5,5,3,6,12,13,-1,18
FC Pune City,3845,6,5,3,6,13,16,-3,18
Kolkata,3845,7,3,8,3,13,13,0,17
FC Goa,3845,8,4,3,7,9,18,-9,15
Delhi Dynamo,3846,1,6,6,2,27,15,12,24
Mumbai City,3846,2,6,4,4,16,10,6,22
Kolkata,3846,3,5,7,2,18,15,3,22
Chennaiyin,3846,4,4,5,5,20,23,-3,17
Kerala Blast,3846,5,4,5,5,11,16,-5,17
FC Pune City,3846,6,4,4,6,12,15,-3,16
NorthEast Un,3846,7,4,4,6,13,17,-4,16
FC Goa,3846,8,4,3,7,16,22,-6,15
Mumbai City,3847,1,6,5,3,17,9,8,23
Delhi Dynamo,3847,2,4,8,2,24,17,7,20
Kerala Blast,3847,3,5,4,5,13,18,-5,19
FC Pune City,3847,4,5,3,6,16,16,0,18
NorthEast Un,3847,5,5,3,6,14,15,-1,18
FC Goa,3847,6,5,3,6,11,15,-4,18
Chennaiyin,3847,7,4,5,5,17,19,-2,17
Kolkata,3847,8,3,7,4,16,19,-3,16
Mumbai City,3848,1,7,4,3,19,8,11,25
NorthEast Un,3848,2,6,3,5,12,10,2,21
Delhi Dynamo,3848,3,5,5,4,24,18,6,20
Kolkata,3848,4,4,7,3,17,16,1,19
Kerala Blast,3848,5,4,6,4,11,15,-4,18
FC Pune City,3848,6,4,4,6,14,17,-3,16
Chennaiyin,3848,7,3,6,5,16,21,-5,15
FC Goa,3848,8,4,3,7,12,20,-8,15
Mumbai City,3849,1,7,4,3,19,9,10,25
Delhi Dynamo,3849,2,6,5,3,25,17,8,23
Kolkata,3849,3,4,8,2,21,16,5,20
Chennaiyin,3849,4,4,6,4,17,20,-3,18
Kerala Blast,3849,5,5,3,6,10,18,-8,18
NorthEast Un,3849,6,5,2,7,10,11,-1,17
FC Pune City,3849,7,4,4,6,15,18,-3,16
FC Goa,3849,8,3,4,7,12,20,-8,13
Mumbai City,3850,1,7,4,3,17,8,9,25
Kerala Blast,3850,2,7,3,4,14,14,0,24
Delhi Dynamo,3850,3,5,6,3,24,16,8,21
FC Goa,3850,4,5,2,7,11,17,-6,17
Kolkata,3850,5,3,7,4,14,15,-1,16
NorthEast Un,3850,6,4,4,6,10,11,-1,16
FC Pune City,3850,7,4,4,6,12,16,-4,16
Chennaiyin,3850,8,3,6,5,14,19,-5,15
Mumbai City,3851,1,7,4,3,20,9,11,25
Delhi Dynamo,3851,2,6,5,3,27,21,6,23
Chennaiyin,3851,3,5,5,4,17,19,-2,20
FC Pune City,3851,4,5,4,5,14,14,0,19
Kolkata,3851,4,4,7,3,14,14,0,19
Kerala Blast,3851,6,5,4,5,12,15,-3,19
NorthEast Un,3851,7,4,2,8,14,18,-4,14
FC Goa,3851,8,3,3,8,9,17,-8,12
Mumbai City,3852,1,7,4,3,17,8,9,25
Delhi Dynamo,3852,2,5,6,3,26,15,11,21
Kolkata,3852,3,5,6,3,17,14,3,21
FC Pune City,3852,4,5,4,5,14,15,-1,19
NorthEast Un,3852,5,5,3,6,11,12,-1,18
Chennaiyin,3852,6,4,6,4,16,18,-2,18
Kerala Blast,3852,7,4,4,6,11,17,-6,16
FC Goa,3852,8,3,3,8,8,21,-13,12
Kolkata,3853,1,6,6,2,18,12,6,24
Mumbai City,3853,2,6,5,3,17,9,8,23
Delhi Dynamo,3853,3,5,6,3,25,18,7,21
NorthEast Un,3853,4,5,3,6,13,13,0,18
FC Pune City,3853,5,5,3,6,15,17,-2,18
Kerala Blast,3853,6,5,3,6,12,18,-6,18
Chennaiyin,3853,7,3,6,5,15,20,-5,15
FC Goa,3853,8,4,2,8,10,18,-8,14
Mumbai City,3854,1,6,4,4,17,13,4,22
Delhi Dynamo,3854,2,5,5,4,27,19,8,20
NorthEast Un,3854,3,5,4,5,12,10,2,19
FC Pune City,3854,4,5,4,5,16,17,-1,19
Chennaiyin,3854,5,4,6,4,14,17,-3,18
Kolkata,3854,6,3,8,3,16,17,-1,17
FC Goa,3854,7,5,2,7,12,16,-4,17
Kerala Blast,3854,8,4,5,5,12,17,-5,17
Mumbai City,3855,1,7,4,3,17,8,9,25
NorthEast Un,3855,2,6,3,5,12,9,3,21
Delhi Dynamo,3855,3,5,5,4,24,17,7,20
Kolkata,3855,4,4,7,3,17,16,1,19
Kerala Blast,3855,5,4,6,4,12,16,-4,18
FC Pune City,3855,6,4,4,6,15,19,-4,16
Chennaiyin,3855,7,3,6,5,14,19,-5,15
FC Goa,3855,8,4,3,7,11,18,-7,15
Mumbai City,3856,1,6,5,3,18,10,8,23
Delhi Dynamo,3856,2,5,7,2,27,17,10,22
Kerala Blast,3856,3,6,3,5,14,17,-3,21
Kolkata,3856,4,4,7,3,17,16,1,19
FC Pune City,3856,5,5,3,6,14,16,-2,18
NorthEast Un,3856,6,4,4,6,14,15,-1,16
Chennaiyin,3856,7,3,7,4,15,19,-4,16
FC Goa,3856,8,3,4,7,9,18,-9,13
Delhi Dynamo,3857,1,6,5,3,28,17,11,23
Mumbai City,3857,2,6,4,4,17,11,6,22
Kolkata,3857,3,5,7,2,16,13,3,22
Kerala Blast,3857,4,5,4,5,10,14,-4,19
Chennaiyin,3857,5,4,6,4,15,18,-3,18
NorthEast Un,3857,6,5,2,7,12,13,-1,17
FC Pune City,3857,7,4,5,5,13,15,-2,17
FC Goa,3857,8,3,3,8,8,18,-10,12
Mumbai City,3858,1,7,4,3,20,9,11,25
NorthEast Un,3858,2,5,4,5,13,12,1,19
Kerala Blast,3858,3,5,4,5,12,16,-4,19
Delhi Dynamo,3858,4,4,6,4,24,21,3,18
Chennaiyin,3858,5,4,6,4,17,17,0,18
Kolkata,3858,6,4,6,4,14,15,-1,18
FC Pune City,3858,7,5,3,6,13,15,-2,18
FC Goa,3858,8,4,3,7,11,19,-8,15
Mumbai City,3859,1,6,4,4,16,9,7,22
Delhi Dynamo,3859,2,5,6,3,24,17,7,21
NorthEast Un,3859,3,6,2,6,12,11,1,20
Kolkata,3859,4,4,7,3,14,14,0,19
Kerala Blast,3859,5,5,4,5,14,17,-3,19
Chennaiyin,3859,6,4,6,4,15,18,-3,18
FC Pune City,3859,7,4,5,5,15,17,-2,17
FC Goa,3859,8,3,4,7,10,17,-7,13
Mumbai City,3860,1,7,4,3,21,8,13,25
NorthEast Un,3860,2,6,2,6,14,12,2,20
Delhi Dynamo,3860,3,5,5,4,24,23,1,20
Chennaiyin,3860,4,5,5,4,16,18,-2,20
FC Pune City,3860,5,5,4,5,15,16,-1,19
Kerala Blast,3860,6,5,4,5,13,17,-4,19
Kolkata,3860,7,3,7,4,18,19,-1,16
FC Goa,3860,8,3,3,8,13,21,-8,12
Delhi Dynamo,3861,1,6,5,3,27,16,11,23
Mumbai City,3861,2,6,4,4,17,11,6,22
Kolkata,3861,3,5,7,2,19,16,3,22
NorthEast Un,3861,4,5,3,6,11,11,0,18
Chennaiyin,3861,5,4,6,4,15,18,-3,18
FC Pune City,3861,6,4,5,5,17,19,-2,17
Kerala Blast,3861,7,4,5,5,13,18,-5,17
FC Goa,3861,8,3,3,8,11,21,-10,12
Mumbai City,3862,1,7,4,3,20,9,11,25
Delhi Dynamo,3862,2,5,6,3,23,18,5,21
Kerala Blast,3862,3,5,5,4,13,16,-3,20
FC Pune City,3862,4,5,4,5,15,15,0,19
FC Goa,3862,5,5,3,6,10,14,-4,18
Chennaiyin,3862,6,4,5,5,15,18,-3,17
Kolkata,3862,7,3,6,5,13,16,-3,15
NorthEast Un,3862,8,4,3,7,11,14,-3,15
Mumbai City,3863,1,6,5,3,17,9,8,23
Kolkata,3863,2,5,6,3,20,16,4,21
NorthEast Un,3863,3,6,2,6,12,11,1,20
Chennaiyin,3863,4,5,5,4,15,17,-2,20
Delhi Dynamo,3863,5,4,7,3,26,20,6,19
Kerala Blast,3863,6,5,4,5,12,14,-2,19
FC Pune City,3863,7,4,4,6,13,20,-7,16
FC Goa,3863,8,3,3,8,11,19,-8,12
Mumbai City,3864,1,6,5,3,17,9,8,23
Delhi Dynamo,3864,2,5,6,3,27,20,7,21
Kolkata,3864,3,4,8,2,16,14,2,20
Chennaiyin,3864,4,5,5,4,17,18,-1,20
Kerala Blast,3864,5,5,4,5,12,16,-4,19
NorthEast Un,3864,6,5,2,7,13,14,-1,17
FC Pune City,3864,7,4,5,5,14,16,-2,17
FC Goa,3864,8,3,3,8,10,19,-9,12
Mumbai City,3865,1,7,4,3,21,8,13,25
Kolkata,3865,2,5,7,2,17,13,4,22
Delhi Dynamo,3865,3,5,5,4,26,22,4,20
NorthEast Un,3865,4,5,4,5,13,12,1,19
Kerala Blast,3865,5,5,4,5,11,16,-5,19
FC Pune City,3865,6,4,3,7,13,17,-4,15
Chennaiyin,3865,7,3,6,5,15,20,-5,15
FC Goa,3865,8,4,3,7,11,19,-8,15
Mumbai City,3866,1,7,4,3,18,9,9,25
Kolkata,3866,2,5,6,3,17,14,3,21
Delhi Dynamo,3866,3,4,7,3,24,18,6,19
FC Goa,3866,4,5,3,6,14,17,-3,18
NorthEast Un,3866,5,4,5,5,12,12,0,17
Kerala Blast,3866,6,4,5,5,11,16,-5,17
FC Pune City,3866,7,4,4,6,13,17,-4,16
Chennaiyin,3866,8,3,6,5,15,21,-6,15
Delhi Dynamo,3867,1,6,6,2,31,17,14,24
Mumbai City,3867,2,6,5,3,17,9,8,23
FC Pune City,3867,3,6,3,5,16,16,0,21
Kolkata,3867,4,4,7,3,18,17,1,19
NorthEast Un,3867,5,4,4,6,12,17,-5,16
Kerala Blast,3867,6,4,4,6,12,18,-6,16
Chennaiyin,3867,7,3,6,5,15,20,-5,15
FC Goa,3867,8,4,3,7,13,20,-7,15
Mumbai City,3868,1,7,4,3,17,8,9,25
Delhi Dynamo,3868,2,5,6,3,24,17,7,21
NorthEast Un,3868,3,6,2,6,14,12,2,20
FC Pune City,3868,4,5,4,5,14,14,0,19
Kerala Blast,3868,5,5,4,5,13,18,-5,19
Kolkata,3868,6,4,6,4,18,18,0,18
FC Goa,3868,7,4,3,7,10,17,-7,15
Chennaiyin,3868,8,3,5,6,14,20,-6,14
Mumbai City,3869,1,7,4,3,17,8,9,25
Delhi Dynamo,3869,2,5,6,3,25,16,9,21
Kolkata,3869,3,5,6,3,17,13,4,21
FC Pune City,3869,4,6,3,5,14,14,0,21
NorthEast Un,3869,5,5,3,6,13,12,1,18
Kerala Blast,3869,6,5,3,6,10,17,-7,18
Chennaiyin,3869,7,3,5,6,14,21,-7,14
FC Goa,3869,8,4,2,8,9,18,-9,14
Kerala Blast,3870,1,7,3,4,16,14,2,24
Delhi Dynamo,3870,2,6,5,3,25,20,5,23
Mumbai City,3870,3,6,4,4,16,10,6,22
Kolkata,3870,4,4,6,4,14,17,-3,18
NorthEast Un,3870,5,5,2,7,14,11,3,17
Chennaiyin,3870,6,4,5,5,15,19,-4,17
FC Goa,3870,7,5,2,7,13,17,-4,17
FC Pune City,3870,8,4,3,7,13,18,-5,15
Kolkata,3871,1,6,6,2,19,14,5,24
Mumbai City,3871,2,6,5,3,16,8,8,23
Delhi Dynamo,3871,3,5,7,2,23,15,8,22
Kerala Blast,3871,4,6,3,5,13,15,-2,21
NorthEast Un,3871,5,5,3,6,12,12,0,18
FC Pune City,3871,6,4,3,7,14,20,-6,15
Chennaiyin,3871,7,3,5,6,17,23,-6,14
FC Goa,3871,8,4,2,8,12,19,-7,14
Mumbai City,3872,1,7,4,3,17,8,9,25
NorthEast Un,3872,2,7,2,5,15,10,5,23
Kolkata,3872,3,5,7,2,19,16,3,22
Delhi Dynamo,3872,4,4,6,4,23,19,4,18
Kerala Blast,3872,5,5,3,6,12,17,-5,18
Chennaiyin,3872,6,4,5,5,16,20,-4,17
FC Pune City,3872,7,4,3,7,14,18,-4,15
FC Goa,3872,8,3,4,7,12,20,-8,13
Mumbai City,3873,1,7,4,3,20,9,11,25
Delhi Dynamo,3873,2,6,5,3,24,18,6,23
Kerala Blast,3873,3,6,4,4,13,15,-2,22
Kolkata,3873,4,4,6,4,18,17,1,18
Chennaiyin,3873,5,4,6,4,17,19,-2,18
NorthEast Un,3873,6,4,3,7,9,12,-3,15
FC Goa,3873,7,4,3,7,14,19,-5,15
FC Pune City,3873,8,4,3,7,14,20,-6,15
Mumbai City,3874,1,7,4,3,17,8,9,25
NorthEast Un,3874,2,6,3,5,15,12,3,21
Delhi Dynamo,3874,3,5,5,4,25,18,7,20
Kerala Blast,3874,4,5,5,4,12,15,-3,20
Kolkata,3874,5,3,8,3,14,16,-2,17
FC Pune City,3874,6,4,4,6,14,17,-3,16
FC Goa,3874,7,4,3,7,12,17,-5,15
Chennaiyin,3874,8,3,6,5,14,20,-6,15
Delhi Dynamo,3875,1,6,5,3,29,23,6,23
Mumbai City,3875,2,6,4,4,19,12,7,22
Kolkata,3875,3,4,7,3,17,16,1,19
NorthEast Un,3875,4,5,3,6,14,13,1,18
Chennaiyin,3875,5,4,5,5,16,18,-2,17
FC Pune City,3875,6,4,5,5,14,16,-2,17
Kerala Blast,3875,7,4,5,5,12,17,-5,17
FC Goa,3875,8,5,2,7,13,19,-6,17
Mumbai City,3876,1,7,4,3,19,8,11,25
Kerala Blast,3876,2,6,4,4,14,15,-1,22
Kolkata,3876,3,4,7,3,15,15,0,19
NorthEast Un,3876,4,5,3,6,12,12,0,18
FC Pune City,3876,5,5,3,6,15,17,-2,18
Delhi Dynamo,3876,6,4,5,5,21,19,2,17
Chennaiyin,3876,7,3,7,4,14,18,-4,16
FC Goa,3876,8,4,3,7,10,16,-6,15
Mumbai City,3877,1,6,5,3,17,9,8,23
Kerala Blast,3877,2,6,4,4,12,14,-2,22
Delhi Dynamo,3877,3,4,7,3,25,20,5,19
Kolkata,3877,4,4,6,4,16,15,1,18
FC Goa,3877,5,5,3,6,13,16,-3,18
NorthEast Un,3877,6,5,2,7,12,13,-1,17
Chennaiyin,3877,7,4,5,5,15,19,-4,17
FC Pune City,3877,8,4,4,6,14,18,-4,16
Mumbai City,3878,1,6,5,3,18,10,8,23
Delhi Dynamo,3878,2,5,7,2,25,16,9,22
Kolkata,3878,3,5,6,3,16,14,2,21
FC Pune City,3878,4,6,3,5,15,15,0,21
NorthEast Un,3878,5,6,2,6,12,12,0,20
FC Goa,3878,6,4,3,7,11,17,-6,15
Kerala Blast,3878,7,4,3,7,9,16,-7,15
Chennaiyin,3878,8,3,5,6,16,22,-6,14
Mumbai City,3879,1,6,5,3,17,9,8,23
Delhi Dynamo,3879,2,5,7,2,24,16,8,22
Kolkata,3879,3,4,7,3,16,17,-1,19
Kerala Blast,3879,4,5,4,5,11,14,-3,19
NorthEast Un,3879,5,4,5,5,11,11,0,17
FC Goa,3879,6,5,2,7,15,16,-1,17
FC Pune City,3879,7,4,4,6,13,17,-4,16
Chennaiyin,3879,8,3,6,5,14,21,-7,15
Mumbai City,3880,1,7,4,3,18,8,10,25
NorthEast Un,3880,2,5,4,5,12,10,2,19
Kolkata,3880,3,4,7,3,16,15,1,19
Kerala Blast,3880,4,5,4,5,12,15,-3,19
Delhi Dynamo,3880,5,4,6,4,22,19,3,18
FC Pune City,3880,6,5,3,6,14,17,-3,18
FC Goa,3880,7,4,4,6,11,15,-4,16
Chennaiyin,3880,8,3,6,5,14,20,-6,15
Mumbai City,3881,1,7,4,3,18,8,10,25
Kolkata,3881,2,5,7,2,17,13,4,22
Delhi Dynamo,3881,3,5,6,3,23,17,6,21
NorthEast Un,3881,4,6,2,6,11,10,1,20
FC Pune City,3881,5,5,3,6,14,16,-2,18
Kerala Blast,3881,6,4,4,6,9,16,-7,16
FC Goa,3881,7,4,3,7,13,18,-5,15
Chennaiyin,3881,8,3,5,6,14,21,-7,14
Delhi Dynamo,3882,1,6,6,2,24,14,10,24
Mumbai City,3882,2,6,4,4,16,10,6,22
Kerala Blast,3882,3,6,3,5,12,15,-3,21
FC Pune City,3882,4,5,3,6,14,15,-1,18
Kolkata,3882,5,4,6,4,15,17,-2,18
Chennaiyin,3882,6,4,6,4,14,17,-3,18
FC Goa,3882,7,4,4,6,10,14,-4,16
NorthEast Un,3882,8,4,2,8,9,12,-3,14
Delhi Dynamo,3883,1,6,6,2,25,16,9,24
Mumbai City,3883,2,6,4,4,17,10,7,22
Kolkata,3883,3,5,6,3,20,17,3,21
FC Goa,3883,4,5,3,6,15,18,-3,18
Kerala Blast,3883,5,5,3,6,13,19,-6,18
NorthEast Un,3883,6,5,2,7,11,12,-1,17
Chennaiyin,3883,7,4,5,5,16,21,-5,17
FC Pune City,3883,8,4,3,7,17,21,-4,15
Kolkata,3884,1,6,6,2,20,14,6,24
Delhi Dynamo,3884,2,6,5,3,27,19,8,23
Mumbai City,3884,3,6,4,4,17,10,7,22
NorthEast Un,3884,4,6,3,5,13,11,2,21
Kerala Blast,3884,5,5,4,5,13,16,-3,19
Chennaiyin,3884,6,4,5,5,16,19,-3,17
FC Pune City,3884,7,4,3,7,14,20,-6,15
FC Goa,3884,8,3,2,9,11,22,-11,11
Mumbai City,3885,1,7,4,3,17,8,9,25
Kerala Blast,3885,2,6,3,5,15,18,-3,21
Delhi Dynamo,3885,3,5,5,4,24,19,5,20
NorthEast Un,3885,4,6,2,6,14,12,2,20
Kolkata,3885,5,4,7,3,17,17,0,19
FC Goa,3885,6,5,2,7,16,19,-3,17
FC Pune City,3885,7,4,4,6,13,16,-3,16
Chennaiyin,3885,8,3,5,6,14,21,-7,14
Mumbai City,3886,1,7,4,3,17,8,9,25
Chennaiyin,3886,2,5,5,4,17,18,-1,20
Kerala Blast,3886,3,5,5,4,13,15,-2,20
Delhi Dynamo,3886,4,4,7,3,25,19,6,19
Kolkata,3886,5,4,7,3,15,14,1,19
FC Pune City,3886,6,5,3,6,14,17,-3,18
NorthEast Un,3886,7,4,4,6,13,15,-2,16
FC Goa,3886,8,3,3,8,11,19,-8,12
Mumbai City,3887,1,7,4,3,17,8,9,25
Delhi Dynamo,3887,2,6,5,3,25,16,9,23
FC Pune City,3887,3,6,3,5,17,16,1,21
Kolkata,3887,4,4,7,3,19,17,2,19
Kerala Blast,3887,5,5,3,6,14,19,-5,18
Chennaiyin,3887,6,4,5,5,16,20,-4,17
FC Goa,3887,7,4,3,7,12,17,-5,15
NorthEast Un,3887,8,4,2,8,12,19,-7,14
Mumbai City,3888,1,7,4,3,20,11,9,25
Kerala Blast,3888,2,7,3,4,14,14,0,24
Delhi Dynamo,3888,3,4,6,4,25,20,5,18
Kolkata,3888,4,4,6,4,14,14,0,18
FC Pune City,3888,5,5,3,6,14,16,-2,18
NorthEast Un,3888,6,5,2,7,11,13,-2,17
Chennaiyin,3888,7,4,5,5,15,19,-4,17
FC Goa,3888,8,4,3,7,10,16,-6,15
Mumbai City,3889,1,6,4,4,16,10,6,22
FC Pune City,3889,2,6,3,5,18,17,1,21
Kolkata,3889,3,5,6,3,17,16,1,21
Delhi Dynamo,3889,4,5,5,4,23,17,6,20
NorthEast Un,3889,5,5,3,6,10,12,-2,18
Kerala Blast,3889,6,5,3,6,15,18,-3,18
Chennaiyin,3889,7,3,7,4,15,19,-4,16
FC Goa,3889,8,4,3,7,12,17,-5,15
Mumbai City,3890,1,6,5,3,16,8,8,23
Kerala Blast,3890,2,6,4,4,13,14,-1,22
Delhi Dynamo,3890,3,5,6,3,25,17,8,21
Kolkata,3890,4,4,8,2,17,15,2,20
NorthEast Un,3890,5,5,3,6,14,15,-1,18
Chennaiyin,3890,6,4,6,4,19,21,-2,18
FC Pune City,3890,7,4,3,7,13,17,-4,15
FC Goa,3890,8,3,3,8,11,21,-10,12
Delhi Dynamo,3891,1,6,6,2,29,19,10,24
Mumbai City,3891,2,6,4,4,16,9,7,22
NorthEast Un,3891,3,6,3,5,16,13,3,21
Kolkata,3891,4,4,7,3,15,14,1,19
FC Pune City,3891,5,5,4,5,13,14,-1,19
Chennaiyin,3891,6,4,5,5,15,19,-4,17
Kerala Blast,3891,7,4,4,6,12,19,-7,16
FC Goa,3891,8,3,3,8,12,21,-9,12
Mumbai City,3892,1,7,4,3,18,9,9,25
Kerala Blast,3892,2,6,4,4,14,16,-2,22
Kolkata,3892,3,4,7,3,17,17,0,19
Delhi Dynamo,3892,4,4,6,4,25,21,4,18
NorthEast Un,3892,5,5,3,6,12,12,0,18
FC Goa,3892,6,5,2,7,15,18,-3,17
Chennaiyin,3892,7,4,5,5,16,20,-4,17
FC Pune City,3892,8,4,3,7,14,18,-4,15
Mumbai City,3893,1,7,4,3,17,8,9,25
Delhi Dynamo,3893,2,5,6,3,25,17,8,21
Kolkata,3893,3,4,7,3,19,18,1,19
NorthEast Un,3893,4,5,4,5,12,11,1,19
FC Pune City,3893,5,5,4,5,14,15,-1,19
Kerala Blast,3893,6,5,4,5,14,17,-3,19
Chennaiyin,3893,7,4,5,5,15,18,-3,17
FC Goa,3893,8,3,2,9,10,22,-12,11
Delhi Dynamo,3894,1,6,5,3,27,17,10,23
Mumbai City,3894,2,6,4,4,16,11,5,22
Kolkata,3894,3,5,6,3,16,14,2,21
Chennaiyin,3894,4,5,5,4,17,17,0,20
FC Pune City,3894,5,5,3,6,15,16,-1,18
NorthEast Un,3894,6,5,2,7,13,14,-1,17
FC Goa,3894,7,5,2,7,12,17,-5,17
Kerala Blast,3894,8,4,3,7,11,21,-10,15
Mumbai City,3895,1,7,4,3,17,8,9,25
Kerala Blast,3895,2,6,4,4,17,14,3,22
Delhi Dynamo,3895,3,5,5,4,22,16,6,20
FC Pune City,3895,4,5,3,6,16,20,-4,18
Kolkata,3895,5,3,8,3,15,15,0,17
Chennaiyin,3895,6,4,5,5,15,19,-4,17
NorthEast Un,3895,7,5,2,7,10,14,-4,17
FC Goa,3895,8,4,3,7,10,16,-6,15
Mumbai City,3896,1,6,5,3,18,10,8,23
Delhi Dynamo,3896,2,5,7,2,27,17,10,22
Kolkata,3896,3,5,6,3,18,15,3,21
Kerala Blast,3896,4,6,3,5,16,20,-4,21
Chennaiyin,3896,5,4,5,5,16,20,-4,17
FC Goa,3896,6,5,2,7,12,17,-5,17
FC Pune City,3896,7,4,3,7,16,20,-4,15
NorthEast Un,3896,8,4,3,7,12,16,-4,15
Delhi Dynamo,3897,1,6,5,3,25,16,9,23
Mumbai City,3897,2,6,4,4,17,10,7,22
Kerala Blast,3897,3,6,4,4,14,16,-2,22
Kolkata,3897,4,4,8,2,18,15,3,20
NorthEast Un,3897,5,5,3,6,11,11,0,18
FC Goa,3897,6,4,3,7,12,17,-5,15
FC Pune City,3897,6,4,3,7,12,17,-5,15
Chennaiyin,3897,8,3,6,5,13,20,-7,15
Delhi Dynamo,3898,1,6,6,2,27,17,10,24
Mumbai City,3898,2,6,4,4,17,10,7,22
Kolkata,3898,3,4,7,3,17,14,3,19
FC Pune City,3898,4,5,4,5,14,15,-1,19
Chennaiyin,3898,5,4,6,4,15,18,-3,18
Kerala Blast,3898,6,5,3,6,13,19,-6,18
NorthEast Un,3898,7,4,4,6,11,13,-2,16
FC Goa,3898,8,4,2,8,10,18,-8,14
Mumbai City,3899,1,7,4,3,20,9,11,25
Kerala Blast,3899,2,6,4,4,13,15,-2,22
Kolkata,3899,3,5,6,3,18,14,4,21
NorthEast Un,3899,4,5,4,5,12,10,2,19
Delhi Dynamo,3899,5,4,5,5,24,23,1,17
FC Goa,3899,6,5,2,7,16,19,-3,17
FC Pune City,3899,7,4,3,7,12,17,-5,15
Chennaiyin,3899,8,3,6,5,14,22,-8,15
Delhi Dynamo,3900,1,6,5,3,26,16,10,23
Mumbai City,3900,2,6,4,4,16,9,7,22
FC Pune City,3900,3,6,3,5,15,15,0,21
Kerala Blast,3900,4,6,3,5,13,16,-3,21
Kolkata,3900,5,4,6,4,15,15,0,18
NorthEast Un,3900,6,5,2,7,12,15,-3,17
Chennaiyin,3900,7,4,5,5,14,18,-4,17
FC Goa,3900,8,4,2,8,10,17,-7,14
Mumbai City,3901,1,7,4,3,18,8,10,25
Kolkata,3901,2,6,6,2,22,15,7,24
Delhi Dynamo,3901,3,5,6,3,25,19,6,21
FC Pune City,3901,4,5,3,6,14,16,-2,18
NorthEast Un,3901,5,4,5,5,12,12,0,17
Kerala Blast,3901,6,4,4,6,9,18,-9,16
Chennaiyin,3901,7,3,6,5,15,20,-5,15
FC Goa,3901,8,4,2,8,13,20,-7,14
Mumbai City,3902,1,6,5,3,17,9,8,23
Kolkata,3902,2,5,7,2,19,15,4,22
NorthEast Un,3902,3,6,2,6,16,15,1,20
Delhi Dynamo,3902,4,4,6,4,23,23,0,18
FC Goa,3902,5,5,3,6,15,16,-1,18
FC Pune City,3902,6,5,3,6,14,16,-2,18
Kerala Blast,3902,7,5,3,6,14,17,-3,18
Chennaiyin,3902,8,3,5,6,15,22,-7,14
Mumbai City,3903,1,6,4,4,17,10,7,22
Kerala Blast,3903,2,6,4,4,14,15,-1,22
Delhi Dynamo,3903,3,5,5,4,26,20,6,20
FC Pune City,3903,4,5,4,5,16,16,0,19
Kolkata,3903,5,4,6,4,17,17,0,18
NorthEast Un,3903,6,5,2,7,12,15,-3,17
FC Goa,3903,7,5,2,7,13,17,-4,17
Chennaiyin,3903,8,4,5,5,15,20,-5,17
Delhi Dynamo,3904,1,6,5,3,23,17,6,23
Mumbai City,3904,2,6,4,4,16,9,7,22
Kerala Blast,3904,3,6,4,4,14,15,-1,22
FC Pune City,3904,4,5,4,5,15,15,0,19
Kolkata,3904,5,4,6,4,14,15,-1,18
Chennaiyin,3904,6,4,5,5,19,21,-2,17
NorthEast Un,3904,7,5,2,7,13,15,-2,17
FC Goa,3904,8,4,2,8,12,19,-7,14
Delhi Dynamo,3905,1,6,6,2,28,19,9,24
Mumbai City,3905,2,6,5,3,17,9,8,23
Kerala Blast,3905,3,6,3,5,11,15,-4,21
Kolkata,3905,4,4,7,3,16,15,1,19
FC Pune City,3905,5,5,3,6,14,15,-1,18
Chennaiyin,3905,6,4,6,4,17,19,-2,18
NorthEast Un,3905,7,4,3,7,11,13,-2,15
FC Goa,3905,8,3,3,8,13,22,-9,12
Delhi Dynamo,3906,1,7,5,2,26,14,12,26
Mumbai City,3906,2,6,4,4,16,9,7,22
Kerala Blast,3906,3,6,4,4,13,15,-2,22
Kolkata,3906,4,4,6,4,14,14,0,18
NorthEast Un,3906,5,5,2,7,11,13,-2,17
FC Goa,3906,6,5,2,7,11,16,-5,17
FC Pune City,3906,7,4,4,6,13,16,-3,16
Chennaiyin,3906,8,3,5,6,13,20,-7,14
Mumbai City,3907,1,7,4,3,18,9,9,25
Delhi Dynamo,3907,2,6,5,3,26,16,10,23
Kolkata,3907,3,5,7,2,16,13,3,22
Kerala Blast,3907,4,6,3,5,15,16,-1,21
NorthEast Un,3907,5,5,2,7,10,13,-3,17
FC Pune City,3907,6,4,4,6,13,17,-4,16
Chennaiyin,3907,7,3,6,5,14,19,-5,15
FC Goa,3907,8,3,3,8,9,18,-9,12
Mumbai City,3908,1,6,4,4,17,10,7,22
Kerala Blast,3908,2,6,3,5,16,17,-1,21
Delhi Dynamo,3908,3,5,5,4,26,21,5,20
NorthEast Un,3908,4,6,2,6,14,13,1,20
Chennaiyin,3908,5,5,5,4,20,20,0,20
Kolkata,3908,6,4,6,4,17,17,0,18
FC Goa,3908,7,5,2,7,15,21,-6,17
FC Pune City,3908,8,4,3,7,13,19,-6,15
Mumbai City,3909,1,7,4,3,18,9,9,25
Delhi Dynamo,3909,2,5,6,3,25,18,7,21
Kolkata,3909,3,4,7,3,15,14,1,19
FC Pune City,3909,4,5,4,5,13,14,-1,19
Kerala Blast,3909,5,5,4,5,14,18,-4,19
NorthEast Un,3909,6,4,5,5,15,15,0,17
Chennaiyin,3909,7,3,7,4,16,20,-4,16
FC Goa,3909,8,3,3,8,10,18,-8,12
Delhi Dynamo,3910,1,7,5,2,27,16,11,26
Mumbai City,3910,2,6,4,4,16,10,6,22
Kolkata,3910,3,4,8,2,16,14,2,20
FC Pune City,3910,4,5,4,5,15,16,-1,19
Kerala Blast,3910,5,5,3,6,13,18,-5,18
Chennaiyin,3910,6,3,7,4,15,19,-4,16
NorthEast Un,3910,7,4,3,7,13,15,-2,15
FC Goa,3910,8,3,4,7,9,16,-7,13
Mumbai City,3911,1,7,4,3,19,8,11,25
Kerala Blast,3911,2,7,3,4,15,14,1,24
Kolkata,3911,3,4,7,3,20,17,3,19
NorthEast Un,3911,4,5,3,6,13,14,-1,18
Chennaiyin,3911,5,4,6,4,17,20,-3,18
Delhi Dynamo,3911,6,4,5,5,22,20,2,17
FC Pune City,3911,7,4,4,6,15,18,-3,16
FC Goa,3911,8,4,2,8,11,21,-10,14
Kolkata,3912,1,6,6,2,20,12,8,24
Mumbai City,3912,2,6,5,3,18,10,8,23
Delhi Dynamo,3912,3,5,7,2,25,16,9,22
Kerala Blast,3912,4,6,3,5,12,15,-3,21
Chennaiyin,3912,5,4,5,5,17,19,-2,17
FC Pune City,3912,6,4,3,7,13,19,-6,15
FC Goa,3912,7,4,3,7,10,18,-8,15
NorthEast Un,3912,8,4,2,8,9,15,-6,14
Delhi Dynamo,3913,1,7,5,2,26,16,10,26
Kerala Blast,3913,2,7,3,4,13,14,-1,24
Mumbai City,3913,3,6,4,4,17,10,7,22
Kolkata,3913,4,4,7,3,18,17,1,19
NorthEast Un,3913,5,5,2,7,10,11,-1,17
FC Pune City,3913,6,4,3,7,13,17,-4,15
FC Goa,3913,7,4,3,7,12,18,-6,15
Chennaiyin,3913,8,3,5,6,13,19,-6,14
Delhi Dynamo,3914,1,7,5,2,30,16,14,26
Mumbai City,3914,2,6,4,4,16,10,6,22
Kerala Blast,3914,3,6,4,4,17,17,0,22
Chennaiyin,3914,4,5,5,4,16,17,-1,20
FC Pune City,3914,5,4,5,5,14,16,-2,17
Kolkata,3914,6,3,7,4,15,17,-2,16
NorthEast Un,3914,7,4,2,8,10,15,-5,14
FC Goa,3914,8,4,2,8,11,21,-10,14
Mumbai City,3915,1,7,4,3,19,8,11,25
Kolkata,3915,2,5,6,3,16,15,1,21
FC Goa,3915,3,6,2,6,13,14,-1,20
Delhi Dynamo,3915,4,4,6,4,22,19,3,18
FC Pune City,3915,5,5,3,6,13,15,-2,18
Kerala Blast,3915,6,5,3,6,11,16,-5,18
NorthEast Un,3915,7,4,4,6,10,12,-2,16
Chennaiyin,3915,8,3,6,5,13,18,-5,15
Mumbai City,3916,1,6,5,3,16,8,8,23
NorthEast Un,3916,2,7,2,5,16,10,6,23
Delhi Dynamo,3916,3,5,6,3,22,16,6,21
Kolkata,3916,4,5,6,3,18,16,2,21
FC Pune City,3916,5,5,3,6,14,16,-2,18
Kerala Blast,3916,6,5,3,6,12,17,-5,18
Chennaiyin,3916,7,3,5,6,14,21,-7,14
FC Goa,3916,8,4,2,8,9,17,-8,14
Mumbai City,3917,1,7,4,3,18,9,9,25
Delhi Dynamo,3917,2,5,5,4,24,20,4,20
Kolkata,3917,3,4,8,2,15,12,3,20
NorthEast Un,3917,4,5,4,5,13,10,3,19
FC Pune City,3917,5,5,4,5,14,15,-1,19
Kerala Blast,3917,6,4,5,5,10,15,-5,17
Chennaiyin,3917,7,3,6,5,15,22,-7,15
FC Goa,3917,8,4,2,8,13,19,-6,14
Delhi Dynamo,3918,1,6,5,3,26,16,10,23
Mumbai City,3918,2,6,4,4,16,9,7,22
Kolkata,3918,3,4,8,2,17,14,3,20
Kerala Blast,3918,4,5,5,4,13,16,-3,20
NorthEast Un,3918,5,5,4,5,10,9,1,19
Chennaiyin,3918,6,3,6,5,14,19,-5,15
FC Pune City,3918,7,4,3,7,13,18,-5,15
FC Goa,3918,8,4,3,7,11,19,-8,15
Mumbai City,3919,1,7,4,3,18,8,10,25
Kolkata,3919,2,4,8,2,18,16,2,20
NorthEast Un,3919,3,6,2,6,13,11,2,20
FC Pune City,3919,4,5,4,5,15,16,-1,19
Kerala Blast,3919,5,5,3,6,11,16,-5,18
Delhi Dynamo,3919,6,4,5,5,22,20,2,17
FC Goa,3919,7,4,4,6,11,16,-5,16
Chennaiyin,3919,8,3,6,5,14,19,-5,15
Kerala Blast,3920,1,7,3,4,14,13,1,24
Mumbai City,3920,2,6,5,3,17,9,8,23
Delhi Dynamo,3920,3,5,7,2,23,15,8,22
NorthEast Un,3920,4,5,3,6,11,12,-1,18
FC Pune City,3920,5,5,3,6,15,17,-2,18
Kolkata,3920,6,3,7,4,16,18,-2,16
FC Goa,3920,7,4,3,7,13,19,-6,15
Chennaiyin,3920,8,3,5,6,16,22,-6,14
Mumbai City,3921,1,7,4,3,21,9,12,25
Delhi Dynamo,3921,2,6,5,3,29,20,9,23
Kerala Blast,3921,3,5,5,4,12,15,-3,20
Kolkata,3921,4,4,7,3,15,14,1,19
Chennaiyin,3921,5,4,6,4,16,18,-2,18
FC Pune City,3921,6,5,3,6,14,16,-2,18
NorthEast Un,3921,7,4,3,7,9,14,-5,15
FC Goa,3921,8,3,3,8,10,20,-10,12
Mumbai City,3922,1,6,5,3,18,10,8,23
Delhi Dynamo,3922,2,5,6,3,26,18,8,21
Chennaiyin,3922,3,5,5,4,17,19,-2,20
FC Pune City,3922,4,5,4,5,16,16,0,19
Kolkata,3922,5,4,6,4,15,16,-1,18
FC Goa,3922,6,5,2,7,12,17,-5,17
Kerala Blast,3922,7,4,5,5,10,15,-5,17
NorthEast Un,3922,8,4,3,7,10,13,-3,15
Mumbai City,3923,1,6,4,4,16,9,7,22
Kerala Blast,3923,2,6,4,4,13,14,-1,22
Delhi Dynamo,3923,3,5,6,3,24,17,7,21
Kolkata,3923,4,4,7,3,15,14,1,19
NorthEast Un,3923,5,5,4,5,13,12,1,19
FC Goa,3923,6,4,4,6,13,17,-4,16
FC Pune City,3923,7,4,3,7,12,17,-5,15
Chennaiyin,3923,8,3,6,5,15,21,-6,15
Mumbai City,3924,1,7,4,3,18,8,10,25
Delhi Dynamo,3924,2,5,5,4,22,17,5,20
Kolkata,3924,3,4,8,2,18,16,2,20
FC Pune City,3924,4,5,4,5,15,16,-1,19
NorthEast Un,3924,5,5,3,6,10,10,0,18
Chennaiyin,3924,6,4,6,4,14,17,-3,18
Kerala Blast,3924,7,4,4,6,10,16,-6,16
FC Goa,3924,8,3,4,7,9,16,-7,13
Mumbai City,3925,1,6,4,4,17,10,7,22
Kolkata,3925,2,5,7,2,17,12,5,22
Delhi Dynamo,3925,3,5,6,3,24,19,5,21
Kerala Blast,3925,4,6,3,5,13,15,-2,21
NorthEast Un,3925,5,6,2,6,13,12,1,20
FC Goa,3925,6,4,4,6,12,15,-3,16
FC Pune City,3925,7,4,3,7,12,17,-5,15
Chennaiyin,3925,8,3,5,6,13,21,-8,14
Mumbai City,3926,1,7,4,3,17,8,9,25
Kerala Blast,3926,2,6,4,4,13,15,-2,22
Delhi Dynamo,3926,3,5,5,4,24,18,6,20
FC Goa,3926,4,6,2,6,14,16,-2,20
Kolkata,3926,5,4,6,4,14,14,0,18
Chennaiyin,3926,6,4,5,5,15,19,-4,17
NorthEast Un,3926,7,4,3,7,10,13,-3,15
FC Pune City,3926,8,4,3,7,13,17,-4,15
Delhi Dynamo,3927,1,6,6,2,26,15,11,24
Mumbai City,3927,2,6,4,4,16,9,7,22
Kerala Blast,3927,3,5,5,4,12,15,-3,20
Kolkata,3927,4,4,7,3,16,15,1,19
NorthEast Un,3927,5,4,5,5,11,11,0,17
FC Pune City,3927,6,4,4,6,13,16,-3,16
Chennaiyin,3927,7,3,6,5,14,19,-5,15
FC Goa,3927,8,4,3,7,10,18,-8,15
Mumbai City,3928,1,7,4,3,18,9,9,25
NorthEast Un,3928,2,6,3,5,15,12,3,21
Kerala Blast,3928,3,5,5,4,15,17,-2,20
Kolkata,3928,4,3,9,2,16,15,1,18
Delhi Dynamo,3928,5,4,5,5,22,20,2,17
Chennaiyin,3928,6,4,5,5,16,19,-3,17
FC Pune City,3928,7,4,4,6,14,18,-4,16
FC Goa,3928,8,4,3,7,11,17,-6,15
Mumbai City,3929,1,6,5,3,16,8,8,23
Kolkata,3929,2,5,6,3,18,15,3,21
Delhi Dynamo,3929,3,4,7,3,21,15,6,19
FC Pune City,3929,4,5,3,6,15,17,-2,18
Chennaiyin,3929,5,4,6,4,17,20,-3,18
FC Goa,3929,6,5,3,6,12,16,-4,18
NorthEast Un,3929,7,4,4,6,12,13,-1,16
Kerala Blast,3929,8,4,4,6,10,17,-7,16
Kolkata,3930,1,6,6,2,19,14,5,24
Mumbai City,3930,2,6,4,4,16,9,7,22
Delhi Dynamo,3930,3,5,5,4,23,20,3,20
NorthEast Un,3930,4,5,3,6,14,12,2,18
FC Pune City,3930,5,5,3,6,13,16,-3,18
Kerala Blast,3930,6,5,3,6,11,16,-5,18
FC Goa,3930,7,5,2,7,13,17,-4,17
Chennaiyin,3930,8,3,6,5,15,20,-5,15
Kolkata,3931,1,6,6,2,17,12,5,24
Mumbai City,3931,2,6,5,3,18,10,8,23
Kerala Blast,3931,3,6,3,5,12,16,-4,21
Delhi Dynamo,3931,4,4,6,4,23,20,3,18
Chennaiyin,3931,5,4,6,4,16,18,-2,18
NorthEast Un,3931,6,5,2,7,10,12,-2,17
FC Pune City,3931,7,4,3,7,13,17,-4,15
FC Goa,3931,8,4,3,7,12,16,-4,15
Delhi Dynamo,3932,1,6,6,2,26,16,10,24
Mumbai City,3932,2,6,5,3,17,9,8,23
Kolkata,3932,3,5,7,2,17,14,3,22
Kerala Blast,3932,4,6,4,4,12,14,-2,22
Chennaiyin,3932,5,5,5,4,18,17,1,20
FC Pune City,3932,6,4,3,7,15,19,-4,15
NorthEast Un,3932,7,4,2,8,9,14,-5,14
FC Goa,3932,8,3,2,9,9,20,-11,11
Delhi Dynamo,3933,1,6,6,2,28,17,11,24
Mumbai City,3933,2,6,4,4,17,10,7,22
Kolkata,3933,3,5,7,2,16,12,4,22
NorthEast Un,3933,4,5,4,5,17,13,4,19
Chennaiyin,3933,5,4,6,4,16,19,-3,18
FC Pune City,3933,6,4,5,5,13,15,-2,17
Kerala Blast,3933,7,4,4,6,10,19,-9,16
FC Goa,3933,8,3,2,9,8,20,-12,11
Delhi Dynamo,3934,1,7,5,2,29,15,14,26
Mumbai City,3934,2,6,4,4,17,10,7,22
Kolkata,3934,3,4,8,2,16,13,3,20
Chennaiyin,3934,4,4,6,4,16,19,-3,18
FC Pune City,3934,5,4,5,5,13,15,-2,17
Kerala Blast,3934,6,4,5,5,12,18,-6,17
NorthEast Un,3934,7,4,4,6,12,15,-3,16
FC Goa,3934,8,3,3,8,10,20,-10,12
Delhi Dynamo,3935,1,5,7,2,30,19,11,22
Mumbai City,3935,2,6,4,4,17,13,4,22
Kolkata,3935,3,4,8,2,18,15,3,20
Kerala Blast,3935,4,4,6,4,14,18,-4,18
Chennaiyin,3935,5,4,5,5,15,19,-4,17
NorthEast Un,3935,6,4,4,6,14,15,-1,16
FC Pune City,3935,7,4,4,6,13,17,-4,16
FC Goa,3935,8,4,4,6,12,17,-5,16
Mumbai City,3936,1,7,4,3,18,8,10,25
Delhi Dynamo,3936,2,6,5,3,26,17,9,23
NorthEast Un,3936,3,6,2,6,12,11,1,20
Kolkata,3936,4,4,7,3,17,14,3,19
FC Pune City,3936,5,5,4,5,15,16,-1,19
Kerala Blast,3936,6,4,4,6,10,19,-9,16
FC Goa,3936,7,4,3,7,10,17,-7,15
Chennaiyin,3936,8,3,5,6,13,19,-6,14
Delhi Dynamo,3937,1,6,6,2,30,15,15,24
Mumbai City,3937,2,6,4,4,16,12,4,22
Kerala Blast,3937,3,5,5,4,11,14,-3,20
FC Pune City,3937,4,5,4,5,14,14,0,19
Chennaiyin,3937,5,4,6,4,15,17,-2,18
Kolkata,3937,6,3,7,4,15,17,-2,16
NorthEast Un,3937,7,4,4,6,11,13,-2,16
FC Goa,3937,8,3,4,7,10,20,-10,13
Mumbai City,3938,1,7,4,3,18,9,9,25
Kolkata,3938,2,5,7,2,17,13,4,22
Kerala Blast,3938,3,6,3,5,13,16,-3,21
Delhi Dynamo,3938,4,5,5,4,24,18,6,20
FC Goa,3938,5,5,2,7,12,16,-4,17
FC Pune City,3938,6,4,4,6,15,18,-3,16
NorthEast Un,3938,7,4,3,7,11,13,-2,15
Chennaiyin,3938,8,3,6,5,14,21,-7,15
Kolkata,3939,1,6,6,2,24,17,7,24
Delhi Dynamo,3939,2,6,5,3,24,15,9,23
Mumbai City,3939,3,6,4,4,16,9,7,22
NorthEast Un,3939,4,5,4,5,12,11,1,19
FC Pune City,3939,5,5,3,6,15,19,-4,18
Kerala Blast,3939,6,4,4,6,11,18,-7,16
Chennaiyin,3939,7,3,6,5,14,19,-5,15
FC Goa,3939,8,4,2,8,11,19,-8,14
Mumbai City,3940,1,7,4,3,19,8,11,25
NorthEast Un,3940,2,6,3,5,12,10,2,21
Delhi Dynamo,3940,3,5,5,4,24,18,6,20
Kerala Blast,3940,4,5,5,4,12,15,-3,20
Kolkata,3940,5,3,8,3,15,15,0,17
FC Pune City,3940,6,4,4,6,13,16,-3,16
Chennaiyin,3940,7,3,6,5,14,19,-5,15
FC Goa,3940,8,4,3,7,10,18,-8,15
Mumbai City,3941,1,6,4,4,16,9,7,22
Delhi Dynamo,3941,2,5,6,3,22,15,7,21
Kolkata,3941,3,5,6,3,18,16,2,21
NorthEast Un,3941,4,5,4,5,13,12,1,19
FC Pune City,3941,5,5,3,6,16,17,-1,18
Chennaiyin,3941,6,3,7,4,15,19,-4,16
FC Goa,3941,7,4,4,6,12,16,-4,16
Kerala Blast,3941,8,4,4,6,11,19,-8,16
Mumbai City,3942,1,6,5,3,17,9,8,23
Delhi Dynamo,3942,2,5,6,3,25,19,6,21
Kerala Blast,3942,3,5,5,4,13,16,-3,20
Kolkata,3942,4,4,7,3,15,14,1,19
NorthEast Un,3942,5,5,2,7,14,15,-1,17
Chennaiyin,3942,6,4,5,5,17,21,-4,17
FC Goa,3942,7,5,2,7,13,17,-4,17
FC Pune City,3942,8,4,4,6,13,16,-3,16
Mumbai City,3943,1,6,5,3,17,9,8,23
Delhi Dynamo,3943,2,4,7,3,25,19,6,19
FC Pune City,3943,3,5,4,5,14,15,-1,19
Kerala Blast,3943,4,5,4,5,12,16,-4,19
Kolkata,3943,5,3,9,2,16,15,1,18
Chennaiyin,3943,6,4,6,4,19,20,-1,18
FC Goa,3943,7,4,4,6,13,18,-5,16
NorthEast Un,3943,8,4,3,7,13,17,-4,15
Delhi Dynamo,3944,1,6,6,2,28,17,11,24
Mumbai City,3944,2,6,4,4,17,11,6,22
Kolkata,3944,3,5,7,2,21,18,3,22
Chennaiyin,3944,4,4,6,4,20,19,1,18
NorthEast Un,3944,5,5,3,6,13,15,-2,18
Kerala Blast,3944,6,5,3,6,14,20,-6,18
FC Pune City,3944,7,4,4,6,17,21,-4,16
FC Goa,3944,8,3,3,8,13,22,-9,12
Mumbai City,3945,1,6,5,3,16,8,8,23
Delhi Dynamo,3945,2,5,7,2,24,15,9,22
FC Pune City,3945,3,6,3,5,17,16,1,21
NorthEast Un,3945,4,5,3,6,12,13,-1,18
Chennaiyin,3945,5,4,6,4,16,18,-2,18
Kerala Blast,3945,6,5,3,6,13,18,-5,18
Kolkata,3945,7,3,6,5,16,19,-3,15
FC Goa,3945,8,4,3,7,11,18,-7,15
Delhi Dynamo,3946,1,6,6,2,26,15,11,24
Mumbai City,3946,2,6,4,4,17,12,5,22
Kerala Blast,3946,3,6,4,4,14,15,-1,22
Chennaiyin,3946,4,5,5,4,18,17,1,20
Kolkata,3946,5,4,6,4,19,17,2,18
FC Pune City,3946,6,4,4,6,14,20,-6,16
NorthEast Un,3946,7,4,3,7,9,12,-3,15
FC Goa,3946,8,4,2,8,11,20,-9,14
Mumbai City,3947,1,7,4,3,18,8,10,25
Kolkata,3947,2,5,6,3,17,17,0,21
Delhi Dynamo,3947,3,5,5,4,25,20,5,20
Chennaiyin,3947,4,5,5,4,18,17,1,20
FC Goa,3947,5,5,2,7,15,19,-4,17
Kerala Blast,3947,6,4,5,5,11,16,-5,17
FC Pune City,3947,7,4,4,6,14,17,-3,16
NorthEast Un,3947,8,4,3,7,11,15,-4,15
Delhi Dynamo,3948,1,6,6,2,28,15,13,24
Mumbai City,3948,2,6,4,4,17,10,7,22
Kolkata,3948,3,5,7,2,17,13,4,22
Kerala Blast,3948,4,5,4,5,10,15,-5,19
NorthEast Un,3948,5,5,3,6,10,10,0,18
FC Pune City,3948,6,4,4,6,12,15,-3,16
Chennaiyin,3948,7,3,6,5,13,18,-5,15
FC Goa,3948,8,3,4,7,9,20,-11,13
Kolkata,3949,1,6,6,2,17,12,5,24
Mumbai City,3949,2,6,5,3,17,9,8,23
NorthEast Un,3949,3,6,2,6,18,15,3,20
Chennaiyin,3949,4,5,5,4,18,19,-1,20
Delhi Dynamo,3949,5,4,6,4,22,19,3,18
FC Pune City,3949,6,4,4,6,14,17,-3,16
Kerala Blast,3949,7,4,4,6,14,21,-7,16
FC Goa,3949,8,4,2,8,9,17,-8,14
Mumbai City,3950,1,6,5,3,16,8,8,23
NorthEast Un,3950,2,6,3,5,16,10,6,21
Kolkata,3950,3,4,8,2,17,14,3,20
Delhi Dynamo,3950,4,4,7,3,21,17,4,19
Chennaiyin,3950,5,4,5,5,15,21,-6,17
Kerala Blast,3950,6,4,5,5,11,18,-7,17
FC Pune City,3950,7,4,4,6,14,18,-4,16
FC Goa,3950,8,4,3,7,11,15,-4,15
Mumbai City,3951,1,7,4,3,19,9,10,25
NorthEast Un,3951,2,6,3,5,13,11,2,21
Delhi Dynamo,3951,3,5,5,4,23,18,5,20
Kolkata,3951,4,3,9,2,14,13,1,18
FC Pune City,3951,5,4,5,5,13,15,-2,17
Kerala Blast,3951,6,4,5,5,12,17,-5,17
Chennaiyin,3951,7,3,6,5,15,20,-5,15
FC Goa,3951,8,4,3,7,10,16,-6,15
Mumbai City,3952,1,7,4,3,19,9,10,25
Delhi Dynamo,3952,2,5,6,3,26,19,7,21
Kolkata,3952,3,4,8,2,17,15,2,20
Kerala Blast,3952,4,5,5,4,13,16,-3,20
FC Pune City,3952,5,4,5,5,15,17,-2,17
Chennaiyin,3952,6,4,5,5,15,19,-4,17
NorthEast Un,3952,7,4,3,7,11,13,-2,15
FC Goa,3952,8,4,2,8,11,19,-8,14
Kolkata,3953,1,6,6,2,20,14,6,24
Mumbai City,3953,2,6,5,3,16,8,8,23
Delhi Dynamo,3953,3,5,7,2,23,15,8,22
NorthEast Un,3953,4,6,3,5,11,9,2,21
Kerala Blast,3953,5,5,3,6,10,16,-6,18
FC Pune City,3953,6,4,3,7,13,17,-4,15
Chennaiyin,3953,7,3,5,6,13,19,-6,14
FC Goa,3953,8,4,2,8,11,19,-8,14
Mumbai City,3954,1,7,4,3,20,8,12,25
Kerala Blast,3954,2,6,3,5,13,15,-2,21
Delhi Dynamo,3954,3,4,6,4,23,22,1,18
Kolkata,3954,4,4,6,4,15,15,0,18
FC Pune City,3954,5,5,3,6,13,15,-2,18
FC Goa,3954,6,5,3,6,12,15,-3,18
NorthEast Un,3954,7,4,4,6,11,13,-2,16
Chennaiyin,3954,8,3,7,4,14,18,-4,16
Kerala Blast,3955,1,7,3,4,13,14,-1,24
Delhi Dynamo,3955,2,6,5,3,25,16,9,23
Mumbai City,3955,3,6,4,4,17,10,7,22
Kolkata,3955,4,4,7,3,17,16,1,19
Chennaiyin,3955,5,3,7,4,15,19,-4,16
FC Goa,3955,6,4,4,6,10,15,-5,16
NorthEast Un,3955,7,4,3,7,11,14,-3,15
FC Pune City,3955,8,4,3,7,15,19,-4,15
Mumbai City,3956,1,6,5,3,17,9,8,23
Kolkata,3956,2,5,6,3,17,13,4,21
FC Goa,3956,3,6,2,6,13,15,-2,20
Delhi Dynamo,3956,4,4,7,3,23,18,5,19
Kerala Blast,3956,5,5,4,5,12,17,-5,19
Chennaiyin,3956,6,4,5,5,15,19,-4,17
NorthEast Un,3956,7,4,4,6,11,12,-1,16
FC Pune City,3956,8,4,3,7,12,17,-5,15
Mumbai City,3957,1,6,5,3,17,9,8,23
Delhi Dynamo,3957,2,5,7,2,24,15,9,22
Kolkata,3957,3,4,7,3,15,14,1,19
Kerala Blast,3957,4,5,4,5,12,15,-3,19
FC Pune City,3957,5,5,3,6,13,15,-2,18
NorthEast Un,3957,6,5,2,7,10,13,-3,17
FC Goa,3957,7,4,4,6,10,15,-5,16
Chennaiyin,3957,8,3,6,5,14,19,-5,15
Mumbai City,3958,1,7,4,3,18,8,10,25
Kolkata,3958,2,4,8,2,20,17,3,20
Delhi Dynamo,3958,3,4,7,3,24,19,5,19
NorthEast Un,3958,4,5,4,5,13,12,1,19
Kerala Blast,3958,5,4,6,4,14,18,-4,18
FC Pune City,3958,6,4,4,6,14,18,-4,16
FC Goa,3958,7,4,4,6,11,16,-5,16
Chennaiyin,3958,8,3,5,6,13,19,-6,14
Delhi Dynamo,3959,1,6,6,2,27,16,11,24
Mumbai City,3959,2,6,4,4,16,9,7,22
Kolkata,3959,3,5,6,3,18,15,3,21
Kerala Blast,3959,4,5,4,5,11,17,-6,19
NorthEast Un,3959,5,5,3,6,14,14,0,18
FC Pune City,3959,6,4,4,6,14,17,-3,16
Chennaiyin,3959,7,3,7,4,14,18,-4,16
FC Goa,3959,8,3,4,7,10,18,-8,13
Mumbai City,3960,1,7,4,3,17,8,9,25
Kolkata,3960,2,4,7,3,16,16,0,19
Kerala Blast,3960,3,5,4,5,14,17,-3,19
Delhi Dynamo,3960,4,4,6,4,24,19,5,18
Chennaiyin,3960,5,4,6,4,17,20,-3,18
FC Goa,3960,6,5,3,6,14,17,-3,18
NorthEast Un,3960,7,4,4,6,14,15,-1,16
FC Pune City,3960,8,4,4,6,13,17,-4,16
Mumbai City,3961,1,6,5,3,17,9,8,23
Delhi Dynamo,3961,2,5,6,3,25,16,9,21
Kolkata,3961,3,4,7,3,19,18,1,19
FC Pune City,3961,4,5,4,5,17,18,-1,19
Kerala Blast,3961,5,5,4,5,15,18,-3,19
NorthEast Un,3961,6,5,2,7,12,14,-2,17
Chennaiyin,3961,7,4,5,5,16,21,-5,17
FC Goa,3961,8,4,3,7,13,20,-7,15
Mumbai City,3962,1,7,4,3,18,8,10,25
Delhi Dynamo,3962,2,6,5,3,24,16,8,23
Kolkata,3962,3,5,7,2,18,13,5,22
NorthEast Un,3962,4,5,3,6,11,10,1,18
Kerala Blast,3962,5,5,3,6,10,18,-8,18
Chennaiyin,3962,6,3,7,4,14,18,-4,16
FC Pune City,3962,7,4,3,7,13,17,-4,15
FC Goa,3962,8,3,4,7,9,17,-8,13
Mumbai City,3963,1,6,5,3,16,8,8,23
Delhi Dynamo,3963,2,5,7,2,27,19,8,22
FC Pune City,3963,3,6,3,5,16,15,1,21
Kolkata,3963,4,4,7,3,17,14,3,19
Kerala Blast,3963,5,5,4,5,10,15,-5,19
NorthEast Un,3963,6,5,2,7,13,13,0,17
FC Goa,3963,7,4,3,7,12,20,-8,15
Chennaiyin,3963,8,3,5,6,13,20,-7,14
Mumbai City,3964,1,7,4,3,18,8,10,25
Kerala Blast,3964,2,7,3,4,14,14,0,24
Chennaiyin,3964,3,5,5,4,15,17,-2,20
Delhi Dynamo,3964,4,4,7,3,22,17,5,19
Kolkata,3964,5,4,6,4,15,16,-1,18
NorthEast Un,3964,6,4,3,7,10,12,-2,15
FC Pune City,3964,7,4,3,7,13,17,-4,15
FC Goa,3964,8,4,3,7,10,16,-6,15
Mumbai City,3965,1,7,4,3,18,9,9,25
Kerala Blast,3965,2,5,5,4,12,15,-3,20
NorthEast Un,3965,3,5,4,5,12,10,2,19
Kolkata,3965,4,4,7,3,16,15,1,19
Delhi Dynamo,3965,5,4,6,4,24,20,4,18
Chennaiyin,3965,6,4,6,4,15,17,-2,18
FC Pune City,3965,7,4,4,6,14,17,-3,16
FC Goa,3965,8,3,4,7,11,19,-8,13
Kerala Blast,3966,1,7,3,4,18,17,1,24
Mumbai City,3966,2,6,5,3,18,10,8,23
Delhi Dynamo,3966,3,5,6,3,29,20,9,21
NorthEast Un,3966,4,6,2,6,18,15,3,20
Kolkata,3966,5,4,6,4,16,17,-1,18
FC Goa,3966,6,5,2,7,12,19,-7,17
FC Pune City,3966,7,4,3,7,12,17,-5,15
Chennaiyin,3966,8,3,5,6,13,21,-8,14
Mumbai City,3967,1,7,4,3,19,9,10,25
Kolkata,3967,2,5,7,2,17,13,4,22
Kerala Blast,3967,3,5,4,5,12,15,-3,19
Delhi Dynamo,3967,4,4,6,4,24,21,3,18
NorthEast Un,3967,5,5,3,6,13,13,0,18
FC Pune City,3967,6,5,3,6,13,15,-2,18
Chennaiyin,3967,7,4,6,4,16,19,-3,18
FC Goa,3967,8,3,3,8,12,21,-9,12
Mumbai City,3968,1,6,5,3,18,10,8,23
NorthEast Un,3968,2,7,2,5,17,9,8,23
Delhi Dynamo,3968,3,5,6,3,25,19,6,21
FC Pune City,3968,4,6,3,5,15,15,0,21
Kolkata,3968,5,3,8,3,18,18,0,17
Kerala Blast,3968,6,4,4,6,12,19,-7,16
FC Goa,3968,7,4,3,7,11,17,-6,15
Chennaiyin,3968,8,3,5,6,13,22,-9,14
Mumbai City,3969,1,6,5,3,17,9,8,23
NorthEast Un,3969,2,6,3,5,15,13,2,21
Kerala Blast,3969,3,6,3,5,13,16,-3,21
Delhi Dynamo,3969,4,4,8,2,24,17,7,20
Kolkata,3969,5,4,7,3,17,14,3,19
Chennaiyin,3969,6,3,6,5,17,22,-5,15
FC Pune City,3969,7,4,3,7,12,18,-6,15
FC Goa,3969,8,3,5,6,11,17,-6,14
Delhi Dynamo,3970,1,5,7,2,25,16,9,22
Mumbai City,3970,2,6,4,4,17,11,6,22
Kolkata,3970,3,5,7,2,18,14,4,22
Kerala Blast,3970,4,6,3,5,12,14,-2,21
Chennaiyin,3970,5,5,5,4,16,18,-2,20
NorthEast Un,3970,6,4,3,7,10,12,-2,15
FC Pune City,3970,7,4,3,7,12,18,-6,15
FC Goa,3970,8,3,4,7,11,18,-7,13
Mumbai City,3971,1,6,5,3,17,9,8,23
Chennaiyin,3971,2,5,5,4,17,19,-2,20
FC Pune City,3971,3,5,4,5,16,16,0,19
Delhi Dynamo,3971,4,4,6,4,23,21,2,18
NorthEast Un,3971,5,5,3,6,14,13,1,18
Kerala Blast,3971,6,4,6,4,10,14,-4,18
FC Goa,3971,7,5,2,7,13,16,-3,17
Kolkata,3971,8,3,7,4,15,17,-2,16
Delhi Dynamo,3972,1,6,6,2,27,16,11,24
Mumbai City,3972,2,6,5,3,18,10,8,23
Chennaiyin,3972,3,5,5,4,18,18,0,20
Kerala Blast,3972,4,5,5,4,12,15,-3,20
Kolkata,3972,5,4,7,3,17,15,2,19
FC Pune City,3972,6,4,4,6,12,16,-4,16
NorthEast Un,3972,7,4,3,7,10,13,-3,15
FC Goa,3972,8,3,3,8,10,21,-11,12
Delhi Dynamo,3973,1,7,5,2,27,16,11,26
Mumbai City,3973,2,6,4,4,16,9,7,22
Kerala Blast,3973,3,6,4,4,13,13,0,22
Chennaiyin,3973,4,4,6,4,19,19,0,18
Kolkata,3973,5,4,6,4,16,16,0,18
NorthEast Un,3973,6,4,4,6,12,13,-1,16
FC Pune City,3973,7,4,3,7,13,20,-7,15
FC Goa,3973,8,4,2,8,11,21,-10,14
Kerala Blast,3974,1,7,3,4,15,15,0,24
Mumbai City,3974,2,6,5,3,16,8,8,23
Delhi Dynamo,3974,3,5,6,3,23,16,7,21
FC Pune City,3974,4,5,3,6,15,17,-2,18
FC Goa,3974,5,5,3,6,11,15,-4,18
Kolkata,3974,6,3,7,4,16,18,-2,16
NorthEast Un,3974,7,4,3,7,11,13,-2,15
Chennaiyin,3974,8,3,6,5,15,20,-5,15
Mumbai City,3975,1,7,4,3,18,8,10,25
Kerala Blast,3975,2,7,3,4,13,13,0,24
Delhi Dynamo,3975,3,5,5,4,23,19,4,20
NorthEast Un,3975,4,6,2,6,14,10,4,20
FC Pune City,3975,5,5,3,6,15,17,-2,18
FC Goa,3975,6,4,3,7,15,18,-3,15
Kolkata,3975,7,3,6,5,15,21,-6,15
Chennaiyin,3975,8,3,6,5,15,22,-7,15
Delhi Dynamo,3976,1,6,5,3,28,19,9,23
Mumbai City,3976,2,6,4,4,17,10,7,22
Kolkata,3976,3,4,7,3,18,17,1,19
Kerala Blast,3976,4,5,4,5,13,16,-3,19
Chennaiyin,3976,5,4,6,4,17,18,-1,18
FC Pune City,3976,6,5,3,6,15,17,-2,18
FC Goa,3976,7,5,2,7,12,19,-7,17
NorthEast Un,3976,8,4,3,7,11,15,-4,15
Delhi Dynamo,3977,1,5,7,2,26,18,8,22
Mumbai City,3977,2,6,4,4,18,11,7,22
Kerala Blast,3977,3,6,4,4,15,15,0,22
Kolkata,3977,4,4,6,4,15,16,-1,18
Chennaiyin,3977,5,4,6,4,15,17,-2,18
NorthEast Un,3977,6,4,5,5,12,12,0,17
FC Pune City,3977,7,4,3,7,12,17,-5,15
FC Goa,3977,8,4,3,7,9,16,-7,15
Mumbai City,3978,1,7,4,3,17,8,9,25
Kerala Blast,3978,2,7,3,4,17,14,3,24
FC Goa,3978,3,6,2,6,14,14,0,20
Delhi Dynamo,3978,4,4,6,4,22,18,4,18
Kolkata,3978,5,4,6,4,20,19,1,18
NorthEast Un,3978,6,4,4,6,11,14,-3,16
Chennaiyin,3978,7,3,6,5,14,20,-6,15
FC Pune City,3978,8,4,3,7,14,22,-8,15
Kerala Blast,3979,1,7,3,4,15,15,0,24
Delhi Dynamo,3979,2,6,5,3,27,17,10,23
Mumbai City,3979,3,6,4,4,17,10,7,22
Chennaiyin,3979,4,5,5,4,16,17,-1,20
Kolkata,3979,5,4,7,3,18,16,2,19
NorthEast Un,3979,6,5,2,7,12,13,-1,17
FC Pune City,3979,7,4,3,7,12,17,-5,15
FC Goa,3979,8,3,3,8,10,22,-12,12
Mumbai City,3980,1,7,4,3,17,8,9,25
Kerala Blast,3980,2,6,4,4,14,14,0,22
Delhi Dynamo,3980,3,5,6,3,24,17,7,21
Kolkata,3980,4,4,7,3,14,13,1,19
FC Goa,3980,5,5,2,7,11,16,-5,17
NorthEast Un,3980,6,4,4,6,12,15,-3,16
FC Pune City,3980,7,4,3,7,12,16,-4,15
Chennaiyin,3980,8,3,6,5,14,19,-5,15
Mumbai City,3981,1,7,4,3,18,8,10,25
Kerala Blast,3981,2,6,3,5,16,19,-3,21
Kolkata,3981,3,4,8,2,17,13,4,20
Delhi Dynamo,3981,4,5,5,4,22,20,2,20
NorthEast Un,3981,5,5,2,7,12,14,-2,17
Chennaiyin,3981,6,4,5,5,14,19,-5,17
FC Pune City,3981,7,4,4,6,14,17,-3,16
FC Goa,3981,8,4,3,7,13,16,-3,15
Mumbai City,3982,1,7,4,3,19,8,11,25
Delhi Dynamo,3982,2,6,5,3,26,17,9,23
Kerala Blast,3982,3,6,3,5,12,15,-3,21
Kolkata,3982,4,4,6,4,16,16,0,18
FC Pune City,3982,5,5,3,6,13,15,-2,18
NorthEast Un,3982,6,5,3,6,10,13,-3,18
Chennaiyin,3982,7,3,6,5,14,19,-5,15
FC Goa,3982,8,4,2,8,11,18,-7,14
Mumbai City,3983,1,7,4,3,19,10,9,25
Kerala Blast,3983,2,6,3,5,15,16,-1,21
NorthEast Un,3983,3,5,3,6,16,13,3,18
Kolkata,3983,4,4,6,4,15,15,0,18
FC Pune City,3983,5,5,3,6,13,17,-4,18
FC Goa,3983,6,5,3,6,11,15,-4,18
Delhi Dynamo,3983,7,4,5,5,24,23,1,17
Chennaiyin,3983,8,3,7,4,15,19,-4,16
Delhi Dynamo,3984,1,6,6,2,26,15,11,24
Mumbai City,3984,2,6,5,3,17,9,8,23
Kolkata,3984,3,4,7,3,20,18,2,19
FC Pune City,3984,4,5,4,5,16,17,-1,19
Kerala Blast,3984,5,5,3,6,12,18,-6,18
Chennaiyin,3984,6,4,5,5,14,18,-4,17
FC Goa,3984,7,5,2,7,12,19,-7,17
NorthEast Un,3984,8,4,2,8,9,12,-3,14
Mumbai City,3985,1,6,4,4,17,11,6,22
Kolkata,3985,2,5,7,2,17,13,4,22
Delhi Dynamo,3985,3,5,6,3,26,18,8,21
NorthEast Un,3985,4,6,3,5,16,12,4,21
Kerala Blast,3985,5,5,5,4,12,14,-2,20
Chennaiyin,3985,6,4,5,5,16,22,-6,17
FC Pune City,3985,7,4,3,7,12,18,-6,15
FC Goa,3985,8,3,3,8,9,17,-8,12
Mumbai City,3986,1,7,4,3,18,8,10,25
Delhi Dynamo,3986,2,6,5,3,26,18,8,23
Kolkata,3986,3,5,6,3,18,14,4,21
Kerala Blast,3986,4,5,3,6,10,15,-5,18
NorthEast Un,3986,5,5,2,7,12,13,-1,17
FC Goa,3986,6,5,2,7,13,17,-4,17
Chennaiyin,3986,7,4,5,5,15,20,-5,17
FC Pune City,3986,8,4,3,7,12,19,-7,15
Delhi Dynamo,3987,1,6,6,2,25,16,9,24
Mumbai City,3987,2,6,5,3,17,9,8,23
Kolkata,3987,3,5,7,2,19,15,4,22
FC Pune City,3987,4,5,4,5,16,17,-1,19
Kerala Blast,3987,5,5,3,6,14,18,-4,18
NorthEast Un,3987,6,5,2,7,12,13,-1,17
Chennaiyin,3987,7,3,5,6,14,21,-7,14
FC Goa,3987,8,4,2,8,11,19,-8,14
Delhi Dynamo,3988,1,7,5,2,27,17,10,26
Mumbai City,3988,2,6,4,4,18,11,7,22
Kolkata,3988,3,5,7,2,20,15,5,22
Kerala Blast,3988,4,6,4,4,17,18,-1,22
NorthEast Un,3988,5,5,2,7,13,15,-2,17
FC Pune City,3988,6,4,3,7,12,17,-5,15
Chennaiyin,3988,7,3,5,6,15,22,-7,14
FC Goa,3988,8,4,2,8,12,19,-7,14
Mumbai City,3989,1,6,5,3,17,9,8,23
FC Goa,3989,2,6,2,6,15,18,-3,20
Kerala Blast,3989,3,5,5,4,11,14,-3,20
FC Pune City,3989,4,5,4,5,15,16,-1,19
Delhi Dynamo,3989,5,4,6,4,23,20,3,18
NorthEast Un,3989,6,5,2,7,13,12,1,17
Chennaiyin,3989,7,4,5,5,17,21,-4,17
Kolkata,3989,8,3,7,4,15,16,-1,16
Mumbai City,3990,1,6,5,3,17,9,8,23
Delhi Dynamo,3990,2,5,7,2,23,15,8,22
Kolkata,3990,3,5,7,2,18,13,5,22
NorthEast Un,3990,4,5,3,6,13,13,0,18
Kerala Blast,3990,5,5,3,6,14,19,-5,18
Chennaiyin,3990,6,4,5,5,15,20,-5,17
FC Pune City,3990,7,4,4,6,13,18,-5,16
FC Goa,3990,8,4,2,8,10,16,-6,14
Mumbai City,3991,1,7,4,3,18,8,10,25
Kolkata,3991,2,5,7,2,17,14,3,22
Delhi Dynamo,3991,3,5,6,3,23,17,6,21
FC Pune City,3991,4,5,4,5,15,15,0,19
Chennaiyin,3991,5,4,6,4,15,18,-3,18
Kerala Blast,3991,6,5,3,6,12,18,-6,18
NorthEast Un,3991,7,4,2,8,10,13,-3,14
FC Goa,3991,8,3,4,7,10,17,-7,13
Delhi Dynamo,3992,1,7,5,2,27,15,12,26
Mumbai City,3992,2,6,4,4,16,10,6,22
Kolkata,3992,3,5,6,3,20,16,4,21
FC Pune City,3992,4,5,4,5,16,16,0,19
Chennaiyin,3992,5,4,6,4,17,19,-2,18
NorthEast Un,3992,6,5,2,7,11,13,-2,17
Kerala Blast,3992,7,4,4,6,13,22,-9,16
FC Goa,3992,8,3,3,8,10,19,-9,12
Mumbai City,3993,1,7,4,3,18,8,10,25
Kolkata,3993,2,6,6,2,16,12,4,24
Delhi Dynamo,3993,3,5,5,4,24,19,5,20
FC Pune City,3993,4,5,3,6,13,15,-2,18
Kerala Blast,3993,5,5,3,6,10,15,-5,18
NorthEast Un,3993,6,5,2,7,11,13,-2,17
Chennaiyin,3993,7,4,5,5,17,20,-3,17
FC Goa,3993,8,4,2,8,12,19,-7,14
Mumbai City,3994,1,6,4,4,16,9,7,22
Delhi Dynamo,3994,2,5,6,3,23,17,6,21
Kolkata,3994,3,4,8,2,14,12,2,20
Chennaiyin,3994,4,4,6,4,17,18,-1,18
NorthEast Un,3994,5,5,3,6,11,13,-2,18
FC Pune City,3994,6,4,5,5,13,15,-2,17
FC Goa,3994,7,4,4,6,11,15,-4,16
Kerala Blast,3994,8,4,4,6,10,16,-6,16
Mumbai City,3995,1,6,5,3,17,9,8,23
Kerala Blast,3995,2,6,4,4,11,13,-2,22
Delhi Dynamo,3995,3,5,6,3,25,19,6,21
Kolkata,3995,4,4,7,3,15,13,2,19
NorthEast Un,3995,5,5,2,7,11,12,-1,17
FC Pune City,3995,6,4,5,5,12,14,-2,17
FC Goa,3995,7,5,2,7,14,19,-5,17
Chennaiyin,3995,8,3,5,6,15,21,-6,14
Mumbai City,3996,1,7,4,3,17,8,9,25
NorthEast Un,3996,2,6,3,5,12,9,3,21
Kerala Blast,3996,3,6,3,5,14,18,-4,21
Delhi Dynamo,3996,4,5,5,4,24,18,6,20
Chennaiyin,3996,5,4,6,4,15,17,-2,18
FC Pune City,3996,6,5,3,6,14,16,-2,18
Kolkata,3996,7,3,6,5,15,19,-4,15
FC Goa,3996,8,4,2,8,13,19,-6,14
Mumbai City,3997,1,7,4,3,18,9,9,25
Delhi Dynamo,3997,2,5,6,3,25,17,8,21
FC Pune City,3997,3,5,4,5,16,14,2,19
Kolkata,3997,4,4,7,3,15,14,1,19
NorthEast Un,3997,5,5,3,6,12,13,-1,18
Kerala Blast,3997,6,5,3,6,12,19,-7,18
Chennaiyin,3997,7,4,5,5,16,20,-4,17
FC Goa,3997,8,4,2,8,10,18,-8,14
Mumbai City,3998,1,7,4,3,18,9,9,25
Kolkata,3998,2,5,6,3,16,14,2,21
Delhi Dynamo,3998,3,4,7,3,23,17,6,19
Kerala Blast,3998,4,5,4,5,13,15,-2,19
NorthEast Un,3998,5,5,3,6,13,14,-1,18
Chennaiyin,3998,6,4,5,5,16,21,-5,17
FC Pune City,3998,7,4,4,6,13,16,-3,16
FC Goa,3998,8,4,3,7,11,17,-6,15
Mumbai City,3999,1,7,4,3,19,9,10,25
FC Pune City,3999,2,6,3,5,17,15,2,21
Delhi Dynamo,3999,3,5,5,4,26,20,6,20
Chennaiyin,3999,4,5,5,4,20,19,1,20
Kerala Blast,3999,5,5,4,5,13,16,-3,19
Kolkata,3999,6,3,8,3,13,15,-2,17
FC Goa,3999,7,4,3,7,11,18,-7,15
NorthEast Un,3999,8,4,2,8,12,19,-7,14
Delhi Dynamo,4000,1,7,5,2,30,17,13,26
Mumbai City,4000,2,6,4,4,16,11,5,22
FC Pune City,4000,3,6,3,5,16,14,2,21
NorthEast Un,4000,4,6,2,6,16,15,1,20
Kolkata,4000,5,4,6,4,15,15,0,18
FC Goa,4000,6,5,2,7,12,18,-6,17
Kerala Blast,4000,7,4,3,7,10,19,-9,15
Chennaiyin,4000,8,3,5,6,17,23,-6,14
Mumbai City,4001,1,7,4,3,17,8,9,25
Kolkata,4001,2,5,7,2,17,13,4,22
NorthEast Un,4001,3,6,3,5,12,10,2,21
Kerala Blast,4001,4,5,4,5,12,15,-3,19
Delhi Dynamo,4001,5,4,6,4,22,18,4,18
FC Goa,4001,6,5,2,7,13,17,-4,17
FC Pune City,4001,7,4,3,7,12,17,-5,15
Chennaiyin,4001,8,3,5,6,14,21,-7,14
Delhi Dynamo,4002,1,5,7,2,26,16,10,22
Mumbai City,4002,2,6,4,4,16,11,5,22
Kolkata,4002,3,4,7,3,17,17,0,19
Kerala Blast,4002,4,5,4,5,12,16,-4,19
Chennaiyin,4002,5,4,6,4,16,19,-3,18
FC Pune City,4002,6,4,5,5,13,15,-2,17
FC Goa,4002,7,4,4,6,14,18,-4,16
NorthEast Un,4002,8,4,3,7,11,13,-2,15
Mumbai City,4003,1,7,4,3,20,9,11,25
Kerala Blast,4003,2,6,4,4,14,15,-1,22
Delhi Dynamo,4003,3,5,5,4,23,19,4,20
Chennaiyin,4003,4,5,5,4,18,19,-1,20
FC Pune City,4003,5,5,3,6,13,16,-3,18
FC Goa,4003,6,5,2,7,11,17,-6,17
Kolkata,4003,7,3,6,5,15,17,-2,15
NorthEast Un,4003,8,4,3,7,12,14,-2,15
Mumbai City,4004,1,6,5,3,16,8,8,23
Delhi Dynamo,4004,2,5,6,3,23,17,6,21
NorthEast Un,4004,3,6,3,5,14,10,4,21
Kolkata,4004,4,4,8,2,16,14,2,20
Kerala Blast,4004,5,4,5,5,11,17,-6,17
FC Pune City,4004,6,4,4,6,13,16,-3,16
Chennaiyin,4004,7,3,6,5,14,19,-5,15
FC Goa,4004,8,4,3,7,11,17,-6,15
Mumbai City,4005,1,7,4,3,17,8,9,25
NorthEast Un,4005,2,7,2,5,14,9,5,23
Kolkata,4005,3,5,6,3,15,15,0,21
Delhi Dynamo,4005,4,4,6,4,22,19,3,18
FC Pune City,4005,5,4,4,6,13,16,-3,16
FC Goa,4005,6,4,4,6,12,15,-3,16
Kerala Blast,4005,7,4,4,6,10,16,-6,16
Chennaiyin,4005,8,3,6,5,13,18,-5,15
Mumbai City,4006,1,7,4,3,19,9,10,25
Kerala Blast,4006,2,7,3,4,19,18,1,24
Delhi Dynamo,4006,3,5,5,4,24,21,3,20
Chennaiyin,4006,4,4,6,4,16,19,-3,18
NorthEast Un,4006,5,5,2,7,14,13,1,17
Kolkata,4006,6,3,7,4,16,17,-1,16
FC Pune City,4006,7,4,4,6,15,20,-5,16
FC Goa,4006,8,4,3,7,13,19,-6,15
Mumbai City,4007,1,6,5,3,18,10,8,23
Kolkata,4007,2,4,8,2,18,15,3,20
NorthEast Un,4007,3,6,2,6,14,14,0,20
Delhi Dynamo,4007,4,4,7,3,24,19,5,19
Kerala Blast,4007,5,5,4,5,14,17,-3,19
Chennaiyin,4007,6,4,6,4,19,20,-1,18
FC Pune City,4007,7,4,3,7,14,20,-6,15
FC Goa,4007,8,3,5,6,12,18,-6,14
Mumbai City,4008,1,6,5,3,16,8,8,23
Delhi Dynamo,4008,2,4,8,2,21,14,7,20
Kolkata,4008,3,4,7,3,17,15,2,19
Kerala Blast,4008,4,5,4,5,12,18,-6,19
Chennaiyin,4008,5,4,6,4,16,19,-3,18
NorthEast Un,4008,6,4,5,5,10,10,0,17
FC Pune City,4008,7,4,4,6,15,18,-3,16
FC Goa,4008,8,4,3,7,11,16,-5,15
Mumbai City,4009,1,6,4,4,18,13,5,22
NorthEast Un,4009,2,6,3,5,16,12,4,21
Kerala Blast,4009,3,6,3,5,16,18,-2,21
Delhi Dynamo,4009,4,5,5,4,26,20,6,20
FC Goa,4009,5,5,3,6,11,15,-4,18
Kolkata,4009,6,3,8,3,15,15,0,17
FC Pune City,4009,7,4,4,6,13,17,-4,16
Chennaiyin,4009,8,3,6,5,14,19,-5,15
Mumbai City,4010,1,6,5,3,18,10,8,23
Delhi Dynamo,4010,2,5,7,2,27,18,9,22
Kerala Blast,4010,3,5,4,5,11,15,-4,19
FC Goa,4010,4,5,3,6,16,17,-1,18
FC Pune City,4010,5,4,5,5,14,16,-2,17
NorthEast Un,4010,6,5,2,7,10,13,-3,17
Chennaiyin,4010,7,4,5,5,15,20,-5,17
Kolkata,4010,8,3,7,4,15,17,-2,16
Mumbai City,4011,1,6,5,3,18,10,8,23
Delhi Dynamo,4011,2,5,6,3,25,18,7,21
Kolkata,4011,3,5,6,3,16,14,2,21
NorthEast Un,4011,4,6,2,6,14,12,2,20
FC Pune City,4011,5,5,3,6,14,16,-2,18
Kerala Blast,4011,6,5,3,6,12,18,-6,18
Chennaiyin,4011,7,3,6,5,13,18,-5,15
FC Goa,4011,8,4,3,7,10,16,-6,15
Mumbai City,4012,1,7,4,3,18,8,10,25
Delhi Dynamo,4012,2,5,5,4,25,21,4,20
NorthEast Un,4012,3,6,2,6,15,14,1,20
Kolkata,4012,4,4,7,3,18,17,1,19
Kerala Blast,4012,5,5,4,5,15,20,-5,19
FC Pune City,4012,6,4,5,5,14,16,-2,17
FC Goa,4012,7,4,3,7,14,18,-4,15
Chennaiyin,4012,8,3,6,5,14,19,-5,15
Mumbai City,4013,1,7,4,3,19,8,11,25
NorthEast Un,4013,2,6,3,5,12,10,2,21
Kolkata,4013,3,4,7,3,17,19,-2,19
FC Goa,4013,4,5,3,6,16,17,-1,18
Delhi Dynamo,4013,5,4,5,5,23,21,2,17
FC Pune City,4013,6,4,5,5,16,18,-2,17
Kerala Blast,4013,7,4,5,5,13,18,-5,17
Chennaiyin,4013,8,3,6,5,14,19,-5,15
Mumbai City,4014,1,7,4,3,18,9,9,25
Kolkata,4014,2,5,7,2,21,15,6,22
Delhi Dynamo,4014,3,5,6,3,28,20,8,21
Kerala Blast,4014,4,5,3,6,14,17,-3,18
NorthEast Un,4014,5,5,2,7,13,15,-2,17
Chennaiyin,4014,6,4,5,5,15,19,-4,17
FC Pune City,4014,7,4,4,6,13,20,-7,16
FC Goa,4014,8,4,3,7,13,20,-7,15
Delhi Dynamo,4015,1,6,5,3,24,18,6,23
Mumbai City,4015,2,6,4,4,16,9,7,22
Kerala Blast,4015,3,6,4,4,15,13,2,22
NorthEast Un,4015,4,6,3,5,15,10,5,21
Kolkata,4015,5,4,6,4,14,16,-2,18
FC Pune City,4015,6,5,3,6,14,18,-4,18
FC Goa,4015,7,4,2,8,13,17,-4,14
Chennaiyin,4015,8,3,5,6,14,24,-10,14
Mumbai City,4016,1,6,5,3,17,9,8,23
NorthEast Un,4016,2,7,2,5,15,10,5,23
Kolkata,4016,3,5,7,2,22,15,7,22
Delhi Dynamo,4016,4,5,6,3,25,17,8,21
Kerala Blast,4016,5,5,4,5,13,17,-4,19
Chennaiyin,4016,6,4,5,5,15,21,-6,17
FC Pune City,4016,7,4,3,7,14,20,-6,15
FC Goa,4016,8,3,2,9,9,21,-12,11
Delhi Dynamo,4017,1,6,6,2,26,16,10,24
Mumbai City,4017,2,6,4,4,17,11,6,22
FC Pune City,4017,3,5,4,5,13,14,-1,19
Chennaiyin,4017,4,4,6,4,18,18,0,18
Kolkata,4017,5,3,8,3,14,15,-1,17
NorthEast Un,4017,6,5,2,7,14,18,-4,17
FC Goa,4017,7,4,4,6,10,14,-4,16
Kerala Blast,4017,8,4,4,6,12,18,-6,16
Mumbai City,4018,1,7,4,3,19,8,11,25
Delhi Dynamo,4018,2,5,6,3,26,19,7,21
Kolkata,4018,3,4,8,2,17,15,2,20
Kerala Blast,4018,4,5,4,5,15,17,-2,19
NorthEast Un,4018,5,5,3,6,12,14,-2,18
FC Goa,4018,6,4,4,6,11,16,-5,16
Chennaiyin,4018,7,3,6,5,15,20,-5,15
FC Pune City,4018,8,4,3,7,14,20,-6,15
Mumbai City,4019,1,7,4,3,19,9,10,25
Kolkata,4019,2,5,7,2,19,14,5,22
Delhi Dynamo,4019,3,4,7,3,23,18,5,19
NorthEast Un,4019,4,5,3,6,11,11,0,18
FC Pune City,4019,5,5,3,6,14,16,-2,18
Kerala Blast,4019,6,5,3,6,10,17,-7,18
Chennaiyin,4019,7,4,5,5,15,19,-4,17
FC Goa,4019,8,3,4,7,11,18,-7,13
Mumbai City,4020,1,7,4,3,18,8,10,25
Delhi Dynamo,4020,2,5,6,3,25,18,7,21
NorthEast Un,4020,3,6,3,5,13,11,2,21
Kerala Blast,4020,4,6,3,5,14,15,-1,21
Kolkata,4020,5,4,6,4,16,16,0,18
FC Goa,4020,6,5,2,7,13,19,-6,17
FC Pune City,4020,7,4,3,7,14,20,-6,15
Chennaiyin,4020,8,3,5,6,15,21,-6,14
Mumbai City,4021,1,6,5,3,18,10,8,23
Kerala Blast,4021,2,6,4,4,12,14,-2,22
NorthEast Un,4021,3,6,3,5,13,10,3,21
Delhi Dynamo,4021,4,4,6,4,24,21,3,18
FC Pune City,4021,5,5,3,6,14,16,-2,18
FC Goa,4021,6,5,2,7,13,15,-2,17
Chennaiyin,4021,7,4,5,5,14,18,-4,17
Kolkata,4021,8,3,6,5,15,19,-4,15
Mumbai City,4022,1,7,4,3,17,8,9,25
Kolkata,4022,2,5,6,3,15,14,1,21
NorthEast Un,4022,3,6,2,6,15,14,1,20
Delhi Dynamo,4022,4,4,6,4,24,19,5,18
FC Pune City,4022,5,5,3,6,13,15,-2,18
FC Goa,4022,6,5,3,6,13,16,-3,18
Chennaiyin,4022,7,4,5,5,16,20,-4,17
Kerala Blast,4022,8,4,3,7,10,17,-7,15
Mumbai City,4023,1,7,4,3,17,8,9,25
FC Goa,4023,2,6,2,6,13,14,-1,20
Kerala Blast,4023,3,5,5,4,14,17,-3,20
NorthEast Un,4023,4,5,4,5,14,12,2,19
FC Pune City,4023,5,5,3,6,14,16,-2,18
Delhi Dynamo,4023,6,4,5,5,22,19,3,17
Kolkata,4023,7,3,7,4,17,20,-3,16
Chennaiyin,4023,8,3,6,5,14,19,-5,15
Mumbai City,4024,1,7,4,3,18,9,9,25
Kerala Blast,4024,2,6,4,4,13,13,0,22
Delhi Dynamo,4024,3,5,5,4,25,18,7,20
Kolkata,4024,4,4,8,2,15,13,2,20
Chennaiyin,4024,5,4,6,4,16,19,-3,18
FC Pune City,4024,6,4,4,6,12,15,-3,16
FC Goa,4024,7,4,3,7,12,18,-6,15
NorthEast Un,4024,8,4,2,8,10,16,-6,14
Mumbai City,4025,1,6,5,3,16,8,8,23
Kerala Blast,4025,2,6,4,4,16,17,-1,22
Delhi Dynamo,4025,3,4,7,3,27,21,6,19
Kolkata,4025,4,4,7,3,20,19,1,19
FC Goa,4025,5,5,3,6,15,19,-4,18
NorthEast Un,4025,6,5,2,7,13,15,-2,17
Chennaiyin,4025,7,4,5,5,15,19,-4,17
FC Pune City,4025,8,4,3,7,15,19,-4,15
Delhi Dynamo,4026,1,6,6,2,30,16,14,24
Mumbai City,4026,2,6,5,3,18,10,8,23
Kolkata,4026,3,4,7,3,14,15,-1,19
FC Pune City,4026,4,5,3,6,16,16,0,18
NorthEast Un,4026,5,5,3,6,12,14,-2,18
FC Goa,4026,6,5,2,7,12,18,-6,17
Kerala Blast,4026,7,4,5,5,10,17,-7,17
Chennaiyin,4026,8,3,5,6,15,21,-6,14
Mumbai City,4027,1,7,4,3,21,9,12,25
Kolkata,4027,2,5,7,2,21,13,8,22
Delhi Dynamo,4027,3,5,6,3,25,20,5,21
Chennaiyin,4027,4,5,5,4,18,18,0,20
Kerala Blast,4027,5,5,3,6,12,17,-5,18
NorthEast Un,4027,6,5,2,7,11,14,-3,17
FC Pune City,4027,7,4,4,6,12,16,-4,16
FC Goa,4027,8,3,3,8,9,22,-13,12
Mumbai City,4028,1,7,4,3,19,9,10,25
Delhi Dynamo,4028,2,5,6,3,25,19,6,21
Kerala Blast,4028,3,5,5,4,11,13,-2,20
Kolkata,4028,4,4,7,3,17,14,3,19
NorthEast Un,4028,5,5,4,5,12,11,1,19
FC Goa,4028,6,5,2,7,12,16,-4,17
FC Pune City,4028,7,4,3,7,13,20,-7,15
Chennaiyin,4028,8,3,5,6,14,21,-7,14
Mumbai City,4029,1,7,4,3,18,9,9,25
Kerala Blast,4029,2,6,4,4,14,14,0,22
Kolkata,4029,3,5,6,3,18,14,4,21
Delhi Dynamo,4029,4,5,5,4,23,19,4,20
NorthEast Un,4029,5,5,3,6,14,14,0,18
Chennaiyin,4029,6,4,6,4,18,19,-1,18
FC Pune City,4029,7,4,4,6,13,16,-3,16
FC Goa,4029,8,3,2,9,9,22,-13,11
Mumbai City,4030,1,7,4,3,18,9,9,25
Kolkata,4030,2,6,6,2,19,14,5,24
NorthEast Un,4030,3,5,4,5,13,12,1,19
Delhi Dynamo,4030,4,4,6,4,23,18,5,18
Chennaiyin,4030,5,4,6,4,17,19,-2,18
FC Pune City,4030,6,5,3,6,13,16,-3,18
Kerala Blast,4030,7,4,3,7,10,17,-7,15
FC Goa,4030,8,4,2,8,10,18,-8,14
Mumbai City,4031,1,7,4,3,17,8,9,25
Kolkata,4031,2,5,6,3,15,13,2,21
NorthEast Un,4031,3,6,2,6,13,11,2,20
Delhi Dynamo,4031,4,4,6,4,21,17,4,18
FC Goa,4031,5,5,3,6,11,15,-4,18
Kerala Blast,4031,5,5,3,6,11,15,-4,18
Chennaiyin,4031,7,4,5,5,16,20,-4,17
FC Pune City,4031,8,4,3,7,12,17,-5,15
Mumbai City,4032,1,7,4,3,17,8,9,25
Kerala Blast,4032,2,6,4,4,12,14,-2,22
Delhi Dynamo,4032,3,5,6,3,25,16,9,21
NorthEast Un,4032,4,5,3,6,10,10,0,18
FC Pune City,4032,5,5,3,6,14,16,-2,18
Kolkata,4032,6,3,8,3,15,15,0,17
FC Goa,4032,7,4,3,7,12,19,-7,15
Chennaiyin,4032,8,3,5,6,14,21,-7,14
Mumbai City,4033,1,6,5,3,18,10,8,23
Delhi Dynamo,4033,2,5,7,2,26,17,9,22
Kolkata,4033,3,5,6,3,20,15,5,21
NorthEast Un,4033,4,5,4,5,12,11,1,19
Kerala Blast,4033,5,5,4,5,12,16,-4,19
FC Goa,4033,6,5,2,7,10,16,-6,17
FC Pune City,4033,7,4,3,7,13,20,-7,15
Chennaiyin,4033,8,3,5,6,13,19,-6,14
Delhi Dynamo,4034,1,6,5,3,28,19,9,23
Mumbai City,4034,2,6,4,4,18,11,7,22
Kolkata,4034,3,4,7,3,15,15,0,19
Kerala Blast,4034,4,5,4,5,12,16,-4,19
NorthEast Un,4034,5,5,3,6,12,12,0,18
FC Goa,4034,6,5,2,7,14,18,-4,17
Chennaiyin,4034,7,4,5,5,15,20,-5,17
FC Pune City,4034,8,4,4,6,12,15,-3,16
Mumbai City,4035,1,6,4,4,16,9,7,22
Delhi Dynamo,4035,2,5,6,3,24,18,6,21
Kerala Blast,4035,3,6,3,5,12,16,-4,21
NorthEast Un,4035,4,6,2,6,14,13,1,20
Chennaiyin,4035,5,4,6,4,17,18,-1,18
FC Pune City,4035,6,5,3,6,14,16,-2,18
FC Goa,4035,7,4,4,6,12,17,-5,16
Kolkata,4035,8,3,6,5,14,16,-2,15
Mumbai City,4036,1,6,5,3,17,9,8,23
Delhi Dynamo,4036,2,5,7,2,26,17,9,22
Kerala Blast,4036,3,5,5,4,13,16,-3,20
NorthEast Un,4036,4,5,4,5,12,10,2,19
Kolkata,4036,5,4,7,3,15,15,0,19
FC Pune City,4036,6,5,3,6,16,17,-1,18
Chennaiyin,4036,7,3,5,6,13,20,-7,14
FC Goa,4036,8,4,2,8,10,18,-8,14
Mumbai City,4037,1,7,4,3,18,8,10,25
Kerala Blast,4037,2,7,3,4,14,15,-1,24
Kolkata,4037,3,5,6,3,18,14,4,21
Delhi Dynamo,4037,4,5,5,4,22,19,3,20
NorthEast Un,4037,5,5,2,7,11,12,-1,17
FC Goa,4037,6,5,2,7,13,17,-4,17
FC Pune City,4037,7,4,3,7,12,17,-5,15
Chennaiyin,4037,8,3,5,6,14,20,-6,14
Mumbai City,4038,1,7,4,3,18,8,10,25
Kolkata,4038,2,5,7,2,18,14,4,22
Kerala Blast,4038,3,6,4,4,18,17,1,22
NorthEast Un,4038,4,5,3,6,13,14,-1,18
Delhi Dynamo,4038,5,4,5,5,22,22,0,17
FC Goa,4038,6,5,2,7,12,16,-4,17
FC Pune City,4038,7,4,3,7,15,20,-5,15
Chennaiyin,4038,8,3,6,5,13,18,-5,15
Delhi Dynamo,4039,1,7,5,2,31,15,16,26
Mumbai City,4039,2,6,4,4,16,12,4,22
Kolkata,4039,3,4,7,3,17,16,1,19
FC Pune City,4039,4,5,4,5,16,17,-1,19
Chennaiyin,4039,5,4,6,4,17,17,0,18
Kerala Blast,4039,6,4,5,5,12,17,-5,17
NorthEast Un,4039,7,4,3,7,9,15,-6,15
FC Goa,4039,8,3,4,7,10,19,-9,13
Delhi Dynamo,4040,1,6,6,2,25,15,10,24
Mumbai City,4040,2,6,4,4,17,11,6,22
Kolkata,4040,3,5,6,3,18,16,2,21
FC Pune City,4040,4,6,3,5,17,16,1,21
Chennaiyin,4040,5,4,6,4,16,19,-3,18
Kerala Blast,4040,6,5,3,6,10,16,-6,18
NorthEast Un,4040,7,4,3,7,10,12,-2,15
FC Goa,4040,8,3,3,8,9,17,-8,12
Mumbai City,4041,1,7,4,3,19,10,9,25
Delhi Dynamo,4041,2,5,6,3,27,18,9,21
NorthEast Un,4041,3,6,3,5,14,11,3,21
Kolkata,4041,4,4,8,2,17,15,2,20
FC Pune City,4041,5,4,5,5,13,15,-2,17
Kerala Blast,4041,6,4,4,6,11,18,-7,16
FC Goa,4041,7,4,3,7,12,20,-8,15
Chennaiyin,4041,8,3,5,6,15,21,-6,14
Mumbai City,4042,1,6,5,3,18,10,8,23
NorthEast Un,4042,2,7,2,5,16,10,6,23
Kolkata,4042,3,4,8,2,17,15,2,20
Kerala Blast,4042,4,5,4,5,13,17,-4,19
Delhi Dynamo,4042,5,4,6,4,25,21,4,18
FC Pune City,4042,6,4,4,6,12,16,-4,16
Chennaiyin,4042,7,3,6,5,13,19,-6,15
FC Goa,4042,7,4,3,7,13,19,-6,15
Delhi Dynamo,4043,1,6,6,2,28,16,12,24
Mumbai City,4043,2,6,4,4,16,10,6,22
FC Pune City,4043,3,6,3,5,15,15,0,21
Kolkata,4043,4,4,7,3,18,17,1,19
NorthEast Un,4043,5,5,3,6,12,13,-1,18
FC Goa,4043,6,4,4,6,13,18,-5,16
Kerala Blast,4043,7,4,4,6,10,16,-6,16
Chennaiyin,4043,8,3,5,6,14,21,-7,14
Mumbai City,4044,1,7,4,3,20,10,10,25
Kerala Blast,4044,2,6,4,4,14,14,0,22
Delhi Dynamo,4044,3,5,5,4,24,20,4,20
NorthEast Un,4044,4,6,2,6,14,14,0,20
FC Pune City,4044,5,5,4,5,19,17,2,19
Kolkata,4044,6,4,6,4,19,22,-3,18
Chennaiyin,4044,7,4,5,5,17,20,-3,17
FC Goa,4044,8,3,2,9,11,21,-10,11
Kolkata,4045,1,6,6,2,21,14,7,24
Mumbai City,4045,2,6,5,3,16,8,8,23
Delhi Dynamo,4045,3,5,6,3,22,16,6,21
NorthEast Un,4045,4,6,2,6,13,10,3,20
Chennaiyin,4045,5,4,6,4,15,18,-3,18
Kerala Blast,4045,6,5,3,6,14,18,-4,18
FC Pune City,4045,7,4,3,7,14,22,-8,15
FC Goa,4045,8,3,3,8,9,18,-9,12
Mumbai City,4046,1,7,4,3,19,8,11,25
Delhi Dynamo,4046,2,5,6,3,25,17,8,21
Kolkata,4046,3,4,8,2,17,15,2,20
Chennaiyin,4046,4,4,6,4,17,18,-1,18
FC Pune City,4046,5,5,3,6,14,16,-2,18
Kerala Blast,4046,6,4,5,5,11,16,-5,17
NorthEast Un,4046,7,4,4,6,11,14,-3,16
FC Goa,4046,8,3,4,7,9,19,-10,13
Mumbai City,4047,1,6,5,3,16,8,8,23
Delhi Dynamo,4047,2,5,6,3,25,17,8,21
NorthEast Un,4047,3,5,4,5,12,10,2,19
Kerala Blast,4047,4,5,4,5,10,14,-4,19
Kolkata,4047,5,4,6,4,16,16,0,18
Chennaiyin,4047,6,4,6,4,16,18,-2,18
FC Pune City,4047,7,5,3,6,14,16,-2,18
FC Goa,4047,8,4,2,8,11,21,-10,14
Delhi Dynamo,4048,1,6,5,3,27,20,7,23
Mumbai City,4048,2,6,4,4,17,10,7,22
Kolkata,4048,3,5,7,2,17,12,5,22
NorthEast Un,4048,4,5,3,6,13,11,2,18
FC Pune City,4048,5,5,3,6,13,15,-2,18
Kerala Blast,4048,6,5,3,6,10,17,-7,18
Chennaiyin,4048,7,3,7,4,14,18,-4,16
FC Goa,4048,8,3,4,7,10,18,-8,13
Mumbai City,4049,1,6,5,3,18,10,8,23
Kolkata,4049,2,5,7,2,16,13,3,22
Delhi Dynamo,4049,3,4,7,3,24,18,6,19
NorthEast Un,4049,4,5,4,5,13,10,3,19
Kerala Blast,4049,5,5,4,5,11,15,-4,19
FC Pune City,4049,6,4,4,6,13,16,-3,16
FC Goa,4049,7,4,3,7,10,16,-6,15
Chennaiyin,4049,8,3,6,5,13,20,-7,15
Delhi Dynamo,4050,1,7,5,2,29,15,14,26
Mumbai City,4050,2,6,4,4,17,10,7,22
Kolkata,4050,3,5,7,2,17,13,4,22
Kerala Blast,4050,4,5,5,4,14,17,-3,20
Chennaiyin,4050,5,4,6,4,15,18,-3,18
FC Pune City,4050,6,4,4,6,14,18,-4,16
NorthEast Un,4050,7,4,3,7,10,12,-2,15
FC Goa,4050,8,3,2,9,9,22,-13,11
Mumbai City,4051,1,7,4,3,18,9,9,25
Kerala Blast,4051,2,6,4,4,14,16,-2,22
Delhi Dynamo,4051,3,5,6,3,23,16,7,21
Kolkata,4051,4,5,6,3,19,15,4,21
Chennaiyin,4051,5,4,5,5,16,18,-2,17
NorthEast Un,4051,6,4,4,6,10,13,-3,16
FC Pune City,4051,7,4,3,7,13,18,-5,15
FC Goa,4051,8,4,2,8,10,18,-8,14
Mumbai City,4052,1,7,4,3,20,9,11,25
Delhi Dynamo,4052,2,6,5,3,24,18,6,23
Kerala Blast,4052,3,5,5,4,16,18,-2,20
Kolkata,4052,4,4,7,3,16,15,1,19
NorthEast Un,4052,5,5,3,6,14,13,1,18
FC Pune City,4052,6,4,5,5,15,17,-2,17
Chennaiyin,4052,7,3,5,6,13,20,-7,14
FC Goa,4052,8,4,2,8,9,17,-8,14
Mumbai City,4053,1,7,4,3,19,9,10,25
FC Pune City,4053,2,6,3,5,16,15,1,21
Chennaiyin,4053,3,5,5,4,18,17,1,20
Kolkata,4053,4,4,7,3,15,15,0,19
Kerala Blast,4053,5,5,3,6,11,15,-4,18
Delhi Dynamo,4053,6,4,5,5,23,21,2,17
NorthEast Un,4053,7,5,2,7,11,12,-1,17
FC Goa,4053,8,4,3,7,10,19,-9,15
Mumbai City,4054,1,6,5,3,17,9,8,23
Delhi Dynamo,4054,2,5,6,3,25,18,7,21
Kolkata,4054,3,5,6,3,17,14,3,21
FC Goa,4054,4,6,2,6,13,14,-1,20
Kerala Blast,4054,5,5,4,5,13,16,-3,19
FC Pune City,4054,6,4,4,6,14,18,-4,16
NorthEast Un,4054,7,4,3,7,11,15,-4,15
Chennaiyin,4054,8,3,6,5,13,19,-6,15
Mumbai City,4055,1,7,4,3,17,8,9,25
Delhi Dynamo,4055,2,5,6,3,23,16,7,21
Kerala Blast,4055,3,5,5,4,13,16,-3,20
Kolkata,4055,4,4,7,3,17,16,1,19
FC Pune City,4055,5,5,3,6,15,17,-2,18
Chennaiyin,4055,6,4,5,5,16,21,-5,17
NorthEast Un,4055,7,4,3,7,12,14,-2,15
FC Goa,4055,8,4,3,7,12,17,-5,15
Delhi Dynamo,4056,1,6,6,2,25,16,9,24
Mumbai City,4056,2,6,5,3,17,9,8,23
Kerala Blast,4056,3,6,3,5,15,15,0,21
Kolkata,4056,4,4,6,4,15,16,-1,18
FC Pune City,4056,5,5,3,6,13,19,-6,18
FC Goa,4056,6,5,2,7,14,15,-1,17
Chennaiyin,4056,7,4,5,5,16,21,-5,17
NorthEast Un,4056,8,4,2,8,11,15,-4,14
Delhi Dynamo,4057,1,6,5,3,25,18,7,23
Mumbai City,4057,2,6,4,4,16,9,7,22
NorthEast Un,4057,3,6,3,5,16,12,4,21
Kolkata,4057,4,5,6,3,18,16,2,21
Kerala Blast,4057,5,5,4,5,14,19,-5,19
FC Pune City,4057,6,5,3,6,15,16,-1,18
Chennaiyin,4057,7,3,5,6,15,22,-7,14
FC Goa,4057,8,4,2,8,13,20,-7,14
Mumbai City,4058,1,6,5,3,17,9,8,23
Delhi Dynamo,4058,2,5,7,2,23,15,8,22
Kolkata,4058,3,4,8,2,15,13,2,20
Kerala Blast,4058,4,5,4,5,12,15,-3,19
Chennaiyin,4058,5,4,6,4,19,19,0,18
FC Pune City,4058,6,5,3,6,15,17,-2,18
NorthEast Un,4058,7,4,4,6,11,13,-2,16
FC Goa,4058,8,3,3,8,8,19,-11,12
Mumbai City,4059,1,6,5,3,18,10,8,23
NorthEast Un,4059,2,7,2,5,14,11,3,23
FC Pune City,4059,3,5,4,5,16,16,0,19
Kerala Blast,4059,4,5,4,5,12,16,-4,19
Delhi Dynamo,4059,5,4,6,4,25,20,5,18
Chennaiyin,4059,6,4,5,5,15,19,-4,17
Kolkata,4059,7,3,7,4,15,17,-2,16
FC Goa,4059,8,4,3,7,12,18,-6,15
Delhi Dynamo,4060,1,6,5,3,25,15,10,23
Mumbai City,4060,2,6,4,4,16,11,5,22
Kerala Blast,4060,3,6,4,4,15,15,0,22
Kolkata,4060,4,4,7,3,16,15,1,19
NorthEast Un,4060,5,5,4,5,13,12,1,19
FC Pune City,4060,6,4,4,6,13,18,-5,16
Chennaiyin,4060,7,3,6,5,14,20,-6,15
FC Goa,4060,8,4,2,8,11,17,-6,14
Delhi Dynamo,4061,1,6,5,3,24,15,9,23
Mumbai City,4061,2,6,4,4,16,10,6,22
Kolkata,4061,3,5,6,3,19,13,6,21
NorthEast Un,4061,4,6,3,5,11,9,2,21
FC Pune City,4061,5,5,3,6,13,16,-3,18
FC Goa,4061,6,5,2,7,11,15,-4,17
Kerala Blast,4061,7,4,4,6,9,18,-9,16
Chennaiyin,4061,8,3,5,6,13,20,-7,14
Mumbai City,4062,1,7,4,3,20,9,11,25
Kolkata,4062,2,5,6,3,16,14,2,21
Kerala Blast,4062,3,6,3,5,14,17,-3,21
Chennaiyin,4062,4,5,5,4,18,17,1,20
NorthEast Un,4062,5,6,2,6,13,12,1,20
Delhi Dynamo,4062,6,4,5,5,23,21,2,17
FC Pune City,4062,7,4,3,7,12,17,-5,15
FC Goa,4062,8,4,2,8,10,19,-9,14
Mumbai City,4063,1,7,4,3,19,8,11,25
Delhi Dynamo,4063,2,6,5,3,28,20,8,23
Kolkata,4063,3,4,7,3,15,16,-1,19
Kerala Blast,4063,4,5,4,5,11,15,-4,19
FC Pune City,4063,5,5,3,6,15,15,0,18
Chennaiyin,4063,6,4,6,4,17,19,-2,18
NorthEast Un,4063,7,4,3,7,10,13,-3,15
FC Goa,4063,8,3,4,7,12,21,-9,13
Mumbai City,4064,1,7,4,3,19,9,10,25
Kolkata,4064,2,6,6,2,20,13,7,24
Delhi Dynamo,4064,3,5,6,3,26,19,7,21
NorthEast Un,4064,4,6,3,5,13,11,2,21
FC Pune City,4064,5,4,4,6,13,18,-5,16
Kerala Blast,4064,6,4,4,6,11,17,-6,16
Chennaiyin,4064,7,3,6,5,14,19,-5,15
FC Goa,4064,8,3,3,8,11,21,-10,12
Mumbai City,4065,1,7,4,3,19,9,10,25
Delhi Dynamo,4065,2,5,6,3,25,19,6,21
Kolkata,4065,3,5,6,3,20,16,4,21
NorthEast Un,4065,4,6,2,6,13,10,3,20
Kerala Blast,4065,5,5,4,5,13,18,-5,19
Chennaiyin,4065,6,4,5,5,14,18,-4,17
FC Pune City,4065,7,4,4,6,13,18,-5,16
FC Goa,4065,8,3,3,8,11,20,-9,12
Mumbai City,4066,1,7,4,3,17,8,9,25
Kolkata,4066,2,4,8,2,17,15,2,20
NorthEast Un,4066,3,6,2,6,15,13,2,20
Chennaiyin,4066,4,5,5,4,19,20,-1,20
Delhi Dynamo,4066,5,4,6,4,21,18,3,18
FC Pune City,4066,6,4,5,5,14,16,-2,17
Kerala Blast,4066,7,4,4,6,12,18,-6,16
FC Goa,4066,8,3,4,7,11,18,-7,13
Delhi Dynamo,4067,1,6,5,3,23,17,6,23
Mumbai City,4067,2,6,4,4,16,9,7,22
Kerala Blast,4067,3,6,4,4,13,14,-1,22
Kolkata,4067,4,5,6,3,17,15,2,21
NorthEast Un,4067,5,5,2,7,12,11,1,17
Chennaiyin,4067,6,4,5,5,14,20,-6,17
FC Pune City,4067,7,4,4,6,14,18,-4,16
FC Goa,4067,8,4,2,8,11,16,-5,14
Mumbai City,4068,1,7,4,3,19,9,10,25
Delhi Dynamo,4068,2,6,5,3,25,17,8,23
Kerala Blast,4068,3,5,4,5,11,15,-4,19
FC Pune City,4068,4,5,3,6,14,15,-1,18
Kolkata,4068,5,4,6,4,14,16,-2,18
FC Goa,4068,6,5,2,7,12,16,-4,17
NorthEast Un,4068,7,4,4,6,9,10,-1,16
Chennaiyin,4068,8,3,6,5,13,19,-6,15
Kolkata,4069,1,6,6,2,18,12,6,24
Delhi Dynamo,4069,2,5,7,2,26,17,9,22
Mumbai City,4069,3,6,4,4,16,10,6,22
NorthEast Un,4069,4,5,3,6,12,14,-2,18
Chennaiyin,4069,5,4,5,5,17,19,-2,17
FC Pune City,4069,6,4,4,6,12,15,-3,16
Kerala Blast,4069,7,4,4,6,9,16,-7,16
FC Goa,4069,8,4,3,7,11,18,-7,15
Mumbai City,4070,1,7,4,3,18,9,9,25
Kolkata,4070,2,5,7,2,20,16,4,22
Delhi Dynamo,4070,3,5,6,3,23,16,7,21
FC Pune City,4070,4,5,4,5,15,15,0,19
NorthEast Un,4070,5,5,2,7,13,13,0,17
Chennaiyin,4070,6,4,5,5,16,20,-4,17
FC Goa,4070,7,4,3,7,14,20,-6,15
Kerala Blast,4070,8,4,3,7,13,23,-10,15
Mumbai City,4071,1,6,5,3,18,10,8,23
Delhi Dynamo,4071,2,5,7,2,25,16,9,22
Kerala Blast,4071,3,5,5,4,10,13,-3,20
Kolkata,4071,4,4,6,4,17,18,-1,18
FC Goa,4071,5,5,3,6,15,16,-1,18
NorthEast Un,4071,6,4,4,6,10,12,-2,16
FC Pune City,4071,7,4,4,6,14,17,-3,16
Chennaiyin,4071,8,3,6,5,15,22,-7,15
Mumbai City,4072,1,6,5,3,20,12,8,23
Delhi Dynamo,4072,2,5,6,3,27,19,8,21
Kerala Blast,4072,3,6,3,5,11,14,-3,21
Kolkata,4072,4,4,7,3,17,15,2,19
FC Pune City,4072,5,5,4,5,14,15,-1,19
NorthEast Un,4072,6,5,2,7,12,13,-1,17
Chennaiyin,4072,7,4,5,5,16,20,-4,17
FC Goa,4072,8,4,2,8,10,19,-9,14
Mumbai City,4073,1,6,5,3,17,9,8,23
Kerala Blast,4073,2,5,5,4,11,14,-3,20
Delhi Dynamo,4073,3,4,6,4,22,18,4,18
Chennaiyin,4073,4,4,6,4,17,18,-1,18
FC Goa,4073,5,5,3,6,13,15,-2,18
Kolkata,4073,6,3,8,3,15,16,-1,17
FC Pune City,4073,7,4,5,5,13,15,-2,17
NorthEast Un,4073,8,5,2,7,10,13,-3,17
Mumbai City,4074,1,7,4,3,18,9,9,25
Delhi Dynamo,4074,2,6,5,3,28,18,10,23
Kerala Blast,4074,3,6,3,5,14,17,-3,21
FC Pune City,4074,4,5,3,6,15,16,-1,18
Kolkata,4074,5,4,6,4,15,17,-2,18
Chennaiyin,4074,6,4,5,5,18,22,-4,17
FC Goa,4074,7,5,2,7,15,20,-5,17
NorthEast Un,4074,8,4,2,8,14,18,-4,14
Delhi Dynamo,4075,1,6,5,3,30,18,12,23
Mumbai City,4075,2,6,4,4,17,12,5,22
Kolkata,4075,3,5,7,2,16,13,3,22
FC Pune City,4075,4,5,4,5,15,15,0,19
NorthEast Un,4075,5,5,3,6,12,11,1,18
Chennaiyin,4075,6,4,6,4,14,17,-3,18
Kerala Blast,4075,7,4,4,6,9,16,-7,16
FC Goa,4075,8,3,3,8,8,19,-11,12
Delhi Dynamo,4076,1,6,5,3,24,17,7,23
Mumbai City,4076,2,6,4,4,16,9,7,22
Kolkata,4076,3,5,6,3,19,13,6,21
Chennaiyin,4076,4,5,5,4,15,17,-2,20
FC Pune City,4076,5,5,3,6,15,19,-4,18
Kerala Blast,4076,6,5,3,6,12,19,-7,18
NorthEast Un,4076,7,5,2,7,12,11,1,17
FC Goa,4076,8,4,2,8,9,17,-8,14
Delhi Dynamo,4077,1,6,6,2,28,15,13,24
Mumbai City,4077,2,6,4,4,16,11,5,22
NorthEast Un,4077,3,5,4,5,11,9,2,19
Kerala Blast,4077,4,5,4,5,11,14,-3,19
Kolkata,4077,5,4,6,4,15,16,-1,18
FC Pune City,4077,6,5,3,6,13,16,-3,18
FC Goa,4077,7,5,2,7,16,20,-4,17
Chennaiyin,4077,8,3,5,6,15,24,-9,14
Mumbai City,4078,1,7,4,3,19,8,11,25
FC Pune City,4078,2,6,3,5,16,14,2,21
NorthEast Un,4078,3,6,2,6,13,12,1,20
FC Goa,4078,4,5,3,6,13,17,-4,18
Kerala Blast,4078,5,5,3,6,11,17,-6,18
Delhi Dynamo,4078,6,4,5,5,22,20,2,17
Chennaiyin,4078,7,4,5,5,16,20,-4,17
Kolkata,4078,8,3,7,4,16,18,-2,16
Mumbai City,4079,1,7,4,3,17,8,9,25
Delhi Dynamo,4079,2,5,5,4,23,18,5,20
NorthEast Un,4079,3,6,2,6,16,13,3,20
Kolkata,4079,4,4,8,2,19,17,2,20
Kerala Blast,4079,5,5,4,5,12,16,-4,19
FC Pune City,4079,6,4,4,6,16,19,-3,16
FC Goa,4079,7,4,3,7,14,19,-5,15
Chennaiyin,4079,8,3,6,5,16,23,-7,15
Mumbai City,4080,1,7,4,3,17,8,9,25
Delhi Dynamo,4080,2,6,5,3,24,16,8,23
FC Pune City,4080,3,6,3,5,15,14,1,21
Kolkata,4080,3,5,6,3,15,14,1,21
Kerala Blast,4080,5,5,3,6,11,15,-4,18
Chennaiyin,4080,6,4,5,5,16,21,-5,17
NorthEast Un,4080,7,4,2,8,11,15,-4,14
FC Goa,4080,8,4,2,8,11,17,-6,14
Mumbai City,4081,1,7,4,3,20,8,12,25
Delhi Dynamo,4081,2,5,5,4,24,20,4,20
Chennaiyin,4081,3,5,5,4,15,17,-2,20
Kerala Blast,4081,4,5,5,4,13,16,-3,20
FC Pune City,4081,5,5,4,5,16,17,-1,19
Kolkata,4081,6,4,6,4,14,14,0,18
NorthEast Un,4081,7,5,3,6,10,10,0,18
FC Goa,4081,8,3,2,9,9,19,-10,11
Delhi Dynamo,4082,1,6,6,2,27,18,9,24
Mumbai City,4082,2,6,4,4,17,10,7,22
Kolkata,4082,3,4,7,3,20,16,4,19
FC Pune City,4082,4,5,4,5,15,16,-1,19
Chennaiyin,4082,5,4,6,4,16,19,-3,18
Kerala Blast,4082,6,5,3,6,12,19,-7,18
NorthEast Un,4082,7,4,3,7,12,15,-3,15
FC Goa,4082,8,4,3,7,13,19,-6,15
Mumbai City,4083,1,7,4,3,18,8,10,25
Kerala Blast,4083,2,7,3,4,14,15,-1,24
Delhi Dynamo,4083,3,5,5,4,23,19,4,20
Chennaiyin,4083,4,4,6,4,16,18,-2,18
FC Goa,4083,5,5,3,6,13,16,-3,18
Kolkata,4083,6,3,7,4,16,17,-1,16
FC Pune City,4083,7,4,4,6,14,17,-3,16
NorthEast Un,4083,8,4,2,8,10,14,-4,14
Mumbai City,4084,1,7,4,3,21,9,12,25
Delhi Dynamo,4084,2,6,5,3,29,21,8,23
Kolkata,4084,3,4,7,3,14,13,1,19
FC Pune City,4084,4,5,3,6,14,15,-1,18
NorthEast Un,4084,5,5,3,6,13,14,-1,18
FC Goa,4084,6,5,2,7,13,18,-5,17
Kerala Blast,4084,7,4,5,5,10,16,-6,17
Chennaiyin,4084,8,3,5,6,14,22,-8,14
Mumbai City,4085,1,7,4,3,19,8,11,25
Kolkata,4085,2,6,6,2,20,14,6,24
Delhi Dynamo,4085,3,5,6,3,27,21,6,21
NorthEast Un,4085,4,5,4,5,15,14,1,19
Kerala Blast,4085,5,5,4,5,14,16,-2,19
Chennaiyin,4085,6,4,5,5,18,20,-2,17
FC Pune City,4085,7,4,3,7,12,19,-7,15
FC Goa,4085,8,3,2,9,10,23,-13,11
Mumbai City,4086,1,7,4,3,18,8,10,25
NorthEast Un,4086,2,6,2,6,13,12,1,20
Kolkata,4086,3,4,7,3,19,17,2,19
Kerala Blast,4086,4,5,4,5,13,17,-4,19
FC Pune City,4086,5,5,3,6,15,17,-2,18
Delhi Dynamo,4086,6,4,5,5,22,19,3,17
Chennaiyin,4086,7,4,5,5,14,19,-5,17
FC Goa,4086,8,5,2,7,11,16,-5,17
Mumbai City,4087,1,7,4,3,19,10,9,25
Delhi Dynamo,4087,2,5,6,3,26,19,7,21
Kolkata,4087,3,5,6,3,17,14,3,21
FC Pune City,4087,4,5,4,5,15,16,-1,19
NorthEast Un,4087,5,5,3,6,12,12,0,18
Chennaiyin,4087,6,4,5,5,16,19,-3,17
Kerala Blast,4087,7,4,5,5,10,16,-6,17
FC Goa,4087,8,3,3,8,9,18,-9,12
Mumbai City,4088,1,6,5,3,17,9,8,23
Kolkata,4088,2,5,7,2,18,13,5,22
Delhi Dynamo,4088,3,5,6,3,25,18,7,21
NorthEast Un,4088,4,6,3,5,14,10,4,21
FC Pune City,4088,5,5,4,5,14,15,-1,19
Chennaiyin,4088,6,4,6,4,16,18,-2,18
Kerala Blast,4088,7,4,3,7,9,17,-8,15
FC Goa,4088,8,3,2,9,8,21,-13,11
Delhi Dynamo,4089,1,7,5,2,26,14,12,26
Mumbai City,4089,2,6,4,4,16,9,7,22
Kerala Blast,4089,3,6,4,4,15,13,2,22
Chennaiyin,4089,4,5,5,4,16,17,-1,20
Kolkata,4089,5,4,6,4,18,18,0,18
NorthEast Un,4089,6,4,3,7,9,14,-5,15
FC Pune City,4089,7,4,3,7,14,22,-8,15
FC Goa,4089,8,4,2,8,9,16,-7,14
Mumbai City,4090,1,6,4,4,16,9,7,22
Kerala Blast,4090,2,6,4,4,14,15,-1,22
Delhi Dynamo,4090,3,5,5,4,25,19,6,20
Kolkata,4090,4,4,8,2,18,15,3,20
FC Goa,4090,5,5,3,6,15,18,-3,18
Chennaiyin,4090,6,4,5,5,17,20,-3,17
NorthEast Un,4090,7,5,2,7,12,15,-3,17
FC Pune City,4090,8,4,3,7,13,19,-6,15
Delhi Dynamo,4091,1,7,5,2,27,15,12,26
Mumbai City,4091,2,6,4,4,17,10,7,22
Kerala Blast,4091,3,5,4,5,11,15,-4,19
Kolkata,4091,4,4,6,4,14,14,0,18
FC Pune City,4091,5,5,3,6,14,16,-2,18
Chennaiyin,4091,6,4,6,4,15,18,-3,18
NorthEast Un,4091,7,4,3,7,9,12,-3,15
FC Goa,4091,8,4,3,7,10,17,-7,15
Mumbai City,4092,1,6,5,3,17,9,8,23
NorthEast Un,4092,2,6,3,5,17,12,5,21
Delhi Dynamo,4092,3,4,7,3,24,20,4,19
Kolkata,4092,4,4,7,3,16,15,1,19
FC Pune City,4092,5,5,3,6,16,16,0,18
Kerala Blast,4092,6,5,3,6,11,19,-8,18
FC Goa,4092,7,4,4,6,12,17,-5,16
Chennaiyin,4092,8,3,6,5,15,20,-5,15
Delhi Dynamo,4093,1,6,6,2,28,17,11,24
Mumbai City,4093,2,6,5,3,16,8,8,23
Kerala Blast,4093,3,5,5,4,14,16,-2,20
Kolkata,4093,4,3,8,3,16,16,0,17
NorthEast Un,4093,5,5,2,7,13,15,-2,17
FC Pune City,4093,6,4,5,5,12,14,-2,17
Chennaiyin,4093,7,3,6,5,15,20,-5,15
FC Goa,4093,8,4,3,7,13,21,-8,15
Delhi Dynamo,4094,1,6,5,3,27,16,11,23
NorthEast Un,4094,2,7,2,5,18,10,8,23
Mumbai City,4094,3,6,4,4,17,10,7,22
Kolkata,4094,4,4,6,4,16,15,1,18
FC Pune City,4094,5,5,3,6,14,18,-4,18
Kerala Blast,4094,6,5,3,6,13,20,-7,18
Chennaiyin,4094,7,3,6,5,15,22,-7,15
FC Goa,4094,8,4,3,7,11,20,-9,15
Mumbai City,4095,1,7,4,3,19,9,10,25
NorthEast Un,4095,2,6,3,5,13,11,2,21
FC Pune City,4095,3,5,4,5,16,17,-1,19
Kerala Blast,4095,4,5,3,6,11,16,-5,18
Delhi Dynamo,4095,5,4,5,5,25,23,2,17
Kolkata,4095,6,3,8,3,18,18,0,17
FC Goa,4095,7,4,4,6,16,20,-4,16
Chennaiyin,4095,8,3,7,4,15,19,-4,16
Mumbai City,4096,1,7,4,3,18,9,9,25
Kolkata,4096,2,5,7,2,17,14,3,22
NorthEast Un,4096,3,6,3,5,15,13,2,21
Delhi Dynamo,4096,4,4,6,4,25,20,5,18
Kerala Blast,4096,5,4,6,4,10,14,-4,18
FC Pune City,4096,6,4,4,6,13,16,-3,16
FC Goa,4096,7,4,3,7,12,16,-4,15
Chennaiyin,4096,8,3,5,6,15,23,-8,14
Kolkata,4097,1,6,6,2,21,12,9,24
Mumbai City,4097,2,6,5,3,18,10,8,23
Delhi Dynamo,4097,3,5,7,2,24,16,8,22
Chennaiyin,4097,4,5,5,4,18,19,-1,20
NorthEast Un,4097,5,5,3,6,13,11,2,18
Kerala Blast,4097,6,5,3,6,11,20,-9,18
FC Pune City,4097,7,4,3,7,12,19,-7,15
FC Goa,4097,8,3,2,9,9,19,-10,11
Delhi Dynamo,4098,1,7,5,2,27,17,10,26
Mumbai City,4098,2,6,4,4,16,9,7,22
Kolkata,4098,3,5,7,2,19,14,5,22
NorthEast Un,4098,4,6,2,6,14,11,3,20
Kerala Blast,4098,5,5,3,6,11,19,-8,18
Chennaiyin,4098,6,4,5,5,14,19,-5,17
FC Pune City,4098,7,4,4,6,15,18,-3,16
FC Goa,4098,8,3,2,9,10,19,-9,11
Delhi Dynamo,4099,1,6,5,3,26,18,8,23
Mumbai City,4099,2,6,4,4,17,10,7,22
FC Pune City,4099,3,6,3,5,17,15,2,21
Kerala Blast,4099,4,6,3,5,13,16,-3,21
NorthEast Un,4099,5,5,3,6,12,11,1,18
FC Goa,4099,6,5,2,7,16,17,-1,17
Chennaiyin,4099,7,3,6,5,14,21,-7,15
Kolkata,4099,7,3,6,5,14,21,-7,15
Mumbai City,4100,1,6,5,3,18,10,8,23
NorthEast Un,4100,2,6,2,6,18,15,3,20
Delhi Dynamo,4100,3,4,7,3,26,20,6,19
Kolkata,4100,4,4,7,3,16,15,1,19
FC Pune City,4100,5,5,4,5,15,16,-1,19
Kerala Blast,4100,6,5,3,6,16,19,-3,18
FC Goa,4100,7,5,3,6,13,17,-4,18
Chennaiyin,4100,8,3,5,6,14,24,-10,14
Mumbai City,4101,1,6,5,3,16,8,8,23
Delhi Dynamo,4101,2,5,7,2,23,14,9,22
FC Pune City,4101,3,5,4,5,14,15,-1,19
Kerala Blast,4101,4,5,4,5,13,16,-3,19
Kolkata,4101,5,3,9,2,16,15,1,18
NorthEast Un,4101,6,5,2,7,12,15,-3,17
Chennaiyin,4101,7,4,5,5,15,19,-4,17
FC Goa,4101,8,3,4,7,9,16,-7,13
Mumbai City,4102,1,7,4,3,19,9,10,25
Kolkata,4102,2,5,7,2,15,12,3,22
Delhi Dynamo,4102,3,4,7,3,22,17,5,19
Kerala Blast,4102,4,5,4,5,10,16,-6,19
NorthEast Un,4102,5,5,3,6,14,11,3,18
FC Pune City,4102,6,5,3,6,15,15,0,18
Chennaiyin,4102,7,3,6,5,16,24,-8,15
FC Goa,4102,8,3,4,7,10,17,-7,13
Mumbai City,4103,1,6,5,3,16,8,8,23
Delhi Dynamo,4103,2,5,7,2,24,14,10,22
Kolkata,4103,3,5,6,3,17,14,3,21
Kerala Blast,4103,4,6,3,5,12,15,-3,21
FC Goa,4103,5,5,3,6,11,15,-4,18
FC Pune City,4103,6,4,3,7,12,16,-4,15
Chennaiyin,4103,7,3,6,5,14,19,-5,15
NorthEast Un,4103,8,4,3,7,10,15,-5,15
Mumbai City,4104,1,7,4,3,17,8,9,25
Delhi Dynamo,4104,2,5,6,3,23,16,7,21
FC Pune City,4104,3,6,3,5,15,15,0,21
Kolkata,4104,4,4,7,3,15,13,2,19
Kerala Blast,4104,5,5,4,5,12,15,-3,19
Chennaiyin,4104,6,4,5,5,17,20,-3,17
FC Goa,4104,7,4,3,7,11,18,-7,15
NorthEast Un,4104,8,4,2,8,10,15,-5,14
Mumbai City,4105,1,7,4,3,18,9,9,25
NorthEast Un,4105,2,7,2,5,16,10,6,23
FC Pune City,4105,3,6,3,5,15,15,0,21
Delhi Dynamo,4105,4,5,5,4,24,19,5,20
Kerala Blast,4105,5,5,3,6,12,19,-7,18
Kolkata,4105,6,3,6,5,14,16,-2,15
Chennaiyin,4105,7,3,6,5,13,18,-5,15
FC Goa,4105,8,4,3,7,9,15,-6,15
Mumbai City,4106,1,7,4,3,21,9,12,25
NorthEast Un,4106,2,7,2,5,16,11,5,23
Kolkata,4106,3,5,7,2,22,18,4,22
Delhi Dynamo,4106,4,5,5,4,25,23,2,20
FC Pune City,4106,5,5,4,5,16,16,0,19
Kerala Blast,4106,6,4,3,7,12,21,-9,15
FC Goa,4106,7,4,2,8,12,18,-6,14
Chennaiyin,4106,8,3,5,6,13,21,-8,14
Mumbai City,4107,1,7,4,3,19,8,11,25
Delhi Dynamo,4107,2,5,6,3,26,19,7,21
Kolkata,4107,3,4,8,2,14,12,2,20
NorthEast Un,4107,4,5,4,5,13,12,1,19
FC Pune City,4107,5,5,4,5,15,15,0,19
Kerala Blast,4107,6,4,4,6,10,17,-7,16
Chennaiyin,4107,7,3,6,5,14,19,-5,15
FC Goa,4107,8,4,2,8,9,18,-9,14
Mumbai City,4108,1,7,4,3,20,9,11,25
FC Pune City,4108,2,6,3,5,16,15,1,21
Kerala Blast,4108,3,6,3,5,12,15,-3,21
Delhi Dynamo,4108,4,5,5,4,25,22,3,20
NorthEast Un,4108,5,5,3,6,12,12,0,18
Kolkata,4108,6,3,7,4,14,15,-1,16
Chennaiyin,4108,7,3,7,4,15,19,-4,16
FC Goa,4108,8,3,4,7,11,18,-7,13
Mumbai City,4109,1,7,4,3,18,8,10,25
Kerala Blast,4109,2,6,4,4,14,16,-2,22
FC Pune City,4109,3,5,4,5,14,15,-1,19
Delhi Dynamo,4109,4,4,6,4,24,20,4,18
Kolkata,4109,5,3,7,4,14,15,-1,16
NorthEast Un,4109,6,4,4,6,13,14,-1,16
Chennaiyin,4109,7,3,7,4,14,18,-4,16
FC Goa,4109,8,4,4,6,12,17,-5,16
Delhi Dynamo,4110,1,6,5,3,25,19,6,23
Mumbai City,4110,2,6,4,4,17,10,7,22
Kolkata,4110,3,5,6,3,18,14,4,21
Kerala Blast,4110,4,6,3,5,13,16,-3,21
NorthEast Un,4110,5,5,2,7,13,13,0,17
Chennaiyin,4110,6,4,5,5,15,18,-3,17
FC Goa,4110,7,5,2,7,11,16,-5,17
FC Pune City,4110,8,4,3,7,13,19,-6,15
Mumbai City,4111,1,6,5,3,18,10,8,23
Delhi Dynamo,4111,2,5,7,2,27,19,8,22
Kolkata,4111,3,4,8,2,17,15,2,20
FC Pune City,4111,4,4,5,5,15,17,-2,17
Kerala Blast,4111,5,4,5,5,13,18,-5,17
NorthEast Un,4111,6,4,4,6,12,13,-1,16
Chennaiyin,4111,7,3,7,4,15,19,-4,16
FC Goa,4111,8,3,5,6,10,16,-6,14
Mumbai City,4112,1,6,5,3,18,10,8,23
Kerala Blast,4112,2,6,4,4,13,15,-2,22
Delhi Dynamo,4112,3,5,6,3,25,18,7,21
NorthEast Un,4112,4,5,3,6,13,13,0,18
Chennaiyin,4112,5,4,5,5,15,19,-4,17
FC Goa,4112,6,5,2,7,11,15,-4,17
Kolkata,4112,7,3,7,4,15,17,-2,16
FC Pune City,4112,8,4,4,6,15,18,-3,16
Delhi Dynamo,4113,1,6,5,3,27,18,9,23
Mumbai City,4113,2,6,4,4,17,10,7,22
Kolkata,4113,3,5,6,3,19,16,3,21
FC Pune City,4113,4,6,3,5,18,15,3,21
NorthEast Un,4113,5,6,2,6,13,12,1,20
Kerala Blast,4113,6,5,3,6,13,19,-6,18
Chennaiyin,4113,7,3,6,5,13,18,-5,15
FC Goa,4113,8,3,3,8,8,20,-12,12
Mumbai City,4114,1,6,5,3,17,9,8,23
Delhi Dynamo,4114,2,5,7,2,25,17,8,22
NorthEast Un,4114,3,6,3,5,14,12,2,21
Kolkata,4114,4,4,8,2,18,15,3,20
FC Pune City,4114,5,5,4,5,14,15,-1,19
Kerala Blast,4114,6,4,4,6,11,17,-6,16
FC Goa,4114,7,4,2,8,12,18,-6,14
Chennaiyin,4114,8,3,5,6,13,21,-8,14
Delhi Dynamo,4115,1,6,6,2,27,18,9,24
Mumbai City,4115,2,6,4,4,18,11,7,22
Kolkata,4115,3,5,6,3,19,15,4,21
Chennaiyin,4115,4,5,5,4,18,19,-1,20
FC Pune City,4115,5,5,3,6,14,15,-1,18
Kerala Blast,4115,6,5,3,6,12,20,-8,18
NorthEast Un,4115,7,5,2,7,14,13,1,17
FC Goa,4115,8,3,3,8,10,21,-11,12
Mumbai City,4116,1,7,4,3,18,9,9,25
Delhi Dynamo,4116,2,6,5,3,28,16,12,23
FC Pune City,4116,3,6,3,5,15,15,0,21
Kolkata,4116,4,4,6,4,16,15,1,18
Kerala Blast,4116,5,5,3,6,10,16,-6,18
FC Goa,4116,6,5,2,7,12,17,-5,17
Chennaiyin,4116,7,4,5,5,14,20,-6,17
NorthEast Un,4116,8,4,2,8,9,14,-5,14
Mumbai City,4117,1,6,5,3,17,9,8,23
FC Pune City,4117,2,6,3,5,14,14,0,21
NorthEast Un,4117,3,6,2,6,14,14,0,20
Delhi Dynamo,4117,4,4,7,3,23,17,6,19
Kolkata,4117,5,4,6,4,16,15,1,18
FC Goa,4117,6,5,3,6,12,16,-4,18
Kerala Blast,4117,6,5,3,6,12,16,-4,18
Chennaiyin,4117,8,3,5,6,15,22,-7,14
Mumbai City,4118,1,7,4,3,17,8,9,25
Kerala Blast,4118,2,7,3,4,14,14,0,24
Kolkata,4118,3,5,6,3,17,15,2,21
Delhi Dynamo,4118,4,5,5,4,27,23,4,20
Chennaiyin,4118,5,5,5,4,18,18,0,20
NorthEast Un,4118,6,5,2,7,16,13,3,17
FC Pune City,4118,7,4,3,7,13,18,-5,15
FC Goa,4118,8,3,2,9,12,25,-13,11
Mumbai City,4119,1,7,4,3,18,9,9,25
Delhi Dynamo,4119,2,5,5,4,29,19,10,20
Kerala Blast,4119,3,5,5,4,12,15,-3,20
NorthEast Un,4119,4,5,4,5,12,11,1,19
FC Pune City,4119,5,4,5,5,13,15,-2,17
Kolkata,4119,6,3,7,4,15,16,-1,16
Chennaiyin,4119,7,3,7,4,15,19,-4,16
FC Goa,4119,8,4,3,7,12,22,-10,15
Delhi Dynamo,4120,1,6,6,2,28,16,12,24
Mumbai City,4120,2,6,4,4,16,11,5,22
Kerala Blast,4120,3,6,4,4,13,15,-2,22
Kolkata,4120,4,4,6,4,15,15,0,18
Chennaiyin,4120,5,4,6,4,17,18,-1,18
FC Pune City,4120,6,4,4,6,14,17,-3,16
FC Goa,4120,7,4,4,6,11,16,-5,16
NorthEast Un,4120,8,4,2,8,11,17,-6,14
Mumbai City,4121,1,7,4,3,18,9,9,25
Kerala Blast,4121,2,6,4,4,17,15,2,22
Kolkata,4121,3,4,7,3,16,16,0,19
Delhi Dynamo,4121,4,4,6,4,24,20,4,18
FC Pune City,4121,5,4,5,5,14,16,-2,17
NorthEast Un,4121,5,5,2,7,14,16,-2,17
Chennaiyin,4121,7,4,5,5,15,19,-4,17
FC Goa,4121,8,4,3,7,10,17,-7,15
Mumbai City,4122,1,7,4,3,18,8,10,25
Kolkata,4122,2,6,6,2,19,13,6,24
Kerala Blast,4122,3,6,3,5,15,16,-1,21
Delhi Dynamo,4122,4,5,5,4,24,19,5,20
NorthEast Un,4122,5,6,2,6,15,14,1,20
Chennaiyin,4122,6,4,5,5,17,20,-3,17
FC Pune City,4122,7,4,3,7,13,19,-6,15
FC Goa,4122,8,3,2,9,9,21,-12,11
Delhi Dynamo,4123,1,7,5,2,28,16,12,26
Mumbai City,4123,2,6,4,4,17,10,7,22
Kerala Blast,4123,3,5,4,5,12,15,-3,19
NorthEast Un,4123,4,5,3,6,11,12,-1,18
FC Pune City,4123,5,5,3,6,14,17,-3,18
Kolkata,4123,6,3,8,3,15,15,0,17
Chennaiyin,4123,7,3,6,5,14,20,-6,15
FC Goa,4123,8,4,3,7,11,17,-6,15
Delhi Dynamo,4124,1,6,5,3,24,17,7,23
Mumbai City,4124,2,6,4,4,16,9,7,22
FC Pune City,4124,3,5,4,5,13,14,-1,19
NorthEast Un,4124,4,5,3,6,13,12,1,18
Kolkata,4124,5,4,6,4,15,16,-1,18
FC Goa,4124,6,5,2,7,14,17,-3,17
Chennaiyin,4124,7,4,5,5,15,19,-4,17
Kerala Blast,4124,8,4,5,5,11,17,-6,17
Mumbai City,4125,1,6,5,3,16,8,8,23
Delhi Dynamo,4125,2,5,7,2,24,14,10,22
Kolkata,4125,3,5,6,3,19,15,4,21
Kerala Blast,4125,4,6,3,5,13,16,-3,21
NorthEast Un,4125,5,4,4,6,9,10,-1,16
Chennaiyin,4125,6,3,7,4,15,19,-4,16
FC Goa,4125,7,4,3,7,12,19,-7,15
FC Pune City,4125,7,4,3,7,12,19,-7,15
Mumbai City,4126,1,7,4,3,17,8,9,25
Kolkata,4126,2,5,7,2,17,13,4,22
Delhi Dynamo,4126,3,5,6,3,26,17,9,21
Kerala Blast,4126,4,6,3,5,13,17,-4,21
Chennaiyin,4126,5,5,5,4,16,18,-2,20
FC Pune City,4126,6,4,4,6,12,15,-3,16
NorthEast Un,4126,7,4,3,7,11,13,-2,15
FC Goa,4126,8,3,2,9,10,21,-11,11
Mumbai City,4127,1,6,5,3,17,9,8,23
Delhi Dynamo,4127,2,5,7,2,26,18,8,22
FC Pune City,4127,3,6,3,5,14,14,0,21
Kolkata,4127,4,4,7,3,17,15,2,19
Kerala Blast,4127,5,5,3,6,11,17,-6,18
NorthEast Un,4127,6,4,4,6,13,14,-1,16
Chennaiyin,4127,7,3,7,4,14,18,-4,16
FC Goa,4127,8,3,4,7,9,16,-7,13
Delhi Dynamo,4128,1,7,5,2,30,17,13,26
Mumbai City,4128,2,6,4,4,17,10,7,22
Kolkata,4128,3,5,6,3,16,15,1,21
Chennaiyin,4128,4,5,5,4,17,17,0,20
FC Pune City,4128,5,5,3,6,15,16,-1,18
Kerala Blast,4128,6,5,3,6,12,18,-6,18
FC Goa,4128,7,4,2,8,11,17,-6,14
NorthEast Un,4128,8,4,2,8,12,20,-8,14
Delhi Dynamo,4129,1,7,5,2,28,15,13,26
Mumbai City,4129,2,6,4,4,17,10,7,22
NorthEast Un,4129,3,6,2,6,12,13,-1,20
FC Pune City,4129,4,5,4,5,16,16,0,19
Kolkata,4129,5,4,6,4,16,17,-1,18
Kerala Blast,4129,6,4,4,6,10,17,-7,16
Chennaiyin,4129,7,3,6,5,16,21,-5,15
FC Goa,4129,8,4,3,7,12,18,-6,15
Delhi Dynamo,4130,1,6,6,2,25,15,10,24
Mumbai City,4130,2,6,5,3,17,9,8,23
FC Pune City,4130,3,5,4,5,16,15,1,19
Kerala Blast,4130,4,5,4,5,12,18,-6,19
Kolkata,4130,5,3,8,3,15,15,0,17
NorthEast Un,4130,6,4,4,6,10,11,-1,16
Chennaiyin,4130,7,3,7,4,14,18,-4,16
FC Goa,4130,8,3,4,7,9,17,-8,13
Delhi Dynamo,4131,1,7,5,2,31,16,15,26
Mumbai City,4131,2,6,4,4,17,10,7,22
Kerala Blast,4131,3,6,4,4,12,14,-2,22
Kolkata,4131,4,5,6,3,17,14,3,21
FC Pune City,4131,5,4,4,6,14,17,-3,16
NorthEast Un,4131,6,4,3,7,10,14,-4,15
Chennaiyin,4131,7,3,6,5,13,20,-7,15
FC Goa,4131,8,4,2,8,11,20,-9,14
Mumbai City,4132,1,7,4,3,19,8,11,25
Delhi Dynamo,4132,2,6,5,3,25,18,7,23
Kolkata,4132,3,5,6,3,17,15,2,21
NorthEast Un,4132,4,5,3,6,13,10,3,18
FC Goa,4132,5,5,2,7,14,18,-4,17
Kerala Blast,4132,6,4,5,5,9,14,-5,17
FC Pune City,4132,7,4,4,6,13,17,-4,16
Chennaiyin,4132,8,3,5,6,14,24,-10,14
Delhi Dynamo,4133,1,6,6,2,26,15,11,24
Mumbai City,4133,2,6,5,3,17,9,8,23
Kolkata,4133,3,5,7,2,18,14,4,22
Kerala Blast,4133,4,5,4,5,11,16,-5,19
FC Pune City,4133,5,4,5,5,15,17,-2,17
Chennaiyin,4133,6,4,5,5,15,20,-5,17
NorthEast Un,4133,7,4,2,8,9,12,-3,14
FC Goa,4133,8,4,2,8,11,19,-8,14
Mumbai City,4134,1,6,5,3,17,9,8,23
Kolkata,4134,2,5,7,2,18,14,4,22
NorthEast Un,4134,3,5,4,5,12,11,1,19
Delhi Dynamo,4134,4,4,6,4,23,18,5,18
FC Pune City,4134,5,5,3,6,15,18,-3,18
FC Goa,4134,6,5,2,7,12,16,-4,17
Kerala Blast,4134,7,4,5,5,11,16,-5,17
Chennaiyin,4134,8,3,6,5,13,19,-6,15
Mumbai City,4135,1,7,4,3,20,10,10,25
Delhi Dynamo,4135,2,6,5,3,31,21,10,23
FC Pune City,4135,3,5,4,5,16,16,0,19
Kerala Blast,4135,4,5,4,5,12,17,-5,19
NorthEast Un,4135,5,5,3,6,16,15,1,18
Kolkata,4135,6,3,7,4,13,15,-2,16
Chennaiyin,4135,7,3,7,4,17,21,-4,16
FC Goa,4135,8,3,4,7,10,20,-10,13
Mumbai City,4136,1,6,5,3,17,9,8,23
Delhi Dynamo,4136,2,5,7,2,26,18,8,22
Kolkata,4136,3,4,7,3,15,15,0,19
NorthEast Un,4136,4,5,3,6,14,13,1,18
FC Pune City,4136,5,5,3,6,13,15,-2,18
Chennaiyin,4136,6,3,7,4,13,17,-4,16
FC Goa,4136,7,4,4,6,12,16,-4,16
Kerala Blast,4136,8,4,4,6,12,19,-7,16
Mumbai City,4137,1,7,4,3,17,8,9,25
Delhi Dynamo,4137,2,6,5,3,24,16,8,23
Chennaiyin,4137,3,5,5,4,18,18,0,20
Kolkata,4137,4,4,7,3,19,18,1,19
Kerala Blast,4137,5,5,4,5,17,21,-4,19
NorthEast Un,4137,6,5,2,7,14,15,-1,17
FC Pune City,4137,7,4,3,7,14,18,-4,15
FC Goa,4137,8,4,2,8,9,18,-9,14
Mumbai City,4138,1,6,4,4,16,14,2,22
Delhi Dynamo,4138,2,5,6,3,30,19,11,21
Kolkata,4138,3,5,6,3,20,14,6,21
Kerala Blast,4138,4,6,3,5,13,16,-3,21
FC Goa,4138,5,6,2,6,14,15,-1,20
NorthEast Un,4138,6,5,3,6,15,16,-1,18
FC Pune City,4138,7,4,3,7,13,20,-7,15
Chennaiyin,4138,8,3,5,6,15,22,-7,14
Delhi Dynamo,4139,1,7,5,2,29,17,12,26
Mumbai City,4139,2,6,4,4,16,9,7,22
Kolkata,4139,3,5,6,3,20,18,2,21
NorthEast Un,4139,4,5,3,6,14,13,1,18
FC Pune City,4139,5,5,3,6,16,18,-2,18
FC Goa,4139,6,5,2,7,14,19,-5,17
Chennaiyin,4139,7,3,6,5,14,19,-5,15
Kerala Blast,4139,8,4,3,7,10,20,-10,15
Mumbai City,4140,1,6,5,3,17,9,8,23
Delhi Dynamo,4140,2,5,6,3,24,17,7,21
Kolkata,4140,3,5,6,3,18,14,4,21
Chennaiyin,4140,4,5,5,4,16,18,-2,20
Kerala Blast,4140,5,5,4,5,15,21,-6,19
NorthEast Un,4140,6,5,3,6,14,14,0,18
FC Pune City,4140,7,5,3,6,15,17,-2,18
FC Goa,4140,8,3,2,9,10,19,-9,11
Delhi Dynamo,4141,1,6,5,3,27,18,9,23
Mumbai City,4141,2,6,4,4,18,11,7,22
Kerala Blast,4141,3,6,3,5,14,15,-1,21
Kolkata,4141,4,4,7,3,15,13,2,19
NorthEast Un,4141,5,5,2,7,10,13,-3,17
FC Goa,4141,6,5,2,7,15,19,-4,17
Chennaiyin,4141,7,4,5,5,17,22,-5,17
FC Pune City,4141,8,4,4,6,12,17,-5,16
Delhi Dynamo,4142,1,7,5,2,29,18,11,26
Mumbai City,4142,2,6,4,4,17,10,7,22
Kolkata,4142,3,4,7,3,18,16,2,19
FC Pune City,4142,4,5,4,5,16,16,0,19
NorthEast Un,4142,5,5,2,7,14,15,-1,17
Chennaiyin,4142,6,4,5,5,16,20,-4,17
FC Goa,4142,7,5,2,7,12,17,-5,17
Kerala Blast,4142,8,4,3,7,9,19,-10,15
Mumbai City,4143,1,7,4,3,18,9,9,25
NorthEast Un,4143,2,7,2,5,15,10,5,23
Delhi Dynamo,4143,3,5,5,4,27,20,7,20
Kerala Blast,4143,4,5,4,5,12,16,-4,19
FC Pune City,4143,5,5,3,6,14,16,-2,18
Chennaiyin,4143,6,4,5,5,15,19,-4,17
Kolkata,4143,7,3,7,4,16,18,-2,16
FC Goa,4143,8,4,2,8,13,22,-9,14
Mumbai City,4144,1,7,4,3,19,10,9,25
Kolkata,4144,2,5,7,2,17,13,4,22
Delhi Dynamo,4144,3,5,5,4,26,19,7,20
NorthEast Un,4144,4,6,2,6,12,11,1,20
Kerala Blast,4144,5,5,4,5,13,16,-3,19
FC Pune City,4144,6,5,3,6,14,17,-3,18
Chennaiyin,4144,7,3,6,5,14,19,-5,15
FC Goa,4144,8,3,3,8,9,19,-10,12
Kerala Blast,4145,1,7,3,4,16,14,2,24
Mumbai City,4145,2,6,5,3,17,9,8,23
Delhi Dynamo,4145,3,5,6,3,25,16,9,21
Chennaiyin,4145,4,5,5,4,18,20,-2,20
Kolkata,4145,5,3,8,3,15,16,-1,17
NorthEast Un,4145,6,5,2,7,11,14,-3,17
FC Pune City,4145,7,4,4,6,12,15,-3,16
FC Goa,4145,8,3,3,8,11,21,-10,12
Mumbai City,4146,1,6,5,3,17,9,8,23
Kolkata,4146,2,5,7,2,19,14,5,22
Delhi Dynamo,4146,3,5,6,3,24,17,7,21
NorthEast Un,4146,4,5,4,5,12,11,1,19
Kerala Blast,4146,5,5,4,5,14,18,-4,19
Chennaiyin,4146,6,3,6,5,14,19,-5,15
FC Pune City,4146,7,4,3,7,14,20,-6,15
FC Goa,4146,8,4,3,7,11,17,-6,15
Mumbai City,4147,1,7,4,3,19,8,11,25
Delhi Dynamo,4147,2,6,5,3,26,17,9,23
Kolkata,4147,3,5,7,2,17,12,5,22
Kerala Blast,4147,4,5,4,5,15,18,-3,19
Chennaiyin,4147,5,4,5,5,16,19,-3,17
FC Pune City,4147,6,4,4,6,14,18,-4,16
NorthEast Un,4147,7,4,3,7,11,16,-5,15
FC Goa,4147,8,4,2,8,10,20,-10,14
Mumbai City,4148,1,7,4,3,21,9,12,25
FC Pune City,4148,2,6,3,5,15,15,0,21
Delhi Dynamo,4148,3,5,5,4,26,23,3,20
Kolkata,4148,4,4,6,4,16,16,0,18
Chennaiyin,4148,5,4,6,4,16,17,-1,18
FC Goa,4148,6,5,3,6,11,14,-3,18
NorthEast Un,4148,7,5,2,7,14,17,-3,17
Kerala Blast,4148,8,4,3,7,10,18,-8,15
Mumbai City,4149,1,6,5,3,16,8,8,23
Kolkata,4149,2,5,7,2,20,13,7,22
Delhi Dynamo,4149,3,4,7,3,24,20,4,19
Kerala Blast,4149,4,5,4,5,11,18,-7,19
NorthEast Un,4149,5,5,3,6,13,11,2,18
Chennaiyin,4149,6,4,5,5,14,19,-5,17
FC Goa,4149,7,4,4,6,14,18,-4,16
FC Pune City,4149,8,4,3,7,12,17,-5,15
Delhi Dynamo,4150,1,6,6,2,26,16,10,24
Mumbai City,4150,2,6,4,4,16,9,7,22
Kerala Blast,4150,3,5,5,4,13,15,-2,20
Kolkata,4150,4,4,7,3,14,14,0,19
FC Goa,4150,5,5,3,6,13,15,-2,18
Chennaiyin,4150,6,4,5,5,16,20,-4,17
NorthEast Un,4150,7,4,3,7,11,15,-4,15
FC Pune City,4150,8,4,3,7,14,19,-5,15
Mumbai City,4151,1,6,5,3,18,10,8,23
Delhi Dynamo,4151,2,5,7,2,26,18,8,22
Kerala Blast,4151,3,6,4,4,12,14,-2,22
Kolkata,4151,4,4,8,2,16,14,2,20
NorthEast Un,4151,5,5,3,6,11,11,0,18
FC Pune City,4151,6,4,4,6,12,15,-3,16
Chennaiyin,4151,7,3,5,6,13,19,-6,14
FC Goa,4151,8,4,2,8,11,18,-7,14
Mumbai City,4152,1,7,4,3,19,8,11,25
Delhi Dynamo,4152,2,5,5,4,28,23,5,20
Kolkata,4152,3,4,8,2,15,13,2,20
Kerala Blast,4152,4,5,5,4,13,15,-2,20
NorthEast Un,4152,5,5,4,5,13,11,2,19
Chennaiyin,4152,6,4,6,4,14,17,-3,18
FC Pune City,4152,7,4,3,7,13,18,-5,15
FC Goa,4152,8,3,3,8,10,20,-10,12
Mumbai City,4153,1,7,4,3,17,8,9,25
Kerala Blast,4153,2,7,3,4,15,14,1,24
Delhi Dynamo,4153,3,5,5,4,24,17,7,20
Kolkata,4153,4,4,6,4,16,17,-1,18
NorthEast Un,4153,5,5,3,6,13,14,-1,18
FC Pune City,4153,6,5,3,6,13,15,-2,18
Chennaiyin,4153,7,3,6,5,14,21,-7,15
FC Goa,4153,8,4,2,8,13,19,-6,14
Mumbai City,4154,1,6,5,3,18,10,8,23
Delhi Dynamo,4154,2,5,6,3,27,19,8,21
Kerala Blast,4154,3,5,5,4,15,17,-2,20
NorthEast Un,4154,4,5,3,6,15,15,0,18
FC Pune City,4154,5,5,3,6,15,17,-2,18
Chennaiyin,4154,6,4,6,4,15,18,-3,18
Kolkata,4154,7,3,8,3,19,20,-1,17
FC Goa,4154,8,3,4,7,11,19,-8,13
Mumbai City,4155,1,7,4,3,18,8,10,25
Kerala Blast,4155,2,6,4,4,16,17,-1,22
NorthEast Un,4155,3,6,2,6,15,12,3,20
Kolkata,4155,4,4,8,2,20,18,2,20
Delhi Dynamo,4155,5,4,6,4,22,19,3,18
FC Pune City,4155,6,4,4,6,14,17,-3,16
FC Goa,4155,7,4,3,7,14,19,-5,15
Chennaiyin,4155,8,3,5,6,15,24,-9,14
Mumbai City,4156,1,7,4,3,18,8,10,25
Kolkata,4156,2,6,6,2,20,14,6,24
Delhi Dynamo,4156,3,6,5,3,27,18,9,23
Kerala Blast,4156,4,6,3,5,12,14,-2,21
Chennaiyin,4156,5,4,5,5,17,21,-4,17
FC Pune City,4156,6,4,3,7,13,20,-7,15
NorthEast Un,4156,7,4,2,8,11,14,-3,14
FC Goa,4156,8,4,2,8,13,22,-9,14
Mumbai City,4157,1,7,4,3,17,8,9,25
NorthEast Un,4157,2,6,3,5,13,11,2,21
Delhi Dynamo,4157,3,5,5,4,25,19,6,20
Kolkata,4157,4,4,7,3,15,14,1,19
FC Pune City,4157,5,5,3,6,14,17,-3,18
Kerala Blast,4157,6,5,3,6,11,15,-4,18
Chennaiyin,4157,7,3,6,5,14,19,-5,15
FC Goa,4157,8,4,3,7,11,17,-6,15
Mumbai City,4158,1,7,4,3,18,9,9,25
Kerala Blast,4158,2,5,5,4,13,15,-2,20
NorthEast Un,4158,3,5,3,6,16,14,2,18
FC Goa,4158,4,5,3,6,13,15,-2,18
Delhi Dynamo,4158,5,4,5,5,24,25,-1,17
Kolkata,4158,6,3,8,3,15,16,-1,17
FC Pune City,4158,7,4,5,5,13,15,-2,17
Chennaiyin,4158,8,4,5,5,16,19,-3,17
Delhi Dynamo,4159,1,6,6,2,24,15,9,24
Kerala Blast,4159,2,7,3,4,15,14,1,24
Mumbai City,4159,3,6,5,3,16,8,8,23
Kolkata,4159,4,4,6,4,15,16,-1,18
Chennaiyin,4159,5,4,6,4,16,19,-3,18
NorthEast Un,4159,6,4,3,7,11,14,-3,15
FC Pune City,4159,7,4,3,7,13,17,-4,15
FC Goa,4159,8,4,2,8,11,18,-7,14
Mumbai City,4160,1,7,4,3,19,10,9,25
Kolkata,4160,2,5,6,3,18,15,3,21
Delhi Dynamo,4160,3,5,5,4,24,20,4,20
NorthEast Un,4160,4,6,2,6,14,11,3,20
Chennaiyin,4160,5,5,5,4,17,19,-2,20
FC Pune City,4160,6,5,4,5,15,16,-1,19
Kerala Blast,4160,7,4,4,6,10,16,-6,16
FC Goa,4160,8,3,2,9,10,20,-10,11
Delhi Dynamo,4161,1,6,5,3,27,17,10,23
Mumbai City,4161,2,6,4,4,17,10,7,22
Kolkata,4161,3,5,7,2,18,15,3,22
Kerala Blast,4161,4,6,4,4,15,17,-2,22
NorthEast Un,4161,5,5,3,6,11,11,0,18
FC Pune City,4161,6,4,3,7,14,18,-4,15
Chennaiyin,4161,7,3,6,5,13,19,-6,15
FC Goa,4161,8,4,2,8,11,19,-8,14
Mumbai City,4162,1,7,4,3,20,10,10,25
Kerala Blast,4162,2,6,4,4,14,16,-2,22
Kolkata,4162,3,5,6,3,17,15,2,21
Chennaiyin,4162,4,5,5,4,18,17,1,20
Delhi Dynamo,4162,5,4,5,5,24,22,2,17
NorthEast Un,4162,6,5,2,7,11,15,-4,17
FC Pune City,4162,7,4,4,6,15,18,-3,16
FC Goa,4162,8,4,2,8,10,16,-6,14
Mumbai City,4163,1,7,4,3,17,8,9,25
Kerala Blast,4163,2,7,3,4,13,13,0,24
Delhi Dynamo,4163,3,4,7,3,23,17,6,19
NorthEast Un,4163,4,5,3,6,14,12,2,18
Kolkata,4163,5,4,6,4,14,14,0,18
FC Goa,4163,6,5,3,6,13,17,-4,18
FC Pune City,4163,7,4,3,7,12,16,-4,15
Chennaiyin,4163,8,3,5,6,15,24,-9,14
Delhi Dynamo,4164,1,6,6,2,26,17,9,24
Kolkata,4164,2,6,6,2,22,14,8,24
Mumbai City,4164,3,6,4,4,17,10,7,22
FC Pune City,4164,4,5,3,6,14,17,-3,18
Kerala Blast,4164,5,5,3,6,11,18,-7,18
Chennaiyin,4164,6,4,5,5,16,19,-3,17
NorthEast Un,4164,7,4,3,7,12,15,-3,15
FC Goa,4164,8,4,2,8,11,19,-8,14
Delhi Dynamo,4165,1,6,6,2,24,15,9,24
Mumbai City,4165,2,6,5,3,16,8,8,23
Kolkata,4165,3,4,6,4,15,15,0,18
FC Pune City,4165,4,5,3,6,13,16,-3,18
Kerala Blast,4165,5,5,3,6,12,16,-4,18
NorthEast Un,4165,6,5,2,7,12,14,-2,17
FC Goa,4165,7,5,2,7,15,18,-3,17
Chennaiyin,4165,8,4,5,5,17,22,-5,17
Kerala Blast,4166,1,7,3,4,15,16,-1,24
Mumbai City,4166,2,6,5,3,17,9,8,23
Delhi Dynamo,4166,3,5,6,3,25,17,8,21
Kolkata,4166,4,4,7,3,19,17,2,19
NorthEast Un,4166,5,5,2,7,13,14,-1,17
Chennaiyin,4166,6,4,5,5,16,19,-3,17
FC Pune City,4166,7,4,4,6,15,18,-3,16
FC Goa,4166,8,4,2,8,10,20,-10,14
Delhi Dynamo,4167,1,6,5,3,27,19,8,23
Mumbai City,4167,2,6,4,4,17,11,6,22
Kolkata,4167,3,5,6,3,19,17,2,21
NorthEast Un,4167,4,6,2,6,14,12,2,20
Chennaiyin,4167,5,5,5,4,17,19,-2,20
FC Pune City,4167,6,5,3,6,15,17,-2,18
Kerala Blast,4167,7,4,3,7,13,21,-8,15
FC Goa,4167,8,4,2,8,13,19,-6,14
Mumbai City,4168,1,7,4,3,18,9,9,25
Delhi Dynamo,4168,2,5,6,3,25,17,8,21
Kerala Blast,4168,3,5,5,4,13,15,-2,20
Kolkata,4168,4,4,7,3,16,14,2,19
Chennaiyin,4168,5,4,5,5,15,19,-4,17
FC Goa,4168,6,5,2,7,12,18,-6,17
FC Pune City,4168,7,4,4,6,14,18,-4,16
NorthEast Un,4168,8,4,3,7,10,13,-3,15
Mumbai City,4169,1,6,4,4,16,9,7,22
Delhi Dynamo,4169,2,5,6,3,23,19,4,21
FC Goa,4169,3,6,2,6,19,16,3,20
FC Pune City,4169,4,5,4,5,15,16,-1,19
Kerala Blast,4169,5,5,4,5,12,16,-4,19
NorthEast Un,4169,6,5,3,6,11,11,0,18
Kolkata,4169,7,3,8,3,18,19,-1,17
Chennaiyin,4169,8,3,5,6,14,22,-8,14
Mumbai City,4170,1,6,5,3,17,9,8,23
Kolkata,4170,2,5,7,2,20,16,4,22
Delhi Dynamo,4170,3,5,6,3,27,19,8,21
Kerala Blast,4170,4,5,5,4,12,15,-3,20
NorthEast Un,4170,5,5,3,6,15,15,0,18
FC Pune City,4170,6,4,4,6,12,15,-3,16
Chennaiyin,4170,7,3,6,5,17,22,-5,15
FC Goa,4170,8,4,2,8,13,22,-9,14
Mumbai City,4171,1,7,4,3,19,10,9,25
FC Pune City,4171,2,6,3,5,17,16,1,21
FC Goa,4171,3,6,2,6,17,16,1,20
NorthEast Un,4171,4,6,2,6,11,12,-1,20
Kerala Blast,4171,5,5,4,5,15,17,-2,19
Delhi Dynamo,4171,6,4,5,5,25,23,2,17
Kolkata,4171,7,3,7,4,14,16,-2,16
Chennaiyin,4171,8,3,5,6,13,21,-8,14
Mumbai City,4172,1,6,5,3,16,8,8,23
Delhi Dynamo,4172,2,5,6,3,24,17,7,21
Kolkata,4172,3,5,6,3,19,14,5,21
NorthEast Un,4172,4,6,3,5,12,10,2,21
FC Pune City,4172,5,5,3,6,14,18,-4,18
FC Goa,4172,6,5,2,7,12,16,-4,17
Chennaiyin,4172,7,3,6,5,13,18,-5,15
Kerala Blast,4172,8,4,3,7,10,19,-9,15
Delhi Dynamo,4173,1,6,5,3,26,18,8,23
Mumbai City,4173,2,6,4,4,17,11,6,22
Chennaiyin,4173,3,5,5,4,18,20,-2,20
Kerala Blast,4173,4,5,5,4,13,15,-2,20
Kolkata,4173,5,4,7,3,15,14,1,19
FC Goa,4173,6,5,2,7,13,17,-4,17
NorthEast Un,4173,7,4,3,7,12,14,-2,15
FC Pune City,4173,8,4,3,7,12,17,-5,15
Mumbai City,4174,1,7,4,3,17,8,9,25
NorthEast Un,4174,2,6,3,5,14,9,5,21
Kolkata,4174,3,5,6,3,20,20,0,21
Kerala Blast,4174,4,5,4,5,12,14,-2,19
FC Pune City,4174,5,5,3,6,14,16,-2,18
Delhi Dynamo,4174,6,4,5,5,21,20,1,17
FC Goa,4174,7,4,3,7,16,20,-4,15
Chennaiyin,4174,8,3,6,5,14,21,-7,15
Delhi Dynamo,4175,1,6,6,2,25,16,9,24
Mumbai City,4175,2,6,5,3,16,8,8,23
Kolkata,4175,3,4,6,4,17,17,0,18
FC Pune City,4175,4,5,3,6,14,15,-1,18
Chennaiyin,4175,5,4,6,4,15,18,-3,18
Kerala Blast,4175,6,5,3,6,11,18,-7,18
NorthEast Un,4175,7,5,2,7,12,12,0,17
FC Goa,4175,8,4,3,7,12,18,-6,15
Kolkata,4176,1,6,6,2,19,13,6,24
Delhi Dynamo,4176,2,6,5,3,25,15,10,23
Mumbai City,4176,3,6,4,4,16,11,5,22
NorthEast Un,4176,4,6,2,6,11,12,-1,20
Chennaiyin,4176,5,4,5,5,17,21,-4,17
FC Pune City,4176,6,4,4,6,12,17,-5,16
Kerala Blast,4176,7,4,4,6,10,16,-6,16
FC Goa,4176,8,4,2,8,12,17,-5,14
Mumbai City,4177,1,6,4,4,17,10,7,22
Kolkata,4177,2,5,7,2,16,13,3,22
Delhi Dynamo,4177,3,5,6,3,25,18,7,21
NorthEast Un,4177,4,6,3,5,14,11,3,21
Kerala Blast,4177,5,5,4,5,11,15,-4,19
FC Goa,4177,6,4,4,6,11,16,-5,16
FC Pune City,4177,7,4,3,7,13,17,-4,15
Chennaiyin,4177,8,3,5,6,14,21,-7,14
Mumbai City,4178,1,6,5,3,16,8,8,23
Delhi Dynamo,4178,2,5,7,2,23,15,8,22
Kerala Blast,4178,3,5,5,4,16,18,-2,20
NorthEast Un,4178,4,5,3,6,15,13,2,18
FC Pune City,4178,5,4,5,5,14,16,-2,17
Chennaiyin,4178,6,4,5,5,15,21,-6,17
Kolkata,4178,7,3,7,4,17,20,-3,16
FC Goa,4178,8,4,3,7,12,17,-5,15
Mumbai City,4179,1,7,4,3,17,8,9,25
Kolkata,4179,2,5,7,2,17,13,4,22
NorthEast Un,4179,3,6,2,6,14,15,-1,20
FC Pune City,4179,4,5,4,5,14,15,-1,19
Chennaiyin,4179,5,4,6,4,17,18,-1,18
Delhi Dynamo,4179,6,4,5,5,23,20,3,17
FC Goa,4179,7,4,3,7,12,17,-5,15
Kerala Blast,4179,8,4,3,7,11,19,-8,15
Mumbai City,4180,1,7,4,3,18,9,9,25
Kolkata,4180,2,4,8,2,17,14,3,20
Delhi Dynamo,4180,3,4,6,4,25,21,4,18
FC Pune City,4180,4,5,3,6,13,16,-3,18
FC Goa,4180,5,5,3,6,12,15,-3,18
NorthEast Un,4180,6,4,5,5,16,16,0,17
Kerala Blast,4180,7,4,5,5,11,16,-5,17
Chennaiyin,4180,8,3,6,5,16,21,-5,15
Delhi Dynamo,4181,1,6,6,2,27,17,10,24
Mumbai City,4181,2,6,4,4,16,9,7,22
Chennaiyin,4181,3,5,5,4,18,18,0,20
FC Pune City,4181,4,5,4,5,14,14,0,19
NorthEast Un,4181,5,5,3,6,14,15,-1,18
Kerala Blast,4181,6,5,3,6,15,18,-3,18
Kolkata,4181,7,3,8,3,14,17,-3,17
FC Goa,4181,8,3,3,8,9,19,-10,12
Mumbai City,4182,1,7,4,3,18,8,10,25
Delhi Dynamo,4182,2,6,5,3,26,19,7,23
Kolkata,4182,3,5,6,3,17,14,3,21
FC Pune City,4182,4,5,4,5,13,14,-1,19
Chennaiyin,4182,5,4,6,4,17,18,-1,18
Kerala Blast,4182,6,4,5,5,11,17,-6,17
NorthEast Un,4182,7,4,3,7,13,17,-4,15
FC Goa,4182,8,3,3,8,9,17,-8,12
Mumbai City,4183,1,7,4,3,18,8,10,25
Delhi Dynamo,4183,2,5,6,3,23,16,7,21
NorthEast Un,4183,3,5,3,6,11,12,-1,18
FC Pune City,4183,4,5,3,6,17,20,-3,18
Kolkata,4183,4,4,6,4,17,20,-3,18
Chennaiyin,4183,6,4,6,4,16,19,-3,18
Kerala Blast,4183,7,5,3,6,14,17,-3,18
FC Goa,4183,8,4,3,7,14,18,-4,15
Mumbai City,4184,1,7,4,3,18,9,9,25
Delhi Dynamo,4184,2,4,7,3,25,19,6,19
Kolkata,4184,3,4,7,3,17,14,3,19
FC Pune City,4184,4,5,4,5,13,14,-1,19
FC Goa,4184,5,5,3,6,12,16,-4,18
Kerala Blast,4184,6,5,3,6,10,17,-7,18
Chennaiyin,4184,7,4,5,5,15,19,-4,17
NorthEast Un,4184,8,4,3,7,12,14,-2,15
Mumbai City,4185,1,7,4,3,19,9,10,25
Kerala Blast,4185,2,7,3,4,18,15,3,24
Chennaiyin,4185,3,5,5,4,17,17,0,20
Kolkata,4185,4,4,6,4,17,17,0,18
Delhi Dynamo,4185,5,4,5,5,24,23,1,17
NorthEast Un,4185,6,5,2,7,11,14,-3,17
FC Goa,4185,7,5,2,7,14,19,-5,17
FC Pune City,4185,8,4,3,7,14,20,-6,15
Delhi Dynamo,4186,1,6,5,3,26,19,7,23
Mumbai City,4186,2,6,4,4,16,9,7,22
NorthEast Un,4186,3,6,2,6,17,14,3,20
Kolkata,4186,4,3,9,2,17,16,1,18
FC Pune City,4186,5,4,5,5,15,17,-2,17
Chennaiyin,4186,6,4,5,5,14,19,-5,17
Kerala Blast,4186,7,4,5,5,13,19,-6,17
FC Goa,4186,8,4,3,7,10,15,-5,15
Delhi Dynamo,4187,1,6,6,2,29,17,12,24
Mumbai City,4187,2,6,5,3,18,10,8,23
Kerala Blast,4187,3,5,5,4,14,15,-1,20
Kolkata,4187,4,4,7,3,18,15,3,19
NorthEast Un,4187,5,5,3,6,10,12,-2,18
FC Pune City,4187,6,5,3,6,13,17,-4,18
Chennaiyin,4187,7,4,5,5,15,19,-4,17
FC Goa,4187,8,3,2,9,10,22,-12,11
Mumbai City,4188,1,7,4,3,18,9,9,25
Kolkata,4188,2,5,6,3,19,14,5,21
Kerala Blast,4188,3,6,3,5,12,15,-3,21
Delhi Dynamo,4188,4,5,5,4,25,17,8,20
NorthEast Un,4188,5,6,2,6,12,12,0,20
FC Pune City,4188,6,5,3,6,14,17,-3,18
Chennaiyin,4188,7,3,6,5,16,21,-5,15
FC Goa,4188,8,3,3,8,11,22,-11,12
Mumbai City,4189,1,6,5,3,18,10,8,23
NorthEast Un,4189,2,6,3,5,15,11,4,21
Kolkata,4189,3,5,6,3,17,15,2,21
Delhi Dynamo,4189,4,4,7,3,24,20,4,19
Kerala Blast,4189,5,5,3,6,12,17,-5,18
Chennaiyin,4189,6,3,7,4,16,20,-4,16
FC Goa,4189,7,4,4,6,12,17,-5,16
FC Pune City,4189,8,4,3,7,15,19,-4,15
Mumbai City,4190,1,7,4,3,20,8,12,25
Delhi Dynamo,4190,2,6,5,3,25,19,6,23
FC Pune City,4190,3,6,3,5,16,15,1,21
Kolkata,4190,4,4,7,3,18,14,4,19
Chennaiyin,4190,5,4,6,4,18,21,-3,18
Kerala Blast,4190,6,5,3,6,11,19,-8,18
NorthEast Un,4190,7,4,3,7,12,15,-3,15
FC Goa,4190,8,3,3,8,10,19,-9,12
Mumbai City,4191,1,7,4,3,17,8,9,25
Kolkata,4191,2,6,6,2,18,14,4,24
Delhi Dynamo,4191,3,6,5,3,26,16,10,23
FC Pune City,4191,4,5,3,6,14,16,-2,18
Kerala Blast,4191,5,5,3,6,10,15,-5,18
Chennaiyin,4191,6,4,5,5,16,19,-3,17
NorthEast Un,4191,7,4,2,8,10,14,-4,14
FC Goa,4191,8,4,2,8,11,20,-9,14
Mumbai City,4192,1,6,4,4,16,11,5,22
Kerala Blast,4192,2,6,3,5,16,19,-3,21
Delhi Dynamo,4192,3,5,5,4,25,20,5,20
Kolkata,4192,4,4,7,3,19,17,2,19
NorthEast Un,4192,5,5,3,6,13,13,0,18
FC Pune City,4192,6,5,3,6,16,18,-2,18
Chennaiyin,4192,7,4,6,4,14,17,-3,18
FC Goa,4192,8,4,3,7,12,16,-4,15
Mumbai City,4193,1,6,5,3,16,8,8,23
Kolkata,4193,2,5,7,2,17,14,3,22
Delhi Dynamo,4193,3,5,6,3,24,18,6,21
Kerala Blast,4193,4,6,3,5,11,14,-3,21
NorthEast Un,4193,5,5,2,7,12,13,-1,17
FC Goa,4193,6,4,4,6,12,16,-4,16
FC Pune City,4193,7,4,3,7,13,17,-4,15
Chennaiyin,4193,8,3,6,5,14,19,-5,15
Mumbai City,4194,1,6,5,3,17,9,8,23
Kerala Blast,4194,2,6,3,5,13,15,-2,21
Kolkata,4194,3,4,8,2,17,15,2,20
Delhi Dynamo,4194,4,4,6,4,25,22,3,18
Chennaiyin,4194,5,4,6,4,15,18,-3,18
NorthEast Un,4194,6,5,2,7,13,14,-1,17
FC Pune City,4194,7,4,4,6,13,16,-3,16
FC Goa,4194,8,4,4,6,13,17,-4,16
Mumbai City,4195,1,6,5,3,18,10,8,23
Delhi Dynamo,4195,2,5,7,2,28,18,10,22
FC Pune City,4195,3,6,3,5,17,17,0,21
NorthEast Un,4195,4,5,3,6,12,12,0,18
Kolkata,4195,5,4,6,4,17,18,-1,18
Kerala Blast,4195,6,5,3,6,14,19,-5,18
Chennaiyin,4195,7,3,6,5,14,19,-5,15
FC Goa,4195,8,4,3,7,13,20,-7,15
Mumbai City,4196,1,7,4,3,19,9,10,25
Kerala Blast,4196,2,7,3,4,16,15,1,24
FC Pune City,4196,3,5,3,6,15,17,-2,18
NorthEast Un,4196,4,5,3,6,11,13,-2,18
Delhi Dynamo,4196,5,4,5,5,23,21,2,17
Kolkata,4196,6,3,7,4,16,17,-1,16
Chennaiyin,4196,7,3,7,4,14,18,-4,16
FC Goa,4196,8,4,4,6,12,16,-4,16
Delhi Dynamo,4197,1,7,5,2,28,15,13,26
Mumbai City,4197,2,6,4,4,16,10,6,22
Kerala Blast,4197,3,5,5,4,12,15,-3,20
Kolkata,4197,4,4,6,4,16,16,0,18
NorthEast Un,4197,5,5,3,6,12,12,0,18
FC Goa,4197,6,5,2,7,11,16,-5,17
FC Pune City,4197,7,4,4,6,14,17,-3,16
Chennaiyin,4197,8,3,5,6,13,21,-8,14
Mumbai City,4198,1,6,5,3,16,8,8,23
Kolkata,4198,2,5,7,2,20,16,4,22
Delhi Dynamo,4198,3,5,6,3,24,16,8,21
FC Pune City,4198,4,5,4,5,13,14,-1,19
NorthEast Un,4198,5,5,3,6,10,11,-1,18
Chennaiyin,4198,6,4,6,4,16,18,-2,18
Kerala Blast,4198,7,4,4,6,10,16,-6,16
FC Goa,4198,8,3,3,8,13,23,-10,12
Kolkata,4199,1,6,6,2,19,13,6,24
Delhi Dynamo,4199,2,6,5,3,26,17,9,23
Mumbai City,4199,3,6,4,4,17,10,7,22
Kerala Blast,4199,4,6,3,5,12,16,-4,21
NorthEast Un,4199,5,6,2,6,12,11,1,20
FC Pune City,4199,6,4,3,7,12,17,-5,15
Chennaiyin,4199,7,3,5,6,13,20,-7,14
FC Goa,4199,8,4,2,8,11,18,-7,14
Mumbai City,4200,1,6,5,3,16,8,8,23
Delhi Dynamo,4200,2,5,6,3,23,17,6,21
Kolkata,4200,3,4,7,3,19,15,4,19
NorthEast Un,4200,4,5,4,5,13,11,2,19
Kerala Blast,4200,5,4,6,4,13,17,-4,18
FC Goa,4200,6,5,2,7,11,16,-5,17
FC Pune City,4200,7,4,4,6,13,19,-6,16
Chennaiyin,4200,8,3,6,5,14,19,-5,15
Mumbai City,4201,1,7,4,3,21,8,13,25
Delhi Dynamo,4201,2,5,6,3,24,21,3,21
Kolkata,4201,3,5,6,3,19,17,2,21
NorthEast Un,4201,4,5,4,5,12,11,1,19
FC Pune City,4201,5,5,3,6,14,16,-2,18
Kerala Blast,4201,6,4,4,6,11,18,-7,16
Chennaiyin,4201,7,3,6,5,15,20,-5,15
FC Goa,4201,8,4,3,7,14,19,-5,15
Delhi Dynamo,4202,1,7,5,2,28,15,13,26
Mumbai City,4202,2,6,4,4,16,10,6,22
Kolkata,4202,3,4,8,2,16,14,2,20
NorthEast Un,4202,4,5,3,6,14,13,1,18
Chennaiyin,4202,5,4,6,4,15,18,-3,18
FC Pune City,4202,6,4,5,5,13,15,-2,17
Kerala Blast,4202,7,4,5,5,12,20,-8,17
FC Goa,4202,8,3,2,9,9,18,-9,11
Delhi Dynamo,4203,1,7,5,2,27,14,13,26
Mumbai City,4203,2,6,4,4,16,11,5,22
Kolkata,4203,3,5,7,2,19,15,4,22
Kerala Blast,4203,4,6,3,5,14,15,-1,21
NorthEast Un,4203,5,5,2,7,12,14,-2,17
FC Pune City,4203,6,4,4,6,15,18,-3,16
FC Goa,4203,7,4,2,8,11,18,-7,14
Chennaiyin,4203,8,3,5,6,13,22,-9,14
Mumbai City,4204,1,7,4,3,18,8,10,25
Delhi Dynamo,4204,2,6,5,3,25,18,7,23
Kerala Blast,4204,3,6,3,5,13,15,-2,21
FC Pune City,4204,4,5,4,5,13,14,-1,19
NorthEast Un,4204,5,5,2,7,14,14,0,17
Chennaiyin,4204,6,4,5,5,16,21,-5,17
Kolkata,4204,7,3,7,4,15,16,-1,16
FC Goa,4204,8,4,2,8,11,19,-8,14
Mumbai City,4205,1,6,5,3,16,8,8,23
Kolkata,4205,2,5,7,2,16,13,3,22
Delhi Dynamo,4205,3,4,8,2,24,17,7,20
NorthEast Un,4205,4,5,4,5,14,12,2,19
Chennaiyin,4205,5,4,6,4,16,18,-2,18
FC Pune City,4205,6,4,5,5,15,17,-2,17
Kerala Blast,4205,7,4,4,6,14,21,-7,16
FC Goa,4205,8,3,3,8,10,19,-9,12
Delhi Dynamo,4206,1,6,5,3,28,16,12,23
Mumbai City,4206,2,6,4,4,16,11,5,22
Kolkata,4206,3,5,7,2,17,14,3,22
FC Pune City,4206,4,4,5,5,13,15,-2,17
NorthEast Un,4206,5,5,2,7,12,15,-3,17
FC Goa,4206,6,5,2,7,13,17,-4,17
Chennaiyin,4206,7,4,5,5,15,20,-5,17
Kerala Blast,4206,8,4,4,6,12,18,-6,16
Mumbai City,4207,1,6,5,3,17,9,8,23
Kolkata,4207,2,5,6,3,19,15,4,21
Delhi Dynamo,4207,3,4,7,3,23,18,5,19
FC Pune City,4207,4,5,4,5,17,17,0,19
NorthEast Un,4207,5,4,5,5,13,13,0,17
Kerala Blast,4207,6,4,5,5,14,20,-6,17
FC Goa,4207,7,5,2,7,13,19,-6,17
Chennaiyin,4207,8,3,6,5,17,22,-5,15
Delhi Dynamo,4208,1,6,6,2,28,17,11,24
Kolkata,4208,2,6,6,2,18,13,5,24
Mumbai City,4208,3,6,5,3,17,9,8,23
NorthEast Un,4208,4,5,3,6,11,11,0,18
FC Pune City,4208,5,5,3,6,14,16,-2,18
Chennaiyin,4208,6,4,6,4,17,20,-3,18
Kerala Blast,4208,7,4,3,7,11,20,-9,15
FC Goa,4208,8,3,2,9,13,23,-10,11
Delhi Dynamo,4209,1,6,5,3,28,20,8,23
Mumbai City,4209,2,6,4,4,17,10,7,22
Kolkata,4209,3,5,6,3,20,15,5,21
NorthEast Un,4209,4,5,3,6,14,13,1,18
FC Pune City,4209,5,5,3,6,16,19,-3,18
Chennaiyin,4209,6,4,5,5,15,19,-4,17
FC Goa,4209,7,5,2,7,13,18,-5,17
Kerala Blast,4209,8,4,4,6,14,23,-9,16
Mumbai City,4210,1,7,4,3,20,8,12,25
FC Pune City,4210,2,5,4,5,16,16,0,19
Kolkata,4210,3,4,7,3,15,15,0,19
Kerala Blast,4210,4,5,4,5,13,16,-3,19
Delhi Dynamo,4210,5,4,6,4,22,21,1,18
FC Goa,4210,6,5,3,6,14,16,-2,18
Chennaiyin,4210,7,4,5,5,18,21,-3,17
NorthEast Un,4210,8,4,3,7,11,16,-5,15
Delhi Dynamo,4211,1,6,6,2,27,15,12,24
Mumbai City,4211,2,6,4,4,16,12,4,22
FC Pune City,4211,3,6,3,5,15,15,0,21
NorthEast Un,4211,4,6,2,6,13,11,2,20
Kerala Blast,4211,5,5,3,6,13,18,-5,18
Chennaiyin,4211,6,4,5,5,17,19,-2,17
Kolkata,4211,7,3,7,4,15,16,-1,16
FC Goa,4211,8,3,4,7,8,18,-10,13
Mumbai City,4212,1,7,4,3,19,8,11,25
Delhi Dynamo,4212,2,6,5,3,27,18,9,23
Kolkata,4212,3,4,8,2,22,17,5,20
FC Pune City,4212,4,5,4,5,17,18,-1,19
Kerala Blast,4212,5,5,3,6,14,22,-8,18
NorthEast Un,4212,6,5,2,7,12,14,-2,17
Chennaiyin,4212,7,3,6,5,13,18,-5,15
FC Goa,4212,8,3,4,7,10,19,-9,13
Mumbai City,4213,1,6,5,3,17,9,8,23
Kerala Blast,4213,2,6,4,4,12,13,-1,22
NorthEast Un,4213,3,6,2,6,11,10,1,20
Delhi Dynamo,4213,4,4,7,3,22,16,6,19
Kolkata,4213,5,3,9,2,15,14,1,18
FC Pune City,4213,6,4,4,6,13,17,-4,16
FC Goa,4213,7,4,4,6,10,15,-5,16
Chennaiyin,4213,8,3,5,6,13,19,-6,14
Mumbai City,4214,1,7,4,3,18,9,9,25
Kerala Blast,4214,2,6,3,5,11,15,-4,21
Delhi Dynamo,4214,3,5,5,4,24,20,4,20
NorthEast Un,4214,4,6,2,6,14,10,4,20
Kolkata,4214,5,4,7,3,16,15,1,19
Chennaiyin,4214,6,4,5,5,15,19,-4,17
FC Pune City,4214,7,4,4,6,13,16,-3,16
FC Goa,4214,8,4,2,8,12,19,-7,14
Mumbai City,4215,1,7,4,3,19,9,10,25
Kolkata,4215,2,4,8,2,17,15,2,20
Chennaiyin,4215,3,5,5,4,17,18,-1,20
Delhi Dynamo,4215,4,4,7,3,23,18,5,19
Kerala Blast,4215,5,5,4,5,12,16,-4,19
NorthEast Un,4215,6,4,4,6,11,13,-2,16
FC Pune City,4215,7,4,4,6,14,17,-3,16
FC Goa,4215,8,3,4,7,9,16,-7,13
Mumbai City,4216,1,7,4,3,19,9,10,25
Kerala Blast,4216,2,5,5,4,13,16,-3,20
Delhi Dynamo,4216,3,4,7,3,22,17,5,19
Kolkata,4216,4,3,9,2,14,13,1,18
FC Pune City,4216,5,4,5,5,13,15,-2,17
NorthEast Un,4216,6,4,4,6,10,11,-1,16
FC Goa,4216,7,4,4,6,10,14,-4,16
Chennaiyin,4216,8,3,6,5,13,19,-6,15
Mumbai City,4217,1,7,4,3,18,9,9,25
Kolkata,4217,2,6,6,2,22,16,6,24
Delhi Dynamo,4217,3,5,6,3,26,18,8,21
NorthEast Un,4217,4,5,3,6,12,13,-1,18
FC Pune City,4217,5,4,4,6,14,17,-3,16
Kerala Blast,4217,6,4,4,6,12,20,-8,16
FC Goa,4217,7,4,3,7,15,20,-5,15
Chennaiyin,4217,8,3,6,5,13,19,-6,15
Mumbai City,4218,1,6,4,4,16,9,7,22
Kerala Blast,4218,2,6,4,4,15,17,-2,22
Delhi Dynamo,4218,3,5,6,3,24,18,6,21
FC Goa,4218,4,5,3,6,15,16,-1,18
Kolkata,4218,5,3,8,3,16,16,0,17
FC Pune City,4218,6,4,5,5,15,17,-2,17
Chennaiyin,4218,7,4,5,5,19,23,-4,17
NorthEast Un,4218,8,4,3,7,12,16,-4,15
Mumbai City,4219,1,6,5,3,16,8,8,23
Kolkata,4219,2,5,7,2,18,15,3,22
NorthEast Un,4219,3,6,2,6,13,12,1,20
Delhi Dynamo,4219,4,4,7,3,21,15,6,19
Chennaiyin,4219,5,4,6,4,15,18,-3,18
FC Pune City,4219,6,4,5,5,13,15,-2,17
Kerala Blast,4219,7,4,4,6,12,18,-6,16
FC Goa,4219,8,3,4,7,10,17,-7,13
Mumbai City,4220,1,7,4,3,20,9,11,25
NorthEast Un,4220,2,6,2,6,13,12,1,20
FC Goa,4220,3,6,2,6,13,15,-2,20
Kolkata,4220,4,4,7,3,17,14,3,19
FC Pune City,4220,5,5,4,5,15,16,-1,19
Kerala Blast,4220,6,5,3,6,13,20,-7,18
Delhi Dynamo,4220,7,4,5,5,23,21,2,17
Chennaiyin,4220,8,3,5,6,14,21,-7,14
Mumbai City,4221,1,7,4,3,18,9,9,25
Delhi Dynamo,4221,2,6,5,3,29,17,12,23
Kerala Blast,4221,3,6,4,4,15,16,-1,22
Chennaiyin,4221,4,5,5,4,16,17,-1,20
Kolkata,4221,5,3,8,3,16,17,-1,17
FC Pune City,4221,6,4,4,6,14,18,-4,16
NorthEast Un,4221,7,4,2,8,11,16,-5,14
FC Goa,4221,8,4,2,8,11,20,-9,14
Mumbai City,4222,1,7,4,3,18,8,10,25
Delhi Dynamo,4222,2,5,6,3,24,16,8,21
Kolkata,4222,3,5,6,3,18,16,2,21
Kerala Blast,4222,4,5,4,5,13,17,-4,19
FC Goa,4222,5,5,2,7,12,17,-5,17
NorthEast Un,4222,6,4,4,6,11,13,-2,16
FC Pune City,4222,7,4,4,6,14,17,-3,16
Chennaiyin,4222,8,3,6,5,15,21,-6,15
Delhi Dynamo,4223,1,6,6,2,28,18,10,24
Mumbai City,4223,2,6,5,3,17,9,8,23
FC Pune City,4223,3,6,3,5,14,14,0,21
Kerala Blast,4223,4,5,4,5,10,14,-4,19
Chennaiyin,4223,5,4,6,4,17,20,-3,18
Kolkata,4223,6,3,7,4,13,14,-1,16
FC Goa,4223,7,4,3,7,12,19,-7,15
NorthEast Un,4223,8,4,2,8,12,15,-3,14
Mumbai City,4224,1,6,4,4,16,10,6,22
Kerala Blast,4224,2,6,4,4,12,14,-2,22
Delhi Dynamo,4224,3,5,5,4,23,18,5,20
NorthEast Un,4224,4,5,3,6,14,12,2,18
Kolkata,4224,5,3,9,2,15,14,1,18
Chennaiyin,4224,6,4,6,4,16,19,-3,18
FC Pune City,4224,7,4,4,6,13,16,-3,16
FC Goa,4224,8,4,3,7,9,15,-6,15
Delhi Dynamo,4225,1,7,5,2,25,14,11,26
Mumbai City,4225,2,6,4,4,16,10,6,22
Kolkata,4225,3,4,7,3,16,15,1,19
Kerala Blast,4225,4,5,4,5,13,19,-6,19
FC Pune City,4225,5,5,3,6,15,16,-1,18
NorthEast Un,4225,6,5,2,7,13,13,0,17
Chennaiyin,4225,7,4,5,5,16,20,-4,17
FC Goa,4225,8,4,2,8,11,18,-7,14
Mumbai City,4226,1,7,4,3,19,8,11,25
Kolkata,4226,2,5,7,2,18,13,5,22
Delhi Dynamo,4226,3,5,5,4,22,18,4,20
Chennaiyin,4226,4,4,6,4,18,19,-1,18
Kerala Blast,4226,5,4,5,5,12,18,-6,17
FC Pune City,4226,6,4,4,6,14,18,-4,16
FC Goa,4226,7,4,4,6,11,16,-5,16
NorthEast Un,4226,8,4,3,7,11,15,-4,15
Mumbai City,4227,1,7,4,3,18,9,9,25
Kolkata,4227,2,6,6,2,20,13,7,24
NorthEast Un,4227,3,5,3,6,15,14,1,18
FC Pune City,4227,4,5,3,6,17,20,-3,18
Kerala Blast,4227,5,5,3,6,12,19,-7,18
Delhi Dynamo,4227,6,4,5,5,23,20,3,17
FC Goa,4227,7,5,2,7,11,15,-4,17
Chennaiyin,4227,8,3,6,5,15,21,-6,15
Mumbai City,4228,1,6,5,3,17,9,8,23
Kolkata,4228,2,5,6,3,18,15,3,21
Chennaiyin,4228,3,5,5,4,18,20,-2,20
Kerala Blast,4228,4,5,4,5,13,16,-3,19
Delhi Dynamo,4228,5,4,6,4,22,18,4,18
NorthEast Un,4228,6,5,3,6,13,12,1,18
FC Goa,4228,7,5,2,7,13,18,-5,17
FC Pune City,4228,8,4,3,7,13,19,-6,15
Mumbai City,4229,1,6,5,3,17,9,8,23
Delhi Dynamo,4229,2,5,7,2,26,18,8,22
Kolkata,4229,3,5,6,3,17,15,2,21
FC Pune City,4229,4,6,3,5,15,15,0,21
NorthEast Un,4229,5,5,3,6,12,13,-1,18
Chennaiyin,4229,6,4,5,5,17,20,-3,17
Kerala Blast,4229,7,4,3,7,9,16,-7,15
FC Goa,4229,8,4,2,8,13,20,-7,14
Delhi Dynamo,4230,1,6,6,2,25,15,10,24
Mumbai City,4230,2,6,5,3,16,8,8,23
Kolkata,4230,3,5,7,2,21,15,6,22
Kerala Blast,4230,4,6,3,5,13,16,-3,21
NorthEast Un,4230,5,5,2,7,10,12,-2,17
FC Pune City,4230,6,4,4,6,13,17,-4,16
Chennaiyin,4230,7,3,5,6,13,19,-6,14
FC Goa,4230,8,4,2,8,11,20,-9,14
Delhi Dynamo,4231,1,6,6,2,29,20,9,24
Mumbai City,4231,2,6,4,4,18,11,7,22
Kerala Blast,4231,3,6,3,5,13,16,-3,21
Chennaiyin,4231,4,5,5,4,17,17,0,20
Kolkata,4231,5,4,6,4,17,16,1,18
FC Pune City,4231,6,5,3,6,15,17,-2,18
NorthEast Un,4231,7,4,3,7,12,17,-5,15
FC Goa,4231,8,4,2,8,10,17,-7,14
Mumbai City,4232,1,7,4,3,17,8,9,25
Delhi Dynamo,4232,2,6,5,3,26,16,10,23
Kolkata,4232,3,4,7,3,19,14,5,19
Kerala Blast,4232,4,5,4,5,14,17,-3,19
NorthEast Un,4232,5,5,3,6,14,14,0,18
FC Goa,4232,6,5,2,7,10,17,-7,17
Chennaiyin,4232,7,3,6,5,14,19,-5,15
FC Pune City,4232,8,4,3,7,12,21,-9,15
Delhi Dynamo,4233,1,7,5,2,28,15,13,26
Mumbai City,4233,2,6,4,4,17,11,6,22
FC Pune City,4233,3,6,3,5,15,15,0,21
Kerala Blast,4233,4,5,4,5,12,16,-4,19
Chennaiyin,4233,5,4,5,5,16,19,-3,17
FC Goa,4233,6,5,2,7,11,18,-7,17
Kolkata,4233,7,3,7,4,16,17,-1,16
NorthEast Un,4233,8,4,2,8,11,15,-4,14
Kolkata,4234,1,6,6,2,17,12,5,24
Delhi Dynamo,4234,2,5,7,2,23,15,8,22
Mumbai City,4234,3,6,4,4,16,9,7,22
Kerala Blast,4234,4,5,4,5,11,15,-4,19
NorthEast Un,4234,5,5,3,6,12,10,2,18
FC Pune City,4234,6,4,4,6,13,17,-4,16
Chennaiyin,4234,7,3,6,5,13,20,-7,15
FC Goa,4234,8,3,4,7,9,16,-7,13
Mumbai City,4235,1,7,4,3,18,9,9,25
NorthEast Un,4235,2,7,2,5,14,9,5,23
Kolkata,4235,3,4,7,3,16,14,2,19
Delhi Dynamo,4235,4,4,6,4,22,17,5,18
FC Pune City,4235,5,5,3,6,13,15,-2,18
Kerala Blast,4235,6,5,3,6,10,16,-6,18
Chennaiyin,4235,7,3,6,5,14,21,-7,15
FC Goa,4235,8,3,5,6,10,16,-6,14
Mumbai City,4236,1,7,4,3,19,9,10,25
Kerala Blast,4236,2,6,4,4,16,14,2,22
Chennaiyin,4236,3,5,5,4,16,18,-2,20
Delhi Dynamo,4236,4,4,6,4,23,20,3,18
NorthEast Un,4236,5,5,3,6,12,11,1,18
FC Pune City,4236,6,5,3,6,14,17,-3,18
Kolkata,4236,7,3,7,4,15,19,-4,16
FC Goa,4236,8,3,4,7,11,18,-7,13
Mumbai City,4237,1,6,4,4,16,9,7,22
Delhi Dynamo,4237,2,5,6,3,24,17,7,21
Kerala Blast,4237,3,5,5,4,12,15,-3,20
FC Pune City,4237,4,5,4,5,14,15,-1,19
FC Goa,4237,5,5,3,6,13,15,-2,18
Chennaiyin,4237,6,4,5,5,17,20,-3,17
NorthEast Un,4237,7,5,2,7,11,15,-4,17
Kolkata,4237,8,3,7,4,14,15,-1,16
Mumbai City,4238,1,7,4,3,18,8,10,25
NorthEast Un,4238,2,7,2,5,16,12,4,23
Kolkata,4238,3,5,6,3,17,16,1,21
Kerala Blast,4238,4,5,4,5,13,16,-3,19
Delhi Dynamo,4238,5,4,5,5,23,20,3,17
FC Goa,4238,6,5,2,7,13,18,-5,17
FC Pune City,4238,7,4,4,6,14,17,-3,16
Chennaiyin,4238,8,3,5,6,15,22,-7,14
Kolkata,4239,1,6,6,2,20,13,7,24
Mumbai City,4239,2,6,5,3,18,10,8,23
Delhi Dynamo,4239,3,5,6,3,26,19,7,21
NorthEast Un,4239,4,5,3,6,13,13,0,18
Chennaiyin,4239,5,4,6,4,15,18,-3,18
FC Pune City,4239,6,5,3,6,14,17,-3,18
Kerala Blast,4239,7,4,3,7,11,19,-8,15
FC Goa,4239,8,4,2,8,10,18,-8,14
Mumbai City,4240,1,6,5,3,17,9,8,23
Kolkata,4240,2,5,7,2,17,14,3,22
Kerala Blast,4240,3,6,4,4,16,14,2,22
Delhi Dynamo,4240,4,5,6,3,26,19,7,21
Chennaiyin,4240,5,5,5,4,17,17,0,20
NorthEast Un,4240,6,5,2,7,13,15,-2,17
FC Pune City,4240,7,4,3,7,13,20,-7,15
FC Goa,4240,8,3,2,9,8,19,-11,11
Mumbai City,4241,1,6,5,3,17,9,8,23
Delhi Dynamo,4241,2,4,8,2,25,18,7,20
FC Pune City,4241,3,5,4,5,16,16,0,19
Kerala Blast,4241,4,4,6,4,12,16,-4,18
NorthEast Un,4241,5,4,5,5,12,12,0,17
Kolkata,4241,6,3,7,4,16,18,-2,16
Chennaiyin,4241,7,3,7,4,14,18,-4,16
FC Goa,4241,8,4,4,6,12,17,-5,16
Mumbai City,4242,1,6,5,3,18,10,8,23
Delhi Dynamo,4242,2,5,7,2,26,17,9,22
Kolkata,4242,3,4,8,2,17,15,2,20
Kerala Blast,4242,4,5,5,4,13,16,-3,20
Chennaiyin,4242,5,4,5,5,18,19,-1,17
NorthEast Un,4242,6,4,4,6,13,17,-4,16
FC Pune City,4242,7,4,3,7,13,17,-4,15
FC Goa,4242,8,4,3,7,10,17,-7,15
Delhi Dynamo,4243,1,7,5,2,26,15,11,26
Mumbai City,4243,2,6,4,4,16,9,7,22
Kolkata,4243,3,4,8,2,15,13,2,20
Chennaiyin,4243,4,5,5,4,17,18,-1,20
Kerala Blast,4243,5,5,3,6,14,17,-3,18
NorthEast Un,4243,6,5,2,7,11,14,-3,17
FC Pune City,4243,7,4,4,6,14,19,-5,16
FC Goa,4243,8,3,3,8,10,18,-8,12
Mumbai City,4244,1,6,5,3,16,8,8,23
Delhi Dynamo,4244,2,5,6,3,25,18,7,21
Kolkata,4244,3,4,8,2,17,14,3,20
NorthEast Un,4244,4,6,2,6,13,12,1,20
Kerala Blast,4244,5,5,3,6,10,17,-7,18
Chennaiyin,4244,6,4,5,5,17,19,-2,17
FC Pune City,4244,7,4,4,6,13,16,-3,16
FC Goa,4244,8,4,3,7,13,20,-7,15
Mumbai City,4245,1,7,4,3,18,8,10,25
NorthEast Un,4245,2,6,3,5,14,11,3,21
Kolkata,4245,3,4,7,3,16,15,1,19
Delhi Dynamo,4245,4,4,6,4,23,20,3,18
FC Goa,4245,5,5,3,6,16,17,-1,18
Kerala Blast,4245,6,4,6,4,11,15,-4,18
FC Pune City,4245,7,4,4,6,15,18,-3,16
Chennaiyin,4245,8,3,5,6,15,24,-9,14
Mumbai City,4246,1,6,5,3,17,9,8,23
Chennaiyin,4246,2,5,5,4,15,17,-2,20
Kerala Blast,4246,3,5,5,4,14,16,-2,20
Kolkata,4246,4,4,7,3,15,14,1,19
FC Pune City,4246,5,5,4,5,15,16,-1,19
Delhi Dynamo,4246,6,4,6,4,23,20,3,18
NorthEast Un,4246,7,5,2,7,12,13,-1,17
FC Goa,4246,8,4,2,8,10,16,-6,14
Delhi Dynamo,4247,1,6,6,2,24,14,10,24
Kolkata,4247,2,6,6,2,19,14,5,24
Mumbai City,4247,3,6,4,4,16,10,6,22
NorthEast Un,4247,4,6,3,5,16,11,5,21
FC Pune City,4247,5,4,4,6,13,17,-4,16
Kerala Blast,4247,6,4,4,6,12,20,-8,16
FC Goa,4247,7,4,2,8,12,17,-5,14
Chennaiyin,4247,8,3,5,6,16,25,-9,14
Mumbai City,4248,1,7,4,3,19,9,10,25
NorthEast Un,4248,2,7,2,5,15,10,5,23
Delhi Dynamo,4248,3,5,5,4,25,21,4,20
FC Pune City,4248,4,5,4,5,14,15,-1,19
Kolkata,4248,5,3,8,3,16,19,-3,17
Kerala Blast,4248,6,4,4,6,12,19,-7,16
FC Goa,4248,7,4,3,7,14,17,-3,15
Chennaiyin,4248,8,3,6,5,13,18,-5,15
Mumbai City,4249,1,6,5,3,17,9,8,23
Delhi Dynamo,4249,2,5,7,2,24,16,8,22
Kolkata,4249,3,5,6,3,16,14,2,21
FC Pune City,4249,4,5,3,6,13,15,-2,18
Kerala Blast,4249,5,5,3,6,12,16,-4,18
Chennaiyin,4249,6,4,5,5,17,20,-3,17
FC Goa,4249,7,5,2,7,11,16,-5,17
NorthEast Un,4249,8,4,3,7,11,15,-4,15
Mumbai City,4250,1,6,5,3,18,10,8,23
Kolkata,4250,2,5,7,2,20,16,4,22
Delhi Dynamo,4250,3,4,8,2,24,17,7,20
NorthEast Un,4250,4,5,4,5,13,11,2,19
FC Pune City,4250,5,4,5,5,14,16,-2,17
Kerala Blast,4250,6,4,4,6,12,19,-7,16
Chennaiyin,4250,7,3,6,5,14,19,-5,15
FC Goa,4250,8,4,3,7,10,17,-7,15
Mumbai City,4251,1,7,4,3,20,10,10,25
Kerala Blast,4251,2,7,3,4,17,14,3,24
Delhi Dynamo,4251,3,5,6,3,27,21,6,21
Kolkata,4251,4,5,6,3,19,15,4,21
Chennaiyin,4251,5,4,6,4,17,19,-2,18
FC Pune City,4251,6,4,3,7,13,19,-6,15
NorthEast Un,4251,7,4,3,7,12,18,-6,15
FC Goa,4251,8,3,3,8,10,19,-9,12
Mumbai City,4252,1,7,4,3,18,9,9,25
Delhi Dynamo,4252,2,6,5,3,27,18,9,23
Kolkata,4252,3,4,7,3,15,14,1,19
FC Pune City,4252,4,5,4,5,15,15,0,19
Kerala Blast,4252,5,5,3,6,11,17,-6,18
Chennaiyin,4252,6,3,7,4,15,19,-4,16
NorthEast Un,4252,7,4,3,7,14,16,-2,15
FC Goa,4252,8,4,3,7,9,16,-7,15
Delhi Dynamo,4253,1,6,5,3,25,16,9,23
Mumbai City,4253,2,6,4,4,16,10,6,22
Kolkata,4253,3,5,7,2,18,13,5,22
Kerala Blast,4253,4,5,5,4,14,16,-2,20
Chennaiyin,4253,5,4,6,4,16,19,-3,18
NorthEast Un,4253,6,4,3,7,12,14,-2,15
FC Pune City,4253,7,4,3,7,13,19,-6,15
FC Goa,4253,8,4,3,7,10,17,-7,15
Mumbai City,4254,1,7,4,3,19,8,11,25
Kerala Blast,4254,2,6,4,4,15,14,1,22
Delhi Dynamo,4254,3,5,6,3,24,17,7,21
NorthEast Un,4254,4,5,4,5,11,10,1,19
Kolkata,4254,5,4,6,4,16,14,2,18
FC Goa,4254,6,5,2,7,11,17,-6,17
FC Pune City,4254,7,4,3,7,13,22,-9,15
Chennaiyin,4254,8,3,5,6,14,21,-7,14
Delhi Dynamo,4255,1,6,6,2,29,19,10,24
Kolkata,4255,2,6,6,2,21,15,6,24
Mumbai City,4255,3,6,4,4,18,11,7,22
Kerala Blast,4255,4,5,4,5,12,17,-5,19
NorthEast Un,4255,5,5,3,6,16,15,1,18
FC Pune City,4255,6,4,4,6,12,16,-4,16
Chennaiyin,4255,7,3,5,6,17,24,-7,14
FC Goa,4255,8,4,2,8,14,22,-8,14
Mumbai City,4256,1,6,5,3,17,9,8,23
Delhi Dynamo,4256,2,5,6,3,24,16,8,21
Kerala Blast,4256,3,6,3,5,13,16,-3,21
Kolkata,4256,4,4,7,3,16,16,0,19
FC Pune City,4256,5,5,3,6,17,17,0,18
Chennaiyin,4256,6,4,6,4,17,19,-2,18
NorthEast Un,4256,7,4,3,7,11,15,-4,15
FC Goa,4256,8,4,3,7,9,16,-7,15
Mumbai City,4257,1,7,4,3,18,9,9,25
FC Pune City,4257,2,6,3,5,17,16,1,21
Kerala Blast,4257,3,6,3,5,13,15,-2,21
Delhi Dynamo,4257,4,5,5,4,24,17,7,20
Chennaiyin,4257,5,5,5,4,18,17,1,20
Kolkata,4257,6,3,7,4,15,18,-3,16
FC Goa,4257,7,4,3,7,10,18,-8,15
NorthEast Un,4257,8,4,2,8,9,14,-5,14
Mumbai City,4258,1,7,4,3,21,8,13,25
Delhi Dynamo,4258,2,5,6,3,27,24,3,21
Kerala Blast,4258,3,6,3,5,12,15,-3,21
NorthEast Un,4258,4,5,3,6,14,14,0,18
FC Goa,4258,5,5,3,6,15,18,-3,18
Kolkata,4258,6,3,7,4,16,17,-1,16
FC Pune City,4258,7,4,4,6,13,16,-3,16
Chennaiyin,4258,8,3,6,5,13,19,-6,15
Mumbai City,4259,1,7,4,3,19,10,9,25
Delhi Dynamo,4259,2,5,6,3,25,18,7,21
NorthEast Un,4259,3,6,3,5,13,10,3,21
Kerala Blast,4259,4,5,4,5,13,17,-4,19
FC Pune City,4259,5,5,3,6,15,17,-2,18
Kolkata,4259,6,3,7,4,18,20,-2,16
FC Goa,4259,7,4,3,7,13,18,-5,15
Chennaiyin,4259,8,3,6,5,14,20,-6,15
Mumbai City,4260,1,7,4,3,19,8,11,25
NorthEast Un,4260,2,6,3,5,20,14,6,21
FC Pune City,4260,3,6,3,5,14,14,0,21
Delhi Dynamo,4260,4,5,5,4,25,22,3,20
Kerala Blast,4260,5,5,4,5,12,16,-4,19
Chennaiyin,4260,6,4,5,5,17,22,-5,17
Kolkata,4260,7,3,6,5,16,19,-3,15
FC Goa,4260,8,4,2,8,12,20,-8,14
Mumbai City,4261,1,7,4,3,17,8,9,25
Delhi Dynamo,4261,2,5,6,3,25,17,8,21
Kolkata,4261,3,4,7,3,16,14,2,19
NorthEast Un,4261,4,5,4,5,12,11,1,19
Chennaiyin,4261,5,4,6,4,15,17,-2,18
FC Pune City,4261,6,4,5,5,12,14,-2,17
Kerala Blast,4261,7,4,4,6,9,17,-8,16
FC Goa,4261,8,4,2,8,10,18,-8,14
Delhi Dynamo,4262,1,7,5,2,29,16,13,26
Mumbai City,4262,2,6,4,4,18,11,7,22
Kolkata,4262,3,4,7,3,18,16,2,19
Kerala Blast,4262,4,5,4,5,17,20,-3,19
Chennaiyin,4262,5,4,6,4,16,18,-2,18
NorthEast Un,4262,6,5,2,7,11,15,-4,17
FC Pune City,4262,7,4,3,7,14,20,-6,15
FC Goa,4262,8,4,3,7,10,17,-7,15
Mumbai City,4263,1,7,4,3,17,8,9,25
Kerala Blast,4263,2,6,4,4,14,16,-2,22
Delhi Dynamo,4263,3,5,5,4,22,16,6,20
FC Pune City,4263,4,5,3,6,16,18,-2,18
NorthEast Un,4263,5,5,2,7,11,12,-1,17
Chennaiyin,4263,6,4,5,5,15,19,-4,17
FC Goa,4263,7,5,2,7,10,15,-5,17
Kolkata,4263,8,3,7,4,15,16,-1,16
Mumbai City,4264,1,7,4,3,17,8,9,25
Delhi Dynamo,4264,2,5,6,3,26,17,9,21
Kolkata,4264,3,4,8,2,17,14,3,20
FC Pune City,4264,4,5,4,5,15,16,-1,19
NorthEast Un,4264,5,5,3,6,14,12,2,18
Chennaiyin,4264,6,4,5,5,14,18,-4,17
FC Goa,4264,7,4,3,7,10,18,-8,15
Kerala Blast,4264,8,4,3,7,10,20,-10,15
Mumbai City,4265,1,6,5,3,17,9,8,23
Delhi Dynamo,4265,2,4,8,2,24,17,7,20
Kerala Blast,4265,3,5,5,4,13,15,-2,20
FC Pune City,4265,4,5,4,5,16,15,1,19
NorthEast Un,4265,5,5,3,6,13,14,-1,18
Kolkata,4265,6,3,8,3,15,17,-2,17
FC Goa,4265,7,4,4,6,14,19,-5,16
Chennaiyin,4265,8,3,5,6,18,24,-6,14
Mumbai City,4266,1,7,4,3,18,8,10,25
FC Pune City,4266,2,6,3,5,16,15,1,21
Delhi Dynamo,4266,3,4,7,3,23,18,5,19
Kolkata,4266,4,4,7,3,17,17,0,19
NorthEast Un,4266,5,5,3,6,11,12,-1,18
Kerala Blast,4266,6,5,3,6,13,17,-4,18
Chennaiyin,4266,7,4,5,5,14,18,-4,17
FC Goa,4266,8,3,4,7,11,18,-7,13
Mumbai City,4267,1,7,4,3,20,10,10,25
Kolkata,4267,2,5,6,3,16,15,1,21
Delhi Dynamo,4267,3,5,5,4,25,20,5,20
Chennaiyin,4267,4,5,5,4,16,17,-1,20
NorthEast Un,4267,5,5,2,7,11,13,-2,17
FC Goa,4267,6,5,2,7,11,15,-4,17
FC Pune City,4267,7,4,4,6,13,16,-3,16
Kerala Blast,4267,8,4,4,6,9,15,-6,16
Mumbai City,4268,1,7,4,3,18,8,10,25
Kerala Blast,4268,2,6,3,5,11,15,-4,21
Delhi Dynamo,4268,3,4,7,3,24,19,5,19
Kolkata,4268,4,4,7,3,14,13,1,19
FC Pune City,4268,5,5,4,5,14,14,0,19
NorthEast Un,4268,6,5,3,6,13,12,1,18
Chennaiyin,4268,7,3,6,5,16,22,-6,15
FC Goa,4268,8,3,4,7,12,19,-7,13
Mumbai City,4269,1,7,4,3,18,8,10,25
Delhi Dynamo,4269,2,5,6,3,24,18,6,21
Kerala Blast,4269,3,6,3,5,12,15,-3,21
Kolkata,4269,4,4,7,3,16,15,1,19
FC Goa,4269,5,5,3,6,13,16,-3,18
NorthEast Un,4269,6,5,2,7,10,11,-1,17
FC Pune City,4269,7,4,4,6,15,18,-3,16
Chennaiyin,4269,8,3,5,6,13,20,-7,14
Mumbai City,4270,1,6,5,3,16,8,8,23
Delhi Dynamo,4270,2,5,6,3,24,17,7,21
Kerala Blast,4270,3,6,3,5,14,18,-4,21
Kolkata,4270,4,4,8,2,17,14,3,20
Chennaiyin,4270,5,5,5,4,16,17,-1,20
NorthEast Un,4270,6,5,2,7,11,13,-2,17
FC Pune City,4270,7,4,4,6,14,17,-3,16
FC Goa,4270,8,3,3,8,10,18,-8,12
Delhi Dynamo,4271,1,7,5,2,26,14,12,26
Mumbai City,4271,2,6,4,4,16,11,5,22
Kerala Blast,4271,3,6,4,4,13,15,-2,22
Kolkata,4271,4,4,7,3,15,14,1,19
Chennaiyin,4271,5,4,6,4,14,17,-3,18
NorthEast Un,4271,6,4,3,7,9,11,-2,15
FC Pune City,4271,7,4,3,7,14,18,-4,15
FC Goa,4271,8,3,4,7,9,16,-7,13
Mumbai City,4272,1,7,4,3,18,8,10,25
NorthEast Un,4272,2,6,2,6,15,11,4,20
Chennaiyin,4272,3,5,5,4,16,18,-2,20
Kerala Blast,4272,4,5,4,5,11,15,-4,19
Delhi Dynamo,4272,5,4,6,4,22,20,2,18
Kolkata,4272,6,3,9,2,13,12,1,18
FC Pune City,4272,7,4,4,6,12,16,-4,16
FC Goa,4272,8,3,4,7,9,16,-7,13
Delhi Dynamo,4273,1,6,6,2,28,17,11,24
Mumbai City,4273,2,6,4,4,17,10,7,22
FC Pune City,4273,3,6,3,5,14,14,0,21
Chennaiyin,4273,4,5,5,4,19,17,2,20
Kolkata,4273,5,4,7,3,15,14,1,19
NorthEast Un,4273,6,5,3,6,12,15,-3,18
Kerala Blast,4273,7,4,4,6,11,17,-6,16
FC Goa,4273,8,3,2,9,9,21,-12,11
Delhi Dynamo,4274,1,7,5,2,26,14,12,26
Mumbai City,4274,2,6,4,4,16,9,7,22
FC Pune City,4274,3,6,3,5,18,17,1,21
Kerala Blast,4274,4,5,3,6,16,22,-6,18
NorthEast Un,4274,5,5,2,7,14,15,-1,17
Chennaiyin,4274,6,4,5,5,17,21,-4,17
FC Goa,4274,7,5,2,7,12,17,-5,17
Kolkata,4274,8,3,6,5,14,18,-4,15
Mumbai City,4275,1,6,5,3,16,8,8,23
Delhi Dynamo,4275,2,5,7,2,25,17,8,22
Kolkata,4275,3,4,7,3,15,15,0,19
Kerala Blast,4275,4,5,4,5,15,17,-2,19
FC Pune City,4275,5,5,3,6,14,15,-1,18
NorthEast Un,4275,6,5,3,6,16,19,-3,18
FC Goa,4275,7,5,2,7,11,15,-4,17
Chennaiyin,4275,8,3,5,6,15,21,-6,14
Delhi Dynamo,4276,1,6,6,2,27,17,10,24
Mumbai City,4276,2,6,4,4,16,9,7,22
FC Pune City,4276,3,6,3,5,15,15,0,21
Kolkata,4276,4,4,7,3,17,16,1,19
Kerala Blast,4276,5,5,4,5,13,17,-4,19
NorthEast Un,4276,6,4,4,6,11,12,-1,16
Chennaiyin,4276,7,3,7,4,14,18,-4,16
FC Goa,4276,8,3,3,8,11,20,-9,12
Mumbai City,4277,1,7,4,3,18,8,10,25
Kolkata,4277,2,5,6,3,19,14,5,21
Chennaiyin,4277,3,5,5,4,16,17,-1,20
Kerala Blast,4277,4,5,4,5,12,18,-6,19
NorthEast Un,4277,5,5,3,6,12,12,0,18
Delhi Dynamo,4277,6,4,5,5,23,20,3,17
FC Goa,4277,7,5,2,7,12,18,-6,17
FC Pune City,4277,8,4,3,7,12,17,-5,15
Mumbai City,4278,1,7,4,3,19,9,10,25
Kolkata,4278,2,5,7,2,17,14,3,22
Kerala Blast,4278,3,6,4,4,14,16,-2,22
Delhi Dynamo,4278,4,5,6,3,27,20,7,21
Chennaiyin,4278,5,4,5,5,16,20,-4,17
NorthEast Un,4278,6,4,3,7,12,15,-3,15
FC Pune City,4278,7,4,3,7,12,16,-4,15
FC Goa,4278,8,4,2,8,12,19,-7,14
Mumbai City,4279,1,6,4,4,16,9,7,22
Delhi Dynamo,4279,2,5,6,3,25,18,7,21
Kerala Blast,4279,3,5,5,4,13,16,-3,20
Kolkata,4279,4,4,6,4,15,15,0,18
NorthEast Un,4279,5,5,3,6,14,14,0,18
Chennaiyin,4279,6,4,6,4,16,19,-3,18
FC Pune City,4279,7,4,4,6,13,16,-3,16
FC Goa,4279,8,4,4,6,11,16,-5,16
Mumbai City,4280,1,7,4,3,19,10,9,25
Kerala Blast,4280,2,7,3,4,14,14,0,24
Kolkata,4280,3,5,6,3,19,17,2,21
Delhi Dynamo,4280,4,4,7,3,25,19,6,19
Chennaiyin,4280,5,4,6,4,17,20,-3,18
NorthEast Un,4280,6,4,4,6,12,14,-2,16
FC Pune City,4280,7,4,3,7,14,18,-4,15
FC Goa,4280,8,3,3,8,13,21,-8,12
Delhi Dynamo,4281,1,5,7,2,24,15,9,22
Mumbai City,4281,2,6,4,4,16,10,6,22
Kerala Blast,4281,3,6,4,4,15,15,0,22
Kolkata,4281,4,4,7,3,17,14,3,19
NorthEast Un,4281,5,5,3,6,13,15,-2,18
FC Goa,4281,6,5,3,6,11,15,-4,18
FC Pune City,4281,7,4,3,7,12,18,-6,15
Chennaiyin,4281,8,3,5,6,15,21,-6,14
Delhi Dynamo,4282,1,6,6,2,24,15,9,24
Mumbai City,4282,2,6,4,4,16,9,7,22
Kolkata,4282,3,5,7,2,18,15,3,22
FC Pune City,4282,4,5,4,5,15,15,0,19
Chennaiyin,4282,5,4,5,5,15,19,-4,17
Kerala Blast,4282,6,4,4,6,9,16,-7,16
NorthEast Un,4282,7,4,3,7,10,12,-2,15
FC Goa,4282,8,4,3,7,12,18,-6,15
Mumbai City,4283,1,6,5,3,17,9,8,23
NorthEast Un,4283,2,7,2,5,14,10,4,23
Kolkata,4283,3,5,7,2,19,14,5,22
Delhi Dynamo,4283,4,4,7,3,25,19,6,19
Kerala Blast,4283,5,5,4,5,13,15,-2,19
Chennaiyin,4283,6,4,5,5,15,20,-5,17
FC Pune City,4283,7,4,3,7,13,19,-6,15
FC Goa,4283,8,3,3,8,11,21,-10,12
Mumbai City,4284,1,7,4,3,17,8,9,25
Kerala Blast,4284,2,5,5,4,12,15,-3,20
Delhi Dynamo,4284,3,4,7,3,23,17,6,19
Kolkata,4284,4,3,8,3,16,16,0,17
FC Pune City,4284,5,4,5,5,14,16,-2,17
Chennaiyin,4284,6,4,5,5,16,20,-4,17
NorthEast Un,4284,7,4,4,6,12,13,-1,16
FC Goa,4284,8,4,4,6,11,16,-5,16
Delhi Dynamo,4285,1,5,7,2,28,18,10,22
Mumbai City,4285,2,6,4,4,17,12,5,22
Kerala Blast,4285,3,6,4,4,14,16,-2,22
Kolkata,4285,4,4,8,2,17,15,2,20
NorthEast Un,4285,5,4,4,6,10,11,-1,16
Chennaiyin,4285,6,3,7,4,15,19,-4,16
FC Pune City,4285,7,4,3,7,14,18,-4,15
FC Goa,4285,8,3,5,6,14,20,-6,14
Mumbai City,4286,1,7,4,3,19,10,9,25
NorthEast Un,4286,2,5,4,5,13,10,3,19
Kolkata,4286,3,4,7,3,16,14,2,19
Delhi Dynamo,4286,4,4,6,4,24,19,5,18
FC Pune City,4286,5,4,5,5,13,15,-2,17
Chennaiyin,4286,6,4,5,5,15,20,-5,17
FC Goa,4286,7,5,2,7,12,18,-6,17
Kerala Blast,4286,8,4,5,5,11,17,-6,17
Mumbai City,4287,1,7,4,3,18,8,10,25
Kolkata,4287,2,6,6,2,17,12,5,24
Delhi Dynamo,4287,3,5,5,4,24,18,6,20
NorthEast Un,4287,4,6,2,6,14,13,1,20
Chennaiyin,4287,5,5,5,4,17,18,-1,20
FC Pune City,4287,6,5,3,6,14,16,-2,18
Kerala Blast,4287,7,4,3,7,10,18,-8,15
FC Goa,4287,8,3,2,9,8,19,-11,11
Mumbai City,4288,1,7,4,3,17,8,9,25
NorthEast Un,4288,2,6,2,6,14,11,3,20
FC Pune City,4288,3,5,4,5,13,14,-1,19
Delhi Dynamo,4288,4,4,6,4,22,18,4,18
Kolkata,4288,5,3,9,2,13,12,1,18
Chennaiyin,4288,6,4,5,5,16,21,-5,17
FC Goa,4288,7,4,4,6,12,16,-4,16
Kerala Blast,4288,8,4,4,6,9,16,-7,16
Mumbai City,4289,1,7,4,3,18,8,10,25
Kerala Blast,4289,2,7,3,4,18,16,2,24
Delhi Dynamo,4289,3,5,5,4,25,18,7,20
Kolkata,4289,4,4,6,4,15,17,-2,18
Chennaiyin,4289,5,4,5,5,15,19,-4,17
NorthEast Un,4289,6,5,2,7,12,16,-4,17
FC Goa,4289,7,5,2,7,12,17,-5,17
FC Pune City,4289,8,4,3,7,15,19,-4,15
Delhi Dynamo,4290,1,6,6,2,27,15,12,24
Kolkata,4290,2,6,6,2,16,12,4,24
Mumbai City,4290,3,6,4,4,16,9,7,22
Chennaiyin,4290,4,5,5,4,16,17,-1,20
NorthEast Un,4290,5,5,3,6,11,12,-1,18
Kerala Blast,4290,6,5,3,6,11,16,-5,18
FC Pune City,4290,7,4,3,7,13,17,-4,15
FC Goa,4290,8,3,2,9,8,20,-12,11
Mumbai City,4291,1,7,4,3,19,9,10,25
Kolkata,4291,2,5,6,3,17,17,0,21
Delhi Dynamo,4291,3,5,5,4,25,20,5,20
Kerala Blast,4291,4,5,4,5,13,16,-3,19
NorthEast Un,4291,5,5,3,6,13,13,0,18
FC Pune City,4291,6,5,3,6,15,16,-1,18
Chennaiyin,4291,7,4,5,5,15,19,-4,17
FC Goa,4291,8,4,2,8,11,18,-7,14
Mumbai City,4292,1,7,4,3,20,10,10,25
Kerala Blast,4292,2,6,3,5,15,16,-1,21
FC Pune City,4292,3,5,4,5,15,16,-1,19
Delhi Dynamo,4292,4,4,6,4,25,22,3,18
Chennaiyin,4292,5,4,6,4,16,19,-3,18
FC Goa,4292,6,5,2,7,13,17,-4,17
NorthEast Un,4292,7,4,4,6,11,12,-1,16
Kolkata,4292,8,3,7,4,13,16,-3,16
Mumbai City,4293,1,7,4,3,18,9,9,25
Kolkata,4293,2,6,6,2,19,14,5,24
Kerala Blast,4293,3,6,3,5,13,15,-2,21
Delhi Dynamo,4293,4,5,5,4,26,19,7,20
NorthEast Un,4293,5,6,2,6,13,11,2,20
Chennaiyin,4293,6,4,5,5,16,20,-4,17
FC Pune City,4293,7,4,3,7,14,20,-6,15
FC Goa,4293,8,3,2,9,10,21,-11,11
Mumbai City,4294,1,7,4,3,19,9,10,25
Delhi Dynamo,4294,2,5,6,3,24,18,6,21
Kerala Blast,4294,3,5,4,5,12,16,-4,19
Kolkata,4294,4,4,6,4,16,18,-2,18
FC Pune City,4294,5,5,3,6,13,15,-2,18
NorthEast Un,4294,6,4,5,5,11,11,0,17
Chennaiyin,4294,7,3,7,4,17,21,-4,16
FC Goa,4294,8,4,3,7,14,18,-4,15
Mumbai City,4295,1,7,4,3,18,9,9,25
Kolkata,4295,2,6,6,2,20,12,8,24
Delhi Dynamo,4295,3,6,5,3,27,19,8,23
Kerala Blast,4295,4,6,3,5,13,18,-5,21
Chennaiyin,4295,5,4,6,4,15,18,-3,18
FC Pune City,4295,6,4,3,7,13,17,-4,15
NorthEast Un,4295,7,4,2,8,11,14,-3,14
FC Goa,4295,8,3,3,8,11,21,-10,12
Mumbai City,4296,1,7,4,3,18,8,10,25
Delhi Dynamo,4296,2,6,5,3,26,17,9,23
Kolkata,4296,3,5,6,3,20,16,4,21
FC Pune City,4296,4,5,4,5,15,16,-1,19
Kerala Blast,4296,5,5,4,5,13,17,-4,19
Chennaiyin,4296,6,4,6,4,17,18,-1,18
NorthEast Un,4296,7,4,2,8,10,15,-5,14
FC Goa,4296,8,3,3,8,9,21,-12,12
Mumbai City,4297,1,7,4,3,18,9,9,25
Delhi Dynamo,4297,2,4,7,3,25,19,6,19
Kolkata,4297,3,4,7,3,17,15,2,19
Kerala Blast,4297,4,5,4,5,13,16,-3,19
NorthEast Un,4297,5,5,3,6,12,14,-2,18
FC Pune City,4297,6,4,5,5,13,15,-2,17
FC Goa,4297,7,4,4,6,13,18,-5,16
Chennaiyin,4297,8,3,6,5,14,19,-5,15
Delhi Dynamo,4298,1,7,5,2,26,14,12,26
Mumbai City,4298,2,6,4,4,16,9,7,22
Kolkata,4298,3,5,7,2,16,13,3,22
NorthEast Un,4298,4,6,2,6,13,14,-1,20
FC Pune City,4298,5,5,3,6,15,16,-1,18
Chennaiyin,4298,6,3,6,5,14,19,-5,15
Kerala Blast,4298,7,4,3,7,12,20,-8,15
FC Goa,4298,8,3,4,7,10,17,-7,13
Mumbai City,4299,1,6,4,4,17,10,7,22
Kolkata,4299,2,5,7,2,20,14,6,22
Delhi Dynamo,4299,3,5,5,4,25,20,5,20
NorthEast Un,4299,4,5,4,5,13,11,2,19
FC Goa,4299,5,5,3,6,13,15,-2,18
FC Pune City,4299,6,5,3,6,14,17,-3,18
Kerala Blast,4299,7,4,4,6,11,19,-8,16
Chennaiyin,4299,8,3,6,5,13,20,-7,15
Mumbai City,4300,1,7,4,3,19,10,9,25
Kolkata,4300,2,5,6,3,18,18,0,21
Delhi Dynamo,4300,3,4,7,3,24,18,6,19
Kerala Blast,4300,4,5,4,5,10,15,-5,19
FC Goa,4300,5,5,3,6,15,16,-1,18
Chennaiyin,4300,6,4,5,5,17,19,-2,17
NorthEast Un,4300,7,4,4,6,9,12,-3,16
FC Pune City,4300,8,4,3,7,14,18,-4,15
Mumbai City,4301,1,7,4,3,17,8,9,25
Kerala Blast,4301,2,6,4,4,14,15,-1,22
Delhi Dynamo,4301,3,5,5,4,25,17,8,20
NorthEast Un,4301,4,6,2,6,14,14,0,20
Kolkata,4301,5,3,8,3,14,15,-1,17
FC Goa,4301,6,5,2,7,16,18,-2,17
FC Pune City,4301,7,4,4,6,14,17,-3,16
Chennaiyin,4301,8,3,5,6,15,25,-10,14
Mumbai City,4302,1,6,5,3,16,8,8,23
Delhi Dynamo,4302,2,5,6,3,23,16,7,21
Kerala Blast,4302,3,5,5,4,13,15,-2,20
NorthEast Un,4302,4,5,3,6,14,12,2,18
Kolkata,4302,5,4,6,4,15,15,0,18
FC Goa,4302,6,5,3,6,11,15,-4,18
FC Pune City,4302,7,4,4,6,13,17,-4,16
Chennaiyin,4302,8,3,6,5,14,21,-7,15
Mumbai City,4303,1,7,4,3,20,8,12,25
Kolkata,4303,2,6,6,2,18,12,6,24
Kerala Blast,4303,3,5,4,5,13,18,-5,19
Chennaiyin,4303,4,4,6,4,15,18,-3,18
Delhi Dynamo,4303,5,4,5,5,22,22,0,17
NorthEast Un,4303,6,5,2,7,13,14,-1,17
FC Pune City,4303,7,4,4,6,13,16,-3,16
FC Goa,4303,8,4,3,7,11,17,-6,15
Mumbai City,4304,1,6,5,3,17,9,8,23
Kerala Blast,4304,2,6,4,4,15,15,0,22
Kolkata,4304,3,4,8,2,17,15,2,20
NorthEast Un,4304,4,6,2,6,14,12,2,20
Delhi Dynamo,4304,5,4,6,4,24,19,5,18
FC Pune City,4304,6,4,4,6,13,18,-5,16
Chennaiyin,4304,7,3,6,5,15,21,-6,15
FC Goa,4304,8,4,3,7,13,19,-6,15
Mumbai City,4305,1,6,5,3,18,10,8,23
Delhi Dynamo,4305,2,5,7,2,27,16,11,22
Kolkata,4305,3,5,6,3,18,15,3,21
NorthEast Un,4305,4,6,3,5,15,12,3,21
FC Pune City,4305,5,5,3,6,16,17,-1,18
Kerala Blast,4305,6,5,3,6,12,18,-6,18
Chennaiyin,4305,7,4,5,5,18,23,-5,17
FC Goa,4305,8,3,2,9,11,24,-13,11
Mumbai City,4306,1,7,4,3,19,8,11,25
Kolkata,4306,2,5,7,2,19,15,4,22
Delhi Dynamo,4306,3,5,5,4,25,19,6,20
NorthEast Un,4306,4,6,2,6,15,14,1,20
Chennaiyin,4306,5,4,6,4,18,20,-2,18
Kerala Blast,4306,6,5,3,6,12,18,-6,18
FC Pune City,4306,7,4,3,7,13,18,-5,15
FC Goa,4306,8,3,4,7,11,20,-9,13
Mumbai City,4307,1,6,5,3,17,9,8,23
Delhi Dynamo,4307,2,5,7,2,26,18,8,22
FC Pune City,4307,3,5,4,5,20,18,2,19
Kolkata,4307,4,3,8,3,20,20,0,17
Kerala Blast,4307,5,4,5,5,13,21,-8,17
NorthEast Un,4307,6,4,4,6,11,12,-1,16
Chennaiyin,4307,7,3,7,4,15,19,-4,16
FC Goa,4307,8,4,4,6,15,20,-5,16
Mumbai City,4308,1,7,4,3,17,8,9,25
Delhi Dynamo,4308,2,6,5,3,25,16,9,23
FC Pune City,4308,3,6,3,5,16,15,1,21
NorthEast Un,4308,4,6,2,6,14,13,1,20
Kolkata,4308,5,4,6,4,17,17,0,18
FC Goa,4308,6,5,2,7,14,17,-3,17
Kerala Blast,4308,7,4,3,7,12,20,-8,15
Chennaiyin,4308,8,3,5,6,13,22,-9,14
Mumbai City,4309,1,7,4,3,18,9,9,25
Kerala Blast,4309,2,6,4,4,15,16,-1,22
Delhi Dynamo,4309,3,5,5,4,25,18,7,20
Kolkata,4309,4,4,7,3,18,17,1,19
NorthEast Un,4309,5,5,3,6,12,12,0,18
Chennaiyin,4309,6,4,6,4,16,19,-3,18
FC Pune City,4309,7,4,5,5,15,17,-2,17
FC Goa,4309,8,3,2,9,10,21,-11,11
Mumbai City,4310,1,6,5,3,17,9,8,23
Delhi Dynamo,4310,2,5,7,2,24,16,8,22
Kolkata,4310,3,5,6,3,17,15,2,21
Kerala Blast,4310,4,6,3,5,13,15,-2,21
Chennaiyin,4310,5,4,6,4,15,18,-3,18
NorthEast Un,4310,6,4,3,7,10,12,-2,15
FC Pune City,4310,7,4,3,7,13,18,-5,15
FC Goa,4310,8,4,3,7,12,18,-6,15
Mumbai City,4311,1,7,4,3,18,8,10,25
Kolkata,4311,2,6,6,2,20,12,8,24
NorthEast Un,4311,3,6,3,5,12,9,3,21
Delhi Dynamo,4311,4,5,5,4,23,18,5,20
Kerala Blast,4311,5,4,4,6,10,16,-6,16
FC Pune City,4311,6,4,4,6,13,20,-7,16
Chennaiyin,4311,7,3,6,5,13,18,-5,15
FC Goa,4311,8,4,2,8,9,17,-8,14
Mumbai City,4312,1,7,4,3,18,8,10,25
Delhi Dynamo,4312,2,5,6,3,24,17,7,21
Kolkata,4312,3,4,7,3,18,14,4,19
Kerala Blast,4312,4,5,4,5,12,16,-4,19
NorthEast Un,4312,5,5,3,6,12,13,-1,18
Chennaiyin,4312,6,4,5,5,16,22,-6,17
FC Pune City,4312,7,4,4,6,14,20,-6,16
FC Goa,4312,8,4,3,7,13,17,-4,15
Kerala Blast,4313,1,7,3,4,12,13,-1,24
Delhi Dynamo,4313,2,6,5,3,26,18,8,23
Mumbai City,4313,3,6,4,4,17,11,6,22
NorthEast Un,4313,4,5,3,6,12,10,2,18
Kolkata,4313,5,4,6,4,15,15,0,18
FC Pune City,4313,6,5,3,6,14,16,-2,18
Chennaiyin,4313,7,4,6,4,16,19,-3,18
FC Goa,4313,8,3,2,9,10,20,-10,11
Delhi Dynamo,4314,1,6,6,2,25,14,11,24
Mumbai City,4314,2,6,5,3,16,8,8,23
Kolkata,4314,3,4,7,3,17,15,2,19
FC Pune City,4314,4,5,4,5,16,16,0,19
NorthEast Un,4314,5,5,3,6,11,12,-1,18
Kerala Blast,4314,6,4,4,6,12,20,-8,16
Chennaiyin,4314,7,3,6,5,13,19,-6,15
FC Goa,4314,8,4,3,7,11,17,-6,15
Mumbai City,4315,1,7,4,3,20,9,11,25
Kolkata,4315,2,4,8,2,18,16,2,20
NorthEast Un,4315,3,6,2,6,12,11,1,20
Chennaiyin,4315,4,5,5,4,17,18,-1,20
FC Pune City,4315,5,5,4,5,16,16,0,19
Delhi Dynamo,4315,6,4,6,4,23,20,3,18
Kerala Blast,4315,7,4,4,6,11,18,-7,16
FC Goa,4315,8,3,3,8,9,18,-9,12
Mumbai City,4316,1,7,4,3,18,8,10,25
Delhi Dynamo,4316,2,5,5,4,23,18,5,20
NorthEast Un,4316,3,6,2,6,15,13,2,20
Kerala Blast,4316,4,5,4,5,15,18,-3,19
Kolkata,4316,5,3,8,3,15,17,-2,17
FC Goa,4316,6,5,2,7,13,16,-3,17
Chennaiyin,4316,7,4,5,5,16,20,-4,17
FC Pune City,4316,8,4,4,6,12,17,-5,16
Delhi Dynamo,4317,1,6,6,2,26,15,11,24
Mumbai City,4317,2,6,5,3,16,8,8,23
FC Pune City,4317,3,6,3,5,16,15,1,21
Kolkata,4317,4,4,6,4,18,16,2,18
Kerala Blast,4317,5,5,3,6,12,22,-10,18
Chennaiyin,4317,6,4,5,5,14,18,-4,17
FC Goa,4317,7,5,2,7,12,16,-4,17
NorthEast Un,4317,8,4,2,8,11,15,-4,14
Mumbai City,4318,1,7,4,3,18,9,9,25
Kolkata,4318,2,5,7,2,19,12,7,22
Delhi Dynamo,4318,3,5,6,3,23,16,7,21
Kerala Blast,4318,4,5,4,5,12,19,-7,19
Chennaiyin,4318,5,4,6,4,16,19,-3,18
FC Pune City,4318,6,4,4,6,13,17,-4,16
NorthEast Un,4318,7,4,3,7,11,13,-2,15
FC Goa,4318,8,3,4,7,9,16,-7,13
Delhi Dynamo,4319,1,5,7,2,22,14,8,22
Mumbai City,4319,2,6,4,4,16,9,7,22
NorthEast Un,4319,3,6,3,5,15,9,6,21
Kerala Blast,4319,4,5,4,5,14,21,-7,19
Kolkata,4319,5,3,9,2,16,15,1,18
FC Pune City,4319,6,4,4,6,15,18,-3,16
FC Goa,4319,7,4,4,6,10,15,-5,16
Chennaiyin,4319,8,3,5,6,14,21,-7,14
Mumbai City,4320,1,7,4,3,17,8,9,25
Kolkata,4320,2,5,7,2,15,12,3,22
NorthEast Un,4320,3,5,3,6,10,10,0,18
Delhi Dynamo,4320,4,4,5,5,22,19,3,17
FC Pune City,4320,5,4,5,5,13,15,-2,17
Chennaiyin,4320,6,4,5,5,14,18,-4,17
FC Goa,4320,7,5,2,7,12,16,-4,17
Kerala Blast,4320,8,4,5,5,10,15,-5,17
Mumbai City,4321,1,7,4,3,18,9,9,25
Kolkata,4321,2,5,6,3,19,16,3,21
Kerala Blast,4321,3,6,3,5,15,18,-3,21
NorthEast Un,4321,4,6,2,6,17,12,5,20
FC Goa,4321,5,6,2,6,12,15,-3,20
Delhi Dynamo,4321,6,4,5,5,22,23,-1,17
FC Pune City,4321,7,4,3,7,16,20,-4,15
Chennaiyin,4321,8,3,5,6,15,21,-6,14
Delhi Dynamo,4322,1,6,6,2,27,15,12,24
Mumbai City,4322,2,6,5,3,17,9,8,23
Kerala Blast,4322,3,6,4,4,16,16,0,22
FC Pune City,4322,4,5,4,5,15,16,-1,19
Chennaiyin,4322,5,4,6,4,16,19,-3,18
Kolkata,4322,6,3,6,5,15,18,-3,15
FC Goa,4322,7,4,3,7,10,18,-8,15
NorthEast Un,4322,8,4,2,8,11,16,-5,14
Delhi Dynamo,4323,1,6,6,2,29,15,14,24
Kolkata,4323,2,6,6,2,18,14,4,24
Mumbai City,4323,3,6,5,3,16,8,8,23
FC Pune City,4323,4,5,3,6,17,18,-1,18
Chennaiyin,4323,5,4,6,4,16,19,-3,18
Kerala Blast,4323,6,5,3,6,13,19,-6,18
NorthEast Un,4323,7,4,2,8,11,15,-4,14
FC Goa,4323,8,3,3,8,9,21,-12,12
Delhi Dynamo,4324,1,6,6,2,27,17,10,24
Mumbai City,4324,2,6,5,3,18,10,8,23
Kolkata,4324,3,5,6,3,18,15,3,21
FC Pune City,4324,4,5,4,5,15,16,-1,19
NorthEast Un,4324,5,5,3,6,11,11,0,18
Kerala Blast,4324,6,4,5,5,12,17,-5,17
Chennaiyin,4324,7,3,6,5,13,18,-5,15
FC Goa,4324,8,3,3,8,11,21,-10,12
Delhi Dynamo,4325,1,7,5,2,29,16,13,26
Kolkata,4325,2,6,6,2,22,13,9,24
Mumbai City,4325,3,6,4,4,17,10,7,22
Chennaiyin,4325,4,4,5,5,15,20,-5,17
Kerala Blast,4325,5,4,5,5,13,21,-8,17
FC Pune City,4325,6,4,4,6,14,19,-5,16
NorthEast Un,4325,7,4,3,7,11,15,-4,15
FC Goa,4325,8,4,2,8,11,18,-7,14
Kolkata,4326,1,6,6,2,19,12,7,24
Delhi Dynamo,4326,2,6,5,3,29,18,11,23
Mumbai City,4326,3,6,4,4,17,10,7,22
NorthEast Un,4326,4,6,3,5,15,13,2,21
Chennaiyin,4326,5,4,6,4,16,19,-3,18
Kerala Blast,4326,6,5,3,6,13,19,-6,18
FC Pune City,4326,7,4,3,7,14,19,-5,15
FC Goa,4326,8,3,2,9,9,22,-13,11
Mumbai City,4327,1,7,4,3,19,8,11,25
Kolkata,4327,2,5,7,2,17,14,3,22
Kerala Blast,4327,3,6,3,5,13,15,-2,21
Delhi Dynamo,4327,4,4,7,3,23,19,4,19
Chennaiyin,4327,5,4,6,4,16,19,-3,18
NorthEast Un,4327,6,4,4,6,10,11,-1,16
FC Pune City,4327,7,4,4,6,14,18,-4,16
FC Goa,4327,8,3,3,8,12,20,-8,12
Delhi Dynamo,4328,1,6,6,2,26,14,12,24
Mumbai City,4328,2,6,5,3,16,8,8,23
Kolkata,4328,3,4,8,2,18,14,4,20
FC Pune City,4328,4,5,4,5,15,15,0,19
Chennaiyin,4328,5,4,5,5,14,20,-6,17
Kerala Blast,4328,6,4,5,5,11,17,-6,17
NorthEast Un,4328,7,4,3,7,10,12,-2,15
FC Goa,4328,8,4,2,8,11,21,-10,14
Delhi Dynamo,4329,1,6,6,2,24,14,10,24
Mumbai City,4329,2,6,5,3,16,8,8,23
Kolkata,4329,3,5,7,2,22,15,7,22
Kerala Blast,4329,4,5,4,5,10,14,-4,19
NorthEast Un,4329,5,5,2,7,11,12,-1,17
Chennaiyin,4329,6,4,5,5,17,19,-2,17
FC Pune City,4329,7,4,5,5,13,15,-2,17
FC Goa,4329,8,3,2,9,10,26,-16,11
Mumbai City,4330,1,7,4,3,17,8,9,25
NorthEast Un,4330,2,6,3,5,14,11,3,21
Delhi Dynamo,4330,3,5,5,4,24,17,7,20
Kerala Blast,4330,4,5,5,4,13,16,-3,20
FC Pune City,4330,5,5,3,6,16,17,-1,18
FC Goa,4330,6,5,2,7,12,16,-4,17
Kolkata,4330,7,3,7,4,15,18,-3,16
Chennaiyin,4330,8,3,5,6,13,21,-8,14
Mumbai City,4331,1,7,4,3,19,9,10,25
NorthEast Un,4331,2,7,2,5,15,9,6,23
Kolkata,4331,3,5,6,3,19,15,4,21
Delhi Dynamo,4331,4,5,5,4,24,20,4,20
FC Pune City,4331,5,5,3,6,13,16,-3,18
FC Goa,4331,6,5,2,7,10,16,-6,17
Kerala Blast,4331,7,4,3,7,11,19,-8,15
Chennaiyin,4331,8,3,5,6,13,20,-7,14
Kerala Blast,4332,1,7,3,4,13,14,-1,24
Mumbai City,4332,2,6,5,3,17,9,8,23
Delhi Dynamo,4332,3,4,7,3,24,18,6,19
Kolkata,4332,4,4,7,3,16,14,2,19
NorthEast Un,4332,5,5,2,7,12,14,-2,17
Chennaiyin,4332,6,4,5,5,16,22,-6,17
FC Goa,4332,7,4,4,6,14,16,-2,16
FC Pune City,4332,8,4,3,7,13,18,-5,15
Mumbai City,4333,1,7,4,3,17,8,9,25
Kerala Blast,4333,2,7,3,4,13,13,0,24
Delhi Dynamo,4333,3,5,5,4,24,17,7,20
Chennaiyin,4333,4,5,5,4,16,18,-2,20
FC Pune City,4333,5,5,3,6,14,15,-1,18
FC Goa,4333,6,5,2,7,14,16,-2,17
Kolkata,4333,7,3,6,5,13,19,-6,15
NorthEast Un,4333,8,4,2,8,10,15,-5,14
Delhi Dynamo,4334,1,6,5,3,27,18,9,23
NorthEast Un,4334,2,7,2,5,17,13,4,23
Mumbai City,4334,3,6,4,4,17,10,7,22
Kolkata,4334,4,4,7,3,15,15,0,19
Kerala Blast,4334,5,5,3,6,12,17,-5,18
FC Goa,4334,6,5,2,7,11,17,-6,17
FC Pune City,4334,7,4,4,6,12,15,-3,16
Chennaiyin,4334,8,3,5,6,15,21,-6,14
Mumbai City,4335,1,6,5,3,17,9,8,23
NorthEast Un,4335,2,6,3,5,15,10,5,21
Delhi Dynamo,4335,3,4,7,3,23,17,6,19
Kolkata,4335,4,4,7,3,16,15,1,19
Kerala Blast,4335,5,5,4,5,15,21,-6,19
FC Pune City,4335,6,4,4,6,16,19,-3,16
FC Goa,4335,7,4,4,6,14,19,-5,16
Chennaiyin,4335,8,3,6,5,15,21,-6,15
Mumbai City,4336,1,6,4,4,19,12,7,22
Delhi Dynamo,4336,2,5,6,3,26,20,6,21
Kolkata,4336,3,5,6,3,22,16,6,21
Kerala Blast,4336,4,6,3,5,13,19,-6,21
FC Goa,4336,5,5,3,6,11,15,-4,18
Chennaiyin,4336,6,4,5,5,17,19,-2,17
NorthEast Un,4336,7,5,2,7,13,15,-2,17
FC Pune City,4336,8,4,3,7,14,19,-5,15
Delhi Dynamo,4337,1,6,6,2,24,15,9,24
Kerala Blast,4337,2,7,3,4,12,13,-1,24
Mumbai City,4337,3,6,4,4,16,9,7,22
Chennaiyin,4337,4,4,6,4,16,19,-3,18
FC Goa,4337,5,4,4,6,14,17,-3,16
Kolkata,4337,5,3,7,4,14,17,-3,16
FC Pune City,4337,7,4,4,6,13,16,-3,16
NorthEast Un,4337,8,4,2,8,9,12,-3,14
Mumbai City,4338,1,6,5,3,17,9,8,23
Kolkata,4338,2,5,6,3,16,14,2,21
Kerala Blast,4338,3,6,3,5,12,15,-3,21
Delhi Dynamo,4338,4,4,7,3,25,19,6,19
Chennaiyin,4338,5,4,6,4,17,18,-1,18
FC Pune City,4338,6,5,3,6,14,16,-2,18
NorthEast Un,4338,7,4,3,7,11,15,-4,15
FC Goa,4338,8,4,3,7,12,18,-6,15
Mumbai City,4339,1,6,5,3,18,10,8,23
NorthEast Un,4339,2,7,2,5,15,11,4,23
Kolkata,4339,3,5,7,2,18,13,5,22
Delhi Dynamo,4339,4,4,6,4,26,21,5,18
FC Pune City,4339,5,4,4,6,12,15,-3,16
FC Goa,4339,6,4,4,6,12,17,-5,16
Kerala Blast,4339,7,4,4,6,9,18,-9,16
Chennaiyin,4339,8,3,6,5,14,19,-5,15
Mumbai City,4340,1,7,4,3,18,9,9,25
Kolkata,4340,2,5,7,2,18,15,3,22
Kerala Blast,4340,3,6,3,5,11,14,-3,21
Delhi Dynamo,4340,4,5,5,4,24,18,6,20
Chennaiyin,4340,5,4,6,4,14,17,-3,18
NorthEast Un,4340,6,5,2,7,10,11,-1,17
FC Pune City,4340,7,4,4,6,14,17,-3,16
FC Goa,4340,8,3,3,8,10,18,-8,12
Mumbai City,4341,1,7,4,3,19,9,10,25
Delhi Dynamo,4341,2,5,5,4,26,23,3,20
NorthEast Un,4341,3,6,2,6,17,14,3,20
Kolkata,4341,4,4,7,3,17,16,1,19
FC Pune City,4341,5,5,3,6,13,16,-3,18
Kerala Blast,4341,6,5,3,6,12,16,-4,18
Chennaiyin,4341,7,4,5,5,17,22,-5,17
FC Goa,4341,8,4,3,7,14,19,-5,15
Mumbai City,4342,1,7,4,3,19,8,11,25
Kolkata,4342,2,6,6,2,17,12,5,24
Delhi Dynamo,4342,3,5,5,4,24,20,4,20
NorthEast Un,4342,4,5,3,6,14,13,1,18
Chennaiyin,4342,5,4,6,4,16,18,-2,18
Kerala Blast,4342,6,5,3,6,10,16,-6,18
FC Pune City,4342,7,4,3,7,12,17,-5,15
FC Goa,4342,8,4,2,8,9,17,-8,14
Mumbai City,4343,1,7,4,3,20,9,11,25
Delhi Dynamo,4343,2,6,5,3,27,19,8,23
FC Pune City,4343,3,5,4,5,14,15,-1,19
Kolkata,4343,4,3,9,2,15,14,1,18
NorthEast Un,4343,5,5,2,7,13,15,-2,17
Chennaiyin,4343,6,4,5,5,17,20,-3,17
Kerala Blast,4343,7,4,4,6,10,16,-6,16
FC Goa,4343,8,4,3,7,11,19,-8,15
Mumbai City,4344,1,7,4,3,18,8,10,25
Kolkata,4344,2,5,6,3,18,16,2,21
NorthEast Un,4344,3,6,3,5,17,15,2,21
Delhi Dynamo,4344,4,5,5,4,23,18,5,20
Kerala Blast,4344,5,5,5,4,16,17,-1,20
FC Pune City,4344,6,4,4,6,14,18,-4,16
Chennaiyin,4344,7,3,5,6,15,21,-6,14
FC Goa,4344,8,4,2,8,9,17,-8,14
Mumbai City,4345,1,6,4,4,18,13,5,22
Delhi Dynamo,4345,2,5,6,3,27,18,9,21
Kerala Blast,4345,3,6,3,5,13,14,-1,21
NorthEast Un,4345,4,6,2,6,13,13,0,20
Kolkata,4345,5,4,7,3,16,16,0,19
FC Pune City,4345,6,5,3,6,14,15,-1,18
Chennaiyin,4345,7,4,5,5,15,20,-5,17
FC Goa,4345,8,3,4,7,11,18,-7,13
Delhi Dynamo,4346,1,6,5,3,29,22,7,23
Mumbai City,4346,2,6,4,4,17,11,6,22
Kolkata,4346,3,5,7,2,18,13,5,22
Kerala Blast,4346,4,6,3,5,17,19,-2,21
NorthEast Un,4346,5,5,3,6,16,14,2,18
Chennaiyin,4346,6,4,6,4,14,17,-3,18
FC Pune City,4346,7,4,4,6,14,19,-5,16
FC Goa,4346,8,3,2,9,11,21,-10,11
Mumbai City,4347,1,6,5,3,16,8,8,23
Delhi Dynamo,4347,2,5,7,2,25,16,9,22
Kolkata,4347,3,5,6,3,19,15,4,21
FC Goa,4347,4,5,3,6,12,15,-3,18
FC Pune City,4347,5,5,3,6,13,17,-4,18
NorthEast Un,4347,6,5,2,7,13,16,-3,17
Chennaiyin,4347,7,4,5,5,17,21,-4,17
Kerala Blast,4347,8,4,3,7,11,18,-7,15
Delhi Dynamo,4348,1,6,5,3,26,17,9,23
Mumbai City,4348,2,6,4,4,16,9,7,22
Kerala Blast,4348,3,6,3,5,13,14,-1,21
Kolkata,4348,4,4,7,3,15,13,2,19
FC Pune City,4348,5,5,4,5,13,14,-1,19
Chennaiyin,4348,6,3,7,4,15,19,-4,16
NorthEast Un,4348,7,4,3,7,10,15,-5,15
FC Goa,4348,8,4,3,7,12,19,-7,15
Mumbai City,4349,1,7,4,3,17,8,9,25
Kerala Blast,4349,2,6,4,4,16,17,-1,22
Delhi Dynamo,4349,3,5,6,3,23,16,7,21
Kolkata,4349,4,5,6,3,20,17,3,21
NorthEast Un,4349,5,4,4,6,14,15,-1,16
Chennaiyin,4349,6,3,6,5,15,20,-5,15
FC Pune City,4349,7,4,3,7,13,19,-6,15
FC Goa,4349,8,4,3,7,11,17,-6,15
Mumbai City,4350,1,6,5,3,17,9,8,23
Kolkata,4350,2,5,7,2,19,14,5,22
Delhi Dynamo,4350,3,5,6,3,24,17,7,21
NorthEast Un,4350,4,6,2,6,14,13,1,20
Chennaiyin,4350,5,4,6,4,17,20,-3,18
Kerala Blast,4350,6,5,3,6,14,19,-5,18
FC Pune City,4350,7,4,4,6,14,17,-3,16
FC Goa,4350,8,3,3,8,9,19,-10,12
Mumbai City,4351,1,7,4,3,19,10,9,25
Kolkata,4351,2,5,7,2,20,16,4,22
NorthEast Un,4351,3,6,3,5,14,12,2,21
Delhi Dynamo,4351,4,5,5,4,28,21,7,20
Kerala Blast,4351,5,4,6,4,11,15,-4,18
Chennaiyin,4351,6,4,5,5,16,20,-4,17
FC Pune City,4351,7,4,4,6,13,17,-4,16
FC Goa,4351,8,3,2,9,11,21,-10,11
Mumbai City,4352,1,7,4,3,17,8,9,25
Delhi Dynamo,4352,2,5,6,3,25,17,8,21
NorthEast Un,4352,3,6,3,5,15,11,4,21
Kolkata,4352,4,5,6,3,17,15,2,21
FC Pune City,4352,5,5,3,6,14,16,-2,18
Chennaiyin,4352,6,4,5,5,14,20,-6,17
Kerala Blast,4352,7,4,3,7,10,17,-7,15
FC Goa,4352,8,4,2,8,11,19,-8,14
Mumbai City,4353,1,6,5,3,18,10,8,23
Delhi Dynamo,4353,2,5,7,2,27,18,9,22
Kerala Blast,4353,3,6,4,4,15,16,-1,22
Kolkata,4353,4,4,8,2,17,14,3,20
NorthEast Un,4353,5,5,3,6,13,14,-1,18
Chennaiyin,4353,6,3,6,5,16,21,-5,15
FC Pune City,4353,7,4,3,7,14,19,-5,15
FC Goa,4353,8,3,4,7,11,19,-8,13
Delhi Dynamo,4354,1,7,5,2,25,15,10,26
Mumbai City,4354,2,6,4,4,17,10,7,22
Kolkata,4354,3,5,6,3,17,14,3,21
Chennaiyin,4354,4,5,5,4,18,19,-1,20
FC Pune City,4354,5,5,4,5,14,15,-1,19
Kerala Blast,4354,6,5,4,5,11,15,-4,19
NorthEast Un,4354,7,4,2,8,9,12,-3,14
FC Goa,4354,8,3,2,9,11,22,-11,11
Delhi Dynamo,4355,1,7,5,2,30,14,16,26
Mumbai City,4355,2,6,4,4,16,10,6,22
Kolkata,4355,3,5,7,2,17,14,3,22
Kerala Blast,4355,4,5,4,5,12,15,-3,19
Chennaiyin,4355,5,3,7,4,13,17,-4,16
FC Pune City,4355,5,4,4,6,13,17,-4,16
NorthEast Un,4355,7,4,4,6,10,14,-4,16
FC Goa,4355,8,3,3,8,9,19,-10,12
Mumbai City,4356,1,7,4,3,18,9,9,25
Kerala Blast,4356,2,6,3,5,14,16,-2,21
Chennaiyin,4356,3,5,5,4,17,17,0,20
Delhi Dynamo,4356,4,4,7,3,25,19,6,19
FC Pune City,4356,5,5,3,6,15,16,-1,18
NorthEast Un,4356,6,5,3,6,14,15,-1,18
FC Goa,4356,7,4,3,7,12,17,-5,15
Kolkata,4356,8,3,6,5,14,20,-6,15
Delhi Dynamo,4357,1,7,5,2,30,18,12,26
Mumbai City,4357,2,6,4,4,17,11,6,22
Kolkata,4357,3,5,6,3,18,15,3,21
NorthEast Un,4357,4,6,2,6,15,12,3,20
FC Pune City,4357,5,5,3,6,15,16,-1,18
Kerala Blast,4357,6,5,3,6,10,17,-7,18
Chennaiyin,4357,7,3,5,6,13,20,-7,14
FC Goa,4357,8,4,2,8,11,20,-9,14
Mumbai City,4358,1,7,4,3,21,8,13,25
Delhi Dynamo,4358,2,5,5,4,27,24,3,20
Kolkata,4358,3,4,7,3,17,16,1,19
FC Pune City,4358,4,5,4,5,16,17,-1,19
Kerala Blast,4358,5,4,6,4,11,15,-4,18
Chennaiyin,4358,6,4,5,5,17,20,-3,17
FC Goa,4358,7,5,2,7,16,21,-5,17
NorthEast Un,4358,8,4,3,7,11,15,-4,15
Mumbai City,4359,1,7,4,3,21,9,12,25
Delhi Dynamo,4359,2,5,6,3,25,21,4,21
Kerala Blast,4359,3,6,3,5,12,15,-3,21
Kolkata,4359,4,4,7,3,16,15,1,19
Chennaiyin,4359,5,4,6,4,19,21,-2,18
FC Pune City,4359,6,5,3,6,14,16,-2,18
NorthEast Un,4359,7,4,2,8,10,14,-4,14
FC Goa,4359,8,3,5,6,13,19,-6,14
Mumbai City,4360,1,7,4,3,18,9,9,25
NorthEast Un,4360,2,6,3,5,17,12,5,21
Kolkata,4360,3,5,6,3,15,15,0,21
Delhi Dynamo,4360,4,4,6,4,24,22,2,18
FC Goa,4360,5,5,3,6,14,16,-2,18
Kerala Blast,4360,6,5,3,6,11,16,-5,18
FC Pune City,4360,7,4,3,7,12,16,-4,15
Chennaiyin,4360,8,3,6,5,15,20,-5,15
Mumbai City,4361,1,6,5,3,18,10,8,23
Kerala Blast,4361,2,6,4,4,13,15,-2,22
NorthEast Un,4361,3,6,2,6,17,11,6,20
Kolkata,4361,4,4,7,3,18,17,1,19
Delhi Dynamo,4361,5,4,6,4,24,22,2,18
Chennaiyin,4361,6,4,5,5,14,21,-7,17
FC Pune City,4361,7,4,4,6,16,19,-3,16
FC Goa,4361,8,4,3,7,12,17,-5,15
Delhi Dynamo,4362,1,6,5,3,24,16,8,23
Mumbai City,4362,2,6,4,4,16,9,7,22
Kolkata,4362,3,5,6,3,18,16,2,21
FC Pune City,4362,4,6,3,5,16,16,0,21
Kerala Blast,4362,5,5,3,6,14,17,-3,18
FC Goa,4362,6,5,2,7,13,18,-5,17
NorthEast Un,4362,7,4,3,7,11,15,-4,15
Chennaiyin,4362,8,3,6,5,16,21,-5,15
Mumbai City,4363,1,7,4,3,19,8,11,25
NorthEast Un,4363,2,6,3,5,14,10,4,21
Delhi Dynamo,4363,3,5,5,4,24,20,4,20
FC Pune City,4363,4,5,4,5,15,16,-1,19
Kerala Blast,4363,5,4,6,4,10,14,-4,18
Kolkata,4363,6,3,7,4,14,16,-2,16
FC Goa,4363,7,4,3,7,13,18,-5,15
Chennaiyin,4363,8,3,6,5,15,22,-7,15
Delhi Dynamo,4364,1,6,6,2,23,14,9,24
Kolkata,4364,2,6,6,2,20,13,7,24
Mumbai City,4364,3,6,5,3,16,8,8,23
Kerala Blast,4364,4,6,3,5,13,16,-3,21
NorthEast Un,4364,5,5,2,7,12,14,-2,17
FC Pune City,4364,6,4,3,7,14,18,-4,15
FC Goa,4364,7,4,2,8,11,18,-7,14
Chennaiyin,4364,8,3,5,6,15,23,-8,14
Delhi Dynamo,4365,1,6,6,2,26,16,10,24
Mumbai City,4365,2,6,5,3,17,9,8,23
Kerala Blast,4365,3,6,4,4,15,17,-2,22
Kolkata,4365,4,3,9,2,15,14,1,18
Chennaiyin,4365,5,4,6,4,18,18,0,18
FC Pune City,4365,6,4,4,6,16,19,-3,16
NorthEast Un,4365,7,4,3,7,10,13,-3,15
FC Goa,4365,8,3,3,8,9,20,-11,12
Mumbai City,4366,1,7,4,3,20,8,12,25
Kolkata,4366,2,6,6,2,21,14,7,24
Delhi Dynamo,4366,3,5,5,4,24,21,3,20
NorthEast Un,4366,4,5,3,6,12,12,0,18
Chennaiyin,4366,5,3,7,4,14,18,-4,16
FC Pune City,4366,6,4,4,6,13,17,-4,16
Kerala Blast,4366,7,4,4,6,10,16,-6,16
FC Goa,4366,8,4,3,7,12,20,-8,15
Mumbai City,4367,1,7,4,3,18,9,9,25
Delhi Dynamo,4367,2,6,5,3,26,18,8,23
Kolkata,4367,3,5,6,3,19,15,4,21
Kerala Blast,4367,4,6,3,5,14,15,-1,21
NorthEast Un,4367,5,5,3,6,15,14,1,18
Chennaiyin,4367,6,3,6,5,16,21,-5,15
FC Pune City,4367,7,4,3,7,13,19,-6,15
FC Goa,4367,8,4,2,8,10,20,-10,14
Mumbai City,4368,1,6,5,3,17,9,8,23
Delhi Dynamo,4368,2,5,7,2,25,17,8,22
Kolkata,4368,3,5,7,2,17,13,4,22
Kerala Blast,4368,4,5,5,4,11,14,-3,20
Chennaiyin,4368,5,4,6,4,15,18,-3,18
FC Pune City,4368,6,4,4,6,14,17,-3,16
NorthEast Un,4368,7,4,2,8,9,12,-3,14
FC Goa,4368,8,3,4,7,11,19,-8,13
Mumbai City,4369,1,7,4,3,19,8,11,25
Delhi Dynamo,4369,2,6,5,3,27,19,8,23
Kerala Blast,4369,3,5,5,4,12,14,-2,20
Kolkata,4369,4,4,6,4,17,18,-1,18
Chennaiyin,4369,5,4,5,5,15,18,-3,17
FC Goa,4369,6,5,2,7,14,20,-6,17
FC Pune City,4369,7,4,4,6,12,15,-3,16
NorthEast Un,4369,8,4,3,7,9,13,-4,15
Delhi Dynamo,4370,1,6,5,3,25,17,8,23
Mumbai City,4370,2,6,4,4,17,10,7,22
NorthEast Un,4370,3,6,2,6,15,12,3,20
Chennaiyin,4370,4,5,5,4,16,18,-2,20
Kerala Blast,4370,5,5,4,5,14,17,-3,19
FC Pune City,4370,6,5,3,6,13,17,-4,18
Kolkata,4370,7,3,7,4,14,15,-1,16
FC Goa,4370,8,4,2,8,9,17,-8,14
Mumbai City,4371,1,7,4,3,17,8,9,25
Delhi Dynamo,4371,2,5,5,4,23,17,6,20
NorthEast Un,4371,3,5,4,5,11,10,1,19
FC Pune City,4371,4,5,4,5,14,15,-1,19
Kolkata,4371,5,3,9,2,14,13,1,18
Chennaiyin,4371,6,4,6,4,16,19,-3,18
Kerala Blast,4371,7,4,5,5,9,14,-5,17
FC Goa,4371,8,3,3,8,10,18,-8,12
Delhi Dynamo,4372,1,6,5,3,26,15,11,23
Mumbai City,4372,2,6,4,4,16,11,5,22
Kerala Blast,4372,3,6,4,4,12,14,-2,22
NorthEast Un,4372,4,6,2,6,14,11,3,20
Kolkata,4372,5,4,7,3,17,15,2,19
FC Pune City,4372,6,4,5,5,13,15,-2,17
Chennaiyin,4372,7,3,6,5,15,22,-7,15
FC Goa,4372,8,3,3,8,9,19,-10,12
Mumbai City,4373,1,7,4,3,18,8,10,25
NorthEast Un,4373,2,6,3,5,16,11,5,21
Delhi Dynamo,4373,3,5,5,4,25,20,5,20
Kolkata,4373,4,4,7,3,19,15,4,19
Kerala Blast,4373,5,5,3,6,11,20,-9,18
FC Goa,4373,6,5,2,7,13,20,-7,17
FC Pune City,4373,7,4,4,6,15,18,-3,16
Chennaiyin,4373,8,3,6,5,17,22,-5,15
Mumbai City,4374,1,7,4,3,19,8,11,25
Delhi Dynamo,4374,2,5,6,3,25,19,6,21
NorthEast Un,4374,3,5,4,5,13,12,1,19
Kolkata,4374,4,4,7,3,16,16,0,19
Kerala Blast,4374,5,5,3,6,11,17,-6,18
FC Pune City,4374,6,4,4,6,12,15,-3,16
Chennaiyin,4374,7,3,7,4,15,19,-4,16
FC Goa,4374,8,4,3,7,12,17,-5,15
Mumbai City,4375,1,7,4,3,20,10,10,25
Delhi Dynamo,4375,2,5,6,3,25,19,6,21
Kolkata,4375,3,5,6,3,19,14,5,21
NorthEast Un,4375,4,5,3,6,11,11,0,18
FC Pune City,4375,5,5,3,6,14,19,-5,18
Kerala Blast,4375,6,5,3,6,13,18,-5,18
Chennaiyin,4375,7,3,7,4,14,18,-4,16
FC Goa,4375,8,3,4,7,10,17,-7,13
Delhi Dynamo,4376,1,6,5,3,25,19,6,23
Mumbai City,4376,2,6,4,4,18,11,7,22
Kerala Blast,4376,3,6,4,4,18,16,2,22
Chennaiyin,4376,4,5,5,4,17,17,0,20
Kolkata,4376,5,4,7,3,15,14,1,19
NorthEast Un,4376,6,5,2,7,15,18,-3,17
FC Pune City,4376,7,4,3,7,12,17,-5,15
FC Goa,4376,8,4,2,8,10,18,-8,14
Kolkata,4377,1,6,6,2,19,12,7,24
Mumbai City,4377,2,6,4,4,17,10,7,22
NorthEast Un,4377,3,6,3,5,14,11,3,21
Delhi Dynamo,4377,4,5,5,4,26,21,5,20
Kerala Blast,4377,5,5,4,5,13,16,-3,19
Chennaiyin,4377,6,3,6,5,14,19,-5,15
FC Goa,4377,7,4,3,7,12,18,-6,15
FC Pune City,4377,8,4,3,7,12,20,-8,15
Mumbai City,4378,1,6,5,3,18,10,8,23
Delhi Dynamo,4378,2,5,6,3,25,20,5,21
Kolkata,4378,3,5,6,3,15,14,1,21
Kerala Blast,4378,4,6,3,5,13,15,-2,21
NorthEast Un,4378,5,6,2,6,14,13,1,20
FC Goa,4378,6,4,3,7,12,16,-4,15
FC Pune City,4378,6,4,3,7,12,16,-4,15
Chennaiyin,4378,8,3,6,5,15,20,-5,15
Mumbai City,4379,1,7,4,3,21,10,11,25
Kolkata,4379,2,6,6,2,17,12,5,24
Delhi Dynamo,4379,3,5,6,3,26,20,6,21
Kerala Blast,4379,4,5,4,5,12,16,-4,19
Chennaiyin,4379,5,4,5,5,15,20,-5,17
FC Pune City,4379,6,4,4,6,13,16,-3,16
NorthEast Un,4379,7,4,3,7,10,13,-3,15
FC Goa,4379,8,4,2,8,11,18,-7,14
Mumbai City,4380,1,7,4,3,18,9,9,25
Delhi Dynamo,4380,2,5,5,4,24,17,7,20
FC Goa,4380,3,6,2,6,12,14,-2,20
Kolkata,4380,4,4,7,3,16,14,2,19
Kerala Blast,4380,5,5,4,5,12,15,-3,19
NorthEast Un,4380,6,5,3,6,11,12,-1,18
FC Pune City,4380,7,4,4,6,13,18,-5,16
Chennaiyin,4380,8,3,5,6,14,21,-7,14
Delhi Dynamo,4381,1,7,5,2,25,15,10,26
Mumbai City,4381,2,6,4,4,16,9,7,22
Kolkata,4381,3,4,8,2,17,15,2,20
Kerala Blast,4381,4,5,4,5,14,17,-3,19
Chennaiyin,4381,5,4,6,4,16,18,-2,18
NorthEast Un,4381,6,4,4,6,11,12,-1,16
FC Pune City,4381,7,4,4,6,14,18,-4,16
FC Goa,4381,8,3,3,8,10,19,-9,12
Mumbai City,4382,1,7,4,3,20,8,12,25
NorthEast Un,4382,2,6,3,5,14,11,3,21
Delhi Dynamo,4382,3,5,5,4,27,22,5,20
FC Pune City,4382,4,5,4,5,14,15,-1,19
Kolkata,4382,5,4,6,4,15,15,0,18
Chennaiyin,4382,6,3,7,4,15,19,-4,16
Kerala Blast,4382,7,4,4,6,10,16,-6,16
FC Goa,4382,8,4,3,7,12,21,-9,15
Delhi Dynamo,4383,1,6,5,3,24,16,8,23
Mumbai City,4383,2,6,4,4,16,9,7,22
Kolkata,4383,3,5,6,3,16,14,2,21
NorthEast Un,4383,4,6,3,5,12,10,2,21
Kerala Blast,4383,5,5,4,5,11,15,-4,19
FC Pune City,4383,6,5,3,6,15,17,-2,18
Chennaiyin,4383,7,3,6,5,15,20,-5,15
FC Goa,4383,8,3,3,8,10,18,-8,12
Delhi Dynamo,4384,1,6,5,3,23,16,7,23
Mumbai City,4384,2,6,4,4,16,9,7,22
Kolkata,4384,3,5,6,3,22,16,6,21
Kerala Blast,4384,4,6,3,5,12,18,-6,21
Chennaiyin,4384,5,4,6,4,16,19,-3,18
NorthEast Un,4384,6,5,2,7,12,12,0,17
FC Pune City,4384,7,4,3,7,12,17,-5,15
FC Goa,4384,8,4,3,7,14,20,-6,15
Mumbai City,4385,1,7,4,3,18,9,9,25
NorthEast Un,4385,2,6,3,5,12,10,2,21
FC Pune City,4385,3,6,3,5,15,14,1,21
Kolkata,4385,4,4,7,3,15,15,0,19
Delhi Dynamo,4385,5,4,6,4,22,17,5,18
Kerala Blast,4385,6,4,5,5,11,16,-5,17
FC Goa,4385,7,4,3,7,10,16,-6,15
Chennaiyin,4385,8,3,5,6,14,20,-6,14
Delhi Dynamo,4386,1,7,5,2,28,17,11,26
Mumbai City,4386,2,6,4,4,18,11,7,22
Kerala Blast,4386,3,6,4,4,16,15,1,22
Chennaiyin,4386,4,5,5,4,16,18,-2,20
FC Pune City,4386,5,4,5,5,13,15,-2,17
Kolkata,4386,6,3,7,4,13,16,-3,16
FC Goa,4386,7,4,2,8,11,17,-6,14
NorthEast Un,4386,7,4,2,8,11,17,-6,14
Delhi Dynamo,4387,1,6,6,2,26,15,11,24
Mumbai City,4387,2,6,4,4,16,11,5,22
Kolkata,4387,3,5,7,2,17,14,3,22
NorthEast Un,4387,4,5,4,5,11,10,1,19
FC Pune City,4387,5,5,3,6,13,15,-2,18
Chennaiyin,4387,6,4,6,4,15,18,-3,18
Kerala Blast,4387,7,4,3,7,12,19,-7,15
FC Goa,4387,8,3,3,8,10,18,-8,12
Mumbai City,4388,1,7,4,3,19,9,10,25
Delhi Dynamo,4388,2,6,5,3,25,17,8,23
Chennaiyin,4388,3,5,5,4,18,18,0,20
Kerala Blast,4388,4,5,4,5,11,14,-3,19
Kolkata,4388,5,4,6,4,14,16,-2,18
FC Pune City,4388,6,5,3,6,13,16,-3,18
NorthEast Un,4388,7,4,3,7,9,12,-3,15
FC Goa,4388,8,4,2,8,12,19,-7,14
Delhi Dynamo,4389,1,6,5,3,28,20,8,23
Mumbai City,4389,2,6,4,4,17,11,6,22
Kolkata,4389,3,4,8,2,16,13,3,20
FC Pune City,4389,4,5,4,5,16,17,-1,19
Kerala Blast,4389,5,5,4,5,13,17,-4,19
Chennaiyin,4389,6,3,7,4,16,20,-4,16
NorthEast Un,4389,7,4,3,7,14,16,-2,15
FC Goa,4389,8,4,3,7,12,18,-6,15
Mumbai City,4390,1,7,4,3,17,8,9,25
Kolkata,4390,2,5,7,2,20,16,4,22
Delhi Dynamo,4390,3,5,5,4,24,17,7,20
NorthEast Un,4390,4,6,2,6,15,15,0,20
Chennaiyin,4390,5,4,6,4,16,18,-2,18
Kerala Blast,4390,6,4,5,5,14,19,-5,17
FC Pune City,4390,7,4,4,6,14,18,-4,16
FC Goa,4390,8,3,3,8,9,18,-9,12
Mumbai City,4391,1,7,4,3,19,8,11,25
Delhi Dynamo,4391,2,5,6,3,24,19,5,21
NorthEast Un,4391,3,6,2,6,17,13,4,20
Kolkata,4391,4,4,8,2,18,15,3,20
FC Pune City,4391,5,5,4,5,14,15,-1,19
Kerala Blast,4391,6,4,4,6,12,19,-7,16
Chennaiyin,4391,7,3,6,5,13,20,-7,15
FC Goa,4391,8,3,4,7,8,16,-8,13
Mumbai City,4392,1,7,4,3,17,8,9,25
Kerala Blast,4392,2,6,3,5,14,16,-2,21
NorthEast Un,4392,3,6,2,6,12,12,0,20
Kolkata,4392,4,4,7,3,20,18,2,19
Delhi Dynamo,4392,5,4,6,4,22,17,5,18
FC Pune City,4392,6,5,3,6,15,18,-3,18
FC Goa,4392,7,4,4,6,11,15,-4,16
Chennaiyin,4392,8,3,5,6,13,20,-7,14
Mumbai City,4393,1,6,5,3,17,9,8,23
Kerala Blast,4393,2,6,4,4,15,16,-1,22
NorthEast Un,4393,3,6,3,5,12,10,2,21
Delhi Dynamo,4393,4,4,7,3,23,17,6,19
Kolkata,4393,5,4,6,4,17,17,0,18
FC Goa,4393,6,5,3,6,15,18,-3,18
FC Pune City,4393,7,4,3,7,14,19,-5,15
Chennaiyin,4393,8,3,5,6,15,22,-7,14
Mumbai City,4394,1,6,5,3,16,8,8,23
Delhi Dynamo,4394,2,5,7,2,23,15,8,22
Kolkata,4394,3,4,8,2,17,14,3,20
Kerala Blast,4394,4,5,4,5,12,17,-5,19
Chennaiyin,4394,5,4,5,5,14,18,-4,17
FC Pune City,4394,6,4,4,6,13,16,-3,16
FC Goa,4394,7,4,4,6,11,16,-5,16
NorthEast Un,4394,8,4,3,7,11,13,-2,15
Mumbai City,4395,1,7,4,3,18,9,9,25
Delhi Dynamo,4395,2,6,5,3,27,17,10,23
Kerala Blast,4395,3,6,4,4,14,15,-1,22
Kolkata,4395,4,4,7,3,18,15,3,19
FC Goa,4395,5,5,2,7,12,19,-7,17
NorthEast Un,4395,6,4,3,7,12,15,-3,15
Chennaiyin,4395,7,3,6,5,15,20,-5,15
FC Pune City,4395,8,4,3,7,14,20,-6,15
Delhi Dynamo,4396,1,5,7,2,24,16,8,22
Mumbai City,4396,2,6,4,4,17,10,7,22
FC Pune City,4396,3,5,4,5,15,15,0,19
Chennaiyin,4396,4,4,6,4,18,17,1,18
Kolkata,4396,5,3,8,3,17,17,0,17
Kerala Blast,4396,6,4,5,5,12,18,-6,17
NorthEast Un,4396,7,4,4,6,11,16,-5,16
FC Goa,4396,8,4,4,6,10,15,-5,16
Mumbai City,4397,1,7,4,3,22,8,14,25
Kolkata,4397,2,5,7,2,18,13,5,22
Chennaiyin,4397,3,5,5,4,18,17,1,20
Delhi Dynamo,4397,4,4,6,4,23,23,0,18
NorthEast Un,4397,5,5,3,6,11,13,-2,18
Kerala Blast,4397,6,4,6,4,10,14,-4,18
FC Pune City,4397,7,4,4,6,14,17,-3,16
FC Goa,4397,8,3,3,8,9,20,-11,12
Kerala Blast,4398,1,7,3,4,16,15,1,24
Mumbai City,4398,2,6,5,3,17,9,8,23
Kolkata,4398,3,4,7,3,18,15,3,19
Delhi Dynamo,4398,4,4,6,4,24,21,3,18
NorthEast Un,4398,5,5,3,6,14,14,0,18
Chennaiyin,4398,6,3,7,4,15,19,-4,16
FC Goa,4398,7,4,4,6,13,17,-4,16
FC Pune City,4398,8,4,3,7,13,20,-7,15
Delhi Dynamo,4399,1,6,6,2,27,15,12,24
Kolkata,4399,2,6,6,2,18,13,5,24
Mumbai City,4399,3,6,5,3,16,8,8,23
NorthEast Un,4399,4,5,3,6,13,11,2,18
Kerala Blast,4399,5,4,5,5,11,16,-5,17
FC Pune City,4399,6,4,4,6,14,17,-3,16
Chennaiyin,4399,7,3,6,5,13,21,-8,15
FC Goa,4399,8,3,3,8,10,21,-11,12
Mumbai City,4400,1,7,4,3,19,8,11,25
Delhi Dynamo,4400,2,6,5,3,27,18,9,23
Kolkata,4400,3,5,6,3,17,14,3,21
Kerala Blast,4400,4,5,5,4,14,16,-2,20
NorthEast Un,4400,5,4,4,6,13,14,-1,16
FC Pune City,4400,6,4,4,6,13,18,-5,16
Chennaiyin,4400,7,3,6,5,15,20,-5,15
FC Goa,4400,8,4,2,8,10,20,-10,14
Mumbai City,4401,1,7,4,3,19,9,10,25
Kolkata,4401,2,6,6,2,18,12,6,24
Kerala Blast,4401,3,6,3,5,13,17,-4,21
Delhi Dynamo,4401,4,5,5,4,26,22,4,20
FC Goa,4401,5,5,2,7,15,17,-2,17
NorthEast Un,4401,6,4,3,7,13,15,-2,15
FC Pune City,4401,7,4,3,7,14,19,-5,15
Chennaiyin,4401,8,3,6,5,16,23,-7,15
Mumbai City,4402,1,7,4,3,19,10,9,25
Delhi Dynamo,4402,2,6,5,3,28,20,8,23
FC Pune City,4402,3,6,3,5,18,16,2,21
Chennaiyin,4402,4,5,5,4,16,18,-2,20
Kerala Blast,4402,5,5,4,5,11,16,-5,19
Kolkata,4402,6,3,7,4,19,21,-2,16
NorthEast Un,4402,7,4,3,7,12,14,-2,15
FC Goa,4402,8,3,3,8,13,21,-8,12
Mumbai City,4403,1,7,4,3,19,9,10,25
Delhi Dynamo,4403,2,5,6,3,30,20,10,21
Kolkata,4403,3,4,8,2,16,13,3,20
NorthEast Un,4403,4,5,3,6,13,17,-4,18
Kerala Blast,4403,5,5,3,6,12,16,-4,18
FC Goa,4403,6,4,4,6,14,17,-3,16
FC Pune City,4403,7,4,4,6,12,17,-5,16
Chennaiyin,4403,8,3,6,5,15,22,-7,15
Mumbai City,4404,1,7,4,3,17,8,9,25
Kerala Blast,4404,2,6,4,4,14,15,-1,22
Delhi Dynamo,4404,3,5,6,3,23,16,7,21
Kolkata,4404,4,4,8,2,18,15,3,20
NorthEast Un,4404,5,5,2,7,14,14,0,17
Chennaiyin,4404,6,4,5,5,16,19,-3,17
FC Pune City,4404,7,4,3,7,12,18,-6,15
FC Goa,4404,8,3,4,7,11,20,-9,13
Delhi Dynamo,4405,1,6,6,2,27,16,11,24
Kolkata,4405,2,6,6,2,19,15,4,24
Mumbai City,4405,3,6,4,4,16,9,7,22
FC Pune City,4405,4,5,3,6,14,16,-2,18
Kerala Blast,4405,5,5,3,6,12,16,-4,18
Chennaiyin,4405,6,4,5,5,16,20,-4,17
FC Goa,4405,7,4,3,7,12,17,-5,15
NorthEast Un,4405,8,4,2,8,11,18,-7,14
Mumbai City,4406,1,7,4,3,18,9,9,25
Kolkata,4406,2,5,6,3,17,15,2,21
Delhi Dynamo,4406,3,5,5,4,24,18,6,20
FC Pune City,4406,4,5,4,5,14,15,-1,19
NorthEast Un,4406,5,5,3,6,12,12,0,18
Chennaiyin,4406,6,4,6,4,16,18,-2,18
Kerala Blast,4406,7,4,5,5,11,16,-5,17
FC Goa,4406,8,3,3,8,9,18,-9,12
Delhi Dynamo,4407,1,6,6,2,25,15,10,24
Mumbai City,4407,2,6,5,3,16,8,8,23
Kerala Blast,4407,3,5,5,4,12,14,-2,20
Kolkata,4407,4,4,7,3,19,16,3,19
Chennaiyin,4407,5,4,6,4,14,17,-3,18
NorthEast Un,4407,6,4,3,7,10,12,-2,15
FC Pune City,4407,7,4,3,7,12,19,-7,15
FC Goa,4407,8,4,3,7,11,18,-7,15
Mumbai City,4408,1,6,5,3,17,9,8,23
Delhi Dynamo,4408,2,5,7,2,26,17,9,22
FC Pune City,4408,3,6,3,5,17,14,3,21
Chennaiyin,4408,4,5,5,4,17,19,-2,20
NorthEast Un,4408,5,5,3,6,11,11,0,18
Kolkata,4408,6,3,7,4,15,16,-1,16
Kerala Blast,4408,7,4,4,6,10,19,-9,16
FC Goa,4408,8,4,2,8,13,21,-8,14
Mumbai City,4409,1,7,4,3,19,9,10,25
Kolkata,4409,2,5,7,2,17,14,3,22
Kerala Blast,4409,3,5,4,5,15,18,-3,19
NorthEast Un,4409,4,5,3,6,13,13,0,18
Chennaiyin,4409,5,4,6,4,15,18,-3,18
Delhi Dynamo,4409,6,4,5,5,22,21,1,17
FC Goa,4409,7,4,4,6,12,15,-3,16
FC Pune City,4409,8,4,3,7,13,18,-5,15
Mumbai City,4410,1,7,4,3,20,9,11,25
Kerala Blast,4410,2,7,3,4,15,15,0,24
Delhi Dynamo,4410,3,4,7,3,23,19,4,19
NorthEast Un,4410,4,5,3,6,12,12,0,18
FC Goa,4410,5,5,3,6,13,14,-1,18
FC Pune City,4410,6,4,4,6,15,18,-3,16
Kolkata,4410,7,3,7,4,15,20,-5,16
Chennaiyin,4410,8,3,5,6,13,19,-6,14
Kerala Blast,4411,1,7,3,4,19,13,6,24
Mumbai City,4411,2,6,5,3,19,11,8,23
Delhi Dynamo,4411,3,5,6,3,26,19,7,21
Chennaiyin,4411,4,5,5,4,17,18,-1,20
FC Goa,4411,5,5,2,7,11,16,-5,17
Kolkata,4411,6,3,7,4,15,19,-4,16
FC Pune City,4411,7,4,4,6,14,19,-5,16
NorthEast Un,4411,8,4,2,8,10,16,-6,14
Delhi Dynamo,4412,1,6,6,2,26,16,10,24
Kolkata,4412,2,6,6,2,19,12,7,24
Mumbai City,4412,3,6,4,4,17,10,7,22
Chennaiyin,4412,4,4,6,4,15,17,-2,18
NorthEast Un,4412,5,4,5,5,10,10,0,17
Kerala Blast,4412,6,4,5,5,11,16,-5,17
FC Pune City,4412,7,4,4,6,13,17,-4,16
FC Goa,4412,8,3,2,9,9,22,-13,11
Delhi Dynamo,4413,1,6,5,3,27,16,11,23
Mumbai City,4413,2,6,4,4,17,11,6,22
Kolkata,4413,3,5,6,3,23,16,7,21
Kerala Blast,4413,4,6,3,5,14,17,-3,21
NorthEast Un,4413,5,6,2,6,12,11,1,20
FC Pune City,4413,6,5,3,6,14,16,-2,18
Chennaiyin,4413,7,3,5,6,14,20,-6,14
FC Goa,4413,8,4,2,8,10,24,-14,14
Delhi Dynamo,4414,1,7,5,2,27,15,12,26
Mumbai City,4414,2,6,4,4,16,9,7,22
FC Pune City,4414,3,6,3,5,18,18,0,21
NorthEast Un,4414,4,6,2,6,13,13,0,20
Kerala Blast,4414,5,5,3,6,12,17,-5,18
Kolkata,4414,6,3,7,4,18,19,-1,16
Chennaiyin,4414,7,3,6,5,15,20,-5,15
FC Goa,4414,8,3,4,7,10,18,-8,13
Mumbai City,4415,1,7,4,3,21,8,13,25
Delhi Dynamo,4415,2,5,5,4,24,21,3,20
Kolkata,4415,3,4,8,2,16,14,2,20
FC Pune City,4415,4,5,4,5,16,17,-1,19
Kerala Blast,4415,5,5,4,5,13,16,-3,19
Chennaiyin,4415,6,4,5,5,17,18,-1,17
NorthEast Un,4415,7,5,2,7,12,16,-4,17
FC Goa,4415,8,4,2,8,9,18,-9,14
Mumbai City,4416,1,7,4,3,19,8,11,25
Delhi Dynamo,4416,2,5,6,3,24,17,7,21
Kolkata,4416,3,4,7,3,16,15,1,19
FC Pune City,4416,4,5,4,5,13,14,-1,19
Kerala Blast,4416,5,5,4,5,13,16,-3,19
Chennaiyin,4416,6,3,7,4,15,19,-4,16
NorthEast Un,4416,7,4,3,7,11,16,-5,15
FC Goa,4416,8,3,5,6,10,16,-6,14
Kolkata,4417,1,6,6,2,21,15,6,24
Mumbai City,4417,2,6,4,4,16,9,7,22
Kerala Blast,4417,3,6,3,5,14,17,-3,21
Delhi Dynamo,4417,4,5,5,4,23,20,3,20
NorthEast Un,4417,5,5,3,6,14,13,1,18
Chennaiyin,4417,6,3,7,4,15,19,-4,16
FC Goa,4417,7,4,3,7,12,16,-4,15
FC Pune City,4417,8,4,3,7,16,22,-6,15
Mumbai City,4418,1,7,4,3,18,8,10,25
Delhi Dynamo,4418,2,5,6,3,25,18,7,21
FC Pune City,4418,3,6,3,5,18,15,3,21
NorthEast Un,4418,4,6,3,5,13,11,2,21
Kolkata,4418,5,4,6,4,17,18,-1,18
Kerala Blast,4418,6,5,3,6,12,18,-6,18
Chennaiyin,4418,7,4,5,5,17,19,-2,17
FC Goa,4418,8,3,2,9,10,23,-13,11
Mumbai City,4419,1,7,4,3,18,9,9,25
Delhi Dynamo,4419,2,6,5,3,26,17,9,23
Kolkata,4419,3,4,8,2,18,15,3,20
FC Pune City,4419,4,5,4,5,17,16,1,19
Kerala Blast,4419,5,5,4,5,12,18,-6,19
Chennaiyin,4419,6,4,5,5,16,22,-6,17
NorthEast Un,4419,7,4,2,8,12,15,-3,14
FC Goa,4419,8,4,2,8,12,19,-7,14
Kolkata,4420,1,5,7,2,20,13,7,22
Mumbai City,4420,2,6,4,4,16,9,7,22
Delhi Dynamo,4420,3,5,6,3,23,17,6,21
Chennaiyin,4420,4,4,6,4,16,18,-2,18
NorthEast Un,4420,5,4,5,5,10,10,0,17
FC Pune City,4420,6,4,5,5,13,15,-2,17
Kerala Blast,4420,7,4,5,5,9,16,-7,17
FC Goa,4420,8,4,2,8,11,20,-9,14
Mumbai City,4421,1,6,4,4,17,10,7,22
Delhi Dynamo,4421,2,5,6,3,24,19,5,21
Kolkata,4421,3,4,8,2,18,16,2,20
NorthEast Un,4421,4,6,2,6,13,12,1,20
Chennaiyin,4421,5,5,5,4,19,19,0,20
FC Pune City,4421,6,4,5,5,15,17,-2,17
Kerala Blast,4421,7,4,5,5,11,16,-5,17
FC Goa,4421,8,3,3,8,12,20,-8,12
Mumbai City,4422,1,7,4,3,17,8,9,25
Kolkata,4422,2,5,6,3,19,16,3,21
Kerala Blast,4422,3,6,3,5,13,16,-3,21
Delhi Dynamo,4422,4,5,5,4,25,20,5,20
NorthEast Un,4422,5,5,2,7,12,13,-1,17
Chennaiyin,4422,6,4,5,5,16,20,-4,17
FC Goa,4422,7,5,2,7,15,19,-4,17
FC Pune City,4422,8,4,3,7,13,18,-5,15
Delhi Dynamo,4423,1,7,5,2,29,18,11,26
Mumbai City,4423,2,6,4,4,16,9,7,22
Kerala Blast,4423,3,5,5,4,11,13,-2,20
NorthEast Un,4423,4,5,3,6,12,13,-1,18
Kolkata,4423,5,3,8,3,16,17,-1,17
FC Pune City,4423,6,4,5,5,14,16,-2,17
FC Goa,4423,7,4,3,7,17,18,-1,15
Chennaiyin,4423,8,3,5,6,13,24,-11,14
Mumbai City,4424,1,7,4,3,18,9,9,25
Delhi Dynamo,4424,2,6,5,3,29,18,11,23
FC Pune City,4424,3,6,3,5,16,14,2,21
Kerala Blast,4424,4,5,4,5,12,17,-5,19
FC Goa,4424,5,5,2,7,16,19,-3,17
Chennaiyin,4424,6,4,5,5,16,20,-4,17
Kolkata,4424,7,3,7,4,14,21,-7,16
NorthEast Un,4424,8,4,2,8,13,16,-3,14
Delhi Dynamo,4425,1,6,6,2,29,20,9,24
Mumbai City,4425,2,6,4,4,17,10,7,22
Kerala Blast,4425,3,6,3,5,12,19,-7,21
Chennaiyin,4425,4,5,5,4,15,17,-2,20
Kolkata,4425,5,4,7,3,16,15,1,19
NorthEast Un,4425,6,5,2,7,16,13,3,17
FC Pune City,4425,7,4,4,6,13,16,-3,16
FC Goa,4425,8,3,3,8,11,19,-8,12
Delhi Dynamo,4426,1,6,6,2,27,15,12,24
Mumbai City,4426,2,6,4,4,17,10,7,22
Kolkata,4426,3,5,6,3,19,16,3,21
NorthEast Un,4426,4,5,3,6,13,12,1,18
Chennaiyin,4426,5,4,6,4,15,17,-2,18
Kerala Blast,4426,6,5,3,6,12,18,-6,18
FC Pune City,4426,7,4,3,7,12,18,-6,15
FC Goa,4426,8,4,3,7,12,21,-9,15
Mumbai City,4427,1,6,5,3,19,11,8,23
Delhi Dynamo,4427,2,5,6,3,28,19,9,21
Kerala Blast,4427,3,6,3,5,17,17,0,21
NorthEast Un,4427,4,6,2,6,11,11,0,20
FC Pune City,4427,5,5,3,6,17,19,-2,18
Chennaiyin,4427,6,4,6,4,15,17,-2,18
FC Goa,4427,7,4,3,7,12,18,-6,15
Kolkata,4427,8,3,6,5,13,20,-7,15
Mumbai City,4428,1,7,4,3,21,8,13,25
NorthEast Un,4428,2,5,4,5,13,12,1,19
FC Pune City,4428,3,5,4,5,17,17,0,19
Delhi Dynamo,4428,4,4,6,4,24,23,1,18
Kolkata,4428,5,3,9,2,16,15,1,18
Kerala Blast,4428,6,4,5,5,12,18,-6,17
Chennaiyin,4428,7,3,7,4,16,20,-4,16
FC Goa,4428,8,3,5,6,12,18,-6,14
Mumbai City,4429,1,7,4,3,18,9,9,25
Kolkata,4429,2,5,6,3,18,16,2,21
Delhi Dynamo,4429,3,5,5,4,24,18,6,20
FC Pune City,4429,4,5,3,6,16,18,-2,18
Chennaiyin,4429,5,4,6,4,15,17,-2,18
Kerala Blast,4429,6,5,3,6,14,19,-5,18
FC Goa,4429,7,5,2,7,13,17,-4,17
NorthEast Un,4429,8,4,3,7,10,14,-4,15
Delhi Dynamo,4430,1,7,5,2,30,16,14,26
Mumbai City,4430,2,6,4,4,17,11,6,22
Kerala Blast,4430,3,6,4,4,15,14,1,22
Chennaiyin,4430,4,4,5,5,16,21,-5,17
FC Goa,4430,5,5,2,7,14,20,-6,17
Kolkata,4430,6,3,7,4,16,18,-2,16
FC Pune City,4430,7,4,4,6,13,18,-5,16
NorthEast Un,4430,8,4,3,7,10,13,-3,15
Mumbai City,4431,1,7,4,3,18,8,10,25
Kerala Blast,4431,2,6,4,4,13,15,-2,22
Delhi Dynamo,4431,3,5,6,3,23,17,6,21
Kolkata,4431,4,4,7,3,17,16,1,19
Chennaiyin,4431,5,4,6,4,17,19,-2,18
NorthEast Un,4431,6,4,5,5,12,12,0,17
FC Pune City,4431,7,4,4,6,16,19,-3,16
FC Goa,4431,8,3,2,9,9,19,-10,11
Delhi Dynamo,4432,1,6,6,2,27,16,11,24
Mumbai City,4432,2,6,4,4,17,11,6,22
Kerala Blast,4432,3,6,3,5,11,14,-3,21
Kolkata,4432,4,4,8,2,16,14,2,20
NorthEast Un,4432,5,5,3,6,11,11,0,18
FC Pune City,4432,6,4,4,6,14,17,-3,16
Chennaiyin,4432,7,3,6,5,14,19,-5,15
FC Goa,4432,8,3,4,7,9,17,-8,13
Mumbai City,4433,1,7,4,3,18,8,10,25
NorthEast Un,4433,2,7,2,5,14,10,4,23
Kolkata,4433,3,5,6,3,19,16,3,21
Delhi Dynamo,4433,4,5,5,4,24,18,6,20
FC Pune City,4433,5,5,3,6,15,16,-1,18
Kerala Blast,4433,6,5,3,6,11,19,-8,18
Chennaiyin,4433,7,4,5,5,15,18,-3,17
FC Goa,4433,8,3,2,9,10,21,-11,11
Mumbai City,4434,1,7,4,3,20,10,10,25
NorthEast Un,4434,2,6,2,6,15,12,3,20
Kolkata,4434,3,4,7,3,17,15,2,19
FC Pune City,4434,4,5,3,6,14,16,-2,18
FC Goa,4434,5,5,3,6,13,16,-3,18
Kerala Blast,4434,6,5,3,6,13,20,-7,18
Delhi Dynamo,4434,7,4,5,5,24,22,2,17
Chennaiyin,4434,8,4,5,5,14,19,-5,17
Mumbai City,4435,1,7,4,3,18,9,9,25
NorthEast Un,4435,2,7,2,5,18,10,8,23
Delhi Dynamo,4435,3,5,5,4,26,23,3,20
Kolkata,4435,4,4,7,3,16,16,0,19
Kerala Blast,4435,5,4,5,5,11,16,-5,17
FC Pune City,4435,6,4,4,6,14,17,-3,16
FC Goa,4435,7,4,3,7,12,17,-5,15
Chennaiyin,4435,8,3,6,5,13,20,-7,15
Mumbai City,4436,1,6,5,3,17,9,8,23
Delhi Dynamo,4436,2,5,7,2,26,16,10,22
Kerala Blast,4436,3,6,3,5,12,17,-5,21
Kolkata,4436,4,4,7,3,16,13,3,19
NorthEast Un,4436,5,5,3,6,10,10,0,18
FC Goa,4436,6,5,2,7,12,18,-6,17
FC Pune City,4436,7,4,4,6,13,16,-3,16
Chennaiyin,4436,8,3,5,6,13,20,-7,14
Mumbai City,4437,1,6,5,3,16,8,8,23
Kolkata,4437,2,5,6,3,22,15,7,21
NorthEast Un,4437,3,6,3,5,14,11,3,21
FC Goa,4437,4,6,2,6,13,16,-3,20
Delhi Dynamo,4437,5,4,7,3,24,18,6,19
FC Pune City,4437,6,4,4,6,12,17,-5,16
Kerala Blast,4437,7,4,4,6,10,20,-10,16
Chennaiyin,4437,8,3,5,6,13,19,-6,14
Mumbai City,4438,1,7,4,3,18,8,10,25
Delhi Dynamo,4438,2,6,5,3,26,16,10,23
Kolkata,4438,3,5,6,3,17,13,4,21
Kerala Blast,4438,4,6,3,5,12,15,-3,21
Chennaiyin,4438,5,5,5,4,19,19,0,20
FC Pune City,4438,6,5,3,6,14,18,-4,18
NorthEast Un,4438,7,4,2,8,10,14,-4,14
FC Goa,4438,8,3,2,9,9,22,-13,11
Delhi Dynamo,4439,1,6,6,2,28,18,10,24
Kerala Blast,4439,2,7,3,4,12,13,-1,24
Mumbai City,4439,3,6,4,4,18,11,7,22
Kolkata,4439,4,4,6,4,15,16,-1,18
FC Goa,4439,5,5,2,7,14,18,-4,17
Chennaiyin,4439,6,4,5,5,15,20,-5,17
NorthEast Un,4439,7,4,3,7,11,13,-2,15
FC Pune City,4439,8,4,3,7,12,16,-4,15
Mumbai City,4440,1,7,4,3,17,8,9,25
Kolkata,4440,2,5,7,2,19,14,5,22
NorthEast Un,4440,3,5,4,5,14,11,3,19
FC Pune City,4440,4,5,4,5,15,15,0,19
Delhi Dynamo,4440,5,4,6,4,21,18,3,18
Chennaiyin,4440,6,3,7,4,15,19,-4,16
Kerala Blast,4440,7,4,4,6,11,20,-9,16
FC Goa,4440,8,3,4,7,9,16,-7,13
Mumbai City,4441,1,7,4,3,19,9,10,25
FC Pune City,4441,2,6,3,5,14,14,0,21
NorthEast Un,4441,3,6,2,6,14,11,3,20
Delhi Dynamo,4441,4,4,6,4,23,20,3,18
Kolkata,4441,5,4,6,4,17,15,2,18
FC Goa,4441,6,5,3,6,11,15,-4,18
Chennaiyin,4441,7,4,5,5,15,19,-4,17
Kerala Blast,4441,8,4,3,7,10,20,-10,15
Mumbai City,4442,1,7,4,3,18,9,9,25
Delhi Dynamo,4442,2,5,6,3,24,17,7,21
FC Pune City,4442,3,5,4,5,14,15,-1,19
Kerala Blast,4442,4,5,4,5,10,14,-4,19
NorthEast Un,4442,5,5,3,6,13,13,0,18
Chennaiyin,4442,6,4,5,5,16,20,-4,17
FC Goa,4442,7,5,2,7,11,15,-4,17
Kolkata,4442,8,3,6,5,14,17,-3,15
Mumbai City,4443,1,6,5,3,17,9,8,23
Delhi Dynamo,4443,2,5,6,3,26,19,7,21
NorthEast Un,4443,3,6,3,5,17,11,6,21
Kolkata,4443,4,4,7,3,16,15,1,19
FC Goa,4443,5,5,2,7,13,20,-7,17
Kerala Blast,4443,6,4,5,5,11,18,-7,17
FC Pune City,4443,7,4,4,6,12,15,-3,16
Chennaiyin,4443,8,3,6,5,15,20,-5,15
Mumbai City,4444,1,7,4,3,19,10,9,25
Kerala Blast,4444,2,6,4,4,14,15,-1,22
Delhi Dynamo,4444,3,5,6,3,26,17,9,21
Chennaiyin,4444,4,4,6,4,15,18,-3,18
FC Pune City,4444,4,5,3,6,15,18,-3,18
FC Goa,4444,6,4,4,6,13,15,-2,16
Kolkata,4444,7,3,7,4,15,19,-4,16
NorthEast Un,4444,8,4,2,8,9,14,-5,14
Mumbai City,4445,1,6,5,3,17,9,8,23
Kerala Blast,4445,2,6,4,4,16,14,2,22
Delhi Dynamo,4445,3,4,7,3,23,17,6,19
Kolkata,4445,4,4,7,3,18,16,2,19
FC Goa,4445,5,5,3,6,13,16,-3,18
NorthEast Un,4445,6,5,2,7,10,11,-1,17
Chennaiyin,4445,7,4,5,5,14,18,-4,17
FC Pune City,4445,8,4,3,7,12,22,-10,15
Mumbai City,4446,1,7,4,3,19,8,11,25
FC Pune City,4446,2,5,4,5,18,16,2,19
Kerala Blast,4446,3,5,4,5,13,15,-2,19
Delhi Dynamo,4446,4,4,6,4,22,21,1,18
Kolkata,4446,5,4,6,4,16,19,-3,18
FC Goa,4446,6,5,3,6,14,18,-4,18
NorthEast Un,4446,7,5,2,7,13,14,-1,17
Chennaiyin,4446,8,4,5,5,17,21,-4,17
Mumbai City,4447,1,7,4,3,19,8,11,25
NorthEast Un,4447,2,7,2,5,17,12,5,23
FC Pune City,4447,3,6,3,5,15,14,1,21
Delhi Dynamo,4447,4,5,5,4,24,21,3,20
Kolkata,4447,5,3,8,3,15,16,-1,17
Chennaiyin,4447,6,4,5,5,15,20,-5,17
Kerala Blast,4447,7,4,4,6,12,18,-6,16
FC Goa,4447,8,3,3,8,9,17,-8,12
Mumbai City,4448,1,6,5,3,17,9,8,23
Delhi Dynamo,4448,2,5,7,2,27,18,9,22
Kolkata,4448,3,5,6,3,21,16,5,21
NorthEast Un,4448,4,6,3,5,13,11,2,21
Kerala Blast,4448,5,5,3,6,11,20,-9,18
FC Pune City,4448,6,4,3,7,14,18,-4,15
Chennaiyin,4448,7,3,6,5,15,20,-5,15
FC Goa,4448,8,4,3,7,14,20,-6,15
Mumbai City,4449,1,6,4,4,17,10,7,22
Kerala Blast,4449,2,6,4,4,16,15,1,22
Delhi Dynamo,4449,3,5,6,3,24,17,7,21
Kolkata,4449,4,4,8,2,17,15,2,20
Chennaiyin,4449,5,4,6,4,16,17,-1,18
FC Pune City,4449,6,4,4,6,13,17,-4,16
NorthEast Un,4449,7,4,3,7,10,16,-6,15
FC Goa,4449,8,4,3,7,9,15,-6,15
Mumbai City,4450,1,6,4,4,17,11,6,22
Delhi Dynamo,4450,2,5,6,3,24,17,7,21
Kolkata,4450,3,5,6,3,20,17,3,21
NorthEast Un,4450,4,5,4,5,12,11,1,19
Chennaiyin,4450,5,4,6,4,18,21,-3,18
Kerala Blast,4450,6,5,3,6,14,18,-4,18
FC Goa,4450,7,5,2,7,14,18,-4,17
FC Pune City,4450,8,4,3,7,14,20,-6,15
Mumbai City,4451,1,7,4,3,19,9,10,25
Kolkata,4451,2,5,7,2,20,13,7,22
Kerala Blast,4451,3,6,3,5,14,16,-2,21
Delhi Dynamo,4451,4,5,5,4,23,19,4,20
NorthEast Un,4451,5,5,3,6,13,13,0,18
Chennaiyin,4451,6,4,6,4,17,20,-3,18
FC Pune City,4451,7,4,3,7,14,22,-8,15
FC Goa,4451,8,3,3,8,9,17,-8,12
Delhi Dynamo,4452,1,6,6,2,25,14,11,24
Mumbai City,4452,2,6,5,3,16,8,8,23
Kerala Blast,4452,3,6,4,4,15,17,-2,22
Kolkata,4452,4,4,6,4,16,15,1,18
NorthEast Un,4452,4,5,3,6,16,15,1,18
FC Pune City,4452,6,5,3,6,15,17,-2,18
Chennaiyin,4452,7,3,6,5,15,21,-6,15
FC Goa,4452,8,3,3,8,8,19,-11,12
Mumbai City,4453,1,7,4,3,19,10,9,25
Delhi Dynamo,4453,2,6,5,3,26,18,8,23
Kerala Blast,4453,3,6,4,4,15,14,1,22
Chennaiyin,4453,4,5,5,4,16,17,-1,20
Kolkata,4453,5,4,7,3,20,18,2,19
FC Pune City,4453,6,4,4,6,13,18,-5,16
NorthEast Un,4453,7,4,2,8,10,15,-5,14
FC Goa,4453,8,3,3,8,12,21,-9,12
Delhi Dynamo,4454,1,6,6,2,28,17,11,24
Mumbai City,4454,2,6,5,3,17,9,8,23
Kolkata,4454,3,4,8,2,19,17,2,20
Chennaiyin,4454,4,5,5,4,18,19,-1,20
NorthEast Un,4454,5,5,2,7,12,14,-2,17
Kerala Blast,4454,6,4,5,5,10,16,-6,17
FC Pune City,4454,7,4,4,6,13,16,-3,16
FC Goa,4454,8,3,3,8,14,23,-9,12
Mumbai City,4455,1,6,5,3,17,9,8,23
NorthEast Un,4455,2,7,2,5,13,9,4,23
Kolkata,4455,3,4,7,3,18,16,2,19
Kerala Blast,4455,4,5,4,5,12,16,-4,19
Delhi Dynamo,4455,5,4,6,4,24,19,5,18
FC Pune City,4455,6,5,3,6,16,17,-1,18
Chennaiyin,4455,7,3,6,5,14,20,-6,15
FC Goa,4455,8,4,3,7,12,20,-8,15
Delhi Dynamo,4456,1,6,6,2,23,14,9,24
Mumbai City,4456,2,6,4,4,16,9,7,22
NorthEast Un,4456,3,6,3,5,14,10,4,21
Kerala Blast,4456,4,6,3,5,17,21,-4,21
FC Pune City,4456,5,5,3,6,17,19,-2,18
FC Goa,4456,6,5,2,7,11,16,-5,17
Kolkata,4456,7,3,6,5,18,21,-3,15
Chennaiyin,4456,8,3,5,6,13,19,-6,14
Mumbai City,4457,1,6,5,3,17,9,8,23
NorthEast Un,4457,2,6,3,5,13,10,3,21
FC Goa,4457,3,6,2,6,14,16,-2,20
Kolkata,4457,4,4,7,3,18,15,3,19
Delhi Dynamo,4457,5,4,6,4,22,19,3,18
Kerala Blast,4457,6,4,6,4,10,14,-4,18
FC Pune City,4457,7,4,4,6,13,18,-5,16
Chennaiyin,4457,8,3,5,6,14,20,-6,14
Mumbai City,4458,1,6,5,3,17,9,8,23
Delhi Dynamo,4458,2,5,7,2,25,16,9,22
FC Pune City,4458,3,6,3,5,17,15,2,21
Chennaiyin,4458,4,4,6,4,15,18,-3,18
Kerala Blast,4458,5,4,5,5,11,17,-6,17
NorthEast Un,4458,6,4,4,6,12,13,-1,16
Kolkata,4458,7,3,7,4,14,16,-2,16
FC Goa,4458,8,4,3,7,10,17,-7,15
Mumbai City,4459,1,6,5,3,18,10,8,23
Kerala Blast,4459,2,6,4,4,14,15,-1,22
Delhi Dynamo,4459,3,5,6,3,28,19,9,21
Chennaiyin,4459,4,5,5,4,17,19,-2,20
Kolkata,4459,5,4,7,3,17,16,1,19
FC Pune City,4459,6,5,3,6,14,17,-3,18
NorthEast Un,4459,7,4,2,8,10,15,-5,14
FC Goa,4459,8,4,2,8,12,19,-7,14
Mumbai City,4460,1,7,4,3,18,8,10,25
Kolkata,4460,2,5,6,3,18,15,3,21
Delhi Dynamo,4460,3,5,5,4,23,19,4,20
NorthEast Un,4460,4,5,3,6,14,14,0,18
FC Pune City,4460,5,5,3,6,15,17,-2,18
Kerala Blast,4460,6,5,3,6,13,19,-6,18
Chennaiyin,4460,7,3,7,4,17,21,-4,16
FC Goa,4460,8,4,3,7,13,18,-5,15
Mumbai City,4461,1,7,4,3,18,9,9,25
Delhi Dynamo,4461,2,5,6,3,24,17,7,21
Kerala Blast,4461,3,5,4,5,16,17,-1,19
Kolkata,4461,4,3,9,2,15,14,1,18
NorthEast Un,4461,5,5,3,6,13,13,0,18
Chennaiyin,4461,6,3,7,4,16,20,-4,16
FC Pune City,4461,7,4,4,6,14,20,-6,16
FC Goa,4461,8,3,5,6,10,16,-6,14
Delhi Dynamo,4462,1,6,5,3,25,18,7,23
Mumbai City,4462,2,6,4,4,17,10,7,22
NorthEast Un,4462,3,6,3,5,12,9,3,21
Kolkata,4462,4,4,7,3,16,17,-1,19
FC Pune City,4462,5,5,4,5,15,16,-1,19
Kerala Blast,4462,6,5,4,5,12,14,-2,19
Chennaiyin,4462,7,4,5,5,15,18,-3,17
FC Goa,4462,8,3,2,9,9,19,-10,11
Mumbai City,4463,1,7,4,3,20,8,12,25
Kolkata,4463,2,4,8,2,19,14,5,20
Kerala Blast,4463,3,5,4,5,13,19,-6,19
Delhi Dynamo,4463,4,4,6,4,22,20,2,18
NorthEast Un,4463,5,5,3,6,11,11,0,18
FC Pune City,4463,6,5,3,6,16,19,-3,18
FC Goa,4463,7,4,4,6,12,17,-5,16
Chennaiyin,4463,8,3,6,5,14,19,-5,15
Delhi Dynamo,4464,1,6,6,2,28,18,10,24
Kolkata,4464,2,5,7,2,19,13,6,22
Mumbai City,4464,3,6,4,4,16,10,6,22
Kerala Blast,4464,4,6,3,5,13,17,-4,21
FC Goa,4464,5,4,4,6,13,18,-5,16
NorthEast Un,4464,6,4,3,7,13,15,-2,15
Chennaiyin,4464,7,3,6,5,17,22,-5,15
FC Pune City,4464,8,4,3,7,12,18,-6,15
Mumbai City,4465,1,7,4,3,19,9,10,25
Kerala Blast,4465,2,6,3,5,15,18,-3,21
Delhi Dynamo,4465,3,5,5,4,24,21,3,20
NorthEast Un,4465,4,6,2,6,15,12,3,20
Chennaiyin,4465,5,5,5,4,16,17,-1,20
FC Pune City,4465,6,5,3,6,13,15,-2,18
Kolkata,4465,7,3,6,5,16,19,-3,15
FC Goa,4465,8,4,2,8,10,17,-7,14
Mumbai City,4466,1,7,4,3,20,9,11,25
Delhi Dynamo,4466,2,5,5,4,24,20,4,20
Chennaiyin,4466,3,5,5,4,16,17,-1,20
Kerala Blast,4466,4,5,5,4,13,15,-2,20
NorthEast Un,4466,5,5,3,6,13,14,-1,18
Kolkata,4466,6,3,8,3,14,14,0,17
FC Pune City,4466,7,4,4,6,13,17,-4,16
FC Goa,4466,8,4,2,8,9,16,-7,14
Delhi Dynamo,4467,1,6,6,2,28,17,11,24
Mumbai City,4467,2,6,5,3,18,10,8,23
Kolkata,4467,3,5,7,2,18,13,5,22
FC Pune City,4467,4,5,4,5,14,15,-1,19
Chennaiyin,4467,5,4,6,4,17,19,-2,18
NorthEast Un,4467,6,4,4,6,13,14,-1,16
Kerala Blast,4467,7,4,4,6,12,20,-8,16
FC Goa,4467,8,3,2,9,8,20,-12,11
Mumbai City,4468,1,7,4,3,19,10,9,25
Delhi Dynamo,4468,2,5,5,4,27,21,6,20
Kerala Blast,4468,3,5,5,4,11,14,-3,20
Kolkata,4468,4,4,7,3,16,15,1,19
NorthEast Un,4468,5,5,3,6,14,11,3,18
Chennaiyin,4468,6,4,6,4,15,18,-3,18
FC Pune City,4468,7,4,4,6,14,17,-3,16
FC Goa,4468,8,3,4,7,9,19,-10,13
Mumbai City,4469,1,7,4,3,18,9,9,25
Kolkata,4469,2,6,6,2,19,13,6,24
Delhi Dynamo,4469,3,5,5,4,26,20,6,20
NorthEast Un,4469,4,5,3,6,14,14,0,18
Chennaiyin,4469,5,4,5,5,15,20,-5,17
Kerala Blast,4469,6,4,5,5,11,18,-7,17
FC Pune City,4469,7,4,4,6,14,17,-3,16
FC Goa,4469,8,4,2,8,11,17,-6,14
Mumbai City,4470,1,6,5,3,16,8,8,23
FC Goa,4470,2,6,2,6,19,18,1,20
Kolkata,4470,3,4,7,3,21,19,2,19
Kerala Blast,4470,4,5,4,5,12,18,-6,19
Delhi Dynamo,4470,5,4,6,4,21,19,2,18
NorthEast Un,4470,6,5,3,6,14,14,0,18
Chennaiyin,4470,7,4,5,5,17,21,-4,17
FC Pune City,4470,8,4,4,6,14,17,-3,16
Mumbai City,4471,1,6,5,3,17,9,8,23
Delhi Dynamo,4471,2,5,6,3,27,18,9,21
Kolkata,4471,3,4,7,3,16,16,0,19
Chennaiyin,4471,4,4,6,4,19,20,-1,18
FC Goa,4471,5,5,3,6,17,19,-2,18
Kerala Blast,4471,6,5,3,6,12,18,-6,18
NorthEast Un,4471,7,5,2,7,13,17,-4,17
FC Pune City,4471,8,4,4,6,12,16,-4,16
Mumbai City,4472,1,7,4,3,18,9,9,25
Kerala Blast,4472,2,6,4,4,17,16,1,22
Delhi Dynamo,4472,3,5,6,3,23,16,7,21
Kolkata,4472,4,5,6,3,19,17,2,21
NorthEast Un,4472,5,5,3,6,12,12,0,18
FC Pune City,4472,6,4,3,7,14,19,-5,15
FC Goa,4472,7,4,3,7,11,19,-8,15
Chennaiyin,4472,8,3,5,6,15,21,-6,14
Delhi Dynamo,4473,1,6,6,2,28,16,12,24
Mumbai City,4473,2,6,5,3,18,10,8,23
Kerala Blast,4473,3,6,4,4,13,14,-1,22
Kolkata,4473,4,5,6,3,20,15,5,21
FC Pune City,4473,5,4,4,6,13,18,-5,16
NorthEast Un,4473,6,4,3,7,12,14,-2,15
Chennaiyin,4473,7,3,6,5,16,21,-5,15
FC Goa,4473,8,4,2,8,10,22,-12,14
Mumbai City,4474,1,6,5,3,18,10,8,23
NorthEast Un,4474,2,6,3,5,17,10,7,21
Delhi Dynamo,4474,3,5,6,3,28,23,5,21
FC Pune City,4474,4,6,3,5,17,14,3,21
Kolkata,4474,5,5,6,3,17,15,2,21
Kerala Blast,4474,6,4,4,6,11,20,-9,16
Chennaiyin,4474,7,3,5,6,13,20,-7,14
FC Goa,4474,8,4,2,8,12,21,-9,14
Delhi Dynamo,4475,1,6,5,3,26,15,11,23
Mumbai City,4475,2,6,4,4,16,9,7,22
Kerala Blast,4475,3,6,3,5,14,14,0,21
Chennaiyin,4475,4,5,5,4,15,17,-2,20
Kolkata,4475,5,4,6,4,15,15,0,18
FC Pune City,4475,6,5,3,6,13,17,-4,18
FC Goa,4475,7,5,2,7,11,16,-5,17
NorthEast Un,4475,8,4,2,8,9,16,-7,14
Mumbai City,4476,1,7,4,3,19,9,10,25
Kolkata,4476,2,5,6,3,17,15,2,21
Kerala Blast,4476,3,6,3,5,17,16,1,21
Delhi Dynamo,4476,4,5,5,4,24,19,5,20
FC Goa,4476,5,6,2,6,13,15,-2,20
NorthEast Un,4476,6,5,2,7,11,14,-3,17
FC Pune City,4476,7,4,3,7,12,18,-6,15
Chennaiyin,4476,8,3,5,6,14,21,-7,14
Delhi Dynamo,4477,1,6,5,3,30,17,13,23
Mumbai City,4477,2,6,4,4,16,11,5,22
Kolkata,4477,3,5,6,3,16,14,2,21
Kerala Blast,4477,4,6,3,5,16,18,-2,21
Chennaiyin,4477,5,5,5,4,16,18,-2,20
FC Pune City,4477,6,5,3,6,16,18,-2,18
NorthEast Un,4477,7,5,2,7,12,14,-2,17
FC Goa,4477,8,3,2,9,9,21,-12,11
Mumbai City,4478,1,7,4,3,19,8,11,25
Delhi Dynamo,4478,2,5,6,3,23,17,6,21
Kolkata,4478,3,4,7,3,16,16,0,19
Kerala Blast,4478,4,5,4,5,12,15,-3,19
FC Pune City,4478,5,5,3,6,14,16,-2,18
NorthEast Un,4478,6,4,5,5,12,12,0,17
Chennaiyin,4478,7,3,6,5,16,22,-6,15
FC Goa,4478,8,4,3,7,10,16,-6,15
Mumbai City,4479,1,6,4,4,17,11,6,22
Delhi Dynamo,4479,2,5,6,3,27,19,8,21
NorthEast Un,4479,3,6,3,5,14,12,2,21
Kolkata,4479,4,4,7,3,15,15,0,19
Kerala Blast,4479,5,5,4,5,13,16,-3,19
FC Pune City,4479,6,5,3,6,13,15,-2,18
Chennaiyin,4479,7,3,6,5,13,18,-5,15
FC Goa,4479,8,3,5,6,9,15,-6,14
Delhi Dynamo,4480,1,6,6,2,28,17,11,24
Mumbai City,4480,2,6,4,4,16,9,7,22
FC Pune City,4480,3,6,3,5,14,14,0,21
Kolkata,4480,4,4,6,4,16,15,1,18
Kerala Blast,4480,5,5,3,6,14,18,-4,18
Chennaiyin,4480,6,4,5,5,16,20,-4,17
FC Goa,4480,7,5,2,7,15,21,-6,17
NorthEast Un,4480,8,4,3,7,10,15,-5,15
Mumbai City,4481,1,6,5,3,18,10,8,23
Delhi Dynamo,4481,2,5,7,2,27,19,8,22
NorthEast Un,4481,3,6,2,6,16,14,2,20
FC Pune City,4481,4,5,4,5,14,15,-1,19
Kerala Blast,4481,5,5,3,6,12,16,-4,18
Kolkata,4481,6,3,8,3,15,17,-2,17
Chennaiyin,4481,7,3,6,5,15,20,-5,15
FC Goa,4481,8,3,5,6,10,16,-6,14
Delhi Dynamo,4482,1,6,6,2,27,17,10,24
Mumbai City,4482,2,6,4,4,18,11,7,22
FC Pune City,4482,3,6,3,5,17,15,2,21
Kolkata,4482,4,4,7,3,16,17,-1,19
Kerala Blast,4482,5,5,4,5,11,15,-4,19
NorthEast Un,4482,6,5,3,6,12,11,1,18
Chennaiyin,4482,7,4,5,5,16,20,-4,17
FC Goa,4482,8,3,2,9,9,20,-11,11
Kerala Blast,4483,1,7,3,4,18,14,4,24
Mumbai City,4483,2,6,5,3,17,9,8,23
Delhi Dynamo,4483,3,5,7,2,27,19,8,22
NorthEast Un,4483,4,5,2,7,13,14,-1,17
Chennaiyin,4483,5,4,5,5,16,19,-3,17
Kolkata,4483,6,3,7,4,16,20,-4,16
FC Pune City,4483,7,4,4,6,13,18,-5,16
FC Goa,4483,8,4,3,7,13,20,-7,15
Mumbai City,4484,1,7,4,3,18,9,9,25
Delhi Dynamo,4484,2,5,6,3,24,17,7,21
Kolkata,4484,3,5,6,3,16,13,3,21
Kerala Blast,4484,4,6,3,5,12,14,-2,21
Chennaiyin,4484,5,5,5,4,16,17,-1,20
FC Pune City,4484,6,4,3,7,12,18,-6,15
FC Goa,4484,7,4,3,7,10,17,-7,15
NorthEast Un,4484,8,4,2,8,9,12,-3,14
Mumbai City,4485,1,7,4,3,19,8,11,25
Delhi Dynamo,4485,2,6,5,3,27,17,10,23
FC Pune City,4485,3,6,3,5,14,14,0,21
Kolkata,4485,4,4,7,3,17,15,2,19
Kerala Blast,4485,5,5,4,5,15,17,-2,19
Chennaiyin,4485,6,3,6,5,14,19,-5,15
NorthEast Un,4485,7,4,3,7,10,16,-6,15
FC Goa,4485,8,4,2,8,10,20,-10,14
Kerala Blast,4486,1,7,3,4,16,14,2,24
Mumbai City,4486,2,6,5,3,17,9,8,23
Delhi Dynamo,4486,3,4,7,3,24,18,6,19
Kolkata,4486,4,4,7,3,18,17,1,19
NorthEast Un,4486,5,5,3,6,12,12,0,18
FC Pune City,4486,6,4,4,6,12,16,-4,16
Chennaiyin,4486,7,3,6,5,14,20,-6,15
FC Goa,4486,8,4,3,7,14,21,-7,15
Mumbai City,4487,1,6,5,3,17,9,8,23
Delhi Dynamo,4487,2,5,6,3,25,18,7,21
Kolkata,4487,3,4,8,2,16,13,3,20
Kerala Blast,4487,4,5,5,4,14,16,-2,20
NorthEast Un,4487,5,5,3,6,12,13,-1,18
Chennaiyin,4487,6,4,6,4,16,18,-2,18
FC Pune City,4487,7,4,5,5,13,15,-2,17
FC Goa,4487,8,3,2,9,10,21,-11,11
Mumbai City,4488,1,7,4,3,18,8,10,25
Delhi Dynamo,4488,2,6,5,3,30,17,13,23
Kolkata,4488,3,5,6,3,16,14,2,21
NorthEast Un,4488,4,5,3,6,13,15,-2,18
FC Goa,4488,5,5,2,7,12,18,-6,17
FC Pune City,4488,6,4,4,6,13,17,-4,16
Kerala Blast,4488,7,4,4,6,10,18,-8,16
Chennaiyin,4488,8,3,6,5,14,19,-5,15
Mumbai City,4489,1,7,4,3,18,8,10,25
Delhi Dynamo,4489,2,6,5,3,25,18,7,23
Kolkata,4489,3,4,8,2,14,12,2,20
Chennaiyin,4489,4,5,5,4,16,18,-2,20
FC Pune City,4489,5,5,4,5,13,14,-1,19
NorthEast Un,4489,6,5,2,7,13,14,-1,17
Kerala Blast,4489,7,4,3,7,10,17,-7,15
FC Goa,4489,8,3,3,8,9,17,-8,12
Delhi Dynamo,4490,1,7,5,2,27,15,12,26
Mumbai City,4490,2,6,4,4,16,9,7,22
Kolkata,4490,3,5,7,2,16,13,3,22
Kerala Blast,4490,4,6,3,5,12,14,-2,21
FC Pune City,4490,5,4,4,6,12,15,-3,16
NorthEast Un,4490,6,4,3,7,11,15,-4,15
Chennaiyin,4490,7,3,6,5,14,19,-5,15
FC Goa,4490,8,4,2,8,10,18,-8,14
Delhi Dynamo,4491,1,6,5,3,25,17,8,23
Mumbai City,4491,2,6,4,4,18,11,7,22
NorthEast Un,4491,3,6,2,6,13,12,1,20
FC Pune City,4491,4,5,4,5,15,15,0,19
Kerala Blast,4491,5,5,4,5,11,16,-5,19
Chennaiyin,4491,6,4,5,5,15,18,-3,17
Kolkata,4491,7,3,7,4,15,17,-2,16
FC Goa,4491,8,4,3,7,10,16,-6,15
Delhi Dynamo,4492,1,7,5,2,26,15,11,26
Mumbai City,4492,2,6,4,4,16,10,6,22
Kerala Blast,4492,3,6,4,4,11,13,-2,22
Kolkata,4492,4,5,6,3,17,14,3,21
Chennaiyin,4492,5,5,5,4,19,18,1,20
NorthEast Un,4492,6,4,3,7,9,12,-3,15
FC Pune City,4492,7,4,3,7,12,16,-4,15
FC Goa,4492,8,3,2,9,11,23,-12,11
Mumbai City,4493,1,7,4,3,17,8,9,25
Kolkata,4493,2,5,7,2,18,12,6,22
Kerala Blast,4493,3,6,4,4,14,14,0,22
Delhi Dynamo,4493,4,5,5,4,24,19,5,20
NorthEast Un,4493,5,5,3,6,14,14,0,18
Chennaiyin,4493,6,4,6,4,19,20,-1,18
FC Pune City,4493,7,4,3,7,13,20,-7,15
FC Goa,4493,8,3,2,9,10,22,-12,11
Mumbai City,4494,1,6,5,3,16,8,8,23
Delhi Dynamo,4494,2,5,6,3,22,16,6,21
Kolkata,4494,3,5,6,3,17,14,3,21
NorthEast Un,4494,4,5,4,5,13,11,2,19
Kerala Blast,4494,5,5,4,5,12,17,-5,19
FC Pune City,4494,6,5,3,6,16,17,-1,18
Chennaiyin,4494,7,3,6,5,15,21,-6,15
FC Goa,4494,8,4,2,8,11,18,-7,14
Mumbai City,4495,1,7,4,3,20,9,11,25
Kerala Blast,4495,2,6,4,4,14,16,-2,22
NorthEast Un,4495,3,5,4,5,14,12,2,19
Delhi Dynamo,4495,4,4,5,5,24,23,1,17
Kolkata,4495,5,3,8,3,16,16,0,17
FC Pune City,4495,6,4,4,6,14,17,-3,16
Chennaiyin,4495,7,3,7,4,16,20,-4,16
FC Goa,4495,8,4,4,6,13,18,-5,16
Delhi Dynamo,4496,1,6,5,3,23,15,8,23
Mumbai City,4496,2,6,4,4,16,9,7,22
Kolkata,4496,3,5,6,3,18,17,1,21
Kerala Blast,4496,4,6,3,5,12,14,-2,21
FC Goa,4496,5,5,2,7,17,17,0,17
NorthEast Un,4496,6,5,2,7,10,13,-3,17
Chennaiyin,4496,7,4,5,5,15,22,-7,17
FC Pune City,4496,8,4,3,7,13,17,-4,15
Mumbai City,4497,1,7,4,3,17,8,9,25
Kerala Blast,4497,2,6,4,4,13,14,-1,22
Kolkata,4497,3,4,8,2,15,13,2,20
Delhi Dynamo,4497,4,4,7,3,23,17,6,19
NorthEast Un,4497,5,5,3,6,15,13,2,18
FC Pune City,4497,6,4,3,7,12,17,-5,15
Chennaiyin,4497,7,3,6,5,14,21,-7,15
FC Goa,4497,8,3,5,6,8,14,-6,14
Delhi Dynamo,4498,1,6,5,3,26,18,8,23
Mumbai City,4498,2,6,4,4,17,10,7,22
Kerala Blast,4498,3,6,3,5,13,17,-4,21
NorthEast Un,4498,4,6,2,6,12,10,2,20
FC Pune City,4498,5,5,4,5,16,15,1,19
Kolkata,4498,6,3,8,3,13,14,-1,17
FC Goa,4498,7,4,3,7,13,19,-6,15
Chennaiyin,4498,8,3,5,6,15,22,-7,14
Mumbai City,4499,1,6,4,4,16,9,7,22
Delhi Dynamo,4499,2,5,6,3,23,16,7,21
FC Goa,4499,3,6,2,6,14,16,-2,20
Kolkata,4499,4,4,7,3,19,15,4,19
FC Pune City,4499,5,5,4,5,15,14,1,19
Kerala Blast,4499,6,5,3,6,11,21,-10,18
NorthEast Un,4499,7,4,4,6,11,13,-2,16
Chennaiyin,4499,8,3,6,5,15,20,-5,15
Mumbai City,4500,1,7,4,3,18,9,9,25
Delhi Dynamo,4500,2,5,6,3,26,18,8,21
NorthEast Un,4500,3,5,4,5,11,10,1,19
Kolkata,4500,4,4,7,3,16,16,0,19
Kerala Blast,4500,5,5,4,5,11,14,-3,19
FC Pune City,4500,6,5,3,6,13,15,-2,18
FC Goa,4500,7,4,3,7,15,20,-5,15
Chennaiyin,4500,8,3,5,6,14,22,-8,14
Mumbai City,4501,1,6,5,3,16,8,8,23
Kerala Blast,4501,2,6,4,4,12,14,-2,22
Delhi Dynamo,4501,3,5,6,3,22,16,6,21
Kolkata,4501,4,4,7,3,16,14,2,19
NorthEast Un,4501,5,5,4,5,13,11,2,19
FC Goa,4501,6,4,3,7,12,17,-5,15
FC Pune City,4501,6,4,3,7,12,17,-5,15
Chennaiyin,4501,8,3,6,5,15,21,-6,15
Mumbai City,4502,1,7,4,3,18,9,9,25
NorthEast Un,4502,2,6,3,5,17,12,5,21
Delhi Dynamo,4502,3,5,5,4,24,19,5,20
FC Pune City,4502,4,5,4,5,13,14,-1,19
Kerala Blast,4502,5,5,3,6,11,18,-7,18
FC Goa,4502,6,5,2,7,13,18,-5,17
Kolkata,4502,7,3,7,4,15,16,-1,16
Chennaiyin,4502,8,3,6,5,15,20,-5,15
Mumbai City,4503,1,6,5,3,17,9,8,23
Delhi Dynamo,4503,2,5,7,2,24,16,8,22
Kerala Blast,4503,3,5,5,4,12,15,-3,20
FC Pune City,4503,4,5,3,6,15,15,0,18
NorthEast Un,4503,5,4,5,5,9,9,0,17
Kolkata,4503,6,3,8,3,15,17,-2,17
Chennaiyin,4503,7,3,7,4,14,18,-4,16
FC Goa,4503,8,3,4,7,10,17,-7,13
Delhi Dynamo,4504,1,6,6,2,25,16,9,24
Mumbai City,4504,2,6,5,3,16,8,8,23
Kolkata,4504,3,4,8,2,17,15,2,20
Kerala Blast,4504,4,5,4,5,11,14,-3,19
NorthEast Un,4504,5,5,2,7,12,13,-1,17
FC Pune City,4504,6,4,5,5,14,16,-2,17
FC Goa,4504,7,4,3,7,12,17,-5,15
Chennaiyin,4504,8,3,5,6,13,21,-8,14
Delhi Dynamo,4505,1,5,7,2,24,15,9,22
Mumbai City,4505,2,6,4,4,16,10,6,22
Kerala Blast,4505,3,5,5,4,12,15,-3,20
FC Pune City,4505,4,5,3,6,14,15,-1,18
NorthEast Un,4505,5,4,5,5,11,11,0,17
Kolkata,4505,6,3,8,3,14,15,-1,17
Chennaiyin,4505,7,3,7,4,13,17,-4,16
FC Goa,4505,8,3,5,6,8,14,-6,14
Mumbai City,4506,1,7,4,3,20,8,12,25
Delhi Dynamo,4506,2,5,5,4,24,21,3,20
Kerala Blast,4506,3,5,5,4,11,14,-3,20
Kolkata,4506,4,4,7,3,16,16,0,19
FC Pune City,4506,5,5,3,6,14,15,-1,18
Chennaiyin,4506,6,4,5,5,17,20,-3,17
FC Goa,4506,7,5,2,7,15,19,-4,17
NorthEast Un,4506,8,4,3,7,9,13,-4,15
Mumbai City,4507,1,7,4,3,17,8,9,25
Delhi Dynamo,4507,2,5,5,4,24,17,7,20
Kolkata,4507,3,4,7,3,16,15,1,19
Kerala Blast,4507,4,5,4,5,13,17,-4,19
NorthEast Un,4507,5,5,3,6,13,13,0,18
FC Goa,4507,6,5,2,7,13,17,-4,17
Chennaiyin,4507,7,4,5,5,14,19,-5,17
FC Pune City,4507,8,4,4,6,12,16,-4,16
Mumbai City,4508,1,7,4,3,19,9,10,25
Kerala Blast,4508,2,6,4,4,15,14,1,22
Delhi Dynamo,4508,3,5,5,4,26,21,5,20
FC Pune City,4508,4,4,5,5,14,16,-2,17
FC Goa,4508,5,5,2,7,15,18,-3,17
NorthEast Un,4508,6,5,2,7,10,13,-3,17
Chennaiyin,4508,7,4,5,5,15,19,-4,17
Kolkata,4508,8,3,7,4,14,18,-4,16
Mumbai City,4509,1,7,4,3,20,10,10,25
Kolkata,4509,2,4,8,2,15,12,3,20
NorthEast Un,4509,3,6,2,6,11,11,0,20
Kerala Blast,4509,4,5,4,5,11,14,-3,19
Delhi Dynamo,4509,5,4,6,4,23,19,4,18
Chennaiyin,4509,6,4,5,5,15,18,-3,17
FC Pune City,4509,7,4,4,6,12,16,-4,16
FC Goa,4509,8,4,3,7,9,16,-7,15
Delhi Dynamo,4510,1,6,6,2,26,17,9,24
Mumbai City,4510,2,6,5,3,17,9,8,23
FC Pune City,4510,3,5,4,5,15,15,0,19
Chennaiyin,4510,4,4,6,4,17,19,-2,18
Kolkata,4510,5,3,8,3,16,17,-1,17
Kerala Blast,4510,6,4,5,5,13,19,-6,17
NorthEast Un,4510,7,4,4,6,14,15,-1,16
FC Goa,4510,8,4,2,8,13,20,-7,14
Mumbai City,4511,1,7,4,3,17,8,9,25
Kolkata,4511,2,5,6,3,18,14,4,21
Delhi Dynamo,4511,3,5,5,4,22,21,1,20
NorthEast Un,4511,4,5,4,5,17,11,6,19
Kerala Blast,4511,5,5,4,5,11,16,-5,19
FC Pune City,4511,6,5,3,6,14,16,-2,18
Chennaiyin,4511,7,3,7,4,16,20,-4,16
FC Goa,4511,8,3,3,8,10,19,-9,12
Mumbai City,4512,1,6,5,3,17,9,8,23
NorthEast Un,4512,2,7,2,5,15,11,4,23
Kolkata,4512,3,5,7,2,19,14,5,22
Kerala Blast,4512,4,5,4,5,12,16,-4,19
Delhi Dynamo,4512,5,4,6,4,23,18,5,18
FC Goa,4512,6,5,2,7,14,18,-4,17
FC Pune City,4512,7,4,3,7,14,20,-6,15
Chennaiyin,4512,8,3,5,6,15,23,-8,14
Mumbai City,4513,1,7,4,3,17,8,9,25
Delhi Dynamo,4513,2,5,6,3,25,18,7,21
FC Pune City,4513,3,6,3,5,17,15,2,21
Kerala Blast,4513,4,6,3,5,14,17,-3,21
Chennaiyin,4513,5,4,6,4,15,18,-3,18
NorthEast Un,4513,6,4,3,7,13,15,-2,15
Kolkata,4513,7,3,6,5,15,19,-4,15
FC Goa,4513,8,4,3,7,11,17,-6,15
Mumbai City,4514,1,7,4,3,17,8,9,25
Kerala Blast,4514,2,7,3,4,19,14,5,24
Delhi Dynamo,4514,3,4,6,4,23,19,4,18
Kolkata,4514,4,4,6,4,17,16,1,18
Chennaiyin,4514,5,4,6,4,17,19,-2,18
FC Pune City,4514,6,5,3,6,13,17,-4,18
NorthEast Un,4514,7,4,4,6,12,16,-4,16
FC Goa,4514,8,4,2,8,13,22,-9,14
Mumbai City,4515,1,7,4,3,19,8,11,25
Kolkata,4515,2,5,7,2,18,14,4,22
Delhi Dynamo,4515,3,5,6,3,24,19,5,21
NorthEast Un,4515,4,5,4,5,12,11,1,19
Chennaiyin,4515,5,4,6,4,17,18,-1,18
Kerala Blast,4515,6,5,3,6,12,16,-4,18
FC Pune City,4515,7,4,3,7,12,18,-6,15
FC Goa,4515,8,3,3,8,10,20,-10,12
Mumbai City,4516,1,7,4,3,19,10,9,25
NorthEast Un,4516,2,7,2,5,14,10,4,23
Kolkata,4516,3,5,6,3,15,13,2,21
FC Goa,4516,4,6,2,6,11,14,-3,20
Kerala Blast,4516,5,5,3,6,10,16,-6,18
Delhi Dynamo,4516,6,4,5,5,24,20,4,17
FC Pune City,4516,7,4,3,7,12,16,-4,15
Chennaiyin,4516,8,3,5,6,13,19,-6,14
Mumbai City,4517,1,6,5,3,16,8,8,23
Delhi Dynamo,4517,2,5,6,3,22,15,7,21
NorthEast Un,4517,3,6,3,5,13,11,2,21
Kolkata,4517,4,4,7,3,16,14,2,19
FC Pune City,4517,5,5,3,6,14,17,-3,18
Kerala Blast,4517,6,5,3,6,12,17,-5,18
Chennaiyin,4517,7,3,6,5,17,22,-5,15
FC Goa,4517,8,4,3,7,11,17,-6,15
Delhi Dynamo,4518,1,7,5,2,26,16,10,26
Mumbai City,4518,2,6,4,4,16,9,7,22
Kolkata,4518,3,5,6,3,17,13,4,21
Kerala Blast,4518,4,5,4,5,11,15,-4,19
FC Goa,4518,5,5,2,7,13,17,-4,17
FC Pune City,4518,6,4,4,6,12,16,-4,16
NorthEast Un,4518,7,4,3,7,11,14,-3,15
Chennaiyin,4518,8,3,6,5,15,21,-6,15
Mumbai City,4519,1,7,4,3,19,8,11,25
Kolkata,4519,2,5,7,2,18,13,5,22
Delhi Dynamo,4519,3,5,5,4,24,20,4,20
NorthEast Un,4519,4,5,3,6,13,13,0,18
Chennaiyin,4519,5,4,6,4,18,20,-2,18
FC Pune City,4519,6,5,3,6,14,17,-3,18
Kerala Blast,4519,7,4,4,6,9,16,-7,16
FC Goa,4519,8,3,4,7,11,19,-8,13
Mumbai City,4520,1,7,4,3,19,9,10,25
Delhi Dynamo,4520,2,6,5,3,27,19,8,23
Kolkata,4520,3,5,6,3,16,13,3,21
Kerala Blast,4520,4,6,3,5,12,16,-4,21
Chennaiyin,4520,5,3,7,4,16,20,-4,16
NorthEast Un,4520,6,4,3,7,12,14,-2,15
FC Pune City,4520,7,4,3,7,12,16,-4,15
FC Goa,4520,8,4,3,7,12,19,-7,15
Delhi Dynamo,4521,1,7,5,2,28,16,12,26
Mumbai City,4521,2,6,4,4,17,12,5,22
Kerala Blast,4521,3,6,3,5,16,17,-1,21
Kolkata,4521,4,4,6,4,15,17,-2,18
FC Pune City,4521,5,5,3,6,15,18,-3,18
FC Goa,4521,6,5,2,7,13,16,-3,17
NorthEast Un,4521,7,4,3,7,12,15,-3,15
Chennaiyin,4521,8,3,6,5,16,21,-5,15
Delhi Dynamo,4522,1,6,6,2,29,18,11,24
Mumbai City,4522,2,6,5,3,18,10,8,23
Kolkata,4522,3,4,7,3,18,18,0,19
FC Goa,4522,4,5,2,7,16,18,-2,17
FC Pune City,4522,4,4,5,5,16,18,-2,17
Chennaiyin,4522,6,4,5,5,14,20,-6,17
Kerala Blast,4522,7,4,5,5,12,18,-6,17
NorthEast Un,4522,8,4,3,7,11,14,-3,15
Delhi Dynamo,4523,1,7,5,2,26,14,12,26
Mumbai City,4523,2,6,4,4,16,10,6,22
Kolkata,4523,3,4,7,3,19,16,3,19
Chennaiyin,4523,4,4,6,4,17,20,-3,18
Kerala Blast,4523,5,5,3,6,11,18,-7,18
NorthEast Un,4523,6,5,2,7,11,13,-2,17
FC Pune City,4523,7,4,4,6,15,18,-3,16
FC Goa,4523,8,4,3,7,12,18,-6,15
Delhi Dynamo,4524,1,5,7,2,26,16,10,22
Mumbai City,4524,2,6,4,4,16,11,5,22
Kolkata,4524,3,5,7,2,17,14,3,22
Kerala Blast,4524,4,6,3,5,15,18,-3,21
NorthEast Un,4524,5,4,4,6,12,13,-1,16
FC Pune City,4524,6,4,4,6,12,15,-3,16
FC Goa,4524,7,4,3,7,12,16,-4,15
Chennaiyin,4524,8,3,6,5,13,20,-7,15
Delhi Dynamo,4525,1,6,6,2,24,15,9,24
Mumbai City,4525,2,6,4,4,16,9,7,22
Kolkata,4525,3,4,8,2,17,15,2,20
Kerala Blast,4525,4,5,5,4,12,15,-3,20
NorthEast Un,4525,5,5,2,7,14,14,0,17
FC Pune City,4525,6,4,4,6,12,15,-3,16
Chennaiyin,4525,7,3,6,5,15,21,-6,15
FC Goa,4525,8,3,5,6,9,15,-6,14
Mumbai City,4526,1,7,4,3,19,10,9,25
Kolkata,4526,2,5,6,3,21,13,8,21
NorthEast Un,4526,3,6,2,6,14,11,3,20
Chennaiyin,4526,4,5,5,4,16,17,-1,20
Kerala Blast,4526,5,5,3,6,12,21,-9,18
Delhi Dynamo,4526,6,4,5,5,23,21,2,17
FC Goa,4526,7,5,2,7,10,15,-5,17
FC Pune City,4526,8,4,3,7,12,19,-7,15
Mumbai City,4527,1,6,5,3,17,9,8,23
Kolkata,4527,2,5,7,2,18,15,3,22
NorthEast Un,4527,3,6,3,5,13,10,3,21
Delhi Dynamo,4527,4,4,7,3,25,20,5,19
Kerala Blast,4527,5,4,6,4,11,15,-4,18
Chennaiyin,4527,6,4,5,5,17,21,-4,17
FC Pune City,4527,7,4,4,6,14,17,-3,16
FC Goa,4527,8,3,3,8,14,22,-8,12
Mumbai City,4528,1,6,5,3,17,9,8,23
Delhi Dynamo,4528,2,5,6,3,25,18,7,21
FC Pune City,4528,3,6,3,5,19,18,1,21
FC Goa,4528,4,6,2,6,12,15,-3,20
Kerala Blast,4528,5,5,4,5,12,16,-4,19
Chennaiyin,4528,6,4,5,5,15,19,-4,17
Kolkata,4528,7,3,7,4,15,17,-2,16
NorthEast Un,4528,8,4,2,8,11,14,-3,14
Mumbai City,4529,1,6,4,4,16,9,7,22
Kerala Blast,4529,2,6,4,4,14,15,-1,22
Delhi Dynamo,4529,3,5,6,3,25,19,6,21
Kolkata,4529,4,4,7,3,18,16,2,19
FC Goa,4529,5,5,3,6,14,18,-4,18
Chennaiyin,4529,6,4,5,5,17,19,-2,17
NorthEast Un,4529,7,5,2,7,13,16,-3,17
FC Pune City,4529,8,4,3,7,13,18,-5,15
Mumbai City,4530,1,7,4,3,21,9,12,25
Kolkata,4530,2,5,7,2,17,12,5,22
Delhi Dynamo,4530,3,5,5,4,26,22,4,20
Chennaiyin,4530,4,5,5,4,17,18,-1,20
Kerala Blast,4530,5,5,4,5,12,16,-4,19
NorthEast Un,4530,6,5,3,6,14,12,2,18
FC Pune City,4530,7,4,3,7,12,18,-6,15
FC Goa,4530,8,3,3,8,8,20,-12,12
Delhi Dynamo,4531,1,6,6,2,26,17,9,24
Mumbai City,4531,2,6,4,4,17,10,7,22
Kolkata,4531,3,5,6,3,19,16,3,21
Kerala Blast,4531,4,6,3,5,13,16,-3,21
NorthEast Un,4531,5,5,3,6,12,11,1,18
Chennaiyin,4531,6,3,7,4,15,19,-4,16
FC Pune City,4531,7,4,3,7,14,18,-4,15
FC Goa,4531,8,3,4,7,12,21,-9,13
Mumbai City,4532,1,7,4,3,18,8,10,25
Delhi Dynamo,4532,2,6,5,3,26,16,10,23
Kolkata,4532,3,5,7,2,20,17,3,22
Kerala Blast,4532,4,5,5,4,15,17,-2,20
NorthEast Un,4532,5,4,4,6,9,13,-4,16
FC Pune City,4532,6,4,3,7,14,19,-5,15
Chennaiyin,4532,7,3,6,5,13,19,-6,15
FC Goa,4532,8,4,2,8,11,17,-6,14
Mumbai City,4533,1,6,5,3,17,9,8,23
Delhi Dynamo,4533,2,5,6,3,23,16,7,21
FC Goa,4533,3,6,2,6,12,15,-3,20
Kolkata,4533,4,4,7,3,18,17,1,19
FC Pune City,4533,5,5,3,6,15,16,-1,18
NorthEast Un,4533,6,5,2,7,11,12,-1,17
Chennaiyin,4533,7,4,5,5,15,19,-4,17
Kerala Blast,4533,8,4,4,6,13,20,-7,16
Mumbai City,4534,1,6,5,3,16,8,8,23
Delhi Dynamo,4534,2,5,6,3,24,17,7,21
Kolkata,4534,3,4,7,3,18,15,3,19
Kerala Blast,4534,4,5,4,5,10,16,-6,19
FC Pune City,4534,5,5,3,6,15,17,-2,18
Chennaiyin,4534,6,4,6,4,14,17,-3,18
NorthEast Un,4534,7,5,2,7,11,11,0,17
FC Goa,4534,8,4,3,7,12,19,-7,15
Delhi Dynamo,4535,1,6,5,3,24,16,8,23
NorthEast Un,4535,2,7,2,5,14,9,5,23
Mumbai City,4535,3,6,4,4,17,10,7,22
Kerala Blast,4535,4,6,3,5,11,16,-5,21
Kolkata,4535,5,4,7,3,15,14,1,19
Chennaiyin,4535,6,4,5,5,16,19,-3,17
FC Pune City,4535,7,4,4,6,13,16,-3,16
FC Goa,4535,8,3,2,9,9,19,-10,11
Mumbai City,4536,1,6,5,3,17,9,8,23
NorthEast Un,4536,2,6,3,5,12,10,2,21
Kerala Blast,4536,3,5,5,4,13,15,-2,20
Delhi Dynamo,4536,4,4,6,4,22,17,5,18
Kolkata,4536,5,3,8,3,16,16,0,17
Chennaiyin,4536,6,4,5,5,15,19,-4,17
FC Goa,4536,7,5,2,7,11,16,-5,17
FC Pune City,4536,8,4,4,6,14,18,-4,16
Mumbai City,4537,1,6,5,3,17,9,8,23
Kerala Blast,4537,2,6,4,4,14,13,1,22
Delhi Dynamo,4537,3,5,6,3,27,18,9,21
FC Goa,4537,4,6,2,6,18,18,0,20
Kolkata,4537,5,3,8,3,17,19,-2,17
FC Pune City,4537,6,4,4,6,14,20,-6,16
NorthEast Un,4537,7,4,3,7,11,15,-4,15
Chennaiyin,4537,8,3,6,5,15,21,-6,15
Delhi Dynamo,4538,1,6,5,3,27,15,12,23
Kolkata,4538,2,5,7,2,19,13,6,22
Mumbai City,4538,3,6,4,4,16,12,4,22
Kerala Blast,4538,4,5,4,5,10,17,-7,19
NorthEast Un,4538,5,5,3,6,10,11,-1,18
Chennaiyin,4538,6,4,6,4,15,17,-2,18
FC Pune City,4538,7,4,4,6,13,16,-3,16
FC Goa,4538,8,3,3,8,8,17,-9,12
Mumbai City,4539,1,7,4,3,19,9,10,25
Kerala Blast,4539,2,7,3,4,14,15,-1,24
Delhi Dynamo,4539,3,5,5,4,26,20,6,20
Kolkata,4539,4,3,8,3,14,14,0,17
NorthEast Un,4539,5,5,2,7,13,14,-1,17
Chennaiyin,4539,6,4,5,5,14,19,-5,17
FC Pune City,4539,7,4,4,6,13,16,-3,16
FC Goa,4539,8,4,3,7,11,17,-6,15
Mumbai City,4540,1,6,5,3,17,9,8,23
Delhi Dynamo,4540,2,5,7,2,24,16,8,22
Kolkata,4540,3,5,6,3,18,15,3,21
FC Pune City,4540,4,5,4,5,15,16,-1,19
Kerala Blast,4540,5,5,4,5,13,16,-3,19
NorthEast Un,4540,6,5,3,6,12,12,0,18
FC Goa,4540,7,4,2,8,10,17,-7,14
Chennaiyin,4540,8,3,5,6,13,21,-8,14
Mumbai City,4541,1,7,4,3,19,10,9,25
Kolkata,4541,2,5,7,2,19,15,4,22
NorthEast Un,4541,3,6,3,5,12,10,2,21
Kerala Blast,4541,4,5,4,5,12,16,-4,19
Delhi Dynamo,4541,5,4,5,5,25,21,4,17
Chennaiyin,4541,6,4,5,5,15,19,-4,17
FC Pune City,4541,7,4,3,7,14,19,-5,15
FC Goa,4541,8,4,3,7,12,18,-6,15
Mumbai City,4542,1,7,4,3,19,10,9,25
Delhi Dynamo,4542,2,6,5,3,28,18,10,23
Kolkata,4542,3,4,8,2,18,14,4,20
NorthEast Un,4542,4,6,2,6,11,12,-1,20
Chennaiyin,4542,5,4,5,5,14,18,-4,17
Kerala Blast,4542,6,4,5,5,10,15,-5,17
FC Pune City,4542,7,4,4,6,14,19,-5,16
FC Goa,4542,8,3,3,8,10,18,-8,12
Mumbai City,4543,1,7,4,3,20,8,12,25
Delhi Dynamo,4543,2,6,5,3,27,18,9,23
Kolkata,4543,3,5,6,3,21,17,4,21
Kerala Blast,4543,4,6,3,5,15,19,-4,21
FC Pune City,4543,5,5,3,6,16,18,-2,18
NorthEast Un,4543,6,5,2,7,12,15,-3,17
Chennaiyin,4543,7,3,5,6,14,22,-8,14
FC Goa,4543,8,4,2,8,12,20,-8,14
Mumbai City,4544,1,6,5,3,17,9,8,23
Delhi Dynamo,4544,2,5,7,2,24,16,8,22
Kerala Blast,4544,3,6,3,5,13,14,-1,21
Kolkata,4544,4,4,7,3,16,17,-1,19
Chennaiyin,4544,5,4,6,4,17,20,-3,18
NorthEast Un,4544,6,4,4,6,10,12,-2,16
FC Pune City,4544,7,4,4,6,13,17,-4,16
FC Goa,4544,8,4,2,8,15,20,-5,14
Mumbai City,4545,1,7,4,3,17,8,9,25
Delhi Dynamo,4545,2,6,5,3,23,15,8,23
Kerala Blast,4545,3,6,4,4,13,14,-1,22
Kolkata,4545,4,5,6,3,18,17,1,21
FC Pune City,4545,5,4,4,6,13,16,-3,16
NorthEast Un,4545,6,4,3,7,11,13,-2,15
Chennaiyin,4545,7,3,6,5,17,22,-5,15
FC Goa,4545,8,4,2,8,12,19,-7,14
Mumbai City,4546,1,7,4,3,18,8,10,25
Delhi Dynamo,4546,2,6,5,3,27,19,8,23
Kerala Blast,4546,3,5,5,4,14,15,-1,20
Kolkata,4546,4,3,9,2,15,14,1,18
NorthEast Un,4546,5,5,3,6,14,14,0,18
FC Pune City,4546,6,4,4,6,13,18,-5,16
FC Goa,4546,7,4,3,7,12,19,-7,15
Chennaiyin,4546,8,3,5,6,14,20,-6,14
Mumbai City,4547,1,6,5,3,16,8,8,23
Delhi Dynamo,4547,2,5,7,2,25,17,8,22
NorthEast Un,4547,3,5,4,5,16,14,2,19
FC Pune City,4547,4,5,4,5,16,16,0,19
Kerala Blast,4547,5,4,6,4,13,17,-4,18
Kolkata,4547,6,3,8,3,14,15,-1,17
FC Goa,4547,7,4,3,7,11,17,-6,15
Chennaiyin,4547,8,3,5,6,16,23,-7,14
Mumbai City,4548,1,7,4,3,20,8,12,25
Kerala Blast,4548,2,6,4,4,14,16,-2,22
Delhi Dynamo,4548,3,5,6,3,26,22,4,21
NorthEast Un,4548,4,5,3,6,15,15,0,18
Chennaiyin,4548,5,4,5,5,17,20,-3,17
Kolkata,4548,6,3,7,4,13,14,-1,16
FC Pune City,4548,7,4,4,6,14,17,-3,16
FC Goa,4548,8,4,3,7,11,18,-7,15
Mumbai City,4549,1,7,4,3,18,8,10,25
NorthEast Un,4549,2,7,2,5,16,12,4,23
Kolkata,4549,3,5,6,3,17,15,2,21
Delhi Dynamo,4549,4,5,5,4,26,19,7,20
FC Goa,4549,5,5,2,7,14,19,-5,17
FC Pune City,4549,6,4,4,6,14,17,-3,16
Kerala Blast,4549,7,4,4,6,11,18,-7,16
Chennaiyin,4549,8,3,5,6,14,22,-8,14
Mumbai City,4550,1,7,4,3,19,8,11,25
Kolkata,4550,2,6,6,2,16,12,4,24
Delhi Dynamo,4550,3,6,5,3,27,17,10,23
Chennaiyin,4550,4,5,5,4,16,18,-2,20
Kerala Blast,4550,5,5,4,5,12,16,-4,19
FC Pune City,4550,6,4,3,7,12,16,-4,15
NorthEast Un,4550,7,4,3,7,11,15,-4,15
FC Goa,4550,8,3,2,9,9,20,-11,11
Delhi Dynamo,4551,1,6,5,3,27,19,8,23
Mumbai City,4551,2,6,4,4,16,11,5,22
Kerala Blast,4551,3,6,3,5,15,17,-2,21
Kolkata,4551,4,4,7,3,16,15,1,19
NorthEast Un,4551,5,5,3,6,14,13,1,18
Chennaiyin,4551,6,4,6,4,16,18,-2,18
FC Pune City,4551,7,4,4,6,14,17,-3,16
FC Goa,4551,8,4,2,8,11,19,-8,14
Delhi Dynamo,4552,1,6,6,2,25,16,9,24
Kolkata,4552,2,6,6,2,19,14,5,24
Mumbai City,4552,3,6,4,4,17,10,7,22
NorthEast Un,4552,4,5,3,6,10,10,0,18
Chennaiyin,4552,5,4,5,5,15,20,-5,17
FC Pune City,4552,6,4,4,6,15,18,-3,16
Kerala Blast,4552,7,4,4,6,11,18,-7,16
FC Goa,4552,8,4,2,8,13,19,-6,14
Mumbai City,4553,1,7,4,3,19,9,10,25
Delhi Dynamo,4553,2,5,6,3,26,20,6,21
FC Pune City,4553,3,5,4,5,14,15,-1,19
FC Goa,4553,4,5,3,6,13,17,-4,18
Kolkata,4553,5,3,8,3,16,16,0,17
Kerala Blast,4553,6,4,5,5,11,16,-5,17
NorthEast Un,4553,7,4,4,6,11,12,-1,16
Chennaiyin,4553,8,3,6,5,13,18,-5,15
Mumbai City,4554,1,7,4,3,19,10,9,25
Delhi Dynamo,4554,2,6,5,3,26,18,8,23
Kerala Blast,4554,3,5,5,4,12,15,-3,20
Kolkata,4554,4,4,7,3,15,16,-1,19
FC Goa,4554,5,5,2,7,14,17,-3,17
FC Pune City,4554,6,4,4,6,14,17,-3,16
NorthEast Un,4554,7,4,3,7,10,12,-2,15
Chennaiyin,4554,8,3,6,5,14,19,-5,15
Mumbai City,4555,1,7,4,3,18,8,10,25
Kerala Blast,4555,2,6,3,5,14,16,-2,21
Delhi Dynamo,4555,3,5,5,4,22,17,5,20
NorthEast Un,4555,4,6,2,6,12,11,1,20
Kolkata,4555,5,4,7,3,17,15,2,19
FC Pune City,4555,6,5,4,5,15,16,-1,19
Chennaiyin,4555,7,3,5,6,14,21,-7,14
FC Goa,4555,8,4,2,8,10,18,-8,14
Mumbai City,4556,1,6,5,3,16,8,8,23
Delhi Dynamo,4556,2,5,6,3,22,15,7,21
FC Pune City,4556,3,6,3,5,14,14,0,21
Kerala Blast,4556,4,5,4,5,13,17,-4,19
Kolkata,4556,5,4,6,4,14,14,0,18
FC Goa,4556,6,5,2,7,12,17,-5,17
NorthEast Un,4556,7,4,4,6,12,13,-1,16
Chennaiyin,4556,8,3,6,5,15,20,-5,15
Delhi Dynamo,4557,1,6,6,2,27,18,9,24
Mumbai City,4557,2,6,5,3,17,9,8,23
Kolkata,4557,3,5,6,3,18,14,4,21
Kerala Blast,4557,4,6,3,5,12,15,-3,21
NorthEast Un,4557,5,5,2,7,12,13,-1,17
Chennaiyin,4557,6,3,6,5,15,20,-5,15
FC Pune City,4557,7,4,3,7,14,20,-6,15
FC Goa,4557,8,4,3,7,12,18,-6,15
Mumbai City,4558,1,7,4,3,20,10,10,25
NorthEast Un,4558,2,7,2,5,16,11,5,23
Kolkata,4558,3,5,6,3,18,16,2,21
FC Pune City,4558,4,5,3,6,15,16,-1,18
Kerala Blast,4558,5,5,3,6,11,18,-7,18
Delhi Dynamo,4558,6,4,5,5,24,21,3,17
FC Goa,4558,7,5,2,7,12,17,-5,17
Chennaiyin,4558,8,3,5,6,14,21,-7,14
Mumbai City,4559,1,7,4,3,19,8,11,25
NorthEast Un,4559,2,7,2,5,16,10,6,23
FC Pune City,4559,3,6,3,5,17,14,3,21
Delhi Dynamo,4559,4,5,5,4,25,20,5,20
Chennaiyin,4559,5,4,5,5,15,21,-6,17
Kolkata,4559,6,3,7,4,15,18,-3,16
Kerala Blast,4559,7,4,4,6,10,19,-9,16
FC Goa,4559,8,4,2,8,13,20,-7,14
Mumbai City,4560,1,7,4,3,17,8,9,25
Kolkata,4560,2,5,7,2,17,13,4,22
Delhi Dynamo,4560,3,5,6,3,26,18,8,21
FC Pune City,4560,4,5,4,5,15,16,-1,19
Kerala Blast,4560,5,5,3,6,13,17,-4,18
NorthEast Un,4560,6,4,4,6,12,15,-3,16
Chennaiyin,4560,7,3,6,5,16,22,-6,15
FC Goa,4560,8,4,2,8,13,20,-7,14
Mumbai City,4561,1,6,5,3,17,9,8,23
Kolkata,4561,2,4,7,3,15,13,2,19
Kerala Blast,4561,3,5,4,5,13,18,-5,19
Delhi Dynamo,4561,4,4,6,4,22,19,3,18
NorthEast Un,4561,5,5,3,6,14,12,2,18
Chennaiyin,4561,6,4,6,4,16,19,-3,18
FC Pune City,4561,7,4,5,5,14,16,-2,17
FC Goa,4561,8,5,2,7,11,16,-5,17
Mumbai City,4562,1,6,5,3,18,10,8,23
Kolkata,4562,2,5,7,2,17,14,3,22
Delhi Dynamo,4562,3,5,6,3,26,18,8,21
NorthEast Un,4562,4,6,2,6,11,11,0,20
FC Pune City,4562,5,5,3,6,15,17,-2,18
Kerala Blast,4562,6,5,3,6,12,16,-4,18
FC Goa,4562,7,4,3,7,12,19,-7,15
Chennaiyin,4562,8,3,5,6,14,20,-6,14
Mumbai City,4563,1,7,4,3,18,8,10,25
Delhi Dynamo,4563,2,6,5,3,30,17,13,23
Kerala Blast,4563,3,6,3,5,11,15,-4,21
Chennaiyin,4563,4,5,5,4,16,18,-2,20
FC Pune City,4563,5,5,4,5,15,15,0,19
Kolkata,4563,6,3,7,4,14,15,-1,16
NorthEast Un,4563,7,4,2,8,9,14,-5,14
FC Goa,4563,8,4,2,8,11,22,-11,14
Mumbai City,4564,1,7,4,3,17,8,9,25
Kerala Blast,4564,2,7,3,4,14,15,-1,24
Delhi Dynamo,4564,3,5,5,4,23,18,5,20
NorthEast Un,4564,4,5,3,6,12,10,2,18
Kolkata,4564,5,4,6,4,16,18,-2,18
FC Goa,4564,6,5,2,7,15,19,-4,17
FC Pune City,4564,7,4,3,7,13,17,-4,15
Chennaiyin,4564,8,3,6,5,15,20,-5,15
Delhi Dynamo,4565,1,6,5,3,28,17,11,23
Mumbai City,4565,2,6,4,4,16,12,4,22
Kerala Blast,4565,3,6,3,5,16,18,-2,21
Kolkata,4565,4,4,6,4,17,16,1,18
FC Pune City,4565,5,5,3,6,15,19,-4,18
FC Goa,4565,6,5,3,6,14,18,-4,18
Chennaiyin,4565,7,3,7,4,15,19,-4,16
NorthEast Un,4565,8,4,3,7,10,12,-2,15
Delhi Dynamo,4566,1,7,5,2,28,16,12,26
Mumbai City,4566,2,6,4,4,16,9,7,22
Kolkata,4566,3,4,7,3,15,14,1,19
Kerala Blast,4566,4,5,4,5,14,17,-3,19
NorthEast Un,4566,5,5,3,6,14,13,1,18
FC Pune City,4566,6,4,4,6,14,18,-4,16
Chennaiyin,4566,7,3,6,5,14,20,-6,15
FC Goa,4566,8,4,3,7,11,19,-8,15
Mumbai City,4567,1,6,4,4,16,10,6,22
Delhi Dynamo,4567,2,5,5,4,25,18,7,20
NorthEast Un,4567,3,6,2,6,13,12,1,20
Kolkata,4567,4,4,7,3,19,16,3,19
Chennaiyin,4567,5,4,6,4,14,17,-3,18
FC Goa,4567,6,5,3,6,13,17,-4,18
FC Pune City,4567,7,4,5,5,13,15,-2,17
Kerala Blast,4567,8,4,4,6,10,18,-8,16
Mumbai City,4568,1,7,4,3,18,9,9,25
Kolkata,4568,2,5,7,2,16,13,3,22
NorthEast Un,4568,3,6,3,5,14,12,2,21
Delhi Dynamo,4568,4,5,5,4,23,17,6,20
FC Pune City,4568,5,4,5,5,13,15,-2,17
Chennaiyin,4568,6,4,5,5,17,20,-3,17
Kerala Blast,4568,7,4,5,5,11,16,-5,17
FC Goa,4568,8,3,2,9,9,19,-10,11
Mumbai City,4569,1,7,4,3,19,9,10,25
NorthEast Un,4569,2,6,2,6,11,10,1,20
FC Goa,4569,3,6,2,6,16,16,0,20
FC Pune City,4569,4,5,4,5,15,15,0,19
Kolkata,4569,5,4,6,4,16,17,-1,18
Delhi Dynamo,4569,6,4,5,5,22,20,2,17
Chennaiyin,4569,7,4,5,5,16,20,-4,17
Kerala Blast,4569,8,4,4,6,10,18,-8,16
Mumbai City,4570,1,7,4,3,18,8,10,25
Kolkata,4570,2,6,6,2,18,14,4,24
Delhi Dynamo,4570,3,5,6,3,26,16,10,21
Kerala Blast,4570,4,6,3,5,12,15,-3,21
Chennaiyin,4570,5,4,5,5,16,19,-3,17
NorthEast Un,4570,6,4,3,7,9,12,-3,15
FC Pune City,4570,7,4,3,7,13,17,-4,15
FC Goa,4570,8,4,2,8,10,21,-11,14
Mumbai City,4571,1,6,5,3,16,8,8,23
Delhi Dynamo,4571,2,5,7,2,25,15,10,22
NorthEast Un,4571,3,5,4,5,12,11,1,19
FC Pune City,4571,4,5,4,5,14,15,-1,19
Chennaiyin,4571,5,4,6,4,14,17,-3,18
Kolkata,4571,6,3,8,3,15,16,-1,17
Kerala Blast,4571,7,4,4,6,11,17,-6,16
FC Goa,4571,8,4,2,8,10,18,-8,14
Mumbai City,4572,1,7,4,3,19,9,10,25
Kolkata,4572,2,5,7,2,19,16,3,22
Delhi Dynamo,4572,3,5,5,4,25,19,6,20
Chennaiyin,4572,4,5,5,4,18,18,0,20
Kerala Blast,4572,5,5,4,5,14,18,-4,19
NorthEast Un,4572,6,5,3,6,12,14,-2,18
FC Pune City,4572,7,4,3,7,14,18,-4,15
FC Goa,4572,8,3,3,8,10,19,-9,12
Mumbai City,4573,1,7,4,3,18,9,9,25
Kerala Blast,4573,2,6,4,4,13,14,-1,22
Delhi Dynamo,4573,3,5,5,4,24,18,6,20
NorthEast Un,4573,4,5,3,6,12,12,0,18
FC Goa,4573,5,5,3,6,14,17,-3,18
Kolkata,4573,6,3,8,3,17,18,-1,17
FC Pune City,4573,7,4,4,6,13,16,-3,16
Chennaiyin,4573,8,3,5,6,15,22,-7,14
Mumbai City,4574,1,7,4,3,17,8,9,25
Kolkata,4574,2,5,7,2,18,13,5,22
Delhi Dynamo,4574,3,5,6,3,24,15,9,21
NorthEast Un,4574,4,5,4,5,13,10,3,19
Kerala Blast,4574,5,5,4,5,10,16,-6,19
FC Pune City,4574,6,4,4,6,13,16,-3,16
Chennaiyin,4574,7,3,6,5,16,23,-7,15
FC Goa,4574,8,3,3,8,10,20,-10,12
Mumbai City,4575,1,7,4,3,17,8,9,25
Kolkata,4575,2,5,6,3,17,16,1,21
Kerala Blast,4575,3,6,3,5,12,15,-3,21
Delhi Dynamo,4575,4,4,7,3,22,16,6,19
NorthEast Un,4575,5,5,3,6,12,12,0,18
Chennaiyin,4575,6,4,5,5,15,19,-4,17
FC Goa,4575,7,4,3,7,12,16,-4,15
FC Pune City,4575,8,4,3,7,13,18,-5,15
Delhi Dynamo,4576,1,6,5,3,25,17,8,23
Mumbai City,4576,2,6,4,4,16,9,7,22
NorthEast Un,4576,3,6,2,6,15,14,1,20
Kolkata,4576,4,4,7,3,15,14,1,19
Kerala Blast,4576,5,5,3,6,12,16,-4,18
Chennaiyin,4576,6,4,5,5,17,20,-3,17
FC Goa,4576,7,5,2,7,11,17,-6,17
FC Pune City,4576,8,4,4,6,13,17,-4,16
Delhi Dynamo,4577,1,7,5,2,27,14,13,26
Mumbai City,4577,2,6,4,4,16,11,5,22
Kolkata,4577,3,5,7,2,18,15,3,22
FC Pune City,4577,4,5,4,5,14,15,-1,19
NorthEast Un,4577,5,5,3,6,14,15,-1,18
Chennaiyin,4577,6,3,7,4,15,19,-4,16
Kerala Blast,4577,7,4,3,7,13,20,-7,15
FC Goa,4577,8,3,3,8,10,18,-8,12
Mumbai City,4578,1,6,5,3,17,9,8,23
Kolkata,4578,2,5,7,2,20,16,4,22
Delhi Dynamo,4578,3,4,6,4,24,19,5,18
FC Pune City,4578,4,5,3,6,17,19,-2,18
NorthEast Un,4578,5,5,3,6,11,13,-2,18
Chennaiyin,4578,6,4,5,5,16,18,-2,17
FC Goa,4578,7,5,2,7,13,18,-5,17
Kerala Blast,4578,8,4,5,5,10,16,-6,17
Mumbai City,4579,1,6,5,3,17,9,8,23
Kolkata,4579,2,5,7,2,18,14,4,22
Delhi Dynamo,4579,3,5,6,3,25,18,7,21
Kerala Blast,4579,4,5,4,5,14,17,-3,19
FC Pune City,4579,5,5,3,6,16,18,-2,18
NorthEast Un,4579,6,5,2,7,12,14,-2,17
FC Goa,4579,7,5,2,7,12,16,-4,17
Chennaiyin,4579,8,3,5,6,13,21,-8,14
Kolkata,4580,1,6,6,2,23,15,8,24
Mumbai City,4580,2,6,4,4,17,10,7,22
Delhi Dynamo,4580,3,5,5,4,25,20,5,20
NorthEast Un,4580,4,6,2,6,14,11,3,20
FC Pune City,4580,5,5,3,6,15,17,-2,18
FC Goa,4580,6,5,2,7,14,18,-4,17
Chennaiyin,4580,7,4,5,5,14,19,-5,17
Kerala Blast,4580,8,4,3,7,10,22,-12,15
Delhi Dynamo,4581,1,6,6,2,25,15,10,24
Mumbai City,4581,2,6,4,4,17,10,7,22
NorthEast Un,4581,3,6,3,5,13,9,4,21
Kolkata,4581,4,5,6,3,19,16,3,21
FC Pune City,4581,5,6,3,5,15,15,0,21
Kerala Blast,4581,6,4,3,7,10,19,-9,15
Chennaiyin,4581,7,3,5,6,13,20,-7,14
FC Goa,4581,8,4,2,8,10,18,-8,14
Delhi Dynamo,4582,1,6,5,3,25,16,9,23
Mumbai City,4582,2,6,4,4,16,10,6,22
NorthEast Un,4582,3,6,2,6,13,11,2,20
Chennaiyin,4582,4,5,5,4,15,17,-2,20
Kolkata,4582,5,4,7,3,16,18,-2,19
FC Pune City,4582,6,4,5,5,13,15,-2,17
Kerala Blast,4582,7,4,4,6,12,18,-6,16
FC Goa,4582,8,4,2,8,13,18,-5,14
Mumbai City,4583,1,7,4,3,18,8,10,25
Kolkata,4583,2,6,6,2,19,14,5,24
Delhi Dynamo,4583,3,5,5,4,23,17,6,20
NorthEast Un,4583,4,5,3,6,12,13,-1,18
FC Pune City,4583,5,5,3,6,13,15,-2,18
Chennaiyin,4583,6,4,6,4,17,20,-3,18
Kerala Blast,4583,7,5,3,6,12,16,-4,18
FC Goa,4583,8,3,2,9,12,23,-11,11
Mumbai City,4584,1,7,4,3,18,9,9,25
Kerala Blast,4584,2,5,4,5,16,19,-3,19
Delhi Dynamo,4584,3,4,6,4,22,17,5,18
Kolkata,4584,4,3,9,2,16,15,1,18
NorthEast Un,4584,5,5,3,6,11,11,0,18
Chennaiyin,4584,6,4,6,4,15,18,-3,18
FC Pune City,4584,7,4,4,6,14,18,-4,16
FC Goa,4584,8,4,4,6,11,16,-5,16
Mumbai City,4585,1,7,4,3,18,8,10,25
Kolkata,4585,2,5,6,3,21,17,4,21
Delhi Dynamo,4585,3,5,5,4,25,20,5,20
NorthEast Un,4585,4,5,4,5,12,10,2,19
Kerala Blast,4585,5,5,4,5,11,17,-6,19
FC Goa,4585,6,5,2,7,16,20,-4,17
FC Pune City,4585,7,4,3,7,12,17,-5,15
Chennaiyin,4585,8,3,6,5,14,20,-6,15
Mumbai City,4586,1,6,5,3,16,8,8,23
Delhi Dynamo,4586,2,5,7,2,22,14,8,22
Kolkata,4586,3,5,6,3,18,14,4,21
FC Pune City,4586,4,5,3,6,13,17,-4,18
FC Goa,4586,5,5,3,6,11,15,-4,18
NorthEast Un,4586,6,5,2,7,13,15,-2,17
Chennaiyin,4586,7,4,5,5,17,20,-3,17
Kerala Blast,4586,8,4,3,7,12,19,-7,15
Mumbai City,4587,1,7,4,3,17,8,9,25
Kerala Blast,4587,2,6,4,4,13,15,-2,22
Kolkata,4587,3,4,7,3,16,14,2,19
Delhi Dynamo,4587,4,4,6,4,25,21,4,18
Chennaiyin,4587,5,4,5,5,19,19,0,17
FC Goa,4587,6,5,2,7,13,18,-5,17
FC Pune City,4587,7,4,4,6,14,17,-3,16
NorthEast Un,4587,8,4,4,6,13,18,-5,16
Delhi Dynamo,4588,1,6,5,3,23,16,7,23
Mumbai City,4588,2,6,4,4,16,9,7,22
FC Pune City,4588,3,5,4,5,16,17,-1,19
Kerala Blast,4588,4,5,4,5,13,16,-3,19
Kolkata,4588,5,3,8,3,16,16,0,17
NorthEast Un,4588,6,5,2,7,11,13,-2,17
Chennaiyin,4588,7,4,5,5,15,18,-3,17
FC Goa,4588,8,5,2,7,10,15,-5,17
Delhi Dynamo,4589,1,6,6,2,26,16,10,24
Kolkata,4589,2,6,6,2,20,12,8,24
Mumbai City,4589,3,6,5,3,17,9,8,23
NorthEast Un,4589,4,5,3,6,14,13,1,18
Chennaiyin,4589,5,4,5,5,17,22,-5,17
Kerala Blast,4589,6,4,5,5,12,18,-6,17
FC Pune City,4589,7,4,4,6,15,21,-6,16
FC Goa,4589,8,3,2,9,9,19,-10,11
Mumbai City,4590,1,7,4,3,18,9,9,25
Kolkata,4590,2,6,6,2,18,12,6,24
Delhi Dynamo,4590,3,5,6,3,27,19,8,21
NorthEast Un,4590,4,6,3,5,17,13,4,21
FC Pune City,4590,5,5,3,6,14,18,-4,18
Chennaiyin,4590,6,3,6,5,14,19,-5,15
Kerala Blast,4590,7,4,3,7,10,19,-9,15
FC Goa,4590,8,3,3,8,8,17,-9,12
Mumbai City,4591,1,7,4,3,18,9,9,25
FC Goa,4591,2,6,2,6,15,16,-1,20
Kerala Blast,4591,3,5,5,4,11,13,-2,20
Kolkata,4591,4,4,7,3,15,16,-1,19
NorthEast Un,4591,5,5,3,6,13,10,3,18
Delhi Dynamo,4591,6,4,5,5,22,21,1,17
Chennaiyin,4591,7,4,5,5,16,20,-4,17
FC Pune City,4591,8,4,3,7,13,18,-5,15
Delhi Dynamo,4592,1,6,5,3,24,16,8,23
Mumbai City,4592,2,6,4,4,16,9,7,22
FC Goa,4592,3,6,2,6,16,15,1,20
Kerala Blast,4592,4,5,5,4,13,16,-3,20
Kolkata,4592,5,4,7,3,18,15,3,19
Chennaiyin,4592,6,4,5,5,14,22,-8,17
FC Pune City,4592,7,4,4,6,13,18,-5,16
NorthEast Un,4592,8,4,2,8,9,12,-3,14
Mumbai City,4593,1,7,4,3,17,8,9,25
Kolkata,4593,2,5,6,3,16,14,2,21
Delhi Dynamo,4593,3,5,5,4,23,17,6,20
NorthEast Un,4593,4,6,2,6,15,13,2,20
FC Pune City,4593,5,5,4,5,15,16,-1,19
Kerala Blast,4593,6,5,4,5,12,16,-4,19
Chennaiyin,4593,7,3,5,6,15,22,-7,14
FC Goa,4593,8,4,2,8,10,17,-7,14
Mumbai City,4594,1,7,4,3,20,10,10,25
Delhi Dynamo,4594,2,5,6,3,28,22,6,21
NorthEast Un,4594,3,5,4,5,15,13,2,19
Kolkata,4594,4,4,7,3,16,15,1,19
Chennaiyin,4594,5,4,6,4,18,21,-3,18
Kerala Blast,4594,6,5,3,6,12,17,-5,18
FC Pune City,4594,7,4,4,6,14,18,-4,16
FC Goa,4594,8,4,2,8,14,21,-7,14
Delhi Dynamo,4595,1,6,6,2,26,17,9,24
Mumbai City,4595,2,6,4,4,17,10,7,22
Kerala Blast,4595,3,6,3,5,13,15,-2,21
Kolkata,4595,4,4,6,4,14,14,0,18
Chennaiyin,4595,5,4,6,4,17,19,-2,18
FC Pune City,4595,6,5,3,6,13,15,-2,18
NorthEast Un,4595,7,4,3,7,12,16,-4,15
FC Goa,4595,8,4,3,7,11,17,-6,15
Mumbai City,4596,1,7,4,3,18,8,10,25
Kerala Blast,4596,2,6,3,5,13,16,-3,21
Delhi Dynamo,4596,3,5,5,4,25,17,8,20
Kolkata,4596,4,4,6,4,16,16,0,18
NorthEast Un,4596,5,5,3,6,11,11,0,18
FC Pune City,4596,6,5,3,6,13,15,-2,18
FC Goa,4596,7,5,2,7,11,19,-8,17
Chennaiyin,4596,8,3,6,5,13,18,-5,15
Delhi Dynamo,4597,1,6,6,2,27,15,12,24
Mumbai City,4597,2,6,5,3,16,8,8,23
Kolkata,4597,3,5,7,2,19,14,5,22
Kerala Blast,4597,4,5,4,5,12,18,-6,19
NorthEast Un,4597,5,5,3,6,12,12,0,18
FC Pune City,4597,6,4,3,7,13,17,-4,15
Chennaiyin,4597,7,3,6,5,16,21,-5,15
FC Goa,4597,8,3,4,7,13,23,-10,13
Mumbai City,4598,1,7,4,3,20,8,12,25
NorthEast Un,4598,2,6,3,5,16,10,6,21
Kerala Blast,4598,3,5,4,5,11,15,-4,19
Kolkata,4598,4,4,6,4,16,15,1,18
Delhi Dynamo,4598,5,4,6,4,24,24,0,18
FC Pune City,4598,6,5,3,6,13,16,-3,18
FC Goa,4598,7,5,3,6,12,16,-4,18
Chennaiyin,4598,8,3,5,6,13,21,-8,14
Delhi Dynamo,4599,1,6,6,2,26,17,9,24
Mumbai City,4599,2,6,4,4,18,11,7,22
Kolkata,4599,3,5,7,2,18,15,3,22
Kerala Blast,4599,4,5,4,5,13,17,-4,19
NorthEast Un,4599,5,5,2,7,14,15,-1,17
FC Pune City,4599,6,4,5,5,16,18,-2,17
FC Goa,4599,7,4,3,7,12,17,-5,15
Chennaiyin,4599,8,3,5,6,16,23,-7,14
Mumbai City,4600,1,7,4,3,17,8,9,25
Delhi Dynamo,4600,2,5,6,3,25,18,7,21
Kerala Blast,4600,3,6,3,5,12,18,-6,21
Kolkata,4600,4,4,6,4,18,15,3,18
NorthEast Un,4600,5,5,3,6,15,14,1,18
FC Pune City,4600,6,5,3,6,13,15,-2,18
FC Goa,4600,7,5,2,7,12,17,-5,17
Chennaiyin,4600,8,3,5,6,14,21,-7,14
Delhi Dynamo,4601,1,6,6,2,25,16,9,24
Mumbai City,4601,2,6,4,4,18,11,7,22
Kolkata,4601,3,5,7,2,19,16,3,22
Kerala Blast,4601,4,5,4,5,16,18,-2,19
NorthEast Un,4601,5,5,3,6,13,11,2,18
FC Pune City,4601,6,4,4,6,13,18,-5,16
Chennaiyin,4601,7,3,6,5,14,21,-7,15
FC Goa,4601,8,3,4,7,9,16,-7,13
Mumbai City,4602,1,7,4,3,18,8,10,25
Kolkata,4602,2,5,6,3,17,17,0,21
Kerala Blast,4602,3,5,4,5,12,16,-4,19
NorthEast Un,4602,4,5,3,6,11,11,0,18
Chennaiyin,4602,5,4,6,4,16,17,-1,18
Delhi Dynamo,4602,6,4,5,5,22,20,2,17
FC Goa,4602,7,5,2,7,13,17,-4,17
FC Pune City,4602,8,4,4,6,14,17,-3,16
Mumbai City,4603,1,7,4,3,18,8,10,25
Delhi Dynamo,4603,2,5,5,4,23,17,6,20
FC Goa,4603,3,6,2,6,12,14,-2,20
Kolkata,4603,4,4,7,3,18,17,1,19
Kerala Blast,4603,5,4,6,4,13,17,-4,18
Chennaiyin,4603,6,4,5,5,17,20,-3,17
FC Pune City,4603,7,4,4,6,13,17,-4,16
NorthEast Un,4603,8,4,3,7,11,15,-4,15
Mumbai City,4604,1,6,5,3,17,9,8,23
Delhi Dynamo,4604,2,5,7,2,27,17,10,22
Kolkata,4604,3,5,7,2,18,14,4,22
Kerala Blast,4604,4,6,3,5,14,17,-3,21
NorthEast Un,4604,5,4,4,6,13,14,-1,16
FC Pune City,4604,6,4,4,6,14,18,-4,16
Chennaiyin,4604,7,3,6,5,16,21,-5,15
FC Goa,4604,8,4,2,8,12,21,-9,14
Mumbai City,4605,1,7,4,3,19,9,10,25
Kolkata,4605,2,5,6,3,19,14,5,21
Kerala Blast,4605,3,6,3,5,14,16,-2,21
Delhi Dynamo,4605,4,5,5,4,26,20,6,20
NorthEast Un,4605,5,6,2,6,14,14,0,20
FC Goa,4605,6,5,2,7,10,16,-6,17
FC Pune City,4605,7,4,3,7,13,20,-7,15
Chennaiyin,4605,8,3,5,6,14,20,-6,14
Mumbai City,4606,1,7,4,3,18,8,10,25
Kerala Blast,4606,2,6,4,4,15,16,-1,22
Delhi Dynamo,4606,3,5,5,4,22,17,5,20
Kolkata,4606,4,4,7,3,15,15,0,19
Chennaiyin,4606,5,4,6,4,15,18,-3,18
NorthEast Un,4606,6,5,2,7,11,13,-2,17
FC Pune City,4606,7,4,3,7,13,17,-4,15
FC Goa,4606,8,4,3,7,11,16,-5,15
Mumbai City,4607,1,7,4,3,17,8,9,25
Kolkata,4607,2,5,7,2,18,14,4,22
Delhi Dynamo,4607,3,5,6,3,23,16,7,21
FC Pune City,4607,4,5,3,6,15,17,-2,18
NorthEast Un,4607,5,4,5,5,13,13,0,17
Kerala Blast,4607,6,4,5,5,13,19,-6,17
Chennaiyin,4607,7,3,7,4,15,19,-4,16
FC Goa,4607,8,3,3,8,10,18,-8,12
Mumbai City,4608,1,7,4,3,19,10,9,25
Delhi Dynamo,4608,2,5,6,3,29,20,9,21
Kerala Blast,4608,3,5,4,5,12,16,-4,19
Kolkata,4608,4,4,6,4,17,17,0,18
FC Pune City,4608,5,5,3,6,15,17,-2,18
Chennaiyin,4608,6,4,6,4,14,17,-3,18
FC Goa,4608,7,4,4,6,10,15,-5,16
NorthEast Un,4608,8,4,3,7,12,16,-4,15
Delhi Dynamo,4609,1,6,5,3,25,17,8,23
Mumbai City,4609,2,6,4,4,16,9,7,22
NorthEast Un,4609,3,6,3,5,12,10,2,21
FC Pune City,4609,4,5,4,5,17,17,0,19
Kerala Blast,4609,5,5,4,5,13,16,-3,19
Kolkata,4609,6,3,7,4,15,18,-3,16
Chennaiyin,4609,7,3,6,5,13,18,-5,15
FC Goa,4609,8,4,3,7,11,17,-6,15
Mumbai City,4610,1,6,5,3,16,8,8,23
Delhi Dynamo,4610,2,5,7,2,27,18,9,22
Kolkata,4610,3,5,6,3,21,21,0,21
Kerala Blast,4610,4,5,4,5,13,18,-5,19
Chennaiyin,4610,5,4,6,4,17,19,-2,18
NorthEast Un,4610,6,4,4,6,13,15,-2,16
FC Goa,4610,7,4,3,7,17,20,-3,15
FC Pune City,4610,8,4,3,7,13,18,-5,15
Mumbai City,4611,1,7,4,3,17,8,9,25
Delhi Dynamo,4611,2,6,5,3,28,15,13,23
Kerala Blast,4611,3,6,4,4,14,14,0,22
FC Pune City,4611,4,4,5,5,13,15,-2,17
NorthEast Un,4611,5,5,2,7,11,15,-4,17
FC Goa,4611,6,5,2,7,11,20,-9,17
Kolkata,4611,7,3,7,4,16,17,-1,16
Chennaiyin,4611,8,3,5,6,14,20,-6,14
Mumbai City,4612,1,7,4,3,18,9,9,25
Delhi Dynamo,4612,2,6,5,3,28,18,10,23
NorthEast Un,4612,3,6,2,6,15,12,3,20
FC Pune City,4612,4,5,4,5,13,14,-1,19
FC Goa,4612,5,5,2,7,14,18,-4,17
Kerala Blast,4612,6,4,5,5,10,16,-6,17
Kolkata,4612,7,3,7,4,15,17,-2,16
Chennaiyin,4612,8,3,5,6,13,22,-9,14
Mumbai City,4613,1,6,5,3,16,8,8,23
Delhi Dynamo,4613,2,5,6,3,24,16,8,21
Kerala Blast,4613,3,6,3,5,14,16,-2,21
FC Pune City,4613,4,5,4,5,15,16,-1,19
Chennaiyin,4613,5,4,6,4,19,18,1,18
NorthEast Un,4613,6,5,3,6,12,13,-1,18
Kolkata,4613,7,3,7,4,16,17,-1,16
FC Goa,4613,8,4,2,8,12,24,-12,14
Mumbai City,4614,1,7,4,3,20,8,12,25
Delhi Dynamo,4614,2,6,5,3,29,22,7,23
Kolkata,4614,3,5,7,2,17,14,3,22
Kerala Blast,4614,4,5,5,4,12,13,-1,20
FC Pune City,4614,5,4,4,6,14,17,-3,16
Chennaiyin,4614,6,3,7,4,13,17,-4,16
NorthEast Un,4614,7,4,3,7,11,16,-5,15
FC Goa,4614,8,3,3,8,10,19,-9,12
Delhi Dynamo,4615,1,7,5,2,27,16,11,26
Kerala Blast,4615,2,7,3,4,15,16,-1,24
Mumbai City,4615,3,6,4,4,18,11,7,22
FC Pune City,4615,4,5,3,6,15,17,-2,18
Chennaiyin,4615,5,4,6,4,17,20,-3,18
Kolkata,4615,6,3,6,5,14,17,-3,15
FC Goa,4615,7,4,3,7,12,18,-6,15
NorthEast Un,4615,8,4,2,8,10,13,-3,14
Mumbai City,4616,1,6,4,4,18,11,7,22
Kerala Blast,4616,2,6,4,4,14,13,1,22
Delhi Dynamo,4616,3,5,6,3,28,21,7,21
Chennaiyin,4616,4,5,5,4,15,17,-2,20
FC Pune City,4616,5,5,3,6,14,17,-3,18
FC Goa,4616,6,5,2,7,12,16,-4,17
Kolkata,4616,7,3,7,4,14,16,-2,16
NorthEast Un,4616,8,4,3,7,12,16,-4,15
Mumbai City,4617,1,7,4,3,18,8,10,25
Kolkata,4617,2,5,6,3,18,16,2,21
Kerala Blast,4617,3,6,3,5,13,16,-3,21
Delhi Dynamo,4617,4,5,5,4,23,18,5,20
FC Goa,4617,5,6,2,6,14,16,-2,20
NorthEast Un,4617,6,5,2,7,10,11,-1,17
FC Pune City,4617,7,4,3,7,15,20,-5,15
Chennaiyin,4617,8,3,5,6,13,19,-6,14
Mumbai City,4618,1,7,4,3,19,9,10,25
Delhi Dynamo,4618,2,5,6,3,23,17,6,21
Chennaiyin,4618,3,5,5,4,19,20,-1,20
FC Pune City,4618,4,5,4,5,17,16,1,19
Kerala Blast,4618,5,5,4,5,12,18,-6,19
Kolkata,4618,6,3,8,3,15,15,0,17
NorthEast Un,4618,7,4,4,6,11,13,-2,16
FC Goa,4618,8,3,3,8,11,19,-8,12
Delhi Dynamo,4619,1,6,5,3,27,17,10,23
Mumbai City,4619,2,6,4,4,16,9,7,22
Kolkata,4619,3,5,6,3,18,16,2,21
Kerala Blast,4619,4,6,3,5,15,17,-2,21
NorthEast Un,4619,5,6,2,6,14,13,1,20
Chennaiyin,4619,6,4,5,5,16,20,-4,17
FC Pune City,4619,7,4,3,7,14,20,-6,15
FC Goa,4619,8,4,2,8,11,19,-8,14
Mumbai City,4620,1,7,4,3,18,8,10,25
NorthEast Un,4620,2,6,2,6,15,11,4,20
Chennaiyin,4620,3,5,5,4,15,17,-2,20
Kolkata,4620,4,4,7,3,14,14,0,19
Kerala Blast,4620,5,5,4,5,10,14,-4,19
Delhi Dynamo,4620,6,4,6,4,23,22,1,18
FC Pune City,4620,7,4,3,7,12,16,-4,15
FC Goa,4620,8,4,3,7,11,16,-5,15
Mumbai City,4621,1,7,4,3,18,9,9,25
Kolkata,4621,2,5,6,3,17,16,1,21
Delhi Dynamo,4621,3,5,5,4,26,21,5,20
FC Pune City,4621,4,5,4,5,15,15,0,19
FC Goa,4621,5,5,2,7,15,18,-3,17
Kerala Blast,4621,6,4,5,5,11,16,-5,17
NorthEast Un,4621,7,4,4,6,12,14,-2,16
Chennaiyin,4621,8,3,6,5,14,19,-5,15
Kolkata,4622,1,6,6,2,19,14,5,24
Delhi Dynamo,4622,2,6,5,3,27,17,10,23
Mumbai City,4622,3,6,4,4,18,12,6,22
Kerala Blast,4622,4,6,3,5,13,15,-2,21
Chennaiyin,4622,5,5,5,4,17,18,-1,20
FC Pune City,4622,6,4,3,7,13,19,-6,15
NorthEast Un,4622,7,4,2,8,9,13,-4,14
FC Goa,4622,8,4,2,8,11,19,-8,14
Mumbai City,4623,1,7,4,3,18,8,10,25
Delhi Dynamo,4623,2,5,5,4,24,18,6,20
NorthEast Un,4623,3,6,2,6,14,13,1,20
Kolkata,4623,4,4,7,3,16,16,0,19
Kerala Blast,4623,5,5,4,5,11,16,-5,19
FC Pune City,4623,6,5,3,6,15,16,-1,18
FC Goa,4623,7,5,2,7,13,17,-4,17
Chennaiyin,4623,8,3,5,6,16,23,-7,14
Delhi Dynamo,4624,1,6,6,2,27,16,11,24
Mumbai City,4624,2,6,4,4,17,10,7,22
Kolkata,4624,3,4,8,2,18,16,2,20
Kerala Blast,4624,4,5,5,4,14,16,-2,20
NorthEast Un,4624,5,5,3,6,12,12,0,18
FC Pune City,4624,6,4,5,5,13,15,-2,17
Chennaiyin,4624,7,3,5,6,14,22,-8,14
FC Goa,4624,8,4,2,8,13,21,-8,14
Mumbai City,4625,1,6,4,4,16,9,7,22
Kolkata,4625,2,5,7,2,15,12,3,22
Delhi Dynamo,4625,3,5,5,4,22,18,4,20
Kerala Blast,4625,4,5,4,5,11,15,-4,19
NorthEast Un,4625,5,5,3,6,12,12,0,18
Chennaiyin,4625,6,4,6,4,15,18,-3,18
FC Pune City,4625,7,4,4,6,12,15,-3,16
FC Goa,4625,8,4,3,7,11,15,-4,15
Mumbai City,4626,1,7,4,3,20,8,12,25
Kolkata,4626,2,5,7,2,20,13,7,22
NorthEast Un,4626,3,6,2,6,16,13,3,20
Delhi Dynamo,4626,4,5,5,4,23,21,2,20
Chennaiyin,4626,5,5,5,4,16,18,-2,20
Kerala Blast,4626,6,4,5,5,14,20,-6,17
FC Pune City,4626,7,4,4,6,14,19,-5,16
FC Goa,4626,8,3,2,9,9,20,-11,11
Delhi Dynamo,4627,1,6,6,2,27,16,11,24
Kolkata,4627,2,5,7,2,19,13,6,22
Mumbai City,4627,3,6,4,4,16,10,6,22
Kerala Blast,4627,4,6,4,4,14,14,0,22
Chennaiyin,4627,5,4,6,4,16,19,-3,18
NorthEast Un,4627,6,4,3,7,10,12,-2,15
FC Pune City,4627,7,4,3,7,12,20,-8,15
FC Goa,4627,8,3,3,8,11,21,-10,12
Delhi Dynamo,4628,1,7,5,2,28,17,11,26
Mumbai City,4628,2,6,4,4,17,10,7,22
Kolkata,4628,3,4,8,2,19,17,2,20
Kerala Blast,4628,4,5,4,5,12,16,-4,19
FC Pune City,4628,5,4,5,5,16,18,-2,17
NorthEast Un,4628,6,4,3,7,11,13,-2,15
Chennaiyin,4628,7,3,6,5,14,20,-6,15
FC Goa,4628,8,4,3,7,12,18,-6,15
Delhi Dynamo,4629,1,6,5,3,25,17,8,23
NorthEast Un,4629,2,7,2,5,13,9,4,23
Mumbai City,4629,3,6,4,4,17,10,7,22
Kolkata,4629,4,5,6,3,19,14,5,21
Kerala Blast,4629,5,5,3,6,13,18,-5,18
FC Goa,4629,6,5,2,7,14,16,-2,17
FC Pune City,4629,7,4,3,7,13,20,-7,15
Chennaiyin,4629,8,3,5,6,13,23,-10,14
Mumbai City,4630,1,7,4,3,18,9,9,25
Delhi Dynamo,4630,2,5,6,3,27,19,8,21
NorthEast Un,4630,3,6,2,6,15,13,2,20
FC Pune City,4630,4,5,4,5,15,15,0,19
Kerala Blast,4630,5,5,3,6,11,17,-6,18
Kolkata,4630,6,3,8,3,14,14,0,17
Chennaiyin,4630,7,4,5,5,14,20,-6,17
FC Goa,4630,8,3,4,7,10,17,-7,13
Delhi Dynamo,4631,1,6,5,3,27,16,11,23
Mumbai City,4631,2,6,4,4,16,9,7,22
Kolkata,4631,3,4,8,2,19,15,4,20
NorthEast Un,4631,4,5,4,5,13,12,1,19
Kerala Blast,4631,5,4,6,4,11,15,-4,18
FC Pune City,4631,6,4,4,6,12,17,-5,16
Chennaiyin,4631,7,3,6,5,14,20,-6,15
FC Goa,4631,8,4,3,7,12,20,-8,15
Mumbai City,4632,1,6,4,4,17,10,7,22
FC Pune City,4632,2,6,3,5,17,16,1,21
Kerala Blast,4632,3,6,3,5,15,17,-2,21
Delhi Dynamo,4632,4,5,5,4,25,20,5,20
NorthEast Un,4632,5,5,3,6,14,14,0,18
FC Goa,4632,6,5,3,6,13,16,-3,18
Kolkata,4632,7,3,7,4,13,16,-3,16
Chennaiyin,4632,8,3,6,5,16,21,-5,15
Mumbai City,4633,1,6,4,4,16,10,6,22
Kolkata,4633,2,5,7,2,18,14,4,22
NorthEast Un,4633,3,6,3,5,14,10,4,21
Delhi Dynamo,4633,4,5,5,4,24,19,5,20
Kerala Blast,4633,5,5,4,5,14,19,-5,19
FC Goa,4633,6,5,3,6,13,15,-2,18
FC Pune City,4633,7,4,3,7,15,19,-4,15
Chennaiyin,4633,8,3,5,6,13,21,-8,14
Mumbai City,4634,1,7,4,3,18,8,10,25
Delhi Dynamo,4634,2,5,6,3,25,17,8,21
Kolkata,4634,3,4,7,3,18,17,1,19
FC Pune City,4634,4,5,4,5,17,18,-1,19
Chennaiyin,4634,5,4,6,4,14,17,-3,18
Kerala Blast,4634,6,4,5,5,13,18,-5,17
NorthEast Un,4634,7,4,3,7,11,15,-4,15
FC Goa,4634,8,3,5,6,9,15,-6,14
Mumbai City,4635,1,6,5,3,16,8,8,23
Delhi Dynamo,4635,2,5,7,2,25,15,10,22
Kolkata,4635,3,5,7,2,17,13,4,22
NorthEast Un,4635,4,6,3,5,14,11,3,21
Kerala Blast,4635,5,5,4,5,12,15,-3,19
FC Pune City,4635,6,4,3,7,13,19,-6,15
Chennaiyin,4635,7,3,5,6,14,20,-6,14
FC Goa,4635,8,4,2,8,9,19,-10,14
Delhi Dynamo,4636,1,5,7,2,25,17,8,22
Mumbai City,4636,2,6,4,4,17,10,7,22
NorthEast Un,4636,3,5,4,5,14,12,2,19
FC Pune City,4636,4,5,4,5,17,18,-1,19
Kolkata,4636,5,3,9,2,18,17,1,18
Chennaiyin,4636,6,4,5,5,17,20,-3,17
Kerala Blast,4636,7,4,5,5,12,17,-5,17
FC Goa,4636,8,3,4,7,10,19,-9,13
Mumbai City,4637,1,7,4,3,19,8,11,25
Delhi Dynamo,4637,2,5,6,3,25,20,5,21
NorthEast Un,4637,3,6,3,5,15,12,3,21
Kolkata,4637,4,4,7,3,17,16,1,19
FC Pune City,4637,5,5,4,5,14,15,-1,19
Chennaiyin,4637,6,4,5,5,14,18,-4,17
Kerala Blast,4637,7,4,3,7,13,22,-9,15
FC Goa,4637,8,4,2,8,11,17,-6,14
Mumbai City,4638,1,7,4,3,18,9,9,25
Kerala Blast,4638,2,6,4,4,13,13,0,22
Delhi Dynamo,4638,3,5,6,3,24,17,7,21
Kolkata,4638,4,5,6,3,18,16,2,21
NorthEast Un,4638,5,5,3,6,12,11,1,18
Chennaiyin,4638,6,4,5,5,15,20,-5,17
FC Pune City,4638,7,4,3,7,13,19,-6,15
FC Goa,4638,8,3,3,8,10,18,-8,12
Mumbai City,4639,1,6,5,3,17,9,8,23
Delhi Dynamo,4639,2,5,6,3,25,19,6,21
Kolkata,4639,3,5,6,3,17,16,1,21
NorthEast Un,4639,4,6,2,6,14,11,3,20
FC Goa,4639,5,6,2,6,16,16,0,20
FC Pune City,4639,6,4,4,6,14,17,-3,16
Kerala Blast,4639,7,4,4,6,11,19,-8,16
Chennaiyin,4639,8,3,5,6,14,21,-7,14
Mumbai City,4640,1,6,5,3,17,9,8,23
Kerala Blast,4640,2,6,3,5,12,15,-3,21
Delhi Dynamo,4640,3,4,8,2,23,16,7,20
NorthEast Un,4640,4,5,3,6,11,12,-1,18
Chennaiyin,4640,5,4,6,4,15,17,-2,18
Kolkata,4640,6,3,7,4,13,14,-1,16
FC Pune City,4640,7,4,4,6,13,16,-3,16
FC Goa,4640,8,4,4,6,9,14,-5,16
Mumbai City,4641,1,7,4,3,18,9,9,25
Delhi Dynamo,4641,2,5,5,4,24,18,6,20
FC Goa,4641,3,6,2,6,13,15,-2,20
Kolkata,4641,4,4,7,3,16,16,0,19
Kerala Blast,4641,5,5,4,5,11,15,-4,19
NorthEast Un,4641,6,5,3,6,12,12,0,18
FC Pune City,4641,7,4,3,7,12,16,-4,15
Chennaiyin,4641,8,3,6,5,14,19,-5,15
Mumbai City,4642,1,7,4,3,17,8,9,25
Kerala Blast,4642,2,6,4,4,14,16,-2,22
Delhi Dynamo,4642,3,4,7,3,22,16,6,19
FC Goa,4642,4,5,3,6,12,16,-4,18
NorthEast Un,4642,5,4,5,5,10,10,0,17
Kolkata,4642,6,3,7,4,14,15,-1,16
FC Pune City,4642,7,4,4,6,13,16,-3,16
Chennaiyin,4642,8,3,6,5,14,19,-5,15
Mumbai City,4643,1,6,5,3,17,9,8,23
FC Pune City,4643,2,6,3,5,15,15,0,21
Chennaiyin,4643,3,5,5,4,16,17,-1,20
Kolkata,4643,4,4,7,3,17,15,2,19
Delhi Dynamo,4643,5,4,6,4,24,19,5,18
NorthEast Un,4643,6,5,3,6,13,13,0,18
Kerala Blast,4643,7,4,4,6,10,17,-7,16
FC Goa,4643,8,4,3,7,10,17,-7,15
Mumbai City,4644,1,7,4,3,18,8,10,25
Kolkata,4644,2,5,7,2,17,13,4,22
NorthEast Un,4644,3,6,3,5,15,11,4,21
Delhi Dynamo,4644,4,4,6,4,23,19,4,18
FC Pune City,4644,5,5,3,6,15,17,-2,18
Chennaiyin,4644,6,4,5,5,15,19,-4,17
FC Goa,4644,7,4,3,7,10,17,-7,15
Kerala Blast,4644,8,4,3,7,10,19,-9,15
Mumbai City,4645,1,7,4,3,18,9,9,25
Delhi Dynamo,4645,2,6,5,3,28,18,10,23
Kolkata,4645,3,4,7,3,19,20,-1,19
NorthEast Un,4645,4,5,3,6,13,12,1,18
FC Goa,4645,5,5,2,7,16,21,-5,17
Kerala Blast,4645,6,4,5,5,12,18,-6,17
FC Pune City,4645,7,4,4,6,14,17,-3,16
Chennaiyin,4645,8,3,6,5,15,20,-5,15
Mumbai City,4646,1,7,4,3,18,9,9,25
Kolkata,4646,2,5,6,3,19,15,4,21
FC Goa,4646,3,6,2,6,13,15,-2,20
Kerala Blast,4646,4,5,4,5,12,17,-5,19
Delhi Dynamo,4646,5,4,6,4,22,17,5,18
Chennaiyin,4646,6,4,5,5,15,20,-5,17
FC Pune City,4646,7,4,4,6,12,16,-4,16
NorthEast Un,4646,8,4,3,7,11,13,-2,15
Kerala Blast,4647,1,7,3,4,17,13,4,24
Delhi Dynamo,4647,2,6,5,3,27,18,9,23
Mumbai City,4647,3,6,4,4,17,12,5,22
NorthEast Un,4647,4,6,2,6,14,11,3,20
Kolkata,4647,5,4,6,4,16,18,-2,18
Chennaiyin,4647,6,4,5,5,15,21,-6,17
FC Pune City,4647,7,4,3,7,14,20,-6,15
FC Goa,4647,8,4,2,8,11,18,-7,14
Mumbai City,4648,1,7,4,3,18,8,10,25
Delhi Dynamo,4648,2,6,5,3,23,16,7,23
Kolkata,4648,3,5,6,3,18,16,2,21
Chennaiyin,4648,4,5,5,4,18,18,0,20
Kerala Blast,4648,5,5,4,5,12,15,-3,19
NorthEast Un,4648,6,5,2,7,11,13,-2,17
FC Pune City,4648,7,4,4,6,13,16,-3,16
FC Goa,4648,8,3,2,9,10,21,-11,11
Mumbai City,4649,1,7,4,3,17,8,9,25
Delhi Dynamo,4649,2,6,5,3,26,17,9,23
FC Pune City,4649,3,5,4,5,14,15,-1,19
Kolkata,4649,4,3,9,2,15,14,1,18
Kerala Blast,4649,5,4,5,5,12,17,-5,17
NorthEast Un,4649,6,4,4,6,12,13,-1,16
FC Goa,4649,7,4,3,7,14,19,-5,15
Chennaiyin,4649,8,3,6,5,15,22,-7,15
Mumbai City,4650,1,7,4,3,20,8,12,25
Delhi Dynamo,4650,2,6,5,3,27,22,5,23
Kolkata,4650,3,5,6,3,18,18,0,21
NorthEast Un,4650,4,6,2,6,13,12,1,20
FC Goa,4650,5,5,2,7,17,18,-1,17
FC Pune City,4650,6,4,4,6,14,19,-5,16
Kerala Blast,4650,7,4,4,6,10,16,-6,16
Chennaiyin,4650,8,3,5,6,14,20,-6,14
Delhi Dynamo,4651,1,6,6,2,27,16,11,24
Mumbai City,4651,2,6,5,3,16,8,8,23
Kerala Blast,4651,3,6,3,5,16,20,-4,21
Kolkata,4651,4,4,7,3,19,17,2,19
FC Pune City,4651,5,5,3,6,18,20,-2,18
NorthEast Un,4651,6,5,2,7,11,14,-3,17
FC Goa,4651,7,4,3,7,14,19,-5,15
Chennaiyin,4651,8,3,5,6,15,22,-7,14
Mumbai City,4652,1,7,4,3,19,9,10,25
Kolkata,4652,2,5,7,2,17,13,4,22
Kerala Blast,4652,3,6,3,5,14,17,-3,21
Delhi Dynamo,4652,4,5,5,4,26,21,5,20
NorthEast Un,4652,5,6,2,6,15,14,1,20
Chennaiyin,4652,6,4,5,5,18,21,-3,17
FC Pune City,4652,7,4,3,7,13,18,-5,15
FC Goa,4652,8,3,3,8,13,22,-9,12
Mumbai City,4653,1,7,4,3,17,8,9,25
Delhi Dynamo,4653,2,5,6,3,27,18,9,21
Kerala Blast,4653,3,5,4,5,11,16,-5,19
Kolkata,4653,4,4,6,4,17,16,1,18
NorthEast Un,4653,5,5,3,6,14,13,1,18
FC Goa,4653,6,5,2,7,14,19,-5,17
Chennaiyin,4653,7,4,5,5,15,21,-6,17
FC Pune City,4653,8,4,4,6,14,18,-4,16
Mumbai City,4654,1,6,5,3,18,10,8,23
Delhi Dynamo,4654,2,5,7,2,28,18,10,22
NorthEast Un,4654,3,6,3,5,14,12,2,21
Kerala Blast,4654,4,5,4,5,14,17,-3,19
Kolkata,4654,5,4,6,4,18,18,0,18
FC Goa,4654,6,5,2,7,10,17,-7,17
FC Pune City,4654,7,4,4,6,13,17,-4,16
Chennaiyin,4654,8,3,5,6,13,19,-6,14
Mumbai City,4655,1,7,4,3,18,9,9,25
Delhi Dynamo,4655,2,6,5,3,31,19,12,23
Kolkata,4655,3,5,7,2,20,14,6,22
NorthEast Un,4655,4,6,2,6,16,16,0,20
FC Pune City,4655,5,4,4,6,13,17,-4,16
Kerala Blast,4655,6,4,4,6,11,19,-8,16
FC Goa,4655,7,4,3,7,11,20,-9,15
Chennaiyin,4655,8,3,5,6,14,20,-6,14
Mumbai City,4656,1,7,4,3,18,8,10,25
Delhi Dynamo,4656,2,5,5,4,23,18,5,20
Kolkata,4656,3,4,8,2,17,13,4,20
Kerala Blast,4656,4,5,4,5,11,15,-4,19
FC Pune City,4656,5,5,3,6,13,17,-4,18
Chennaiyin,4656,6,3,7,4,15,19,-4,16
FC Goa,4656,7,4,4,6,13,18,-5,16
NorthEast Un,4656,8,4,3,7,10,12,-2,15
Delhi Dynamo,4657,1,7,5,2,31,18,13,26
Mumbai City,4657,2,6,4,4,17,13,4,22
FC Pune City,4657,3,5,4,5,15,16,-1,19
Kolkata,4657,4,4,6,4,17,18,-1,18
FC Goa,4657,5,5,2,7,15,18,-3,17
Chennaiyin,4657,6,4,5,5,15,19,-4,17
Kerala Blast,4657,7,4,5,5,12,17,-5,17
NorthEast Un,4657,8,4,3,7,11,14,-3,15
Mumbai City,4658,1,6,5,3,18,10,8,23
Delhi Dynamo,4658,2,4,7,3,25,21,4,19
NorthEast Un,4658,3,5,4,5,14,11,3,19
Kolkata,4658,4,4,7,3,17,16,1,19
Kerala Blast,4658,5,5,4,5,12,15,-3,19
Chennaiyin,4658,6,3,7,4,13,17,-4,16
FC Pune City,4658,6,4,4,6,13,17,-4,16
FC Goa,4658,8,4,4,6,12,17,-5,16
Delhi Dynamo,4659,1,6,6,2,26,17,9,24
Mumbai City,4659,2,6,5,3,18,10,8,23
Kolkata,4659,3,5,6,3,18,16,2,21
NorthEast Un,4659,4,5,3,6,12,12,0,18
Chennaiyin,4659,5,4,6,4,14,17,-3,18
Kerala Blast,4659,6,5,3,6,12,19,-7,18
FC Pune City,4659,7,4,3,7,13,17,-4,15
FC Goa,4659,8,4,2,8,12,17,-5,14
Mumbai City,4660,1,7,4,3,18,9,9,25
Kolkata,4660,2,5,7,2,17,13,4,22
NorthEast Un,4660,3,5,4,5,13,11,2,19
Delhi Dynamo,4660,4,4,6,4,23,18,5,18
FC Pune City,4660,5,5,3,6,16,16,0,18
Chennaiyin,4660,6,4,5,5,14,19,-5,17
Kerala Blast,4660,7,4,5,5,13,20,-7,17
FC Goa,4660,8,4,2,8,10,18,-8,14
Kerala Blast,4661,1,7,3,4,16,16,0,24
Mumbai City,4661,2,6,5,3,19,11,8,23
Delhi Dynamo,4661,3,4,8,2,27,20,7,20
NorthEast Un,4661,4,5,3,6,13,11,2,18
Kolkata,4661,5,4,6,4,20,20,0,18
FC Goa,4661,6,5,3,6,17,18,-1,18
FC Pune City,4661,7,4,3,7,12,19,-7,15
Chennaiyin,4661,8,3,5,6,14,23,-9,14
Mumbai City,4662,1,7,4,3,18,8,10,25
Delhi Dynamo,4662,2,5,6,3,25,19,6,21
Kolkata,4662,3,5,6,3,18,15,3,21
Kerala Blast,4662,4,6,3,5,16,17,-1,21
Chennaiyin,4662,5,4,5,5,17,19,-2,17
NorthEast Un,4662,6,5,2,7,12,15,-3,17
FC Pune City,4662,7,4,3,7,13,19,-6,15
FC Goa,4662,8,4,3,7,13,20,-7,15
Kerala Blast,4663,1,7,3,4,18,16,2,24
Mumbai City,4663,2,6,5,3,17,9,8,23
Delhi Dynamo,4663,3,4,7,3,24,18,6,19
NorthEast Un,4663,4,5,3,6,12,13,-1,18
FC Pune City,4663,5,5,3,6,16,18,-2,18
Kolkata,4663,6,4,6,4,15,17,-2,18
Chennaiyin,4663,7,4,6,4,14,17,-3,18
FC Goa,4663,8,3,3,8,9,17,-8,12
Mumbai City,4664,1,6,4,4,17,10,7,22
Delhi Dynamo,4664,2,5,6,3,24,18,6,21
Chennaiyin,4664,3,5,5,4,17,17,0,20
Kerala Blast,4664,4,5,4,5,11,14,-3,19
Kolkata,4664,5,4,6,4,16,16,0,18
NorthEast Un,4664,6,5,3,6,12,12,0,18
FC Pune City,4664,7,5,3,6,13,16,-3,18
FC Goa,4664,8,4,3,7,11,18,-7,15
Delhi Dynamo,4665,1,6,6,2,24,15,9,24
Mumbai City,4665,2,6,4,4,16,9,7,22
Kolkata,4665,3,5,6,3,18,15,3,21
NorthEast Un,4665,4,5,3,6,13,14,-1,18
Kerala Blast,4665,5,5,3,6,16,18,-2,18
FC Goa,4665,6,5,2,7,13,16,-3,17
Chennaiyin,4665,7,4,5,5,16,21,-5,17
FC Pune City,4665,8,4,3,7,13,21,-8,15
Delhi Dynamo,4666,1,6,6,2,26,16,10,24
Mumbai City,4666,2,6,4,4,16,10,6,22
Kolkata,4666,3,5,6,3,15,15,0,21
Kerala Blast,4666,4,5,4,5,14,16,-2,19
Chennaiyin,4666,5,4,5,5,16,19,-3,17
FC Goa,4666,6,5,2,7,15,18,-3,17
NorthEast Un,4666,7,4,4,6,10,12,-2,16
FC Pune City,4666,8,4,3,7,13,19,-6,15
Mumbai City,4667,1,7,4,3,18,9,9,25
Kolkata,4667,2,6,6,2,18,13,5,24
NorthEast Un,4667,3,7,2,5,16,10,6,23
Delhi Dynamo,4667,4,4,5,5,25,23,2,17
FC Pune City,4667,5,4,4,6,13,17,-4,16
Kerala Blast,4667,6,4,4,6,11,18,-7,16
Chennaiyin,4667,7,3,6,5,14,19,-5,15
FC Goa,4667,8,4,3,7,12,18,-6,15
Delhi Dynamo,4668,1,6,6,2,25,16,9,24
Mumbai City,4668,2,6,5,3,17,9,8,23
Kerala Blast,4668,3,6,4,4,13,13,0,22
Kolkata,4668,4,3,9,2,17,16,1,18
FC Pune City,4668,5,4,4,6,15,20,-5,16
NorthEast Un,4668,6,4,3,7,11,13,-2,15
Chennaiyin,4668,7,3,6,5,14,19,-5,15
FC Goa,4668,8,4,3,7,10,16,-6,15
Delhi Dynamo,4669,1,7,5,2,27,16,11,26
Mumbai City,4669,2,6,4,4,16,9,7,22
Kolkata,4669,3,5,7,2,18,13,5,22
Kerala Blast,4669,4,5,4,5,11,15,-4,19
FC Pune City,4669,5,4,4,6,12,17,-5,16
NorthEast Un,4669,6,4,3,7,12,15,-3,15
Chennaiyin,4669,7,3,6,5,15,20,-5,15
FC Goa,4669,8,4,3,7,12,18,-6,15
Mumbai City,4670,1,7,4,3,18,9,9,25
Kerala Blast,4670,2,5,5,4,11,14,-3,20
FC Pune City,4670,3,5,4,5,15,15,0,19
Delhi Dynamo,4670,4,4,6,4,25,21,4,18
NorthEast Un,4670,5,5,3,6,14,13,1,18
Chennaiyin,4670,6,4,6,4,15,18,-3,18
Kolkata,4670,7,3,7,4,15,18,-3,16
FC Goa,4670,8,4,3,7,13,18,-5,15
Mumbai City,4671,1,7,4,3,18,9,9,25
NorthEast Un,4671,2,7,2,5,14,10,4,23
Kerala Blast,4671,3,6,3,5,14,15,-1,21
Delhi Dynamo,4671,4,5,5,4,24,19,5,20
Chennaiyin,4671,5,4,5,5,17,20,-3,17
Kolkata,4671,6,3,7,4,16,17,-1,16
FC Pune City,4671,7,4,4,6,14,19,-5,16
FC Goa,4671,8,4,2,8,11,19,-8,14
Mumbai City,4672,1,6,4,4,17,10,7,22
Delhi Dynamo,4672,2,5,6,3,26,19,7,21
FC Goa,4672,3,6,2,6,15,14,1,20
FC Pune City,4672,4,5,4,5,16,16,0,19
NorthEast Un,4672,5,5,3,6,17,16,1,18
Kolkata,4672,6,4,6,4,15,16,-1,18
Chennaiyin,4672,7,4,5,5,16,23,-7,17
Kerala Blast,4672,8,4,4,6,12,20,-8,16
Kerala Blast,4673,1,7,3,4,16,16,0,24
Mumbai City,4673,2,6,5,3,17,9,8,23
Delhi Dynamo,4673,3,5,7,2,25,17,8,22
NorthEast Un,4673,4,5,3,6,15,12,3,18
Kolkata,4673,5,4,6,4,16,16,0,18
FC Pune City,4673,6,4,3,7,13,17,-4,15
FC Goa,4673,7,4,3,7,12,18,-6,15
Chennaiyin,4673,8,3,6,5,15,24,-9,15
Mumbai City,4674,1,6,5,3,18,10,8,23
Delhi Dynamo,4674,2,5,7,2,26,18,8,22
Kerala Blast,4674,3,6,4,4,14,14,0,22
Kolkata,4674,4,4,7,3,15,14,1,19
FC Goa,4674,5,5,3,6,10,14,-4,18
Chennaiyin,4674,6,4,5,5,15,19,-4,17
FC Pune City,4674,7,4,3,7,12,18,-6,15
NorthEast Un,4674,8,4,2,8,12,15,-3,14
Mumbai City,4675,1,7,4,3,21,8,13,25
Kolkata,4675,2,5,7,2,18,13,5,22
NorthEast Un,4675,3,6,3,5,13,10,3,21
Delhi Dynamo,4675,4,5,5,4,24,22,2,20
FC Pune City,4675,5,5,3,6,13,16,-3,18
Chennaiyin,4675,6,4,5,5,15,19,-4,17
Kerala Blast,4675,7,4,4,6,10,17,-7,16
FC Goa,4675,8,3,3,8,9,18,-9,12
Delhi Dynamo,4676,1,6,5,3,25,15,10,23
Mumbai City,4676,2,6,4,4,16,10,6,22
FC Pune City,4676,3,5,4,5,17,18,-1,19
Kerala Blast,4676,4,5,4,5,16,17,-1,19
NorthEast Un,4676,5,5,3,6,11,11,0,18
Chennaiyin,4676,6,4,6,4,17,20,-3,18
Kolkata,4676,7,3,8,3,17,20,-3,17
FC Goa,4676,8,3,4,7,11,19,-8,13
Mumbai City,4677,1,7,4,3,19,8,11,25
Kolkata,4677,2,5,6,3,19,13,6,21
Kerala Blast,4677,3,6,3,5,13,17,-4,21
NorthEast Un,4677,4,6,2,6,12,12,0,20
FC Goa,4677,5,6,2,6,14,15,-1,20
Delhi Dynamo,4677,6,4,5,5,22,20,2,17
FC Pune City,4677,7,4,3,7,12,18,-6,15
Chennaiyin,4677,8,3,5,6,14,22,-8,14
Mumbai City,4678,1,6,5,3,17,9,8,23
Delhi Dynamo,4678,2,4,8,2,24,17,7,20
Kolkata,4678,3,4,7,3,16,15,1,19
Kerala Blast,4678,4,5,4,5,11,15,-4,19
FC Pune City,4678,5,5,3,6,14,16,-2,18
Chennaiyin,4678,6,4,6,4,16,19,-3,18
FC Goa,4678,7,4,4,6,12,17,-5,16
NorthEast Un,4678,8,4,3,7,10,12,-2,15
Mumbai City,4679,1,7,4,3,18,8,10,25
Delhi Dynamo,4679,2,5,6,3,25,18,7,21
Kolkata,4679,3,5,6,3,18,15,3,21
FC Pune City,4679,4,6,3,5,15,15,0,21
Kerala Blast,4679,5,5,3,6,12,18,-6,18
NorthEast Un,4679,6,5,2,7,12,14,-2,17
Chennaiyin,4679,7,3,6,5,14,19,-5,15
FC Goa,4679,8,3,4,7,10,17,-7,13
Mumbai City,4680,1,6,5,3,16,8,8,23
Delhi Dynamo,4680,2,5,7,2,24,16,8,22
Kerala Blast,4680,3,5,5,4,12,15,-3,20
FC Pune City,4680,4,5,4,5,15,15,0,19
FC Goa,4680,5,5,3,6,14,16,-2,18
NorthEast Un,4680,6,4,4,6,13,14,-1,16
Kolkata,4680,7,3,6,5,13,17,-4,15
Chennaiyin,4680,8,3,6,5,16,22,-6,15
Mumbai City,4681,1,7,4,3,19,9,10,25
FC Pune City,4681,2,6,3,5,19,16,3,21
Delhi Dynamo,4681,3,5,5,4,25,20,5,20
Kolkata,4681,4,4,7,3,17,17,0,19
Kerala Blast,4681,5,5,4,5,13,18,-5,19
Chennaiyin,4681,6,4,6,4,16,19,-3,18
FC Goa,4681,7,4,3,7,13,18,-5,15
NorthEast Un,4681,8,4,2,8,10,15,-5,14
Mumbai City,4682,1,6,5,3,17,9,8,23
Delhi Dynamo,4682,2,5,6,3,28,19,9,21
Kolkata,4682,3,4,8,2,15,13,2,20
FC Goa,4682,4,5,3,6,14,16,-2,18
FC Pune City,4682,5,4,5,5,14,16,-2,17
Chennaiyin,4682,6,4,5,5,16,21,-5,17
Kerala Blast,4682,7,4,5,5,11,16,-5,17
NorthEast Un,4682,8,4,3,7,12,17,-5,15
Mumbai City,4683,1,7,4,3,19,8,11,25
Kolkata,4683,2,5,7,2,17,14,3,22
Delhi Dynamo,4683,3,5,5,4,23,19,4,20
NorthEast Un,4683,4,5,3,6,12,12,0,18
FC Pune City,4683,5,5,3,6,16,17,-1,18
Kerala Blast,4683,6,5,3,6,12,17,-5,18
Chennaiyin,4683,7,3,6,5,14,20,-6,15
FC Goa,4683,8,4,3,7,11,17,-6,15
Mumbai City,4684,1,6,5,3,16,8,8,23
Delhi Dynamo,4684,2,5,6,3,24,17,7,21
NorthEast Un,4684,3,6,3,5,18,15,3,21
Kolkata,4684,4,4,7,3,16,16,0,19
FC Pune City,4684,5,5,4,5,15,16,-1,19
Chennaiyin,4684,6,4,6,4,16,19,-3,18
Kerala Blast,4684,7,5,3,6,16,20,-4,18
FC Goa,4684,8,3,2,9,10,20,-10,11
Mumbai City,4685,1,7,4,3,18,9,9,25
Kolkata,4685,2,6,6,2,22,15,7,24
NorthEast Un,4685,3,5,4,5,12,11,1,19
Delhi Dynamo,4685,4,4,6,4,23,18,5,18
Kerala Blast,4685,5,5,3,6,12,17,-5,18
Chennaiyin,4685,6,3,7,4,13,17,-4,16
FC Goa,4685,7,4,3,7,11,17,-6,15
FC Pune City,4685,8,4,3,7,14,21,-7,15
Delhi Dynamo,4686,1,6,6,2,30,19,11,24
Mumbai City,4686,2,6,5,3,17,9,8,23
Kerala Blast,4686,3,6,4,4,13,14,-1,22
Kolkata,4686,4,5,6,3,16,14,2,21
FC Pune City,4686,5,4,4,6,13,16,-3,16
NorthEast Un,4686,6,4,3,7,11,14,-3,15
Chennaiyin,4686,7,3,6,5,13,19,-6,15
FC Goa,4686,8,4,2,8,13,21,-8,14
Mumbai City,4687,1,6,5,3,16,8,8,23
Delhi Dynamo,4687,2,5,7,2,23,15,8,22
Kolkata,4687,3,5,6,3,15,13,2,21
NorthEast Un,4687,4,5,3,6,12,12,0,18
Kerala Blast,4687,5,4,5,5,10,15,-5,17
FC Pune City,4687,6,4,4,6,13,16,-3,16
FC Goa,4687,7,4,4,6,12,17,-5,16
Chennaiyin,4687,8,3,6,5,17,22,-5,15
Kolkata,4688,1,6,6,2,19,14,5,24
Mumbai City,4688,2,6,4,4,17,10,7,22
Delhi Dynamo,4688,3,5,5,4,25,21,4,20
NorthEast Un,4688,4,6,2,6,18,15,3,20
Chennaiyin,4688,5,5,5,4,16,18,-2,20
Kerala Blast,4688,6,5,3,6,13,19,-6,18
FC Pune City,4688,7,4,3,7,13,17,-4,15
FC Goa,4688,8,4,2,8,10,17,-7,14
Mumbai City,4689,1,7,4,3,19,10,9,25
Delhi Dynamo,4689,2,5,5,4,24,18,6,20
Kolkata,4689,3,4,8,2,15,13,2,20
NorthEast Un,4689,4,6,2,6,14,13,1,20
FC Pune City,4689,5,5,4,5,15,16,-1,19
Chennaiyin,4689,6,4,5,5,15,23,-8,17
FC Goa,4689,7,4,3,7,13,15,-2,15
Kerala Blast,4689,8,4,3,7,12,19,-7,15
Delhi Dynamo,4690,1,6,6,2,27,18,9,24
Mumbai City,4690,2,6,4,4,18,11,7,22
Kerala Blast,4690,3,6,4,4,13,14,-1,22
Kolkata,4690,4,3,8,3,17,17,0,17
NorthEast Un,4690,5,4,4,6,9,10,-1,16
Chennaiyin,4690,6,3,7,4,14,18,-4,16
FC Pune City,4690,7,4,4,6,13,17,-4,16
FC Goa,4690,8,3,5,6,13,19,-6,14
Delhi Dynamo,4691,1,6,6,2,27,16,11,24
Mumbai City,4691,2,6,5,3,17,9,8,23
Kerala Blast,4691,3,6,3,5,13,16,-3,21
NorthEast Un,4691,4,6,2,6,15,14,1,20
Kolkata,4691,5,4,7,3,18,17,1,19
FC Pune City,4691,6,4,4,6,13,16,-3,16
Chennaiyin,4691,7,3,5,6,17,23,-6,14
FC Goa,4691,8,4,2,8,11,20,-9,14
Kolkata,4692,1,6,6,2,20,13,7,24
Mumbai City,4692,2,6,5,3,17,9,8,23
Delhi Dynamo,4692,3,5,7,2,26,18,8,22
FC Pune City,4692,4,5,3,6,14,18,-4,18
Kerala Blast,4692,5,5,3,6,14,19,-5,18
NorthEast Un,4692,6,4,4,6,13,15,-2,16
Chennaiyin,4692,7,3,7,4,14,18,-4,16
FC Goa,4692,8,3,3,8,9,17,-8,12
Mumbai City,4693,1,7,4,3,18,9,9,25
Delhi Dynamo,4693,2,5,5,4,24,19,5,20
FC Goa,4693,3,6,2,6,19,15,4,20
FC Pune City,4693,4,5,4,5,15,16,-1,19
Kerala Blast,4693,5,5,4,5,12,14,-2,19
Kolkata,4693,6,3,8,3,16,19,-3,17
NorthEast Un,4693,7,4,3,7,10,14,-4,15
Chennaiyin,4693,8,3,6,5,13,21,-8,15
Delhi Dynamo,4694,1,6,6,2,25,16,9,24
Mumbai City,4694,2,6,4,4,16,9,7,22
Kolkata,4694,3,5,6,3,17,14,3,21
NorthEast Un,4694,4,5,4,5,11,10,1,19
Kerala Blast,4694,5,5,4,5,10,15,-5,19
FC Goa,4694,6,5,2,7,16,20,-4,17
FC Pune City,4694,7,4,3,7,12,16,-4,15
Chennaiyin,4694,8,3,5,6,16,23,-7,14
Mumbai City,4695,1,7,4,3,17,8,9,25
FC Pune City,4695,2,6,3,5,16,16,0,21
Delhi Dynamo,4695,3,4,7,3,24,18,6,19
NorthEast Un,4695,4,5,4,5,12,11,1,19
Kerala Blast,4695,5,5,4,5,11,15,-4,19
Kolkata,4695,6,4,6,4,15,15,0,18
FC Goa,4695,7,4,3,7,12,18,-6,15
Chennaiyin,4695,8,3,5,6,15,21,-6,14
Mumbai City,4696,1,6,5,3,17,9,8,23
Delhi Dynamo,4696,2,5,7,2,25,17,8,22
Kerala Blast,4696,3,6,4,4,17,18,-1,22
Kolkata,4696,4,4,7,3,18,18,0,19
NorthEast Un,4696,5,5,3,6,13,13,0,18
FC Goa,4696,6,5,2,7,12,16,-4,17
FC Pune City,4696,7,4,3,7,15,20,-5,15
Chennaiyin,4696,8,3,5,6,15,21,-6,14
Delhi Dynamo,4697,1,6,5,3,30,18,12,23
Mumbai City,4697,2,6,4,4,17,10,7,22
NorthEast Un,4697,3,6,3,5,14,11,3,21
FC Pune City,4697,4,5,4,5,14,15,-1,19
Kolkata,4697,5,4,6,4,18,16,2,18
FC Goa,4697,6,5,2,7,14,21,-7,17
Kerala Blast,4697,7,4,4,6,9,18,-9,16
Chennaiyin,4697,8,3,6,5,14,21,-7,15
Mumbai City,4698,1,6,5,3,17,9,8,23
Delhi Dynamo,4698,2,5,6,3,26,19,7,21
Kerala Blast,4698,3,6,3,5,13,15,-2,21
FC Goa,4698,4,6,2,6,13,16,-3,20
Kolkata,4698,5,4,6,4,16,16,0,18
FC Pune City,4698,6,5,3,6,14,16,-2,18
Chennaiyin,4698,7,4,5,5,14,18,-4,17
NorthEast Un,4698,8,4,2,8,11,15,-4,14
Mumbai City,4699,1,6,5,3,17,9,8,23
Delhi Dynamo,4699,2,5,7,2,27,17,10,22
Kolkata,4699,3,5,6,3,17,15,2,21
NorthEast Un,4699,4,5,4,5,14,11,3,19
Chennaiyin,4699,5,4,5,5,15,21,-6,17
Kerala Blast,4699,6,4,5,5,11,17,-6,17
FC Pune City,4699,7,4,4,6,13,16,-3,16
FC Goa,4699,8,4,2,8,13,21,-8,14
Delhi Dynamo,4700,1,5,7,2,25,15,10,22
Mumbai City,4700,2,6,4,4,16,11,5,22
Kerala Blast,4700,3,6,4,4,16,16,0,22
NorthEast Un,4700,4,5,3,6,14,13,1,18
FC Pune City,4700,5,4,5,5,15,17,-2,17
Kolkata,4700,6,3,7,4,15,18,-3,16
FC Goa,4700,7,4,4,6,12,15,-3,16
Chennaiyin,4700,8,3,6,5,14,22,-8,15
Mumbai City,4701,1,7,4,3,18,8,10,25
Delhi Dynamo,4701,2,5,6,3,26,20,6,21
Kolkata,4701,3,4,8,2,18,15,3,20
NorthEast Un,4701,4,5,4,5,16,15,1,19
Chennaiyin,4701,5,4,6,4,15,18,-3,18
Kerala Blast,4701,6,5,3,6,12,18,-6,18
FC Pune City,4701,7,4,4,6,15,18,-3,16
FC Goa,4701,8,3,3,8,9,17,-8,12
Mumbai City,4702,1,7,4,3,18,9,9,25
FC Goa,4702,2,6,2,6,15,16,-1,20
Kerala Blast,4702,3,5,4,5,11,15,-4,19
Delhi Dynamo,4702,4,4,6,4,23,18,5,18
Kolkata,4702,5,4,6,4,17,17,0,18
FC Pune City,4702,6,5,3,6,13,16,-3,18
NorthEast Un,4702,7,4,5,5,11,11,0,17
Chennaiyin,4702,8,3,6,5,13,19,-6,15
Delhi Dynamo,4703,1,5,7,2,25,17,8,22
Mumbai City,4703,2,6,4,4,17,10,7,22
NorthEast Un,4703,3,6,3,5,16,11,5,21
Kolkata,4703,4,4,7,3,14,14,0,19
FC Pune City,4703,5,5,3,6,15,16,-1,18
Kerala Blast,4703,6,5,3,6,12,17,-5,18
Chennaiyin,4703,7,4,5,5,14,21,-7,17
FC Goa,4703,8,3,4,7,9,16,-7,13
Mumbai City,4704,1,7,4,3,18,8,10,25
Kolkata,4704,2,5,6,3,18,14,4,21
Delhi Dynamo,4704,3,4,7,3,22,17,5,19
Kerala Blast,4704,4,5,4,5,11,15,-4,19
Chennaiyin,4704,5,4,6,4,17,19,-2,18
NorthEast Un,4704,6,4,4,6,11,13,-2,16
FC Goa,4704,7,4,4,6,11,16,-5,16
FC Pune City,4704,8,4,3,7,13,19,-6,15
Kolkata,4705,1,6,6,2,19,15,4,24
Mumbai City,4705,2,6,4,4,16,9,7,22
Delhi Dynamo,4705,3,5,6,3,23,16,7,21
FC Pune City,4705,4,5,3,6,17,18,-1,18
FC Goa,4705,5,5,2,7,15,16,-1,17
Chennaiyin,4705,6,4,5,5,14,22,-8,17
NorthEast Un,4705,7,4,4,6,11,12,-1,16
Kerala Blast,4705,8,4,4,6,11,18,-7,16
Delhi Dynamo,4706,1,6,6,2,24,15,9,24
Mumbai City,4706,2,6,4,4,16,9,7,22
Kerala Blast,4706,3,6,4,4,17,15,2,22
FC Pune City,4706,4,5,3,6,14,17,-3,18
NorthEast Un,4706,5,5,3,6,13,16,-3,18
Kolkata,4706,6,3,8,3,14,14,0,17
FC Goa,4706,7,4,3,7,10,16,-6,15
Chennaiyin,4706,8,3,5,6,16,22,-6,14
Kerala Blast,4707,1,7,3,4,17,15,2,24
Mumbai City,4707,2,6,5,3,17,9,8,23
Delhi Dynamo,4707,3,4,7,3,24,18,6,19
Kolkata,4707,4,4,7,3,17,14,3,19
NorthEast Un,4707,5,5,3,6,12,13,-1,18
FC Goa,4707,6,4,4,6,13,18,-5,16
Chennaiyin,4707,7,3,6,5,15,20,-5,15
FC Pune City,4707,8,4,3,7,13,21,-8,15
Mumbai City,4708,1,7,4,3,18,8,10,25
Kolkata,4708,2,5,7,2,19,13,6,22
Delhi Dynamo,4708,3,5,5,4,25,19,6,20
NorthEast Un,4708,4,6,2,6,14,11,3,20
Kerala Blast,4708,5,5,4,5,11,17,-6,19
FC Pune City,4708,6,4,4,6,13,17,-4,16
Chennaiyin,4708,7,3,6,5,14,21,-7,15
FC Goa,4708,8,3,4,7,11,19,-8,13
Mumbai City,4709,1,7,4,3,18,9,9,25
Kolkata,4709,2,6,6,2,20,12,8,24
Kerala Blast,4709,3,6,3,5,14,14,0,21
Delhi Dynamo,4709,4,5,5,4,24,17,7,20
Chennaiyin,4709,5,5,5,4,20,21,-1,20
FC Pune City,4709,6,4,3,7,12,21,-9,15
NorthEast Un,4709,7,4,2,8,9,13,-4,14
FC Goa,4709,8,4,2,8,13,23,-10,14
Delhi Dynamo,4710,1,6,5,3,26,17,9,23
NorthEast Un,4710,2,7,2,5,16,10,6,23
Mumbai City,4710,3,6,4,4,18,12,6,22
FC Pune City,4710,4,6,3,5,14,14,0,21
Kolkata,4710,5,4,7,3,18,15,3,19
FC Goa,4710,6,4,3,7,10,16,-6,15
Kerala Blast,4710,7,4,3,7,11,21,-10,15
Chennaiyin,4710,8,3,5,6,13,21,-8,14
Mumbai City,4711,1,6,5,3,18,10,8,23
Delhi Dynamo,4711,2,5,6,3,25,20,5,21
Kolkata,4711,3,5,6,3,18,13,5,21
Chennaiyin,4711,4,4,6,4,17,19,-2,18
FC Goa,4711,5,5,3,6,14,16,-2,18
Kerala Blast,4711,6,4,5,5,12,19,-7,17
FC Pune City,4711,7,4,4,6,14,18,-4,16
NorthEast Un,4711,8,4,3,7,11,14,-3,15
Delhi Dynamo,4712,1,6,5,3,24,16,8,23
Mumbai City,4712,2,6,4,4,16,10,6,22
Kolkata,4712,3,5,7,2,16,13,3,22
NorthEast Un,4712,4,6,3,5,16,13,3,21
FC Pune City,4712,5,5,4,5,14,15,-1,19
Kerala Blast,4712,6,4,4,6,11,17,-6,16
Chennaiyin,4712,7,3,6,5,16,21,-5,15
FC Goa,4712,8,3,3,8,9,17,-8,12
Mumbai City,4713,1,6,5,3,17,9,8,23
Delhi Dynamo,4713,2,5,7,2,26,17,9,22
Kolkata,4713,3,4,7,3,14,14,0,19
FC Pune City,4713,4,5,4,5,14,15,-1,19
FC Goa,4713,5,5,3,6,15,17,-2,18
Kerala Blast,4713,6,5,3,6,14,16,-2,18
Chennaiyin,4713,7,4,5,5,16,20,-4,17
NorthEast Un,4713,8,4,2,8,9,17,-8,14
Mumbai City,4714,1,6,5,3,19,11,8,23
Kolkata,4714,2,5,7,2,17,13,4,22
Chennaiyin,4714,3,5,5,4,19,19,0,20
Kerala Blast,4714,4,5,4,5,12,16,-4,19
Delhi Dynamo,4714,5,4,6,4,25,21,4,18
NorthEast Un,4714,6,5,2,7,12,14,-2,17
FC Pune City,4714,7,4,4,6,13,16,-3,16
FC Goa,4714,8,4,3,7,12,19,-7,15
Delhi Dynamo,4715,1,6,6,2,31,19,12,24
Mumbai City,4715,2,6,4,4,16,11,5,22
Chennaiyin,4715,3,5,5,4,17,17,0,20
Kerala Blast,4715,4,5,4,5,12,16,-4,19
NorthEast Un,4715,5,5,3,6,13,13,0,18
Kolkata,4715,6,3,8,3,16,17,-1,17
FC Pune City,4715,7,4,5,5,15,17,-2,17
FC Goa,4715,8,3,3,8,12,22,-10,12
Delhi Dynamo,4716,1,6,6,2,27,17,10,24
Mumbai City,4716,2,6,5,3,17,9,8,23
Kolkata,4716,3,5,6,3,19,16,3,21
Kerala Blast,4716,4,5,4,5,11,14,-3,19
Chennaiyin,4716,5,4,6,4,17,18,-1,18
FC Pune City,4716,6,4,4,6,14,18,-4,16
FC Goa,4716,7,4,3,7,11,18,-7,15
NorthEast Un,4716,8,4,2,8,11,17,-6,14
Mumbai City,4717,1,7,4,3,17,8,9,25
Delhi Dynamo,4717,2,5,6,3,23,15,8,21
Kolkata,4717,3,4,8,2,18,16,2,20
NorthEast Un,4717,4,5,3,6,12,11,1,18
Chennaiyin,4717,5,4,6,4,17,20,-3,18
Kerala Blast,4717,6,5,3,6,12,17,-5,18
FC Pune City,4717,7,4,4,6,13,17,-4,16
FC Goa,4717,8,3,4,7,12,20,-8,13
Kerala Blast,4718,1,7,3,4,16,15,1,24
Delhi Dynamo,4718,2,5,7,2,27,17,10,22
Mumbai City,4718,3,6,4,4,16,11,5,22
Kolkata,4718,4,4,6,4,17,18,-1,18
Chennaiyin,4718,5,4,6,4,15,18,-3,18
NorthEast Un,4718,6,4,4,6,9,11,-2,16
FC Goa,4718,7,4,3,7,15,19,-4,15
FC Pune City,4718,8,4,3,7,13,19,-6,15
Mumbai City,4719,1,7,4,3,18,8,10,25
Kolkata,4719,2,5,7,2,18,13,5,22
Delhi Dynamo,4719,3,5,6,3,24,17,7,21
Kerala Blast,4719,4,5,5,4,12,14,-2,20
NorthEast Un,4719,5,5,3,6,12,12,0,18
Chennaiyin,4719,6,4,5,5,15,20,-5,17
FC Pune City,4719,7,4,3,7,13,18,-5,15
FC Goa,4719,8,3,3,8,10,20,-10,12
Mumbai City,4720,1,7,4,3,20,9,11,25
Kolkata,4720,2,4,8,2,15,13,2,20
Delhi Dynamo,4720,3,4,6,4,24,21,3,18
NorthEast Un,4720,4,5,3,6,14,13,1,18
FC Goa,4720,5,5,3,6,12,15,-3,18
Kerala Blast,4720,6,5,3,6,12,18,-6,18
Chennaiyin,4720,7,4,5,5,15,20,-5,17
FC Pune City,4720,8,4,4,6,12,15,-3,16
Delhi Dynamo,4721,1,6,6,2,25,16,9,24
Kolkata,4721,2,6,6,2,17,13,4,24
Mumbai City,4721,3,6,4,4,16,9,7,22
Kerala Blast,4721,4,5,4,5,17,16,1,19
NorthEast Un,4721,5,5,3,6,14,16,-2,18
Chennaiyin,4721,6,4,5,5,15,21,-6,17
FC Pune City,4721,7,4,4,6,13,16,-3,16
FC Goa,4721,8,3,2,9,9,19,-10,11
Mumbai City,4722,1,6,4,4,16,9,7,22
Delhi Dynamo,4722,2,5,6,3,24,19,5,21
Kolkata,4722,3,4,8,2,21,18,3,20
NorthEast Un,4722,4,6,2,6,13,11,2,20
Kerala Blast,4722,5,5,5,4,16,18,-2,20
FC Pune City,4722,6,4,5,5,15,17,-2,17
FC Goa,4722,7,4,3,7,14,20,-6,15
Chennaiyin,4722,8,3,5,6,13,20,-7,14
Mumbai City,4723,1,6,5,3,16,8,8,23
Kolkata,4723,2,5,6,3,21,20,1,21
Delhi Dynamo,4723,3,4,7,3,24,18,6,19
Chennaiyin,4723,4,4,6,4,16,18,-2,18
NorthEast Un,4723,5,4,5,5,12,12,0,17
FC Goa,4723,6,5,2,7,16,20,-4,17
Kerala Blast,4723,7,4,5,5,13,19,-6,17
FC Pune City,4723,8,4,4,6,16,19,-3,16
Mumbai City,4724,1,7,4,3,20,10,10,25
Kerala Blast,4724,2,6,4,4,13,15,-2,22
Delhi Dynamo,4724,3,5,5,4,26,20,6,20
NorthEast Un,4724,4,6,2,6,11,10,1,20
FC Pune City,4724,5,5,3,6,14,16,-2,18
Chennaiyin,4724,6,4,5,5,15,19,-4,17
Kolkata,4724,7,3,7,4,14,15,-1,16
FC Goa,4724,8,4,2,8,11,19,-8,14
Mumbai City,4725,1,7,4,3,17,8,9,25
Kolkata,4725,2,5,6,3,18,15,3,21
Kerala Blast,4725,3,6,3,5,16,17,-1,21
Delhi Dynamo,4725,4,4,6,4,21,17,4,18
FC Goa,4725,5,5,3,6,11,15,-4,18
NorthEast Un,4725,6,5,2,7,13,15,-2,17
Chennaiyin,4725,7,4,5,5,15,18,-3,17
FC Pune City,4725,8,4,3,7,12,18,-6,15
Delhi Dynamo,4726,1,6,6,2,27,18,9,24
Kolkata,4726,2,6,6,2,17,13,4,24
Mumbai City,4726,3,6,5,3,17,9,8,23
Kerala Blast,4726,4,5,4,5,13,17,-4,19
Chennaiyin,4726,5,4,5,5,15,21,-6,17
FC Pune City,4726,6,4,4,6,13,16,-3,16
NorthEast Un,4726,7,4,2,8,13,16,-3,14
FC Goa,4726,8,4,2,8,12,17,-5,14
Mumbai City,4727,1,7,4,3,18,9,9,25
FC Pune City,4727,2,6,3,5,16,14,2,21
Delhi Dynamo,4727,3,4,7,3,24,18,6,19
FC Goa,4727,4,5,3,6,14,16,-2,18
Kolkata,4727,5,4,6,4,14,17,-3,18
Kerala Blast,4727,6,5,3,6,13,18,-5,18
Chennaiyin,4727,7,4,5,5,15,19,-4,17
NorthEast Un,4727,8,4,3,7,12,15,-3,15
Mumbai City,4728,1,6,5,3,17,9,8,23
Delhi Dynamo,4728,2,5,7,2,25,17,8,22
Kerala Blast,4728,3,5,5,4,14,16,-2,20
Chennaiyin,4728,4,4,6,4,18,19,-1,18
Kolkata,4728,5,3,8,3,16,16,0,17
FC Pune City,4728,6,4,5,5,14,16,-2,17
NorthEast Un,4728,7,4,3,7,11,16,-5,15
FC Goa,4728,8,4,3,7,13,19,-6,15
Mumbai City,4729,1,7,4,3,18,8,10,25
Delhi Dynamo,4729,2,6,5,3,24,16,8,23
Kolkata,4729,3,5,6,3,15,13,2,21
NorthEast Un,4729,4,5,3,6,13,12,1,18
FC Goa,4729,5,5,2,7,10,15,-5,17
FC Pune City,4729,6,4,4,6,13,16,-3,16
Kerala Blast,4729,7,4,4,6,10,18,-8,16
Chennaiyin,4729,8,3,6,5,14,19,-5,15
Mumbai City,4730,1,6,5,3,17,9,8,23
Delhi Dynamo,4730,2,5,7,2,25,16,9,22
Kolkata,4730,3,5,7,2,18,14,4,22
Kerala Blast,4730,4,5,4,5,14,14,0,19
Chennaiyin,4730,5,4,5,5,15,19,-4,17
FC Pune City,4730,6,4,4,6,13,20,-7,16
NorthEast Un,4730,7,4,3,7,9,12,-3,15
FC Goa,4730,8,4,3,7,12,19,-7,15
Mumbai City,4731,1,7,4,3,17,8,9,25
Delhi Dynamo,4731,2,5,6,3,22,15,7,21
Kolkata,4731,3,4,8,2,16,14,2,20
Chennaiyin,4731,4,4,6,4,16,19,-3,18
Kerala Blast,4731,5,5,3,6,11,19,-8,18
NorthEast Un,4731,6,5,2,7,14,12,2,17
FC Pune City,4731,7,4,4,6,13,16,-3,16
FC Goa,4731,8,3,5,6,9,15,-6,14
Mumbai City,4732,1,6,5,3,16,8,8,23
Delhi Dynamo,4732,2,5,7,2,25,17,8,22
Kolkata,4732,3,5,6,3,18,15,3,21
NorthEast Un,4732,4,5,4,5,14,11,3,19
Chennaiyin,4732,5,4,6,4,15,18,-3,18
FC Pune City,4732,6,4,4,6,13,17,-4,16
Kerala Blast,4732,7,4,4,6,10,18,-8,16
FC Goa,4732,8,4,2,8,13,20,-7,14
Mumbai City,4733,1,7,4,3,18,9,9,25
Delhi Dynamo,4733,2,5,6,3,25,18,7,21
Kolkata,4733,3,4,7,3,19,16,3,19
FC Pune City,4733,4,5,4,5,13,14,-1,19
Chennaiyin,4733,5,4,6,4,16,18,-2,18
Kerala Blast,4733,6,4,5,5,9,16,-7,17
NorthEast Un,4733,7,4,3,7,10,13,-3,15
FC Goa,4733,8,3,5,6,13,19,-6,14
Mumbai City,4734,1,6,5,3,17,9,8,23
FC Goa,4734,2,6,2,6,16,17,-1,20
Delhi Dynamo,4734,3,4,7,3,23,19,4,19
Kolkata,4734,4,4,7,3,17,16,1,19
NorthEast Un,4734,5,5,3,6,10,11,-1,18
Chennaiyin,4734,6,4,5,5,16,19,-3,17
Kerala Blast,4734,7,4,5,5,9,14,-5,17
FC Pune City,4734,8,4,4,6,14,17,-3,16
Mumbai City,4735,1,6,5,3,17,9,8,23
Delhi Dynamo,4735,2,5,7,2,24,16,8,22
Kolkata,4735,3,5,7,2,16,12,4,22
NorthEast Un,4735,4,6,2,6,12,11,1,20
Kerala Blast,4735,5,5,3,6,13,18,-5,18
FC Pune City,4735,6,4,4,6,13,17,-4,16
Chennaiyin,4735,7,3,6,5,13,18,-5,15
FC Goa,4735,8,3,4,7,9,16,-7,13
Mumbai City,4736,1,7,4,3,18,9,9,25
Kolkata,4736,2,6,6,2,21,13,8,24
Delhi Dynamo,4736,3,6,5,3,30,18,12,23
FC Pune City,4736,4,5,3,6,14,18,-4,18
Kerala Blast,4736,5,5,3,6,11,16,-5,18
NorthEast Un,4736,6,5,2,7,12,15,-3,17
Chennaiyin,4736,7,4,5,5,16,20,-4,17
FC Goa,4736,8,3,2,9,10,23,-13,11
Mumbai City,4737,1,6,5,3,18,10,8,23
Kolkata,4737,2,5,6,3,19,16,3,21
FC Pune City,4737,3,6,3,5,15,15,0,21
NorthEast Un,4737,4,6,2,6,12,11,1,20
Delhi Dynamo,4737,5,4,7,3,24,18,6,19
Kerala Blast,4737,6,5,3,6,12,17,-5,18
Chennaiyin,4737,7,3,6,5,14,19,-5,15
FC Goa,4737,8,3,4,7,9,17,-8,13
Mumbai City,4738,1,7,4,3,18,9,9,25
Kolkata,4738,2,4,8,2,18,16,2,20
NorthEast Un,4738,3,6,2,6,14,13,1,20
Kerala Blast,4738,4,5,4,5,13,17,-4,19
FC Goa,4738,5,5,3,6,16,17,-1,18
Delhi Dynamo,4738,6,4,5,5,23,22,1,17
Chennaiyin,4738,7,4,5,5,17,21,-4,17
FC Pune City,4738,8,4,3,7,13,17,-4,15
Mumbai City,4739,1,6,5,3,19,11,8,23
Delhi Dynamo,4739,2,5,7,2,28,17,11,22
Kolkata,4739,3,4,8,2,16,14,2,20
Kerala Blast,4739,4,5,4,5,13,17,-4,19
NorthEast Un,4739,5,5,3,6,11,11,0,18
FC Pune City,4739,6,4,5,5,13,15,-2,17
Chennaiyin,4739,7,4,5,5,15,19,-4,17
FC Goa,4739,8,3,3,8,10,21,-11,12
Delhi Dynamo,4740,1,5,7,2,23,14,9,22
Mumbai City,4740,2,6,4,4,16,10,6,22
Kolkata,4740,3,4,7,3,21,18,3,19
NorthEast Un,4740,4,5,4,5,12,11,1,19
Kerala Blast,4740,5,5,4,5,12,18,-6,19
FC Goa,4740,6,5,3,6,11,15,-4,18
FC Pune City,4740,7,4,4,6,14,17,-3,16
Chennaiyin,4740,8,3,5,6,15,21,-6,14
Mumbai City,4741,1,6,5,3,18,10,8,23
Kolkata,4741,2,5,6,3,19,15,4,21
Kerala Blast,4741,3,5,4,5,12,17,-5,19
Delhi Dynamo,4741,4,4,6,4,24,19,5,18
NorthEast Un,4741,5,5,3,6,10,10,0,18
FC Pune City,4741,6,5,3,6,16,17,-1,18
Chennaiyin,4741,7,4,6,4,16,19,-3,18
FC Goa,4741,8,4,3,7,12,20,-8,15
Delhi Dynamo,4742,1,6,5,3,26,20,6,23
Mumbai City,4742,2,6,4,4,18,11,7,22
Kerala Blast,4742,3,6,4,4,17,17,0,22
NorthEast Un,4742,4,5,4,5,16,13,3,19
Kolkata,4742,5,3,7,4,16,17,-1,16
Chennaiyin,4742,6,3,7,4,14,18,-4,16
FC Pune City,4742,7,4,4,6,13,18,-5,16
FC Goa,4742,8,4,3,7,9,15,-6,15
Delhi Dynamo,4743,1,7,5,2,27,15,12,26
Mumbai City,4743,2,6,4,4,16,9,7,22
Kerala Blast,4743,3,6,3,5,15,17,-2,21
Kolkata,4743,4,4,7,3,19,17,2,19
FC Pune City,4743,5,5,3,6,16,19,-3,18
Chennaiyin,4743,6,4,5,5,15,21,-6,17
FC Goa,4743,7,4,3,7,14,18,-4,15
NorthEast Un,4743,8,4,2,8,10,16,-6,14
Delhi Dynamo,4744,1,7,5,2,28,15,13,26
Mumbai City,4744,2,6,4,4,17,10,7,22
NorthEast Un,4744,3,6,2,6,13,12,1,20
FC Pune City,4744,4,5,4,5,17,16,1,19
Kolkata,4744,5,4,7,3,16,15,1,19
Kerala Blast,4744,6,5,3,6,12,19,-7,18
Chennaiyin,4744,7,3,6,5,16,22,-6,15
FC Goa,4744,8,3,3,8,12,22,-10,12
Delhi Dynamo,4745,1,6,6,2,27,17,10,24
Mumbai City,4745,2,6,4,4,16,9,7,22
Kerala Blast,4745,3,6,4,4,13,14,-1,22
NorthEast Un,4745,4,5,2,7,14,15,-1,17
FC Pune City,4745,5,4,5,5,14,16,-2,17
Chennaiyin,4745,6,4,5,5,14,20,-6,17
Kolkata,4745,7,3,7,4,15,17,-2,16
FC Goa,4745,8,4,3,7,12,17,-5,15
Mumbai City,4746,1,6,5,3,16,8,8,23
Kerala Blast,4746,2,6,4,4,14,14,0,22
Delhi Dynamo,4746,3,5,6,3,25,17,8,21
Kolkata,4746,4,4,8,2,18,16,2,20
NorthEast Un,4746,5,6,2,6,15,15,0,20
Chennaiyin,4746,6,4,5,5,15,20,-5,17
FC Pune City,4746,7,4,3,7,13,17,-4,15
FC Goa,4746,8,3,3,8,10,19,-9,12
Delhi Dynamo,4747,1,6,6,2,26,17,9,24
Mumbai City,4747,2,6,4,4,17,10,7,22
NorthEast Un,4747,3,5,4,5,13,11,2,19
Kerala Blast,4747,4,5,4,5,11,16,-5,19
FC Pune City,4747,5,5,3,6,16,16,0,18
FC Goa,4747,6,5,2,7,14,18,-4,17
Kolkata,4747,7,3,7,4,13,16,-3,16
Chennaiyin,4747,8,3,6,5,16,22,-6,15
Mumbai City,4748,1,7,4,3,19,10,9,25
NorthEast Un,4748,2,6,3,5,14,11,3,21
Kerala Blast,4748,3,6,3,5,16,17,-1,21
Delhi Dynamo,4748,4,5,5,4,26,20,6,20
Kolkata,4748,5,4,7,3,17,18,-1,19
FC Goa,4748,6,4,3,7,15,20,-5,15
FC Pune City,4748,7,4,3,7,13,18,-5,15
Chennaiyin,4748,8,3,6,5,15,21,-6,15
Delhi Dynamo,4749,1,6,5,3,24,16,8,23
Mumbai City,4749,2,6,4,4,16,10,6,22
Kolkata,4749,3,5,7,2,19,15,4,22
Chennaiyin,4749,4,5,5,4,16,18,-2,20
FC Pune City,4749,5,5,3,6,15,17,-2,18
Kerala Blast,4749,6,5,3,6,12,17,-5,18
FC Goa,4749,7,4,3,7,12,17,-5,15
NorthEast Un,4749,8,4,2,8,9,13,-4,14
Mumbai City,4750,1,7,4,3,18,8,10,25
Kolkata,4750,2,5,7,2,20,14,6,22
Delhi Dynamo,4750,3,5,5,4,25,19,6,20
Kerala Blast,4750,4,5,4,5,17,17,0,19
NorthEast Un,4750,5,5,3,6,14,17,-3,18
FC Pune City,4750,6,5,3,6,13,17,-4,18
Chennaiyin,4750,7,3,7,4,16,20,-4,16
FC Goa,4750,8,3,3,8,10,21,-11,12
Delhi Dynamo,4751,1,6,5,3,25,16,9,23
NorthEast Un,4751,2,7,2,5,13,10,3,23
Mumbai City,4751,3,6,4,4,17,10,7,22
Kerala Blast,4751,4,6,3,5,12,15,-3,21
FC Pune City,4751,5,5,3,6,15,16,-1,18
Kolkata,4751,5,4,6,4,15,16,-1,18
Chennaiyin,4751,7,3,5,6,14,20,-6,14
FC Goa,4751,8,4,2,8,10,18,-8,14
Mumbai City,4752,1,6,5,3,16,8,8,23
Kolkata,4752,2,4,8,2,16,13,3,20
Delhi Dynamo,4752,3,4,7,3,22,16,6,19
NorthEast Un,4752,4,5,4,5,11,10,1,19
FC Pune City,4752,5,5,3,6,15,17,-2,18
FC Goa,4752,6,5,3,6,12,15,-3,18
Kerala Blast,4752,7,4,4,6,11,18,-7,16
Chennaiyin,4752,8,3,6,5,14,20,-6,15
Mumbai City,4753,1,7,4,3,20,9,11,25
Delhi Dynamo,4753,2,5,6,3,27,20,7,21
FC Pune City,4753,3,5,4,5,15,16,-1,19
Kerala Blast,4753,4,5,4,5,15,20,-5,19
Kolkata,4753,5,4,6,4,17,15,2,18
Chennaiyin,4753,6,3,7,4,16,20,-4,16
FC Goa,4753,7,4,4,6,13,18,-5,16
NorthEast Un,4753,8,4,3,7,11,16,-5,15
Delhi Dynamo,4754,1,6,6,2,29,16,13,24
Mumbai City,4754,2,6,5,3,17,9,8,23
Kerala Blast,4754,3,6,4,4,11,13,-2,22
Kolkata,4754,4,5,6,3,18,13,5,21
Chennaiyin,4754,5,4,5,5,15,20,-5,17
FC Pune City,4754,6,4,4,6,12,17,-5,16
NorthEast Un,4754,7,4,2,8,10,15,-5,14
FC Goa,4754,8,4,2,8,11,20,-9,14
Mumbai City,4755,1,7,4,3,19,8,11,25
Delhi Dynamo,4755,2,5,6,3,24,19,5,21
NorthEast Un,4755,3,5,4,5,15,12,3,19
Kolkata,4755,4,4,7,3,17,17,0,19
Kerala Blast,4755,5,5,4,5,13,16,-3,19
FC Pune City,4755,6,5,3,6,15,17,-2,18
FC Goa,4755,7,4,3,7,13,18,-5,15
Chennaiyin,4755,8,3,5,6,14,23,-9,14
Mumbai City,4756,1,7,4,3,19,9,10,25
Kolkata,4756,2,4,8,2,16,13,3,20
FC Pune City,4756,3,5,4,5,14,14,0,19
FC Goa,4756,4,5,3,6,10,14,-4,18
Kerala Blast,4756,5,5,3,6,11,18,-7,18
Delhi Dynamo,4756,6,4,5,5,23,20,3,17
NorthEast Un,4756,7,5,2,7,12,14,-2,17
Chennaiyin,4756,8,4,5,5,16,19,-3,17
Mumbai City,4757,1,7,4,3,18,9,9,25
Kolkata,4757,2,4,8,2,19,17,2,20
Chennaiyin,4757,3,5,5,4,20,19,1,20
Kerala Blast,4757,4,5,5,4,12,14,-2,20
Delhi Dynamo,4757,5,4,7,3,22,16,6,19
NorthEast Un,4757,6,4,4,6,10,13,-3,16
FC Pune City,4757,7,4,3,7,14,19,-5,15
FC Goa,4757,8,3,4,7,11,19,-8,13
Mumbai City,4758,1,7,4,3,19,10,9,25
Delhi Dynamo,4758,2,6,5,3,26,17,9,23
Kolkata,4758,3,5,6,3,19,16,3,21
FC Pune City,4758,4,5,4,5,16,16,0,19
Chennaiyin,4758,5,4,5,5,15,19,-4,17
Kerala Blast,4758,6,4,5,5,12,19,-7,17
NorthEast Un,4758,7,4,3,7,10,12,-2,15
FC Goa,4758,8,4,2,8,10,18,-8,14
Delhi Dynamo,4759,1,6,6,2,26,15,11,24
Mumbai City,4759,2,6,5,3,17,9,8,23
FC Pune City,4759,3,6,3,5,17,14,3,21
NorthEast Un,4759,4,6,2,6,11,10,1,20
Kolkata,4759,5,4,7,3,15,15,0,19
Chennaiyin,4759,6,4,5,5,16,19,-3,17
Kerala Blast,4759,7,4,3,7,9,18,-9,15
FC Goa,4759,8,3,3,8,10,21,-11,12
Mumbai City,4760,1,7,4,3,20,8,12,25
FC Pune City,4760,2,6,3,5,14,14,0,21
Kerala Blast,4760,3,6,3,5,13,16,-3,21
Delhi Dynamo,4760,4,5,5,4,24,20,4,20
Chennaiyin,4760,5,4,6,4,16,19,-3,18
NorthEast Un,4760,6,5,2,7,14,15,-1,17
Kolkata,4760,7,3,7,4,15,16,-1,16
FC Goa,4760,8,3,4,7,9,17,-8,13
Kolkata,4761,1,5,7,2,21,13,8,22
Mumbai City,4761,2,6,4,4,16,11,5,22
Delhi Dynamo,4761,3,5,6,3,28,20,8,21
Chennaiyin,4761,4,5,5,4,16,17,-1,20
NorthEast Un,4761,5,5,3,6,13,13,0,18
FC Pune City,4761,6,5,3,6,15,18,-3,18
Kerala Blast,4761,7,4,4,6,10,17,-7,16
FC Goa,4761,8,4,2,8,12,22,-10,14
Mumbai City,4762,1,7,4,3,18,9,9,25
FC Pune City,4762,2,5,4,5,13,14,-1,19
Kerala Blast,4762,3,5,4,5,12,16,-4,19
Delhi Dynamo,4762,4,4,6,4,23,18,5,18
Kolkata,4762,5,3,9,2,18,17,1,18
NorthEast Un,4762,6,5,3,6,11,11,0,18
FC Goa,4762,7,4,4,6,13,18,-5,16
Chennaiyin,4762,8,3,6,5,14,19,-5,15
Delhi Dynamo,4763,1,6,6,2,31,20,11,24
Mumbai City,4763,2,6,4,4,19,13,6,22
Kolkata,4763,3,5,7,2,17,13,4,22
Kerala Blast,4763,4,6,3,5,12,15,-3,21
NorthEast Un,4763,5,4,4,6,13,14,-1,16
FC Pune City,4763,6,4,4,6,12,15,-3,16
Chennaiyin,4763,7,3,6,5,15,20,-5,15
FC Goa,4763,8,4,2,8,12,21,-9,14
Delhi Dynamo,4764,1,5,7,2,23,15,8,22
Mumbai City,4764,2,6,4,4,16,9,7,22
Kolkata,4764,3,4,8,2,15,13,2,20
Chennaiyin,4764,4,4,6,4,15,17,-2,18
NorthEast Un,4764,5,4,5,5,10,10,0,17
FC Pune City,4764,6,4,5,5,14,16,-2,17
Kerala Blast,4764,7,4,5,5,10,15,-5,17
FC Goa,4764,8,3,4,7,8,16,-8,13
Mumbai City,4765,1,7,4,3,20,10,10,25
Kolkata,4765,2,5,6,3,15,15,0,21
Delhi Dynamo,4765,3,5,5,4,27,20,7,20
FC Goa,4765,4,6,2,6,14,15,-1,20
NorthEast Un,4765,5,5,3,6,11,13,-2,18
FC Pune City,4765,6,4,4,6,12,15,-3,16
Kerala Blast,4765,7,4,4,6,9,15,-6,16
Chennaiyin,4765,8,3,6,5,14,19,-5,15
Mumbai City,4766,1,7,4,3,20,10,10,25
Kolkata,4766,2,5,6,3,20,17,3,21
Kerala Blast,4766,3,6,3,5,12,15,-3,21
Delhi Dynamo,4766,4,5,5,4,28,23,5,20
NorthEast Un,4766,5,5,3,6,13,13,0,18
Chennaiyin,4766,6,4,6,4,14,17,-3,18
FC Pune City,4766,7,4,3,7,13,18,-5,15
FC Goa,4766,8,4,2,8,12,19,-7,14
Mumbai City,4767,1,7,4,3,18,8,10,25
Kolkata,4767,2,5,7,2,15,12,3,22
NorthEast Un,4767,3,6,3,5,17,13,4,21
Delhi Dynamo,4767,4,5,5,4,24,19,5,20
Kerala Blast,4767,5,4,5,5,11,17,-6,17
FC Pune City,4767,6,4,4,6,13,16,-3,16
Chennaiyin,4767,7,3,6,5,15,23,-8,15
FC Goa,4767,8,4,2,8,12,17,-5,14
Mumbai City,4768,1,7,4,3,19,9,10,25
Kerala Blast,4768,2,6,4,4,14,15,-1,22
Delhi Dynamo,4768,3,5,6,3,25,19,6,21
Kolkata,4768,4,4,7,3,19,16,3,19
NorthEast Un,4768,5,5,3,6,11,11,0,18
Chennaiyin,4768,6,3,6,5,15,20,-5,15
FC Goa,4768,7,4,3,7,12,18,-6,15
FC Pune City,4768,8,4,3,7,13,20,-7,15
Mumbai City,4769,1,7,4,3,18,8,10,25
Delhi Dynamo,4769,2,6,5,3,25,17,8,23
FC Pune City,4769,3,6,3,5,17,16,1,21
NorthEast Un,4769,4,5,3,6,13,13,0,18
Kolkata,4769,5,4,6,4,16,17,-1,18
Chennaiyin,4769,6,4,6,4,16,19,-3,18
Kerala Blast,4769,7,4,3,7,13,20,-7,15
FC Goa,4769,8,4,2,8,11,19,-8,14
Mumbai City,4770,1,7,4,3,18,9,9,25
Kolkata,4770,2,5,6,3,16,15,1,21
NorthEast Un,4770,3,5,4,5,13,10,3,19
Delhi Dynamo,4770,4,4,6,4,24,21,3,18
Chennaiyin,4770,5,4,6,4,15,18,-3,18
Kerala Blast,4770,6,4,5,5,10,15,-5,17
FC Pune City,4770,7,4,4,6,12,15,-3,16
FC Goa,4770,8,4,3,7,12,17,-5,15
Mumbai City,4771,1,7,4,3,18,9,9,25
Delhi Dynamo,4771,2,6,5,3,25,16,9,23
FC Pune City,4771,3,6,3,5,16,16,0,21
NorthEast Un,4771,4,6,2,6,12,11,1,20
Kolkata,4771,5,4,7,3,16,15,1,19
FC Goa,4771,6,4,3,7,10,16,-6,15
Kerala Blast,4771,7,4,3,7,10,17,-7,15
Chennaiyin,4771,8,3,5,6,13,20,-7,14
Mumbai City,4772,1,7,4,3,17,8,9,25
Kolkata,4772,2,5,6,3,17,14,3,21
NorthEast Un,4772,3,6,3,5,13,10,3,21
Kerala Blast,4772,4,6,3,5,12,16,-4,21
Delhi Dynamo,4772,5,4,6,4,23,18,5,18
FC Pune City,4772,6,4,3,7,12,16,-4,15
Chennaiyin,4772,7,3,6,5,13,19,-6,15
FC Goa,4772,8,4,3,7,11,17,-6,15
Mumbai City,4773,1,6,4,4,17,10,7,22
Delhi Dynamo,4773,2,5,6,3,26,20,6,21
FC Pune City,4773,3,6,3,5,17,17,0,21
Kolkata,4773,4,4,7,3,16,15,1,19
NorthEast Un,4773,5,5,3,6,12,11,1,18
Chennaiyin,4773,6,4,5,5,15,20,-5,17
Kerala Blast,4773,7,4,5,5,12,17,-5,17
FC Goa,4773,8,4,3,7,13,18,-5,15
Delhi Dynamo,4774,1,6,6,2,25,14,11,24
Mumbai City,4774,2,6,5,3,16,8,8,23
FC Pune City,4774,3,5,3,6,16,17,-1,18
Chennaiyin,4774,4,4,6,4,16,18,-2,18
Kolkata,4774,5,4,6,4,14,16,-2,18
Kerala Blast,4774,6,5,3,6,13,19,-6,18
NorthEast Un,4774,7,5,2,7,12,13,-1,17
FC Goa,4774,8,4,3,7,11,18,-7,15
Delhi Dynamo,4775,1,6,6,2,24,15,9,24
Mumbai City,4775,2,6,4,4,16,9,7,22
Kolkata,4775,3,5,6,3,22,19,3,21
FC Pune City,4775,4,5,3,6,16,19,-3,18
Kerala Blast,4775,5,5,3,6,12,18,-6,18
NorthEast Un,4775,6,5,2,7,12,13,-1,17
FC Goa,4775,7,4,4,6,16,20,-4,16
Chennaiyin,4775,8,3,6,5,18,23,-5,15
Mumbai City,4776,1,7,4,3,18,9,9,25
Kerala Blast,4776,2,6,4,4,15,15,0,22
Delhi Dynamo,4776,3,5,5,4,25,18,7,20
FC Goa,4776,4,6,2,6,14,15,-1,20
NorthEast Un,4776,5,5,3,6,11,13,-2,18
FC Pune City,4776,6,5,3,6,15,18,-3,18
Kolkata,4776,7,3,6,5,16,19,-3,15
Chennaiyin,4776,8,3,5,6,13,20,-7,14
Mumbai City,4777,1,6,5,3,16,8,8,23
Kerala Blast,4777,2,6,3,5,14,17,-3,21
NorthEast Un,4777,3,6,2,6,16,13,3,20
Delhi Dynamo,4777,4,4,6,4,21,20,1,18
Chennaiyin,4777,5,4,6,4,16,18,-2,18
Kolkata,4777,6,3,8,3,16,16,0,17
FC Goa,4777,7,4,4,6,12,15,-3,16
FC Pune City,4777,8,4,4,6,15,19,-4,16
Mumbai City,4778,1,7,4,3,18,8,10,25
Delhi Dynamo,4778,2,5,6,3,28,19,9,21
Kolkata,4778,3,5,6,3,17,15,2,21
Kerala Blast,4778,4,6,3,5,15,17,-2,21
Chennaiyin,4778,5,5,5,4,19,18,1,20
FC Goa,4778,6,4,3,7,13,19,-6,15
FC Pune City,4778,6,4,3,7,13,19,-6,15
NorthEast Un,4778,8,4,2,8,12,20,-8,14
Delhi Dynamo,4779,1,6,6,2,26,15,11,24
Kerala Blast,4779,2,7,3,4,14,13,1,24
Mumbai City,4779,3,6,5,3,16,8,8,23
Kolkata,4779,4,4,7,3,17,17,0,19
NorthEast Un,4779,5,5,2,7,11,14,-3,17
Chennaiyin,4779,6,4,5,5,15,19,-4,17
FC Pune City,4779,7,4,3,7,13,18,-5,15
FC Goa,4779,8,3,3,8,11,19,-8,12
Mumbai City,4780,1,6,4,4,16,10,6,22
Kerala Blast,4780,2,6,3,5,12,14,-2,21
Delhi Dynamo,4780,3,5,5,4,24,19,5,20
NorthEast Un,4780,4,6,2,6,16,12,4,20
Kolkata,4780,5,4,7,3,17,15,2,19
FC Pune City,4780,6,5,3,6,13,16,-3,18
FC Goa,4780,7,5,3,6,13,17,-4,18
Chennaiyin,4780,8,3,5,6,14,22,-8,14
Mumbai City,4781,1,7,4,3,19,9,10,25
Delhi Dynamo,4781,2,6,5,3,26,17,9,23
Kolkata,4781,3,4,6,4,16,14,2,18
Chennaiyin,4781,4,4,6,4,14,17,-3,18
FC Pune City,4781,5,5,3,6,13,16,-3,18
Kerala Blast,4781,6,5,3,6,12,20,-8,18
NorthEast Un,4781,7,5,2,7,13,13,0,17
FC Goa,4781,8,4,3,7,9,16,-7,15
Delhi Dynamo,4782,1,6,6,2,25,16,9,24
Mumbai City,4782,2,6,5,3,17,9,8,23
Kolkata,4782,3,4,7,3,16,15,1,19
Kerala Blast,4782,4,5,4,5,11,17,-6,19
NorthEast Un,4782,5,5,2,7,11,12,-1,17
FC Pune City,4782,6,4,5,5,13,15,-2,17
FC Goa,4782,7,4,3,7,11,15,-4,15
Chennaiyin,4782,8,3,6,5,13,18,-5,15
Mumbai City,4783,1,7,4,3,18,9,9,25
Delhi Dynamo,4783,2,5,6,3,24,17,7,21
Chennaiyin,4783,3,5,5,4,17,18,-1,20
Kerala Blast,4783,4,5,4,5,13,17,-4,19
Kolkata,4783,5,4,6,4,16,17,-1,18
FC Pune City,4783,6,5,3,6,16,18,-2,18
NorthEast Un,4783,7,4,4,6,11,13,-2,16
FC Goa,4783,8,4,2,8,12,18,-6,14
Mumbai City,4784,1,6,4,4,16,9,7,22
Kerala Blast,4784,2,6,3,5,13,14,-1,21
Delhi Dynamo,4784,3,5,5,4,22,18,4,20
FC Goa,4784,4,6,2,6,16,15,1,20
NorthEast Un,4784,5,6,2,6,11,11,0,20
Kolkata,4784,6,4,6,4,16,16,0,18
FC Pune City,4784,7,5,3,6,13,16,-3,18
Chennaiyin,4784,8,3,5,6,13,21,-8,14
Mumbai City,4785,1,7,4,3,17,8,9,25
Kolkata,4785,2,6,6,2,23,14,9,24
Delhi Dynamo,4785,3,6,5,3,24,15,9,23
Chennaiyin,4785,4,5,5,4,17,19,-2,20
Kerala Blast,4785,5,5,4,5,10,19,-9,19
FC Pune City,4785,6,4,4,6,14,17,-3,16
NorthEast Un,4785,7,4,2,8,9,13,-4,14
FC Goa,4785,8,3,2,9,10,19,-9,11
Mumbai City,4786,1,6,5,3,16,8,8,23
Delhi Dynamo,4786,2,5,6,3,22,15,7,21
Kerala Blast,4786,3,5,5,4,11,14,-3,20
Kolkata,4786,4,4,7,3,15,14,1,19
NorthEast Un,4786,5,5,4,5,11,10,1,19
FC Pune City,4786,6,4,5,5,14,16,-2,17
Chennaiyin,4786,7,3,6,5,14,21,-7,15
FC Goa,4786,8,4,2,8,11,16,-5,14
Mumbai City,4787,1,7,4,3,19,8,11,25
Kolkata,4787,2,5,6,3,20,17,3,21
NorthEast Un,4787,3,6,3,5,12,9,3,21
Kerala Blast,4787,4,6,3,5,12,15,-3,21
Delhi Dynamo,4787,5,4,5,5,21,21,0,17
Chennaiyin,4787,6,3,7,4,13,17,-4,16
FC Pune City,4787,7,4,3,7,14,19,-5,15
FC Goa,4787,8,4,3,7,11,16,-5,15
Mumbai City,4788,1,6,4,4,16,9,7,22
Kolkata,4788,2,5,7,2,16,13,3,22
Delhi Dynamo,4788,3,5,6,3,23,16,7,21
Chennaiyin,4788,4,5,5,4,16,17,-1,20
FC Pune City,4788,5,5,3,6,13,15,-2,18
Kerala Blast,4788,6,5,3,6,11,16,-5,18
NorthEast Un,4788,7,5,2,7,11,13,-2,17
FC Goa,4788,8,3,4,7,8,15,-7,13
Mumbai City,4789,1,6,5,3,16,8,8,23
Kerala Blast,4789,2,6,4,4,15,15,0,22
FC Goa,4789,3,6,2,6,18,17,1,20
Delhi Dynamo,4789,4,4,7,3,22,17,5,19
FC Pune City,4789,5,5,3,6,14,17,-3,18
Chennaiyin,4789,6,4,5,5,17,23,-6,17
NorthEast Un,4789,7,4,4,6,11,12,-1,16
Kolkata,4789,8,3,6,5,15,19,-4,15
Mumbai City,4790,1,7,4,3,18,9,9,25
Kolkata,4790,2,5,6,3,20,15,5,21
NorthEast Un,4790,3,5,4,5,12,11,1,19
Delhi Dynamo,4790,4,4,6,4,23,21,2,18
Chennaiyin,4790,5,4,6,4,15,18,-3,18
FC Pune City,4790,6,5,3,6,14,17,-3,18
FC Goa,4790,7,5,2,7,15,17,-2,17
Kerala Blast,4790,8,4,3,7,10,19,-9,15
Mumbai City,4791,1,7,4,3,19,9,10,25
Delhi Dynamo,4791,2,6,5,3,24,17,7,23
Kolkata,4791,3,5,7,2,17,13,4,22
Kerala Blast,4791,4,6,3,5,15,15,0,21
Chennaiyin,4791,5,3,7,4,15,19,-4,16
NorthEast Un,4791,6,4,3,7,10,12,-2,15
FC Pune City,4791,7,4,3,7,13,21,-8,15
FC Goa,4791,8,3,4,7,9,16,-7,13
Mumbai City,4792,1,6,5,3,19,11,8,23
Delhi Dynamo,4792,2,5,6,3,26,20,6,21
Kerala Blast,4792,3,6,3,5,14,16,-2,21
NorthEast Un,4792,4,6,2,6,13,12,1,20
FC Pune City,4792,5,5,4,5,14,15,-1,19
Kolkata,4792,6,3,8,3,15,15,0,17
Chennaiyin,4792,7,3,6,5,14,19,-5,15
FC Goa,4792,8,3,4,7,12,19,-7,13
Mumbai City,4793,1,7,4,3,18,9,9,25
Kerala Blast,4793,2,7,3,4,14,14,0,24
Kolkata,4793,3,5,6,3,19,14,5,21
Delhi Dynamo,4793,4,5,5,4,25,19,6,20
NorthEast Un,4793,5,5,2,7,14,14,0,17
Chennaiyin,4793,6,4,5,5,15,20,-5,17
FC Pune City,4793,7,4,3,7,13,17,-4,15
FC Goa,4793,8,4,2,8,10,21,-11,14
Mumbai City,4794,1,7,4,3,20,9,11,25
FC Pune City,4794,2,6,3,5,18,17,1,21
Kerala Blast,4794,3,6,3,5,14,17,-3,21
Delhi Dynamo,4794,4,5,5,4,24,21,3,20
Chennaiyin,4794,5,5,5,4,15,17,-2,20
Kolkata,4794,6,4,6,4,18,18,0,18
NorthEast Un,4794,7,5,2,7,13,14,-1,17
FC Goa,4794,8,3,2,9,8,17,-9,11
Mumbai City,4795,1,7,4,3,18,8,10,25
Kolkata,4795,2,6,6,2,18,14,4,24
Delhi Dynamo,4795,3,5,6,3,24,18,6,21
NorthEast Un,4795,4,6,3,5,14,11,3,21
FC Pune City,4795,5,5,3,6,13,15,-2,18
Chennaiyin,4795,6,3,6,5,14,20,-6,15
Kerala Blast,4795,7,4,3,7,10,17,-7,15
FC Goa,4795,8,3,3,8,10,18,-8,12
Mumbai City,4796,1,7,4,3,17,8,9,25
Kolkata,4796,2,4,7,3,17,14,3,19
Delhi Dynamo,4796,3,4,6,4,24,19,5,18
NorthEast Un,4796,4,5,3,6,14,12,2,18
Chennaiyin,4796,5,4,6,4,15,18,-3,18
FC Pune City,4796,6,5,3,6,13,17,-4,18
Kerala Blast,4796,7,5,3,6,11,18,-7,18
FC Goa,4796,8,4,4,6,11,16,-5,16
Mumbai City,4797,1,7,4,3,17,8,9,25
NorthEast Un,4797,2,6,3,5,17,13,4,21
Kerala Blast,4797,3,5,4,5,10,14,-4,19
Delhi Dynamo,4797,4,4,6,4,24,19,5,18
Kolkata,4797,5,3,8,3,15,15,0,17
FC Pune City,4797,6,4,5,5,12,14,-2,17
Chennaiyin,4797,7,4,5,5,15,21,-6,17
FC Goa,4797,8,4,3,7,11,17,-6,15
Kolkata,4798,1,6,6,2,19,13,6,24
Mumbai City,4798,2,6,5,3,16,8,8,23
NorthEast Un,4798,3,6,3,5,12,10,2,21
Delhi Dynamo,4798,4,4,8,2,23,16,7,20
Kerala Blast,4798,5,5,3,6,10,17,-7,18
FC Pune City,4798,6,4,3,7,13,17,-4,15
Chennaiyin,4798,7,3,6,5,14,19,-5,15
FC Goa,4798,8,3,4,7,10,17,-7,13
Kolkata,4799,1,6,6,2,18,14,4,24
Mumbai City,4799,2,6,5,3,17,9,8,23
Delhi Dynamo,4799,3,5,6,3,24,17,7,21
Kerala Blast,4799,4,5,4,5,10,14,-4,19
NorthEast Un,4799,5,5,2,7,10,12,-2,17
Chennaiyin,4799,6,4,5,5,15,18,-3,17
FC Pune City,4799,7,4,4,6,13,16,-3,16
FC Goa,4799,8,4,2,8,11,18,-7,14
Mumbai City,4800,1,7,4,3,18,9,9,25
Delhi Dynamo,4800,2,5,6,3,23,16,7,21
NorthEast Un,4800,3,5,4,5,14,13,1,19
Kerala Blast,4800,4,5,4,5,15,17,-2,19
FC Pune City,4800,5,5,3,6,13,15,-2,18
Kolkata,4800,6,4,6,4,14,18,-4,18
Chennaiyin,4800,7,4,5,5,16,20,-4,17
FC Goa,4800,8,4,2,8,12,17,-5,14
Mumbai City,4801,1,6,4,4,16,9,7,22
NorthEast Un,4801,2,6,3,5,15,12,3,21
Delhi Dynamo,4801,3,5,5,4,22,17,5,20
FC Goa,4801,4,6,2,6,11,14,-3,20
FC Pune City,4801,5,5,4,5,15,16,-1,19
Kolkata,4801,6,4,6,4,15,15,0,18
Kerala Blast,4801,7,4,4,6,11,17,-6,16
Chennaiyin,4801,8,3,6,5,15,20,-5,15
Mumbai City,4802,1,6,4,4,18,11,7,22
Kerala Blast,4802,2,6,4,4,14,15,-1,22
Delhi Dynamo,4802,3,5,5,4,25,20,5,20
NorthEast Un,4802,4,5,4,5,13,11,2,19
Kolkata,4802,5,4,7,3,17,17,0,19
Chennaiyin,4802,6,4,6,4,15,18,-3,18
FC Pune City,4802,7,4,3,7,12,16,-4,15
FC Goa,4802,8,4,3,7,10,16,-6,15
Mumbai City,4803,1,6,5,3,19,11,8,23
Delhi Dynamo,4803,2,5,6,3,30,22,8,21
Kolkata,4803,3,4,7,3,17,18,-1,19
NorthEast Un,4803,4,5,3,6,12,11,1,18
Kerala Blast,4803,5,4,6,4,12,16,-4,18
FC Goa,4803,6,5,2,7,15,19,-4,17
Chennaiyin,4803,7,4,5,5,14,18,-4,17
FC Pune City,4803,8,4,4,6,13,17,-4,16
Delhi Dynamo,4804,1,6,6,2,28,17,11,24
Mumbai City,4804,2,6,4,4,16,9,7,22
Kerala Blast,4804,3,6,4,4,12,14,-2,22
Chennaiyin,4804,4,5,5,4,18,18,0,20
Kolkata,4804,5,4,6,4,16,16,0,18
FC Pune City,4804,6,5,3,6,13,15,-2,18
NorthEast Un,4804,7,4,4,6,12,14,-2,16
FC Goa,4804,8,3,2,9,10,22,-12,11
Kolkata,4805,1,6,6,2,22,15,7,24
Delhi Dynamo,4805,2,6,5,3,27,18,9,23
Mumbai City,4805,3,6,4,4,17,11,6,22
Kerala Blast,4805,4,5,3,6,13,22,-9,18
NorthEast Un,4805,5,5,2,7,15,13,2,17
FC Goa,4805,6,5,2,7,14,18,-4,17
Chennaiyin,4805,7,4,5,5,15,21,-6,17
FC Pune City,4805,8,4,3,7,14,19,-5,15
NorthEast Un,4806,1,7,2,5,13,10,3,23
Mumbai City,4806,2,6,4,4,16,9,7,22
Delhi Dynamo,4806,3,5,5,4,22,16,6,20
FC Goa,4806,4,6,2,6,12,14,-2,20
Kolkata,4806,5,4,7,3,20,16,4,19
Kerala Blast,4806,6,5,4,5,15,17,-2,19
FC Pune City,4806,7,4,3,7,15,24,-9,15
Chennaiyin,4806,8,3,5,6,13,20,-7,14
Mumbai City,4807,1,6,5,3,16,8,8,23
Delhi Dynamo,4807,2,5,6,3,24,17,7,21
Kerala Blast,4807,3,6,3,5,11,16,-5,21
Kolkata,4807,4,4,8,2,18,14,4,20
FC Goa,4807,5,5,3,6,13,16,-3,18
Chennaiyin,4807,6,4,5,5,16,19,-3,17
FC Pune City,4807,7,4,4,6,13,16,-3,16
NorthEast Un,4807,8,4,2,8,10,15,-5,14
Mumbai City,4808,1,6,4,4,18,11,7,22
Delhi Dynamo,4808,2,5,5,4,24,20,4,20
FC Goa,4808,3,6,2,6,14,14,0,20
NorthEast Un,4808,4,6,2,6,11,11,0,20
Kolkata,4808,5,4,6,4,14,15,-1,18
FC Pune City,4808,6,5,3,6,13,15,-2,18
Kerala Blast,4808,7,5,3,6,11,15,-4,18
Chennaiyin,4808,8,4,5,5,15,19,-4,17
Delhi Dynamo,4809,1,6,6,2,27,16,11,24
Mumbai City,4809,2,6,4,4,17,10,7,22
Kerala Blast,4809,3,6,3,5,15,16,-1,21
Kolkata,4809,4,4,7,3,14,13,1,19
FC Pune City,4809,5,5,3,6,15,17,-2,18
NorthEast Un,4809,6,5,3,6,11,13,-2,18
FC Goa,4809,7,4,3,7,9,17,-8,15
Chennaiyin,4809,8,3,5,6,13,19,-6,14
Mumbai City,4810,1,7,4,3,18,8,10,25
Kolkata,4810,2,6,6,2,17,13,4,24
Kerala Blast,4810,3,5,4,5,11,15,-4,19
Delhi Dynamo,4810,4,4,5,5,23,21,2,17
NorthEast Un,4810,5,5,2,7,12,12,0,17
FC Goa,4810,6,5,2,7,14,17,-3,17
Chennaiyin,4810,7,4,5,5,15,21,-6,17
FC Pune City,4810,8,4,4,6,14,17,-3,16
Mumbai City,4811,1,6,5,3,18,10,8,23
Kerala Blast,4811,2,6,4,4,11,13,-2,22
Delhi Dynamo,4811,3,4,7,3,26,20,6,19
Chennaiyin,4811,4,4,6,4,18,19,-1,18
Kolkata,4811,5,4,6,4,16,17,-1,18
NorthEast Un,4811,6,4,5,5,13,13,0,17
FC Goa,4811,7,5,2,7,12,18,-6,17
FC Pune City,4811,8,4,3,7,14,18,-4,15
Kolkata,4812,1,5,7,2,22,16,6,22
Mumbai City,4812,2,6,4,4,16,11,5,22
Delhi Dynamo,4812,3,5,6,3,24,16,8,21
NorthEast Un,4812,4,6,3,5,13,10,3,21
FC Pune City,4812,5,5,3,6,14,17,-3,18
Chennaiyin,4812,6,3,7,4,15,19,-4,16
Kerala Blast,4812,7,4,4,6,14,20,-6,16
FC Goa,4812,8,3,4,7,9,18,-9,13
Mumbai City,4813,1,6,5,3,17,9,8,23
Delhi Dynamo,4813,2,5,6,3,27,19,8,21
Kerala Blast,4813,3,6,3,5,13,17,-4,21
Kolkata,4813,4,4,7,3,18,16,2,19
Chennaiyin,4813,5,4,6,4,16,18,-2,18
NorthEast Un,4813,6,5,2,7,12,14,-2,17
FC Pune City,4813,7,4,4,6,15,18,-3,16
FC Goa,4813,8,4,3,7,11,18,-7,15
Delhi Dynamo,4814,1,6,6,2,28,18,10,24
Mumbai City,4814,2,6,4,4,18,12,6,22
Kolkata,4814,3,5,7,2,18,15,3,22
NorthEast Un,4814,4,5,3,6,12,12,0,18
FC Pune City,4814,5,4,4,6,13,16,-3,16
FC Goa,4814,6,4,4,6,11,16,-5,16
Kerala Blast,4814,7,4,4,6,10,16,-6,16
Chennaiyin,4814,8,3,6,5,14,19,-5,15
Mumbai City,4815,1,7,4,3,18,9,9,25
Kolkata,4815,2,6,6,2,22,15,7,24
Delhi Dynamo,4815,3,6,5,3,25,16,9,23
Kerala Blast,4815,4,5,4,5,12,17,-5,19
NorthEast Un,4815,5,5,3,6,14,14,0,18
FC Pune City,4815,6,4,3,7,13,19,-6,15
FC Goa,4815,7,4,2,8,13,17,-4,14
Chennaiyin,4815,8,3,5,6,15,25,-10,14
Mumbai City,4816,1,7,4,3,17,8,9,25
Delhi Dynamo,4816,2,5,6,3,24,16,8,21
Kolkata,4816,3,5,6,3,18,14,4,21
Kerala Blast,4816,4,6,3,5,12,16,-4,21
Chennaiyin,4816,5,4,6,4,15,18,-3,18
FC Goa,4816,6,4,4,6,10,15,-5,16
FC Pune City,4816,7,4,3,7,14,19,-5,15
NorthEast Un,4816,8,4,2,8,10,14,-4,14
Mumbai City,4817,1,6,5,3,17,9,8,23
Kolkata,4817,2,5,7,2,19,15,4,22
Delhi Dynamo,4817,3,5,6,3,24,17,7,21
NorthEast Un,4817,4,6,3,5,13,10,3,21
Chennaiyin,4817,5,4,6,4,15,18,-3,18
Kerala Blast,4817,6,5,3,6,12,18,-6,18
FC Pune City,4817,7,4,3,7,12,17,-5,15
FC Goa,4817,8,3,3,8,12,20,-8,12
Mumbai City,4818,1,7,4,3,17,8,9,25
NorthEast Un,4818,2,6,3,5,13,11,2,21
FC Pune City,4818,3,5,4,5,13,14,-1,19
Delhi Dynamo,4818,4,4,6,4,22,17,5,18
Kerala Blast,4818,5,4,6,4,10,14,-4,18
Kolkata,4818,6,3,8,3,14,14,0,17
Chennaiyin,4818,7,3,6,5,15,20,-5,15
FC Goa,4818,8,3,5,6,9,15,-6,14
Delhi Dynamo,4819,1,6,6,2,25,16,9,24
Mumbai City,4819,2,6,4,4,17,10,7,22
Kolkata,4819,3,5,6,3,18,15,3,21
FC Pune City,4819,4,5,3,6,19,20,-1,18
Kerala Blast,4819,5,5,3,6,16,22,-6,18
NorthEast Un,4819,6,5,2,7,10,12,-2,17
Chennaiyin,4819,7,4,5,5,15,19,-4,17
FC Goa,4819,8,4,3,7,11,17,-6,15
Kolkata,4820,1,6,6,2,22,16,6,24
Mumbai City,4820,2,6,5,3,18,10,8,23
Delhi Dynamo,4820,3,4,7,3,25,20,5,19
Kerala Blast,4820,4,5,4,5,12,18,-6,19
NorthEast Un,4820,5,5,3,6,12,11,1,18
FC Pune City,4820,6,4,4,6,14,17,-3,16
Chennaiyin,4820,7,3,7,4,14,18,-4,16
FC Goa,4820,8,3,4,7,14,21,-7,13
Mumbai City,4821,1,7,4,3,17,8,9,25
NorthEast Un,4821,2,6,3,5,13,10,3,21
Kerala Blast,4821,3,5,4,5,11,15,-4,19
Delhi Dynamo,4821,4,4,6,4,23,18,5,18
Kolkata,4821,5,4,6,4,18,19,-1,18
FC Pune City,4821,6,5,3,6,16,17,-1,18
Chennaiyin,4821,7,4,5,5,16,21,-5,17
FC Goa,4821,8,4,3,7,13,19,-6,15
Mumbai City,4822,1,7,4,3,19,8,11,25
NorthEast Un,4822,2,6,3,5,15,11,4,21
FC Goa,4822,3,6,2,6,16,15,1,20
Kerala Blast,4822,4,5,4,5,12,16,-4,19
Delhi Dynamo,4822,5,4,5,5,23,22,1,17
Kolkata,4822,6,3,8,3,15,15,0,17
FC Pune City,4822,7,4,4,6,14,18,-4,16
Chennaiyin,4822,8,3,6,5,13,22,-9,15
Delhi Dynamo,4823,1,6,6,2,27,17,10,24
Mumbai City,4823,2,6,5,3,18,10,8,23
Kolkata,4823,3,4,8,2,16,14,2,20
FC Pune City,4823,4,5,4,5,15,15,0,19
NorthEast Un,4823,5,5,3,6,12,12,0,18
Kerala Blast,4823,6,4,4,6,13,20,-7,16
FC Goa,4823,7,4,3,7,9,16,-7,15
Chennaiyin,4823,8,3,5,6,13,19,-6,14
Delhi Dynamo,4824,1,6,6,2,26,16,10,24
Mumbai City,4824,2,6,4,4,16,9,7,22
Kolkata,4824,3,5,6,3,21,15,6,21
Chennaiyin,4824,4,4,6,4,16,19,-3,18
NorthEast Un,4824,5,4,5,5,11,11,0,17
Kerala Blast,4824,6,4,5,5,10,18,-8,17
FC Pune City,4824,7,4,4,6,14,18,-4,16
FC Goa,4824,8,4,2,8,12,20,-8,14
Mumbai City,4825,1,6,5,3,18,10,8,23
NorthEast Un,4825,2,5,4,5,14,13,1,19
Kerala Blast,4825,3,5,4,5,13,17,-4,19
Delhi Dynamo,4825,4,4,6,4,24,19,5,18
Kolkata,4825,5,4,6,4,15,15,0,18
FC Pune City,4825,6,5,3,6,14,16,-2,18
Chennaiyin,4825,7,4,6,4,15,18,-3,18
FC Goa,4825,8,5,2,7,10,15,-5,17
Mumbai City,4826,1,6,5,3,17,9,8,23
Delhi Dynamo,4826,2,5,6,3,25,17,8,21
Chennaiyin,4826,3,5,5,4,18,18,0,20
Kolkata,4826,4,4,7,3,18,15,3,19
NorthEast Un,4826,5,5,3,6,12,14,-2,18
Kerala Blast,4826,6,4,6,4,10,14,-4,18
FC Pune City,4826,7,4,4,6,12,18,-6,16
FC Goa,4826,8,4,2,8,12,19,-7,14
Delhi Dynamo,4827,1,7,5,2,31,15,16,26
Mumbai City,4827,2,6,4,4,17,12,5,22
Kerala Blast,4827,3,5,5,4,12,15,-3,20
Kolkata,4827,4,4,7,3,17,16,1,19
FC Pune City,4827,5,5,3,6,15,17,-2,18
Chennaiyin,4827,6,4,5,5,15,19,-4,17
NorthEast Un,4827,7,4,3,7,9,11,-2,15
FC Goa,4827,8,4,2,8,11,22,-11,14
Mumbai City,4828,1,7,4,3,17,8,9,25
Delhi Dynamo,4828,2,5,6,3,25,16,9,21
Kerala Blast,4828,3,6,3,5,16,17,-1,21
NorthEast Un,4828,4,5,4,5,12,11,1,19
Kolkata,4828,5,4,7,3,18,18,0,19
Chennaiyin,4828,6,3,6,5,15,20,-5,15
FC Pune City,4828,7,4,3,7,13,18,-5,15
FC Goa,4828,8,4,3,7,11,19,-8,15
Delhi Dynamo,4829,1,7,5,2,26,16,10,26
Mumbai City,4829,2,6,4,4,17,10,7,22
Kerala Blast,4829,3,6,4,4,14,16,-2,22
FC Goa,4829,4,5,2,7,16,15,1,17
Kolkata,4829,5,3,8,3,15,16,-1,17
Chennaiyin,4829,6,4,5,5,15,23,-8,17
FC Pune City,4829,7,4,4,6,13,16,-3,16
NorthEast Un,4829,8,4,2,8,10,14,-4,14
Mumbai City,4830,1,7,4,3,17,8,9,25
Delhi Dynamo,4830,2,5,6,3,23,15,8,21
Kolkata,4830,3,5,6,3,18,15,3,21
NorthEast Un,4830,4,5,4,5,12,9,3,19
Kerala Blast,4830,5,5,4,5,11,16,-5,19
FC Pune City,4830,6,4,3,7,12,17,-5,15
FC Goa,4830,7,4,3,7,12,18,-6,15
Chennaiyin,4830,8,3,6,5,14,21,-7,15
Kerala Blast,4831,1,7,3,4,13,13,0,24
Mumbai City,4831,2,6,5,3,16,8,8,23
Delhi Dynamo,4831,3,5,7,2,24,16,8,22
Kolkata,4831,4,4,7,3,14,13,1,19
NorthEast Un,4831,5,5,2,7,14,14,0,17
Chennaiyin,4831,6,4,5,5,16,22,-6,17
FC Pune City,4831,7,4,3,7,12,16,-4,15
FC Goa,4831,8,3,4,7,10,17,-7,13
Mumbai City,4832,1,7,4,3,17,8,9,25
Delhi Dynamo,4832,2,5,6,3,26,19,7,21
NorthEast Un,4832,3,6,3,5,15,11,4,21
Kerala Blast,4832,4,5,4,5,13,17,-4,19
FC Pune City,4832,5,4,5,5,15,17,-2,17
Kolkata,4832,6,3,7,4,13,15,-2,16
FC Goa,4832,7,4,3,7,13,18,-5,15
Chennaiyin,4832,8,3,6,5,14,21,-7,15
Delhi Dynamo,4833,1,6,6,2,25,15,10,24
Mumbai City,4833,2,6,4,4,17,10,7,22
Kolkata,4833,3,5,6,3,20,17,3,21
Chennaiyin,4833,4,4,6,4,16,19,-3,18
NorthEast Un,4833,5,5,2,7,10,12,-2,17
FC Pune City,4833,6,4,4,6,17,20,-3,16
FC Goa,4833,7,4,4,6,11,16,-5,16
Kerala Blast,4833,8,4,4,6,12,19,-7,16
Mumbai City,4834,1,6,5,3,16,8,8,23
Kolkata,4834,2,5,6,3,16,14,2,21
NorthEast Un,4834,3,6,3,5,13,11,2,21
Kerala Blast,4834,4,5,5,4,11,13,-2,20
Delhi Dynamo,4834,5,4,6,4,22,18,4,18
FC Goa,4834,6,5,2,7,12,17,-5,17
FC Pune City,4834,7,4,4,6,12,15,-3,16
Chennaiyin,4834,8,3,5,6,15,21,-6,14
Mumbai City,4835,1,6,4,4,16,9,7,22
Kolkata,4835,2,5,6,3,18,13,5,21
Delhi Dynamo,4835,3,5,5,4,24,20,4,20
Kerala Blast,4835,4,5,4,5,11,15,-4,19
NorthEast Un,4835,5,5,3,6,13,12,1,18
Chennaiyin,4835,6,4,6,4,17,19,-2,18
FC Pune City,4835,7,5,3,6,13,16,-3,18
FC Goa,4835,8,4,3,7,12,20,-8,15
Mumbai City,4836,1,7,4,3,19,8,11,25
Kolkata,4836,2,5,7,2,19,12,7,22
NorthEast Un,4836,3,6,3,5,13,10,3,21
FC Goa,4836,4,5,3,6,14,15,-1,18
Kerala Blast,4836,5,5,3,6,12,19,-7,18
Delhi Dynamo,4836,6,4,5,5,22,20,2,17
FC Pune City,4836,7,4,3,7,12,19,-7,15
Chennaiyin,4836,8,3,6,5,13,21,-8,15
Mumbai City,4837,1,7,4,3,17,8,9,25
Kerala Blast,4837,2,6,3,5,16,17,-1,21
Delhi Dynamo,4837,3,5,5,4,25,18,7,20
Kolkata,4837,4,4,8,2,16,14,2,20
NorthEast Un,4837,5,5,2,7,15,17,-2,17
Chennaiyin,4837,6,4,5,5,16,19,-3,17
FC Pune City,4837,7,4,4,6,13,17,-4,16
FC Goa,4837,8,4,3,7,9,17,-8,15
Delhi Dynamo,4838,1,6,6,2,27,16,11,24
Mumbai City,4838,2,6,4,4,17,10,7,22
Kolkata,4838,3,4,7,3,16,15,1,19
Chennaiyin,4838,4,4,6,4,15,18,-3,18
NorthEast Un,4838,5,4,5,5,11,11,0,17
FC Pune City,4838,6,4,5,5,16,18,-2,17
Kerala Blast,4838,7,4,5,5,12,17,-5,17
FC Goa,4838,8,4,2,8,10,19,-9,14
Mumbai City,4839,1,6,5,3,17,9,8,23
Kolkata,4839,2,5,7,2,17,14,3,22
Kerala Blast,4839,3,6,3,5,11,14,-3,21
Delhi Dynamo,4839,4,4,7,3,23,17,6,19
NorthEast Un,4839,5,5,3,6,14,11,3,18
Chennaiyin,4839,6,4,5,5,15,22,-7,17
FC Pune City,4839,7,4,4,6,13,16,-3,16
FC Goa,4839,8,4,2,8,11,18,-7,14
Mumbai City,4840,1,7,4,3,18,9,9,25
Delhi Dynamo,4840,2,6,5,3,25,16,9,23
Kerala Blast,4840,3,6,4,4,13,15,-2,22
Kolkata,4840,4,5,6,3,16,13,3,21
NorthEast Un,4840,5,5,3,6,14,11,3,18
FC Pune City,4840,6,4,3,7,13,17,-4,15
FC Goa,4840,7,4,2,8,12,19,-7,14
Chennaiyin,4840,8,3,5,6,14,25,-11,14
Mumbai City,4841,1,7,4,3,18,9,9,25
FC Pune City,4841,2,6,3,5,15,14,1,21
Kolkata,4841,3,4,7,3,18,16,2,19
Chennaiyin,4841,4,4,6,4,17,17,0,18
Kerala Blast,4841,5,5,3,6,10,17,-7,18
Delhi Dynamo,4841,6,4,5,5,23,21,2,17
NorthEast Un,4841,7,5,2,7,13,15,-2,17
FC Goa,4841,8,4,4,6,11,16,-5,16
Mumbai City,4842,1,6,5,3,17,9,8,23
Delhi Dynamo,4842,2,5,7,2,24,16,8,22
NorthEast Un,4842,3,6,3,5,16,13,3,21
Kerala Blast,4842,4,6,3,5,16,17,-1,21
Kolkata,4842,5,4,6,4,17,18,-1,18
Chennaiyin,4842,6,4,5,5,17,20,-3,17
FC Pune City,4842,7,4,3,7,13,18,-5,15
FC Goa,4842,8,4,2,8,10,19,-9,14
Delhi Dynamo,4843,1,6,5,3,28,19,9,23
Mumbai City,4843,2,6,4,4,17,11,6,22
Kolkata,4843,3,5,7,2,20,16,4,22
NorthEast Un,4843,4,6,3,5,16,11,5,21
Chennaiyin,4843,5,4,6,4,17,19,-2,18
Kerala Blast,4843,6,5,3,6,11,19,-8,18
FC Pune City,4843,7,4,3,7,15,19,-4,15
FC Goa,4843,8,3,3,8,12,22,-10,12
Mumbai City,4844,1,6,5,3,17,9,8,23
Delhi Dynamo,4844,2,5,7,2,25,16,9,22
Kolkata,4844,3,5,7,2,20,13,7,22
Kerala Blast,4844,4,5,4,5,15,23,-8,19
NorthEast Un,4844,5,5,3,6,13,12,1,18
FC Goa,4844,6,4,4,6,13,18,-5,16
FC Pune City,4844,7,4,3,7,16,20,-4,15
Chennaiyin,4844,8,3,5,6,15,23,-8,14
Mumbai City,4845,1,7,4,3,17,8,9,25
Kolkata,4845,2,6,6,2,20,14,6,24
Delhi Dynamo,4845,3,5,5,4,22,18,4,20
NorthEast Un,4845,4,6,2,6,14,11,3,20
FC Pune City,4845,5,5,3,6,17,20,-3,18
Kerala Blast,4845,6,5,3,6,12,17,-5,18
Chennaiyin,4845,7,4,5,5,17,20,-3,17
FC Goa,4845,8,3,2,9,9,20,-11,11
Delhi Dynamo,4846,1,7,5,2,29,15,14,26
Mumbai City,4846,2,6,4,4,16,9,7,22
Kerala Blast,4846,3,6,3,5,12,16,-4,21
Kolkata,4846,4,4,7,3,17,14,3,19
FC Pune City,4846,5,5,3,6,16,19,-3,18
Chennaiyin,4846,6,3,7,4,15,19,-4,16
NorthEast Un,4846,7,4,3,7,11,15,-4,15
FC Goa,4846,8,3,4,7,9,18,-9,13
Mumbai City,4847,1,6,4,4,16,9,7,22
Kolkata,4847,2,5,7,2,15,12,3,22
Delhi Dynamo,4847,3,5,5,4,23,19,4,20
NorthEast Un,4847,4,5,4,5,13,10,3,19
FC Pune City,4847,5,5,3,6,17,16,1,18
FC Goa,4847,6,5,3,6,13,17,-4,18
Kerala Blast,4847,7,4,4,6,10,19,-9,16
Chennaiyin,4847,8,3,6,5,16,21,-5,15
Mumbai City,4848,1,6,5,3,17,9,8,23
Kolkata,4848,2,4,8,2,15,13,2,20
Delhi Dynamo,4848,3,4,7,3,23,17,6,19
Kerala Blast,4848,4,5,4,5,12,16,-4,19
NorthEast Un,4848,5,5,3,6,11,11,0,18
Chennaiyin,4848,6,4,6,4,16,19,-3,18
FC Pune City,4848,7,4,5,5,15,17,-2,17
FC Goa,4848,8,3,4,7,10,17,-7,13
Mumbai City,4849,1,7,4,3,18,9,9,25
Delhi Dynamo,4849,2,6,5,3,24,16,8,23
Kerala Blast,4849,3,6,3,5,15,15,0,21
Kolkata,4849,4,4,6,4,15,15,0,18
FC Pune City,4849,5,5,3,6,15,17,-2,18
Chennaiyin,4849,6,4,5,5,15,18,-3,17
FC Goa,4849,7,5,2,7,10,15,-5,17
NorthEast Un,4849,8,4,2,8,9,16,-7,14
Delhi Dynamo,4850,1,6,6,2,26,17,9,24
Mumbai City,4850,2,6,5,3,18,10,8,23
NorthEast Un,4850,3,6,2,6,13,11,2,20
Kerala Blast,4850,4,5,4,5,11,15,-4,19
Kolkata,4850,5,4,6,4,17,17,0,18
FC Goa,4850,6,5,2,7,13,17,-4,17
FC Pune City,4850,7,4,4,6,12,15,-3,16
Chennaiyin,4850,8,3,5,6,13,21,-8,14
Mumbai City,4851,1,7,4,3,17,8,9,25
Kolkata,4851,2,5,7,2,17,12,5,22
Delhi Dynamo,4851,3,5,6,3,24,17,7,21
NorthEast Un,4851,4,5,4,5,14,13,1,19
Kerala Blast,4851,5,5,4,5,11,16,-5,19
Chennaiyin,4851,6,4,5,5,16,19,-3,17
FC Pune City,4851,7,4,4,6,12,15,-3,16
FC Goa,4851,8,3,2,9,8,19,-11,11
Mumbai City,4852,1,7,4,3,18,8,10,25
Delhi Dynamo,4852,2,6,5,3,24,16,8,23
Kolkata,4852,3,5,7,2,17,13,4,22
NorthEast Un,4852,4,5,3,6,11,12,-1,18
FC Pune City,4852,5,5,3,6,14,17,-3,18
Chennaiyin,4852,6,4,5,5,15,19,-4,17
Kerala Blast,4852,7,4,5,5,12,17,-5,17
FC Goa,4852,8,3,2,9,9,18,-9,11
Delhi Dynamo,4853,1,5,7,2,26,16,10,22
Mumbai City,4853,2,6,4,4,16,11,5,22
Kolkata,4853,3,4,8,2,15,13,2,20
Kerala Blast,4853,4,5,5,4,12,15,-3,20
NorthEast Un,4853,5,4,5,5,11,11,0,17
FC Pune City,4853,6,4,4,6,13,16,-3,16
Chennaiyin,4853,7,3,6,5,15,20,-5,15
FC Goa,4853,8,4,3,7,11,17,-6,15
NorthEast Un,4854,1,7,2,5,15,11,4,23
Mumbai City,4854,2,6,4,4,16,10,6,22
Delhi Dynamo,4854,3,5,6,3,25,18,7,21
Kerala Blast,4854,4,5,4,5,12,15,-3,19
Kolkata,4854,5,4,6,4,16,17,-1,18
FC Goa,4854,6,5,3,6,13,16,-3,18
FC Pune City,4854,7,4,4,6,13,16,-3,16
Chennaiyin,4854,8,3,5,6,13,20,-7,14
Mumbai City,4855,1,6,4,4,17,10,7,22
Delhi Dynamo,4855,2,5,6,3,24,23,1,21
NorthEast Un,4855,3,6,2,6,17,10,7,20
FC Pune City,4855,4,5,4,5,16,14,2,19
Chennaiyin,4855,5,4,6,4,14,17,-3,18
Kerala Blast,4855,6,5,3,6,10,18,-8,18
Kolkata,4855,7,3,7,4,14,15,-1,16
FC Goa,4855,8,4,4,6,11,16,-5,16
Mumbai City,4856,1,6,5,3,17,9,8,23
Delhi Dynamo,4856,2,5,6,3,26,17,9,21
NorthEast Un,4856,3,6,3,5,12,9,3,21
Kolkata,4856,4,5,6,3,18,16,2,21
Kerala Blast,4856,5,5,4,5,11,16,-5,19
FC Pune City,4856,6,4,4,6,15,18,-3,16
Chennaiyin,4856,7,3,7,4,14,18,-4,16
FC Goa,4856,8,3,3,8,11,21,-10,12
Delhi Dynamo,4857,1,7,5,2,31,16,15,26
Mumbai City,4857,2,6,4,4,16,9,7,22
FC Pune City,4857,3,5,4,5,15,16,-1,19
Chennaiyin,4857,4,4,6,4,18,19,-1,18
NorthEast Un,4857,5,5,2,7,12,15,-3,17
Kerala Blast,4857,6,4,5,5,10,15,-5,17
Kolkata,4857,7,3,7,4,16,17,-1,16
FC Goa,4857,8,4,3,7,11,22,-11,15
Delhi Dynamo,4858,1,6,6,2,27,18,9,24
Mumbai City,4858,2,6,4,4,16,9,7,22
Kerala Blast,4858,3,6,4,4,14,14,0,22
Kolkata,4858,4,4,7,3,16,15,1,19
Chennaiyin,4858,5,4,5,5,16,20,-4,17
FC Goa,4858,6,5,2,7,13,18,-5,17
NorthEast Un,4858,7,4,3,7,13,15,-2,15
FC Pune City,4858,8,4,3,7,14,20,-6,15
Mumbai City,4859,1,7,4,3,19,9,10,25
NorthEast Un,4859,2,7,2,5,14,11,3,23
Kerala Blast,4859,3,6,3,5,13,15,-2,21
Delhi Dynamo,4859,4,5,5,4,25,20,5,20
Kolkata,4859,5,4,6,4,16,16,0,18
FC Pune City,4859,6,5,3,6,13,15,-2,18
Chennaiyin,4859,7,4,5,5,15,18,-3,17
FC Goa,4859,8,3,2,9,10,21,-11,11
Mumbai City,4860,1,7,4,3,19,8,11,25
Delhi Dynamo,4860,2,5,6,3,27,20,7,21
NorthEast Un,4860,3,6,3,5,15,12,3,21
Kerala Blast,4860,4,5,4,5,12,17,-5,19
Kolkata,4860,5,4,6,4,18,16,2,18
Chennaiyin,4860,6,4,5,5,15,19,-4,17
FC Pune City,4860,7,4,4,6,13,18,-5,16
FC Goa,4860,8,4,2,8,11,20,-9,14
Mumbai City,4861,1,7,4,3,18,9,9,25
Kolkata,4861,2,5,6,3,17,14,3,21
NorthEast Un,4861,3,6,3,5,15,12,3,21
FC Pune City,4861,4,6,3,5,16,14,2,21
Delhi Dynamo,4861,5,5,5,4,25,18,7,20
Chennaiyin,4861,6,4,6,4,17,19,-2,18
Kerala Blast,4861,7,4,3,7,9,18,-9,15
FC Goa,4861,8,3,2,9,8,21,-13,11
Mumbai City,4862,1,7,4,3,18,8,10,25
Kolkata,4862,2,5,6,3,16,13,3,21
NorthEast Un,4862,3,6,2,6,16,10,6,20
Kerala Blast,4862,4,5,4,5,11,19,-8,19
Delhi Dynamo,4862,5,4,6,4,24,21,3,18
Chennaiyin,4862,6,4,5,5,14,18,-4,17
FC Pune City,4862,7,4,4,6,13,17,-4,16
FC Goa,4862,8,4,3,7,12,18,-6,15
Mumbai City,4863,1,7,4,3,17,8,9,25
Kolkata,4863,2,4,8,2,18,16,2,20
Delhi Dynamo,4863,3,4,7,3,22,16,6,19
FC Pune City,4863,4,5,4,5,19,18,1,19
NorthEast Un,4863,5,5,3,6,14,13,1,18
Kerala Blast,4863,6,5,3,6,15,22,-7,18
Chennaiyin,4863,7,3,6,5,15,21,-6,15
FC Goa,4863,8,3,5,6,9,15,-6,14
Kerala Blast,4864,1,7,3,4,16,16,0,24
Delhi Dynamo,4864,2,6,5,3,27,22,5,23
Mumbai City,4864,3,6,4,4,17,10,7,22
Kolkata,4864,4,4,7,3,18,16,2,19
Chennaiyin,4864,5,4,6,4,16,19,-3,18
NorthEast Un,4864,6,5,2,7,18,15,3,17
FC Pune City,4864,7,4,3,7,14,20,-6,15
FC Goa,4864,8,3,4,7,12,20,-8,13
Mumbai City,4865,1,7,4,3,20,10,10,25
Delhi Dynamo,4865,2,5,6,3,25,19,6,21
NorthEast Un,4865,3,5,4,5,12,11,1,19
Kerala Blast,4865,4,5,4,5,12,16,-4,19
Kolkata,4865,5,3,9,2,14,13,1,18
FC Pune City,4865,6,4,4,6,13,16,-3,16
Chennaiyin,4865,7,3,7,4,14,18,-4,16
FC Goa,4865,8,3,4,7,10,17,-7,13
Mumbai City,4866,1,6,4,4,16,9,7,22
Kolkata,4866,2,5,7,2,18,13,5,22
Delhi Dynamo,4866,3,5,6,3,23,17,6,21
Chennaiyin,4866,4,5,5,4,16,18,-2,20
Kerala Blast,4866,5,4,5,5,10,16,-6,17
NorthEast Un,4866,6,4,4,6,12,13,-1,16
FC Pune City,4866,7,4,4,6,12,16,-4,16
FC Goa,4866,8,4,3,7,11,16,-5,15
Mumbai City,4867,1,7,4,3,19,9,10,25
Kolkata,4867,2,5,6,3,19,18,1,21
Chennaiyin,4867,3,5,5,4,17,18,-1,20
Kerala Blast,4867,4,5,4,5,13,17,-4,19
NorthEast Un,4867,5,5,3,6,13,12,1,18
Delhi Dynamo,4867,6,4,5,5,22,22,0,17
FC Goa,4867,7,5,2,7,14,17,-3,17
FC Pune City,4867,8,4,3,7,15,19,-4,15
Mumbai City,4868,1,6,5,3,17,9,8,23
Delhi Dynamo,4868,2,5,7,2,29,19,10,22
Kolkata,4868,3,4,7,3,17,15,2,19
NorthEast Un,4868,4,5,3,6,15,15,0,18
FC Pune City,4868,5,5,3,6,16,19,-3,18
Kerala Blast,4868,6,5,3,6,14,19,-5,18
Chennaiyin,4868,7,4,5,5,16,22,-6,17
FC Goa,4868,8,4,3,7,15,21,-6,15
Mumbai City,4869,1,7,4,3,18,9,9,25
Kerala Blast,4869,2,7,3,4,12,13,-1,24
Delhi Dynamo,4869,3,6,5,3,27,18,9,23
Kolkata,4869,4,4,6,4,16,16,0,18
Chennaiyin,4869,5,4,6,4,16,19,-3,18
FC Pune City,4869,6,4,3,7,14,18,-4,15
FC Goa,4869,7,4,3,7,10,17,-7,15
NorthEast Un,4869,8,4,2,8,12,15,-3,14
Mumbai City,4870,1,7,4,3,18,9,9,25
Kolkata,4870,2,6,6,2,21,14,7,24
Delhi Dynamo,4870,3,5,6,3,26,16,10,21
NorthEast Un,4870,4,6,3,5,12,9,3,21
FC Pune City,4870,5,5,3,6,15,17,-2,18
Chennaiyin,4870,6,3,6,5,13,18,-5,15
Kerala Blast,4870,7,4,3,7,11,20,-9,15
FC Goa,4870,8,3,3,8,8,21,-13,12
Delhi Dynamo,4871,1,6,6,2,27,18,9,24
Mumbai City,4871,2,6,5,3,19,11,8,23
Kolkata,4871,3,5,7,2,17,13,4,22
Kerala Blast,4871,4,5,5,4,12,15,-3,20
Chennaiyin,4871,5,4,5,5,14,19,-5,17
NorthEast Un,4871,6,4,3,7,10,12,-2,15
FC Pune City,4871,7,4,3,7,13,17,-4,15
FC Goa,4871,8,4,2,8,10,17,-7,14
Mumbai City,4872,1,7,4,3,17,8,9,25
Kolkata,4872,2,5,6,3,17,15,2,21
Delhi Dynamo,4872,3,5,5,4,26,18,8,20
FC Pune City,4872,4,5,4,5,15,16,-1,19
Kerala Blast,4872,5,5,4,5,11,15,-4,19
Chennaiyin,4872,6,3,7,4,16,20,-4,16
NorthEast Un,4872,7,4,3,7,10,14,-4,15
FC Goa,4872,8,4,3,7,14,20,-6,15
Mumbai City,4873,1,7,4,3,19,8,11,25
Delhi Dynamo,4873,2,5,5,4,24,21,3,20
Kerala Blast,4873,3,5,5,4,16,18,-2,20
Kolkata,4873,4,3,9,2,17,16,1,18
NorthEast Un,4873,5,5,3,6,14,13,1,18
FC Pune City,4873,6,4,5,5,15,17,-2,17
Chennaiyin,4873,7,3,7,4,15,19,-4,16
FC Goa,4873,8,3,4,7,11,19,-8,13
Mumbai City,4874,1,7,4,3,18,8,10,25
Kolkata,4874,2,6,6,2,20,14,6,24
Delhi Dynamo,4874,3,5,6,3,24,18,6,21
NorthEast Un,4874,4,6,3,5,13,10,3,21
Kerala Blast,4874,5,5,3,6,12,17,-5,18
FC Pune City,4874,6,4,3,7,12,18,-6,15
FC Goa,4874,7,4,2,8,13,18,-5,14
Chennaiyin,4874,8,3,5,6,14,23,-9,14
Mumbai City,4875,1,7,4,3,19,8,11,25
Kolkata,4875,2,6,6,2,20,14,6,24
Kerala Blast,4875,3,6,3,5,12,14,-2,21
Delhi Dynamo,4875,4,4,5,5,24,25,-1,17
NorthEast Un,4875,5,5,2,7,13,14,-1,17
Chennaiyin,4875,6,4,5,5,17,20,-3,17
FC Goa,4875,7,5,2,7,16,19,-3,17
FC Pune City,4875,8,4,3,7,13,20,-7,15
Delhi Dynamo,4876,1,6,6,2,27,17,10,24
Mumbai City,4876,2,6,4,4,17,10,7,22
Kerala Blast,4876,3,6,4,4,13,15,-2,22
Kolkata,4876,4,4,7,3,16,15,1,19
FC Goa,4876,5,5,3,6,13,17,-4,18
NorthEast Un,4876,6,4,3,7,12,15,-3,15
FC Pune City,4876,7,4,3,7,12,16,-4,15
Chennaiyin,4876,8,3,6,5,15,20,-5,15
Mumbai City,4877,1,7,4,3,19,8,11,25
FC Pune City,4877,2,6,3,5,15,14,1,21
Chennaiyin,4877,3,5,5,4,21,18,3,20
Kolkata,4877,4,4,7,3,15,14,1,19
NorthEast Un,4877,5,5,3,6,14,18,-4,18
Delhi Dynamo,4877,6,4,5,5,22,22,0,17
Kerala Blast,4877,7,4,5,5,12,18,-6,17
FC Goa,4877,8,4,2,8,11,17,-6,14
Mumbai City,4878,1,7,4,3,18,9,9,25
Kerala Blast,4878,2,6,4,4,13,15,-2,22
Delhi Dynamo,4878,3,5,5,4,24,18,6,20
Kolkata,4878,4,4,8,2,16,14,2,20
NorthEast Un,4878,5,5,2,7,11,12,-1,17
Chennaiyin,4878,6,4,5,5,14,18,-4,17
FC Pune City,4878,7,4,3,7,14,18,-4,15
FC Goa,4878,8,4,3,7,9,15,-6,15
Mumbai City,4879,1,7,4,3,18,9,9,25
Kerala Blast,4879,2,6,4,4,14,15,-1,22
Delhi Dynamo,4879,3,5,6,3,31,19,12,21
Kolkata,4879,4,5,6,3,16,14,2,21
NorthEast Un,4879,5,5,4,5,17,15,2,19
Chennaiyin,4879,6,4,5,5,17,22,-5,17
FC Pune City,4879,7,4,3,7,13,18,-5,15
FC Goa,4879,8,3,2,9,8,22,-14,11
Kolkata,4880,1,5,7,2,19,14,5,22
Mumbai City,4880,2,6,4,4,16,12,4,22
Delhi Dynamo,4880,3,5,6,3,31,22,9,21
Kerala Blast,4880,4,5,4,5,12,18,-6,19
NorthEast Un,4880,5,5,3,6,14,13,1,18
Chennaiyin,4880,6,4,6,4,14,17,-3,18
FC Pune City,4880,7,4,3,7,15,19,-4,15
FC Goa,4880,8,3,5,6,12,18,-6,14
Mumbai City,4881,1,6,5,3,16,8,8,23
FC Pune City,4881,2,6,3,5,18,15,3,21
Delhi Dynamo,4881,3,4,8,2,23,16,7,20
Chennaiyin,4881,4,5,5,4,17,19,-2,20
Kolkata,4881,5,4,7,3,16,14,2,19
Kerala Blast,4881,6,5,3,6,13,21,-8,18
NorthEast Un,4881,7,4,3,7,12,15,-3,15
FC Goa,4881,8,3,4,7,11,18,-7,13
Delhi Dynamo,4882,1,6,5,3,26,19,7,23
Mumbai City,4882,2,6,4,4,17,10,7,22
Kolkata,4882,3,4,7,3,17,16,1,19
FC Pune City,4882,4,5,4,5,15,16,-1,19
Kerala Blast,4882,5,5,4,5,10,14,-4,19
NorthEast Un,4882,6,5,3,6,13,12,1,18
Chennaiyin,4882,7,4,6,4,15,18,-3,18
FC Goa,4882,8,3,3,8,10,18,-8,12
Delhi Dynamo,4883,1,6,5,3,28,17,11,23
Mumbai City,4883,2,6,4,4,16,9,7,22
FC Pune City,4883,3,5,4,5,15,16,-1,19
NorthEast Un,4883,4,5,3,6,15,14,1,18
Kerala Blast,4883,5,4,6,4,14,18,-4,18
Kolkata,4883,6,3,8,3,15,15,0,17
Chennaiyin,4883,7,4,5,5,17,21,-4,17
FC Goa,4883,8,4,3,7,12,22,-10,15
Delhi Dynamo,4884,1,6,6,2,25,15,10,24
Mumbai City,4884,2,6,4,4,16,10,6,22
NorthEast Un,4884,3,6,3,5,13,10,3,21
Kolkata,4884,4,4,6,4,16,18,-2,18
FC Pune City,4884,5,5,3,6,13,15,-2,18
Kerala Blast,4884,6,5,3,6,13,16,-3,18
Chennaiyin,4884,7,4,5,5,15,20,-5,17
FC Goa,4884,8,4,2,8,11,18,-7,14
Mumbai City,4885,1,6,5,3,17,9,8,23
Delhi Dynamo,4885,2,5,7,2,26,18,8,22
Kolkata,4885,3,4,7,3,17,16,1,19
Kerala Blast,4885,4,5,4,5,13,16,-3,19
NorthEast Un,4885,5,5,3,6,11,11,0,18
Chennaiyin,4885,6,4,6,4,16,19,-3,18
FC Goa,4885,7,4,3,7,14,19,-5,15
FC Pune City,4885,8,4,3,7,12,18,-6,15
Mumbai City,4886,1,7,4,3,17,8,9,25
Kolkata,4886,2,5,7,2,20,13,7,22
Delhi Dynamo,4886,3,5,5,4,23,18,5,20
Kerala Blast,4886,4,5,4,5,13,16,-3,19
FC Pune City,4886,5,5,3,6,13,15,-2,18
NorthEast Un,4886,6,5,2,7,15,14,1,17
Chennaiyin,4886,7,3,6,5,14,22,-8,15
FC Goa,4886,8,4,3,7,11,20,-9,15
Mumbai City,4887,1,7,4,3,18,9,9,25
Kerala Blast,4887,2,6,4,4,14,16,-2,22
Delhi Dynamo,4887,3,4,7,3,23,17,6,19
Kolkata,4887,4,4,7,3,16,15,1,19
NorthEast Un,4887,5,5,3,6,13,12,1,18
FC Goa,4887,6,5,3,6,12,15,-3,18
FC Pune City,4887,7,4,3,7,13,18,-5,15
Chennaiyin,4887,8,3,5,6,14,21,-7,14
Mumbai City,4888,1,7,4,3,18,9,9,25
NorthEast Un,4888,2,7,2,5,17,10,7,23
Delhi Dynamo,4888,3,5,5,4,27,22,5,20
Kolkata,4888,4,4,7,3,19,17,2,19
Kerala Blast,4888,5,5,3,6,13,19,-6,18
Chennaiyin,4888,6,4,5,5,16,19,-3,17
FC Pune City,4888,7,4,4,6,14,19,-5,16
FC Goa,4888,8,4,2,8,13,22,-9,14
Delhi Dynamo,4889,1,6,5,3,28,18,10,23
NorthEast Un,4889,2,7,2,5,14,11,3,23
Mumbai City,4889,3,6,4,4,17,11,6,22
Kolkata,4889,4,4,7,3,18,16,2,19
FC Pune City,4889,5,5,4,5,15,15,0,19
Kerala Blast,4889,6,5,3,6,11,17,-6,18
Chennaiyin,4889,7,4,5,5,16,19,-3,17
FC Goa,4889,8,3,2,9,10,22,-12,11
Mumbai City,4890,1,7,4,3,18,8,10,25
Kolkata,4890,2,5,7,2,18,15,3,22
Kerala Blast,4890,3,5,4,5,11,16,-5,19
Delhi Dynamo,4890,4,4,6,4,23,19,4,18
NorthEast Un,4890,5,5,3,6,11,11,0,18
FC Pune City,4890,6,5,3,6,14,15,-1,18
Chennaiyin,4890,7,4,6,4,17,19,-2,18
FC Goa,4890,8,3,3,8,13,22,-9,12
Mumbai City,4891,1,6,5,3,18,10,8,23
Delhi Dynamo,4891,2,5,7,2,27,18,9,22
Kolkata,4891,3,4,7,3,17,15,2,19
Kerala Blast,4891,4,5,4,5,15,19,-4,19
NorthEast Un,4891,5,4,4,6,12,14,-2,16
Chennaiyin,4891,6,3,7,4,14,18,-4,16
FC Pune City,4891,7,4,4,6,13,17,-4,16
FC Goa,4891,8,4,4,6,12,17,-5,16
Mumbai City,4892,1,7,4,3,19,8,11,25
Kolkata,4892,2,6,6,2,17,12,5,24
Delhi Dynamo,4892,3,5,6,3,24,19,5,21
NorthEast Un,4892,4,5,3,6,14,12,2,18
Kerala Blast,4892,5,4,5,5,12,18,-6,17
FC Pune City,4892,6,4,4,6,13,16,-3,16
FC Goa,4892,7,4,3,7,14,17,-3,15
Chennaiyin,4892,8,3,5,6,13,24,-11,14
Mumbai City,4893,1,6,4,4,17,11,6,22
Kerala Blast,4893,2,6,4,4,15,15,0,22
Delhi Dynamo,4893,3,5,5,4,25,20,5,20
Chennaiyin,4893,4,5,5,4,19,18,1,20
Kolkata,4893,5,3,8,3,17,17,0,17
FC Goa,4893,6,5,2,7,13,17,-4,17
NorthEast Un,4893,7,5,2,7,12,16,-4,17
FC Pune City,4893,8,4,4,6,13,17,-4,16
Delhi Dynamo,4894,1,7,5,2,25,15,10,26
Mumbai City,4894,2,6,4,4,17,10,7,22
Kerala Blast,4894,3,5,4,5,11,14,-3,19
Kolkata,4894,4,4,6,4,14,15,-1,18
NorthEast Un,4894,5,5,2,7,11,12,-1,17
FC Goa,4894,6,5,2,7,12,16,-4,17
Chennaiyin,4894,7,4,5,5,16,21,-5,17
FC Pune City,4894,8,4,4,6,12,15,-3,16
Mumbai City,4895,1,7,4,3,17,8,9,25
Kolkata,4895,2,5,7,2,19,13,6,22
Kerala Blast,4895,3,5,5,4,13,14,-1,20
NorthEast Un,4895,4,5,3,6,11,13,-2,18
Delhi Dynamo,4895,5,4,5,5,21,17,4,17
FC Goa,4895,6,5,2,7,11,15,-4,17
FC Pune City,4895,7,4,4,6,12,18,-6,16
Chennaiyin,4895,8,3,6,5,14,20,-6,15
Mumbai City,4896,1,7,4,3,17,8,9,25
Delhi Dynamo,4896,2,6,5,3,29,17,12,23
Kolkata,4896,3,4,7,3,18,16,2,19
NorthEast Un,4896,4,5,3,6,14,13,1,18
FC Pune City,4896,5,5,3,6,15,17,-2,18
Kerala Blast,4896,6,4,5,5,15,21,-6,17
FC Goa,4896,7,5,2,7,13,21,-8,17
Chennaiyin,4896,8,3,5,6,14,22,-8,14
Delhi Dynamo,4897,1,6,6,2,25,14,11,24
Mumbai City,4897,2,6,4,4,16,10,6,22
Kerala Blast,4897,3,6,4,4,12,14,-2,22
Chennaiyin,4897,4,5,5,4,17,17,0,20
Kolkata,4897,5,4,7,3,21,15,6,19
NorthEast Un,4897,6,4,3,7,10,13,-3,15
FC Pune City,4897,7,4,3,7,13,22,-9,15
FC Goa,4897,8,3,4,7,9,18,-9,13
Mumbai City,4898,1,7,4,3,17,8,9,25
Delhi Dynamo,4898,2,5,6,3,24,16,8,21
Kolkata,4898,3,5,6,3,18,16,2,21
Chennaiyin,4898,4,5,5,4,18,20,-2,20
Kerala Blast,4898,5,5,3,6,10,15,-5,18
NorthEast Un,4898,6,5,2,7,12,14,-2,17
FC Pune City,4898,7,4,3,7,14,18,-4,15
FC Goa,4898,8,4,3,7,12,18,-6,15
Mumbai City,4899,1,6,4,4,16,11,5,22
Kerala Blast,4899,2,6,4,4,18,14,4,22
Delhi Dynamo,4899,3,5,6,3,26,17,9,21
NorthEast Un,4899,4,6,3,5,13,10,3,21
Kolkata,4899,5,5,6,3,18,20,-2,21
Chennaiyin,4899,6,4,5,5,15,20,-5,17
FC Pune City,4899,7,4,3,7,14,19,-5,15
FC Goa,4899,8,3,3,8,11,20,-9,12
Kolkata,4900,1,6,6,2,20,13,7,24
Mumbai City,4900,2,6,5,3,17,9,8,23
Delhi Dynamo,4900,3,5,7,2,24,16,8,22
NorthEast Un,4900,4,5,3,6,10,11,-1,18
Chennaiyin,4900,5,4,6,4,15,17,-2,18
FC Pune City,4900,6,5,3,6,17,20,-3,18
Kerala Blast,4900,7,4,3,7,12,19,-7,15
FC Goa,4900,8,3,3,8,9,19,-10,12
Mumbai City,4901,1,7,4,3,17,8,9,25
Kerala Blast,4901,2,6,3,5,12,15,-3,21
Delhi Dynamo,4901,3,4,7,3,23,17,6,19
Kolkata,4901,4,4,6,4,15,15,0,18
NorthEast Un,4901,5,5,3,6,12,13,-1,18
FC Pune City,4901,6,5,3,6,13,15,-2,18
Chennaiyin,4901,7,4,5,5,16,19,-3,17
FC Goa,4901,8,4,3,7,10,16,-6,15
Mumbai City,4902,1,7,4,3,17,8,9,25
NorthEast Un,4902,2,7,2,5,15,12,3,23
Kerala Blast,4902,3,6,3,5,16,19,-3,21
Delhi Dynamo,4902,4,5,5,4,24,17,7,20
Kolkata,4902,5,4,7,3,22,17,5,19
FC Goa,4902,6,4,3,7,12,19,-7,15
FC Pune City,4902,7,4,3,7,13,21,-8,15
Chennaiyin,4902,8,3,5,6,14,20,-6,14
Mumbai City,4903,1,6,4,4,16,9,7,22
Kerala Blast,4903,2,6,4,4,17,16,1,22
NorthEast Un,4903,3,6,3,5,14,12,2,21
Delhi Dynamo,4903,4,5,5,4,24,18,6,20
Kolkata,4903,5,4,7,3,16,15,1,19
FC Goa,4903,6,5,3,6,11,15,-4,18
FC Pune City,4903,7,4,3,7,12,19,-7,15
Chennaiyin,4903,8,3,5,6,13,19,-6,14
Mumbai City,4904,1,7,4,3,17,8,9,25
Delhi Dynamo,4904,2,5,6,3,24,16,8,21
FC Pune City,4904,3,6,3,5,18,17,1,21
Kerala Blast,4904,4,6,3,5,15,17,-2,21
NorthEast Un,4904,5,5,3,6,12,13,-1,18
Chennaiyin,4904,6,4,5,5,16,20,-4,17
Kolkata,4904,7,3,6,5,15,18,-3,15
FC Goa,4904,8,4,2,8,12,20,-8,14
Delhi Dynamo,4905,1,6,5,3,28,18,10,23
Mumbai City,4905,2,6,4,4,18,12,6,22
NorthEast Un,4905,3,6,3,5,12,10,2,21
FC Pune City,4905,4,5,4,5,16,17,-1,19
Kerala Blast,4905,5,4,6,4,13,17,-4,18
FC Goa,4905,6,5,2,7,12,17,-5,17
Kolkata,4905,7,3,7,4,15,16,-1,16
Chennaiyin,4905,8,3,5,6,13,20,-7,14
Mumbai City,4906,1,7,4,3,20,8,12,25
Kolkata,4906,2,5,6,3,19,15,4,21
Chennaiyin,4906,3,5,5,4,16,18,-2,20
Delhi Dynamo,4906,4,4,7,3,25,22,3,19
NorthEast Un,4906,5,5,3,6,12,12,0,18
Kerala Blast,4906,6,5,3,6,10,16,-6,18
FC Goa,4906,7,4,3,7,14,18,-4,15
FC Pune City,4906,8,4,3,7,12,19,-7,15
Delhi Dynamo,4907,1,6,6,2,26,17,9,24
Mumbai City,4907,2,6,5,3,17,9,8,23
FC Pune City,4907,3,6,3,5,16,16,0,21
Kerala Blast,4907,4,6,3,5,13,16,-3,21
Chennaiyin,4907,5,5,5,4,19,19,0,20
Kolkata,4907,6,3,7,4,15,16,-1,16
NorthEast Un,4907,7,4,2,8,11,16,-5,14
FC Goa,4907,8,3,3,8,10,18,-8,12
Mumbai City,4908,1,6,4,4,16,9,7,22
Kolkata,4908,2,5,6,3,17,15,2,21
Delhi Dynamo,4908,3,5,5,4,24,19,5,20
FC Goa,4908,4,6,2,6,15,16,-1,20
Kerala Blast,4908,5,5,4,5,11,15,-4,19
NorthEast Un,4908,6,5,3,6,11,11,0,18
FC Pune City,4908,7,4,4,6,13,17,-4,16
Chennaiyin,4908,8,3,6,5,13,18,-5,15
Mumbai City,4909,1,6,5,3,16,8,8,23
Delhi Dynamo,4909,2,5,6,3,24,17,7,21
Kerala Blast,4909,3,6,3,5,12,15,-3,21
Kolkata,4909,4,4,7,3,16,16,0,19
Chennaiyin,4909,5,4,6,4,16,19,-3,18
NorthEast Un,4909,6,5,2,7,10,11,-1,17
FC Pune City,4909,7,4,4,6,13,16,-3,16
FC Goa,4909,8,4,3,7,14,19,-5,15
Mumbai City,4910,1,7,4,3,19,8,11,25
Kerala Blast,4910,2,6,4,4,14,14,0,22
Chennaiyin,4910,3,5,5,4,17,17,0,20
Kolkata,4910,4,4,7,3,17,18,-1,19
Delhi Dynamo,4910,5,4,6,4,23,20,3,18
FC Goa,4910,6,5,2,7,14,17,-3,17
NorthEast Un,4910,7,4,3,7,10,14,-4,15
FC Pune City,4910,8,4,3,7,13,19,-6,15
Kolkata,4911,1,6,6,2,21,13,8,24
Mumbai City,4911,2,6,5,3,16,8,8,23
Delhi Dynamo,4911,3,5,7,2,24,16,8,22
Kerala Blast,4911,4,5,4,5,12,17,-5,19
NorthEast Un,4911,5,4,4,6,11,12,-1,16
Chennaiyin,4911,6,3,6,5,14,20,-6,15
FC Pune City,4911,7,4,3,7,13,19,-6,15
FC Goa,4911,8,4,3,7,11,17,-6,15
Mumbai City,4912,1,7,4,3,22,10,12,25
NorthEast Un,4912,2,6,3,5,14,10,4,21
FC Pune City,4912,3,6,3,5,19,17,2,21
Delhi Dynamo,4912,4,5,5,4,25,22,3,20
Kolkata,4912,5,4,6,4,21,19,2,18
FC Goa,4912,6,5,2,7,13,19,-6,17
Kerala Blast,4912,7,4,4,6,11,21,-10,16
Chennaiyin,4912,8,3,5,6,13,20,-7,14
Mumbai City,4913,1,7,4,3,19,8,11,25
Kolkata,4913,2,5,6,3,20,14,6,21
Delhi Dynamo,4913,3,4,7,3,22,18,4,19
Kerala Blast,4913,4,5,4,5,13,16,-3,19
FC Goa,4913,5,5,3,6,13,17,-4,18
NorthEast Un,4913,6,4,4,6,11,13,-2,16
FC Pune City,4913,7,4,4,6,13,20,-7,16
Chennaiyin,4913,8,3,6,5,15,20,-5,15
Kolkata,4914,1,6,6,2,18,12,6,24
Delhi Dynamo,4914,2,6,5,3,27,20,7,23
Mumbai City,4914,3,6,4,4,19,12,7,22
Kerala Blast,4914,4,6,3,5,13,16,-3,21
NorthEast Un,4914,5,5,2,7,15,14,1,17
Chennaiyin,4914,6,4,5,5,17,22,-5,17
FC Pune City,4914,7,4,3,7,13,18,-5,15
FC Goa,4914,8,4,2,8,11,19,-8,14
Mumbai City,4915,1,7,4,3,17,8,9,25
Delhi Dynamo,4915,2,6,5,3,27,16,11,23
FC Pune City,4915,3,5,4,5,17,16,1,19
NorthEast Un,4915,4,5,3,6,11,12,-1,18
Kolkata,4915,5,3,8,3,17,18,-1,17
FC Goa,4915,6,5,2,7,15,19,-4,17
Kerala Blast,4915,7,4,5,5,10,17,-7,17
Chennaiyin,4915,8,3,5,6,14,22,-8,14
Mumbai City,4916,1,7,4,3,17,8,9,25
FC Pune City,4916,2,6,3,5,16,16,0,21
Delhi Dynamo,4916,3,5,5,4,24,19,5,20
Chennaiyin,4916,4,5,5,4,17,17,0,20
NorthEast Un,4916,5,5,3,6,13,13,0,18
Kerala Blast,4916,6,4,5,5,10,15,-5,17
Kolkata,4916,7,3,7,4,15,17,-2,16
FC Goa,4916,8,4,2,8,11,18,-7,14
Delhi Dynamo,4917,1,6,5,3,27,20,7,23
Mumbai City,4917,2,6,4,4,17,10,7,22
Kerala Blast,4917,3,6,4,4,13,14,-1,22
Kolkata,4917,4,4,8,2,17,15,2,20
Chennaiyin,4917,5,4,5,5,17,19,-2,17
FC Goa,4917,6,5,2,7,13,17,-4,17
FC Pune City,4917,7,4,4,6,14,18,-4,16
NorthEast Un,4917,8,4,2,8,11,16,-5,14
NorthEast Un,4918,1,7,2,5,14,11,3,23
Mumbai City,4918,2,6,4,4,16,9,7,22
Delhi Dynamo,4918,3,5,5,4,22,16,6,20
Kerala Blast,4918,4,5,4,5,11,15,-4,19
FC Pune City,4918,5,5,3,6,14,16,-2,18
FC Goa,4918,6,5,3,6,13,17,-4,18
Kolkata,4918,7,3,7,4,16,17,-1,16
Chennaiyin,4918,8,3,6,5,15,20,-5,15
Mumbai City,4919,1,6,4,4,16,9,7,22
Kerala Blast,4919,2,6,4,4,13,14,-1,22
Delhi Dynamo,4919,3,5,6,3,23,16,7,21
Chennaiyin,4919,4,4,6,4,17,18,-1,18
NorthEast Un,4919,5,5,3,6,12,14,-2,18
FC Pune City,4919,6,5,3,6,14,17,-3,18
FC Goa,4919,7,4,4,6,14,15,-1,16
Kolkata,4919,8,3,6,5,14,20,-6,15
Mumbai City,4920,1,6,4,4,16,9,7,22
Kerala Blast,4920,2,6,4,4,16,16,0,22
Delhi Dynamo,4920,3,5,5,4,23,17,6,20
FC Goa,4920,4,6,2,6,15,17,-2,20
NorthEast Un,4920,5,5,3,6,12,13,-1,18
Chennaiyin,4920,6,4,5,5,17,20,-3,17
Kolkata,4920,7,3,7,4,14,16,-2,16
FC Pune City,4920,8,4,4,6,12,17,-5,16
Kerala Blast,4921,1,7,3,4,16,14,2,24
Mumbai City,4921,2,6,5,3,17,9,8,23
Delhi Dynamo,4921,3,5,7,2,23,15,8,22
Kolkata,4921,4,4,7,3,16,15,1,19
FC Goa,4921,5,4,4,6,10,15,-5,16
FC Pune City,4921,6,4,3,7,12,16,-4,15
Chennaiyin,4921,7,3,6,5,13,18,-5,15
NorthEast Un,4921,8,4,3,7,9,14,-5,15
Mumbai City,4922,1,7,4,3,17,8,9,25
Kolkata,4922,2,5,7,2,18,13,5,22
Delhi Dynamo,4922,3,5,6,3,26,19,7,21
NorthEast Un,4922,4,6,2,6,14,12,2,20
Kerala Blast,4922,5,5,4,5,11,15,-4,19
Chennaiyin,4922,6,4,5,5,15,19,-4,17
FC Pune City,4922,7,4,3,7,14,19,-5,15
FC Goa,4922,8,3,3,8,10,20,-10,12
Delhi Dynamo,4923,1,6,6,2,27,16,11,24
Mumbai City,4923,2,6,5,3,17,9,8,23
Kerala Blast,4923,3,6,3,5,12,14,-2,21
FC Pune City,4923,4,5,4,5,14,15,-1,19
Kolkata,4923,5,3,8,3,14,14,0,17
Chennaiyin,4923,6,3,6,5,16,21,-5,15
NorthEast Un,4923,7,4,3,7,12,17,-5,15
FC Goa,4923,8,4,3,7,10,16,-6,15
Mumbai City,4924,1,7,4,3,19,9,10,25
Kolkata,4924,2,5,6,3,18,14,4,21
Delhi Dynamo,4924,3,4,6,4,24,20,4,18
FC Pune City,4924,4,5,3,6,13,15,-2,18
FC Goa,4924,5,5,3,6,13,16,-3,18
Kerala Blast,4924,6,5,3,6,11,18,-7,18
NorthEast Un,4924,7,5,2,7,11,12,-1,17
Chennaiyin,4924,8,4,5,5,15,20,-5,17
Mumbai City,4925,1,7,4,3,18,9,9,25
Delhi Dynamo,4925,2,5,6,3,25,17,8,21
Kolkata,4925,3,5,6,3,20,16,4,21
NorthEast Un,4925,4,6,3,5,15,11,4,21
Kerala Blast,4925,5,5,3,6,14,19,-5,18
FC Goa,4925,6,4,3,7,13,18,-5,15
Chennaiyin,4925,7,3,6,5,15,22,-7,15
FC Pune City,4925,8,4,3,7,13,21,-8,15
Mumbai City,4926,1,7,4,3,18,8,10,25
Kerala Blast,4926,2,6,4,4,15,16,-1,22
Delhi Dynamo,4926,3,4,6,4,23,19,4,18
NorthEast Un,4926,4,5,3,6,11,11,0,18
FC Goa,4926,5,5,3,6,14,17,-3,18
FC Pune City,4926,6,4,5,5,14,16,-2,17
Kolkata,4926,7,3,7,4,14,17,-3,16
Chennaiyin,4926,8,3,6,5,15,20,-5,15
Delhi Dynamo,4927,1,6,5,3,25,18,7,23
Mumbai City,4927,2,6,4,4,17,10,7,22
FC Pune City,4927,3,6,3,5,19,16,3,21
Kolkata,4927,4,4,6,4,17,17,0,18
Kerala Blast,4927,5,5,3,6,11,19,-8,18
NorthEast Un,4927,6,5,2,7,15,15,0,17
Chennaiyin,4927,7,4,5,5,18,22,-4,17
FC Goa,4927,8,5,2,7,13,18,-5,17
Mumbai City,4928,1,7,4,3,20,11,9,25
Delhi Dynamo,4928,2,6,5,3,30,21,9,23
Kolkata,4928,3,5,6,3,17,14,3,21
Kerala Blast,4928,4,5,4,5,13,18,-5,19
FC Pune City,4928,5,5,3,6,16,18,-2,18
Chennaiyin,4928,6,4,5,5,15,20,-5,17
NorthEast Un,4928,7,4,3,7,14,16,-2,15
FC Goa,4928,8,4,2,8,10,17,-7,14
Mumbai City,4929,1,7,4,3,18,8,10,25
NorthEast Un,4929,2,7,2,5,15,12,3,23
Kerala Blast,4929,3,6,3,5,17,15,2,21
FC Pune City,4929,4,5,3,6,15,21,-6,18
Delhi Dynamo,4929,5,4,5,5,22,19,3,17
Chennaiyin,4929,6,4,5,5,16,19,-3,17
Kolkata,4929,7,3,7,4,16,18,-2,16
FC Goa,4929,8,4,3,7,10,17,-7,15
Delhi Dynamo,4930,1,6,6,2,27,17,10,24
Mumbai City,4930,2,6,4,4,16,10,6,22
Kolkata,4930,3,5,6,3,18,14,4,21
Kerala Blast,4930,4,6,3,5,11,15,-4,21
FC Pune City,4930,5,5,3,6,15,17,-2,18
Chennaiyin,4930,6,4,5,5,17,21,-4,17
NorthEast Un,4930,7,4,3,7,10,15,-5,15
FC Goa,4930,8,4,2,8,14,19,-5,14
Delhi Dynamo,4931,1,6,6,2,29,17,12,24
Mumbai City,4931,2,6,5,3,17,9,8,23
Kerala Blast,4931,3,6,3,5,14,18,-4,21
NorthEast Un,4931,4,5,3,6,13,13,0,18
FC Pune City,4931,5,5,3,6,17,18,-1,18
Chennaiyin,4931,6,4,6,4,14,17,-3,18
Kolkata,4931,7,3,6,5,15,20,-5,15
FC Goa,4931,8,4,2,8,12,19,-7,14
Mumbai City,4932,1,7,4,3,19,10,9,25
Delhi Dynamo,4932,2,5,5,4,26,19,7,20
Kolkata,4932,3,4,7,3,14,14,0,19
FC Pune City,4932,4,5,4,5,15,16,-1,19
Chennaiyin,4932,5,4,6,4,16,19,-3,18
Kerala Blast,4932,6,5,3,6,12,17,-5,18
FC Goa,4932,7,5,2,7,12,16,-4,17
NorthEast Un,4932,8,4,3,7,11,14,-3,15
Mumbai City,4933,1,7,4,3,17,8,9,25
Kerala Blast,4933,2,7,3,4,12,13,-1,24
Delhi Dynamo,4933,3,4,7,3,22,16,6,19
Kolkata,4933,4,4,6,4,15,15,0,18
NorthEast Un,4933,5,4,4,6,10,11,-1,16
Chennaiyin,4933,6,3,7,4,15,19,-4,16
FC Goa,4933,7,4,4,6,12,16,-4,16
FC Pune City,4933,8,4,3,7,12,17,-5,15
NorthEast Un,4934,1,7,2,5,16,11,5,23
Mumbai City,4934,2,6,4,4,16,9,7,22
Delhi Dynamo,4934,3,5,5,4,24,20,4,20
Kolkata,4934,4,4,7,3,17,16,1,19
FC Pune City,4934,5,5,3,6,15,17,-2,18
Chennaiyin,4934,6,4,5,5,16,20,-4,17
FC Goa,4934,7,5,2,7,12,17,-5,17
Kerala Blast,4934,8,4,4,6,12,18,-6,16
Mumbai City,4935,1,6,5,3,18,10,8,23
NorthEast Un,4935,2,6,3,5,14,12,2,21
Kolkata,4935,3,4,7,3,16,15,1,19
Kerala Blast,4935,4,5,4,5,13,16,-3,19
Delhi Dynamo,4935,5,4,6,4,24,19,5,18
FC Goa,4935,6,5,3,6,10,14,-4,18
FC Pune City,4935,7,4,4,6,13,17,-4,16
Chennaiyin,4935,8,3,6,5,14,19,-5,15
Mumbai City,4936,1,7,4,3,19,8,11,25
Delhi Dynamo,4936,2,6,5,3,25,18,7,23
Kolkata,4936,3,5,6,3,20,19,1,21
Kerala Blast,4936,4,5,4,5,13,16,-3,19
NorthEast Un,4936,5,5,3,6,11,11,0,18
Chennaiyin,4936,6,4,5,5,16,20,-4,17
FC Pune City,4936,7,4,3,7,13,18,-5,15
FC Goa,4936,8,4,2,8,14,21,-7,14
Mumbai City,4937,1,6,5,3,16,8,8,23
NorthEast Un,4937,2,7,2,5,16,12,4,23
Delhi Dynamo,4937,3,5,6,3,24,17,7,21
FC Pune City,4937,4,5,4,5,13,14,-1,19
Kerala Blast,4937,5,5,4,5,13,17,-4,19
Kolkata,4937,6,4,6,4,16,17,-1,18
Chennaiyin,4937,7,3,6,5,14,19,-5,15
FC Goa,4937,8,3,3,8,8,16,-8,12
Mumbai City,4938,1,7,4,3,19,9,10,25
Kerala Blast,4938,2,6,4,4,15,15,0,22
Delhi Dynamo,4938,3,5,5,4,24,18,6,20
NorthEast Un,4938,4,5,4,5,11,10,1,19
Chennaiyin,4938,5,4,6,4,15,18,-3,18
Kolkata,4938,6,3,8,3,15,15,0,17
FC Pune City,4938,7,4,4,6,13,18,-5,16
FC Goa,4938,8,3,3,8,9,18,-9,12
Mumbai City,4939,1,7,4,3,19,9,10,25
Delhi Dynamo,4939,2,5,6,3,24,18,6,21
Kolkata,4939,3,5,6,3,16,15,1,21
NorthEast Un,4939,4,5,4,5,11,10,1,19
FC Pune City,4939,5,5,3,6,14,16,-2,18
Chennaiyin,4939,6,4,6,4,14,17,-3,18
Kerala Blast,4939,7,4,3,7,10,17,-7,15
FC Goa,4939,8,4,2,8,11,17,-6,14
Mumbai City,4940,1,7,4,3,19,10,9,25
FC Pune City,4940,2,6,3,5,16,16,0,21
Delhi Dynamo,4940,3,5,5,4,25,19,6,20
Kerala Blast,4940,4,5,4,5,14,16,-2,19
Kolkata,4940,5,4,6,4,15,17,-2,18
FC Goa,4940,6,5,2,7,11,16,-5,17
NorthEast Un,4940,7,4,4,6,12,13,-1,16
Chennaiyin,4940,8,3,6,5,15,20,-5,15
Mumbai City,4941,1,6,4,4,16,12,4,22
Kerala Blast,4941,2,6,4,4,16,17,-1,22
Delhi Dynamo,4941,3,5,6,3,28,18,10,21
Kolkata,4941,4,4,7,3,19,17,2,19
NorthEast Un,4941,5,5,3,6,12,13,-1,18
Chennaiyin,4941,6,4,6,4,15,18,-3,18
FC Pune City,4941,7,4,3,7,15,20,-5,15
FC Goa,4941,8,4,3,7,12,18,-6,15
Mumbai City,4942,1,6,5,3,16,8,8,23
Delhi Dynamo,4942,2,5,6,3,24,17,7,21
NorthEast Un,4942,3,6,3,5,13,11,2,21
FC Pune City,4942,4,5,4,5,15,16,-1,19
Kerala Blast,4942,5,5,4,5,12,16,-4,19
Kolkata,4942,6,3,7,4,15,16,-1,16
Chennaiyin,4942,7,3,6,5,15,20,-5,15
FC Goa,4942,8,4,3,7,11,17,-6,15
Mumbai City,4943,1,6,5,3,18,10,8,23
Delhi Dynamo,4943,2,5,7,2,26,17,9,22
Kolkata,4943,3,5,7,2,18,13,5,22
NorthEast Un,4943,4,5,4,5,13,12,1,19
FC Pune City,4943,5,5,3,6,13,17,-4,18
Kerala Blast,4943,6,4,5,5,11,16,-5,17
Chennaiyin,4943,7,3,5,6,15,21,-6,14
FC Goa,4943,8,4,2,8,10,18,-8,14
Mumbai City,4944,1,7,4,3,18,9,9,25
Kolkata,4944,2,6,6,2,18,13,5,24
Delhi Dynamo,4944,3,6,5,3,30,17,13,23
Chennaiyin,4944,4,4,6,4,16,17,-1,18
NorthEast Un,4944,5,5,3,6,10,12,-2,18
FC Pune City,4944,6,4,4,6,13,16,-3,16
Kerala Blast,4944,7,4,4,6,11,17,-6,16
FC Goa,4944,8,3,2,9,9,24,-15,11
Mumbai City,4945,1,6,5,3,17,9,8,23
Delhi Dynamo,4945,2,5,7,2,25,16,9,22
Kolkata,4945,3,5,7,2,16,13,3,22
Kerala Blast,4945,4,5,5,4,11,14,-3,20
NorthEast Un,4945,5,4,5,5,11,11,0,17
FC Pune City,4945,6,4,3,7,13,17,-4,15
Chennaiyin,4945,7,3,6,5,14,19,-5,15
FC Goa,4945,8,4,2,8,10,18,-8,14
Mumbai City,4946,1,7,4,3,18,8,10,25
Kolkata,4946,2,4,8,2,18,15,3,20
NorthEast Un,4946,3,6,2,6,14,11,3,20
Kerala Blast,4946,4,5,4,5,14,18,-4,19
FC Goa,4946,5,5,3,6,16,19,-3,18
Delhi Dynamo,4946,6,4,5,5,23,21,2,17
FC Pune City,4946,7,4,5,5,16,18,-2,17
Chennaiyin,4946,8,3,5,6,14,23,-9,14
Mumbai City,4947,1,6,5,3,17,9,8,23
Delhi Dynamo,4947,2,5,7,2,25,17,8,22
Kerala Blast,4947,3,6,4,4,15,16,-1,22
NorthEast Un,4947,4,5,4,5,13,12,1,19
Kolkata,4947,5,4,6,4,17,17,0,18
Chennaiyin,4947,6,3,6,5,14,19,-5,15
FC Pune City,4947,7,4,3,7,13,18,-5,15
FC Goa,4947,8,4,3,7,10,16,-6,15
Mumbai City,4948,1,6,5,3,17,9,8,23
Delhi Dynamo,4948,2,5,7,2,25,17,8,22
Kolkata,4948,3,5,7,2,16,13,3,22
FC Pune City,4948,4,5,3,6,15,16,-1,18
Chennaiyin,4948,5,4,6,4,14,17,-3,18
NorthEast Un,4948,6,5,2,7,13,12,1,17
Kerala Blast,4948,7,4,3,7,11,21,-10,15
FC Goa,4948,8,3,5,6,9,15,-6,14
Mumbai City,4949,1,7,4,3,18,8,10,25
Kolkata,4949,2,4,8,2,20,14,6,20
NorthEast Un,4949,3,6,2,6,14,11,3,20
FC Goa,4949,4,5,3,6,15,18,-3,18
Kerala Blast,4949,5,5,3,6,11,22,-11,18
Delhi Dynamo,4949,6,4,5,5,24,21,3,17
Chennaiyin,4949,7,4,5,5,15,20,-5,17
FC Pune City,4949,8,4,4,6,14,17,-3,16
Delhi Dynamo,4950,1,6,6,2,28,18,10,24
Kerala Blast,4950,2,7,3,4,15,16,-1,24
Mumbai City,4950,3,6,4,4,18,12,6,22
Kolkata,4950,4,4,6,4,17,17,0,18
FC Pune City,4950,5,5,3,6,17,19,-2,18
NorthEast Un,4950,6,4,4,6,12,13,-1,16
Chennaiyin,4950,7,3,6,5,15,20,-5,15
FC Goa,4950,8,4,2,8,10,17,-7,14
Kolkata,4951,1,6,6,2,18,13,5,24
Mumbai City,4951,2,6,5,3,17,9,8,23
Delhi Dynamo,4951,3,5,6,3,25,18,7,21
Kerala Blast,4951,4,6,3,5,12,15,-3,21
NorthEast Un,4951,5,5,2,7,11,13,-2,17
Chennaiyin,4951,6,4,5,5,15,19,-4,17
FC Pune City,4951,7,4,3,7,14,19,-5,15
FC Goa,4951,8,4,2,8,11,17,-6,14
Delhi Dynamo,4952,1,6,6,2,28,16,12,24
Mumbai City,4952,2,6,4,4,16,10,6,22
Kerala Blast,4952,3,6,4,4,15,14,1,22
FC Pune City,4952,4,5,4,5,15,15,0,19
Kolkata,4952,5,4,6,4,15,16,-1,18
NorthEast Un,4952,6,4,4,6,13,16,-3,16
Chennaiyin,4952,7,3,6,5,15,20,-5,15
FC Goa,4952,8,4,2,8,9,19,-10,14
Kerala Blast,4953,1,7,3,4,15,14,1,24
Mumbai City,4953,2,6,5,3,16,8,8,23
Delhi Dynamo,4953,3,5,6,3,25,18,7,21
Kolkata,4953,4,5,6,3,19,15,4,21
NorthEast Un,4953,5,5,3,6,12,12,0,18
Chennaiyin,4953,6,3,7,4,16,20,-4,16
FC Pune City,4953,7,4,3,7,13,21,-8,15
FC Goa,4953,8,3,3,8,14,22,-8,12
Delhi Dynamo,4954,1,7,5,2,28,17,11,26
Mumbai City,4954,2,6,4,4,18,11,7,22
Kerala Blast,4954,3,5,5,4,13,16,-3,20
FC Pune City,4954,4,5,4,5,15,16,-1,19
NorthEast Un,4954,5,5,2,7,12,13,-1,17
Chennaiyin,4954,6,4,5,5,14,19,-5,17
Kolkata,4954,7,3,7,4,16,17,-1,16
FC Goa,4954,8,4,2,8,11,18,-7,14
NorthEast Un,4955,1,7,2,5,18,11,7,23
Mumbai City,4955,2,6,4,4,16,9,7,22
Kerala Blast,4955,3,6,3,5,15,16,-1,21
Delhi Dynamo,4955,4,5,5,4,24,19,5,20
FC Pune City,4955,5,5,3,6,15,21,-6,18
Chennaiyin,4955,6,4,5,5,16,20,-4,17
FC Goa,4955,7,5,2,7,12,17,-5,17
Kolkata,4955,8,3,6,5,15,18,-3,15
Mumbai City,4956,1,7,4,3,18,9,9,25
Chennaiyin,4956,2,5,5,4,20,20,0,20
Kerala Blast,4956,3,5,5,4,13,15,-2,20
Delhi Dynamo,4956,4,4,7,3,23,17,6,19
Kolkata,4956,5,4,7,3,18,16,2,19
FC Pune City,4956,6,4,4,6,12,16,-4,16
NorthEast Un,4956,7,4,3,7,10,14,-4,15
FC Goa,4956,8,4,3,7,13,20,-7,15
Delhi Dynamo,4957,1,5,7,2,27,18,9,22
Mumbai City,4957,2,6,4,4,17,11,6,22
Kolkata,4957,3,4,8,2,18,15,3,20
NorthEast Un,4957,4,5,4,5,13,10,3,19
FC Pune City,4957,5,4,5,5,14,16,-2,17
Kerala Blast,4957,6,4,5,5,12,19,-7,17
Chennaiyin,4957,7,3,7,4,14,18,-4,16
FC Goa,4957,8,3,4,7,11,19,-8,13
Mumbai City,4958,1,6,4,4,16,9,7,22
Delhi Dynamo,4958,2,5,6,3,24,17,7,21
Kerala Blast,4958,3,5,5,4,11,14,-3,20
Kolkata,4958,4,4,7,3,15,14,1,19
FC Pune City,4958,5,5,4,5,14,15,-1,19
NorthEast Un,4958,6,5,2,7,12,13,-1,17
Chennaiyin,4958,7,4,5,5,14,18,-4,17
FC Goa,4958,8,4,3,7,10,16,-6,15
Mumbai City,4959,1,7,4,3,19,10,9,25
Kerala Blast,4959,2,6,4,4,13,13,0,22
Delhi Dynamo,4959,3,5,5,4,25,20,5,20
NorthEast Un,4959,4,5,3,6,12,12,0,18
Kolkata,4959,5,3,8,3,16,17,-1,17
FC Pune City,4959,6,4,5,5,14,16,-2,17
Chennaiyin,4959,7,3,7,4,14,18,-4,16
FC Goa,4959,8,3,4,7,10,17,-7,13
Delhi Dynamo,4960,1,6,6,2,27,16,11,24
Mumbai City,4960,2,6,5,3,16,8,8,23
Kolkata,4960,3,5,7,2,16,13,3,22
Kerala Blast,4960,4,5,4,5,11,14,-3,19
NorthEast Un,4960,5,5,3,6,13,14,-1,18
FC Pune City,4960,6,4,4,6,13,17,-4,16
Chennaiyin,4960,7,3,5,6,15,22,-7,14
FC Goa,4960,8,4,2,8,11,18,-7,14
Mumbai City,4961,1,7,4,3,19,10,9,25
Delhi Dynamo,4961,2,6,5,3,28,18,10,23
FC Pune City,4961,3,5,4,5,15,16,-1,19
Chennaiyin,4961,4,4,6,4,16,18,-2,18
Kolkata,4961,5,3,8,3,19,20,-1,17
Kerala Blast,4961,6,4,5,5,13,18,-5,17
NorthEast Un,4961,7,4,3,7,11,15,-4,15
FC Goa,4961,8,4,3,7,12,18,-6,15
Mumbai City,4962,1,6,5,3,16,8,8,23
Delhi Dynamo,4962,2,5,6,3,25,18,7,21
Kolkata,4962,3,5,6,3,17,16,1,21
Kerala Blast,4962,4,5,4,5,12,16,-4,19
NorthEast Un,4962,5,5,2,7,12,13,-1,17
FC Goa,4962,6,5,2,7,15,18,-3,17
Chennaiyin,4962,7,4,5,5,16,21,-5,17
FC Pune City,4962,8,4,4,6,14,17,-3,16
Mumbai City,4963,1,6,5,3,16,8,8,23
Delhi Dynamo,4963,2,5,7,2,23,15,8,22
Kerala Blast,4963,3,5,5,4,13,15,-2,20
Kolkata,4963,4,4,7,3,17,15,2,19
NorthEast Un,4963,5,5,2,7,11,13,-2,17
FC Pune City,4963,6,4,4,6,13,17,-4,16
FC Goa,4963,7,4,4,6,11,16,-5,16
Chennaiyin,4963,8,3,6,5,14,19,-5,15
Mumbai City,4964,1,7,4,3,19,9,10,25
Kolkata,4964,2,5,6,3,17,13,4,21
NorthEast Un,4964,3,6,3,5,15,12,3,21
Delhi Dynamo,4964,4,4,6,4,24,20,4,18
Kerala Blast,4964,5,5,3,6,12,18,-6,18
Chennaiyin,4964,6,3,7,4,14,18,-4,16
FC Goa,4964,7,4,4,6,10,15,-5,16
FC Pune City,4964,8,4,3,7,13,19,-6,15
Delhi Dynamo,4965,1,6,6,2,25,15,10,24
Mumbai City,4965,2,6,4,4,16,10,6,22
Kolkata,4965,3,5,6,3,15,13,2,21
Kerala Blast,4965,4,6,3,5,11,14,-3,21
Chennaiyin,4965,5,4,6,4,17,20,-3,18
NorthEast Un,4965,6,4,3,7,12,14,-2,15
FC Pune City,4965,7,4,3,7,12,16,-4,15
FC Goa,4965,8,4,3,7,10,16,-6,15
Mumbai City,4966,1,7,4,3,18,9,9,25
Kerala Blast,4966,2,6,4,4,14,16,-2,22
Delhi Dynamo,4966,3,4,7,3,26,20,6,19
Kolkata,4966,4,4,7,3,18,14,4,19
NorthEast Un,4966,5,4,5,5,16,16,0,17
FC Pune City,4966,6,4,4,6,13,16,-3,16
Chennaiyin,4966,7,3,7,4,15,19,-4,16
FC Goa,4966,8,3,4,7,10,20,-10,13
Mumbai City,4967,1,6,5,3,17,9,8,23
Delhi Dynamo,4967,2,4,8,2,23,16,7,20
NorthEast Un,4967,3,5,4,5,12,10,2,19
Kolkata,4967,4,4,7,3,20,19,1,19
Kerala Blast,4967,5,5,4,5,14,18,-4,19
Chennaiyin,4967,6,4,6,4,15,18,-3,18
FC Goa,4967,7,4,3,7,13,17,-4,15
FC Pune City,4967,8,4,3,7,12,19,-7,15
Mumbai City,4968,1,7,4,3,19,9,10,25
Kolkata,4968,2,6,6,2,19,13,6,24
Delhi Dynamo,4968,3,5,5,4,25,18,7,20
NorthEast Un,4968,4,5,3,6,12,14,-2,18
FC Pune City,4968,5,5,3,6,15,18,-3,18
FC Goa,4968,6,5,2,7,10,15,-5,17
Chennaiyin,4968,7,3,6,5,14,19,-5,15
Kerala Blast,4968,8,4,3,7,12,20,-8,15
Mumbai City,4969,1,6,4,4,16,10,6,22
Delhi Dynamo,4969,2,5,6,3,23,15,8,21
Kolkata,4969,3,5,6,3,18,16,2,21
FC Goa,4969,4,6,2,6,14,15,-1,20
NorthEast Un,4969,5,5,4,5,12,10,2,19
Kerala Blast,4969,6,5,3,6,12,19,-7,18
FC Pune City,4969,7,4,3,7,13,17,-4,15
Chennaiyin,4969,8,3,6,5,14,20,-6,15
Mumbai City,4970,1,7,4,3,19,10,9,25
Kerala Blast,4970,2,6,4,4,14,16,-2,22
Delhi Dynamo,4970,3,5,5,4,26,18,8,20
Kolkata,4970,4,4,6,4,17,17,0,18
NorthEast Un,4970,5,5,3,6,12,13,-1,18
FC Pune City,4970,6,5,3,6,14,16,-2,18
Chennaiyin,4970,7,3,6,5,15,21,-6,15
FC Goa,4970,8,4,3,7,11,17,-6,15
Mumbai City,4971,1,7,4,3,19,8,11,25
Kerala Blast,4971,2,7,3,4,14,14,0,24
Delhi Dynamo,4971,3,4,6,4,22,19,3,18
Kolkata,4971,4,4,6,4,17,14,3,18
NorthEast Un,4971,5,5,3,6,12,12,0,18
Chennaiyin,4971,6,4,5,5,14,18,-4,17
FC Goa,4971,7,5,2,7,10,15,-5,17
FC Pune City,4971,8,4,3,7,12,20,-8,15
Mumbai City,4972,1,6,5,3,16,8,8,23
NorthEast Un,4972,2,6,3,5,12,10,2,21
Kolkata,4972,3,4,7,3,15,14,1,19
FC Pune City,4972,4,5,4,5,13,14,-1,19
Delhi Dynamo,4972,5,4,6,4,23,18,5,18
FC Goa,4972,6,5,3,6,14,17,-3,18
Kerala Blast,4972,7,4,5,5,10,15,-5,17
Chennaiyin,4972,8,3,5,6,13,20,-7,14
Mumbai City,4973,1,7,4,3,18,8,10,25
Kerala Blast,4973,2,6,4,4,15,16,-1,22
Delhi Dynamo,4973,3,5,5,4,26,20,6,20
NorthEast Un,4973,4,6,2,6,18,15,3,20
Kolkata,4973,5,3,8,3,15,17,-2,17
Chennaiyin,4973,6,4,5,5,16,22,-6,17
FC Pune City,4973,7,4,4,6,13,16,-3,16
FC Goa,4973,8,4,2,8,13,20,-7,14
Delhi Dynamo,4974,1,6,5,3,24,15,9,23
Mumbai City,4974,2,6,4,4,16,9,7,22
NorthEast Un,4974,3,6,3,5,13,10,3,21
Kolkata,4974,4,4,7,3,16,16,0,19
Kerala Blast,4974,5,5,4,5,13,17,-4,19
FC Pune City,4974,6,5,3,6,15,16,-1,18
Chennaiyin,4974,7,4,5,5,15,20,-5,17
FC Goa,4974,8,3,3,8,8,17,-9,12
Mumbai City,4975,1,7,4,3,19,9,10,25
Kolkata,4975,2,6,6,2,18,12,6,24
Delhi Dynamo,4975,3,5,5,4,25,21,4,20
NorthEast Un,4975,4,5,3,6,13,13,0,18
FC Pune City,4975,5,5,3,6,13,16,-3,18
Chennaiyin,4975,6,3,7,4,17,21,-4,16
FC Goa,4975,7,4,3,7,13,19,-6,15
Kerala Blast,4975,8,4,3,7,9,16,-7,15
Delhi Dynamo,4976,1,5,7,2,28,19,9,22
Mumbai City,4976,2,6,4,4,17,11,6,22
Kolkata,4976,3,4,8,2,17,14,3,20
FC Pune City,4976,4,5,4,5,14,14,0,19
Chennaiyin,4976,5,4,5,5,16,21,-5,17
NorthEast Un,4976,6,4,4,6,12,13,-1,16
FC Goa,4976,7,4,4,6,15,19,-4,16
Kerala Blast,4976,8,4,4,6,11,19,-8,16
Mumbai City,4977,1,7,4,3,17,8,9,25
Delhi Dynamo,4977,2,5,5,4,25,17,8,20
Chennaiyin,4977,3,5,5,4,17,17,0,20
Kerala Blast,4977,4,5,5,4,14,17,-3,20
FC Pune City,4977,5,5,4,5,19,17,2,19
FC Goa,4977,6,5,2,7,12,17,-5,17
Kolkata,4977,7,3,7,4,16,21,-5,16
NorthEast Un,4977,8,4,2,8,9,15,-6,14
Delhi Dynamo,4978,1,6,5,3,23,15,8,23
Mumbai City,4978,2,6,4,4,16,9,7,22
NorthEast Un,4978,3,6,2,6,14,11,3,20
FC Pune City,4978,4,5,4,5,18,18,0,19
Kerala Blast,4978,5,5,4,5,14,18,-4,19
Kolkata,4978,6,4,6,4,16,17,-1,18
FC Goa,4978,7,4,3,7,11,17,-6,15
Chennaiyin,4978,8,3,6,5,14,21,-7,15
Kolkata,4979,1,6,6,2,20,12,8,24
Mumbai City,4979,2,6,5,3,18,10,8,23
Kerala Blast,4979,3,5,4,5,11,15,-4,19
Delhi Dynamo,4979,4,4,6,4,23,19,4,18
NorthEast Un,4979,5,5,3,6,12,11,1,18
FC Goa,4979,6,5,2,7,12,17,-5,17
Chennaiyin,4979,7,4,5,5,14,20,-6,17
FC Pune City,4979,8,4,3,7,12,18,-6,15
Mumbai City,4980,1,6,5,3,16,8,8,23
Delhi Dynamo,4980,2,5,7,2,25,16,9,22
Kerala Blast,4980,3,6,4,4,12,13,-1,22
Kolkata,4980,4,4,7,3,16,15,1,19
NorthEast Un,4980,5,5,2,7,10,12,-2,17
Chennaiyin,4980,6,4,5,5,14,18,-4,17
FC Pune City,4980,7,4,4,6,12,16,-4,16
FC Goa,4980,8,3,4,7,11,18,-7,13
NorthEast Un,4981,1,7,2,5,17,11,6,23
Mumbai City,4981,2,6,4,4,16,9,7,22
Delhi Dynamo,4981,3,5,6,3,24,17,7,21
Kolkata,4981,4,5,6,3,21,15,6,21
Kerala Blast,4981,5,6,3,5,16,16,0,21
FC Pune City,4981,6,4,3,7,12,20,-8,15
FC Goa,4981,7,4,3,7,11,21,-10,15
Chennaiyin,4981,8,3,5,6,14,22,-8,14
Mumbai City,4982,1,7,4,3,20,10,10,25
Kolkata,4982,2,6,6,2,20,15,5,24
Delhi Dynamo,4982,3,5,5,4,26,21,5,20
Kerala Blast,4982,4,5,4,5,14,17,-3,19
NorthEast Un,4982,5,5,2,7,13,15,-2,17
Chennaiyin,4982,6,4,5,5,16,20,-4,17
FC Pune City,4982,7,4,4,6,15,18,-3,16
FC Goa,4982,8,4,2,8,11,19,-8,14
Mumbai City,4983,1,7,4,3,19,8,11,25
Delhi Dynamo,4983,2,5,6,3,24,19,5,21
Kolkata,4983,3,4,7,3,15,16,-1,19
Kerala Blast,4983,4,5,4,5,13,16,-3,19
NorthEast Un,4983,5,4,5,5,9,9,0,17
FC Goa,4983,6,5,2,7,17,18,-1,17
FC Pune City,4983,7,4,4,6,13,17,-4,16
Chennaiyin,4983,8,3,6,5,14,21,-7,15
Delhi Dynamo,4984,1,6,6,2,26,16,10,24
Mumbai City,4984,2,6,5,3,17,9,8,23
Kolkata,4984,3,5,7,2,17,14,3,22
NorthEast Un,4984,4,6,2,6,15,14,1,20
Kerala Blast,4984,5,5,3,6,12,18,-6,18
Chennaiyin,4984,6,4,5,5,16,19,-3,17
FC Pune City,4984,7,4,4,6,14,17,-3,16
FC Goa,4984,8,3,2,9,9,19,-10,11
Delhi Dynamo,4985,1,6,6,2,26,15,11,24
Kerala Blast,4985,2,7,3,4,15,14,1,24
Mumbai City,4985,3,6,5,3,16,8,8,23
Chennaiyin,4985,4,4,5,5,15,19,-4,17
FC Goa,4985,5,5,2,7,12,19,-7,17
Kolkata,4985,6,3,7,4,16,18,-2,16
FC Pune City,4985,7,4,4,6,13,17,-4,16
NorthEast Un,4985,8,4,2,8,10,13,-3,14
Mumbai City,4986,1,7,4,3,19,8,11,25
Kolkata,4986,2,5,7,2,17,13,4,22
Delhi Dynamo,4986,3,5,6,3,25,20,5,21
Kerala Blast,4986,4,5,4,5,11,15,-4,19
NorthEast Un,4986,5,5,3,6,11,11,0,18
FC Pune City,4986,6,4,4,6,14,17,-3,16
Chennaiyin,4986,7,3,6,5,13,18,-5,15
FC Goa,4986,8,3,4,7,10,18,-8,13
Mumbai City,4987,1,7,4,3,19,10,9,25
Delhi Dynamo,4987,2,6,5,3,29,18,11,23
Kolkata,4987,3,5,7,2,21,14,7,22
Chennaiyin,4987,4,4,6,4,18,21,-3,18
FC Pune City,4987,5,5,3,6,13,17,-4,18
Kerala Blast,4987,6,4,4,6,12,20,-8,16
NorthEast Un,4987,7,4,3,7,12,15,-3,15
FC Goa,4987,8,3,4,7,11,20,-9,13
Mumbai City,4988,1,6,5,3,16,8,8,23
Kolkata,4988,2,5,7,2,19,16,3,22
Delhi Dynamo,4988,3,4,8,2,24,17,7,20
Chennaiyin,4988,4,5,5,4,19,20,-1,20
Kerala Blast,4988,5,5,5,4,15,18,-3,20
NorthEast Un,4988,6,4,4,6,15,17,-2,16
FC Pune City,4988,7,4,3,7,14,18,-4,15
FC Goa,4988,8,3,3,8,11,19,-8,12
Delhi Dynamo,4989,1,6,6,2,28,16,12,24
Kerala Blast,4989,2,7,3,4,18,17,1,24
Mumbai City,4989,3,6,4,4,16,9,7,22
Kolkata,4989,4,5,6,3,16,14,2,21
NorthEast Un,4989,5,4,4,6,15,17,-2,16
FC Pune City,4989,6,4,3,7,12,17,-5,15
Chennaiyin,4989,7,3,6,5,14,20,-6,15
FC Goa,4989,8,4,2,8,10,19,-9,14
Mumbai City,4990,1,7,4,3,17,8,9,25
Kolkata,4990,2,5,7,2,18,14,4,22
Delhi Dynamo,4990,3,5,6,3,24,16,8,21
NorthEast Un,4990,4,5,3,6,10,11,-1,18
Chennaiyin,4990,5,4,6,4,17,19,-2,18
Kerala Blast,4990,6,5,3,6,11,16,-5,18
FC Pune City,4990,7,4,4,6,13,17,-4,16
FC Goa,4990,8,3,3,8,12,21,-9,12
Mumbai City,4991,1,7,4,3,17,8,9,25
Kolkata,4991,2,5,7,2,20,13,7,22
NorthEast Un,4991,3,6,3,5,15,11,4,21
Delhi Dynamo,4991,4,5,5,4,24,20,4,20
Kerala Blast,4991,5,5,3,6,11,19,-8,18
FC Pune City,4991,6,4,4,6,12,15,-3,16
Chennaiyin,4991,7,3,6,5,15,20,-5,15
FC Goa,4991,8,4,2,8,11,19,-8,14
Delhi Dynamo,4992,1,7,5,2,25,14,11,26
Mumbai City,4992,2,6,4,4,16,9,7,22
Kolkata,4992,3,4,8,2,17,15,2,20
Chennaiyin,4992,4,5,5,4,18,19,-1,20
Kerala Blast,4992,5,5,3,6,13,17,-4,18
NorthEast Un,4992,6,5,2,7,12,14,-2,17
FC Pune City,4992,7,4,4,6,12,16,-4,16
FC Goa,4992,8,3,3,8,11,20,-9,12
Mumbai City,4993,1,7,4,3,18,9,9,25
Delhi Dynamo,4993,2,6,5,3,26,17,9,23
Kerala Blast,4993,3,6,3,5,13,16,-3,21
FC Pune City,4993,4,5,3,6,16,16,0,18
NorthEast Un,4993,5,5,3,6,11,11,0,18
Kolkata,4993,6,3,7,4,14,17,-3,16
Chennaiyin,4993,7,3,6,5,13,19,-6,15
FC Goa,4993,8,4,3,7,12,18,-6,15
Mumbai City,4994,1,7,4,3,19,8,11,25
Kolkata,4994,2,4,7,3,16,15,1,19
Kerala Blast,4994,3,5,4,5,11,15,-4,19
Delhi Dynamo,4994,4,4,6,4,22,19,3,18
NorthEast Un,4994,5,5,3,6,11,12,-1,18
FC Pune City,4994,6,5,3,6,14,16,-2,18
Chennaiyin,4994,7,4,5,5,17,20,-3,17
FC Goa,4994,8,4,4,6,13,18,-5,16
Mumbai City,4995,1,6,5,3,18,10,8,23
Delhi Dynamo,4995,2,5,6,3,25,17,8,21
NorthEast Un,4995,3,6,2,6,14,12,2,20
Kolkata,4995,4,4,7,3,18,17,1,19
Kerala Blast,4995,5,5,4,5,11,16,-5,19
Chennaiyin,4995,6,4,5,5,16,21,-5,17
FC Goa,4995,7,5,2,7,11,16,-5,17
FC Pune City,4995,8,4,3,7,15,19,-4,15
Delhi Dynamo,4996,1,6,6,2,26,16,10,24
Mumbai City,4996,2,6,4,4,16,10,6,22
Kerala Blast,4996,3,6,4,4,14,15,-1,22
Chennaiyin,4996,4,5,5,4,15,17,-2,20
NorthEast Un,4996,5,4,4,6,11,12,-1,16
Kolkata,4996,6,3,7,4,15,17,-2,16
FC Pune City,4996,7,4,4,6,13,16,-3,16
FC Goa,4996,8,4,2,8,10,17,-7,14
Mumbai City,4997,1,6,5,3,17,9,8,23
Delhi Dynamo,4997,2,5,6,3,25,18,7,21
FC Pune City,4997,3,6,3,5,16,15,1,21
NorthEast Un,4997,4,5,4,5,12,11,1,19
FC Goa,4997,5,5,2,7,12,16,-4,17
Kerala Blast,4997,6,4,5,5,11,17,-6,17
Kolkata,4997,7,3,7,4,14,16,-2,16
Chennaiyin,4997,8,3,6,5,14,19,-5,15
Mumbai City,4998,1,6,4,4,17,11,6,22
Delhi Dynamo,4998,2,5,6,3,25,19,6,21
FC Pune City,4998,3,6,3,5,15,15,0,21
NorthEast Un,4998,4,5,3,6,13,11,2,18
Kolkata,4998,5,4,6,4,17,16,1,18
Kerala Blast,4998,6,5,3,6,12,19,-7,18
Chennaiyin,4998,7,3,7,4,15,19,-4,16
FC Goa,4998,8,4,4,6,12,16,-4,16
Mumbai City,4999,1,7,4,3,17,8,9,25
Kerala Blast,4999,2,6,4,4,12,14,-2,22
Kolkata,4999,3,5,6,3,18,16,2,21
Delhi Dynamo,4999,4,5,5,4,22,16,6,20
NorthEast Un,4999,5,5,2,7,12,13,-1,17
Chennaiyin,4999,6,4,5,5,15,19,-4,17
FC Pune City,4999,7,4,4,6,14,17,-3,16
FC Goa,4999,8,4,2,8,10,17,-7,14
Mumbai City,5000,1,7,4,3,17,8,9,25
Kolkata,5000,2,5,7,2,20,15,5,22
Delhi Dynamo,5000,3,5,5,4,25,18,7,20
Chennaiyin,5000,4,5,5,4,16,18,-2,20
Kerala Blast,5000,5,4,6,4,13,17,-4,18
FC Pune City,5000,6,4,4,6,14,17,-3,16
NorthEast Un,5000,7,4,3,7,13,16,-3,15
FC Goa,5000,8,4,2,8,11,20,-9,14
Mumbai City,5001,1,7,4,3,18,9,9,25
Delhi Dynamo,5001,2,6,5,3,29,20,9,23
Kolkata,5001,3,5,7,2,18,15,3,22
Kerala Blast,5001,4,6,4,4,13,15,-2,22
NorthEast Un,5001,5,5,2,7,17,19,-2,17
Chennaiyin,5001,6,4,5,5,17,21,-4,17
FC Pune City,5001,7,4,3,7,12,16,-4,15
FC Goa,5001,8,3,2,9,11,20,-9,11
Delhi Dynamo,5002,1,6,6,2,24,15,9,24
Mumbai City,5002,2,6,5,3,17,9,8,23
Kolkata,5002,3,4,7,3,15,15,0,19
FC Pune City,5002,4,5,3,6,14,16,-2,18
Kerala Blast,5002,5,5,3,6,12,16,-4,18
Chennaiyin,5002,6,4,5,5,18,19,-1,17
NorthEast Un,5002,7,5,2,7,12,16,-4,17
FC Goa,5002,8,4,3,7,9,15,-6,15
Mumbai City,5003,1,7,4,3,19,9,10,25
Kolkata,5003,2,5,7,2,16,13,3,22
Kerala Blast,5003,3,6,4,4,13,14,-1,22
Delhi Dynamo,5003,4,5,6,3,24,18,6,21
Chennaiyin,5003,5,4,6,4,15,18,-3,18
NorthEast Un,5003,6,4,3,7,11,14,-3,15
FC Pune City,5003,7,4,3,7,13,17,-4,15
FC Goa,5003,8,3,3,8,9,17,-8,12
Mumbai City,5004,1,6,5,3,16,8,8,23
Delhi Dynamo,5004,2,5,7,2,25,17,8,22
Kolkata,5004,3,5,6,3,18,14,4,21
NorthEast Un,5004,4,5,3,6,12,12,0,18
Kerala Blast,5004,5,4,5,5,10,16,-6,17
FC Pune City,5004,6,4,4,6,13,17,-4,16
FC Goa,5004,7,4,4,6,14,19,-5,16
Chennaiyin,5004,8,3,6,5,16,21,-5,15
Delhi Dynamo,5005,1,6,5,3,25,16,9,23
NorthEast Un,5005,2,7,2,5,14,11,3,23
Mumbai City,5005,3,6,4,4,17,11,6,22
Kolkata,5005,4,5,7,2,15,12,3,22
Kerala Blast,5005,5,5,3,6,12,16,-4,18
Chennaiyin,5005,6,3,6,5,15,20,-5,15
FC Pune City,5005,7,4,3,7,12,17,-5,15
FC Goa,5005,8,3,4,7,9,16,-7,13
Mumbai City,5006,1,7,4,3,17,8,9,25
Delhi Dynamo,5006,2,6,5,3,25,16,9,23
Kerala Blast,5006,3,5,4,5,13,15,-2,19
Kolkata,5006,4,4,6,4,18,18,0,18
FC Pune City,5006,5,5,3,6,14,18,-4,18
NorthEast Un,5006,6,4,4,6,9,10,-1,16
Chennaiyin,5006,7,3,7,4,14,18,-4,16
FC Goa,5006,8,4,3,7,13,20,-7,15
Mumbai City,5007,1,6,5,3,16,8,8,23
Kerala Blast,5007,2,6,4,4,17,15,2,22
Delhi Dynamo,5007,3,5,6,3,23,17,6,21
Chennaiyin,5007,4,4,6,4,17,19,-2,18
NorthEast Un,5007,5,5,2,7,13,14,-1,17
FC Pune City,5007,6,4,5,5,13,15,-2,17
Kolkata,5007,7,3,7,4,13,18,-5,16
FC Goa,5007,8,4,3,7,11,17,-6,15
Delhi Dynamo,5008,1,6,5,3,26,19,7,23
Mumbai City,5008,2,6,4,4,17,10,7,22
Kolkata,5008,3,5,7,2,18,15,3,22
Kerala Blast,5008,4,5,4,5,11,15,-4,19
NorthEast Un,5008,5,5,3,6,14,12,2,18
FC Pune City,5008,6,4,4,6,13,16,-3,16
Chennaiyin,5008,7,3,7,4,15,19,-4,16
FC Goa,5008,8,3,4,7,10,18,-8,13
Mumbai City,5009,1,6,5,3,16,8,8,23
Delhi Dynamo,5009,2,5,7,2,24,14,10,22
FC Pune City,5009,3,5,4,5,14,15,-1,19
Kerala Blast,5009,4,5,4,5,11,15,-4,19
Chennaiyin,5009,5,4,6,4,16,18,-2,18
Kolkata,5009,6,3,8,3,16,16,0,17
NorthEast Un,5009,7,4,3,7,10,13,-3,15
FC Goa,5009,8,4,3,7,12,20,-8,15
Mumbai City,5010,1,7,4,3,17,8,9,25
Kolkata,5010,2,6,6,2,21,12,9,24
NorthEast Un,5010,3,5,4,5,12,10,2,19
Delhi Dynamo,5010,4,4,6,4,22,18,4,18
FC Pune City,5010,5,5,3,6,16,16,0,18
Chennaiyin,5010,6,4,6,4,16,17,-1,18
Kerala Blast,5010,7,4,4,6,10,21,-11,16
FC Goa,5010,8,3,3,8,8,20,-12,12
Delhi Dynamo,5011,1,6,5,3,26,17,9,23
Mumbai City,5011,2,6,4,4,16,10,6,22
Kolkata,5011,3,5,7,2,18,14,4,22
Chennaiyin,5011,4,5,5,4,16,18,-2,20
Kerala Blast,5011,5,5,4,5,11,15,-4,19
FC Pune City,5011,6,5,3,6,14,17,-3,18
NorthEast Un,5011,7,5,2,7,13,13,0,17
FC Goa,5011,8,3,2,9,10,20,-10,11
Kolkata,5012,1,6,6,2,21,12,9,24
Delhi Dynamo,5012,2,5,7,2,23,15,8,22
Mumbai City,5012,3,6,4,4,16,9,7,22
NorthEast Un,5012,4,5,4,5,14,13,1,19
Kerala Blast,5012,5,4,5,5,14,20,-6,17
FC Pune City,5012,6,4,4,6,14,20,-6,16
FC Goa,5012,7,4,3,7,10,17,-7,15
Chennaiyin,5012,8,3,5,6,14,20,-6,14
Mumbai City,5013,1,6,5,3,17,9,8,23
Delhi Dynamo,5013,2,5,6,3,24,17,7,21
NorthEast Un,5013,3,6,3,5,13,10,3,21
Kolkata,5013,4,4,6,4,16,14,2,18
Chennaiyin,5013,5,4,6,4,17,19,-2,18
FC Pune City,5013,6,5,3,6,13,15,-2,18
Kerala Blast,5013,7,5,3,6,10,18,-8,18
FC Goa,5013,8,4,2,8,11,19,-8,14
Mumbai City,5014,1,6,4,4,16,9,7,22
Kerala Blast,5014,2,6,3,5,13,17,-4,21
Delhi Dynamo,5014,3,5,5,4,23,19,4,20
Kolkata,5014,4,4,7,3,16,13,3,19
FC Pune City,5014,5,5,3,6,14,17,-3,18
FC Goa,5014,6,5,3,6,12,15,-3,18
NorthEast Un,5014,7,5,2,7,13,12,1,17
Chennaiyin,5014,8,4,5,5,15,20,-5,17
NorthEast Un,5015,1,7,2,5,12,9,3,23
Mumbai City,5015,2,6,4,4,17,11,6,22
Delhi Dynamo,5015,3,5,6,3,26,18,8,21
Kolkata,5015,4,5,6,3,21,17,4,21
FC Pune City,5015,5,5,3,6,15,16,-1,18
FC Goa,5015,6,4,4,6,14,19,-5,16
Chennaiyin,5015,7,3,6,5,14,19,-5,15
Kerala Blast,5015,8,4,3,7,10,20,-10,15
Delhi Dynamo,5016,1,6,6,2,29,19,10,24
Mumbai City,5016,2,6,4,4,17,10,7,22
Kolkata,5016,3,5,6,3,19,17,2,21
FC Pune City,5016,4,6,3,5,15,14,1,21
NorthEast Un,5016,5,5,4,5,13,12,1,19
Chennaiyin,5016,6,3,6,5,16,21,-5,15
Kerala Blast,5016,7,4,3,7,9,17,-8,15
FC Goa,5016,8,4,2,8,17,25,-8,14
Mumbai City,5017,1,7,4,3,17,8,9,25
NorthEast Un,5017,2,6,3,5,15,10,5,21
Delhi Dynamo,5017,3,5,5,4,24,20,4,20
Kerala Blast,5017,4,5,4,5,13,15,-2,19
Kolkata,5017,5,4,6,4,16,19,-3,18
FC Pune City,5017,6,5,3,6,15,19,-4,18
Chennaiyin,5017,7,4,5,5,15,20,-5,17
FC Goa,5017,8,4,2,8,15,19,-4,14
Mumbai City,5018,1,7,4,3,21,10,11,25
NorthEast Un,5018,2,6,2,6,11,10,1,20
Delhi Dynamo,5018,3,4,6,4,24,21,3,18
FC Pune City,5018,4,5,3,6,15,15,0,18
FC Goa,5018,5,5,3,6,14,15,-1,18
Kolkata,5018,6,4,6,4,14,16,-2,18
Kerala Blast,5018,7,5,3,6,11,17,-6,18
Chennaiyin,5018,8,4,5,5,14,20,-6,17
Mumbai City,5019,1,7,4,3,19,8,11,25
Kolkata,5019,2,6,6,2,20,12,8,24
Delhi Dynamo,5019,3,6,5,3,28,20,8,23
NorthEast Un,5019,4,5,2,7,12,14,-2,17
Chennaiyin,5019,5,4,5,5,14,18,-4,17
Kerala Blast,5019,6,4,4,6,10,16,-6,16
FC Pune City,5019,7,4,4,6,12,19,-7,16
FC Goa,5019,8,4,2,8,11,19,-8,14
Delhi Dynamo,5020,1,7,5,2,28,16,12,26
Mumbai City,5020,2,6,4,4,17,10,7,22
NorthEast Un,5020,3,6,2,6,12,11,1,20
Kolkata,5020,4,4,7,3,17,15,2,19
FC Pune City,5020,5,5,4,5,14,15,-1,19
Kerala Blast,5020,6,4,4,6,10,17,-7,16
Chennaiyin,5020,7,3,6,5,13,18,-5,15
FC Goa,5020,8,3,4,7,10,19,-9,13
Mumbai City,5021,1,6,5,3,16,8,8,23
Delhi Dynamo,5021,2,5,7,2,25,14,11,22
FC Pune City,5021,3,5,4,5,18,17,1,19
NorthEast Un,5021,4,5,3,6,12,10,2,18
Kolkata,5021,5,4,6,4,16,17,-1,18
Chennaiyin,5021,6,4,6,4,15,18,-3,18
Kerala Blast,5021,7,4,4,6,12,22,-10,16
FC Goa,5021,8,4,3,7,11,19,-8,15
Mumbai City,5022,1,6,5,3,17,9,8,23
Kolkata,5022,2,5,7,2,18,13,5,22
NorthEast Un,5022,3,6,2,6,15,12,3,20
Kerala Blast,5022,4,5,4,5,14,18,-4,19
Delhi Dynamo,5022,5,4,6,4,22,19,3,18
FC Goa,5022,6,5,3,6,14,17,-3,18
FC Pune City,5022,7,4,4,6,14,18,-4,16
Chennaiyin,5022,8,3,5,6,15,23,-8,14
Mumbai City,5023,1,7,4,3,18,9,9,25
Kolkata,5023,2,5,6,3,18,16,2,21
Delhi Dynamo,5023,3,4,6,4,24,19,5,18
FC Goa,5023,4,5,3,6,17,17,0,18
NorthEast Un,5023,5,5,3,6,13,13,0,18
FC Pune City,5023,6,5,3,6,14,16,-2,18
Kerala Blast,5023,7,5,3,6,13,18,-5,18
Chennaiyin,5023,8,3,6,5,14,23,-9,15
Mumbai City,5024,1,7,4,3,18,9,9,25
Kolkata,5024,2,5,6,3,18,13,5,21
NorthEast Un,5024,3,5,4,5,14,13,1,19
Kerala Blast,5024,4,5,4,5,12,17,-5,19
Delhi Dynamo,5024,5,4,6,4,23,18,5,18
FC Pune City,5024,6,5,3,6,13,15,-2,18
Chennaiyin,5024,7,3,7,4,15,19,-4,16
FC Goa,5024,8,3,4,7,9,18,-9,13
Mumbai City,5025,1,7,4,3,17,8,9,25
Kerala Blast,5025,2,6,4,4,14,14,0,22
Kolkata,5025,3,4,8,2,15,13,2,20
Delhi Dynamo,5025,4,4,6,4,22,19,3,18
NorthEast Un,5025,5,5,3,6,13,12,1,18
FC Goa,5025,6,4,4,6,11,16,-5,16
Chennaiyin,5025,7,3,6,5,15,20,-5,15
FC Pune City,5025,8,4,3,7,14,19,-5,15
Mumbai City,5026,1,6,5,3,16,8,8,23
Delhi Dynamo,5026,2,5,7,2,26,14,12,22
Chennaiyin,5026,3,5,5,4,20,18,2,20
Kolkata,5026,4,4,7,3,17,15,2,19
Kerala Blast,5026,5,5,4,5,12,17,-5,19
FC Pune City,5026,6,5,3,6,13,15,-2,18
NorthEast Un,5026,7,5,3,6,12,15,-3,18
FC Goa,5026,8,3,2,9,10,24,-14,11
Delhi Dynamo,5027,1,6,6,2,24,15,9,24
Mumbai City,5027,2,6,5,3,17,9,8,23
Kerala Blast,5027,3,6,4,4,12,13,-1,22
Kolkata,5027,4,4,8,2,16,13,3,20
Chennaiyin,5027,5,4,6,4,15,17,-2,18
FC Pune City,5027,6,4,3,7,12,18,-6,15
NorthEast Un,5027,7,4,2,8,9,13,-4,14
FC Goa,5027,8,3,4,7,9,16,-7,13
Mumbai City,5028,1,6,5,3,18,10,8,23
Kolkata,5028,2,5,7,2,20,15,5,22
NorthEast Un,5028,3,6,2,6,13,11,2,20
Delhi Dynamo,5028,4,4,7,3,25,20,5,19
FC Pune City,5028,5,4,5,5,13,15,-2,17
Chennaiyin,5028,6,4,5,5,15,18,-3,17
Kerala Blast,5028,7,4,4,6,10,18,-8,16
FC Goa,5028,8,4,3,7,12,19,-7,15
Delhi Dynamo,5029,1,6,5,3,27,17,10,23
Mumbai City,5029,2,6,4,4,17,11,6,22
Chennaiyin,5029,3,5,5,4,18,18,0,20
FC Pune City,5029,4,5,4,5,14,15,-1,19
Kerala Blast,5029,5,5,4,5,12,17,-5,19
Kolkata,5029,6,4,6,4,15,16,-1,18
NorthEast Un,5029,7,5,2,7,12,15,-3,17
FC Goa,5029,8,4,2,8,12,18,-6,14
Mumbai City,5030,1,6,5,3,17,9,8,23
Delhi Dynamo,5030,2,5,7,2,26,15,11,22
Kerala Blast,5030,3,6,4,4,13,15,-2,22
NorthEast Un,5030,4,5,4,5,11,10,1,19
Kolkata,5030,5,3,8,3,16,16,0,17
Chennaiyin,5030,6,4,5,5,15,19,-4,17
FC Pune City,5030,7,4,4,6,13,16,-3,16
FC Goa,5030,8,3,3,8,10,21,-11,12
Mumbai City,5031,1,7,4,3,20,9,11,25
FC Pune City,5031,2,6,3,5,16,14,2,21
Delhi Dynamo,5031,3,4,7,3,26,22,4,19
NorthEast Un,5031,4,5,4,5,14,12,2,19
Kerala Blast,5031,5,5,4,5,11,16,-5,19
Chennaiyin,5031,6,4,5,5,15,20,-5,17
Kolkata,5031,7,3,6,5,14,17,-3,15
FC Goa,5031,8,4,3,7,12,18,-6,15
Mumbai City,5032,1,6,5,3,16,8,8,23
Delhi Dynamo,5032,2,5,6,3,23,17,6,21
Kolkata,5032,3,4,7,3,16,15,1,19
Kerala Blast,5032,4,5,4,5,13,16,-3,19
NorthEast Un,5032,5,5,3,6,13,13,0,18
Chennaiyin,5032,6,4,6,4,16,18,-2,18
FC Pune City,5032,7,4,5,5,13,15,-2,17
FC Goa,5032,8,4,2,8,12,20,-8,14
Mumbai City,5033,1,7,4,3,17,8,9,25
Delhi Dynamo,5033,2,5,6,3,26,18,8,21
Kerala Blast,5033,3,6,3,5,15,16,-1,21
Kolkata,5033,4,4,6,4,18,18,0,18
FC Pune City,5033,5,5,3,6,17,19,-2,18
Chennaiyin,5033,6,4,5,5,16,19,-3,17
FC Goa,5033,7,5,2,7,12,18,-6,17
NorthEast Un,5033,8,4,3,7,12,17,-5,15
Delhi Dynamo,5034,1,6,6,2,28,17,11,24
Mumbai City,5034,2,6,4,4,16,9,7,22
Chennaiyin,5034,3,5,5,4,17,19,-2,20
Kolkata,5034,4,4,7,3,18,15,3,19
FC Pune City,5034,5,5,4,5,15,16,-1,19
Kerala Blast,5034,6,5,4,5,12,16,-4,19
NorthEast Un,5034,7,4,4,6,13,14,-1,16
FC Goa,5034,8,3,2,9,11,24,-13,11
Delhi Dynamo,5035,1,6,6,2,28,17,11,24
Mumbai City,5035,2,6,4,4,19,13,6,22
Kerala Blast,5035,3,6,4,4,13,14,-1,22
FC Pune City,5035,4,5,3,6,15,17,-2,18
FC Goa,5035,5,5,3,6,12,15,-3,18
Chennaiyin,5035,6,4,5,5,15,20,-5,17
Kolkata,5035,7,3,7,4,14,16,-2,16
NorthEast Un,5035,8,4,2,8,10,14,-4,14
Mumbai City,5036,1,7,4,3,21,8,13,25
Delhi Dynamo,5036,2,5,6,3,24,20,4,21
FC Pune City,5036,3,6,3,5,18,15,3,21
Kolkata,5036,4,4,6,4,14,17,-3,18
Kerala Blast,5036,5,5,3,6,12,18,-6,18
Chennaiyin,5036,6,4,5,5,16,20,-4,17
FC Goa,5036,7,5,2,7,13,17,-4,17
NorthEast Un,5036,8,4,3,7,11,14,-3,15
Mumbai City,5037,1,7,4,3,18,8,10,25
Delhi Dynamo,5037,2,5,6,3,26,17,9,21
Kolkata,5037,3,5,6,3,16,13,3,21
Kerala Blast,5037,4,5,4,5,15,18,-3,19
Chennaiyin,5037,5,4,6,4,14,17,-3,18
FC Pune City,5037,6,5,3,6,14,18,-4,18
NorthEast Un,5037,7,4,4,6,12,13,-1,16
FC Goa,5037,8,3,3,8,8,19,-11,12
Mumbai City,5038,1,7,4,3,20,9,11,25
Delhi Dynamo,5038,2,6,5,3,27,18,9,23
FC Pune City,5038,3,5,4,5,15,15,0,19
Kolkata,5038,4,3,9,2,16,15,1,18
Chennaiyin,5038,5,4,5,5,16,19,-3,17
NorthEast Un,5038,6,5,2,7,10,15,-5,17
Kerala Blast,5038,7,4,4,6,10,17,-7,16
FC Goa,5038,8,4,3,7,11,17,-6,15
Mumbai City,5039,1,7,4,3,17,8,9,25
Delhi Dynamo,5039,2,6,5,3,25,17,8,23
Kolkata,5039,3,5,7,2,20,16,4,22
NorthEast Un,5039,4,5,3,6,12,12,0,18
Kerala Blast,5039,5,5,3,6,12,18,-6,18
FC Pune City,5039,6,4,4,6,13,16,-3,16
Chennaiyin,5039,7,3,7,4,13,17,-4,16
FC Goa,5039,8,3,3,8,11,19,-8,12
Mumbai City,5040,1,7,4,3,18,8,10,25
Kerala Blast,5040,2,6,4,4,13,14,-1,22
Delhi Dynamo,5040,3,5,6,3,23,17,6,21
Chennaiyin,5040,4,5,5,4,18,18,0,20
Kolkata,5040,5,3,8,3,14,15,-1,17
NorthEast Un,5040,6,4,4,6,10,12,-2,16
FC Pune City,5040,7,4,4,6,14,17,-3,16
FC Goa,5040,8,3,3,8,9,18,-9,12
Delhi Dynamo,5041,1,6,5,3,24,16,8,23
Mumbai City,5041,2,6,4,4,16,9,7,22
Chennaiyin,5041,3,5,5,4,20,20,0,20
Kerala Blast,5041,4,5,5,4,13,16,-3,20
FC Pune City,5041,5,5,4,5,15,15,0,19
NorthEast Un,5041,6,5,2,7,13,16,-3,17
Kolkata,5041,7,3,7,4,14,16,-2,16
FC Goa,5041,8,4,2,8,11,18,-7,14
Mumbai City,5042,1,7,4,3,17,8,9,25
Delhi Dynamo,5042,2,6,5,3,24,16,8,23
Kolkata,5042,3,5,7,2,17,13,4,22
Kerala Blast,5042,4,5,4,5,13,16,-3,19
Chennaiyin,5042,5,4,6,4,18,17,1,18
FC Pune City,5042,6,5,3,6,14,16,-2,18
NorthEast Un,5042,7,4,2,8,10,19,-9,14
FC Goa,5042,8,3,3,8,8,16,-8,12
Mumbai City,5043,1,7,4,3,17,8,9,25
Delhi Dynamo,5043,2,5,6,3,24,17,7,21
NorthEast Un,5043,3,5,3,6,12,12,0,18
Kolkata,5043,4,4,6,4,15,17,-2,18
FC Pune City,5043,5,5,3,6,13,15,-2,18
Kerala Blast,5043,6,5,3,6,13,17,-4,18
Chennaiyin,5043,7,3,7,4,13,17,-4,16
FC Goa,5043,8,4,4,6,11,15,-4,16
Mumbai City,5044,1,6,5,3,17,9,8,23
Delhi Dynamo,5044,2,5,6,3,25,18,7,21
Kolkata,5044,3,4,6,4,16,16,0,18
Chennaiyin,5044,4,4,6,4,17,19,-2,18
FC Pune City,5044,5,5,3,6,14,16,-2,18
FC Goa,5044,6,5,3,6,14,18,-4,18
Kerala Blast,5044,7,5,3,6,12,17,-5,18
NorthEast Un,5044,8,5,2,7,13,15,-2,17
Delhi Dynamo,5045,1,7,5,2,28,14,14,26
Mumbai City,5045,2,6,4,4,16,10,6,22
Kolkata,5045,3,5,6,3,16,14,2,21
FC Pune City,5045,4,5,4,5,15,16,-1,19
Chennaiyin,5045,5,4,5,5,15,19,-4,17
Kerala Blast,5045,6,4,5,5,13,18,-5,17
NorthEast Un,5045,7,4,3,7,11,16,-5,15
FC Goa,5045,8,4,2,8,9,16,-7,14
Mumbai City,5046,1,7,4,3,18,9,9,25
Kolkata,5046,2,4,8,2,18,15,3,20
FC Pune City,5046,3,5,4,5,17,17,0,19
Delhi Dynamo,5046,4,4,6,4,24,20,4,18
Kerala Blast,5046,5,5,3,6,10,17,-7,18
NorthEast Un,5046,6,5,2,7,12,12,0,17
Chennaiyin,5046,7,4,5,5,15,19,-4,17
FC Goa,5046,8,4,4,6,11,16,-5,16
Delhi Dynamo,5047,1,6,5,3,27,16,11,23
Mumbai City,5047,2,6,4,4,17,12,5,22
FC Pune City,5047,3,6,3,5,18,15,3,21
Kerala Blast,5047,4,5,4,5,11,16,-5,19
NorthEast Un,5047,5,5,3,6,10,11,-1,18
Kolkata,5047,6,4,6,4,17,19,-2,18
FC Goa,5047,7,5,2,7,13,17,-4,17
Chennaiyin,5047,8,3,5,6,13,20,-7,14
Mumbai City,5048,1,7,4,3,18,9,9,25
Delhi Dynamo,5048,2,6,5,3,27,17,10,23
Kerala Blast,5048,3,6,3,5,16,18,-2,21
NorthEast Un,5048,4,6,2,6,14,13,1,20
Kolkata,5048,5,4,6,4,15,16,-1,18
FC Pune City,5048,6,5,3,6,17,19,-2,18
Chennaiyin,5048,7,3,6,5,14,20,-6,15
FC Goa,5048,8,3,3,8,9,18,-9,12
Delhi Dynamo,5049,1,6,5,3,27,20,7,23
Mumbai City,5049,2,6,4,4,17,10,7,22
FC Pune City,5049,3,6,3,5,16,14,2,21
Kolkata,5049,4,4,7,3,18,18,0,19
NorthEast Un,5049,5,5,3,6,15,14,1,18
Chennaiyin,5049,6,4,5,5,14,19,-5,17
Kerala Blast,5049,7,4,5,5,12,17,-5,17
FC Goa,5049,8,4,2,8,11,18,-7,14
Mumbai City,5050,1,6,5,3,17,9,8,23
Delhi Dynamo,5050,2,5,7,2,24,16,8,22
Chennaiyin,5050,3,5,5,4,17,18,-1,20
Kerala Blast,5050,4,5,5,4,12,15,-3,20
Kolkata,5050,5,3,9,2,15,14,1,18
FC Pune City,5050,6,4,5,5,14,16,-2,17
NorthEast Un,5050,7,4,2,8,10,13,-3,14
FC Goa,5050,8,3,4,7,9,17,-8,13
Mumbai City,5051,1,6,5,3,17,9,8,23
Kerala Blast,5051,2,6,3,5,14,18,-4,21
Delhi Dynamo,5051,3,4,8,2,27,20,7,20
Kolkata,5051,4,4,7,3,20,17,3,19
NorthEast Un,5051,5,5,3,6,11,12,-1,18
FC Goa,5051,6,4,4,6,15,19,-4,16
FC Pune City,5051,7,4,4,6,13,17,-4,16
Chennaiyin,5051,8,3,6,5,13,18,-5,15
Delhi Dynamo,5052,1,7,5,2,27,16,11,26
Mumbai City,5052,2,6,4,4,17,10,7,22
Kolkata,5052,3,4,8,2,17,15,2,20
Kerala Blast,5052,4,5,3,6,14,19,-5,18
NorthEast Un,5052,5,5,2,7,11,14,-3,17
Chennaiyin,5052,6,4,5,5,15,19,-4,17
FC Pune City,5052,7,4,4,6,13,16,-3,16
FC Goa,5052,8,4,3,7,12,17,-5,15
Mumbai City,5053,1,7,4,3,19,9,10,25
Kolkata,5053,2,5,7,2,22,13,9,22
Delhi Dynamo,5053,3,5,6,3,25,18,7,21
Kerala Blast,5053,4,5,4,5,11,19,-8,19
NorthEast Un,5053,5,4,4,6,10,11,-1,16
FC Pune City,5053,6,4,4,6,13,18,-5,16
Chennaiyin,5053,7,3,6,5,13,19,-6,15
FC Goa,5053,8,4,3,7,11,17,-6,15
Kerala Blast,5054,1,7,3,4,14,14,0,24
Delhi Dynamo,5054,2,6,5,3,27,18,9,23
Mumbai City,5054,3,6,4,4,18,12,6,22
Kolkata,5054,4,4,7,3,17,16,1,19
Chennaiyin,5054,5,4,6,4,15,18,-3,18
NorthEast Un,5054,6,5,2,7,12,13,-1,17
FC Pune City,5054,7,4,3,7,12,17,-5,15
FC Goa,5054,8,3,4,7,10,17,-7,13
Mumbai City,5055,1,6,5,3,17,9,8,23
Delhi Dynamo,5055,2,5,6,3,26,17,9,21
Kerala Blast,5055,3,5,5,4,14,16,-2,20
NorthEast Un,5055,4,5,3,6,13,14,-1,18
FC Goa,5055,5,5,3,6,12,16,-4,18
Kolkata,5055,6,3,8,3,18,18,0,17
FC Pune City,5055,7,4,4,6,16,20,-4,16
Chennaiyin,5055,8,3,6,5,14,20,-6,15
Mumbai City,5056,1,6,5,3,16,8,8,23
Delhi Dynamo,5056,2,5,7,2,23,15,8,22
FC Pune City,5056,3,6,3,5,17,17,0,21
Kerala Blast,5056,4,5,4,5,13,16,-3,19
FC Goa,5056,5,5,3,6,15,16,-1,18
Chennaiyin,5056,6,4,5,5,16,20,-4,17
Kolkata,5056,7,3,6,5,17,21,-4,15
NorthEast Un,5056,8,4,3,7,9,13,-4,15
Mumbai City,5057,1,7,4,3,18,8,10,25
Kolkata,5057,2,5,7,2,17,14,3,22
Kerala Blast,5057,3,5,4,5,11,15,-4,19
Chennaiyin,5057,4,4,6,4,15,18,-3,18
NorthEast Un,5057,5,5,2,7,17,14,3,17
Delhi Dynamo,5057,6,4,5,5,23,24,-1,17
FC Pune City,5057,7,4,5,5,13,15,-2,17
FC Goa,5057,8,4,3,7,9,15,-6,15
Delhi Dynamo,5058,1,6,5,3,25,17,8,23
Mumbai City,5058,2,6,4,4,16,10,6,22
NorthEast Un,5058,3,6,3,5,14,11,3,21
Kerala Blast,5058,4,5,4,5,12,14,-2,19
FC Pune City,5058,5,5,3,6,14,18,-4,18
Kolkata,5058,6,3,8,3,15,15,0,17
Chennaiyin,5058,7,3,7,4,16,20,-4,16
FC Goa,5058,8,3,4,7,11,18,-7,13
Mumbai City,5059,1,6,5,3,17,9,8,23
Delhi Dynamo,5059,2,5,6,3,24,18,6,21
Kolkata,5059,3,5,6,3,18,14,4,21
FC Pune City,5059,4,5,4,5,13,14,-1,19
Chennaiyin,5059,5,4,6,4,15,18,-3,18
NorthEast Un,5059,6,5,2,7,11,13,-2,17
Kerala Blast,5059,7,4,4,6,11,17,-6,16
FC Goa,5059,8,4,3,7,12,18,-6,15
Mumbai City,5060,1,7,4,3,18,9,9,25
Kolkata,5060,2,5,6,3,19,16,3,21
Delhi Dynamo,5060,3,5,5,4,26,20,6,20
NorthEast Un,5060,4,6,2,6,14,14,0,20
FC Pune City,5060,5,5,3,6,15,16,-1,18
Chennaiyin,5060,6,4,6,4,16,18,-2,18
Kerala Blast,5060,7,5,3,6,12,16,-4,18
FC Goa,5060,8,3,3,8,9,20,-11,12
Delhi Dynamo,5061,1,5,7,2,24,16,8,22
Mumbai City,5061,2,6,4,4,17,10,7,22
Kolkata,5061,3,4,8,2,18,16,2,20
FC Pune City,5061,4,5,3,6,16,17,-1,18
Chennaiyin,5061,5,4,6,4,16,19,-3,18
NorthEast Un,5061,6,4,5,5,12,12,0,17
Kerala Blast,5061,7,4,5,5,10,16,-6,17
FC Goa,5061,8,3,4,7,9,16,-7,13
Mumbai City,5062,1,7,4,3,17,8,9,25
Delhi Dynamo,5062,2,5,6,3,24,17,7,21
Kolkata,5062,3,5,6,3,19,14,5,21
Chennaiyin,5062,4,4,6,4,15,18,-3,18
FC Pune City,5062,5,5,3,6,16,20,-4,18
NorthEast Un,5062,6,4,4,6,11,12,-1,16
Kerala Blast,5062,7,4,4,6,12,19,-7,16
FC Goa,5062,8,4,3,7,11,17,-6,15
Mumbai City,5063,1,7,4,3,19,10,9,25
Delhi Dynamo,5063,2,5,5,4,26,19,7,20
Chennaiyin,5063,3,5,5,4,18,19,-1,20
Kolkata,5063,4,4,7,3,14,13,1,19
Kerala Blast,5063,5,5,4,5,10,14,-4,19
FC Goa,5063,6,5,2,7,11,16,-5,17
FC Pune City,5063,7,4,4,6,12,15,-3,16
NorthEast Un,5063,8,4,3,7,11,15,-4,15
Kolkata,5064,1,6,6,2,20,13,7,24
Delhi Dynamo,5064,2,6,5,3,26,17,9,23
Mumbai City,5064,3,6,4,4,17,11,6,22
Kerala Blast,5064,4,6,3,5,13,17,-4,21
Chennaiyin,5064,5,4,6,4,15,18,-3,18
NorthEast Un,5064,6,5,2,7,10,11,-1,17
FC Pune City,5064,7,4,3,7,12,18,-6,15
FC Goa,5064,8,3,3,8,10,18,-8,12
Mumbai City,5065,1,7,4,3,18,8,10,25
Kolkata,5065,2,6,6,2,18,12,6,24
Delhi Dynamo,5065,3,5,5,4,25,19,6,20
NorthEast Un,5065,4,6,2,6,12,12,0,20
FC Pune City,5065,5,5,3,6,14,18,-4,18
FC Goa,5065,6,5,2,7,12,17,-5,17
Kerala Blast,5065,7,4,3,7,10,17,-7,15
Chennaiyin,5065,8,3,5,6,14,20,-6,14
Mumbai City,5066,1,6,5,3,16,8,8,23
Delhi Dynamo,5066,2,5,7,2,24,16,8,22
Kolkata,5066,3,5,6,3,18,15,3,21
Kerala Blast,5066,4,5,4,5,16,16,0,19
FC Pune City,5066,5,5,4,5,15,16,-1,19
Chennaiyin,5066,6,3,7,4,14,18,-4,16
NorthEast Un,5066,7,4,4,6,11,16,-5,16
FC Goa,5066,8,3,3,8,9,18,-9,12
Mumbai City,5067,1,7,4,3,17,8,9,25
Kerala Blast,5067,2,6,4,4,15,16,-1,22
Delhi Dynamo,5067,3,5,5,4,23,19,4,20
FC Pune City,5067,4,5,4,5,15,15,0,19
FC Goa,5067,5,5,3,6,13,15,-2,18
Chennaiyin,5067,6,4,6,4,15,18,-3,18
Kolkata,5067,7,3,6,5,13,16,-3,15
NorthEast Un,5067,8,4,2,8,12,16,-4,14
Mumbai City,5068,1,6,5,3,17,9,8,23
NorthEast Un,5068,2,7,2,5,14,11,3,23
Delhi Dynamo,5068,3,4,7,3,23,17,6,19
Kerala Blast,5068,4,5,4,5,10,14,-4,19
Kolkata,5068,5,4,6,4,14,16,-2,18
Chennaiyin,5068,6,4,5,5,16,20,-4,17
FC Pune City,5068,7,4,4,6,12,15,-3,16
FC Goa,5068,8,4,3,7,12,16,-4,15
Delhi Dynamo,5069,1,7,5,2,25,14,11,26
Kerala Blast,5069,2,7,3,4,14,13,1,24
Mumbai City,5069,3,6,4,4,16,9,7,22
FC Pune City,5069,4,5,3,6,14,18,-4,18
Kolkata,5069,5,3,7,4,14,15,-1,16
Chennaiyin,5069,6,3,7,4,14,18,-4,16
NorthEast Un,5069,7,4,3,7,9,11,-2,15
FC Goa,5069,8,3,4,7,9,17,-8,13
Mumbai City,5070,1,6,4,4,17,10,7,22
Kolkata,5070,2,5,7,2,18,14,4,22
Delhi Dynamo,5070,3,5,6,3,25,18,7,21
NorthEast Un,5070,4,6,3,5,12,10,2,21
FC Pune City,5070,5,5,3,6,16,18,-2,18
FC Goa,5070,6,4,4,6,11,16,-5,16
Kerala Blast,5070,7,4,4,6,10,17,-7,16
Chennaiyin,5070,8,3,5,6,13,19,-6,14
Mumbai City,5071,1,7,4,3,17,8,9,25
FC Pune City,5071,2,6,3,5,17,15,2,21
NorthEast Un,5071,3,5,4,5,13,10,3,19
Kerala Blast,5071,4,5,4,5,14,19,-5,19
FC Goa,5071,5,5,3,6,14,15,-1,18
Delhi Dynamo,5071,6,4,5,5,22,22,0,17
Kolkata,5071,7,3,7,4,15,17,-2,16
Chennaiyin,5071,8,3,6,5,13,19,-6,15
Delhi Dynamo,5072,1,6,5,3,26,16,10,23
Mumbai City,5072,2,6,4,4,16,11,5,22
Chennaiyin,5072,3,5,5,4,17,17,0,20
Kerala Blast,5072,4,5,5,4,10,13,-3,20
Kolkata,5072,5,3,8,3,14,14,0,17
NorthEast Un,5072,6,5,2,7,11,12,-1,17
FC Pune City,5072,7,4,5,5,13,15,-2,17
FC Goa,5072,8,4,2,8,9,18,-9,14
Delhi Dynamo,5073,1,7,5,2,28,15,13,26
Mumbai City,5073,2,6,4,4,16,9,7,22
Kolkata,5073,3,5,6,3,18,15,3,21
FC Pune City,5073,4,6,3,5,16,14,2,21
Chennaiyin,5073,5,5,5,4,16,17,-1,20
Kerala Blast,5073,6,4,4,6,10,18,-8,16
NorthEast Un,5073,7,4,3,7,11,13,-2,15
FC Goa,5073,8,3,2,9,9,23,-14,11
Delhi Dynamo,5074,1,6,6,2,29,15,14,24
Mumbai City,5074,2,6,5,3,17,9,8,23
Kerala Blast,5074,3,5,5,4,12,15,-3,20
Chennaiyin,5074,4,4,6,4,17,18,-1,18
Kolkata,5074,5,3,8,3,14,15,-1,17
FC Pune City,5074,6,4,5,5,13,15,-2,17
FC Goa,5074,7,4,3,7,11,19,-8,15
NorthEast Un,5074,8,4,2,8,9,16,-7,14
Mumbai City,5075,1,7,4,3,17,8,9,25
Delhi Dynamo,5075,2,5,6,3,25,17,8,21
Kerala Blast,5075,3,6,3,5,12,17,-5,21
Chennaiyin,5075,4,5,5,4,17,18,-1,20
Kolkata,5075,5,4,6,4,18,15,3,18
FC Pune City,5075,6,5,3,6,14,17,-3,18
FC Goa,5075,7,4,3,7,12,19,-7,15
NorthEast Un,5075,8,4,2,8,9,13,-4,14
Mumbai City,5076,1,7,4,3,19,8,11,25
FC Pune City,5076,2,6,3,5,18,15,3,21
Kolkata,5076,3,5,6,3,15,16,-1,21
NorthEast Un,5076,4,6,2,6,14,13,1,20
Kerala Blast,5076,5,5,3,6,13,17,-4,18
Delhi Dynamo,5076,6,4,5,5,22,21,1,17
FC Goa,5076,7,5,2,7,11,15,-4,17
Chennaiyin,5076,8,3,5,6,13,20,-7,14
Mumbai City,5077,1,7,4,3,21,9,12,25
Kerala Blast,5077,2,6,3,5,15,16,-1,21
Chennaiyin,5077,3,5,5,4,17,19,-2,20
Kolkata,5077,4,4,7,3,15,14,1,19
FC Pune City,5077,5,5,3,6,14,17,-3,18
Delhi Dynamo,5077,6,4,5,5,23,23,0,17
NorthEast Un,5077,7,5,2,7,12,14,-2,17
FC Goa,5077,8,4,3,7,13,18,-5,15
Mumbai City,5078,1,7,4,3,19,10,9,25
Delhi Dynamo,5078,2,6,5,3,28,19,9,23
Kerala Blast,5078,3,6,3,5,15,17,-2,21
Kolkata,5078,4,4,7,3,18,17,1,19
Chennaiyin,5078,5,4,6,4,14,17,-3,18
FC Pune City,5078,6,4,4,6,13,17,-4,16
FC Goa,5078,7,4,3,7,14,19,-5,15
NorthEast Un,5078,8,4,2,8,9,14,-5,14
Kolkata,5079,1,6,6,2,22,17,5,24
Delhi Dynamo,5079,2,6,5,3,26,20,6,23
Mumbai City,5079,3,6,4,4,18,11,7,22
NorthEast Un,5079,4,6,2,6,15,11,4,20
Kerala Blast,5079,5,5,4,5,13,17,-4,19
Chennaiyin,5079,6,4,5,5,15,20,-5,17
FC Pune City,5079,7,4,4,6,15,18,-3,16
FC Goa,5079,8,3,2,9,10,20,-10,11
Mumbai City,5080,1,7,4,3,17,8,9,25
Delhi Dynamo,5080,2,5,6,3,25,16,9,21
Kolkata,5080,3,4,8,2,18,14,4,20
NorthEast Un,5080,4,5,4,5,12,10,2,19
Kerala Blast,5080,5,4,6,4,13,17,-4,18
FC Pune City,5080,6,4,5,5,13,15,-2,17
Chennaiyin,5080,7,3,6,5,13,19,-6,15
FC Goa,5080,8,3,3,8,9,21,-12,12
Mumbai City,5081,1,7,4,3,18,9,9,25
Kerala Blast,5081,2,6,4,4,13,15,-2,22
Chennaiyin,5081,3,5,5,4,16,17,-1,20
Kolkata,5081,4,4,7,3,16,15,1,19
Delhi Dynamo,5081,5,4,6,4,23,18,5,18
FC Pune City,5081,6,4,5,5,14,16,-2,17
NorthEast Un,5081,7,5,2,7,12,14,-2,17
FC Goa,5081,8,3,3,8,9,17,-8,12
Delhi Dynamo,5082,1,7,5,2,27,16,11,26
Mumbai City,5082,2,6,4,4,16,9,7,22
Kolkata,5082,3,5,7,2,20,15,5,22
NorthEast Un,5082,4,6,2,6,18,14,4,20
FC Pune City,5082,5,4,4,6,14,17,-3,16
Kerala Blast,5082,6,4,4,6,12,23,-11,16
FC Goa,5082,7,4,3,7,10,17,-7,15
Chennaiyin,5082,8,3,5,6,14,20,-6,14
Mumbai City,5083,1,7,4,3,17,8,9,25
Kerala Blast,5083,2,6,4,4,13,14,-1,22
Delhi Dynamo,5083,3,5,5,4,26,19,7,20
FC Pune City,5083,4,5,3,6,13,16,-3,18
NorthEast Un,5083,5,5,2,7,13,14,-1,17
Chennaiyin,5083,6,4,5,5,15,19,-4,17
FC Goa,5083,7,5,2,7,11,17,-6,17
Kolkata,5083,8,3,7,4,14,15,-1,16
Delhi Dynamo,5084,1,7,5,2,30,16,14,26
Mumbai City,5084,2,6,4,4,17,11,6,22
Kolkata,5084,3,5,6,3,17,16,1,21
Kerala Blast,5084,4,5,4,5,12,17,-5,19
FC Pune City,5084,5,5,3,6,16,16,0,18
Chennaiyin,5084,6,4,5,5,17,19,-2,17
NorthEast Un,5084,7,4,3,7,12,17,-5,15
FC Goa,5084,8,4,2,8,10,19,-9,14
Mumbai City,5085,1,7,4,3,18,8,10,25
Kerala Blast,5085,2,6,4,4,16,15,1,22
Delhi Dynamo,5085,3,5,5,4,24,18,6,20
Kolkata,5085,4,4,8,2,16,14,2,20
NorthEast Un,5085,5,6,2,6,13,11,2,20
FC Pune City,5085,6,4,4,6,12,18,-6,16
Chennaiyin,5085,7,3,5,6,14,20,-6,14
FC Goa,5085,8,4,2,8,11,20,-9,14
Mumbai City,5086,1,6,5,3,16,8,8,23
Kolkata,5086,2,5,7,2,22,13,9,22
Delhi Dynamo,5086,3,4,7,3,24,18,6,19
Kerala Blast,5086,4,5,4,5,15,21,-6,19
NorthEast Un,5086,5,5,3,6,14,16,-2,18
FC Pune City,5086,6,4,4,6,14,19,-5,16
FC Goa,5086,7,4,4,6,12,17,-5,16
Chennaiyin,5086,8,3,6,5,15,20,-5,15
Mumbai City,5087,1,7,4,3,19,8,11,25
Kerala Blast,5087,2,6,4,4,16,15,1,22
NorthEast Un,5087,3,6,3,5,17,13,4,21
Delhi Dynamo,5087,4,5,5,4,23,21,2,20
Kolkata,5087,5,4,7,3,16,14,2,19
Chennaiyin,5087,6,4,5,5,16,19,-3,17
FC Pune City,5087,7,4,3,7,12,20,-8,15
FC Goa,5087,8,3,3,8,9,18,-9,12
Mumbai City,5088,1,7,4,3,17,8,9,25
Kolkata,5088,2,5,7,2,17,13,4,22
NorthEast Un,5088,3,6,2,6,11,10,1,20
Kerala Blast,5088,4,5,4,5,10,17,-7,19
Delhi Dynamo,5088,5,4,6,4,23,18,5,18
FC Pune City,5088,6,5,3,6,16,16,0,18
FC Goa,5088,7,4,3,7,12,18,-6,15
Chennaiyin,5088,8,3,5,6,13,19,-6,14
Mumbai City,5089,1,7,4,3,18,8,10,25
Kerala Blast,5089,2,6,4,4,15,15,0,22
Kolkata,5089,3,4,7,3,16,16,0,19
Delhi Dynamo,5089,4,4,6,4,21,19,2,18
NorthEast Un,5089,5,5,3,6,14,13,1,18
FC Pune City,5089,6,4,4,6,13,16,-3,16
FC Goa,5089,7,4,4,6,10,14,-4,16
Chennaiyin,5089,8,3,6,5,14,20,-6,15
Mumbai City,5090,1,7,4,3,19,8,11,25
Kolkata,5090,2,5,7,2,18,13,5,22
Delhi Dynamo,5090,3,5,6,3,24,18,6,21
Chennaiyin,5090,4,5,5,4,16,18,-2,20
FC Pune City,5090,5,5,3,6,15,17,-2,18
Kerala Blast,5090,6,4,5,5,11,17,-6,17
NorthEast Un,5090,7,4,4,6,11,12,-1,16
FC Goa,5090,8,3,2,9,8,19,-11,11
Mumbai City,5091,1,6,4,4,17,11,6,22
Delhi Dynamo,5091,2,5,5,4,24,19,5,20
FC Goa,5091,3,6,2,6,12,14,-2,20
Kerala Blast,5091,4,5,5,4,11,14,-3,20
NorthEast Un,5091,5,5,3,6,13,11,2,18
FC Pune City,5091,6,5,3,6,14,16,-2,18
Chennaiyin,5091,7,4,5,5,14,18,-4,17
Kolkata,5091,8,3,7,4,14,16,-2,16
Mumbai City,5092,1,7,4,3,20,9,11,25
NorthEast Un,5092,2,7,2,5,16,9,7,23
Kerala Blast,5092,3,6,3,5,12,15,-3,21
Delhi Dynamo,5092,4,4,6,4,24,22,2,18
FC Goa,5092,5,5,3,6,13,16,-3,18
Kolkata,5092,6,3,7,4,13,14,-1,16
FC Pune City,5092,7,4,4,6,12,16,-4,16
Chennaiyin,5092,8,3,5,6,13,22,-9,14
Delhi Dynamo,5093,1,5,7,2,25,17,8,22
Mumbai City,5093,2,6,4,4,17,10,7,22
NorthEast Un,5093,3,6,3,5,14,12,2,21
Kerala Blast,5093,4,6,3,5,16,16,0,21
Kolkata,5093,5,4,7,3,17,15,2,19
Chennaiyin,5093,6,4,5,5,17,20,-3,17
FC Pune City,5093,7,4,3,7,13,21,-8,15
FC Goa,5093,8,3,4,7,11,19,-8,13
Kolkata,5094,1,6,6,2,19,14,5,24
Mumbai City,5094,2,6,4,4,18,11,7,22
Delhi Dynamo,5094,3,5,5,4,26,20,6,20
Kerala Blast,5094,4,5,4,5,11,15,-4,19
NorthEast Un,5094,5,5,3,6,11,13,-2,18
Chennaiyin,5094,6,4,5,5,16,19,-3,17
FC Goa,5094,7,5,2,7,13,17,-4,17
FC Pune City,5094,8,4,3,7,12,17,-5,15
Mumbai City,5095,1,6,5,3,16,8,8,23
Kerala Blast,5095,2,6,4,4,12,13,-1,22
FC Goa,5095,3,6,2,6,13,15,-2,20
Delhi Dynamo,5095,4,4,7,3,23,17,6,19
Kolkata,5095,5,4,6,4,15,16,-1,18
Chennaiyin,5095,6,4,5,5,15,19,-4,17
NorthEast Un,5095,7,4,4,6,11,12,-1,16
FC Pune City,5095,8,4,3,7,12,17,-5,15
Delhi Dynamo,5096,1,7,5,2,26,16,10,26
Mumbai City,5096,2,6,4,4,16,9,7,22
Chennaiyin,5096,3,5,5,4,17,18,-1,20
FC Pune City,5096,4,5,4,5,15,16,-1,19
Kolkata,5096,5,4,6,4,18,17,1,18
Kerala Blast,5096,6,4,5,5,11,18,-7,17
NorthEast Un,5096,7,4,3,7,12,14,-2,15
FC Goa,5096,8,4,2,8,12,19,-7,14
Mumbai City,5097,1,7,4,3,19,9,10,25
Delhi Dynamo,5097,2,5,6,3,24,18,6,21
Kolkata,5097,3,4,8,2,16,14,2,20
FC Pune City,5097,4,5,4,5,13,14,-1,19
Chennaiyin,5097,5,4,6,4,14,17,-3,18
Kerala Blast,5097,6,5,3,6,13,18,-5,18
NorthEast Un,5097,7,4,4,6,11,12,-1,16
FC Goa,5097,8,3,3,8,10,18,-8,12
Mumbai City,5098,1,7,4,3,18,8,10,25
Kerala Blast,5098,2,6,3,5,12,14,-2,21
Kolkata,5098,3,4,7,3,16,17,-1,19
Delhi Dynamo,5098,4,4,6,4,22,20,2,18
Chennaiyin,5098,5,4,6,4,16,17,-1,18
FC Pune City,5098,5,5,3,6,16,17,-1,18
NorthEast Un,5098,7,5,2,7,12,13,-1,17
FC Goa,5098,8,3,5,6,10,16,-6,14
Mumbai City,5099,1,6,4,4,17,10,7,22
Delhi Dynamo,5099,2,5,6,3,24,17,7,21
Kolkata,5099,3,5,6,3,20,15,5,21
NorthEast Un,5099,4,6,2,6,13,10,3,20
Chennaiyin,5099,5,4,6,4,15,18,-3,18
FC Pune City,5099,6,5,3,6,14,17,-3,18
FC Goa,5099,7,4,4,6,12,17,-5,16
Kerala Blast,5099,8,4,3,7,11,22,-11,15
Kolkata,5100,1,6,6,2,19,13,6,24
Mumbai City,5100,2,6,5,3,19,11,8,23
Delhi Dynamo,5100,3,5,7,2,28,20,8,22
Kerala Blast,5100,4,6,3,5,14,15,-1,21
NorthEast Un,5100,5,4,3,7,15,17,-2,15
FC Goa,5100,6,4,3,7,12,17,-5,15
Chennaiyin,5100,7,3,6,5,15,22,-7,15
FC Pune City,5100,8,4,3,7,12,19,-7,15
Mumbai City,5101,1,7,4,3,17,8,9,25
Delhi Dynamo,5101,2,6,5,3,26,16,10,23
Kolkata,5101,3,4,7,3,15,13,2,19
Kerala Blast,5101,4,5,4,5,10,14,-4,19
NorthEast Un,5101,5,5,2,7,10,12,-2,17
Chennaiyin,5101,6,4,5,5,15,19,-4,17
FC Goa,5101,7,5,2,7,12,18,-6,17
FC Pune City,5101,8,4,3,7,12,17,-5,15
Delhi Dynamo,5102,1,6,6,2,25,14,11,24
Mumbai City,5102,2,6,5,3,16,8,8,23
Kolkata,5102,3,4,6,4,14,14,0,18
NorthEast Un,5102,4,5,3,6,11,11,0,18
FC Pune City,5102,5,5,3,6,13,15,-2,18
Kerala Blast,5102,6,5,3,6,10,15,-5,18
FC Goa,5102,7,5,2,7,11,17,-6,17
Chennaiyin,5102,8,3,6,5,14,20,-6,15
Mumbai City,5103,1,7,4,3,19,10,9,25
FC Pune City,5103,2,6,3,5,16,16,0,21
Delhi Dynamo,5103,3,5,5,4,27,19,8,20
Chennaiyin,5103,4,5,5,4,16,18,-2,20
Kolkata,5103,5,4,7,3,16,15,1,19
Kerala Blast,5103,6,5,3,6,12,16,-4,18
FC Goa,5103,7,4,3,7,11,17,-6,15
NorthEast Un,5103,8,4,2,8,10,16,-6,14
Delhi Dynamo,5104,1,6,5,3,24,17,7,23
Mumbai City,5104,2,6,4,4,16,9,7,22
Kolkata,5104,3,5,7,2,22,17,5,22
Kerala Blast,5104,4,5,4,5,11,17,-6,19
FC Goa,5104,5,5,3,6,18,20,-2,18
FC Pune City,5104,6,4,4,6,12,15,-3,16
NorthEast Un,5104,7,4,3,7,11,13,-2,15
Chennaiyin,5104,8,3,6,5,16,22,-6,15
Mumbai City,5105,1,7,4,3,17,8,9,25
Delhi Dynamo,5105,2,5,5,4,26,19,7,20
Kolkata,5105,3,4,8,2,17,14,3,20
NorthEast Un,5105,4,5,4,5,12,11,1,19
Chennaiyin,5105,5,4,6,4,15,17,-2,18
FC Pune City,5105,6,4,5,5,13,15,-2,17
Kerala Blast,5105,7,4,5,5,10,16,-6,17
FC Goa,5105,8,3,3,8,11,21,-10,12
Kerala Blast,5106,1,7,3,4,15,13,2,24
Mumbai City,5106,2,6,5,3,16,8,8,23
Kolkata,5106,3,5,6,3,17,15,2,21
Chennaiyin,5106,4,5,5,4,17,19,-2,20
Delhi Dynamo,5106,5,4,7,3,24,18,6,19
NorthEast Un,5106,6,5,2,7,12,14,-2,17
FC Pune City,5106,7,4,3,7,12,17,-5,15
FC Goa,5106,8,3,3,8,12,21,-9,12
Mumbai City,5107,1,6,5,3,16,8,8,23
Delhi Dynamo,5107,2,5,6,3,25,19,6,21
Chennaiyin,5107,3,5,5,4,19,17,2,20
Kerala Blast,5107,4,5,5,4,14,15,-1,20
FC Pune City,5107,5,5,4,5,16,16,0,19
NorthEast Un,5107,6,5,3,6,12,13,-1,18
Kolkata,5107,7,3,6,5,14,21,-7,15
FC Goa,5107,8,4,2,8,14,21,-7,14
Mumbai City,5108,1,7,4,3,23,8,15,25
Kerala Blast,5108,2,7,3,4,16,15,1,24
Delhi Dynamo,5108,3,5,5,4,23,23,0,20
Kolkata,5108,4,4,7,3,18,17,1,19
Chennaiyin,5108,5,4,6,4,17,18,-1,18
FC Goa,5108,6,4,4,6,10,15,-5,16
FC Pune City,5108,7,4,3,7,14,20,-6,15
NorthEast Un,5108,8,4,2,8,10,15,-5,14
Delhi Dynamo,5109,1,6,6,2,24,15,9,24
Mumbai City,5109,2,6,5,3,16,8,8,23
Kerala Blast,5109,3,6,3,5,12,15,-3,21
Kolkata,5109,4,4,6,4,15,15,0,18
FC Pune City,5109,5,5,3,6,15,17,-2,18
Chennaiyin,5109,6,3,7,4,14,18,-4,16
NorthEast Un,5109,7,4,3,7,9,11,-2,15
FC Goa,5109,8,4,3,7,11,17,-6,15
Mumbai City,5110,1,6,4,4,17,11,6,22
Delhi Dynamo,5110,2,5,6,3,26,19,7,21
Kerala Blast,5110,3,5,5,4,16,17,-1,20
FC Goa,5110,4,6,2,6,15,16,-1,20
NorthEast Un,5110,5,5,4,5,13,12,1,19
Kolkata,5110,6,4,7,3,20,20,0,19
FC Pune City,5110,7,4,3,7,14,20,-6,15
Chennaiyin,5110,8,3,5,6,14,20,-6,14
Mumbai City,5111,1,7,4,3,19,9,10,25
Kolkata,5111,2,6,6,2,17,13,4,24
Delhi Dynamo,5111,3,6,5,3,27,18,9,23
Chennaiyin,5111,4,5,5,4,18,18,0,20
FC Pune City,5111,5,5,3,6,15,16,-1,18
NorthEast Un,5111,6,5,2,7,11,13,-2,17
Kerala Blast,5111,7,4,3,7,11,20,-9,15
FC Goa,5111,8,3,2,9,10,21,-11,11
Mumbai City,5112,1,7,4,3,20,9,11,25
NorthEast Un,5112,2,7,2,5,15,9,6,23
Delhi Dynamo,5112,3,5,5,4,23,20,3,20
FC Pune City,5112,4,5,3,6,15,17,-2,18
Kolkata,5112,5,4,6,4,16,19,-3,18
Kerala Blast,5112,6,5,3,6,13,17,-4,18
FC Goa,5112,7,5,2,7,12,15,-3,17
Chennaiyin,5112,8,3,5,6,13,21,-8,14
Delhi Dynamo,5113,1,5,7,2,24,16,8,22
Mumbai City,5113,2,6,4,4,16,9,7,22
FC Pune City,5113,3,6,3,5,16,15,1,21
Kolkata,5113,4,4,7,3,16,15,1,19
NorthEast Un,5113,5,5,3,6,10,10,0,18
Chennaiyin,5113,6,4,5,5,14,18,-4,17
FC Goa,5113,7,4,4,6,12,17,-5,16
Kerala Blast,5113,8,4,3,7,11,19,-8,15
Mumbai City,5114,1,6,5,3,18,10,8,23
Delhi Dynamo,5114,2,5,7,2,25,17,8,22
Kolkata,5114,3,5,6,3,17,14,3,21
NorthEast Un,5114,4,5,4,5,13,12,1,19
FC Pune City,5114,5,5,3,6,15,16,-1,18
Kerala Blast,5114,6,5,3,6,12,19,-7,18
Chennaiyin,5114,7,3,7,4,16,20,-4,16
FC Goa,5114,8,3,3,8,10,18,-8,12
Mumbai City,5115,1,6,4,4,16,9,7,22
Delhi Dynamo,5115,2,5,6,3,27,21,6,21
FC Pune City,5115,3,6,3,5,15,14,1,21
Kolkata,5115,4,4,7,3,14,13,1,19
NorthEast Un,5115,5,4,5,5,13,13,0,17
FC Goa,5115,6,5,2,7,15,18,-3,17
Kerala Blast,5115,7,4,5,5,10,16,-6,17
Chennaiyin,5115,8,3,6,5,14,20,-6,15
Mumbai City,5116,1,6,5,3,17,9,8,23
Delhi Dynamo,5116,2,5,6,3,24,16,8,21
FC Pune City,5116,3,6,3,5,17,15,2,21
NorthEast Un,5116,4,5,3,6,10,11,-1,18
Chennaiyin,5116,5,4,6,4,16,18,-2,18
Kerala Blast,5116,6,4,5,5,12,17,-5,17
Kolkata,5116,7,3,7,4,16,20,-4,16
FC Goa,5116,8,4,3,7,12,18,-6,15
Mumbai City,5117,1,6,5,3,17,9,8,23
Delhi Dynamo,5117,2,5,7,2,25,17,8,22
NorthEast Un,5117,3,6,3,5,15,10,5,21
Kolkata,5117,4,5,6,3,17,13,4,21
FC Pune City,5117,5,5,3,6,15,17,-2,18
Chennaiyin,5117,6,4,5,5,16,19,-3,17
Kerala Blast,5117,7,4,3,7,10,21,-11,15
FC Goa,5117,8,4,2,8,10,19,-9,14
Mumbai City,5118,1,7,4,3,18,8,10,25
Kolkata,5118,2,5,7,2,18,15,3,22
Delhi Dynamo,5118,3,5,5,4,24,19,5,20
Kerala Blast,5118,4,5,5,4,11,14,-3,20
NorthEast Un,5118,5,5,2,7,15,13,2,17
Chennaiyin,5118,6,4,5,5,15,22,-7,17
FC Pune City,5118,7,4,4,6,13,16,-3,16
FC Goa,5118,8,4,2,8,11,18,-7,14
Delhi Dynamo,5119,1,6,5,3,26,18,8,23
Mumbai City,5119,2,6,4,4,17,10,7,22
Kerala Blast,5119,3,6,4,4,14,15,-1,22
FC Pune City,5119,4,5,3,6,13,16,-3,18
Kolkata,5119,5,3,8,3,15,15,0,17
NorthEast Un,5119,6,5,2,7,13,14,-1,17
Chennaiyin,5119,7,4,5,5,15,19,-4,17
FC Goa,5119,8,4,3,7,11,17,-6,15
Delhi Dynamo,5120,1,6,6,2,24,15,9,24
Kolkata,5120,2,5,7,2,21,14,7,22
Mumbai City,5120,3,6,4,4,16,9,7,22
Kerala Blast,5120,4,6,3,5,12,18,-6,21
NorthEast Un,5120,5,4,4,6,10,12,-2,16
Chennaiyin,5120,6,3,7,4,14,18,-4,16
FC Pune City,5120,7,4,3,7,13,17,-4,15
FC Goa,5120,8,3,4,7,10,17,-7,13
Delhi Dynamo,5121,1,6,5,3,24,16,8,23
NorthEast Un,5121,2,7,2,5,15,10,5,23
Mumbai City,5121,3,6,4,4,16,10,6,22
FC Pune City,5121,4,5,4,5,15,16,-1,19
Kolkata,5121,5,4,6,4,19,16,3,18
FC Goa,5121,6,5,2,7,11,15,-4,17
Kerala Blast,5121,7,4,4,6,13,23,-10,16
Chennaiyin,5121,8,3,5,6,13,20,-7,14
Mumbai City,5122,1,7,4,3,17,8,9,25
Delhi Dynamo,5122,2,5,6,3,24,17,7,21
Kolkata,5122,3,4,7,3,20,19,1,19
NorthEast Un,5122,4,5,3,6,12,12,0,18
Kerala Blast,5122,5,5,3,6,13,18,-5,18
Chennaiyin,5122,6,4,5,5,16,20,-4,17
FC Goa,5122,7,5,2,7,14,18,-4,17
FC Pune City,5122,8,4,4,6,14,18,-4,16
Mumbai City,5123,1,7,4,3,18,9,9,25
Delhi Dynamo,5123,2,6,5,3,26,17,9,23
Kolkata,5123,3,5,6,3,18,13,5,21
Kerala Blast,5123,4,5,5,4,11,14,-3,20
NorthEast Un,5123,5,4,4,6,12,13,-1,16
FC Pune City,5123,6,4,4,6,13,18,-5,16
Chennaiyin,5123,7,3,6,5,15,20,-5,15
FC Goa,5123,8,4,2,8,9,18,-9,14
Mumbai City,5124,1,7,4,3,17,8,9,25
Kerala Blast,5124,2,6,4,4,13,15,-2,22
Kolkata,5124,3,4,7,3,18,15,3,19
NorthEast Un,5124,4,5,3,6,13,13,0,18
Chennaiyin,5124,5,4,6,4,17,18,-1,18
Delhi Dynamo,5124,6,4,5,5,22,18,4,17
FC Pune City,5124,7,4,5,5,13,15,-2,17
FC Goa,5124,8,4,2,8,9,20,-11,14
Mumbai City,5125,1,6,4,4,16,10,6,22
NorthEast Un,5125,2,6,3,5,12,10,2,21
Delhi Dynamo,5125,3,5,5,4,23,16,7,20
Kolkata,5125,4,4,7,3,16,15,1,19
FC Pune City,5125,5,5,3,6,14,16,-2,18
Kerala Blast,5125,6,5,3,6,10,15,-5,18
Chennaiyin,5125,7,3,7,4,14,18,-4,16
FC Goa,5125,8,4,4,6,10,15,-5,16
Mumbai City,5126,1,7,4,3,18,8,10,25
Delhi Dynamo,5126,2,5,6,3,27,17,10,21
Kolkata,5126,3,5,6,3,17,15,2,21
Kerala Blast,5126,4,6,3,5,12,16,-4,21
NorthEast Un,5126,5,5,4,5,12,10,2,19
Chennaiyin,5126,6,3,7,4,13,17,-4,16
FC Pune City,5126,7,4,3,7,12,16,-4,15
FC Goa,5126,8,3,3,8,9,21,-12,12
Mumbai City,5127,1,7,4,3,19,9,10,25
Kolkata,5127,2,6,6,2,22,13,9,24
NorthEast Un,5127,3,5,3,6,13,11,2,18
Delhi Dynamo,5127,4,4,5,5,23,25,-2,17
FC Goa,5127,5,5,2,7,15,17,-2,17
Chennaiyin,5127,6,4,5,5,15,19,-4,17
Kerala Blast,5127,7,4,5,5,11,18,-7,17
FC Pune City,5127,8,4,4,6,14,20,-6,16
Mumbai City,5128,1,7,4,3,18,9,9,25
Kerala Blast,5128,2,7,3,4,14,14,0,24
Delhi Dynamo,5128,3,4,6,4,23,18,5,18
Kolkata,5128,4,4,6,4,14,15,-1,18
FC Pune City,5128,5,5,3,6,13,15,-2,18
NorthEast Un,5128,6,5,2,7,13,15,-2,17
Chennaiyin,5128,7,4,5,5,16,20,-4,17
FC Goa,5128,8,4,3,7,10,15,-5,15
Mumbai City,5129,1,7,4,3,18,8,10,25
FC Pune City,5129,2,6,3,5,15,15,0,21
NorthEast Un,5129,3,5,4,5,15,12,3,19
Kerala Blast,5129,4,5,4,5,14,18,-4,19
Kolkata,5129,5,4,6,4,18,15,3,18
Delhi Dynamo,5129,6,4,6,4,22,20,2,18
Chennaiyin,5129,7,3,6,5,13,20,-7,15
FC Goa,5129,8,4,3,7,11,18,-7,15
Kolkata,5130,1,6,6,2,19,13,6,24
Delhi Dynamo,5130,2,6,5,3,27,20,7,23
Mumbai City,5130,3,6,4,4,17,10,7,22
NorthEast Un,5130,4,5,4,5,14,10,4,19
FC Pune City,5130,5,5,3,6,14,15,-1,18
Chennaiyin,5130,6,3,7,4,14,18,-4,16
Kerala Blast,5130,7,4,4,6,11,19,-8,16
FC Goa,5130,8,3,3,8,10,21,-11,12
Mumbai City,5131,1,7,4,3,19,10,9,25
Kerala Blast,5131,2,6,3,5,13,14,-1,21
Chennaiyin,5131,3,5,5,4,20,18,2,20
NorthEast Un,5131,4,6,2,6,13,12,1,20
Kolkata,5131,5,4,7,3,15,16,-1,19
Delhi Dynamo,5131,6,4,5,5,23,20,3,17
FC Pune City,5131,7,4,4,6,13,16,-3,16
FC Goa,5131,8,4,2,8,9,19,-10,14
Mumbai City,5132,1,6,4,4,18,11,7,22
NorthEast Un,5132,2,6,3,5,16,10,6,21
Delhi Dynamo,5132,3,5,6,3,25,22,3,21
Kerala Blast,5132,4,6,3,5,13,15,-2,21
Kolkata,5132,5,4,6,4,16,16,0,18
Chennaiyin,5132,6,4,6,4,17,18,-1,18
FC Pune City,5132,7,4,3,7,13,18,-5,15
FC Goa,5132,8,4,3,7,10,18,-8,15
Delhi Dynamo,5133,1,6,6,2,25,16,9,24
Mumbai City,5133,2,6,4,4,16,9,7,22
NorthEast Un,5133,3,5,4,5,13,11,2,19
Kolkata,5133,4,4,7,3,17,16,1,19
FC Pune City,5133,5,5,4,5,14,15,-1,19
Chennaiyin,5133,6,4,6,4,14,17,-3,18
Kerala Blast,5133,7,4,4,6,12,19,-7,16
FC Goa,5133,8,3,3,8,9,17,-8,12
Mumbai City,5134,1,7,4,3,20,9,11,25
Kolkata,5134,2,5,7,2,17,13,4,22
NorthEast Un,5134,3,6,2,6,15,11,4,20
Delhi Dynamo,5134,4,4,6,4,24,23,1,18
Chennaiyin,5134,5,4,5,5,15,20,-5,17
Kerala Blast,5134,6,4,5,5,9,15,-6,17
FC Pune City,5134,7,4,4,6,12,15,-3,16
FC Goa,5134,8,4,3,7,13,19,-6,15
Mumbai City,5135,1,7,4,3,18,9,9,25
Kolkata,5135,2,4,8,2,19,15,4,20
FC Pune City,5135,3,5,4,5,14,15,-1,19
Delhi Dynamo,5135,4,4,6,4,24,21,3,18
NorthEast Un,5135,5,5,3,6,13,13,0,18
Kerala Blast,5135,6,5,3,6,10,17,-7,18
Chennaiyin,5135,7,4,5,5,17,19,-2,17
FC Goa,5135,8,4,3,7,13,19,-6,15
Delhi Dynamo,5136,1,5,7,2,26,17,9,22
Mumbai City,5136,2,6,4,4,16,10,6,22
FC Pune City,5136,3,5,4,5,15,16,-1,19
Kerala Blast,5136,4,5,4,5,11,15,-4,19
NorthEast Un,5136,5,5,3,6,11,11,0,18
FC Goa,5136,6,5,3,6,13,16,-3,18
Kolkata,5136,7,3,8,3,14,14,0,17
Chennaiyin,5136,8,3,5,6,13,20,-7,14
Delhi Dynamo,5137,1,6,5,3,26,18,8,23
Mumbai City,5137,2,6,4,4,16,10,6,22
FC Goa,5137,3,6,2,6,15,16,-1,20
Kolkata,5137,4,4,6,4,16,16,0,18
NorthEast Un,5137,5,5,3,6,13,14,-1,18
FC Pune City,5137,6,5,3,6,15,17,-2,18
Kerala Blast,5137,7,5,3,6,13,18,-5,18
Chennaiyin,5137,8,3,6,5,14,19,-5,15
Mumbai City,5138,1,7,4,3,17,8,9,25
Delhi Dynamo,5138,2,5,5,4,24,19,5,20
Kerala Blast,5138,3,5,5,4,12,15,-3,20
NorthEast Un,5138,4,5,4,5,14,10,4,19
Kolkata,5138,5,4,7,3,17,16,1,19
Chennaiyin,5138,6,4,6,4,15,18,-3,18
FC Pune City,5138,7,4,5,5,14,16,-2,17
FC Goa,5138,8,3,2,9,9,20,-11,11
Kolkata,5139,1,6,6,2,22,14,8,24
Mumbai City,5139,2,6,5,3,17,9,8,23
Delhi Dynamo,5139,3,5,7,2,26,18,8,22
NorthEast Un,5139,4,5,3,6,13,11,2,18
FC Pune City,5139,5,5,3,6,18,19,-1,18
Kerala Blast,5139,6,4,4,6,11,19,-8,16
Chennaiyin,5139,7,3,6,5,15,22,-7,15
FC Goa,5139,8,3,4,7,12,22,-10,13
Delhi Dynamo,5140,1,6,6,2,24,15,9,24
Mumbai City,5140,2,6,4,4,16,9,7,22
FC Pune City,5140,3,6,3,5,19,18,1,21
Kolkata,5140,4,4,7,3,18,18,0,19
Kerala Blast,5140,5,5,3,6,12,17,-5,18
Chennaiyin,5140,6,4,5,5,15,20,-5,17
FC Goa,5140,7,4,4,6,14,18,-4,16
NorthEast Un,5140,8,4,2,8,9,12,-3,14
Mumbai City,5141,1,7,4,3,19,8,11,25
Delhi Dynamo,5141,2,5,5,4,25,19,6,20
Kolkata,5141,3,4,7,3,15,14,1,19
FC Pune City,5141,4,5,4,5,13,14,-1,19
Kerala Blast,5141,5,5,4,5,11,15,-4,19
NorthEast Un,5141,6,5,3,6,12,12,0,18
Chennaiyin,5141,7,4,5,5,17,22,-5,17
FC Goa,5141,8,4,2,8,12,20,-8,14
Delhi Dynamo,5142,1,6,5,3,27,17,10,23
Mumbai City,5142,2,6,4,4,16,10,6,22
Kolkata,5142,3,5,7,2,18,15,3,22
NorthEast Un,5142,4,6,2,6,13,11,2,20
Kerala Blast,5142,5,5,4,5,13,16,-3,19
FC Pune City,5142,6,5,3,6,13,15,-2,18
Chennaiyin,5142,7,3,6,5,15,21,-6,15
FC Goa,5142,8,3,3,8,12,22,-10,12
Mumbai City,5143,1,7,4,3,18,9,9,25
Kolkata,5143,2,6,6,2,18,12,6,24
Delhi Dynamo,5143,3,6,5,3,26,18,8,23
Kerala Blast,5143,4,5,4,5,12,16,-4,19
Chennaiyin,5143,5,4,6,4,16,19,-3,18
FC Pune City,5143,6,4,4,6,13,18,-5,16
NorthEast Un,5143,7,4,2,8,13,16,-3,14
FC Goa,5143,8,3,3,8,9,17,-8,12
Mumbai City,5144,1,7,4,3,19,8,11,25
Delhi Dynamo,5144,2,5,6,3,25,19,6,21
NorthEast Un,5144,3,6,2,6,13,12,1,20
Kerala Blast,5144,4,5,4,5,15,16,-1,19
Kolkata,5144,5,4,6,4,17,19,-2,18
Chennaiyin,5144,6,4,5,5,17,19,-2,17
FC Pune City,5144,7,4,4,6,13,17,-4,16
FC Goa,5144,8,4,3,7,13,22,-9,15
Mumbai City,5145,1,7,4,3,19,9,10,25
Kolkata,5145,2,5,6,3,16,14,2,21
Kerala Blast,5145,3,6,3,5,13,15,-2,21
Chennaiyin,5145,4,5,5,4,19,20,-1,20
Delhi Dynamo,5145,5,4,6,4,23,21,2,18
FC Goa,5145,6,5,2,7,14,18,-4,17
NorthEast Un,5145,7,4,3,7,12,15,-3,15
FC Pune City,5145,8,4,3,7,13,17,-4,15
Mumbai City,5146,1,7,4,3,20,10,10,25
Kolkata,5146,2,6,6,2,16,12,4,24
NorthEast Un,5146,3,5,4,5,11,10,1,19
Delhi Dynamo,5146,4,4,6,4,25,21,4,18
Kerala Blast,5146,5,4,5,5,10,15,-5,17
FC Pune City,5146,6,4,4,6,13,16,-3,16
Chennaiyin,5146,7,3,7,4,14,18,-4,16
FC Goa,5146,8,3,4,7,10,17,-7,13
Delhi Dynamo,5147,1,6,6,2,24,14,10,24
Mumbai City,5147,2,6,4,4,16,9,7,22
Kolkata,5147,3,5,7,2,19,13,6,22
NorthEast Un,5147,4,5,4,5,11,9,2,19
Kerala Blast,5147,5,5,4,5,11,17,-6,19
FC Pune City,5147,6,4,3,7,13,18,-5,15
FC Goa,5147,7,4,3,7,12,17,-5,15
Chennaiyin,5147,8,3,5,6,13,22,-9,14
Delhi Dynamo,5148,1,6,6,2,26,17,9,24
Mumbai City,5148,2,6,4,4,17,10,7,22
Kolkata,5148,3,4,7,3,17,16,1,19
NorthEast Un,5148,4,5,3,6,14,13,1,18
FC Pune City,5148,5,4,5,5,14,16,-2,17
Chennaiyin,5148,6,4,5,5,17,21,-4,17
FC Goa,5148,7,5,2,7,13,18,-5,17
Kerala Blast,5148,8,4,4,6,13,20,-7,16
Mumbai City,5149,1,7,4,3,19,10,9,25
Kerala Blast,5149,2,6,4,4,17,18,-1,22
Delhi Dynamo,5149,3,5,5,4,27,20,7,20
NorthEast Un,5149,4,6,2,6,13,10,3,20
FC Pune City,5149,5,5,3,6,17,18,-1,18
Kolkata,5149,6,3,8,3,17,19,-2,17
Chennaiyin,5149,7,4,5,5,17,20,-3,17
FC Goa,5149,8,3,3,8,11,23,-12,12
Mumbai City,5150,1,7,4,3,19,8,11,25
Delhi Dynamo,5150,2,6,5,3,26,18,8,23
Kolkata,5150,3,5,7,2,17,12,5,22
Kerala Blast,5150,4,5,4,5,13,16,-3,19
NorthEast Un,5150,5,4,4,6,11,12,-1,16
Chennaiyin,5150,6,3,6,5,13,18,-5,15
FC Pune City,5150,7,4,3,7,13,20,-7,15
FC Goa,5150,8,4,3,7,9,17,-8,15
Mumbai City,5151,1,7,4,3,17,8,9,25
Kolkata,5151,2,5,6,3,18,13,5,21
NorthEast Un,5151,3,6,3,5,16,12,4,21
Delhi Dynamo,5151,4,5,5,4,23,19,4,20
FC Pune City,5151,5,5,3,6,13,15,-2,18
Kerala Blast,5151,6,5,3,6,13,19,-6,18
Chennaiyin,5151,7,3,6,5,13,20,-7,15
FC Goa,5151,8,4,2,8,12,19,-7,14
Mumbai City,5152,1,6,4,4,16,9,7,22
Delhi Dynamo,5152,2,5,6,3,23,17,6,21
Kerala Blast,5152,3,5,5,4,12,15,-3,20
Chennaiyin,5152,4,4,6,4,14,17,-3,18
NorthEast Un,5152,5,4,5,5,10,10,0,17
FC Pune City,5152,6,4,5,5,14,16,-2,17
FC Goa,5152,7,5,2,7,13,17,-4,17
Kolkata,5152,8,3,7,4,17,18,-1,16
Delhi Dynamo,5153,1,7,5,2,27,16,11,26
Mumbai City,5153,2,6,4,4,17,10,7,22
Kolkata,5153,3,5,6,3,17,14,3,21
Kerala Blast,5153,4,6,3,5,12,16,-4,21
Chennaiyin,5153,5,3,7,4,15,19,-4,16
NorthEast Un,5153,6,4,3,7,11,14,-3,15
FC Pune City,5153,7,4,3,7,12,16,-4,15
FC Goa,5153,8,4,3,7,11,17,-6,15
Mumbai City,5154,1,6,5,3,17,9,8,23
Delhi Dynamo,5154,2,5,6,3,24,17,7,21
NorthEast Un,5154,3,6,2,6,13,12,1,20
Kerala Blast,5154,4,5,5,4,14,15,-1,20
FC Pune City,5154,5,5,4,5,14,15,-1,19
Kolkata,5154,6,3,8,3,17,17,0,17
Chennaiyin,5154,7,4,5,5,14,19,-5,17
FC Goa,5154,8,3,3,8,9,18,-9,12
Mumbai City,5155,1,7,4,3,17,8,9,25
Kerala Blast,5155,2,7,3,4,14,14,0,24
Delhi Dynamo,5155,3,5,5,4,23,17,6,20
NorthEast Un,5155,4,6,2,6,13,12,1,20
Kolkata,5155,5,4,7,3,17,15,2,19
FC Pune City,5155,6,4,3,7,14,20,-6,15
FC Goa,5155,7,4,3,7,11,17,-6,15
Chennaiyin,5155,8,3,5,6,15,21,-6,14
Kolkata,5156,1,6,6,2,18,14,4,24
Mumbai City,5156,2,6,5,3,16,8,8,23
Delhi Dynamo,5156,3,5,6,3,26,15,11,21
NorthEast Un,5156,4,6,2,6,11,11,0,20
Kerala Blast,5156,5,5,3,6,12,15,-3,18
Chennaiyin,5156,6,4,5,5,15,19,-4,17
FC Pune City,5156,7,4,3,7,14,20,-6,15
FC Goa,5156,8,4,2,8,10,20,-10,14
Mumbai City,5157,1,7,4,3,21,9,12,25
Delhi Dynamo,5157,2,5,6,3,26,21,5,21
Kerala Blast,5157,3,5,5,4,11,14,-3,20
NorthEast Un,5157,4,5,4,5,12,11,1,19
Kolkata,5157,5,3,8,3,13,13,0,17
FC Pune City,5157,6,4,5,5,13,15,-2,17
FC Goa,5157,7,4,3,7,12,18,-6,15
Chennaiyin,5157,8,3,5,6,15,22,-7,14
Mumbai City,5158,1,7,4,3,20,10,10,25
FC Pune City,5158,2,6,3,5,16,16,0,21
NorthEast Un,5158,3,6,2,6,13,11,2,20
FC Goa,5158,4,5,3,6,14,14,0,18
Chennaiyin,5158,5,4,6,4,14,17,-3,18
Kolkata,5158,6,4,6,4,18,22,-4,18
Delhi Dynamo,5158,7,4,5,5,24,21,3,17
Kerala Blast,5158,8,4,3,7,11,19,-8,15
Mumbai City,5159,1,6,5,3,16,8,8,23
Kerala Blast,5159,2,6,3,5,13,17,-4,21
NorthEast Un,5159,3,6,2,6,13,11,2,20
Kolkata,5159,4,4,7,3,17,16,1,19
Delhi Dynamo,5159,5,4,6,4,21,16,5,18
FC Goa,5159,6,5,2,7,12,16,-4,17
Chennaiyin,5159,7,4,5,5,15,20,-5,17
FC Pune City,5159,8,4,4,6,15,18,-3,16
Delhi Dynamo,5160,1,6,6,2,26,14,12,24
Mumbai City,5160,2,6,4,4,16,11,5,22
Kerala Blast,5160,3,5,5,4,15,18,-3,20
Kolkata,5160,4,4,7,3,19,17,2,19
NorthEast Un,5160,5,4,4,6,11,13,-2,16
FC Pune City,5160,6,4,4,6,15,19,-4,16
FC Goa,5160,7,4,4,6,12,16,-4,16
Chennaiyin,5160,8,3,6,5,15,21,-6,15
Delhi Dynamo,5161,1,6,5,3,25,17,8,23
Mumbai City,5161,2,6,4,4,16,9,7,22
Kolkata,5161,3,5,6,3,20,17,3,21
NorthEast Un,5161,4,6,3,5,14,11,3,21
FC Goa,5161,5,5,2,7,15,18,-3,17
Kerala Blast,5161,6,4,5,5,12,17,-5,17
FC Pune City,5161,7,4,4,6,14,19,-5,16
Chennaiyin,5161,8,3,5,6,14,22,-8,14
Mumbai City,5162,1,6,5,3,17,9,8,23
Kerala Blast,5162,2,6,3,5,15,14,1,21
Delhi Dynamo,5162,3,4,8,2,23,16,7,20
FC Pune City,5162,4,5,4,5,14,15,-1,19
FC Goa,5162,5,5,3,6,12,15,-3,18
Chennaiyin,5162,6,4,5,5,14,18,-4,17
Kolkata,5162,7,3,7,4,15,18,-3,16
NorthEast Un,5162,8,4,3,7,10,15,-5,15
Mumbai City,5163,1,7,4,3,18,8,10,25
Delhi Dynamo,5163,2,5,6,3,25,18,7,21
NorthEast Un,5163,3,5,3,6,13,13,0,18
FC Goa,5163,4,5,3,6,14,16,-2,18
Kerala Blast,5163,5,4,6,4,11,15,-4,18
Kolkata,5163,6,3,8,3,16,17,-1,17
FC Pune City,5163,7,4,5,5,13,15,-2,17
Chennaiyin,5163,8,3,5,6,13,21,-8,14
Mumbai City,5164,1,7,4,3,17,8,9,25
Kolkata,5164,2,5,7,2,18,14,4,22
Delhi Dynamo,5164,3,5,6,3,23,15,8,21
NorthEast Un,5164,4,5,4,5,13,10,3,19
Kerala Blast,5164,5,5,4,5,14,17,-3,19
FC Pune City,5164,6,4,3,7,13,19,-6,15
FC Goa,5164,7,4,3,7,11,18,-7,15
Chennaiyin,5164,8,3,5,6,14,22,-8,14
Delhi Dynamo,5165,1,6,5,3,30,20,10,23
Mumbai City,5165,2,6,4,4,18,12,6,22
Kolkata,5165,3,5,6,3,17,16,1,21
Kerala Blast,5165,4,6,3,5,14,18,-4,21
NorthEast Un,5165,5,6,2,6,18,13,5,20
Chennaiyin,5165,6,4,5,5,16,23,-7,17
FC Pune City,5165,7,4,3,7,15,19,-4,15
FC Goa,5165,8,4,2,8,13,20,-7,14
Delhi Dynamo,5166,1,5,7,2,23,15,8,22
Mumbai City,5166,2,6,4,4,16,9,7,22
Kolkata,5166,3,5,6,3,16,14,2,21
NorthEast Un,5166,4,5,3,6,12,12,0,18
FC Pune City,5166,5,5,3,6,14,15,-1,18
Chennaiyin,5166,6,4,6,4,17,20,-3,18
FC Goa,5166,7,4,4,6,12,17,-5,16
Kerala Blast,5166,8,4,3,7,9,17,-8,15
Mumbai City,5167,1,7,4,3,19,10,9,25
NorthEast Un,5167,2,6,2,6,12,11,1,20
FC Goa,5167,3,6,2,6,15,16,-1,20
Kerala Blast,5167,4,5,4,5,12,16,-4,19
Delhi Dynamo,5167,5,4,5,5,26,22,4,17
FC Pune City,5167,6,4,5,5,15,17,-2,17
Chennaiyin,5167,7,4,5,5,14,19,-5,17
Kolkata,5167,8,3,7,4,16,18,-2,16
Delhi Dynamo,5168,1,6,5,3,26,16,10,23
Mumbai City,5168,2,6,4,4,16,9,7,22
NorthEast Un,5168,3,6,3,5,14,10,4,21
Kerala Blast,5168,4,5,5,4,11,14,-3,20
FC Pune City,5168,5,5,4,5,13,14,-1,19
Chennaiyin,5168,6,4,5,5,15,19,-4,17
Kolkata,5168,7,3,6,5,13,15,-2,15
FC Goa,5168,8,4,2,8,9,20,-11,14
Mumbai City,5169,1,7,4,3,18,9,9,25
Delhi Dynamo,5169,2,5,5,4,24,18,6,20
NorthEast Un,5169,3,6,2,6,11,10,1,20
FC Goa,5169,4,6,2,6,17,17,0,20
FC Pune City,5169,5,4,5,5,14,16,-2,17
Kolkata,5169,6,3,8,3,16,19,-3,17
Kerala Blast,5169,7,4,5,5,12,17,-5,17
Chennaiyin,5169,8,3,5,6,15,21,-6,14
Mumbai City,5170,1,6,5,3,17,9,8,23
Kolkata,5170,2,5,7,2,23,16,7,22
Kerala Blast,5170,3,6,4,4,15,15,0,22
Delhi Dynamo,5170,4,5,6,3,25,18,7,21
Chennaiyin,5170,5,5,5,4,18,18,0,20
NorthEast Un,5170,6,5,2,7,11,15,-4,17
FC Pune City,5170,7,4,3,7,13,22,-9,15
FC Goa,5170,8,3,2,9,13,22,-9,11
Mumbai City,5171,1,7,4,3,17,8,9,25
Delhi Dynamo,5171,2,6,5,3,26,15,11,23
NorthEast Un,5171,3,6,2,6,12,11,1,20
Kolkata,5171,4,4,7,3,16,15,1,19
Kerala Blast,5171,5,5,3,6,13,19,-6,18
FC Goa,5171,6,5,2,7,12,19,-7,17
FC Pune City,5171,7,4,4,6,13,16,-3,16
Chennaiyin,5171,8,3,5,6,14,20,-6,14
Delhi Dynamo,5172,1,7,5,2,27,16,11,26
Kolkata,5172,2,6,6,2,20,15,5,24
Mumbai City,5172,3,6,4,4,16,10,6,22
Kerala Blast,5172,4,5,4,5,11,15,-4,19
Chennaiyin,5172,5,4,6,4,14,17,-3,18
NorthEast Un,5172,6,4,3,7,10,12,-2,15
FC Pune City,5172,7,4,3,7,13,18,-5,15
FC Goa,5172,8,3,3,8,10,18,-8,12
Mumbai City,5173,1,6,5,3,18,10,8,23
Kerala Blast,5173,2,6,4,4,15,16,-1,22
Delhi Dynamo,5173,3,4,8,2,27,20,7,20
Kolkata,5173,4,4,8,2,19,15,4,20
Chennaiyin,5173,5,5,5,4,18,19,-1,20
NorthEast Un,5173,6,4,3,7,13,15,-2,15
FC Pune City,5173,7,4,3,7,13,20,-7,15
FC Goa,5173,8,3,4,7,13,21,-8,13
Delhi Dynamo,5174,1,6,5,3,25,16,9,23
Mumbai City,5174,2,6,4,4,16,10,6,22
NorthEast Un,5174,3,6,2,6,13,11,2,20
FC Pune City,5174,4,5,4,5,16,15,1,19
Kerala Blast,5174,5,5,4,5,12,17,-5,19
Kolkata,5174,6,4,6,4,14,16,-2,18
Chennaiyin,5174,7,4,5,5,14,21,-7,17
FC Goa,5174,8,4,2,8,13,17,-4,14
Mumbai City,5175,1,6,5,3,17,9,8,23
Delhi Dynamo,5175,2,5,7,2,25,16,9,22
Kolkata,5175,3,5,6,3,18,16,2,21
NorthEast Un,5175,4,5,4,5,11,10,1,19
FC Goa,5175,5,5,2,7,16,20,-4,17
FC Pune City,5175,6,4,4,6,14,17,-3,16
Kerala Blast,5175,7,4,4,6,13,19,-6,16
Chennaiyin,5175,8,3,6,5,16,23,-7,15
Mumbai City,5176,1,6,4,4,18,12,6,22
Delhi Dynamo,5176,2,5,6,3,26,19,7,21
Kolkata,5176,3,5,6,3,20,16,4,21
NorthEast Un,5176,4,6,2,6,12,10,2,20
Chennaiyin,5176,5,5,5,4,16,18,-2,20
FC Pune City,5176,6,5,3,6,17,19,-2,18
Kerala Blast,5176,7,5,3,6,13,18,-5,18
FC Goa,5176,8,3,3,8,10,20,-10,12
Mumbai City,5177,1,7,4,3,17,8,9,25
Delhi Dynamo,5177,2,5,5,4,24,20,4,20
NorthEast Un,5177,3,5,3,6,14,11,3,18
Chennaiyin,5177,4,4,6,4,15,18,-3,18
Kerala Blast,5177,5,4,6,4,9,13,-4,18
Kolkata,5177,6,3,8,3,14,14,0,17
FC Pune City,5177,7,4,5,5,13,15,-2,17
FC Goa,5177,8,4,3,7,10,17,-7,15
Delhi Dynamo,5178,1,5,7,2,26,18,8,22
Mumbai City,5178,2,6,4,4,17,10,7,22
Kolkata,5178,3,5,6,3,19,14,5,21
NorthEast Un,5178,4,5,4,5,11,10,1,19
Chennaiyin,5178,5,4,6,4,15,18,-3,18
Kerala Blast,5178,6,5,3,6,12,16,-4,18
FC Goa,5178,7,4,3,7,13,19,-6,15
FC Pune City,5178,8,4,3,7,13,21,-8,15
Delhi Dynamo,5179,1,6,5,3,29,16,13,23
Mumbai City,5179,2,6,4,4,17,12,5,22
Kolkata,5179,3,5,7,2,18,14,4,22
Kerala Blast,5179,4,5,4,5,11,16,-5,19
Chennaiyin,5179,5,4,6,4,19,19,0,18
NorthEast Un,5179,6,5,2,7,11,15,-4,17
FC Pune City,5179,7,4,4,6,13,16,-3,16
FC Goa,5179,8,3,4,7,9,19,-10,13
Mumbai City,5180,1,7,4,3,18,8,10,25
Delhi Dynamo,5180,2,5,5,4,24,17,7,20
Kolkata,5180,3,4,7,3,16,17,-1,19
Kerala Blast,5180,4,5,4,5,13,17,-4,19
NorthEast Un,5180,5,5,3,6,12,12,0,18
FC Pune City,5180,6,4,5,5,13,15,-2,17
FC Goa,5180,7,5,2,7,14,19,-5,17
Chennaiyin,5180,8,3,6,5,15,20,-5,15
Delhi Dynamo,5181,1,6,6,2,26,15,11,24
Mumbai City,5181,2,6,4,4,16,10,6,22
FC Pune City,5181,3,5,4,5,15,15,0,19
Kerala Blast,5181,4,5,4,5,11,16,-5,19
Chennaiyin,5181,5,4,6,4,16,19,-3,18
Kolkata,5181,6,3,8,3,15,15,0,17
NorthEast Un,5181,7,4,5,5,13,13,0,17
FC Goa,5181,8,3,3,8,9,18,-9,12
Mumbai City,5182,1,7,4,3,17,8,9,25
Kolkata,5182,2,6,6,2,17,13,4,24
Delhi Dynamo,5182,3,6,5,3,24,16,8,23
Kerala Blast,5182,4,6,3,5,13,16,-3,21
Chennaiyin,5182,5,4,6,4,17,18,-1,18
NorthEast Un,5182,6,4,3,7,11,13,-2,15
FC Pune City,5182,7,4,3,7,13,17,-4,15
FC Goa,5182,8,3,2,9,10,21,-11,11
Mumbai City,5183,1,7,4,3,17,8,9,25
Kolkata,5183,2,6,6,2,21,13,8,24
Delhi Dynamo,5183,3,5,6,3,25,17,8,21
Kerala Blast,5183,4,5,4,5,12,20,-8,19
Chennaiyin,5183,5,4,6,4,16,19,-3,18
NorthEast Un,5183,6,4,4,6,11,13,-2,16
FC Pune City,5183,7,4,3,7,13,17,-4,15
FC Goa,5183,8,3,3,8,10,18,-8,12
Mumbai City,5184,1,7,4,3,18,8,10,25
NorthEast Un,5184,2,7,2,5,15,12,3,23
Kolkata,5184,3,4,8,2,16,14,2,20
Delhi Dynamo,5184,4,4,5,5,22,19,3,17
Chennaiyin,5184,5,4,5,5,17,19,-2,17
FC Pune City,5184,6,4,5,5,14,16,-2,17
Kerala Blast,5184,7,4,4,6,12,18,-6,16
FC Goa,5184,8,4,3,7,9,17,-8,15
Delhi Dynamo,5185,1,7,5,2,27,17,10,26
Mumbai City,5185,2,6,4,4,17,10,7,22
Kerala Blast,5185,3,6,4,4,14,16,-2,22
Kolkata,5185,4,5,6,3,20,18,2,21
NorthEast Un,5185,5,4,4,6,14,15,-1,16
FC Pune City,5185,6,4,3,7,13,17,-4,15
Chennaiyin,5185,7,3,6,5,18,23,-5,15
FC Goa,5185,8,4,2,8,14,21,-7,14
Delhi Dynamo,5186,1,6,5,3,28,19,9,23
Mumbai City,5186,2,6,4,4,17,11,6,22
Kolkata,5186,3,5,7,2,16,13,3,22
NorthEast Un,5186,4,6,3,5,14,12,2,21
Kerala Blast,5186,5,4,6,4,12,16,-4,18
Chennaiyin,5186,6,4,5,5,16,18,-2,17
FC Pune City,5186,7,4,4,6,13,16,-3,16
FC Goa,5186,8,3,2,9,9,20,-11,11
Mumbai City,5187,1,6,5,3,17,9,8,23
Delhi Dynamo,5187,2,5,7,2,27,18,9,22
Kerala Blast,5187,3,6,3,5,17,17,0,21
Kolkata,5187,3,5,6,3,17,17,0,21
Chennaiyin,5187,5,5,5,4,17,18,-1,20
FC Pune City,5187,6,5,3,6,20,20,0,18
NorthEast Un,5187,7,4,3,7,11,17,-6,15
FC Goa,5187,8,3,2,9,10,20,-10,11
Mumbai City,5188,1,7,4,3,17,8,9,25
Delhi Dynamo,5188,2,5,6,3,25,18,7,21
Kolkata,5188,3,4,7,3,15,14,1,19
NorthEast Un,5188,4,5,3,6,11,12,-1,18
Chennaiyin,5188,5,4,5,5,16,19,-3,17
FC Goa,5188,6,5,2,7,14,18,-4,17
Kerala Blast,5188,7,4,5,5,9,14,-5,17
FC Pune City,5188,8,4,4,6,12,16,-4,16
Mumbai City,5189,1,7,4,3,19,8,11,25
Kolkata,5189,2,5,6,3,18,15,3,21
Kerala Blast,5189,3,6,3,5,12,16,-4,21
Delhi Dynamo,5189,4,4,6,4,22,20,2,18
NorthEast Un,5189,5,5,3,6,11,10,1,18
FC Pune City,5189,6,5,3,6,16,18,-2,18
FC Goa,5189,7,4,3,7,11,16,-5,15
Chennaiyin,5189,8,3,6,5,13,19,-6,15
Mumbai City,5190,1,6,5,3,18,10,8,23
Delhi Dynamo,5190,2,5,7,2,25,17,8,22
Kerala Blast,5190,3,6,3,5,13,14,-1,21
NorthEast Un,5190,4,6,2,6,11,10,1,20
Kolkata,5190,5,4,6,4,15,15,0,18
FC Pune City,5190,6,5,3,6,14,18,-4,18
FC Goa,5190,7,4,3,7,12,16,-4,15
Chennaiyin,5190,8,3,5,6,13,21,-8,14
Mumbai City,5191,1,6,5,3,17,9,8,23
Delhi Dynamo,5191,2,5,6,3,24,17,7,21
Chennaiyin,5191,3,5,5,4,15,17,-2,20
Kolkata,5191,4,4,7,3,15,16,-1,19
FC Pune City,5191,5,5,4,5,14,15,-1,19
Kerala Blast,5191,6,5,4,5,12,14,-2,19
NorthEast Un,5191,7,5,3,6,11,10,1,18
FC Goa,5191,8,3,2,9,8,18,-10,11
Mumbai City,5192,1,7,4,3,18,8,10,25
Kerala Blast,5192,2,6,4,4,11,13,-2,22
Delhi Dynamo,5192,3,5,6,3,25,19,6,21
FC Pune City,5192,4,5,3,6,14,15,-1,18
Kolkata,5192,5,3,8,3,14,15,-1,17
Chennaiyin,5192,6,4,5,5,15,18,-3,17
NorthEast Un,5192,7,4,3,7,11,14,-3,15
FC Goa,5192,8,4,3,7,11,17,-6,15
Mumbai City,5193,1,7,4,3,18,9,9,25
Kolkata,5193,2,5,7,2,19,15,4,22
Delhi Dynamo,5193,3,5,6,3,25,17,8,21
Chennaiyin,5193,4,5,5,4,15,17,-2,20
Kerala Blast,5193,5,5,4,5,14,19,-5,19
FC Pune City,5193,6,4,4,6,16,19,-3,16
NorthEast Un,5193,7,4,3,7,9,12,-3,15
FC Goa,5193,8,3,3,8,10,18,-8,12
Delhi Dynamo,5194,1,7,5,2,26,16,10,26
Mumbai City,5194,2,6,4,4,17,10,7,22
Kolkata,5194,3,5,7,2,17,13,4,22
Kerala Blast,5194,4,5,4,5,12,15,-3,19
FC Pune City,5194,5,4,5,5,12,14,-2,17
NorthEast Un,5194,6,5,2,7,11,14,-3,17
Chennaiyin,5194,7,3,6,5,14,19,-5,15
FC Goa,5194,8,3,3,8,10,18,-8,12
Delhi Dynamo,5195,1,7,5,2,28,15,13,26
Mumbai City,5195,2,6,4,4,17,10,7,22
FC Pune City,5195,3,6,3,5,15,15,0,21
Kerala Blast,5195,4,5,4,5,10,14,-4,19
Chennaiyin,5195,5,4,5,5,15,20,-5,17
FC Goa,5195,6,5,2,7,13,18,-5,17
Kolkata,5195,7,3,7,4,14,16,-2,16
NorthEast Un,5195,8,4,2,8,9,13,-4,14
Mumbai City,5196,1,7,4,3,18,8,10,25
Delhi Dynamo,5196,2,5,5,4,24,18,6,20
NorthEast Un,5196,3,5,4,5,11,10,1,19
FC Pune City,5196,4,5,4,5,14,15,-1,19
Kolkata,5196,5,3,8,3,14,15,-1,17
FC Goa,5196,6,5,2,7,12,17,-5,17
Kerala Blast,5196,7,4,5,5,11,16,-5,17
Chennaiyin,5196,8,3,6,5,14,19,-5,15
Mumbai City,5197,1,6,5,3,17,9,8,23
Kolkata,5197,2,4,8,2,14,12,2,20
Delhi Dynamo,5197,3,4,7,3,24,18,6,19
NorthEast Un,5197,4,5,3,6,13,11,2,18
FC Goa,5197,5,5,3,6,13,16,-3,18
FC Pune City,5197,6,4,5,5,13,15,-2,17
Chennaiyin,5197,7,4,5,5,15,20,-5,17
Kerala Blast,5197,8,4,4,6,10,18,-8,16
Mumbai City,5198,1,7,4,3,19,8,11,25
Kolkata,5198,2,5,6,3,18,15,3,21
Kerala Blast,5198,3,5,4,5,12,16,-4,19
Delhi Dynamo,5198,4,4,6,4,23,20,3,18
Chennaiyin,5198,5,4,6,4,17,20,-3,18
NorthEast Un,5198,6,4,5,5,11,11,0,17
FC Goa,5198,7,5,2,7,13,18,-5,17
FC Pune City,5198,8,4,3,7,15,20,-5,15
Delhi Dynamo,5199,1,7,5,2,31,19,12,26
Mumbai City,5199,2,6,4,4,16,9,7,22
Kolkata,5199,3,4,8,2,20,18,2,20
Chennaiyin,5199,4,5,5,4,17,17,0,20
Kerala Blast,5199,5,5,4,5,14,18,-4,19
FC Pune City,5199,6,4,5,5,17,19,-2,17
NorthEast Un,5199,7,4,2,8,14,18,-4,14
FC Goa,5199,8,3,3,8,11,22,-11,12
Mumbai City,5200,1,7,4,3,17,8,9,25
Kolkata,5200,2,5,7,2,16,13,3,22
Kerala Blast,5200,3,5,5,4,11,14,-3,20
NorthEast Un,5200,4,5,4,5,13,11,2,19
Delhi Dynamo,5200,5,4,6,4,21,17,4,18
Chennaiyin,5200,6,4,6,4,16,18,-2,18
FC Pune City,5200,7,4,3,7,13,17,-4,15
FC Goa,5200,8,3,3,8,8,17,-9,12
Delhi Dynamo,5201,1,6,6,2,30,17,13,24
Mumbai City,5201,2,6,5,3,18,10,8,23
Kolkata,5201,3,4,8,2,18,15,3,20
FC Pune City,5201,4,5,4,5,14,15,-1,19
Chennaiyin,5201,5,4,5,5,15,18,-3,17
NorthEast Un,5201,6,5,2,7,10,15,-5,17
FC Goa,5201,7,4,3,7,10,17,-7,15
Kerala Blast,5201,8,4,3,7,11,19,-8,15
Delhi Dynamo,5202,1,7,5,2,29,17,12,26
Mumbai City,5202,2,6,4,4,16,10,6,22
Kolkata,5202,3,4,7,3,17,15,2,19
FC Pune City,5202,4,5,4,5,15,15,0,19
Kerala Blast,5202,5,5,3,6,10,17,-7,18
FC Goa,5202,6,5,2,7,14,20,-6,17
NorthEast Un,5202,7,4,3,7,11,13,-2,15
Chennaiyin,5202,8,3,6,5,15,20,-5,15
Kolkata,5203,1,6,6,2,20,13,7,24
Mumbai City,5203,2,6,5,3,19,11,8,23
NorthEast Un,5203,3,6,2,6,14,13,1,20
Delhi Dynamo,5203,4,4,6,4,25,20,5,18
Chennaiyin,5203,5,4,5,5,16,20,-4,17
FC Goa,5203,6,5,2,7,11,17,-6,17
FC Pune City,5203,7,4,4,6,15,19,-4,16
Kerala Blast,5203,8,4,4,6,12,19,-7,16
Mumbai City,5204,1,7,4,3,17,8,9,25
Kolkata,5204,2,5,6,3,19,14,5,21
Kerala Blast,5204,3,6,3,5,13,15,-2,21
Delhi Dynamo,5204,4,5,5,4,23,17,6,20
NorthEast Un,5204,5,5,3,6,12,14,-2,18
FC Goa,5204,6,5,2,7,13,17,-4,17
Chennaiyin,5204,7,3,6,5,15,21,-6,15
FC Pune City,5204,8,4,3,7,12,18,-6,15
Delhi Dynamo,5205,1,7,5,2,26,15,11,26
Mumbai City,5205,2,6,4,4,16,9,7,22
Kerala Blast,5205,3,6,4,4,11,13,-2,22
Kolkata,5205,4,3,8,3,14,14,0,17
NorthEast Un,5205,5,5,2,7,11,12,-1,17
FC Pune City,5205,6,4,5,5,12,14,-2,17
FC Goa,5205,7,4,3,7,13,20,-7,15
Chennaiyin,5205,8,3,5,6,16,22,-6,14
Mumbai City,5206,1,7,4,3,18,8,10,25
Kerala Blast,5206,2,7,3,4,14,14,0,24
Chennaiyin,5206,3,5,5,4,16,17,-1,20
Delhi Dynamo,5206,4,4,5,5,22,20,2,17
Kolkata,5206,5,3,8,3,16,16,0,17
NorthEast Un,5206,6,5,2,7,12,14,-2,17
FC Pune City,5206,7,4,4,6,14,17,-3,16
FC Goa,5206,8,4,3,7,11,17,-6,15
Mumbai City,5207,1,7,4,3,18,8,10,25
Delhi Dynamo,5207,2,5,6,3,25,18,7,21
Kolkata,5207,3,5,6,3,18,18,0,21
NorthEast Un,5207,4,4,5,5,10,10,0,17
FC Goa,5207,5,5,2,7,14,18,-4,17
Kerala Blast,5207,6,4,5,5,11,16,-5,17
FC Pune City,5207,7,4,4,6,15,18,-3,16
Chennaiyin,5207,8,3,6,5,14,19,-5,15
Kerala Blast,5208,1,7,3,4,16,17,-1,24
Delhi Dynamo,5208,2,6,5,3,27,18,9,23
Mumbai City,5208,3,6,4,4,17,10,7,22
Kolkata,5208,4,5,6,3,16,14,2,21
Chennaiyin,5208,5,5,5,4,19,18,1,20
FC Pune City,5208,6,4,3,7,14,18,-4,15
NorthEast Un,5208,7,4,2,8,13,20,-7,14
FC Goa,5208,8,4,2,8,11,18,-7,14
Mumbai City,5209,1,6,5,3,17,9,8,23
NorthEast Un,5209,2,7,2,5,18,12,6,23
Delhi Dynamo,5209,3,5,6,3,26,17,9,21
Kolkata,5209,4,4,7,3,15,13,2,19
Kerala Blast,5209,5,5,4,5,12,16,-4,19
Chennaiyin,5209,6,4,5,5,16,22,-6,17
FC Pune City,5209,7,4,3,7,13,18,-5,15
FC Goa,5209,8,4,2,8,9,19,-10,14
Delhi Dynamo,5210,1,7,5,2,27,16,11,26
Mumbai City,5210,2,6,4,4,16,9,7,22
Kolkata,5210,3,5,6,3,17,17,0,21
Kerala Blast,5210,4,5,4,5,13,17,-4,19
NorthEast Un,5210,5,5,3,6,15,16,-1,18
FC Goa,5210,6,4,3,7,12,16,-4,15
FC Pune City,5210,6,4,3,7,12,16,-4,15
Chennaiyin,5210,8,3,6,5,14,19,-5,15
Mumbai City,5211,1,6,5,3,17,9,8,23
Kerala Blast,5211,2,6,4,4,13,14,-1,22
Delhi Dynamo,5211,3,5,6,3,24,16,8,21
Kolkata,5211,4,3,8,3,15,15,0,17
FC Pune City,5211,5,4,5,5,14,16,-2,17
NorthEast Un,5211,6,5,2,7,11,13,-2,17
Chennaiyin,5211,7,4,5,5,17,21,-4,17
FC Goa,5211,8,4,3,7,12,19,-7,15
Mumbai City,5212,1,7,4,3,18,9,9,25
Kolkata,5212,2,5,7,2,18,14,4,22
NorthEast Un,5212,3,6,3,5,15,12,3,21
Delhi Dynamo,5212,4,4,6,4,26,22,4,18
FC Pune City,5212,5,5,3,6,15,17,-2,18
Kerala Blast,5212,6,4,5,5,11,16,-5,17
FC Goa,5212,7,4,3,7,14,20,-6,15
Chennaiyin,5212,8,3,5,6,14,21,-7,14
Mumbai City,5213,1,7,4,3,18,9,9,25
Delhi Dynamo,5213,2,6,5,3,24,16,8,23
Kerala Blast,5213,3,6,4,4,15,13,2,22
Kolkata,5213,4,4,7,3,16,17,-1,19
NorthEast Un,5213,5,5,2,7,11,12,-1,17
FC Pune City,5213,6,4,4,6,13,17,-4,16
Chennaiyin,5213,7,3,6,5,13,19,-6,15
FC Goa,5213,8,3,4,7,8,15,-7,13
Mumbai City,5214,1,7,4,3,18,8,10,25
Kerala Blast,5214,2,6,4,4,14,15,-1,22
Delhi Dynamo,5214,3,5,6,3,26,19,7,21
Kolkata,5214,4,4,6,4,16,17,-1,18
FC Pune City,5214,5,5,3,6,13,15,-2,18
Chennaiyin,5214,6,4,6,4,15,18,-3,18
NorthEast Un,5214,7,4,5,5,14,14,0,17
FC Goa,5214,8,3,2,9,9,19,-10,11
Mumbai City,5215,1,7,4,3,17,8,9,25
Kerala Blast,5215,2,6,4,4,14,15,-1,22
Kolkata,5215,3,5,6,3,18,14,4,21
NorthEast Un,5215,4,5,4,5,14,12,2,19
Delhi Dynamo,5215,5,4,5,5,22,20,2,17
Chennaiyin,5215,6,3,7,4,15,19,-4,16
FC Goa,5215,7,4,3,7,11,16,-5,15
FC Pune City,5215,8,4,3,7,12,19,-7,15
Delhi Dynamo,5216,1,6,5,3,24,16,8,23
Mumbai City,5216,2,6,4,4,16,9,7,22
Kolkata,5216,3,5,6,3,20,18,2,21
NorthEast Un,5216,4,6,2,6,12,10,2,20
Chennaiyin,5216,5,5,5,4,17,19,-2,20
FC Pune City,5216,6,4,4,6,13,16,-3,16
Kerala Blast,5216,7,4,4,6,12,18,-6,16
FC Goa,5216,8,4,2,8,12,20,-8,14
Mumbai City,5217,1,6,5,3,17,9,8,23
NorthEast Un,5217,2,7,2,5,15,9,6,23
Kolkata,5217,3,4,8,2,15,12,3,20
Delhi Dynamo,5217,4,4,7,3,22,18,4,19
Kerala Blast,5217,5,5,4,5,13,14,-1,19
FC Goa,5217,6,4,4,6,9,14,-5,16
FC Pune City,5217,7,4,3,7,12,20,-8,15
Chennaiyin,5217,8,3,5,6,13,20,-7,14
Mumbai City,5218,1,7,4,3,19,8,11,25
Delhi Dynamo,5218,2,5,6,3,24,19,5,21
Kerala Blast,5218,3,6,3,5,11,15,-4,21
Chennaiyin,5218,4,4,6,4,17,18,-1,18
FC Pune City,5218,5,5,3,6,15,16,-1,18
NorthEast Un,5218,6,5,3,6,13,14,-1,18
Kolkata,5218,7,3,6,5,14,17,-3,15
FC Goa,5218,8,4,3,7,10,16,-6,15
Mumbai City,5219,1,7,4,3,18,8,10,25
Delhi Dynamo,5219,2,5,6,3,24,17,7,21
Kolkata,5219,3,4,7,3,16,15,1,19
Kerala Blast,5219,4,5,4,5,14,18,-4,19
NorthEast Un,5219,5,5,3,6,12,13,-1,18
FC Pune City,5219,6,5,3,6,13,15,-2,18
FC Goa,5219,7,4,3,7,12,16,-4,15
Chennaiyin,5219,8,3,6,5,13,20,-7,15
Mumbai City,5220,1,7,4,3,19,8,11,25
Kerala Blast,5220,2,6,4,4,16,14,2,22
FC Goa,5220,3,6,2,6,16,14,2,20
Delhi Dynamo,5220,4,5,5,4,24,24,0,20
Kolkata,5220,5,4,6,4,15,18,-3,18
Chennaiyin,5220,6,4,5,5,14,19,-5,17
NorthEast Un,5220,7,4,3,7,12,14,-2,15
FC Pune City,5220,8,4,3,7,13,18,-5,15
Mumbai City,5221,1,7,4,3,17,8,9,25
Kerala Blast,5221,2,6,4,4,12,14,-2,22
Delhi Dynamo,5221,3,5,6,3,24,16,8,21
Kolkata,5221,4,4,6,4,17,16,1,18
Chennaiyin,5221,5,4,6,4,15,17,-2,18
FC Pune City,5221,6,5,3,6,14,16,-2,18
NorthEast Un,5221,7,4,5,5,9,9,0,17
FC Goa,5221,8,3,2,9,9,21,-12,11
Kolkata,5222,1,6,6,2,18,12,6,24
Mumbai City,5222,2,6,5,3,17,9,8,23
Delhi Dynamo,5222,3,4,7,3,24,18,6,19
Chennaiyin,5222,4,4,6,4,18,19,-1,18
FC Pune City,5222,5,5,3,6,13,15,-2,18
Kerala Blast,5222,6,5,3,6,10,16,-6,18
NorthEast Un,5222,7,4,3,7,10,14,-4,15
FC Goa,5222,8,4,3,7,12,19,-7,15
Kolkata,5223,1,5,7,2,20,13,7,22
Mumbai City,5223,2,6,4,4,16,12,4,22
Delhi Dynamo,5223,3,5,6,3,27,20,7,21
NorthEast Un,5223,4,5,4,5,14,12,2,19
Kerala Blast,5223,5,5,4,5,14,18,-4,19
Chennaiyin,5223,6,4,5,5,17,20,-3,17
FC Pune City,5223,7,4,4,6,13,18,-5,16
FC Goa,5223,8,4,2,8,12,20,-8,14
Delhi Dynamo,5224,1,6,5,3,25,18,7,23
Mumbai City,5224,2,6,4,4,17,10,7,22
Kolkata,5224,3,5,6,3,17,18,-1,21
NorthEast Un,5224,4,5,3,6,12,13,-1,18
FC Goa,5224,5,5,2,7,17,16,1,17
Chennaiyin,5224,6,4,5,5,16,21,-5,17
Kerala Blast,5224,7,4,5,5,11,16,-5,17
FC Pune City,5224,8,4,4,6,15,18,-3,16
Mumbai City,5225,1,7,4,3,20,11,9,25
NorthEast Un,5225,2,6,3,5,16,12,4,21
FC Pune City,5225,3,6,3,5,16,15,1,21
Delhi Dynamo,5225,4,5,5,4,29,24,5,20
Kolkata,5225,5,4,6,4,16,15,1,18
FC Goa,5225,6,5,2,7,14,17,-3,17
Chennaiyin,5225,7,3,6,5,14,21,-7,15
Kerala Blast,5225,8,4,3,7,10,20,-10,15
Mumbai City,5226,1,6,5,3,18,10,8,23
Delhi Dynamo,5226,2,5,7,2,27,18,9,22
Kolkata,5226,3,4,7,3,17,15,2,19
Kerala Blast,5226,4,5,4,5,14,17,-3,19
FC Pune City,5226,5,5,3,6,16,19,-3,18
NorthEast Un,5226,6,4,4,6,10,12,-2,16
Chennaiyin,5226,7,3,7,4,14,18,-4,16
FC Goa,5226,8,4,3,7,11,18,-7,15
Mumbai City,5227,1,7,4,3,17,8,9,25
Delhi Dynamo,5227,2,5,6,3,28,20,8,21
FC Pune City,5227,3,5,4,5,15,14,1,19
Kolkata,5227,4,3,9,2,13,12,1,18
NorthEast Un,5227,5,5,3,6,13,16,-3,18
Chennaiyin,5227,6,4,5,5,19,22,-3,17
Kerala Blast,5227,7,4,4,6,9,17,-8,16
FC Goa,5227,8,4,3,7,15,20,-5,15
Mumbai City,5228,1,6,5,3,18,10,8,23
Delhi Dynamo,5228,2,5,7,2,28,17,11,22
Kolkata,5228,3,5,7,2,17,13,4,22
NorthEast Un,5228,4,6,3,5,12,10,2,21
FC Pune City,5228,5,5,3,6,15,17,-2,18
FC Goa,5228,6,4,3,7,12,18,-6,15
Kerala Blast,5228,7,4,3,7,10,18,-8,15
Chennaiyin,5228,8,3,5,6,13,22,-9,14
Mumbai City,5229,1,7,4,3,18,9,9,25
Delhi Dynamo,5229,2,6,5,3,27,16,11,23
Kolkata,5229,3,5,6,3,18,15,3,21
FC Pune City,5229,4,5,3,6,14,17,-3,18
Kerala Blast,5229,5,5,3,6,11,16,-5,18
NorthEast Un,5229,6,5,2,7,11,11,0,17
FC Goa,5229,7,5,2,7,12,18,-6,17
Chennaiyin,5229,8,3,5,6,13,22,-9,14
Delhi Dynamo,5230,1,6,5,3,27,19,8,23
Mumbai City,5230,2,6,4,4,17,10,7,22
Kerala Blast,5230,3,6,4,4,12,13,-1,22
Kolkata,5230,4,4,7,3,15,13,2,19
Chennaiyin,5230,5,4,6,4,17,19,-2,18
FC Goa,5230,6,5,3,6,13,17,-4,18
FC Pune City,5230,7,4,3,7,12,18,-6,15
NorthEast Un,5230,8,4,2,8,11,15,-4,14
Delhi Dynamo,5231,1,7,5,2,28,15,13,26
Mumbai City,5231,2,6,4,4,16,12,4,22
Kerala Blast,5231,3,5,5,4,15,16,-1,20
Kolkata,5231,4,4,7,3,17,16,1,19
FC Goa,5231,5,5,2,7,14,17,-3,17
Chennaiyin,5231,6,4,5,5,16,22,-6,17
FC Pune City,5231,7,4,4,6,12,15,-3,16
NorthEast Un,5231,8,4,2,8,10,15,-5,14
Mumbai City,5232,1,6,4,4,17,10,7,22
Kolkata,5232,2,5,6,3,18,15,3,21
Delhi Dynamo,5232,3,5,5,4,24,18,6,20
FC Goa,5232,4,6,2,6,12,14,-2,20
Kerala Blast,5232,5,5,4,5,13,15,-2,19
Chennaiyin,5232,6,4,5,5,15,18,-3,17
NorthEast Un,5232,7,5,2,7,11,15,-4,17
FC Pune City,5232,8,4,4,6,14,19,-5,16
Mumbai City,5233,1,7,4,3,17,8,9,25
Delhi Dynamo,5233,2,5,6,3,23,16,7,21
Chennaiyin,5233,3,5,5,4,22,18,4,20
FC Pune City,5233,4,5,4,5,15,16,-1,19
Kerala Blast,5233,5,5,4,5,11,14,-3,19
Kolkata,5233,6,3,9,2,17,16,1,18
NorthEast Un,5233,7,4,3,7,9,14,-5,15
FC Goa,5233,8,3,3,8,12,24,-12,12
Mumbai City,5234,1,7,4,3,18,9,9,25
NorthEast Un,5234,2,6,2,6,14,12,2,20
Kolkata,5234,3,4,7,3,15,14,1,19
FC Pune City,5234,4,5,4,5,14,15,-1,19
Delhi Dynamo,5234,5,4,6,4,24,19,5,18
Chennaiyin,5234,6,4,6,4,16,19,-3,18
Kerala Blast,5234,7,4,4,6,10,17,-7,16
FC Goa,5234,8,3,5,6,11,17,-6,14
Mumbai City,5235,1,7,4,3,19,9,10,25
Delhi Dynamo,5235,2,4,7,3,22,17,5,19
Kolkata,5235,3,3,9,2,17,16,1,18
NorthEast Un,5235,4,5,3,6,13,12,1,18
FC Pune City,5235,5,4,5,5,14,16,-2,17
Chennaiyin,5235,6,4,5,5,17,20,-3,17
Kerala Blast,5235,7,4,5,5,11,18,-7,17
FC Goa,5235,8,4,4,6,10,15,-5,16
Mumbai City,5236,1,6,4,4,17,10,7,22
Delhi Dynamo,5236,2,5,5,4,24,18,6,20
NorthEast Un,5236,3,5,4,5,10,9,1,19
FC Pune City,5236,4,5,4,5,14,14,0,19
Kerala Blast,5236,5,5,4,5,13,16,-3,19
FC Goa,5236,6,5,3,6,14,17,-3,18
Kolkata,5236,7,3,8,3,14,16,-2,17
Chennaiyin,5236,8,3,6,5,15,21,-6,15
Mumbai City,5237,1,6,5,3,18,10,8,23
NorthEast Un,5237,2,6,3,5,16,11,5,21
Kolkata,5237,3,5,6,3,18,17,1,21
Delhi Dynamo,5237,4,4,7,3,25,21,4,19
FC Goa,5237,5,5,3,6,14,17,-3,18
Kerala Blast,5237,6,4,5,5,13,18,-5,17
FC Pune City,5237,7,4,4,6,14,17,-3,16
Chennaiyin,5237,8,3,5,6,13,20,-7,14
Mumbai City,5238,1,6,5,3,18,10,8,23
Kerala Blast,5238,2,5,5,4,10,13,-3,20
Delhi Dynamo,5238,3,4,7,3,24,20,4,19
NorthEast Un,5238,4,5,4,5,13,10,3,19
Kolkata,5238,5,4,7,3,16,15,1,19
FC Pune City,5238,6,4,5,5,12,14,-2,17
FC Goa,5238,7,4,3,7,17,19,-2,15
Chennaiyin,5238,8,3,6,5,15,24,-9,15
Delhi Dynamo,5239,1,6,6,2,25,16,9,24
Kerala Blast,5239,2,7,3,4,18,17,1,24
Mumbai City,5239,3,6,4,4,16,9,7,22
Kolkata,5239,4,4,7,3,21,18,3,19
FC Pune City,5239,5,4,4,6,14,19,-5,16
NorthEast Un,5239,6,4,3,7,12,14,-2,15
FC Goa,5239,7,4,3,7,13,19,-6,15
Chennaiyin,5239,8,3,6,5,15,22,-7,15
Mumbai City,5240,1,7,4,3,20,8,12,25
Kerala Blast,5240,2,6,4,4,14,15,-1,22
NorthEast Un,5240,3,6,2,6,13,12,1,20
Delhi Dynamo,5240,4,4,6,4,23,21,2,18
FC Pune City,5240,5,5,3,6,15,18,-3,18
Kolkata,5240,6,3,7,4,14,16,-2,16
FC Goa,5240,7,4,4,6,12,16,-4,16
Chennaiyin,5240,8,3,6,5,14,19,-5,15
Mumbai City,5241,1,6,4,4,18,11,7,22
Delhi Dynamo,5241,2,5,6,3,25,18,7,21
Kolkata,5241,3,4,8,2,16,13,3,20
NorthEast Un,5241,4,5,4,5,12,11,1,19
FC Pune City,5241,5,5,4,5,14,15,-1,19
FC Goa,5241,6,4,4,6,14,17,-3,16
Kerala Blast,5241,7,4,4,6,11,18,-7,16
Chennaiyin,5241,8,3,6,5,15,22,-7,15
Mumbai City,5242,1,6,5,3,17,9,8,23
Delhi Dynamo,5242,2,5,6,3,25,21,4,21
NorthEast Un,5242,3,6,2,6,20,13,7,20
Kolkata,5242,4,4,7,3,19,18,1,19
Kerala Blast,5242,5,5,4,5,14,19,-5,19
FC Pune City,5242,6,4,5,5,14,16,-2,17
FC Goa,5242,7,4,3,7,14,19,-5,15
Chennaiyin,5242,8,3,6,5,16,24,-8,15
Mumbai City,5243,1,7,4,3,19,9,10,25
Delhi Dynamo,5243,2,6,5,3,29,19,10,23
FC Pune City,5243,3,5,4,5,14,15,-1,19
Kolkata,5243,4,4,6,4,17,17,0,18
FC Goa,5243,5,5,2,7,13,19,-6,17
Kerala Blast,5243,6,4,5,5,11,17,-6,17
NorthEast Un,5243,7,4,4,6,12,14,-2,16
Chennaiyin,5243,8,3,6,5,15,20,-5,15
Mumbai City,5244,1,7,4,3,20,8,12,25
Kerala Blast,5244,2,6,4,4,15,14,1,22
Delhi Dynamo,5244,3,5,5,4,23,19,4,20
Kolkata,5244,4,4,7,3,16,17,-1,19
Chennaiyin,5244,5,4,6,4,15,18,-3,18
NorthEast Un,5244,6,5,2,7,11,12,-1,17
FC Pune City,5244,7,4,4,6,12,16,-4,16
FC Goa,5244,8,3,4,7,8,16,-8,13
Mumbai City,5245,1,6,5,3,17,9,8,23
Delhi Dynamo,5245,2,5,6,3,25,17,8,21
Kolkata,5245,3,4,7,3,20,18,2,19
NorthEast Un,5245,4,5,4,5,11,10,1,19
Kerala Blast,5245,5,5,4,5,11,18,-7,19
FC Pune City,5245,6,4,4,6,15,18,-3,16
Chennaiyin,5245,7,3,7,4,14,18,-4,16
FC Goa,5245,8,4,3,7,13,18,-5,15
Mumbai City,5246,1,6,5,3,17,9,8,23
Delhi Dynamo,5246,2,5,7,2,24,15,9,22
Kolkata,5246,3,5,7,2,19,13,6,22
Chennaiyin,5246,4,4,6,4,14,17,-3,18
Kerala Blast,5246,5,5,3,6,13,17,-4,18
FC Pune City,5246,6,5,3,6,13,18,-5,18
NorthEast Un,5246,7,4,2,8,10,15,-5,14
FC Goa,5246,8,3,5,6,8,14,-6,14
Mumbai City,5247,1,7,4,3,18,8,10,25
Kolkata,5247,2,6,6,2,20,14,6,24
NorthEast Un,5247,3,7,2,5,14,9,5,23
Delhi Dynamo,5247,4,4,6,4,24,21,3,18
Kerala Blast,5247,5,5,3,6,11,18,-7,18
Chennaiyin,5247,6,4,5,5,17,20,-3,17
FC Pune City,5247,7,4,3,7,14,18,-4,15
FC Goa,5247,8,3,3,8,13,23,-10,12
Delhi Dynamo,5248,1,6,6,2,24,15,9,24
Kolkata,5248,2,6,6,2,20,13,7,24
Mumbai City,5248,3,6,4,4,16,9,7,22
Kerala Blast,5248,4,5,4,5,11,17,-6,19
NorthEast Un,5248,5,4,4,6,12,13,-1,16
FC Pune City,5248,6,4,4,6,13,16,-3,16
Chennaiyin,5248,7,3,7,4,14,18,-4,16
FC Goa,5248,8,3,3,8,8,17,-9,12
Delhi Dynamo,5249,1,6,6,2,31,18,13,24
Mumbai City,5249,2,6,4,4,17,10,7,22
FC Pune City,5249,3,6,3,5,17,17,0,21
Kerala Blast,5249,4,6,3,5,13,15,-2,21
Kolkata,5249,5,4,6,4,17,16,1,18
Chennaiyin,5249,6,4,5,5,17,20,-3,17
NorthEast Un,5249,7,4,3,7,11,16,-5,15
FC Goa,5249,8,4,2,8,12,23,-11,14
Mumbai City,5250,1,6,4,4,17,10,7,22
Delhi Dynamo,5250,2,5,5,4,24,20,4,20
NorthEast Un,5250,3,6,2,6,13,12,1,20
Kolkata,5250,4,4,7,3,15,13,2,19
FC Pune City,5250,5,5,4,5,13,14,-1,19
Chennaiyin,5250,6,4,6,4,16,18,-2,18
FC Goa,5250,7,4,4,6,13,16,-3,16
Kerala Blast,5250,8,4,4,6,10,18,-8,16
Mumbai City,5251,1,7,4,3,18,9,9,25
Kolkata,5251,2,6,6,2,21,14,7,24
Delhi Dynamo,5251,3,5,5,4,24,19,5,20
NorthEast Un,5251,4,5,4,5,13,11,2,19
FC Pune City,5251,5,5,3,6,15,18,-3,18
Chennaiyin,5251,6,3,7,4,15,19,-4,16
Kerala Blast,5251,7,4,4,6,12,18,-6,16
FC Goa,5251,8,3,3,8,10,20,-10,12
Mumbai City,5252,1,6,4,4,17,11,6,22
Delhi Dynamo,5252,2,5,6,3,24,17,7,21
NorthEast Un,5252,3,6,2,6,15,12,3,20
Kolkata,5252,4,4,7,3,16,14,2,19
FC Goa,5252,5,5,3,6,10,14,-4,18
FC Pune City,5252,6,4,5,5,12,14,-2,17
Chennaiyin,5252,7,4,5,5,15,18,-3,17
Kerala Blast,5252,8,4,4,6,11,20,-9,16
Delhi Dynamo,5253,1,6,5,3,25,17,8,23
Mumbai City,5253,2,6,4,4,17,10,7,22
Kerala Blast,5253,3,6,4,4,14,15,-1,22
FC Goa,5253,4,6,2,6,13,16,-3,20
Kolkata,5253,5,4,6,4,15,15,0,18
Chennaiyin,5253,6,4,5,5,15,19,-4,17
FC Pune City,5253,7,4,4,6,12,15,-3,16
NorthEast Un,5253,8,4,2,8,12,16,-4,14
Delhi Dynamo,5254,1,6,6,2,26,16,10,24
Mumbai City,5254,2,6,4,4,16,9,7,22
Kolkata,5254,3,5,6,3,20,16,4,21
Kerala Blast,5254,4,5,4,5,16,20,-4,19
FC Pune City,5254,5,5,3,6,15,19,-4,18
Chennaiyin,5254,6,4,5,5,18,20,-2,17
NorthEast Un,5254,7,4,4,6,14,18,-4,16
FC Goa,5254,8,4,2,8,11,18,-7,14
Mumbai City,5255,1,7,4,3,18,9,9,25
Delhi Dynamo,5255,2,6,5,3,26,17,9,23
Kolkata,5255,3,4,8,2,18,14,4,20
Chennaiyin,5255,4,5,5,4,16,17,-1,20
Kerala Blast,5255,5,5,4,5,13,19,-6,19
FC Pune City,5255,6,4,5,5,14,16,-2,17
NorthEast Un,5255,7,4,2,8,12,16,-4,14
FC Goa,5255,8,3,3,8,9,18,-9,12
Kolkata,5256,1,6,6,2,19,14,5,24
Mumbai City,5256,2,6,5,3,16,8,8,23
Delhi Dynamo,5256,3,4,8,2,23,16,7,20
NorthEast Un,5256,4,5,4,5,12,11,1,19
Kerala Blast,5256,5,5,4,5,13,18,-5,19
FC Pune City,5256,6,4,3,7,14,18,-4,15
FC Goa,5256,7,4,3,7,14,20,-6,15
Chennaiyin,5256,8,3,5,6,15,21,-6,14
Mumbai City,5257,1,7,4,3,18,9,9,25
Kerala Blast,5257,2,6,4,4,15,16,-1,22
Delhi Dynamo,5257,3,4,7,3,23,17,6,19
NorthEast Un,5257,4,5,4,5,14,12,2,19
FC Goa,5257,5,5,3,6,17,15,2,18
Kolkata,5257,6,3,7,4,16,19,-3,16
FC Pune City,5257,7,4,4,6,13,17,-4,16
Chennaiyin,5257,8,3,5,6,13,24,-11,14
Mumbai City,5258,1,6,4,4,17,11,6,22
Kerala Blast,5258,2,6,4,4,14,15,-1,22
Delhi Dynamo,5258,3,5,6,3,25,17,8,21
Kolkata,5258,4,3,9,2,17,16,1,18
FC Goa,5258,5,5,3,6,12,16,-4,18
NorthEast Un,5258,6,4,4,6,11,12,-1,16
FC Pune City,5258,7,4,4,6,13,17,-4,16
Chennaiyin,5258,8,3,6,5,15,20,-5,15
Mumbai City,5259,1,6,5,3,16,8,8,23
Delhi Dynamo,5259,2,5,6,3,24,16,8,21
Kerala Blast,5259,3,6,3,5,14,16,-2,21
Kolkata,5259,4,4,8,2,19,17,2,20
NorthEast Un,5259,5,6,2,6,14,13,1,20
Chennaiyin,5259,6,4,5,5,15,19,-4,17
FC Pune City,5259,7,4,4,6,16,19,-3,16
FC Goa,5259,8,3,3,8,10,20,-10,12
Delhi Dynamo,5260,1,6,5,3,27,17,10,23
Mumbai City,5260,2,6,4,4,16,9,7,22
Kerala Blast,5260,3,6,4,4,14,15,-1,22
Kolkata,5260,4,5,6,3,20,18,2,21
NorthEast Un,5260,5,6,3,5,12,10,2,21
FC Pune City,5260,6,4,3,7,14,19,-5,15
Chennaiyin,5260,7,3,5,6,13,19,-6,14
FC Goa,5260,8,4,2,8,11,20,-9,14
Delhi Dynamo,5261,1,5,7,2,23,15,8,22
Mumbai City,5261,2,6,4,4,16,9,7,22
Kolkata,5261,3,5,6,3,18,13,5,21
Kerala Blast,5261,4,6,3,5,12,16,-4,21
NorthEast Un,5261,5,5,3,6,11,11,0,18
FC Pune City,5261,6,5,3,6,13,16,-3,18
Chennaiyin,5261,7,4,5,5,14,18,-4,17
FC Goa,5261,8,3,3,8,8,17,-9,12
Mumbai City,5262,1,7,4,3,18,8,10,25
Delhi Dynamo,5262,2,5,6,3,25,19,6,21
Kolkata,5262,3,4,7,3,17,16,1,19
FC Pune City,5262,4,5,4,5,15,15,0,19
Kerala Blast,5262,5,5,3,6,11,17,-6,18
NorthEast Un,5262,6,5,2,7,12,13,-1,17
Chennaiyin,5262,7,4,5,5,16,22,-6,17
FC Goa,5262,8,4,3,7,15,19,-4,15
Delhi Dynamo,5263,1,6,5,3,27,18,9,23
Mumbai City,5263,2,6,4,4,16,12,4,22
Kerala Blast,5263,3,5,5,4,13,16,-3,20
NorthEast Un,5263,4,5,4,5,13,10,3,19
Kolkata,5263,5,4,6,4,16,16,0,18
Chennaiyin,5263,6,4,6,4,15,18,-3,18
FC Pune City,5263,7,4,4,6,15,18,-3,16
FC Goa,5263,8,4,2,8,10,17,-7,14
Kolkata,5264,1,6,6,2,17,13,4,24
Delhi Dynamo,5264,2,6,5,3,27,18,9,23
Mumbai City,5264,3,6,4,4,16,11,5,22
Kerala Blast,5264,4,6,3,5,15,17,-2,21
NorthEast Un,5264,5,6,2,6,15,13,2,20
FC Pune City,5264,6,4,3,7,12,17,-5,15
Chennaiyin,5264,7,3,5,6,13,19,-6,14
FC Goa,5264,8,4,2,8,10,17,-7,14
Mumbai City,5265,1,6,5,3,16,8,8,23
NorthEast Un,5265,2,7,2,5,15,12,3,23
Kolkata,5265,3,5,6,3,20,17,3,21
Delhi Dynamo,5265,4,4,6,4,22,17,5,18
FC Pune City,5265,5,5,3,6,16,17,-1,18
Kerala Blast,5265,6,5,3,6,12,18,-6,18
Chennaiyin,5265,7,3,6,5,16,21,-5,15
FC Goa,5265,8,4,3,7,12,19,-7,15
Mumbai City,5266,1,6,5,3,17,9,8,23
Kolkata,5266,2,5,7,2,18,15,3,22
Delhi Dynamo,5266,3,5,6,3,23,18,5,21
Chennaiyin,5266,4,5,5,4,17,18,-1,20
Kerala Blast,5266,5,5,3,6,15,19,-4,18
NorthEast Un,5266,6,5,2,7,12,13,-1,17
FC Pune City,5266,7,4,3,7,16,21,-5,15
FC Goa,5266,8,4,3,7,11,16,-5,15
Mumbai City,5267,1,7,4,3,17,8,9,25
Kerala Blast,5267,2,6,3,5,14,17,-3,21
Chennaiyin,5267,3,5,5,4,19,17,2,20
Kolkata,5267,4,4,7,3,19,18,1,19
Delhi Dynamo,5267,5,4,6,4,22,18,4,18
FC Pune City,5267,6,5,3,6,14,16,-2,18
NorthEast Un,5267,7,5,2,7,11,14,-3,17
FC Goa,5267,8,3,4,7,10,18,-8,13
Delhi Dynamo,5268,1,6,6,2,26,15,11,24
Mumbai City,5268,2,6,4,4,16,10,6,22
Kolkata,5268,3,5,7,2,18,15,3,22
NorthEast Un,5268,4,5,3,6,12,13,-1,18
Kerala Blast,5268,5,5,3,6,15,17,-2,18
Chennaiyin,5268,6,4,5,5,16,20,-4,17
FC Goa,5268,7,4,3,7,11,17,-6,15
FC Pune City,5268,8,4,3,7,12,19,-7,15
Mumbai City,5269,1,6,5,3,17,9,8,23
Kolkata,5269,2,5,6,3,19,14,5,21
Kerala Blast,5269,3,6,3,5,14,20,-6,21
Delhi Dynamo,5269,4,4,7,3,25,20,5,19
NorthEast Un,5269,5,5,3,6,13,12,1,18
FC Goa,5269,6,5,3,6,14,17,-3,18
Chennaiyin,5269,7,3,6,5,14,19,-5,15
FC Pune City,5269,7,4,3,7,14,19,-5,15
Mumbai City,5270,1,7,4,3,18,8,10,25
Kerala Blast,5270,2,6,4,4,14,16,-2,22
Delhi Dynamo,5270,3,4,6,4,23,19,4,18
FC Pune City,5270,4,5,3,6,15,17,-2,18
FC Goa,5270,5,5,3,6,11,15,-4,18
Kolkata,5270,6,3,8,3,16,16,0,17
NorthEast Un,5270,7,4,4,6,12,13,-1,16
Chennaiyin,5270,8,3,6,5,13,18,-5,15
Kolkata,5271,1,6,6,2,16,12,4,24
Mumbai City,5271,2,6,4,4,17,10,7,22
Delhi Dynamo,5271,3,5,6,3,24,18,6,21
NorthEast Un,5271,4,6,2,6,13,11,2,20
Kerala Blast,5271,5,5,4,5,11,15,-4,19
FC Pune City,5271,6,4,4,6,13,16,-3,16
FC Goa,5271,7,4,3,7,11,17,-6,15
Chennaiyin,5271,8,3,5,6,15,21,-6,14
Mumbai City,5272,1,7,4,3,20,8,12,25
Delhi Dynamo,5272,2,6,5,3,27,21,6,23
Kerala Blast,5272,3,6,4,4,13,14,-1,22
Kolkata,5272,4,4,8,2,18,15,3,20
Chennaiyin,5272,5,4,5,5,14,18,-4,17
FC Pune City,5272,6,4,4,6,13,16,-3,16
NorthEast Un,5272,7,4,2,8,12,16,-4,14
FC Goa,5272,8,4,2,8,10,19,-9,14
Mumbai City,5273,1,7,4,3,19,10,9,25
Kolkata,5273,2,5,6,3,17,15,2,21
Delhi Dynamo,5273,3,4,7,3,26,20,6,19
FC Pune City,5273,4,5,4,5,15,15,0,19
Chennaiyin,5273,5,4,6,4,17,20,-3,18
Kerala Blast,5273,6,4,5,5,11,16,-5,17
NorthEast Un,5273,7,4,4,6,12,13,-1,16
FC Goa,5273,8,3,4,7,11,19,-8,13
Mumbai City,5274,1,7,4,3,19,8,11,25
Delhi Dynamo,5274,2,5,6,3,24,18,6,21
Kerala Blast,5274,3,5,5,4,14,17,-3,20
FC Pune City,5274,4,5,3,6,15,16,-1,18
Chennaiyin,5274,5,4,5,5,18,22,-4,17
FC Goa,5274,6,5,2,7,13,18,-5,17
Kolkata,5274,7,3,7,4,15,17,-2,16
NorthEast Un,5274,8,4,4,6,14,16,-2,16
Mumbai City,5275,1,7,4,3,18,8,10,25
Delhi Dynamo,5275,2,6,5,3,25,17,8,23
Kolkata,5275,3,5,7,2,17,13,4,22
FC Pune City,5275,4,5,3,6,13,15,-2,18
Kerala Blast,5275,5,5,3,6,10,16,-6,18
NorthEast Un,5275,6,5,2,7,12,14,-2,17
Chennaiyin,5275,7,3,6,5,16,21,-5,15
FC Goa,5275,8,3,4,7,11,18,-7,13
Mumbai City,5276,1,7,4,3,21,8,13,25
Kolkata,5276,2,6,6,2,21,17,4,24
Delhi Dynamo,5276,3,6,5,3,26,20,6,23
Kerala Blast,5276,4,6,3,5,15,18,-3,21
Chennaiyin,5276,5,4,5,5,15,19,-4,17
FC Pune City,5276,6,4,3,7,17,21,-4,15
NorthEast Un,5276,7,4,2,8,13,16,-3,14
FC Goa,5276,8,4,2,8,9,18,-9,14
Mumbai City,5277,1,6,5,3,16,8,8,23
Kolkata,5277,2,5,6,3,18,17,1,21
Chennaiyin,5277,3,5,5,4,19,19,0,20
Kerala Blast,5277,4,5,4,5,12,16,-4,19
Delhi Dynamo,5277,5,4,6,4,23,18,5,18
NorthEast Un,5277,6,5,3,6,12,13,-1,18
FC Goa,5277,7,5,2,7,16,21,-5,17
FC Pune City,5277,8,4,3,7,14,18,-4,15
Mumbai City,5278,1,6,5,3,17,9,8,23
Kerala Blast,5278,2,6,4,4,15,16,-1,22
Delhi Dynamo,5278,3,5,6,3,23,17,6,21
NorthEast Un,5278,4,5,3,6,13,13,0,18
Chennaiyin,5278,5,4,6,4,17,18,-1,18
FC Pune City,5278,6,5,3,6,13,15,-2,18
Kolkata,5278,7,3,8,3,16,16,0,17
FC Goa,5278,8,3,3,8,9,19,-10,12
Mumbai City,5279,1,7,4,3,18,8,10,25
Delhi Dynamo,5279,2,6,5,3,25,17,8,23
Kolkata,5279,3,4,7,3,21,20,1,19
FC Pune City,5279,4,5,4,5,18,18,0,19
Chennaiyin,5279,5,4,6,4,15,18,-3,18
Kerala Blast,5279,6,4,6,4,14,18,-4,18
NorthEast Un,5279,7,4,3,7,10,12,-2,15
FC Goa,5279,8,3,3,8,12,22,-10,12
Delhi Dynamo,5280,1,6,6,2,25,15,10,24
Kolkata,5280,2,6,6,2,20,12,8,24
Mumbai City,5280,3,6,4,4,16,9,7,22
NorthEast Un,5280,4,5,3,6,11,12,-1,18
Chennaiyin,5280,5,4,6,4,14,17,-3,18
Kerala Blast,5280,6,5,3,6,14,18,-4,18
FC Pune City,5280,7,4,3,7,13,22,-9,15
FC Goa,5280,8,3,3,8,9,17,-8,12
Mumbai City,5281,1,6,5,3,17,9,8,23
NorthEast Un,5281,2,6,3,5,14,12,2,21
FC Pune City,5281,3,6,3,5,16,16,0,21
Delhi Dynamo,5281,4,4,6,4,24,19,5,18
Kolkata,5281,5,3,8,3,16,16,0,17
Chennaiyin,5281,6,3,7,4,16,20,-4,16
FC Goa,5281,7,4,4,6,14,19,-5,16
Kerala Blast,5281,8,4,4,6,11,17,-6,16
Delhi Dynamo,5282,1,6,6,2,28,19,9,24
Mumbai City,5282,2,6,4,4,17,10,7,22
Kolkata,5282,3,4,8,2,17,14,3,20
FC Pune City,5282,4,5,3,6,15,16,-1,18
Chennaiyin,5282,5,4,6,4,16,19,-3,18
NorthEast Un,5282,6,5,2,7,13,14,-1,17
Kerala Blast,5282,7,4,4,6,9,17,-8,16
FC Goa,5282,8,3,5,6,13,19,-6,14
Delhi Dynamo,5283,1,7,5,2,29,17,12,26
Mumbai City,5283,2,6,4,4,16,10,6,22
NorthEast Un,5283,3,6,2,6,14,13,1,20
Kerala Blast,5283,4,5,4,5,11,16,-5,19
Kolkata,5283,5,4,6,4,14,15,-1,18
Chennaiyin,5283,6,4,5,5,16,20,-4,17
FC Pune City,5283,7,4,4,6,12,15,-3,16
FC Goa,5283,8,4,2,8,14,20,-6,14
Mumbai City,5284,1,7,4,3,18,8,10,25
Kolkata,5284,2,5,6,3,16,14,2,21
NorthEast Un,5284,3,6,3,5,11,9,2,21
Delhi Dynamo,5284,4,5,5,4,22,17,5,20
Kerala Blast,5284,5,5,4,5,10,15,-5,19
FC Pune City,5284,6,4,3,7,12,16,-4,15
Chennaiyin,5284,7,3,6,5,13,18,-5,15
FC Goa,5284,8,4,3,7,10,15,-5,15
Mumbai City,5285,1,6,4,4,16,10,6,22
Delhi Dynamo,5285,2,5,6,3,25,17,8,21
FC Pune City,5285,3,6,3,5,17,15,2,21
Chennaiyin,5285,4,5,5,4,15,17,-2,20
Kerala Blast,5285,5,5,4,5,13,19,-6,19
NorthEast Un,5285,6,5,3,6,11,11,0,18
Kolkata,5285,7,3,6,5,16,18,-2,15
FC Goa,5285,8,4,3,7,11,17,-6,15
Kolkata,5286,1,6,6,2,18,13,5,24
Mumbai City,5286,2,6,4,4,18,11,7,22
Delhi Dynamo,5286,3,5,6,3,26,19,7,21
Kerala Blast,5286,4,5,4,5,10,14,-4,19
NorthEast Un,5286,5,5,2,7,12,13,-1,17
Chennaiyin,5286,6,4,5,5,16,20,-4,17
FC Pune City,5286,7,4,4,6,13,17,-4,16
FC Goa,5286,8,4,3,7,11,17,-6,15
Mumbai City,5287,1,7,4,3,18,8,10,25
Delhi Dynamo,5287,2,6,5,3,25,17,8,23
Kolkata,5287,3,4,7,3,15,14,1,19
Kerala Blast,5287,4,5,4,5,11,15,-4,19
Chennaiyin,5287,5,4,6,4,16,19,-3,18
NorthEast Un,5287,6,5,2,7,11,13,-2,17
FC Pune City,5287,7,4,3,7,12,16,-4,15
FC Goa,5287,8,4,3,7,11,17,-6,15
Mumbai City,5288,1,7,4,3,17,8,9,25
Kolkata,5288,2,5,6,3,17,15,2,21
Kerala Blast,5288,3,6,3,5,13,20,-7,21
NorthEast Un,5288,4,6,2,6,16,12,4,20
Delhi Dynamo,5288,5,4,6,4,23,18,5,18
Chennaiyin,5288,6,4,5,5,15,19,-4,17
FC Pune City,5288,7,4,3,7,12,16,-4,15
FC Goa,5288,8,4,3,7,13,18,-5,15
Delhi Dynamo,5289,1,6,5,3,26,18,8,23
Mumbai City,5289,2,6,4,4,17,10,7,22
Kerala Blast,5289,3,6,3,5,14,16,-2,21
Kolkata,5289,4,4,6,4,15,16,-1,18
NorthEast Un,5289,5,5,3,6,13,14,-1,18
FC Pune City,5289,6,5,3,6,13,15,-2,18
FC Goa,5289,7,5,2,7,14,18,-4,17
Chennaiyin,5289,8,3,6,5,16,21,-5,15
Kolkata,5290,1,6,6,2,19,13,6,24
Mumbai City,5290,2,6,5,3,17,9,8,23
NorthEast Un,5290,3,6,2,6,18,10,8,20
Delhi Dynamo,5290,4,4,7,3,23,19,4,19
Kerala Blast,5290,5,5,4,5,10,15,-5,19
FC Pune City,5290,6,4,4,6,12,15,-3,16
FC Goa,5290,7,4,3,7,12,18,-6,15
Chennaiyin,5290,8,3,5,6,13,25,-12,14
Delhi Dynamo,5291,1,6,6,2,27,17,10,24
Mumbai City,5291,2,6,5,3,16,8,8,23
NorthEast Un,5291,3,6,2,6,13,12,1,20
Kolkata,5291,4,4,7,3,19,15,4,19
Kerala Blast,5291,5,5,4,5,11,15,-4,19
FC Pune City,5291,6,5,3,6,15,17,-2,18
Chennaiyin,5291,7,4,5,5,16,19,-3,17
FC Goa,5291,8,3,2,9,11,25,-14,11
Mumbai City,5292,1,6,5,3,17,9,8,23
Delhi Dynamo,5292,2,5,6,3,25,19,6,21
Kolkata,5292,3,5,6,3,17,15,2,21
NorthEast Un,5292,4,6,2,6,17,13,4,20
FC Pune City,5292,5,5,3,6,14,16,-2,18
Kerala Blast,5292,6,5,3,6,13,19,-6,18
Chennaiyin,5292,7,4,5,5,14,20,-6,17
FC Goa,5292,8,4,2,8,11,17,-6,14
Mumbai City,5293,1,6,5,3,16,8,8,23
Kerala Blast,5293,2,6,4,4,14,15,-1,22
Delhi Dynamo,5293,3,5,6,3,24,17,7,21
Chennaiyin,5293,4,5,5,4,18,17,1,20
NorthEast Un,5293,5,5,3,6,13,13,0,18
Kolkata,5293,6,3,7,4,15,16,-1,16
FC Pune City,5293,7,4,4,6,13,17,-4,16
FC Goa,5293,8,4,2,8,11,21,-10,14
Mumbai City,5294,1,7,4,3,17,8,9,25
Kolkata,5294,2,5,7,2,18,12,6,22
Kerala Blast,5294,3,6,3,5,14,19,-5,21
Chennaiyin,5294,4,5,5,4,15,17,-2,20
Delhi Dynamo,5294,5,4,6,4,23,18,5,18
NorthEast Un,5294,6,5,2,7,12,13,-1,17
FC Pune City,5294,7,4,3,7,13,18,-5,15
FC Goa,5294,8,3,4,7,10,17,-7,13
Mumbai City,5295,1,6,5,3,17,9,8,23
Kolkata,5295,2,5,7,2,19,16,3,22
Delhi Dynamo,5295,3,4,7,3,26,21,5,19
NorthEast Un,5295,4,5,4,5,17,16,1,19
FC Pune City,5295,5,5,3,6,15,17,-2,18
FC Goa,5295,6,5,3,6,14,17,-3,18
Chennaiyin,5295,7,3,6,5,16,21,-5,15
Kerala Blast,5295,8,4,3,7,12,19,-7,15
Mumbai City,5296,1,6,5,3,17,9,8,23
FC Pune City,5296,2,5,4,5,18,17,1,19
NorthEast Un,5296,3,5,4,5,12,11,1,19
Kerala Blast,5296,4,5,4,5,13,19,-6,19
Delhi Dynamo,5296,5,4,6,4,23,18,5,18
FC Goa,5296,6,5,3,6,15,18,-3,18
Kolkata,5296,7,3,7,4,17,19,-2,16
Chennaiyin,5296,8,3,7,4,16,20,-4,16
Mumbai City,5297,1,6,5,3,17,9,8,23
Kolkata,5297,2,5,7,2,21,13,8,22
Delhi Dynamo,5297,3,5,6,3,25,17,8,21
NorthEast Un,5297,4,6,3,5,13,11,2,21
FC Pune City,5297,5,5,4,5,16,16,0,19
Chennaiyin,5297,6,4,5,5,17,18,-1,17
Kerala Blast,5297,7,4,4,6,11,22,-11,16
FC Goa,5297,8,3,2,9,8,22,-14,11
Mumbai City,5298,1,7,4,3,17,8,9,25
Delhi Dynamo,5298,2,4,7,3,23,17,6,19
Kolkata,5298,3,4,7,3,17,15,2,19
Kerala Blast,5298,4,5,4,5,12,16,-4,19
FC Goa,5298,5,5,3,6,14,17,-3,18
FC Pune City,5298,5,5,3,6,14,17,-3,18
NorthEast Un,5298,7,4,4,6,12,13,-1,16
Chennaiyin,5298,8,3,6,5,16,22,-6,15
Mumbai City,5299,1,7,4,3,18,9,9,25
Delhi Dynamo,5299,2,5,6,3,23,16,7,21
Kolkata,5299,3,5,6,3,17,16,1,21
NorthEast Un,5299,4,5,4,5,12,10,2,19
FC Pune City,5299,5,5,3,6,15,15,0,18
Chennaiyin,5299,6,4,6,4,15,18,-3,18
Kerala Blast,5299,7,5,3,6,13,18,-5,18
FC Goa,5299,8,3,2,9,8,19,-11,11
Mumbai City,5300,1,7,4,3,17,8,9,25
Kolkata,5300,2,5,7,2,20,15,5,22
Delhi Dynamo,5300,3,5,6,3,25,18,7,21
Kerala Blast,5300,4,5,4,5,13,18,-5,19
Chennaiyin,5300,5,4,6,4,18,20,-2,18
FC Pune City,5300,6,4,4,6,13,16,-3,16
NorthEast Un,5300,7,4,3,7,11,15,-4,15
FC Goa,5300,8,3,4,7,14,21,-7,13
Mumbai City,5301,1,7,4,3,18,9,9,25
NorthEast Un,5301,2,7,2,5,13,9,4,23
Kolkata,5301,3,5,7,2,24,17,7,22
Delhi Dynamo,5301,4,4,6,4,23,19,4,18
FC Pune City,5301,5,5,3,6,13,16,-3,18
Kerala Blast,5301,6,4,4,6,12,18,-6,16
FC Goa,5301,7,4,3,7,13,22,-9,15
Chennaiyin,5301,8,3,5,6,14,20,-6,14
Mumbai City,5302,1,7,4,3,17,8,9,25
Kerala Blast,5302,2,6,4,4,15,16,-1,22
Delhi Dynamo,5302,3,5,5,4,24,17,7,20
NorthEast Un,5302,4,6,2,6,12,11,1,20
FC Pune City,5302,5,5,4,5,15,16,-1,19
Kolkata,5302,6,3,6,5,14,17,-3,15
Chennaiyin,5302,7,3,6,5,16,22,-6,15
FC Goa,5302,8,4,3,7,14,20,-6,15
NorthEast Un,5303,1,7,2,5,14,9,5,23
Mumbai City,5303,2,6,4,4,17,10,7,22
Delhi Dynamo,5303,3,5,6,3,23,16,7,21
Kolkata,5303,4,5,6,3,19,15,4,21
Chennaiyin,5303,5,4,5,5,14,20,-6,17
FC Pune City,5303,6,4,4,6,12,16,-4,16
Kerala Blast,5303,7,4,4,6,10,17,-7,16
FC Goa,5303,8,4,3,7,10,16,-6,15
Mumbai City,5304,1,6,5,3,16,8,8,23
Delhi Dynamo,5304,2,5,6,3,28,18,10,21
NorthEast Un,5304,3,6,3,5,16,12,4,21
FC Pune City,5304,4,5,4,5,14,15,-1,19
Kerala Blast,5304,5,5,4,5,12,18,-6,19
Kolkata,5304,6,4,6,4,16,15,1,18
Chennaiyin,5304,7,3,6,5,13,19,-6,15
FC Goa,5304,8,4,2,8,10,20,-10,14
Mumbai City,5305,1,6,5,3,18,10,8,23
Delhi Dynamo,5305,2,5,6,3,29,20,9,21
Kerala Blast,5305,3,5,5,4,11,14,-3,20
NorthEast Un,5305,4,5,3,6,12,12,0,18
Kolkata,5305,5,4,6,4,17,18,-1,18
Chennaiyin,5305,6,4,5,5,15,19,-4,17
FC Goa,5305,7,5,2,7,15,21,-6,17
FC Pune City,5305,8,4,4,6,12,15,-3,16
Mumbai City,5306,1,6,5,3,20,12,8,23
Delhi Dynamo,5306,2,5,6,3,28,23,5,21
FC Pune City,5306,3,5,4,5,16,16,0,19
Kerala Blast,5306,4,5,4,5,14,18,-4,19
FC Goa,5306,5,5,3,6,16,17,-1,18
Chennaiyin,5306,6,4,6,4,17,19,-2,18
Kolkata,5306,7,4,6,4,15,17,-2,18
NorthEast Un,5306,8,4,2,8,13,17,-4,14
Mumbai City,5307,1,6,5,3,17,9,8,23
Kolkata,5307,2,5,7,2,16,13,3,22
NorthEast Un,5307,3,6,3,5,13,9,4,21
Kerala Blast,5307,4,5,4,5,13,15,-2,19
Delhi Dynamo,5307,5,4,6,4,22,17,5,18
FC Pune City,5307,6,4,4,6,14,19,-5,16
FC Goa,5307,7,4,3,7,10,16,-6,15
Chennaiyin,5307,8,3,6,5,14,21,-7,15
Delhi Dynamo,5308,1,6,5,3,28,19,9,23
Kolkata,5308,2,5,7,2,18,12,6,22
Mumbai City,5308,2,6,4,4,18,12,6,22
NorthEast Un,5308,4,6,3,5,13,11,2,21
FC Pune City,5308,5,5,4,5,13,14,-1,19
Kerala Blast,5308,6,4,4,6,10,16,-6,16
FC Goa,5308,7,4,2,8,14,21,-7,14
Chennaiyin,5308,8,3,5,6,14,23,-9,14
Mumbai City,5309,1,6,5,3,16,8,8,23
Delhi Dynamo,5309,2,5,7,2,23,14,9,22
Kolkata,5309,3,5,6,3,18,14,4,21
NorthEast Un,5309,4,5,4,5,11,9,2,19
Chennaiyin,5309,5,4,6,4,16,18,-2,18
Kerala Blast,5309,6,5,3,6,13,18,-5,18
FC Pune City,5309,7,4,3,7,12,19,-7,15
FC Goa,5309,8,4,2,8,10,19,-9,14
Mumbai City,5310,1,6,5,3,18,10,8,23
Delhi Dynamo,5310,2,5,6,3,28,20,8,21
Kolkata,5310,3,5,6,3,18,14,4,21
Kerala Blast,5310,4,6,3,5,14,18,-4,21
NorthEast Un,5310,5,6,2,6,15,13,2,20
Chennaiyin,5310,6,3,6,5,13,18,-5,15
FC Pune City,5310,6,4,3,7,13,18,-5,15
FC Goa,5310,8,4,3,7,10,18,-8,15
Mumbai City,5311,1,7,4,3,21,8,13,25
Delhi Dynamo,5311,2,5,6,3,22,19,3,21
Kolkata,5311,3,5,6,3,20,17,3,21
FC Pune City,5311,4,5,3,6,14,16,-2,18
Kerala Blast,5311,5,5,3,6,11,17,-6,18
FC Goa,5311,6,5,2,7,16,21,-5,17
NorthEast Un,5311,7,4,4,6,10,11,-1,16
Chennaiyin,5311,8,3,6,5,16,21,-5,15
Mumbai City,5312,1,7,4,3,19,9,10,25
NorthEast Un,5312,2,6,3,5,14,11,3,21
Delhi Dynamo,5312,3,5,5,4,26,22,4,20
Kerala Blast,5312,4,5,5,4,13,16,-3,20
Kolkata,5312,5,4,7,3,16,14,2,19
FC Pune City,5312,6,4,5,5,15,17,-2,17
FC Goa,5312,7,4,2,8,14,20,-6,14
Chennaiyin,5312,8,3,5,6,14,22,-8,14
Mumbai City,5313,1,6,5,3,17,9,8,23
Delhi Dynamo,5313,2,5,6,3,24,16,8,21
NorthEast Un,5313,3,6,3,5,13,11,2,21
Kolkata,5313,4,4,7,3,17,13,4,19
Kerala Blast,5313,5,5,4,5,13,16,-3,19
FC Goa,5313,6,5,2,7,11,17,-6,17
Chennaiyin,5313,7,3,6,5,14,19,-5,15
FC Pune City,5313,8,4,3,7,12,20,-8,15
Mumbai City,5314,1,7,4,3,20,10,10,25
Kolkata,5314,2,5,6,3,16,15,1,21
Delhi Dynamo,5314,3,5,5,4,25,20,5,20
NorthEast Un,5314,4,6,2,6,14,12,2,20
FC Pune City,5314,5,5,3,6,14,16,-2,18
Chennaiyin,5314,6,4,5,5,15,19,-4,17
FC Goa,5314,7,5,2,7,11,15,-4,17
Kerala Blast,5314,8,4,3,7,11,19,-8,15
Mumbai City,5315,1,7,4,3,18,9,9,25
Kerala Blast,5315,2,7,3,4,17,17,0,24
Delhi Dynamo,5315,3,6,5,3,28,16,12,23
Kolkata,5315,4,4,7,3,17,16,1,19
NorthEast Un,5315,5,5,2,7,14,14,0,17
FC Pune City,5315,6,4,3,7,12,16,-4,15
FC Goa,5315,7,4,3,7,10,20,-10,15
Chennaiyin,5315,8,3,5,6,13,21,-8,14
Mumbai City,5316,1,6,5,3,16,8,8,23
Delhi Dynamo,5316,2,5,7,2,26,16,10,22
Kerala Blast,5316,3,5,4,5,12,17,-5,19
Kolkata,5316,4,4,6,4,16,16,0,18
FC Pune City,5316,5,5,3,6,15,17,-2,18
Chennaiyin,5316,6,4,5,5,16,20,-4,17
FC Goa,5316,7,5,2,7,14,19,-5,17
NorthEast Un,5316,8,4,4,6,11,13,-2,16
Delhi Dynamo,5317,1,6,6,2,29,20,9,24
Mumbai City,5317,2,6,4,4,17,10,7,22
Kolkata,5317,3,4,7,3,18,16,2,19
FC Pune City,5317,4,5,4,5,14,15,-1,19
NorthEast Un,5317,5,5,3,6,13,13,0,18
FC Goa,5317,6,4,4,6,15,20,-5,16
Kerala Blast,5317,7,4,4,6,12,19,-7,16
Chennaiyin,5317,8,3,6,5,14,19,-5,15
Mumbai City,5318,1,7,4,3,18,9,9,25
Kerala Blast,5318,2,6,4,4,14,16,-2,22
Delhi Dynamo,5318,3,5,5,4,24,18,6,20
Kolkata,5318,4,4,7,3,18,16,2,19
NorthEast Un,5318,5,5,3,6,11,11,0,18
Chennaiyin,5318,6,4,6,4,14,17,-3,18
FC Pune City,5318,7,4,4,6,16,19,-3,16
FC Goa,5318,8,3,3,8,8,17,-9,12
Mumbai City,5319,1,7,4,3,19,10,9,25
Delhi Dynamo,5319,2,5,5,4,28,20,8,20
NorthEast Un,5319,3,6,2,6,12,10,2,20
Kolkata,5319,4,4,7,3,18,15,3,19
FC Pune City,5319,5,5,4,5,13,14,-1,19
Kerala Blast,5319,6,5,3,6,12,17,-5,18
Chennaiyin,5319,7,4,5,5,14,18,-4,17
FC Goa,5319,8,4,2,8,10,22,-12,14
Mumbai City,5320,1,7,4,3,17,8,9,25
Delhi Dynamo,5320,2,6,5,3,26,17,9,23
Kolkata,5320,3,4,8,2,17,15,2,20
Chennaiyin,5320,4,5,5,4,17,18,-1,20
FC Pune City,5320,5,5,4,5,16,16,0,19
Kerala Blast,5320,6,5,3,6,10,16,-6,18
NorthEast Un,5320,7,4,2,8,11,15,-4,14
FC Goa,5320,8,3,3,8,10,19,-9,12
Mumbai City,5321,1,7,4,3,19,9,10,25
Delhi Dynamo,5321,2,6,5,3,27,17,10,23
Kolkata,5321,3,5,6,3,17,14,3,21
NorthEast Un,5321,4,5,3,6,11,12,-1,18
Chennaiyin,5321,5,4,6,4,16,19,-3,18
FC Pune City,5321,6,4,4,6,13,17,-4,16
Kerala Blast,5321,7,4,4,6,10,17,-7,16
FC Goa,5321,8,4,2,8,11,19,-8,14
Mumbai City,5322,1,7,4,3,17,8,9,25
Kolkata,5322,2,5,6,3,15,16,-1,21
Kerala Blast,5322,3,6,3,5,12,14,-2,21
Delhi Dynamo,5322,4,4,6,4,22,18,4,18
FC Pune City,5322,5,5,3,6,16,15,1,18
Chennaiyin,5322,6,4,6,4,14,17,-3,18
NorthEast Un,5322,7,4,4,6,10,12,-2,16
FC Goa,5322,8,4,2,8,10,16,-6,14
Mumbai City,5323,1,7,4,3,18,9,9,25
Delhi Dynamo,5323,2,5,6,3,25,17,8,21
Kolkata,5323,3,5,6,3,15,15,0,21
NorthEast Un,5323,4,5,3,6,10,11,-1,18
Kerala Blast,5323,5,5,3,6,11,15,-4,18
FC Goa,5323,6,5,2,7,16,19,-3,17
Chennaiyin,5323,7,4,5,5,17,21,-4,17
FC Pune City,5323,8,4,3,7,12,17,-5,15
Mumbai City,5324,1,7,4,3,17,8,9,25
Kerala Blast,5324,2,6,4,4,12,14,-2,22
Delhi Dynamo,5324,3,5,5,4,26,17,9,20
Chennaiyin,5324,4,5,5,4,18,19,-1,20
NorthEast Un,5324,5,5,2,7,13,14,-1,17
FC Pune City,5324,6,4,5,5,13,15,-2,17
Kolkata,5324,7,3,7,4,16,17,-1,16
FC Goa,5324,8,4,2,8,10,21,-11,14
Mumbai City,5325,1,7,4,3,17,8,9,25
Kolkata,5325,2,5,7,2,16,13,3,22
Delhi Dynamo,5325,3,5,6,3,24,17,7,21
NorthEast Un,5325,4,6,3,5,16,13,3,21
FC Pune City,5325,5,5,3,6,14,16,-2,18
Chennaiyin,5325,6,3,6,5,14,20,-6,15
Kerala Blast,5325,7,4,3,7,13,20,-7,15
FC Goa,5325,8,3,4,7,9,16,-7,13
Mumbai City,5326,1,7,4,3,17,8,9,25
Kolkata,5326,2,6,6,2,23,13,10,24
Kerala Blast,5326,3,6,3,5,14,22,-8,21
Delhi Dynamo,5326,4,4,6,4,23,19,4,18
NorthEast Un,5326,5,5,3,6,15,14,1,18
Chennaiyin,5326,6,4,6,4,16,19,-3,18
FC Pune City,5326,7,4,3,7,15,19,-4,15
FC Goa,5326,8,3,3,8,9,18,-9,12
Delhi Dynamo,5327,1,6,5,3,27,18,9,23
Mumbai City,5327,2,6,4,4,17,10,7,22
Kerala Blast,5327,3,6,4,4,14,14,0,22
Kolkata,5327,4,4,8,2,18,15,3,20
NorthEast Un,5327,5,6,2,6,12,12,0,20
FC Pune City,5327,6,4,4,6,13,16,-3,16
Chennaiyin,5327,7,3,5,6,14,21,-7,14
FC Goa,5327,8,4,2,8,13,22,-9,14
Mumbai City,5328,1,7,4,3,18,8,10,25
FC Pune City,5328,2,6,3,5,17,15,2,21
Delhi Dynamo,5328,3,5,5,4,22,17,5,20
Kerala Blast,5328,4,5,4,5,14,19,-5,19
FC Goa,5328,5,5,3,6,12,16,-4,18
Kolkata,5328,6,3,8,3,16,16,0,17
NorthEast Un,5328,7,4,3,7,12,15,-3,15
Chennaiyin,5328,8,3,6,5,15,20,-5,15
Mumbai City,5329,1,7,4,3,18,9,9,25
Kolkata,5329,2,6,6,2,19,15,4,24
Delhi Dynamo,5329,3,5,5,4,25,19,6,20
NorthEast Un,5329,4,5,4,5,13,11,2,19
FC Pune City,5329,5,5,3,6,16,17,-1,18
Chennaiyin,5329,6,4,6,4,15,18,-3,18
Kerala Blast,5329,7,4,4,6,11,18,-7,16
FC Goa,5329,8,3,2,9,9,19,-10,11
Mumbai City,5330,1,7,4,3,18,8,10,25
Delhi Dynamo,5330,2,5,6,3,24,18,6,21
Kolkata,5330,3,5,6,3,17,13,4,21
NorthEast Un,5330,4,5,4,5,16,12,4,19
Kerala Blast,5330,5,5,3,6,10,18,-8,18
FC Goa,5330,6,5,2,7,11,15,-4,17
Chennaiyin,5330,7,3,6,5,14,20,-6,15
FC Pune City,5330,8,4,3,7,12,18,-6,15
Delhi Dynamo,5331,1,6,6,2,28,14,14,24
Mumbai City,5331,2,6,5,3,16,8,8,23
Kerala Blast,5331,3,6,4,4,14,16,-2,22
Kolkata,5331,4,4,7,3,19,16,3,19
Chennaiyin,5331,5,4,6,4,17,19,-2,18
FC Pune City,5331,6,5,3,6,16,18,-2,18
NorthEast Un,5331,7,4,3,7,10,14,-4,15
FC Goa,5331,8,3,2,9,10,25,-15,11
Mumbai City,5332,1,7,4,3,18,9,9,25
Delhi Dynamo,5332,2,5,6,3,28,19,9,21
Kerala Blast,5332,3,5,5,4,13,16,-3,20
NorthEast Un,5332,4,5,4,5,15,14,1,19
FC Pune City,5332,5,4,5,5,13,15,-2,17
Chennaiyin,5332,6,4,5,5,17,20,-3,17
Kolkata,5332,7,3,7,4,13,15,-2,16
FC Goa,5332,8,4,2,8,12,21,-9,14
Mumbai City,5333,1,6,5,3,17,9,8,23
NorthEast Un,5333,2,7,2,5,19,13,6,23
Delhi Dynamo,5333,3,5,6,3,28,22,6,21
Kerala Blast,5333,4,6,3,5,15,16,-1,21
Kolkata,5333,5,4,6,4,19,21,-2,18
FC Pune City,5333,6,4,3,7,16,21,-5,15
Chennaiyin,5333,7,3,6,5,15,21,-6,15
FC Goa,5333,8,4,3,7,13,19,-6,15
Mumbai City,5334,1,7,4,3,19,10,9,25
Delhi Dynamo,5334,2,5,5,4,26,21,5,20
FC Pune City,5334,3,5,4,5,17,18,-1,19
Kerala Blast,5334,4,5,4,5,16,20,-4,19
FC Goa,5334,5,5,2,7,17,18,-1,17
NorthEast Un,5334,6,5,2,7,13,14,-1,17
Kolkata,5334,7,3,8,3,19,22,-3,17
Chennaiyin,5334,8,4,5,5,18,22,-4,17
Mumbai City,5335,1,6,5,3,17,9,8,23
Kolkata,5335,2,5,7,2,21,14,7,22
NorthEast Un,5335,3,6,2,6,13,10,3,20
Delhi Dynamo,5335,4,4,6,4,23,21,2,18
Chennaiyin,5335,5,4,5,5,15,20,-5,17
FC Goa,5335,6,5,2,7,14,19,-5,17
Kerala Blast,5335,7,4,5,5,10,15,-5,17
FC Pune City,5335,8,4,4,6,13,18,-5,16
Mumbai City,5336,1,7,4,3,19,9,10,25
Kolkata,5336,2,6,6,2,16,12,4,24
Kerala Blast,5336,3,6,3,5,14,16,-2,21
Delhi Dynamo,5336,4,4,7,3,23,18,5,19
NorthEast Un,5336,5,4,4,6,12,13,-1,16
FC Goa,5336,6,4,3,7,13,15,-2,15
FC Pune City,5336,7,4,3,7,13,18,-5,15
Chennaiyin,5336,8,3,6,5,14,23,-9,15
Mumbai City,5337,1,7,4,3,18,9,9,25
Delhi Dynamo,5337,2,5,6,3,27,18,9,21
Kolkata,5337,3,5,6,3,17,15,2,21
Kerala Blast,5337,4,6,3,5,12,15,-3,21
Chennaiyin,5337,5,4,6,4,16,19,-3,18
NorthEast Un,5337,6,4,4,6,12,13,-1,16
FC Pune City,5337,7,4,3,7,13,18,-5,15
FC Goa,5337,8,4,2,8,12,20,-8,14
Mumbai City,5338,1,7,4,3,19,9,10,25
Kolkata,5338,2,6,6,2,19,13,6,24
Delhi Dynamo,5338,3,6,5,3,29,18,11,23
Kerala Blast,5338,4,5,4,5,12,16,-4,19
Chennaiyin,5338,5,4,6,4,17,20,-3,18
NorthEast Un,5338,6,4,4,6,12,14,-2,16
FC Pune City,5338,7,4,3,7,12,18,-6,15
FC Goa,5338,8,3,2,9,10,22,-12,11
Delhi Dynamo,5339,1,6,5,3,26,18,8,23
Mumbai City,5339,2,6,4,4,17,10,7,22
Kolkata,5339,3,5,6,3,15,13,2,21
Kerala Blast,5339,4,6,3,5,16,16,0,21
FC Pune City,5339,5,5,3,6,14,18,-4,18
NorthEast Un,5339,6,5,2,7,14,16,-2,17
Chennaiyin,5339,7,3,6,5,16,21,-5,15
FC Goa,5339,8,4,3,7,11,17,-6,15
Mumbai City,5340,1,7,4,3,20,8,12,25
Delhi Dynamo,5340,2,6,5,3,24,19,5,23
Kolkata,5340,3,4,7,3,15,14,1,19
Kerala Blast,5340,4,5,4,5,12,15,-3,19
Chennaiyin,5340,5,4,5,5,16,20,-4,17
FC Goa,5340,6,5,2,7,11,15,-4,17
FC Pune City,5340,7,4,4,6,13,17,-4,16
NorthEast Un,5340,8,4,3,7,12,15,-3,15
Kerala Blast,5341,1,7,3,4,16,16,0,24
Mumbai City,5341,2,6,5,3,17,9,8,23
Delhi Dynamo,5341,3,5,6,3,25,19,6,21
Kolkata,5341,4,5,6,3,21,16,5,21
NorthEast Un,5341,5,5,3,6,14,12,2,18
Chennaiyin,5341,6,4,6,4,15,18,-3,18
FC Pune City,5341,7,4,3,7,13,21,-8,15
FC Goa,5341,8,3,2,9,8,18,-10,11
Mumbai City,5342,1,7,4,3,17,8,9,25
Kerala Blast,5342,2,6,4,4,17,15,2,22
Delhi Dynamo,5342,3,5,6,3,25,18,7,21
NorthEast Un,5342,4,5,4,5,14,11,3,19
Kolkata,5342,5,3,8,3,14,15,-1,17
Chennaiyin,5342,6,4,5,5,16,21,-5,17
FC Pune City,5342,7,4,4,6,13,19,-6,16
FC Goa,5342,8,3,3,8,12,21,-9,12
Mumbai City,5343,1,6,5,3,16,8,8,23
Delhi Dynamo,5343,2,5,6,3,23,16,7,21
NorthEast Un,5343,3,6,3,5,13,10,3,21
Kolkata,5343,4,4,7,3,16,17,-1,19
Kerala Blast,5343,5,4,6,4,12,16,-4,18
FC Pune City,5343,6,4,4,6,15,18,-3,16
Chennaiyin,5343,7,3,6,5,15,20,-5,15
FC Goa,5343,8,4,3,7,12,17,-5,15
Mumbai City,5344,1,6,4,4,17,12,5,22
Kolkata,5344,2,5,6,3,19,18,1,21
Kerala Blast,5344,3,6,3,5,14,14,0,21
Delhi Dynamo,5344,4,5,5,4,26,19,7,20
NorthEast Un,5344,5,6,2,6,12,11,1,20
Chennaiyin,5344,6,4,6,4,15,18,-3,18
FC Pune City,5344,7,4,3,7,13,18,-5,15
FC Goa,5344,8,4,3,7,12,18,-6,15
Mumbai City,5345,1,7,4,3,18,9,9,25
Delhi Dynamo,5345,2,6,5,3,26,16,10,23
Kolkata,5345,3,5,7,2,17,13,4,22
Kerala Blast,5345,4,6,3,5,15,17,-2,21
NorthEast Un,5345,5,4,3,7,12,16,-4,15
Chennaiyin,5345,6,3,6,5,15,20,-5,15
FC Pune City,5345,7,4,3,7,14,19,-5,15
FC Goa,5345,8,4,3,7,10,17,-7,15
Mumbai City,5346,1,7,4,3,19,8,11,25
Delhi Dynamo,5346,2,5,5,4,24,19,5,20
FC Goa,5346,3,6,2,6,14,16,-2,20
Kerala Blast,5346,4,5,4,5,10,14,-4,19
NorthEast Un,5346,5,5,3,6,12,11,1,18
Kolkata,5346,6,4,6,4,14,14,0,18
FC Pune City,5346,7,5,3,6,13,15,-2,18
Chennaiyin,5346,8,3,5,6,14,23,-9,14
Mumbai City,5347,1,6,5,3,16,8,8,23
Delhi Dynamo,5347,2,5,6,3,27,21,6,21
Kolkata,5347,3,5,6,3,20,17,3,21
Kerala Blast,5347,4,6,3,5,13,16,-3,21
NorthEast Un,5347,5,6,2,6,14,13,1,20
FC Pune City,5347,6,5,3,6,14,16,-2,18
FC Goa,5347,7,4,2,8,16,22,-6,14
Chennaiyin,5347,8,3,5,6,14,21,-7,14
Mumbai City,5348,1,6,4,4,17,10,7,22
Delhi Dynamo,5348,2,5,6,3,24,17,7,21
Kerala Blast,5348,3,5,5,4,12,15,-3,20
NorthEast Un,5348,4,5,4,5,13,12,1,19
Kolkata,5348,5,3,9,2,15,14,1,18
Chennaiyin,5348,6,4,6,4,18,21,-3,18
FC Pune City,5348,7,4,4,6,13,16,-3,16
FC Goa,5348,8,3,4,7,11,18,-7,13
Mumbai City,5349,1,7,4,3,21,8,13,25
Delhi Dynamo,5349,2,5,5,4,25,23,2,20
NorthEast Un,5349,3,6,2,6,13,12,1,20
Kolkata,5349,4,4,7,3,17,17,0,19
Kerala Blast,5349,5,5,4,5,14,17,-3,19
FC Pune City,5349,6,5,3,6,14,16,-2,18
FC Goa,5349,7,5,2,7,16,19,-3,17
Chennaiyin,5349,8,3,5,6,14,22,-8,14
Mumbai City,5350,1,7,4,3,19,9,10,25
Delhi Dynamo,5350,2,5,6,3,26,20,6,21
Kolkata,5350,3,4,8,2,18,15,3,20
FC Pune City,5350,4,5,3,6,15,17,-2,18
Chennaiyin,5350,5,4,5,5,14,19,-5,17
Kerala Blast,5350,6,4,5,5,10,16,-6,17
NorthEast Un,5350,7,4,4,6,10,11,-1,16
FC Goa,5350,8,4,3,7,13,18,-5,15
Mumbai City,5351,1,6,4,4,18,11,7,22
Kolkata,5351,2,5,7,2,19,15,4,22
Delhi Dynamo,5351,3,5,5,4,24,20,4,20
NorthEast Un,5351,4,5,4,5,11,9,2,19
Kerala Blast,5351,5,4,6,4,10,14,-4,18
Chennaiyin,5351,6,3,7,4,14,18,-4,16
FC Pune City,5351,6,4,4,6,14,18,-4,16
FC Goa,5351,8,4,3,7,13,18,-5,15
Mumbai City,5352,1,6,5,3,17,9,8,23
Kolkata,5352,2,5,6,3,19,16,3,21
Delhi Dynamo,5352,3,4,7,3,23,17,6,19
FC Pune City,5352,4,5,4,5,16,17,-1,19
NorthEast Un,5352,5,5,3,6,11,11,0,18
Chennaiyin,5352,6,4,6,4,15,18,-3,18
Kerala Blast,5352,7,4,5,5,13,19,-6,17
FC Goa,5352,8,3,4,7,11,18,-7,13
Mumbai City,5353,1,7,4,3,20,8,12,25
Kolkata,5353,2,6,6,2,20,12,8,24
Delhi Dynamo,5353,3,5,6,3,24,20,4,21
NorthEast Un,5353,4,5,4,5,16,14,2,19
FC Pune City,5353,5,5,3,6,13,16,-3,18
Chennaiyin,5353,6,3,6,5,16,23,-7,15
Kerala Blast,5353,7,4,3,7,10,20,-10,15
FC Goa,5353,8,4,2,8,12,18,-6,14
Mumbai City,5354,1,7,4,3,18,8,10,25
FC Pune City,5354,2,5,4,5,17,17,0,19
Kolkata,5354,3,4,7,3,15,15,0,19
Delhi Dynamo,5354,4,4,6,4,23,19,4,18
NorthEast Un,5354,5,5,3,6,12,12,0,18
Chennaiyin,5354,6,4,6,4,16,19,-3,18
FC Goa,5354,7,4,4,6,11,16,-5,16
Kerala Blast,5354,8,4,4,6,11,17,-6,16
Mumbai City,5355,1,7,4,3,18,9,9,25
NorthEast Un,5355,2,6,3,5,16,11,5,21
Kolkata,5355,3,5,6,3,16,14,2,21
Kerala Blast,5355,4,6,3,5,14,18,-4,21
Delhi Dynamo,5355,5,4,6,4,24,20,4,18
FC Goa,5355,6,5,2,7,14,17,-3,17
FC Pune City,5355,7,4,3,7,12,17,-5,15
Chennaiyin,5355,8,3,5,6,14,22,-8,14
Mumbai City,5356,1,7,4,3,19,9,10,25
Delhi Dynamo,5356,2,5,6,3,27,20,7,21
Kerala Blast,5356,3,5,5,4,12,15,-3,20
NorthEast Un,5356,4,5,4,5,15,14,1,19
FC Pune City,5356,5,5,3,6,14,16,-2,18
Chennaiyin,5356,6,4,5,5,17,19,-2,17
Kolkata,5356,7,3,7,4,13,15,-2,16
FC Goa,5356,8,4,2,8,10,19,-9,14
Mumbai City,5357,1,6,4,4,16,11,5,22
Delhi Dynamo,5357,2,5,6,3,25,17,8,21
NorthEast Un,5357,3,6,2,6,15,12,3,20
Kolkata,5357,4,4,8,2,19,17,2,20
Kerala Blast,5357,5,5,4,5,13,18,-5,19
Chennaiyin,5357,6,4,5,5,19,24,-5,17
FC Pune City,5357,7,4,4,6,13,16,-3,16
FC Goa,5357,8,4,3,7,17,22,-5,15
Mumbai City,5358,1,7,4,3,18,9,9,25
Kerala Blast,5358,2,6,4,4,12,14,-2,22
Delhi Dynamo,5358,3,5,5,4,24,18,6,20
Kolkata,5358,4,4,7,3,15,14,1,19
FC Pune City,5358,5,4,4,6,12,15,-3,16
Chennaiyin,5358,6,3,7,4,13,17,-4,16
FC Goa,5358,7,4,4,6,11,16,-5,16
NorthEast Un,5358,8,4,3,7,10,12,-2,15
Delhi Dynamo,5359,1,5,7,2,26,18,8,22
Kolkata,5359,2,5,7,2,21,13,8,22
Mumbai City,5359,3,6,4,4,16,9,7,22
Kerala Blast,5359,4,6,3,5,12,18,-6,21
NorthEast Un,5359,5,4,4,6,11,12,-1,16
FC Pune City,5359,6,4,4,6,14,17,-3,16
Chennaiyin,5359,7,3,6,5,15,21,-6,15
FC Goa,5359,8,4,3,7,14,21,-7,15
Mumbai City,5360,1,7,4,3,19,9,10,25
Delhi Dynamo,5360,2,6,5,3,25,17,8,23
Kolkata,5360,3,5,6,3,19,16,3,21
Kerala Blast,5360,4,5,4,5,12,15,-3,19
Chennaiyin,5360,5,4,6,4,17,18,-1,18
FC Pune City,5360,6,4,4,6,14,20,-6,16
NorthEast Un,5360,7,4,3,7,10,13,-3,15
FC Goa,5360,8,4,2,8,11,19,-8,14
Mumbai City,5361,1,7,4,3,19,8,11,25
Chennaiyin,5361,2,5,5,4,20,18,2,20
NorthEast Un,5361,3,6,2,6,15,13,2,20
Delhi Dynamo,5361,4,5,5,4,22,21,1,20
FC Pune City,5361,5,5,4,5,15,14,1,19
Kerala Blast,5361,6,5,4,5,10,14,-4,19
Kolkata,5361,7,3,7,4,15,18,-3,16
FC Goa,5361,8,3,3,8,10,20,-10,12
Delhi Dynamo,5362,1,7,5,2,28,15,13,26
Mumbai City,5362,2,6,4,4,17,10,7,22
Kerala Blast,5362,3,6,4,4,13,14,-1,22
Kolkata,5362,4,4,7,3,15,13,2,19
NorthEast Un,5362,5,4,4,6,10,13,-3,16
Chennaiyin,5362,6,3,7,4,13,17,-4,16
FC Pune City,5362,7,4,3,7,12,18,-6,15
FC Goa,5362,8,3,4,7,8,16,-8,13
Kolkata,5363,1,6,6,2,18,13,5,24
Mumbai City,5363,2,6,5,3,17,9,8,23
Delhi Dynamo,5363,3,5,6,3,25,19,6,21
NorthEast Un,5363,4,5,3,6,13,12,1,18
Chennaiyin,5363,5,4,5,5,15,20,-5,17
Kerala Blast,5363,6,4,5,5,10,15,-5,17
FC Pune City,5363,7,4,4,6,13,17,-4,16
FC Goa,5363,8,4,2,8,12,18,-6,14
Mumbai City,5364,1,7,4,3,19,8,11,25
Kerala Blast,5364,2,6,4,4,13,14,-1,22
Delhi Dynamo,5364,3,4,7,3,22,18,4,19
FC Pune City,5364,4,5,4,5,13,14,-1,19
Kolkata,5364,5,4,6,4,17,15,2,18
NorthEast Un,5364,6,4,4,6,11,13,-2,16
FC Goa,5364,7,4,3,7,12,17,-5,15
Chennaiyin,5364,8,3,6,5,14,22,-8,15
Mumbai City,5365,1,7,4,3,17,8,9,25
Delhi Dynamo,5365,2,5,6,3,27,16,11,21
NorthEast Un,5365,3,5,4,5,17,13,4,19
FC Pune City,5365,4,5,4,5,16,17,-1,19
Kolkata,5365,5,4,6,4,17,17,0,18
FC Goa,5365,6,5,2,7,13,22,-9,17
Kerala Blast,5365,7,4,4,6,12,21,-9,16
Chennaiyin,5365,8,3,6,5,16,21,-5,15
Mumbai City,5366,1,7,4,3,20,8,12,25
NorthEast Un,5366,2,6,2,6,17,14,3,20
Kerala Blast,5366,3,5,4,5,15,21,-6,19
Chennaiyin,5366,4,4,6,4,17,19,-2,18
FC Pune City,5366,5,5,3,6,15,17,-2,18
FC Goa,5366,6,5,3,6,14,16,-2,18
Delhi Dynamo,5366,7,4,5,5,22,22,0,17
Kolkata,5366,8,3,7,4,16,19,-3,16
Mumbai City,5367,1,7,4,3,18,8,10,25
Delhi Dynamo,5367,2,5,6,3,23,17,6,21
FC Pune City,5367,3,6,3,5,18,15,3,21
Kerala Blast,5367,4,5,4,5,11,17,-6,19
NorthEast Un,5367,5,5,3,6,12,12,0,18
Kolkata,5367,6,3,8,3,16,17,-1,17
FC Goa,5367,7,4,3,7,12,17,-5,15
Chennaiyin,5367,8,3,5,6,15,22,-7,14
Mumbai City,5368,1,7,4,3,18,9,9,25
Kolkata,5368,2,5,7,2,18,14,4,22
Delhi Dynamo,5368,3,5,6,3,26,17,9,21
Chennaiyin,5368,4,5,5,4,17,18,-1,20
Kerala Blast,5368,5,5,4,5,14,18,-4,19
FC Pune City,5368,6,4,4,6,15,19,-4,16
NorthEast Un,5368,7,4,3,7,10,12,-2,15
FC Goa,5368,8,3,3,8,10,21,-11,12
Kolkata,5369,1,6,6,2,19,14,5,24
Delhi Dynamo,5369,2,6,5,3,26,18,8,23
Mumbai City,5369,3,6,4,4,17,10,7,22
NorthEast Un,5369,4,6,2,6,13,12,1,20
Kerala Blast,5369,5,5,3,6,12,17,-5,18
Chennaiyin,5369,6,4,5,5,17,20,-3,17
FC Pune City,5369,7,4,3,7,14,18,-4,15
FC Goa,5369,8,4,2,8,11,20,-9,14
Mumbai City,5370,1,6,5,3,16,8,8,23
Delhi Dynamo,5370,2,4,8,2,24,17,7,20
Kerala Blast,5370,3,5,4,5,11,16,-5,19
NorthEast Un,5370,4,5,3,6,13,12,1,18
FC Pune City,5370,5,5,3,6,14,16,-2,18
Chennaiyin,5370,6,4,6,4,16,19,-3,18
Kolkata,5370,7,3,8,3,15,15,0,17
FC Goa,5370,8,3,5,6,11,17,-6,14
Mumbai City,5371,1,7,4,3,17,8,9,25
Kolkata,5371,2,5,7,2,16,12,4,22
Kerala Blast,5371,3,6,3,5,15,15,0,21
Delhi Dynamo,5371,4,5,5,4,24,18,6,20
FC Goa,5371,5,5,3,6,12,15,-3,18
Chennaiyin,5371,6,4,5,5,14,19,-5,17
FC Pune City,5371,7,4,3,7,12,17,-5,15
NorthEast Un,5371,8,4,2,8,11,17,-6,14
Mumbai City,5372,1,7,4,3,18,8,10,25
Kolkata,5372,2,6,6,2,17,12,5,24
Delhi Dynamo,5372,3,6,5,3,25,17,8,23
Chennaiyin,5372,4,4,5,5,15,19,-4,17
Kerala Blast,5372,5,4,5,5,12,18,-6,17
FC Pune City,5372,6,4,4,6,13,16,-3,16
NorthEast Un,5372,7,4,3,7,13,15,-2,15
FC Goa,5372,8,4,2,8,9,17,-8,14
Kolkata,5373,1,6,6,2,19,15,4,24
Mumbai City,5373,2,6,5,3,17,9,8,23
Kerala Blast,5373,3,6,3,5,16,17,-1,21
Delhi Dynamo,5373,4,4,8,2,25,18,7,20
NorthEast Un,5373,5,4,4,6,14,16,-2,16
Chennaiyin,5373,6,3,6,5,16,21,-5,15
FC Pune City,5373,7,4,3,7,12,17,-5,15
FC Goa,5373,8,4,3,7,12,18,-6,15
Mumbai City,5374,1,7,4,3,19,9,10,25
Delhi Dynamo,5374,2,6,5,3,25,18,7,23
Kolkata,5374,3,4,8,2,21,14,7,20
FC Pune City,5374,4,5,4,5,16,16,0,19
Kerala Blast,5374,5,5,3,6,11,22,-11,18
Chennaiyin,5374,6,3,7,4,15,19,-4,16
NorthEast Un,5374,7,4,3,7,12,14,-2,15
FC Goa,5374,8,3,4,7,9,16,-7,13
Mumbai City,5375,1,6,5,3,16,8,8,23
FC Pune City,5375,2,6,3,5,15,15,0,21
Delhi Dynamo,5375,3,4,7,3,21,15,6,19
Kolkata,5375,4,4,7,3,15,14,1,19
NorthEast Un,5375,5,5,4,5,13,12,1,19
Chennaiyin,5375,6,3,7,4,17,21,-4,16
Kerala Blast,5375,7,4,4,6,9,15,-6,16
FC Goa,5375,8,3,5,6,9,15,-6,14
Delhi Dynamo,5376,1,7,5,2,31,17,14,26
Mumbai City,5376,2,6,4,4,17,11,6,22
Kolkata,5376,3,4,8,2,17,12,5,20
Kerala Blast,5376,4,5,4,5,13,19,-6,19
NorthEast Un,5376,5,4,4,6,12,13,-1,16
Chennaiyin,5376,6,3,7,4,14,18,-4,16
FC Pune City,5376,7,4,4,6,12,16,-4,16
FC Goa,5376,8,3,4,7,10,20,-10,13
Delhi Dynamo,5377,1,6,5,3,26,17,9,23
Mumbai City,5377,2,6,4,4,17,10,7,22
Kolkata,5377,3,5,6,3,19,17,2,21
Chennaiyin,5377,4,5,5,4,15,17,-2,20
FC Pune City,5377,5,5,3,6,15,19,-4,18
Kerala Blast,5377,6,5,3,6,12,17,-5,18
NorthEast Un,5377,7,5,2,7,11,12,-1,17
FC Goa,5377,8,4,2,8,11,17,-6,14
Mumbai City,5378,1,6,4,4,17,10,7,22
Delhi Dynamo,5378,2,5,6,3,24,17,7,21
FC Pune City,5378,3,5,4,5,17,16,1,19
NorthEast Un,5378,4,5,4,5,10,9,1,19
FC Goa,5378,5,5,3,6,15,15,0,18
Kolkata,5378,6,3,8,3,16,16,0,17
Kerala Blast,5378,7,4,5,5,10,17,-7,17
Chennaiyin,5378,8,3,6,5,13,22,-9,15
Mumbai City,5379,1,7,4,3,20,9,11,25
Kerala Blast,5379,2,6,3,5,14,17,-3,21
Delhi Dynamo,5379,3,5,5,4,25,21,4,20
Kolkata,5379,4,4,7,3,17,16,1,19
FC Pune City,5379,5,5,3,6,15,16,-1,18
Chennaiyin,5379,6,4,6,4,15,18,-3,18
NorthEast Un,5379,7,5,2,7,12,12,0,17
FC Goa,5379,8,3,4,7,10,19,-9,13
Mumbai City,5380,1,6,4,4,16,9,7,22
Delhi Dynamo,5380,2,5,6,3,23,16,7,21
Kolkata,5380,3,4,8,2,18,16,2,20
FC Pune City,5380,4,5,4,5,16,17,-1,19
Kerala Blast,5380,5,5,3,6,11,16,-5,18
NorthEast Un,5380,6,5,2,7,11,12,-1,17
Chennaiyin,5380,7,4,5,5,15,19,-4,17
FC Goa,5380,8,4,4,6,12,17,-5,16
Mumbai City,5381,1,7,4,3,19,8,11,25
Kolkata,5381,2,4,8,2,18,16,2,20
Delhi Dynamo,5381,3,4,7,3,24,20,4,19
NorthEast Un,5381,4,5,3,6,13,13,0,18
Chennaiyin,5381,5,4,5,5,15,19,-4,17
Kerala Blast,5381,6,4,5,5,13,19,-6,17
FC Pune City,5381,7,4,4,6,13,16,-3,16
FC Goa,5381,8,4,4,6,12,16,-4,16
Delhi Dynamo,5382,1,6,6,2,28,17,11,24
Mumbai City,5382,2,6,4,4,17,10,7,22
Kolkata,5382,3,4,8,2,17,14,3,20
Kerala Blast,5382,4,5,5,4,13,16,-3,20
NorthEast Un,5382,5,5,3,6,14,14,0,18
FC Pune City,5382,6,4,4,6,12,16,-4,16
FC Goa,5382,7,4,3,7,10,17,-7,15
Chennaiyin,5382,8,3,5,6,14,21,-7,14
Mumbai City,5383,1,6,5,3,17,9,8,23
Delhi Dynamo,5383,2,5,6,3,25,17,8,21
Kolkata,5383,3,5,6,3,17,15,2,21
NorthEast Un,5383,4,6,3,5,14,12,2,21
Kerala Blast,5383,5,5,4,5,13,18,-5,19
FC Pune City,5383,6,4,3,7,14,18,-4,15
Chennaiyin,5383,7,3,6,5,14,19,-5,15
FC Goa,5383,8,4,3,7,11,17,-6,15
Mumbai City,5384,1,6,5,3,16,8,8,23
Delhi Dynamo,5384,2,5,7,2,25,17,8,22
Kerala Blast,5384,3,6,4,4,12,14,-2,22
Kolkata,5384,4,4,6,4,15,15,0,18
NorthEast Un,5384,5,5,3,6,12,12,0,18
FC Goa,5384,6,5,2,7,12,17,-5,17
FC Pune City,5384,7,4,4,6,12,15,-3,16
Chennaiyin,5384,8,3,5,6,14,20,-6,14
Mumbai City,5385,1,7,4,3,20,8,12,25
Delhi Dynamo,5385,2,5,5,4,27,22,5,20
Kolkata,5385,3,4,8,2,19,16,3,20
NorthEast Un,5385,4,5,4,5,15,13,2,19
Kerala Blast,5385,5,4,6,4,13,17,-4,18
FC Pune City,5385,6,4,4,6,14,18,-4,16
Chennaiyin,5385,7,3,6,5,14,20,-6,15
FC Goa,5385,8,4,3,7,13,21,-8,15
Mumbai City,5386,1,7,4,3,17,8,9,25
Delhi Dynamo,5386,2,6,5,3,27,18,9,23
Kerala Blast,5386,3,6,4,4,13,15,-2,22
Kolkata,5386,4,4,6,4,16,16,0,18
FC Goa,5386,5,5,2,7,15,19,-4,17
Chennaiyin,5386,6,4,5,5,15,21,-6,17
NorthEast Un,5386,7,4,3,7,13,15,-2,15
FC Pune City,5386,8,4,3,7,13,17,-4,15
Mumbai City,5387,1,7,4,3,17,8,9,25
Delhi Dynamo,5387,2,4,7,3,24,18,6,19
Kerala Blast,5387,3,5,4,5,12,16,-4,19
Kolkata,5387,4,4,6,4,15,15,0,18
FC Pune City,5387,5,5,3,6,14,16,-2,18
Chennaiyin,5387,6,4,6,4,16,19,-3,18
NorthEast Un,5387,7,4,5,5,10,10,0,17
FC Goa,5387,8,4,3,7,13,19,-6,15
Mumbai City,5388,1,6,5,3,17,9,8,23
Delhi Dynamo,5388,2,5,6,3,23,17,6,21
Kerala Blast,5388,3,6,3,5,16,16,0,21
NorthEast Un,5388,4,6,2,6,17,15,2,20
Kolkata,5388,5,4,7,3,16,14,2,19
FC Pune City,5388,6,4,4,6,12,16,-4,16
FC Goa,5388,7,4,3,7,11,17,-6,15
Chennaiyin,5388,8,3,6,5,15,23,-8,15
Delhi Dynamo,5389,1,6,6,2,25,15,10,24
Mumbai City,5389,2,6,4,4,16,9,7,22
Kerala Blast,5389,3,6,4,4,12,13,-1,22
FC Pune City,5389,4,5,4,5,14,14,0,19
Chennaiyin,5389,5,4,6,4,16,18,-2,18
Kolkata,5389,6,3,7,4,14,16,-2,16
FC Goa,5389,7,3,5,6,10,16,-6,14
NorthEast Un,5389,7,4,2,8,10,16,-6,14
Mumbai City,5390,1,6,4,4,17,10,7,22
Delhi Dynamo,5390,2,5,6,3,23,16,7,21
Kolkata,5390,3,5,6,3,15,14,1,21
Kerala Blast,5390,4,6,3,5,13,16,-3,21
FC Goa,5390,5,6,2,6,15,15,0,20
NorthEast Un,5390,6,4,4,6,11,12,-1,16
FC Pune City,5390,7,4,3,7,13,17,-4,15
Chennaiyin,5390,8,3,6,5,15,22,-7,15
Mumbai City,5391,1,7,4,3,17,8,9,25
Kerala Blast,5391,2,7,3,4,18,17,1,24
Delhi Dynamo,5391,3,5,5,4,23,18,5,20
NorthEast Un,5391,4,6,2,6,14,13,1,20
Kolkata,5391,5,3,8,3,15,15,0,17
FC Pune City,5391,6,4,4,6,14,18,-4,16
FC Goa,5391,7,4,3,7,11,17,-6,15
Chennaiyin,5391,8,3,5,6,14,20,-6,14
Mumbai City,5392,1,6,5,3,19,11,8,23
Delhi Dynamo,5392,2,5,6,3,27,20,7,21
Kolkata,5392,3,5,6,3,18,17,1,21
FC Pune City,5392,4,5,3,6,17,19,-2,18
FC Goa,5392,5,5,3,6,13,16,-3,18
NorthEast Un,5392,6,4,4,6,13,14,-1,16
Chennaiyin,5392,7,3,7,4,17,21,-4,16
Kerala Blast,5392,8,4,4,6,12,18,-6,16
Mumbai City,5393,1,6,5,3,17,9,8,23
Kolkata,5393,2,4,8,2,21,19,2,20
Delhi Dynamo,5393,3,4,7,3,24,18,6,19
Kerala Blast,5393,4,5,4,5,14,18,-4,19
Chennaiyin,5393,5,4,6,4,16,19,-3,18
FC Pune City,5393,6,4,5,5,15,17,-2,17
NorthEast Un,5393,7,4,4,6,12,13,-1,16
FC Goa,5393,8,4,3,7,12,18,-6,15
Mumbai City,5394,1,6,5,3,18,10,8,23
Delhi Dynamo,5394,2,5,7,2,27,18,9,22
Kerala Blast,5394,3,6,3,5,14,16,-2,21
Kolkata,5394,4,4,7,3,18,19,-1,19
FC Goa,5394,5,5,3,6,16,15,1,18
Chennaiyin,5394,6,4,5,5,14,20,-6,17
FC Pune City,5394,7,4,4,6,14,19,-5,16
NorthEast Un,5394,8,4,2,8,10,14,-4,14
Mumbai City,5395,1,7,4,3,19,9,10,25
Kolkata,5395,2,4,8,2,19,14,5,20
Delhi Dynamo,5395,3,5,5,4,23,19,4,20
NorthEast Un,5395,4,6,2,6,14,12,2,20
Kerala Blast,5395,5,5,3,6,14,20,-6,18
Chennaiyin,5395,6,4,5,5,15,18,-3,17
FC Pune City,5395,7,4,4,6,13,19,-6,16
FC Goa,5395,8,4,3,7,10,16,-6,15
Mumbai City,5396,1,7,4,3,20,9,11,25
Kolkata,5396,2,5,6,3,16,13,3,21
Delhi Dynamo,5396,3,5,5,4,26,22,4,20
NorthEast Un,5396,4,6,2,6,16,14,2,20
FC Pune City,5396,5,5,3,6,13,15,-2,18
Chennaiyin,5396,6,4,5,5,15,20,-5,17
FC Goa,5396,7,5,2,7,11,16,-5,17
Kerala Blast,5396,8,4,3,7,10,18,-8,15
Mumbai City,5397,1,7,4,3,17,8,9,25
Delhi Dynamo,5397,2,5,5,4,28,17,11,20
Kerala Blast,5397,3,5,5,4,11,14,-3,20
NorthEast Un,5397,4,5,3,6,11,11,0,18
FC Pune City,5397,5,5,3,6,13,15,-2,18
Chennaiyin,5397,6,4,6,4,14,17,-3,18
Kolkata,5397,7,3,8,3,15,15,0,17
FC Goa,5397,8,3,4,7,9,21,-12,13
Delhi Dynamo,5398,1,6,6,2,32,16,16,24
Kolkata,5398,2,6,6,2,20,16,4,24
Mumbai City,5398,3,6,5,3,17,9,8,23
FC Pune City,5398,4,5,3,6,15,17,-2,18
NorthEast Un,5398,5,5,2,7,11,14,-3,17
Chennaiyin,5398,6,4,5,5,14,18,-4,17
Kerala Blast,5398,7,4,3,7,12,20,-8,15
FC Goa,5398,8,4,2,8,11,22,-11,14
Mumbai City,5399,1,7,4,3,19,9,10,25
Delhi Dynamo,5399,2,5,5,4,26,21,5,20
Kerala Blast,5399,3,5,5,4,14,16,-2,20
Kolkata,5399,4,3,9,2,15,14,1,18
NorthEast Un,5399,5,5,2,7,14,15,-1,17
FC Pune City,5399,6,4,5,5,13,15,-2,17
Chennaiyin,5399,7,4,5,5,16,21,-5,17
FC Goa,5399,8,4,3,7,11,17,-6,15
Mumbai City,5400,1,6,5,3,17,9,8,23
Delhi Dynamo,5400,2,5,6,3,25,17,8,21
FC Pune City,5400,3,6,3,5,19,15,4,21
NorthEast Un,5400,4,6,2,6,14,11,3,20
Chennaiyin,5400,5,5,5,4,16,17,-1,20
Kolkata,5400,6,4,6,4,17,17,0,18
Kerala Blast,5400,7,5,3,6,11,21,-10,18
FC Goa,5400,8,3,2,9,8,20,-12,11
Mumbai City,5401,1,7,4,3,18,9,9,25
Kerala Blast,5401,2,6,4,4,12,14,-2,22
Kolkata,5401,3,5,6,3,16,13,3,21
Delhi Dynamo,5401,4,5,5,4,25,18,7,20
NorthEast Un,5401,5,6,2,6,13,12,1,20
FC Pune City,5401,6,4,4,6,12,16,-4,16
FC Goa,5401,7,4,2,8,13,18,-5,14
Chennaiyin,5401,8,3,5,6,14,23,-9,14
Mumbai City,5402,1,7,4,3,17,8,9,25
Delhi Dynamo,5402,2,5,6,3,23,16,7,21
Kerala Blast,5402,3,6,3,5,11,14,-3,21
NorthEast Un,5402,4,6,2,6,14,13,1,20
Kolkata,5402,5,4,7,3,18,16,2,19
Chennaiyin,5402,6,4,5,5,17,20,-3,17
FC Pune City,5402,7,4,3,7,12,17,-5,15
FC Goa,5402,8,3,4,7,11,19,-8,13
Mumbai City,5403,1,7,4,3,19,9,10,25
Kolkata,5403,2,5,7,2,19,13,6,22
Kerala Blast,5403,3,6,3,5,15,18,-3,21
Delhi Dynamo,5403,4,5,5,4,26,20,6,20
NorthEast Un,5403,5,6,2,6,14,12,2,20
Chennaiyin,5403,6,4,5,5,15,19,-4,17
FC Pune City,5403,7,4,3,7,14,20,-6,15
FC Goa,5403,8,3,3,8,9,20,-11,12
Mumbai City,5404,1,7,4,3,19,8,11,25
Delhi Dynamo,5404,2,6,5,3,24,17,7,23
FC Pune City,5404,3,5,4,5,14,15,-1,19
Kerala Blast,5404,4,4,6,4,11,15,-4,18
Kolkata,5404,5,3,8,3,14,14,0,17
Chennaiyin,5404,6,4,5,5,16,19,-3,17
NorthEast Un,5404,7,4,3,7,10,14,-4,15
FC Goa,5404,8,4,3,7,11,17,-6,15
Delhi Dynamo,5405,1,6,6,2,27,16,11,24
Mumbai City,5405,2,6,5,3,18,10,8,23
Kolkata,5405,3,4,7,3,15,13,2,19
FC Pune City,5405,4,5,4,5,13,14,-1,19
NorthEast Un,5405,5,5,3,6,11,12,-1,18
FC Goa,5405,6,5,2,7,12,15,-3,17
Kerala Blast,5405,7,4,4,6,9,16,-7,16
Chennaiyin,5405,8,3,5,6,13,22,-9,14
Delhi Dynamo,5406,1,6,6,2,27,17,10,24
Mumbai City,5406,2,6,4,4,17,10,7,22
Kolkata,5406,3,5,6,3,18,16,2,21
FC Pune City,5406,4,5,3,6,16,18,-2,18
NorthEast Un,5406,5,4,5,5,12,12,0,17
Chennaiyin,5406,6,3,7,4,15,19,-4,16
Kerala Blast,5406,7,4,4,6,12,18,-6,16
FC Goa,5406,8,4,3,7,11,18,-7,15
Mumbai City,5407,1,6,4,4,17,11,6,22
Delhi Dynamo,5407,2,5,6,3,25,17,8,21
Kolkata,5407,3,5,6,3,20,18,2,21
Kerala Blast,5407,4,6,3,5,13,15,-2,21
FC Goa,5407,5,6,2,6,14,16,-2,20
Chennaiyin,5407,6,4,5,5,16,19,-3,17
NorthEast Un,5407,7,4,3,7,10,13,-3,15
FC Pune City,5407,8,4,3,7,14,20,-6,15
Mumbai City,5408,1,6,5,3,17,9,8,23
NorthEast Un,5408,2,7,2,5,14,11,3,23
Delhi Dynamo,5408,3,4,7,3,23,17,6,19
Kerala Blast,5408,4,5,4,5,14,16,-2,19
FC Pune City,5408,5,5,3,6,15,19,-4,18
Kolkata,5408,6,3,7,4,15,16,-1,16
FC Goa,5408,7,4,4,6,12,17,-5,16
Chennaiyin,5408,8,3,6,5,15,20,-5,15
Mumbai City,5409,1,7,4,3,18,8,10,25
Kerala Blast,5409,2,6,4,4,14,16,-2,22
Delhi Dynamo,5409,3,5,5,4,23,18,5,20
FC Pune City,5409,4,5,4,5,15,15,0,19
NorthEast Un,5409,5,5,3,6,11,10,1,18
Chennaiyin,5409,6,4,6,4,14,17,-3,18
Kolkata,5409,7,3,6,5,15,20,-5,15
FC Goa,5409,8,4,2,8,11,17,-6,14
Mumbai City,5410,1,7,4,3,18,8,10,25
Kerala Blast,5410,2,6,4,4,13,14,-1,22
Delhi Dynamo,5410,3,5,5,4,22,18,4,20
NorthEast Un,5410,4,5,3,6,12,11,1,18
Chennaiyin,5410,5,4,5,5,15,19,-4,17
FC Goa,5410,6,5,2,7,10,15,-5,17
Kolkata,5410,7,3,7,4,14,16,-2,16
FC Pune City,5410,8,4,4,6,14,17,-3,16
Delhi Dynamo,5411,1,6,6,2,25,16,9,24
Mumbai City,5411,2,6,5,3,17,9,8,23
Kerala Blast,5411,3,6,3,5,13,14,-1,21
FC Pune City,5411,4,5,3,6,14,16,-2,18
Chennaiyin,5411,5,4,6,4,16,19,-3,18
NorthEast Un,5411,6,5,2,7,11,12,-1,17
Kolkata,5411,7,3,6,5,14,18,-4,15
FC Goa,5411,8,4,3,7,11,17,-6,15
Mumbai City,5412,1,6,5,3,18,10,8,23
Kolkata,5412,2,5,6,3,16,16,0,21
NorthEast Un,5412,3,6,2,6,13,11,2,20
Delhi Dynamo,5412,4,4,7,3,24,19,5,19
FC Pune City,5412,5,5,3,6,14,16,-2,18
FC Goa,5412,6,5,3,6,13,15,-2,18
Chennaiyin,5412,7,4,5,5,15,19,-4,17
Kerala Blast,5412,8,4,3,7,9,16,-7,15
Mumbai City,5413,1,7,4,3,22,10,12,25
NorthEast Un,5413,2,6,3,5,13,11,2,21
Kolkata,5413,3,5,6,3,16,16,0,21
Delhi Dynamo,5413,4,5,5,4,28,22,6,20
Kerala Blast,5413,5,5,4,5,12,16,-4,19
Chennaiyin,5413,6,4,5,5,16,20,-4,17
FC Pune City,5413,7,4,3,7,12,16,-4,15
FC Goa,5413,8,4,2,8,13,21,-8,14
Mumbai City,5414,1,6,5,3,17,9,8,23
Delhi Dynamo,5414,2,5,7,2,26,18,8,22
NorthEast Un,5414,3,6,2,6,14,11,3,20
Kolkata,5414,4,4,7,3,17,16,1,19
FC Goa,5414,5,5,3,6,14,18,-4,18
Kerala Blast,5414,5,5,3,6,14,18,-4,18
FC Pune City,5414,7,4,4,6,12,16,-4,16
Chennaiyin,5414,8,3,5,6,13,21,-8,14
Mumbai City,5415,1,7,4,3,19,9,10,25
Kolkata,5415,2,5,6,3,16,16,0,21
Kerala Blast,5415,3,6,3,5,13,15,-2,21
FC Pune City,5415,4,5,3,6,16,16,0,18
NorthEast Un,5415,5,5,3,6,13,14,-1,18
Delhi Dynamo,5415,6,4,5,5,25,23,2,17
FC Goa,5415,7,5,2,7,14,18,-4,17
Chennaiyin,5415,8,3,6,5,15,20,-5,15
Mumbai City,5416,1,7,4,3,17,8,9,25
Kerala Blast,5416,2,7,3,4,14,13,1,24
Delhi Dynamo,5416,3,5,6,3,23,16,7,21
Kolkata,5416,4,4,7,3,15,13,2,19
Chennaiyin,5416,5,4,6,4,17,19,-2,18
NorthEast Un,5416,6,4,4,6,10,13,-3,16
FC Pune City,5416,7,4,3,7,12,17,-5,15
FC Goa,5416,8,3,3,8,10,19,-9,12
Delhi Dynamo,5417,1,6,6,2,28,18,10,24
Mumbai City,5417,2,6,5,3,18,10,8,23
Kolkata,5417,3,5,6,3,16,14,2,21
Kerala Blast,5417,4,5,4,5,15,16,-1,19
Chennaiyin,5417,5,4,5,5,17,21,-4,17
NorthEast Un,5417,6,5,2,7,12,16,-4,17
FC Pune City,5417,7,4,4,6,14,18,-4,16
FC Goa,5417,8,4,2,8,13,20,-7,14
Kerala Blast,5418,1,7,3,4,16,14,2,24
Delhi Dynamo,5418,2,6,5,3,26,18,8,23
Mumbai City,5418,3,6,4,4,16,10,6,22
Chennaiyin,5418,4,5,5,4,18,18,0,20
Kolkata,5418,5,4,6,4,18,19,-1,18
NorthEast Un,5418,6,5,2,7,13,14,-1,17
FC Pune City,5418,7,4,3,7,14,21,-7,15
FC Goa,5418,8,4,2,8,12,19,-7,14
Mumbai City,5419,1,6,5,3,17,9,8,23
Delhi Dynamo,5419,2,5,7,2,24,16,8,22
Kolkata,5419,3,5,7,2,17,12,5,22
FC Pune City,5419,4,5,3,6,13,15,-2,18
Kerala Blast,5419,5,5,3,6,11,18,-7,18
Chennaiyin,5419,6,4,5,5,15,19,-4,17
NorthEast Un,5419,7,4,3,7,10,12,-2,15
FC Goa,5419,8,4,3,7,11,17,-6,15
Delhi Dynamo,5420,1,6,6,2,25,16,9,24
Kolkata,5420,2,6,6,2,20,13,7,24
Mumbai City,5420,3,6,4,4,16,9,7,22
FC Pune City,5420,4,5,3,6,15,16,-1,18
Kerala Blast,5420,5,5,3,6,11,19,-8,18
Chennaiyin,5420,6,4,5,5,17,19,-2,17
NorthEast Un,5420,7,4,3,7,12,16,-4,15
FC Goa,5420,8,4,2,8,10,18,-8,14
Mumbai City,5421,1,7,4,3,20,8,12,25
Kerala Blast,5421,2,7,3,4,14,13,1,24
Chennaiyin,5421,3,5,5,4,21,21,0,20
Delhi Dynamo,5421,4,4,6,4,21,19,2,18
Kolkata,5421,5,3,8,3,15,16,-1,17
NorthEast Un,5421,6,5,2,7,12,15,-3,17
FC Pune City,5421,7,4,4,6,13,16,-3,16
FC Goa,5421,8,3,4,7,11,19,-8,13
Mumbai City,5422,1,7,4,3,20,10,10,25
Kerala Blast,5422,2,6,4,4,15,16,-1,22
Delhi Dynamo,5422,3,5,5,4,25,21,4,20
Kolkata,5422,4,4,7,3,16,15,1,19
NorthEast Un,5422,5,5,3,6,12,12,0,18
Chennaiyin,5422,6,4,6,4,17,19,-2,18
FC Pune City,5422,7,4,4,6,13,16,-3,16
FC Goa,5422,8,3,3,8,11,20,-9,12
Mumbai City,5423,1,7,4,3,19,9,10,25
Kerala Blast,5423,2,6,4,4,15,17,-2,22
Delhi Dynamo,5423,3,5,6,3,25,19,6,21
Kolkata,5423,4,4,7,3,19,17,2,19
NorthEast Un,5423,5,4,4,6,11,12,-1,16
FC Goa,5423,6,4,4,6,12,17,-5,16
Chennaiyin,5423,7,3,6,5,14,19,-5,15
FC Pune City,5423,8,4,3,7,12,17,-5,15
Mumbai City,5424,1,7,4,3,18,9,9,25
Delhi Dynamo,5424,2,5,6,3,25,18,7,21
Kolkata,5424,3,4,8,2,17,13,4,20
Kerala Blast,5424,4,5,4,5,12,18,-6,19
NorthEast Un,5424,5,5,3,6,14,14,0,18
FC Pune City,5424,6,4,5,5,13,15,-2,17
Chennaiyin,5424,7,4,5,5,15,19,-4,17
FC Goa,5424,8,3,3,8,9,17,-8,12
Mumbai City,5425,1,6,5,3,16,8,8,23
Delhi Dynamo,5425,2,5,7,2,24,14,10,22
NorthEast Un,5425,3,6,3,5,13,10,3,21
Kerala Blast,5425,4,6,3,5,15,16,-1,21
Chennaiyin,5425,5,4,5,5,15,20,-5,17
Kolkata,5425,6,3,7,4,16,17,-1,16
FC Pune City,5425,7,4,4,6,12,17,-5,16
FC Goa,5425,8,4,2,8,10,19,-9,14
Mumbai City,5426,1,6,5,3,16,8,8,23
Delhi Dynamo,5426,2,5,6,3,22,15,7,21
Kolkata,5426,3,5,6,3,20,15,5,21
NorthEast Un,5426,4,6,2,6,11,10,1,20
FC Pune City,5426,5,5,3,6,14,17,-3,18
Kerala Blast,5426,6,5,3,6,11,18,-7,18
Chennaiyin,5426,7,4,5,5,17,19,-2,17
FC Goa,5426,8,4,2,8,11,20,-9,14
Mumbai City,5427,1,7,4,3,23,8,15,25
FC Pune City,5427,2,6,3,5,15,15,0,21
NorthEast Un,5427,3,5,3,6,14,13,1,18
Delhi Dynamo,5427,4,4,6,4,23,24,-1,18
Kolkata,5427,5,4,6,4,17,19,-2,18
FC Goa,5427,6,5,3,6,16,18,-2,18
Kerala Blast,5427,7,5,3,6,12,17,-5,18
Chennaiyin,5427,8,3,6,5,16,22,-6,15
Delhi Dynamo,5428,1,5,7,2,24,16,8,22
Mumbai City,5428,2,6,4,4,16,9,7,22
FC Pune City,5428,3,6,3,5,16,16,0,21
Kolkata,5428,4,4,6,4,19,19,0,18
NorthEast Un,5428,5,5,3,6,11,11,0,18
Kerala Blast,5428,6,5,3,6,14,20,-6,18
Chennaiyin,5428,7,4,5,5,15,18,-3,17
FC Goa,5428,8,4,3,7,11,17,-6,15
Delhi Dynamo,5429,1,7,5,2,28,16,12,26
Mumbai City,5429,2,6,4,4,17,10,7,22
Kerala Blast,5429,3,6,3,5,13,16,-3,21
FC Pune City,5429,4,5,4,5,14,15,-1,19
Chennaiyin,5429,5,4,6,4,14,17,-3,18
Kolkata,5429,6,3,7,4,15,18,-3,16
FC Goa,5429,7,4,3,7,11,17,-6,15
NorthEast Un,5429,8,4,2,8,11,14,-3,14
Delhi Dynamo,5430,1,6,6,2,25,16,9,24
Mumbai City,5430,2,6,4,4,17,10,7,22
Kolkata,5430,3,5,7,2,17,14,3,22
Kerala Blast,5430,4,5,4,5,10,14,-4,19
FC Pune City,5430,5,4,4,6,13,16,-3,16
FC Goa,5430,6,4,4,6,12,16,-4,16
NorthEast Un,5430,7,4,3,7,11,13,-2,15
Chennaiyin,5430,8,3,6,5,15,21,-6,15
Delhi Dynamo,5431,1,5,7,2,25,17,8,22
Mumbai City,5431,2,6,4,4,17,10,7,22
Kolkata,5431,3,5,7,2,18,14,4,22
Kerala Blast,5431,4,5,4,5,13,17,-4,19
Chennaiyin,5431,5,4,6,4,19,22,-3,18
NorthEast Un,5431,6,4,4,6,13,14,-1,16
FC Pune City,5431,7,4,4,6,14,17,-3,16
FC Goa,5431,8,3,4,7,12,20,-8,13
Delhi Dynamo,5432,1,6,6,2,28,17,11,24
Kolkata,5432,2,5,7,2,20,13,7,22
Mumbai City,5432,3,6,4,4,17,10,7,22
Chennaiyin,5432,4,5,5,4,15,17,-2,20
FC Pune City,5432,5,5,3,6,15,19,-4,18
Kerala Blast,5432,6,5,3,6,12,19,-7,18
NorthEast Un,5432,7,4,3,7,11,13,-2,15
FC Goa,5432,8,3,3,8,10,20,-10,12
Mumbai City,5433,1,6,5,3,17,9,8,23
NorthEast Un,5433,2,7,2,5,14,9,5,23
Kolkata,5433,3,4,7,3,20,17,3,19
FC Pune City,5433,4,5,4,5,15,15,0,19
Delhi Dynamo,5433,5,4,6,4,22,18,4,18
FC Goa,5433,6,5,3,6,14,16,-2,18
Kerala Blast,5433,7,4,4,6,9,19,-10,16
Chennaiyin,5433,8,3,5,6,13,21,-8,14
Mumbai City,5434,1,6,5,3,17,9,8,23
Delhi Dynamo,5434,2,5,7,2,25,17,8,22
Kerala Blast,5434,3,5,4,5,13,18,-5,19
NorthEast Un,5434,4,5,3,6,12,11,1,18
FC Pune City,5434,5,5,3,6,16,17,-1,18
Chennaiyin,5434,6,4,6,4,14,17,-3,18
Kolkata,5434,7,3,7,4,15,18,-3,16
FC Goa,5434,8,4,3,7,12,17,-5,15
Mumbai City,5435,1,6,5,3,17,9,8,23
Kerala Blast,5435,2,6,4,4,13,14,-1,22
Delhi Dynamo,5435,3,5,6,3,26,19,7,21
NorthEast Un,5435,4,5,3,6,14,15,-1,18
Chennaiyin,5435,5,4,6,4,17,19,-2,18
Kolkata,5435,6,3,8,3,15,16,-1,17
FC Pune City,5435,7,4,4,6,13,16,-3,16
FC Goa,5435,8,3,4,7,11,18,-7,13
Delhi Dynamo,5436,1,6,6,2,26,16,10,24
Kolkata,5436,2,6,6,2,21,16,5,24
Mumbai City,5436,3,6,5,3,18,10,8,23
Kerala Blast,5436,4,6,3,5,14,16,-2,21
Chennaiyin,5436,5,4,6,4,15,17,-2,18
NorthEast Un,5436,6,4,3,7,9,11,-2,15
FC Pune City,5436,7,4,3,7,12,18,-6,15
FC Goa,5436,8,3,2,9,10,21,-11,11
Mumbai City,5437,1,7,4,3,18,8,10,25
Kerala Blast,5437,2,6,4,4,15,14,1,22
NorthEast Un,5437,3,5,4,5,12,11,1,19
Chennaiyin,5437,4,4,6,4,15,17,-2,18
FC Pune City,5437,5,5,3,6,14,18,-4,18
Delhi Dynamo,5437,6,4,5,5,25,22,3,17
FC Goa,5437,7,5,2,7,13,18,-5,17
Kolkata,5437,8,3,6,5,13,17,-4,15
Mumbai City,5438,1,6,4,4,16,9,7,22
Kolkata,5438,2,5,7,2,17,14,3,22
Delhi Dynamo,5438,3,5,6,3,23,17,6,21
Kerala Blast,5438,4,6,3,5,12,15,-3,21
NorthEast Un,5438,5,6,2,6,12,10,2,20
Chennaiyin,5438,6,4,5,5,16,19,-3,17
FC Pune City,5438,7,4,4,6,12,15,-3,16
FC Goa,5438,8,3,3,8,11,20,-9,12
Mumbai City,5439,1,7,4,3,18,8,10,25
Kerala Blast,5439,2,6,4,4,12,13,-1,22
Delhi Dynamo,5439,3,5,5,4,22,19,3,20
FC Goa,5439,4,6,2,6,13,14,-1,20
Kolkata,5439,5,4,7,3,16,14,2,19
NorthEast Un,5439,6,5,2,7,10,11,-1,17
FC Pune City,5439,7,4,3,7,13,19,-6,15
Chennaiyin,5439,8,3,5,6,13,19,-6,14
Mumbai City,5440,1,6,5,3,18,10,8,23
Delhi Dynamo,5440,2,5,6,3,24,19,5,21
Kolkata,5440,3,5,6,3,20,15,5,21
Kerala Blast,5440,4,6,3,5,15,17,-2,21
Chennaiyin,5440,5,4,6,4,14,17,-3,18
NorthEast Un,5440,6,5,2,7,12,13,-1,17
FC Pune City,5440,7,4,3,7,14,20,-6,15
FC Goa,5440,8,4,3,7,10,16,-6,15
Mumbai City,5441,1,7,4,3,19,9,10,25
Kolkata,5441,2,5,7,2,18,15,3,22
Delhi Dynamo,5441,3,5,6,3,27,20,7,21
Kerala Blast,5441,4,6,3,5,13,16,-3,21
Chennaiyin,5441,5,4,5,5,15,22,-7,17
FC Goa,5441,6,4,4,6,14,16,-2,16
FC Pune City,5441,7,4,3,7,13,17,-4,15
NorthEast Un,5441,8,4,2,8,11,15,-4,14
Kerala Blast,5442,1,7,3,4,15,15,0,24
Mumbai City,5442,2,6,5,3,18,10,8,23
Kolkata,5442,3,5,6,3,18,14,4,21
Delhi Dynamo,5442,4,4,7,3,26,21,5,19
NorthEast Un,5442,5,5,3,6,15,14,1,18
Chennaiyin,5442,6,3,6,5,15,21,-6,15
FC Pune City,5442,7,4,3,7,13,19,-6,15
FC Goa,5442,8,4,3,7,11,17,-6,15
Delhi Dynamo,5443,1,7,5,2,28,15,13,26
Mumbai City,5443,2,6,4,4,17,10,7,22
Kolkata,5443,3,4,8,2,16,14,2,20
Kerala Blast,5443,4,5,5,4,13,15,-2,20
NorthEast Un,5443,5,5,3,6,13,14,-1,18
FC Pune City,5443,6,4,4,6,13,17,-4,16
FC Goa,5443,7,4,2,8,12,18,-6,14
Chennaiyin,5443,8,3,5,6,13,22,-9,14
Mumbai City,5444,1,7,4,3,18,9,9,25
Kolkata,5444,2,5,7,2,17,13,4,22
Delhi Dynamo,5444,3,4,7,3,22,16,6,19
FC Pune City,5444,4,4,5,5,14,16,-2,17
Chennaiyin,5444,5,4,5,5,15,19,-4,17
Kerala Blast,5444,6,4,5,5,10,16,-6,17
NorthEast Un,5444,7,4,4,6,9,11,-2,16
FC Goa,5444,8,4,3,7,10,15,-5,15
Delhi Dynamo,5445,1,6,6,2,28,19,9,24
Mumbai City,5445,2,6,5,3,18,10,8,23
Kolkata,5445,3,5,6,3,16,16,0,21
Kerala Blast,5445,4,6,3,5,15,15,0,21
NorthEast Un,5445,5,5,2,7,13,14,-1,17
Chennaiyin,5445,6,4,5,5,15,20,-5,17
FC Pune City,5445,7,4,3,7,13,18,-5,15
FC Goa,5445,8,4,2,8,12,18,-6,14
Mumbai City,5446,1,6,5,3,17,9,8,23
NorthEast Un,5446,2,6,3,5,12,9,3,21
Kolkata,5446,3,5,6,3,18,16,2,21
Kerala Blast,5446,4,6,3,5,14,16,-2,21
Delhi Dynamo,5446,5,4,7,3,23,17,6,19
Chennaiyin,5446,6,4,5,5,17,22,-5,17
FC Pune City,5446,7,4,3,7,15,20,-5,15
FC Goa,5446,8,4,2,8,13,20,-7,14
Mumbai City,5447,1,7,4,3,21,10,11,25
Kerala Blast,5447,2,6,4,4,13,13,0,22
Delhi Dynamo,5447,3,5,5,4,26,22,4,20
Kolkata,5447,4,3,9,2,13,12,1,18
NorthEast Un,5447,5,5,2,7,12,13,-1,17
Chennaiyin,5447,6,4,5,5,17,21,-4,17
FC Pune City,5447,7,4,4,6,12,17,-5,16
FC Goa,5447,8,4,3,7,12,18,-6,15
Mumbai City,5448,1,7,4,3,18,8,10,25
Kolkata,5448,2,6,6,2,23,17,6,24
Delhi Dynamo,5448,3,4,7,3,23,18,5,19
NorthEast Un,5448,4,5,4,5,12,10,2,19
Chennaiyin,5448,5,4,6,4,18,20,-2,18
Kerala Blast,5448,6,5,3,6,16,19,-3,18
FC Pune City,5448,7,4,3,7,13,22,-9,15
FC Goa,5448,8,3,3,8,13,22,-9,12
Mumbai City,5449,1,7,4,3,17,8,9,25
Kerala Blast,5449,2,7,3,4,15,16,-1,24
Delhi Dynamo,5449,3,4,6,4,24,19,5,18
Kolkata,5449,4,4,6,4,18,18,0,18
NorthEast Un,5449,5,5,3,6,12,12,0,18
FC Goa,5449,6,5,3,6,13,16,-3,18
Chennaiyin,5449,7,3,6,5,14,19,-5,15
FC Pune City,5449,8,4,3,7,12,17,-5,15
Mumbai City,5450,1,7,4,3,20,9,11,25
Delhi Dynamo,5450,2,5,5,4,25,20,5,20
Kerala Blast,5450,3,5,5,4,12,13,-1,20
FC Pune City,5450,4,5,4,5,14,14,0,19
Chennaiyin,5450,5,4,6,4,16,19,-3,18
Kolkata,5450,6,3,8,3,14,15,-1,17
NorthEast Un,5450,7,5,2,7,12,15,-3,17
FC Goa,5450,8,3,4,7,10,18,-8,13
Mumbai City,5451,1,6,5,3,16,8,8,23
FC Pune City,5451,2,6,3,5,16,15,1,21
Delhi Dynamo,5451,3,4,7,3,23,17,6,19
Kolkata,5451,4,4,7,3,17,16,1,19
NorthEast Un,5451,5,5,4,5,11,10,1,19
Kerala Blast,5451,6,4,5,5,10,16,-6,17
Chennaiyin,5451,7,3,6,5,14,19,-5,15
FC Goa,5451,8,4,3,7,12,18,-6,15
Mumbai City,5452,1,6,5,3,16,8,8,23
Kerala Blast,5452,2,6,4,4,15,16,-1,22
NorthEast Un,5452,3,6,3,5,18,12,6,21
Delhi Dynamo,5452,4,5,6,3,26,21,5,21
Kolkata,5452,5,4,6,4,18,18,0,18
Chennaiyin,5452,6,4,5,5,15,19,-4,17
FC Pune City,5452,7,4,3,7,16,21,-5,15
FC Goa,5452,8,4,2,8,12,21,-9,14
Kolkata,5453,1,6,6,2,19,13,6,24
Mumbai City,5453,2,6,5,3,17,9,8,23
NorthEast Un,5453,3,6,3,5,14,11,3,21
Delhi Dynamo,5453,4,4,7,3,25,19,6,19
FC Pune City,5453,5,5,3,6,14,18,-4,18
Kerala Blast,5453,6,4,4,6,10,16,-6,16
Chennaiyin,5453,7,3,6,5,16,22,-6,15
FC Goa,5453,8,3,4,7,13,20,-7,13
Mumbai City,5454,1,7,4,3,18,8,10,25
Delhi Dynamo,5454,2,5,6,3,24,18,6,21
NorthEast Un,5454,3,6,3,5,14,10,4,21
Kolkata,5454,4,4,8,2,18,16,2,20
Kerala Blast,5454,5,5,4,5,12,17,-5,19
FC Pune City,5454,6,4,3,7,13,17,-4,15
Chennaiyin,5454,7,3,6,5,13,19,-6,15
FC Goa,5454,8,3,4,7,10,17,-7,13
Mumbai City,5455,1,6,5,3,17,9,8,23
Delhi Dynamo,5455,2,5,7,2,26,17,9,22
Kerala Blast,5455,3,6,4,4,15,15,0,22
Kolkata,5455,4,4,8,2,17,15,2,20
NorthEast Un,5455,5,5,3,6,12,13,-1,18
FC Pune City,5455,6,4,4,6,13,17,-4,16
Chennaiyin,5455,7,3,5,6,14,21,-7,14
FC Goa,5455,8,4,2,8,11,18,-7,14
Mumbai City,5456,1,6,5,3,18,10,8,23
Delhi Dynamo,5456,2,5,7,2,24,16,8,22
FC Pune City,5456,3,6,3,5,18,17,1,21
Kolkata,5456,4,4,6,4,20,19,1,18
Chennaiyin,5456,5,4,6,4,14,17,-3,18
NorthEast Un,5456,6,4,4,6,10,11,-1,16
Kerala Blast,5456,7,4,4,6,10,18,-8,16
FC Goa,5456,8,4,3,7,11,17,-6,15
Mumbai City,5457,1,7,4,3,18,9,9,25
Chennaiyin,5457,2,5,5,4,18,17,1,20
Kolkata,5457,3,4,7,3,16,15,1,19
Delhi Dynamo,5457,4,4,6,4,24,22,2,18
Kerala Blast,5457,5,4,6,4,11,15,-4,18
FC Goa,5457,6,5,2,7,13,15,-2,17
FC Pune City,5457,7,4,4,6,12,15,-3,16
NorthEast Un,5457,8,4,4,6,11,15,-4,16
Mumbai City,5458,1,6,5,3,17,9,8,23
Kolkata,5458,2,5,7,2,18,14,4,22
Delhi Dynamo,5458,3,5,6,3,26,16,10,21
Kerala Blast,5458,4,6,3,5,13,15,-2,21
NorthEast Un,5458,5,5,3,6,10,10,0,18
FC Pune City,5458,6,4,4,6,12,16,-4,16
Chennaiyin,5458,7,3,6,5,13,19,-6,15
FC Goa,5458,8,4,2,8,11,21,-10,14
Mumbai City,5459,1,6,5,3,17,9,8,23
Kolkata,5459,2,5,7,2,22,14,8,22
Kerala Blast,5459,3,5,5,4,12,15,-3,20
Delhi Dynamo,5459,4,4,7,3,22,16,6,19
Chennaiyin,5459,5,4,5,5,19,22,-3,17
FC Goa,5459,6,5,2,7,12,17,-5,17
NorthEast Un,5459,7,4,4,6,11,14,-3,16
FC Pune City,5459,8,4,3,7,12,20,-8,15
Mumbai City,5460,1,6,5,3,17,9,8,23
Delhi Dynamo,5460,2,5,7,2,24,16,8,22
FC Pune City,5460,3,6,3,5,17,16,1,21
Kerala Blast,5460,4,6,3,5,15,17,-2,21
Kolkata,5460,5,4,6,4,19,20,-1,18
NorthEast Un,5460,6,4,3,7,11,13,-2,15
Chennaiyin,5460,7,3,6,5,15,20,-5,15
FC Goa,5460,8,4,3,7,11,18,-7,15
Mumbai City,5461,1,7,4,3,19,9,10,25
Kolkata,5461,2,5,6,3,16,13,3,21
Delhi Dynamo,5461,3,5,5,4,24,20,4,20
NorthEast Un,5461,4,6,2,6,12,11,1,20
FC Goa,5461,5,6,2,6,14,14,0,20
FC Pune City,5461,6,5,3,6,15,17,-2,18
Kerala Blast,5461,7,4,3,7,11,19,-8,15
Chennaiyin,5461,8,3,5,6,13,21,-8,14
Delhi Dynamo,5462,1,6,6,2,30,19,11,24
Mumbai City,5462,2,6,5,3,19,11,8,23
Kolkata,5462,3,5,6,3,17,14,3,21
Kerala Blast,5462,4,6,3,5,11,15,-4,21
Chennaiyin,5462,5,5,5,4,16,17,-1,20
NorthEast Un,5462,6,5,2,7,12,13,-1,17
FC Pune City,5462,7,4,3,7,12,17,-5,15
FC Goa,5462,8,3,2,9,10,21,-11,11
Kerala Blast,5463,1,7,3,4,14,13,1,24
Delhi Dynamo,5463,2,6,5,3,24,18,6,23
Mumbai City,5463,3,6,4,4,16,9,7,22
FC Goa,5463,4,5,3,6,14,16,-2,18
Kolkata,5463,5,3,8,3,13,13,0,17
FC Pune City,5463,6,4,4,6,12,16,-4,16
NorthEast Un,5463,7,4,3,7,10,13,-3,15
Chennaiyin,5463,8,3,6,5,15,20,-5,15
Mumbai City,5464,1,7,4,3,19,8,11,25
Delhi Dynamo,5464,2,6,5,3,26,18,8,23
FC Pune City,5464,3,6,3,5,16,15,1,21
Kerala Blast,5464,4,6,3,5,13,14,-1,21
Kolkata,5464,5,3,7,4,14,17,-3,16
NorthEast Un,5464,6,4,3,7,10,14,-4,15
Chennaiyin,5464,7,3,6,5,15,20,-5,15
FC Goa,5464,8,4,3,7,11,18,-7,15
Mumbai City,5465,1,7,4,3,18,9,9,25
Delhi Dynamo,5465,2,5,6,3,26,19,7,21
Kerala Blast,5465,3,5,5,4,13,14,-1,20
Chennaiyin,5465,4,4,6,4,16,19,-3,18
FC Pune City,5465,5,4,5,5,14,16,-2,17
NorthEast Un,5465,6,4,4,6,11,12,-1,16
Kolkata,5465,7,3,7,4,14,18,-4,16
FC Goa,5465,8,4,3,7,13,18,-5,15
Mumbai City,5466,1,6,5,3,16,8,8,23
Kerala Blast,5466,2,6,4,4,16,15,1,22
Delhi Dynamo,5466,3,5,6,3,26,18,8,21
NorthEast Un,5466,4,5,3,6,14,13,1,18
Chennaiyin,5466,5,4,6,4,17,19,-2,18
Kolkata,5466,6,3,8,3,16,17,-1,17
FC Pune City,5466,7,4,4,6,13,19,-6,16
FC Goa,5466,8,4,2,8,11,20,-9,14
Mumbai City,5467,1,7,4,3,17,8,9,25
Kerala Blast,5467,2,6,4,4,13,13,0,22
Delhi Dynamo,5467,3,5,5,4,24,17,7,20
FC Goa,5467,4,5,3,6,14,16,-2,18
Kolkata,5467,5,3,8,3,13,15,-2,17
FC Pune City,5467,6,4,4,6,12,15,-3,16
Chennaiyin,5467,7,3,7,4,14,18,-4,16
NorthEast Un,5467,8,4,3,7,9,14,-5,15
Delhi Dynamo,5468,1,6,5,3,27,19,8,23
Mumbai City,5468,2,6,4,4,17,11,6,22
Kolkata,5468,3,4,8,2,14,12,2,20
Chennaiyin,5468,4,5,5,4,16,18,-2,20
Kerala Blast,5468,5,5,5,4,11,13,-2,20
NorthEast Un,5468,6,5,3,6,14,13,1,18
FC Pune City,5468,7,4,3,7,12,17,-5,15
FC Goa,5468,8,3,3,8,8,16,-8,12
Delhi Dynamo,5469,1,7,5,2,29,16,13,26
Mumbai City,5469,2,6,4,4,18,11,7,22
Kerala Blast,5469,3,6,3,5,15,17,-2,21
Kolkata,5469,4,4,7,3,16,16,0,19
FC Pune City,5469,5,5,4,5,15,16,-1,19
Chennaiyin,5469,6,4,6,4,17,18,-1,18
NorthEast Un,5469,7,4,2,8,11,17,-6,14
FC Goa,5469,8,3,3,8,8,18,-10,12
Mumbai City,5470,1,7,4,3,18,9,9,25
Delhi Dynamo,5470,2,6,5,3,31,19,12,23
FC Pune City,5470,3,6,3,5,18,18,0,21
NorthEast Un,5470,4,6,2,6,13,13,0,20
Kolkata,5470,5,4,6,4,17,17,0,18
Chennaiyin,5470,6,4,5,5,14,19,-5,17
Kerala Blast,5470,7,4,3,7,10,17,-7,15
FC Goa,5470,8,4,2,8,11,20,-9,14
Mumbai City,5471,1,6,5,3,18,10,8,23
Delhi Dynamo,5471,2,5,7,2,25,17,8,22
Kolkata,5471,3,4,8,2,18,15,3,20
NorthEast Un,5471,4,6,2,6,12,10,2,20
FC Pune City,5471,5,5,3,6,14,17,-3,18
Kerala Blast,5471,6,4,4,6,12,18,-6,16
Chennaiyin,5471,7,3,6,5,13,19,-6,15
FC Goa,5471,8,3,5,6,10,16,-6,14
Delhi Dynamo,5472,1,6,6,2,27,14,13,24
Mumbai City,5472,2,6,5,3,16,8,8,23
Kolkata,5472,3,5,6,3,21,17,4,21
Chennaiyin,5472,4,4,6,4,17,18,-1,18
FC Pune City,5472,5,5,3,6,16,20,-4,18
Kerala Blast,5472,6,4,4,6,11,18,-7,16
NorthEast Un,5472,7,4,3,7,10,15,-5,15
FC Goa,5472,8,4,3,7,12,20,-8,15
Mumbai City,5473,1,7,4,3,17,8,9,25
Delhi Dynamo,5473,2,6,5,3,24,15,9,23
Kerala Blast,5473,3,6,4,4,15,15,0,22
Kolkata,5473,4,4,6,4,19,20,-1,18
NorthEast Un,5473,5,5,3,6,12,13,-1,18
Chennaiyin,5473,6,3,6,5,17,22,-5,15
FC Goa,5473,7,4,3,7,15,20,-5,15
FC Pune City,5473,8,4,3,7,12,18,-6,15
Mumbai City,5474,1,7,4,3,18,8,10,25
Kerala Blast,5474,2,6,4,4,15,17,-2,22
Delhi Dynamo,5474,3,5,6,3,24,18,6,21
Kolkata,5474,4,4,8,2,17,15,2,20
Chennaiyin,5474,5,4,5,5,16,19,-3,17
FC Pune City,5474,6,4,4,6,14,17,-3,16
NorthEast Un,5474,7,4,3,7,11,14,-3,15
FC Goa,5474,8,4,2,8,11,18,-7,14
Mumbai City,5475,1,6,5,3,18,10,8,23
Delhi Dynamo,5475,2,4,8,2,26,19,7,20
Kolkata,5475,3,4,8,2,17,15,2,20
NorthEast Un,5475,4,5,4,5,13,11,2,19
FC Pune City,5475,5,5,3,6,13,15,-2,18
Chennaiyin,5475,6,3,7,4,14,18,-4,16
Kerala Blast,5475,7,4,4,6,11,18,-7,16
FC Goa,5475,8,3,5,6,11,17,-6,14
Mumbai City,5476,1,6,5,3,18,10,8,23
NorthEast Un,5476,2,6,3,5,12,10,2,21
Delhi Dynamo,5476,3,4,7,3,23,17,6,19
Kolkata,5476,4,4,7,3,15,13,2,19
Kerala Blast,5476,5,5,4,5,13,15,-2,19
Chennaiyin,5476,6,3,7,4,16,20,-4,16
FC Goa,5476,7,4,4,6,12,17,-5,16
FC Pune City,5476,8,4,3,7,12,19,-7,15
Mumbai City,5477,1,6,4,4,17,11,6,22
Delhi Dynamo,5477,2,5,6,3,27,19,8,21
FC Pune City,5477,3,6,3,5,16,15,1,21
Kerala Blast,5477,4,6,3,5,14,15,-1,21
NorthEast Un,5477,5,5,3,6,12,14,-2,18
Kolkata,5477,6,3,7,4,15,17,-2,16
Chennaiyin,5477,7,3,7,4,14,18,-4,16
FC Goa,5477,8,3,5,6,10,16,-6,14
Mumbai City,5478,1,6,5,3,17,9,8,23
Kerala Blast,5478,2,6,4,4,13,14,-1,22
Delhi Dynamo,5478,3,5,6,3,24,17,7,21
Kolkata,5478,4,4,7,3,14,15,-1,19
FC Pune City,5478,5,5,3,6,16,17,-1,18
FC Goa,5478,6,5,2,7,13,16,-3,17
Chennaiyin,5478,7,4,5,5,15,21,-6,17
NorthEast Un,5478,8,4,2,8,10,13,-3,14
Mumbai City,5479,1,6,4,4,18,11,7,22
Kolkata,5479,2,5,7,2,18,13,5,22
Delhi Dynamo,5479,3,5,6,3,27,20,7,21
NorthEast Un,5479,4,6,3,5,15,12,3,21
Kerala Blast,5479,5,5,3,6,11,18,-7,18
Chennaiyin,5479,6,4,5,5,14,19,-5,17
FC Pune City,5479,7,4,3,7,12,16,-4,15
FC Goa,5479,8,4,3,7,11,17,-6,15
Mumbai City,5480,1,7,4,3,17,8,9,25
Kolkata,5480,2,4,8,2,14,12,2,20
FC Pune City,5480,3,5,4,5,15,15,0,19
Delhi Dynamo,5480,4,4,6,4,23,19,4,18
NorthEast Un,5480,5,5,3,6,13,12,1,18
Chennaiyin,5480,6,4,6,4,16,19,-3,18
Kerala Blast,5480,7,4,5,5,11,17,-6,17
FC Goa,5480,8,3,4,7,11,18,-7,13
Mumbai City,5481,1,7,4,3,17,8,9,25
Delhi Dynamo,5481,2,5,6,3,24,17,7,21
Kerala Blast,5481,3,6,3,5,14,14,0,21
FC Pune City,5481,4,5,3,6,16,16,0,18
NorthEast Un,5481,5,5,3,6,12,13,-1,18
Kolkata,5481,6,4,6,4,14,17,-3,18
FC Goa,5481,7,5,2,7,14,18,-4,17
Chennaiyin,5481,8,3,5,6,15,23,-8,14
Mumbai City,5482,1,7,4,3,21,8,13,25
NorthEast Un,5482,2,7,2,5,13,9,4,23
Kolkata,5482,3,5,6,3,19,15,4,21
FC Pune City,5482,4,6,3,5,17,14,3,21
Delhi Dynamo,5482,5,4,6,4,21,21,0,18
Chennaiyin,5482,6,3,6,5,14,19,-5,15
Kerala Blast,5482,7,4,3,7,9,18,-9,15
FC Goa,5482,8,3,4,7,10,20,-10,13
Mumbai City,5483,1,7,4,3,17,8,9,25
Kolkata,5483,2,5,7,2,17,13,4,22
Kerala Blast,5483,3,6,4,4,17,14,3,22
Delhi Dynamo,5483,4,5,5,4,23,16,7,20
Chennaiyin,5483,5,4,6,4,17,19,-2,18
FC Goa,5483,6,4,3,7,11,17,-6,15
FC Pune City,5483,7,4,3,7,12,20,-8,15
NorthEast Un,5483,8,4,2,8,9,16,-7,14
Mumbai City,5484,1,7,4,3,17,8,9,25
Kolkata,5484,2,4,7,3,17,16,1,19
FC Pune City,5484,3,5,4,5,16,17,-1,19
Kerala Blast,5484,4,5,4,5,16,18,-2,19
Delhi Dynamo,5484,5,4,6,4,22,17,5,18
Chennaiyin,5484,6,4,6,4,16,19,-3,18
NorthEast Un,5484,7,4,4,6,11,14,-3,16
FC Goa,5484,8,4,3,7,12,18,-6,15
Mumbai City,5485,1,6,5,3,18,10,8,23
FC Pune City,5485,2,6,3,5,20,15,5,21
Kerala Blast,5485,3,6,3,5,18,17,1,21
Delhi Dynamo,5485,4,4,7,3,24,18,6,19
Kolkata,5485,5,4,6,4,17,22,-5,18
Chennaiyin,5485,6,4,5,5,15,20,-5,17
FC Goa,5485,7,5,2,7,12,17,-5,17
NorthEast Un,5485,8,4,3,7,10,15,-5,15
Kolkata,5486,1,6,6,2,21,15,6,24
Mumbai City,5486,2,6,5,3,17,9,8,23
Chennaiyin,5486,3,5,5,4,15,17,-2,20
Delhi Dynamo,5486,4,4,7,3,24,18,6,19
Kerala Blast,5486,5,4,5,5,11,18,-7,17
NorthEast Un,5486,6,4,4,6,10,11,-1,16
FC Pune City,5486,7,4,4,6,15,18,-3,16
FC Goa,5486,8,4,2,8,10,17,-7,14
Mumbai City,5487,1,7,4,3,17,8,9,25
Kolkata,5487,2,5,6,3,19,16,3,21
Kerala Blast,5487,3,6,3,5,15,18,-3,21
Delhi Dynamo,5487,4,4,7,3,25,19,6,19
FC Pune City,5487,5,5,3,6,14,17,-3,18
NorthEast Un,5487,6,4,4,6,13,14,-1,16
Chennaiyin,5487,7,3,6,5,14,19,-5,15
FC Goa,5487,8,4,3,7,12,18,-6,15
Delhi Dynamo,5488,1,6,6,2,25,16,9,24
Mumbai City,5488,2,6,5,3,17,9,8,23
FC Pune City,5488,3,5,4,5,15,16,-1,19
Kerala Blast,5488,4,5,4,5,11,15,-4,19
Kolkata,5488,5,3,9,2,14,13,1,18
Chennaiyin,5488,6,4,6,4,17,19,-2,18
NorthEast Un,5488,7,4,2,8,10,14,-4,14
FC Goa,5488,8,3,4,7,10,17,-7,13
Mumbai City,5489,1,7,4,3,18,9,9,25
Delhi Dynamo,5489,2,5,5,4,24,18,6,20
Chennaiyin,5489,3,5,5,4,17,18,-1,20
Kolkata,5489,4,4,7,3,15,14,1,19
FC Pune City,5489,5,5,4,5,14,15,-1,19
Kerala Blast,5489,6,5,3,6,12,17,-5,18
NorthEast Un,5489,7,5,2,7,12,13,-1,17
FC Goa,5489,8,4,2,8,9,17,-8,14
Mumbai City,5490,1,7,4,3,19,9,10,25
Kolkata,5490,2,6,6,2,17,12,5,24
Kerala Blast,5490,3,6,3,5,13,16,-3,21
Delhi Dynamo,5490,4,5,5,4,26,23,3,20
Chennaiyin,5490,5,5,5,4,21,19,2,20
NorthEast Un,5490,6,5,2,7,14,16,-2,17
FC Pune City,5490,7,4,3,7,14,18,-4,15
FC Goa,5490,8,3,2,9,11,22,-11,11
Delhi Dynamo,5491,1,7,5,2,26,14,12,26
Mumbai City,5491,2,6,4,4,16,9,7,22
NorthEast Un,5491,3,6,2,6,12,12,0,20
FC Pune City,5491,4,5,4,5,15,15,0,19
Kolkata,5491,5,3,9,2,16,15,1,18
Kerala Blast,5491,6,4,4,6,10,18,-8,16
FC Goa,5491,7,4,3,7,10,16,-6,15
Chennaiyin,5491,8,3,5,6,13,19,-6,14
Mumbai City,5492,1,7,4,3,19,9,10,25
Delhi Dynamo,5492,2,5,6,3,26,19,7,21
Kolkata,5492,3,5,6,3,18,18,0,21
NorthEast Un,5492,4,5,4,5,13,10,3,19
FC Pune City,5492,5,5,3,6,13,16,-3,18
Chennaiyin,5492,6,4,5,5,15,21,-6,17
Kerala Blast,5492,7,4,4,6,10,16,-6,16
FC Goa,5492,8,4,2,8,15,20,-5,14
Delhi Dynamo,5493,1,6,6,2,28,15,13,24
Mumbai City,5493,2,6,4,4,17,11,6,22
Kerala Blast,5493,3,6,3,5,13,15,-2,21
Kolkata,5493,4,4,7,3,18,17,1,19
Chennaiyin,5493,5,4,6,4,18,21,-3,18
FC Pune City,5493,6,4,4,6,14,17,-3,16
NorthEast Un,5493,7,4,3,7,10,13,-3,15
FC Goa,5493,8,4,3,7,13,22,-9,15
Mumbai City,5494,1,7,4,3,19,9,10,25
Delhi Dynamo,5494,2,5,6,3,24,18,6,21
Kerala Blast,5494,3,6,3,5,17,17,0,21
Kolkata,5494,4,4,8,2,17,15,2,20
NorthEast Un,5494,5,5,3,6,13,13,0,18
FC Pune City,5494,6,4,4,6,15,19,-4,16
FC Goa,5494,7,4,3,7,12,17,-5,15
Chennaiyin,5494,8,3,5,6,14,23,-9,14
Mumbai City,5495,1,7,4,3,18,8,10,25
Kolkata,5495,2,5,7,2,16,12,4,22
Delhi Dynamo,5495,3,5,6,3,24,18,6,21
FC Pune City,5495,4,5,4,5,15,15,0,19
Kerala Blast,5495,5,5,3,6,13,19,-6,18
Chennaiyin,5495,6,4,5,5,14,18,-4,17
NorthEast Un,5495,7,4,3,7,11,14,-3,15
FC Goa,5495,8,4,2,8,10,17,-7,14
Mumbai City,5496,1,7,4,3,18,8,10,25
Delhi Dynamo,5496,2,5,5,4,24,18,6,20
Kolkata,5496,3,4,7,3,19,17,2,19
NorthEast Un,5496,4,5,4,5,11,10,1,19
FC Pune City,5496,5,5,4,5,16,17,-1,19
Kerala Blast,5496,6,4,5,5,11,17,-6,17
Chennaiyin,5496,7,3,7,4,16,20,-4,16
FC Goa,5496,8,3,4,7,12,20,-8,13
Mumbai City,5497,1,6,4,4,20,13,7,22
NorthEast Un,5497,2,6,3,5,15,10,5,21
Delhi Dynamo,5497,3,5,5,4,28,25,3,20
Kerala Blast,5497,4,5,5,4,12,15,-3,20
Kolkata,5497,5,4,7,3,15,14,1,19
FC Pune City,5497,6,4,5,5,14,16,-2,17
FC Goa,5497,7,5,2,7,14,18,-4,17
Chennaiyin,5497,8,3,5,6,14,21,-7,14
Mumbai City,5498,1,7,4,3,19,8,11,25
Delhi Dynamo,5498,2,5,5,4,23,19,4,20
FC Pune City,5498,3,5,4,5,15,16,-1,19
Kerala Blast,5498,4,5,4,5,13,19,-6,19
Kolkata,5498,5,4,6,4,17,16,1,18
NorthEast Un,5498,6,5,3,6,12,12,0,18
FC Goa,5498,7,5,2,7,12,16,-4,17
Chennaiyin,5498,8,3,6,5,13,18,-5,15
Mumbai City,5499,1,7,4,3,20,10,10,25
Kolkata,5499,2,5,7,2,18,15,3,22
Delhi Dynamo,5499,3,5,5,4,25,21,4,20
Chennaiyin,5499,4,5,5,4,18,17,1,20
FC Pune City,5499,5,5,3,6,15,17,-2,18
Kerala Blast,5499,6,5,3,6,13,17,-4,18
NorthEast Un,5499,7,5,2,7,11,14,-3,17
FC Goa,5499,8,3,3,8,10,19,-9,12
Mumbai City,5500,1,6,5,3,16,8,8,23
Delhi Dynamo,5500,2,5,7,2,23,15,8,22
Kerala Blast,5500,3,6,4,4,14,14,0,22
Kolkata,5500,4,4,7,3,17,15,2,19
FC Pune City,5500,5,4,4,6,14,18,-4,16
FC Goa,5500,6,4,4,6,11,16,-5,16
NorthEast Un,5500,7,4,3,7,9,13,-4,15
Chennaiyin,5500,8,3,6,5,13,18,-5,15
Mumbai City,5501,1,7,4,3,19,9,10,25
Kerala Blast,5501,2,7,3,4,14,15,-1,24
Kolkata,5501,3,5,6,3,18,14,4,21
Delhi Dynamo,5501,4,4,7,3,24,19,5,19
Chennaiyin,5501,5,4,6,4,14,17,-3,18
NorthEast Un,5501,6,4,4,6,12,13,-1,16
FC Pune City,5501,7,4,3,7,13,19,-6,15
FC Goa,5501,8,3,3,8,9,17,-8,12
Mumbai City,5502,1,7,4,3,19,9,10,25
Kolkata,5502,2,5,7,2,17,13,4,22
NorthEast Un,5502,3,6,3,5,14,11,3,21
Delhi Dynamo,5502,4,4,6,4,22,19,3,18
Kerala Blast,5502,5,4,5,5,11,17,-6,17
FC Pune City,5502,6,4,4,6,12,15,-3,16
FC Goa,5502,7,4,4,6,10,14,-4,16
Chennaiyin,5502,8,3,5,6,14,21,-7,14
Mumbai City,5503,1,6,4,4,16,11,5,22
Kolkata,5503,2,5,6,3,18,16,2,21
Delhi Dynamo,5503,3,5,5,4,26,19,7,20
Kerala Blast,5503,4,5,5,4,14,17,-3,20
NorthEast Un,5503,5,5,3,6,14,14,0,18
Chennaiyin,5503,6,4,6,4,15,18,-3,18
FC Pune City,5503,7,4,4,6,16,19,-3,16
FC Goa,5503,8,4,3,7,12,17,-5,15
Mumbai City,5504,1,6,5,3,16,8,8,23
Delhi Dynamo,5504,2,5,7,2,25,15,10,22
Kolkata,5504,3,4,7,3,21,18,3,19
Kerala Blast,5504,4,5,4,5,12,16,-4,19
Chennaiyin,5504,5,4,6,4,17,18,-1,18
FC Pune City,5504,6,5,3,6,15,17,-2,18
NorthEast Un,5504,7,5,2,7,10,15,-5,17
FC Goa,5504,8,3,4,7,11,20,-9,13
Mumbai City,5505,1,7,4,3,17,8,9,25
FC Pune City,5505,2,5,4,5,14,15,-1,19
Kolkata,5505,3,3,9,2,16,15,1,18
NorthEast Un,5505,4,5,3,6,13,12,1,18
FC Goa,5505,5,5,3,6,15,18,-3,18
Delhi Dynamo,5505,6,4,5,5,24,21,3,17
Chennaiyin,5505,7,4,5,5,15,20,-5,17
Kerala Blast,5505,8,4,5,5,11,16,-5,17
Kolkata,5506,1,6,6,2,19,13,6,24
Mumbai City,5506,2,6,5,3,17,9,8,23
Chennaiyin,5506,3,5,5,4,18,17,1,20
Delhi Dynamo,5506,4,4,7,3,23,20,3,19
Kerala Blast,5506,5,5,3,6,15,18,-3,18
FC Pune City,5506,6,5,3,6,15,19,-4,18
NorthEast Un,5506,7,4,3,7,10,17,-7,15
FC Goa,5506,8,4,2,8,12,16,-4,14
Mumbai City,5507,1,6,5,3,17,9,8,23
NorthEast Un,5507,2,6,2,6,14,14,0,20
Kolkata,5507,3,4,7,3,18,17,1,19
FC Pune City,5507,4,5,4,5,15,16,-1,19
Delhi Dynamo,5507,5,4,6,4,25,22,3,18
Kerala Blast,5507,6,5,3,6,11,16,-5,18
Chennaiyin,5507,7,4,5,5,17,19,-2,17
FC Goa,5507,8,5,2,7,14,18,-4,17
Kolkata,5508,1,6,6,2,20,14,6,24
Mumbai City,5508,2,6,5,3,17,9,8,23
Delhi Dynamo,5508,3,5,6,3,27,17,10,21
FC Pune City,5508,4,5,3,6,14,17,-3,18
Kerala Blast,5508,5,5,3,6,10,16,-6,18
FC Goa,5508,6,5,2,7,12,17,-5,17
Chennaiyin,5508,7,3,6,5,16,21,-5,15
NorthEast Un,5508,8,4,3,7,12,17,-5,15
Mumbai City,5509,1,6,4,4,16,9,7,22
Delhi Dynamo,5509,2,5,5,4,23,20,3,20
Kolkata,5509,3,4,7,3,16,16,0,19
Kerala Blast,5509,4,5,4,5,14,16,-2,19
Chennaiyin,5509,5,4,6,4,15,18,-3,18
FC Goa,5509,6,5,3,6,13,16,-3,18
NorthEast Un,5509,7,5,2,7,13,13,0,17
FC Pune City,5509,8,4,5,5,14,16,-2,17
Mumbai City,5510,1,6,4,4,16,11,5,22
Delhi Dynamo,5510,2,5,6,3,25,16,9,21
Kerala Blast,5510,3,5,4,5,11,15,-4,19
Kolkata,5510,4,4,6,4,15,15,0,18
FC Pune City,5510,5,5,3,6,13,15,-2,18
FC Goa,5510,6,5,3,6,11,15,-4,18
NorthEast Un,5510,7,4,5,5,10,10,0,17
Chennaiyin,5510,8,3,7,4,14,18,-4,16
Delhi Dynamo,5511,1,6,5,3,26,18,8,23
Mumbai City,5511,2,6,4,4,17,11,6,22
FC Goa,5511,3,6,2,6,15,17,-2,20
Kolkata,5511,4,4,6,4,19,18,1,18
FC Pune City,5511,5,5,3,6,17,21,-4,18
Kerala Blast,5511,6,5,3,6,14,18,-4,18
Chennaiyin,5511,7,4,5,5,18,20,-2,17
NorthEast Un,5511,8,5,2,7,12,15,-3,17
Delhi Dynamo,5512,1,7,5,2,29,17,12,26
Mumbai City,5512,2,6,4,4,16,10,6,22
Chennaiyin,5512,3,5,5,4,16,17,-1,20
Kolkata,5512,4,3,8,3,16,17,-1,17
FC Pune City,5512,5,4,5,5,15,17,-2,17
NorthEast Un,5512,6,5,2,7,12,15,-3,17
Kerala Blast,5512,7,4,5,5,12,17,-5,17
FC Goa,5512,8,4,2,8,12,18,-6,14
Mumbai City,5513,1,6,5,3,17,9,8,23
Delhi Dynamo,5513,2,5,6,3,24,16,8,21
Kerala Blast,5513,3,5,5,4,12,14,-2,20
Kolkata,5513,4,4,7,3,16,17,-1,19
NorthEast Un,5513,5,5,3,6,11,11,0,18
FC Pune City,5513,6,5,3,6,15,16,-1,18
Chennaiyin,5513,7,4,6,4,16,19,-3,18
FC Goa,5513,8,3,3,8,10,19,-9,12
Mumbai City,5514,1,7,4,3,19,8,11,25
Delhi Dynamo,5514,2,6,5,3,27,19,8,23
Kolkata,5514,3,5,6,3,18,16,2,21
Kerala Blast,5514,4,5,4,5,12,16,-4,19
NorthEast Un,5514,5,5,3,6,11,11,0,18
Chennaiyin,5514,6,4,5,5,14,18,-4,17
FC Pune City,5514,7,4,3,7,15,19,-4,15
FC Goa,5514,8,4,2,8,12,21,-9,14
Delhi Dynamo,5515,1,6,6,2,26,16,10,24
Mumbai City,5515,2,6,4,4,17,10,7,22
Kerala Blast,5515,3,6,4,4,12,14,-2,22
FC Goa,5515,4,5,2,7,14,18,-4,17
Chennaiyin,5515,5,4,5,5,15,20,-5,17
NorthEast Un,5515,6,4,4,6,10,11,-1,16
Kolkata,5515,7,3,7,4,15,17,-2,16
FC Pune City,5515,8,4,4,6,14,17,-3,16
Mumbai City,5516,1,7,4,3,18,8,10,25
Delhi Dynamo,5516,2,5,6,3,25,19,6,21
Kolkata,5516,3,4,7,3,15,14,1,19
Kerala Blast,5516,4,5,4,5,13,18,-5,19
FC Pune City,5516,5,5,3,6,14,15,-1,18
Chennaiyin,5516,6,4,6,4,15,18,-3,18
NorthEast Un,5516,7,4,3,7,14,16,-2,15
FC Goa,5516,8,4,3,7,10,16,-6,15
Kolkata,5517,1,6,6,2,21,15,6,24
Mumbai City,5517,2,6,5,3,17,9,8,23
Delhi Dynamo,5517,3,5,7,2,23,15,8,22
Kerala Blast,5517,4,5,4,5,14,16,-2,19
Chennaiyin,5517,5,4,6,4,17,20,-3,18
FC Pune City,5517,6,4,4,6,13,16,-3,16
NorthEast Un,5517,7,4,3,7,10,15,-5,15
FC Goa,5517,8,3,3,8,11,20,-9,12
Mumbai City,5518,1,7,4,3,17,8,9,25
Kolkata,5518,2,5,6,3,18,17,1,21
Delhi Dynamo,5518,3,5,5,4,22,16,6,20
NorthEast Un,5518,4,6,2,6,14,12,2,20
FC Pune City,5518,5,5,3,6,15,17,-2,18
Kerala Blast,5518,6,5,3,6,11,17,-6,18
Chennaiyin,5518,7,4,5,5,16,21,-5,17
FC Goa,5518,8,4,2,8,12,17,-5,14
Mumbai City,5519,1,7,4,3,18,8,10,25
Kolkata,5519,2,5,6,3,19,16,3,21
Kerala Blast,5519,3,5,4,5,13,16,-3,19
Delhi Dynamo,5519,4,4,6,4,25,23,2,18
NorthEast Un,5519,5,5,3,6,14,13,1,18
Chennaiyin,5519,6,3,7,4,15,19,-4,16
FC Pune City,5519,7,4,4,6,12,16,-4,16
FC Goa,5519,8,4,4,6,16,21,-5,16
Delhi Dynamo,5520,1,7,5,2,25,14,11,26
Mumbai City,5520,2,6,4,4,16,9,7,22
FC Pune City,5520,3,5,4,5,13,14,-1,19
Kolkata,5520,4,4,6,4,15,14,1,18
Chennaiyin,5520,5,4,5,5,17,20,-3,17
FC Goa,5520,6,5,2,7,11,17,-6,17
Kerala Blast,5520,7,4,5,5,9,15,-6,17
NorthEast Un,5520,8,4,3,7,10,13,-3,15
Mumbai City,5521,1,7,4,3,18,9,9,25
Delhi Dynamo,5521,2,5,5,4,24,17,7,20
NorthEast Un,5521,3,5,4,5,12,11,1,19
FC Pune City,5521,4,5,4,5,15,15,0,19
Kerala Blast,5521,5,5,4,5,12,17,-5,19
Kolkata,5521,6,3,8,3,14,14,0,17
Chennaiyin,5521,7,3,6,5,16,21,-5,15
FC Goa,5521,8,4,3,7,12,19,-7,15
Mumbai City,5522,1,7,4,3,18,9,9,25
Delhi Dynamo,5522,2,6,5,3,27,19,8,23
FC Pune City,5522,3,6,3,5,15,15,0,21
Kolkata,5522,4,4,7,3,16,15,1,19
Chennaiyin,5522,5,4,6,4,16,19,-3,18
Kerala Blast,5522,6,4,4,6,11,17,-6,16
NorthEast Un,5522,7,4,3,7,10,12,-2,15
FC Goa,5522,8,3,4,7,13,20,-7,13
Mumbai City,5523,1,7,4,3,19,8,11,25
Kolkata,5523,2,6,6,2,20,12,8,24
NorthEast Un,5523,3,7,2,5,14,10,4,23
Delhi Dynamo,5523,4,4,5,5,24,22,2,17
FC Goa,5523,5,5,2,7,14,18,-4,17
FC Pune City,5523,6,4,4,6,13,19,-6,16
Kerala Blast,5523,7,4,4,6,10,17,-7,16
Chennaiyin,5523,8,3,5,6,13,21,-8,14
Mumbai City,5524,1,7,4,3,17,8,9,25
Kolkata,5524,2,6,6,2,18,13,5,24
Delhi Dynamo,5524,3,5,6,3,23,16,7,21
Kerala Blast,5524,4,6,3,5,11,15,-4,21
Chennaiyin,5524,5,4,5,5,14,19,-5,17
NorthEast Un,5524,6,4,3,7,10,12,-2,15
FC Pune City,5524,7,4,3,7,13,17,-4,15
FC Goa,5524,8,4,2,8,10,16,-6,14
Delhi Dynamo,5525,1,6,5,3,25,16,9,23
Mumbai City,5525,2,6,4,4,16,11,5,22
NorthEast Un,5525,3,6,2,6,12,11,1,20
Kerala Blast,5525,4,5,5,4,12,14,-2,20
FC Pune City,5525,5,5,4,5,15,16,-1,19
Kolkata,5525,6,3,8,3,17,17,0,17
FC Goa,5525,7,4,3,7,10,16,-6,15
Chennaiyin,5525,8,3,5,6,13,19,-6,14
Mumbai City,5526,1,6,5,3,17,9,8,23
FC Pune City,5526,2,6,3,5,16,16,0,21
Kerala Blast,5526,3,6,3,5,16,17,-1,21
Delhi Dynamo,5526,4,4,8,2,24,17,7,20
Chennaiyin,5526,5,4,6,4,14,17,-3,18
FC Goa,5526,6,4,4,6,11,16,-5,16
Kolkata,5526,7,3,6,5,15,18,-3,15
NorthEast Un,5526,8,4,3,7,10,13,-3,15
Mumbai City,5527,1,7,4,3,20,10,10,25
Kolkata,5527,2,6,6,2,21,13,8,24
Delhi Dynamo,5527,3,6,5,3,28,19,9,23
Chennaiyin,5527,4,5,5,4,16,17,-1,20
Kerala Blast,5527,5,4,5,5,10,18,-8,17
FC Pune City,5527,6,4,4,6,12,16,-4,16
NorthEast Un,5527,7,4,3,7,10,15,-5,15
FC Goa,5527,8,3,2,9,10,19,-9,11
Mumbai City,5528,1,7,4,3,17,8,9,25
Delhi Dynamo,5528,2,6,5,3,30,18,12,23
Kolkata,5528,3,5,7,2,19,14,5,22
Kerala Blast,5528,4,6,3,5,14,18,-4,21
NorthEast Un,5528,5,5,2,7,14,17,-3,17
FC Pune City,5528,6,4,4,6,15,19,-4,16
Chennaiyin,5528,7,3,5,6,14,20,-6,14
FC Goa,5528,8,4,2,8,10,19,-9,14
Mumbai City,5529,1,6,5,3,16,8,8,23
Delhi Dynamo,5529,2,5,7,2,26,16,10,22
Kolkata,5529,3,5,6,3,17,14,3,21
Kerala Blast,5529,4,5,4,5,15,17,-2,19
NorthEast Un,5529,5,4,5,5,13,13,0,17
Chennaiyin,5529,6,3,7,4,14,18,-4,16
FC Pune City,5529,7,4,3,7,13,20,-7,15
FC Goa,5529,8,4,3,7,10,18,-8,15
Mumbai City,5530,1,6,5,3,16,8,8,23
Kolkata,5530,2,5,7,2,17,14,3,22
Delhi Dynamo,5530,3,5,6,3,24,16,8,21
Chennaiyin,5530,4,5,5,4,15,17,-2,20
NorthEast Un,5530,5,5,3,6,11,11,0,18
FC Pune City,5530,6,4,5,5,14,16,-2,17
Kerala Blast,5530,7,4,5,5,10,15,-5,17
FC Goa,5530,8,3,2,9,9,19,-10,11
Mumbai City,5531,1,7,4,3,17,8,9,25
Kerala Blast,5531,2,6,3,5,14,16,-2,21
Kolkata,5531,3,4,8,2,15,13,2,20
Chennaiyin,5531,4,5,5,4,17,17,0,20
Delhi Dynamo,5531,5,4,5,5,21,18,3,17
NorthEast Un,5531,6,5,2,7,12,15,-3,17
FC Pune City,5531,7,4,4,6,14,17,-3,16
FC Goa,5531,8,4,3,7,9,15,-6,15
Delhi Dynamo,5532,1,6,6,2,26,16,10,24
Mumbai City,5532,2,6,5,3,16,8,8,23
Kolkata,5532,3,5,6,3,18,15,3,21
FC Pune City,5532,4,5,3,6,15,15,0,18
NorthEast Un,5532,5,5,3,6,12,12,0,18
FC Goa,5532,6,5,2,7,14,18,-4,17
Kerala Blast,5532,7,4,4,6,11,20,-9,16
Chennaiyin,5532,8,3,5,6,13,21,-8,14
Mumbai City,5533,1,6,5,3,18,10,8,23
Kerala Blast,5533,2,5,5,4,11,14,-3,20
NorthEast Un,5533,3,5,4,5,13,11,2,19
Delhi Dynamo,5533,4,4,6,4,24,20,4,18
Kolkata,5533,5,3,9,2,15,14,1,18
FC Goa,5533,6,5,3,6,13,17,-4,18
FC Pune City,5533,7,4,4,6,14,17,-3,16
Chennaiyin,5533,8,3,6,5,16,21,-5,15
Delhi Dynamo,5534,1,6,6,2,28,17,11,24
Mumbai City,5534,2,6,4,4,17,12,5,22
Kerala Blast,5534,3,6,3,5,14,16,-2,21
NorthEast Un,5534,4,5,3,6,15,15,0,18
Kolkata,5534,5,4,6,4,15,17,-2,18
FC Goa,5534,6,5,3,6,12,14,-2,18
Chennaiyin,5534,7,3,6,5,14,19,-5,15
FC Pune City,5534,8,4,3,7,13,18,-5,15
Mumbai City,5535,1,6,4,4,16,10,6,22
Kerala Blast,5535,2,6,4,4,12,13,-1,22
Delhi Dynamo,5535,3,5,6,3,25,17,8,21
Kolkata,5535,4,4,7,3,15,15,0,19
NorthEast Un,5535,5,5,3,6,11,12,-1,18
Chennaiyin,5535,6,4,5,5,14,18,-4,17
FC Goa,5535,7,5,2,7,12,16,-4,17
FC Pune City,5535,8,4,3,7,13,17,-4,15
Mumbai City,5536,1,7,4,3,17,8,9,25
Kolkata,5536,2,6,6,2,20,13,7,24
Delhi Dynamo,5536,3,5,6,3,24,17,7,21
Kerala Blast,5536,4,6,3,5,12,15,-3,21
Chennaiyin,5536,5,5,5,4,16,18,-2,20
FC Pune City,5536,6,4,3,7,12,18,-6,15
NorthEast Un,5536,7,4,2,8,11,15,-4,14
FC Goa,5536,8,3,3,8,10,18,-8,12
Mumbai City,5537,1,6,5,3,17,9,8,23
Delhi Dynamo,5537,2,5,7,2,25,17,8,22
FC Pune City,5537,3,6,3,5,14,14,0,21
Kolkata,5537,4,3,8,3,15,15,0,17
Chennaiyin,5537,5,4,5,5,17,21,-4,17
Kerala Blast,5537,6,4,5,5,10,15,-5,17
NorthEast Un,5537,7,4,4,6,12,14,-2,16
FC Goa,5537,8,4,3,7,12,17,-5,15
Mumbai City,5538,1,6,5,3,18,10,8,23
Delhi Dynamo,5538,2,5,7,2,25,17,8,22
Kerala Blast,5538,3,6,3,5,14,15,-1,21
Kolkata,5538,4,4,7,3,17,17,0,19
FC Pune City,5538,5,5,3,6,16,18,-2,18
NorthEast Un,5538,6,5,2,7,12,12,0,17
FC Goa,5538,7,4,4,6,14,16,-2,16
Chennaiyin,5538,8,3,5,6,13,24,-11,14
Delhi Dynamo,5539,1,6,6,2,26,17,9,24
Mumbai City,5539,2,6,5,3,17,9,8,23
Kolkata,5539,3,5,6,3,16,15,1,21
Kerala Blast,5539,4,5,4,5,11,15,-4,19
Chennaiyin,5539,5,4,5,5,15,19,-4,17
FC Goa,5539,6,5,2,7,13,17,-4,17
NorthEast Un,5539,7,4,3,7,10,12,-2,15
FC Pune City,5539,8,4,3,7,14,18,-4,15
Delhi Dynamo,5540,1,7,5,2,27,16,11,26
Kerala Blast,5540,2,7,3,4,12,13,-1,24
Mumbai City,5540,3,6,4,4,17,10,7,22
Kolkata,5540,4,4,6,4,16,15,1,18
NorthEast Un,5540,5,5,2,7,10,12,-2,17
Chennaiyin,5540,6,3,6,5,15,20,-5,15
FC Pune City,5540,7,4,3,7,13,18,-5,15
FC Goa,5540,8,4,3,7,12,18,-6,15
Mumbai City,5541,1,7,4,3,19,8,11,25
Kolkata,5541,2,5,7,2,17,14,3,22
Delhi Dynamo,5541,3,5,5,4,22,19,3,20
NorthEast Un,5541,4,6,2,6,12,11,1,20
Kerala Blast,5541,5,5,4,5,12,15,-3,19
FC Pune City,5541,6,4,4,6,12,15,-3,16
FC Goa,5541,7,4,3,7,11,17,-6,15
Chennaiyin,5541,8,3,5,6,14,20,-6,14
Delhi Dynamo,5542,1,6,6,2,26,15,11,24
Mumbai City,5542,2,6,5,3,16,8,8,23
Kolkata,5542,3,5,6,3,18,14,4,21
FC Pune City,5542,4,5,4,5,15,15,0,19
Chennaiyin,5542,5,4,5,5,16,19,-3,17
Kerala Blast,5542,6,4,5,5,11,17,-6,17
NorthEast Un,5542,7,4,3,7,11,16,-5,15
FC Goa,5542,8,4,2,8,10,19,-9,14
Mumbai City,5543,1,6,5,3,16,8,8,23
Delhi Dynamo,5543,2,5,6,3,24,16,8,21
Kerala Blast,5543,3,6,3,5,11,17,-6,21
FC Pune City,5543,4,5,4,5,17,15,2,19
Kolkata,5543,5,3,8,3,15,15,0,17
NorthEast Un,5543,6,5,2,7,11,12,-1,17
Chennaiyin,5543,7,4,5,5,16,21,-5,17
FC Goa,5543,8,4,3,7,13,19,-6,15
Delhi Dynamo,5544,1,5,7,2,25,17,8,22
Mumbai City,5544,2,6,4,4,17,10,7,22
Kolkata,5544,3,5,7,2,19,13,6,22
NorthEast Un,5544,4,5,3,6,14,12,2,18
Chennaiyin,5544,5,4,6,4,14,17,-3,18
FC Pune City,5544,6,4,4,6,13,16,-3,16
Kerala Blast,5544,7,4,4,6,10,21,-11,16
FC Goa,5544,8,3,5,6,9,15,-6,14
Mumbai City,5545,1,7,4,3,20,11,9,25
Kerala Blast,5545,2,6,4,4,17,18,-1,22
Delhi Dynamo,5545,3,5,5,4,26,21,5,20
NorthEast Un,5545,4,6,2,6,16,13,3,20
Kolkata,5545,5,4,7,3,17,16,1,19
Chennaiyin,5545,6,4,5,5,14,18,-4,17
FC Pune City,5545,7,4,4,6,16,20,-4,16
FC Goa,5545,8,3,3,8,8,17,-9,12
Delhi Dynamo,5546,1,7,5,2,27,15,12,26
Mumbai City,5546,2,6,4,4,16,9,7,22
Kolkata,5546,3,4,7,3,17,16,1,19
Kerala Blast,5546,4,5,4,5,13,18,-5,19
NorthEast Un,5546,5,5,3,6,14,14,0,18
FC Pune City,5546,6,5,3,6,16,17,-1,18
FC Goa,5546,7,4,3,7,11,18,-7,15
Chennaiyin,5546,8,3,5,6,14,21,-7,14
Delhi Dynamo,5547,1,7,5,2,26,15,11,26
Kolkata,5547,2,5,7,2,23,16,7,22
Mumbai City,5547,3,6,4,4,17,10,7,22
FC Pune City,5547,4,5,3,6,14,17,-3,18
Kerala Blast,5547,5,5,3,6,13,19,-6,18
NorthEast Un,5547,6,5,2,7,12,16,-4,17
FC Goa,5547,7,4,3,7,13,17,-4,15
Chennaiyin,5547,8,3,5,6,15,23,-8,14
Delhi Dynamo,5548,1,6,6,2,26,15,11,24
Mumbai City,5548,2,6,5,3,16,8,8,23
Kolkata,5548,3,4,7,3,18,15,3,19
FC Pune City,5548,4,5,4,5,15,16,-1,19
Kerala Blast,5548,5,5,3,6,11,17,-6,18
FC Goa,5548,6,5,2,7,11,15,-4,17
Chennaiyin,5548,7,4,5,5,15,20,-5,17
NorthEast Un,5548,8,4,2,8,11,17,-6,14
Mumbai City,5549,1,7,4,3,17,8,9,25
Delhi Dynamo,5549,2,6,5,3,25,17,8,23
Kolkata,5549,3,5,6,3,16,15,1,21
Kerala Blast,5549,4,6,3,5,15,15,0,21
Chennaiyin,5549,5,5,5,4,19,19,0,20
FC Pune City,5549,6,5,3,6,14,18,-4,18
NorthEast Un,5549,7,4,2,8,11,15,-4,14
FC Goa,5549,8,3,2,9,10,20,-10,11
Mumbai City,5550,1,7,4,3,18,8,10,25
Kolkata,5550,2,5,6,3,17,15,2,21
Kerala Blast,5550,3,6,3,5,14,15,-1,21
Delhi Dynamo,5550,4,5,5,4,23,18,5,20
Chennaiyin,5550,5,4,6,4,16,17,-1,18
NorthEast Un,5550,6,5,2,7,12,15,-3,17
FC Goa,5550,7,4,3,7,11,15,-4,15
FC Pune City,5550,8,4,3,7,12,20,-8,15
Mumbai City,5551,1,6,5,3,16,8,8,23
NorthEast Un,5551,2,7,2,5,19,14,5,23
Kolkata,5551,3,5,7,2,16,13,3,22
Delhi Dynamo,5551,4,4,7,3,25,20,5,19
Kerala Blast,5551,5,4,5,5,11,17,-6,17
FC Pune City,5551,6,4,4,6,12,15,-3,16
Chennaiyin,5551,7,3,6,5,16,21,-5,15
FC Goa,5551,8,3,4,7,11,18,-7,13
Mumbai City,5552,1,7,4,3,17,8,9,25
Delhi Dynamo,5552,2,6,5,3,25,16,9,23
Kerala Blast,5552,3,6,4,4,13,14,-1,22
FC Pune City,5552,4,5,3,6,13,15,-2,18
Chennaiyin,5552,5,4,6,4,15,18,-3,18
Kolkata,5552,6,3,8,3,16,16,0,17
NorthEast Un,5552,7,4,2,8,10,15,-5,14
FC Goa,5552,8,3,4,7,11,18,-7,13
Mumbai City,5553,1,7,4,3,18,9,9,25
Delhi Dynamo,5553,2,6,5,3,24,16,8,23
FC Pune City,5553,3,6,3,5,15,14,1,21
Chennaiyin,5553,4,5,5,4,21,20,1,20
Kolkata,5553,5,4,6,4,15,16,-1,18
Kerala Blast,5553,6,4,4,6,10,16,-6,16
NorthEast Un,5553,7,4,3,7,12,17,-5,15
FC Goa,5553,8,4,2,8,11,18,-7,14
Mumbai City,5554,1,6,5,3,17,9,8,23
Kerala Blast,5554,2,6,4,4,13,13,0,22
Delhi Dynamo,5554,3,4,7,3,24,18,6,19
NorthEast Un,5554,4,5,3,6,12,13,-1,18
Kolkata,5554,5,4,6,4,16,18,-2,18
FC Goa,5554,6,4,4,6,13,15,-2,16
Chennaiyin,5554,7,3,7,4,14,18,-4,16
FC Pune City,5554,8,4,4,6,12,17,-5,16
Delhi Dynamo,5555,1,6,6,2,25,16,9,24
Mumbai City,5555,2,6,4,4,16,9,7,22
Kolkata,5555,3,4,7,3,18,17,1,19
NorthEast Un,5555,4,5,4,5,12,11,1,19
FC Pune City,5555,5,4,5,5,15,17,-2,17
Kerala Blast,5555,6,4,5,5,11,16,-5,17
Chennaiyin,5555,7,3,6,5,14,19,-5,15
FC Goa,5555,8,4,3,7,11,17,-6,15
Delhi Dynamo,5556,1,7,5,2,27,15,12,26
Mumbai City,5556,2,6,4,4,16,9,7,22
Kerala Blast,5556,3,5,5,4,13,16,-3,20
Kolkata,5556,4,4,7,3,18,17,1,19
NorthEast Un,5556,5,5,3,6,12,12,0,18
Chennaiyin,5556,6,4,5,5,15,19,-4,17
FC Pune City,5556,7,4,4,6,14,17,-3,16
FC Goa,5556,8,3,3,8,11,21,-10,12
Mumbai City,5557,1,7,4,3,19,10,9,25
Kolkata,5557,2,6,6,2,19,13,6,24
Delhi Dynamo,5557,3,6,5,3,30,17,13,23
Chennaiyin,5557,4,5,5,4,15,17,-2,20
FC Pune City,5557,5,5,3,6,14,18,-4,18
NorthEast Un,5557,6,5,2,7,12,13,-1,17
Kerala Blast,5557,7,4,3,7,11,20,-9,15
FC Goa,5557,8,3,2,9,8,20,-12,11
Mumbai City,5558,1,7,4,3,19,10,9,25
FC Pune City,5558,2,6,3,5,14,14,0,21
Chennaiyin,5558,3,5,5,4,16,17,-1,20
Kerala Blast,5558,4,5,4,5,13,15,-2,19
Delhi Dynamo,5558,5,4,6,4,25,24,1,18
NorthEast Un,5558,6,5,2,7,14,13,1,17
Kolkata,5558,7,3,7,4,14,15,-1,16
FC Goa,5558,8,4,3,7,11,18,-7,15
Mumbai City,5559,1,7,4,3,18,8,10,25
NorthEast Un,5559,2,7,2,5,16,10,6,23
FC Pune City,5559,3,6,3,5,15,15,0,21
Delhi Dynamo,5559,4,5,5,4,22,17,5,20
Kolkata,5559,5,4,6,4,16,16,0,18
FC Goa,5559,6,5,2,7,14,16,-2,17
Kerala Blast,5559,7,4,3,7,10,19,-9,15
Chennaiyin,5559,8,3,5,6,13,23,-10,14
Kolkata,5560,1,6,6,2,18,12,6,24
Mumbai City,5560,2,6,5,3,17,9,8,23
Delhi Dynamo,5560,3,5,6,3,25,17,8,21
Kerala Blast,5560,4,6,3,5,12,16,-4,21
NorthEast Un,5560,5,6,2,6,13,12,1,20
FC Pune City,5560,6,4,3,7,12,16,-4,15
Chennaiyin,5560,7,3,5,6,15,22,-7,14
FC Goa,5560,8,4,2,8,12,20,-8,14
Mumbai City,5561,1,7,4,3,17,8,9,25
NorthEast Un,5561,2,7,2,5,13,10,3,23
FC Pune City,5561,3,5,4,5,14,15,-1,19
Delhi Dynamo,5561,4,4,6,4,21,16,5,18
Kerala Blast,5561,5,4,5,5,11,16,-5,17
Kolkata,5561,6,3,7,4,14,17,-3,16
FC Goa,5561,7,4,4,6,13,16,-3,16
Chennaiyin,5561,8,3,6,5,16,21,-5,15
Mumbai City,5562,1,7,4,3,18,9,9,25
Delhi Dynamo,5562,2,5,6,3,30,19,11,21
FC Pune City,5562,3,5,4,5,16,17,-1,19
Kerala Blast,5562,4,5,4,5,13,16,-3,19
NorthEast Un,5562,5,5,3,6,15,16,-1,18
Kolkata,5562,6,3,8,3,16,16,0,17
FC Goa,5562,7,5,2,7,11,20,-9,17
Chennaiyin,5562,8,3,5,6,16,22,-6,14
Mumbai City,5563,1,7,4,3,17,8,9,25
Kolkata,5563,2,5,7,2,18,14,4,22
Kerala Blast,5563,3,5,5,4,11,14,-3,20
Delhi Dynamo,5563,4,4,7,3,22,16,6,19
Chennaiyin,5563,5,4,5,5,16,20,-4,17
NorthEast Un,5563,6,4,4,6,11,12,-1,16
FC Pune City,5563,7,4,3,7,13,17,-4,15
FC Goa,5563,8,4,3,7,12,19,-7,15
Delhi Dynamo,5564,1,7,5,2,26,15,11,26
Mumbai City,5564,2,6,4,4,16,10,6,22
Kolkata,5564,3,4,7,3,17,16,1,19
Kerala Blast,5564,4,4,6,4,10,14,-4,18
FC Goa,5564,5,5,2,7,13,15,-2,17
NorthEast Un,5564,6,4,4,6,11,12,-1,16
FC Pune City,5564,7,4,4,6,13,17,-4,16
Chennaiyin,5564,8,3,6,5,14,21,-7,15
Mumbai City,5565,1,6,4,4,17,11,6,22
Delhi Dynamo,5565,2,5,6,3,25,17,8,21
Kerala Blast,5565,3,5,5,4,11,14,-3,20
NorthEast Un,5565,4,5,4,5,12,9,3,19
Kolkata,5565,5,4,7,3,16,15,1,19
Chennaiyin,5565,6,4,5,5,16,20,-4,17
FC Goa,5565,7,5,2,7,12,19,-7,17
FC Pune City,5565,8,4,3,7,12,16,-4,15
Delhi Dynamo,5566,1,6,5,3,24,16,8,23
Mumbai City,5566,2,6,4,4,17,10,7,22
Chennaiyin,5566,3,5,5,4,16,17,-1,20
FC Pune City,5566,4,5,3,6,13,15,-2,18
Kolkata,5566,5,4,6,4,14,18,-4,18
Kerala Blast,5566,6,5,3,6,13,17,-4,18
NorthEast Un,5566,7,5,2,7,12,12,0,17
FC Goa,5566,8,5,2,7,12,16,-4,17
Mumbai City,5567,1,6,5,3,17,9,8,23
Delhi Dynamo,5567,2,5,7,2,24,16,8,22
Kolkata,5567,3,5,7,2,19,15,4,22
NorthEast Un,5567,4,6,3,5,12,10,2,21
FC Pune City,5567,5,5,3,6,16,17,-1,18
FC Goa,5567,6,4,3,7,12,18,-6,15
Kerala Blast,5567,7,4,3,7,10,19,-9,15
Chennaiyin,5567,8,3,5,6,14,20,-6,14
Mumbai City,5568,1,7,4,3,17,8,9,25
Kolkata,5568,2,6,6,2,19,13,6,24
Delhi Dynamo,5568,3,6,5,3,26,18,8,23
Kerala Blast,5568,4,6,3,5,14,18,-4,21
NorthEast Un,5568,5,5,2,7,15,13,2,17
FC Pune City,5568,6,4,3,7,14,19,-5,15
Chennaiyin,5568,7,3,6,5,13,21,-8,15
FC Goa,5568,8,3,3,8,9,17,-8,12
Delhi Dynamo,5569,1,6,5,3,26,17,9,23
Mumbai City,5569,2,6,4,4,17,11,6,22
Kolkata,5569,3,4,7,3,18,17,1,19
Kerala Blast,5569,4,5,4,5,13,16,-3,19
Chennaiyin,5569,5,4,6,4,16,18,-2,18
FC Goa,5569,6,5,3,6,14,17,-3,18
NorthEast Un,5569,7,5,2,7,11,13,-2,17
FC Pune City,5569,8,4,3,7,13,19,-6,15
Mumbai City,5570,1,6,5,3,17,9,8,23
Kolkata,5570,2,5,7,2,20,13,7,22
NorthEast Un,5570,3,6,2,6,13,12,1,20
Delhi Dynamo,5570,4,4,6,4,23,18,5,18
FC Goa,5570,5,5,3,6,13,15,-2,18
Chennaiyin,5570,6,4,5,5,15,21,-6,17
FC Pune City,5570,7,4,4,6,13,17,-4,16
Kerala Blast,5570,8,4,4,6,10,19,-9,16
Mumbai City,5571,1,7,4,3,18,8,10,25
Kolkata,5571,2,5,6,3,22,19,3,21
Kerala Blast,5571,3,6,3,5,12,16,-4,21
Delhi Dynamo,5571,4,4,7,3,23,18,5,19
NorthEast Un,5571,5,5,3,6,14,12,2,18
FC Pune City,5571,6,5,3,6,17,19,-2,18
Chennaiyin,5571,7,3,6,5,14,21,-7,15
FC Goa,5571,8,3,4,7,11,18,-7,13
Mumbai City,5572,1,7,4,3,19,8,11,25
Delhi Dynamo,5572,2,6,5,3,25,19,6,23
Kolkata,5572,3,5,7,2,17,13,4,22
Kerala Blast,5572,4,5,4,5,12,16,-4,19
Chennaiyin,5572,5,4,6,4,16,19,-3,18
NorthEast Un,5572,6,5,2,7,14,15,-1,17
FC Pune City,5572,7,4,3,7,12,17,-5,15
FC Goa,5572,8,3,3,8,9,17,-8,12
Mumbai City,5573,1,7,4,3,17,8,9,25
Chennaiyin,5573,2,5,5,4,17,17,0,20
Delhi Dynamo,5573,3,4,7,3,22,16,6,19
FC Pune City,5573,4,5,4,5,16,15,1,19
Kerala Blast,5573,5,4,6,4,11,15,-4,18
Kolkata,5573,6,3,8,3,17,19,-2,17
NorthEast Un,5573,7,4,4,6,11,12,-1,16
FC Goa,5573,8,3,4,7,10,19,-9,13
Kerala Blast,5574,1,7,3,4,17,14,3,24
Mumbai City,5574,2,6,5,3,16,8,8,23
Delhi Dynamo,5574,3,5,6,3,24,18,6,21
FC Goa,5574,4,5,3,6,14,14,0,18
FC Pune City,5574,5,5,3,6,15,17,-2,18
Chennaiyin,5574,6,4,5,5,16,21,-5,17
Kolkata,5574,7,3,7,4,15,19,-4,16
NorthEast Un,5574,8,4,2,8,11,17,-6,14
Mumbai City,5575,1,7,4,3,18,9,9,25
Delhi Dynamo,5575,2,6,5,3,29,17,12,23
Kolkata,5575,3,4,7,3,17,15,2,19
Kerala Blast,5575,4,4,6,4,9,13,-4,18
Chennaiyin,5575,5,4,5,5,16,20,-4,17
FC Goa,5575,6,5,2,7,14,19,-5,17
FC Pune City,5575,7,4,4,6,13,18,-5,16
NorthEast Un,5575,8,4,3,7,9,14,-5,15
Mumbai City,5576,1,7,4,3,18,8,10,25
Delhi Dynamo,5576,2,5,5,4,23,18,5,20
Kolkata,5576,3,4,7,3,16,15,1,19
NorthEast Un,5576,4,5,4,5,11,10,1,19
FC Pune City,5576,5,5,4,5,14,15,-1,19
Kerala Blast,5576,6,4,5,5,10,15,-5,17
Chennaiyin,5576,7,3,6,5,14,19,-5,15
FC Goa,5576,8,4,3,7,12,18,-6,15
Mumbai City,5577,1,7,4,3,18,8,10,25
Kolkata,5577,2,5,6,3,17,14,3,21
Delhi Dynamo,5577,3,5,5,4,22,19,3,20
Chennaiyin,5577,4,5,5,4,19,19,0,20
FC Pune City,5577,5,5,3,6,14,17,-3,18
Kerala Blast,5577,6,5,3,6,12,17,-5,18
NorthEast Un,5577,7,5,2,7,14,13,1,17
FC Goa,5577,8,4,2,8,9,18,-9,14
Mumbai City,5578,1,6,5,3,18,10,8,23
Delhi Dynamo,5578,2,5,6,3,24,18,6,21
Kerala Blast,5578,3,5,4,5,13,18,-5,19
NorthEast Un,5578,4,5,3,6,12,10,2,18
FC Goa,5578,5,5,3,6,12,15,-3,18
Kolkata,5578,6,3,8,3,17,17,0,17
Chennaiyin,5578,7,3,7,4,14,18,-4,16
FC Pune City,5578,7,4,4,6,14,18,-4,16
Mumbai City,5579,1,7,4,3,17,8,9,25
Delhi Dynamo,5579,2,5,6,3,23,15,8,21
Kerala Blast,5579,3,5,5,4,12,15,-3,20
Kolkata,5579,4,4,7,3,16,15,1,19
FC Pune City,5579,5,4,5,5,12,14,-2,17
Chennaiyin,5579,6,4,5,5,16,20,-4,17
NorthEast Un,5579,7,4,4,6,10,12,-2,16
FC Goa,5579,8,4,2,8,12,19,-7,14
Mumbai City,5580,1,6,5,3,18,10,8,23
Delhi Dynamo,5580,2,4,8,2,26,19,7,20
Kolkata,5580,3,4,7,3,16,15,1,19
Kerala Blast,5580,4,5,4,5,12,15,-3,19
Chennaiyin,5580,5,4,6,4,17,18,-1,18
NorthEast Un,5580,6,4,4,6,10,13,-3,16
FC Pune City,5580,7,4,4,6,12,16,-4,16
FC Goa,5580,8,4,4,6,13,18,-5,16
Mumbai City,5581,1,6,5,3,16,8,8,23
Delhi Dynamo,5581,2,5,6,3,23,16,7,21
Chennaiyin,5581,3,5,5,4,19,18,1,20
FC Pune City,5581,4,5,4,5,13,14,-1,19
Kerala Blast,5581,5,5,4,5,12,16,-4,19
Kolkata,5581,6,3,9,2,16,15,1,18
NorthEast Un,5581,7,5,2,7,11,14,-3,17
FC Goa,5581,8,3,3,8,10,19,-9,12
Kerala Blast,5582,1,7,3,4,13,13,0,24
Delhi Dynamo,5582,2,6,5,3,32,19,13,23
Mumbai City,5582,3,6,4,4,16,14,2,22
Kolkata,5582,4,4,7,3,17,16,1,19
FC Goa,5582,5,5,3,6,16,20,-4,18
NorthEast Un,5582,6,5,2,7,13,14,-1,17
FC Pune City,5582,7,4,3,7,13,18,-5,15
Chennaiyin,5582,8,3,5,6,16,22,-6,14
Mumbai City,5583,1,6,5,3,17,9,8,23
Kerala Blast,5583,2,6,4,4,15,14,1,22
FC Goa,5583,3,6,2,6,15,16,-1,20
NorthEast Un,5583,4,5,4,5,13,11,2,19
Delhi Dynamo,5583,5,4,6,4,24,20,4,18
Kolkata,5583,6,4,6,4,17,19,-2,18
Chennaiyin,5583,7,3,6,5,13,18,-5,15
FC Pune City,5583,8,4,3,7,12,19,-7,15
Delhi Dynamo,5584,1,6,5,3,26,16,10,23
Mumbai City,5584,2,6,4,4,16,9,7,22
Kerala Blast,5584,3,6,4,4,16,17,-1,22
Chennaiyin,5584,4,5,5,4,18,20,-2,20
NorthEast Un,5584,5,5,3,6,14,14,0,18
Kolkata,5584,6,3,7,4,14,16,-2,16
FC Pune City,5584,7,4,4,6,16,20,-4,16
FC Goa,5584,8,4,2,8,11,19,-8,14
Mumbai City,5585,1,7,4,3,20,11,9,25
Kolkata,5585,2,5,7,2,18,14,4,22
Kerala Blast,5585,3,5,4,5,12,16,-4,19
Delhi Dynamo,5585,4,4,6,4,26,21,5,18
Chennaiyin,5585,5,4,6,4,16,19,-3,18
NorthEast Un,5585,6,4,5,5,13,13,0,17
FC Pune City,5585,7,4,4,6,13,16,-3,16
FC Goa,5585,8,4,2,8,10,18,-8,14
Mumbai City,5586,1,7,4,3,21,8,13,25
NorthEast Un,5586,2,6,3,5,14,10,4,21
Delhi Dynamo,5586,3,5,5,4,23,23,0,20
Kerala Blast,5586,4,5,5,4,11,14,-3,20
Kolkata,5586,5,3,9,2,15,14,1,18
FC Pune City,5586,6,4,4,6,13,16,-3,16
FC Goa,5586,7,4,3,7,12,17,-5,15
Chennaiyin,5586,8,3,5,6,13,20,-7,14
Mumbai City,5587,1,6,4,4,16,9,7,22
Delhi Dynamo,5587,2,5,5,4,23,19,4,20
NorthEast Un,5587,3,6,2,6,15,11,4,20
Kolkata,5587,4,4,6,4,15,15,0,18
FC Pune City,5587,5,5,3,6,14,15,-1,18
Chennaiyin,5587,6,4,6,4,14,17,-3,18
FC Goa,5587,7,5,3,6,11,15,-4,18
Kerala Blast,5587,8,5,3,6,10,17,-7,18
Mumbai City,5588,1,6,5,3,18,10,8,23
Delhi Dynamo,5588,2,5,7,2,24,16,8,22
Kolkata,5588,3,4,7,3,18,17,1,19
NorthEast Un,5588,4,5,3,6,11,11,0,18
FC Pune City,5588,5,4,5,5,15,17,-2,17
Chennaiyin,5588,6,3,7,4,14,18,-4,16
FC Goa,5588,7,4,4,6,10,14,-4,16
Kerala Blast,5588,8,4,4,6,11,18,-7,16
Mumbai City,5589,1,6,5,3,16,8,8,23
Delhi Dynamo,5589,2,5,6,3,25,17,8,21
Kolkata,5589,3,4,8,2,15,13,2,20
Kerala Blast,5589,4,5,5,4,13,14,-1,20
Chennaiyin,5589,5,5,5,4,17,19,-2,20
NorthEast Un,5589,6,5,2,7,12,15,-3,17
FC Pune City,5589,7,4,4,6,12,15,-3,16
FC Goa,5589,8,3,3,8,10,19,-9,12
NorthEast Un,5590,1,7,2,5,19,10,9,23
Delhi Dynamo,5590,2,6,5,3,23,19,4,23
Mumbai City,5590,3,6,4,4,16,9,7,22
Kolkata,5590,4,5,6,3,18,16,2,21
Kerala Blast,5590,5,5,3,6,12,18,-6,18
FC Goa,5590,6,5,2,7,12,16,-4,17
FC Pune City,5590,7,4,3,7,13,17,-4,15
Chennaiyin,5590,8,3,5,6,13,21,-8,14
Mumbai City,5591,1,6,5,3,18,10,8,23
Delhi Dynamo,5591,2,5,6,3,24,19,5,21
Kolkata,5591,3,5,6,3,19,15,4,21
FC Goa,5591,4,5,3,6,15,16,-1,18
Chennaiyin,5591,5,4,6,4,16,19,-3,18
Kerala Blast,5591,6,5,3,6,12,19,-7,18
NorthEast Un,5591,7,5,2,7,11,12,-1,17
FC Pune City,5591,8,4,3,7,12,17,-5,15
Delhi Dynamo,5592,1,7,5,2,29,16,13,26
Mumbai City,5592,2,6,4,4,16,10,6,22
Kolkata,5592,3,4,8,2,18,16,2,20
FC Pune City,5592,4,5,4,5,15,16,-1,19
NorthEast Un,5592,5,5,3,6,14,15,-1,18
Kerala Blast,5592,6,4,5,5,12,17,-5,17
Chennaiyin,5592,7,3,6,5,15,20,-5,15
FC Goa,5592,8,3,3,8,11,20,-9,12
Mumbai City,5593,1,7,4,3,19,8,11,25
Kolkata,5593,2,5,7,2,18,13,5,22
Delhi Dynamo,5593,3,5,6,3,25,18,7,21
NorthEast Un,5593,4,5,3,6,13,13,0,18
Chennaiyin,5593,5,4,5,5,14,20,-6,17
FC Pune City,5593,6,4,4,6,12,17,-5,16
Kerala Blast,5593,7,4,4,6,11,17,-6,16
FC Goa,5593,8,4,3,7,12,18,-6,15
Mumbai City,5594,1,6,5,3,18,10,8,23
Delhi Dynamo,5594,2,5,7,2,25,17,8,22
Kolkata,5594,3,5,7,2,18,13,5,22
Kerala Blast,5594,4,5,4,5,12,16,-4,19
NorthEast Un,5594,5,5,3,6,11,12,-1,18
FC Pune City,5594,6,4,4,6,12,16,-4,16
Chennaiyin,5594,7,3,6,5,15,20,-5,15
FC Goa,5594,8,3,4,7,10,17,-7,13
Delhi Dynamo,5595,1,5,7,2,24,16,8,22
Mumbai City,5595,2,6,4,4,17,10,7,22
Kerala Blast,5595,3,5,5,4,11,13,-2,20
Kolkata,5595,4,3,9,2,16,15,1,18
NorthEast Un,5595,5,4,5,5,12,12,0,17
FC Goa,5595,6,4,4,6,13,15,-2,16
FC Pune City,5595,7,4,4,6,14,18,-4,16
Chennaiyin,5595,8,3,6,5,15,23,-8,15
Mumbai City,5596,1,6,5,3,16,8,8,23
NorthEast Un,5596,2,6,3,5,17,13,4,21
Kerala Blast,5596,3,6,3,5,13,16,-3,21
Delhi Dynamo,5596,4,4,7,3,24,20,4,19
Kolkata,5596,5,4,7,3,19,15,4,19
FC Goa,5596,6,4,4,6,14,19,-5,16
Chennaiyin,5596,7,3,6,5,17,22,-5,15
FC Pune City,5596,8,4,3,7,12,19,-7,15
NorthEast Un,5597,1,7,2,5,16,10,6,23
Mumbai City,5597,2,6,4,4,16,9,7,22
Delhi Dynamo,5597,3,5,5,4,24,19,5,20
Kolkata,5597,4,4,7,3,18,18,0,19
FC Goa,5597,5,5,2,7,15,18,-3,17
Chennaiyin,5597,6,4,5,5,15,20,-5,17
Kerala Blast,5597,7,4,5,5,10,16,-6,17
FC Pune City,5597,8,4,4,6,13,17,-4,16
Kolkata,5598,1,6,6,2,23,15,8,24
Mumbai City,5598,2,6,5,3,17,9,8,23
Delhi Dynamo,5598,3,4,7,3,22,16,6,19
Chennaiyin,5598,4,4,6,4,16,19,-3,18
NorthEast Un,5598,5,4,5,5,11,11,0,17
Kerala Blast,5598,6,4,5,5,12,18,-6,17
FC Pune City,5598,7,4,4,6,15,21,-6,16
FC Goa,5598,8,4,2,8,10,17,-7,14
Mumbai City,5599,1,6,5,3,17,9,8,23
FC Pune City,5599,2,6,3,5,17,17,0,21
Delhi Dynamo,5599,3,4,7,3,25,20,5,19
Kolkata,5599,4,4,7,3,19,18,1,19
NorthEast Un,5599,5,5,3,6,13,13,0,18
Kerala Blast,5599,6,5,3,6,15,19,-4,18
FC Goa,5599,7,4,4,6,14,19,-5,16
Chennaiyin,5599,8,3,6,5,15,20,-5,15
Mumbai City,5600,1,6,5,3,17,9,8,23
Delhi Dynamo,5600,2,5,7,2,25,17,8,22
Kerala Blast,5600,3,6,4,4,16,16,0,22
Kolkata,5600,4,5,6,3,18,16,2,21
Chennaiyin,5600,5,5,5,4,18,17,1,20
FC Pune City,5600,6,4,4,6,13,16,-3,16
NorthEast Un,5600,7,4,2,8,9,15,-6,14
FC Goa,5600,8,3,3,8,10,20,-10,12
Mumbai City,5601,1,7,4,3,18,9,9,25
Kerala Blast,5601,2,5,5,4,13,16,-3,20
NorthEast Un,5601,3,5,4,5,12,10,2,19
FC Goa,5601,4,5,3,6,12,16,-4,18
Delhi Dynamo,5601,5,4,5,5,22,19,3,17
Kolkata,5601,6,3,8,3,14,14,0,17
FC Pune City,5601,7,4,4,6,13,16,-3,16
Chennaiyin,5601,8,3,7,4,15,19,-4,16
Mumbai City,5602,1,7,4,3,17,8,9,25
Delhi Dynamo,5602,2,6,5,3,26,16,10,23
Kerala Blast,5602,3,6,4,4,17,17,0,22
Kolkata,5602,4,4,6,4,16,16,0,18
Chennaiyin,5602,5,4,5,5,17,18,-1,17
FC Goa,5602,6,5,2,7,12,18,-6,17
FC Pune City,5602,7,4,3,7,13,19,-6,15
NorthEast Un,5602,8,4,3,7,12,18,-6,15
Delhi Dynamo,5603,1,5,7,2,25,17,8,22
Mumbai City,5603,2,6,4,4,17,10,7,22
Kolkata,5603,3,5,6,3,17,15,2,21
FC Goa,5603,4,5,3,6,14,15,-1,18
NorthEast Un,5603,5,5,3,6,13,15,-2,18
Chennaiyin,5603,6,4,5,5,16,20,-4,17
FC Pune City,5603,7,4,4,6,13,17,-4,16
Kerala Blast,5603,8,4,4,6,11,17,-6,16
Mumbai City,5604,1,6,5,3,16,8,8,23
Kerala Blast,5604,2,6,3,5,13,17,-4,21
FC Goa,5604,3,6,2,6,14,17,-3,20
Delhi Dynamo,5604,4,4,7,3,24,18,6,19
Kolkata,5604,5,4,6,4,17,16,1,18
NorthEast Un,5604,6,5,3,6,15,14,1,18
Chennaiyin,5604,7,4,5,5,16,20,-4,17
FC Pune City,5604,8,4,3,7,12,17,-5,15
Mumbai City,5605,1,6,4,4,16,9,7,22
Delhi Dynamo,5605,2,5,6,3,25,19,6,21
Kolkata,5605,3,5,6,3,19,15,4,21
Kerala Blast,5605,4,6,3,5,13,16,-3,21
Chennaiyin,5605,5,4,6,4,16,18,-2,18
FC Goa,5605,6,5,3,6,14,17,-3,18
NorthEast Un,5605,7,4,3,7,11,14,-3,15
FC Pune City,5605,8,4,3,7,14,20,-6,15
Delhi Dynamo,5606,1,6,6,2,26,16,10,24
Mumbai City,5606,2,6,4,4,17,10,7,22
Kolkata,5606,3,4,8,2,14,12,2,20
Kerala Blast,5606,4,5,5,4,14,15,-1,20
Chennaiyin,5606,5,4,6,4,16,18,-2,18
FC Pune City,5606,6,4,4,6,13,16,-3,16
NorthEast Un,5606,7,4,3,7,12,17,-5,15
FC Goa,5606,8,3,4,7,8,16,-8,13
Mumbai City,5607,1,6,5,3,16,8,8,23
Kolkata,5607,2,5,7,2,18,14,4,22
Delhi Dynamo,5607,3,5,6,3,23,15,8,21
NorthEast Un,5607,4,6,3,5,14,11,3,21
Chennaiyin,5607,5,4,6,4,16,19,-3,18
FC Pune City,5607,6,4,4,6,14,18,-4,16
Kerala Blast,5607,7,4,4,6,13,20,-7,16
FC Goa,5607,8,3,3,8,10,19,-9,12
Mumbai City,5608,1,7,4,3,17,8,9,25
Delhi Dynamo,5608,2,5,5,4,22,17,5,20
Kerala Blast,5608,3,5,5,4,11,14,-3,20
Kolkata,5608,4,3,9,2,16,15,1,18
NorthEast Un,5608,5,5,2,7,11,12,-1,17
FC Pune City,5608,6,4,5,5,13,15,-2,17
Chennaiyin,5608,7,4,5,5,15,18,-3,17
FC Goa,5608,8,4,3,7,10,16,-6,15
Delhi Dynamo,5609,1,7,5,2,29,14,15,26
Mumbai City,5609,2,6,4,4,16,10,6,22
Kolkata,5609,3,4,8,2,17,13,4,20
Kerala Blast,5609,4,5,4,5,14,19,-5,19
FC Pune City,5609,5,5,3,6,15,18,-3,18
NorthEast Un,5609,6,5,2,7,13,17,-4,17
FC Goa,5609,7,4,3,7,10,16,-6,15
Chennaiyin,5609,8,3,5,6,14,21,-7,14
Mumbai City,5610,1,6,5,3,16,8,8,23
Delhi Dynamo,5610,2,5,7,2,23,15,8,22
NorthEast Un,5610,3,6,2,6,12,11,1,20
Kolkata,5610,4,4,7,3,18,17,1,19
Kerala Blast,5610,5,5,4,5,14,18,-4,19
FC Goa,5610,6,5,3,6,13,16,-3,18
FC Pune City,5610,7,4,3,7,14,19,-5,15
Chennaiyin,5610,8,3,5,6,14,20,-6,14
Mumbai City,5611,1,7,4,3,17,8,9,25
Kerala Blast,5611,2,7,3,4,21,17,4,24
Chennaiyin,5611,3,5,5,4,17,19,-2,20
Delhi Dynamo,5611,4,4,6,4,22,17,5,18
FC Goa,5611,5,5,2,7,13,17,-4,17
Kolkata,5611,6,3,7,4,17,19,-2,16
FC Pune City,5611,7,4,4,6,12,16,-4,16
NorthEast Un,5611,8,4,3,7,10,16,-6,15
Delhi Dynamo,5612,1,5,7,2,25,17,8,22
Mumbai City,5612,2,6,4,4,17,10,7,22
NorthEast Un,5612,3,6,3,5,13,10,3,21
Kolkata,5612,4,4,7,3,16,16,0,19
Kerala Blast,5612,5,5,4,5,11,16,-5,19
FC Pune City,5612,6,5,3,6,14,15,-1,18
FC Goa,5612,7,4,3,7,12,18,-6,15
Chennaiyin,5612,8,3,5,6,14,20,-6,14
Mumbai City,5613,1,7,4,3,17,8,9,25
Delhi Dynamo,5613,2,5,6,3,22,15,7,21
Kerala Blast,5613,3,5,4,5,13,15,-2,19
Kolkata,5613,4,4,6,4,14,15,-1,18
FC Pune City,5613,5,5,3,6,14,17,-3,18
Chennaiyin,5613,6,4,5,5,16,19,-3,17
FC Goa,5613,7,5,2,7,11,16,-5,17
NorthEast Un,5613,8,4,4,6,10,12,-2,16
Delhi Dynamo,5614,1,6,6,2,30,17,13,24
Mumbai City,5614,2,6,4,4,18,13,5,22
Kolkata,5614,3,5,7,2,17,14,3,22
NorthEast Un,5614,4,6,3,5,14,12,2,21
FC Pune City,5614,5,5,3,6,16,17,-1,18
Kerala Blast,5614,6,4,4,6,12,19,-7,16
Chennaiyin,5614,7,3,5,6,15,21,-6,14
FC Goa,5614,8,4,2,8,10,19,-9,14
Delhi Dynamo,5615,1,6,5,3,26,19,7,23
Mumbai City,5615,2,6,4,4,16,9,7,22
Kolkata,5615,3,4,7,3,17,15,2,19
NorthEast Un,5615,4,5,3,6,11,11,0,18
FC Goa,5615,5,5,3,6,13,16,-3,18
Kerala Blast,5615,6,4,5,5,11,16,-5,17
FC Pune City,5615,7,4,4,6,14,18,-4,16
Chennaiyin,5615,8,3,7,4,13,17,-4,16
Delhi Dynamo,5616,1,6,6,2,24,15,9,24
Mumbai City,5616,2,6,4,4,16,9,7,22
Kolkata,5616,3,5,6,3,17,15,2,21
Kerala Blast,5616,4,5,4,5,11,15,-4,19
Chennaiyin,5616,5,4,6,4,16,18,-2,18
FC Goa,5616,6,4,4,6,11,16,-5,16
NorthEast Un,5616,7,4,3,7,9,12,-3,15
FC Pune City,5616,8,4,3,7,15,19,-4,15
Mumbai City,5617,1,7,4,3,18,9,9,25
Kolkata,5617,2,4,8,2,14,12,2,20
NorthEast Un,5617,3,6,2,6,13,11,2,20
Kerala Blast,5617,4,5,4,5,12,16,-4,19
Delhi Dynamo,5617,5,4,6,4,23,18,5,18
FC Pune City,5617,6,4,5,5,13,15,-2,17
Chennaiyin,5617,7,3,6,5,15,21,-6,15
FC Goa,5617,8,3,5,6,11,17,-6,14
Mumbai City,5618,1,6,5,3,17,9,8,23
Kolkata,5618,2,5,7,2,19,16,3,22
Kerala Blast,5618,3,6,4,4,15,16,-1,22
Delhi Dynamo,5618,4,5,6,3,26,19,7,21
Chennaiyin,5618,5,3,7,4,16,20,-4,16
FC Goa,5618,6,4,3,7,15,19,-4,15
FC Pune City,5618,7,4,3,7,14,18,-4,15
NorthEast Un,5618,8,4,3,7,10,15,-5,15
Mumbai City,5619,1,7,4,3,18,8,10,25
NorthEast Un,5619,2,6,3,5,15,13,2,21
Delhi Dynamo,5619,3,5,5,4,23,18,5,20
Kerala Blast,5619,4,5,4,5,12,16,-4,19
Kolkata,5619,5,4,6,4,18,18,0,18
FC Goa,5619,6,5,2,7,13,18,-5,17
FC Pune City,5619,7,4,4,6,13,16,-3,16
Chennaiyin,5619,8,3,6,5,16,21,-5,15
Delhi Dynamo,5620,1,6,6,2,27,17,10,24
Mumbai City,5620,2,6,4,4,17,10,7,22
Kolkata,5620,3,4,8,2,17,15,2,20
Kerala Blast,5620,4,5,5,4,13,16,-3,20
NorthEast Un,5620,5,5,2,7,12,13,-1,17
FC Pune City,5620,6,4,4,6,14,17,-3,16
FC Goa,5620,7,4,4,6,11,16,-5,16
Chennaiyin,5620,8,3,5,6,14,21,-7,14
Delhi Dynamo,5621,1,7,5,2,28,18,10,26
Mumbai City,5621,2,6,4,4,18,11,7,22
Kerala Blast,5621,3,6,4,4,14,13,1,22
FC Pune City,5621,4,5,3,6,15,19,-4,18
Kolkata,5621,5,3,8,3,15,15,0,17
Chennaiyin,5621,6,3,7,4,15,19,-4,16
NorthEast Un,5621,7,4,3,7,10,13,-3,15
FC Goa,5621,8,3,4,7,11,18,-7,13
Mumbai City,5622,1,6,4,4,16,10,6,22
Kolkata,5622,2,5,6,3,15,13,2,21
NorthEast Un,5622,3,6,3,5,13,11,2,21
Delhi Dynamo,5622,4,5,5,4,25,18,7,20
FC Pune City,5622,5,5,3,6,13,15,-2,18
FC Goa,5622,6,5,3,6,13,17,-4,18
Kerala Blast,5622,7,4,4,6,10,16,-6,16
Chennaiyin,5622,8,3,6,5,15,20,-5,15
Delhi Dynamo,5623,1,6,6,2,26,15,11,24
Mumbai City,5623,2,6,5,3,16,8,8,23
Kolkata,5623,3,5,7,2,17,14,3,22
FC Pune City,5623,4,5,3,6,13,15,-2,18
Kerala Blast,5623,5,5,3,6,10,15,-5,18
NorthEast Un,5623,6,5,2,7,12,12,0,17
FC Goa,5623,7,4,3,7,13,21,-8,15
Chennaiyin,5623,8,3,5,6,15,22,-7,14
Delhi Dynamo,5624,1,6,6,2,28,16,12,24
Mumbai City,5624,2,6,4,4,17,10,7,22
Kolkata,5624,3,5,7,2,19,16,3,22
Kerala Blast,5624,4,5,4,5,13,17,-4,19
NorthEast Un,5624,5,5,3,6,12,13,-1,18
Chennaiyin,5624,6,4,6,4,17,19,-2,18
FC Pune City,5624,7,4,3,7,14,18,-4,15
FC Goa,5624,8,3,3,8,10,21,-11,12
Mumbai City,5625,1,7,4,3,18,9,9,25
Kerala Blast,5625,2,7,3,4,13,14,-1,24
Delhi Dynamo,5625,3,6,5,3,28,16,12,23
Kolkata,5625,4,4,6,4,14,14,0,18
FC Pune City,5625,5,5,3,6,14,16,-2,18
NorthEast Un,5625,6,5,2,7,10,11,-1,17
Chennaiyin,5625,7,3,6,5,14,19,-5,15
FC Goa,5625,8,3,3,8,9,21,-12,12
Mumbai City,5626,1,7,4,3,18,8,10,25
Kolkata,5626,2,6,6,2,18,13,5,24
Delhi Dynamo,5626,3,5,6,3,26,19,7,21
Kerala Blast,5626,4,5,4,5,13,16,-3,19
Chennaiyin,5626,5,4,6,4,17,18,-1,18
NorthEast Un,5626,6,4,4,6,12,15,-3,16
FC Pune City,5626,7,4,3,7,12,18,-6,15
FC Goa,5626,8,3,3,8,10,19,-9,12
Mumbai City,5627,1,7,4,3,18,8,10,25
Delhi Dynamo,5627,2,6,5,3,27,18,9,23
Kolkata,5627,3,4,8,2,16,13,3,20
FC Pune City,5627,4,4,5,5,12,14,-2,17
NorthEast Un,5627,5,5,2,7,12,15,-3,17
Chennaiyin,5627,6,4,5,5,15,20,-5,17
Kerala Blast,5627,7,4,4,6,10,17,-7,16
FC Goa,5627,8,4,3,7,13,18,-5,15
Mumbai City,5628,1,7,4,3,17,8,9,25
Kerala Blast,5628,2,7,3,4,15,16,-1,24
Delhi Dynamo,5628,3,5,6,3,23,16,7,21
FC Pune City,5628,4,5,3,6,17,17,0,18
Chennaiyin,5628,5,4,5,5,14,19,-5,17
Kolkata,5628,6,3,7,4,14,17,-3,16
NorthEast Un,5628,7,4,3,7,11,13,-2,15
FC Goa,5628,8,4,3,7,11,16,-5,15
Mumbai City,5629,1,7,4,3,19,10,9,25
Delhi Dynamo,5629,2,6,5,3,28,19,9,23
Kolkata,5629,3,5,6,3,17,15,2,21
FC Pune City,5629,4,5,3,6,15,16,-1,18
Kerala Blast,5629,5,5,3,6,11,17,-6,18
Chennaiyin,5629,6,3,7,4,14,18,-4,16
NorthEast Un,5629,7,4,3,7,10,13,-3,15
FC Goa,5629,8,4,3,7,12,18,-6,15
Delhi Dynamo,5630,1,5,7,2,25,17,8,22
Mumbai City,5630,2,6,4,4,17,10,7,22
Kolkata,5630,3,4,8,2,14,12,2,20
NorthEast Un,5630,4,5,3,6,12,10,2,18
Kerala Blast,5630,5,5,3,6,10,17,-7,18
Chennaiyin,5630,6,4,5,5,14,19,-5,17
FC Pune City,5630,7,4,4,6,12,15,-3,16
FC Goa,5630,8,4,4,6,12,16,-4,16
Delhi Dynamo,5631,1,6,6,2,25,16,9,24
Mumbai City,5631,2,6,5,3,17,9,8,23
Kerala Blast,5631,3,5,4,5,16,20,-4,19
Kolkata,5631,4,4,6,4,17,18,-1,18
FC Pune City,5631,5,5,3,6,16,19,-3,18
FC Goa,5631,6,5,2,7,14,16,-2,17
NorthEast Un,5631,7,4,4,6,14,15,-1,16
Chennaiyin,5631,8,3,6,5,16,22,-6,15
Mumbai City,5632,1,7,4,3,18,9,9,25
Kerala Blast,5632,2,6,4,4,12,14,-2,22
Delhi Dynamo,5632,3,4,6,4,26,21,5,18
FC Pune City,5632,4,5,3,6,15,16,-1,18
Chennaiyin,5632,5,4,6,4,16,18,-2,18
Kolkata,5632,6,3,8,3,16,17,-1,17
NorthEast Un,5632,7,5,2,7,12,14,-2,17
FC Goa,5632,8,3,5,6,12,18,-6,14
Delhi Dynamo,5633,1,6,6,2,27,16,11,24
Mumbai City,5633,2,6,4,4,16,9,7,22
Kolkata,5633,3,4,8,2,15,13,2,20
FC Pune City,5633,4,5,4,5,15,15,0,19
NorthEast Un,5633,5,5,3,6,14,13,1,18
Chennaiyin,5633,6,4,5,5,15,18,-3,17
Kerala Blast,5633,7,4,4,6,11,20,-9,16
FC Goa,5633,8,4,2,8,9,18,-9,14
Mumbai City,5634,1,7,4,3,17,8,9,25
Kolkata,5634,2,6,6,2,20,15,5,24
Delhi Dynamo,5634,3,6,5,3,24,16,8,23
Kerala Blast,5634,4,5,4,5,13,17,-4,19
NorthEast Un,5634,5,5,3,6,15,13,2,18
FC Pune City,5634,6,4,3,7,13,18,-5,15
Chennaiyin,5634,7,3,6,5,14,21,-7,15
FC Goa,5634,8,3,3,8,8,16,-8,12
Mumbai City,5635,1,7,4,3,18,9,9,25
NorthEast Un,5635,2,6,3,5,14,11,3,21
FC Goa,5635,3,6,2,6,14,16,-2,20
Kolkata,5635,4,4,7,3,15,14,1,19
Kerala Blast,5635,5,5,4,5,13,17,-4,19
Delhi Dynamo,5635,6,4,5,5,23,19,4,17
FC Pune City,5635,7,4,4,6,15,18,-3,16
Chennaiyin,5635,8,3,5,6,15,23,-8,14
Delhi Dynamo,5636,1,7,5,2,27,16,11,26
Mumbai City,5636,2,6,4,4,16,10,6,22
Kolkata,5636,3,4,8,2,17,13,4,20
Chennaiyin,5636,4,4,6,4,14,17,-3,18
FC Pune City,5636,5,4,5,5,13,15,-2,17
Kerala Blast,5636,6,4,5,5,11,18,-7,17
NorthEast Un,5636,7,4,3,7,11,13,-2,15
FC Goa,5636,8,3,4,7,10,17,-7,13
Mumbai City,5637,1,6,5,3,18,10,8,23
NorthEast Un,5637,2,6,3,5,16,12,4,21
Delhi Dynamo,5637,3,4,6,4,24,22,2,18
Kolkata,5637,4,4,6,4,17,18,-1,18
FC Pune City,5637,5,5,3,6,16,17,-1,18
Chennaiyin,5637,6,4,6,4,16,19,-3,18
Kerala Blast,5637,7,5,3,6,13,18,-5,18
FC Goa,5637,8,5,2,7,12,16,-4,17
Mumbai City,5638,1,7,4,3,18,9,9,25
Kerala Blast,5638,2,6,3,5,14,17,-3,21
Delhi Dynamo,5638,3,5,5,4,24,18,6,20
NorthEast Un,5638,4,6,2,6,13,12,1,20
Kolkata,5638,5,4,7,3,19,16,3,19
FC Pune City,5638,6,5,3,6,13,17,-4,18
Chennaiyin,5638,7,3,6,5,15,20,-5,15
FC Goa,5638,8,3,4,7,11,18,-7,13
Mumbai City,5639,1,7,4,3,20,8,12,25
Delhi Dynamo,5639,2,5,6,3,23,19,4,21
FC Pune City,5639,3,6,3,5,16,16,0,21
NorthEast Un,5639,4,5,4,5,14,11,3,19
Kolkata,5639,5,4,6,4,19,17,2,18
FC Goa,5639,6,5,2,7,13,17,-4,17
Chennaiyin,5639,7,3,6,5,15,20,-5,15
Kerala Blast,5639,8,4,3,7,10,22,-12,15
Mumbai City,5640,1,6,5,3,17,9,8,23
Delhi Dynamo,5640,2,4,8,2,23,16,7,20
Chennaiyin,5640,3,5,5,4,18,17,1,20
Kolkata,5640,4,4,7,3,17,16,1,19
Kerala Blast,5640,5,5,4,5,14,19,-5,19
NorthEast Un,5640,6,5,3,6,12,13,-1,18
FC Pune City,5640,7,4,3,7,14,19,-5,15
FC Goa,5640,8,4,3,7,10,16,-6,15
Mumbai City,5641,1,7,4,3,19,8,11,25
Delhi Dynamo,5641,2,5,6,3,22,17,5,21
Kolkata,5641,3,5,6,3,21,16,5,21
Kerala Blast,5641,4,5,4,5,12,17,-5,19
Chennaiyin,5641,5,4,6,4,16,19,-3,18
FC Pune City,5641,6,4,4,6,13,19,-6,16
NorthEast Un,5641,7,4,3,7,9,11,-2,15
FC Goa,5641,8,4,3,7,13,18,-5,15
Mumbai City,5642,1,6,5,3,17,9,8,23
Delhi Dynamo,5642,2,5,6,3,25,20,5,21
Kolkata,5642,3,4,8,2,17,14,3,20
NorthEast Un,5642,4,5,4,5,15,11,4,19
FC Pune City,5642,5,5,4,5,15,15,0,19
Kerala Blast,5642,6,4,4,6,10,18,-8,16
Chennaiyin,5642,7,3,6,5,15,21,-6,15
FC Goa,5642,8,4,3,7,13,19,-6,15
Mumbai City,5643,1,7,4,3,19,8,11,25
Delhi Dynamo,5643,2,5,5,4,25,20,5,20
Kolkata,5643,3,4,8,2,19,16,3,20
Chennaiyin,5643,4,5,5,4,16,18,-2,20
Kerala Blast,5643,5,5,5,4,14,16,-2,20
NorthEast Un,5643,6,5,2,7,13,14,-1,17
FC Pune City,5643,7,4,5,5,16,18,-2,17
FC Goa,5643,8,3,2,9,9,21,-12,11
Mumbai City,5644,1,7,4,3,18,9,9,25
Kerala Blast,5644,2,5,5,4,11,14,-3,20
Kolkata,5644,3,4,7,3,15,17,-2,19
Delhi Dynamo,5644,4,4,6,4,25,21,4,18
NorthEast Un,5644,5,5,3,6,12,12,0,18
FC Goa,5644,6,5,3,6,17,18,-1,18
Chennaiyin,5644,7,4,5,5,16,19,-3,17
FC Pune City,5644,8,4,3,7,13,17,-4,15
Mumbai City,5645,1,7,4,3,18,8,10,25
NorthEast Un,5645,2,6,3,5,14,10,4,21
Kolkata,5645,3,4,7,3,17,16,1,19
FC Pune City,5645,4,5,4,5,14,15,-1,19
Delhi Dynamo,5645,5,4,6,4,21,17,4,18
Kerala Blast,5645,6,4,5,5,12,17,-5,17
Chennaiyin,5645,7,3,6,5,14,21,-7,15
FC Goa,5645,8,3,5,6,11,17,-6,14
Mumbai City,5646,1,7,4,3,19,8,11,25
Kolkata,5646,2,5,7,2,21,14,7,22
NorthEast Un,5646,3,6,3,5,13,11,2,21
Delhi Dynamo,5646,4,5,5,4,24,20,4,20
Kerala Blast,5646,5,5,4,5,13,17,-4,19
Chennaiyin,5646,6,4,5,5,15,19,-4,17
FC Pune City,5646,7,4,4,6,13,17,-4,16
FC Goa,5646,8,3,2,9,10,22,-12,11
Delhi Dynamo,5647,1,7,5,2,28,17,11,26
Mumbai City,5647,2,6,4,4,16,10,6,22
Kolkata,5647,3,5,7,2,19,15,4,22
Kerala Blast,5647,4,6,4,4,13,15,-2,22
NorthEast Un,5647,5,5,2,7,13,13,0,17
Chennaiyin,5647,6,4,5,5,16,20,-4,17
FC Pune City,5647,7,4,3,7,12,16,-4,15
FC Goa,5647,8,3,2,9,11,22,-11,11
Mumbai City,5648,1,7,4,3,20,9,11,25
Delhi Dynamo,5648,2,5,6,3,24,19,5,21
FC Pune City,5648,3,5,4,5,16,17,-1,19
Kolkata,5648,4,4,6,4,17,17,0,18
FC Goa,5648,5,5,3,6,14,15,-1,18
Chennaiyin,5648,6,4,5,5,17,21,-4,17
Kerala Blast,5648,7,4,5,5,10,16,-6,17
NorthEast Un,5648,8,4,3,7,10,14,-4,15
Mumbai City,5649,1,6,4,4,16,10,6,22
Kolkata,5649,2,5,7,2,17,13,4,22
Delhi Dynamo,5649,3,5,6,3,25,17,8,21
Kerala Blast,5649,4,6,3,5,13,15,-2,21
Chennaiyin,5649,5,4,5,5,16,19,-3,17
FC Goa,5649,6,5,2,7,13,19,-6,17
FC Pune City,5649,7,4,4,6,13,17,-4,16
NorthEast Un,5649,8,4,3,7,10,13,-3,15
Mumbai City,5650,1,6,4,4,16,10,6,22
Kolkata,5650,2,5,7,2,19,16,3,22
Delhi Dynamo,5650,3,5,6,3,24,18,6,21
NorthEast Un,5650,4,6,2,6,17,14,3,20
Chennaiyin,5650,5,5,5,4,19,20,-1,20
FC Pune City,5650,6,5,3,6,15,17,-2,18
Kerala Blast,5650,7,4,4,6,12,19,-7,16
FC Goa,5650,8,3,3,8,12,20,-8,12
Mumbai City,5651,1,6,5,3,17,9,8,23
Kolkata,5651,2,5,7,2,17,12,5,22
Delhi Dynamo,5651,3,4,7,3,23,18,5,19
NorthEast Un,5651,4,4,5,5,10,10,0,17
FC Pune City,5651,5,4,5,5,12,14,-2,17
FC Goa,5651,6,5,2,7,12,16,-4,17
Kerala Blast,5651,7,4,5,5,9,15,-6,17
Chennaiyin,5651,8,3,6,5,13,19,-6,15
Mumbai City,5652,1,7,4,3,17,8,9,25
Delhi Dynamo,5652,2,5,6,3,24,16,8,21
Kolkata,5652,3,4,8,2,14,12,2,20
Chennaiyin,5652,4,5,5,4,16,18,-2,20
FC Pune City,5652,5,5,4,5,13,14,-1,19
Kerala Blast,5652,6,5,4,5,10,14,-4,19
NorthEast Un,5652,7,4,3,7,11,13,-2,15
FC Goa,5652,8,3,2,9,8,18,-10,11
Mumbai City,5653,1,6,5,3,16,8,8,23
Delhi Dynamo,5653,2,5,7,2,23,15,8,22
Kolkata,5653,3,5,7,2,18,13,5,22
NorthEast Un,5653,4,5,3,6,11,11,0,18
FC Pune City,5653,5,4,4,6,12,16,-4,16
FC Goa,5653,6,4,4,6,11,15,-4,16
Kerala Blast,5653,7,4,4,6,9,16,-7,16
Chennaiyin,5653,8,3,6,5,13,19,-6,15
Mumbai City,5654,1,7,4,3,17,8,9,25
Kolkata,5654,2,5,7,2,17,14,3,22
Delhi Dynamo,5654,3,5,6,3,25,17,8,21
Kerala Blast,5654,4,5,4,5,12,16,-4,19
FC Pune City,5654,5,5,3,6,15,17,-2,18
NorthEast Un,5654,6,5,2,7,11,12,-1,17
FC Goa,5654,7,4,3,7,12,17,-5,15
Chennaiyin,5654,8,3,5,6,13,21,-8,14
Mumbai City,5655,1,7,4,3,17,8,9,25
Delhi Dynamo,5655,2,6,5,3,24,15,9,23
Kerala Blast,5655,3,6,4,4,16,16,0,22
Kolkata,5655,4,5,6,3,22,16,6,21
NorthEast Un,5655,5,5,3,6,13,14,-1,18
FC Pune City,5655,6,4,3,7,12,20,-8,15
Chennaiyin,5655,7,3,5,6,15,22,-7,14
FC Goa,5655,8,4,2,8,11,19,-8,14
Mumbai City,5656,1,7,4,3,18,8,10,25
Kolkata,5656,2,4,8,2,17,14,3,20
NorthEast Un,5656,3,6,2,6,16,14,2,20
FC Pune City,5656,4,5,4,5,14,15,-1,19
Delhi Dynamo,5656,5,4,6,4,23,21,2,18
Chennaiyin,5656,6,4,5,5,17,18,-1,17
Kerala Blast,5656,7,4,4,6,10,18,-8,16
FC Goa,5656,8,4,3,7,10,17,-7,15
Mumbai City,5657,1,7,4,3,18,8,10,25
NorthEast Un,5657,2,6,3,5,13,11,2,21
Kolkata,5657,3,4,7,3,16,15,1,19
Chennaiyin,5657,4,4,6,4,16,18,-2,18
FC Pune City,5657,5,5,3,6,14,16,-2,18
Kerala Blast,5657,6,5,3,6,13,18,-5,18
Delhi Dynamo,5657,7,4,5,5,21,18,3,17
FC Goa,5657,8,4,3,7,11,18,-7,15
Kerala Blast,5658,1,7,3,4,14,15,-1,24
Delhi Dynamo,5658,2,6,5,3,27,19,8,23
Mumbai City,5658,3,6,4,4,17,11,6,22
NorthEast Un,5658,4,5,3,6,13,12,1,18
Kolkata,5658,5,4,6,4,15,15,0,18
FC Goa,5658,6,5,2,7,12,17,-5,17
FC Pune City,5658,7,4,3,7,13,17,-4,15
Chennaiyin,5658,8,3,6,5,13,18,-5,15
Mumbai City,5659,1,7,4,3,17,8,9,25
Delhi Dynamo,5659,2,5,6,3,24,15,9,21
Chennaiyin,5659,3,5,5,4,17,19,-2,20
Kerala Blast,5659,4,5,5,4,13,16,-3,20
FC Pune City,5659,5,4,5,5,14,16,-2,17
NorthEast Un,5659,6,4,4,6,10,11,-1,16
Kolkata,5659,7,3,7,4,15,17,-2,16
FC Goa,5659,8,4,2,8,12,20,-8,14
Mumbai City,5660,1,6,5,3,18,10,8,23
Kolkata,5660,2,5,7,2,18,13,5,22
Delhi Dynamo,5660,3,5,6,3,26,17,9,21
NorthEast Un,5660,4,5,4,5,12,11,1,19
FC Pune City,5660,5,5,4,5,15,15,0,19
Chennaiyin,5660,6,4,6,4,18,21,-3,18
Kerala Blast,5660,7,4,4,6,9,17,-8,16
FC Goa,5660,8,3,2,9,10,22,-12,11
Mumbai City,5661,1,7,4,3,19,9,10,25
Delhi Dynamo,5661,2,5,5,4,24,19,5,20
Kolkata,5661,3,4,8,2,17,13,4,20
FC Goa,5661,4,5,3,6,13,16,-3,18
FC Pune City,5661,5,4,5,5,15,17,-2,17
Kerala Blast,5661,6,4,5,5,13,20,-7,17
NorthEast Un,5661,7,4,4,6,12,14,-2,16
Chennaiyin,5661,8,3,6,5,16,21,-5,15
Mumbai City,5662,1,7,4,3,19,9,10,25
Kolkata,5662,2,5,6,3,18,15,3,21
Delhi Dynamo,5662,3,5,5,4,23,18,5,20
Kerala Blast,5662,4,5,5,4,11,14,-3,20
NorthEast Un,5662,5,5,4,5,10,9,1,19
FC Pune City,5662,6,4,4,6,14,17,-3,16
Chennaiyin,5662,7,3,6,5,14,20,-6,15
FC Goa,5662,8,4,2,8,12,19,-7,14
Mumbai City,5663,1,7,4,3,18,8,10,25
Kolkata,5663,2,5,7,2,17,13,4,22
Delhi Dynamo,5663,3,5,6,3,25,17,8,21
NorthEast Un,5663,4,6,2,6,13,12,1,20
Chennaiyin,5663,5,4,5,5,17,22,-5,17
FC Pune City,5663,6,4,4,6,14,17,-3,16
Kerala Blast,5663,7,4,4,6,10,17,-7,16
FC Goa,5663,8,3,4,7,11,19,-8,13
Mumbai City,5664,1,7,4,3,18,8,10,25
Delhi Dynamo,5664,2,5,6,3,24,17,7,21
Kolkata,5664,3,4,7,3,15,14,1,19
FC Pune City,5664,4,5,4,5,14,15,-1,19
NorthEast Un,5664,5,4,5,5,11,11,0,17
FC Goa,5664,6,5,2,7,13,17,-4,17
Kerala Blast,5664,7,4,4,6,11,17,-6,16
Chennaiyin,5664,8,3,6,5,15,22,-7,15
Delhi Dynamo,5665,1,6,6,2,26,17,9,24
Mumbai City,5665,2,6,5,3,17,9,8,23
Kolkata,5665,3,5,7,2,20,15,5,22
FC Pune City,5665,4,5,4,5,15,15,0,19
Chennaiyin,5665,5,4,6,4,16,17,-1,18
NorthEast Un,5665,6,5,2,7,14,14,0,17
Kerala Blast,5665,7,4,3,7,10,22,-12,15
FC Goa,5665,8,3,3,8,10,19,-9,12
Delhi Dynamo,5666,1,6,5,3,25,15,10,23
Mumbai City,5666,2,6,4,4,16,10,6,22
NorthEast Un,5666,3,6,2,6,13,15,-2,20
Kolkata,5666,4,4,7,3,16,16,0,19
Chennaiyin,5666,5,4,6,4,17,17,0,18
Kerala Blast,5666,6,5,3,6,13,18,-5,18
FC Pune City,5666,7,4,4,6,13,16,-3,16
FC Goa,5666,8,4,3,7,10,16,-6,15
Delhi Dynamo,5667,1,6,6,2,28,19,9,24
Mumbai City,5667,2,6,4,4,18,11,7,22
Kolkata,5667,3,5,7,2,19,14,5,22
NorthEast Un,5667,4,5,4,5,12,11,1,19
FC Pune City,5667,5,5,3,6,14,18,-4,18
Chennaiyin,5667,6,4,5,5,15,18,-3,17
Kerala Blast,5667,7,4,5,5,11,16,-5,17
FC Goa,5667,8,3,2,9,10,20,-10,11
Delhi Dynamo,5668,1,6,6,2,27,18,9,24
Mumbai City,5668,2,6,4,4,17,10,7,22
FC Pune City,5668,3,5,4,5,16,17,-1,19
Kerala Blast,5668,4,5,4,5,16,21,-5,19
Kolkata,5668,5,4,6,4,18,17,1,18
NorthEast Un,5668,6,5,3,6,13,12,1,18
FC Goa,5668,7,5,2,7,15,18,-3,17
Chennaiyin,5668,8,3,5,6,13,22,-9,14
Mumbai City,5669,1,6,4,4,16,10,6,22
Delhi Dynamo,5669,2,5,5,4,23,18,5,20
NorthEast Un,5669,3,6,2,6,14,11,3,20
FC Goa,5669,4,6,2,6,12,14,-2,20
Kolkata,5669,5,4,7,3,14,13,1,19
FC Pune City,5669,6,5,4,5,13,14,-1,19
Chennaiyin,5669,7,4,5,5,15,20,-5,17
Kerala Blast,5669,8,4,3,7,9,16,-7,15
Delhi Dynamo,5670,1,7,5,2,35,17,18,26
Kolkata,5670,2,5,7,2,18,14,4,22
Mumbai City,5670,2,6,4,4,18,14,4,22
NorthEast Un,5670,4,5,3,6,12,13,-1,18
FC Pune City,5670,5,5,3,6,16,18,-2,18
Kerala Blast,5670,6,4,4,6,11,18,-7,16
FC Goa,5670,7,4,3,7,10,19,-9,15
Chennaiyin,5670,8,3,5,6,13,20,-7,14
Delhi Dynamo,5671,1,6,6,2,24,14,10,24
Mumbai City,5671,2,6,4,4,16,9,7,22
NorthEast Un,5671,3,6,3,5,12,10,2,21
FC Pune City,5671,4,5,4,5,13,14,-1,19
Kolkata,5671,5,3,9,2,14,13,1,18
Chennaiyin,5671,6,4,5,5,15,19,-4,17
Kerala Blast,5671,7,4,4,6,11,17,-6,16
FC Goa,5671,8,3,3,8,9,18,-9,12
Mumbai City,5672,1,7,4,3,19,8,11,25
Kerala Blast,5672,2,6,4,4,12,14,-2,22
NorthEast Un,5672,3,5,4,5,12,10,2,19
Delhi Dynamo,5672,4,4,6,4,22,20,2,18
Kolkata,5672,5,4,6,4,16,15,1,18
Chennaiyin,5672,6,4,6,4,15,17,-2,18
FC Pune City,5672,7,4,3,7,13,18,-5,15
FC Goa,5672,8,4,3,7,10,17,-7,15
Delhi Dynamo,5673,1,5,7,2,26,18,8,22
Mumbai City,5673,2,6,4,4,16,9,7,22
Kolkata,5673,3,4,7,3,15,14,1,19
Kerala Blast,5673,4,5,4,5,14,19,-5,19
FC Pune City,5673,5,5,3,6,16,17,-1,18
FC Goa,5673,6,5,3,6,13,17,-4,18
NorthEast Un,5673,7,4,4,6,12,13,-1,16
Chennaiyin,5673,8,3,6,5,14,19,-5,15
Mumbai City,5674,1,7,4,3,18,8,10,25
Kolkata,5674,2,6,6,2,19,13,6,24
Delhi Dynamo,5674,3,6,5,3,24,17,7,23
FC Pune City,5674,4,5,3,6,14,16,-2,18
Kerala Blast,5674,5,5,3,6,11,18,-7,18
Chennaiyin,5674,6,4,5,5,15,18,-3,17
NorthEast Un,5674,7,4,2,8,11,15,-4,14
FC Goa,5674,8,4,2,8,10,17,-7,14
Mumbai City,5675,1,6,5,3,17,9,8,23
Delhi Dynamo,5675,2,5,6,3,23,17,6,21
Kerala Blast,5675,3,6,3,5,14,14,0,21
FC Goa,5675,4,6,2,6,17,15,2,20
NorthEast Un,5675,5,6,2,6,11,10,1,20
Kolkata,5675,6,4,6,4,15,20,-5,18
FC Pune City,5675,7,4,3,7,13,18,-5,15
Chennaiyin,5675,8,3,5,6,14,21,-7,14
Delhi Dynamo,5676,1,7,5,2,27,16,11,26
Mumbai City,5676,2,6,4,4,17,10,7,22
Chennaiyin,5676,3,5,5,4,18,19,-1,20
Kolkata,5676,4,4,7,3,19,16,3,19
FC Pune City,5676,5,5,3,6,14,18,-4,18
Kerala Blast,5676,6,5,3,6,13,18,-5,18
NorthEast Un,5676,7,5,2,7,12,15,-3,17
FC Goa,5676,8,3,3,8,12,20,-8,12
Mumbai City,5677,1,7,4,3,17,8,9,25
Kerala Blast,5677,2,6,4,4,14,15,-1,22
NorthEast Un,5677,3,6,3,5,14,9,5,21
Delhi Dynamo,5677,4,5,5,4,24,19,5,20
FC Pune City,5677,5,5,3,6,16,17,-1,18
Chennaiyin,5677,6,4,5,5,14,18,-4,17
Kolkata,5677,7,3,6,5,16,20,-4,15
FC Goa,5677,8,4,2,8,10,19,-9,14
Mumbai City,5678,1,7,4,3,19,8,11,25
Delhi Dynamo,5678,2,6,5,3,23,17,6,23
Kolkata,5678,3,5,6,3,17,15,2,21
NorthEast Un,5678,4,5,3,6,11,11,0,18
FC Pune City,5678,5,5,3,6,13,16,-3,18
Kerala Blast,5678,6,5,3,6,12,16,-4,18
Chennaiyin,5678,7,3,6,5,13,19,-6,15
FC Goa,5678,8,4,2,8,12,18,-6,14
Mumbai City,5679,1,7,4,3,22,8,14,25
Delhi Dynamo,5679,2,6,5,3,29,24,5,23
Kerala Blast,5679,3,6,4,4,11,13,-2,22
Kolkata,5679,4,4,7,3,17,15,2,19
FC Pune City,5679,5,4,4,6,12,16,-4,16
NorthEast Un,5679,6,4,3,7,12,16,-4,15
Chennaiyin,5679,7,3,6,5,15,20,-5,15
FC Goa,5679,8,4,3,7,14,20,-6,15
Mumbai City,5680,1,6,4,4,16,10,6,22
Kolkata,5680,2,5,6,3,19,15,4,21
Delhi Dynamo,5680,3,5,5,4,25,19,6,20
FC Goa,5680,4,6,2,6,13,15,-2,20
NorthEast Un,5680,5,5,3,6,12,11,1,18
FC Pune City,5680,6,5,3,6,14,18,-4,18
Chennaiyin,5680,7,4,5,5,14,18,-4,17
Kerala Blast,5680,8,4,4,6,11,18,-7,16
Mumbai City,5681,1,6,5,3,18,10,8,23
NorthEast Un,5681,2,6,3,5,14,11,3,21
Kerala Blast,5681,3,6,3,5,12,15,-3,21
Delhi Dynamo,5681,4,4,8,2,25,18,7,20
Kolkata,5681,5,3,7,4,14,15,-1,16
FC Pune City,5681,6,4,4,6,13,16,-3,16
FC Goa,5681,7,4,4,6,12,17,-5,16
Chennaiyin,5681,8,3,6,5,15,21,-6,15
Mumbai City,5682,1,7,4,3,17,8,9,25
Kerala Blast,5682,2,6,3,5,17,15,2,21
Chennaiyin,5682,3,5,5,4,19,20,-1,20
Kolkata,5682,4,4,7,3,16,16,0,19
Delhi Dynamo,5682,5,4,6,4,22,18,4,18
NorthEast Un,5682,6,5,3,6,11,11,0,18
FC Goa,5682,7,4,3,7,14,20,-6,15
FC Pune City,5682,8,4,3,7,12,20,-8,15
Delhi Dynamo,5683,1,6,5,3,25,15,10,23
Mumbai City,5683,2,6,4,4,16,10,6,22
NorthEast Un,5683,3,6,3,5,13,10,3,21
Kolkata,5683,4,4,8,2,19,17,2,20
Kerala Blast,5683,5,5,5,4,13,14,-1,20
FC Pune City,5683,6,4,3,7,14,20,-6,15
FC Goa,5683,7,4,3,7,12,19,-7,15
Chennaiyin,5683,8,3,5,6,15,22,-7,14
Mumbai City,5684,1,7,4,3,17,8,9,25
Delhi Dynamo,5684,2,5,6,3,25,16,9,21
Kolkata,5684,3,4,8,2,20,17,3,20
Kerala Blast,5684,4,5,4,5,12,15,-3,19
Chennaiyin,5684,5,4,6,4,16,19,-3,18
NorthEast Un,5684,6,4,4,6,9,10,-1,16
FC Pune City,5684,7,4,4,6,14,19,-5,16
FC Goa,5684,8,3,4,7,14,23,-9,13
Mumbai City,5685,1,7,4,3,18,8,10,25
Kolkata,5685,2,6,6,2,22,14,8,24
Delhi Dynamo,5685,3,5,6,3,26,18,8,21
Chennaiyin,5685,4,4,6,4,17,20,-3,18
NorthEast Un,5685,5,4,5,5,13,13,0,17
Kerala Blast,5685,6,4,5,5,10,17,-7,17
FC Pune City,5685,7,4,4,6,13,18,-5,16
FC Goa,5685,8,3,2,9,11,22,-11,11
Delhi Dynamo,5686,1,6,6,2,27,17,10,24
Mumbai City,5686,2,6,5,3,18,10,8,23
Kerala Blast,5686,3,6,4,4,13,14,-1,22
NorthEast Un,5686,4,5,3,6,10,10,0,18
Kolkata,5686,5,4,6,4,15,16,-1,18
FC Pune City,5686,6,4,3,7,12,16,-4,15
Chennaiyin,5686,7,3,6,5,14,19,-5,15
FC Goa,5686,8,4,3,7,11,18,-7,15
Mumbai City,5687,1,7,4,3,17,8,9,25
Kerala Blast,5687,2,6,3,5,14,17,-3,21
Delhi Dynamo,5687,3,5,5,4,24,16,8,20
NorthEast Un,5687,4,6,2,6,12,11,1,20
Kolkata,5687,5,4,7,3,17,16,1,19
Chennaiyin,5687,6,4,5,5,15,19,-4,17
FC Pune City,5687,7,4,4,6,13,16,-3,16
FC Goa,5687,8,4,2,8,12,21,-9,14
Mumbai City,5688,1,7,4,3,19,10,9,25
Kolkata,5688,2,6,6,2,20,13,7,24
NorthEast Un,5688,3,6,3,5,14,12,2,21
Delhi Dynamo,5688,4,4,6,4,24,19,5,18
Kerala Blast,5688,5,4,5,5,10,15,-5,17
FC Pune City,5688,6,4,4,6,13,18,-5,16
FC Goa,5688,7,4,3,7,9,16,-7,15
Chennaiyin,5688,8,3,5,6,14,20,-6,14
Mumbai City,5689,1,6,5,3,17,9,8,23
NorthEast Un,5689,2,7,2,5,15,10,5,23
Delhi Dynamo,5689,3,5,6,3,24,18,6,21
Kerala Blast,5689,4,6,3,5,14,16,-2,21
Kolkata,5689,5,4,6,4,18,19,-1,18
FC Pune City,5689,6,4,3,7,15,19,-4,15
Chennaiyin,5689,7,3,6,5,14,19,-5,15
FC Goa,5689,8,4,3,7,10,17,-7,15
Mumbai City,5690,1,7,4,3,19,9,10,25
NorthEast Un,5690,2,7,2,5,15,10,5,23
Kolkata,5690,3,5,6,3,16,15,1,21
Delhi Dynamo,5690,4,5,5,4,24,19,5,20
FC Goa,5690,5,5,2,7,12,16,-4,17
FC Pune City,5690,6,4,4,6,14,17,-3,16
Kerala Blast,5690,7,4,4,6,10,17,-7,16
Chennaiyin,5690,8,3,5,6,14,21,-7,14
Mumbai City,5691,1,7,4,3,18,8,10,25
Kerala Blast,5691,2,7,3,4,14,15,-1,24
Delhi Dynamo,5691,3,4,6,4,25,21,4,18
FC Pune City,5691,4,5,3,6,14,16,-2,18
FC Goa,5691,5,5,3,6,14,18,-4,18
Chennaiyin,5691,6,4,5,5,17,19,-2,17
Kolkata,5691,7,3,7,4,16,17,-1,16
NorthEast Un,5691,8,4,3,7,12,16,-4,15
Delhi Dynamo,5692,1,6,5,3,26,19,7,23
Mumbai City,5692,2,6,4,4,17,12,5,22
Chennaiyin,5692,3,5,5,4,18,19,-1,20
FC Pune City,5692,4,5,4,5,15,15,0,19
Kerala Blast,5692,5,5,4,5,11,17,-6,19
Kolkata,5692,6,4,6,4,17,20,-3,18
NorthEast Un,5692,7,5,2,7,15,14,1,17
FC Goa,5692,8,4,2,8,14,17,-3,14
Mumbai City,5693,1,7,4,3,19,8,11,25
Delhi Dynamo,5693,2,5,6,3,26,20,6,21
Kolkata,5693,3,4,8,2,16,14,2,20
Kerala Blast,5693,4,5,4,5,12,15,-3,19
Chennaiyin,5693,5,4,6,4,15,18,-3,18
NorthEast Un,5693,6,5,2,7,11,13,-2,17
FC Pune City,5693,7,4,3,7,12,17,-5,15
FC Goa,5693,8,3,5,6,12,18,-6,14
Delhi Dynamo,5694,1,6,6,2,27,16,11,24
Mumbai City,5694,2,6,4,4,17,10,7,22
FC Pune City,5694,3,6,3,5,16,16,0,21
Kolkata,5694,4,4,6,4,19,20,-1,18
FC Goa,5694,5,5,3,6,18,20,-2,18
NorthEast Un,5694,6,4,4,6,10,13,-3,16
Kerala Blast,5694,7,4,4,6,9,15,-6,16
Chennaiyin,5694,8,3,6,5,16,22,-6,15
Mumbai City,5695,1,7,4,3,17,8,9,25
NorthEast Un,5695,2,6,3,5,15,12,3,21
Kolkata,5695,3,4,8,2,17,14,3,20
Delhi Dynamo,5695,4,4,6,4,24,20,4,18
FC Pune City,5695,5,4,5,5,14,16,-2,17
Kerala Blast,5695,6,4,5,5,10,16,-6,17
FC Goa,5695,7,4,4,6,14,18,-4,16
Chennaiyin,5695,8,3,5,6,16,23,-7,14
Mumbai City,5696,1,7,4,3,21,10,11,25
Delhi Dynamo,5696,2,5,6,3,26,21,5,21
Kolkata,5696,3,5,6,3,18,15,3,21
NorthEast Un,5696,4,5,3,6,13,11,2,18
FC Pune City,5696,5,5,3,6,15,17,-2,18
Kerala Blast,5696,6,5,3,6,12,19,-7,18
Chennaiyin,5696,7,3,6,5,15,21,-6,15
FC Goa,5696,8,4,3,7,14,20,-6,15
Mumbai City,5697,1,7,4,3,18,8,10,25
NorthEast Un,5697,2,6,3,5,13,11,2,21
Delhi Dynamo,5697,3,5,5,4,25,20,5,20
FC Pune City,5697,4,5,4,5,16,17,-1,19
FC Goa,5697,5,5,2,7,13,18,-5,17
Kerala Blast,5697,6,4,5,5,11,16,-5,17
Kolkata,5697,7,3,7,4,16,17,-1,16
Chennaiyin,5697,8,3,6,5,15,20,-5,15
Mumbai City,5698,1,6,5,3,17,9,8,23
Delhi Dynamo,5698,2,5,6,3,26,17,9,21
NorthEast Un,5698,3,6,3,5,12,9,3,21
Kolkata,5698,4,4,7,3,16,14,2,19
Kerala Blast,5698,5,5,4,5,11,16,-5,19
FC Pune City,5698,6,5,3,6,13,15,-2,18
Chennaiyin,5698,7,4,5,5,18,21,-3,17
FC Goa,5698,8,3,3,8,11,23,-12,12
Mumbai City,5699,1,6,5,3,18,10,8,23
Delhi Dynamo,5699,2,5,7,2,25,17,8,22
NorthEast Un,5699,3,5,3,6,11,11,0,18
Kolkata,5699,4,4,6,4,16,17,-1,18
FC Pune City,5699,5,5,3,6,14,17,-3,18
Kerala Blast,5699,6,5,3,6,13,17,-4,18
Chennaiyin,5699,7,4,5,5,15,19,-4,17
FC Goa,5699,8,5,2,7,13,17,-4,17
Mumbai City,5700,1,7,4,3,20,10,10,25
Delhi Dynamo,5700,2,6,5,3,29,18,11,23
Kolkata,5700,3,5,7,2,18,14,4,22
FC Pune City,5700,4,5,3,6,15,16,-1,18
Chennaiyin,5700,5,4,6,4,16,19,-3,18
NorthEast Un,5700,6,4,4,6,13,16,-3,16
Kerala Blast,5700,7,4,4,6,11,19,-8,16
FC Goa,5700,8,3,3,8,9,19,-10,12
Mumbai City,5701,1,7,4,3,18,8,10,25
NorthEast Un,5701,2,6,2,6,12,13,-1,20
Kolkata,5701,3,4,7,3,17,16,1,19
FC Pune City,5701,4,5,4,5,16,17,-1,19
Kerala Blast,5701,5,5,4,5,14,16,-2,19
Delhi Dynamo,5701,6,4,6,4,23,19,4,18
FC Goa,5701,7,4,4,6,10,15,-5,16
Chennaiyin,5701,8,3,5,6,13,19,-6,14
Mumbai City,5702,1,6,5,3,17,9,8,23
NorthEast Un,5702,2,7,2,5,14,10,4,23
Delhi Dynamo,5702,3,4,6,4,22,18,4,18
FC Pune City,5702,4,5,3,6,14,15,-1,18
Kolkata,5702,5,4,6,4,15,19,-4,18
Kerala Blast,5702,6,5,3,6,10,16,-6,18
FC Goa,5702,7,5,2,7,14,16,-2,17
Chennaiyin,5702,8,4,5,5,16,19,-3,17
Mumbai City,5703,1,7,4,3,18,8,10,25
Delhi Dynamo,5703,2,5,6,3,24,18,6,21
Kolkata,5703,3,5,6,3,17,14,3,21
Kerala Blast,5703,4,6,3,5,12,16,-4,21
FC Goa,5703,5,5,3,6,12,16,-4,18
NorthEast Un,5703,6,4,3,7,10,12,-2,15
FC Pune City,5703,7,4,3,7,12,16,-4,15
Chennaiyin,5703,8,3,6,5,14,19,-5,15
Mumbai City,5704,1,7,4,3,18,9,9,25
Delhi Dynamo,5704,2,5,6,3,25,18,7,21
NorthEast Un,5704,3,6,3,5,14,11,3,21
Kolkata,5704,4,4,8,2,18,15,3,20
Kerala Blast,5704,5,5,4,5,11,16,-5,19
FC Pune City,5704,6,4,4,6,13,16,-3,16
Chennaiyin,5704,7,3,5,6,15,22,-7,14
FC Goa,5704,8,4,2,8,13,20,-7,14
Mumbai City,5705,1,6,4,4,17,10,7,22
Delhi Dynamo,5705,2,5,6,3,25,18,7,21
Kolkata,5705,3,5,6,3,19,14,5,21
FC Pune City,5705,4,6,3,5,14,14,0,21
Chennaiyin,5705,5,4,6,4,15,17,-2,18
NorthEast Un,5705,6,4,5,5,11,11,0,17
Kerala Blast,5705,7,4,4,6,10,19,-9,16
FC Goa,5705,8,4,2,8,11,19,-8,14
Delhi Dynamo,5706,1,6,6,2,25,15,10,24
Mumbai City,5706,2,6,4,4,17,10,7,22
Kerala Blast,5706,3,6,3,5,12,14,-2,21
NorthEast Un,5706,4,6,2,6,13,12,1,20
Kolkata,5706,5,4,7,3,15,14,1,19
FC Pune City,5706,6,4,4,6,12,16,-4,16
Chennaiyin,5706,7,3,6,5,15,21,-6,15
FC Goa,5706,8,3,4,7,10,17,-7,13
Mumbai City,5707,1,6,5,3,16,8,8,23
Delhi Dynamo,5707,2,5,7,2,27,15,12,22
Kolkata,5707,3,5,7,2,16,13,3,22
Kerala Blast,5707,4,5,4,5,12,16,-4,19
Chennaiyin,5707,5,4,6,4,18,20,-2,18
NorthEast Un,5707,6,4,4,6,12,14,-2,16
FC Pune City,5707,7,4,3,7,13,17,-4,15
FC Goa,5707,8,3,4,7,11,22,-11,13
Mumbai City,5708,1,7,4,3,20,11,9,25
NorthEast Un,5708,2,6,3,5,17,13,4,21
FC Pune City,5708,3,5,4,5,15,16,-1,19
Delhi Dynamo,5708,4,4,6,4,26,22,4,18
Kolkata,5708,5,4,6,4,19,17,2,18
FC Goa,5708,6,5,3,6,13,15,-2,18
Kerala Blast,5708,7,4,4,6,10,20,-10,16
Chennaiyin,5708,8,3,6,5,15,21,-6,15
Kolkata,5709,1,6,6,2,20,14,6,24
Mumbai City,5709,2,6,5,3,17,9,8,23
Delhi Dynamo,5709,3,5,7,2,26,18,8,22
FC Pune City,5709,4,5,3,6,14,18,-4,18
Kerala Blast,5709,5,5,3,6,11,16,-5,18
NorthEast Un,5709,6,5,2,7,12,13,-1,17
Chennaiyin,5709,7,3,6,5,16,21,-5,15
FC Goa,5709,8,3,4,7,14,21,-7,13
Delhi Dynamo,5710,1,6,5,3,29,20,9,23
Mumbai City,5710,2,6,4,4,17,11,6,22
Kerala Blast,5710,3,6,4,4,13,15,-2,22
Kolkata,5710,4,5,6,3,18,16,2,21
NorthEast Un,5710,5,5,3,6,13,12,1,18
FC Pune City,5710,6,4,4,6,14,17,-3,16
Chennaiyin,5710,7,3,6,5,15,20,-5,15
FC Goa,5710,8,4,2,8,15,23,-8,14
Delhi Dynamo,5711,1,6,5,3,24,16,8,23
Mumbai City,5711,2,6,4,4,16,9,7,22
NorthEast Un,5711,3,6,2,6,12,11,1,20
Chennaiyin,5711,4,5,5,4,17,17,0,20
Kerala Blast,5711,5,5,4,5,12,16,-4,19
FC Pune City,5711,6,5,3,6,14,16,-2,18
Kolkata,5711,7,3,8,3,15,15,0,17
FC Goa,5711,8,3,3,8,9,19,-10,12
Delhi Dynamo,5712,1,6,6,2,28,19,9,24
Mumbai City,5712,2,6,5,3,18,10,8,23
Chennaiyin,5712,3,5,5,4,17,17,0,20
FC Pune City,5712,4,5,4,5,16,17,-1,19
Kerala Blast,5712,5,5,4,5,13,15,-2,19
Kolkata,5712,6,4,6,4,16,18,-2,18
NorthEast Un,5712,7,5,2,7,11,12,-1,17
FC Goa,5712,8,3,2,9,10,21,-11,11
Delhi Dynamo,5713,1,6,5,3,26,19,7,23
Mumbai City,5713,2,6,4,4,17,11,6,22
Kolkata,5713,3,5,7,2,16,12,4,22
Kerala Blast,5713,4,6,4,4,13,14,-1,22
Chennaiyin,5713,5,4,6,4,18,19,-1,18
FC Goa,5713,6,4,3,7,14,18,-4,15
FC Pune City,5713,7,4,3,7,13,18,-5,15
NorthEast Un,5713,8,4,2,8,9,15,-6,14
Delhi Dynamo,5714,1,6,5,3,28,19,9,23
Mumbai City,5714,2,6,4,4,17,10,7,22
Kolkata,5714,3,5,7,2,17,13,4,22
Kerala Blast,5714,4,6,4,4,13,14,-1,22
NorthEast Un,5714,5,5,3,6,14,15,-1,18
FC Pune City,5714,6,4,3,7,12,17,-5,15
Chennaiyin,5714,7,3,6,5,16,22,-6,15
FC Goa,5714,8,4,2,8,12,19,-7,14
Mumbai City,5715,1,6,5,3,18,10,8,23
Delhi Dynamo,5715,2,5,7,2,29,18,11,22
Kerala Blast,5715,3,6,3,5,14,15,-1,21
Kolkata,5715,4,4,7,3,15,16,-1,19
Chennaiyin,5715,5,4,5,5,15,20,-5,17
NorthEast Un,5715,6,5,2,7,13,18,-5,17
FC Pune City,5715,7,4,4,6,12,15,-3,16
FC Goa,5715,8,4,3,7,12,16,-4,15
Mumbai City,5716,1,7,4,3,18,8,10,25
Kerala Blast,5716,2,7,3,4,16,15,1,24
Kolkata,5716,3,4,7,3,18,16,2,19
Delhi Dynamo,5716,4,4,6,4,22,18,4,18
FC Goa,5716,5,5,2,7,15,19,-4,17
Chennaiyin,5716,6,4,5,5,15,21,-6,17
FC Pune City,5716,7,4,4,6,15,20,-5,16
NorthEast Un,5716,8,4,3,7,10,12,-2,15
Delhi Dynamo,5717,1,6,6,2,28,17,11,24
Mumbai City,5717,2,6,5,3,17,9,8,23
FC Pune City,5717,3,5,3,6,14,15,-1,18
Kolkata,5717,3,4,6,4,14,15,-1,18
Chennaiyin,5717,5,4,6,4,17,19,-2,18
Kerala Blast,5717,6,5,3,6,10,16,-6,18
NorthEast Un,5717,7,5,2,7,12,14,-2,17
FC Goa,5717,8,4,3,7,12,19,-7,15
Mumbai City,5718,1,7,4,3,17,8,9,25
Delhi Dynamo,5718,2,5,6,3,23,15,8,21
Chennaiyin,5718,3,5,5,4,16,18,-2,20
Kolkata,5718,4,4,7,3,16,16,0,19
Kerala Blast,5718,5,5,4,5,15,18,-3,19
NorthEast Un,5718,6,5,2,7,11,13,-2,17
FC Goa,5718,7,4,3,7,12,16,-4,15
FC Pune City,5718,8,4,3,7,14,20,-6,15
Mumbai City,5719,1,7,4,3,18,8,10,25
Delhi Dynamo,5719,2,6,5,3,25,18,7,23
Kolkata,5719,3,5,7,2,17,14,3,22
Chennaiyin,5719,4,5,5,4,15,17,-2,20
FC Pune City,5719,5,5,4,5,14,15,-1,19
Kerala Blast,5719,6,4,4,6,13,19,-6,16
NorthEast Un,5719,7,4,3,7,12,14,-2,15
FC Goa,5719,8,3,2,9,10,19,-9,11
Delhi Dynamo,5720,1,6,6,2,28,19,9,24
Mumbai City,5720,2,6,5,3,18,10,8,23
Kolkata,5720,3,5,7,2,19,14,5,22
Chennaiyin,5720,4,4,6,4,15,17,-2,18
Kerala Blast,5720,5,4,5,5,11,18,-7,17
NorthEast Un,5720,6,4,4,6,10,11,-1,16
FC Pune City,5720,7,4,4,6,14,17,-3,16
FC Goa,5720,8,3,3,8,10,19,-9,12
Mumbai City,5721,1,6,5,3,17,9,8,23
Kerala Blast,5721,2,5,5,4,13,15,-2,20
Delhi Dynamo,5721,3,4,7,3,25,19,6,19
Kolkata,5721,4,4,7,3,16,15,1,19
Chennaiyin,5721,5,4,6,4,17,17,0,18
NorthEast Un,5721,6,5,3,6,12,15,-3,18
FC Pune City,5721,7,4,5,5,13,15,-2,17
FC Goa,5721,8,3,4,7,11,19,-8,13
Mumbai City,5722,1,7,4,3,17,8,9,25
Delhi Dynamo,5722,2,5,5,4,25,19,6,20
Kolkata,5722,3,4,8,2,18,16,2,20
NorthEast Un,5722,4,5,4,5,14,12,2,19
FC Pune City,5722,5,5,4,5,16,16,0,19
Chennaiyin,5722,6,3,7,4,15,19,-4,16
Kerala Blast,5722,7,4,4,6,11,18,-7,16
FC Goa,5722,8,3,4,7,11,19,-8,13
Mumbai City,5723,1,7,4,3,17,8,9,25
Kerala Blast,5723,2,6,4,4,12,14,-2,22
Delhi Dynamo,5723,3,5,6,3,22,15,7,21
Chennaiyin,5723,4,5,5,4,24,17,7,20
Kolkata,5723,5,4,7,3,16,15,1,19
FC Pune City,5723,6,4,4,6,13,16,-3,16
NorthEast Un,5723,7,4,3,7,9,16,-7,15
FC Goa,5723,8,3,3,8,8,20,-12,12
Mumbai City,5724,1,6,4,4,16,10,6,22
Delhi Dynamo,5724,2,5,6,3,23,15,8,21
Chennaiyin,5724,3,5,5,4,22,18,4,20
Kerala Blast,5724,4,5,5,4,13,15,-2,20
Kolkata,5724,5,4,7,3,17,15,2,19
FC Pune City,5724,6,5,3,6,15,18,-3,18
NorthEast Un,5724,7,5,3,6,10,15,-5,18
FC Goa,5724,8,3,3,8,9,19,-10,12
Delhi Dynamo,5725,1,6,5,3,29,19,10,23
Mumbai City,5725,2,6,4,4,16,11,5,22
Kerala Blast,5725,3,6,3,5,12,15,-3,21
NorthEast Un,5725,4,6,2,6,16,11,5,20
FC Pune City,5725,5,5,4,5,15,16,-1,19
Kolkata,5725,6,3,8,3,17,17,0,17
Chennaiyin,5725,7,3,6,5,14,19,-5,15
FC Goa,5725,8,3,4,7,11,22,-11,13
Mumbai City,5726,1,7,4,3,17,8,9,25
Kolkata,5726,2,5,7,2,17,13,4,22
NorthEast Un,5726,3,6,3,5,16,11,5,21
Delhi Dynamo,5726,4,5,5,4,23,19,4,20
FC Pune City,5726,5,5,3,6,15,17,-2,18
Kerala Blast,5726,6,4,5,5,11,16,-5,17
Chennaiyin,5726,7,3,5,6,14,21,-7,14
FC Goa,5726,8,4,2,8,10,18,-8,14
Delhi Dynamo,5727,1,6,5,3,26,18,8,23
Mumbai City,5727,2,6,4,4,17,10,7,22
Kolkata,5727,3,5,6,3,18,16,2,21
Kerala Blast,5727,4,6,3,5,13,16,-3,21
NorthEast Un,5727,5,6,2,6,14,11,3,20
Chennaiyin,5727,6,4,6,4,15,18,-3,18
FC Pune City,5727,7,4,3,7,13,18,-5,15
FC Goa,5727,8,3,3,8,11,20,-9,12
Delhi Dynamo,5728,1,7,5,2,31,14,17,26
Mumbai City,5728,2,6,4,4,16,11,5,22
Kolkata,5728,3,5,7,2,18,15,3,22
FC Pune City,5728,4,5,3,6,13,15,-2,18
NorthEast Un,5728,5,4,4,6,11,14,-3,16
Chennaiyin,5728,6,3,7,4,17,21,-4,16
Kerala Blast,5728,7,4,4,6,10,16,-6,16
FC Goa,5728,8,3,4,7,14,24,-10,13
Delhi Dynamo,5729,1,7,5,2,31,17,14,26
Mumbai City,5729,2,6,4,4,18,12,6,22
Kerala Blast,5729,3,6,3,5,14,16,-2,21
Kolkata,5729,4,4,7,3,16,16,0,19
FC Pune City,5729,5,5,4,5,15,16,-1,19
Chennaiyin,5729,6,3,7,4,15,19,-4,16
NorthEast Un,5729,7,4,3,7,11,14,-3,15
FC Goa,5729,8,3,3,8,11,21,-10,12
Mumbai City,5730,1,7,4,3,21,9,12,25
Kolkata,5730,2,5,6,3,16,13,3,21
Delhi Dynamo,5730,3,5,5,4,24,20,4,20
NorthEast Un,5730,4,6,2,6,12,11,1,20
Chennaiyin,5730,5,4,5,5,16,20,-4,17
FC Goa,5730,6,5,2,7,11,17,-6,17
FC Pune City,5730,7,4,4,6,13,16,-3,16
Kerala Blast,5730,8,4,4,6,10,17,-7,16
NorthEast Un,5731,1,7,2,5,16,11,5,23
Mumbai City,5731,2,6,4,4,17,10,7,22
Delhi Dynamo,5731,3,5,6,3,25,18,7,21
Kolkata,5731,4,4,6,4,17,15,2,18
FC Pune City,5731,5,5,3,6,15,17,-2,18
FC Goa,5731,6,5,3,6,11,15,-4,18
Kerala Blast,5731,7,5,3,6,12,21,-9,18
Chennaiyin,5731,8,3,5,6,13,19,-6,14
Delhi Dynamo,5732,1,6,6,2,28,16,12,24
Kerala Blast,5732,2,7,3,4,15,15,0,24
Mumbai City,5732,3,6,4,4,17,11,6,22
Kolkata,5732,4,5,6,3,18,15,3,21
Chennaiyin,5732,5,4,6,4,15,18,-3,18
FC Pune City,5732,6,4,3,7,13,17,-4,15
NorthEast Un,5732,7,4,2,8,10,16,-6,14
FC Goa,5732,8,3,4,7,10,18,-8,13
Mumbai City,5733,1,6,5,3,16,8,8,23
Delhi Dynamo,5733,2,5,6,3,23,16,7,21
Kerala Blast,5733,3,6,3,5,12,14,-2,21
Chennaiyin,5733,4,4,6,4,19,18,1,18
Kolkata,5733,5,4,6,4,14,15,-1,18
FC Pune City,5733,6,5,3,6,13,15,-2,18
NorthEast Un,5733,7,5,2,7,12,16,-4,17
FC Goa,5733,8,4,3,7,9,16,-7,15
Mumbai City,5734,1,7,4,3,17,8,9,25
Kolkata,5734,2,5,7,2,16,13,3,22
NorthEast Un,5734,3,6,3,5,13,10,3,21
Delhi Dynamo,5734,4,5,5,4,26,19,7,20
Kerala Blast,5734,5,5,4,5,11,14,-3,19
FC Pune City,5734,6,4,4,6,12,16,-4,16
Chennaiyin,5734,7,3,5,6,14,21,-7,14
FC Goa,5734,8,4,2,8,13,21,-8,14
Mumbai City,5735,1,7,4,3,19,9,10,25
Delhi Dynamo,5735,2,6,5,3,24,17,7,23
FC Pune City,5735,3,6,3,5,18,14,4,21
Kolkata,5735,4,5,6,3,16,15,1,21
NorthEast Un,5735,5,5,3,6,10,10,0,18
Kerala Blast,5735,6,4,4,6,9,18,-9,16
FC Goa,5735,7,4,2,8,13,17,-4,14
Chennaiyin,5735,8,3,5,6,13,22,-9,14
Mumbai City,5736,1,7,4,3,18,9,9,25
Kolkata,5736,2,5,7,2,18,13,5,22
Kerala Blast,5736,3,5,5,4,13,14,-1,20
NorthEast Un,5736,4,5,4,5,11,10,1,19
Delhi Dynamo,5736,5,4,6,4,25,20,5,18
FC Goa,5736,6,5,2,7,14,19,-5,17
FC Pune City,5736,7,4,3,7,13,20,-7,15
Chennaiyin,5736,8,3,5,6,13,20,-7,14
Delhi Dynamo,5737,1,6,6,2,29,16,13,24
Mumbai City,5737,2,6,4,4,16,12,4,22
Kolkata,5737,3,5,6,3,16,14,2,21
Kerala Blast,5737,4,5,4,5,10,14,-4,19
NorthEast Un,5737,5,4,4,6,11,12,-1,16
Chennaiyin,5737,6,3,7,4,15,19,-4,16
FC Pune City,5737,7,4,4,6,12,16,-4,16
FC Goa,5737,8,4,3,7,12,18,-6,15
Mumbai City,5738,1,6,5,3,18,10,8,23
FC Pune City,5738,2,6,3,5,17,15,2,21
Delhi Dynamo,5738,3,4,8,2,26,19,7,20
Kolkata,5738,4,4,7,3,17,17,0,19
Kerala Blast,5738,5,5,4,5,13,17,-4,19
Chennaiyin,5738,6,4,6,4,16,19,-3,18
NorthEast Un,5738,7,4,4,6,11,13,-2,16
FC Goa,5738,8,3,3,8,13,21,-8,12
Mumbai City,5739,1,7,4,3,18,9,9,25
Kolkata,5739,2,6,6,2,18,13,5,24
Delhi Dynamo,5739,3,5,6,3,27,18,9,21
Chennaiyin,5739,4,5,5,4,15,17,-2,20
NorthEast Un,5739,5,5,3,6,11,10,1,18
FC Pune City,5739,6,4,4,6,13,16,-3,16
Kerala Blast,5739,7,4,4,6,9,17,-8,16
FC Goa,5739,8,3,2,9,10,21,-11,11
Mumbai City,5740,1,6,5,3,16,8,8,23
FC Pune City,5740,2,6,3,5,16,16,0,21
Delhi Dynamo,5740,3,4,8,2,24,17,7,20
Kolkata,5740,4,4,7,3,16,15,1,19
Kerala Blast,5740,5,5,4,5,14,16,-2,19
Chennaiyin,5740,6,4,6,4,14,17,-3,18
NorthEast Un,5740,7,4,3,7,10,14,-4,15
FC Goa,5740,8,3,4,7,10,17,-7,13
Mumbai City,5741,1,6,5,3,17,9,8,23
Delhi Dynamo,5741,2,5,7,2,25,16,9,22
FC Pune City,5741,3,5,4,5,13,14,-1,19
Kerala Blast,5741,4,5,4,5,13,16,-3,19
Kolkata,5741,5,3,8,3,15,16,-1,17
Chennaiyin,5741,6,4,5,5,17,19,-2,17
NorthEast Un,5741,7,4,4,6,11,14,-3,16
FC Goa,5741,8,4,3,7,11,18,-7,15
Mumbai City,5742,1,7,4,3,17,8,9,25
Kerala Blast,5742,2,6,4,4,12,13,-1,22
Delhi Dynamo,5742,3,4,7,3,22,16,6,19
Kolkata,5742,4,4,7,3,15,14,1,19
Chennaiyin,5742,5,4,5,5,16,18,-2,17
NorthEast Un,5742,6,4,4,6,9,12,-3,16
FC Goa,5742,7,4,4,6,11,16,-5,16
FC Pune City,5742,8,4,3,7,12,17,-5,15
Mumbai City,5743,1,7,4,3,19,9,10,25
Kolkata,5743,2,5,7,2,15,12,3,22
FC Pune City,5743,3,5,4,5,17,14,3,19
Delhi Dynamo,5743,4,4,6,4,24,21,3,18
NorthEast Un,5743,5,5,3,6,12,14,-2,18
Chennaiyin,5743,6,4,5,5,18,19,-1,17
Kerala Blast,5743,7,4,4,6,10,20,-10,16
FC Goa,5743,8,4,3,7,12,18,-6,15
Delhi Dynamo,5744,1,6,6,2,27,17,10,24
Mumbai City,5744,2,6,4,4,17,10,7,22
Kolkata,5744,3,5,7,2,17,13,4,22
FC Pune City,5744,4,5,4,5,14,15,-1,19
Kerala Blast,5744,5,5,3,6,11,16,-5,18
NorthEast Un,5744,6,5,2,7,11,13,-2,17
FC Goa,5744,7,4,3,7,11,18,-7,15
Chennaiyin,5744,8,3,5,6,13,19,-6,14
Mumbai City,5745,1,6,4,4,16,9,7,22
Kerala Blast,5745,2,6,4,4,16,16,0,22
Delhi Dynamo,5745,3,5,5,4,24,21,3,20
Chennaiyin,5745,4,5,5,4,16,18,-2,20
NorthEast Un,5745,5,5,3,6,16,14,2,18
FC Pune City,5745,6,5,3,6,15,17,-2,18
Kolkata,5745,7,3,7,4,16,19,-3,16
FC Goa,5745,8,4,3,7,12,17,-5,15
Mumbai City,5746,1,6,4,4,17,10,7,22
Kerala Blast,5746,2,6,4,4,13,14,-1,22
Delhi Dynamo,5746,3,5,5,4,23,18,5,20
FC Goa,5746,4,6,2,6,16,14,2,20
NorthEast Un,5746,5,5,3,6,11,10,1,18
FC Pune City,5746,6,4,5,5,14,16,-2,17
Kolkata,5746,7,3,7,4,14,19,-5,16
Chennaiyin,5746,8,3,6,5,13,20,-7,15
Mumbai City,5747,1,6,4,4,17,11,6,22
Kolkata,5747,2,5,7,2,18,13,5,22
Delhi Dynamo,5747,3,5,6,3,25,21,4,21
Kerala Blast,5747,4,5,5,4,14,14,0,20
NorthEast Un,5747,5,5,3,6,16,14,2,18
Chennaiyin,5747,6,4,5,5,16,21,-5,17
FC Goa,5747,7,4,3,7,12,17,-5,15
FC Pune City,5747,8,4,3,7,13,20,-7,15
Mumbai City,5748,1,7,4,3,20,10,10,25
NorthEast Un,5748,2,6,3,5,15,13,2,21
FC Pune City,5748,3,6,3,5,14,14,0,21
Delhi Dynamo,5748,4,4,6,4,24,20,4,18
FC Goa,5748,5,5,3,6,15,17,-2,18
Kerala Blast,5748,6,4,5,5,12,17,-5,17
Kolkata,5748,7,3,7,4,14,17,-3,16
Chennaiyin,5748,8,3,5,6,17,23,-6,14
Mumbai City,5749,1,6,4,4,17,11,6,22
Kerala Blast,5749,2,6,3,5,12,15,-3,21
Delhi Dynamo,5749,3,5,5,4,24,18,6,20
Kolkata,5749,4,4,8,2,17,15,2,20
Chennaiyin,5749,5,5,5,4,19,20,-1,20
NorthEast Un,5749,6,5,2,7,12,14,-2,17
FC Pune City,5749,7,4,4,6,14,17,-3,16
FC Goa,5749,8,4,3,7,13,18,-5,15
Mumbai City,5750,1,7,4,3,17,8,9,25
Kolkata,5750,2,5,6,3,17,14,3,21
FC Goa,5750,3,6,2,6,16,17,-1,20
Delhi Dynamo,5750,4,4,6,4,24,20,4,18
NorthEast Un,5750,5,5,3,6,14,14,0,18
FC Pune City,5750,6,5,3,6,14,16,-2,18
Chennaiyin,5750,7,4,5,5,15,20,-5,17
Kerala Blast,5750,8,4,3,7,11,19,-8,15
Delhi Dynamo,5751,1,6,6,2,26,17,9,24
Mumbai City,5751,2,6,4,4,17,10,7,22
Kerala Blast,5751,3,6,3,5,14,18,-4,21
Kolkata,5751,4,4,6,4,19,18,1,18
FC Pune City,5751,5,5,3,6,17,20,-3,18
NorthEast Un,5751,6,5,2,7,14,15,-1,17
Chennaiyin,5751,7,4,5,5,17,21,-4,17
FC Goa,5751,8,4,3,7,12,17,-5,15
Kolkata,5752,1,6,6,2,20,12,8,24
Mumbai City,5752,2,6,4,4,17,10,7,22
Delhi Dynamo,5752,3,5,6,3,24,19,5,21
Kerala Blast,5752,4,6,3,5,12,15,-3,21
Chennaiyin,5752,5,5,5,4,18,18,0,20
NorthEast Un,5752,6,5,2,7,12,12,0,17
FC Pune City,5752,7,4,3,7,12,18,-6,15
FC Goa,5752,8,3,3,8,10,21,-11,12
Kolkata,5753,1,6,6,2,19,14,5,24
Mumbai City,5753,2,6,5,3,16,8,8,23
Delhi Dynamo,5753,3,5,6,3,24,18,6,21
Kerala Blast,5753,4,5,4,5,12,16,-4,19
NorthEast Un,5753,5,5,3,6,12,12,0,18
Chennaiyin,5753,6,4,5,5,17,21,-4,17
FC Pune City,5753,7,4,3,7,14,19,-5,15
FC Goa,5753,8,4,2,8,15,21,-6,14
Delhi Dynamo,5754,1,6,6,2,26,17,9,24
Mumbai City,5754,2,6,4,4,17,10,7,22
NorthEast Un,5754,3,5,4,5,14,13,1,19
Kolkata,5754,4,4,7,3,17,18,-1,19
FC Pune City,5754,5,4,5,5,15,17,-2,17
Chennaiyin,5754,6,4,5,5,15,19,-4,17
Kerala Blast,5754,7,4,5,5,11,16,-5,17
FC Goa,5754,8,4,2,8,12,17,-5,14
Mumbai City,5755,1,6,4,4,17,10,7,22
Delhi Dynamo,5755,2,5,6,3,23,16,7,21
NorthEast Un,5755,3,6,3,5,11,9,2,21
FC Pune City,5755,4,5,4,5,13,14,-1,19
Kerala Blast,5755,5,5,4,5,10,14,-4,19
Kolkata,5755,6,4,6,4,16,16,0,18
FC Goa,5755,7,5,2,7,12,17,-5,17
Chennaiyin,5755,8,3,5,6,13,19,-6,14
Mumbai City,5756,1,7,4,3,17,8,9,25
Delhi Dynamo,5756,2,6,5,3,24,16,8,23
Kerala Blast,5756,3,6,4,4,13,14,-1,22
FC Pune City,5756,4,5,4,5,14,15,-1,19
NorthEast Un,5756,5,5,2,7,10,11,-1,17
Chennaiyin,5756,6,4,5,5,16,19,-3,17
Kolkata,5756,7,3,6,5,14,18,-4,15
FC Goa,5756,8,4,2,8,13,20,-7,14
Mumbai City,5757,1,7,4,3,18,8,10,25
Delhi Dynamo,5757,2,6,5,3,28,19,9,23
Kerala Blast,5757,3,6,4,4,14,16,-2,22
Kolkata,5757,4,4,6,4,17,16,1,18
NorthEast Un,5757,5,5,3,6,13,13,0,18
Chennaiyin,5757,6,3,6,5,14,19,-5,15
FC Pune City,5757,7,4,3,7,13,18,-5,15
FC Goa,5757,8,4,3,7,12,20,-8,15
Kolkata,5758,1,6,6,2,18,14,4,24
Mumbai City,5758,2,6,4,4,16,9,7,22
Delhi Dynamo,5758,3,5,6,3,24,17,7,21
NorthEast Un,5758,4,5,4,5,14,12,2,19
FC Pune City,5758,5,5,3,6,17,17,0,18
FC Goa,5758,6,5,2,7,12,16,-4,17
Kerala Blast,5758,7,4,4,6,10,18,-8,16
Chennaiyin,5758,8,3,5,6,14,22,-8,14
Kolkata,5759,1,6,6,2,24,16,8,24
Mumbai City,5759,2,6,5,3,18,10,8,23
Delhi Dynamo,5759,3,4,7,3,24,19,5,19
NorthEast Un,5759,4,5,3,6,14,13,1,18
Chennaiyin,5759,5,4,6,4,17,20,-3,18
Kerala Blast,5759,6,4,5,5,10,17,-7,17
FC Pune City,5759,7,4,4,6,13,17,-4,16
FC Goa,5759,8,3,4,7,11,19,-8,13
Delhi Dynamo,5760,1,6,6,2,25,15,10,24
Mumbai City,5760,2,6,5,3,16,8,8,23
NorthEast Un,5760,3,6,2,6,12,11,1,20
Kerala Blast,5760,4,5,4,5,13,15,-2,19
FC Pune City,5760,5,5,3,6,13,18,-5,18
Kolkata,5760,6,3,8,3,16,16,0,17
FC Goa,5760,7,4,3,7,16,21,-5,15
Chennaiyin,5760,8,3,5,6,15,22,-7,14
Kerala Blast,5761,1,7,3,4,15,13,2,24
Delhi Dynamo,5761,2,6,5,3,24,17,7,23
Mumbai City,5761,3,6,4,4,16,9,7,22
Kolkata,5761,4,4,6,4,15,16,-1,18
FC Pune City,5761,5,5,3,6,13,16,-3,18
NorthEast Un,5761,6,5,2,7,12,12,0,17
Chennaiyin,5761,7,4,5,5,15,19,-4,17
FC Goa,5761,8,4,2,8,11,19,-8,14
Delhi Dynamo,5762,1,6,5,3,26,16,10,23
Mumbai City,5762,2,6,4,4,16,9,7,22
Kolkata,5762,3,5,6,3,17,15,2,21
Kerala Blast,5762,4,5,4,5,13,16,-3,19
NorthEast Un,5762,5,5,3,6,13,15,-2,18
Chennaiyin,5762,6,4,6,4,16,19,-3,18
FC Pune City,5762,7,4,4,6,13,17,-4,16
FC Goa,5762,8,4,2,8,11,18,-7,14
Mumbai City,5763,1,7,4,3,18,8,10,25
Delhi Dynamo,5763,2,5,6,3,26,17,9,21
Kolkata,5763,3,4,7,3,16,17,-1,19
Kerala Blast,5763,4,5,4,5,10,14,-4,19
FC Goa,5763,5,5,2,7,14,18,-4,17
Chennaiyin,5763,6,4,5,5,14,20,-6,17
NorthEast Un,5763,7,4,4,6,10,11,-1,16
FC Pune City,5763,8,4,4,6,14,17,-3,16
Mumbai City,5764,1,6,5,3,17,9,8,23
Chennaiyin,5764,2,5,5,4,17,17,0,20
Kerala Blast,5764,3,5,5,4,14,16,-2,20
Kolkata,5764,4,4,7,3,18,17,1,19
Delhi Dynamo,5764,5,4,6,4,23,21,2,18
NorthEast Un,5764,6,5,2,7,14,15,-1,17
FC Goa,5764,7,5,2,7,13,16,-3,17
FC Pune City,5764,8,4,4,6,14,19,-5,16
Mumbai City,5765,1,7,4,3,18,9,9,25
Kerala Blast,5765,2,6,3,5,14,21,-7,21
Delhi Dynamo,5765,3,5,5,4,25,18,7,20
Chennaiyin,5765,4,5,5,4,17,18,-1,20
Kolkata,5765,5,4,7,3,19,14,5,19
FC Pune City,5765,6,5,3,6,14,16,-2,18
NorthEast Un,5765,7,5,2,7,14,14,0,17
FC Goa,5765,8,3,3,8,9,20,-11,12
Mumbai City,5766,1,7,4,3,18,8,10,25
Kolkata,5766,2,5,6,3,15,13,2,21
Kerala Blast,5766,3,6,3,5,12,15,-3,21
NorthEast Un,5766,4,6,2,6,12,10,2,20
FC Goa,5766,5,5,3,6,12,16,-4,18
Delhi Dynamo,5766,6,4,5,5,22,20,2,17
FC Pune City,5766,7,4,3,7,13,17,-4,15
Chennaiyin,5766,8,3,6,5,14,19,-5,15
Delhi Dynamo,5767,1,7,5,2,28,17,11,26
Mumbai City,5767,2,6,4,4,18,12,6,22
FC Pune City,5767,3,6,3,5,17,15,2,21
Kerala Blast,5767,4,5,4,5,11,16,-5,19
NorthEast Un,5767,5,4,4,6,12,13,-1,16
Chennaiyin,5767,6,3,7,4,14,18,-4,16
Kolkata,5767,7,3,6,5,14,18,-4,15
FC Goa,5767,8,4,3,7,10,15,-5,15
Delhi Dynamo,5768,1,6,6,2,27,16,11,24
Kerala Blast,5768,2,7,3,4,15,14,1,24
Mumbai City,5768,3,6,5,3,17,9,8,23
Kolkata,5768,4,4,6,4,15,16,-1,18
FC Goa,5768,5,5,2,7,13,19,-6,17
NorthEast Un,5768,6,4,3,7,9,12,-3,15
Chennaiyin,5768,7,3,6,5,13,18,-5,15
FC Pune City,5768,7,4,3,7,13,18,-5,15
Delhi Dynamo,5769,1,6,5,3,26,15,11,23
Mumbai City,5769,2,6,4,4,16,10,6,22
NorthEast Un,5769,3,6,2,6,15,15,0,20
Kerala Blast,5769,4,5,5,4,15,17,-2,20
Kolkata,5769,5,4,7,3,14,13,1,19
FC Pune City,5769,6,5,4,5,15,16,-1,19
Chennaiyin,5769,7,3,6,5,16,21,-5,15
FC Goa,5769,8,3,3,8,9,19,-10,12
Delhi Dynamo,5770,1,6,6,2,30,18,12,24
Mumbai City,5770,2,6,5,3,17,9,8,23
Kolkata,5770,3,4,8,2,16,12,4,20
Kerala Blast,5770,4,5,5,4,14,14,0,20
NorthEast Un,5770,5,5,2,7,11,15,-4,17
FC Pune City,5770,6,4,4,6,13,18,-5,16
Chennaiyin,5770,7,3,6,5,14,19,-5,15
FC Goa,5770,8,3,4,7,11,21,-10,13
Mumbai City,5771,1,7,4,3,18,8,10,25
Kolkata,5771,2,6,6,2,18,12,6,24
NorthEast Un,5771,3,5,3,6,15,12,3,18
Delhi Dynamo,5771,4,4,6,4,24,23,1,18
FC Pune City,5771,5,5,3,6,14,17,-3,18
Kerala Blast,5771,6,5,3,6,12,17,-5,18
Chennaiyin,5771,7,3,6,5,14,19,-5,15
FC Goa,5771,8,4,3,7,12,19,-7,15
Mumbai City,5772,1,7,4,3,17,8,9,25
NorthEast Un,5772,2,6,3,5,14,9,5,21
Delhi Dynamo,5772,3,5,5,4,22,18,4,20
Kolkata,5772,4,4,8,2,17,15,2,20
Kerala Blast,5772,5,5,4,5,13,14,-1,19
FC Pune City,5772,6,4,4,6,13,19,-6,16
FC Goa,5772,7,4,3,7,12,18,-6,15
Chennaiyin,5772,8,3,5,6,14,21,-7,14
Mumbai City,5773,1,7,4,3,19,10,9,25
Delhi Dynamo,5773,2,6,5,3,28,18,10,23
Kolkata,5773,3,5,6,3,20,18,2,21
NorthEast Un,5773,4,5,2,7,13,11,2,17
Chennaiyin,5773,5,4,5,5,14,19,-5,17
FC Goa,5773,6,5,2,7,13,18,-5,17
FC Pune City,5773,7,4,4,6,14,17,-3,16
Kerala Blast,5773,8,4,4,6,11,21,-10,16
Mumbai City,5774,1,7,4,3,18,8,10,25
FC Goa,5774,2,6,2,6,16,16,0,20
Kerala Blast,5774,3,5,5,4,15,18,-3,20
Delhi Dynamo,5774,4,4,6,4,22,18,4,18
Kolkata,5774,5,3,8,3,15,16,-1,17
FC Pune City,5774,6,4,5,5,14,16,-2,17
Chennaiyin,5774,7,4,5,5,16,22,-6,17
NorthEast Un,5774,8,4,3,7,13,15,-2,15
Mumbai City,5775,1,6,5,3,18,10,8,23
Delhi Dynamo,5775,2,5,7,2,26,18,8,22
Kolkata,5775,3,5,6,3,18,15,3,21
Kerala Blast,5775,4,6,3,5,17,16,1,21
FC Pune City,5775,5,5,3,6,13,18,-5,18
NorthEast Un,5775,6,5,2,7,14,15,-1,17
Chennaiyin,5775,7,4,5,5,15,21,-6,17
FC Goa,5775,8,3,3,8,10,18,-8,12
Kolkata,5776,1,5,7,2,21,15,6,22
Mumbai City,5776,2,6,4,4,16,10,6,22
Delhi Dynamo,5776,3,5,6,3,23,15,8,21
NorthEast Un,5776,4,5,4,5,10,9,1,19
Kerala Blast,5776,5,5,3,6,14,16,-2,18
FC Goa,5776,6,5,3,6,12,15,-3,18
Chennaiyin,5776,7,3,6,5,13,19,-6,15
FC Pune City,5776,8,4,3,7,13,23,-10,15
Mumbai City,5777,1,7,4,3,18,8,10,25
Kolkata,5777,2,5,6,3,16,13,3,21
FC Pune City,5777,3,6,3,5,15,15,0,21
Delhi Dynamo,5777,4,4,6,4,22,20,2,18
NorthEast Un,5777,5,5,3,6,13,11,2,18
Kerala Blast,5777,6,5,3,6,11,17,-6,18
Chennaiyin,5777,7,3,7,4,15,19,-4,16
FC Goa,5777,8,3,4,7,10,17,-7,13
Mumbai City,5778,1,7,4,3,19,8,11,25
Delhi Dynamo,5778,2,5,6,3,25,20,5,21
Kolkata,5778,3,4,7,3,16,16,0,19
Chennaiyin,5778,4,4,6,4,14,17,-3,18
Kerala Blast,5778,5,4,6,4,12,16,-4,18
NorthEast Un,5778,6,4,4,6,12,13,-1,16
FC Pune City,5778,7,4,4,6,14,17,-3,16
FC Goa,5778,8,4,3,7,13,18,-5,15
Mumbai City,5779,1,7,4,3,18,9,9,25
Delhi Dynamo,5779,2,6,5,3,30,19,11,23
Kolkata,5779,3,4,8,2,15,12,3,20
NorthEast Un,5779,4,5,3,6,12,13,-1,18
FC Pune City,5779,5,5,3,6,15,17,-2,18
Chennaiyin,5779,6,3,7,4,13,17,-4,16
Kerala Blast,5779,7,4,4,6,10,18,-8,16
FC Goa,5779,8,3,4,7,10,18,-8,13
Mumbai City,5780,1,7,4,3,18,8,10,25
Kerala Blast,5780,2,6,4,4,14,16,-2,22
Delhi Dynamo,5780,3,5,5,4,24,17,7,20
Kolkata,5780,4,4,7,3,18,15,3,19
NorthEast Un,5780,5,5,2,7,12,13,-1,17
FC Pune City,5780,6,4,5,5,14,16,-2,17
Chennaiyin,5780,7,4,5,5,16,20,-4,17
FC Goa,5780,8,4,2,8,10,21,-11,14
Mumbai City,5781,1,7,4,3,19,10,9,25
Kolkata,5781,2,5,7,2,17,13,4,22
Delhi Dynamo,5781,3,5,6,3,26,19,7,21
NorthEast Un,5781,4,5,4,5,13,11,2,19
FC Pune City,5781,5,5,4,5,16,17,-1,19
Kerala Blast,5781,6,4,4,6,11,18,-7,16
Chennaiyin,5781,7,3,6,5,15,21,-6,15
FC Goa,5781,8,3,3,8,10,18,-8,12
Mumbai City,5782,1,6,5,3,17,9,8,23
Delhi Dynamo,5782,2,5,7,2,28,17,11,22
Kolkata,5782,3,4,8,2,19,16,3,20
Kerala Blast,5782,4,5,4,5,14,16,-2,19
NorthEast Un,5782,5,5,3,6,16,18,-2,18
FC Pune City,5782,6,4,5,5,14,16,-2,17
FC Goa,5782,7,4,3,7,15,23,-8,15
Chennaiyin,5782,8,3,5,6,18,26,-8,14
Mumbai City,5783,1,6,5,3,18,10,8,23
Delhi Dynamo,5783,2,5,7,2,27,17,10,22
Kerala Blast,5783,3,6,3,5,13,15,-2,21
Chennaiyin,5783,4,5,5,4,18,18,0,20
Kolkata,5783,5,4,7,3,17,14,3,19
FC Pune City,5783,6,5,4,5,14,15,-1,19
NorthEast Un,5783,7,4,3,7,12,15,-3,15
FC Goa,5783,8,3,2,9,8,23,-15,11
Mumbai City,5784,1,6,5,3,17,9,8,23
Delhi Dynamo,5784,2,5,6,3,23,16,7,21
NorthEast Un,5784,3,5,3,6,13,10,3,18
FC Goa,5784,4,5,3,6,10,14,-4,18
Kerala Blast,5784,4,4,6,4,10,14,-4,18
Kolkata,5784,6,3,8,3,15,15,0,17
FC Pune City,5784,7,4,5,5,13,15,-2,17
Chennaiyin,5784,8,3,6,5,13,21,-8,15
Mumbai City,5785,1,7,4,3,20,10,10,25
Kolkata,5785,2,5,6,3,16,14,2,21
Kerala Blast,5785,3,6,3,5,15,17,-2,21
Delhi Dynamo,5785,4,4,6,4,25,21,4,18
FC Goa,5785,5,5,3,6,15,17,-2,18
NorthEast Un,5785,6,5,2,7,13,14,-1,17
Chennaiyin,5785,7,4,5,5,15,21,-6,17
FC Pune City,5785,8,4,3,7,13,18,-5,15
Mumbai City,5786,1,7,4,3,17,8,9,25
Kerala Blast,5786,2,7,3,4,15,16,-1,24
Delhi Dynamo,5786,3,4,6,4,21,16,5,18
NorthEast Un,5786,4,5,3,6,12,12,0,18
FC Goa,5786,5,5,3,6,14,16,-2,18
Kolkata,5786,6,3,7,4,16,19,-3,16
FC Pune City,5786,7,4,4,6,14,17,-3,16
Chennaiyin,5786,8,3,6,5,15,20,-5,15
Mumbai City,5787,1,7,4,3,19,9,10,25
FC Pune City,5787,2,6,3,5,15,15,0,21
Delhi Dynamo,5787,3,5,5,4,27,20,7,20
NorthEast Un,5787,4,5,4,5,15,13,2,19
Kolkata,5787,5,4,7,3,14,13,1,19
Kerala Blast,5787,6,4,5,5,11,16,-5,17
Chennaiyin,5787,7,3,7,4,16,20,-4,16
FC Goa,5787,8,3,3,8,9,20,-11,12
Mumbai City,5788,1,7,4,3,17,8,9,25
Kolkata,5788,2,5,7,2,18,13,5,22
Chennaiyin,5788,3,5,5,4,17,17,0,20
Delhi Dynamo,5788,4,4,6,4,25,20,5,18
FC Pune City,5788,5,5,3,6,15,18,-3,18
Kerala Blast,5788,6,5,3,6,12,18,-6,18
NorthEast Un,5788,7,5,2,7,11,13,-2,17
FC Goa,5788,8,3,4,7,11,19,-8,13
Delhi Dynamo,5789,1,6,6,2,31,17,14,24
Kerala Blast,5789,2,7,3,4,13,14,-1,24
Mumbai City,5789,3,6,5,3,19,11,8,23
Chennaiyin,5789,4,5,5,4,18,18,0,20
Kolkata,5789,5,3,7,4,15,16,-1,16
FC Pune City,5789,6,4,4,6,14,17,-3,16
NorthEast Un,5789,7,4,2,8,10,16,-6,14
FC Goa,5789,8,4,2,8,10,21,-11,14
Mumbai City,5790,1,7,4,3,20,8,12,25
Kolkata,5790,2,5,7,2,17,12,5,22
Delhi Dynamo,5790,3,5,5,4,23,21,2,20
FC Pune City,5790,4,5,3,6,13,16,-3,18
Kerala Blast,5790,5,5,3,6,11,17,-6,18
Chennaiyin,5790,6,4,5,5,17,19,-2,17
NorthEast Un,5790,7,5,2,7,13,15,-2,17
FC Goa,5790,8,4,3,7,10,16,-6,15
Delhi Dynamo,5791,1,6,5,3,29,19,10,23
Mumbai City,5791,2,6,4,4,17,10,7,22
Kolkata,5791,3,5,7,2,19,16,3,22
Chennaiyin,5791,4,5,5,4,17,19,-2,20
Kerala Blast,5791,5,5,4,5,10,16,-6,19
FC Pune City,5791,6,5,3,6,17,17,0,18
NorthEast Un,5791,7,5,2,7,15,16,-1,17
FC Goa,5791,8,3,2,9,10,21,-11,11
Mumbai City,5792,1,6,5,3,17,9,8,23
Delhi Dynamo,5792,2,5,6,3,25,18,7,21
Kolkata,5792,3,4,8,2,18,14,4,20
Kerala Blast,5792,4,5,5,4,11,13,-2,20
NorthEast Un,5792,5,5,2,7,12,14,-2,17
Chennaiyin,5792,6,4,5,5,15,20,-5,17
FC Pune City,5792,7,4,4,6,13,18,-5,16
FC Goa,5792,8,4,3,7,12,17,-5,15
Mumbai City,5793,1,6,5,3,18,10,8,23
Kerala Blast,5793,2,6,4,4,14,16,-2,22
Kolkata,5793,3,4,7,3,15,14,1,19
NorthEast Un,5793,4,5,4,5,13,12,1,19
Delhi Dynamo,5793,5,4,6,4,26,21,5,18
FC Pune City,5793,6,4,4,6,12,15,-3,16
Chennaiyin,5793,7,3,7,4,14,18,-4,16
FC Goa,5793,8,4,3,7,12,18,-6,15
Mumbai City,5794,1,6,5,3,17,9,8,23
Delhi Dynamo,5794,2,5,6,3,27,17,10,21
NorthEast Un,5794,3,6,2,6,14,14,0,20
Kolkata,5794,4,4,7,3,16,14,2,19
FC Pune City,5794,5,5,4,5,14,15,-1,19
Chennaiyin,5794,6,4,6,4,18,18,0,18
Kerala Blast,5794,7,4,5,5,11,18,-7,17
FC Goa,5794,8,3,3,8,9,21,-12,12
Mumbai City,5795,1,6,4,4,17,10,7,22
Delhi Dynamo,5795,2,5,6,3,24,19,5,21
Chennaiyin,5795,3,5,5,4,17,18,-1,20
Kolkata,5795,4,4,7,3,17,15,2,19
Kerala Blast,5795,5,5,4,5,12,15,-3,19
FC Pune City,5795,6,5,3,6,15,19,-4,18
NorthEast Un,5795,7,5,2,7,12,13,-1,17
FC Goa,5795,8,4,3,7,12,17,-5,15
Mumbai City,5796,1,7,4,3,18,8,10,25
NorthEast Un,5796,2,6,3,5,14,11,3,21
FC Goa,5796,3,5,3,6,15,18,-3,18
Kerala Blast,5796,4,4,6,4,11,15,-4,18
Delhi Dynamo,5796,5,4,5,5,22,21,1,17
Kolkata,5796,6,3,8,3,17,17,0,17
FC Pune City,5796,7,4,5,5,13,15,-2,17
Chennaiyin,5796,8,3,6,5,15,20,-5,15
Mumbai City,5797,1,7,4,3,18,9,9,25
Kerala Blast,5797,2,6,4,4,13,15,-2,22
NorthEast Un,5797,3,6,3,5,15,11,4,21
Delhi Dynamo,5797,4,5,5,4,24,20,4,20
FC Pune City,5797,5,5,3,6,14,16,-2,18
FC Goa,5797,6,5,2,7,15,18,-3,17
Kolkata,5797,7,3,6,5,14,16,-2,15
Chennaiyin,5797,8,3,5,6,15,23,-8,14
Mumbai City,5798,1,6,4,4,16,11,5,22
Delhi Dynamo,5798,2,5,6,3,26,17,9,21
Kolkata,5798,3,4,7,3,17,15,2,19
Kerala Blast,5798,4,5,4,5,12,17,-5,19
NorthEast Un,5798,5,5,3,6,12,13,-1,18
Chennaiyin,5798,6,4,6,4,16,18,-2,18
FC Pune City,5798,7,4,4,6,13,16,-3,16
FC Goa,5798,8,4,4,6,11,16,-5,16
Delhi Dynamo,5799,1,6,5,3,26,18,8,23
NorthEast Un,5799,2,7,2,5,15,11,4,23
Mumbai City,5799,3,6,4,4,16,9,7,22
Kolkata,5799,4,4,8,2,14,12,2,20
Kerala Blast,5799,5,5,4,5,11,14,-3,19
FC Pune City,5799,6,4,3,7,12,17,-5,15
FC Goa,5799,7,4,3,7,10,17,-7,15
Chennaiyin,5799,8,3,5,6,14,20,-6,14
Mumbai City,5800,1,6,5,3,16,8,8,23
Delhi Dynamo,5800,2,5,6,3,23,15,8,21
FC Goa,5800,3,6,2,6,15,18,-3,20
Kolkata,5800,4,4,7,3,19,17,2,19
FC Pune City,5800,5,5,4,5,16,16,0,19
Kerala Blast,5800,6,5,3,6,13,19,-6,18
NorthEast Un,5800,7,5,2,7,12,15,-3,17
Chennaiyin,5800,8,3,5,6,15,21,-6,14
Mumbai City,5801,1,7,4,3,19,10,9,25
NorthEast Un,5801,2,7,2,5,18,11,7,23
Delhi Dynamo,5801,3,5,5,4,26,20,6,20
FC Pune City,5801,4,5,4,5,16,16,0,19
Kerala Blast,5801,5,5,4,5,15,21,-6,19
Kolkata,5801,6,3,7,4,16,18,-2,16
FC Goa,5801,7,4,3,7,13,18,-5,15
Chennaiyin,5801,8,3,5,6,14,23,-9,14
Mumbai City,5802,1,7,4,3,17,8,9,25
Kolkata,5802,2,5,7,2,16,12,4,22
Delhi Dynamo,5802,3,4,6,4,21,16,5,18
FC Goa,5802,4,5,3,6,13,14,-1,18
Kerala Blast,5802,5,4,5,5,11,16,-5,17
Chennaiyin,5802,6,4,5,5,16,23,-7,17
NorthEast Un,5802,7,4,4,6,13,14,-1,16
FC Pune City,5802,8,4,4,6,12,16,-4,16
Delhi Dynamo,5803,1,6,5,3,28,21,7,23
Mumbai City,5803,2,6,4,4,16,9,7,22
Kerala Blast,5803,3,6,4,4,18,15,3,22
Kolkata,5803,4,4,7,3,18,15,3,19
FC Goa,5803,5,5,2,7,21,19,2,17
NorthEast Un,5803,6,5,2,7,16,18,-2,17
Chennaiyin,5803,7,4,5,5,16,27,-11,17
FC Pune City,5803,8,4,3,7,12,21,-9,15
Mumbai City,5804,1,7,4,3,21,8,13,25
Delhi Dynamo,5804,2,6,5,3,27,21,6,23
Kolkata,5804,3,4,8,2,16,14,2,20
Kerala Blast,5804,4,5,4,5,12,15,-3,19
Chennaiyin,5804,5,4,6,4,17,18,-1,18
NorthEast Un,5804,6,4,4,6,12,13,-1,16
FC Pune City,5804,7,4,4,6,13,17,-4,16
FC Goa,5804,8,3,3,8,8,20,-12,12
Mumbai City,5805,1,7,4,3,18,9,9,25
Kerala Blast,5805,2,7,3,4,15,15,0,24
Delhi Dynamo,5805,3,6,5,3,29,18,11,23
FC Pune City,5805,4,5,3,6,14,17,-3,18
Chennaiyin,5805,5,4,5,5,14,18,-4,17
FC Goa,5805,6,5,2,7,12,16,-4,17
Kolkata,5805,7,3,6,5,14,17,-3,15
NorthEast Un,5805,8,4,2,8,10,16,-6,14
Mumbai City,5806,1,7,4,3,18,9,9,25
Kerala Blast,5806,2,6,4,4,14,15,-1,22
Delhi Dynamo,5806,3,4,7,3,23,17,6,19
Chennaiyin,5806,4,4,6,4,15,18,-3,18
Kolkata,5806,5,3,8,3,15,15,0,17
NorthEast Un,5806,6,4,5,5,10,10,0,17
FC Pune City,5806,7,4,4,6,12,16,-4,16
FC Goa,5806,8,3,4,7,11,18,-7,13
Mumbai City,5807,1,7,4,3,18,9,9,25
Kerala Blast,5807,2,6,4,4,12,14,-2,22
Delhi Dynamo,5807,3,4,7,3,24,18,6,19
FC Goa,5807,4,5,3,6,14,16,-2,18
FC Pune City,5807,4,5,3,6,14,16,-2,18
Chennaiyin,5807,6,4,5,5,17,20,-3,17
NorthEast Un,5807,7,4,4,6,12,15,-3,16
Kolkata,5807,8,3,6,5,15,18,-3,15
Mumbai City,5808,1,7,4,3,19,9,10,25
Kerala Blast,5808,2,7,3,4,15,14,1,24
Delhi Dynamo,5808,3,5,5,4,24,18,6,20
FC Pune City,5808,4,5,3,6,14,16,-2,18
FC Goa,5808,5,5,3,6,11,15,-4,18
Kolkata,5808,6,3,7,4,15,18,-3,16
NorthEast Un,5808,7,4,3,7,9,12,-3,15
Chennaiyin,5808,8,3,6,5,13,18,-5,15
Mumbai City,5809,1,7,4,3,19,10,9,25
Delhi Dynamo,5809,2,5,5,4,30,22,8,20
NorthEast Un,5809,3,6,2,6,15,12,3,20
Chennaiyin,5809,4,5,5,4,17,19,-2,20
Kolkata,5809,5,4,7,3,18,17,1,19
Kerala Blast,5809,6,5,4,5,15,16,-1,19
FC Pune City,5809,7,4,3,7,12,20,-8,15
FC Goa,5809,8,4,2,8,13,23,-10,14
Mumbai City,5810,1,7,4,3,18,9,9,25
Kolkata,5810,2,6,6,2,18,13,5,24
Kerala Blast,5810,3,6,3,5,13,15,-2,21
Delhi Dynamo,5810,4,4,6,4,23,18,5,18
NorthEast Un,5810,5,4,4,6,10,11,-1,16
Chennaiyin,5810,6,3,7,4,15,19,-4,16
FC Pune City,5810,7,4,3,7,12,18,-6,15
FC Goa,5810,8,4,3,7,11,17,-6,15
Delhi Dynamo,5811,1,6,5,3,24,15,9,23
Mumbai City,5811,2,6,4,4,16,10,6,22
NorthEast Un,5811,3,6,2,6,13,12,1,20
Chennaiyin,5811,4,5,5,4,17,18,-1,20
Kolkata,5811,5,4,7,3,18,16,2,19
FC Pune City,5811,6,5,3,6,14,19,-5,18
Kerala Blast,5811,7,4,4,6,12,18,-6,16
FC Goa,5811,8,4,2,8,11,17,-6,14
Mumbai City,5812,1,6,5,3,16,8,8,23
Delhi Dynamo,5812,2,5,6,3,26,17,9,21
Kolkata,5812,3,5,6,3,17,15,2,21
Kerala Blast,5812,4,6,3,5,14,15,-1,21
NorthEast Un,5812,5,6,2,6,13,12,1,20
FC Pune City,5812,6,5,3,6,13,16,-3,18
Chennaiyin,5812,7,4,5,5,15,20,-5,17
FC Goa,5812,8,3,2,9,11,22,-11,11
Mumbai City,5813,1,7,4,3,19,9,10,25
Delhi Dynamo,5813,2,5,6,3,25,19,6,21
Kolkata,5813,3,4,7,3,17,16,1,19
Kerala Blast,5813,4,5,4,5,16,17,-1,19
FC Pune City,5813,5,5,3,6,16,18,-2,18
Chennaiyin,5813,6,4,6,4,17,20,-3,18
FC Goa,5813,7,4,3,7,14,19,-5,15
NorthEast Un,5813,8,4,3,7,10,16,-6,15
Mumbai City,5814,1,7,4,3,18,8,10,25
Kerala Blast,5814,2,7,3,4,17,13,4,24
Delhi Dynamo,5814,3,5,6,3,26,17,9,21
Kolkata,5814,4,3,8,3,16,18,-2,17
NorthEast Un,5814,5,4,4,6,10,12,-2,16
FC Pune City,5814,6,4,4,6,14,19,-5,16
Chennaiyin,5814,7,3,6,5,14,19,-5,15
FC Goa,5814,8,4,3,7,11,20,-9,15
Mumbai City,5815,1,7,4,3,17,8,9,25
Delhi Dynamo,5815,2,5,6,3,23,16,7,21
NorthEast Un,5815,3,6,2,6,12,11,1,20
Kolkata,5815,4,4,7,3,18,18,0,19
FC Pune City,5815,5,5,4,5,15,16,-1,19
FC Goa,5815,6,4,4,6,15,19,-4,16
Chennaiyin,5815,7,3,6,5,15,20,-5,15
Kerala Blast,5815,8,4,3,7,12,19,-7,15
Mumbai City,5816,1,7,4,3,20,8,12,25
Kolkata,5816,2,5,7,2,16,12,4,22
Delhi Dynamo,5816,3,5,5,4,24,20,4,20
Chennaiyin,5816,4,4,5,5,17,18,-1,17
FC Pune City,5816,5,4,5,5,14,16,-2,17
NorthEast Un,5816,6,5,2,7,10,15,-5,17
FC Goa,5816,7,5,2,7,11,17,-6,17
Kerala Blast,5816,8,4,4,6,11,17,-6,16
Delhi Dynamo,5817,1,6,6,2,25,15,10,24
Mumbai City,5817,2,6,5,3,17,9,8,23
Kolkata,5817,3,4,8,2,17,13,4,20
FC Pune City,5817,4,5,3,6,14,18,-4,18
NorthEast Un,5817,5,5,2,7,11,13,-2,17
Chennaiyin,5817,6,4,5,5,16,21,-5,17
Kerala Blast,5817,7,4,4,6,10,16,-6,16
FC Goa,5817,8,4,3,7,12,17,-5,15
Mumbai City,5818,1,6,4,4,16,9,7,22
Kolkata,5818,2,5,7,2,16,13,3,22
Kerala Blast,5818,3,6,3,5,13,14,-1,21
Delhi Dynamo,5818,4,5,5,4,22,18,4,20
Chennaiyin,5818,5,5,5,4,17,19,-2,20
NorthEast Un,5818,6,5,2,7,12,12,0,17
FC Goa,5818,7,4,3,7,12,17,-5,15
FC Pune City,5818,8,4,3,7,12,18,-6,15
Delhi Dynamo,5819,1,7,5,2,27,15,12,26
Mumbai City,5819,2,6,4,4,17,11,6,22
Kolkata,5819,3,5,6,3,18,14,4,21
FC Pune City,5819,4,5,3,6,13,15,-2,18
Chennaiyin,5819,5,4,5,5,16,20,-4,17
FC Goa,5819,6,5,2,7,11,17,-6,17
Kerala Blast,5819,7,4,4,6,11,19,-8,16
NorthEast Un,5819,8,4,3,7,11,13,-2,15
Mumbai City,5820,1,6,5,3,18,10,8,23
Delhi Dynamo,5820,2,5,7,2,26,18,8,22
Kolkata,5820,3,4,7,3,17,16,1,19
FC Pune City,5820,4,5,4,5,14,15,-1,19
FC Goa,5820,5,5,3,6,14,18,-4,18
Kerala Blast,5820,6,5,3,6,13,17,-4,18
NorthEast Un,5820,7,4,3,7,11,14,-3,15
Chennaiyin,5820,8,3,6,5,15,20,-5,15
Mumbai City,5821,1,6,5,3,17,9,8,23
Delhi Dynamo,5821,2,5,6,3,24,18,6,21
NorthEast Un,5821,3,6,3,5,13,10,3,21
Kolkata,5821,4,4,8,2,15,13,2,20
FC Pune City,5821,5,5,4,5,16,17,-1,19
Kerala Blast,5821,6,4,5,5,14,19,-5,17
Chennaiyin,5821,7,3,6,5,15,20,-5,15
FC Goa,5821,8,3,3,8,11,19,-8,12
Delhi Dynamo,5822,1,7,5,2,28,14,14,26
Mumbai City,5822,2,6,4,4,16,10,6,22
Kolkata,5822,3,5,7,2,18,14,4,22
Chennaiyin,5822,4,5,5,4,17,18,-1,20
Kerala Blast,5822,5,5,4,5,13,19,-6,19
FC Pune City,5822,6,5,3,6,18,17,1,18
NorthEast Un,5822,7,4,2,8,10,16,-6,14
FC Goa,5822,8,3,2,9,8,20,-12,11
NorthEast Un,5823,1,7,2,5,18,13,5,23
Mumbai City,5823,2,6,4,4,16,9,7,22
Delhi Dynamo,5823,3,5,5,4,24,19,5,20
FC Goa,5823,4,6,2,6,13,15,-2,20
Kerala Blast,5823,5,5,4,5,15,20,-5,19
Kolkata,5823,6,4,6,4,19,18,1,18
FC Pune City,5823,7,4,4,6,13,17,-4,16
Chennaiyin,5823,8,3,5,6,14,21,-7,14
Mumbai City,5824,1,7,4,3,19,9,10,25
Kerala Blast,5824,2,6,3,5,15,15,0,21
Delhi Dynamo,5824,3,5,5,4,26,20,6,20
NorthEast Un,5824,4,6,2,6,15,13,2,20
FC Goa,5824,5,5,3,6,13,16,-3,18
FC Pune City,5824,6,5,3,6,14,19,-5,18
Kolkata,5824,7,3,7,4,15,16,-1,16
Chennaiyin,5824,8,3,5,6,13,22,-9,14
Mumbai City,5825,1,6,5,3,17,9,8,23
Delhi Dynamo,5825,2,5,7,2,23,15,8,22
Kerala Blast,5825,3,6,4,4,12,14,-2,22
Kolkata,5825,4,4,7,3,16,15,1,19
FC Pune City,5825,5,5,3,6,15,17,-2,18
Chennaiyin,5825,6,4,5,5,16,20,-4,17
NorthEast Un,5825,7,4,3,7,11,13,-2,15
FC Goa,5825,8,4,2,8,10,17,-7,14
Mumbai City,5826,1,6,5,3,17,9,8,23
Delhi Dynamo,5826,2,4,7,3,23,17,6,19
Kolkata,5826,3,4,7,3,16,13,3,19
FC Pune City,5826,4,5,4,5,15,16,-1,19
FC Goa,5826,5,5,3,6,12,15,-3,18
Chennaiyin,5826,6,4,5,5,16,21,-5,17
Kerala Blast,5826,7,4,5,5,11,18,-7,17
NorthEast Un,5826,8,4,4,6,11,12,-1,16
Mumbai City,5827,1,7,4,3,18,8,10,25
Delhi Dynamo,5827,2,5,5,4,23,19,4,20
Kolkata,5827,3,4,8,2,16,14,2,20
Kerala Blast,5827,4,5,4,5,12,17,-5,19
NorthEast Un,5827,5,5,3,6,14,12,2,18
FC Pune City,5827,6,5,3,6,14,15,-1,18
Chennaiyin,5827,7,3,6,5,16,21,-5,15
FC Goa,5827,8,4,3,7,12,19,-7,15
Mumbai City,5828,1,7,4,3,18,8,10,25
Delhi Dynamo,5828,2,6,5,3,25,16,9,23
Kolkata,5828,3,5,6,3,16,14,2,21
Chennaiyin,5828,4,5,5,4,16,18,-2,20
Kerala Blast,5828,5,5,4,5,13,17,-4,19
FC Pune City,5828,6,5,3,6,14,16,-2,18
NorthEast Un,5828,7,4,3,7,12,15,-3,15
FC Goa,5828,8,3,2,9,8,18,-10,11
Kerala Blast,5829,1,7,3,4,14,14,0,24
Delhi Dynamo,5829,2,6,5,3,28,18,10,23
Mumbai City,5829,3,6,4,4,17,12,5,22
Kolkata,5829,4,5,6,3,16,14,2,21
NorthEast Un,5829,5,6,2,6,17,11,6,20
Chennaiyin,5829,6,4,5,5,14,22,-8,17
FC Pune City,5829,7,4,3,7,12,17,-5,15
FC Goa,5829,8,3,2,9,8,18,-10,11
Mumbai City,5830,1,6,5,3,17,9,8,23
Delhi Dynamo,5830,2,5,6,3,24,17,7,21
Kerala Blast,5830,3,6,3,5,14,16,-2,21
FC Goa,5830,4,6,2,6,15,18,-3,20
Kolkata,5830,5,4,6,4,18,18,0,18
NorthEast Un,5830,6,5,2,7,10,11,-1,17
Chennaiyin,5830,7,4,5,5,16,20,-4,17
FC Pune City,5830,8,4,3,7,13,18,-5,15
Delhi Dynamo,5831,1,6,5,3,26,17,9,23
Mumbai City,5831,2,6,4,4,17,11,6,22
Kerala Blast,5831,3,6,4,4,13,14,-1,22
FC Pune City,5831,4,5,4,5,15,16,-1,19
Kolkata,5831,5,4,6,4,17,16,1,18
Chennaiyin,5831,6,4,6,4,17,20,-3,18
NorthEast Un,5831,7,5,2,7,12,14,-2,17
FC Goa,5831,8,3,3,8,11,20,-9,12
Mumbai City,5832,1,7,4,3,17,8,9,25
Kolkata,5832,2,5,6,3,17,15,2,21
FC Pune City,5832,3,5,4,5,14,15,-1,19
Kerala Blast,5832,4,5,4,5,12,15,-3,19
Delhi Dynamo,5832,5,4,5,5,25,21,4,17
Chennaiyin,5832,6,4,5,5,15,18,-3,17
NorthEast Un,5832,7,5,2,7,11,14,-3,17
FC Goa,5832,8,5,2,7,15,20,-5,17
Mumbai City,5833,1,6,5,3,18,10,8,23
Kolkata,5833,2,5,7,2,19,15,4,22
Chennaiyin,5833,3,5,5,4,19,18,1,20
Delhi Dynamo,5833,4,4,7,3,26,20,6,19
Kerala Blast,5833,5,5,4,5,13,17,-4,19
NorthEast Un,5833,6,5,3,6,12,12,0,18
FC Pune City,5833,7,4,4,6,13,17,-4,16
FC Goa,5833,8,3,3,8,12,23,-11,12
Delhi Dynamo,5834,1,6,6,2,27,17,10,24
Mumbai City,5834,2,6,4,4,16,10,6,22
Kerala Blast,5834,3,6,4,4,13,15,-2,22
Chennaiyin,5834,4,5,5,4,15,17,-2,20
Kolkata,5834,5,4,7,3,15,14,1,19
FC Pune City,5834,6,4,4,6,13,16,-3,16
NorthEast Un,5834,7,4,2,8,11,14,-3,14
FC Goa,5834,8,3,4,7,11,18,-7,13
Delhi Dynamo,5835,1,5,7,2,29,17,12,22
Mumbai City,5835,2,6,4,4,16,13,3,22
Kolkata,5835,3,4,8,2,22,17,5,20
Kerala Blast,5835,4,5,4,5,15,18,-3,19
NorthEast Un,5835,5,5,3,6,14,14,0,18
FC Pune City,5835,6,5,3,6,14,19,-5,18
Chennaiyin,5835,7,3,6,5,15,21,-6,15
FC Goa,5835,8,3,5,6,12,18,-6,14
Mumbai City,5836,1,7,4,3,19,8,11,25
Delhi Dynamo,5836,2,5,6,3,26,20,6,21
Kolkata,5836,3,5,6,3,18,13,5,21
Kerala Blast,5836,4,5,4,5,12,15,-3,19
Chennaiyin,5836,5,4,6,4,16,19,-3,18
NorthEast Un,5836,6,4,4,6,12,14,-2,16
FC Goa,5836,7,4,3,7,12,18,-6,15
FC Pune City,5836,8,4,3,7,12,20,-8,15
Mumbai City,5837,1,7,4,3,18,9,9,25
Delhi Dynamo,5837,2,6,5,3,30,17,13,23
Kerala Blast,5837,3,6,4,4,12,13,-1,22
FC Pune City,5837,4,5,3,6,16,15,1,18
Kolkata,5837,5,4,6,4,15,18,-3,18
Chennaiyin,5837,6,4,6,4,14,17,-3,18
NorthEast Un,5837,7,4,3,7,10,13,-3,15
FC Goa,5837,8,3,3,8,8,21,-13,12
Mumbai City,5838,1,7,4,3,17,8,9,25
Kerala Blast,5838,2,5,5,4,13,13,0,20
Chennaiyin,5838,3,5,5,4,16,18,-2,20
Delhi Dynamo,5838,4,4,7,3,24,18,6,19
Kolkata,5838,5,4,6,4,17,19,-2,18
NorthEast Un,5838,6,4,4,6,11,12,-1,16
FC Pune City,5838,7,4,4,6,13,17,-4,16
FC Goa,5838,8,4,3,7,12,18,-6,15
Mumbai City,5839,1,6,5,3,17,9,8,23
Delhi Dynamo,5839,2,5,7,2,25,16,9,22
NorthEast Un,5839,3,5,4,5,11,10,1,19
Kerala Blast,5839,4,5,4,5,11,15,-4,19
FC Pune City,5839,5,4,5,5,14,16,-2,17
Kolkata,5839,6,3,7,4,14,16,-2,16
Chennaiyin,5839,7,3,7,4,14,18,-4,16
FC Goa,5839,8,4,3,7,11,17,-6,15
Mumbai City,5840,1,7,4,3,19,9,10,25
Kerala Blast,5840,2,6,4,4,17,14,3,22
Delhi Dynamo,5840,3,5,6,3,26,19,7,21
Chennaiyin,5840,4,4,6,4,16,19,-3,18
Kolkata,5840,5,4,6,4,15,22,-7,18
FC Pune City,5840,6,4,4,6,14,17,-3,16
NorthEast Un,5840,7,4,3,7,12,15,-3,15
FC Goa,5840,8,4,3,7,13,17,-4,15
Mumbai City,5841,1,7,4,3,17,8,9,25
Delhi Dynamo,5841,2,5,6,3,24,15,9,21
Kolkata,5841,3,5,6,3,17,15,2,21
NorthEast Un,5841,4,5,4,5,11,10,1,19
FC Pune City,5841,5,5,4,5,15,16,-1,19
Chennaiyin,5841,6,4,5,5,16,20,-4,17
Kerala Blast,5841,7,4,5,5,12,17,-5,17
FC Goa,5841,8,3,2,9,10,21,-11,11
Mumbai City,5842,1,6,4,4,17,10,7,22
Delhi Dynamo,5842,2,5,6,3,23,17,6,21
NorthEast Un,5842,3,5,4,5,12,10,2,19
Kolkata,5842,4,4,7,3,15,14,1,19
Chennaiyin,5842,5,4,6,4,17,19,-2,18
Kerala Blast,5842,6,4,6,4,12,16,-4,18
FC Pune City,5842,7,4,4,6,14,17,-3,16
FC Goa,5842,8,4,3,7,10,17,-7,15
Delhi Dynamo,5843,1,6,6,2,25,16,9,24
Mumbai City,5843,2,6,5,3,17,9,8,23
Kolkata,5843,3,4,8,2,15,13,2,20
Chennaiyin,5843,4,4,6,4,15,18,-3,18
Kerala Blast,5843,5,4,6,4,10,14,-4,18
FC Pune City,5843,6,4,5,5,12,14,-2,17
NorthEast Un,5843,7,4,4,6,10,11,-1,16
FC Goa,5843,8,3,2,9,9,18,-9,11
Mumbai City,5844,1,6,5,3,16,8,8,23
Delhi Dynamo,5844,2,5,7,2,26,17,9,22
Kolkata,5844,3,5,7,2,19,14,5,22
Chennaiyin,5844,4,5,5,4,16,18,-2,20
FC Pune City,5844,5,5,4,5,13,14,-1,19
Kerala Blast,5844,6,5,3,6,11,17,-6,18
NorthEast Un,5844,7,4,2,8,10,14,-4,14
FC Goa,5844,8,3,3,8,12,21,-9,12
Delhi Dynamo,5845,1,7,5,2,28,15,13,26
Mumbai City,5845,2,6,4,4,17,11,6,22
Chennaiyin,5845,3,5,5,4,17,19,-2,20
Kolkata,5845,4,4,7,3,18,16,2,19
Kerala Blast,5845,5,5,3,6,11,17,-6,18
NorthEast Un,5845,6,5,2,7,10,11,-1,17
FC Pune City,5845,7,4,4,6,14,18,-4,16
FC Goa,5845,8,4,2,8,12,20,-8,14
Mumbai City,5846,1,6,5,3,16,8,8,23
Kolkata,5846,2,5,7,2,18,12,6,22
Delhi Dynamo,5846,3,4,7,3,25,19,6,19
Kerala Blast,5846,4,5,4,5,12,14,-2,19
FC Pune City,5846,5,5,3,6,13,17,-4,18
Chennaiyin,5846,6,4,5,5,18,21,-3,17
NorthEast Un,5846,7,5,2,7,13,17,-4,17
FC Goa,5846,8,4,3,7,13,20,-7,15
Delhi Dynamo,5847,1,7,5,2,30,16,14,26
Kolkata,5847,2,5,7,2,20,13,7,22
Mumbai City,5847,3,6,4,4,17,11,6,22
Kerala Blast,5847,4,6,3,5,12,16,-4,21
FC Pune City,5847,5,4,4,6,13,17,-4,16
NorthEast Un,5847,6,4,3,7,12,16,-4,15
Chennaiyin,5847,7,3,6,5,15,20,-5,15
FC Goa,5847,8,4,2,8,9,19,-10,14
Mumbai City,5848,1,7,4,3,20,9,11,25
Delhi Dynamo,5848,2,6,5,3,28,18,10,23
Kerala Blast,5848,3,6,4,4,16,16,0,22
Kolkata,5848,4,3,9,2,15,14,1,18
NorthEast Un,5848,5,5,2,7,14,15,-1,17
Chennaiyin,5848,6,4,5,5,16,20,-4,17
FC Pune City,5848,7,4,4,6,12,17,-5,16
FC Goa,5848,8,3,3,8,9,21,-12,12
Mumbai City,5849,1,6,5,3,17,9,8,23
FC Pune City,5849,2,6,3,5,16,14,2,21
Delhi Dynamo,5849,3,4,8,2,25,18,7,20
Chennaiyin,5849,4,5,5,4,16,17,-1,20
NorthEast Un,5849,5,5,3,6,11,11,0,18
Kerala Blast,5849,6,5,3,6,11,15,-4,18
Kolkata,5849,7,3,6,5,13,18,-5,15
FC Goa,5849,8,4,3,7,11,18,-7,15
Mumbai City,5850,1,6,5,3,17,9,8,23
Kerala Blast,5850,2,6,4,4,17,15,2,22
Delhi Dynamo,5850,3,5,6,3,27,18,9,21
NorthEast Un,5850,4,6,3,5,15,11,4,21
FC Goa,5850,5,5,2,7,11,18,-7,17
Kolkata,5850,6,3,7,4,15,18,-3,16
FC Pune City,5850,7,4,4,6,13,18,-5,16
Chennaiyin,5850,8,3,5,6,13,21,-8,14
Delhi Dynamo,5851,1,6,5,3,27,17,10,23
Mumbai City,5851,2,6,4,4,16,10,6,22
Kerala Blast,5851,3,6,3,5,14,16,-2,21
Kolkata,5851,4,4,7,3,16,15,1,19
NorthEast Un,5851,5,5,2,7,11,12,-1,17
Chennaiyin,5851,6,4,5,5,14,18,-4,17
FC Goa,5851,7,5,2,7,13,19,-6,17
FC Pune City,5851,8,4,4,6,13,17,-4,16
Mumbai City,5852,1,7,4,3,19,9,10,25
Delhi Dynamo,5852,2,4,7,3,24,19,5,19
Kolkata,5852,3,4,7,3,18,15,3,19
Kerala Blast,5852,4,5,4,5,11,17,-6,19
Chennaiyin,5852,5,4,6,4,15,18,-3,18
NorthEast Un,5852,6,4,5,5,10,10,0,17
FC Pune City,5852,7,4,4,6,14,17,-3,16
FC Goa,5852,8,4,3,7,12,18,-6,15
Mumbai City,5853,1,6,5,3,17,9,8,23
Kolkata,5853,2,5,7,2,17,12,5,22
Delhi Dynamo,5853,3,5,6,3,26,18,8,21
NorthEast Un,5853,4,6,2,6,13,12,1,20
Chennaiyin,5853,5,5,5,4,17,18,-1,20
FC Pune City,5853,6,5,3,6,13,16,-3,18
Kerala Blast,5853,7,4,3,7,9,18,-9,15
FC Goa,5853,8,3,3,8,10,19,-9,12
Delhi Dynamo,5854,1,6,6,2,30,15,15,24
Kolkata,5854,2,5,7,2,17,13,4,22
Mumbai City,5854,3,6,4,4,16,14,2,22
Kerala Blast,5854,4,5,4,5,12,16,-4,19
NorthEast Un,5854,5,5,2,7,12,13,-1,17
FC Pune City,5854,6,4,4,6,14,18,-4,16
FC Goa,5854,7,4,4,6,12,16,-4,16
Chennaiyin,5854,8,3,5,6,14,22,-8,14
Mumbai City,5855,1,7,4,3,20,9,11,25
NorthEast Un,5855,2,6,3,5,13,10,3,21
FC Goa,5855,3,6,2,6,14,16,-2,20
Kerala Blast,5855,3,5,5,4,14,16,-2,20
Kolkata,5855,5,4,7,3,17,15,2,19
Delhi Dynamo,5855,6,4,5,5,23,22,1,17
FC Pune City,5855,7,4,3,7,13,19,-6,15
Chennaiyin,5855,8,3,5,6,13,20,-7,14
Kolkata,5856,1,6,6,2,24,12,12,24
Mumbai City,5856,2,6,5,3,17,9,8,23
Delhi Dynamo,5856,3,5,6,3,23,16,7,21
NorthEast Un,5856,4,6,2,6,15,15,0,20
FC Pune City,5856,5,5,3,6,15,17,-2,18
Kerala Blast,5856,6,5,3,6,15,26,-11,18
Chennaiyin,5856,7,3,5,6,15,21,-6,14
FC Goa,5856,8,4,2,8,10,18,-8,14
Mumbai City,5857,1,7,4,3,20,10,10,25
NorthEast Un,5857,2,7,2,5,19,11,8,23
Kolkata,5857,3,5,6,3,16,15,1,21
Delhi Dynamo,5857,4,4,6,4,26,23,3,18
FC Pune City,5857,5,5,3,6,15,17,-2,18
FC Goa,5857,6,4,4,6,12,16,-4,16
Chennaiyin,5857,7,3,6,5,14,21,-7,15
Kerala Blast,5857,8,4,3,7,10,19,-9,15
Delhi Dynamo,5858,1,7,5,2,28,15,13,26
Mumbai City,5858,2,6,4,4,16,11,5,22
Kolkata,5858,3,5,6,3,18,15,3,21
Kerala Blast,5858,4,6,3,5,13,15,-2,21
NorthEast Un,5858,5,6,2,6,12,10,2,20
Chennaiyin,5858,6,3,6,5,14,19,-5,15
FC Pune City,5858,7,4,3,7,13,19,-6,15
FC Goa,5858,8,3,3,8,10,20,-10,12
Mumbai City,5859,1,6,5,3,17,9,8,23
Delhi Dynamo,5859,2,5,7,2,23,15,8,22
Kerala Blast,5859,3,6,4,4,14,16,-2,22
Chennaiyin,5859,4,5,5,4,16,18,-2,20
Kolkata,5859,5,4,7,3,18,17,1,19
FC Pune City,5859,6,4,4,6,17,20,-3,16
NorthEast Un,5859,7,4,3,7,10,12,-2,15
FC Goa,5859,8,3,3,8,10,18,-8,12
Mumbai City,5860,1,6,5,3,16,8,8,23
Delhi Dynamo,5860,2,5,6,3,22,16,6,21
FC Pune City,5860,3,5,4,5,15,15,0,19
Kerala Blast,5860,4,5,4,5,11,15,-4,19
NorthEast Un,5860,5,5,3,6,11,10,1,18
Kolkata,5860,6,4,6,4,15,16,-1,18
FC Goa,5860,7,5,2,7,13,17,-4,17
Chennaiyin,5860,8,3,6,5,14,20,-6,15
Mumbai City,5861,1,7,4,3,17,8,9,25
Kolkata,5861,2,5,7,2,16,13,3,22
Delhi Dynamo,5861,3,5,6,3,24,17,7,21
Kerala Blast,5861,4,5,5,4,12,15,-3,20
NorthEast Un,5861,5,5,2,7,13,13,0,17
FC Pune City,5861,6,4,4,6,13,16,-3,16
FC Goa,5861,7,4,3,7,11,17,-6,15
Chennaiyin,5861,8,3,5,6,13,20,-7,14
Delhi Dynamo,5862,1,6,6,2,28,16,12,24
Mumbai City,5862,2,6,4,4,16,9,7,22
Kolkata,5862,3,5,7,2,21,16,5,22
FC Pune City,5862,4,5,4,5,14,15,-1,19
Kerala Blast,5862,5,5,3,6,13,20,-7,18
Chennaiyin,5862,6,3,7,4,17,21,-4,16
NorthEast Un,5862,7,4,3,7,13,18,-5,15
FC Goa,5862,8,3,4,7,14,21,-7,13
Mumbai City,5863,1,6,5,3,17,9,8,23
Kerala Blast,5863,2,6,4,4,14,16,-2,22
Delhi Dynamo,5863,3,4,8,2,22,15,7,20
Kolkata,5863,4,3,8,3,16,16,0,17
Chennaiyin,5863,5,4,5,5,15,19,-4,17
NorthEast Un,5863,6,4,4,6,10,12,-2,16
FC Pune City,5863,7,4,4,6,14,17,-3,16
FC Goa,5863,8,4,4,6,11,15,-4,16
Mumbai City,5864,1,6,5,3,16,8,8,23
FC Pune City,5864,2,6,3,5,16,16,0,21
Kerala Blast,5864,3,6,3,5,15,16,-1,21
Delhi Dynamo,5864,4,4,8,2,24,17,7,20
Chennaiyin,5864,5,4,5,5,15,22,-7,17
FC Goa,5864,6,4,4,6,14,16,-2,16
Kolkata,5864,6,3,7,4,14,16,-2,16
NorthEast Un,5864,8,4,3,7,12,15,-3,15
Mumbai City,5865,1,6,5,3,17,9,8,23
NorthEast Un,5865,2,7,2,5,14,10,4,23
Delhi Dynamo,5865,3,5,6,3,26,18,8,21
Kolkata,5865,4,5,6,3,19,18,1,21
Kerala Blast,5865,5,5,3,6,10,16,-6,18
FC Pune City,5865,6,4,3,7,14,18,-4,15
Chennaiyin,5865,7,3,6,5,15,20,-5,15
FC Goa,5865,8,4,3,7,14,20,-6,15
Mumbai City,5866,1,7,4,3,18,9,9,25
Delhi Dynamo,5866,2,5,6,3,23,16,7,21
Kerala Blast,5866,3,5,5,4,13,14,-1,20
FC Pune City,5866,4,5,4,5,16,17,-1,19
FC Goa,5866,5,5,3,6,14,16,-2,18
Chennaiyin,5866,6,4,5,5,15,21,-6,17
NorthEast Un,5866,7,4,3,7,9,11,-2,15
Kolkata,5866,8,3,6,5,16,20,-4,15
Mumbai City,5867,1,7,4,3,21,10,11,25
Kolkata,5867,2,5,6,3,19,15,4,21
Kerala Blast,5867,3,6,3,5,15,16,-1,21
NorthEast Un,5867,4,5,3,6,13,12,1,18
Chennaiyin,5867,5,4,6,4,15,17,-2,18
FC Pune City,5867,6,5,3,6,13,18,-5,18
Delhi Dynamo,5867,7,4,5,5,23,25,-2,17
FC Goa,5867,8,4,2,8,11,17,-6,14
Mumbai City,5868,1,6,4,4,16,11,5,22
Kerala Blast,5868,2,6,3,5,13,15,-2,21
Delhi Dynamo,5868,3,5,5,4,25,21,4,20
Kolkata,5868,4,4,7,3,16,14,2,19
NorthEast Un,5868,5,5,3,6,15,14,1,18
Chennaiyin,5868,6,4,6,4,17,20,-3,18
FC Goa,5868,7,5,2,7,13,16,-3,17
FC Pune City,5868,8,4,4,6,13,17,-4,16
Delhi Dynamo,5869,1,6,6,2,28,18,10,24
Mumbai City,5869,2,6,4,4,17,10,7,22
Kerala Blast,5869,3,6,4,4,16,18,-2,22
Kolkata,5869,4,5,6,3,21,16,5,21
FC Pune City,5869,5,4,4,6,15,20,-5,16
NorthEast Un,5869,6,4,3,7,13,16,-3,15
FC Goa,5869,7,4,3,7,14,19,-5,15
Chennaiyin,5869,8,3,6,5,14,21,-7,15
Delhi Dynamo,5870,1,6,6,2,26,16,10,24
Mumbai City,5870,2,6,4,4,17,10,7,22
Kerala Blast,5870,3,5,5,4,14,16,-2,20
Kolkata,5870,4,4,7,3,14,13,1,19
Chennaiyin,5870,5,4,5,5,18,20,-2,17
FC Goa,5870,6,5,2,7,12,17,-5,17
FC Pune City,5870,7,4,4,6,15,18,-3,16
NorthEast Un,5870,8,4,3,7,10,16,-6,15
Mumbai City,5871,1,7,4,3,20,9,11,25
Kerala Blast,5871,2,6,4,4,15,17,-2,22
Delhi Dynamo,5871,3,5,5,4,25,20,5,20
Kolkata,5871,4,4,8,2,16,14,2,20
NorthEast Un,5871,5,5,2,7,13,14,-1,17
Chennaiyin,5871,6,4,5,5,16,21,-5,17
FC Pune City,5871,7,4,3,7,14,18,-4,15
FC Goa,5871,8,4,3,7,12,18,-6,15
Mumbai City,5872,1,7,4,3,19,10,9,25
Delhi Dynamo,5872,2,5,5,4,26,20,6,20
Kolkata,5872,3,4,8,2,16,14,2,20
NorthEast Un,5872,4,6,2,6,13,12,1,20
FC Goa,5872,5,5,3,6,12,15,-3,18
FC Pune City,5872,6,4,5,5,13,15,-2,17
Kerala Blast,5872,7,4,4,6,10,16,-6,16
Chennaiyin,5872,8,3,5,6,14,21,-7,14
Mumbai City,5873,1,7,4,3,18,8,10,25
Kolkata,5873,2,6,6,2,23,14,9,24
NorthEast Un,5873,3,7,2,5,16,12,4,23
Delhi Dynamo,5873,4,4,6,4,24,21,3,18
Chennaiyin,5873,5,4,5,5,16,19,-3,17
FC Pune City,5873,6,4,4,6,13,19,-6,16
Kerala Blast,5873,7,4,4,6,12,20,-8,16
FC Goa,5873,8,3,3,8,11,20,-9,12
Mumbai City,5874,1,7,4,3,19,9,10,25
Delhi Dynamo,5874,2,5,5,4,26,19,7,20
Chennaiyin,5874,3,5,5,4,17,18,-1,20
FC Pune City,5874,4,5,4,5,15,15,0,19
NorthEast Un,5874,5,5,3,6,13,13,0,18
Kerala Blast,5874,6,4,6,4,11,15,-4,18
Kolkata,5874,7,3,8,3,14,15,-1,17
FC Goa,5874,8,3,3,8,9,20,-11,12
Mumbai City,5875,1,7,4,3,18,8,10,25
Kerala Blast,5875,2,6,4,4,15,16,-1,22
Delhi Dynamo,5875,3,5,5,4,24,18,6,20
Kolkata,5875,4,4,7,3,19,18,1,19
FC Goa,5875,5,5,3,6,13,16,-3,18
Chennaiyin,5875,6,4,5,5,15,19,-4,17
NorthEast Un,5875,7,4,3,7,12,16,-4,15
FC Pune City,5875,8,4,3,7,14,19,-5,15
Delhi Dynamo,5876,1,7,5,2,32,18,14,26
Mumbai City,5876,2,6,4,4,17,12,5,22
Chennaiyin,5876,3,5,5,4,17,19,-2,20
Kerala Blast,5876,4,5,5,4,12,15,-3,20
FC Pune City,5876,5,5,4,5,15,16,-1,19
NorthEast Un,5876,6,4,3,7,12,14,-2,15
Kolkata,5876,7,3,6,5,15,18,-3,15
FC Goa,5876,8,4,2,8,12,20,-8,14
Mumbai City,5877,1,6,5,3,17,9,8,23
Delhi Dynamo,5877,2,5,7,2,25,17,8,22
Kolkata,5877,3,5,6,3,17,15,2,21
Kerala Blast,5877,4,5,4,5,13,16,-3,19
NorthEast Un,5877,5,4,5,5,11,11,0,17
FC Goa,5877,6,5,2,7,15,18,-3,17
FC Pune City,5877,7,4,3,7,13,18,-5,15
Chennaiyin,5877,8,3,6,5,15,22,-7,15
Mumbai City,5878,1,6,5,3,17,9,8,23
Delhi Dynamo,5878,2,5,7,2,25,17,8,22
Kolkata,5878,3,5,6,3,18,15,3,21
Kerala Blast,5878,4,6,3,5,12,14,-2,21
FC Pune City,5878,5,5,3,6,13,16,-3,18
Chennaiyin,5878,6,4,5,5,16,20,-4,17
FC Goa,5878,7,4,3,7,12,19,-7,15
NorthEast Un,5878,8,4,2,8,12,15,-3,14
Mumbai City,5879,1,6,5,3,17,9,8,23
NorthEast Un,5879,2,6,3,5,11,9,2,21
FC Pune City,5879,3,6,3,5,15,15,0,21
Delhi Dynamo,5879,4,4,7,3,23,17,6,19
Kerala Blast,5879,5,5,3,6,11,16,-5,18
Kolkata,5879,6,3,7,4,14,15,-1,16
FC Goa,5879,7,4,4,6,12,16,-4,16
Chennaiyin,5879,8,3,6,5,13,19,-6,15
Mumbai City,5880,1,6,5,3,16,8,8,23
Kerala Blast,5880,2,6,4,4,14,15,-1,22
Delhi Dynamo,5880,3,4,7,3,23,17,6,19
FC Pune City,5880,4,5,4,5,16,14,2,19
NorthEast Un,5880,5,5,3,6,11,12,-1,18
Kolkata,5880,6,4,6,4,16,19,-3,18
Chennaiyin,5880,7,3,7,4,15,19,-4,16
FC Goa,5880,8,3,4,7,11,18,-7,13
Delhi Dynamo,5881,1,6,6,2,26,14,12,24
Mumbai City,5881,2,6,5,3,16,8,8,23
Kerala Blast,5881,3,6,4,4,11,13,-2,22
FC Pune City,5881,4,5,4,5,13,14,-1,19
Kolkata,5881,5,4,6,4,16,15,1,18
NorthEast Un,5881,6,5,2,7,11,11,0,17
Chennaiyin,5881,7,3,5,6,13,20,-7,14
FC Goa,5881,8,4,2,8,10,21,-11,14
Mumbai City,5882,1,6,5,3,16,8,8,23
Delhi Dynamo,5882,2,5,7,2,23,15,8,22
Kerala Blast,5882,3,6,3,5,14,16,-2,21
Kolkata,5882,4,4,6,4,17,18,-1,18
Chennaiyin,5882,5,4,6,4,16,19,-3,18
FC Pune City,5882,6,5,3,6,14,17,-3,18
NorthEast Un,5882,7,4,3,7,10,13,-3,15
FC Goa,5882,8,4,3,7,13,17,-4,15
Delhi Dynamo,5883,1,6,6,2,26,17,9,24
Mumbai City,5883,2,6,4,4,16,9,7,22
Kolkata,5883,3,4,7,3,18,16,2,19
Kerala Blast,5883,4,5,4,5,12,17,-5,19
FC Pune City,5883,5,4,5,5,13,15,-2,17
FC Goa,5883,6,5,2,7,13,18,-5,17
NorthEast Un,5883,7,4,4,6,12,13,-1,16
Chennaiyin,5883,8,3,6,5,14,19,-5,15
Mumbai City,5884,1,7,4,3,17,8,9,25
Kerala Blast,5884,2,6,4,4,16,18,-2,22
NorthEast Un,5884,3,5,4,5,13,11,2,19
Delhi Dynamo,5884,4,4,6,4,21,17,4,18
Kolkata,5884,5,4,6,4,16,16,0,18
FC Pune City,5884,6,5,3,6,14,16,-2,18
Chennaiyin,5884,7,3,6,5,14,19,-5,15
FC Goa,5884,8,4,3,7,10,16,-6,15
Mumbai City,5885,1,6,5,3,17,9,8,23
Kerala Blast,5885,2,6,4,4,14,15,-1,22
Delhi Dynamo,5885,3,4,7,3,23,18,5,19
Kolkata,5885,4,3,9,2,14,13,1,18
FC Goa,5885,5,5,3,6,12,14,-2,18
NorthEast Un,5885,6,4,4,6,12,13,-1,16
FC Pune City,5885,7,4,4,6,14,18,-4,16
Chennaiyin,5885,8,3,6,5,14,20,-6,15
Mumbai City,5886,1,6,5,3,17,9,8,23
FC Pune City,5886,2,6,3,5,15,15,0,21
Delhi Dynamo,5886,3,4,8,2,23,16,7,20
Kolkata,5886,4,4,7,3,19,16,3,19
NorthEast Un,5886,5,5,4,5,14,11,3,19
Chennaiyin,5886,6,4,6,4,16,18,-2,18
Kerala Blast,5886,7,4,3,7,9,20,-11,15
FC Goa,5886,8,3,4,7,10,18,-8,13
Mumbai City,5887,1,7,4,3,19,9,10,25
Kerala Blast,5887,2,6,4,4,16,14,2,22
Chennaiyin,5887,3,5,5,4,17,17,0,20
Delhi Dynamo,5887,4,4,6,4,23,20,3,18
NorthEast Un,5887,5,5,3,6,11,12,-1,18
Kolkata,5887,6,4,6,4,18,20,-2,18
FC Goa,5887,7,4,3,7,12,18,-6,15
FC Pune City,5887,7,4,3,7,12,18,-6,15
Mumbai City,5888,1,7,4,3,17,8,9,25
Kolkata,5888,2,5,7,2,19,14,5,22
Delhi Dynamo,5888,3,5,6,3,23,15,8,21
Chennaiyin,5888,4,5,5,4,16,18,-2,20
Kerala Blast,5888,5,5,4,5,10,14,-4,19
NorthEast Un,5888,6,5,3,6,10,10,0,18
FC Pune City,5888,7,4,3,7,13,18,-5,15
FC Goa,5888,8,3,2,9,10,21,-11,11
Mumbai City,5889,1,7,4,3,19,10,9,25
Kolkata,5889,2,5,7,2,21,14,7,22
NorthEast Un,5889,3,6,3,5,11,9,2,21
Delhi Dynamo,5889,4,4,6,4,25,20,5,18
Kerala Blast,5889,5,5,3,6,11,17,-6,18
FC Goa,5889,6,4,4,6,12,17,-5,16
Chennaiyin,5889,7,3,6,5,13,18,-5,15
FC Pune City,5889,8,4,3,7,14,21,-7,15
Mumbai City,5890,1,7,4,3,18,8,10,25
Delhi Dynamo,5890,2,6,5,3,26,19,7,23
Kolkata,5890,3,4,8,2,15,13,2,20
Kerala Blast,5890,4,5,5,4,13,15,-2,20
FC Pune City,5890,5,4,4,6,13,16,-3,16
NorthEast Un,5890,6,4,3,7,13,16,-3,15
FC Goa,5890,7,4,3,7,13,17,-4,15
Chennaiyin,5890,8,3,6,5,14,21,-7,15
Mumbai City,5891,1,7,4,3,17,8,9,25
Delhi Dynamo,5891,2,5,6,3,24,17,7,21
Kolkata,5891,3,5,6,3,18,13,5,21
FC Pune City,5891,4,5,4,5,14,15,-1,19
NorthEast Un,5891,5,5,3,6,12,12,0,18
Chennaiyin,5891,6,4,5,5,16,20,-4,17
Kerala Blast,5891,7,4,4,6,10,18,-8,16
FC Goa,5891,8,4,2,8,11,19,-8,14
Mumbai City,5892,1,7,4,3,18,9,9,25
NorthEast Un,5892,2,6,2,6,17,14,3,20
Kolkata,5892,3,4,7,3,16,13,3,19
FC Pune City,5892,4,5,4,5,13,14,-1,19
Kerala Blast,5892,5,5,4,5,11,16,-5,19
FC Goa,5892,6,5,3,6,13,16,-3,18
Delhi Dynamo,5892,7,4,5,5,24,24,0,17
Chennaiyin,5892,8,3,5,6,16,22,-6,14
Mumbai City,5893,1,6,4,4,16,9,7,22
Delhi Dynamo,5893,2,5,5,4,25,19,6,20
Kerala Blast,5893,3,5,4,5,11,16,-5,19
Kolkata,5893,4,4,6,4,18,17,1,18
NorthEast Un,5893,5,5,3,6,11,11,0,18
FC Pune City,5893,6,5,3,6,15,17,-2,18
Chennaiyin,5893,7,4,6,4,15,18,-3,18
FC Goa,5893,8,5,3,6,14,18,-4,18
Delhi Dynamo,5894,1,7,5,2,26,16,10,26
Mumbai City,5894,2,6,4,4,17,10,7,22
Kolkata,5894,3,5,7,2,18,13,5,22
FC Pune City,5894,4,5,3,6,15,17,-2,18
Kerala Blast,5894,5,5,3,6,12,19,-7,18
NorthEast Un,5894,6,5,2,7,11,12,-1,17
Chennaiyin,5894,7,4,5,5,16,18,-2,17
FC Goa,5894,8,3,3,8,10,20,-10,12
Mumbai City,5895,1,7,4,3,18,8,10,25
NorthEast Un,5895,2,7,2,5,13,9,4,23
FC Pune City,5895,3,6,3,5,17,17,0,21
Kolkata,5895,4,4,7,3,16,15,1,19
Delhi Dynamo,5895,5,4,6,4,23,19,4,18
Chennaiyin,5895,6,3,6,5,15,20,-5,15
Kerala Blast,5895,7,4,3,7,11,19,-8,15
FC Goa,5895,8,3,5,6,13,19,-6,14
Mumbai City,5896,1,7,4,3,18,8,10,25
Kerala Blast,5896,2,6,4,4,14,15,-1,22
Delhi Dynamo,5896,3,5,5,4,22,17,5,20
FC Pune City,5896,4,5,3,6,15,16,-1,18
FC Goa,5896,5,5,3,6,10,14,-4,18
Kolkata,5896,6,3,7,4,14,17,-3,16
Chennaiyin,5896,7,3,7,4,13,17,-4,16
NorthEast Un,5896,8,4,3,7,10,12,-2,15
Mumbai City,5897,1,6,4,4,16,9,7,22
Kerala Blast,5897,2,6,4,4,16,18,-2,22
Delhi Dynamo,5897,3,5,6,3,23,17,6,21
FC Goa,5897,4,6,2,6,16,16,0,20
Kolkata,5897,5,3,8,3,19,19,0,17
NorthEast Un,5897,6,4,4,6,16,17,-1,16
FC Pune City,5897,7,4,4,6,15,18,-3,16
Chennaiyin,5897,8,3,6,5,15,22,-7,15
Mumbai City,5898,1,7,4,3,19,10,9,25
Delhi Dynamo,5898,2,6,5,3,27,17,10,23
Chennaiyin,5898,3,5,5,4,19,18,1,20
Kolkata,5898,4,4,6,4,14,14,0,18
FC Pune City,5898,5,5,3,6,14,16,-2,18
Kerala Blast,5898,6,5,3,6,12,18,-6,18
NorthEast Un,5898,7,5,2,7,12,14,-2,17
FC Goa,5898,8,4,2,8,10,20,-10,14
Mumbai City,5899,1,7,4,3,18,9,9,25
NorthEast Un,5899,2,6,3,5,16,11,5,21
FC Goa,5899,3,6,2,6,16,15,1,20
Kolkata,5899,4,4,7,3,17,17,0,19
Kerala Blast,5899,5,5,4,5,13,17,-4,19
Delhi Dynamo,5899,6,4,5,5,23,21,2,17
FC Pune City,5899,7,4,4,6,13,16,-3,16
Chennaiyin,5899,8,3,5,6,14,24,-10,14
Delhi Dynamo,5900,1,6,6,2,27,15,12,24
Mumbai City,5900,2,6,4,4,17,11,6,22
Chennaiyin,5900,3,5,5,4,18,20,-2,20
Kolkata,5900,4,4,7,3,16,16,0,19
Kerala Blast,5900,5,5,4,5,12,15,-3,19
NorthEast Un,5900,6,5,3,6,12,12,0,18
FC Pune City,5900,7,4,4,6,13,16,-3,16
FC Goa,5900,8,3,3,8,11,21,-10,12
Mumbai City,5901,1,6,5,3,16,8,8,23
Delhi Dynamo,5901,2,5,7,2,23,15,8,22
Kolkata,5901,3,5,6,3,19,16,3,21
FC Pune City,5901,4,6,3,5,15,14,1,21
NorthEast Un,5901,5,4,4,6,11,12,-1,16
Chennaiyin,5901,6,3,7,4,15,19,-4,16
Kerala Blast,5901,7,4,4,6,11,18,-7,16
FC Goa,5901,8,3,4,7,11,19,-8,13
Mumbai City,5902,1,7,4,3,17,8,9,25
Kolkata,5902,2,5,6,3,17,14,3,21
NorthEast Un,5902,3,6,2,6,11,10,1,20
Delhi Dynamo,5902,4,4,6,4,22,17,5,18
FC Goa,5902,5,5,3,6,13,15,-2,18
Chennaiyin,5902,6,4,5,5,14,20,-6,17
FC Pune City,5902,7,4,4,6,14,18,-4,16
Kerala Blast,5902,8,4,4,6,10,16,-6,16
Delhi Dynamo,5903,1,7,5,2,30,15,15,26
Mumbai City,5903,2,6,4,4,17,11,6,22
Kerala Blast,5903,3,5,4,5,12,17,-5,19
FC Pune City,5903,4,4,5,5,16,18,-2,17
FC Goa,5903,5,5,2,7,14,16,-2,17
Chennaiyin,5903,6,4,5,5,17,20,-3,17
NorthEast Un,5903,7,5,2,7,12,17,-5,17
Kolkata,5903,8,3,7,4,16,20,-4,16
Mumbai City,5904,1,7,4,3,21,8,13,25
Delhi Dynamo,5904,2,5,6,3,26,21,5,21
Kolkata,5904,3,5,6,3,17,13,4,21
Kerala Blast,5904,4,6,3,5,16,16,0,21
FC Goa,5904,5,5,2,7,13,18,-5,17
NorthEast Un,5904,6,4,4,6,12,15,-3,16
Chennaiyin,5904,7,3,6,5,15,22,-7,15
FC Pune City,5904,8,4,3,7,13,20,-7,15
NorthEast Un,5905,1,7,2,5,14,9,5,23
Mumbai City,5905,2,6,4,4,16,9,7,22
Delhi Dynamo,5905,3,5,6,3,23,17,6,21
FC Pune City,5905,4,5,4,5,15,16,-1,19
FC Goa,5905,5,5,3,6,13,15,-2,18
Kolkata,5905,6,3,8,3,15,16,-1,17
Kerala Blast,5905,7,4,4,6,11,17,-6,16
Chennaiyin,5905,8,3,5,6,13,21,-8,14
Delhi Dynamo,5906,1,6,6,2,25,16,9,24
Mumbai City,5906,2,6,5,3,18,10,8,23
NorthEast Un,5906,3,6,2,6,12,11,1,20
Kolkata,5906,4,4,7,3,19,16,3,19
FC Pune City,5906,5,5,3,6,14,17,-3,18
Kerala Blast,5906,6,5,3,6,12,18,-6,18
Chennaiyin,5906,7,4,5,5,16,19,-3,17
FC Goa,5906,8,3,3,8,11,20,-9,12
Mumbai City,5907,1,6,5,3,18,10,8,23
Kolkata,5907,2,5,7,2,17,13,4,22
Delhi Dynamo,5907,3,5,6,3,27,20,7,21
Kerala Blast,5907,4,5,4,5,12,15,-3,19
NorthEast Un,5907,5,5,3,6,12,12,0,18
Chennaiyin,5907,6,4,5,5,17,19,-2,17
FC Pune City,5907,7,4,4,6,13,17,-4,16
FC Goa,5907,8,4,2,8,12,22,-10,14
Mumbai City,5908,1,7,4,3,24,9,15,25
Kolkata,5908,2,5,6,3,16,14,2,21
Delhi Dynamo,5908,3,5,5,4,25,26,-1,20
Kerala Blast,5908,4,5,4,5,11,14,-3,19
Chennaiyin,5908,5,4,6,4,17,18,-1,18
FC Goa,5908,6,5,3,6,12,14,-2,18
NorthEast Un,5908,7,4,3,7,12,16,-4,15
FC Pune City,5908,8,4,3,7,12,18,-6,15
Mumbai City,5909,1,6,4,4,17,11,6,22
Delhi Dynamo,5909,2,5,6,3,26,21,5,21
FC Pune City,5909,3,5,4,5,18,18,0,19
Kolkata,5909,4,4,7,3,19,20,-1,19
NorthEast Un,5909,5,5,3,6,15,13,2,18
FC Goa,5909,6,5,3,6,14,16,-2,18
Chennaiyin,5909,7,4,5,5,16,19,-3,17
Kerala Blast,5909,8,4,4,6,11,18,-7,16
Mumbai City,5910,1,7,4,3,17,8,9,25
NorthEast Un,5910,2,7,2,5,16,11,5,23
Kolkata,5910,3,5,7,2,19,14,5,22
Delhi Dynamo,5910,4,4,5,5,21,19,2,17
FC Pune City,5910,5,4,4,6,13,16,-3,16
FC Goa,5910,6,4,4,6,9,14,-5,16
Kerala Blast,5910,7,4,4,6,11,19,-8,16
Chennaiyin,5910,8,3,6,5,14,19,-5,15
Mumbai City,5911,1,6,5,3,17,9,8,23
Delhi Dynamo,5911,2,5,7,2,24,16,8,22
NorthEast Un,5911,3,6,3,5,15,12,3,21
Kolkata,5911,4,4,7,3,20,16,4,19
FC Pune City,5911,5,5,3,6,14,19,-5,18
Kerala Blast,5911,6,5,3,6,10,16,-6,18
Chennaiyin,5911,7,3,6,5,16,21,-5,15
FC Goa,5911,8,3,4,7,11,18,-7,13
Delhi Dynamo,5912,1,6,5,3,29,18,11,23
Mumbai City,5912,2,6,4,4,16,11,5,22
Kerala Blast,5912,3,5,5,4,12,15,-3,20
Kolkata,5912,4,4,7,3,15,14,1,19
NorthEast Un,5912,5,5,4,5,13,12,1,19
FC Goa,5912,6,5,2,7,13,18,-5,17
FC Pune City,5912,7,4,3,7,12,16,-4,15
Chennaiyin,5912,8,3,6,5,14,20,-6,15
Kerala Blast,5913,1,7,3,4,17,17,0,24
Mumbai City,5913,2,6,5,3,17,9,8,23
Delhi Dynamo,5913,3,5,7,2,24,16,8,22
Chennaiyin,5913,4,4,6,4,15,18,-3,18
FC Pune City,5913,5,4,4,6,16,19,-3,16
Kolkata,5913,6,3,7,4,14,17,-3,16
FC Goa,5913,7,4,4,6,11,15,-4,16
NorthEast Un,5913,8,4,2,8,11,14,-3,14
Kolkata,5914,1,6,6,2,18,13,5,24
Mumbai City,5914,2,6,5,3,16,8,8,23
Delhi Dynamo,5914,3,5,6,3,25,18,7,21
FC Pune City,5914,4,5,3,6,15,17,-2,18
Kerala Blast,5914,5,5,3,6,11,16,-5,18
NorthEast Un,5914,6,5,2,7,12,12,0,17
Chennaiyin,5914,7,4,5,5,15,20,-5,17
FC Goa,5914,8,4,2,8,12,20,-8,14
Delhi Dynamo,5915,1,6,6,2,27,17,10,24
Kolkata,5915,2,6,6,2,19,13,6,24
Mumbai City,5915,3,6,5,3,17,9,8,23
Kerala Blast,5915,4,6,3,5,15,18,-3,21
Chennaiyin,5915,5,3,7,4,17,21,-4,16
NorthEast Un,5915,6,4,3,7,15,18,-3,15
FC Pune City,5915,7,4,3,7,13,17,-4,15
FC Goa,5915,8,3,3,8,10,20,-10,12
Delhi Dynamo,5916,1,6,6,2,26,16,10,24
Mumbai City,5916,2,6,4,4,16,10,6,22
Kolkata,5916,3,5,6,3,19,15,4,21
Chennaiyin,5916,4,5,5,4,17,18,-1,20
FC Pune City,5916,5,5,3,6,13,16,-3,18
Kerala Blast,5916,6,5,3,6,11,17,-6,18
NorthEast Un,5916,7,4,3,7,10,13,-3,15
FC Goa,5916,8,4,2,8,12,19,-7,14
Mumbai City,5917,1,6,5,3,17,9,8,23
Delhi Dynamo,5917,2,5,7,2,25,17,8,22
Kolkata,5917,3,4,7,3,16,16,0,19
FC Pune City,5917,4,5,4,5,15,15,0,19
NorthEast Un,5917,5,5,3,6,14,14,0,18
Kerala Blast,5917,6,5,3,6,14,19,-5,18
Chennaiyin,5917,7,3,7,4,15,19,-4,16
FC Goa,5917,8,3,4,7,10,17,-7,13
Mumbai City,5918,1,6,5,3,17,9,8,23
Delhi Dynamo,5918,2,5,7,2,27,16,11,22
Kolkata,5918,3,5,7,2,16,12,4,22
Chennaiyin,5918,4,5,5,4,18,19,-1,20
NorthEast Un,5918,5,5,3,6,11,11,0,18
Kerala Blast,5918,6,4,5,5,10,15,-5,17
FC Pune City,5918,7,4,4,6,13,16,-3,16
FC Goa,5918,8,3,2,9,10,24,-14,11
Mumbai City,5919,1,6,5,3,17,9,8,23
Delhi Dynamo,5919,2,5,7,2,27,17,10,22
FC Goa,5919,3,5,3,6,13,16,-3,18
Kerala Blast,5919,4,4,6,4,13,17,-4,18
Kolkata,5919,5,3,8,3,17,18,-1,17
FC Pune City,5919,6,4,5,5,14,16,-2,17
Chennaiyin,5919,7,4,5,5,15,18,-3,17
NorthEast Un,5919,8,4,3,7,11,16,-5,15
Mumbai City,5920,1,7,4,3,20,10,10,25
Delhi Dynamo,5920,2,6,5,3,29,21,8,23
Kolkata,5920,3,5,6,3,19,15,4,21
Kerala Blast,5920,4,5,4,5,13,15,-2,19
Chennaiyin,5920,5,4,5,5,15,19,-4,17
FC Goa,5920,6,5,2,7,12,18,-6,17
FC Pune City,5920,7,4,4,6,15,20,-5,16
NorthEast Un,5920,8,4,2,8,11,16,-5,14
Mumbai City,5921,1,6,5,3,16,8,8,23
NorthEast Un,5921,2,6,3,5,16,13,3,21
FC Pune City,5921,3,6,3,5,16,16,0,21
Delhi Dynamo,5921,4,4,8,2,25,18,7,20
Kolkata,5921,5,4,6,4,17,16,1,18
FC Goa,5921,6,5,3,6,16,16,0,18
Kerala Blast,5921,7,4,3,7,11,22,-11,15
Chennaiyin,5921,8,3,5,6,15,23,-8,14
Mumbai City,5922,1,7,4,3,19,10,9,25
Kerala Blast,5922,2,7,3,4,15,15,0,24
Delhi Dynamo,5922,3,5,5,4,26,19,7,20
Chennaiyin,5922,4,5,5,4,16,18,-2,20
Kolkata,5922,5,4,6,4,17,16,1,18
NorthEast Un,5922,6,5,2,7,10,12,-2,17
FC Pune City,5922,7,4,3,7,14,19,-5,15
FC Goa,5922,8,4,2,8,11,19,-8,14
Mumbai City,5923,1,6,4,4,17,10,7,22
Delhi Dynamo,5923,2,5,6,3,23,16,7,21
Kolkata,5923,3,4,8,2,18,15,3,20
Kerala Blast,5923,4,5,5,4,12,15,-3,20
NorthEast Un,5923,5,5,3,6,10,10,0,18
FC Pune City,5923,6,4,5,5,13,15,-2,17
Chennaiyin,5923,7,3,6,5,15,20,-5,15
FC Goa,5923,8,4,3,7,11,18,-7,15
Mumbai City,5924,1,6,5,3,17,9,8,23
Chennaiyin,5924,2,5,5,4,19,19,0,20
Kerala Blast,5924,3,5,5,4,13,16,-3,20
FC Pune City,5924,4,5,4,5,15,15,0,19
Delhi Dynamo,5924,5,4,6,4,23,19,4,18
NorthEast Un,5924,6,5,2,7,11,13,-2,17
FC Goa,5924,7,5,2,7,15,19,-4,17
Kolkata,5924,8,3,7,4,14,17,-3,16
Mumbai City,5925,1,7,4,3,19,9,10,25
Delhi Dynamo,5925,2,5,5,4,25,21,4,20
Kolkata,5925,3,4,7,3,17,15,2,19
Kerala Blast,5925,4,5,4,5,14,17,-3,19
FC Pune City,5925,5,4,5,5,15,17,-2,17
NorthEast Un,5925,6,5,2,7,14,17,-3,17
Chennaiyin,5925,7,4,5,5,15,19,-4,17
FC Goa,5925,8,5,2,7,11,15,-4,17
Delhi Dynamo,5926,1,6,5,3,23,16,7,23
Mumbai City,5926,2,6,4,4,16,9,7,22
NorthEast Un,5926,3,6,2,6,13,10,3,20
Chennaiyin,5926,4,5,5,4,16,17,-1,20
Kolkata,5926,5,4,6,4,16,16,0,18
FC Pune City,5926,6,5,3,6,15,17,-2,18
Kerala Blast,5926,7,5,3,6,11,18,-7,18
FC Goa,5926,8,4,2,8,10,17,-7,14
Delhi Dynamo,5927,1,7,5,2,28,17,11,26
Mumbai City,5927,2,6,4,4,18,11,7,22
Kolkata,5927,3,5,7,2,18,13,5,22
Chennaiyin,5927,4,5,5,4,19,17,2,20
Kerala Blast,5927,5,5,3,6,11,19,-8,18
NorthEast Un,5927,6,5,2,7,11,12,-1,17
FC Pune City,5927,7,4,3,7,13,17,-4,15
FC Goa,5927,8,3,3,8,10,22,-12,12
Mumbai City,5928,1,7,4,3,18,8,10,25
Kerala Blast,5928,2,7,3,4,15,13,2,24
Delhi Dynamo,5928,3,5,6,3,24,16,8,21
Kolkata,5928,4,4,6,4,14,15,-1,18
FC Pune City,5928,5,5,3,6,13,17,-4,18
NorthEast Un,5928,6,4,3,7,9,13,-4,15
FC Goa,5928,7,4,3,7,11,16,-5,15
Chennaiyin,5928,8,3,6,5,14,20,-6,15
Delhi Dynamo,5929,1,6,5,3,26,16,10,23
Mumbai City,5929,2,6,4,4,16,9,7,22
Kolkata,5929,3,5,6,3,17,15,2,21
Chennaiyin,5929,4,5,5,4,19,17,2,20
FC Pune City,5929,5,5,3,6,15,18,-3,18
FC Goa,5929,6,5,2,7,11,16,-5,17
NorthEast Un,5929,7,5,2,7,12,18,-6,17
Kerala Blast,5929,8,4,3,7,11,18,-7,15
Mumbai City,5930,1,7,4,3,18,8,10,25
Delhi Dynamo,5930,2,6,5,3,26,17,9,23
Kolkata,5930,3,4,8,2,16,13,3,20
Chennaiyin,5930,4,5,5,4,19,20,-1,20
Kerala Blast,5930,5,5,5,4,12,15,-3,20
NorthEast Un,5930,6,4,3,7,11,14,-3,15
FC Pune City,5930,7,4,3,7,12,17,-5,15
FC Goa,5930,8,3,3,8,11,21,-10,12
Mumbai City,5931,1,6,5,3,17,9,8,23
Kolkata,5931,2,5,7,2,16,12,4,22
Delhi Dynamo,5931,3,5,6,3,24,16,8,21
Kerala Blast,5931,4,6,3,5,13,15,-2,21
Chennaiyin,5931,5,4,6,4,16,18,-2,18
NorthEast Un,5931,6,5,2,7,11,13,-2,17
FC Pune City,5931,7,4,3,7,12,18,-6,15
FC Goa,5931,8,3,4,7,8,16,-8,13
Delhi Dynamo,5932,1,7,5,2,26,15,11,26
Mumbai City,5932,2,6,4,4,16,9,7,22
Kolkata,5932,3,4,7,3,14,13,1,19
FC Pune City,5932,4,5,4,5,15,16,-1,19
Kerala Blast,5932,5,5,3,6,13,18,-5,18
NorthEast Un,5932,6,5,2,7,12,13,-1,17
Chennaiyin,5932,7,3,6,5,15,20,-5,15
FC Goa,5932,8,4,3,7,11,18,-7,15
Mumbai City,5933,1,7,4,3,17,8,9,25
Kerala Blast,5933,2,5,5,4,17,15,2,20
Kolkata,5933,3,4,7,3,17,16,1,19
Delhi Dynamo,5933,4,4,6,4,22,18,4,18
NorthEast Un,5933,5,5,3,6,11,16,-5,18
Chennaiyin,5933,6,4,5,5,18,20,-2,17
FC Goa,5933,7,5,2,7,14,19,-5,17
FC Pune City,5933,8,4,4,6,14,18,-4,16
Mumbai City,5934,1,7,4,3,18,8,10,25
Kolkata,5934,2,5,6,3,17,14,3,21
Delhi Dynamo,5934,3,5,5,4,22,17,5,20
FC Pune City,5934,4,5,4,5,14,15,-1,19
Kerala Blast,5934,5,5,4,5,11,15,-4,19
Chennaiyin,5934,6,4,6,4,15,18,-3,18
NorthEast Un,5934,7,5,2,7,11,12,-1,17
FC Goa,5934,8,3,3,8,9,18,-9,12
Mumbai City,5935,1,7,4,3,18,8,10,25
Kerala Blast,5935,2,6,4,4,11,13,-2,22
Delhi Dynamo,5935,3,5,5,4,25,22,3,20
Kolkata,5935,4,4,7,3,15,13,2,19
NorthEast Un,5935,5,5,3,6,15,11,4,18
Chennaiyin,5935,6,3,7,4,15,19,-4,16
FC Pune City,5935,7,4,3,7,12,17,-5,15
FC Goa,5935,8,4,3,7,11,19,-8,15
Delhi Dynamo,5936,1,6,6,2,27,17,10,24
Mumbai City,5936,2,6,4,4,16,9,7,22
NorthEast Un,5936,3,6,2,6,13,12,1,20
Kolkata,5936,4,4,7,3,18,20,-2,19
Kerala Blast,5936,5,5,4,5,15,20,-5,19
FC Goa,5936,6,5,3,6,17,18,-1,18
FC Pune City,5936,7,4,3,7,15,19,-4,15
Chennaiyin,5936,8,3,5,6,15,21,-6,14
Mumbai City,5937,1,7,4,3,17,8,9,25
Kolkata,5937,2,5,6,3,16,14,2,21
Kerala Blast,5937,3,5,4,5,13,17,-4,19
Chennaiyin,5937,4,4,6,4,15,17,-2,18
FC Goa,5937,5,5,3,6,13,15,-2,18
Delhi Dynamo,5937,6,4,5,5,22,19,3,17
NorthEast Un,5937,7,5,2,7,12,14,-2,17
FC Pune City,5937,8,4,4,6,13,17,-4,16
Mumbai City,5938,1,7,4,3,18,9,9,25
Kerala Blast,5938,2,7,3,4,15,14,1,24
Kolkata,5938,3,4,7,3,17,17,0,19
Delhi Dynamo,5938,4,4,6,4,23,18,5,18
FC Goa,5938,5,5,3,6,14,17,-3,18
NorthEast Un,5938,6,4,4,6,13,14,-1,16
FC Pune City,5938,7,4,3,7,13,18,-5,15
Chennaiyin,5938,8,3,6,5,16,22,-6,15
Kolkata,5939,1,6,6,2,21,13,8,24
Delhi Dynamo,5939,2,6,5,3,27,17,10,23
Mumbai City,5939,3,6,4,4,17,11,6,22
FC Pune City,5939,4,5,3,6,14,18,-4,18
Kerala Blast,5939,5,5,3,6,11,18,-7,18
NorthEast Un,5939,6,5,2,7,11,13,-2,17
FC Goa,5939,7,5,2,7,14,17,-3,17
Chennaiyin,5939,8,3,5,6,14,22,-8,14
Mumbai City,5940,1,7,4,3,17,8,9,25
Delhi Dynamo,5940,2,5,6,3,24,17,7,21
Kolkata,5940,3,4,7,3,19,16,3,19
Kerala Blast,5940,4,5,4,5,11,16,-5,19
FC Pune City,5940,5,5,3,6,14,17,-3,18
NorthEast Un,5940,6,4,5,5,11,11,0,17
Chennaiyin,5940,7,3,6,5,15,20,-5,15
FC Goa,5940,8,4,3,7,13,19,-6,15
Mumbai City,5941,1,7,4,3,17,8,9,25
Kolkata,5941,2,5,7,2,19,15,4,22
Kerala Blast,5941,3,6,3,5,15,18,-3,21
FC Goa,5941,4,5,3,6,12,16,-4,18
Delhi Dynamo,5941,5,4,5,5,22,19,3,17
NorthEast Un,5941,6,5,2,7,11,12,-1,17
Chennaiyin,5941,7,4,5,5,14,18,-4,17
FC Pune City,5941,8,4,3,7,13,17,-4,15
Mumbai City,5942,1,7,4,3,19,9,10,25
Delhi Dynamo,5942,2,5,6,3,24,18,6,21
Kerala Blast,5942,3,6,3,5,11,14,-3,21
NorthEast Un,5942,4,5,3,6,12,11,1,18
Kolkata,5942,5,4,6,4,16,16,0,18
FC Pune City,5942,6,5,3,6,14,16,-2,18
FC Goa,5942,7,5,2,7,14,18,-4,17
Chennaiyin,5942,8,3,5,6,15,23,-8,14
Mumbai City,5943,1,7,4,3,20,11,9,25
NorthEast Un,5943,2,7,2,5,15,11,4,23
FC Goa,5943,3,6,2,6,14,17,-3,20
Kolkata,5943,4,4,7,3,16,14,2,19
Kerala Blast,5943,5,5,3,6,12,18,-6,18
Delhi Dynamo,5943,6,4,5,5,26,22,4,17
FC Pune City,5943,7,4,4,6,15,18,-3,16
Chennaiyin,5943,8,3,5,6,16,23,-7,14
Mumbai City,5944,1,6,5,3,16,8,8,23
Kerala Blast,5944,2,6,4,4,15,16,-1,22
NorthEast Un,5944,3,6,2,6,13,13,0,20
Delhi Dynamo,5944,4,4,7,3,25,19,6,19
Kolkata,5944,5,4,6,4,20,17,3,18
FC Goa,5944,6,4,4,6,13,17,-4,16
FC Pune City,5944,7,4,4,6,15,22,-7,16
Chennaiyin,5944,8,3,6,5,14,19,-5,15
Delhi Dynamo,5945,1,6,5,3,28,16,12,23
NorthEast Un,5945,2,7,2,5,15,11,4,23
Mumbai City,5945,3,6,4,4,16,12,4,22
Kerala Blast,5945,4,6,3,5,16,17,-1,21
Kolkata,5945,5,4,6,4,16,16,0,18
FC Pune City,5945,6,5,3,6,13,16,-3,18
Chennaiyin,5945,7,3,6,5,14,20,-6,15
FC Goa,5945,8,3,3,8,10,20,-10,12
Delhi Dynamo,5946,1,6,5,3,25,17,8,23
Mumbai City,5946,2,6,4,4,16,9,7,22
NorthEast Un,5946,3,6,3,5,16,12,4,21
Kolkata,5946,4,5,6,3,17,15,2,21
Kerala Blast,5946,5,5,3,6,11,18,-7,18
Chennaiyin,5946,6,3,7,4,16,20,-4,16
FC Pune City,5946,7,4,3,7,15,19,-4,15
FC Goa,5946,8,4,3,7,11,17,-6,15
Mumbai City,5947,1,7,4,3,18,8,10,25
Kerala Blast,5947,2,7,3,4,12,13,-1,24
Delhi Dynamo,5947,3,5,6,3,25,18,7,21
Chennaiyin,5947,4,5,5,4,15,17,-2,20
Kolkata,5947,5,3,7,4,14,15,-1,16
FC Pune City,5947,6,4,4,6,12,15,-3,16
FC Goa,5947,7,4,3,7,11,17,-6,15
NorthEast Un,5947,8,4,2,8,10,14,-4,14
Mumbai City,5948,1,7,4,3,17,8,9,25
Delhi Dynamo,5948,2,5,6,3,24,17,7,21
FC Pune City,5948,3,5,4,5,17,16,1,19
NorthEast Un,5948,4,5,4,5,13,12,1,19
Kolkata,5948,5,4,6,4,17,18,-1,18
Kerala Blast,5948,6,4,5,5,12,18,-6,17
Chennaiyin,5948,7,3,6,5,14,19,-5,15
FC Goa,5948,8,4,3,7,12,18,-6,15
Mumbai City,5949,1,7,4,3,18,9,9,25
Delhi Dynamo,5949,2,5,6,3,24,17,7,21
Kolkata,5949,3,5,6,3,17,15,2,21
Kerala Blast,5949,4,5,4,5,12,15,-3,19
NorthEast Un,5949,5,5,3,6,12,12,0,18
Chennaiyin,5949,6,4,6,4,17,20,-3,18
FC Pune City,5949,7,4,4,6,12,15,-3,16
FC Goa,5949,8,3,3,8,12,21,-9,12
Delhi Dynamo,5950,1,6,5,3,24,15,9,23
NorthEast Un,5950,2,7,2,5,14,9,5,23
Mumbai City,5950,3,6,4,4,16,10,6,22
Kerala Blast,5950,4,6,3,5,12,16,-4,21
Kolkata,5950,5,4,6,4,15,15,0,18
FC Pune City,5950,6,4,3,7,12,16,-4,15
Chennaiyin,5950,7,3,6,5,14,20,-6,15
FC Goa,5950,8,4,3,7,10,16,-6,15
Mumbai City,5951,1,7,4,3,19,8,11,25
Kolkata,5951,2,5,6,3,19,16,3,21
Kerala Blast,5951,3,6,3,5,15,16,-1,21
Delhi Dynamo,5951,4,5,5,4,26,21,5,20
NorthEast Un,5951,5,6,2,6,13,11,2,20
Chennaiyin,5951,6,4,5,5,15,20,-5,17
FC Pune City,5951,7,4,3,7,13,20,-7,15
FC Goa,5951,8,4,2,8,13,21,-8,14
Mumbai City,5952,1,7,4,3,19,8,11,25
FC Pune City,5952,2,6,3,5,16,14,2,21
Delhi Dynamo,5952,3,4,6,4,24,21,3,18
Kolkata,5952,4,4,6,4,15,15,0,18
FC Goa,5952,5,5,3,6,14,17,-3,18
Kerala Blast,5952,6,5,3,6,11,18,-7,18
NorthEast Un,5952,7,5,2,7,12,14,-2,17
Chennaiyin,5952,8,4,5,5,16,20,-4,17
Mumbai City,5953,1,7,4,3,18,8,10,25
Delhi Dynamo,5953,2,5,6,3,24,17,7,21
Kolkata,5953,3,5,6,3,20,16,4,21
FC Pune City,5953,4,5,4,5,15,15,0,19
NorthEast Un,5953,5,4,5,5,12,12,0,17
Kerala Blast,5953,6,4,5,5,11,18,-7,17
Chennaiyin,5953,7,3,7,4,17,21,-4,16
FC Goa,5953,8,3,3,8,11,21,-10,12
Kolkata,5954,1,6,6,2,19,14,5,24
Mumbai City,5954,2,6,4,4,16,11,5,22
Kerala Blast,5954,3,6,3,5,14,15,-1,21
Delhi Dynamo,5954,4,5,5,4,24,17,7,20
Chennaiyin,5954,5,4,5,5,14,18,-4,17
FC Goa,5954,6,5,2,7,11,15,-4,17
NorthEast Un,5954,7,5,2,7,10,14,-4,17
FC Pune City,5954,8,4,3,7,14,18,-4,15
Mumbai City,5955,1,7,4,3,18,9,9,25
Kolkata,5955,2,6,6,2,19,13,6,24
Delhi Dynamo,5955,3,6,5,3,27,16,11,23
Kerala Blast,5955,4,6,3,5,12,16,-4,21
Chennaiyin,5955,5,4,5,5,16,19,-3,17
NorthEast Un,5955,6,5,2,7,10,14,-4,17
FC Pune City,5955,7,4,3,7,12,17,-5,15
FC Goa,5955,8,3,2,9,9,19,-10,11
Delhi Dynamo,5956,1,6,5,3,26,17,9,23
Mumbai City,5956,2,6,4,4,17,10,7,22
Kolkata,5956,3,5,6,3,16,13,3,21
NorthEast Un,5956,4,5,4,5,11,10,1,19
Kerala Blast,5956,5,5,4,5,10,14,-4,19
FC Goa,5956,6,5,2,7,10,16,-6,17
Chennaiyin,5956,7,3,6,5,13,18,-5,15
FC Pune City,5956,8,4,3,7,12,17,-5,15
Delhi Dynamo,5957,1,6,5,3,27,18,9,23
Mumbai City,5957,2,6,4,4,17,10,7,22
Kolkata,5957,3,4,8,2,16,14,2,20
FC Pune City,5957,4,5,4,5,14,15,-1,19
Kerala Blast,5957,5,5,4,5,13,15,-2,19
NorthEast Un,5957,6,5,2,7,13,17,-4,17
Chennaiyin,5957,7,3,6,5,16,21,-5,15
FC Goa,5957,8,4,3,7,11,17,-6,15
Mumbai City,5958,1,7,4,3,20,10,10,25
Kolkata,5958,2,5,7,2,17,13,4,22
Delhi Dynamo,5958,3,5,5,4,27,22,5,20
Kerala Blast,5958,4,5,4,5,13,17,-4,19
Chennaiyin,5958,5,4,6,4,15,18,-3,18
FC Goa,5958,6,4,4,6,11,16,-5,16
NorthEast Un,5958,7,4,3,7,13,15,-2,15
FC Pune City,5958,8,4,3,7,13,18,-5,15
Mumbai City,5959,1,7,4,3,17,8,9,25
Kolkata,5959,2,6,6,2,19,12,7,24
NorthEast Un,5959,3,6,2,6,14,13,1,20
Chennaiyin,5959,4,4,6,4,17,20,-3,18
FC Pune City,5959,5,5,3,6,13,17,-4,18
Delhi Dynamo,5959,6,4,5,5,23,19,4,17
FC Goa,5959,7,4,3,7,11,18,-7,15
Kerala Blast,5959,8,4,3,7,9,16,-7,15
Mumbai City,5960,1,7,4,3,19,8,11,25
Delhi Dynamo,5960,2,5,6,3,25,20,5,21
FC Pune City,5960,3,6,3,5,15,14,1,21
Kolkata,5960,4,4,7,3,16,16,0,19
Chennaiyin,5960,5,4,5,5,16,19,-3,17
NorthEast Un,5960,6,5,2,7,12,15,-3,17
Kerala Blast,5960,7,4,4,6,11,17,-6,16
FC Goa,5960,8,4,3,7,13,18,-5,15
Mumbai City,5961,1,6,5,3,17,9,8,23
Delhi Dynamo,5961,2,5,7,2,25,17,8,22
NorthEast Un,5961,3,6,3,5,13,11,2,21
Kolkata,5961,4,4,8,2,15,13,2,20
FC Pune City,5961,5,4,5,5,12,14,-2,17
Kerala Blast,5961,6,4,5,5,9,14,-5,17
FC Goa,5961,7,4,2,8,12,17,-5,14
Chennaiyin,5961,8,3,5,6,13,21,-8,14
Mumbai City,5962,1,7,4,3,19,10,9,25
NorthEast Un,5962,2,7,2,5,13,10,3,23
FC Goa,5962,3,6,2,6,13,15,-2,20
Kolkata,5962,4,4,7,3,15,14,1,19
Kerala Blast,5962,5,5,3,6,13,18,-5,18
Delhi Dynamo,5962,6,4,5,5,24,20,4,17
FC Pune City,5962,7,4,4,6,14,17,-3,16
Chennaiyin,5962,8,3,5,6,14,21,-7,14
Delhi Dynamo,5963,1,6,6,2,27,17,10,24
Mumbai City,5963,2,6,4,4,18,12,6,22
Kolkata,5963,3,5,6,3,19,14,5,21
NorthEast Un,5963,4,6,3,5,13,9,4,21
FC Pune City,5963,5,5,3,6,15,17,-2,18
Kerala Blast,5963,6,5,3,6,11,20,-9,18
Chennaiyin,5963,7,3,6,5,14,19,-5,15
FC Goa,5963,8,3,3,8,10,19,-9,12
Delhi Dynamo,5964,1,6,6,2,26,16,10,24
Mumbai City,5964,2,6,4,4,16,10,6,22
FC Pune City,5964,3,6,3,5,17,17,0,21
Kerala Blast,5964,4,6,3,5,14,16,-2,21
Chennaiyin,5964,5,4,6,4,16,19,-3,18
Kolkata,5964,6,3,7,4,15,16,-1,16
NorthEast Un,5964,7,4,4,6,11,13,-2,16
FC Goa,5964,8,3,3,8,11,19,-8,12
Delhi Dynamo,5965,1,6,5,3,26,16,10,23
Mumbai City,5965,2,6,4,4,16,11,5,22
Kolkata,5965,3,5,7,2,20,16,4,22
Kerala Blast,5965,4,5,4,5,15,18,-3,19
NorthEast Un,5965,5,5,3,6,12,12,0,18
Chennaiyin,5965,6,4,5,5,14,19,-5,17
FC Goa,5965,7,4,3,7,13,18,-5,15
FC Pune City,5965,8,4,3,7,14,20,-6,15
Mumbai City,5966,1,7,4,3,18,9,9,25
Delhi Dynamo,5966,2,5,6,3,27,18,9,21
FC Pune City,5966,3,6,3,5,17,16,1,21
Kolkata,5966,4,4,6,4,17,17,0,18
Kerala Blast,5966,5,5,3,6,12,17,-5,18
FC Goa,5966,6,5,2,7,14,20,-6,17
NorthEast Un,5966,7,4,4,6,12,14,-2,16
Chennaiyin,5966,8,3,6,5,16,22,-6,15
Delhi Dynamo,5967,1,6,6,2,25,15,10,24
Mumbai City,5967,2,6,5,3,17,9,8,23
Kolkata,5967,3,5,6,3,17,14,3,21
Kerala Blast,5967,4,6,3,5,14,14,0,21
FC Pune City,5967,5,5,3,6,13,15,-2,18
NorthEast Un,5967,6,5,2,7,11,14,-3,17
Chennaiyin,5967,7,3,5,6,14,21,-7,14
FC Goa,5967,8,4,2,8,11,20,-9,14
Mumbai City,5968,1,6,5,3,18,10,8,23
FC Pune City,5968,2,6,3,5,14,14,0,21
NorthEast Un,5968,3,6,2,6,12,12,0,20
Delhi Dynamo,5968,4,4,7,3,25,19,6,19
Kolkata,5968,5,4,6,4,16,14,2,18
Chennaiyin,5968,6,4,6,4,15,17,-2,18
Kerala Blast,5968,7,5,3,6,11,16,-5,18
FC Goa,5968,8,3,4,7,10,19,-9,13
Mumbai City,5969,1,7,4,3,19,9,10,25
Kerala Blast,5969,2,6,4,4,13,14,-1,22
Delhi Dynamo,5969,3,4,7,3,25,20,5,19
Kolkata,5969,4,4,7,3,19,16,3,19
FC Pune City,5969,5,5,3,6,16,18,-2,18
NorthEast Un,5969,6,4,4,6,13,14,-1,16
Chennaiyin,5969,7,3,6,5,14,19,-5,15
FC Goa,5969,8,4,3,7,10,19,-9,15
Mumbai City,5970,1,6,4,4,16,9,7,22
NorthEast Un,5970,2,6,3,5,13,11,2,21
Delhi Dynamo,5970,3,5,5,4,24,18,6,20
Kolkata,5970,4,4,8,2,17,14,3,20
Chennaiyin,5970,5,4,6,4,15,18,-3,18
FC Pune City,5970,6,4,5,5,14,16,-2,17
Kerala Blast,5970,7,4,4,6,10,17,-7,16
FC Goa,5970,8,4,3,7,11,17,-6,15
Delhi Dynamo,5971,1,6,6,2,26,16,10,24
Mumbai City,5971,2,6,4,4,18,11,7,22
Kolkata,5971,3,5,6,3,16,15,1,21
NorthEast Un,5971,4,5,4,5,12,11,1,19
FC Pune City,5971,5,5,3,6,14,15,-1,18
FC Goa,5971,6,5,2,7,14,17,-3,17
Kerala Blast,5971,7,4,4,6,10,18,-8,16
Chennaiyin,5971,8,3,5,6,15,22,-7,14
Mumbai City,5972,1,7,4,3,18,9,9,25
Kolkata,5972,2,4,8,2,17,15,2,20
Kerala Blast,5972,3,5,5,4,15,15,0,20
Delhi Dynamo,5972,4,4,6,4,23,20,3,18
Chennaiyin,5972,5,4,6,4,15,18,-3,18
NorthEast Un,5972,6,4,4,6,11,12,-1,16
FC Pune City,5972,7,4,4,6,12,18,-6,16
FC Goa,5972,8,4,3,7,14,18,-4,15
Kerala Blast,5973,1,7,3,4,13,13,0,24
Delhi Dynamo,5973,2,6,5,3,27,17,10,23
Mumbai City,5973,3,6,4,4,16,11,5,22
Kolkata,5973,4,5,6,3,17,14,3,21
Chennaiyin,5973,5,4,6,4,16,18,-2,18
FC Pune City,5973,6,4,3,7,12,17,-5,15
FC Goa,5973,7,4,3,7,10,16,-6,15
NorthEast Un,5973,8,4,2,8,12,17,-5,14
Mumbai City,5974,1,6,5,3,17,9,8,23
Delhi Dynamo,5974,2,5,6,3,25,17,8,21
FC Pune City,5974,3,6,3,5,16,16,0,21
NorthEast Un,5974,4,6,2,6,11,11,0,20
Kolkata,5974,5,4,6,4,16,16,0,18
FC Goa,5974,6,5,3,6,11,15,-4,18
Chennaiyin,5974,7,3,6,5,13,18,-5,15
Kerala Blast,5974,8,4,3,7,11,18,-7,15
Mumbai City,5975,1,7,4,3,18,8,10,25
Delhi Dynamo,5975,2,5,5,4,24,19,5,20
Kerala Blast,5975,3,5,4,5,12,15,-3,19
Kolkata,5975,4,3,9,2,14,13,1,18
FC Goa,5975,5,5,3,6,14,17,-3,18
NorthEast Un,5975,6,5,2,7,10,12,-2,17
Chennaiyin,5975,7,4,5,5,16,20,-4,17
FC Pune City,5975,8,4,4,6,12,16,-4,16
Mumbai City,5976,1,6,4,4,16,9,7,22
Kerala Blast,5976,2,6,3,5,11,15,-4,21
Delhi Dynamo,5976,3,5,5,4,23,19,4,20
NorthEast Un,5976,4,6,2,6,14,11,3,20
FC Goa,5976,5,6,2,6,13,15,-2,20
Chennaiyin,5976,6,4,5,5,15,18,-3,17
Kolkata,5976,7,3,7,4,13,15,-2,16
FC Pune City,5976,8,4,4,6,12,15,-3,16
Delhi Dynamo,5977,1,6,5,3,24,17,7,23
Mumbai City,5977,2,6,4,4,16,9,7,22
FC Pune City,5977,3,6,3,5,17,15,2,21
Chennaiyin,5977,4,5,5,4,19,18,1,20
Kerala Blast,5977,5,5,4,5,11,15,-4,19
Kolkata,5977,6,3,8,3,15,17,-2,17
NorthEast Un,5977,7,5,2,7,11,14,-3,17
FC Goa,5977,8,3,3,8,12,20,-8,12
Mumbai City,5978,1,7,4,3,19,9,10,25
NorthEast Un,5978,2,6,3,5,14,10,4,21
Delhi Dynamo,5978,3,5,5,4,24,21,3,20
Kerala Blast,5978,4,5,5,4,10,13,-3,20
Kolkata,5978,5,4,6,4,16,16,0,18
FC Pune City,5978,6,4,4,6,12,17,-5,16
FC Goa,5978,7,4,3,7,11,15,-4,15
Chennaiyin,5978,8,3,6,5,13,18,-5,15
Mumbai City,5979,1,6,5,3,16,8,8,23
Kolkata,5979,2,5,7,2,18,14,4,22
Delhi Dynamo,5979,3,5,6,3,22,15,7,21
Kerala Blast,5979,4,5,4,5,12,16,-4,19
FC Pune City,5979,5,5,3,6,13,15,-2,18
Chennaiyin,5979,6,4,5,5,17,19,-2,17
NorthEast Un,5979,7,5,2,7,11,14,-3,17
FC Goa,5979,8,4,2,8,11,19,-8,14
Mumbai City,5980,1,6,4,4,16,9,7,22
Kolkata,5980,2,5,7,2,16,12,4,22
Delhi Dynamo,5980,3,5,5,4,22,16,6,20
Kerala Blast,5980,4,5,4,5,12,16,-4,19
FC Pune City,5980,5,4,5,5,13,15,-2,17
NorthEast Un,5980,6,5,2,7,11,13,-2,17
Chennaiyin,5980,7,4,5,5,16,19,-3,17
FC Goa,5980,8,5,2,7,11,17,-6,17
Delhi Dynamo,5981,1,6,5,3,26,19,7,23
Mumbai City,5981,2,6,4,4,16,10,6,22
FC Goa,5981,3,6,2,6,19,18,1,20
Kolkata,5981,4,4,7,3,17,16,1,19
NorthEast Un,5981,5,5,2,7,12,13,-1,17
FC Pune City,5981,6,4,5,5,15,17,-2,17
Chennaiyin,5981,7,4,5,5,17,22,-5,17
Kerala Blast,5981,8,4,4,6,11,18,-7,16
Mumbai City,5982,1,7,4,3,18,9,9,25
Kerala Blast,5982,2,6,4,4,13,13,0,22
NorthEast Un,5982,3,6,3,5,15,11,4,21
Delhi Dynamo,5982,4,5,5,4,25,21,4,20
Kolkata,5982,5,4,6,4,16,16,0,18
Chennaiyin,5982,6,3,6,5,14,19,-5,15
FC Goa,5982,7,4,3,7,11,16,-5,15
FC Pune City,5982,8,4,3,7,12,19,-7,15
Delhi Dynamo,5983,1,7,5,2,27,17,10,26
Mumbai City,5983,2,6,4,4,17,10,7,22
Kerala Blast,5983,3,5,5,4,14,15,-1,20
Kolkata,5983,4,4,7,3,17,16,1,19
FC Pune City,5983,5,5,4,5,14,15,-1,19
NorthEast Un,5983,6,5,2,7,15,17,-2,17
Chennaiyin,5983,7,3,5,6,16,23,-7,14
FC Goa,5983,8,4,2,8,12,19,-7,14
Delhi Dynamo,5984,1,6,6,2,26,17,9,24
Mumbai City,5984,2,6,4,4,17,10,7,22
Kolkata,5984,3,5,6,3,20,14,6,21
FC Pune City,5984,4,5,3,6,14,16,-2,18
FC Goa,5984,5,5,3,6,12,15,-3,18
Kerala Blast,5984,6,5,3,6,10,19,-9,18
Chennaiyin,5984,7,4,5,5,15,20,-5,17
NorthEast Un,5984,8,4,2,8,11,14,-3,14
Mumbai City,5985,1,6,4,4,16,9,7,22
Delhi Dynamo,5985,2,5,6,3,22,16,6,21
Kolkata,5985,3,4,8,2,18,16,2,20
Chennaiyin,5985,4,5,5,4,18,19,-1,20
FC Pune City,5985,5,5,4,5,17,18,-1,19
Kerala Blast,5985,6,5,4,5,13,16,-3,19
NorthEast Un,5985,7,4,3,7,10,14,-4,15
FC Goa,5985,8,4,2,8,11,17,-6,14
Mumbai City,5986,1,6,5,3,17,9,8,23
Kolkata,5986,2,5,7,2,18,14,4,22
NorthEast Un,5986,3,6,3,5,12,10,2,21
Delhi Dynamo,5986,4,4,7,3,24,18,6,19
Kerala Blast,5986,5,5,4,5,11,15,-4,19
Chennaiyin,5986,6,3,6,5,15,20,-5,15
FC Pune City,5986,7,4,3,7,12,17,-5,15
FC Goa,5986,8,3,5,6,13,19,-6,14
Delhi Dynamo,5987,1,6,6,2,25,16,9,24
Mumbai City,5987,2,6,5,3,17,9,8,23
Kolkata,5987,3,5,7,2,16,13,3,22
Kerala Blast,5987,4,5,4,5,12,17,-5,19
FC Pune City,5987,5,5,3,6,14,15,-1,18
Chennaiyin,5987,6,3,7,4,17,21,-4,16
NorthEast Un,5987,7,4,3,7,13,15,-2,15
FC Goa,5987,8,3,3,8,10,18,-8,12
Mumbai City,5988,1,7,4,3,21,8,13,25
NorthEast Un,5988,2,6,3,5,16,12,4,21
Kerala Blast,5988,3,6,3,5,14,16,-2,21
Kolkata,5988,4,4,7,3,15,15,0,19
Delhi Dynamo,5988,5,4,6,4,23,23,0,18
Chennaiyin,5988,6,4,6,4,16,18,-2,18
FC Pune City,5988,7,4,3,7,12,17,-5,15
FC Goa,5988,8,3,4,7,9,17,-8,13
Mumbai City,5989,1,7,4,3,19,9,10,25
Delhi Dynamo,5989,2,6,5,3,26,17,9,23
Kolkata,5989,3,3,9,2,17,16,1,18
NorthEast Un,5989,4,5,2,7,11,12,-1,17
FC Pune City,5989,5,4,5,5,15,17,-2,17
Chennaiyin,5989,6,4,5,5,15,19,-4,17
Kerala Blast,5989,7,4,5,5,11,16,-5,17
FC Goa,5989,8,4,3,7,12,20,-8,15
Delhi Dynamo,5990,1,6,6,2,27,16,11,24
Mumbai City,5990,2,6,5,3,17,9,8,23
Kerala Blast,5990,3,6,4,4,14,15,-1,22
Kolkata,5990,4,5,6,3,18,16,2,21
NorthEast Un,5990,5,5,3,6,14,15,-1,18
Chennaiyin,5990,6,4,5,5,18,22,-4,17
FC Pune City,5990,7,4,3,7,14,19,-5,15
FC Goa,5990,8,3,2,9,10,20,-10,11
Mumbai City,5991,1,7,4,3,17,8,9,25
Kolkata,5991,2,5,7,2,19,14,5,22
Kerala Blast,5991,3,6,4,4,13,15,-2,22
NorthEast Un,5991,4,6,2,6,15,11,4,20
Delhi Dynamo,5991,5,4,6,4,23,20,3,18
Chennaiyin,5991,6,4,5,5,15,20,-5,17
FC Pune City,5991,7,4,3,7,12,18,-6,15
FC Goa,5991,8,3,3,8,10,18,-8,12
Mumbai City,5992,1,7,4,3,18,9,9,25
Kolkata,5992,2,4,7,3,16,15,1,19
NorthEast Un,5992,3,5,4,5,13,12,1,19
FC Pune City,5992,4,5,4,5,15,15,0,19
Chennaiyin,5992,5,4,6,4,19,22,-3,18
Delhi Dynamo,5992,6,4,5,5,23,19,4,17
Kerala Blast,5992,7,4,5,5,11,17,-6,17
FC Goa,5992,8,4,3,7,14,20,-6,15
Mumbai City,5993,1,7,4,3,18,8,10,25
FC Pune City,5993,2,6,3,5,15,15,0,21
NorthEast Un,5993,3,6,2,6,15,14,1,20
Kolkata,5993,4,4,7,3,15,14,1,19
Delhi Dynamo,5993,5,4,6,4,24,22,2,18
Kerala Blast,5993,6,5,3,6,14,17,-3,18
Chennaiyin,5993,7,4,5,5,15,19,-4,17
FC Goa,5993,8,3,4,7,12,19,-7,13
Mumbai City,5994,1,7,4,3,18,8,10,25
Kolkata,5994,2,5,6,3,17,14,3,21
Delhi Dynamo,5994,3,5,5,4,25,17,8,20
Chennaiyin,5994,4,5,5,4,19,17,2,20
Kerala Blast,5994,5,5,4,5,12,16,-4,19
NorthEast Un,5994,6,5,2,7,11,15,-4,17
FC Pune City,5994,7,4,4,6,12,16,-4,16
FC Goa,5994,8,4,2,8,9,20,-11,14
Mumbai City,5995,1,6,5,3,16,8,8,23
Kerala Blast,5995,2,5,5,4,12,14,-2,20
Delhi Dynamo,5995,3,4,7,3,21,16,5,19
NorthEast Un,5995,4,5,4,5,12,10,2,19
Chennaiyin,5995,5,4,6,4,16,18,-2,18
FC Pune City,5995,6,4,5,5,14,16,-2,17
Kolkata,5995,7,3,7,4,15,18,-3,16
FC Goa,5995,8,4,3,7,11,17,-6,15
Mumbai City,5996,1,6,5,3,16,8,8,23
Delhi Dynamo,5996,2,5,6,3,24,16,8,21
NorthEast Un,5996,3,6,2,6,14,13,1,20
FC Pune City,5996,4,5,4,5,15,16,-1,19
Kerala Blast,5996,5,5,4,5,12,15,-3,19
Chennaiyin,5996,6,4,5,5,17,22,-5,17
Kolkata,5996,7,3,7,4,17,19,-2,16
FC Goa,5996,8,4,3,7,12,18,-6,15
Mumbai City,5997,1,6,5,3,19,11,8,23
NorthEast Un,5997,2,7,2,5,17,12,5,23
Delhi Dynamo,5997,3,5,6,3,28,23,5,21
Kolkata,5997,4,4,8,2,16,14,2,20
Kerala Blast,5997,5,5,3,6,11,16,-5,18
FC Pune City,5997,6,4,4,6,13,16,-3,16
Chennaiyin,5997,7,3,6,5,15,20,-5,15
FC Goa,5997,8,3,4,7,12,19,-7,13
Mumbai City,5998,1,6,5,3,18,10,8,23
Delhi Dynamo,5998,2,5,7,2,24,16,8,22
Kolkata,5998,3,4,7,3,17,15,2,19
Kerala Blast,5998,4,5,4,5,11,16,-5,19
Chennaiyin,5998,5,4,6,4,16,17,-1,18
FC Pune City,5998,6,4,5,5,12,14,-2,17
FC Goa,5998,7,4,4,6,10,15,-5,16
NorthEast Un,5998,8,4,2,8,9,14,-5,14
Mumbai City,5999,1,6,5,3,18,10,8,23
Delhi Dynamo,5999,2,5,6,3,26,19,7,21
Kolkata,5999,3,5,6,3,17,14,3,21
Kerala Blast,5999,4,5,4,5,13,16,-3,19
NorthEast Un,5999,5,5,3,6,15,13,2,18
Chennaiyin,5999,6,4,5,5,16,21,-5,17
FC Goa,5999,7,5,2,7,13,19,-6,17
FC Pune City,5999,8,4,3,7,12,18,-6,15
Mumbai City,6000,1,6,4,4,17,12,5,22
Delhi Dynamo,6000,2,5,6,3,27,18,9,21
NorthEast Un,6000,3,6,2,6,14,12,2,20
Chennaiyin,6000,4,5,5,4,17,17,0,20
Kolkata,6000,5,4,7,3,20,15,5,19
FC Pune City,6000,6,5,3,6,14,19,-5,18
Kerala Blast,6000,7,4,4,6,11,21,-10,16
FC Goa,6000,8,4,3,7,11,17,-6,15
Delhi Dynamo,6001,1,6,6,2,25,16,9,24
Mumbai City,6001,2,6,5,3,17,9,8,23
Kolkata,6001,3,4,8,2,15,13,2,20
Kerala Blast,6001,4,5,4,5,13,15,-2,19
Chennaiyin,6001,5,4,6,4,16,19,-3,18
NorthEast Un,6001,6,5,2,7,11,12,-1,17
FC Pune City,6001,7,4,3,7,12,18,-6,15
FC Goa,6001,8,3,4,7,10,17,-7,13
Mumbai City,6002,1,6,5,3,17,9,8,23
NorthEast Un,6002,2,6,3,5,15,12,3,21
Delhi Dynamo,6002,3,4,7,3,24,20,4,19
Kolkata,6002,4,4,6,4,17,17,0,18
FC Pune City,6002,5,5,3,6,14,16,-2,18
Kerala Blast,6002,6,5,3,6,14,19,-5,18
FC Goa,6002,7,5,2,7,15,18,-3,17
Chennaiyin,6002,8,4,5,5,16,21,-5,17
Mumbai City,6003,1,7,4,3,20,9,11,25
NorthEast Un,6003,2,6,3,5,15,11,4,21
Kerala Blast,6003,3,5,5,4,15,16,-1,20
Kolkata,6003,4,4,7,3,18,16,2,19
Delhi Dynamo,6003,5,4,6,4,24,22,2,18
FC Pune City,6003,6,5,3,6,14,17,-3,18
Chennaiyin,6003,7,3,6,5,13,19,-6,15
FC Goa,6003,8,3,4,7,9,18,-9,13
Mumbai City,6004,1,7,4,3,17,8,9,25
Delhi Dynamo,6004,2,5,6,3,22,15,7,21
Kolkata,6004,3,5,6,3,18,15,3,21
FC Pune City,6004,4,5,3,6,15,16,-1,18
Chennaiyin,6004,5,4,6,4,16,19,-3,18
NorthEast Un,6004,6,4,5,5,11,11,0,17
Kerala Blast,6004,7,4,4,6,10,19,-9,16
FC Goa,6004,8,4,2,8,12,18,-6,14
Delhi Dynamo,6005,1,6,6,2,26,14,12,24
Mumbai City,6005,2,6,4,4,16,10,6,22
Kolkata,6005,3,4,8,2,18,16,2,20
Kerala Blast,6005,4,5,5,4,14,15,-1,20
Chennaiyin,6005,5,4,5,5,15,20,-5,17
FC Pune City,6005,6,4,4,6,15,18,-3,16
NorthEast Un,6005,7,4,3,7,9,13,-4,15
FC Goa,6005,8,4,3,7,12,19,-7,15
Kolkata,6006,1,6,6,2,21,14,7,24
Mumbai City,6006,2,6,5,3,17,9,8,23
Delhi Dynamo,6006,3,5,7,2,29,19,10,22
Chennaiyin,6006,4,5,5,4,17,18,-1,20
Kerala Blast,6006,5,4,5,5,12,18,-6,17
NorthEast Un,6006,6,4,4,6,12,14,-2,16
FC Pune City,6006,7,4,4,6,14,17,-3,16
FC Goa,6006,8,3,2,9,11,24,-13,11
Kerala Blast,6007,1,7,3,4,12,13,-1,24
Delhi Dynamo,6007,2,6,5,3,25,17,8,23
Mumbai City,6007,3,6,4,4,16,9,7,22
Kolkata,6007,4,5,6,3,16,14,2,21
NorthEast Un,6007,5,5,2,7,12,13,-1,17
Chennaiyin,6007,6,4,5,5,15,20,-5,17
FC Pune City,6007,7,4,3,7,12,16,-4,15
FC Goa,6007,8,4,2,8,12,18,-6,14
Mumbai City,6008,1,6,4,4,16,11,5,22
Kerala Blast,6008,2,6,4,4,11,13,-2,22
Delhi Dynamo,6008,3,5,5,4,25,18,7,20
NorthEast Un,6008,4,5,3,6,13,13,0,18
Chennaiyin,6008,5,4,6,4,18,20,-2,18
FC Goa,6008,6,5,3,6,14,16,-2,18
FC Pune City,6008,7,5,3,6,13,15,-2,18
Kolkata,6008,8,3,6,5,13,17,-4,15
Mumbai City,6009,1,7,4,3,21,9,12,25
Kerala Blast,6009,2,6,4,4,14,15,-1,22
Delhi Dynamo,6009,3,5,6,3,28,23,5,21
Chennaiyin,6009,4,5,5,4,16,18,-2,20
Kolkata,6009,5,4,6,4,15,15,0,18
FC Pune City,6009,6,4,4,6,14,17,-3,16
FC Goa,6009,7,4,3,7,13,19,-6,15
NorthEast Un,6009,8,4,2,8,11,16,-5,14
Mumbai City,6010,1,6,5,3,17,9,8,23
Delhi Dynamo,6010,2,5,6,3,24,16,8,21
Chennaiyin,6010,3,5,5,4,20,19,1,20
NorthEast Un,6010,4,6,2,6,12,13,-1,20
Kerala Blast,6010,5,5,4,5,12,16,-4,19
FC Pune City,6010,6,5,3,6,14,15,-1,18
Kolkata,6010,7,3,7,4,15,17,-2,16
FC Goa,6010,8,4,2,8,10,19,-9,14
Mumbai City,6011,1,7,4,3,18,9,9,25
Delhi Dynamo,6011,2,5,6,3,26,19,7,21
Kerala Blast,6011,3,5,5,4,17,19,-2,20
Kolkata,6011,4,4,7,3,18,18,0,19
Chennaiyin,6011,5,4,5,5,14,21,-7,17
FC Goa,6011,6,4,4,6,15,17,-2,16
FC Pune City,6011,7,4,4,6,14,17,-3,16
NorthEast Un,6011,8,4,3,7,11,13,-2,15
Mumbai City,6012,1,7,4,3,17,8,9,25
Delhi Dynamo,6012,2,5,6,3,22,15,7,21
NorthEast Un,6012,3,6,3,5,12,9,3,21
FC Pune City,6012,4,5,4,5,15,16,-1,19
Chennaiyin,6012,5,4,5,5,17,19,-2,17
Kerala Blast,6012,6,4,5,5,11,17,-6,17
Kolkata,6012,7,3,7,4,15,17,-2,16
FC Goa,6012,8,4,2,8,11,19,-8,14
Mumbai City,6013,1,6,5,3,18,10,8,23
NorthEast Un,6013,2,7,2,5,16,10,6,23
Kolkata,6013,3,5,7,2,19,14,5,22
Delhi Dynamo,6013,4,4,6,4,23,21,2,18
FC Goa,6013,5,5,3,6,12,16,-4,18
FC Pune City,6013,6,4,4,6,14,17,-3,16
Kerala Blast,6013,7,4,4,6,10,18,-8,16
Chennaiyin,6013,8,3,5,6,15,21,-6,14
Mumbai City,6014,1,7,4,3,19,9,10,25
Delhi Dynamo,6014,2,5,6,3,26,20,6,21
FC Pune City,6014,3,6,3,5,15,15,0,21
Kolkata,6014,4,4,7,3,18,16,2,19
Chennaiyin,6014,5,4,6,4,17,20,-3,18
Kerala Blast,6014,6,4,5,5,12,17,-5,17
NorthEast Un,6014,7,4,4,6,12,13,-1,16
FC Goa,6014,8,3,3,8,12,21,-9,12
Mumbai City,6015,1,6,5,3,19,11,8,23
Delhi Dynamo,6015,2,5,7,2,26,18,8,22
Kerala Blast,6015,3,6,4,4,12,14,-2,22
Kolkata,6015,4,4,7,3,15,15,0,19
Chennaiyin,6015,5,4,6,4,18,18,0,18
FC Pune City,6015,6,5,3,6,14,15,-1,18
NorthEast Un,6015,7,4,2,8,10,16,-6,14
FC Goa,6015,8,3,4,7,9,16,-7,13
Kolkata,6016,1,6,6,2,22,16,6,24
Mumbai City,6016,2,6,4,4,18,11,7,22
Delhi Dynamo,6016,3,5,6,3,26,19,7,21
Kerala Blast,6016,4,6,3,5,16,19,-3,21
Chennaiyin,6016,5,4,5,5,16,20,-4,17
FC Goa,6016,6,5,2,7,14,19,-5,17
FC Pune City,6016,7,4,3,7,13,17,-4,15
NorthEast Un,6016,8,4,3,7,11,15,-4,15
Delhi Dynamo,6017,1,6,5,3,24,16,8,23
Mumbai City,6017,2,6,4,4,16,9,7,22
Kolkata,6017,3,5,6,3,17,14,3,21
Chennaiyin,6017,4,4,6,4,16,18,-2,18
Kerala Blast,6017,5,4,5,5,13,18,-5,17
FC Goa,6017,6,5,2,7,10,16,-6,17
NorthEast Un,6017,7,4,4,6,12,13,-1,16
FC Pune City,6017,8,4,4,6,14,18,-4,16
Mumbai City,6018,1,7,4,3,20,8,12,25
Kolkata,6018,2,5,6,3,18,15,3,21
NorthEast Un,6018,3,6,3,5,12,10,2,21
FC Pune City,6018,4,6,3,5,17,16,1,21
Chennaiyin,6018,5,4,6,4,15,18,-3,18
Delhi Dynamo,6018,6,4,5,5,23,22,1,17
Kerala Blast,6018,7,4,3,7,9,18,-9,15
FC Goa,6018,8,4,2,8,11,18,-7,14
Delhi Dynamo,6019,1,6,5,3,25,16,9,23
Mumbai City,6019,2,6,4,4,17,10,7,22
Kolkata,6019,3,5,7,2,18,13,5,22
Kerala Blast,6019,4,6,3,5,14,15,-1,21
NorthEast Un,6019,5,5,2,7,11,14,-3,17
Chennaiyin,6019,6,4,5,5,16,20,-4,17
FC Pune City,6019,7,4,4,6,13,17,-4,16
FC Goa,6019,8,4,2,8,10,19,-9,14
Mumbai City,6020,1,7,4,3,18,9,9,25
Delhi Dynamo,6020,2,5,6,3,26,19,7,21
NorthEast Un,6020,3,6,3,5,13,11,2,21
Kerala Blast,6020,4,5,4,5,12,14,-2,19
Kolkata,6020,5,4,6,4,14,16,-2,18
FC Goa,6020,6,5,2,7,13,17,-4,17
FC Pune City,6020,7,4,4,6,12,15,-3,16
Chennaiyin,6020,8,3,5,6,14,21,-7,14
Mumbai City,6021,1,6,5,3,17,9,8,23
Delhi Dynamo,6021,2,5,6,3,23,16,7,21
FC Pune City,6021,3,6,3,5,16,15,1,21
Kerala Blast,6021,4,5,4,5,11,16,-5,19
Kolkata,6021,5,3,8,3,16,16,0,17
NorthEast Un,6021,6,5,2,7,11,12,-1,17
Chennaiyin,6021,7,4,5,5,16,19,-3,17
FC Goa,6021,8,4,3,7,10,17,-7,15
Mumbai City,6022,1,6,4,4,16,11,5,22
Delhi Dynamo,6022,2,5,6,3,25,16,9,21
NorthEast Un,6022,3,6,3,5,12,10,2,21
Kolkata,6022,4,4,7,3,17,15,2,19
FC Pune City,6022,5,5,4,5,16,17,-1,19
Chennaiyin,6022,6,4,6,4,15,18,-3,18
FC Goa,6022,7,4,3,7,10,16,-6,15
Kerala Blast,6022,8,4,3,7,10,18,-8,15
Mumbai City,6023,1,6,5,3,16,8,8,23
Kerala Blast,6023,2,6,4,4,14,14,0,22
Delhi Dynamo,6023,3,5,6,3,25,16,9,21
FC Pune City,6023,4,5,4,5,15,15,0,19
Chennaiyin,6023,5,4,6,4,16,19,-3,18
NorthEast Un,6023,6,5,2,7,11,13,-2,17
Kolkata,6023,7,3,6,5,14,19,-5,15
FC Goa,6023,8,4,3,7,13,20,-7,15
Mumbai City,6024,1,7,4,3,18,9,9,25
Kolkata,6024,2,5,7,2,17,14,3,22
Kerala Blast,6024,3,6,3,5,11,14,-3,21
Delhi Dynamo,6024,4,5,5,4,24,19,5,20
NorthEast Un,6024,5,6,2,6,14,12,2,20
Chennaiyin,6024,6,4,5,5,15,19,-4,17
FC Pune City,6024,7,4,4,6,13,16,-3,16
FC Goa,6024,8,3,2,9,9,18,-9,11
Mumbai City,6025,1,6,5,3,16,8,8,23
Delhi Dynamo,6025,2,5,6,3,27,19,8,21
Kerala Blast,6025,3,6,3,5,16,14,2,21
Kolkata,6025,3,5,6,3,16,14,2,21
FC Goa,6025,5,6,2,6,15,17,-2,20
NorthEast Un,6025,6,4,3,7,10,14,-4,15
Chennaiyin,6025,7,3,6,5,13,19,-6,15
FC Pune City,6025,8,4,3,7,13,21,-8,15
Mumbai City,6026,1,6,5,3,16,8,8,23
Delhi Dynamo,6026,2,5,7,2,26,17,9,22
Kolkata,6026,3,5,6,3,18,16,2,21
Kerala Blast,6026,4,6,3,5,13,16,-3,21
FC Goa,6026,5,5,3,6,15,18,-3,18
NorthEast Un,6026,6,5,2,7,11,12,-1,17
FC Pune City,6026,7,4,3,7,13,18,-5,15
Chennaiyin,6026,8,3,5,6,13,20,-7,14
Mumbai City,6027,1,7,4,3,18,8,10,25
Delhi Dynamo,6027,2,5,5,4,23,19,4,20
FC Goa,6027,3,6,2,6,13,14,-1,20
FC Pune City,6027,4,5,4,5,14,15,-1,19
Kerala Blast,6027,5,5,4,5,12,16,-4,19
Kolkata,6027,6,4,6,4,17,16,1,18
Chennaiyin,6027,7,4,5,5,15,20,-5,17
NorthEast Un,6027,8,4,2,8,11,15,-4,14
Mumbai City,6028,1,7,4,3,19,8,11,25
Delhi Dynamo,6028,2,5,6,3,24,19,5,21
Kerala Blast,6028,3,6,3,5,13,16,-3,21
Kolkata,6028,4,4,7,3,16,14,2,19
Chennaiyin,6028,5,4,6,4,16,18,-2,18
FC Pune City,6028,6,4,4,6,12,15,-3,16
FC Goa,6028,7,4,4,6,10,15,-5,16
NorthEast Un,6028,8,4,2,8,13,18,-5,14
Mumbai City,6029,1,6,5,3,19,11,8,23
Kerala Blast,6029,2,6,4,4,12,14,-2,22
Delhi Dynamo,6029,3,5,6,3,26,18,8,21
NorthEast Un,6029,4,5,3,6,10,10,0,18
Chennaiyin,6029,5,4,6,4,15,18,-3,18
FC Pune City,6029,6,4,5,5,12,14,-2,17
Kolkata,6029,7,3,7,4,15,18,-3,16
FC Goa,6029,8,4,2,8,13,19,-6,14
Mumbai City,6030,1,6,5,3,16,8,8,23
Kerala Blast,6030,2,6,3,5,14,14,0,21
NorthEast Un,6030,3,6,2,6,14,12,2,20
Chennaiyin,6030,4,5,5,4,19,20,-1,20
Delhi Dynamo,6030,5,4,7,3,23,18,5,19
Kolkata,6030,6,4,7,3,16,16,0,19
FC Pune City,6030,7,4,3,7,12,18,-6,15
FC Goa,6030,8,3,4,7,12,20,-8,13
Mumbai City,6031,1,7,4,3,18,8,10,25
Kerala Blast,6031,2,7,3,4,15,15,0,24
Kolkata,6031,3,4,7,3,20,18,2,19
Delhi Dynamo,6031,4,4,6,4,22,18,4,18
NorthEast Un,6031,5,5,3,6,11,12,-1,18
FC Pune City,6031,6,4,4,6,13,16,-3,16
Chennaiyin,6031,7,3,6,5,13,19,-6,15
FC Goa,6031,8,4,3,7,12,18,-6,15
Mumbai City,6032,1,7,4,3,18,8,10,25
Kerala Blast,6032,2,7,3,4,19,16,3,24
Kolkata,6032,3,5,6,3,19,17,2,21
Delhi Dynamo,6032,4,5,5,4,24,19,5,20
Chennaiyin,6032,5,5,5,4,17,18,-1,20
NorthEast Un,6032,6,5,2,7,12,16,-4,17
FC Pune City,6032,7,4,3,7,12,16,-4,15
FC Goa,6032,8,3,2,9,12,23,-11,11
Delhi Dynamo,6033,1,6,5,3,25,17,8,23
Mumbai City,6033,2,6,4,4,16,10,6,22
Chennaiyin,6033,3,5,5,4,17,17,0,20
FC Pune City,6033,4,5,4,5,13,14,-1,19
Kerala Blast,6033,5,5,4,5,11,15,-4,19
NorthEast Un,6033,6,5,3,6,12,13,-1,18
Kolkata,6033,7,3,7,4,14,15,-1,16
FC Goa,6033,8,4,2,8,11,18,-7,14
Delhi Dynamo,6034,1,6,6,2,29,16,13,24
Kolkata,6034,2,6,6,2,18,14,4,24
Mumbai City,6034,3,6,4,4,16,10,6,22
Kerala Blast,6034,4,5,4,5,13,17,-4,19
NorthEast Un,6034,5,4,5,5,12,12,0,17
FC Pune City,6034,6,4,3,7,14,18,-4,15
Chennaiyin,6034,7,3,6,5,15,21,-6,15
FC Goa,6034,8,4,2,8,14,23,-9,14
Delhi Dynamo,6035,1,6,5,3,26,16,10,23
Mumbai City,6035,2,6,4,4,16,9,7,22
Kerala Blast,6035,3,6,4,4,15,16,-1,22
NorthEast Un,6035,4,6,2,6,14,12,2,20
Kolkata,6035,5,4,7,3,20,20,0,19
FC Goa,6035,6,5,2,7,13,19,-6,17
FC Pune City,6035,7,4,3,7,14,19,-5,15
Chennaiyin,6035,8,3,5,6,13,20,-7,14
Kolkata,6036,1,6,6,2,18,12,6,24
Mumbai City,6036,2,6,5,3,17,9,8,23
Kerala Blast,6036,3,6,3,5,12,16,-4,21
NorthEast Un,6036,4,6,2,6,12,11,1,20
Delhi Dynamo,6036,5,4,7,3,23,18,5,19
FC Pune City,6036,6,4,3,7,12,16,-4,15
Chennaiyin,6036,7,3,6,5,14,19,-5,15
FC Goa,6036,8,3,4,7,10,17,-7,13
Mumbai City,6037,1,6,5,3,18,10,8,23
Delhi Dynamo,6037,2,5,7,2,26,16,10,22
Kerala Blast,6037,3,5,5,4,11,14,-3,20
FC Pune City,6037,4,5,4,5,13,14,-1,19
Chennaiyin,6037,5,4,6,4,14,17,-3,18
Kolkata,6037,6,3,7,4,15,16,-1,16
NorthEast Un,6037,7,4,4,6,9,10,-1,16
FC Goa,6037,8,3,4,7,9,18,-9,13
Delhi Dynamo,6038,1,6,6,2,26,15,11,24
Mumbai City,6038,2,6,4,4,16,9,7,22
Kerala Blast,6038,3,6,3,5,12,15,-3,21
Kolkata,6038,4,4,6,4,17,15,2,18
Chennaiyin,6038,5,4,6,4,17,20,-3,18
FC Pune City,6038,6,5,3,6,13,17,-4,18
NorthEast Un,6038,7,4,3,7,11,15,-4,15
FC Goa,6038,8,4,3,7,11,17,-6,15
Mumbai City,6039,1,7,4,3,18,8,10,25
FC Goa,6039,2,6,2,6,15,17,-2,20
Kolkata,6039,3,4,7,3,16,15,1,19
Kerala Blast,6039,4,5,4,5,13,15,-2,19
Delhi Dynamo,6039,5,4,6,4,24,21,3,18
NorthEast Un,6039,6,5,3,6,14,15,-1,18
FC Pune City,6039,7,4,5,5,13,15,-2,17
Chennaiyin,6039,8,3,5,6,14,21,-7,14
Mumbai City,6040,1,7,4,3,18,9,9,25
Delhi Dynamo,6040,2,6,5,3,25,16,9,23
Kerala Blast,6040,3,6,3,5,13,15,-2,21
NorthEast Un,6040,4,6,2,6,13,11,2,20
Kolkata,6040,5,3,8,3,16,16,0,17
FC Pune City,6040,6,4,4,6,14,18,-4,16
FC Goa,6040,7,4,3,7,12,17,-5,15
Chennaiyin,6040,8,3,5,6,13,22,-9,14
Delhi Dynamo,6041,1,7,5,2,27,16,11,26
Mumbai City,6041,2,6,4,4,18,11,7,22
Kolkata,6041,3,4,8,2,16,14,2,20
Chennaiyin,6041,4,5,5,4,17,17,0,20
FC Pune City,6041,5,5,3,6,14,15,-1,18
NorthEast Un,6041,6,5,2,7,10,13,-3,17
Kerala Blast,6041,7,4,4,6,11,18,-7,16
FC Goa,6041,8,3,3,8,8,17,-9,12
Mumbai City,6042,1,7,4,3,17,8,9,25
Kolkata,6042,2,6,6,2,24,14,10,24
Delhi Dynamo,6042,3,4,7,3,23,17,6,19
NorthEast Un,6042,4,5,4,5,12,11,1,19
Chennaiyin,6042,5,3,7,4,16,20,-4,16
FC Pune City,6042,6,4,4,6,13,18,-5,16
Kerala Blast,6042,7,4,4,6,10,17,-7,16
FC Goa,6042,8,3,4,7,11,21,-10,13
Delhi Dynamo,6043,1,5,7,2,25,17,8,22
Mumbai City,6043,2,6,4,4,16,9,7,22
NorthEast Un,6043,3,5,4,5,13,11,2,19
Kerala Blast,6043,4,5,4,5,12,15,-3,19
FC Goa,6043,5,5,3,6,15,19,-4,18
Kolkata,6043,6,3,8,3,15,15,0,17
FC Pune City,6043,7,4,4,6,12,17,-5,16
Chennaiyin,6043,8,3,6,5,15,20,-5,15
Mumbai City,6044,1,6,5,3,17,9,8,23
Kolkata,6044,2,4,8,2,18,14,4,20
Kerala Blast,6044,3,5,5,4,14,15,-1,20
Delhi Dynamo,6044,4,4,6,4,25,21,4,18
NorthEast Un,6044,5,5,3,6,14,15,-1,18
FC Goa,6044,6,5,3,6,13,17,-4,18
FC Pune City,6044,7,4,4,6,13,18,-5,16
Chennaiyin,6044,8,3,6,5,15,20,-5,15
Mumbai City,6045,1,6,5,3,17,9,8,23
Kerala Blast,6045,2,6,4,4,14,14,0,22
Delhi Dynamo,6045,3,5,6,3,23,16,7,21
Kolkata,6045,4,4,7,3,17,15,2,19
FC Pune City,6045,5,5,3,6,14,16,-2,18
Chennaiyin,6045,6,4,5,5,18,20,-2,17
FC Goa,6045,7,5,2,7,12,16,-4,17
NorthEast Un,6045,8,4,2,8,9,18,-9,14
Mumbai City,6046,1,7,4,3,18,8,10,25
Delhi Dynamo,6046,2,6,5,3,27,16,11,23
Kerala Blast,6046,3,6,3,5,12,16,-4,21
FC Pune City,6046,4,5,4,5,16,16,0,19
Kolkata,6046,5,3,8,3,17,17,0,17
Chennaiyin,6046,6,3,7,4,15,19,-4,16
NorthEast Un,6046,7,4,3,7,10,12,-2,15
FC Goa,6046,8,3,4,7,10,21,-11,13
Mumbai City,6047,1,6,5,3,16,8,8,23
Delhi Dynamo,6047,2,5,7,2,23,15,8,22
Kolkata,6047,3,4,7,3,15,15,0,19
Kerala Blast,6047,4,5,4,5,12,16,-4,19
Chennaiyin,6047,5,4,5,5,17,20,-3,17
FC Goa,6047,6,5,2,7,12,16,-4,17
NorthEast Un,6047,7,4,4,6,12,14,-2,16
FC Pune City,6047,8,4,4,6,12,15,-3,16
Delhi Dynamo,6048,1,6,5,3,27,16,11,23
Mumbai City,6048,2,6,4,4,16,10,6,22
Kolkata,6048,3,5,6,3,17,15,2,21
NorthEast Un,6048,4,6,3,5,14,12,2,21
FC Pune City,6048,5,5,4,5,15,15,0,19
Chennaiyin,6048,6,3,7,4,15,19,-4,16
Kerala Blast,6048,7,4,4,6,10,16,-6,16
FC Goa,6048,8,3,3,8,9,20,-11,12
Mumbai City,6049,1,6,5,3,18,10,8,23
Kolkata,6049,2,5,6,3,19,14,5,21
Delhi Dynamo,6049,3,4,7,3,25,19,6,19
NorthEast Un,6049,4,5,3,6,14,14,0,18
FC Goa,6049,5,5,3,6,11,14,-3,18
Chennaiyin,6049,6,4,5,5,15,20,-5,17
Kerala Blast,6049,7,4,5,5,11,18,-7,17
FC Pune City,6049,8,4,4,6,14,18,-4,16
Delhi Dynamo,6050,1,6,5,3,27,19,8,23
Mumbai City,6050,2,6,4,4,17,11,6,22
FC Pune City,6050,3,6,3,5,14,14,0,21
NorthEast Un,6050,4,6,2,6,15,11,4,20
Kolkata,6050,5,3,8,3,15,15,0,17
Chennaiyin,6050,6,4,5,5,15,19,-4,17
Kerala Blast,6050,7,4,4,6,9,17,-8,16
FC Goa,6050,8,4,3,7,13,19,-6,15
Delhi Dynamo,6051,1,6,6,2,26,17,9,24
Kerala Blast,6051,2,7,3,4,17,14,3,24
Mumbai City,6051,3,6,5,3,18,10,8,23
Kolkata,6051,4,4,6,4,17,17,0,18
FC Pune City,6051,5,5,3,6,14,15,-1,18
Chennaiyin,6051,6,4,5,5,17,18,-1,17
NorthEast Un,6051,7,5,2,7,11,15,-4,17
FC Goa,6051,8,3,2,9,8,22,-14,11
Mumbai City,6052,1,7,4,3,17,8,9,25
Kerala Blast,6052,2,6,4,4,13,14,-1,22
NorthEast Un,6052,3,6,3,5,14,11,3,21
Delhi Dynamo,6052,4,5,5,4,23,17,6,20
Kolkata,6052,5,4,6,4,17,14,3,18
FC Goa,6052,6,5,2,7,11,17,-6,17
FC Pune City,6052,7,4,3,7,12,20,-8,15
Chennaiyin,6052,8,3,5,6,15,21,-6,14
Delhi Dynamo,6053,1,7,5,2,26,15,11,26
Mumbai City,6053,2,6,4,4,16,10,6,22
Kolkata,6053,3,5,6,3,15,13,2,21
Kerala Blast,6053,4,6,3,5,12,15,-3,21
Chennaiyin,6053,5,5,5,4,19,18,1,20
NorthEast Un,6053,6,5,2,7,10,14,-4,17
FC Pune City,6053,7,4,3,7,13,17,-4,15
FC Goa,6053,8,3,2,9,10,19,-9,11
Mumbai City,6054,1,7,4,3,17,8,9,25
Kolkata,6054,2,5,6,3,16,14,2,21
Delhi Dynamo,6054,3,5,5,4,27,21,6,20
Kerala Blast,6054,4,5,4,5,11,15,-4,19
NorthEast Un,6054,5,5,3,6,12,13,-1,18
FC Pune City,6054,6,5,3,6,13,15,-2,18
FC Goa,6054,7,5,2,7,15,17,-2,17
Chennaiyin,6054,8,3,5,6,13,21,-8,14
Mumbai City,6055,1,7,4,3,18,8,10,25
NorthEast Un,6055,2,6,3,5,16,12,4,21
Delhi Dynamo,6055,3,5,5,4,23,19,4,20
Kolkata,6055,4,4,7,3,18,18,0,19
FC Pune City,6055,5,5,3,6,15,17,-2,18
FC Goa,6055,6,5,2,7,11,15,-4,17
Kerala Blast,6055,7,4,4,6,12,19,-7,16
Chennaiyin,6055,8,3,6,5,14,19,-5,15
Mumbai City,6056,1,7,4,3,18,8,10,25
Delhi Dynamo,6056,2,5,6,3,24,17,7,21
Kerala Blast,6056,3,5,5,4,12,15,-3,20
Kolkata,6056,4,4,7,3,18,14,4,19
NorthEast Un,6056,5,5,3,6,14,12,2,18
FC Pune City,6056,6,5,3,6,13,15,-2,18
Chennaiyin,6056,7,3,6,5,13,21,-8,15
FC Goa,6056,8,3,4,7,9,19,-10,13
Mumbai City,6057,1,6,5,3,16,8,8,23
Kolkata,6057,2,5,6,3,17,14,3,21
FC Goa,6057,3,6,2,6,14,14,0,20
Delhi Dynamo,6057,4,4,7,3,22,18,4,19
NorthEast Un,6057,5,5,4,5,13,11,2,19
Kerala Blast,6057,6,5,4,5,12,16,-4,19
FC Pune City,6057,7,4,3,7,12,17,-5,15
Chennaiyin,6057,8,3,5,6,13,21,-8,14
Delhi Dynamo,6058,1,6,6,2,29,17,12,24
Mumbai City,6058,2,6,4,4,16,12,4,22
Kolkata,6058,3,4,8,2,17,14,3,20
Kerala Blast,6058,4,5,5,4,10,13,-3,20
NorthEast Un,6058,5,5,3,6,12,11,1,18
FC Pune City,6058,6,4,4,6,14,17,-3,16
Chennaiyin,6058,7,3,6,5,16,22,-6,15
FC Goa,6058,8,3,4,7,13,21,-8,13
Mumbai City,6059,1,7,4,3,22,10,12,25
Kolkata,6059,2,5,7,2,17,12,5,22
Delhi Dynamo,6059,3,5,6,3,26,21,5,21
NorthEast Un,6059,4,5,3,6,11,10,1,18
Chennaiyin,6059,5,4,6,4,16,19,-3,18
FC Pune City,6059,6,4,5,5,13,15,-2,17
Kerala Blast,6059,7,4,4,6,10,17,-7,16
FC Goa,6059,8,3,3,8,11,22,-11,12
Mumbai City,6060,1,6,5,3,17,9,8,23
Delhi Dynamo,6060,2,5,6,3,23,16,7,21
Kerala Blast,6060,3,6,3,5,14,14,0,21
FC Pune City,6060,4,5,4,5,13,14,-1,19
Kolkata,6060,5,4,7,3,14,16,-2,19
NorthEast Un,6060,6,5,2,7,10,12,-2,17
Chennaiyin,6060,7,4,5,5,15,18,-3,17
FC Goa,6060,8,4,2,8,9,16,-7,14
Mumbai City,6061,1,7,4,3,21,8,13,25
Kolkata,6061,2,5,6,3,19,15,4,21
NorthEast Un,6061,3,6,2,6,14,12,2,20
FC Goa,6061,4,6,2,6,13,15,-2,20
FC Pune City,6061,5,5,3,6,16,19,-3,18
Delhi Dynamo,6061,6,4,5,5,22,22,0,17
Chennaiyin,6061,7,4,5,5,15,20,-5,17
Kerala Blast,6061,8,4,3,7,13,22,-9,15
Mumbai City,6062,1,6,5,3,17,9,8,23
Kolkata,6062,2,5,7,2,18,14,4,22
Delhi Dynamo,6062,3,4,8,2,23,16,7,20
FC Pune City,6062,4,5,4,5,14,15,-1,19
Chennaiyin,6062,5,4,5,5,15,19,-4,17
NorthEast Un,6062,6,4,4,6,11,13,-2,16
Kerala Blast,6062,7,4,4,6,12,19,-7,16
FC Goa,6062,8,4,3,7,11,16,-5,15
Mumbai City,6063,1,7,4,3,18,9,9,25
Kerala Blast,6063,2,7,3,4,15,14,1,24
Delhi Dynamo,6063,3,5,5,4,25,19,6,20
Chennaiyin,6063,4,5,5,4,17,19,-2,20
Kolkata,6063,5,4,7,3,16,15,1,19
NorthEast Un,6063,6,5,2,7,13,13,0,17
FC Pune City,6063,7,4,3,7,12,17,-5,15
FC Goa,6063,8,3,3,8,10,20,-10,12
Mumbai City,6064,1,7,4,3,19,8,11,25
Kolkata,6064,2,6,6,2,19,15,4,24
NorthEast Un,6064,3,6,3,5,13,11,2,21
Delhi Dynamo,6064,4,4,6,4,22,19,3,18
FC Goa,6064,5,5,2,7,13,17,-4,17
FC Pune City,6064,6,4,4,6,13,16,-3,16
Kerala Blast,6064,7,4,4,6,12,18,-6,16
Chennaiyin,6064,8,3,5,6,13,20,-7,14
Mumbai City,6065,1,7,4,3,18,8,10,25
Kolkata,6065,2,5,7,2,17,13,4,22
Delhi Dynamo,6065,3,5,6,3,22,16,6,21
NorthEast Un,6065,4,6,3,5,12,9,3,21
Kerala Blast,6065,5,5,3,6,11,16,-5,18
FC Pune City,6065,6,4,4,6,13,17,-4,16
Chennaiyin,6065,7,3,6,5,14,19,-5,15
FC Goa,6065,8,3,3,8,9,18,-9,12
Mumbai City,6066,1,6,5,3,17,9,8,23
Kerala Blast,6066,2,5,5,4,11,14,-3,20
Delhi Dynamo,6066,3,4,7,3,25,19,6,19
NorthEast Un,6066,4,5,4,5,13,12,1,19
FC Pune City,6066,5,5,3,6,13,15,-2,18
Kolkata,6066,6,3,8,3,14,14,0,17
FC Goa,6066,7,4,4,6,12,17,-5,16
Chennaiyin,6066,8,3,6,5,14,19,-5,15
Delhi Dynamo,6067,1,7,5,2,29,15,14,26
Mumbai City,6067,2,6,4,4,16,10,6,22
Kerala Blast,6067,3,6,4,4,12,14,-2,22
FC Pune City,6067,4,5,4,5,14,15,-1,19
Chennaiyin,6067,5,4,5,5,14,18,-4,17
Kolkata,6067,6,3,7,4,14,15,-1,16
FC Goa,6067,7,4,3,7,11,19,-8,15
NorthEast Un,6067,8,4,2,8,9,13,-4,14
Mumbai City,6068,1,7,4,3,17,8,9,25
Delhi Dynamo,6068,2,5,5,4,23,18,5,20
Kerala Blast,6068,3,5,5,4,14,16,-2,20
FC Pune City,6068,4,5,4,5,16,16,0,19
Kolkata,6068,4,4,7,3,16,16,0,19
NorthEast Un,6068,6,5,3,6,13,13,0,18
Chennaiyin,6068,7,3,6,5,13,20,-7,15
FC Goa,6068,8,4,2,8,13,18,-5,14
Kolkata,6069,1,6,6,2,19,14,5,24
Delhi Dynamo,6069,2,6,5,3,27,20,7,23
Mumbai City,6069,3,6,4,4,17,12,5,22
Kerala Blast,6069,4,6,3,5,17,17,0,21
Chennaiyin,6069,5,5,5,4,16,18,-2,20
NorthEast Un,6069,6,5,2,7,15,14,1,17
FC Pune City,6069,7,4,3,7,12,19,-7,15
FC Goa,6069,8,3,2,9,9,18,-9,11
Mumbai City,6070,1,7,4,3,17,8,9,25
Delhi Dynamo,6070,2,5,5,4,24,19,5,20
Kolkata,6070,3,4,7,3,15,14,1,19
Kerala Blast,6070,4,5,4,5,13,15,-2,19
NorthEast Un,6070,5,5,3,6,14,12,2,18
Chennaiyin,6070,6,4,5,5,16,20,-4,17
FC Goa,6070,7,5,2,7,11,17,-6,17
FC Pune City,6070,8,4,4,6,14,19,-5,16
Mumbai City,6071,1,6,4,4,17,10,7,22
Delhi Dynamo,6071,2,5,5,4,24,22,2,20
Chennaiyin,6071,3,5,5,4,18,18,0,20
Kerala Blast,6071,4,5,5,4,11,14,-3,20
Kolkata,6071,5,4,7,3,14,13,1,19
NorthEast Un,6071,6,5,3,6,11,12,-1,18
FC Pune City,6071,7,5,3,6,14,16,-2,18
FC Goa,6071,8,4,2,8,14,18,-4,14
Mumbai City,6072,1,7,4,3,18,9,9,25
Delhi Dynamo,6072,2,5,6,3,26,17,9,21
NorthEast Un,6072,3,6,2,6,13,14,-1,20
Kolkata,6072,4,4,7,3,16,14,2,19
FC Goa,6072,5,5,3,6,12,16,-4,18
Kerala Blast,6072,6,4,5,5,13,18,-5,17
FC Pune City,6072,7,4,4,6,13,17,-4,16
Chennaiyin,6072,8,3,5,6,14,20,-6,14
Mumbai City,6073,1,7,4,3,18,9,9,25
Delhi Dynamo,6073,2,6,5,3,27,17,10,23
Kerala Blast,6073,3,6,3,5,15,17,-2,21
Kolkata,6073,4,4,6,4,18,17,1,18
FC Pune City,6073,5,5,3,6,16,19,-3,18
Chennaiyin,6073,6,3,7,4,16,20,-4,16
NorthEast Un,6073,7,4,3,7,11,16,-5,15
FC Goa,6073,8,4,3,7,12,18,-6,15
Delhi Dynamo,6074,1,6,6,2,27,16,11,24
Mumbai City,6074,2,6,5,3,17,9,8,23
Kerala Blast,6074,3,6,4,4,17,14,3,22
Kolkata,6074,4,5,7,2,16,13,3,22
Chennaiyin,6074,5,3,6,5,14,19,-5,15
FC Pune City,6074,6,4,3,7,12,18,-6,15
NorthEast Un,6074,7,4,3,7,11,17,-6,15
FC Goa,6074,8,4,2,8,11,19,-8,14
Mumbai City,6075,1,6,5,3,19,11,8,23
Kolkata,6075,2,5,6,3,19,16,3,21
NorthEast Un,6075,3,6,3,5,14,12,2,21
Delhi Dynamo,6075,4,4,8,2,25,18,7,20
FC Pune City,6075,5,5,3,6,16,17,-1,18
Kerala Blast,6075,6,5,3,6,13,20,-7,18
Chennaiyin,6075,7,3,6,5,14,19,-5,15
FC Goa,6075,8,3,4,7,8,15,-7,13
Delhi Dynamo,6076,1,6,6,2,27,18,9,24
Mumbai City,6076,2,6,4,4,17,10,7,22
Kolkata,6076,3,5,7,2,17,14,3,22
Chennaiyin,6076,4,5,5,4,16,17,-1,20
Kerala Blast,6076,5,5,4,5,16,18,-2,19
FC Pune City,6076,6,4,5,5,15,17,-2,17
NorthEast Un,6076,7,4,3,7,11,16,-5,15
FC Goa,6076,8,3,2,9,10,19,-9,11
Mumbai City,6077,1,7,4,3,17,8,9,25
Delhi Dynamo,6077,2,6,5,3,25,17,8,23
Kolkata,6077,3,4,8,2,16,13,3,20
Chennaiyin,6077,4,5,5,4,18,20,-2,20
FC Pune City,6077,5,5,4,5,13,14,-1,19
Kerala Blast,6077,6,5,3,6,11,17,-6,18
NorthEast Un,6077,7,4,2,8,13,16,-3,14
FC Goa,6077,8,3,3,8,11,19,-8,12
Mumbai City,6078,1,7,4,3,18,9,9,25
FC Pune City,6078,2,6,3,5,15,14,1,21
Kerala Blast,6078,3,6,3,5,14,15,-1,21
Delhi Dynamo,6078,4,5,5,4,26,19,7,20
FC Goa,6078,5,6,2,6,15,17,-2,20
Chennaiyin,6078,6,4,5,5,16,21,-5,17
Kolkata,6078,7,3,6,5,14,18,-4,15
NorthEast Un,6078,8,4,2,8,10,15,-5,14
Mumbai City,6079,1,7,4,3,20,9,11,25
Delhi Dynamo,6079,2,5,6,3,27,21,6,21
Kolkata,6079,3,5,6,3,16,15,1,21
FC Pune City,6079,4,6,3,5,15,14,1,21
NorthEast Un,6079,5,4,4,6,9,11,-2,16
Kerala Blast,6079,6,4,4,6,9,15,-6,16
Chennaiyin,6079,7,3,6,5,13,18,-5,15
FC Goa,6079,8,4,3,7,13,19,-6,15
Mumbai City,6080,1,7,4,3,18,9,9,25
Delhi Dynamo,6080,2,5,5,4,26,20,6,20
Kerala Blast,6080,3,5,5,4,11,14,-3,20
Kolkata,6080,4,4,7,3,14,13,1,19
FC Pune City,6080,5,5,4,5,14,15,-1,19
NorthEast Un,6080,6,5,2,7,13,12,1,17
Chennaiyin,6080,7,4,5,5,16,20,-4,17
FC Goa,6080,8,4,2,8,11,20,-9,14
Delhi Dynamo,6081,1,6,6,2,26,16,10,24
Mumbai City,6081,2,6,4,4,17,10,7,22
Kerala Blast,6081,3,6,4,4,14,14,0,22
Kolkata,6081,4,5,6,3,17,15,2,21
NorthEast Un,6081,5,4,4,6,10,11,-1,16
Chennaiyin,6081,6,3,7,4,14,18,-4,16
FC Pune City,6081,7,4,4,6,13,17,-4,16
FC Goa,6081,8,3,3,8,9,19,-10,12
Delhi Dynamo,6082,1,6,6,2,28,16,12,24
Mumbai City,6082,2,6,5,3,17,9,8,23
Kerala Blast,6082,3,5,5,4,16,18,-2,20
Kolkata,6082,4,4,7,3,16,15,1,19
Chennaiyin,6082,5,4,6,4,14,17,-3,18
FC Pune City,6082,6,4,4,6,14,17,-3,16
NorthEast Un,6082,7,4,3,7,11,16,-5,15
FC Goa,6082,8,4,2,8,9,17,-8,14
Delhi Dynamo,6083,1,6,6,2,25,16,9,24
Mumbai City,6083,2,6,4,4,17,10,7,22
FC Pune City,6083,3,6,3,5,14,14,0,21
Kolkata,6083,4,4,6,4,17,14,3,18
FC Goa,6083,5,5,3,6,10,14,-4,18
Chennaiyin,6083,6,4,5,5,15,19,-4,17
Kerala Blast,6083,7,4,4,6,10,19,-9,16
NorthEast Un,6083,8,4,3,7,12,14,-2,15
Mumbai City,6084,1,6,5,3,17,9,8,23
Delhi Dynamo,6084,2,5,7,2,25,17,8,22
Chennaiyin,6084,3,5,5,4,18,19,-1,20
Kerala Blast,6084,4,5,5,4,12,15,-3,20
Kolkata,6084,5,4,6,4,18,17,1,18
NorthEast Un,6084,6,4,4,6,13,14,-1,16
FC Pune City,6084,7,4,4,6,12,17,-5,16
FC Goa,6084,8,4,2,8,12,19,-7,14
Delhi Dynamo,6085,1,6,6,2,28,19,9,24
Mumbai City,6085,2,6,5,3,17,9,8,23
Kolkata,6085,3,5,6,3,19,17,2,21
Kerala Blast,6085,4,5,4,5,10,15,-5,19
NorthEast Un,6085,5,4,4,6,12,13,-1,16
Chennaiyin,6085,6,3,7,4,13,17,-4,16
FC Pune City,6085,7,4,3,7,13,17,-4,15
FC Goa,6085,8,4,3,7,13,18,-5,15
Mumbai City,6086,1,7,4,3,18,9,9,25
Kolkata,6086,2,5,7,2,17,14,3,22
Kerala Blast,6086,3,6,3,5,15,14,1,21
Delhi Dynamo,6086,4,4,7,3,24,18,6,19
Chennaiyin,6086,5,4,6,4,14,17,-3,18
NorthEast Un,6086,6,4,3,7,9,13,-4,15
FC Pune City,6086,7,4,3,7,12,18,-6,15
FC Goa,6086,8,3,5,6,12,18,-6,14
Mumbai City,6087,1,6,5,3,17,9,8,23
Delhi Dynamo,6087,2,5,7,2,25,17,8,22
Kerala Blast,6087,3,6,4,4,14,15,-1,22
Kolkata,6087,4,4,6,4,17,17,0,18
NorthEast Un,6087,5,4,4,6,9,10,-1,16
Chennaiyin,6087,6,3,7,4,13,17,-4,16
FC Goa,6087,7,4,4,6,12,17,-5,16
FC Pune City,6087,8,4,3,7,14,19,-5,15
Delhi Dynamo,6088,1,6,6,2,24,14,10,24
Mumbai City,6088,2,6,4,4,16,10,6,22
Kolkata,6088,3,5,7,2,20,15,5,22
NorthEast Un,6088,4,5,3,6,11,11,0,18
FC Pune City,6088,5,5,3,6,13,17,-4,18
Kerala Blast,6088,6,5,3,6,13,18,-5,18
Chennaiyin,6088,7,4,5,5,15,19,-4,17
FC Goa,6088,8,3,3,8,10,18,-8,12
Kolkata,6089,1,6,6,2,17,12,5,24
Mumbai City,6089,2,6,5,3,18,10,8,23
Delhi Dynamo,6089,3,4,7,3,25,19,6,19
NorthEast Un,6089,4,5,3,6,14,13,1,18
FC Pune City,6089,5,5,3,6,13,15,-2,18
Kerala Blast,6089,6,5,3,6,11,16,-5,18
Chennaiyin,6089,7,3,6,5,14,20,-6,15
FC Goa,6089,8,4,3,7,10,17,-7,15
Mumbai City,6090,1,7,4,3,19,10,9,25
Delhi Dynamo,6090,2,6,5,3,26,17,9,23
Kolkata,6090,3,4,8,2,17,15,2,20
Kerala Blast,6090,4,5,5,4,11,14,-3,20
Chennaiyin,6090,5,4,6,4,14,17,-3,18
FC Pune City,6090,6,4,5,5,15,17,-2,17
NorthEast Un,6090,7,4,2,8,9,13,-4,14
FC Goa,6090,8,3,3,8,9,17,-8,12
Delhi Dynamo,6091,1,7,5,2,27,16,11,26
Mumbai City,6091,2,6,4,4,17,10,7,22
NorthEast Un,6091,3,6,2,6,14,13,1,20
FC Pune City,6091,4,5,4,5,15,16,-1,19
Kerala Blast,6091,5,5,4,5,14,18,-4,19
Kolkata,6091,6,4,6,4,15,15,0,18
FC Goa,6091,7,4,2,8,13,18,-5,14
Chennaiyin,6091,8,3,5,6,14,23,-9,14
Mumbai City,6092,1,7,4,3,17,8,9,25
Delhi Dynamo,6092,2,5,5,4,24,18,6,20
NorthEast Un,6092,3,6,2,6,14,13,1,20
FC Pune City,6092,4,5,4,5,16,16,0,19
Chennaiyin,6092,5,4,6,4,16,17,-1,18
Kolkata,6092,6,3,8,3,16,16,0,17
Kerala Blast,6092,7,4,4,6,10,18,-8,16
FC Goa,6092,8,4,3,7,9,16,-7,15
Mumbai City,6093,1,6,5,3,19,11,8,23
Delhi Dynamo,6093,2,5,6,3,29,20,9,21
Kerala Blast,6093,3,6,3,5,14,17,-3,21
NorthEast Un,6093,4,6,2,6,12,11,1,20
Kolkata,6093,5,4,6,4,19,18,1,18
FC Pune City,6093,6,5,3,6,14,17,-3,18
FC Goa,6093,7,5,2,7,13,20,-7,17
Chennaiyin,6093,8,3,5,6,15,21,-6,14
Delhi Dynamo,6094,1,6,6,2,27,16,11,24
Mumbai City,6094,2,6,4,4,16,11,5,22
NorthEast Un,6094,3,6,3,5,12,10,2,21
Kolkata,6094,4,4,7,3,20,16,4,19
Kerala Blast,6094,5,5,4,5,13,15,-2,19
FC Goa,6094,6,5,2,7,16,19,-3,17
FC Pune City,6094,7,4,3,7,12,21,-9,15
Chennaiyin,6094,8,3,5,6,14,22,-8,14
Kolkata,6095,1,6,6,2,19,14,5,24
Mumbai City,6095,2,6,5,3,16,8,8,23
Delhi Dynamo,6095,3,5,6,3,26,19,7,21
NorthEast Un,6095,4,6,3,5,16,11,5,21
FC Pune City,6095,5,5,3,6,15,17,-2,18
Chennaiyin,6095,6,3,7,4,14,18,-4,16
Kerala Blast,6095,7,4,3,7,11,18,-7,15
FC Goa,6095,8,3,3,8,8,20,-12,12
Mumbai City,6096,1,6,5,3,16,8,8,23
Delhi Dynamo,6096,2,5,6,3,23,16,7,21
Kolkata,6096,3,3,9,2,19,18,1,18
Kerala Blast,6096,4,4,6,4,12,16,-4,18
FC Pune City,6096,5,4,5,5,17,19,-2,17
NorthEast Un,6096,6,4,4,6,11,12,-1,16
Chennaiyin,6096,7,3,7,4,14,18,-4,16
FC Goa,6096,8,4,4,6,11,16,-5,16
Delhi Dynamo,6097,1,7,5,2,30,18,12,26
Kolkata,6097,2,6,6,2,24,13,11,24
Mumbai City,6097,3,6,4,4,18,11,7,22
Chennaiyin,6097,4,5,5,4,15,17,-2,20
FC Pune City,6097,5,5,3,6,14,19,-5,18
NorthEast Un,6097,6,5,2,7,15,15,0,17
Kerala Blast,6097,7,4,3,7,12,24,-12,15
FC Goa,6097,8,3,2,9,9,20,-11,11
Mumbai City,6098,1,7,4,3,19,9,10,25
Kolkata,6098,2,5,7,2,20,16,4,22
Delhi Dynamo,6098,3,5,5,4,24,18,6,20
NorthEast Un,6098,4,6,2,6,13,12,1,20
Kerala Blast,6098,5,5,4,5,13,18,-5,19
Chennaiyin,6098,6,4,5,5,15,19,-4,17
FC Pune City,6098,7,4,4,6,13,16,-3,16
FC Goa,6098,8,3,3,8,11,20,-9,12
Mumbai City,6099,1,7,4,3,17,8,9,25
Kolkata,6099,2,5,7,2,21,14,7,22
Delhi Dynamo,6099,3,5,6,3,23,15,8,21
Kerala Blast,6099,4,5,4,5,13,16,-3,19
FC Pune City,6099,5,5,3,6,14,16,-2,18
NorthEast Un,6099,6,4,3,7,11,15,-4,15
Chennaiyin,6099,7,3,6,5,14,19,-5,15
FC Goa,6099,8,4,3,7,9,19,-10,15
Delhi Dynamo,6100,1,7,5,2,25,14,11,26
Mumbai City,6100,2,6,4,4,16,9,7,22
Kolkata,6100,3,5,7,2,20,15,5,22
Kerala Blast,6100,4,6,3,5,13,16,-3,21
NorthEast Un,6100,5,5,2,7,10,12,-2,17
Chennaiyin,6100,6,4,5,5,15,18,-3,17
FC Pune City,6100,7,4,3,7,13,19,-6,15
FC Goa,6100,8,3,3,8,10,19,-9,12
Mumbai City,6101,1,7,4,3,19,8,11,25
Delhi Dynamo,6101,2,5,5,4,22,19,3,20
NorthEast Un,6101,3,6,2,6,13,11,2,20
FC Goa,6101,4,6,2,6,14,16,-2,20
Kolkata,6101,5,4,6,4,16,15,1,18
FC Pune City,6101,6,5,3,6,14,16,-2,18
Kerala Blast,6101,7,5,3,6,11,17,-6,18
Chennaiyin,6101,8,3,5,6,14,21,-7,14
Delhi Dynamo,6102,1,6,5,3,24,17,7,23
Mumbai City,6102,2,6,4,4,16,10,6,22
FC Pune City,6102,3,6,3,5,15,15,0,21
Kolkata,6102,4,4,7,3,15,14,1,19
NorthEast Un,6102,5,5,3,6,13,11,2,18
Chennaiyin,6102,6,4,5,5,15,21,-6,17
Kerala Blast,6102,7,4,4,6,9,15,-6,16
FC Goa,6102,8,4,3,7,11,15,-4,15
Delhi Dynamo,6103,1,6,6,2,26,17,9,24
Mumbai City,6103,2,6,4,4,17,10,7,22
Kolkata,6103,3,4,7,3,18,18,0,19
FC Pune City,6103,4,5,4,5,15,15,0,19
NorthEast Un,6103,5,5,3,6,12,11,1,18
Kerala Blast,6103,6,5,3,6,11,17,-6,18
Chennaiyin,6103,7,4,5,5,14,19,-5,17
FC Goa,6103,8,4,2,8,13,19,-6,14
Mumbai City,6104,1,6,5,3,16,8,8,23
Delhi Dynamo,6104,2,5,7,2,25,17,8,22
Kolkata,6104,3,5,6,3,18,15,3,21
Kerala Blast,6104,4,5,4,5,12,17,-5,19
Chennaiyin,6104,5,4,6,4,15,18,-3,18
FC Pune City,6104,6,4,4,6,13,16,-3,16
NorthEast Un,6104,7,4,3,7,14,16,-2,15
FC Goa,6104,8,4,3,7,11,17,-6,15
Kerala Blast,6105,1,7,3,4,13,14,-1,24
Mumbai City,6105,2,6,5,3,18,10,8,23
Kolkata,6105,3,5,6,3,21,14,7,21
Delhi Dynamo,6105,4,4,8,2,26,19,7,20
Chennaiyin,6105,5,4,6,4,14,17,-3,18
NorthEast Un,6105,6,4,4,6,10,11,-1,16
FC Pune City,6105,7,4,3,7,12,17,-5,15
FC Goa,6105,8,3,3,8,10,22,-12,12
Mumbai City,6106,1,6,5,3,18,10,8,23
Kerala Blast,6106,2,6,4,4,14,14,0,22
Delhi Dynamo,6106,3,5,6,3,27,21,6,21
Kolkata,6106,4,4,7,3,16,15,1,19
Chennaiyin,6106,5,4,6,4,17,18,-1,18
FC Pune City,6106,6,4,5,5,12,14,-2,17
NorthEast Un,6106,7,5,2,7,12,15,-3,17
FC Goa,6106,8,3,3,8,11,20,-9,12
Mumbai City,6107,1,7,4,3,17,8,9,25
Kerala Blast,6107,2,6,4,4,15,16,-1,22
Delhi Dynamo,6107,3,4,6,4,25,21,4,18
FC Goa,6107,4,5,3,6,18,19,-1,18
FC Pune City,6107,5,5,3,6,15,18,-3,18
NorthEast Un,6107,6,5,2,7,13,13,0,17
Chennaiyin,6107,7,4,5,5,16,23,-7,17
Kolkata,6107,8,3,7,4,17,18,-1,16
Delhi Dynamo,6108,1,6,5,3,27,18,9,23
Mumbai City,6108,2,6,4,4,18,12,6,22
NorthEast Un,6108,3,6,3,5,12,10,2,21
Kolkata,6108,4,4,8,2,17,15,2,20
FC Pune City,6108,5,5,4,5,17,17,0,19
Chennaiyin,6108,6,4,5,5,15,19,-4,17
Kerala Blast,6108,7,4,4,6,10,17,-7,16
FC Goa,6108,8,3,3,8,10,18,-8,12
Delhi Dynamo,6109,1,6,6,2,26,15,11,24
Mumbai City,6109,2,6,4,4,16,9,7,22
Kolkata,6109,3,5,6,3,16,14,2,21
NorthEast Un,6109,4,5,4,5,12,11,1,19
Kerala Blast,6109,5,5,4,5,12,16,-4,19
FC Pune City,6109,6,5,3,6,13,15,-2,18
Chennaiyin,6109,7,3,5,6,14,20,-6,14
FC Goa,6109,8,4,2,8,10,19,-9,14
Mumbai City,6110,1,7,4,3,19,10,9,25
Kolkata,6110,2,5,6,3,20,16,4,21
FC Pune City,6110,3,6,3,5,16,16,0,21
Delhi Dynamo,6110,4,5,5,4,25,21,4,20
NorthEast Un,6110,5,5,3,6,13,12,1,18
Chennaiyin,6110,6,4,6,4,15,18,-3,18
Kerala Blast,6110,7,5,3,6,13,18,-5,18
FC Goa,6110,8,3,2,9,10,20,-10,11
Delhi Dynamo,6111,1,6,6,2,30,21,9,24
Mumbai City,6111,2,6,5,3,17,9,8,23
Kolkata,6111,3,5,7,2,18,14,4,22
Kerala Blast,6111,4,6,3,5,15,16,-1,21
Chennaiyin,6111,5,4,5,5,16,21,-5,17
FC Goa,6111,6,4,3,7,16,21,-5,15
FC Pune City,6111,7,4,3,7,15,22,-7,15
NorthEast Un,6111,8,4,2,8,12,15,-3,14
Mumbai City,6112,1,6,5,3,16,8,8,23
Delhi Dynamo,6112,2,5,7,2,24,16,8,22
Kerala Blast,6112,3,6,4,4,13,15,-2,22
FC Pune City,6112,4,4,5,5,14,16,-2,17
FC Goa,6112,5,5,2,7,12,16,-4,17
Chennaiyin,6112,6,4,5,5,14,19,-5,17
Kolkata,6112,7,3,7,4,14,15,-1,16
NorthEast Un,6112,8,4,3,7,11,13,-2,15
Mumbai City,6113,1,7,4,3,17,8,9,25
Kerala Blast,6113,2,6,4,4,12,14,-2,22
Kolkata,6113,3,4,7,3,17,16,1,19
Delhi Dynamo,6113,4,4,6,4,22,18,4,18
NorthEast Un,6113,5,5,3,6,13,13,0,18
Chennaiyin,6113,6,4,5,5,16,19,-3,17
FC Goa,6113,7,4,4,6,11,16,-5,16
FC Pune City,6113,8,4,3,7,12,16,-4,15
Mumbai City,6114,1,6,4,4,16,9,7,22
Kolkata,6114,2,5,7,2,17,12,5,22
Delhi Dynamo,6114,3,5,5,4,24,18,6,20
NorthEast Un,6114,4,6,2,6,14,13,1,20
Kerala Blast,6114,5,5,5,4,13,16,-3,20
Chennaiyin,6114,6,4,5,5,15,19,-4,17
FC Pune City,6114,7,4,4,6,14,18,-4,16
FC Goa,6114,8,4,2,8,10,18,-8,14
Delhi Dynamo,6115,1,6,5,3,24,16,8,23
Mumbai City,6115,2,6,4,4,16,9,7,22
Kerala Blast,6115,3,6,3,5,15,15,0,21
FC Pune City,6115,4,6,3,5,14,14,0,21
NorthEast Un,6115,5,6,2,6,13,13,0,20
Kolkata,6115,6,3,7,4,14,17,-3,16
Chennaiyin,6115,7,3,6,5,16,21,-5,15
FC Goa,6115,8,3,4,7,10,17,-7,13
Delhi Dynamo,6116,1,7,5,2,30,16,14,26
Mumbai City,6116,2,6,4,4,16,9,7,22
Kerala Blast,6116,3,6,4,4,16,16,0,22
Kolkata,6116,4,5,6,3,18,16,2,21
Chennaiyin,6116,5,4,6,4,17,19,-2,18
FC Pune City,6116,6,4,4,6,14,17,-3,16
NorthEast Un,6116,7,4,2,8,12,19,-7,14
FC Goa,6116,8,3,3,8,10,21,-11,12
Delhi Dynamo,6117,1,6,6,2,27,17,10,24
Kolkata,6117,2,6,6,2,20,14,6,24
Mumbai City,6117,3,6,4,4,16,10,6,22
Kerala Blast,6117,4,6,3,5,14,17,-3,21
NorthEast Un,6117,5,5,2,7,14,14,0,17
Chennaiyin,6117,6,4,5,5,16,20,-4,17
FC Pune City,6117,7,4,3,7,12,16,-4,15
FC Goa,6117,8,3,3,8,9,20,-11,12
Delhi Dynamo,6118,1,7,5,2,26,15,11,26
Mumbai City,6118,2,6,4,4,16,9,7,22
Kerala Blast,6118,3,6,4,4,15,15,0,22
Chennaiyin,6118,4,5,5,4,17,18,-1,20
Kolkata,6118,5,4,6,4,16,17,-1,18
FC Pune City,6118,6,4,4,6,12,15,-3,16
NorthEast Un,6118,7,4,2,8,9,13,-4,14
FC Goa,6118,8,4,2,8,11,20,-9,14
Mumbai City,6119,1,7,4,3,17,8,9,25
Kolkata,6119,2,6,6,2,19,14,5,24
NorthEast Un,6119,3,6,2,6,15,13,2,20
Kerala Blast,6119,4,5,4,5,14,18,-4,19
Delhi Dynamo,6119,5,4,6,4,22,18,4,18
FC Pune City,6119,6,4,4,6,12,16,-4,16
FC Goa,6119,7,4,3,7,11,17,-6,15
Chennaiyin,6119,8,3,5,6,15,21,-6,14
Mumbai City,6120,1,7,4,3,20,9,11,25
Delhi Dynamo,6120,2,6,5,3,26,19,7,23
Kolkata,6120,3,4,7,3,17,18,-1,19
FC Pune City,6120,4,5,4,5,13,14,-1,19
Chennaiyin,6120,5,4,6,4,16,17,-1,18
Kerala Blast,6120,6,5,3,6,11,17,-6,18
NorthEast Un,6120,7,4,3,7,9,11,-2,15
FC Goa,6120,8,4,2,8,14,21,-7,14
Mumbai City,6121,1,7,4,3,18,8,10,25
Kerala Blast,6121,2,6,3,5,13,15,-2,21
NorthEast Un,6121,3,6,2,6,15,11,4,20
Kolkata,6121,4,4,6,4,15,15,0,18
FC Pune City,6121,5,5,3,6,14,17,-3,18
FC Goa,6121,6,5,3,6,12,15,-3,18
Delhi Dynamo,6121,7,4,5,5,21,22,-1,17
Chennaiyin,6121,8,3,6,5,14,19,-5,15
Mumbai City,6122,1,7,4,3,19,9,10,25
Delhi Dynamo,6122,2,5,5,4,26,19,7,20
Chennaiyin,6122,3,5,5,4,15,17,-2,20
Kerala Blast,6122,4,5,5,4,11,14,-3,20
Kolkata,6122,5,3,8,3,15,15,0,17
FC Goa,6122,6,5,2,7,11,16,-5,17
FC Pune City,6122,7,4,4,6,13,16,-3,16
NorthEast Un,6122,8,4,3,7,9,13,-4,15
Mumbai City,6123,1,6,5,3,17,9,8,23
Delhi Dynamo,6123,2,5,7,2,26,17,9,22
Chennaiyin,6123,3,5,5,4,17,19,-2,20
Kolkata,6123,4,4,7,3,14,13,1,19
Kerala Blast,6123,5,5,4,5,11,15,-4,19
FC Pune City,6123,6,4,5,5,12,14,-2,17
NorthEast Un,6123,6,5,2,7,12,14,-2,17
FC Goa,6123,8,3,3,8,11,19,-8,12
Mumbai City,6124,1,7,4,3,19,8,11,25
Delhi Dynamo,6124,2,6,5,3,23,17,6,23
Kerala Blast,6124,3,5,5,4,14,15,-1,20
Kolkata,6124,4,4,7,3,18,18,0,19
NorthEast Un,6124,5,5,3,6,11,11,0,18
FC Pune City,6124,6,4,5,5,13,15,-2,17
Chennaiyin,6124,7,3,6,5,14,19,-5,15
FC Goa,6124,8,3,3,8,10,19,-9,12
Mumbai City,6125,1,6,5,3,17,9,8,23
Delhi Dynamo,6125,2,5,7,2,24,16,8,22
NorthEast Un,6125,3,5,4,5,12,10,2,19
Kolkata,6125,4,4,7,3,16,16,0,19
Kerala Blast,6125,5,4,6,4,10,14,-4,18
FC Goa,6125,6,5,2,7,12,15,-3,17
FC Pune City,6125,7,4,4,6,13,16,-3,16
Chennaiyin,6125,8,3,5,6,13,21,-8,14
Mumbai City,6126,1,7,4,3,17,8,9,25
Kolkata,6126,2,6,6,2,18,12,6,24
Delhi Dynamo,6126,3,6,5,3,24,16,8,23
Kerala Blast,6126,4,5,4,5,11,17,-6,19
NorthEast Un,6126,5,4,4,6,11,12,-1,16
Chennaiyin,6126,6,3,7,4,15,19,-4,16
FC Pune City,6126,7,4,3,7,12,16,-4,15
FC Goa,6126,8,3,3,8,10,18,-8,12
Mumbai City,6127,1,7,4,3,20,9,11,25
Kerala Blast,6127,2,6,4,4,15,16,-1,22
Delhi Dynamo,6127,3,5,6,3,28,21,7,21
Kolkata,6127,4,4,8,2,19,15,4,20
NorthEast Un,6127,5,5,3,6,13,14,-1,18
FC Pune City,6127,6,4,4,6,15,18,-3,16
Chennaiyin,6127,7,3,5,6,13,19,-6,14
FC Goa,6127,8,4,2,8,10,21,-11,14
Mumbai City,6128,1,6,5,3,16,8,8,23
Delhi Dynamo,6128,2,5,7,2,25,15,10,22
Chennaiyin,6128,3,5,5,4,19,17,2,20
Kolkata,6128,4,4,8,2,16,14,2,20
Kerala Blast,6128,5,5,4,5,14,14,0,19
FC Pune City,6128,6,4,5,5,13,15,-2,17
NorthEast Un,6128,7,4,3,7,10,19,-9,15
FC Goa,6128,8,3,3,8,9,20,-11,12
Delhi Dynamo,6129,1,7,5,2,29,17,12,26
Mumbai City,6129,2,6,4,4,17,12,5,22
Kerala Blast,6129,3,6,4,4,13,14,-1,22
Kolkata,6129,4,4,8,2,16,13,3,20
FC Pune City,6129,5,4,4,6,13,17,-4,16
NorthEast Un,6129,6,4,3,7,15,17,-2,15
Chennaiyin,6129,7,3,6,5,17,22,-5,15
FC Goa,6129,8,4,2,8,10,18,-8,14
Mumbai City,6130,1,6,5,3,16,8,8,23
Delhi Dynamo,6130,2,5,7,2,26,17,9,22
Kolkata,6130,3,5,6,3,18,13,5,21
Chennaiyin,6130,4,5,5,4,16,18,-2,20
NorthEast Un,6130,5,5,3,6,14,14,0,18
Kerala Blast,6130,6,5,3,6,13,17,-4,18
FC Pune City,6130,7,4,3,7,12,20,-8,15
FC Goa,6130,8,4,2,8,11,19,-8,14
Delhi Dynamo,6131,1,7,5,2,27,16,11,26
Mumbai City,6131,2,6,4,4,16,9,7,22
Kerala Blast,6131,3,6,4,4,13,15,-2,22
Kolkata,6131,4,5,6,3,16,14,2,21
NorthEast Un,6131,5,5,2,7,12,14,-2,17
FC Pune City,6131,6,4,4,6,12,15,-3,16
Chennaiyin,6131,7,3,6,5,14,19,-5,15
FC Goa,6131,8,3,3,8,12,20,-8,12
Mumbai City,6132,1,7,4,3,18,9,9,25
Kerala Blast,6132,2,7,3,4,17,14,3,24
Kolkata,6132,3,5,6,3,16,14,2,21
Delhi Dynamo,6132,4,4,6,4,23,21,2,18
NorthEast Un,6132,5,5,3,6,14,13,1,18
Chennaiyin,6132,6,3,6,5,15,20,-5,15
FC Pune City,6132,7,4,3,7,13,19,-6,15
FC Goa,6132,8,4,3,7,11,17,-6,15
Mumbai City,6133,1,7,4,3,18,8,10,25
Kolkata,6133,2,4,7,3,15,15,0,19
Delhi Dynamo,6133,3,4,6,4,24,21,3,18
FC Goa,6133,4,5,3,6,14,16,-2,18
NorthEast Un,6133,5,4,5,5,12,12,0,17
FC Pune City,6133,6,4,5,5,14,16,-2,17
Kerala Blast,6133,7,4,5,5,10,15,-5,17
Chennaiyin,6133,8,3,7,4,15,19,-4,16
Mumbai City,6134,1,6,5,3,17,9,8,23
Kolkata,6134,2,5,7,2,17,13,4,22
Delhi Dynamo,6134,3,5,6,3,23,18,5,21
Kerala Blast,6134,4,6,3,5,13,17,-4,21
NorthEast Un,6134,5,5,3,6,14,12,2,18
FC Pune City,6134,6,4,4,6,14,17,-3,16
Chennaiyin,6134,7,3,7,4,15,19,-4,16
FC Goa,6134,8,3,3,8,9,17,-8,12
Mumbai City,6135,1,7,4,3,19,8,11,25
Delhi Dynamo,6135,2,5,6,3,27,19,8,21
Kolkata,6135,3,5,6,3,18,15,3,21
Chennaiyin,6135,4,5,5,4,16,18,-2,20
Kerala Blast,6135,5,5,4,5,13,17,-4,19
FC Pune City,6135,6,5,3,6,14,16,-2,18
NorthEast Un,6135,7,4,4,6,11,12,-1,16
FC Goa,6135,8,3,2,9,9,22,-13,11
Mumbai City,6136,1,7,4,3,19,9,10,25
Kerala Blast,6136,2,6,3,5,15,17,-2,21
Kolkata,6136,3,4,8,2,15,13,2,20
Chennaiyin,6136,4,5,5,4,17,18,-1,20
Delhi Dynamo,6136,5,4,6,4,25,21,4,18
FC Pune City,6136,6,4,4,6,14,17,-3,16
NorthEast Un,6136,7,4,3,7,11,15,-4,15
FC Goa,6136,8,4,3,7,11,17,-6,15
Mumbai City,6137,1,7,4,3,21,10,11,25
Kolkata,6137,2,5,7,2,18,13,5,22
Delhi Dynamo,6137,3,5,5,4,27,22,5,20
NorthEast Un,6137,4,6,2,6,12,12,0,20
Chennaiyin,6137,5,5,5,4,17,18,-1,20
Kerala Blast,6137,6,5,3,6,12,17,-5,18
FC Pune City,6137,7,4,4,6,14,18,-4,16
FC Goa,6137,8,3,2,9,10,21,-11,11
Mumbai City,6138,1,6,4,4,17,13,4,22
Delhi Dynamo,6138,2,5,6,3,27,17,10,21
Kerala Blast,6138,3,5,5,4,14,16,-2,20
Kolkata,6138,4,4,7,3,15,17,-2,19
Chennaiyin,6138,5,4,6,4,16,18,-2,18
FC Goa,6138,6,5,2,7,13,16,-3,17
NorthEast Un,6138,7,4,4,6,12,14,-2,16
FC Pune City,6138,8,4,4,6,13,16,-3,16
Delhi Dynamo,6139,1,6,5,3,27,18,9,23
Mumbai City,6139,2,6,4,4,18,12,6,22
Kerala Blast,6139,3,6,4,4,15,16,-1,22
FC Goa,6139,4,6,2,6,12,15,-3,20
Kolkata,6139,5,4,6,4,18,17,1,18
Chennaiyin,6139,6,4,5,5,14,18,-4,17
NorthEast Un,6139,7,4,3,7,10,12,-2,15
FC Pune City,6139,8,4,3,7,14,20,-6,15
Mumbai City,6140,1,7,4,3,19,8,11,25
Delhi Dynamo,6140,2,6,5,3,24,17,7,23
Kerala Blast,6140,3,6,3,5,14,17,-3,21
Kolkata,6140,4,4,6,4,17,17,0,18
NorthEast Un,6140,5,5,3,6,12,12,0,18
Chennaiyin,6140,6,3,7,4,15,19,-4,16
FC Goa,6140,7,4,3,7,12,17,-5,15
FC Pune City,6140,8,4,3,7,15,21,-6,15
Delhi Dynamo,6141,1,6,6,2,26,16,10,24
Mumbai City,6141,2,6,5,3,17,9,8,23
Kolkata,6141,3,5,6,3,18,15,3,21
NorthEast Un,6141,4,5,2,7,12,14,-2,17
FC Goa,6141,5,5,2,7,12,15,-3,17
Chennaiyin,6141,6,4,5,5,15,20,-5,17
FC Pune City,6141,7,4,4,6,14,18,-4,16
Kerala Blast,6141,8,4,4,6,10,17,-7,16
Mumbai City,6142,1,6,4,4,16,10,6,22
Delhi Dynamo,6142,2,5,6,3,23,15,8,21
Kolkata,6142,3,4,8,2,18,15,3,20
Kerala Blast,6142,4,5,5,4,12,14,-2,20
NorthEast Un,6142,5,5,3,6,12,13,-1,18
Chennaiyin,6142,6,4,5,5,17,20,-3,17
FC Goa,6142,7,4,4,6,13,18,-5,16
FC Pune City,6142,8,4,3,7,12,18,-6,15
Delhi Dynamo,6143,1,6,6,2,27,17,10,24
Mumbai City,6143,2,6,4,4,16,10,6,22
Kolkata,6143,3,4,6,4,20,17,3,18
NorthEast Un,6143,4,5,3,6,13,14,-1,18
FC Pune City,6143,5,5,3,6,16,20,-4,18
Kerala Blast,6143,6,5,3,6,14,20,-6,18
Chennaiyin,6143,7,4,5,5,15,19,-4,17
FC Goa,6143,8,5,2,7,13,17,-4,17
Mumbai City,6144,1,7,4,3,19,9,10,25
Kolkata,6144,2,5,7,2,17,14,3,22
Delhi Dynamo,6144,3,4,6,4,23,19,4,18
Chennaiyin,6144,4,4,6,4,17,17,0,18
FC Pune City,6144,5,5,3,6,13,15,-2,18
NorthEast Un,6144,6,4,4,6,11,15,-4,16
FC Goa,6144,7,4,4,6,10,15,-5,16
Kerala Blast,6144,8,4,4,6,11,17,-6,16
Kerala Blast,6145,1,7,3,4,14,13,1,24
Mumbai City,6145,2,6,5,3,16,8,8,23
NorthEast Un,6145,3,6,2,6,13,12,1,20
Delhi Dynamo,6145,4,4,6,4,23,18,5,18
Kolkata,6145,5,3,8,3,17,18,-1,17
FC Pune City,6145,6,4,4,6,16,19,-3,16
FC Goa,6145,7,4,4,6,12,17,-5,16
Chennaiyin,6145,8,3,6,5,15,21,-6,15
Mumbai City,6146,1,7,4,3,23,9,14,25
Delhi Dynamo,6146,2,5,6,3,28,23,5,21
Kerala Blast,6146,3,5,5,4,13,16,-3,20
Kolkata,6146,4,4,7,3,16,15,1,19
FC Goa,6146,5,5,2,7,11,19,-8,17
NorthEast Un,6146,6,4,4,6,12,13,-1,16
FC Pune City,6146,7,4,4,6,15,18,-3,16
Chennaiyin,6146,8,3,6,5,15,20,-5,15
Mumbai City,6147,1,7,4,3,17,8,9,25
Delhi Dynamo,6147,2,6,5,3,26,16,10,23
Kolkata,6147,3,4,7,3,14,15,-1,19
Kerala Blast,6147,4,5,4,5,12,16,-4,19
FC Pune City,6147,5,4,5,5,14,16,-2,17
FC Goa,6147,6,5,2,7,13,16,-3,17
Chennaiyin,6147,7,4,5,5,14,19,-5,17
NorthEast Un,6147,8,4,2,8,10,14,-4,14
Mumbai City,6148,1,7,4,3,19,9,10,25
Kolkata,6148,2,5,6,3,18,16,2,21
Delhi Dynamo,6148,3,5,5,4,25,18,7,20
NorthEast Un,6148,4,6,2,6,13,11,2,20
FC Pune City,6148,5,5,4,5,17,15,2,19
Chennaiyin,6148,6,4,5,5,17,22,-5,17
Kerala Blast,6148,7,4,4,6,10,20,-10,16
FC Goa,6148,8,4,2,8,12,20,-8,14
Mumbai City,6149,1,7,4,3,19,8,11,25
FC Pune City,6149,2,6,3,5,16,16,0,21
Delhi Dynamo,6149,3,4,7,3,23,19,4,19
NorthEast Un,6149,4,5,4,5,11,10,1,19
Kolkata,6149,5,4,6,4,16,17,-1,18
FC Goa,6149,6,5,3,6,13,15,-2,18
Chennaiyin,6149,7,3,6,5,13,19,-6,15
Kerala Blast,6149,8,4,3,7,11,18,-7,15
Kerala Blast,6150,1,7,3,4,18,15,3,24
Mumbai City,6150,2,6,5,3,17,9,8,23
Delhi Dynamo,6150,3,5,7,2,25,17,8,22
Chennaiyin,6150,4,5,5,4,16,17,-1,20
FC Pune City,6150,5,4,4,6,15,18,-3,16
Kolkata,6150,6,3,7,4,16,20,-4,16
NorthEast Un,6150,7,4,3,7,10,15,-5,15
FC Goa,6150,8,4,2,8,13,19,-6,14
Mumbai City,6151,1,6,5,3,18,10,8,23
Delhi Dynamo,6151,2,4,7,3,25,19,6,19
FC Pune City,6151,3,5,4,5,17,16,1,19
Kerala Blast,6151,4,5,4,5,12,18,-6,19
NorthEast Un,6151,5,5,3,6,11,11,0,18
Chennaiyin,6151,6,4,6,4,16,18,-2,18
Kolkata,6151,7,3,8,3,15,15,0,17
FC Goa,6151,8,4,3,7,11,18,-7,15
Mumbai City,6152,1,7,4,3,17,8,9,25
Kerala Blast,6152,2,5,5,4,15,17,-2,20
Delhi Dynamo,6152,3,4,7,3,21,15,6,19
FC Pune City,6152,4,5,4,5,15,16,-1,19
FC Goa,6152,5,5,3,6,14,16,-2,18
Chennaiyin,6152,6,4,5,5,17,21,-4,17
Kolkata,6152,7,3,7,4,16,18,-2,16
NorthEast Un,6152,8,4,3,7,10,14,-4,15
Delhi Dynamo,6153,1,7,5,2,30,17,13,26
Mumbai City,6153,2,6,4,4,17,10,7,22
Kerala Blast,6153,3,6,3,5,14,16,-2,21
Chennaiyin,6153,4,5,5,4,17,18,-1,20
Kolkata,6153,5,4,6,4,18,18,0,18
NorthEast Un,6153,6,5,2,7,12,17,-5,17
FC Pune City,6153,7,4,3,7,13,20,-7,15
FC Goa,6153,8,4,2,8,13,18,-5,14
Delhi Dynamo,6154,1,6,6,2,30,15,15,24
Kolkata,6154,2,6,6,2,20,14,6,24
Mumbai City,6154,3,6,4,4,16,12,4,22
NorthEast Un,6154,4,5,3,6,11,11,0,18
Kerala Blast,6154,5,5,3,6,13,17,-4,18
Chennaiyin,6154,6,4,5,5,14,20,-6,17
FC Pune City,6154,7,4,3,7,13,19,-6,15
FC Goa,6154,8,4,2,8,11,20,-9,14
Mumbai City,6155,1,7,4,3,19,10,9,25
Kerala Blast,6155,2,7,3,4,18,14,4,24
Delhi Dynamo,6155,3,6,5,3,30,21,9,23
Kolkata,6155,4,4,6,4,16,19,-3,18
NorthEast Un,6155,5,5,2,7,13,16,-3,17
Chennaiyin,6155,6,4,5,5,16,20,-4,17
FC Pune City,6155,7,4,3,7,14,19,-5,15
FC Goa,6155,8,4,2,8,13,20,-7,14
Mumbai City,6156,1,6,5,3,17,9,8,23
Kolkata,6156,2,5,7,2,16,13,3,22
Delhi Dynamo,6156,3,5,6,3,25,20,5,21
NorthEast Un,6156,4,6,2,6,16,13,3,20
Chennaiyin,6156,5,5,5,4,17,19,-2,20
FC Pune City,6156,6,5,3,6,13,15,-2,18
Kerala Blast,6156,7,4,4,6,10,16,-6,16
FC Goa,6156,8,3,2,9,9,18,-9,11
Mumbai City,6157,1,7,4,3,18,8,10,25
Kolkata,6157,2,6,6,2,19,13,6,24
NorthEast Un,6157,3,6,3,5,14,12,2,21
Delhi Dynamo,6157,4,5,5,4,26,21,5,20
FC Pune City,6157,5,5,3,6,15,17,-2,18
Chennaiyin,6157,6,4,5,5,15,19,-4,17
Kerala Blast,6157,7,4,4,6,10,18,-8,16
FC Goa,6157,8,3,2,9,11,20,-9,11
Mumbai City,6158,1,7,4,3,20,9,11,25
Delhi Dynamo,6158,2,5,6,3,23,18,5,21
Kolkata,6158,3,5,6,3,18,15,3,21
Kerala Blast,6158,4,6,3,5,15,17,-2,21
FC Goa,6158,5,5,3,6,11,14,-3,18
NorthEast Un,6158,6,5,2,7,11,11,0,17
FC Pune City,6158,7,4,3,7,13,19,-6,15
Chennaiyin,6158,8,3,5,6,13,21,-8,14
Delhi Dynamo,6159,1,6,5,3,27,19,8,23
Mumbai City,6159,2,6,4,4,17,10,7,22
NorthEast Un,6159,3,6,2,6,13,12,1,20
Kerala Blast,6159,4,5,4,5,10,14,-4,19
FC Pune City,6159,5,5,3,6,13,15,-2,18
Chennaiyin,6159,6,4,5,5,16,20,-4,17
FC Goa,6159,7,5,2,7,13,18,-5,17
Kolkata,6159,8,3,7,4,13,14,-1,16
Mumbai City,6160,1,7,4,3,19,8,11,25
Kolkata,6160,2,5,7,2,19,14,5,22
Delhi Dynamo,6160,3,5,6,3,25,19,6,21
Kerala Blast,6160,4,6,3,5,14,17,-3,21
NorthEast Un,6160,5,5,3,6,15,14,1,18
Chennaiyin,6160,6,4,5,5,18,21,-3,17
FC Pune City,6160,7,4,3,7,13,19,-6,15
FC Goa,6160,8,3,3,8,10,21,-11,12
Delhi Dynamo,6161,1,6,5,3,24,17,7,23
Mumbai City,6161,2,6,4,4,16,9,7,22
NorthEast Un,6161,3,6,2,6,13,13,0,20
FC Pune City,6161,4,5,4,5,15,15,0,19
Kerala Blast,6161,5,5,3,6,11,16,-5,18
Chennaiyin,6161,6,4,5,5,17,19,-2,17
FC Goa,6161,7,5,2,7,13,16,-3,17
Kolkata,6161,8,3,7,4,14,18,-4,16
Mumbai City,6162,1,6,4,4,16,10,6,22
Kolkata,6162,2,5,6,3,17,14,3,21
FC Pune City,6162,3,6,3,5,15,15,0,21
Delhi Dynamo,6162,4,5,5,4,23,17,6,20
NorthEast Un,6162,5,6,2,6,14,14,0,20
Chennaiyin,6162,6,4,5,5,17,20,-3,17
FC Goa,6162,7,5,2,7,13,18,-5,17
Kerala Blast,6162,8,4,3,7,12,19,-7,15
Mumbai City,6163,1,6,4,4,18,11,7,22
NorthEast Un,6163,2,6,3,5,15,10,5,21
Delhi Dynamo,6163,3,5,6,3,25,21,4,21
Kerala Blast,6163,4,5,4,5,13,16,-3,19
FC Pune City,6163,5,5,3,6,13,16,-3,18
Kolkata,6163,6,3,8,3,16,16,0,17
FC Goa,6163,7,4,4,6,14,19,-5,16
Chennaiyin,6163,8,3,6,5,17,22,-5,15
Mumbai City,6164,1,7,4,3,17,8,9,25
NorthEast Un,6164,2,6,3,5,12,10,2,21
Delhi Dynamo,6164,3,5,5,4,24,18,6,20
Kolkata,6164,4,4,8,2,15,13,2,20
FC Pune City,6164,5,4,5,5,13,15,-2,17
Chennaiyin,6164,6,4,5,5,16,19,-3,17
Kerala Blast,6164,7,4,5,5,10,15,-5,17
FC Goa,6164,8,3,3,8,11,20,-9,12
Delhi Dynamo,6165,1,6,5,3,27,18,9,23
Mumbai City,6165,2,6,4,4,16,10,6,22
Kolkata,6165,3,4,8,2,16,14,2,20
Kerala Blast,6165,4,5,5,4,12,15,-3,20
NorthEast Un,6165,5,5,3,6,13,13,0,18
FC Pune City,6165,6,4,5,5,13,15,-2,17
Chennaiyin,6165,7,3,6,5,15,22,-7,15
FC Goa,6165,8,4,2,8,14,19,-5,14
Delhi Dynamo,6166,1,7,5,2,29,18,11,26
Mumbai City,6166,2,6,4,4,16,9,7,22
Kolkata,6166,3,5,6,3,17,14,3,21
FC Pune City,6166,4,5,3,6,13,17,-4,18
Kerala Blast,6166,5,5,3,6,10,15,-5,18
Chennaiyin,6166,6,3,7,4,13,17,-4,16
NorthEast Un,6166,7,4,3,7,11,14,-3,15
FC Goa,6166,8,4,3,7,12,17,-5,15
Delhi Dynamo,6167,1,6,6,2,28,16,12,24
Mumbai City,6167,2,6,4,4,17,10,7,22
Kolkata,6167,3,5,6,3,17,13,4,21
Chennaiyin,6167,4,4,5,5,15,19,-4,17
Kerala Blast,6167,5,4,5,5,11,17,-6,17
FC Goa,6167,6,5,2,7,11,19,-8,17
NorthEast Un,6167,7,4,4,6,11,12,-1,16
FC Pune City,6167,8,4,4,6,13,17,-4,16
Mumbai City,6168,1,6,5,3,16,8,8,23
Delhi Dynamo,6168,2,5,6,3,24,19,5,21
Kolkata,6168,3,4,7,3,17,15,2,19
Kerala Blast,6168,4,5,4,5,13,17,-4,19
NorthEast Un,6168,5,5,3,6,11,11,0,18
FC Goa,6168,6,5,2,7,15,18,-3,17
Chennaiyin,6168,7,4,5,5,15,19,-4,17
FC Pune City,6168,8,4,4,6,15,19,-4,16
Mumbai City,6169,1,7,4,3,17,8,9,25
Delhi Dynamo,6169,2,6,5,3,28,16,12,23
Kolkata,6169,3,5,6,3,17,13,4,21
FC Pune City,6169,4,5,3,6,13,17,-4,18
Kerala Blast,6169,5,5,3,6,10,15,-5,18
FC Goa,6169,6,5,2,7,14,19,-5,17
Chennaiyin,6169,7,4,5,5,15,21,-6,17
NorthEast Un,6169,8,4,2,8,9,14,-5,14
Mumbai City,6170,1,7,4,3,20,8,12,25
Delhi Dynamo,6170,2,5,6,3,27,19,8,21
FC Pune City,6170,3,6,3,5,16,16,0,21
Kolkata,6170,4,4,6,4,16,15,1,18
Kerala Blast,6170,5,5,3,6,11,17,-6,18
Chennaiyin,6170,6,4,5,5,15,19,-4,17
FC Goa,6170,7,5,2,7,11,20,-9,17
NorthEast Un,6170,8,4,3,7,10,12,-2,15
Mumbai City,6171,1,6,4,4,16,10,6,22
Kolkata,6171,2,5,6,3,16,13,3,21
Delhi Dynamo,6171,3,5,5,4,25,18,7,20
NorthEast Un,6171,4,5,4,5,12,11,1,19
FC Goa,6171,5,5,3,6,12,16,-4,18
Kerala Blast,6171,6,4,5,5,11,17,-6,17
FC Pune City,6171,7,4,4,6,13,16,-3,16
Chennaiyin,6171,8,3,7,4,14,18,-4,16
Delhi Dynamo,6172,1,5,7,2,26,17,9,22
Mumbai City,6172,2,6,4,4,17,11,6,22
NorthEast Un,6172,3,5,4,5,13,11,2,19
FC Pune City,6172,4,5,4,5,14,14,0,19
Kerala Blast,6172,5,5,4,5,10,15,-5,19
Kolkata,6172,6,4,6,4,16,16,0,18
Chennaiyin,6172,7,3,7,4,14,18,-4,16
FC Goa,6172,8,3,4,7,10,18,-8,13
Mumbai City,6173,1,7,4,3,19,8,11,25
Kolkata,6173,2,4,8,2,17,14,3,20
Delhi Dynamo,6173,3,5,5,4,22,21,1,20
Kerala Blast,6173,4,5,4,5,12,15,-3,19
NorthEast Un,6173,5,5,3,6,13,12,1,18
FC Pune City,6173,6,4,5,5,13,15,-2,17
Chennaiyin,6173,7,3,7,4,13,17,-4,16
FC Goa,6173,8,3,4,7,9,16,-7,13
Delhi Dynamo,6174,1,7,5,2,29,14,15,26
Mumbai City,6174,2,6,4,4,16,9,7,22
Kolkata,6174,3,4,8,2,21,14,7,20
NorthEast Un,6174,4,6,2,6,12,12,0,20
Kerala Blast,6174,5,5,3,6,13,21,-8,18
Chennaiyin,6174,6,4,5,5,15,19,-4,17
FC Pune City,6174,7,4,4,6,13,18,-5,16
FC Goa,6174,8,3,3,8,8,20,-12,12
Mumbai City,6175,1,6,5,3,19,11,8,23
Delhi Dynamo,6175,2,5,6,3,25,18,7,21
FC Pune City,6175,3,6,3,5,18,17,1,21
FC Goa,6175,4,6,2,6,12,14,-2,20
NorthEast Un,6175,5,5,3,6,10,10,0,18
Kolkata,6175,6,3,7,4,16,19,-3,16
Kerala Blast,6175,7,4,4,6,13,19,-6,16
Chennaiyin,6175,8,3,6,5,13,18,-5,15
Delhi Dynamo,6176,1,6,6,2,27,17,10,24
Kolkata,6176,2,6,6,2,22,12,10,24
Mumbai City,6176,3,6,5,3,18,10,8,23
Chennaiyin,6176,4,5,5,4,17,18,-1,20
Kerala Blast,6176,5,5,4,5,13,18,-5,19
FC Pune City,6176,6,4,4,6,13,20,-7,16
NorthEast Un,6176,7,4,2,8,11,16,-5,14
FC Goa,6176,8,3,2,9,9,19,-10,11
Mumbai City,6177,1,7,4,3,18,8,10,25
Delhi Dynamo,6177,2,6,5,3,25,18,7,23
Kerala Blast,6177,3,6,4,4,15,15,0,22
Kolkata,6177,4,4,8,2,18,15,3,20
NorthEast Un,6177,5,5,2,7,11,12,-1,17
Chennaiyin,6177,6,3,6,5,15,20,-5,15
FC Pune City,6177,7,4,3,7,12,19,-7,15
FC Goa,6177,8,3,4,7,12,19,-7,13
Mumbai City,6178,1,7,4,3,17,8,9,25
Kolkata,6178,2,5,7,2,19,14,5,22
Chennaiyin,6178,3,5,5,4,16,17,-1,20
NorthEast Un,6178,4,5,3,6,12,11,1,18
FC Pune City,6178,5,5,3,6,15,16,-1,18
Delhi Dynamo,6178,6,4,5,5,21,18,3,17
Kerala Blast,6178,7,4,4,6,10,19,-9,16
FC Goa,6178,8,4,3,7,10,17,-7,15
Delhi Dynamo,6179,1,6,5,3,24,17,7,23
Mumbai City,6179,2,6,4,4,16,9,7,22
Kolkata,6179,3,5,6,3,15,15,0,21
Kerala Blast,6179,4,5,4,5,13,16,-3,19
NorthEast Un,6179,5,5,3,6,13,13,0,18
FC Pune City,6179,6,4,4,6,14,17,-3,16
Chennaiyin,6179,7,3,7,4,17,21,-4,16
FC Goa,6179,8,4,3,7,14,18,-4,15
Mumbai City,6180,1,7,4,3,17,8,9,25
Delhi Dynamo,6180,2,6,5,3,26,15,11,23
Kerala Blast,6180,3,6,4,4,16,16,0,22
Kolkata,6180,4,5,6,3,17,16,1,21
NorthEast Un,6180,5,5,2,7,12,15,-3,17
FC Pune City,6180,6,4,4,6,14,17,-3,16
Chennaiyin,6180,7,3,5,6,14,20,-6,14
FC Goa,6180,8,4,2,8,9,18,-9,14
Mumbai City,6181,1,7,4,3,17,8,9,25
Kerala Blast,6181,2,7,3,4,16,16,0,24
Delhi Dynamo,6181,3,5,5,4,24,18,6,20
Kolkata,6181,4,4,6,4,18,17,1,18
FC Goa,6181,5,5,2,7,15,17,-2,17
NorthEast Un,6181,6,5,2,7,12,15,-3,17
Chennaiyin,6181,7,4,5,5,17,22,-5,17
FC Pune City,6181,8,4,3,7,13,19,-6,15
Mumbai City,6182,1,6,5,3,18,10,8,23
NorthEast Un,6182,2,7,2,5,16,11,5,23
Delhi Dynamo,6182,3,5,6,3,26,18,8,21
Kolkata,6182,4,5,6,3,17,15,2,21
Kerala Blast,6182,5,5,4,5,11,16,-5,19
FC Pune City,6182,6,4,4,6,13,16,-3,16
FC Goa,6182,7,4,2,8,11,18,-7,14
Chennaiyin,6182,8,3,5,6,15,23,-8,14
Kerala Blast,6183,1,7,3,4,17,17,0,24
Mumbai City,6183,2,6,5,3,17,9,8,23
Delhi Dynamo,6183,3,5,6,3,26,20,6,21
Kolkata,6183,4,5,6,3,21,18,3,21
NorthEast Un,6183,5,5,2,7,14,14,0,17
Chennaiyin,6183,6,4,5,5,18,21,-3,17
FC Pune City,6183,7,4,3,7,14,19,-5,15
FC Goa,6183,8,4,2,8,15,24,-9,14
Mumbai City,6184,1,7,4,3,18,9,9,25
Kolkata,6184,2,5,6,3,17,19,-2,21
Delhi Dynamo,6184,3,5,5,4,25,18,7,20
FC Pune City,6184,4,5,3,6,17,16,1,18
NorthEast Un,6184,5,5,3,6,11,12,-1,18
Kerala Blast,6184,6,5,3,6,13,17,-4,18
Chennaiyin,6184,7,3,7,4,14,18,-4,16
FC Goa,6184,8,4,3,7,10,16,-6,15
Mumbai City,6185,1,7,4,3,18,8,10,25
Kolkata,6185,2,5,7,2,20,14,6,22
Kerala Blast,6185,3,6,3,5,17,16,1,21
Delhi Dynamo,6185,4,4,6,4,22,20,2,18
NorthEast Un,6185,5,5,3,6,12,14,-2,18
FC Pune City,6185,6,4,4,6,15,19,-4,16
Chennaiyin,6185,7,3,7,4,14,18,-4,16
FC Goa,6185,8,3,4,7,10,19,-9,13
Delhi Dynamo,6186,1,6,5,3,27,17,10,23
Mumbai City,6186,2,6,4,4,17,12,5,22
Kolkata,6186,3,4,7,3,16,15,1,19
Kerala Blast,6186,4,5,4,5,13,17,-4,19
FC Pune City,6186,5,5,3,6,15,18,-3,18
NorthEast Un,6186,6,5,2,7,11,12,-1,17
Chennaiyin,6186,7,4,5,5,15,18,-3,17
FC Goa,6186,8,5,2,7,13,18,-5,17
Mumbai City,6187,1,7,4,3,17,8,9,25
Kolkata,6187,2,5,7,2,17,13,4,22
Kerala Blast,6187,3,6,3,5,15,16,-1,21
Delhi Dynamo,6187,4,4,7,3,25,19,6,19
NorthEast Un,6187,5,5,3,6,13,14,-1,18
Chennaiyin,6187,6,4,5,5,16,19,-3,17
FC Pune City,6187,7,4,3,7,13,19,-6,15
FC Goa,6187,8,3,4,7,10,18,-8,13
Mumbai City,6188,1,7,4,3,17,8,9,25
NorthEast Un,6188,2,6,3,5,13,10,3,21
Delhi Dynamo,6188,3,5,5,4,23,17,6,20
Kerala Blast,6188,4,5,5,4,12,15,-3,20
Kolkata,6188,5,4,7,3,15,15,0,19
FC Goa,6188,6,5,2,7,12,15,-3,17
FC Pune City,6188,7,4,3,7,13,17,-4,15
Chennaiyin,6188,8,3,5,6,13,21,-8,14
Delhi Dynamo,6189,1,6,6,2,25,15,10,24
Mumbai City,6189,2,6,4,4,16,10,6,22
FC Pune City,6189,3,6,3,5,17,17,0,21
Kolkata,6189,4,4,7,3,19,18,1,19
Chennaiyin,6189,5,4,6,4,15,18,-3,18
Kerala Blast,6189,6,4,5,5,11,16,-5,17
NorthEast Un,6189,7,4,4,6,10,11,-1,16
FC Goa,6189,8,3,3,8,11,19,-8,12
Kerala Blast,6190,1,7,3,4,15,15,0,24
Mumbai City,6190,2,6,5,3,16,8,8,23
Delhi Dynamo,6190,3,5,6,3,25,16,9,21
Kolkata,6190,4,5,6,3,18,15,3,21
NorthEast Un,6190,5,6,2,6,13,11,2,20
Chennaiyin,6190,6,4,5,5,16,19,-3,17
FC Pune City,6190,7,4,3,7,15,21,-6,15
FC Goa,6190,8,3,2,9,8,21,-13,11
Mumbai City,6191,1,7,4,3,17,8,9,25
Chennaiyin,6191,2,5,5,4,16,17,-1,20
Kolkata,6191,3,4,7,3,17,16,1,19
Kerala Blast,6191,4,5,4,5,11,15,-4,19
Delhi Dynamo,6191,5,4,6,4,22,17,5,18
FC Pune City,6191,6,5,3,6,16,17,-1,18
NorthEast Un,6191,7,5,2,7,11,13,-2,17
FC Goa,6191,8,4,3,7,10,17,-7,15
Mumbai City,6192,1,7,4,3,17,8,9,25
Delhi Dynamo,6192,2,6,5,3,26,18,8,23
FC Pune City,6192,3,6,3,5,14,14,0,21
Kerala Blast,6192,4,6,3,5,12,14,-2,21
Kolkata,6192,5,4,6,4,15,15,0,18
NorthEast Un,6192,6,5,2,7,11,13,-2,17
Chennaiyin,6192,7,4,5,5,16,20,-4,17
FC Goa,6192,8,3,2,9,13,22,-9,11
Mumbai City,6193,1,7,4,3,18,8,10,25
FC Pune City,6193,2,6,3,5,14,14,0,21
Delhi Dynamo,6193,3,4,7,3,24,19,5,19
Kerala Blast,6193,4,5,4,5,12,15,-3,19
NorthEast Un,6193,5,5,3,6,12,13,-1,18
Kolkata,6193,6,3,8,3,15,15,0,17
Chennaiyin,6193,7,4,5,5,17,18,-1,17
FC Goa,6193,8,3,4,7,10,20,-10,13
Delhi Dynamo,6194,1,6,5,3,25,16,9,23
Mumbai City,6194,2,6,4,4,16,10,6,22
Kerala Blast,6194,3,6,4,4,14,15,-1,22
FC Pune City,6194,4,5,3,6,15,16,-1,18
FC Goa,6194,5,5,3,6,12,14,-2,18
NorthEast Un,6194,6,4,4,6,12,13,-1,16
Kolkata,6194,7,3,7,4,14,17,-3,16
Chennaiyin,6194,8,3,6,5,14,21,-7,15
Delhi Dynamo,6195,1,6,5,3,28,18,10,23
Mumbai City,6195,2,6,4,4,17,12,5,22
Kerala Blast,6195,3,6,3,5,11,14,-3,21
NorthEast Un,6195,4,6,2,6,12,11,1,20
Kolkata,6195,5,4,6,4,15,16,-1,18
FC Pune City,6195,6,5,3,6,14,16,-2,18
FC Goa,6195,7,5,2,7,15,17,-2,17
Chennaiyin,6195,8,3,5,6,14,22,-8,14
Delhi Dynamo,6196,1,6,6,2,25,16,9,24
Mumbai City,6196,2,6,5,3,17,9,8,23
Kolkata,6196,3,5,7,2,22,14,8,22
Chennaiyin,6196,4,4,5,5,14,18,-4,17
Kerala Blast,6196,5,4,5,5,9,16,-7,17
FC Pune City,6196,6,4,4,6,14,20,-6,16
NorthEast Un,6196,7,4,3,7,10,12,-2,15
FC Goa,6196,8,4,3,7,9,15,-6,15
Mumbai City,6197,1,7,4,3,18,9,9,25
Delhi Dynamo,6197,2,5,6,3,24,17,7,21
NorthEast Un,6197,3,6,3,5,16,12,4,21
Kerala Blast,6197,4,5,4,5,10,15,-5,19
Kolkata,6197,5,4,6,4,14,17,-3,18
Chennaiyin,6197,6,4,5,5,16,21,-5,17
FC Pune City,6197,7,4,4,6,12,15,-3,16
FC Goa,6197,8,4,2,8,12,16,-4,14
Mumbai City,6198,1,7,4,3,17,8,9,25
Delhi Dynamo,6198,2,5,6,3,26,19,7,21
FC Pune City,6198,3,6,3,5,16,14,2,21
NorthEast Un,6198,4,5,4,5,14,13,1,19
Kolkata,6198,5,4,7,3,16,16,0,19
Kerala Blast,6198,6,4,4,6,10,17,-7,16
Chennaiyin,6198,7,3,6,5,15,20,-5,15
FC Goa,6198,8,3,4,7,12,19,-7,13
Mumbai City,6199,1,7,4,3,19,8,11,25
Delhi Dynamo,6199,2,5,6,3,24,18,6,21
Kolkata,6199,3,4,7,3,17,14,3,19
Kerala Blast,6199,4,4,6,4,9,13,-4,18
NorthEast Un,6199,5,4,5,5,11,11,0,17
FC Goa,6199,6,5,2,7,13,19,-6,17
FC Pune City,6199,7,4,4,6,12,17,-5,16
Chennaiyin,6199,8,3,6,5,16,21,-5,15
Mumbai City,6200,1,6,5,3,17,9,8,23
Delhi Dynamo,6200,2,5,7,2,27,19,8,22
FC Pune City,6200,3,6,3,5,16,16,0,21
Kerala Blast,6200,4,6,3,5,12,15,-3,21
Chennaiyin,6200,5,4,6,4,17,18,-1,18
Kolkata,6200,6,3,7,4,14,15,-1,16
NorthEast Un,6200,7,4,4,6,12,13,-1,16
FC Goa,6200,8,3,3,8,10,20,-10,12
Mumbai City,6201,1,7,4,3,20,9,11,25
Chennaiyin,6201,2,5,5,4,21,19,2,20
Kolkata,6201,3,4,7,3,17,16,1,19
NorthEast Un,6201,4,5,3,6,14,13,1,18
Kerala Blast,6201,5,4,6,4,10,14,-4,18
Delhi Dynamo,6201,6,4,5,5,23,23,0,17
FC Goa,6201,7,5,2,7,13,21,-8,17
FC Pune City,6201,8,4,4,6,14,17,-3,16
Mumbai City,6202,1,7,4,3,19,9,10,25
Delhi Dynamo,6202,2,6,5,3,26,18,8,23
Kerala Blast,6202,3,6,4,4,12,14,-2,22
Kolkata,6202,4,4,7,3,15,15,0,19
FC Goa,6202,5,5,2,7,14,15,-1,17
NorthEast Un,6202,6,5,2,7,12,13,-1,17
FC Pune City,6202,7,4,3,7,14,18,-4,15
Chennaiyin,6202,8,3,5,6,13,23,-10,14
Mumbai City,6203,1,6,4,4,16,10,6,22
Delhi Dynamo,6203,2,5,6,3,24,16,8,21
FC Pune City,6203,3,6,3,5,17,14,3,21
Kolkata,6203,4,5,6,3,15,15,0,21
Chennaiyin,6203,5,5,5,4,19,19,0,20
Kerala Blast,6203,6,5,3,6,11,16,-5,18
NorthEast Un,6203,7,4,3,7,11,14,-3,15
FC Goa,6203,8,4,2,8,10,19,-9,14
Mumbai City,6204,1,6,5,3,17,9,8,23
Kerala Blast,6204,2,6,3,5,13,16,-3,21
Delhi Dynamo,6204,3,4,8,2,23,16,7,20
Kolkata,6204,4,4,6,4,16,17,-1,18
FC Pune City,6204,5,5,3,6,14,15,-1,18
Chennaiyin,6204,6,4,6,4,15,18,-3,18
NorthEast Un,6204,7,4,4,6,9,10,-1,16
FC Goa,6204,8,4,3,7,12,18,-6,15
Delhi Dynamo,6205,1,6,6,2,26,15,11,24
Mumbai City,6205,2,6,4,4,17,11,6,22
Kolkata,6205,3,4,8,2,16,14,2,20
Kerala Blast,6205,4,5,4,5,14,15,-1,19
NorthEast Un,6205,5,5,3,6,11,12,-1,18
Chennaiyin,6205,6,4,5,5,16,19,-3,17
FC Pune City,6205,7,4,3,7,13,20,-7,15
FC Goa,6205,8,4,3,7,9,16,-7,15
Mumbai City,6206,1,7,4,3,18,9,9,25
Delhi Dynamo,6206,2,6,5,3,28,17,11,23
Kolkata,6206,3,5,6,3,21,14,7,21
FC Pune City,6206,4,6,3,5,15,15,0,21
Chennaiyin,6206,5,3,7,4,14,18,-4,16
NorthEast Un,6206,6,4,4,6,11,15,-4,16
Kerala Blast,6206,7,4,4,6,12,22,-10,16
FC Goa,6206,8,3,3,8,9,18,-9,12
Delhi Dynamo,6207,1,6,6,2,24,14,10,24
Mumbai City,6207,2,6,5,3,16,8,8,23
Kerala Blast,6207,3,5,4,5,14,18,-4,19
NorthEast Un,6207,4,5,3,6,11,11,0,18
Kolkata,6207,5,3,8,3,16,17,-1,17
FC Goa,6207,6,5,2,7,12,17,-5,17
FC Pune City,6207,7,4,4,6,14,17,-3,16
Chennaiyin,6207,8,3,6,5,14,19,-5,15
Mumbai City,6208,1,7,4,3,20,10,10,25
Chennaiyin,6208,2,5,5,4,18,18,0,20
Delhi Dynamo,6208,3,4,7,3,24,19,5,19
Kerala Blast,6208,4,5,4,5,12,16,-4,19
Kolkata,6208,5,4,6,4,16,17,-1,18
FC Pune City,6208,6,5,3,6,14,16,-2,18
NorthEast Un,6208,7,4,4,6,11,14,-3,16
FC Goa,6208,8,4,3,7,11,16,-5,15
Delhi Dynamo,6209,1,6,6,2,27,16,11,24
Mumbai City,6209,2,6,5,3,16,8,8,23
FC Pune City,6209,3,5,4,5,15,15,0,19
Kolkata,6209,4,4,6,4,16,16,0,18
Kerala Blast,6209,5,4,5,5,12,18,-6,17
NorthEast Un,6209,6,4,4,6,11,13,-2,16
Chennaiyin,6209,7,3,7,4,14,18,-4,16
FC Goa,6209,8,4,3,7,11,18,-7,15
Delhi Dynamo,6210,1,6,6,2,25,15,10,24
Mumbai City,6210,2,6,4,4,16,9,7,22
Kolkata,6210,3,5,7,2,17,13,4,22
Kerala Blast,6210,4,5,3,6,18,17,1,18
FC Pune City,6210,5,5,3,6,15,18,-3,18
FC Goa,6210,6,4,4,6,11,15,-4,16
Chennaiyin,6210,7,3,6,5,14,20,-6,15
NorthEast Un,6210,8,4,3,7,11,20,-9,15
Mumbai City,6211,1,6,5,3,16,8,8,23
Delhi Dynamo,6211,2,5,7,2,25,17,8,22
Kerala Blast,6211,3,6,3,5,12,17,-5,21
Kolkata,6211,4,4,7,3,18,15,3,19
Chennaiyin,6211,5,4,6,4,14,17,-3,18
FC Pune City,6211,6,4,4,6,13,16,-3,16
FC Goa,6211,7,4,4,6,11,16,-5,16
NorthEast Un,6211,8,4,2,8,10,13,-3,14
Delhi Dynamo,6212,1,6,5,3,26,18,8,23
Mumbai City,6212,2,6,4,4,16,9,7,22
Kolkata,6212,3,5,6,3,15,13,2,21
NorthEast Un,6212,4,6,3,5,12,10,2,21
FC Pune City,6212,5,5,3,6,13,15,-2,18
Kerala Blast,6212,6,5,3,6,11,16,-5,18
Chennaiyin,6212,7,3,6,5,14,19,-5,15
FC Goa,6212,8,4,2,8,13,20,-7,14
Mumbai City,6213,1,7,4,3,19,9,10,25
Delhi Dynamo,6213,2,6,5,3,28,18,10,23
Kolkata,6213,3,4,7,3,15,14,1,19
NorthEast Un,6213,4,5,3,6,13,11,2,18
FC Pune City,6213,5,5,3,6,13,16,-3,18
Kerala Blast,6213,6,5,3,6,11,17,-6,18
Chennaiyin,6213,7,3,6,5,14,19,-5,15
FC Goa,6213,8,4,3,7,11,20,-9,15
Mumbai City,6214,1,6,5,3,17,9,8,23
Kerala Blast,6214,2,6,3,5,14,16,-2,21
Kolkata,6214,3,4,8,2,17,14,3,20
Delhi Dynamo,6214,4,4,7,3,24,19,5,19
FC Goa,6214,5,5,3,6,15,16,-1,18
Chennaiyin,6214,6,4,5,5,16,20,-4,17
FC Pune City,6214,7,4,4,6,14,17,-3,16
NorthEast Un,6214,8,4,3,7,10,16,-6,15
Mumbai City,6215,1,6,5,3,18,10,8,23
Kerala Blast,6215,2,6,3,5,13,16,-3,21
Delhi Dynamo,6215,3,4,8,2,24,17,7,20
Kolkata,6215,4,4,8,2,16,13,3,20
NorthEast Un,6215,5,4,4,6,10,12,-2,16
FC Pune City,6215,6,4,4,6,14,17,-3,16
Chennaiyin,6215,7,3,7,4,14,18,-4,16
FC Goa,6215,8,3,5,6,9,15,-6,14
Mumbai City,6216,1,7,4,3,18,9,9,25
Kolkata,6216,2,5,7,2,20,16,4,22
Delhi Dynamo,6216,3,4,6,4,24,20,4,18
NorthEast Un,6216,4,5,3,6,13,13,0,18
FC Pune City,6216,5,5,3,6,14,17,-3,18
Chennaiyin,6216,6,4,5,5,16,20,-4,17
FC Goa,6216,7,5,2,7,14,18,-4,17
Kerala Blast,6216,8,4,4,6,10,16,-6,16
Mumbai City,6217,1,7,4,3,18,9,9,25
Kolkata,6217,2,5,7,2,17,13,4,22
NorthEast Un,6217,3,5,4,5,13,11,2,19
Kerala Blast,6217,4,5,4,5,12,16,-4,19
Delhi Dynamo,6217,5,4,6,4,24,19,5,18
FC Goa,6217,6,5,2,7,11,17,-6,17
Chennaiyin,6217,7,3,6,5,14,19,-5,15
FC Pune City,6217,7,4,3,7,14,19,-5,15
Mumbai City,6218,1,6,5,3,18,10,8,23
Delhi Dynamo,6218,2,5,6,3,26,18,8,21
FC Goa,6218,3,6,2,6,13,15,-2,20
Kolkata,6218,4,4,7,3,16,16,0,19
NorthEast Un,6218,5,5,3,6,12,12,0,18
Kerala Blast,6218,6,5,3,6,13,17,-4,18
FC Pune City,6218,7,4,4,6,12,17,-5,16
Chennaiyin,6218,8,3,6,5,13,18,-5,15
Mumbai City,6219,1,7,4,3,18,9,9,25
Kerala Blast,6219,2,6,4,4,13,14,-1,22
Delhi Dynamo,6219,3,5,5,4,23,17,6,20
NorthEast Un,6219,4,6,2,6,12,12,0,20
FC Pune City,6219,5,4,5,5,14,16,-2,17
Chennaiyin,6219,6,4,5,5,15,19,-4,17
Kolkata,6219,7,3,7,4,15,17,-2,16
FC Goa,6219,8,4,2,8,11,17,-6,14
Mumbai City,6220,1,7,4,3,18,8,10,25
Delhi Dynamo,6220,2,5,5,4,24,19,5,20
NorthEast Un,6220,3,6,2,6,13,12,1,20
Chennaiyin,6220,4,5,5,4,18,18,0,20
FC Pune City,6220,5,5,4,5,17,17,0,19
Kolkata,6220,6,4,6,4,16,17,-1,18
Kerala Blast,6220,7,4,4,6,12,18,-6,16
FC Goa,6220,8,4,2,8,12,21,-9,14
Delhi Dynamo,6221,1,7,5,2,31,15,16,26
Mumbai City,6221,2,6,4,4,17,11,6,22
FC Pune City,6221,3,5,4,5,17,17,0,19
Kolkata,6221,4,4,7,3,15,15,0,19
NorthEast Un,6221,5,5,3,6,12,13,-1,18
Kerala Blast,6221,6,4,6,4,13,17,-4,18
Chennaiyin,6221,7,4,5,5,16,20,-4,17
FC Goa,6221,8,3,2,9,10,23,-13,11
Mumbai City,6222,1,6,5,3,17,9,8,23
NorthEast Un,6222,2,6,2,6,12,10,2,20
Kerala Blast,6222,3,5,5,4,12,15,-3,20
Delhi Dynamo,6222,4,4,7,3,23,17,6,19
Kolkata,6222,5,3,8,3,16,16,0,17
FC Pune City,6222,6,4,5,5,13,15,-2,17
Chennaiyin,6222,7,4,5,5,16,19,-3,17
FC Goa,6222,8,4,3,7,10,18,-8,15
Delhi Dynamo,6223,1,6,6,2,28,16,12,24
Mumbai City,6223,2,6,5,3,17,9,8,23
Kerala Blast,6223,3,5,4,5,11,16,-5,19
NorthEast Un,6223,4,5,3,6,13,12,1,18
Kolkata,6223,5,4,6,4,16,16,0,18
Chennaiyin,6223,6,3,7,4,16,20,-4,16
FC Pune City,6223,7,4,4,6,13,17,-4,16
FC Goa,6223,8,4,3,7,13,21,-8,15
Mumbai City,6224,1,7,4,3,17,8,9,25
Kolkata,6224,2,5,7,2,18,15,3,22
Delhi Dynamo,6224,3,5,5,4,26,20,6,20
Chennaiyin,6224,4,5,5,4,20,18,2,20
NorthEast Un,6224,5,5,3,6,14,16,-2,18
Kerala Blast,6224,6,4,5,5,13,18,-5,17
FC Pune City,6224,7,4,4,6,14,17,-3,16
FC Goa,6224,8,3,3,8,12,22,-10,12
Mumbai City,6225,1,7,4,3,18,9,9,25
Kolkata,6225,2,6,6,2,20,14,6,24
Delhi Dynamo,6225,3,6,5,3,25,16,9,23
Kerala Blast,6225,4,5,4,5,13,17,-4,19
Chennaiyin,6225,5,4,6,4,15,18,-3,18
FC Pune City,6225,6,4,4,6,14,19,-5,16
NorthEast Un,6225,7,4,3,7,11,14,-3,15
FC Goa,6225,8,3,2,9,8,17,-9,11
Mumbai City,6226,1,7,4,3,20,9,11,25
Delhi Dynamo,6226,2,6,5,3,27,19,8,23
Kolkata,6226,3,5,6,3,17,14,3,21
FC Pune City,6226,4,5,4,5,16,17,-1,19
NorthEast Un,6226,5,5,3,6,10,11,-1,18
Chennaiyin,6226,6,4,5,5,14,18,-4,17
Kerala Blast,6226,7,4,5,5,11,17,-6,17
FC Goa,6226,8,3,2,9,9,19,-10,11
Mumbai City,6227,1,6,5,3,17,9,8,23
Delhi Dynamo,6227,2,5,7,2,24,16,8,22
Kerala Blast,6227,3,5,5,4,12,14,-2,20
Kolkata,6227,4,4,7,3,17,17,0,19
FC Pune City,6227,5,5,3,6,17,19,-2,18
NorthEast Un,6227,6,4,4,6,11,12,-1,16
FC Goa,6227,7,4,3,7,14,17,-3,15
Chennaiyin,6227,8,3,6,5,15,23,-8,15
Mumbai City,6228,1,6,5,3,17,9,8,23
Delhi Dynamo,6228,2,5,7,2,24,16,8,22
Kolkata,6228,3,4,6,4,17,18,-1,18
NorthEast Un,6228,4,5,3,6,10,11,-1,18
Chennaiyin,6228,5,4,6,4,16,18,-2,18
FC Pune City,6228,6,5,3,6,13,15,-2,18
Kerala Blast,6228,7,5,3,6,12,17,-5,18
FC Goa,6228,8,4,3,7,13,18,-5,15
Mumbai City,6229,1,7,4,3,18,9,9,25
Kerala Blast,6229,2,6,4,4,14,13,1,22
Delhi Dynamo,6229,3,5,5,4,26,20,6,20
FC Goa,6229,4,5,3,6,14,17,-3,18
FC Pune City,6229,5,5,3,6,14,18,-4,18
NorthEast Un,6229,6,5,2,7,13,14,-1,17
Kolkata,6229,7,3,7,4,15,17,-2,16
Chennaiyin,6229,8,3,6,5,14,20,-6,15
Mumbai City,6230,1,7,4,3,18,9,9,25
Kolkata,6230,2,6,6,2,20,13,7,24
NorthEast Un,6230,3,7,2,5,15,11,4,23
Delhi Dynamo,6230,4,4,6,4,24,19,5,18
FC Pune City,6230,5,4,4,6,14,18,-4,16
Kerala Blast,6230,6,4,4,6,13,19,-6,16
FC Goa,6230,7,4,3,7,12,20,-8,15
Chennaiyin,6230,8,3,5,6,15,22,-7,14
Mumbai City,6231,1,7,4,3,17,8,9,25
Delhi Dynamo,6231,2,5,6,3,25,18,7,21
Kerala Blast,6231,3,5,5,4,12,15,-3,20
FC Goa,6231,4,5,3,6,14,18,-4,18
Kolkata,6231,5,3,8,3,15,15,0,17
NorthEast Un,6231,6,5,2,7,12,13,-1,17
FC Pune City,6231,7,4,5,5,15,17,-2,17
Chennaiyin,6231,8,3,5,6,15,21,-6,14
Delhi Dynamo,6232,1,6,5,3,26,16,10,23
Mumbai City,6232,2,6,4,4,17,10,7,22
Kerala Blast,6232,3,6,3,5,11,14,-3,21
FC Goa,6232,4,5,3,6,14,16,-2,18
NorthEast Un,6232,5,5,3,6,11,13,-2,18
Kolkata,6232,6,3,8,3,14,14,0,17
FC Pune City,6232,7,4,4,6,12,15,-3,16
Chennaiyin,6232,8,3,6,5,15,22,-7,15
Mumbai City,6233,1,7,4,3,18,9,9,25
NorthEast Un,6233,2,7,2,5,15,11,4,23
Kerala Blast,6233,3,6,3,5,15,14,1,21
Delhi Dynamo,6233,4,5,5,4,27,22,5,20
Kolkata,6233,5,4,6,4,16,16,0,18
FC Goa,6233,6,5,2,7,12,17,-5,17
FC Pune City,6233,7,4,3,7,13,21,-8,15
Chennaiyin,6233,8,3,5,6,13,19,-6,14
Mumbai City,6234,1,7,4,3,19,8,11,25
Delhi Dynamo,6234,2,5,6,3,23,18,5,21
Kerala Blast,6234,3,6,3,5,12,15,-3,21
Kolkata,6234,4,4,7,3,15,14,1,19
FC Pune City,6234,5,5,3,6,14,15,-1,18
NorthEast Un,6234,6,5,2,7,10,12,-2,17
FC Goa,6234,7,4,4,6,11,15,-4,16
Chennaiyin,6234,8,3,5,6,13,20,-7,14
Mumbai City,6235,1,7,4,3,18,9,9,25
Delhi Dynamo,6235,2,5,6,3,25,18,7,21
Kolkata,6235,3,5,6,3,17,15,2,21
Chennaiyin,6235,4,4,5,5,15,19,-4,17
FC Goa,6235,5,5,2,7,14,18,-4,17
Kerala Blast,6235,6,4,5,5,11,17,-6,17
NorthEast Un,6235,7,4,4,6,11,12,-1,16
FC Pune City,6235,8,4,4,6,13,16,-3,16
Delhi Dynamo,6236,1,6,6,2,29,19,10,24
Mumbai City,6236,2,6,4,4,18,12,6,22
Kolkata,6236,3,5,6,3,18,15,3,21
FC Pune City,6236,4,5,3,6,14,17,-3,18
Kerala Blast,6236,5,5,3,6,12,19,-7,18
FC Goa,6236,6,5,2,7,15,17,-2,17
Chennaiyin,6236,7,4,5,5,16,19,-3,17
NorthEast Un,6236,8,4,3,7,11,15,-4,15
Mumbai City,6237,1,6,4,4,17,10,7,22
Kerala Blast,6237,2,6,4,4,13,14,-1,22
Kolkata,6237,3,5,6,3,15,13,2,21
Delhi Dynamo,6237,4,5,5,4,25,21,4,20
NorthEast Un,6237,5,6,2,6,16,13,3,20
FC Goa,6237,6,5,2,7,12,17,-5,17
FC Pune City,6237,7,4,4,6,13,16,-3,16
Chennaiyin,6237,8,3,5,6,15,22,-7,14
Mumbai City,6238,1,7,4,3,18,8,10,25
Delhi Dynamo,6238,2,5,6,3,25,18,7,21
Kolkata,6238,3,3,9,2,15,14,1,18
Kerala Blast,6238,4,4,6,4,9,13,-4,18
FC Pune City,6238,5,4,5,5,13,15,-2,17
NorthEast Un,6238,6,4,4,6,10,12,-2,16
FC Goa,6238,7,4,4,6,14,18,-4,16
Chennaiyin,6238,8,3,6,5,15,21,-6,15
Mumbai City,6239,1,7,4,3,20,10,10,25
NorthEast Un,6239,2,5,4,5,13,11,2,19
Kolkata,6239,3,4,7,3,14,13,1,19
FC Pune City,6239,4,5,3,6,13,15,-2,18
FC Goa,6239,5,5,3,6,15,19,-4,18
Delhi Dynamo,6239,6,4,5,5,27,25,2,17
Kerala Blast,6239,7,4,5,5,10,15,-5,17
Chennaiyin,6239,8,3,7,4,15,19,-4,16
Mumbai City,6240,1,6,5,3,18,10,8,23
NorthEast Un,6240,2,5,4,5,14,10,4,19
Delhi Dynamo,6240,3,4,7,3,25,22,3,19
Kolkata,6240,4,4,7,3,17,17,0,19
Kerala Blast,6240,5,5,4,5,12,16,-4,19
FC Goa,6240,6,5,3,6,16,17,-1,18
FC Pune City,6240,7,4,4,6,13,16,-3,16
Chennaiyin,6240,8,3,6,5,15,22,-7,15
Mumbai City,6241,1,7,4,3,19,8,11,25
Kolkata,6241,2,4,8,2,19,16,3,20
FC Pune City,6241,3,5,4,5,15,16,-1,19
Delhi Dynamo,6241,4,4,6,4,23,21,2,18
NorthEast Un,6241,5,5,3,6,13,15,-2,18
FC Goa,6241,6,5,3,6,12,15,-3,18
Chennaiyin,6241,7,4,5,5,17,19,-2,17
Kerala Blast,6241,8,4,3,7,10,18,-8,15
Delhi Dynamo,6242,1,7,5,2,30,15,15,26
Kolkata,6242,2,5,7,2,22,16,6,22
Mumbai City,6242,3,6,4,4,16,11,5,22
FC Pune City,6242,4,5,4,5,16,17,-1,19
Kerala Blast,6242,5,5,3,6,13,18,-5,18
NorthEast Un,6242,6,5,2,7,15,16,-1,17
Chennaiyin,6242,7,3,6,5,14,20,-6,15
FC Goa,6242,8,3,3,8,10,23,-13,12
NorthEast Un,6243,1,7,2,5,12,9,3,23
Mumbai City,6243,2,6,4,4,17,10,7,22
Delhi Dynamo,6243,3,5,5,4,24,18,6,20
FC Goa,6243,4,6,2,6,16,17,-1,20
Kolkata,6243,5,4,7,3,19,17,2,19
Kerala Blast,6243,6,5,4,5,12,16,-4,19
FC Pune City,6243,7,4,3,7,12,17,-5,15
Chennaiyin,6243,8,3,5,6,13,21,-8,14
Mumbai City,6244,1,6,5,3,18,10,8,23
Kolkata,6244,2,5,7,2,16,13,3,22
Delhi Dynamo,6244,3,5,6,3,27,17,10,21
Chennaiyin,6244,4,5,5,4,16,18,-2,20
NorthEast Un,6244,5,5,3,6,11,11,0,18
Kerala Blast,6244,6,4,6,4,10,14,-4,18
FC Pune City,6244,7,4,4,6,12,15,-3,16
FC Goa,6244,8,3,2,9,8,20,-12,11
Mumbai City,6245,1,7,4,3,17,8,9,25
Delhi Dynamo,6245,2,6,5,3,26,16,10,23
Kerala Blast,6245,3,6,4,4,15,15,0,22
Kolkata,6245,4,3,9,2,14,13,1,18
Chennaiyin,6245,5,4,5,5,16,18,-2,17
NorthEast Un,6245,6,5,2,7,11,13,-2,17
FC Pune City,6245,7,4,4,6,13,17,-4,16
FC Goa,6245,8,3,3,8,8,20,-12,12
Mumbai City,6246,1,6,5,3,18,10,8,23
Kolkata,6246,2,4,8,2,18,15,3,20
Kerala Blast,6246,3,5,4,5,14,16,-2,19
Delhi Dynamo,6246,4,4,6,4,25,20,5,18
NorthEast Un,6246,5,5,3,6,12,15,-3,18
FC Goa,6246,6,5,3,6,12,16,-4,18
FC Pune City,6246,7,4,5,5,14,16,-2,17
Chennaiyin,6246,8,3,6,5,13,18,-5,15
Delhi Dynamo,6247,1,6,5,3,27,15,12,23
Mumbai City,6247,2,6,4,4,16,10,6,22
Kolkata,6247,3,5,6,3,19,17,2,21
NorthEast Un,6247,4,5,4,5,10,9,1,19
Kerala Blast,6247,5,5,4,5,13,17,-4,19
FC Pune City,6247,6,5,3,6,15,17,-2,18
Chennaiyin,6247,7,3,6,5,13,18,-5,15
FC Goa,6247,8,4,2,8,11,21,-10,14
Mumbai City,6248,1,6,5,3,17,9,8,23
Kerala Blast,6248,2,6,4,4,11,13,-2,22
Delhi Dynamo,6248,3,4,8,2,24,17,7,20
Kolkata,6248,4,4,7,3,14,13,1,19
NorthEast Un,6248,5,5,3,6,12,12,0,18
FC Goa,6248,6,5,3,6,11,15,-4,18
FC Pune City,6248,7,4,3,7,12,16,-4,15
Chennaiyin,6248,8,3,5,6,14,20,-6,14
Mumbai City,6249,1,7,4,3,19,8,11,25
Delhi Dynamo,6249,2,5,6,3,25,20,5,21
Chennaiyin,6249,3,5,5,4,16,17,-1,20
FC Pune City,6249,4,5,4,5,13,14,-1,19
Kolkata,6249,5,3,8,3,14,14,0,17
Kerala Blast,6249,6,4,5,5,11,16,-5,17
NorthEast Un,6249,7,4,4,6,11,12,-1,16
FC Goa,6249,8,4,2,8,11,19,-8,14
Mumbai City,6250,1,7,4,3,18,8,10,25
Chennaiyin,6250,2,5,5,4,17,19,-2,20
FC Pune City,6250,3,5,4,5,14,15,-1,19
Delhi Dynamo,6250,4,4,6,4,21,18,3,18
Kolkata,6250,5,4,6,4,17,18,-1,18
FC Goa,6250,6,5,2,7,13,16,-3,17
Kerala Blast,6250,7,4,5,5,12,17,-5,17
NorthEast Un,6250,8,4,4,6,11,12,-1,16
Mumbai City,6251,1,7,4,3,18,8,10,25
Kolkata,6251,2,5,7,2,24,17,7,22
Delhi Dynamo,6251,3,4,7,3,22,17,5,19
Kerala Blast,6251,4,5,4,5,12,17,-5,19
Chennaiyin,6251,5,4,5,5,14,20,-6,17
NorthEast Un,6251,6,4,4,6,9,10,-1,16
FC Goa,6251,7,4,4,6,15,18,-3,16
FC Pune City,6251,8,4,3,7,14,21,-7,15
Delhi Dynamo,6252,1,6,5,3,24,16,8,23
Mumbai City,6252,2,6,4,4,16,9,7,22
Kolkata,6252,3,5,7,2,20,15,5,22
Kerala Blast,6252,4,5,4,5,11,17,-6,19
FC Goa,6252,5,5,3,6,13,16,-3,18
Chennaiyin,6252,6,4,5,5,17,20,-3,17
FC Pune City,6252,7,4,3,7,13,17,-4,15
NorthEast Un,6252,8,4,3,7,10,14,-4,15
Mumbai City,6253,1,6,4,4,17,10,7,22
NorthEast Un,6253,2,6,3,5,16,13,3,21
Delhi Dynamo,6253,3,5,5,4,25,20,5,20
Kolkata,6253,4,4,7,3,18,15,3,19
Chennaiyin,6253,5,4,6,4,20,21,-1,18
FC Pune City,6253,6,5,3,6,15,19,-4,18
Kerala Blast,6253,7,5,3,6,13,19,-6,18
FC Goa,6253,8,4,3,7,13,20,-7,15
Delhi Dynamo,6254,1,6,6,2,24,15,9,24
Mumbai City,6254,2,6,4,4,16,9,7,22
NorthEast Un,6254,3,6,3,5,12,10,2,21
Kolkata,6254,4,4,8,2,19,16,3,20
FC Pune City,6254,5,5,4,5,14,15,-1,19
Kerala Blast,6254,6,4,4,6,11,17,-6,16
Chennaiyin,6254,7,3,6,5,13,18,-5,15
FC Goa,6254,8,3,3,8,9,18,-9,12
Delhi Dynamo,6255,1,6,5,3,26,17,9,23
Mumbai City,6255,2,6,4,4,16,10,6,22
Kolkata,6255,3,5,6,3,20,18,2,21
NorthEast Un,6255,4,5,3,6,13,13,0,18
FC Pune City,6255,5,5,3,6,16,17,-1,18
Chennaiyin,6255,6,4,5,5,18,19,-1,17
FC Goa,6255,7,5,2,7,12,19,-7,17
Kerala Blast,6255,8,4,4,6,13,21,-8,16
Mumbai City,6256,1,7,4,3,17,8,9,25
Delhi Dynamo,6256,2,5,5,4,26,19,7,20
Kolkata,6256,3,4,8,2,18,15,3,20
NorthEast Un,6256,4,6,2,6,15,13,2,20
Chennaiyin,6256,5,5,5,4,18,18,0,20
Kerala Blast,6256,6,5,3,6,13,18,-5,18
FC Pune City,6256,7,4,4,6,14,18,-4,16
FC Goa,6256,8,3,3,8,11,23,-12,12
Delhi Dynamo,6257,1,7,5,2,28,17,11,26
Mumbai City,6257,2,6,4,4,17,10,7,22
Kerala Blast,6257,3,5,5,4,13,15,-2,20
FC Pune City,6257,4,5,4,5,14,14,0,19
Kolkata,6257,5,4,6,4,17,18,-1,18
Chennaiyin,6257,6,4,5,5,15,20,-5,17
NorthEast Un,6257,7,4,3,7,12,14,-2,15
FC Goa,6257,8,4,2,8,12,20,-8,14
Mumbai City,6258,1,6,5,3,16,8,8,23
Kolkata,6258,2,5,6,3,17,17,0,21
Delhi Dynamo,6258,3,4,7,3,22,16,6,19
Kerala Blast,6258,4,5,4,5,13,16,-3,19
NorthEast Un,6258,5,5,3,6,13,14,-1,18
FC Goa,6258,6,5,3,6,13,15,-2,18
Chennaiyin,6258,7,4,5,5,17,20,-3,17
FC Pune City,6258,8,4,3,7,13,18,-5,15
Mumbai City,6259,1,7,4,3,18,9,9,25
Delhi Dynamo,6259,2,6,5,3,26,17,9,23
Kerala Blast,6259,3,6,4,4,14,15,-1,22
Kolkata,6259,4,3,8,3,15,15,0,17
NorthEast Un,6259,5,5,2,7,11,14,-3,17
FC Pune City,6259,6,4,4,6,12,15,-3,16
Chennaiyin,6259,7,3,6,5,14,19,-5,15
FC Goa,6259,8,4,3,7,10,16,-6,15
Mumbai City,6260,1,6,5,3,16,8,8,23
Kolkata,6260,2,5,7,2,15,12,3,22
Delhi Dynamo,6260,3,5,6,3,25,17,8,21
Kerala Blast,6260,4,6,3,5,14,14,0,21
FC Goa,6260,5,5,2,7,14,16,-2,17
Chennaiyin,6260,6,4,5,5,16,23,-7,17
FC Pune City,6260,7,4,4,6,12,16,-4,16
NorthEast Un,6260,8,4,2,8,12,18,-6,14
Mumbai City,6261,1,7,4,3,19,8,11,25
Kerala Blast,6261,2,6,4,4,16,15,1,22
Delhi Dynamo,6261,3,4,7,3,24,20,4,19
Kolkata,6261,4,4,7,3,20,16,4,19
NorthEast Un,6261,5,5,3,6,13,15,-2,18
FC Pune City,6261,6,4,5,5,14,16,-2,17
Chennaiyin,6261,7,3,6,5,14,20,-6,15
FC Goa,6261,8,3,4,7,11,21,-10,13
Delhi Dynamo,6262,1,6,5,3,26,17,9,23
Mumbai City,6262,2,6,4,4,16,9,7,22
NorthEast Un,6262,3,6,2,6,17,14,3,20
Kolkata,6262,4,4,6,4,17,16,1,18
FC Pune City,6262,5,5,3,6,14,16,-2,18
Chennaiyin,6262,6,4,6,4,15,18,-3,18
Kerala Blast,6262,7,5,3,6,14,22,-8,18
FC Goa,6262,8,4,3,7,11,18,-7,15
Mumbai City,6263,1,7,4,3,19,9,10,25
Kolkata,6263,2,5,6,3,20,18,2,21
Kerala Blast,6263,3,6,3,5,16,18,-2,21
Delhi Dynamo,6263,4,4,7,3,25,20,5,19
FC Goa,6263,5,5,3,6,13,15,-2,18
NorthEast Un,6263,5,5,3,6,13,15,-2,18
FC Pune City,6263,7,4,3,7,14,19,-5,15
Chennaiyin,6263,8,3,5,6,13,19,-6,14
Delhi Dynamo,6264,1,5,7,2,27,16,11,22
Mumbai City,6264,2,6,4,4,16,12,4,22
Kolkata,6264,3,5,6,3,17,14,3,21
Kerala Blast,6264,4,6,3,5,15,19,-4,21
FC Pune City,6264,5,5,3,6,17,18,-1,18
Chennaiyin,6264,6,4,6,4,15,17,-2,18
NorthEast Un,6264,7,4,4,6,10,12,-2,16
FC Goa,6264,8,3,3,8,9,18,-9,12
Mumbai City,6265,1,7,4,3,17,8,9,25
Delhi Dynamo,6265,2,5,6,3,24,17,7,21
Kolkata,6265,3,4,8,2,17,15,2,20
NorthEast Un,6265,4,5,3,6,13,13,0,18
Kerala Blast,6265,5,5,3,6,12,17,-5,18
Chennaiyin,6265,6,4,5,5,15,21,-6,17
FC Pune City,6265,7,4,4,6,16,19,-3,16
FC Goa,6265,8,4,3,7,12,16,-4,15
Mumbai City,6266,1,7,4,3,17,8,9,25
Kolkata,6266,2,5,7,2,18,12,6,22
Delhi Dynamo,6266,3,5,6,3,23,15,8,21
NorthEast Un,6266,4,5,4,5,11,10,1,19
FC Pune City,6266,5,4,4,6,13,17,-4,16
Kerala Blast,6266,6,4,4,6,11,19,-8,16
Chennaiyin,6266,7,3,6,5,13,18,-5,15
FC Goa,6266,8,4,3,7,9,16,-7,15
Mumbai City,6267,1,6,5,3,17,9,8,23
Kolkata,6267,2,4,8,2,17,14,3,20
Chennaiyin,6267,3,5,5,4,16,17,-1,20
Delhi Dynamo,6267,4,4,7,3,23,18,5,19
Kerala Blast,6267,5,5,4,5,10,15,-5,19
NorthEast Un,6267,6,5,2,7,11,11,0,17
FC Pune City,6267,7,4,5,5,12,14,-2,17
FC Goa,6267,8,3,4,7,11,19,-8,13
Mumbai City,6268,1,6,4,4,17,10,7,22
Delhi Dynamo,6268,2,5,5,4,23,20,3,20
Chennaiyin,6268,3,5,5,4,17,17,0,20
Kolkata,6268,4,4,7,3,16,15,1,19
NorthEast Un,6268,5,5,3,6,13,13,0,18
Kerala Blast,6268,6,4,6,4,12,16,-4,18
FC Goa,6268,7,5,2,7,11,15,-4,17
FC Pune City,6268,8,4,4,6,14,17,-3,16
Mumbai City,6269,1,7,4,3,19,9,10,25
Kolkata,6269,2,6,6,2,16,12,4,24
Chennaiyin,6269,3,5,5,4,19,19,0,20
Delhi Dynamo,6269,4,4,6,4,24,22,2,18
FC Pune City,6269,5,5,3,6,14,16,-2,18
Kerala Blast,6269,6,5,3,6,11,16,-5,18
NorthEast Un,6269,7,5,2,7,14,13,1,17
FC Goa,6269,8,3,3,8,10,20,-10,12
Mumbai City,6270,1,7,4,3,17,8,9,25
Delhi Dynamo,6270,2,6,5,3,25,16,9,23
Kolkata,6270,3,5,6,3,16,14,2,21
NorthEast Un,6270,4,5,3,6,11,11,0,18
FC Pune City,6270,5,5,3,6,13,16,-3,18
Chennaiyin,6270,6,4,5,5,16,19,-3,17
Kerala Blast,6270,7,4,4,6,10,16,-6,16
FC Goa,6270,8,4,2,8,12,20,-8,14
Delhi Dynamo,6271,1,6,6,2,26,15,11,24
Mumbai City,6271,2,6,5,3,16,8,8,23
Kerala Blast,6271,3,6,3,5,13,15,-2,21
NorthEast Un,6271,4,6,2,6,13,13,0,20
Kolkata,6271,5,4,6,4,16,14,2,18
Chennaiyin,6271,6,3,6,5,13,18,-5,15
FC Pune City,6271,7,4,3,7,12,19,-7,15
FC Goa,6271,8,4,3,7,9,16,-7,15
Delhi Dynamo,6272,1,7,5,2,26,16,10,26
Mumbai City,6272,2,6,4,4,17,10,7,22
Kerala Blast,6272,3,6,4,4,18,15,3,22
Kolkata,6272,4,5,6,3,19,18,1,21
NorthEast Un,6272,5,5,3,6,13,13,0,18
FC Pune City,6272,6,4,3,7,13,21,-8,15
FC Goa,6272,7,4,2,8,14,18,-4,14
Chennaiyin,6272,8,3,5,6,14,23,-9,14
Mumbai City,6273,1,7,4,3,19,9,10,25
Kolkata,6273,2,5,6,3,17,15,2,21
Delhi Dynamo,6273,3,4,7,3,23,18,5,19
Chennaiyin,6273,4,4,6,4,16,19,-3,18
Kerala Blast,6273,5,4,5,5,11,16,-5,17
NorthEast Un,6273,6,4,4,6,11,12,-1,16
FC Pune City,6273,7,4,4,6,13,16,-3,16
FC Goa,6273,8,4,4,6,11,16,-5,16
Mumbai City,6274,1,7,4,3,18,8,10,25
Delhi Dynamo,6274,2,5,5,4,24,21,3,20
FC Goa,6274,3,6,2,6,14,14,0,20
Kerala Blast,6274,4,5,4,5,10,15,-5,19
Kolkata,6274,5,4,6,4,15,14,1,18
FC Pune City,6274,6,5,3,6,14,16,-2,18
NorthEast Un,6274,7,4,4,6,13,14,-1,16
Chennaiyin,6274,8,3,6,5,15,21,-6,15
Mumbai City,6275,1,6,4,4,17,10,7,22
Delhi Dynamo,6275,2,5,6,3,24,18,6,21
Kerala Blast,6275,3,6,3,5,15,15,0,21
Kolkata,6275,4,4,7,3,15,16,-1,19
FC Pune City,6275,5,5,4,5,14,15,-1,19
Chennaiyin,6275,6,4,6,4,16,18,-2,18
NorthEast Un,6275,7,5,2,7,12,14,-2,17
FC Goa,6275,8,3,4,7,10,17,-7,13
Mumbai City,6276,1,7,4,3,17,8,9,25
Delhi Dynamo,6276,2,5,5,4,23,17,6,20
NorthEast Un,6276,3,5,4,5,11,9,2,19
Kolkata,6276,4,4,7,3,14,13,1,19
FC Pune City,6276,5,5,3,6,16,18,-2,18
Chennaiyin,6276,6,4,6,4,14,17,-3,18
Kerala Blast,6276,7,4,5,5,12,17,-5,17
FC Goa,6276,8,4,2,8,9,17,-8,14
Mumbai City,6277,1,7,4,3,17,8,9,25
Kolkata,6277,2,5,6,3,22,14,8,21
NorthEast Un,6277,3,6,3,5,12,9,3,21
FC Pune City,6277,4,6,3,5,16,15,1,21
Delhi Dynamo,6277,5,5,5,4,26,17,9,20
Kerala Blast,6277,6,4,4,6,11,21,-10,16
Chennaiyin,6277,7,3,5,6,14,20,-6,14
FC Goa,6277,8,4,2,8,10,24,-14,14
Mumbai City,6278,1,7,4,3,18,9,9,25
Delhi Dynamo,6278,2,5,6,3,24,16,8,21
Kerala Blast,6278,3,6,3,5,11,14,-3,21
FC Pune City,6278,4,5,4,5,14,15,-1,19
FC Goa,6278,5,5,3,6,11,14,-3,18
Chennaiyin,6278,6,4,5,5,15,19,-4,17
Kolkata,6278,7,3,7,4,14,15,-1,16
NorthEast Un,6278,8,4,2,8,9,14,-5,14
Mumbai City,6279,1,7,4,3,17,8,9,25
Kolkata,6279,2,5,7,2,20,13,7,22
Delhi Dynamo,6279,3,5,5,4,24,19,5,20
Kerala Blast,6279,4,5,4,5,12,16,-4,19
NorthEast Un,6279,5,5,3,6,13,12,1,18
Chennaiyin,6279,6,4,5,5,14,19,-5,17
FC Pune City,6279,7,4,4,6,13,17,-4,16
FC Goa,6279,8,4,2,8,11,20,-9,14
Mumbai City,6280,1,7,4,3,18,9,9,25
Kerala Blast,6280,2,6,4,4,14,14,0,22
FC Goa,6280,3,6,2,6,15,15,0,20
NorthEast Un,6280,4,5,4,5,13,12,1,19
Kolkata,6280,5,4,6,4,17,15,2,18
Delhi Dynamo,6280,6,4,5,5,23,19,4,17
Chennaiyin,6280,7,3,6,5,15,22,-7,15
FC Pune City,6280,8,4,3,7,12,21,-9,15
Delhi Dynamo,6281,1,6,6,2,28,17,11,24
Mumbai City,6281,2,6,4,4,17,12,5,22
Kerala Blast,6281,3,6,4,4,13,13,0,22
Kolkata,6281,4,4,7,3,16,16,0,19
Chennaiyin,6281,5,4,6,4,16,19,-3,18
NorthEast Un,6281,6,4,3,7,10,12,-2,15
FC Pune City,6281,7,4,3,7,13,18,-5,15
FC Goa,6281,8,3,5,6,12,18,-6,14
Mumbai City,6282,1,7,4,3,18,9,9,25
Kolkata,6282,2,5,7,2,21,13,8,22
NorthEast Un,6282,3,6,2,6,13,11,2,20
FC Pune City,6282,4,5,4,5,14,14,0,19
Delhi Dynamo,6282,5,4,6,4,24,20,4,18
Chennaiyin,6282,6,4,6,4,15,18,-3,18
Kerala Blast,6282,7,4,3,7,9,19,-10,15
FC Goa,6282,8,3,4,7,11,21,-10,13
Mumbai City,6283,1,7,4,3,20,8,12,25
Kolkata,6283,2,6,6,2,19,12,7,24
NorthEast Un,6283,3,6,3,5,15,11,4,21
Delhi Dynamo,6283,4,4,6,4,24,23,1,18
FC Pune City,6283,5,5,3,6,14,18,-4,18
Chennaiyin,6283,6,3,7,4,16,20,-4,16
Kerala Blast,6283,7,4,3,7,10,18,-8,15
FC Goa,6283,8,3,4,7,12,20,-8,13
Mumbai City,6284,1,6,4,4,16,10,6,22
Kolkata,6284,2,5,7,2,17,14,3,22
Delhi Dynamo,6284,3,5,6,3,25,17,8,21
NorthEast Un,6284,4,6,3,5,13,11,2,21
Kerala Blast,6284,5,5,3,6,10,15,-5,18
FC Pune City,6284,6,4,4,6,12,15,-3,16
Chennaiyin,6284,7,3,6,5,17,22,-5,15
FC Goa,6284,8,4,3,7,15,21,-6,15
Mumbai City,6285,1,7,4,3,19,8,11,25
Kolkata,6285,2,6,6,2,21,13,8,24
Delhi Dynamo,6285,3,5,5,4,24,21,3,20
NorthEast Un,6285,4,5,3,6,14,14,0,18
Chennaiyin,6285,5,4,5,5,15,19,-4,17
Kerala Blast,6285,6,4,5,5,12,17,-5,17
FC Pune City,6285,7,4,4,6,13,17,-4,16
FC Goa,6285,8,4,2,8,10,19,-9,14
Mumbai City,6286,1,6,4,4,17,10,7,22
Delhi Dynamo,6286,2,5,6,3,25,18,7,21
Kerala Blast,6286,3,5,5,4,13,16,-3,20
Kolkata,6286,4,4,7,3,18,16,2,19
NorthEast Un,6286,5,5,4,5,12,11,1,19
FC Goa,6286,6,4,4,6,14,16,-2,16
FC Pune City,6286,7,4,4,6,13,17,-4,16
Chennaiyin,6286,8,3,6,5,14,22,-8,15
Delhi Dynamo,6287,1,7,5,2,28,16,12,26
Kolkata,6287,2,6,6,2,20,13,7,24
Mumbai City,6287,3,6,4,4,16,10,6,22
Kerala Blast,6287,4,6,3,5,13,17,-4,21
Chennaiyin,6287,5,4,6,4,15,18,-3,18
FC Pune City,6287,6,4,3,7,12,17,-5,15
NorthEast Un,6287,7,4,2,8,10,15,-5,14
FC Goa,6287,8,3,3,8,10,18,-8,12
Mumbai City,6288,1,7,4,3,17,8,9,25
Delhi Dynamo,6288,2,6,5,3,24,16,8,23
Kolkata,6288,3,4,7,3,16,16,0,19
FC Pune City,6288,4,5,4,5,15,15,0,19
Chennaiyin,6288,5,4,6,4,15,17,-2,18
NorthEast Un,6288,6,5,2,7,11,13,-2,17
Kerala Blast,6288,7,4,5,5,10,15,-5,17
FC Goa,6288,8,3,3,8,8,16,-8,12
Delhi Dynamo,6289,1,6,5,3,26,19,7,23
Mumbai City,6289,2,6,4,4,17,10,7,22
Kolkata,6289,3,4,8,2,18,14,4,20
Kerala Blast,6289,4,5,5,4,14,17,-3,20
NorthEast Un,6289,5,5,2,7,14,14,0,17
Chennaiyin,6289,6,4,5,5,15,19,-4,17
FC Pune City,6289,7,4,4,6,15,20,-5,16
FC Goa,6289,8,4,3,7,12,18,-6,15
Mumbai City,6290,1,7,4,3,19,10,9,25
Delhi Dynamo,6290,2,5,6,3,27,19,8,21
Kolkata,6290,3,4,7,3,15,15,0,19
Kerala Blast,6290,4,5,4,5,12,16,-4,19
FC Goa,6290,5,5,3,6,12,15,-3,18
NorthEast Un,6290,6,4,4,6,12,14,-2,16
FC Pune City,6290,7,4,4,6,12,15,-3,16
Chennaiyin,6290,8,3,6,5,14,19,-5,15
Delhi Dynamo,6291,1,7,5,2,25,14,11,26
Mumbai City,6291,2,6,4,4,16,10,6,22
NorthEast Un,6291,3,6,2,6,13,10,3,20
Kolkata,6291,4,4,8,2,17,15,2,20
Kerala Blast,6291,5,5,3,6,10,17,-7,18
FC Pune City,6291,6,4,4,6,13,16,-3,16
FC Goa,6291,7,4,3,7,12,17,-5,15
Chennaiyin,6291,8,3,5,6,13,20,-7,14
Delhi Dynamo,6292,1,6,6,2,27,18,9,24
Mumbai City,6292,2,6,4,4,17,10,7,22
NorthEast Un,6292,3,6,3,5,13,10,3,21
Kolkata,6292,4,4,8,2,17,15,2,20
Kerala Blast,6292,5,5,3,6,12,16,-4,18
FC Pune City,6292,6,4,4,6,13,17,-4,16
Chennaiyin,6292,7,3,6,5,15,21,-6,15
FC Goa,6292,8,3,4,7,13,20,-7,13
Delhi Dynamo,6293,1,7,5,2,24,14,10,26
Kerala Blast,6293,2,7,3,4,15,13,2,24
Mumbai City,6293,3,6,4,4,16,9,7,22
NorthEast Un,6293,4,5,2,7,10,13,-3,17
Chennaiyin,6293,5,4,5,5,15,19,-4,17
Kolkata,6293,6,3,7,4,14,16,-2,16
FC Pune City,6293,7,4,4,6,13,17,-4,16
FC Goa,6293,8,4,2,8,11,17,-6,14
Delhi Dynamo,6294,1,6,5,3,26,18,8,23
Mumbai City,6294,2,6,4,4,16,10,6,22
Kolkata,6294,3,5,6,3,18,16,2,21
Chennaiyin,6294,4,5,5,4,19,20,-1,20
NorthEast Un,6294,5,5,3,6,14,13,1,18
FC Pune City,6294,6,5,3,6,14,17,-3,18
Kerala Blast,6294,7,4,4,6,10,16,-6,16
FC Goa,6294,8,4,2,8,12,19,-7,14
Mumbai City,6295,1,6,5,3,17,9,8,23
Delhi Dynamo,6295,2,5,7,2,24,16,8,22
Kolkata,6295,3,4,7,3,14,13,1,19
Kerala Blast,6295,4,5,4,5,12,16,-4,19
NorthEast Un,6295,5,4,5,5,12,12,0,17
FC Goa,6295,6,5,2,7,12,16,-4,17
FC Pune City,6295,7,4,4,6,13,16,-3,16
Chennaiyin,6295,8,3,6,5,15,21,-6,15
Mumbai City,6296,1,7,4,3,18,9,9,25
Delhi Dynamo,6296,2,5,6,3,25,18,7,21
NorthEast Un,6296,3,6,2,6,12,11,1,20
Kolkata,6296,4,4,7,3,19,19,0,19
Kerala Blast,6296,5,5,4,5,13,15,-2,19
FC Goa,6296,6,4,4,6,16,18,-2,16
Chennaiyin,6296,7,3,6,5,15,20,-5,15
FC Pune City,6296,8,4,3,7,13,21,-8,15
Kolkata,6297,1,5,7,2,18,14,4,22
Mumbai City,6297,2,6,4,4,16,13,3,22
Delhi Dynamo,6297,3,5,6,3,28,17,11,21
Kerala Blast,6297,4,5,4,5,12,16,-4,19
NorthEast Un,6297,5,5,3,6,11,12,-1,18
FC Pune City,6297,6,4,5,5,15,17,-2,17
Chennaiyin,6297,7,3,6,5,13,18,-5,15
FC Goa,6297,8,4,3,7,10,16,-6,15
Mumbai City,6298,1,7,4,3,19,9,10,25
Kolkata,6298,2,5,7,2,19,16,3,22
NorthEast Un,6298,3,6,3,5,17,10,7,21
Delhi Dynamo,6298,4,5,5,4,27,24,3,20
Kerala Blast,6298,5,5,4,5,13,17,-4,19
Chennaiyin,6298,6,4,5,5,15,20,-5,17
FC Pune City,6298,7,4,3,7,12,16,-4,15
FC Goa,6298,8,3,3,8,13,23,-10,12
Mumbai City,6299,1,7,4,3,17,8,9,25
Kolkata,6299,2,4,8,2,19,16,3,20
Delhi Dynamo,6299,3,4,6,4,23,19,4,18
FC Pune City,6299,4,5,3,6,16,19,-3,18
Chennaiyin,6299,5,4,6,4,15,18,-3,18
Kerala Blast,6299,6,4,5,5,14,19,-5,17
NorthEast Un,6299,7,4,4,6,11,12,-1,16
FC Goa,6299,8,4,4,6,13,17,-4,16
Delhi Dynamo,6300,1,6,5,3,26,20,6,23
Mumbai City,6300,2,6,4,4,17,10,7,22
NorthEast Un,6300,3,6,3,5,16,11,5,21
Kolkata,6300,4,5,6,3,16,14,2,21
FC Pune City,6300,5,5,4,5,14,14,0,19
Chennaiyin,6300,6,4,6,4,17,19,-2,18
Kerala Blast,6300,7,4,4,6,10,17,-7,16
FC Goa,6300,8,3,2,9,10,21,-11,11
Mumbai City,6301,1,7,4,3,24,9,15,25
Kolkata,6301,2,4,7,3,18,16,2,19
NorthEast Un,6301,3,5,4,5,13,11,2,19
Delhi Dynamo,6301,4,4,7,3,23,23,0,19
Chennaiyin,6301,5,4,6,4,16,19,-3,18
FC Pune City,6301,6,5,3,6,14,18,-4,18
Kerala Blast,6301,7,5,3,6,12,17,-5,18
FC Goa,6301,8,3,4,7,9,16,-7,13
Mumbai City,6302,1,7,4,3,17,8,9,25
Kolkata,6302,2,6,6,2,21,14,7,24
Delhi Dynamo,6302,3,5,5,4,26,18,8,20
Kerala Blast,6302,4,5,4,5,12,16,-4,19
NorthEast Un,6302,5,5,3,6,11,13,-2,18
Chennaiyin,6302,6,4,5,5,16,18,-2,17
FC Pune City,6302,7,4,3,7,13,20,-7,15
FC Goa,6302,8,4,2,8,11,20,-9,14
Mumbai City,6303,1,7,4,3,18,9,9,25
Kerala Blast,6303,2,6,3,5,15,17,-2,21
Delhi Dynamo,6303,3,5,5,4,24,20,4,20
NorthEast Un,6303,4,5,3,6,15,12,3,18
Kolkata,6303,5,4,6,4,18,16,2,18
FC Pune City,6303,6,5,3,6,14,20,-6,18
Chennaiyin,6303,7,3,7,4,15,19,-4,16
FC Goa,6303,8,4,3,7,12,18,-6,15
Mumbai City,6304,1,6,5,3,16,8,8,23
Delhi Dynamo,6304,2,5,7,2,26,17,9,22
Kerala Blast,6304,3,6,4,4,12,14,-2,22
Kolkata,6304,4,4,6,4,15,15,0,18
FC Goa,6304,5,5,3,6,13,17,-4,18
Chennaiyin,6304,6,4,5,5,16,20,-4,17
NorthEast Un,6304,7,4,3,7,13,16,-3,15
FC Pune City,6304,8,4,3,7,12,16,-4,15
Mumbai City,6305,1,7,4,3,19,8,11,25
Kerala Blast,6305,2,6,3,5,13,16,-3,21
FC Goa,6305,3,6,2,6,16,18,-2,20
Kolkata,6305,4,4,7,3,18,17,1,19
Delhi Dynamo,6305,5,4,6,4,23,21,2,18
Chennaiyin,6305,6,4,5,5,17,21,-4,17
FC Pune City,6305,7,4,4,6,15,18,-3,16
NorthEast Un,6305,8,4,3,7,11,13,-2,15
Delhi Dynamo,6306,1,7,5,2,27,14,13,26
Mumbai City,6306,2,6,4,4,16,10,6,22
Kerala Blast,6306,3,6,3,5,14,16,-2,21
Kolkata,6306,4,4,7,3,15,15,0,19
FC Pune City,6306,5,5,3,6,16,17,-1,18
Chennaiyin,6306,6,4,6,4,15,18,-3,18
NorthEast Un,6306,7,4,3,7,11,16,-5,15
FC Goa,6306,8,3,3,8,8,16,-8,12
Delhi Dynamo,6307,1,6,6,2,25,16,9,24
Mumbai City,6307,2,6,4,4,17,10,7,22
Kolkata,6307,3,5,7,2,18,15,3,22
FC Pune City,6307,4,5,3,6,13,15,-2,18
Chennaiyin,6307,5,4,5,5,15,19,-4,17
NorthEast Un,6307,6,4,4,6,11,13,-2,16
Kerala Blast,6307,7,4,4,6,11,17,-6,16
FC Goa,6307,8,4,3,7,12,17,-5,15
Mumbai City,6308,1,7,4,3,19,9,10,25
Kolkata,6308,2,6,6,2,19,12,7,24
Delhi Dynamo,6308,3,6,5,3,27,20,7,23
FC Pune City,6308,4,5,3,6,16,17,-1,18
Chennaiyin,6308,5,4,5,5,15,20,-5,17
Kerala Blast,6308,6,4,4,6,9,18,-9,16
NorthEast Un,6308,7,4,3,7,11,13,-2,15
FC Goa,6308,8,4,2,8,12,19,-7,14
Mumbai City,6309,1,7,4,3,18,9,9,25
Delhi Dynamo,6309,2,5,6,3,24,17,7,21
FC Pune City,6309,3,6,3,5,15,15,0,21
Kolkata,6309,4,4,6,4,15,16,-1,18
NorthEast Un,6309,5,4,5,5,11,11,0,17
Chennaiyin,6309,6,3,7,4,14,18,-4,16
Kerala Blast,6309,7,4,4,6,12,18,-6,16
FC Goa,6309,8,4,3,7,11,16,-5,15
Mumbai City,6310,1,7,4,3,18,8,10,25
Delhi Dynamo,6310,2,5,5,4,24,18,6,20
Kolkata,6310,3,4,8,2,17,15,2,20
Chennaiyin,6310,4,5,5,4,15,17,-2,20
NorthEast Un,6310,5,5,3,6,11,10,1,18
FC Pune City,6310,6,5,3,6,15,17,-2,18
Kerala Blast,6310,7,4,5,5,10,15,-5,17
FC Goa,6310,8,3,3,8,10,20,-10,12
Delhi Dynamo,6311,1,7,5,2,28,16,12,26
Kerala Blast,6311,2,7,3,4,14,13,1,24
Mumbai City,6311,3,6,4,4,17,11,6,22
FC Pune City,6311,4,5,3,6,15,16,-1,18
NorthEast Un,6311,5,5,2,7,10,12,-2,17
FC Goa,6311,6,4,3,7,12,16,-4,15
Chennaiyin,6311,7,3,6,5,13,18,-5,15
Kolkata,6311,8,3,6,5,14,21,-7,15
Delhi Dynamo,6312,1,6,6,2,28,17,11,24
Mumbai City,6312,2,6,4,4,16,10,6,22
NorthEast Un,6312,3,5,4,5,12,10,2,19
Kerala Blast,6312,4,4,6,4,10,14,-4,18
Kolkata,6312,5,3,8,3,16,16,0,17
FC Pune City,6312,6,4,5,5,14,16,-2,17
Chennaiyin,6312,7,4,5,5,14,19,-5,17
FC Goa,6312,8,4,2,8,13,21,-8,14
Mumbai City,6313,1,6,4,4,18,12,6,22
FC Pune City,6313,2,6,3,5,16,14,2,21
Kolkata,6313,3,5,6,3,15,13,2,21
NorthEast Un,6313,4,6,3,5,12,10,2,21
Delhi Dynamo,6313,5,5,5,4,25,19,6,20
FC Goa,6313,6,5,2,7,12,15,-3,17
Chennaiyin,6313,7,3,6,5,13,19,-6,15
Kerala Blast,6313,8,4,3,7,10,19,-9,15
Mumbai City,6314,1,6,4,4,17,10,7,22
Delhi Dynamo,6314,2,5,5,4,25,21,4,20
NorthEast Un,6314,3,6,2,6,14,11,3,20
Kolkata,6314,4,4,8,2,16,14,2,20
Chennaiyin,6314,5,4,6,4,15,17,-2,18
FC Pune City,6314,6,4,5,5,15,17,-2,17
Kerala Blast,6314,7,4,5,5,12,18,-6,17
FC Goa,6314,8,4,3,7,11,17,-6,15
Kolkata,6315,1,6,6,2,18,14,4,24
Delhi Dynamo,6315,2,6,5,3,27,16,11,23
Mumbai City,6315,3,6,4,4,17,10,7,22
NorthEast Un,6315,4,6,2,6,14,11,3,20
Chennaiyin,6315,5,4,5,5,15,20,-5,17
FC Pune City,6315,6,4,4,6,13,16,-3,16
Kerala Blast,6315,7,4,4,6,9,17,-8,16
FC Goa,6315,8,4,2,8,11,20,-9,14
Kolkata,6316,1,6,6,2,21,12,9,24
Mumbai City,6316,2,6,5,3,17,9,8,23
NorthEast Un,6316,3,7,2,5,14,10,4,23
Delhi Dynamo,6316,4,4,7,3,23,17,6,19
Kerala Blast,6316,5,5,3,6,11,19,-8,18
FC Pune City,6316,6,4,3,7,12,18,-6,15
FC Goa,6316,7,4,3,7,11,18,-7,15
Chennaiyin,6316,8,3,5,6,15,21,-6,14
Delhi Dynamo,6317,1,5,7,2,23,15,8,22
Mumbai City,6317,2,6,4,4,16,9,7,22
Kerala Blast,6317,3,6,4,4,13,15,-2,22
Kolkata,6317,4,4,6,4,16,15,1,18
FC Goa,6317,5,5,3,6,13,15,-2,18
NorthEast Un,6317,6,4,5,5,14,14,0,17
Chennaiyin,6317,7,3,6,5,16,22,-6,15
FC Pune City,6317,8,4,3,7,12,18,-6,15
Mumbai City,6318,1,7,4,3,17,8,9,25
Kolkata,6318,2,4,8,2,22,16,6,20
NorthEast Un,6318,3,6,2,6,13,14,-1,20
FC Pune City,6318,4,5,4,5,15,16,-1,19
FC Goa,6318,5,5,3,6,12,16,-4,18
Kerala Blast,6318,6,5,3,6,14,21,-7,18
Delhi Dynamo,6318,7,4,5,5,23,19,4,17
Chennaiyin,6318,8,3,5,6,13,19,-6,14
Mumbai City,6319,1,7,4,3,20,10,10,25
Delhi Dynamo,6319,2,5,6,3,26,19,7,21
NorthEast Un,6319,3,6,2,6,13,11,2,20
FC Pune City,6319,4,5,4,5,15,16,-1,19
FC Goa,6319,5,5,3,6,14,15,-1,18
Kerala Blast,6319,6,5,3,6,11,16,-5,18
Kolkata,6319,7,3,7,4,14,16,-2,16
Chennaiyin,6319,8,3,5,6,13,23,-10,14
Mumbai City,6320,1,6,5,3,18,10,8,23
Delhi Dynamo,6320,2,4,7,3,27,21,6,19
Kerala Blast,6320,3,5,4,5,11,16,-5,19
Kolkata,6320,4,4,6,4,16,16,0,18
Chennaiyin,6320,5,4,6,4,15,17,-2,18
FC Pune City,6320,6,5,3,6,13,15,-2,18
NorthEast Un,6320,7,4,5,5,13,13,0,17
FC Goa,6320,8,5,2,7,13,18,-5,17
Delhi Dynamo,6321,1,6,5,3,26,16,10,23
Mumbai City,6321,2,6,4,4,16,9,7,22
Kerala Blast,6321,3,6,4,4,17,15,2,22
Kolkata,6321,4,4,6,4,17,17,0,18
Chennaiyin,6321,5,4,5,5,16,20,-4,17
FC Goa,6321,6,5,2,7,12,17,-5,17
NorthEast Un,6321,7,5,2,7,11,16,-5,17
FC Pune City,6321,8,4,4,6,15,20,-5,16
Delhi Dynamo,6322,1,6,6,2,25,15,10,24
Mumbai City,6322,2,6,4,4,16,9,7,22
Kerala Blast,6322,3,5,5,4,10,13,-3,20
Kolkata,6322,4,4,7,3,14,13,1,19
FC Goa,6322,5,5,3,6,15,16,-1,18
NorthEast Un,6322,6,5,3,6,11,12,-1,18
FC Pune City,6322,7,4,3,7,12,16,-4,15
Chennaiyin,6322,8,3,5,6,15,24,-9,14
Mumbai City,6323,1,6,5,3,17,9,8,23
NorthEast Un,6323,2,7,2,5,15,12,3,23
Delhi Dynamo,6323,3,5,6,3,25,18,7,21
Kolkata,6323,4,4,7,3,20,19,1,19
FC Pune City,6323,5,4,5,5,14,16,-2,17
Chennaiyin,6323,6,4,5,5,17,20,-3,17
Kerala Blast,6323,7,4,4,6,10,19,-9,16
FC Goa,6323,8,4,2,8,15,20,-5,14
Delhi Dynamo,6324,1,5,7,2,25,17,8,22
Mumbai City,6324,2,6,4,4,17,10,7,22
Kerala Blast,6324,3,5,5,4,11,14,-3,20
NorthEast Un,6324,4,5,4,5,14,11,3,19
Kolkata,6324,5,4,6,4,14,15,-1,18
Chennaiyin,6324,6,4,5,5,16,22,-6,17
FC Pune City,6324,7,4,4,6,13,16,-3,16
FC Goa,6324,8,4,3,7,12,17,-5,15
Delhi Dynamo,6325,1,7,5,2,31,15,16,26
Mumbai City,6325,2,6,4,4,16,10,6,22
Kerala Blast,6325,3,6,4,4,13,15,-2,22
Kolkata,6325,4,4,7,3,17,14,3,19
Chennaiyin,6325,5,4,5,5,14,19,-5,17
NorthEast Un,6325,6,4,3,7,10,15,-5,15
FC Pune City,6325,7,4,3,7,13,19,-6,15
FC Goa,6325,8,4,3,7,12,19,-7,15
Mumbai City,6326,1,7,4,3,17,8,9,25
Kolkata,6326,2,5,7,2,17,13,4,22
Delhi Dynamo,6326,3,5,6,3,24,16,8,21
Chennaiyin,6326,4,5,5,4,15,17,-2,20
FC Pune City,6326,5,5,3,6,14,17,-3,18
Kerala Blast,6326,6,5,3,6,11,16,-5,18
NorthEast Un,6326,7,4,3,7,10,12,-2,15
FC Goa,6326,8,3,3,8,9,18,-9,12
Mumbai City,6327,1,7,4,3,18,8,10,25
Kolkata,6327,2,5,7,2,18,15,3,22
Delhi Dynamo,6327,3,4,6,4,23,19,4,18
FC Pune City,6327,4,5,3,6,14,15,-1,18
NorthEast Un,6327,5,5,3,6,12,13,-1,18
FC Goa,6327,6,5,3,6,14,17,-3,18
Chennaiyin,6327,7,4,5,5,15,19,-4,17
Kerala Blast,6327,8,4,3,7,11,19,-8,15
Mumbai City,6328,1,7,4,3,19,9,10,25
NorthEast Un,6328,2,7,2,5,15,12,3,23
Delhi Dynamo,6328,3,5,5,4,25,19,6,20
Kolkata,6328,4,4,8,2,15,13,2,20
FC Pune City,6328,5,4,5,5,13,15,-2,17
Kerala Blast,6328,6,4,5,5,10,15,-5,17
Chennaiyin,6328,7,3,5,6,14,20,-6,14
FC Goa,6328,8,4,2,8,9,17,-8,14
Mumbai City,6329,1,7,4,3,19,9,10,25
Kerala Blast,6329,2,6,4,4,12,14,-2,22
Delhi Dynamo,6329,3,5,6,3,25,19,6,21
FC Pune City,6329,4,5,4,5,14,14,0,19
FC Goa,6329,5,5,3,6,13,15,-2,18
Chennaiyin,6329,6,4,5,5,14,19,-5,17
Kolkata,6329,7,3,6,5,14,18,-4,15
NorthEast Un,6329,8,4,2,8,10,13,-3,14
Kolkata,6330,1,6,6,2,20,15,5,24
Mumbai City,6330,2,6,4,4,17,10,7,22
Delhi Dynamo,6330,3,5,6,3,25,20,5,21
NorthEast Un,6330,4,5,4,5,14,11,3,19
Kerala Blast,6330,5,5,4,5,15,18,-3,19
FC Pune City,6330,6,4,3,7,14,19,-5,15
Chennaiyin,6330,7,3,6,5,13,18,-5,15
FC Goa,6330,8,4,3,7,10,17,-7,15
Mumbai City,6331,1,6,5,3,17,9,8,23
Kolkata,6331,2,5,7,2,19,16,3,22
Delhi Dynamo,6331,3,4,7,3,22,16,6,19
Kerala Blast,6331,4,5,4,5,13,15,-2,19
NorthEast Un,6331,5,5,3,6,11,11,0,18
Chennaiyin,6331,6,4,5,5,15,19,-4,17
FC Goa,6331,7,4,4,6,10,15,-5,16
FC Pune City,6331,8,4,3,7,14,20,-6,15
Mumbai City,6332,1,7,4,3,20,9,11,25
Delhi Dynamo,6332,2,5,6,3,25,20,5,21
Kerala Blast,6332,3,6,3,5,13,17,-4,21
Kolkata,6332,4,4,7,3,17,14,3,19
NorthEast Un,6332,5,5,3,6,13,11,2,18
Chennaiyin,6332,6,4,5,5,14,18,-4,17
FC Pune City,6332,7,4,4,6,14,18,-4,16
FC Goa,6332,8,4,2,8,10,19,-9,14
Mumbai City,6333,1,6,5,3,17,9,8,23
NorthEast Un,6333,2,6,3,5,14,11,3,21
Kerala Blast,6333,3,6,3,5,12,15,-3,21
Delhi Dynamo,6333,4,4,7,3,25,19,6,19
Kolkata,6333,5,4,6,4,15,16,-1,18
FC Goa,6333,6,5,3,6,15,18,-3,18
Chennaiyin,6333,7,3,6,5,16,21,-5,15
FC Pune City,6333,8,4,3,7,13,18,-5,15
Mumbai City,6334,1,6,5,3,18,10,8,23
Delhi Dynamo,6334,2,5,6,3,26,20,6,21
Kolkata,6334,3,5,6,3,19,18,1,21
Chennaiyin,6334,4,5,5,4,18,20,-2,20
Kerala Blast,6334,5,5,4,5,11,16,-5,19
FC Pune City,6334,6,5,3,6,15,15,0,18
NorthEast Un,6334,7,4,3,7,11,13,-2,15
FC Goa,6334,8,4,2,8,15,21,-6,14
Mumbai City,6335,1,7,4,3,17,8,9,25
Kolkata,6335,2,5,6,3,18,14,4,21
Delhi Dynamo,6335,3,5,5,4,23,18,5,20
NorthEast Un,6335,4,5,4,5,14,11,3,19
Kerala Blast,6335,5,4,5,5,13,18,-5,17
Chennaiyin,6335,6,3,7,4,13,17,-4,16
FC Pune City,6335,7,4,4,6,13,18,-5,16
FC Goa,6335,8,4,3,7,9,16,-7,15
Mumbai City,6336,1,7,4,3,17,8,9,25
Delhi Dynamo,6336,2,6,5,3,26,15,11,23
Kerala Blast,6336,3,6,4,4,13,15,-2,22
Kolkata,6336,4,4,7,3,16,15,1,19
FC Pune City,6336,5,5,3,6,13,15,-2,18
NorthEast Un,6336,6,5,2,7,10,13,-3,17
Chennaiyin,6336,7,3,5,6,14,20,-6,14
FC Goa,6336,8,4,2,8,10,18,-8,14
Mumbai City,6337,1,7,4,3,18,9,9,25
Delhi Dynamo,6337,2,5,5,4,24,22,2,20
Chennaiyin,6337,3,5,5,4,16,18,-2,20
Kolkata,6337,4,4,7,3,16,14,2,19
FC Pune City,6337,5,5,4,5,15,15,0,19
Kerala Blast,6337,6,5,4,5,12,17,-5,19
NorthEast Un,6337,7,5,3,6,16,12,4,18
FC Goa,6337,8,3,2,9,10,20,-10,11
Mumbai City,6338,1,7,4,3,19,8,11,25
Delhi Dynamo,6338,2,5,5,4,24,19,5,20
Kolkata,6338,3,4,7,3,16,14,2,19
FC Pune City,6338,4,5,4,5,15,15,0,19
Chennaiyin,6338,5,4,6,4,16,19,-3,18
FC Goa,6338,6,5,3,6,12,16,-4,18
Kerala Blast,6338,7,5,3,6,11,17,-6,18
NorthEast Un,6338,8,4,2,8,10,15,-5,14
Mumbai City,6339,1,7,4,3,17,8,9,25
Kolkata,6339,2,4,8,2,18,13,5,20
Kerala Blast,6339,3,5,4,5,13,20,-7,19
FC Goa,6339,4,5,3,6,11,15,-4,18
Delhi Dynamo,6339,5,4,5,5,21,17,4,17
FC Pune City,6339,6,4,5,5,16,18,-2,17
NorthEast Un,6339,7,5,2,7,10,12,-2,17
Chennaiyin,6339,8,4,5,5,16,19,-3,17
Mumbai City,6340,1,6,5,3,16,8,8,23
Delhi Dynamo,6340,2,5,7,2,24,16,8,22
Kolkata,6340,3,5,6,3,19,19,0,21
Chennaiyin,6340,4,5,5,4,19,19,0,20
Kerala Blast,6340,5,5,4,5,13,18,-5,19
FC Pune City,6340,6,4,4,6,14,17,-3,16
NorthEast Un,6340,7,4,3,7,13,17,-4,15
FC Goa,6340,8,4,2,8,14,18,-4,14
Delhi Dynamo,6341,1,6,5,3,26,18,8,23
Mumbai City,6341,2,6,4,4,17,10,7,22
NorthEast Un,6341,3,6,2,6,14,12,2,20
Kerala Blast,6341,4,5,5,4,11,14,-3,20
Kolkata,6341,5,4,7,3,17,14,3,19
FC Goa,6341,6,5,2,7,12,18,-6,17
FC Pune City,6341,7,4,4,6,12,17,-5,16
Chennaiyin,6341,8,3,5,6,16,22,-6,14
Mumbai City,6342,1,6,5,3,18,10,8,23
Kolkata,6342,2,5,6,3,19,15,4,21
NorthEast Un,6342,3,6,2,6,12,11,1,20
Delhi Dynamo,6342,4,4,7,3,24,18,6,19
FC Pune City,6342,5,5,3,6,15,17,-2,18
Kerala Blast,6342,6,5,3,6,10,16,-6,18
Chennaiyin,6342,7,4,5,5,15,20,-5,17
FC Goa,6342,8,4,3,7,11,17,-6,15
Mumbai City,6343,1,7,4,3,17,8,9,25
Kolkata,6343,2,6,6,2,21,12,9,24
Delhi Dynamo,6343,3,6,5,3,27,16,11,23
FC Pune City,6343,4,5,3,6,13,17,-4,18
Kerala Blast,6343,5,5,3,6,11,17,-6,18
Chennaiyin,6343,6,3,7,4,14,18,-4,16
NorthEast Un,6343,7,4,3,7,10,13,-3,15
FC Goa,6343,8,3,3,8,9,21,-12,12
Mumbai City,6344,1,6,5,3,16,8,8,23
Kolkata,6344,2,5,7,2,18,15,3,22
Kerala Blast,6344,3,5,4,5,14,18,-4,19
NorthEast Un,6344,4,5,3,6,14,12,2,18
Delhi Dynamo,6344,5,4,6,4,22,21,1,18
Chennaiyin,6344,6,4,6,4,17,19,-2,18
FC Pune City,6344,7,4,4,6,16,19,-3,16
FC Goa,6344,8,4,3,7,13,18,-5,15
Mumbai City,6345,1,6,5,3,16,8,8,23
Kolkata,6345,2,5,7,2,17,13,4,22
Kerala Blast,6345,3,6,4,4,14,15,-1,22
Delhi Dynamo,6345,4,4,7,3,21,15,6,19
NorthEast Un,6345,5,5,2,7,11,13,-2,17
Chennaiyin,6345,6,4,5,5,17,21,-4,17
FC Pune City,6345,7,4,3,7,13,18,-5,15
FC Goa,6345,8,4,3,7,11,17,-6,15
Mumbai City,6346,1,7,4,3,21,10,11,25
Delhi Dynamo,6346,2,5,6,3,25,20,5,21
Kerala Blast,6346,3,6,3,5,12,16,-4,21
Chennaiyin,6346,4,5,5,4,15,17,-2,20
NorthEast Un,6346,5,5,3,6,12,11,1,18
Kolkata,6346,6,4,6,4,16,17,-1,18
FC Pune City,6346,7,4,3,7,14,18,-4,15
FC Goa,6346,8,4,2,8,11,17,-6,14
Mumbai City,6347,1,7,4,3,19,9,10,25
Kolkata,6347,2,5,7,2,16,13,3,22
Kerala Blast,6347,3,6,3,5,14,15,-1,21
Delhi Dynamo,6347,4,4,6,4,23,19,4,18
NorthEast Un,6347,5,4,4,6,10,12,-2,16
Chennaiyin,6347,6,3,7,4,15,19,-4,16
FC Pune City,6347,7,4,4,6,12,16,-4,16
FC Goa,6347,8,4,3,7,11,17,-6,15
Mumbai City,6348,1,7,4,3,19,9,10,25
Delhi Dynamo,6348,2,5,5,4,26,22,4,20
Kolkata,6348,3,4,7,3,18,18,0,19
Kerala Blast,6348,4,5,4,5,12,17,-5,19
NorthEast Un,6348,5,5,3,6,13,12,1,18
FC Goa,6348,6,5,3,6,17,18,-1,18
Chennaiyin,6348,7,3,7,4,16,20,-4,16
FC Pune City,6348,8,4,3,7,13,18,-5,15
Delhi Dynamo,6349,1,7,5,2,31,17,14,26
Mumbai City,6349,2,6,4,4,16,9,7,22
Kolkata,6349,3,5,7,2,22,17,5,22
Chennaiyin,6349,4,5,5,4,16,18,-2,20
FC Pune City,6349,5,5,3,6,15,18,-3,18
Kerala Blast,6349,6,5,3,6,13,18,-5,18
NorthEast Un,6349,7,4,2,8,10,18,-8,14
FC Goa,6349,8,3,3,8,14,22,-8,12
Mumbai City,6350,1,7,4,3,19,10,9,25
Delhi Dynamo,6350,2,6,5,3,27,17,10,23
FC Pune City,6350,3,6,3,5,14,14,0,21
Kerala Blast,6350,4,6,3,5,13,14,-1,21
Chennaiyin,6350,5,4,6,4,17,18,-1,18
Kolkata,6350,6,3,6,5,13,17,-4,15
FC Goa,6350,7,4,3,7,9,15,-6,15
NorthEast Un,6350,8,4,2,8,10,17,-7,14
Mumbai City,6351,1,6,5,3,17,9,8,23
Delhi Dynamo,6351,2,5,6,3,25,19,6,21
Kolkata,6351,3,5,6,3,19,16,3,21
Kerala Blast,6351,4,6,3,5,13,15,-2,21
NorthEast Un,6351,5,6,2,6,15,13,2,20
FC Pune City,6351,6,5,3,6,14,16,-2,18
Chennaiyin,6351,7,3,5,6,15,22,-7,14
FC Goa,6351,8,4,2,8,12,20,-8,14
Mumbai City,6352,1,7,4,3,19,9,10,25
Delhi Dynamo,6352,2,6,5,3,25,18,7,23
FC Pune City,6352,3,6,3,5,17,15,2,21
NorthEast Un,6352,4,6,2,6,13,10,3,20
Chennaiyin,6352,5,4,5,5,17,22,-5,17
Kolkata,6352,6,3,7,4,16,18,-2,16
Kerala Blast,6352,7,4,4,6,9,17,-8,16
FC Goa,6352,8,4,2,8,15,22,-7,14
Delhi Dynamo,6353,1,7,5,2,26,16,10,26
Mumbai City,6353,2,6,4,4,16,9,7,22
Kolkata,6353,3,4,8,2,21,17,4,20
FC Pune City,6353,4,4,5,5,15,17,-2,17
Chennaiyin,6353,5,4,5,5,15,18,-3,17
Kerala Blast,6353,6,4,5,5,11,18,-7,17
NorthEast Un,6353,7,4,3,7,11,14,-3,15
FC Goa,6353,8,4,3,7,13,19,-6,15
Mumbai City,6354,1,7,4,3,18,9,9,25
Delhi Dynamo,6354,2,5,5,4,26,19,7,20
NorthEast Un,6354,3,6,2,6,13,11,2,20
Chennaiyin,6354,4,5,5,4,15,17,-2,20
FC Pune City,6354,5,5,4,5,14,15,-1,19
Kerala Blast,6354,6,5,3,6,10,16,-6,18
Kolkata,6354,7,3,8,3,16,16,0,17
FC Goa,6354,8,3,3,8,11,20,-9,12
Mumbai City,6355,1,7,4,3,18,9,9,25
Delhi Dynamo,6355,2,6,5,3,27,18,9,23
Kerala Blast,6355,3,5,5,4,12,15,-3,20
FC Pune City,6355,4,5,4,5,14,14,0,19
Chennaiyin,6355,5,4,6,4,15,18,-3,18
Kolkata,6355,6,3,8,3,16,17,-1,17
NorthEast Un,6355,7,4,2,8,10,13,-3,14
FC Goa,6355,8,3,4,7,11,19,-8,13
Delhi Dynamo,6356,1,6,6,2,24,15,9,24
Mumbai City,6356,2,6,5,3,16,8,8,23
Kolkata,6356,3,5,6,3,18,16,2,21
Kerala Blast,6356,4,5,4,5,12,18,-6,19
Chennaiyin,6356,5,4,6,4,17,20,-3,18
NorthEast Un,6356,6,4,4,6,11,12,-1,16
FC Pune City,6356,7,4,3,7,14,19,-5,15
FC Goa,6356,8,4,2,8,14,18,-4,14
Mumbai City,6357,1,7,4,3,19,9,10,25
Chennaiyin,6357,2,5,5,4,16,18,-2,20
Delhi Dynamo,6357,3,4,6,4,24,20,4,18
Kolkata,6357,4,4,6,4,15,14,1,18
NorthEast Un,6357,5,5,3,6,14,14,0,18
FC Pune City,6357,6,5,3,6,14,17,-3,18
Kerala Blast,6357,7,5,3,6,12,17,-5,18
FC Goa,6357,8,5,2,7,10,15,-5,17
Delhi Dynamo,6358,1,6,5,3,26,19,7,23
Mumbai City,6358,2,6,4,4,16,9,7,22
FC Pune City,6358,3,6,3,5,17,14,3,21
NorthEast Un,6358,4,6,2,6,16,14,2,20
Kolkata,6358,5,4,6,4,14,15,-1,18
Chennaiyin,6358,6,4,5,5,16,20,-4,17
FC Goa,6358,7,5,2,7,12,17,-5,17
Kerala Blast,6358,8,4,3,7,10,19,-9,15
Delhi Dynamo,6359,1,7,5,2,29,15,14,26
Kolkata,6359,2,6,6,2,17,13,4,24
Mumbai City,6359,3,6,4,4,17,11,6,22
Kerala Blast,6359,4,5,4,5,12,16,-4,19
Chennaiyin,6359,5,4,5,5,14,19,-5,17
FC Pune City,6359,6,4,4,6,13,16,-3,16
NorthEast Un,6359,7,4,2,8,11,15,-4,14
FC Goa,6359,8,4,2,8,10,18,-8,14
Mumbai City,6360,1,7,4,3,20,11,9,25
Kerala Blast,6360,2,6,4,4,12,14,-2,22
NorthEast Un,6360,3,6,3,5,11,9,2,21
Delhi Dynamo,6360,4,5,5,4,25,19,6,20
Kolkata,6360,5,4,7,3,18,17,1,19
Chennaiyin,6360,6,4,5,5,15,19,-4,17
FC Pune City,6360,7,4,3,7,15,19,-4,15
FC Goa,6360,8,3,3,8,11,19,-8,12
Mumbai City,6361,1,7,4,3,18,8,10,25
Kolkata,6361,2,5,6,3,19,16,3,21
NorthEast Un,6361,3,6,2,6,13,14,-1,20
FC Pune City,6361,4,5,4,5,14,15,-1,19
Delhi Dynamo,6361,5,4,5,5,22,19,3,17
Chennaiyin,6361,6,4,5,5,18,21,-3,17
FC Goa,6361,7,5,2,7,13,17,-4,17
Kerala Blast,6361,8,4,4,6,10,17,-7,16
Mumbai City,6362,1,7,4,3,19,8,11,25
Delhi Dynamo,6362,2,6,5,3,26,18,8,23
Kerala Blast,6362,3,6,4,4,13,15,-2,22
Kolkata,6362,4,3,8,3,16,16,0,17
FC Pune City,6362,5,4,4,6,13,16,-3,16
Chennaiyin,6362,6,3,7,4,17,21,-4,16
NorthEast Un,6362,7,4,3,7,12,16,-4,15
FC Goa,6362,8,4,3,7,11,17,-6,15
Mumbai City,6363,1,6,5,3,17,9,8,23
Delhi Dynamo,6363,2,5,7,2,24,16,8,22
Kolkata,6363,3,5,6,3,24,17,7,21
NorthEast Un,6363,4,5,3,6,10,12,-2,18
Kerala Blast,6363,5,5,3,6,10,17,-7,18
Chennaiyin,6363,6,4,5,5,16,19,-3,17
FC Goa,6363,7,5,2,7,15,19,-4,17
FC Pune City,6363,8,4,3,7,13,20,-7,15
Delhi Dynamo,6364,1,7,5,2,25,15,10,26
Mumbai City,6364,2,6,4,4,16,9,7,22
Kolkata,6364,3,5,7,2,20,16,4,22
FC Pune City,6364,4,5,4,5,16,15,1,19
Kerala Blast,6364,5,5,3,6,11,18,-7,18
Chennaiyin,6364,6,4,5,5,17,23,-6,17
NorthEast Un,6364,7,4,2,8,11,14,-3,14
FC Goa,6364,8,4,2,8,17,23,-6,14
NorthEast Un,6365,1,7,2,5,19,12,7,23
Delhi Dynamo,6365,2,6,5,3,25,20,5,23
Mumbai City,6365,3,6,4,4,16,9,7,22
FC Pune City,6365,4,5,3,6,15,15,0,18
Kolkata,6365,5,4,6,4,14,16,-2,18
Kerala Blast,6365,6,5,3,6,11,17,-6,18
Chennaiyin,6365,7,4,5,5,15,19,-4,17
FC Goa,6365,8,4,2,8,10,17,-7,14
Delhi Dynamo,6366,1,7,5,2,31,15,16,26
Kolkata,6366,2,6,6,2,18,13,5,24
Mumbai City,6366,3,6,4,4,17,11,6,22
Chennaiyin,6366,4,5,5,4,16,17,-1,20
Kerala Blast,6366,5,5,4,5,14,15,-1,19
NorthEast Un,6366,6,4,3,7,10,12,-2,15
FC Pune City,6366,7,4,3,7,12,19,-7,15
FC Goa,6366,8,3,2,9,9,25,-16,11
Mumbai City,6367,1,6,5,3,18,10,8,23
Kolkata,6367,2,5,7,2,17,13,4,22
Delhi Dynamo,6367,3,5,6,3,25,17,8,21
NorthEast Un,6367,4,6,2,6,12,13,-1,20
Chennaiyin,6367,5,4,6,4,18,19,-1,18
FC Pune City,6367,6,5,3,6,13,15,-2,18
Kerala Blast,6367,7,4,4,6,10,16,-6,16
FC Goa,6367,8,3,3,8,9,19,-10,12
Mumbai City,6368,1,7,4,3,17,8,9,25
Delhi Dynamo,6368,2,5,5,4,24,17,7,20
Kolkata,6368,3,4,8,2,18,15,3,20
NorthEast Un,6368,4,6,2,6,12,11,1,20
Kerala Blast,6368,5,5,4,5,12,17,-5,19
Chennaiyin,6368,6,4,5,5,14,18,-4,17
FC Pune City,6368,7,4,4,6,15,18,-3,16
FC Goa,6368,8,4,2,8,10,18,-8,14
Mumbai City,6369,1,7,4,3,18,9,9,25
NorthEast Un,6369,2,6,3,5,13,9,4,21
Kolkata,6369,3,5,6,3,17,20,-3,21
Delhi Dynamo,6369,4,4,6,4,23,19,4,18
Chennaiyin,6369,5,4,6,4,15,17,-2,18
Kerala Blast,6369,6,5,3,6,12,17,-5,18
FC Goa,6369,7,4,3,7,15,17,-2,15
FC Pune City,6369,8,4,3,7,13,18,-5,15
Delhi Dynamo,6370,1,6,6,2,25,16,9,24
Mumbai City,6370,2,6,4,4,16,9,7,22
Chennaiyin,6370,3,5,5,4,15,17,-2,20
Kerala Blast,6370,4,5,5,4,14,16,-2,20
FC Pune City,6370,5,5,3,6,14,17,-3,18
Kolkata,6370,6,3,7,4,15,17,-2,16
NorthEast Un,6370,7,4,3,7,11,13,-2,15
FC Goa,6370,8,4,3,7,12,17,-5,15
Mumbai City,6371,1,7,4,3,19,8,11,25
Kerala Blast,6371,2,6,4,4,14,14,0,22
FC Goa,6371,3,6,2,6,11,14,-3,20
NorthEast Un,6371,4,5,3,6,11,12,-1,18
Delhi Dynamo,6371,5,4,5,5,21,19,2,17
Kolkata,6371,6,3,8,3,15,15,0,17
FC Pune City,6371,7,4,4,6,13,17,-4,16
Chennaiyin,6371,8,3,6,5,14,19,-5,15
Delhi Dynamo,6372,1,6,5,3,23,15,8,23
Mumbai City,6372,2,6,4,4,16,9,7,22
Kerala Blast,6372,3,6,4,4,14,14,0,22
Kolkata,6372,4,4,7,3,17,15,2,19
FC Goa,6372,5,5,3,6,15,16,-1,18
Chennaiyin,6372,6,4,5,5,18,22,-4,17
NorthEast Un,6372,7,4,3,7,10,15,-5,15
FC Pune City,6372,8,4,3,7,13,20,-7,15
Mumbai City,6373,1,6,5,3,18,10,8,23
Delhi Dynamo,6373,2,5,7,2,26,17,9,22
FC Pune City,6373,3,5,4,5,13,14,-1,19
Kerala Blast,6373,4,5,4,5,10,15,-5,19
Kolkata,6373,5,4,6,4,15,14,1,18
FC Goa,6373,6,5,3,6,11,14,-3,18
NorthEast Un,6373,7,4,3,7,11,14,-3,15
Chennaiyin,6373,8,3,6,5,14,20,-6,15
Delhi Dynamo,6374,1,6,5,3,27,17,10,23
Mumbai City,6374,2,6,4,4,17,11,6,22
NorthEast Un,6374,3,6,3,5,15,10,5,21
Kolkata,6374,4,5,6,3,16,14,2,21
Kerala Blast,6374,5,5,4,5,11,15,-4,19
FC Pune City,6374,6,5,3,6,13,15,-2,18
Chennaiyin,6374,7,3,6,5,15,22,-7,15
FC Goa,6374,8,3,3,8,11,21,-10,12
Mumbai City,6375,1,6,4,4,17,10,7,22
Kolkata,6375,2,5,7,2,18,13,5,22
Delhi Dynamo,6375,3,5,6,3,25,19,6,21
NorthEast Un,6375,4,6,3,5,14,11,3,21
FC Pune City,6375,5,5,3,6,16,16,0,18
Kerala Blast,6375,6,4,4,6,11,21,-10,16
Chennaiyin,6375,7,3,6,5,13,18,-5,15
FC Goa,6375,8,3,5,6,10,16,-6,14
Mumbai City,6376,1,7,4,3,18,8,10,25
Kolkata,6376,2,5,6,3,17,15,2,21
NorthEast Un,6376,3,5,4,5,13,12,1,19
Kerala Blast,6376,4,5,4,5,12,16,-4,19
FC Goa,6376,5,5,3,6,14,17,-3,18
Delhi Dynamo,6376,6,4,5,5,23,20,3,17
Chennaiyin,6376,7,3,7,4,16,20,-4,16
FC Pune City,6376,8,4,3,7,12,17,-5,15
Delhi Dynamo,6377,1,6,6,2,28,16,12,24
Mumbai City,6377,2,6,5,3,17,9,8,23
Chennaiyin,6377,3,5,5,4,16,18,-2,20
Kerala Blast,6377,4,5,5,4,12,15,-3,20
FC Pune City,6377,5,5,4,5,16,17,-1,19
Kolkata,6377,6,4,6,4,16,15,1,18
NorthEast Un,6377,7,4,3,7,10,13,-3,15
FC Goa,6377,8,3,2,9,9,21,-12,11
Mumbai City,6378,1,6,5,3,18,10,8,23
Delhi Dynamo,6378,2,5,7,2,25,17,8,22
Kolkata,6378,3,5,6,3,18,17,1,21
Kerala Blast,6378,4,5,4,5,15,17,-2,19
NorthEast Un,6378,5,5,3,6,10,11,-1,18
Chennaiyin,6378,6,4,5,5,16,19,-3,17
FC Pune City,6378,7,4,4,6,17,21,-4,16
FC Goa,6378,8,4,2,8,11,18,-7,14
Mumbai City,6379,1,7,4,3,18,8,10,25
Delhi Dynamo,6379,2,6,5,3,27,16,11,23
FC Pune City,6379,3,5,4,5,18,18,0,19
NorthEast Un,6379,4,5,3,6,11,11,0,18
Kolkata,6379,5,4,6,4,16,18,-2,18
FC Goa,6379,6,5,2,7,13,18,-5,17
Kerala Blast,6379,7,4,4,6,11,18,-7,16
Chennaiyin,6379,8,3,6,5,13,20,-7,15
NorthEast Un,6380,1,7,2,5,14,11,3,23
Mumbai City,6380,2,6,4,4,18,12,6,22
Kolkata,6380,3,5,7,2,17,14,3,22
Delhi Dynamo,6380,4,5,5,4,26,20,6,20
FC Pune City,6380,5,4,5,5,14,16,-2,17
FC Goa,6380,6,5,2,7,11,15,-4,17
Kerala Blast,6380,7,4,4,6,12,18,-6,16
Chennaiyin,6380,8,3,5,6,13,19,-6,14
Delhi Dynamo,6381,1,6,6,2,28,18,10,24
Kerala Blast,6381,2,7,3,4,14,14,0,24
Mumbai City,6381,3,6,4,4,16,9,7,22
Kolkata,6381,4,4,6,4,15,15,0,18
FC Goa,6381,5,5,2,7,13,18,-5,17
NorthEast Un,6381,6,4,4,6,11,12,-1,16
FC Pune City,6381,7,4,3,7,12,17,-5,15
Chennaiyin,6381,8,3,6,5,13,19,-6,15
NorthEast Un,6382,1,7,2,5,16,10,6,23
Mumbai City,6382,2,6,4,4,16,9,7,22
Kolkata,6382,3,5,6,3,18,15,3,21
Delhi Dynamo,6382,4,5,5,4,22,18,4,20
FC Pune City,6382,5,5,3,6,14,16,-2,18
Chennaiyin,6382,6,4,5,5,16,20,-4,17
FC Goa,6382,7,5,2,7,12,17,-5,17
Kerala Blast,6382,8,4,3,7,11,20,-9,15
Mumbai City,6383,1,7,4,3,18,8,10,25
Delhi Dynamo,6383,2,6,5,3,26,18,8,23
Kerala Blast,6383,3,6,3,5,12,16,-4,21
Kolkata,6383,4,4,8,2,19,15,4,20
FC Pune City,6383,5,4,4,6,14,17,-3,16
NorthEast Un,6383,6,4,3,7,11,15,-4,15
Chennaiyin,6383,7,3,6,5,14,19,-5,15
FC Goa,6383,8,4,3,7,11,17,-6,15
Mumbai City,6384,1,7,4,3,19,8,11,25
FC Pune City,6384,2,6,3,5,16,16,0,21
Delhi Dynamo,6384,3,5,5,4,24,21,3,20
Chennaiyin,6384,4,5,5,4,16,17,-1,20
Kolkata,6384,5,4,6,4,18,17,1,18
Kerala Blast,6384,6,5,3,6,10,16,-6,18
FC Goa,6384,7,5,2,7,13,18,-5,17
NorthEast Un,6384,8,4,2,8,10,13,-3,14
Mumbai City,6385,1,6,4,4,18,11,7,22
Kerala Blast,6385,2,6,4,4,13,14,-1,22
Delhi Dynamo,6385,3,5,6,3,25,18,7,21
FC Pune City,6385,4,5,4,5,14,15,-1,19
NorthEast Un,6385,5,5,3,6,10,10,0,18
Chennaiyin,6385,6,4,6,4,15,18,-3,18
Kolkata,6385,7,3,7,4,14,16,-2,16
FC Goa,6385,8,3,4,7,11,18,-7,13
Delhi Dynamo,6386,1,6,6,2,26,16,10,24
Mumbai City,6386,2,6,5,3,17,9,8,23
Kerala Blast,6386,3,5,5,4,14,17,-3,20
FC Pune City,6386,4,5,4,5,15,16,-1,19
Chennaiyin,6386,5,4,6,4,15,17,-2,18
Kolkata,6386,6,3,8,3,15,15,0,17
NorthEast Un,6386,7,4,2,8,12,16,-4,14
FC Goa,6386,8,3,4,7,8,16,-8,13
Mumbai City,6387,1,7,4,3,18,8,10,25
Delhi Dynamo,6387,2,5,6,3,26,18,8,21
Kolkata,6387,3,5,6,3,19,18,1,21
Chennaiyin,6387,4,5,5,4,15,17,-2,20
Kerala Blast,6387,5,5,4,5,11,16,-5,19
NorthEast Un,6387,6,4,4,6,11,12,-1,16
FC Pune City,6387,7,4,3,7,12,17,-5,15
FC Goa,6387,8,4,2,8,13,19,-6,14
Mumbai City,6388,1,7,4,3,17,8,9,25
Delhi Dynamo,6388,2,5,6,3,26,16,10,21
FC Pune City,6388,3,6,3,5,17,16,1,21
NorthEast Un,6388,4,5,4,5,12,11,1,19
Kolkata,6388,5,4,6,4,18,17,1,18
Chennaiyin,6388,6,3,7,4,14,18,-4,16
Kerala Blast,6388,7,4,3,7,12,21,-9,15
FC Goa,6388,8,4,3,7,11,20,-9,15
Mumbai City,6389,1,7,4,3,18,9,9,25
Kolkata,6389,2,5,6,3,17,15,2,21
Delhi Dynamo,6389,3,5,5,4,24,18,6,20
NorthEast Un,6389,4,6,2,6,13,11,2,20
FC Pune City,6389,5,5,3,6,14,17,-3,18
Kerala Blast,6389,6,5,3,6,12,18,-6,18
Chennaiyin,6389,7,4,5,5,15,19,-4,17
FC Goa,6389,8,4,2,8,11,17,-6,14
Delhi Dynamo,6390,1,7,5,2,27,16,11,26
Kolkata,6390,2,6,6,2,19,14,5,24
Mumbai City,6390,3,6,4,4,16,9,7,22
Chennaiyin,6390,4,5,5,4,20,21,-1,20
Kerala Blast,6390,5,5,3,6,12,20,-8,18
NorthEast Un,6390,6,5,2,7,16,14,2,17
FC Pune City,6390,7,4,3,7,12,18,-6,15
FC Goa,6390,8,3,2,9,14,24,-10,11
Mumbai City,6391,1,7,4,3,18,8,10,25
Delhi Dynamo,6391,2,5,5,4,24,19,5,20
Kolkata,6391,3,4,8,2,19,16,3,20
NorthEast Un,6391,4,6,2,6,11,10,1,20
FC Pune City,6391,5,5,3,6,14,17,-3,18
Chennaiyin,6391,6,4,5,5,14,19,-5,17
Kerala Blast,6391,7,4,4,6,11,17,-6,16
FC Goa,6391,8,4,3,7,13,18,-5,15
NorthEast Un,6392,1,7,2,5,13,10,3,23
Mumbai City,6392,2,6,4,4,16,9,7,22
Kolkata,6392,3,5,7,2,18,15,3,22
Delhi Dynamo,6392,4,5,6,3,23,16,7,21
Kerala Blast,6392,5,5,3,6,13,17,-4,18
Chennaiyin,6392,6,4,5,5,17,20,-3,17
FC Pune City,6392,7,4,3,7,12,17,-5,15
FC Goa,6392,8,3,4,7,11,19,-8,13
Mumbai City,6393,1,7,4,3,18,8,10,25
Kolkata,6393,2,6,6,2,17,13,4,24
Delhi Dynamo,6393,3,5,5,4,27,17,10,20
Kerala Blast,6393,4,5,4,5,10,14,-4,19
NorthEast Un,6393,5,5,3,6,10,10,0,18
Chennaiyin,6393,6,4,6,4,14,17,-3,18
FC Pune City,6393,7,4,4,6,12,15,-3,16
FC Goa,6393,8,3,2,9,9,23,-14,11
Mumbai City,6394,1,7,4,3,19,10,9,25
Kerala Blast,6394,2,6,4,4,13,15,-2,22
NorthEast Un,6394,3,5,3,6,13,12,1,18
Chennaiyin,6394,4,4,6,4,18,20,-2,18
Delhi Dynamo,6394,5,4,5,5,24,22,2,17
Kolkata,6394,6,3,8,3,15,15,0,17
FC Pune City,6394,7,4,5,5,12,14,-2,17
FC Goa,6394,8,4,3,7,12,18,-6,15
Mumbai City,6395,1,6,5,3,19,11,8,23
Kerala Blast,6395,2,5,5,4,13,16,-3,20
Delhi Dynamo,6395,3,4,7,3,24,18,6,19
FC Pune City,6395,4,5,4,5,15,16,-1,19
Chennaiyin,6395,5,4,6,4,15,18,-3,18
Kolkata,6395,6,3,8,3,17,17,0,17
NorthEast Un,6395,7,4,4,6,10,11,-1,16
FC Goa,6395,8,4,3,7,12,18,-6,15
Mumbai City,6396,1,6,5,3,17,9,8,23
Delhi Dynamo,6396,2,5,7,2,26,18,8,22
Kerala Blast,6396,3,6,4,4,17,17,0,22
Kolkata,6396,4,4,7,3,18,17,1,19
FC Goa,6396,5,5,2,7,14,19,-5,17
NorthEast Un,6396,6,4,4,6,13,16,-3,16
FC Pune City,6396,7,4,3,7,17,21,-4,15
Chennaiyin,6396,8,3,6,5,17,22,-5,15
Mumbai City,6397,1,7,4,3,20,9,11,25
Kerala Blast,6397,2,6,4,4,14,15,-1,22
Delhi Dynamo,6397,3,5,5,4,24,20,4,20
NorthEast Un,6397,4,5,4,5,13,11,2,19
Chennaiyin,6397,5,4,6,4,16,19,-3,18
Kolkata,6397,6,3,8,3,14,15,-1,17
FC Pune City,6397,7,4,4,6,12,15,-3,16
FC Goa,6397,8,3,3,8,9,18,-9,12
Mumbai City,6398,1,7,4,3,18,8,10,25
Kerala Blast,6398,2,7,3,4,13,13,0,24
Kolkata,6398,3,5,6,3,19,15,4,21
Chennaiyin,6398,4,4,6,4,17,18,-1,18
Delhi Dynamo,6398,5,4,5,5,23,20,3,17
NorthEast Un,6398,6,5,2,7,12,16,-4,17
FC Pune City,6398,7,4,3,7,14,18,-4,15
FC Goa,6398,8,4,3,7,10,18,-8,15
Delhi Dynamo,6399,1,6,6,2,30,17,13,24
Kolkata,6399,2,5,7,2,22,17,5,22
Mumbai City,6399,3,6,4,4,16,12,4,22
NorthEast Un,6399,4,6,3,5,15,12,3,21
Kerala Blast,6399,5,5,3,6,12,18,-6,18
FC Pune City,6399,6,4,3,7,15,20,-5,15
FC Goa,6399,7,4,3,7,12,18,-6,15
Chennaiyin,6399,8,3,5,6,13,21,-8,14
Delhi Dynamo,6400,1,6,5,3,25,17,8,23
Mumbai City,6400,2,6,4,4,16,10,6,22
FC Goa,6400,3,6,2,6,13,15,-2,20
Kolkata,6400,4,4,7,3,17,16,1,19
FC Pune City,6400,5,5,3,6,16,18,-2,18
NorthEast Un,6400,6,5,2,7,12,13,-1,17
Chennaiyin,6400,7,4,5,5,15,19,-4,17
Kerala Blast,6400,8,4,4,6,12,18,-6,16
Mumbai City,6401,1,7,4,3,19,10,9,25
Kerala Blast,6401,2,5,5,4,12,15,-3,20
Delhi Dynamo,6401,3,4,7,3,26,20,6,19
Kolkata,6401,4,4,7,3,16,15,1,19
NorthEast Un,6401,5,4,5,5,12,12,0,17
Chennaiyin,6401,6,3,7,4,15,19,-4,16
FC Goa,6401,7,4,4,6,13,18,-5,16
FC Pune City,6401,8,4,3,7,12,16,-4,15
Delhi Dynamo,6402,1,6,6,2,27,17,10,24
Mumbai City,6402,2,6,5,3,17,9,8,23
Kolkata,6402,3,5,6,3,20,18,2,21
FC Pune City,6402,4,6,3,5,16,15,1,21
Chennaiyin,6402,5,5,5,4,18,18,0,20
Kerala Blast,6402,6,4,4,6,11,18,-7,16
NorthEast Un,6402,7,4,3,7,12,15,-3,15
FC Goa,6402,8,3,2,9,11,22,-11,11
Mumbai City,6403,1,7,4,3,23,12,11,25
Delhi Dynamo,6403,2,6,5,3,29,21,8,23
Kerala Blast,6403,3,5,4,5,14,17,-3,19
Chennaiyin,6403,4,4,6,4,16,18,-2,18
NorthEast Un,6403,5,5,3,6,12,14,-2,18
Kolkata,6403,6,3,8,3,15,15,0,17
FC Pune City,6403,7,4,4,6,16,20,-4,16
FC Goa,6403,8,4,2,8,9,17,-8,14
Mumbai City,6404,1,7,4,3,17,8,9,25
Delhi Dynamo,6404,2,6,5,3,25,16,9,23
Kolkata,6404,3,4,7,3,17,15,2,19
Kerala Blast,6404,4,5,4,5,13,17,-4,19
FC Pune City,6404,5,4,5,5,15,17,-2,17
FC Goa,6404,6,5,2,7,11,16,-5,17
NorthEast Un,6404,7,4,3,7,12,15,-3,15
Chennaiyin,6404,8,3,6,5,14,20,-6,15
Mumbai City,6405,1,7,4,3,17,8,9,25
Delhi Dynamo,6405,2,6,5,3,28,17,11,23
Kerala Blast,6405,3,6,3,5,12,15,-3,21
Kolkata,6405,4,4,7,3,17,17,0,19
NorthEast Un,6405,5,5,2,7,14,13,1,17
FC Pune City,6405,6,4,4,6,15,18,-3,16
Chennaiyin,6405,7,3,6,5,13,20,-7,15
FC Goa,6405,8,4,3,7,11,19,-8,15
Mumbai City,6406,1,7,4,3,19,8,11,25
FC Pune City,6406,2,6,3,5,17,16,1,21
Kerala Blast,6406,3,5,4,5,11,15,-4,19
Delhi Dynamo,6406,4,4,6,4,22,19,3,18
NorthEast Un,6406,5,5,3,6,12,12,0,18
FC Goa,6406,6,5,3,6,12,14,-2,18
Kolkata,6406,7,3,7,4,14,18,-4,16
Chennaiyin,6406,8,3,6,5,14,19,-5,15
Mumbai City,6407,1,7,4,3,19,10,9,25
Delhi Dynamo,6407,2,5,6,3,25,17,8,21
FC Pune City,6407,3,5,4,5,16,16,0,19
NorthEast Un,6407,4,5,3,6,12,12,0,18
Kolkata,6407,5,4,6,4,16,17,-1,18
Chennaiyin,6407,6,4,5,5,16,20,-4,17
FC Goa,6407,7,5,2,7,11,17,-6,17
Kerala Blast,6407,8,4,4,6,12,18,-6,16
Delhi Dynamo,6408,1,7,5,2,29,18,11,26
Mumbai City,6408,2,6,4,4,17,10,7,22
FC Pune City,6408,3,5,4,5,14,15,-1,19
Kerala Blast,6408,4,5,4,5,10,14,-4,19
Kolkata,6408,5,3,9,2,17,16,1,18
NorthEast Un,6408,6,5,2,7,12,13,-1,17
Chennaiyin,6408,7,4,5,5,15,18,-3,17
FC Goa,6408,8,3,3,8,12,22,-10,12
Mumbai City,6409,1,7,4,3,20,9,11,25
Kerala Blast,6409,2,6,4,4,17,14,3,22
Delhi Dynamo,6409,3,5,5,4,26,20,6,20
Kolkata,6409,4,4,7,3,16,15,1,19
Chennaiyin,6409,5,4,6,4,15,18,-3,18
FC Pune City,6409,6,5,3,6,14,19,-5,18
NorthEast Un,6409,7,5,2,7,11,14,-3,17
FC Goa,6409,8,3,3,8,9,19,-10,12
Delhi Dynamo,6410,1,6,6,2,26,14,12,24
Mumbai City,6410,2,6,4,4,16,11,5,22
Kolkata,6410,3,5,7,2,17,13,4,22
Kerala Blast,6410,4,5,5,4,11,14,-3,20
NorthEast Un,6410,5,5,2,7,10,12,-2,17
FC Pune City,6410,6,4,4,6,12,16,-4,16
Chennaiyin,6410,7,3,6,5,14,19,-5,15
FC Goa,6410,8,3,4,7,9,16,-7,13
Delhi Dynamo,6411,1,6,5,3,26,17,9,23
Mumbai City,6411,2,6,4,4,16,10,6,22
Kolkata,6411,3,5,6,3,15,13,2,21
Kerala Blast,6411,4,6,3,5,13,16,-3,21
NorthEast Un,6411,5,5,2,7,13,15,-2,17
Chennaiyin,6411,6,4,5,5,16,19,-3,17
FC Goa,6411,7,5,2,7,12,17,-5,17
FC Pune City,6411,8,4,3,7,12,16,-4,15
Mumbai City,6412,1,6,5,3,17,9,8,23
Delhi Dynamo,6412,2,5,7,2,25,17,8,22
Kolkata,6412,3,5,7,2,18,14,4,22
Kerala Blast,6412,4,5,5,4,14,17,-3,20
NorthEast Un,6412,5,5,3,6,13,13,0,18
Chennaiyin,6412,6,4,5,5,16,19,-3,17
FC Pune City,6412,7,4,4,6,13,16,-3,16
FC Goa,6412,8,3,2,9,9,20,-11,11
Delhi Dynamo,6413,1,7,5,2,26,16,10,26
Mumbai City,6413,2,6,4,4,16,9,7,22
Kolkata,6413,3,4,8,2,17,15,2,20
NorthEast Un,6413,4,5,3,6,14,13,1,18
FC Pune City,6413,5,5,3,6,14,16,-2,18
Kerala Blast,6413,6,4,5,5,13,18,-5,17
Chennaiyin,6413,7,3,6,5,14,20,-6,15
FC Goa,6413,8,3,4,7,12,19,-7,13
Mumbai City,6414,1,7,4,3,18,8,10,25
Delhi Dynamo,6414,2,5,6,3,23,17,6,21
Kerala Blast,6414,3,6,3,5,13,17,-4,21
Kolkata,6414,4,4,7,3,19,15,4,19
Chennaiyin,6414,5,4,6,4,16,18,-2,18
FC Pune City,6414,6,4,4,6,13,17,-4,16
FC Goa,6414,7,4,4,6,11,16,-5,16
NorthEast Un,6414,8,4,2,8,10,15,-5,14
Mumbai City,6415,1,7,4,3,19,9,10,25
Kolkata,6415,2,5,6,3,17,13,4,21
Delhi Dynamo,6415,3,5,5,4,25,19,6,20
NorthEast Un,6415,4,5,3,6,13,14,-1,18
FC Pune City,6415,5,5,3,6,14,17,-3,18
Chennaiyin,6415,6,4,5,5,18,21,-3,17
FC Goa,6415,7,5,2,7,12,18,-6,17
Kerala Blast,6415,8,4,4,6,11,18,-7,16
Mumbai City,6416,1,7,4,3,19,8,11,25
Kerala Blast,6416,2,6,4,4,15,14,1,22
Kolkata,6416,3,4,7,3,15,15,0,19
Delhi Dynamo,6416,4,4,6,4,23,21,2,18
FC Goa,6416,5,5,3,6,12,15,-3,18
Chennaiyin,6416,6,4,5,5,14,18,-4,17
NorthEast Un,6416,7,4,4,6,11,12,-1,16
FC Pune City,6416,8,4,3,7,12,18,-6,15
Mumbai City,6417,1,7,4,3,18,9,9,25
Kerala Blast,6417,2,6,4,4,12,13,-1,22
Delhi Dynamo,6417,3,5,6,3,25,18,7,21
FC Goa,6417,4,5,3,6,11,15,-4,18
Chennaiyin,6417,5,4,5,5,14,18,-4,17
Kolkata,6417,6,3,7,4,14,15,-1,16
FC Pune City,6417,7,4,4,6,12,16,-4,16
NorthEast Un,6417,8,4,3,7,11,13,-2,15
Mumbai City,6418,1,6,5,3,18,10,8,23
Delhi Dynamo,6418,2,5,7,2,29,19,10,22
Kerala Blast,6418,3,6,4,4,12,14,-2,22
Kolkata,6418,4,4,7,3,16,14,2,19
Chennaiyin,6418,5,4,5,5,18,18,0,17
NorthEast Un,6418,6,5,2,7,11,14,-3,17
FC Pune City,6418,7,4,4,6,13,17,-4,16
FC Goa,6418,8,3,4,7,11,22,-11,13
Mumbai City,6419,1,6,5,3,17,9,8,23
Delhi Dynamo,6419,2,5,7,2,25,17,8,22
Kolkata,6419,3,5,6,3,19,15,4,21
Chennaiyin,6419,4,5,5,4,19,18,1,20
NorthEast Un,6419,5,5,2,7,13,14,-1,17
FC Pune City,6419,6,4,4,6,13,16,-3,16
Kerala Blast,6419,7,4,4,6,10,21,-11,16
FC Goa,6419,8,4,3,7,14,20,-6,15
Delhi Dynamo,6420,1,6,5,3,24,17,7,23
Mumbai City,6420,2,6,4,4,16,9,7,22
NorthEast Un,6420,3,6,3,5,12,9,3,21
Kolkata,6420,4,5,6,3,20,19,1,21
Kerala Blast,6420,5,5,4,5,15,17,-2,19
FC Pune City,6420,6,5,3,6,15,17,-2,18
Chennaiyin,6420,7,4,5,5,14,18,-4,17
FC Goa,6420,8,3,2,9,10,20,-10,11
Mumbai City,6421,1,6,5,3,17,9,8,23
NorthEast Un,6421,2,7,2,5,13,10,3,23
Kolkata,6421,3,5,6,3,19,14,5,21
FC Pune City,6421,4,6,3,5,15,15,0,21
Delhi Dynamo,6421,5,4,6,4,23,21,2,18
Chennaiyin,6421,6,4,5,5,16,20,-4,17
Kerala Blast,6421,7,4,3,7,11,19,-8,15
FC Goa,6421,8,4,2,8,14,20,-6,14
Mumbai City,6422,1,6,5,3,17,9,8,23
Delhi Dynamo,6422,2,5,6,3,27,19,8,21
NorthEast Un,6422,3,6,3,5,16,12,4,21
Kerala Blast,6422,4,4,6,4,12,16,-4,18
Kolkata,6422,5,3,8,3,16,16,0,17
FC Pune City,6422,6,4,5,5,14,16,-2,17
Chennaiyin,6422,7,3,6,5,15,20,-5,15
FC Goa,6422,8,4,3,7,11,20,-9,15
Mumbai City,6423,1,7,4,3,18,8,10,25
Kolkata,6423,2,5,7,2,17,14,3,22
Kerala Blast,6423,3,6,3,5,13,14,-1,21
Delhi Dynamo,6423,4,5,5,4,23,18,5,20
NorthEast Un,6423,5,5,2,7,10,13,-3,17
Chennaiyin,6423,6,4,5,5,14,19,-5,17
FC Pune City,6423,7,4,4,6,13,16,-3,16
FC Goa,6423,8,4,2,8,12,18,-6,14
Mumbai City,6424,1,7,4,3,18,8,10,25
Delhi Dynamo,6424,2,6,5,3,25,17,8,23
FC Pune City,6424,3,6,3,5,17,15,2,21
Chennaiyin,6424,4,5,5,4,16,17,-1,20
Kolkata,6424,5,4,7,3,16,14,2,19
Kerala Blast,6424,6,4,4,6,10,19,-9,16
NorthEast Un,6424,7,4,3,7,10,12,-2,15
FC Goa,6424,8,3,3,8,9,19,-10,12
Mumbai City,6425,1,7,4,3,19,8,11,25
Delhi Dynamo,6425,2,5,6,3,25,18,7,21
Kolkata,6425,3,4,7,3,14,13,1,19
FC Pune City,6425,4,5,4,5,15,16,-1,19
Kerala Blast,6425,5,5,4,5,15,17,-2,19
NorthEast Un,6425,6,5,2,7,11,16,-5,17
FC Goa,6425,7,4,4,6,14,16,-2,16
Chennaiyin,6425,8,3,5,6,14,23,-9,14
Delhi Dynamo,6426,1,6,6,2,28,16,12,24
Mumbai City,6426,2,6,5,3,17,9,8,23
Kerala Blast,6426,3,5,5,4,13,15,-2,20
FC Pune City,6426,4,5,4,5,15,15,0,19
Kolkata,6426,5,3,8,3,15,16,-1,17
NorthEast Un,6426,6,4,3,7,9,13,-4,15
Chennaiyin,6426,7,3,6,5,13,19,-6,15
FC Goa,6426,8,4,3,7,12,19,-7,15
Mumbai City,6427,1,6,5,3,16,8,8,23
FC Pune City,6427,2,6,3,5,18,15,3,21
Kerala Blast,6427,3,6,3,5,15,18,-3,21
Delhi Dynamo,6427,4,4,6,4,23,20,3,18
NorthEast Un,6427,5,5,3,6,14,13,1,18
Chennaiyin,6427,6,4,6,4,17,19,-2,18
FC Goa,6427,7,5,2,7,14,19,-5,17
Kolkata,6427,8,3,6,5,16,21,-5,15
Mumbai City,6428,1,7,4,3,23,8,15,25
NorthEast Un,6428,2,6,3,5,15,10,5,21
Kolkata,6428,3,5,6,3,19,17,2,21
FC Pune City,6428,4,5,3,6,14,16,-2,18
Delhi Dynamo,6428,5,4,6,4,22,25,-3,18
FC Goa,6428,6,5,3,6,14,17,-3,18
Chennaiyin,6428,7,3,6,5,13,19,-6,15
Kerala Blast,6428,8,4,3,7,11,19,-8,15
Mumbai City,6429,1,7,4,3,17,8,9,25
Delhi Dynamo,6429,2,5,6,3,24,17,7,21
Kerala Blast,6429,3,5,4,5,13,18,-5,19
Kolkata,6429,4,4,6,4,16,15,1,18
Chennaiyin,6429,5,4,6,4,17,18,-1,18
FC Pune City,6429,6,5,3,6,14,16,-2,18
NorthEast Un,6429,7,4,4,6,13,14,-1,16
FC Goa,6429,8,4,3,7,10,18,-8,15
Mumbai City,6430,1,7,4,3,17,8,9,25
Kerala Blast,6430,2,7,3,4,12,13,-1,24
Chennaiyin,6430,3,5,5,4,18,18,0,20
Kolkata,6430,4,4,6,4,17,16,1,18
FC Pune City,6430,5,5,3,6,14,16,-2,18
Delhi Dynamo,6430,6,4,5,5,22,22,0,17
NorthEast Un,6430,7,5,2,7,14,15,-1,17
FC Goa,6430,8,4,2,8,12,18,-6,14
Delhi Dynamo,6431,1,7,5,2,31,18,13,26
Mumbai City,6431,2,6,4,4,17,12,5,22
Kerala Blast,6431,3,6,3,5,12,15,-3,21
Kolkata,6431,4,4,6,4,16,18,-2,18
FC Pune City,6431,5,5,3,6,14,16,-2,18
FC Goa,6431,6,5,2,7,14,16,-2,17
Chennaiyin,6431,7,4,5,5,16,20,-4,17
NorthEast Un,6431,8,4,2,8,12,17,-5,14
Mumbai City,6432,1,7,4,3,18,8,10,25
Kerala Blast,6432,2,6,3,5,14,17,-3,21
Delhi Dynamo,6432,3,5,5,4,23,18,5,20
Chennaiyin,6432,4,5,5,4,17,17,0,20
FC Pune City,6432,5,5,4,5,16,16,0,19
FC Goa,6432,6,5,2,7,12,17,-5,17
Kolkata,6432,7,3,7,4,16,17,-1,16
NorthEast Un,6432,8,4,2,8,11,17,-6,14
Mumbai City,6433,1,6,5,3,16,8,8,23
Delhi Dynamo,6433,2,5,7,2,25,17,8,22
NorthEast Un,6433,3,6,3,5,12,10,2,21
Kolkata,6433,4,4,8,2,18,14,4,20
Kerala Blast,6433,5,5,3,6,11,18,-7,18
FC Pune City,6433,6,4,4,6,12,15,-3,16
Chennaiyin,6433,7,3,6,5,14,19,-5,15
FC Goa,6433,8,3,4,7,12,19,-7,13
Mumbai City,6434,1,7,4,3,18,9,9,25
Delhi Dynamo,6434,2,5,6,3,26,18,8,21
NorthEast Un,6434,3,6,3,5,14,12,2,21
FC Pune City,6434,4,5,4,5,13,14,-1,19
Kerala Blast,6434,5,4,5,5,12,17,-5,17
Kolkata,6434,6,3,7,4,14,17,-3,16
Chennaiyin,6434,7,3,6,5,14,19,-5,15
FC Goa,6434,8,4,3,7,13,18,-5,15
Mumbai City,6435,1,6,4,4,16,10,6,22
Delhi Dynamo,6435,2,5,6,3,24,19,5,21
Chennaiyin,6435,3,5,5,4,16,17,-1,20
Kerala Blast,6435,4,5,5,4,13,16,-3,20
FC Pune City,6435,5,5,4,5,14,14,0,19
NorthEast Un,6435,6,5,3,6,15,12,3,18
Kolkata,6435,7,3,6,5,15,18,-3,15
FC Goa,6435,8,4,3,7,9,16,-7,15
Delhi Dynamo,6436,1,6,5,3,26,16,10,23
Mumbai City,6436,2,6,4,4,16,10,6,22
Kerala Blast,6436,3,6,4,4,13,15,-2,22
NorthEast Un,6436,4,5,4,5,11,10,1,19
Kolkata,6436,5,4,6,4,16,18,-2,18
FC Goa,6436,6,5,2,7,12,16,-4,17
FC Pune City,6436,7,4,3,7,14,18,-4,15
Chennaiyin,6436,8,3,6,5,13,18,-5,15
Delhi Dynamo,6437,1,7,5,2,28,15,13,26
Mumbai City,6437,2,6,4,4,17,10,7,22
Kolkata,6437,3,5,6,3,19,15,4,21
Kerala Blast,6437,4,6,3,5,14,17,-3,21
Chennaiyin,6437,5,4,6,4,19,21,-2,18
NorthEast Un,6437,6,5,2,7,11,15,-4,17
FC Pune City,6437,7,4,3,7,13,18,-5,15
FC Goa,6437,8,3,3,8,11,21,-10,12
Delhi Dynamo,6438,1,7,5,2,26,15,11,26
Mumbai City,6438,2,6,4,4,16,10,6,22
Kerala Blast,6438,3,5,5,4,13,14,-1,20
Kolkata,6438,4,4,7,3,16,18,-2,19
FC Pune City,6438,5,4,4,6,12,15,-3,16
Chennaiyin,6438,6,3,7,4,13,17,-4,16
FC Goa,6438,7,4,3,7,13,16,-3,15
NorthEast Un,6438,8,4,3,7,10,14,-4,15
Mumbai City,6439,1,7,4,3,18,9,9,25
FC Pune City,6439,2,6,3,5,15,14,1,21
Delhi Dynamo,6439,3,5,5,4,25,18,7,20
NorthEast Un,6439,4,5,4,5,12,11,1,19
Kolkata,6439,5,4,6,4,16,16,0,18
FC Goa,6439,6,5,2,7,13,18,-5,17
Kerala Blast,6439,7,4,4,6,10,17,-7,16
Chennaiyin,6439,8,3,6,5,15,21,-6,15
Delhi Dynamo,6440,1,5,7,2,25,17,8,22
Mumbai City,6440,2,6,4,4,16,9,7,22
Kolkata,6440,3,4,7,3,17,15,2,19
NorthEast Un,6440,4,5,4,5,15,14,1,19
Kerala Blast,6440,5,5,4,5,13,18,-5,19
FC Pune City,6440,6,5,3,6,15,17,-2,18
FC Goa,6440,7,4,4,6,15,18,-3,16
Chennaiyin,6440,8,3,5,6,16,24,-8,14
Kerala Blast,6441,1,7,3,4,14,15,-1,24
Mumbai City,6441,2,6,5,3,17,9,8,23
Delhi Dynamo,6441,3,5,6,3,25,18,7,21
Kolkata,6441,4,5,6,3,18,15,3,21
NorthEast Un,6441,5,5,3,6,13,13,0,18
Chennaiyin,6441,6,3,7,4,15,19,-4,16
FC Pune City,6441,7,4,3,7,13,17,-4,15
FC Goa,6441,8,3,3,8,10,19,-9,12
Mumbai City,6442,1,6,4,4,16,9,7,22
Delhi Dynamo,6442,2,5,6,3,22,16,6,21
Kolkata,6442,3,4,7,3,16,14,2,19
FC Pune City,6442,4,5,4,5,14,15,-1,19
Kerala Blast,6442,5,5,3,6,13,17,-4,18
FC Goa,6442,6,5,3,6,10,14,-4,18
NorthEast Un,6442,7,5,2,7,12,14,-2,17
Chennaiyin,6442,8,4,5,5,14,18,-4,17
Mumbai City,6443,1,7,4,3,19,9,10,25
Delhi Dynamo,6443,2,6,5,3,26,18,8,23
Kolkata,6443,3,4,8,2,18,15,3,20
FC Pune City,6443,4,5,4,5,15,16,-1,19
NorthEast Un,6443,5,5,3,6,12,12,0,18
Chennaiyin,6443,6,4,5,5,17,21,-4,17
Kerala Blast,6443,7,4,4,6,11,18,-7,16
FC Goa,6443,8,3,3,8,11,20,-9,12
Mumbai City,6444,1,7,4,3,18,8,10,25
Kolkata,6444,2,6,6,2,22,14,8,24
Delhi Dynamo,6444,3,5,6,3,24,18,6,21
NorthEast Un,6444,4,5,3,6,12,12,0,18
Chennaiyin,6444,5,4,6,4,16,19,-3,18
Kerala Blast,6444,6,5,3,6,11,17,-6,18
FC Pune City,6444,7,4,3,7,13,18,-5,15
FC Goa,6444,8,3,3,8,10,20,-10,12
Mumbai City,6445,1,7,4,3,19,10,9,25
Kolkata,6445,2,5,6,3,16,13,3,21
Kerala Blast,6445,3,6,3,5,14,16,-2,21
Delhi Dynamo,6445,4,5,5,4,28,19,9,20
NorthEast Un,6445,5,6,2,6,14,10,4,20
Chennaiyin,6445,6,5,5,4,15,17,-2,20
FC Pune City,6445,7,4,3,7,12,20,-8,15
FC Goa,6445,8,3,2,9,8,21,-13,11
Mumbai City,6446,1,6,5,3,17,9,8,23
Delhi Dynamo,6446,2,5,7,2,27,17,10,22
Kolkata,6446,3,5,6,3,16,14,2,21
Kerala Blast,6446,4,6,3,5,13,16,-3,21
NorthEast Un,6446,5,6,2,6,14,14,0,20
Chennaiyin,6446,6,4,5,5,15,19,-4,17
FC Pune City,6446,7,4,3,7,13,18,-5,15
FC Goa,6446,8,3,3,8,10,18,-8,12
Delhi Dynamo,6447,1,7,5,2,24,14,10,26
Mumbai City,6447,2,6,4,4,16,9,7,22
Chennaiyin,6447,3,5,5,4,16,18,-2,20
Kolkata,6447,4,4,7,3,18,18,0,19
FC Pune City,6447,5,5,3,6,18,17,1,18
Kerala Blast,6447,6,5,3,6,12,19,-7,18
NorthEast Un,6447,7,5,2,7,10,11,-1,17
FC Goa,6447,8,3,3,8,10,18,-8,12
Kolkata,6448,1,6,6,2,21,14,7,24
Mumbai City,6448,2,6,5,3,18,10,8,23
Delhi Dynamo,6448,3,5,6,3,24,19,5,21
Kerala Blast,6448,4,6,3,5,14,17,-3,21
NorthEast Un,6448,5,5,3,6,14,12,2,18
Chennaiyin,6448,6,3,6,5,14,20,-6,15
FC Pune City,6448,7,4,3,7,14,21,-7,15
FC Goa,6448,8,4,2,8,11,17,-6,14
Mumbai City,6449,1,7,4,3,18,9,9,25
Kolkata,6449,2,5,6,3,18,14,4,21
Delhi Dynamo,6449,3,5,5,4,26,17,9,20
Kerala Blast,6449,4,5,4,5,12,18,-6,19
NorthEast Un,6449,5,5,3,6,12,12,0,18
Chennaiyin,6449,6,4,5,5,15,21,-6,17
FC Goa,6449,7,5,2,7,13,19,-6,17
FC Pune City,6449,8,4,3,7,13,17,-4,15
Delhi Dynamo,6450,1,6,6,2,26,15,11,24
Mumbai City,6450,2,6,5,3,17,9,8,23
Kerala Blast,6450,3,6,4,4,14,14,0,22
Kolkata,6450,4,4,8,2,15,13,2,20
Chennaiyin,6450,5,4,5,5,16,20,-4,17
FC Pune City,6450,6,4,4,6,12,15,-3,16
NorthEast Un,6450,7,4,2,8,10,16,-6,14
FC Goa,6450,8,4,2,8,10,18,-8,14
Mumbai City,6451,1,6,5,3,16,8,8,23
Delhi Dynamo,6451,2,5,6,3,22,15,7,21
Kolkata,6451,3,4,7,3,17,16,1,19
Kerala Blast,6451,4,5,4,5,13,18,-5,19
FC Pune City,6451,5,5,3,6,16,17,-1,18
NorthEast Un,6451,6,5,3,6,12,13,-1,18
Chennaiyin,6451,7,4,5,5,17,21,-4,17
FC Goa,6451,8,4,3,7,12,17,-5,15
Mumbai City,6452,1,7,4,3,18,9,9,25
Delhi Dynamo,6452,2,5,6,3,27,19,8,21
Kolkata,6452,3,5,6,3,16,16,0,21
FC Pune City,6452,4,5,4,5,17,16,1,19
Chennaiyin,6452,5,4,6,4,15,18,-3,18
Kerala Blast,6452,6,4,5,5,14,19,-5,17
NorthEast Un,6452,7,4,3,7,13,16,-3,15
FC Goa,6452,8,3,4,7,10,17,-7,13
Mumbai City,6453,1,7,4,3,22,8,14,25
Delhi Dynamo,6453,2,5,6,3,24,22,2,21
Kolkata,6453,3,4,8,2,18,15,3,20
FC Pune City,6453,4,5,4,5,14,15,-1,19
Chennaiyin,6453,5,4,5,5,15,20,-5,17
FC Goa,6453,6,4,4,6,14,18,-4,16
Kerala Blast,6453,7,4,4,6,9,16,-7,16
NorthEast Un,6453,8,4,3,7,10,12,-2,15
Mumbai City,6454,1,6,4,4,17,12,5,22
Delhi Dynamo,6454,2,5,5,4,26,18,8,20
FC Pune City,6454,3,5,4,5,15,16,-1,19
Kerala Blast,6454,4,5,4,5,13,17,-4,19
NorthEast Un,6454,5,5,3,6,11,12,-1,18
Chennaiyin,6454,6,4,6,4,15,17,-2,18
FC Goa,6454,7,5,3,6,11,15,-4,18
Kolkata,6454,8,3,7,4,17,18,-1,16
Kolkata,6455,1,6,6,2,18,14,4,24
Delhi Dynamo,6455,2,6,5,3,25,16,9,23
Mumbai City,6455,3,6,4,4,17,11,6,22
Kerala Blast,6455,4,5,4,5,12,16,-4,19
NorthEast Un,6455,5,5,3,6,11,12,-1,18
Chennaiyin,6455,6,4,6,4,15,17,-2,18
FC Pune City,6455,7,4,3,7,13,17,-4,15
FC Goa,6455,8,3,3,8,8,16,-8,12
Mumbai City,6456,1,6,5,3,17,9,8,23
Kerala Blast,6456,2,5,5,4,11,14,-3,20
Delhi Dynamo,6456,3,4,7,3,23,18,5,19
NorthEast Un,6456,4,5,3,6,13,12,1,18
FC Pune City,6456,5,5,3,6,15,17,-2,18
FC Goa,6456,6,5,3,6,14,17,-3,18
Chennaiyin,6456,7,4,5,5,16,20,-4,17
Kolkata,6456,8,3,7,4,16,18,-2,16
Mumbai City,6457,1,6,4,4,17,10,7,22
Kolkata,6457,2,5,6,3,17,16,1,21
Delhi Dynamo,6457,3,5,5,4,25,19,6,20
NorthEast Un,6457,4,6,2,6,13,12,1,20
Chennaiyin,6457,5,5,5,4,18,18,0,20
Kerala Blast,6457,6,5,3,6,10,15,-5,18
FC Goa,6457,7,5,2,7,13,19,-6,17
FC Pune City,6457,8,4,3,7,13,17,-4,15
Mumbai City,6458,1,7,4,3,18,9,9,25
Delhi Dynamo,6458,2,6,5,3,25,16,9,23
Kerala Blast,6458,3,5,5,4,13,16,-3,20
Chennaiyin,6458,4,4,6,4,15,18,-3,18
Kolkata,6458,5,3,8,3,15,16,-1,17
FC Pune City,6458,6,4,5,5,12,14,-2,17
FC Goa,6458,7,4,3,7,11,17,-6,15
NorthEast Un,6458,8,4,2,8,10,13,-3,14
Mumbai City,6459,1,7,4,3,18,9,9,25
Kerala Blast,6459,2,7,3,4,15,16,-1,24
Delhi Dynamo,6459,3,5,5,4,24,17,7,20
Chennaiyin,6459,4,5,5,4,15,17,-2,20
FC Pune City,6459,5,5,3,6,18,20,-2,18
NorthEast Un,6459,6,5,2,7,10,11,-1,17
Kolkata,6459,7,3,6,5,16,18,-2,15
FC Goa,6459,8,4,2,8,10,18,-8,14
Delhi Dynamo,6460,1,6,6,2,25,14,11,24
Mumbai City,6460,2,6,4,4,16,10,6,22
Kerala Blast,6460,3,6,4,4,13,15,-2,22
Kolkata,6460,4,4,7,3,20,19,1,19
Chennaiyin,6460,5,4,6,4,16,19,-3,18
NorthEast Un,6460,6,4,5,5,10,10,0,17
FC Pune City,6460,7,4,3,7,16,20,-4,15
FC Goa,6460,8,3,3,8,11,20,-9,12
Delhi Dynamo,6461,1,6,6,2,25,15,10,24
Mumbai City,6461,2,6,5,3,16,8,8,23
FC Pune City,6461,3,5,4,5,15,16,-1,19
Kerala Blast,6461,4,5,4,5,12,16,-4,19
Kolkata,6461,5,4,6,4,14,14,0,18
NorthEast Un,6461,6,5,2,7,11,13,-2,17
Chennaiyin,6461,7,4,5,5,16,21,-5,17
FC Goa,6461,8,4,2,8,12,18,-6,14
Mumbai City,6462,1,7,4,3,18,9,9,25
Kolkata,6462,2,5,7,2,18,14,4,22
Delhi Dynamo,6462,3,5,6,3,26,18,8,21
FC Pune City,6462,4,5,4,5,15,16,-1,19
NorthEast Un,6462,5,5,3,6,12,13,-1,18
Kerala Blast,6462,6,5,3,6,13,17,-4,18
Chennaiyin,6462,7,4,5,5,16,20,-4,17
FC Goa,6462,8,3,2,9,10,21,-11,11
Mumbai City,6463,1,6,5,3,17,9,8,23
Delhi Dynamo,6463,2,5,6,3,25,17,8,21
FC Pune City,6463,3,6,3,5,19,14,5,21
Chennaiyin,6463,4,5,5,4,15,17,-2,20
Kolkata,6463,5,4,6,4,17,20,-3,18
Kerala Blast,6463,6,5,3,6,12,19,-7,18
FC Goa,6463,7,5,2,7,13,17,-4,17
NorthEast Un,6463,8,4,2,8,10,15,-5,14
Mumbai City,6464,1,6,4,4,16,9,7,22
Delhi Dynamo,6464,2,5,6,3,22,15,7,21
FC Pune City,6464,3,6,3,5,17,17,0,21
NorthEast Un,6464,4,6,2,6,13,12,1,20
Kolkata,6464,5,4,7,3,19,17,2,19
Chennaiyin,6464,6,4,6,4,16,18,-2,18
Kerala Blast,6464,7,4,3,7,10,19,-9,15
FC Goa,6464,8,3,5,6,10,16,-6,14
Delhi Dynamo,6465,1,6,6,2,27,17,10,24
Mumbai City,6465,2,6,5,3,18,10,8,23
Kerala Blast,6465,3,5,5,4,11,14,-3,20
NorthEast Un,6465,4,5,3,6,12,12,0,18
Kolkata,6465,5,3,8,3,14,14,0,17
FC Pune City,6465,6,4,5,5,12,14,-2,17
Chennaiyin,6465,7,3,6,5,13,18,-5,15
FC Goa,6465,8,3,4,7,9,17,-8,13
Mumbai City,6466,1,7,4,3,18,9,9,25
FC Pune City,6466,2,6,3,5,16,14,2,21
Delhi Dynamo,6466,3,4,7,3,25,19,6,19
NorthEast Un,6466,4,5,3,6,13,12,1,18
FC Goa,6466,5,5,3,6,18,18,0,18
Kerala Blast,6466,6,5,3,6,11,17,-6,18
Chennaiyin,6466,7,4,5,5,17,21,-4,17
Kolkata,6466,8,3,6,5,14,22,-8,15
Mumbai City,6467,1,7,4,3,19,8,11,25
Delhi Dynamo,6467,2,6,5,3,23,17,6,23
Kerala Blast,6467,3,6,3,5,13,17,-4,21
FC Pune City,6467,4,5,4,5,16,15,1,19
Kolkata,6467,5,3,8,3,17,18,-1,17
Chennaiyin,6467,6,4,5,5,16,20,-4,17
FC Goa,6467,7,4,3,7,13,17,-4,15
NorthEast Un,6467,8,4,2,8,9,14,-5,14
Mumbai City,6468,1,7,4,3,19,9,10,25
Kolkata,6468,2,5,6,3,17,14,3,21
Delhi Dynamo,6468,3,5,5,4,24,21,3,20
FC Goa,6468,4,5,3,6,13,14,-1,18
NorthEast Un,6468,5,5,3,6,10,11,-1,18
Kerala Blast,6468,6,4,5,5,10,15,-5,17
FC Pune City,6468,7,4,4,6,12,16,-4,16
Chennaiyin,6468,8,3,6,5,13,18,-5,15
Mumbai City,6469,1,7,4,3,19,9,10,25
Delhi Dynamo,6469,2,5,5,4,24,19,5,20
FC Goa,6469,3,6,2,6,13,15,-2,20
Kolkata,6469,4,4,7,3,14,14,0,19
Kerala Blast,6469,5,5,4,5,12,16,-4,19
NorthEast Un,6469,6,5,2,7,12,13,-1,17
Chennaiyin,6469,7,4,5,5,14,18,-4,17
FC Pune City,6469,8,4,3,7,12,16,-4,15
Mumbai City,6470,1,7,4,3,19,8,11,25
Delhi Dynamo,6470,2,6,5,3,27,19,8,23
Kolkata,6470,3,5,6,3,21,14,7,21
Kerala Blast,6470,4,5,4,5,11,18,-7,19
Chennaiyin,6470,5,4,6,4,18,20,-2,18
FC Pune City,6470,6,4,4,6,14,19,-5,16
NorthEast Un,6470,7,4,3,7,13,17,-4,15
FC Goa,6470,8,4,2,8,10,18,-8,14
Delhi Dynamo,6471,1,6,6,2,26,16,10,24
Mumbai City,6471,2,6,4,4,17,10,7,22
Kolkata,6471,3,5,7,2,16,13,3,22
Kerala Blast,6471,4,5,4,5,13,17,-4,19
NorthEast Un,6471,5,5,3,6,11,12,-1,18
FC Pune City,6471,6,4,4,6,13,16,-3,16
FC Goa,6471,7,4,3,7,12,16,-4,15
Chennaiyin,6471,8,3,5,6,13,21,-8,14
Mumbai City,6472,1,6,5,3,17,9,8,23
Kolkata,6472,2,5,6,3,20,16,4,21
Delhi Dynamo,6472,3,4,7,3,25,20,5,19
Kerala Blast,6472,4,5,4,5,13,17,-4,19
NorthEast Un,6472,5,5,3,6,13,13,0,18
Chennaiyin,6472,6,4,6,4,17,20,-3,18
FC Pune City,6472,7,4,4,6,14,18,-4,16
FC Goa,6472,8,4,3,7,14,20,-6,15
Mumbai City,6473,1,6,5,3,17,9,8,23
Kerala Blast,6473,2,6,4,4,14,16,-2,22
Delhi Dynamo,6473,3,5,6,3,26,20,6,21
Kolkata,6473,4,4,7,3,16,17,-1,19
NorthEast Un,6473,5,5,3,6,17,16,1,18
FC Goa,6473,6,5,2,7,14,15,-1,17
FC Pune City,6473,7,4,3,7,13,18,-5,15
Chennaiyin,6473,8,3,6,5,15,21,-6,15
Delhi Dynamo,6474,1,6,6,2,27,18,9,24
Mumbai City,6474,2,6,4,4,16,9,7,22
NorthEast Un,6474,3,6,3,5,15,12,3,21
Kolkata,6474,4,5,6,3,16,16,0,21
FC Pune City,6474,5,5,3,6,14,16,-2,18
FC Goa,6474,6,5,2,7,17,19,-2,17
Kerala Blast,6474,7,4,3,7,12,19,-7,15
Chennaiyin,6474,8,3,5,6,15,23,-8,14
Mumbai City,6475,1,7,4,3,18,9,9,25
NorthEast Un,6475,2,7,2,5,13,10,3,23
Kolkata,6475,3,4,8,2,15,13,2,20
Delhi Dynamo,6475,4,4,5,5,22,20,2,17
FC Pune City,6475,5,4,5,5,12,14,-2,17
Chennaiyin,6475,6,4,5,5,16,20,-4,17
Kerala Blast,6475,7,4,4,6,9,15,-6,16
FC Goa,6475,8,4,3,7,13,17,-4,15
Mumbai City,6476,1,7,4,3,19,9,10,25
Delhi Dynamo,6476,2,5,6,3,24,18,6,21
Kolkata,6476,3,4,7,3,17,16,1,19
FC Pune City,6476,4,5,4,5,15,16,-1,19
Chennaiyin,6476,5,4,6,4,16,18,-2,18
NorthEast Un,6476,6,4,4,6,11,12,-1,16
Kerala Blast,6476,7,4,4,6,10,16,-6,16
FC Goa,6476,8,4,3,7,9,16,-7,15
Mumbai City,6477,1,6,5,3,16,8,8,23
Delhi Dynamo,6477,2,5,7,2,23,15,8,22
FC Pune City,6477,3,5,4,5,15,15,0,19
Kerala Blast,6477,4,5,4,5,13,15,-2,19
NorthEast Un,6477,5,5,3,6,11,12,-1,18
Chennaiyin,6477,6,4,6,4,15,17,-2,18
FC Goa,6477,7,4,3,7,13,18,-5,15
Kolkata,6477,8,3,6,5,16,22,-6,15
Delhi Dynamo,6478,1,6,6,2,28,17,11,24
Mumbai City,6478,2,6,5,3,16,8,8,23
Kolkata,6478,3,4,8,2,17,15,2,20
Kerala Blast,6478,4,5,4,5,11,16,-5,19
Chennaiyin,6478,5,4,6,4,14,17,-3,18
NorthEast Un,6478,6,5,2,7,13,14,-1,17
FC Pune City,6478,7,4,4,6,14,17,-3,16
FC Goa,6478,8,3,3,8,9,18,-9,12
Mumbai City,6479,1,7,4,3,17,8,9,25
Delhi Dynamo,6479,2,5,6,3,25,18,7,21
NorthEast Un,6479,3,6,3,5,13,11,2,21
Kolkata,6479,4,4,8,2,16,14,2,20
FC Pune City,6479,5,5,4,5,15,16,-1,19
Chennaiyin,6479,6,3,6,5,14,19,-5,15
Kerala Blast,6479,7,4,3,7,10,17,-7,15
FC Goa,6479,8,3,4,7,11,18,-7,13
Mumbai City,6480,1,7,4,3,18,9,9,25
Delhi Dynamo,6480,2,5,6,3,24,17,7,21
FC Pune City,6480,3,6,3,5,15,14,1,21
NorthEast Un,6480,4,5,3,6,12,10,2,18
Chennaiyin,6480,5,4,6,4,14,17,-3,18
Kolkata,6480,6,3,7,4,14,17,-3,16
Kerala Blast,6480,7,4,4,6,9,17,-8,16
FC Goa,6480,8,4,3,7,12,17,-5,15
Delhi Dynamo,6481,1,6,5,3,26,17,9,23
Mumbai City,6481,2,6,4,4,16,10,6,22
Kolkata,6481,3,4,7,3,18,17,1,19
Kerala Blast,6481,4,5,4,5,10,14,-4,19
FC Pune City,6481,5,5,3,6,14,18,-4,18
FC Goa,6481,6,5,2,7,15,17,-2,17
NorthEast Un,6481,7,5,2,7,11,13,-2,17
Chennaiyin,6481,8,4,5,5,15,19,-4,17
Mumbai City,6482,1,7,4,3,19,10,9,25
Kerala Blast,6482,2,7,3,4,18,15,3,24
Delhi Dynamo,6482,3,5,6,3,25,18,7,21
Kolkata,6482,4,4,7,3,17,17,0,19
Chennaiyin,6482,5,4,5,5,15,19,-4,17
FC Goa,6482,6,4,4,6,11,16,-5,16
FC Pune City,6482,7,4,3,7,13,19,-6,15
NorthEast Un,6482,8,4,2,8,10,14,-4,14
Delhi Dynamo,6483,1,6,6,2,29,17,12,24
Mumbai City,6483,2,6,4,4,17,12,5,22
NorthEast Un,6483,3,6,3,5,14,11,3,21
Kolkata,6483,4,4,7,3,19,15,4,19
FC Pune City,6483,5,5,3,6,14,18,-4,18
Kerala Blast,6483,6,5,3,6,12,18,-6,18
FC Goa,6483,7,4,3,7,10,17,-7,15
Chennaiyin,6483,8,3,5,6,14,21,-7,14
Mumbai City,6484,1,6,5,3,17,9,8,23
Kolkata,6484,2,5,7,2,16,12,4,22
Delhi Dynamo,6484,3,4,7,3,23,17,6,19
NorthEast Un,6484,4,5,3,6,13,13,0,18
FC Pune City,6484,5,5,3,6,14,16,-2,18
Chennaiyin,6484,6,4,5,5,16,20,-4,17
FC Goa,6484,7,4,4,6,10,15,-5,16
Kerala Blast,6484,8,4,4,6,10,17,-7,16
Mumbai City,6485,1,7,4,3,18,8,10,25
NorthEast Un,6485,2,6,2,6,11,10,1,20
FC Pune City,6485,3,5,4,5,15,16,-1,19
Delhi Dynamo,6485,4,4,6,4,23,19,4,18
Kerala Blast,6485,5,5,3,6,13,17,-4,18
Kolkata,6485,6,3,8,3,15,16,-1,17
Chennaiyin,6485,7,4,5,5,14,22,-8,17
FC Goa,6485,8,4,4,6,15,16,-1,16
Delhi Dynamo,6486,1,5,7,2,25,16,9,22
Mumbai City,6486,2,6,4,4,17,11,6,22
FC Pune City,6486,3,6,3,5,18,15,3,21
Chennaiyin,6486,4,4,6,4,16,18,-2,18
Kolkata,6486,5,4,6,4,15,19,-4,18
Kerala Blast,6486,6,5,3,6,12,18,-6,18
FC Goa,6486,7,4,4,6,12,14,-2,16
NorthEast Un,6486,8,4,3,7,11,15,-4,15
Kolkata,6487,1,6,6,2,19,14,5,24
Mumbai City,6487,2,6,5,3,16,8,8,23
NorthEast Un,6487,3,6,3,5,14,11,3,21
Delhi Dynamo,6487,4,4,7,3,23,18,5,19
Kerala Blast,6487,5,5,3,6,14,17,-3,18
FC Goa,6487,6,4,3,7,14,18,-4,15
Chennaiyin,6487,7,3,6,5,14,21,-7,15
FC Pune City,6487,8,4,3,7,12,19,-7,15
Mumbai City,6488,1,7,4,3,18,9,9,25
Delhi Dynamo,6488,2,6,5,3,28,20,8,23
Kerala Blast,6488,3,5,4,5,12,16,-4,19
Kolkata,6488,4,3,9,2,14,13,1,18
NorthEast Un,6488,5,5,3,6,12,12,0,18
Chennaiyin,6488,6,4,6,4,14,17,-3,18
FC Pune City,6488,7,4,4,6,12,15,-3,16
FC Goa,6488,8,3,3,8,11,19,-8,12
Delhi Dynamo,6489,1,6,6,2,25,16,9,24
Mumbai City,6489,2,6,4,4,16,9,7,22
Kolkata,6489,3,5,7,2,15,12,3,22
Chennaiyin,6489,4,4,6,4,17,20,-3,18
Kerala Blast,6489,5,4,5,5,11,16,-5,17
NorthEast Un,6489,6,4,4,6,11,12,-1,16
FC Pune City,6489,7,4,4,6,14,17,-3,16
FC Goa,6489,8,3,4,7,11,18,-7,13
Delhi Dynamo,6490,1,7,5,2,28,15,13,26
Mumbai City,6490,2,6,4,4,16,10,6,22
NorthEast Un,6490,3,6,2,6,14,13,1,20
Kolkata,6490,4,3,8,3,16,16,0,17
FC Pune City,6490,5,4,5,5,14,16,-2,17
Chennaiyin,6490,6,4,5,5,14,19,-5,17
Kerala Blast,6490,7,4,5,5,13,18,-5,17
FC Goa,6490,8,4,2,8,9,17,-8,14
Mumbai City,6491,1,7,4,3,19,8,11,25
Delhi Dynamo,6491,2,5,6,3,24,17,7,21
Kolkata,6491,3,5,6,3,18,14,4,21
Kerala Blast,6491,4,6,3,5,13,14,-1,21
NorthEast Un,6491,5,5,3,6,10,12,-2,18
Chennaiyin,6491,6,4,5,5,16,18,-2,17
FC Pune City,6491,7,4,3,7,12,19,-7,15
FC Goa,6491,8,4,2,8,10,20,-10,14
Mumbai City,6492,1,6,4,4,17,10,7,22
Delhi Dynamo,6492,2,5,6,3,25,19,6,21
Kolkata,6492,3,5,6,3,20,17,3,21
FC Goa,6492,4,6,2,6,16,16,0,20
FC Pune City,6492,5,5,3,6,16,16,0,18
Chennaiyin,6492,6,4,5,5,15,20,-5,17
NorthEast Un,6492,7,4,4,6,13,14,-1,16
Kerala Blast,6492,8,4,4,6,10,20,-10,16
Mumbai City,6493,1,7,4,3,18,9,9,25
Kolkata,6493,2,5,7,2,18,13,5,22
Kerala Blast,6493,3,6,4,4,14,16,-2,22
Delhi Dynamo,6493,4,5,6,3,26,19,7,21
Chennaiyin,6493,5,5,5,4,17,17,0,20
NorthEast Un,6493,6,4,3,7,10,13,-3,15
FC Pune City,6493,7,4,3,7,14,19,-5,15
FC Goa,6493,8,3,2,9,10,21,-11,11
Mumbai City,6494,1,6,5,3,17,9,8,23
Delhi Dynamo,6494,2,4,8,2,22,15,7,20
Kolkata,6494,3,4,8,2,16,14,2,20
Chennaiyin,6494,4,5,5,4,19,18,1,20
FC Pune City,6494,5,5,3,6,13,15,-2,18
Kerala Blast,6494,6,4,5,5,10,15,-5,17
NorthEast Un,6494,7,4,4,6,9,12,-3,16
FC Goa,6494,8,3,4,7,10,18,-8,13
Mumbai City,6495,1,7,4,3,17,8,9,25
Kerala Blast,6495,2,7,3,4,17,16,1,24
Chennaiyin,6495,3,5,5,4,16,18,-2,20
Delhi Dynamo,6495,4,4,7,3,22,16,6,19
Kolkata,6495,5,4,7,3,15,14,1,19
NorthEast Un,6495,6,4,3,7,10,13,-3,15
FC Pune City,6495,7,4,3,7,13,18,-5,15
FC Goa,6495,8,3,4,7,10,17,-7,13
Mumbai City,6496,1,7,4,3,19,8,11,25
Kerala Blast,6496,2,6,4,4,14,16,-2,22
Kolkata,6496,3,5,6,3,17,15,2,21
NorthEast Un,6496,4,5,4,5,13,12,1,19
Delhi Dynamo,6496,5,4,6,4,22,19,3,18
FC Pune City,6496,6,4,3,7,14,18,-4,15
Chennaiyin,6496,7,3,6,5,14,19,-5,15
FC Goa,6496,8,4,3,7,9,15,-6,15
Mumbai City,6497,1,6,4,4,16,9,7,22
Delhi Dynamo,6497,2,5,6,3,25,21,4,21
NorthEast Un,6497,3,6,2,6,16,10,6,20
Kolkata,6497,4,4,8,2,17,15,2,20
Kerala Blast,6497,5,5,4,5,10,14,-4,19
FC Pune City,6497,6,4,5,5,12,14,-2,17
Chennaiyin,6497,7,4,5,5,15,21,-6,17
FC Goa,6497,8,3,4,7,15,22,-7,13
Mumbai City,6498,1,6,5,3,17,9,8,23
NorthEast Un,6498,2,6,3,5,14,12,2,21
Kolkata,6498,3,4,7,3,17,15,2,19
Delhi Dynamo,6498,4,4,6,4,24,19,5,18
Chennaiyin,6498,5,4,6,4,18,20,-2,18
FC Pune City,6498,6,5,3,6,13,16,-3,18
Kerala Blast,6498,7,5,3,6,13,18,-5,18
FC Goa,6498,8,4,3,7,13,20,-7,15
Delhi Dynamo,6499,1,6,6,2,26,15,11,24
Mumbai City,6499,2,6,4,4,17,11,6,22
Kerala Blast,6499,3,6,3,5,15,14,1,21
Kolkata,6499,4,4,7,3,15,14,1,19
FC Pune City,6499,5,5,3,6,13,17,-4,18
NorthEast Un,6499,6,5,2,7,11,14,-3,17
Chennaiyin,6499,7,4,5,5,14,19,-5,17
FC Goa,6499,8,3,4,7,9,16,-7,13
Kerala Blast,6500,1,7,3,4,18,15,3,24
Mumbai City,6500,2,6,4,4,16,10,6,22
Delhi Dynamo,6500,3,5,6,3,26,18,8,21
Kolkata,6500,4,5,6,3,17,17,0,21
Chennaiyin,6500,5,5,5,4,20,18,2,20
NorthEast Un,6500,6,5,2,7,13,16,-3,17
FC Pune City,6500,7,4,3,7,13,19,-6,15
FC Goa,6500,8,3,3,8,10,20,-10,12
Mumbai City,6501,1,6,4,4,17,10,7,22
Kerala Blast,6501,2,6,4,4,16,17,-1,22
Delhi Dynamo,6501,3,5,6,3,24,17,7,21
Kolkata,6501,4,4,7,3,16,15,1,19
NorthEast Un,6501,5,5,3,6,11,12,-1,18
FC Pune City,6501,6,5,3,6,17,19,-2,18
Chennaiyin,6501,7,3,7,4,14,18,-4,16
FC Goa,6501,8,3,4,7,9,16,-7,13
Kerala Blast,6502,1,7,3,4,14,14,0,24
Delhi Dynamo,6502,2,6,5,3,25,18,7,23
Mumbai City,6502,3,6,4,4,17,10,7,22
FC Goa,6502,4,5,3,6,15,16,-1,18
Kolkata,6502,5,3,8,3,13,14,-1,17
NorthEast Un,6502,6,5,2,7,11,12,-1,17
FC Pune City,6502,7,4,4,6,13,16,-3,16
Chennaiyin,6502,8,3,5,6,15,23,-8,14
Mumbai City,6503,1,7,4,3,18,8,10,25
Kolkata,6503,2,6,6,2,21,13,8,24
NorthEast Un,6503,3,6,3,5,16,12,4,21
Delhi Dynamo,6503,4,4,6,4,23,21,2,18
FC Pune City,6503,5,5,3,6,16,18,-2,18
Chennaiyin,6503,6,3,6,5,15,20,-5,15
FC Goa,6503,7,4,3,7,12,18,-6,15
Kerala Blast,6503,8,4,3,7,13,24,-11,15
Delhi Dynamo,6504,1,6,6,2,29,18,11,24
Mumbai City,6504,2,6,5,3,17,9,8,23
Kolkata,6504,3,5,6,3,16,15,1,21
FC Pune City,6504,4,5,3,6,13,15,-2,18
Kerala Blast,6504,5,5,3,6,13,17,-4,18
NorthEast Un,6504,6,5,2,7,14,16,-2,17
Chennaiyin,6504,7,4,5,5,15,19,-4,17
FC Goa,6504,8,4,2,8,11,19,-8,14
Delhi Dynamo,6505,1,7,5,2,25,14,11,26
Mumbai City,6505,2,6,4,4,16,10,6,22
Kolkata,6505,3,5,6,3,22,17,5,21
Kerala Blast,6505,4,6,3,5,14,19,-5,21
Chennaiyin,6505,5,4,6,4,17,20,-3,18
NorthEast Un,6505,6,4,3,7,11,14,-3,15
FC Pune City,6505,7,4,3,7,15,21,-6,15
FC Goa,6505,8,4,2,8,13,18,-5,14
Mumbai City,6506,1,7,4,3,19,8,11,25
Kolkata,6506,2,5,7,2,16,13,3,22
NorthEast Un,6506,3,6,2,6,13,11,2,20
Kerala Blast,6506,4,5,4,5,11,15,-4,19
Delhi Dynamo,6506,5,4,6,4,23,20,3,18
FC Pune City,6506,6,4,5,5,12,14,-2,17
Chennaiyin,6506,7,3,6,5,15,21,-6,15
FC Goa,6506,8,3,4,7,11,18,-7,13
Delhi Dynamo,6507,1,6,6,2,27,18,9,24
Mumbai City,6507,2,6,4,4,17,10,7,22
Kolkata,6507,3,5,6,3,17,13,4,21
Kerala Blast,6507,4,5,4,5,10,15,-5,19
Chennaiyin,6507,5,4,6,4,16,17,-1,18
FC Pune City,6507,6,4,4,6,12,16,-4,16
NorthEast Un,6507,7,4,3,7,10,14,-4,15
FC Goa,6507,8,4,3,7,11,17,-6,15
Mumbai City,6508,1,7,4,3,18,8,10,25
Kolkata,6508,2,5,6,3,18,16,2,21
Delhi Dynamo,6508,3,4,6,4,22,18,4,18
Chennaiyin,6508,4,4,6,4,16,17,-1,18
FC Goa,6508,5,5,3,6,12,14,-2,18
NorthEast Un,6508,5,5,3,6,12,14,-2,18
Kerala Blast,6508,7,5,3,6,12,17,-5,18
FC Pune City,6508,8,4,3,7,12,18,-6,15
Mumbai City,6509,1,7,4,3,17,8,9,25
Kerala Blast,6509,2,6,3,5,15,15,0,21
Delhi Dynamo,6509,3,5,5,4,26,19,7,20
Kolkata,6509,4,4,6,4,16,16,0,18
FC Pune City,6509,5,5,3,6,13,16,-3,18
Chennaiyin,6509,6,4,5,5,14,18,-4,17
NorthEast Un,6509,7,5,2,7,11,15,-4,17
FC Goa,6509,8,5,2,7,13,18,-5,17
Mumbai City,6510,1,7,4,3,18,8,10,25
Kolkata,6510,2,5,7,2,19,13,6,22
Delhi Dynamo,6510,3,4,6,4,22,19,3,18
FC Pune City,6510,4,5,3,6,15,17,-2,18
FC Goa,6510,5,5,3,6,12,14,-2,18
Kerala Blast,6510,6,5,3,6,12,19,-7,18
NorthEast Un,6510,7,4,4,6,10,12,-2,16
Chennaiyin,6510,8,3,6,5,13,19,-6,15
Delhi Dynamo,6511,1,6,5,3,24,15,9,23
Mumbai City,6511,2,6,4,4,16,10,6,22
Kolkata,6511,3,5,7,2,20,15,5,22
NorthEast Un,6511,4,6,2,6,11,11,0,20
Chennaiyin,6511,5,4,6,4,16,18,-2,18
Kerala Blast,6511,6,5,3,6,10,15,-5,18
FC Pune City,6511,7,4,4,6,13,16,-3,16
FC Goa,6511,8,3,3,8,11,21,-10,12
Mumbai City,6512,1,7,4,3,19,8,11,25
Kerala Blast,6512,2,6,3,5,12,15,-3,21
Delhi Dynamo,6512,3,4,7,3,25,21,4,19
Kolkata,6512,4,4,7,3,14,13,1,19
NorthEast Un,6512,5,5,3,6,14,13,1,18
Chennaiyin,6512,6,4,5,5,15,19,-4,17
FC Pune City,6512,7,4,4,6,12,15,-3,16
FC Goa,6512,8,4,3,7,11,18,-7,15
Mumbai City,6513,1,6,5,3,17,9,8,23
Kolkata,6513,2,5,7,2,20,15,5,22
Delhi Dynamo,6513,3,5,6,3,27,19,8,21
NorthEast Un,6513,4,6,2,6,13,12,1,20
Kerala Blast,6513,5,5,4,5,11,15,-4,19
FC Pune City,6513,6,4,4,6,13,17,-4,16
FC Goa,6513,7,4,3,7,13,20,-7,15
Chennaiyin,6513,8,3,5,6,13,20,-7,14
Mumbai City,6514,1,6,5,3,16,8,8,23
Delhi Dynamo,6514,2,5,7,2,26,17,9,22
Kerala Blast,6514,3,6,4,4,13,14,-1,22
FC Pune City,6514,4,5,3,6,14,16,-2,18
NorthEast Un,6514,5,4,5,5,12,12,0,17
FC Goa,6514,6,5,2,7,15,19,-4,17
Kolkata,6514,7,3,6,5,14,17,-3,15
Chennaiyin,6514,8,3,6,5,15,22,-7,15
Mumbai City,6515,1,7,4,3,19,10,9,25
Kolkata,6515,2,5,6,3,17,14,3,21
Kerala Blast,6515,3,6,3,5,13,17,-4,21
NorthEast Un,6515,4,6,2,6,12,11,1,20
Delhi Dynamo,6515,5,4,6,4,23,18,5,18
FC Pune City,6515,6,5,3,6,15,17,-2,18
Chennaiyin,6515,7,3,6,5,13,18,-5,15
FC Goa,6515,8,3,4,7,9,16,-7,13
Mumbai City,6516,1,6,4,4,17,11,6,22
Kerala Blast,6516,2,6,4,4,13,15,-2,22
Delhi Dynamo,6516,3,5,5,4,24,19,5,20
FC Goa,6516,4,6,2,6,21,16,5,20
FC Pune City,6516,5,4,5,5,14,16,-2,17
NorthEast Un,6516,6,5,2,7,10,12,-2,17
Chennaiyin,6516,7,4,5,5,16,24,-8,17
Kolkata,6516,8,3,7,4,16,18,-2,16
Delhi Dynamo,6517,1,6,6,2,27,18,9,24
Mumbai City,6517,2,6,5,3,19,11,8,23
Kolkata,6517,3,5,7,2,15,12,3,22
Kerala Blast,6517,4,5,4,5,12,16,-4,19
NorthEast Un,6517,5,5,2,7,13,11,2,17
Chennaiyin,6517,6,4,5,5,15,22,-7,17
FC Pune City,6517,7,4,4,6,14,17,-3,16
FC Goa,6517,8,3,3,8,10,18,-8,12
Delhi Dynamo,6518,1,6,5,3,27,20,7,23
Mumbai City,6518,2,6,4,4,17,10,7,22
FC Pune City,6518,3,5,4,5,14,15,-1,19
Kerala Blast,6518,4,5,4,5,12,16,-4,19
Chennaiyin,6518,5,4,6,4,20,19,1,18
Kolkata,6518,6,3,9,2,18,17,1,18
NorthEast Un,6518,7,5,2,7,12,16,-4,17
FC Goa,6518,8,3,4,7,14,21,-7,13
Mumbai City,6519,1,7,4,3,17,8,9,25
Delhi Dynamo,6519,2,6,5,3,25,16,9,23
Kolkata,6519,3,5,7,2,18,13,5,22
Kerala Blast,6519,4,5,4,5,13,17,-4,19
FC Pune City,6519,5,4,5,5,14,16,-2,17
NorthEast Un,6519,6,4,3,7,10,13,-3,15
Chennaiyin,6519,7,3,6,5,15,21,-6,15
FC Goa,6519,8,4,2,8,13,21,-8,14
Mumbai City,6520,1,6,5,3,17,9,8,23
Delhi Dynamo,6520,2,5,6,3,24,18,6,21
NorthEast Un,6520,3,6,3,5,15,11,4,21
Kolkata,6520,4,4,8,2,14,12,2,20
FC Pune City,6520,5,5,4,5,15,15,0,19
Kerala Blast,6520,6,4,4,6,11,18,-7,16
FC Goa,6520,7,4,3,7,9,15,-6,15
Chennaiyin,6520,8,3,5,6,13,20,-7,14
NorthEast Un,6521,1,7,2,5,14,11,3,23
Mumbai City,6521,2,6,4,4,16,9,7,22
Delhi Dynamo,6521,3,5,5,4,23,17,6,20
Kolkata,6521,4,4,7,3,16,15,1,19
Kerala Blast,6521,5,5,3,6,12,16,-4,18
Chennaiyin,6521,6,4,5,5,19,21,-2,17
FC Goa,6521,7,5,2,7,12,19,-7,17
FC Pune City,6521,8,4,4,6,13,17,-4,16
Mumbai City,6522,1,7,4,3,19,8,11,25
Kolkata,6522,2,5,7,2,17,14,3,22
NorthEast Un,6522,3,6,3,5,13,10,3,21
Delhi Dynamo,6522,4,5,5,4,24,19,5,20
FC Pune City,6522,5,4,5,5,15,17,-2,17
Chennaiyin,6522,6,3,7,4,16,20,-4,16
Kerala Blast,6522,7,4,4,6,11,18,-7,16
FC Goa,6522,8,3,3,8,12,21,-9,12
Mumbai City,6523,1,6,5,3,17,9,8,23
Delhi Dynamo,6523,2,5,6,3,24,18,6,21
Kolkata,6523,3,5,6,3,20,15,5,21
NorthEast Un,6523,4,6,3,5,14,10,4,21
Kerala Blast,6523,5,5,4,5,12,19,-7,19
FC Pune City,6523,6,5,3,6,15,17,-2,18
Chennaiyin,6523,7,4,5,5,15,19,-4,17
FC Goa,6523,8,3,2,9,10,20,-10,11
Mumbai City,6524,1,6,5,3,16,8,8,23
Delhi Dynamo,6524,2,5,7,2,24,15,9,22
Kolkata,6524,3,5,7,2,18,13,5,22
FC Pune City,6524,4,5,4,5,15,16,-1,19
Kerala Blast,6524,5,5,3,6,11,18,-7,18
NorthEast Un,6524,6,5,2,7,12,14,-2,17
Chennaiyin,6524,7,4,5,5,17,20,-3,17
FC Goa,6524,8,3,3,8,9,18,-9,12
Delhi Dynamo,6525,1,7,5,2,29,16,13,26
Mumbai City,6525,2,6,4,4,17,10,7,22
Chennaiyin,6525,3,5,5,4,17,18,-1,20
Kerala Blast,6525,4,5,4,5,17,18,-1,19
FC Pune City,6525,5,5,4,5,15,16,-1,19
Kolkata,6525,6,3,9,2,16,15,1,18
NorthEast Un,6525,7,4,2,8,12,19,-7,14
FC Goa,6525,8,3,3,8,10,21,-11,12
Mumbai City,6526,1,7,4,3,19,8,11,25
Kolkata,6526,2,6,6,2,20,14,6,24
Delhi Dynamo,6526,3,5,6,3,24,19,5,21
NorthEast Un,6526,4,6,3,5,12,10,2,21
Kerala Blast,6526,5,5,3,6,13,18,-5,18
FC Pune City,6526,6,4,3,7,14,19,-5,15
Chennaiyin,6526,7,3,5,6,14,20,-6,14
FC Goa,6526,8,4,2,8,11,19,-8,14
Delhi Dynamo,6527,1,5,7,2,24,16,8,22
Mumbai City,6527,2,6,4,4,16,9,7,22
Kolkata,6527,3,5,7,2,18,13,5,22
Kerala Blast,6527,4,6,3,5,13,17,-4,21
Chennaiyin,6527,5,4,5,5,16,18,-2,17
FC Goa,6527,6,4,4,6,11,16,-5,16
NorthEast Un,6527,7,4,3,7,11,15,-4,15
FC Pune City,6527,8,4,3,7,13,18,-5,15
Mumbai City,6528,1,6,5,3,17,9,8,23
Delhi Dynamo,6528,2,5,7,2,24,16,8,22
Kolkata,6528,3,5,7,2,17,13,4,22
Kerala Blast,6528,4,6,3,5,15,14,1,21
Chennaiyin,6528,5,4,5,5,15,20,-5,17
FC Pune City,6528,6,4,4,6,13,18,-5,16
NorthEast Un,6528,7,4,3,7,10,14,-4,15
FC Goa,6528,8,4,2,8,11,18,-7,14
Mumbai City,6529,1,6,5,3,17,9,8,23
Delhi Dynamo,6529,2,5,7,2,27,17,10,22
Kolkata,6529,3,5,7,2,19,13,6,22
Kerala Blast,6529,4,5,4,5,14,19,-5,19
NorthEast Un,6529,5,4,4,6,12,15,-3,16
FC Goa,6529,6,4,4,6,12,17,-5,16
Chennaiyin,6529,7,3,6,5,16,21,-5,15
FC Pune City,6529,8,4,3,7,14,20,-6,15
Mumbai City,6530,1,7,4,3,20,9,11,25
Kerala Blast,6530,2,7,3,4,14,15,-1,24
Delhi Dynamo,6530,3,4,7,3,25,21,4,19
Kolkata,6530,4,4,7,3,18,15,3,19
Chennaiyin,6530,5,4,5,5,15,21,-6,17
FC Pune City,6530,6,4,4,6,12,15,-3,16
NorthEast Un,6530,7,4,3,7,11,13,-2,15
FC Goa,6530,8,4,3,7,15,21,-6,15
Mumbai City,6531,1,6,4,4,18,11,7,22
Delhi Dynamo,6531,2,5,6,3,24,17,7,21
Kerala Blast,6531,3,6,3,5,14,16,-2,21
Kolkata,6531,4,4,7,3,17,16,1,19
FC Pune City,6531,5,5,3,6,13,16,-3,18
FC Goa,6531,6,5,3,6,13,17,-4,18
Chennaiyin,6531,7,4,5,5,15,19,-4,17
NorthEast Un,6531,8,4,3,7,10,12,-2,15
Mumbai City,6532,1,7,4,3,19,8,11,25
Kerala Blast,6532,2,6,4,4,15,16,-1,22
Delhi Dynamo,6532,3,5,6,3,24,18,6,21
Chennaiyin,6532,4,4,6,4,16,18,-2,18
Kolkata,6532,5,3,8,3,16,16,0,17
NorthEast Un,6532,6,4,4,6,12,14,-2,16
FC Pune City,6532,7,4,4,6,14,18,-4,16
FC Goa,6532,8,3,4,7,11,19,-8,13
Delhi Dynamo,6533,1,6,6,2,26,17,9,24
Mumbai City,6533,2,6,5,3,17,9,8,23
Kerala Blast,6533,3,6,4,4,15,16,-1,22
Chennaiyin,6533,4,4,6,4,19,18,1,18
Kolkata,6533,5,4,6,4,14,17,-3,18
FC Pune City,6533,6,4,4,6,14,17,-3,16
NorthEast Un,6533,7,4,3,7,12,14,-2,15
FC Goa,6533,8,4,2,8,12,21,-9,14
Delhi Dynamo,6534,1,6,6,2,29,16,13,24
Mumbai City,6534,2,6,4,4,16,12,4,22
NorthEast Un,6534,3,5,4,5,11,9,2,19
Kerala Blast,6534,4,5,4,5,11,16,-5,19
Kolkata,6534,5,4,6,4,16,15,1,18
FC Pune City,6534,6,5,3,6,15,17,-2,18
FC Goa,6534,7,5,2,7,12,18,-6,17
Chennaiyin,6534,8,3,5,6,13,20,-7,14
Mumbai City,6535,1,6,5,3,17,9,8,23
Kolkata,6535,2,5,7,2,17,13,4,22
Delhi Dynamo,6535,3,4,7,3,24,18,6,19
Kerala Blast,6535,4,5,4,5,12,16,-4,19
FC Pune City,6535,5,5,3,6,14,15,-1,18
NorthEast Un,6535,6,5,3,6,12,13,-1,18
Chennaiyin,6535,7,3,6,5,14,19,-5,15
FC Goa,6535,8,4,3,7,10,17,-7,15
Mumbai City,6536,1,6,4,4,17,10,7,22
Delhi Dynamo,6536,2,5,6,3,27,20,7,21
NorthEast Un,6536,3,6,3,5,16,14,2,21
Kolkata,6536,4,4,8,2,18,15,3,20
FC Pune City,6536,5,4,5,5,14,16,-2,17
Kerala Blast,6536,6,4,5,5,13,19,-6,17
Chennaiyin,6536,7,3,6,5,14,19,-5,15
FC Goa,6536,8,3,5,6,11,17,-6,14
Mumbai City,6537,1,7,4,3,20,9,11,25
Kolkata,6537,2,6,6,2,20,15,5,24
Kerala Blast,6537,3,5,4,5,11,16,-5,19
Delhi Dynamo,6537,4,4,6,4,23,20,3,18
Chennaiyin,6537,5,4,5,5,16,19,-3,17
FC Goa,6537,6,5,2,7,13,18,-5,17
NorthEast Un,6537,7,4,4,6,9,11,-2,16
FC Pune City,6537,8,4,3,7,13,17,-4,15
Delhi Dynamo,6538,1,7,5,2,28,15,13,26
Mumbai City,6538,2,6,4,4,16,10,6,22
Chennaiyin,6538,3,5,5,4,16,18,-2,20
FC Pune City,6538,4,5,4,5,13,14,-1,19
Kerala Blast,6538,5,5,4,5,13,18,-5,19
Kolkata,6538,6,4,6,4,18,16,2,18
NorthEast Un,6538,7,4,2,8,11,15,-4,14
FC Goa,6538,8,4,2,8,11,20,-9,14
Mumbai City,6539,1,7,4,3,17,8,9,25
Delhi Dynamo,6539,2,5,6,3,22,15,7,21
Kerala Blast,6539,3,6,3,5,14,16,-2,21
Chennaiyin,6539,4,5,5,4,17,19,-2,20
Kolkata,6539,5,4,6,4,18,16,2,18
NorthEast Un,6539,6,5,2,7,11,12,-1,17
FC Goa,6539,7,4,3,7,11,16,-5,15
FC Pune City,6539,8,4,3,7,13,21,-8,15
Delhi Dynamo,6540,1,6,6,2,24,15,9,24
Mumbai City,6540,2,6,4,4,16,9,7,22
Kolkata,6540,3,4,8,2,19,17,2,20
NorthEast Un,6540,4,5,3,6,10,10,0,18
Chennaiyin,6540,5,4,6,4,14,17,-3,18
Kerala Blast,6540,6,4,5,5,11,16,-5,17
FC Pune City,6540,7,4,4,6,13,16,-3,16
FC Goa,6540,8,3,4,7,11,18,-7,13
Mumbai City,6541,1,6,5,3,17,9,8,23
Delhi Dynamo,6541,2,5,7,2,26,18,8,22
Kolkata,6541,3,5,6,3,18,16,2,21
FC Pune City,6541,4,5,3,6,16,18,-2,18
Chennaiyin,6541,5,4,6,4,16,19,-3,18
Kerala Blast,6541,6,5,3,6,12,17,-5,18
NorthEast Un,6541,7,4,4,6,13,14,-1,16
FC Goa,6541,8,4,2,8,12,19,-7,14
Mumbai City,6542,1,7,4,3,18,8,10,25
Kolkata,6542,2,5,6,3,15,13,2,21
Kerala Blast,6542,3,6,3,5,12,18,-6,21
Delhi Dynamo,6542,4,4,7,3,24,19,5,19
NorthEast Un,6542,5,5,4,5,15,11,4,19
Chennaiyin,6542,6,4,6,4,15,17,-2,18
FC Pune City,6542,7,4,3,7,13,17,-4,15
FC Goa,6542,8,3,3,8,9,18,-9,12
Mumbai City,6543,1,7,4,3,18,8,10,25
Kolkata,6543,2,5,6,3,19,16,3,21
Delhi Dynamo,6543,3,4,7,3,22,17,5,19
Kerala Blast,6543,4,5,4,5,17,21,-4,19
Chennaiyin,6543,5,4,6,4,16,18,-2,18
FC Pune City,6543,6,4,4,6,18,21,-3,16
NorthEast Un,6543,7,4,4,6,10,13,-3,16
FC Goa,6543,8,4,3,7,12,18,-6,15
Mumbai City,6544,1,6,5,3,17,9,8,23
Delhi Dynamo,6544,2,5,6,3,25,19,6,21
Kolkata,6544,3,4,8,2,19,15,4,20
NorthEast Un,6544,4,5,3,6,13,12,1,18
FC Pune City,6544,5,4,5,5,15,17,-2,17
Chennaiyin,6544,6,3,7,4,16,20,-4,16
FC Goa,6544,7,4,4,6,15,19,-4,16
Kerala Blast,6544,8,4,4,6,11,20,-9,16
Mumbai City,6545,1,7,4,3,18,9,9,25
Delhi Dynamo,6545,2,5,5,4,25,18,7,20
Kolkata,6545,3,4,8,2,18,14,4,20
NorthEast Un,6545,4,6,2,6,13,11,2,20
Chennaiyin,6545,5,5,5,4,18,17,1,20
Kerala Blast,6545,6,5,4,5,12,17,-5,19
FC Pune City,6545,7,4,3,7,12,19,-7,15
FC Goa,6545,8,3,3,8,10,21,-11,12
Delhi Dynamo,6546,1,6,5,3,29,17,12,23
Mumbai City,6546,2,6,4,4,17,12,5,22
NorthEast Un,6546,3,6,3,5,15,13,2,21
Kolkata,6546,4,4,8,2,15,13,2,20
Kerala Blast,6546,5,4,6,4,13,17,-4,18
FC Pune City,6546,6,4,4,6,14,17,-3,16
FC Goa,6546,7,4,3,7,14,18,-4,15
Chennaiyin,6546,8,3,5,6,14,24,-10,14
Mumbai City,6547,1,7,4,3,18,8,10,25
Kerala Blast,6547,2,6,4,4,17,17,0,22
Kolkata,6547,3,5,6,3,16,15,1,21
NorthEast Un,6547,4,6,2,6,16,15,1,20
Delhi Dynamo,6547,5,4,6,4,24,20,4,18
FC Pune City,6547,6,4,4,6,12,15,-3,16
Chennaiyin,6547,7,3,6,5,15,21,-6,15
FC Goa,6547,8,3,4,7,12,19,-7,13
Mumbai City,6548,1,7,4,3,17,8,9,25
Kolkata,6548,2,5,6,3,15,13,2,21
Kerala Blast,6548,3,6,3,5,11,16,-5,21
Delhi Dynamo,6548,4,4,7,3,26,20,6,19
FC Pune City,6548,5,5,3,6,15,15,0,18
Chennaiyin,6548,6,4,5,5,15,19,-4,17
NorthEast Un,6548,7,4,3,7,12,14,-2,15
FC Goa,6548,8,4,3,7,12,18,-6,15
Kerala Blast,6549,1,7,3,4,18,15,3,24
Mumbai City,6549,2,6,5,3,19,11,8,23
Delhi Dynamo,6549,3,4,7,3,27,21,6,19
NorthEast Un,6549,4,5,3,6,13,13,0,18
Chennaiyin,6549,5,4,6,4,17,19,-2,18
FC Pune City,6549,6,5,3,6,15,19,-4,18
Kolkata,6549,7,3,6,5,13,17,-4,15
FC Goa,6549,8,4,3,7,12,19,-7,15
Mumbai City,6550,1,7,4,3,18,9,9,25
Delhi Dynamo,6550,2,6,5,3,29,16,13,23
Kerala Blast,6550,3,5,4,5,13,16,-3,19
Chennaiyin,6550,4,4,6,4,16,18,-2,18
FC Pune City,6550,5,5,3,6,13,16,-3,18
Kolkata,6550,6,3,8,3,14,14,0,17
NorthEast Un,6550,7,5,2,7,11,13,-2,17
FC Goa,6550,8,3,4,7,9,21,-12,13
Mumbai City,6551,1,7,4,3,17,8,9,25
Kolkata,6551,2,5,6,3,18,15,3,21
Kerala Blast,6551,3,6,3,5,17,14,3,21
Delhi Dynamo,6551,4,5,5,4,22,17,5,20
NorthEast Un,6551,5,6,2,6,12,10,2,20
FC Goa,6551,6,5,2,7,12,18,-6,17
FC Pune City,6551,7,4,3,7,12,21,-9,15
Chennaiyin,6551,8,3,5,6,14,21,-7,14
Mumbai City,6552,1,7,4,3,17,8,9,25
Delhi Dynamo,6552,2,6,5,3,27,17,10,23
Kerala Blast,6552,3,6,4,4,13,14,-1,22
NorthEast Un,6552,4,5,3,6,12,12,0,18
FC Pune City,6552,5,5,3,6,14,16,-2,18
Kolkata,6552,6,3,6,5,16,19,-3,15
Chennaiyin,6552,7,3,6,5,14,19,-5,15
FC Goa,6552,8,4,3,7,11,19,-8,15
Kolkata,6553,1,6,6,2,20,15,5,24
Delhi Dynamo,6553,2,6,5,3,25,18,7,23
Mumbai City,6553,3,6,4,4,16,9,7,22
Kerala Blast,6553,4,6,3,5,13,16,-3,21
NorthEast Un,6553,5,5,2,7,13,15,-2,17
Chennaiyin,6553,6,4,5,5,17,21,-4,17
FC Pune City,6553,7,4,3,7,13,17,-4,15
FC Goa,6553,8,4,2,8,13,19,-6,14
Delhi Dynamo,6554,1,6,5,3,27,17,10,23
NorthEast Un,6554,2,7,2,5,15,12,3,23
Mumbai City,6554,3,6,4,4,16,11,5,22
Kolkata,6554,4,5,6,3,19,16,3,21
Kerala Blast,6554,5,6,3,5,12,15,-3,21
Chennaiyin,6554,6,3,6,5,15,20,-5,15
FC Pune City,6554,7,4,3,7,12,17,-5,15
FC Goa,6554,8,3,3,8,11,19,-8,12
Kerala Blast,6555,1,7,3,4,16,14,2,24
Mumbai City,6555,2,6,4,4,17,10,7,22
Delhi Dynamo,6555,3,5,6,3,26,19,7,21
Kolkata,6555,4,5,6,3,16,14,2,21
Chennaiyin,6555,5,4,6,4,15,17,-2,18
FC Pune City,6555,6,4,3,7,12,16,-4,15
NorthEast Un,6555,7,4,3,7,12,18,-6,15
FC Goa,6555,8,4,3,7,11,17,-6,15
Kerala Blast,6556,1,7,3,4,15,15,0,24
Mumbai City,6556,2,6,5,3,17,9,8,23
Chennaiyin,6556,3,5,5,4,15,17,-2,20
Delhi Dynamo,6556,4,4,7,3,24,19,5,19
Kolkata,6556,5,4,7,3,17,16,1,19
NorthEast Un,6556,6,5,2,7,12,12,0,17
FC Pune City,6556,7,4,3,7,12,17,-5,15
FC Goa,6556,8,3,4,7,9,16,-7,13
Mumbai City,6557,1,6,5,3,18,10,8,23
Delhi Dynamo,6557,2,5,6,3,28,20,8,21
Kerala Blast,6557,3,6,3,5,15,16,-1,21
Kolkata,6557,4,4,7,3,20,18,2,19
NorthEast Un,6557,5,5,3,6,13,13,0,18
FC Pune City,6557,6,5,3,6,15,18,-3,18
Chennaiyin,6557,7,3,6,5,15,21,-6,15
FC Goa,6557,8,4,3,7,15,23,-8,15
Mumbai City,6558,1,6,4,4,18,11,7,22
Delhi Dynamo,6558,2,5,6,3,26,22,4,21
Kolkata,6558,3,5,6,3,16,13,3,21
Kerala Blast,6558,4,5,4,5,11,15,-4,19
FC Goa,6558,5,5,3,6,15,16,-1,18
NorthEast Un,6558,6,4,5,5,11,11,0,17
Chennaiyin,6558,7,3,7,4,15,19,-4,16
FC Pune City,6558,8,4,3,7,13,18,-5,15
Mumbai City,6559,1,7,4,3,18,9,9,25
Kolkata,6559,2,5,7,2,19,16,3,22
Delhi Dynamo,6559,3,5,6,3,29,19,10,21
Kerala Blast,6559,4,6,3,5,13,16,-3,21
NorthEast Un,6559,5,4,4,6,13,14,-1,16
Chennaiyin,6559,6,3,7,4,13,17,-4,16
FC Pune City,6559,7,4,3,7,13,17,-4,15
FC Goa,6559,8,3,4,7,10,20,-10,13
Mumbai City,6560,1,6,4,4,16,9,7,22
Delhi Dynamo,6560,2,5,6,3,25,18,7,21
Kolkata,6560,3,5,6,3,21,17,4,21
NorthEast Un,6560,4,6,2,6,13,12,1,20
Chennaiyin,6560,5,5,5,4,17,19,-2,20
Kerala Blast,6560,6,5,3,6,14,18,-4,18
FC Goa,6560,7,4,3,7,15,20,-5,15
FC Pune City,6560,8,4,3,7,12,20,-8,15
Mumbai City,6561,1,7,4,3,19,9,10,25
Kolkata,6561,2,4,8,2,14,12,2,20
Kerala Blast,6561,3,5,5,4,14,15,-1,20
Delhi Dynamo,6561,4,4,6,4,24,20,4,18
NorthEast Un,6561,5,5,3,6,13,13,0,18
Chennaiyin,6561,6,4,6,4,14,17,-3,18
FC Pune City,6561,7,4,4,6,12,17,-5,16
FC Goa,6561,8,3,4,7,9,16,-7,13
Mumbai City,6562,1,7,4,3,17,8,9,25
NorthEast Un,6562,2,6,3,5,13,10,3,21
Delhi Dynamo,6562,3,5,5,4,24,18,6,20
FC Pune City,6562,4,5,4,5,14,15,-1,19
Kolkata,6562,5,3,9,2,15,14,1,18
Kerala Blast,6562,6,4,4,6,11,17,-6,16
Chennaiyin,6562,7,3,6,5,13,19,-6,15
FC Goa,6562,8,4,3,7,11,17,-6,15
Mumbai City,6563,1,7,4,3,18,8,10,25
Delhi Dynamo,6563,2,5,5,4,23,18,5,20
FC Pune City,6563,3,5,4,5,13,14,-1,19
Kerala Blast,6563,4,5,4,5,12,16,-4,19
Kolkata,6563,5,3,9,2,14,13,1,18
NorthEast Un,6563,6,5,3,6,13,12,1,18
Chennaiyin,6563,7,3,6,5,14,19,-5,15
FC Goa,6563,8,4,3,7,9,16,-7,15
Mumbai City,6564,1,7,4,3,21,9,12,25
NorthEast Un,6564,2,7,2,5,12,9,3,23
Kolkata,6564,3,4,7,3,15,14,1,19
FC Pune City,6564,4,5,4,5,13,14,-1,19
Delhi Dynamo,6564,5,4,6,4,23,21,2,18
FC Goa,6564,6,4,4,6,11,16,-5,16
Kerala Blast,6564,7,4,4,6,9,15,-6,16
Chennaiyin,6564,8,3,5,6,13,19,-6,14
Mumbai City,6565,1,7,4,3,19,10,9,25
Delhi Dynamo,6565,2,5,5,4,25,18,7,20
Kerala Blast,6565,3,5,4,5,12,17,-5,19
Kolkata,6565,4,4,6,4,15,15,0,18
FC Pune City,6565,5,5,3,6,15,16,-1,18
Chennaiyin,6565,6,4,6,4,17,20,-3,18
FC Goa,6565,7,5,3,6,12,16,-4,18
NorthEast Un,6565,8,4,3,7,12,15,-3,15
Mumbai City,6566,1,7,4,3,19,8,11,25
Delhi Dynamo,6566,2,5,6,3,25,19,6,21
Kerala Blast,6566,3,6,3,5,12,16,-4,21
Chennaiyin,6566,4,5,5,4,18,18,0,20
Kolkata,6566,5,4,7,3,18,19,-1,19
FC Pune City,6566,6,4,4,6,15,18,-3,16
FC Goa,6566,7,4,3,7,14,19,-5,15
NorthEast Un,6566,8,4,2,8,11,15,-4,14
Mumbai City,6567,1,6,5,3,18,10,8,23
Kolkata,6567,2,5,6,3,18,15,3,21
Kerala Blast,6567,3,6,3,5,17,18,-1,21
Delhi Dynamo,6567,4,4,7,3,23,17,6,19
NorthEast Un,6567,5,5,3,6,11,12,-1,18
Chennaiyin,6567,6,3,7,4,15,19,-4,16
FC Goa,6567,7,4,4,6,10,15,-5,16
FC Pune City,6567,8,4,3,7,14,20,-6,15
Mumbai City,6568,1,7,4,3,19,9,10,25
Kolkata,6568,2,4,7,3,18,17,1,19
FC Pune City,6568,3,5,4,5,14,15,-1,19
Kerala Blast,6568,4,5,4,5,12,15,-3,19
FC Goa,6568,5,5,3,6,14,18,-4,18
Delhi Dynamo,6568,6,4,5,5,23,21,2,17
NorthEast Un,6568,7,5,2,7,11,13,-2,17
Chennaiyin,6568,8,4,5,5,16,19,-3,17
Mumbai City,6569,1,6,5,3,17,9,8,23
Delhi Dynamo,6569,2,5,6,3,24,18,6,21
NorthEast Un,6569,3,6,2,6,14,12,2,20
Chennaiyin,6569,4,5,5,4,19,18,1,20
Kolkata,6569,5,4,7,3,16,14,2,19
Kerala Blast,6569,6,5,4,5,12,14,-2,19
FC Pune City,6569,7,5,3,6,14,18,-4,18
FC Goa,6569,8,3,2,9,8,21,-13,11
Delhi Dynamo,6570,1,5,7,2,25,17,8,22
Mumbai City,6570,2,6,4,4,16,9,7,22
NorthEast Un,6570,3,6,3,5,14,11,3,21
FC Pune City,6570,4,6,3,5,17,17,0,21
Kolkata,6570,5,4,6,4,16,16,0,18
FC Goa,6570,6,5,3,6,11,15,-4,18
Kerala Blast,6570,7,4,3,7,10,18,-8,15
Chennaiyin,6570,8,3,5,6,13,19,-6,14
Delhi Dynamo,6571,1,6,6,2,26,17,9,24
Mumbai City,6571,2,6,4,4,16,9,7,22
Kolkata,6571,3,5,6,3,16,14,2,21
NorthEast Un,6571,4,5,4,5,13,12,1,19
FC Pune City,6571,5,5,4,5,13,14,-1,19
Chennaiyin,6571,6,3,7,4,13,17,-4,16
Kerala Blast,6571,7,4,4,6,9,15,-6,16
FC Goa,6571,8,3,3,8,9,17,-8,12
Delhi Dynamo,6572,1,6,5,3,25,17,8,23
Mumbai City,6572,2,6,4,4,16,10,6,22
NorthEast Un,6572,3,6,2,6,15,12,3,20
FC Pune City,6572,4,5,4,5,16,16,0,19
Kolkata,6572,5,4,6,4,15,18,-3,18
FC Goa,6572,6,5,2,7,14,17,-3,17
Chennaiyin,6572,7,4,5,5,17,21,-4,17
Kerala Blast,6572,8,4,4,6,10,17,-7,16
Delhi Dynamo,6573,1,6,6,2,23,14,9,24
Mumbai City,6573,2,6,4,4,16,9,7,22
Kolkata,6573,3,5,7,2,20,17,3,22
Kerala Blast,6573,4,5,4,5,13,17,-4,19
NorthEast Un,6573,5,4,4,6,11,12,-1,16
Chennaiyin,6573,6,3,7,4,16,20,-4,16
FC Pune City,6573,7,4,3,7,14,18,-4,15
FC Goa,6573,8,3,5,6,11,17,-6,14
Mumbai City,6574,1,6,5,3,16,8,8,23
Kolkata,6574,2,5,6,3,19,15,4,21
FC Pune City,6574,3,6,3,5,19,18,1,21
Delhi Dynamo,6574,4,4,6,4,22,17,5,18
Chennaiyin,6574,5,4,6,4,17,20,-3,18
Kerala Blast,6574,6,5,3,6,14,20,-6,18
NorthEast Un,6574,7,5,2,7,12,13,-1,17
FC Goa,6574,8,4,3,7,12,20,-8,15
Mumbai City,6575,1,6,5,3,17,9,8,23
Delhi Dynamo,6575,2,4,7,3,25,19,6,19
FC Pune City,6575,3,5,4,5,15,14,1,19
NorthEast Un,6575,4,5,3,6,12,12,0,18
Chennaiyin,6575,5,4,6,4,17,20,-3,18
Kolkata,6575,6,4,6,4,14,17,-3,18
Kerala Blast,6575,7,4,5,5,9,14,-5,17
FC Goa,6575,8,4,4,6,14,18,-4,16
Delhi Dynamo,6576,1,6,6,2,28,16,12,24
Mumbai City,6576,2,6,5,3,17,9,8,23
Kerala Blast,6576,3,6,4,4,15,13,2,22
Kolkata,6576,4,4,7,3,15,14,1,19
NorthEast Un,6576,5,5,3,6,12,14,-2,18
Chennaiyin,6576,6,3,6,5,15,21,-6,15
FC Pune City,6576,7,4,3,7,12,20,-8,15
FC Goa,6576,8,3,4,7,11,18,-7,13
Mumbai City,6577,1,7,4,3,17,8,9,25
Delhi Dynamo,6577,2,5,6,3,24,16,8,21
Kolkata,6577,3,5,6,3,18,16,2,21
Chennaiyin,6577,4,5,5,4,20,19,1,20
NorthEast Un,6577,5,5,2,7,12,16,-4,17
FC Pune City,6577,6,4,4,6,14,17,-3,16
Kerala Blast,6577,7,4,4,6,11,19,-8,16
FC Goa,6577,8,4,3,7,12,17,-5,15
Mumbai City,6578,1,7,4,3,17,8,9,25
Kolkata,6578,2,5,6,3,19,15,4,21
Chennaiyin,6578,3,5,5,4,16,17,-1,20
Kerala Blast,6578,4,5,4,5,12,17,-5,19
Delhi Dynamo,6578,5,4,6,4,22,17,5,18
NorthEast Un,6578,6,5,3,6,12,13,-1,18
FC Pune City,6578,7,4,3,7,12,17,-5,15
FC Goa,6578,8,4,3,7,10,16,-6,15
Mumbai City,6579,1,6,5,3,17,9,8,23
Kolkata,6579,2,5,6,3,19,17,2,21
Kerala Blast,6579,3,6,3,5,12,17,-5,21
Delhi Dynamo,6579,4,4,7,3,23,17,6,19
Chennaiyin,6579,5,4,6,4,15,18,-3,18
FC Goa,6579,6,5,2,7,13,16,-3,17
NorthEast Un,6579,7,4,4,6,10,11,-1,16
FC Pune City,6579,8,4,3,7,13,17,-4,15
Mumbai City,6580,1,7,4,3,17,8,9,25
Kolkata,6580,2,5,6,3,20,16,4,21
NorthEast Un,6580,3,5,4,5,10,9,1,19
FC Pune City,6580,4,5,4,5,17,18,-1,19
Delhi Dynamo,6580,5,4,6,4,22,17,5,18
Chennaiyin,6580,6,4,6,4,15,18,-3,18
Kerala Blast,6580,7,4,5,5,14,20,-6,17
FC Goa,6580,8,3,3,8,10,19,-9,12
Mumbai City,6581,1,6,5,3,17,9,8,23
Kolkata,6581,2,5,6,3,19,15,4,21
NorthEast Un,6581,3,6,3,5,16,12,4,21
Delhi Dynamo,6581,4,4,7,3,24,20,4,19
FC Goa,6581,5,5,3,6,15,17,-2,18
FC Pune City,6581,6,5,3,6,14,16,-2,18
Chennaiyin,6581,7,3,6,5,15,21,-6,15
Kerala Blast,6581,8,4,3,7,11,21,-10,15
Mumbai City,6582,1,6,4,4,16,9,7,22
Delhi Dynamo,6582,2,5,6,3,23,16,7,21
Kerala Blast,6582,3,6,3,5,13,16,-3,21
FC Goa,6582,4,6,2,6,17,15,2,20
Kolkata,6582,5,4,6,4,16,16,0,18
NorthEast Un,6582,6,5,3,6,11,11,0,18
Chennaiyin,6582,7,4,5,5,14,22,-8,17
FC Pune City,6582,8,4,3,7,12,17,-5,15
Delhi Dynamo,6583,1,6,5,3,27,18,9,23
Mumbai City,6583,2,6,4,4,17,10,7,22
NorthEast Un,6583,3,6,3,5,15,12,3,21
Kolkata,6583,4,4,7,3,17,15,2,19
FC Goa,6583,5,5,2,7,13,18,-5,17
Kerala Blast,6583,6,4,5,5,12,17,-5,17
FC Pune City,6583,7,4,4,6,13,17,-4,16
Chennaiyin,6583,8,3,6,5,14,21,-7,15
Mumbai City,6584,1,7,4,3,17,8,9,25
Delhi Dynamo,6584,2,5,6,3,27,17,10,21
Kolkata,6584,3,4,8,2,17,13,4,20
NorthEast Un,6584,4,5,3,6,13,13,0,18
Kerala Blast,6584,5,5,3,6,11,18,-7,18
Chennaiyin,6584,6,4,5,5,15,19,-4,17
FC Pune City,6584,7,4,4,6,13,16,-3,16
FC Goa,6584,8,4,3,7,10,19,-9,15
Mumbai City,6585,1,7,4,3,18,9,9,25
Kolkata,6585,2,6,6,2,22,13,9,24
Delhi Dynamo,6585,3,5,6,3,25,17,8,21
Kerala Blast,6585,4,5,4,5,12,17,-5,19
NorthEast Un,6585,5,5,3,6,11,12,-1,18
Chennaiyin,6585,6,4,5,5,15,19,-4,17
FC Pune City,6585,7,4,4,6,14,18,-4,16
FC Goa,6585,8,3,2,9,9,21,-12,11
Mumbai City,6586,1,7,4,3,20,8,12,25
Delhi Dynamo,6586,2,4,7,3,23,20,3,19
Kolkata,6586,3,4,7,3,16,15,1,19
Kerala Blast,6586,4,5,4,5,12,16,-4,19
FC Pune City,6586,5,5,3,6,14,16,-2,18
Chennaiyin,6586,6,4,5,5,14,25,-11,17
FC Goa,6586,7,4,4,6,17,15,2,16
NorthEast Un,6586,8,4,4,6,11,12,-1,16
Mumbai City,6587,1,7,4,3,19,9,10,25
Kerala Blast,6587,2,6,4,4,16,18,-2,22
Chennaiyin,6587,3,5,5,4,15,17,-2,20
Delhi Dynamo,6587,4,4,5,5,22,21,1,17
NorthEast Un,6587,5,5,2,7,13,12,1,17
Kolkata,6587,6,3,8,3,20,21,-1,17
FC Goa,6587,7,5,2,7,13,17,-4,17
FC Pune City,6587,8,4,4,6,15,18,-3,16
Delhi Dynamo,6588,1,6,5,3,31,19,12,23
Mumbai City,6588,2,6,4,4,17,11,6,22
Kerala Blast,6588,3,6,3,5,12,15,-3,21
NorthEast Un,6588,4,6,2,6,14,13,1,20
Kolkata,6588,5,4,7,3,17,16,1,19
Chennaiyin,6588,6,4,6,4,15,18,-3,18
FC Pune City,6588,7,4,3,7,15,19,-4,15
FC Goa,6588,8,3,4,7,10,20,-10,13
Mumbai City,6589,1,6,5,3,16,8,8,23
Delhi Dynamo,6589,2,5,7,2,24,15,9,22
FC Pune City,6589,3,6,3,5,16,15,1,21
NorthEast Un,6589,4,6,2,6,11,11,0,20
FC Goa,6589,5,5,3,6,15,16,-1,18
Kolkata,6589,6,4,6,4,15,19,-4,18
Kerala Blast,6589,7,4,3,7,11,18,-7,15
Chennaiyin,6589,8,3,5,6,14,20,-6,14
Mumbai City,6590,1,6,5,3,16,8,8,23
NorthEast Un,6590,2,7,2,5,16,9,7,23
Kolkata,6590,3,5,6,3,16,14,2,21
Kerala Blast,6590,4,6,3,5,12,15,-3,21
Delhi Dynamo,6590,5,4,7,3,23,19,4,19
Chennaiyin,6590,6,4,5,5,14,19,-5,17
FC Pune City,6590,7,4,3,7,13,18,-5,15
FC Goa,6590,8,3,3,8,10,18,-8,12
Delhi Dynamo,6591,1,6,5,3,25,15,10,23
Kolkata,6591,2,5,7,2,18,12,6,22
Mumbai City,6591,3,6,4,4,16,10,6,22
FC Pune City,6591,4,5,4,5,13,14,-1,19
NorthEast Un,6591,5,5,3,6,11,11,0,18
Kerala Blast,6591,6,5,3,6,10,16,-6,18
Chennaiyin,6591,7,3,6,5,14,20,-6,15
FC Goa,6591,8,4,2,8,10,19,-9,14
Delhi Dynamo,6592,1,6,6,2,26,15,11,24
Mumbai City,6592,2,6,4,4,16,9,7,22
Kolkata,6592,3,5,7,2,23,18,5,22
Kerala Blast,6592,4,5,4,5,13,18,-5,19
NorthEast Un,6592,5,5,3,6,11,11,0,18
FC Pune City,6592,6,5,3,6,17,20,-3,18
Chennaiyin,6592,7,4,5,5,14,18,-4,17
FC Goa,6592,8,3,2,9,10,21,-11,11
Delhi Dynamo,6593,1,7,5,2,26,16,10,26
Mumbai City,6593,2,6,4,4,17,10,7,22
Kerala Blast,6593,3,6,4,4,14,15,-1,22
Kolkata,6593,4,4,8,2,18,16,2,20
NorthEast Un,6593,5,5,2,7,14,13,1,17
Chennaiyin,6593,6,4,5,5,15,21,-6,17
FC Pune City,6593,7,4,4,6,13,17,-4,16
FC Goa,6593,8,3,2,9,11,20,-9,11
Mumbai City,6594,1,7,4,3,18,9,9,25
Delhi Dynamo,6594,2,5,6,3,23,16,7,21
Kolkata,6594,3,5,6,3,16,14,2,21
FC Pune City,6594,4,5,3,6,16,17,-1,18
FC Goa,6594,5,5,3,6,12,14,-2,18
Chennaiyin,6594,6,4,5,5,18,21,-3,17
NorthEast Un,6594,7,5,2,7,13,16,-3,17
Kerala Blast,6594,8,4,3,7,11,20,-9,15
Delhi Dynamo,6595,1,6,5,3,27,19,8,23
Mumbai City,6595,2,6,4,4,16,10,6,22
Kerala Blast,6595,3,6,4,4,12,13,-1,22
Kolkata,6595,4,5,6,3,19,13,6,21
Chennaiyin,6595,5,4,6,4,15,18,-3,18
FC Pune City,6595,6,4,4,6,12,18,-6,16
NorthEast Un,6595,7,4,3,7,12,15,-3,15
FC Goa,6595,8,4,2,8,11,18,-7,14
Delhi Dynamo,6596,1,6,6,2,31,20,11,24
Mumbai City,6596,2,6,4,4,17,11,6,22
Kolkata,6596,3,5,6,3,17,16,1,21
FC Pune City,6596,4,5,3,6,14,15,-1,18
Kerala Blast,6596,5,5,3,6,11,16,-5,18
NorthEast Un,6596,6,5,2,7,14,16,-2,17
Chennaiyin,6596,7,4,5,5,14,18,-4,17
FC Goa,6596,8,4,3,7,12,18,-6,15
Delhi Dynamo,6597,1,6,5,3,24,18,6,23
Mumbai City,6597,2,6,4,4,17,10,7,22
Kolkata,6597,3,5,6,3,19,14,5,21
FC Pune City,6597,4,6,3,5,19,15,4,21
Chennaiyin,6597,5,5,5,4,19,18,1,20
NorthEast Un,6597,6,5,3,6,12,12,0,18
Kerala Blast,6597,7,4,4,6,10,20,-10,16
FC Goa,6597,8,3,2,9,9,22,-13,11
Mumbai City,6598,1,7,4,3,18,9,9,25
Delhi Dynamo,6598,2,6,5,3,25,17,8,23
FC Pune City,6598,3,6,3,5,15,15,0,21
Kolkata,6598,4,4,7,3,17,15,2,19
Chennaiyin,6598,5,4,6,4,20,20,0,18
NorthEast Un,6598,6,4,4,6,14,15,-1,16
Kerala Blast,6598,7,4,4,6,13,20,-7,16
FC Goa,6598,8,3,3,8,10,21,-11,12
Kerala Blast,6599,1,7,3,4,16,16,0,24
Delhi Dynamo,6599,2,6,5,3,24,16,8,23
Mumbai City,6599,3,6,4,4,16,10,6,22
Kolkata,6599,4,5,6,3,16,14,2,21
NorthEast Un,6599,5,5,2,7,13,13,0,17
Chennaiyin,6599,6,4,5,5,16,21,-5,17
FC Pune City,6599,7,4,3,7,14,18,-4,15
FC Goa,6599,8,4,2,8,11,18,-7,14
Mumbai City,6600,1,7,4,3,18,8,10,25
NorthEast Un,6600,2,6,3,5,15,12,3,21
FC Goa,6600,3,6,2,6,14,16,-2,20
FC Pune City,6600,4,5,4,5,16,15,1,19
Kolkata,6600,4,4,7,3,16,15,1,19
Delhi Dynamo,6600,6,4,5,5,22,19,3,17
Kerala Blast,6600,7,4,4,6,11,20,-9,16
Chennaiyin,6600,8,3,5,6,15,22,-7,14
Mumbai City,6601,1,6,5,3,16,8,8,23
FC Pune City,6601,2,6,3,5,18,14,4,21
NorthEast Un,6601,3,6,3,5,11,9,2,21
Delhi Dynamo,6601,4,4,7,3,22,16,6,19
Kolkata,6601,5,3,8,3,14,16,-2,17
Kerala Blast,6601,6,4,5,5,9,16,-7,17
FC Goa,6601,7,4,4,6,12,16,-4,16
Chennaiyin,6601,8,3,5,6,13,20,-7,14
Mumbai City,6602,1,6,5,3,16,8,8,23
Kerala Blast,6602,2,6,3,5,12,16,-4,21
Delhi Dynamo,6602,3,4,7,3,22,18,4,19
FC Pune City,6602,4,5,4,5,15,15,0,19
NorthEast Un,6602,5,5,3,6,14,12,2,18
FC Goa,6602,6,5,3,6,12,16,-4,18
Kolkata,6602,7,3,7,4,15,16,-1,16
Chennaiyin,6602,8,3,6,5,14,19,-5,15
Delhi Dynamo,6603,1,6,6,2,28,17,11,24
Mumbai City,6603,2,6,5,3,17,9,8,23
Kolkata,6603,3,4,8,2,17,14,3,20
Chennaiyin,6603,4,5,5,4,19,18,1,20
FC Pune City,6603,5,5,4,5,16,16,0,19
Kerala Blast,6603,6,5,3,6,12,19,-7,18
NorthEast Un,6603,7,4,2,8,12,17,-5,14
FC Goa,6603,8,3,3,8,10,21,-11,12
Mumbai City,6604,1,7,4,3,19,10,9,25
NorthEast Un,6604,2,6,3,5,16,12,4,21
Kolkata,6604,3,5,6,3,17,16,1,21
Delhi Dynamo,6604,4,5,5,4,25,20,5,20
FC Pune City,6604,5,5,3,6,14,16,-2,18
FC Goa,6604,6,5,2,7,15,18,-3,17
Kerala Blast,6604,7,4,4,6,11,17,-6,16
Chennaiyin,6604,8,3,5,6,15,23,-8,14
Mumbai City,6605,1,6,5,3,16,8,8,23
FC Pune City,6605,2,6,3,5,15,14,1,21
Kerala Blast,6605,3,6,3,5,12,16,-4,21
FC Goa,6605,4,6,2,6,17,15,2,20
Delhi Dynamo,6605,5,4,7,3,23,20,3,19
NorthEast Un,6605,6,5,3,6,13,12,1,18
Kolkata,6605,7,3,6,5,14,18,-4,15
Chennaiyin,6605,8,3,5,6,14,21,-7,14
Delhi Dynamo,6606,1,6,6,2,25,16,9,24
Mumbai City,6606,2,6,5,3,17,9,8,23
Kolkata,6606,3,4,7,3,16,14,2,19
Chennaiyin,6606,4,4,6,4,16,19,-3,18
FC Pune City,6606,5,4,5,5,13,15,-2,17
Kerala Blast,6606,6,4,5,5,10,17,-7,17
NorthEast Un,6606,7,4,4,6,11,12,-1,16
FC Goa,6606,8,4,2,8,11,17,-6,14
Kolkata,6607,1,6,6,2,19,15,4,24
Delhi Dynamo,6607,2,6,5,3,26,16,10,23
Mumbai City,6607,3,6,4,4,16,9,7,22
NorthEast Un,6607,4,6,3,5,16,12,4,21
Kerala Blast,6607,5,5,3,6,13,19,-6,18
Chennaiyin,6607,6,3,7,4,15,19,-4,16
FC Pune City,6607,7,4,3,7,13,17,-4,15
FC Goa,6607,8,3,3,8,10,21,-11,12
Mumbai City,6608,1,7,4,3,18,9,9,25
NorthEast Un,6608,2,6,3,5,15,12,3,21
FC Pune City,6608,3,5,4,5,15,15,0,19
Delhi Dynamo,6608,4,4,6,4,25,21,4,18
Kolkata,6608,5,3,9,2,14,13,1,18
Chennaiyin,6608,6,3,7,4,14,18,-4,16
Kerala Blast,6608,7,4,4,6,12,19,-7,16
FC Goa,6608,8,3,5,6,10,16,-6,14
Mumbai City,6609,1,6,5,3,16,8,8,23
Delhi Dynamo,6609,2,5,6,3,24,17,7,21
Kolkata,6609,3,5,6,3,18,16,2,21
FC Goa,6609,4,6,2,6,14,15,-1,20
FC Pune City,6609,5,5,3,6,16,18,-2,18
NorthEast Un,6609,6,4,4,6,12,13,-1,16
Kerala Blast,6609,7,4,4,6,12,19,-7,16
Chennaiyin,6609,8,3,6,5,13,19,-6,15
Mumbai City,6610,1,7,4,3,18,8,10,25
Kerala Blast,6610,2,6,4,4,15,16,-1,22
Delhi Dynamo,6610,3,5,5,4,22,19,3,20
Chennaiyin,6610,4,5,5,4,17,18,-1,20
Kolkata,6610,5,4,7,3,16,16,0,19
NorthEast Un,6610,6,5,2,7,13,13,0,17
FC Pune City,6610,7,4,4,6,13,16,-3,16
FC Goa,6610,8,3,3,8,10,18,-8,12
Mumbai City,6611,1,6,5,3,17,9,8,23
Delhi Dynamo,6611,2,5,6,3,23,16,7,21
Kolkata,6611,3,5,6,3,18,16,2,21
Kerala Blast,6611,4,6,3,5,14,17,-3,21
NorthEast Un,6611,5,6,2,6,13,11,2,20
Chennaiyin,6611,6,4,5,5,15,20,-5,17
FC Pune City,6611,7,4,3,7,12,16,-4,15
FC Goa,6611,8,4,2,8,12,19,-7,14
Mumbai City,6612,1,7,4,3,20,9,11,25
NorthEast Un,6612,2,7,2,5,15,12,3,23
Kolkata,6612,3,5,7,2,21,13,8,22
Kerala Blast,6612,4,5,4,5,14,16,-2,19
Delhi Dynamo,6612,5,4,5,5,24,22,2,17
FC Goa,6612,6,5,2,7,12,18,-6,17
FC Pune City,6612,7,4,3,7,12,21,-9,15
Chennaiyin,6612,8,3,5,6,14,21,-7,14
Mumbai City,6613,1,7,4,3,17,8,9,25
Delhi Dynamo,6613,2,6,5,3,26,15,11,23
Kolkata,6613,3,4,7,3,16,17,-1,19
Chennaiyin,6613,4,4,5,5,21,22,-1,17
FC Pune City,6613,5,4,5,5,13,15,-2,17
FC Goa,6613,6,5,2,7,16,19,-3,17
NorthEast Un,6613,7,5,2,7,12,18,-6,17
Kerala Blast,6613,8,4,4,6,10,17,-7,16
Mumbai City,6614,1,7,4,3,18,9,9,25
Kolkata,6614,2,6,6,2,20,13,7,24
Delhi Dynamo,6614,3,5,5,4,24,19,5,20
NorthEast Un,6614,4,6,2,6,14,11,3,20
Kerala Blast,6614,5,5,4,5,11,17,-6,19
Chennaiyin,6614,6,4,5,5,16,19,-3,17
FC Pune City,6614,7,4,4,6,13,16,-3,16
FC Goa,6614,8,3,2,9,9,21,-12,11
Kolkata,6615,1,6,6,2,19,15,4,24
Mumbai City,6615,2,6,5,3,17,9,8,23
Chennaiyin,6615,3,5,5,4,20,19,1,20
Delhi Dynamo,6615,4,4,7,3,23,17,6,19
FC Pune City,6615,5,5,3,6,17,18,-1,18
NorthEast Un,6615,6,4,4,6,10,12,-2,16
Kerala Blast,6615,7,4,4,6,11,18,-7,16
FC Goa,6615,8,4,2,8,13,22,-9,14
Kolkata,6616,1,6,6,2,20,14,6,24
Mumbai City,6616,2,6,5,3,18,10,8,23
NorthEast Un,6616,3,6,2,6,14,12,2,20
Delhi Dynamo,6616,4,4,6,4,23,19,4,18
FC Pune City,6616,5,5,3,6,14,16,-2,18
Kerala Blast,6616,6,5,3,6,12,17,-5,18
Chennaiyin,6616,7,4,5,5,15,19,-4,17
FC Goa,6616,8,4,2,8,9,18,-9,14
Mumbai City,6617,1,7,4,3,20,9,11,25
Delhi Dynamo,6617,2,6,5,3,28,18,10,23
Kolkata,6617,3,5,6,3,19,15,4,21
Chennaiyin,6617,4,5,5,4,17,19,-2,20
FC Pune City,6617,5,5,4,5,15,16,-1,19
NorthEast Un,6617,6,5,2,7,13,14,-1,17
Kerala Blast,6617,7,4,4,6,10,20,-10,16
FC Goa,6617,8,3,2,9,11,22,-11,11
Delhi Dynamo,6618,1,6,6,2,26,17,9,24
Kerala Blast,6618,2,7,3,4,15,15,0,24
Mumbai City,6618,3,6,5,3,17,9,8,23
NorthEast Un,6618,4,5,2,7,11,12,-1,17
FC Goa,6618,5,5,2,7,13,17,-4,17
FC Pune City,6618,6,4,4,6,15,18,-3,16
Kolkata,6618,6,3,7,4,15,18,-3,16
Chennaiyin,6618,8,3,5,6,13,19,-6,14
Mumbai City,6619,1,6,5,3,17,9,8,23
Delhi Dynamo,6619,2,4,7,3,24,19,5,19
FC Pune City,6619,3,5,4,5,15,16,-1,19
Kerala Blast,6619,4,5,4,5,13,16,-3,19
Kolkata,6619,5,4,6,4,16,16,0,18
Chennaiyin,6619,6,4,6,4,15,18,-3,18
NorthEast Un,6619,7,5,2,7,11,12,-1,17
FC Goa,6619,8,4,4,6,14,19,-5,16
Mumbai City,6620,1,7,4,3,20,10,10,25
FC Pune City,6620,2,6,3,5,17,17,0,21
Kerala Blast,6620,3,6,3,5,14,17,-3,21
NorthEast Un,6620,4,5,3,6,15,15,0,18
FC Goa,6620,5,5,3,6,10,14,-4,18
Delhi Dynamo,6620,6,4,5,5,26,23,3,17
Kolkata,6620,7,3,7,4,14,15,-1,16
Chennaiyin,6620,8,3,6,5,14,19,-5,15
Mumbai City,6621,1,7,4,3,17,8,9,25
Delhi Dynamo,6621,2,5,6,3,24,15,9,21
Kerala Blast,6621,3,5,5,4,13,14,-1,20
Kolkata,6621,4,3,8,3,13,13,0,17
NorthEast Un,6621,5,4,5,5,9,9,0,17
Chennaiyin,6621,6,3,7,4,15,19,-4,16
FC Pune City,6621,7,4,4,6,13,18,-5,16
FC Goa,6621,8,4,3,7,11,19,-8,15
Mumbai City,6622,1,7,4,3,17,8,9,25
Delhi Dynamo,6622,2,5,6,3,26,17,9,21
Kolkata,6622,3,5,6,3,19,15,4,21
FC Pune City,6622,4,6,3,5,14,14,0,21
NorthEast Un,6622,5,4,5,5,12,12,0,17
Kerala Blast,6622,6,4,4,6,12,20,-8,16
Chennaiyin,6622,7,3,6,5,14,21,-7,15
FC Goa,6622,8,4,2,8,14,21,-7,14
Mumbai City,6623,1,7,4,3,18,9,9,25
Delhi Dynamo,6623,2,5,6,3,25,18,7,21
FC Pune City,6623,3,5,4,5,16,16,0,19
FC Goa,6623,4,5,3,6,13,16,-3,18
Kerala Blast,6623,5,4,6,4,14,18,-4,18
NorthEast Un,6623,6,4,4,6,13,14,-1,16
Kolkata,6623,7,3,7,4,17,19,-2,16
Chennaiyin,6623,8,3,6,5,14,20,-6,15
Kolkata,6624,1,6,6,2,21,14,7,24
Mumbai City,6624,2,6,5,3,17,9,8,23
Delhi Dynamo,6624,3,4,8,2,24,17,7,20
Kerala Blast,6624,4,5,4,5,12,16,-4,19
NorthEast Un,6624,5,4,4,6,10,12,-2,16
Chennaiyin,6624,6,3,7,4,14,18,-4,16
FC Pune City,6624,7,4,4,6,13,17,-4,16
FC Goa,6624,8,3,4,7,12,20,-8,13
Mumbai City,6625,1,7,4,3,20,11,9,25
Kolkata,6625,2,6,6,2,20,14,6,24
Kerala Blast,6625,3,5,4,5,12,16,-4,19
Delhi Dynamo,6625,4,4,6,4,25,20,5,18
NorthEast Un,6625,5,5,3,6,11,12,-1,18
Chennaiyin,6625,6,4,5,5,17,20,-3,17
FC Pune City,6625,7,4,3,7,12,17,-5,15
FC Goa,6625,8,4,3,7,14,21,-7,15
Delhi Dynamo,6626,1,6,6,2,27,16,11,24
Kolkata,6626,2,6,6,2,22,13,9,24
Mumbai City,6626,3,6,4,4,16,10,6,22
NorthEast Un,6626,4,5,4,5,11,10,1,19
Chennaiyin,6626,5,4,6,4,18,19,-1,18
FC Pune City,6626,6,5,3,6,15,18,-3,18
Kerala Blast,6626,7,4,3,7,10,19,-9,15
FC Goa,6626,8,3,2,9,11,25,-14,11
Delhi Dynamo,6627,1,7,5,2,29,17,12,26
Mumbai City,6627,2,6,4,4,16,10,6,22
NorthEast Un,6627,3,6,2,6,16,14,2,20
Kolkata,6627,4,4,6,4,17,16,1,18
FC Pune City,6627,5,5,3,6,15,19,-4,18
Kerala Blast,6627,6,5,3,6,13,20,-7,18
Chennaiyin,6627,7,4,5,5,15,19,-4,17
FC Goa,6627,8,4,2,8,11,17,-6,14
Mumbai City,6628,1,7,4,3,17,8,9,25
NorthEast Un,6628,2,6,3,5,12,9,3,21
FC Goa,6628,3,6,2,6,14,15,-1,20
FC Pune City,6628,4,5,4,5,15,15,0,19
Kolkata,6628,5,4,6,4,15,17,-2,18
Delhi Dynamo,6628,6,4,5,5,21,17,4,17
Kerala Blast,6628,7,4,5,5,10,16,-6,17
Chennaiyin,6628,8,3,5,6,14,21,-7,14
Mumbai City,6629,1,7,4,3,17,8,9,25
Kerala Blast,6629,2,5,5,4,15,16,-1,20
Delhi Dynamo,6629,3,4,7,3,23,17,6,19
Kolkata,6629,4,4,6,4,14,16,-2,18
FC Goa,6629,5,5,3,6,11,15,-4,18
NorthEast Un,6629,6,4,5,5,12,12,0,17
FC Pune City,6629,7,4,4,6,13,16,-3,16
Chennaiyin,6629,8,3,6,5,13,18,-5,15
Delhi Dynamo,6630,1,6,6,2,27,17,10,24
Mumbai City,6630,2,6,4,4,17,11,6,22
Kolkata,6630,3,4,8,2,17,14,3,20
FC Pune City,6630,4,5,4,5,14,15,-1,19
Chennaiyin,6630,5,4,5,5,17,21,-4,17
Kerala Blast,6630,6,4,5,5,9,14,-5,17
NorthEast Un,6630,7,4,4,6,11,12,-1,16
FC Goa,6630,8,4,2,8,13,21,-8,14
Mumbai City,6631,1,7,4,3,18,8,10,25
Kerala Blast,6631,2,6,3,5,12,14,-2,21
Delhi Dynamo,6631,3,5,5,4,25,21,4,20
Kolkata,6631,4,4,7,3,15,15,0,19
NorthEast Un,6631,5,5,2,7,13,13,0,17
FC Goa,6631,6,5,2,7,15,18,-3,17
Chennaiyin,6631,7,4,5,5,14,20,-6,17
FC Pune City,6631,8,4,4,6,12,15,-3,16
Mumbai City,6632,1,7,4,3,20,9,11,25
Kolkata,6632,2,5,7,2,18,14,4,22
Delhi Dynamo,6632,3,5,5,4,24,19,5,20
Kerala Blast,6632,4,5,5,4,12,15,-3,20
FC Goa,6632,5,5,2,7,11,17,-6,17
FC Pune City,6632,6,4,4,6,14,17,-3,16
NorthEast Un,6632,7,4,3,7,10,13,-3,15
Chennaiyin,6632,8,3,6,5,15,20,-5,15
Mumbai City,6633,1,7,4,3,18,9,9,25
NorthEast Un,6633,2,7,2,5,19,12,7,23
Kolkata,6633,3,5,6,3,16,14,2,21
Delhi Dynamo,6633,4,5,5,4,27,22,5,20
Chennaiyin,6633,5,4,5,5,18,23,-5,17
FC Pune City,6633,6,4,4,6,14,17,-3,16
Kerala Blast,6633,7,4,4,6,11,17,-6,16
FC Goa,6633,8,4,2,8,13,22,-9,14
Mumbai City,6634,1,6,5,3,17,9,8,23
Delhi Dynamo,6634,2,5,6,3,24,18,6,21
Kolkata,6634,3,4,7,3,16,16,0,19
Kerala Blast,6634,4,5,4,5,14,20,-6,19
FC Pune City,6634,5,5,3,6,16,16,0,18
FC Goa,6634,6,5,3,6,13,15,-2,18
Chennaiyin,6634,7,4,6,4,15,18,-3,18
NorthEast Un,6634,8,4,2,8,11,14,-3,14
Mumbai City,6635,1,6,5,3,17,9,8,23
Kolkata,6635,2,5,7,2,20,15,5,22
NorthEast Un,6635,3,6,2,6,16,14,2,20
Delhi Dynamo,6635,4,4,7,3,23,19,4,19
FC Pune City,6635,5,5,3,6,14,17,-3,18
Chennaiyin,6635,6,4,5,5,15,18,-3,17
FC Goa,6635,7,4,4,6,10,15,-5,16
Kerala Blast,6635,8,4,3,7,13,21,-8,15
Mumbai City,6636,1,7,4,3,17,8,9,25
Delhi Dynamo,6636,2,5,6,3,23,16,7,21
NorthEast Un,6636,3,6,2,6,12,11,1,20
FC Pune City,6636,4,5,4,5,14,15,-1,19
Kolkata,6636,5,4,6,4,17,16,1,18
FC Goa,6636,6,5,3,6,12,16,-4,18
Kerala Blast,6636,7,4,4,6,9,16,-7,16
Chennaiyin,6636,8,3,5,6,14,20,-6,14
Mumbai City,6637,1,6,5,3,17,9,8,23
Delhi Dynamo,6637,2,5,7,2,24,16,8,22
Kolkata,6637,3,4,7,3,16,16,0,19
FC Pune City,6637,4,5,3,6,14,16,-2,18
NorthEast Un,6637,5,4,5,5,11,11,0,17
Kerala Blast,6637,6,4,5,5,10,15,-5,17
Chennaiyin,6637,7,3,7,4,15,19,-4,16
FC Goa,6637,8,4,3,7,13,18,-5,15
Delhi Dynamo,6638,1,6,5,3,27,17,10,23
Mumbai City,6638,2,6,4,4,16,11,5,22
FC Pune City,6638,3,6,3,5,16,15,1,21
NorthEast Un,6638,4,6,2,6,14,11,3,20
Kerala Blast,6638,5,5,4,5,12,16,-4,19
FC Goa,6638,6,5,2,7,13,16,-3,17
Kolkata,6638,7,3,7,4,14,19,-5,16
Chennaiyin,6638,8,3,5,6,13,20,-7,14
Delhi Dynamo,6639,1,7,5,2,32,20,12,26
Mumbai City,6639,2,6,4,4,18,12,6,22
Kolkata,6639,3,5,6,3,18,15,3,21
Kerala Blast,6639,4,5,4,5,11,15,-4,19
FC Pune City,6639,5,5,3,6,15,18,-3,18
Chennaiyin,6639,6,4,5,5,18,22,-4,17
NorthEast Un,6639,7,4,3,7,15,17,-2,15
FC Goa,6639,8,4,2,8,12,20,-8,14
Mumbai City,6640,1,6,5,3,17,9,8,23
Delhi Dynamo,6640,2,5,6,3,23,17,6,21
Kolkata,6640,3,5,6,3,20,16,4,21
Kerala Blast,6640,4,5,4,5,11,16,-5,19
NorthEast Un,6640,5,5,3,6,12,11,1,18
FC Goa,6640,6,5,2,7,14,16,-2,17
Chennaiyin,6640,7,4,5,5,15,21,-6,17
FC Pune City,6640,8,4,3,7,14,20,-6,15
Mumbai City,6641,1,7,4,3,18,9,9,25
Delhi Dynamo,6641,2,6,5,3,29,19,10,23
Kolkata,6641,3,5,6,3,17,15,2,21
NorthEast Un,6641,4,6,2,6,14,13,1,20
FC Pune City,6641,5,5,3,6,13,15,-2,18
FC Goa,6641,6,5,2,7,11,18,-7,17
Kerala Blast,6641,7,4,3,7,10,17,-7,15
Chennaiyin,6641,8,3,5,6,13,19,-6,14
Mumbai City,6642,1,7,4,3,18,9,9,25
Delhi Dynamo,6642,2,5,6,3,24,16,8,21
Kerala Blast,6642,3,6,3,5,13,15,-2,21
Kolkata,6642,4,4,7,3,16,14,2,19
FC Pune City,6642,5,5,4,5,13,14,-1,19
NorthEast Un,6642,6,5,2,7,13,13,0,17
Chennaiyin,6642,7,3,6,5,14,21,-7,15
FC Goa,6642,8,3,4,7,9,18,-9,13
Mumbai City,6643,1,7,4,3,19,9,10,25
Delhi Dynamo,6643,2,5,5,4,24,20,4,20
Kolkata,6643,3,4,7,3,19,17,2,19
NorthEast Un,6643,4,5,3,6,11,11,0,18
FC Pune City,6643,5,5,3,6,16,18,-2,18
FC Goa,6643,6,5,3,6,13,16,-3,18
Kerala Blast,6643,7,5,3,6,13,19,-6,18
Chennaiyin,6643,8,3,6,5,13,18,-5,15
Mumbai City,6644,1,7,4,3,17,8,9,25
Kolkata,6644,2,5,7,2,18,15,3,22
Delhi Dynamo,6644,3,5,6,3,22,15,7,21
Kerala Blast,6644,4,6,3,5,16,18,-2,21
Chennaiyin,6644,5,4,6,4,16,19,-3,18
NorthEast Un,6644,6,4,4,6,10,12,-2,16
FC Pune City,6644,7,4,3,7,15,19,-4,15
FC Goa,6644,8,3,3,8,11,19,-8,12
Mumbai City,6645,1,7,4,3,18,9,9,25
Delhi Dynamo,6645,2,6,5,3,28,17,11,23
Kerala Blast,6645,3,6,3,5,13,16,-3,21
Kolkata,6645,4,4,6,4,17,16,1,18
FC Pune City,6645,5,5,3,6,13,16,-3,18
FC Goa,6645,6,5,2,7,12,20,-8,17
NorthEast Un,6645,7,4,3,7,10,12,-2,15
Chennaiyin,6645,8,3,6,5,14,19,-5,15
Mumbai City,6646,1,7,4,3,18,9,9,25
FC Pune City,6646,2,6,3,5,18,15,3,21
NorthEast Un,6646,3,6,2,6,14,11,3,20
Delhi Dynamo,6646,4,4,6,4,24,20,4,18
Kolkata,6646,5,4,6,4,14,16,-2,18
Kerala Blast,6646,6,5,3,6,12,18,-6,18
Chennaiyin,6646,7,4,5,5,14,19,-5,17
FC Goa,6646,8,4,3,7,11,17,-6,15
Mumbai City,6647,1,7,4,3,17,8,9,25
NorthEast Un,6647,2,5,4,5,14,11,3,19
Kolkata,6647,3,4,7,3,15,15,0,19
Delhi Dynamo,6647,4,4,6,4,24,21,3,18
FC Goa,6647,5,5,3,6,14,16,-2,18
FC Pune City,6647,6,5,3,6,14,17,-3,18
Kerala Blast,6647,7,4,5,5,10,15,-5,17
Chennaiyin,6647,8,3,6,5,14,19,-5,15
Delhi Dynamo,6648,1,6,6,2,28,18,10,24
Mumbai City,6648,2,6,5,3,17,9,8,23
FC Pune City,6648,3,6,3,5,16,15,1,21
NorthEast Un,6648,4,5,3,6,14,13,1,18
Kerala Blast,6648,5,4,5,5,10,15,-5,17
Kolkata,6648,6,3,7,4,14,16,-2,16
FC Goa,6648,7,4,3,7,13,19,-6,15
Chennaiyin,6648,8,3,6,5,15,22,-7,15
Mumbai City,6649,1,7,4,3,19,9,10,25
Kerala Blast,6649,2,7,3,4,14,14,0,24
Delhi Dynamo,6649,3,6,5,3,24,17,7,23
FC Pune City,6649,4,5,3,6,14,17,-3,18
NorthEast Un,6649,5,5,2,7,11,12,-1,17
Kolkata,6649,6,3,7,4,16,17,-1,16
FC Goa,6649,7,4,3,7,12,17,-5,15
Chennaiyin,6649,8,3,5,6,13,20,-7,14
Kolkata,6650,1,6,6,2,19,14,5,24
Mumbai City,6650,2,6,5,3,16,8,8,23
Delhi Dynamo,6650,3,5,7,2,24,15,9,22
Chennaiyin,6650,4,5,5,4,17,17,0,20
FC Pune City,6650,5,5,3,6,16,19,-3,18
Kerala Blast,6650,5,5,3,6,16,19,-3,18
NorthEast Un,6650,7,4,2,8,9,15,-6,14
FC Goa,6650,8,3,3,8,10,20,-10,12
Delhi Dynamo,6651,1,5,7,2,25,17,8,22
Mumbai City,6651,2,6,4,4,16,9,7,22
Kolkata,6651,3,4,7,3,19,17,2,19
FC Goa,6651,4,5,3,6,13,16,-3,18
Kerala Blast,6651,5,4,6,4,14,18,-4,18
NorthEast Un,6651,6,4,5,5,11,11,0,17
FC Pune City,6651,7,4,4,6,17,21,-4,16
Chennaiyin,6651,8,3,6,5,14,20,-6,15
Delhi Dynamo,6652,1,7,5,2,26,15,11,26
Mumbai City,6652,2,6,4,4,16,10,6,22
Kolkata,6652,3,5,7,2,19,16,3,22
Chennaiyin,6652,4,5,5,4,18,19,-1,20
Kerala Blast,6652,5,5,5,4,13,15,-2,20
FC Pune City,6652,6,4,4,6,13,16,-3,16
NorthEast Un,6652,7,4,2,8,11,15,-4,14
FC Goa,6652,8,3,2,9,10,20,-10,11
Delhi Dynamo,6653,1,6,6,2,24,15,9,24
Mumbai City,6653,2,6,4,4,17,10,7,22
Kolkata,6653,3,4,8,2,18,15,3,20
Kerala Blast,6653,4,5,5,4,14,16,-2,20
FC Pune City,6653,5,4,5,5,14,16,-2,17
NorthEast Un,6653,6,5,2,7,11,13,-2,17
Chennaiyin,6653,7,3,6,5,14,19,-5,15
FC Goa,6653,8,3,4,7,10,18,-8,13
Mumbai City,6654,1,6,5,3,16,8,8,23
Kolkata,6654,2,5,6,3,16,13,3,21
Kerala Blast,6654,3,5,4,5,11,16,-5,19
Delhi Dynamo,6654,4,4,6,4,22,18,4,18
NorthEast Un,6654,5,5,3,6,11,11,0,18
FC Pune City,6654,6,5,3,6,14,16,-2,18
Chennaiyin,6654,7,4,6,4,15,18,-3,18
FC Goa,6654,8,4,3,7,12,17,-5,15
NorthEast Un,6655,1,7,2,5,14,11,3,23
Mumbai City,6655,2,6,4,4,16,9,7,22
Delhi Dynamo,6655,3,5,6,3,25,18,7,21
FC Pune City,6655,4,5,4,5,14,15,-1,19
Kolkata,6655,5,3,8,3,16,16,0,17
Kerala Blast,6655,6,4,5,5,13,18,-5,17
FC Goa,6655,7,4,4,6,12,17,-5,16
Chennaiyin,6655,8,3,5,6,13,19,-6,14
Mumbai City,6656,1,7,4,3,18,9,9,25
NorthEast Un,6656,2,6,3,5,12,10,2,21
Kerala Blast,6656,3,5,5,4,12,14,-2,20
Kolkata,6656,4,4,7,3,14,13,1,19
FC Goa,6656,5,5,3,6,14,17,-3,18
Delhi Dynamo,6656,6,4,5,5,23,20,3,17
Chennaiyin,6656,7,3,6,5,15,20,-5,15
FC Pune City,6656,8,4,3,7,12,17,-5,15
Delhi Dynamo,6657,1,6,5,3,26,17,9,23
NorthEast Un,6657,2,7,2,5,15,12,3,23
Mumbai City,6657,3,6,4,4,16,9,7,22
Kolkata,6657,4,5,6,3,17,15,2,21
Kerala Blast,6657,5,5,3,6,13,18,-5,18
FC Goa,6657,6,5,2,7,12,18,-6,17
FC Pune City,6657,7,4,3,7,13,17,-4,15
Chennaiyin,6657,8,3,5,6,14,20,-6,14
Mumbai City,6658,1,7,4,3,18,9,9,25
NorthEast Un,6658,2,6,2,6,13,12,1,20
Kolkata,6658,3,4,7,3,18,15,3,19
Kerala Blast,6658,4,5,4,5,12,18,-6,19
Delhi Dynamo,6658,5,4,6,4,23,18,5,18
FC Pune City,6658,6,5,3,6,16,18,-2,18
Chennaiyin,6658,7,4,5,5,15,18,-3,17
FC Goa,6658,8,4,3,7,11,18,-7,15
Mumbai City,6659,1,7,4,3,18,9,9,25
Delhi Dynamo,6659,2,5,6,3,24,17,7,21
FC Pune City,6659,3,6,3,5,14,14,0,21
Kerala Blast,6659,4,6,3,5,12,14,-2,21
NorthEast Un,6659,5,5,3,6,11,12,-1,18
Chennaiyin,6659,6,4,5,5,15,19,-4,17
Kolkata,6659,7,3,6,5,14,16,-2,15
FC Goa,6659,8,4,2,8,11,18,-7,14
Mumbai City,6660,1,7,4,3,18,8,10,25
Kolkata,6660,2,5,6,3,21,17,4,21
Delhi Dynamo,6660,3,4,7,3,23,18,5,19
NorthEast Un,6660,4,5,3,6,12,10,2,18
FC Pune City,6660,5,5,3,6,19,19,0,18
Chennaiyin,6660,6,4,6,4,15,18,-3,18
Kerala Blast,6660,7,5,3,6,11,22,-11,18
FC Goa,6660,8,3,4,7,12,19,-7,13
Mumbai City,6661,1,7,4,3,18,9,9,25
Delhi Dynamo,6661,2,6,5,3,26,17,9,23
Kolkata,6661,3,5,7,2,18,14,4,22
Kerala Blast,6661,4,6,4,4,13,15,-2,22
NorthEast Un,6661,5,5,2,7,11,12,-1,17
Chennaiyin,6661,6,3,6,5,15,20,-5,15
FC Pune City,6661,7,4,3,7,12,17,-5,15
FC Goa,6661,8,3,3,8,12,21,-9,12
Mumbai City,6662,1,7,4,3,20,8,12,25
NorthEast Un,6662,2,6,3,5,15,12,3,21
Delhi Dynamo,6662,3,5,5,4,23,20,3,20
FC Pune City,6662,4,5,4,5,14,15,-1,19
Kolkata,6662,5,3,9,2,17,16,1,18
Chennaiyin,6662,6,4,5,5,18,21,-3,17
Kerala Blast,6662,7,4,5,5,11,16,-5,17
FC Goa,6662,8,3,3,8,9,19,-10,12
Mumbai City,6663,1,7,4,3,19,8,11,25
Delhi Dynamo,6663,2,6,5,3,26,19,7,23
Kolkata,6663,3,4,8,2,16,13,3,20
FC Pune City,6663,4,5,4,5,17,17,0,19
Kerala Blast,6663,5,5,3,6,12,19,-7,18
NorthEast Un,6663,6,5,2,7,13,14,-1,17
Chennaiyin,6663,7,3,6,5,13,19,-6,15
FC Goa,6663,8,3,4,7,8,15,-7,13
Delhi Dynamo,6664,1,6,6,2,30,16,14,24
Kerala Blast,6664,2,7,3,4,16,16,0,24
Mumbai City,6664,3,6,5,3,17,9,8,23
FC Pune City,6664,4,5,3,6,17,19,-2,18
NorthEast Un,6664,5,5,2,7,13,15,-2,17
Kolkata,6664,6,3,7,4,17,19,-2,16
FC Goa,6664,7,4,3,7,12,21,-9,15
Chennaiyin,6664,8,3,5,6,15,22,-7,14
Mumbai City,6665,1,7,4,3,19,9,10,25
NorthEast Un,6665,2,7,2,5,15,10,5,23
Delhi Dynamo,6665,3,5,5,4,25,19,6,20
Kolkata,6665,4,4,6,4,16,15,1,18
FC Pune City,6665,5,5,3,6,14,16,-2,18
Kerala Blast,6665,6,5,3,6,11,18,-7,18
FC Goa,6665,7,5,2,7,12,17,-5,17
Chennaiyin,6665,8,3,5,6,13,21,-8,14
Mumbai City,6666,1,7,4,3,17,8,9,25
Kolkata,6666,2,5,6,3,17,15,2,21
Delhi Dynamo,6666,3,5,5,4,22,16,6,20
NorthEast Un,6666,4,5,4,5,10,9,1,19
FC Pune City,6666,5,5,3,6,14,17,-3,18
FC Goa,6666,6,5,2,7,13,17,-4,17
Kerala Blast,6666,7,4,4,6,10,16,-6,16
Chennaiyin,6666,8,3,6,5,14,19,-5,15
Mumbai City,6667,1,7,4,3,18,9,9,25
Kolkata,6667,2,4,8,2,17,15,2,20
Kerala Blast,6667,3,5,5,4,15,17,-2,20
Delhi Dynamo,6667,4,4,7,3,23,17,6,19
Chennaiyin,6667,5,4,5,5,16,19,-3,17
NorthEast Un,6667,6,4,4,6,11,13,-2,16
FC Pune City,6667,7,4,4,6,15,19,-4,16
FC Goa,6667,8,4,3,7,11,17,-6,15
Mumbai City,6668,1,7,4,3,19,8,11,25
NorthEast Un,6668,2,6,2,6,13,10,3,20
Kerala Blast,6668,3,5,4,5,12,17,-5,19
Delhi Dynamo,6668,4,4,6,4,23,21,2,18
Kolkata,6668,5,4,6,4,17,18,-1,18
Chennaiyin,6668,6,4,6,4,15,18,-3,18
FC Pune City,6668,7,4,4,6,16,19,-3,16
FC Goa,6668,8,4,4,6,14,18,-4,16
Mumbai City,6669,1,7,4,3,17,8,9,25
NorthEast Un,6669,2,6,3,5,13,11,2,21
Kerala Blast,6669,3,5,5,4,11,14,-3,20
Kolkata,6669,4,4,7,3,14,14,0,19
FC Goa,6669,5,5,3,6,13,16,-3,18
Delhi Dynamo,6669,6,4,5,5,21,17,4,17
FC Pune City,6669,7,4,3,7,12,16,-4,15
Chennaiyin,6669,8,3,6,5,16,21,-5,15
Delhi Dynamo,6670,1,6,5,3,28,17,11,23
Mumbai City,6670,2,6,4,4,16,10,6,22
Kerala Blast,6670,3,5,5,4,11,14,-3,20
Kolkata,6670,4,4,7,3,15,17,-2,19
FC Pune City,6670,5,5,3,6,16,15,1,18
Chennaiyin,6670,6,4,5,5,16,19,-3,17
FC Goa,6670,7,5,2,7,11,16,-5,17
NorthEast Un,6670,8,4,3,7,11,16,-5,15
Mumbai City,6671,1,7,4,3,19,8,11,25
Kolkata,6671,2,4,7,3,16,15,1,19
Kerala Blast,6671,3,5,4,5,13,16,-3,19
Delhi Dynamo,6671,4,4,6,4,22,20,2,18
NorthEast Un,6671,5,5,3,6,12,11,1,18
FC Goa,6671,6,5,3,6,12,16,-4,18
Chennaiyin,6671,7,4,5,5,15,19,-4,17
FC Pune City,6671,8,4,4,6,13,17,-4,16
Mumbai City,6672,1,6,5,3,17,9,8,23
Delhi Dynamo,6672,2,5,6,3,24,16,8,21
NorthEast Un,6672,3,5,4,5,12,11,1,19
FC Pune City,6672,4,5,4,5,17,18,-1,19
Kolkata,6672,5,3,9,2,17,16,1,18
Kerala Blast,6672,6,4,5,5,11,16,-5,17
Chennaiyin,6672,7,3,6,5,16,21,-5,15
FC Goa,6672,8,4,3,7,12,19,-7,15
Mumbai City,6673,1,7,4,3,19,9,10,25
Delhi Dynamo,6673,2,5,5,4,25,21,4,20
Kolkata,6673,3,4,8,2,17,15,2,20
Kerala Blast,6673,4,5,4,5,13,16,-3,19
NorthEast Un,6673,5,5,3,6,13,11,2,18
Chennaiyin,6673,6,4,5,5,14,19,-5,17
FC Pune City,6673,7,4,4,6,13,17,-4,16
FC Goa,6673,8,4,3,7,12,18,-6,15
Mumbai City,6674,1,7,4,3,18,9,9,25
FC Pune City,6674,2,6,3,5,15,14,1,21
Kerala Blast,6674,3,6,3,5,14,15,-1,21
Delhi Dynamo,6674,4,5,5,4,25,19,6,20
NorthEast Un,6674,5,5,2,7,11,13,-2,17
FC Goa,6674,6,5,2,7,13,16,-3,17
Chennaiyin,6674,7,4,5,5,14,19,-5,17
Kolkata,6674,8,3,6,5,13,18,-5,15
Mumbai City,6675,1,6,5,3,17,9,8,23
Delhi Dynamo,6675,2,5,7,2,24,16,8,22
FC Pune City,6675,3,6,3,5,15,15,0,21
Chennaiyin,6675,4,5,5,4,17,19,-2,20
Kolkata,6675,5,4,7,3,16,15,1,19
Kerala Blast,6675,6,5,4,5,13,17,-4,19
NorthEast Un,6675,7,4,3,7,11,13,-2,15
FC Goa,6675,8,3,2,9,9,18,-9,11
Delhi Dynamo,6676,1,7,5,2,29,15,14,26
Mumbai City,6676,2,6,4,4,17,11,6,22
Kerala Blast,6676,3,5,4,5,12,15,-3,19
FC Pune City,6676,4,5,3,6,14,17,-3,18
NorthEast Un,6676,5,5,2,7,10,12,-2,17
FC Goa,6676,6,5,2,7,13,17,-4,17
Chennaiyin,6676,7,4,5,5,14,21,-7,17
Kolkata,6676,8,3,7,4,15,16,-1,16
Mumbai City,6677,1,7,4,3,17,8,9,25
Kerala Blast,6677,2,6,4,4,11,13,-2,22
Delhi Dynamo,6677,3,5,5,4,25,18,7,20
NorthEast Un,6677,4,5,4,5,12,10,2,19
Chennaiyin,6677,5,4,6,4,15,17,-2,18
Kolkata,6677,6,3,8,3,14,14,0,17
FC Pune City,6677,7,4,4,6,13,16,-3,16
FC Goa,6677,8,3,3,8,8,19,-11,12
Kerala Blast,6678,1,7,3,4,15,14,1,24
Mumbai City,6678,2,6,5,3,17,9,8,23
Delhi Dynamo,6678,3,5,6,3,24,19,5,21
Kolkata,6678,4,4,6,4,18,16,2,18
NorthEast Un,6678,5,5,3,6,13,12,1,18
FC Goa,6678,6,5,2,7,12,17,-5,17
Chennaiyin,6678,7,3,6,5,13,18,-5,15
FC Pune City,6678,8,4,3,7,13,20,-7,15
Mumbai City,6679,1,7,4,3,18,9,9,25
Kolkata,6679,2,6,6,2,19,13,6,24
Delhi Dynamo,6679,3,5,5,4,24,18,6,20
Kerala Blast,6679,4,5,3,6,11,17,-6,18
Chennaiyin,6679,5,4,5,5,16,18,-2,17
NorthEast Un,6679,6,5,2,7,10,13,-3,17
FC Goa,6679,7,5,2,7,12,17,-5,17
FC Pune City,6679,8,4,3,7,13,18,-5,15
NorthEast Un,6680,1,7,2,5,15,11,4,23
Mumbai City,6680,2,6,4,4,16,9,7,22
Delhi Dynamo,6680,3,5,5,4,25,19,6,20
Kolkata,6680,4,4,8,2,16,13,3,20
Kerala Blast,6680,5,4,5,5,12,18,-6,17
FC Pune City,6680,6,4,4,6,14,18,-4,16
FC Goa,6680,7,4,4,6,10,15,-5,16
Chennaiyin,6680,8,3,6,5,13,18,-5,15
Mumbai City,6681,1,7,4,3,17,8,9,25
Kolkata,6681,2,5,7,2,19,15,4,22
Kerala Blast,6681,3,5,4,5,14,17,-3,19
Delhi Dynamo,6681,4,4,6,4,22,18,4,18
FC Pune City,6681,5,5,3,6,16,17,-1,18
NorthEast Un,6681,6,5,3,6,12,13,-1,18
Chennaiyin,6681,7,3,7,4,15,19,-4,16
FC Goa,6681,8,3,4,7,11,19,-8,13
Delhi Dynamo,6682,1,6,5,3,27,18,9,23
Mumbai City,6682,2,6,4,4,17,10,7,22
Kolkata,6682,3,5,7,2,20,14,6,22
Kerala Blast,6682,4,5,4,5,12,16,-4,19
Chennaiyin,6682,5,4,6,4,16,17,-1,18
FC Pune City,6682,6,4,5,5,14,16,-2,17
NorthEast Un,6682,7,5,2,7,12,16,-4,17
FC Goa,6682,8,3,3,8,9,20,-11,12
Mumbai City,6683,1,7,4,3,19,9,10,25
NorthEast Un,6683,2,7,2,5,16,11,5,23
FC Goa,6683,3,6,2,6,15,16,-1,20
Kerala Blast,6683,4,5,4,5,12,16,-4,19
Kolkata,6683,5,4,6,4,16,16,0,18
Delhi Dynamo,6683,6,4,5,5,24,24,0,17
FC Pune City,6683,7,4,4,6,12,15,-3,16
Chennaiyin,6683,8,3,5,6,15,22,-7,14
Mumbai City,6684,1,7,4,3,18,8,10,25
Kolkata,6684,2,5,6,3,20,15,5,21
Delhi Dynamo,6684,3,4,6,4,23,20,3,18
NorthEast Un,6684,4,5,3,6,13,12,1,18
FC Pune City,6684,5,5,3,6,15,19,-4,18
FC Goa,6684,6,5,3,6,12,16,-4,18
Kerala Blast,6684,7,5,3,6,12,18,-6,18
Chennaiyin,6684,8,3,6,5,13,18,-5,15
Mumbai City,6685,1,7,4,3,17,8,9,25
NorthEast Un,6685,2,7,2,5,16,11,5,23
FC Goa,6685,3,6,2,6,12,15,-3,20
FC Pune City,6685,4,5,4,5,13,14,-1,19
Delhi Dynamo,6685,5,4,5,5,23,20,3,17
Kolkata,6685,6,3,8,3,14,14,0,17
Kerala Blast,6685,7,4,4,6,10,17,-7,16
Chennaiyin,6685,8,3,5,6,14,20,-6,14
Mumbai City,6686,1,7,4,3,19,9,10,25
Kerala Blast,6686,2,7,3,4,15,15,0,24
Delhi Dynamo,6686,3,5,5,4,25,20,5,20
FC Goa,6686,4,6,2,6,15,18,-3,20
Kolkata,6686,5,4,6,4,17,17,0,18
Chennaiyin,6686,6,4,5,5,16,20,-4,17
FC Pune City,6686,7,4,3,7,14,19,-5,15
NorthEast Un,6686,8,4,2,8,10,13,-3,14
Kolkata,6687,1,6,6,2,21,13,8,24
Mumbai City,6687,2,6,4,4,16,9,7,22
Delhi Dynamo,6687,3,5,6,3,24,18,6,21
NorthEast Un,6687,4,6,2,6,14,13,1,20
Kerala Blast,6687,5,5,4,5,12,15,-3,19
FC Pune City,6687,6,4,4,6,13,18,-5,16
FC Goa,6687,7,4,3,7,13,18,-5,15
Chennaiyin,6687,8,3,5,6,14,23,-9,14
Kerala Blast,6688,1,7,3,4,13,14,-1,24
Mumbai City,6688,2,6,5,3,17,9,8,23
Delhi Dynamo,6688,3,5,6,3,26,17,9,21
Kolkata,6688,4,4,7,3,16,15,1,19
Chennaiyin,6688,5,4,6,4,18,20,-2,18
FC Pune City,6688,6,4,3,7,13,17,-4,15
NorthEast Un,6688,7,4,3,7,11,15,-4,15
FC Goa,6688,8,4,3,7,11,18,-7,15
Mumbai City,6689,1,7,4,3,21,8,13,25
NorthEast Un,6689,2,6,3,5,19,11,8,21
Kerala Blast,6689,3,6,3,5,16,19,-3,21
Delhi Dynamo,6689,4,5,5,4,24,25,-1,20
Kolkata,6689,5,4,6,4,16,17,-1,18
FC Pune City,6689,6,5,3,6,14,18,-4,18
Chennaiyin,6689,7,3,6,5,14,19,-5,15
FC Goa,6689,8,4,2,8,11,18,-7,14
Mumbai City,6690,1,6,4,4,17,11,6,22
Delhi Dynamo,6690,2,5,6,3,25,17,8,21
Kolkata,6690,3,5,6,3,17,14,3,21
NorthEast Un,6690,4,6,2,6,13,12,1,20
FC Pune City,6690,5,5,3,6,14,16,-2,18
Kerala Blast,6690,6,5,3,6,12,19,-7,18
Chennaiyin,6690,7,4,5,5,16,20,-4,17
FC Goa,6690,8,4,3,7,12,17,-5,15
Delhi Dynamo,6691,1,6,6,2,26,17,9,24
Kerala Blast,6691,2,7,3,4,19,13,6,24
Mumbai City,6691,3,6,4,4,16,9,7,22
Kolkata,6691,4,4,6,4,17,19,-2,18
FC Goa,6691,5,5,3,6,17,21,-4,18
NorthEast Un,6691,6,5,2,7,12,16,-4,17
FC Pune City,6691,7,4,3,7,12,17,-5,15
Chennaiyin,6691,8,3,5,6,15,22,-7,14
NorthEast Un,6692,1,7,2,5,14,9,5,23
Mumbai City,6692,2,6,4,4,16,10,6,22
Kolkata,6692,3,5,6,3,18,16,2,21
FC Pune City,6692,4,6,3,5,15,14,1,21
Delhi Dynamo,6692,5,5,5,4,23,16,7,20
FC Goa,6692,6,5,2,7,16,17,-1,17
Kerala Blast,6692,7,4,3,7,10,18,-8,15
Chennaiyin,6692,8,3,5,6,13,25,-12,14
Mumbai City,6693,1,7,4,3,19,8,11,25
Delhi Dynamo,6693,2,5,6,3,27,18,9,21
Kolkata,6693,3,4,7,3,19,18,1,19
Kerala Blast,6693,4,5,4,5,12,18,-6,19
NorthEast Un,6693,5,5,3,6,13,13,0,18
Chennaiyin,6693,6,4,5,5,16,18,-2,17
FC Goa,6693,7,5,2,7,14,21,-7,17
FC Pune City,6693,8,4,3,7,13,19,-6,15
Mumbai City,6694,1,7,4,3,19,8,11,25
Kolkata,6694,2,5,6,3,16,14,2,21
Delhi Dynamo,6694,3,4,7,3,25,21,4,19
NorthEast Un,6694,4,5,4,5,13,11,2,19
Kerala Blast,6694,5,5,4,5,12,16,-4,19
Chennaiyin,6694,6,4,5,5,15,19,-4,17
FC Pune City,6694,7,4,3,7,13,17,-4,15
FC Goa,6694,8,4,3,7,13,20,-7,15
Mumbai City,6695,1,6,5,3,16,8,8,23
Kerala Blast,6695,2,6,4,4,12,14,-2,22
Delhi Dynamo,6695,3,5,6,3,26,17,9,21
Kolkata,6695,4,4,8,2,17,14,3,20
NorthEast Un,6695,5,5,2,7,11,12,-1,17
Chennaiyin,6695,6,4,5,5,15,19,-4,17
FC Pune City,6695,7,4,3,7,12,17,-5,15
FC Goa,6695,8,4,3,7,12,20,-8,15
Mumbai City,6696,1,7,4,3,18,8,10,25
Delhi Dynamo,6696,2,5,6,3,22,16,6,21
Kerala Blast,6696,3,5,4,5,13,18,-5,19
NorthEast Un,6696,4,5,3,6,12,11,1,18
Kolkata,6696,5,4,6,4,16,16,0,18
Chennaiyin,6696,6,4,6,4,15,18,-3,18
FC Pune City,6696,7,4,4,6,14,18,-4,16
FC Goa,6696,8,4,3,7,10,15,-5,15
Mumbai City,6697,1,6,4,4,16,10,6,22
Delhi Dynamo,6697,2,5,5,4,24,17,7,20
NorthEast Un,6697,3,6,2,6,13,12,1,20
Chennaiyin,6697,4,5,5,4,15,17,-2,20
Kolkata,6697,5,4,7,3,16,17,-1,19
Kerala Blast,6697,6,5,4,5,12,16,-4,19
FC Goa,6697,7,5,2,7,12,15,-3,17
FC Pune City,6697,8,4,3,7,13,17,-4,15
Mumbai City,6698,1,7,4,3,19,8,11,25
Delhi Dynamo,6698,2,5,5,4,24,19,5,20
Kolkata,6698,3,4,8,2,18,14,4,20
NorthEast Un,6698,4,5,4,5,12,10,2,19
Kerala Blast,6698,5,5,4,5,14,18,-4,19
Chennaiyin,6698,6,3,7,4,16,20,-4,16
FC Pune City,6698,7,4,4,6,14,19,-5,16
FC Goa,6698,8,3,4,7,10,19,-9,13
Kolkata,6699,1,6,6,2,21,14,7,24
Delhi Dynamo,6699,2,6,5,3,25,17,8,23
Mumbai City,6699,3,6,4,4,17,10,7,22
Kerala Blast,6699,4,6,3,5,13,16,-3,21
NorthEast Un,6699,5,5,3,6,11,12,-1,18
Chennaiyin,6699,6,3,7,4,14,18,-4,16
FC Pune City,6699,7,4,3,7,13,18,-5,15
FC Goa,6699,8,3,3,8,11,20,-9,12
Mumbai City,6700,1,6,5,3,16,8,8,23
NorthEast Un,6700,2,6,3,5,14,11,3,21
Kolkata,6700,3,4,8,2,16,14,2,20
Delhi Dynamo,6700,4,4,7,3,23,17,6,19
Kerala Blast,6700,5,4,6,4,10,14,-4,18
FC Pune City,6700,6,4,5,5,13,15,-2,17
Chennaiyin,6700,7,3,6,5,14,20,-6,15
FC Goa,6700,8,3,4,7,9,16,-7,13
Mumbai City,6701,1,6,4,4,17,10,7,22
Delhi Dynamo,6701,2,5,6,3,25,20,5,21
NorthEast Un,6701,3,6,3,5,17,12,5,21
Kolkata,6701,4,4,7,3,16,15,1,19
FC Pune City,6701,5,5,3,6,13,16,-3,18
Kerala Blast,6701,6,5,3,6,13,18,-5,18
FC Goa,6701,7,4,4,6,12,16,-4,16
Chennaiyin,6701,8,3,6,5,14,20,-6,15
Delhi Dynamo,6702,1,7,5,2,27,14,13,26
Mumbai City,6702,2,6,4,4,16,10,6,22
Kolkata,6702,3,4,8,2,19,17,2,20
FC Pune City,6702,4,5,3,6,18,18,0,18
NorthEast Un,6702,5,5,3,6,11,12,-1,18
Chennaiyin,6702,6,4,5,5,14,18,-4,17
Kerala Blast,6702,7,4,5,5,12,19,-7,17
FC Goa,6702,8,3,3,8,8,17,-9,12
Mumbai City,6703,1,6,5,3,16,8,8,23
Delhi Dynamo,6703,2,5,7,2,22,14,8,22
Kerala Blast,6703,3,6,3,5,14,18,-4,21
Kolkata,6703,4,4,7,3,16,14,2,19
FC Pune City,6703,5,5,4,5,17,16,1,19
Chennaiyin,6703,6,4,6,4,14,17,-3,18
NorthEast Un,6703,7,4,4,6,10,12,-2,16
FC Goa,6703,8,3,2,9,8,18,-10,11
Mumbai City,6704,1,7,4,3,22,8,14,25
Delhi Dynamo,6704,2,5,6,3,26,22,4,21
Chennaiyin,6704,3,5,5,4,16,18,-2,20
Kolkata,6704,4,4,7,3,18,16,2,19
FC Pune City,6704,5,5,4,5,16,16,0,19
NorthEast Un,6704,6,4,4,6,11,12,-1,16
Kerala Blast,6704,7,4,4,6,11,19,-8,16
FC Goa,6704,8,4,2,8,11,20,-9,14
Delhi Dynamo,6705,1,6,6,2,24,15,9,24
Mumbai City,6705,2,6,5,3,16,8,8,23
FC Pune City,6705,3,6,3,5,19,15,4,21
Kerala Blast,6705,4,6,3,5,14,18,-4,21
NorthEast Un,6705,5,5,2,7,13,15,-2,17
Kolkata,6705,6,3,7,4,14,17,-3,16
Chennaiyin,6705,7,3,6,5,14,19,-5,15
FC Goa,6705,8,3,4,7,9,16,-7,13
Mumbai City,6706,1,7,4,3,20,9,11,25
Kolkata,6706,2,5,7,2,20,15,5,22
Delhi Dynamo,6706,3,5,5,4,25,21,4,20
NorthEast Un,6706,4,6,2,6,11,12,-1,20
Kerala Blast,6706,5,5,4,5,15,17,-2,19
FC Pune City,6706,6,4,5,5,14,16,-2,17
Chennaiyin,6706,7,4,5,5,15,19,-4,17
FC Goa,6706,8,3,2,9,11,22,-11,11
Mumbai City,6707,1,7,4,3,18,8,10,25
Delhi Dynamo,6707,2,6,5,3,25,16,9,23
Kerala Blast,6707,3,5,5,4,10,13,-3,20
FC Pune City,6707,4,5,4,5,17,17,0,19
Kolkata,6707,5,3,7,4,16,18,-2,16
NorthEast Un,6707,6,4,4,6,9,12,-3,16
Chennaiyin,6707,7,3,7,4,14,18,-4,16
FC Goa,6707,8,3,4,7,9,16,-7,13
Mumbai City,6708,1,6,5,3,17,9,8,23
Delhi Dynamo,6708,2,5,7,2,26,18,8,22
Kerala Blast,6708,3,6,4,4,14,16,-2,22
Kolkata,6708,4,4,7,3,16,15,1,19
NorthEast Un,6708,5,4,4,6,12,13,-1,16
FC Goa,6708,6,4,4,6,11,16,-5,16
FC Pune City,6708,7,4,3,7,14,18,-4,15
Chennaiyin,6708,8,3,6,5,14,19,-5,15
Kolkata,6709,1,6,6,2,20,13,7,24
Mumbai City,6709,2,6,5,3,18,10,8,23
Delhi Dynamo,6709,3,5,6,3,26,19,7,21
FC Pune City,6709,4,5,3,6,14,17,-3,18
Chennaiyin,6709,5,4,5,5,16,20,-4,17
FC Goa,6709,6,5,2,7,12,17,-5,17
Kerala Blast,6709,7,4,4,6,10,18,-8,16
NorthEast Un,6709,8,4,3,7,12,14,-2,15
Mumbai City,6710,1,7,4,3,18,8,10,25
Kolkata,6710,2,6,6,2,20,12,8,24
Delhi Dynamo,6710,3,6,5,3,26,17,9,23
Kerala Blast,6710,4,5,4,5,13,17,-4,19
Chennaiyin,6710,5,4,5,5,14,18,-4,17
FC Pune City,6710,6,4,4,6,13,18,-5,16
FC Goa,6710,7,4,2,8,10,17,-7,14
NorthEast Un,6710,8,4,2,8,9,16,-7,14
Mumbai City,6711,1,7,4,3,18,8,10,25
Delhi Dynamo,6711,2,6,5,3,26,18,8,23
Kolkata,6711,3,5,7,2,20,15,5,22
FC Pune City,6711,4,5,3,6,15,18,-3,18
NorthEast Un,6711,5,4,4,6,11,12,-1,16
Kerala Blast,6711,6,4,4,6,10,17,-7,16
Chennaiyin,6711,7,3,6,5,14,20,-6,15
FC Goa,6711,8,4,3,7,12,18,-6,15
Mumbai City,6712,1,6,5,3,17,9,8,23
Delhi Dynamo,6712,2,5,7,2,26,17,9,22
NorthEast Un,6712,3,6,2,6,11,11,0,20
Kolkata,6712,4,4,7,3,17,16,1,19
FC Pune City,6712,5,4,5,5,13,15,-2,17
FC Goa,6712,6,4,4,6,16,19,-3,16
Kerala Blast,6712,7,4,4,6,9,17,-8,16
Chennaiyin,6712,8,3,6,5,16,21,-5,15
Delhi Dynamo,6713,1,6,6,2,26,16,10,24
Mumbai City,6713,2,6,4,4,16,10,6,22
Kolkata,6713,3,5,6,3,17,17,0,21
Chennaiyin,6713,4,4,6,4,15,18,-3,18
NorthEast Un,6713,5,5,2,7,10,11,-1,17
FC Goa,6713,6,4,4,6,14,17,-3,16
FC Pune City,6713,7,4,4,6,13,16,-3,16
Kerala Blast,6713,8,4,4,6,10,16,-6,16
Delhi Dynamo,6714,1,7,5,2,27,16,11,26
Mumbai City,6714,2,6,4,4,17,10,7,22
Kolkata,6714,3,5,6,3,18,15,3,21
FC Pune City,6714,4,6,3,5,16,15,1,21
Kerala Blast,6714,5,5,3,6,14,19,-5,18
NorthEast Un,6714,6,5,2,7,11,15,-4,17
Chennaiyin,6714,7,3,6,5,13,18,-5,15
FC Goa,6714,8,3,3,8,9,17,-8,12
Mumbai City,6715,1,6,5,3,17,9,8,23
Delhi Dynamo,6715,2,5,6,3,25,20,5,21
Kolkata,6715,3,4,8,2,18,15,3,20
NorthEast Un,6715,4,6,2,6,13,10,3,20
FC Pune City,6715,5,4,5,5,14,16,-2,17
Chennaiyin,6715,6,4,5,5,15,19,-4,17
Kerala Blast,6715,7,4,4,6,11,18,-7,16
FC Goa,6715,8,4,3,7,13,19,-6,15
Mumbai City,6716,1,6,4,4,17,10,7,22
Delhi Dynamo,6716,2,5,6,3,24,19,5,21
Chennaiyin,6716,3,5,5,4,18,18,0,20
FC Pune City,6716,4,5,4,5,14,15,-1,19
NorthEast Un,6716,5,5,3,6,13,12,1,18
Kolkata,6716,6,3,8,3,14,14,0,17
Kerala Blast,6716,7,4,5,5,11,16,-5,17
FC Goa,6716,8,4,3,7,12,19,-7,15
Delhi Dynamo,6717,1,6,6,2,25,16,9,24
Mumbai City,6717,2,6,4,4,17,10,7,22
NorthEast Un,6717,3,6,3,5,16,14,2,21
Kolkata,6717,4,5,6,3,15,14,1,21
FC Pune City,6717,5,5,3,6,14,15,-1,18
Chennaiyin,6717,6,3,6,5,15,20,-5,15
FC Goa,6717,7,4,3,7,10,15,-5,15
Kerala Blast,6717,8,4,3,7,11,19,-8,15
Mumbai City,6718,1,6,5,3,17,9,8,23
Delhi Dynamo,6718,2,5,7,2,30,17,13,22
Kolkata,6718,3,4,8,2,17,14,3,20
FC Pune City,6718,4,5,4,5,15,16,-1,19
Kerala Blast,6718,5,5,3,6,12,17,-5,18
Chennaiyin,6718,6,4,5,5,14,19,-5,17
NorthEast Un,6718,7,4,3,7,10,13,-3,15
FC Goa,6718,8,4,3,7,12,22,-10,15
Delhi Dynamo,6719,1,6,6,2,25,16,9,24
Mumbai City,6719,2,6,5,3,17,9,8,23
Kerala Blast,6719,3,6,4,4,16,17,-1,22
Kolkata,6719,4,5,6,3,18,14,4,21
NorthEast Un,6719,5,4,4,6,12,13,-1,16
FC Pune City,6719,6,4,3,7,13,20,-7,15
Chennaiyin,6719,7,3,6,5,14,22,-8,15
FC Goa,6719,8,4,2,8,13,17,-4,14
Mumbai City,6720,1,7,4,3,20,10,10,25
Kerala Blast,6720,2,7,3,4,14,15,-1,24
Kolkata,6720,3,4,6,4,18,18,0,18
Chennaiyin,6720,4,4,6,4,16,18,-2,18
FC Goa,6720,4,5,3,6,16,18,-2,18
Delhi Dynamo,6720,6,4,5,5,24,23,1,17
NorthEast Un,6720,7,5,2,7,11,13,-2,17
FC Pune City,6720,8,4,3,7,13,17,-4,15
Mumbai City,6721,1,7,4,3,18,8,10,25
Kolkata,6721,2,5,7,2,19,14,5,22
NorthEast Un,6721,3,5,4,5,13,12,1,19
Delhi Dynamo,6721,4,4,6,4,24,20,4,18
FC Goa,6721,5,5,2,7,17,19,-2,17
Kerala Blast,6721,6,4,5,5,12,17,-5,17
FC Pune City,6721,7,4,4,6,14,19,-5,16
Chennaiyin,6721,8,3,6,5,16,24,-8,15
Mumbai City,6722,1,7,4,3,19,9,10,25
Kerala Blast,6722,2,7,3,4,13,14,-1,24
NorthEast Un,6722,3,6,2,6,14,12,2,20
Kolkata,6722,4,4,7,3,16,15,1,19
Delhi Dynamo,6722,5,4,5,5,22,19,3,17
Chennaiyin,6722,6,4,5,5,16,20,-4,17
FC Pune City,6722,7,4,4,6,14,17,-3,16
FC Goa,6722,8,4,2,8,9,17,-8,14
Kerala Blast,6723,1,7,3,4,19,17,2,24
Mumbai City,6723,2,6,5,3,17,9,8,23
Delhi Dynamo,6723,3,5,6,3,27,18,9,21
NorthEast Un,6723,4,6,2,6,14,12,2,20
Kolkata,6723,5,3,8,3,17,18,-1,17
FC Pune City,6723,6,4,4,6,12,17,-5,16
FC Goa,6723,7,4,3,7,11,17,-6,15
Chennaiyin,6723,8,3,5,6,13,22,-9,14
Delhi Dynamo,6724,1,6,6,2,28,18,10,24
Mumbai City,6724,2,6,5,3,18,10,8,23
Kerala Blast,6724,3,5,5,4,13,15,-2,20
NorthEast Un,6724,4,5,3,6,13,12,1,18
Kolkata,6724,5,3,8,3,16,17,-1,17
FC Pune City,6724,6,4,5,5,14,16,-2,17
Chennaiyin,6724,7,4,5,5,14,19,-5,17
FC Goa,6724,8,3,3,8,11,20,-9,12
Delhi Dynamo,6725,1,6,5,3,25,19,6,23
Mumbai City,6725,2,6,4,4,18,11,7,22
NorthEast Un,6725,3,6,3,5,14,10,4,21
Kerala Blast,6725,4,5,5,4,12,15,-3,20
Kolkata,6725,5,4,7,3,15,14,1,19
FC Pune City,6725,6,4,3,7,13,17,-4,15
Chennaiyin,6725,7,3,6,5,13,18,-5,15
FC Goa,6725,8,4,3,7,10,16,-6,15
Mumbai City,6726,1,6,4,4,17,11,6,22
Delhi Dynamo,6726,2,5,6,3,27,19,8,21
NorthEast Un,6726,3,6,3,5,15,13,2,21
Kerala Blast,6726,4,6,3,5,14,16,-2,21
Kolkata,6726,5,4,7,3,18,17,1,19
Chennaiyin,6726,6,4,6,4,15,18,-3,18
FC Pune City,6726,7,4,4,6,16,19,-3,16
FC Goa,6726,8,3,3,8,9,18,-9,12
Mumbai City,6727,1,7,4,3,19,10,9,25
FC Pune City,6727,2,6,3,5,16,16,0,21
Chennaiyin,6727,3,5,5,4,16,18,-2,20
Kerala Blast,6727,4,5,4,5,14,17,-3,19
Delhi Dynamo,6727,5,4,5,5,24,20,4,17
NorthEast Un,6727,6,5,2,7,11,13,-2,17
FC Goa,6727,7,5,2,7,12,17,-5,17
Kolkata,6727,8,3,7,4,15,16,-1,16
Mumbai City,6728,1,7,4,3,19,9,10,25
NorthEast Un,6728,2,6,3,5,15,12,3,21
Delhi Dynamo,6728,3,5,5,4,25,19,6,20
FC Pune City,6728,4,5,4,5,17,17,0,19
Chennaiyin,6728,5,4,6,4,17,20,-3,18
Kerala Blast,6728,6,4,5,5,11,17,-6,17
Kolkata,6728,7,3,7,4,15,17,-2,16
FC Goa,6728,8,4,2,8,11,19,-8,14
Mumbai City,6729,1,7,4,3,18,9,9,25
FC Pune City,6729,2,6,3,5,16,15,1,21
Kerala Blast,6729,3,6,3,5,13,16,-3,21
NorthEast Un,6729,4,5,3,6,10,10,0,18
Kolkata,6729,5,4,6,4,15,16,-1,18
Delhi Dynamo,6729,6,4,5,5,23,19,4,17
Chennaiyin,6729,7,3,7,4,14,18,-4,16
FC Goa,6729,8,4,3,7,11,17,-6,15
Mumbai City,6730,1,6,5,3,17,9,8,23
Delhi Dynamo,6730,2,5,6,3,23,17,6,21
NorthEast Un,6730,3,6,2,6,13,10,3,20
Kolkata,6730,4,4,7,3,18,16,2,19
Chennaiyin,6730,5,4,6,4,15,18,-3,18
FC Pune City,6730,6,4,5,5,13,15,-2,17
Kerala Blast,6730,7,4,4,6,10,18,-8,16
FC Goa,6730,8,4,3,7,11,17,-6,15
Mumbai City,6731,1,6,5,3,16,8,8,23
Delhi Dynamo,6731,2,5,7,2,25,16,9,22
Kolkata,6731,3,4,7,3,16,15,1,19
Kerala Blast,6731,4,5,4,5,11,18,-7,19
FC Pune City,6731,5,5,3,6,16,15,1,18
NorthEast Un,6731,6,5,2,7,10,12,-2,17
FC Goa,6731,7,4,4,6,13,18,-5,16
Chennaiyin,6731,8,3,6,5,14,19,-5,15
Mumbai City,6732,1,6,5,3,17,9,8,23
Delhi Dynamo,6732,2,5,6,3,24,17,7,21
Kerala Blast,6732,3,6,3,5,13,14,-1,21
Kolkata,6732,4,4,7,3,16,16,0,19
NorthEast Un,6732,5,5,3,6,13,12,1,18
FC Goa,6732,6,5,2,7,12,17,-5,17
FC Pune City,6732,7,4,4,6,13,18,-5,16
Chennaiyin,6732,8,3,6,5,15,20,-5,15
Mumbai City,6733,1,6,5,3,17,9,8,23
NorthEast Un,6733,2,6,3,5,15,11,4,21
Delhi Dynamo,6733,3,4,8,2,24,17,7,20
FC Pune City,6733,4,5,4,5,14,15,-1,19
Kerala Blast,6733,5,5,3,6,12,18,-6,18
Kolkata,6733,6,3,7,4,15,16,-1,16
FC Goa,6733,7,4,4,6,12,17,-5,16
Chennaiyin,6733,8,3,6,5,15,21,-6,15
Mumbai City,6734,1,7,4,3,20,9,11,25
Kolkata,6734,2,5,7,2,18,14,4,22
Delhi Dynamo,6734,3,5,5,4,28,23,5,20
Kerala Blast,6734,4,5,4,5,11,16,-5,19
NorthEast Un,6734,5,5,3,6,11,12,-1,18
FC Goa,6734,6,4,4,6,12,17,-5,16
FC Pune City,6734,7,4,3,7,13,17,-4,15
Chennaiyin,6734,8,3,6,5,13,18,-5,15
Mumbai City,6735,1,6,4,4,16,12,4,22
Delhi Dynamo,6735,2,5,6,3,27,20,7,21
Kolkata,6735,3,5,6,3,16,14,2,21
Kerala Blast,6735,4,6,3,5,11,17,-6,21
NorthEast Un,6735,5,5,3,6,15,12,3,18
FC Pune City,6735,6,5,3,6,16,15,1,18
Chennaiyin,6735,7,4,6,4,19,22,-3,18
FC Goa,6735,8,3,3,8,14,22,-8,12
Mumbai City,6736,1,7,4,3,20,9,11,25
Delhi Dynamo,6736,2,6,5,3,24,18,6,23
Kolkata,6736,3,4,8,2,18,13,5,20
NorthEast Un,6736,4,5,3,6,12,12,0,18
Chennaiyin,6736,5,4,6,4,15,18,-3,18
Kerala Blast,6736,6,4,5,5,13,18,-5,17
FC Pune City,6736,7,4,4,6,14,20,-6,16
FC Goa,6736,8,3,3,8,8,16,-8,12
Mumbai City,6737,1,7,4,3,18,8,10,25
Kolkata,6737,2,4,7,3,17,19,-2,19
Kerala Blast,6737,3,5,4,5,14,18,-4,19
Delhi Dynamo,6737,4,4,6,4,21,17,4,18
Chennaiyin,6737,5,4,6,4,18,19,-1,18
FC Goa,6737,6,5,3,6,16,17,-1,18
FC Pune City,6737,7,5,3,6,15,17,-2,18
NorthEast Un,6737,8,4,3,7,9,13,-4,15
Kolkata,6738,1,6,6,2,19,13,6,24
Mumbai City,6738,2,6,5,3,17,9,8,23
Delhi Dynamo,6738,3,5,7,2,24,15,9,22
Chennaiyin,6738,4,5,5,4,18,17,1,20
NorthEast Un,6738,5,5,3,6,10,11,-1,18
FC Pune City,6738,6,5,3,6,13,17,-4,18
Kerala Blast,6738,7,4,3,7,10,17,-7,15
FC Goa,6738,8,3,2,9,8,20,-12,11
Mumbai City,6739,1,7,4,3,17,8,9,25
Kerala Blast,6739,2,6,4,4,14,15,-1,22
FC Goa,6739,3,6,2,6,11,14,-3,20
Kolkata,6739,4,4,7,3,16,15,1,19
Delhi Dynamo,6739,5,4,5,5,21,18,3,17
NorthEast Un,6739,6,5,2,7,11,12,-1,17
Chennaiyin,6739,7,4,5,5,14,18,-4,17
FC Pune City,6739,8,4,3,7,14,18,-4,15
Mumbai City,6740,1,7,4,3,17,8,9,25
Kerala Blast,6740,2,7,3,4,14,14,0,24
Kolkata,6740,3,4,7,3,14,13,1,19
Delhi Dynamo,6740,4,4,6,4,22,17,5,18
NorthEast Un,6740,5,5,3,6,11,12,-1,18
FC Goa,6740,6,4,4,6,10,15,-5,16
FC Pune City,6740,7,4,3,7,12,16,-4,15
Chennaiyin,6740,8,3,6,5,13,18,-5,15
Delhi Dynamo,6741,1,6,5,3,25,17,8,23
Mumbai City,6741,2,6,4,4,17,10,7,22
FC Goa,6741,3,6,2,6,14,15,-1,20
Kolkata,6741,4,4,7,3,18,18,0,19
FC Pune City,6741,5,5,3,6,15,18,-3,18
NorthEast Un,6741,6,5,2,7,12,13,-1,17
Chennaiyin,6741,7,4,5,5,14,18,-4,17
Kerala Blast,6741,8,4,4,6,12,18,-6,16
Mumbai City,6742,1,7,4,3,18,8,10,25
Kolkata,6742,2,4,8,2,16,14,2,20
NorthEast Un,6742,3,5,4,5,15,12,3,19
Kerala Blast,6742,4,5,4,5,12,16,-4,19
Delhi Dynamo,6742,5,4,6,4,22,18,4,18
FC Goa,6742,6,5,3,6,11,15,-4,18
Chennaiyin,6742,7,3,6,5,15,20,-5,15
FC Pune City,6742,8,4,3,7,13,19,-6,15
Kerala Blast,6743,1,7,3,4,14,14,0,24
Mumbai City,6743,2,6,5,3,18,10,8,23
Delhi Dynamo,6743,3,5,7,2,24,16,8,22
Kolkata,6743,4,4,7,3,16,15,1,19
Chennaiyin,6743,5,4,6,4,14,17,-3,18
NorthEast Un,6743,6,4,3,7,9,12,-3,15
FC Pune City,6743,7,4,3,7,15,19,-4,15
FC Goa,6743,8,3,4,7,8,15,-7,13
Mumbai City,6744,1,7,4,3,19,9,10,25
Kolkata,6744,2,6,6,2,17,13,4,24
Delhi Dynamo,6744,3,4,7,3,23,18,5,19
Kerala Blast,6744,4,5,4,5,12,15,-3,19
Chennaiyin,6744,5,4,5,5,16,22,-6,17
NorthEast Un,6744,6,4,4,6,12,14,-2,16
FC Goa,6744,7,4,3,7,13,16,-3,15
FC Pune City,6744,8,4,3,7,12,17,-5,15
Delhi Dynamo,6745,1,5,7,2,24,15,9,22
Mumbai City,6745,2,6,4,4,16,10,6,22
Kolkata,6745,3,4,7,3,17,15,2,19
NorthEast Un,6745,4,5,4,5,12,11,1,19
Kerala Blast,6745,5,5,4,5,14,19,-5,19
FC Pune City,6745,6,5,3,6,15,17,-2,18
FC Goa,6745,7,4,4,6,10,15,-5,16
Chennaiyin,6745,8,3,5,6,14,20,-6,14
Delhi Dynamo,6746,1,6,6,2,25,16,9,24
Mumbai City,6746,2,6,5,3,18,10,8,23
Kolkata,6746,3,4,8,2,23,19,4,20
FC Pune City,6746,4,5,4,5,19,18,1,19
NorthEast Un,6746,5,5,2,7,14,13,1,17
Chennaiyin,6746,6,4,5,5,16,20,-4,17
FC Goa,6746,7,4,3,7,12,18,-6,15
Kerala Blast,6746,8,4,3,7,11,24,-13,15
Delhi Dynamo,6747,1,7,5,2,27,17,10,26
Mumbai City,6747,2,6,4,4,18,11,7,22
Kolkata,6747,3,5,7,2,18,13,5,22
Chennaiyin,6747,4,5,5,4,18,17,1,20
Kerala Blast,6747,5,5,3,6,11,15,-4,18
NorthEast Un,6747,6,5,2,7,11,14,-3,17
FC Pune City,6747,7,4,4,6,12,16,-4,16
FC Goa,6747,8,3,2,9,9,21,-12,11
Mumbai City,6748,1,7,4,3,18,8,10,25
Kolkata,6748,2,5,6,3,20,16,4,21
Delhi Dynamo,6748,3,5,5,4,23,18,5,20
FC Goa,6748,4,5,3,6,12,16,-4,18
Kerala Blast,6748,5,4,5,5,14,21,-7,17
NorthEast Un,6748,6,4,4,6,12,13,-1,16
FC Pune City,6748,7,4,4,6,16,19,-3,16
Chennaiyin,6748,8,3,7,4,15,19,-4,16
Mumbai City,6749,1,6,5,3,16,8,8,23
Delhi Dynamo,6749,2,5,7,2,23,15,8,22
Kolkata,6749,3,5,7,2,18,12,6,22
Kerala Blast,6749,4,5,4,5,12,19,-7,19
NorthEast Un,6749,5,5,3,6,12,11,1,18
FC Pune City,6749,6,4,5,5,14,16,-2,17
Chennaiyin,6749,7,4,5,5,15,20,-5,17
FC Goa,6749,8,3,2,9,9,18,-9,11
Kolkata,6750,1,6,6,2,22,15,7,24
Mumbai City,6750,2,6,4,4,16,9,7,22
Delhi Dynamo,6750,3,5,5,4,22,17,5,20
NorthEast Un,6750,4,5,3,6,12,11,1,18
Chennaiyin,6750,5,4,5,5,15,20,-5,17
FC Goa,6750,6,5,2,7,11,16,-5,17
Kerala Blast,6750,6,4,5,5,11,16,-5,17
FC Pune City,6750,8,4,4,6,15,20,-5,16
Mumbai City,6751,1,6,5,3,17,9,8,23
Kolkata,6751,2,5,7,2,17,14,3,22
NorthEast Un,6751,3,6,3,5,14,11,3,21
Delhi Dynamo,6751,4,4,7,3,23,18,5,19
Kerala Blast,6751,5,4,5,5,12,17,-5,17
FC Pune City,6751,6,4,4,6,13,16,-3,16
Chennaiyin,6751,7,3,7,4,15,19,-4,16
FC Goa,6751,8,3,4,7,11,18,-7,13
Mumbai City,6752,1,7,4,3,17,8,9,25
Kolkata,6752,2,6,6,2,19,12,7,24
Delhi Dynamo,6752,3,5,5,4,25,19,6,20
NorthEast Un,6752,4,5,4,5,14,13,1,19
FC Pune City,6752,5,5,3,6,15,15,0,18
Chennaiyin,6752,6,4,6,4,17,18,-1,18
Kerala Blast,6752,7,4,4,6,10,21,-11,16
FC Goa,6752,8,3,2,9,9,20,-11,11
Delhi Dynamo,6753,1,6,6,2,27,16,11,24
Kolkata,6753,2,6,6,2,19,12,7,24
Mumbai City,6753,3,6,4,4,16,10,6,22
Kerala Blast,6753,4,5,4,5,12,17,-5,19
Chennaiyin,6753,5,4,6,4,15,17,-2,18
NorthEast Un,6753,6,4,4,6,9,11,-2,16
FC Pune City,6753,7,4,3,7,13,19,-6,15
FC Goa,6753,8,3,3,8,10,19,-9,12
Mumbai City,6754,1,7,4,3,17,8,9,25
Kolkata,6754,2,6,6,2,17,13,4,24
Delhi Dynamo,6754,3,5,6,3,26,17,9,21
Chennaiyin,6754,4,4,6,4,17,19,-2,18
Kerala Blast,6754,5,5,3,6,12,17,-5,18
NorthEast Un,6754,6,5,2,7,14,18,-4,17
FC Pune City,6754,7,4,3,7,12,16,-4,15
FC Goa,6754,8,3,4,7,11,18,-7,13
Delhi Dynamo,6755,1,7,5,2,28,18,10,26
Mumbai City,6755,2,6,4,4,18,11,7,22
Kolkata,6755,3,5,6,3,17,13,4,21
FC Pune City,6755,4,5,4,5,13,14,-1,19
Chennaiyin,6755,5,4,6,4,15,18,-3,18
Kerala Blast,6755,6,4,5,5,10,16,-6,17
NorthEast Un,6755,7,4,4,6,12,13,-1,16
FC Goa,6755,8,3,2,9,9,19,-10,11
Delhi Dynamo,6756,1,6,6,2,26,16,10,24
Mumbai City,6756,2,6,5,3,17,9,8,23
Kolkata,6756,3,5,7,2,15,12,3,22
FC Pune City,6756,4,5,3,6,16,15,1,18
Chennaiyin,6756,5,4,6,4,16,19,-3,18
Kerala Blast,6756,6,5,3,6,11,19,-8,18
NorthEast Un,6756,7,4,2,8,12,15,-3,14
FC Goa,6756,8,3,4,7,9,17,-8,13
Delhi Dynamo,6757,1,6,6,2,28,17,11,24
Mumbai City,6757,2,6,5,3,16,8,8,23
Kerala Blast,6757,3,6,4,4,19,18,1,22
Kolkata,6757,4,4,7,3,15,14,1,19
Chennaiyin,6757,5,4,6,4,15,18,-3,18
FC Pune City,6757,6,4,3,7,14,18,-4,15
FC Goa,6757,7,4,3,7,10,18,-8,15
NorthEast Un,6757,8,4,2,8,14,20,-6,14
Mumbai City,6758,1,7,4,3,18,9,9,25
Kerala Blast,6758,2,6,4,4,16,17,-1,22
NorthEast Un,6758,3,6,2,6,15,14,1,20
Kolkata,6758,4,4,7,3,16,14,2,19
Delhi Dynamo,6758,5,4,6,4,23,18,5,18
Chennaiyin,6758,6,4,5,5,18,23,-5,17
FC Pune City,6758,7,4,3,7,14,19,-5,15
FC Goa,6758,8,4,3,7,14,20,-6,15
Delhi Dynamo,6759,1,6,6,2,28,15,13,24
Mumbai City,6759,2,6,5,3,17,9,8,23
Kerala Blast,6759,3,5,5,4,12,14,-2,20
Kolkata,6759,4,4,7,3,16,16,0,19
NorthEast Un,6759,5,5,2,7,10,14,-4,17
FC Goa,6759,6,5,2,7,14,19,-5,17
FC Pune City,6759,7,4,4,6,13,16,-3,16
Chennaiyin,6759,8,3,5,6,15,22,-7,14
Mumbai City,6760,1,7,4,3,17,8,9,25
Delhi Dynamo,6760,2,6,5,3,27,18,9,23
Kolkata,6760,3,4,8,2,16,14,2,20
NorthEast Un,6760,4,5,3,6,14,14,0,18
FC Pune City,6760,5,5,3,6,14,16,-2,18
Chennaiyin,6760,6,4,5,5,16,19,-3,17
Kerala Blast,6760,7,4,5,5,11,16,-5,17
FC Goa,6760,8,3,3,8,9,19,-10,12
Mumbai City,6761,1,6,5,3,17,9,8,23
Kolkata,6761,2,5,6,3,18,15,3,21
Delhi Dynamo,6761,3,4,7,3,23,19,4,19
NorthEast Un,6761,4,5,3,6,13,14,-1,18
Chennaiyin,6761,5,4,6,4,16,18,-2,18
Kerala Blast,6761,6,5,3,6,14,16,-2,18
FC Pune City,6761,7,5,3,6,13,17,-4,18
FC Goa,6761,8,4,3,7,11,17,-6,15
Mumbai City,6762,1,6,5,3,17,9,8,23
Delhi Dynamo,6762,2,4,8,2,25,18,7,20
FC Pune City,6762,3,5,4,5,13,14,-1,19
Kolkata,6762,4,4,6,4,16,16,0,18
Chennaiyin,6762,5,4,6,4,16,19,-3,18
NorthEast Un,6762,6,4,5,5,11,11,0,17
Kerala Blast,6762,7,4,5,5,12,17,-5,17
FC Goa,6762,8,4,3,7,13,19,-6,15
Delhi Dynamo,6763,1,6,5,3,26,17,9,23
Mumbai City,6763,2,6,4,4,16,10,6,22
FC Pune City,6763,3,6,3,5,17,15,2,21
NorthEast Un,6763,4,6,2,6,16,13,3,20
Kerala Blast,6763,5,5,4,5,14,19,-5,19
Kolkata,6763,6,3,8,3,17,18,-1,17
FC Goa,6763,7,4,3,7,11,18,-7,15
Chennaiyin,6763,8,3,5,6,14,21,-7,14
Kerala Blast,6764,1,7,3,4,16,14,2,24
Mumbai City,6764,2,6,5,3,17,9,8,23
FC Goa,6764,3,6,2,6,15,17,-2,20
Delhi Dynamo,6764,4,4,7,3,24,18,6,19
NorthEast Un,6764,5,5,3,6,10,11,-1,18
Kolkata,6764,6,3,7,4,15,18,-3,16
FC Pune City,6764,7,4,4,6,14,18,-4,16
Chennaiyin,6764,8,3,5,6,13,19,-6,14
Mumbai City,6765,1,7,4,3,20,8,12,25
Kerala Blast,6765,2,6,4,4,15,15,0,22
Delhi Dynamo,6765,3,5,5,4,23,20,3,20
Kolkata,6765,4,4,7,3,18,17,1,19
FC Pune City,6765,5,5,3,6,15,18,-3,18
NorthEast Un,6765,6,5,2,7,12,15,-3,17
Chennaiyin,6765,7,4,5,5,16,21,-5,17
FC Goa,6765,8,4,2,8,13,18,-5,14
Mumbai City,6766,1,7,4,3,18,9,9,25
Delhi Dynamo,6766,2,6,5,3,26,16,10,23
Kerala Blast,6766,3,6,3,5,14,15,-1,21
Kolkata,6766,4,4,6,4,16,14,2,18
FC Pune City,6766,5,5,3,6,14,18,-4,18
Chennaiyin,6766,6,4,5,5,17,20,-3,17
FC Goa,6766,7,5,2,7,11,18,-7,17
NorthEast Un,6766,8,4,2,8,10,16,-6,14
Delhi Dynamo,6767,1,6,5,3,26,18,8,23
Mumbai City,6767,2,6,4,4,16,9,7,22
Kolkata,6767,3,4,7,3,15,15,0,19
FC Goa,6767,4,5,3,6,15,17,-2,18
Chennaiyin,6767,5,4,6,4,16,19,-3,18
NorthEast Un,6767,6,5,2,7,12,14,-2,17
Kerala Blast,6767,7,4,5,5,13,18,-5,17
FC Pune City,6767,8,4,4,6,16,19,-3,16
Mumbai City,6768,1,7,4,3,18,9,9,25
Kolkata,6768,2,6,6,2,20,12,8,24
Delhi Dynamo,6768,3,5,6,3,28,19,9,21
Kerala Blast,6768,4,6,3,5,14,17,-3,21
Chennaiyin,6768,5,4,6,4,17,18,-1,18
FC Pune City,6768,6,4,3,7,13,17,-4,15
NorthEast Un,6768,7,4,3,7,12,18,-6,15
FC Goa,6768,8,3,3,8,9,21,-12,12
Mumbai City,6769,1,7,4,3,20,9,11,25
Kolkata,6769,2,5,7,2,18,13,5,22
NorthEast Un,6769,3,6,2,6,15,12,3,20
FC Pune City,6769,4,5,4,5,13,14,-1,19
Delhi Dynamo,6769,5,4,6,4,23,21,2,18
Chennaiyin,6769,6,4,6,4,16,19,-3,18
Kerala Blast,6769,7,4,3,7,11,21,-10,15
FC Goa,6769,8,3,4,7,10,17,-7,13
Mumbai City,6770,1,7,4,3,19,8,11,25
NorthEast Un,6770,2,6,3,5,15,13,2,21
Delhi Dynamo,6770,3,5,5,4,28,21,7,20
Kerala Blast,6770,4,5,4,5,12,18,-6,19
FC Pune City,6770,5,5,3,6,17,16,1,18
Kolkata,6770,6,4,6,4,16,18,-2,18
FC Goa,6770,7,5,2,7,12,19,-7,17
Chennaiyin,6770,8,3,5,6,15,21,-6,14
Mumbai City,6771,1,7,4,3,19,9,10,25
NorthEast Un,6771,2,6,3,5,15,10,5,21
Kolkata,6771,3,5,6,3,18,17,1,21
Kerala Blast,6771,4,5,4,5,12,16,-4,19
Chennaiyin,6771,5,4,6,4,17,18,-1,18
Delhi Dynamo,6771,6,4,5,5,22,21,1,17
FC Pune City,6771,7,4,4,6,13,16,-3,16
FC Goa,6771,8,4,2,8,10,19,-9,14
Delhi Dynamo,6772,1,6,6,2,26,17,9,24
Mumbai City,6772,2,6,4,4,16,9,7,22
Kolkata,6772,3,5,7,2,16,12,4,22
Chennaiyin,6772,4,4,6,4,19,20,-1,18
FC Pune City,6772,5,5,3,6,14,17,-3,18
Kerala Blast,6772,6,5,3,6,11,16,-5,18
NorthEast Un,6772,7,4,3,7,11,15,-4,15
FC Goa,6772,8,3,4,7,12,19,-7,13
Mumbai City,6773,1,6,4,4,16,9,7,22
Delhi Dynamo,6773,2,5,6,3,22,15,7,21
Kerala Blast,6773,3,5,5,4,12,14,-2,20
Kolkata,6773,4,4,7,3,16,16,0,19
FC Pune City,6773,5,5,4,5,14,14,0,19
Chennaiyin,6773,6,4,6,4,15,17,-2,18
NorthEast Un,6773,7,5,2,7,10,13,-3,17
FC Goa,6773,8,3,4,7,9,16,-7,13
Mumbai City,6774,1,7,4,3,20,8,12,25
Delhi Dynamo,6774,2,5,6,3,23,19,4,21
Kolkata,6774,3,5,6,3,16,14,2,21
Kerala Blast,6774,4,5,4,5,10,14,-4,19
FC Pune City,6774,5,5,3,6,14,15,-1,18
NorthEast Un,6774,6,4,5,5,10,10,0,17
Chennaiyin,6774,7,3,6,5,14,19,-5,15
FC Goa,6774,8,4,2,8,10,18,-8,14
Mumbai City,6775,1,7,4,3,19,8,11,25
Kolkata,6775,2,6,6,2,17,13,4,24
Delhi Dynamo,6775,3,5,5,4,23,20,3,20
NorthEast Un,6775,4,5,4,5,13,10,3,19
FC Pune City,6775,5,5,3,6,13,15,-2,18
Kerala Blast,6775,6,4,4,6,11,17,-6,16
Chennaiyin,6775,7,3,6,5,13,19,-6,15
FC Goa,6775,8,4,2,8,10,17,-7,14
Mumbai City,6776,1,7,4,3,18,9,9,25
Kolkata,6776,2,6,6,2,18,14,4,24
Delhi Dynamo,6776,3,5,6,3,25,18,7,21
Kerala Blast,6776,4,4,5,5,11,16,-5,17
NorthEast Un,6776,5,4,4,6,12,13,-1,16
FC Pune City,6776,6,4,4,6,14,17,-3,16
Chennaiyin,6776,7,3,6,5,15,20,-5,15
FC Goa,6776,8,4,3,7,12,18,-6,15
Mumbai City,6777,1,7,4,3,19,9,10,25
Kerala Blast,6777,2,6,4,4,13,15,-2,22
Delhi Dynamo,6777,3,5,5,4,25,21,4,20
NorthEast Un,6777,4,6,2,6,12,10,2,20
Kolkata,6777,5,4,6,4,19,18,1,18
Chennaiyin,6777,6,4,5,5,14,18,-4,17
FC Pune City,6777,7,4,4,6,13,17,-4,16
FC Goa,6777,8,4,2,8,12,19,-7,14
Delhi Dynamo,6778,1,6,5,3,25,17,8,23
Mumbai City,6778,2,6,4,4,16,9,7,22
NorthEast Un,6778,3,6,2,6,12,12,0,20
Kolkata,6778,4,4,7,3,15,14,1,19
Kerala Blast,6778,5,5,4,5,12,15,-3,19
Chennaiyin,6778,6,4,6,4,15,17,-2,18
FC Pune City,6778,7,4,3,7,12,17,-5,15
FC Goa,6778,8,4,3,7,10,16,-6,15
Mumbai City,6779,1,7,4,3,18,9,9,25
FC Pune City,6779,2,6,3,5,16,16,0,21
Delhi Dynamo,6779,3,5,5,4,24,18,6,20
FC Goa,6779,4,6,2,6,11,14,-3,20
Kerala Blast,6779,5,5,3,6,14,19,-5,18
Chennaiyin,6779,6,4,5,5,16,18,-2,17
NorthEast Un,6779,7,5,2,7,12,15,-3,17
Kolkata,6779,8,3,6,5,14,16,-2,15
Mumbai City,6780,1,7,4,3,20,11,9,25
Kolkata,6780,2,5,7,2,18,15,3,22
Delhi Dynamo,6780,3,5,6,3,28,21,7,21
NorthEast Un,6780,4,5,3,6,13,13,0,18
Kerala Blast,6780,5,4,5,5,11,16,-5,17
FC Pune City,6780,6,4,4,6,12,15,-3,16
FC Goa,6780,7,4,4,6,15,20,-5,16
Chennaiyin,6780,8,3,5,6,16,22,-6,14
Mumbai City,6781,1,6,5,3,17,9,8,23
Kolkata,6781,2,5,7,2,21,17,4,22
Delhi Dynamo,6781,3,5,6,3,24,17,7,21
NorthEast Un,6781,4,6,2,6,12,10,2,20
Kerala Blast,6781,5,5,4,5,13,18,-5,19
FC Pune City,6781,6,4,4,6,14,17,-3,16
FC Goa,6781,7,4,3,7,14,18,-4,15
Chennaiyin,6781,8,3,5,6,13,22,-9,14
Delhi Dynamo,6782,1,7,5,2,28,16,12,26
Kerala Blast,6782,2,7,3,4,16,15,1,24
Mumbai City,6782,3,6,4,4,16,11,5,22
Kolkata,6782,4,4,7,3,18,18,0,19
NorthEast Un,6782,5,5,2,7,10,12,-2,17
FC Pune City,6782,6,4,3,7,14,18,-4,15
FC Goa,6782,7,4,3,7,14,20,-6,15
Chennaiyin,6782,8,3,5,6,14,20,-6,14
Delhi Dynamo,6783,1,6,5,3,26,17,9,23
Mumbai City,6783,2,6,4,4,18,11,7,22
FC Pune City,6783,3,6,3,5,18,15,3,21
NorthEast Un,6783,4,5,3,6,14,14,0,18
Kolkata,6783,5,4,6,4,14,15,-1,18
Kerala Blast,6783,6,5,3,6,14,22,-8,18
FC Goa,6783,7,5,2,7,14,16,-2,17
Chennaiyin,6783,8,3,6,5,14,22,-8,15
Delhi Dynamo,6784,1,6,6,2,26,17,9,24
Mumbai City,6784,2,6,5,3,18,10,8,23
Kolkata,6784,3,5,6,3,18,16,2,21
NorthEast Un,6784,4,6,2,6,12,11,1,20
FC Goa,6784,5,5,2,7,16,16,0,17
FC Pune City,6784,6,4,4,6,13,17,-4,16
Kerala Blast,6784,7,4,4,6,10,17,-7,16
Chennaiyin,6784,8,3,5,6,13,22,-9,14
Mumbai City,6785,1,6,5,3,17,9,8,23
NorthEast Un,6785,2,5,4,5,10,9,1,19
Kolkata,6785,3,4,7,3,14,14,0,19
FC Pune City,6785,4,5,4,5,13,14,-1,19
Kerala Blast,6785,5,5,4,5,11,14,-3,19
Delhi Dynamo,6785,6,4,6,4,22,18,4,18
Chennaiyin,6785,7,4,6,4,14,17,-3,18
FC Goa,6785,8,4,2,8,10,16,-6,14
Delhi Dynamo,6786,1,6,6,2,26,15,11,24
Mumbai City,6786,2,6,4,4,16,9,7,22
FC Pune City,6786,3,6,3,5,16,16,0,21
Kerala Blast,6786,4,5,4,5,11,15,-4,19
NorthEast Un,6786,5,5,3,6,13,12,1,18
Chennaiyin,6786,6,4,5,5,16,23,-7,17
Kolkata,6786,7,3,6,5,15,18,-3,15
FC Goa,6786,8,4,3,7,14,19,-5,15
Kolkata,6787,1,6,6,2,20,14,6,24
Mumbai City,6787,2,6,4,4,18,11,7,22
Delhi Dynamo,6787,3,5,6,3,26,19,7,21
NorthEast Un,6787,4,6,2,6,13,13,0,20
FC Pune City,6787,5,5,3,6,17,18,-1,18
Chennaiyin,6787,6,4,5,5,16,19,-3,17
FC Goa,6787,7,4,3,7,10,17,-7,15
Kerala Blast,6787,8,4,3,7,11,20,-9,15
Mumbai City,6788,1,7,4,3,20,9,11,25
Kerala Blast,6788,2,6,4,4,13,14,-1,22
Delhi Dynamo,6788,3,4,6,4,26,23,3,18
Chennaiyin,6788,4,4,6,4,15,18,-3,18
NorthEast Un,6788,5,5,2,7,11,12,-1,17
FC Pune City,6788,6,4,5,5,15,17,-2,17
Kolkata,6788,7,3,7,4,15,17,-2,16
FC Goa,6788,8,4,4,6,13,18,-5,16
Mumbai City,6789,1,7,4,3,17,8,9,25
Kolkata,6789,2,5,7,2,18,13,5,22
NorthEast Un,6789,3,6,3,5,14,10,4,21
FC Pune City,6789,4,5,4,5,14,15,-1,19
Delhi Dynamo,6789,5,4,5,5,22,19,3,17
FC Goa,6789,6,5,2,7,11,18,-7,17
Kerala Blast,6789,7,4,4,6,10,16,-6,16
Chennaiyin,6789,8,3,5,6,13,20,-7,14
Mumbai City,6790,1,7,4,3,18,8,10,25
Kerala Blast,6790,2,6,4,4,14,15,-1,22
Chennaiyin,6790,3,5,5,4,18,20,-2,20
NorthEast Un,6790,4,5,3,6,13,11,2,18
FC Pune City,6790,5,5,3,6,18,17,1,18
Delhi Dynamo,6790,6,4,5,5,23,22,1,17
FC Goa,6790,7,5,2,7,15,20,-5,17
Kolkata,6790,8,3,6,5,16,22,-6,15
Kerala Blast,6791,1,7,3,4,18,16,2,24
Mumbai City,6791,2,6,5,3,16,8,8,23
Delhi Dynamo,6791,3,4,8,2,26,19,7,20
FC Pune City,6791,4,5,3,6,16,18,-2,18
Kolkata,6791,5,4,6,4,14,17,-3,18
NorthEast Un,6791,6,4,4,6,12,13,-1,16
FC Goa,6791,7,4,3,7,13,18,-5,15
Chennaiyin,6791,8,3,6,5,13,19,-6,15
Delhi Dynamo,6792,1,6,5,3,27,18,9,23
NorthEast Un,6792,2,7,2,5,15,11,4,23
Mumbai City,6792,3,6,4,4,16,9,7,22
FC Pune City,6792,4,6,3,5,18,18,0,21
Kolkata,6792,5,4,7,3,19,18,1,19
Chennaiyin,6792,6,3,6,5,15,20,-5,15
Kerala Blast,6792,7,4,3,7,11,18,-7,15
FC Goa,6792,8,3,4,7,13,22,-9,13
Delhi Dynamo,6793,1,6,5,3,25,17,8,23
Mumbai City,6793,2,6,4,4,17,10,7,22
Kolkata,6793,3,4,7,3,16,14,2,19
FC Pune City,6793,4,5,4,5,15,16,-1,19
Kerala Blast,6793,5,4,6,4,11,15,-4,18
Chennaiyin,6793,6,4,5,5,16,21,-5,17
FC Goa,6793,7,5,2,7,13,18,-5,17
NorthEast Un,6793,8,4,3,7,11,13,-2,15
Mumbai City,6794,1,6,4,4,16,9,7,22
Delhi Dynamo,6794,2,5,6,3,24,17,7,21
FC Pune City,6794,3,6,3,5,16,14,2,21
FC Goa,6794,4,6,2,6,13,15,-2,20
Kolkata,6794,5,4,6,4,16,17,-1,18
Chennaiyin,6794,6,4,5,5,15,19,-4,17
NorthEast Un,6794,7,4,4,6,11,12,-1,16
Kerala Blast,6794,8,4,4,6,11,19,-8,16
Mumbai City,6795,1,6,5,3,16,8,8,23
Kerala Blast,6795,2,6,4,4,13,14,-1,22
Delhi Dynamo,6795,3,5,6,3,26,18,8,21
Kolkata,6795,4,4,7,3,15,14,1,19
Chennaiyin,6795,5,4,6,4,14,17,-3,18
NorthEast Un,6795,6,5,2,7,13,15,-2,17
FC Pune City,6795,7,4,4,6,12,15,-3,16
FC Goa,6795,8,3,4,7,10,18,-8,13
Mumbai City,6796,1,7,4,3,17,8,9,25
NorthEast Un,6796,2,6,2,6,12,11,1,20
Kerala Blast,6796,3,5,5,4,13,16,-3,20
FC Pune City,6796,4,5,4,5,18,18,0,19
FC Goa,6796,5,5,3,6,16,20,-4,18
Delhi Dynamo,6796,6,4,5,5,24,20,4,17
Kolkata,6796,7,3,8,3,17,18,-1,17
Chennaiyin,6796,8,3,5,6,16,22,-6,14
NorthEast Un,6797,1,7,2,5,13,10,3,23
Mumbai City,6797,2,6,4,4,18,11,7,22
Delhi Dynamo,6797,3,5,5,4,24,18,6,20
Kolkata,6797,4,4,8,2,16,14,2,20
Chennaiyin,6797,5,4,5,5,17,20,-3,17
Kerala Blast,6797,6,4,5,5,11,16,-5,17
FC Pune City,6797,7,4,4,6,13,16,-3,16
FC Goa,6797,8,4,3,7,11,18,-7,15
Mumbai City,6798,1,6,5,3,18,10,8,23
Kerala Blast,6798,2,6,4,4,13,14,-1,22
Delhi Dynamo,6798,3,5,6,3,26,20,6,21
NorthEast Un,6798,4,6,3,5,14,10,4,21
FC Pune City,6798,5,5,3,6,14,16,-2,18
Chennaiyin,6798,6,4,5,5,14,19,-5,17
Kolkata,6798,7,3,6,5,14,17,-3,15
FC Goa,6798,8,4,2,8,12,19,-7,14
Mumbai City,6799,1,7,4,3,17,8,9,25
Delhi Dynamo,6799,2,6,5,3,26,17,9,23
FC Pune City,6799,3,5,4,5,16,15,1,19
Kolkata,6799,4,3,9,2,15,14,1,18
Kerala Blast,6799,5,4,5,5,13,20,-7,17
NorthEast Un,6799,6,4,4,6,13,14,-1,16
Chennaiyin,6799,7,3,7,4,15,19,-4,16
FC Goa,6799,8,3,4,7,9,17,-8,13
Delhi Dynamo,6800,1,5,7,2,25,17,8,22
Mumbai City,6800,2,6,4,4,17,10,7,22
Kerala Blast,6800,3,6,3,5,13,16,-3,21
Kolkata,6800,4,4,6,4,16,16,0,18
FC Pune City,6800,5,5,3,6,15,17,-2,18
FC Goa,6800,6,5,3,6,12,15,-3,18
Chennaiyin,6800,7,4,5,5,15,19,-4,17
NorthEast Un,6800,8,4,3,7,11,14,-3,15
Mumbai City,6801,1,6,5,3,17,9,8,23
Delhi Dynamo,6801,2,5,6,3,26,19,7,21
Kolkata,6801,3,5,6,3,16,14,2,21
FC Pune City,6801,4,5,4,5,15,16,-1,19
NorthEast Un,6801,5,5,3,6,10,12,-2,18
Kerala Blast,6801,6,4,5,5,10,15,-5,17
FC Goa,6801,7,4,3,7,12,16,-4,15
Chennaiyin,6801,8,3,6,5,13,18,-5,15
Delhi Dynamo,6802,1,6,5,3,24,19,5,23
Mumbai City,6802,2,6,4,4,16,9,7,22
NorthEast Un,6802,3,6,3,5,15,10,5,21
Kerala Blast,6802,4,5,4,5,10,14,-4,19
FC Pune City,6802,5,5,3,6,13,15,-2,18
Chennaiyin,6802,6,4,6,4,16,19,-3,18
Kolkata,6802,7,3,7,4,15,16,-1,16
FC Goa,6802,8,4,2,8,13,20,-7,14
Mumbai City,6803,1,7,4,3,18,9,9,25
FC Pune City,6803,2,6,3,5,14,14,0,21
NorthEast Un,6803,3,6,2,6,12,12,0,20
Delhi Dynamo,6803,4,4,6,4,22,17,5,18
Kolkata,6803,5,4,6,4,15,15,0,18
FC Goa,6803,6,5,3,6,11,14,-3,18
Chennaiyin,6803,7,4,5,5,16,20,-4,17
Kerala Blast,6803,8,4,3,7,10,17,-7,15
Kolkata,6804,1,6,6,2,21,16,5,24
Delhi Dynamo,6804,2,6,5,3,28,19,9,23
Mumbai City,6804,3,6,4,4,17,11,6,22
Kerala Blast,6804,4,5,4,5,12,16,-4,19
NorthEast Un,6804,5,5,2,7,11,12,-1,17
Chennaiyin,6804,6,4,5,5,15,20,-5,17
FC Pune City,6804,7,4,4,6,15,18,-3,16
FC Goa,6804,8,4,2,8,14,21,-7,14
Delhi Dynamo,6805,1,6,6,2,26,17,9,24
Mumbai City,6805,2,6,4,4,18,11,7,22
Kolkata,6805,3,5,6,3,17,15,2,21
NorthEast Un,6805,4,5,4,5,13,12,1,19
Kerala Blast,6805,5,5,4,5,12,15,-3,19
FC Pune City,6805,6,4,4,6,13,17,-4,16
Chennaiyin,6805,7,3,6,5,15,20,-5,15
FC Goa,6805,8,4,2,8,10,17,-7,14
Mumbai City,6806,1,7,4,3,18,9,9,25
Kerala Blast,6806,2,6,4,4,14,14,0,22
Delhi Dynamo,6806,3,5,5,4,26,19,7,20
Kolkata,6806,4,4,7,3,15,14,1,19
Chennaiyin,6806,5,4,6,4,14,17,-3,18
NorthEast Un,6806,6,5,2,7,11,12,-1,17
FC Pune City,6806,7,4,3,7,12,17,-5,15
FC Goa,6806,8,4,3,7,10,18,-8,15
Delhi Dynamo,6807,1,6,5,3,24,16,8,23
Mumbai City,6807,2,6,4,4,16,9,7,22
NorthEast Un,6807,3,6,3,5,16,14,2,21
Kolkata,6807,4,4,7,3,17,17,0,19
FC Pune City,6807,5,5,3,6,17,20,-3,18
FC Goa,6807,6,5,2,7,14,16,-2,17
Kerala Blast,6807,7,4,5,5,14,19,-5,17
Chennaiyin,6807,8,3,5,6,15,22,-7,14
Delhi Dynamo,6808,1,6,5,3,24,17,7,23
Mumbai City,6808,2,6,4,4,17,10,7,22
NorthEast Un,6808,3,6,3,5,14,9,5,21
Kerala Blast,6808,4,5,5,4,14,15,-1,20
Kolkata,6808,5,4,7,3,17,18,-1,19
Chennaiyin,6808,6,4,5,5,14,20,-6,17
FC Pune City,6808,7,4,4,6,14,17,-3,16
FC Goa,6808,8,3,3,8,9,17,-8,12
Mumbai City,6809,1,6,5,3,16,8,8,23
Delhi Dynamo,6809,2,5,6,3,23,17,6,21
Kolkata,6809,3,5,6,3,20,17,3,21
Kerala Blast,6809,4,6,3,5,13,19,-6,21
Chennaiyin,6809,5,4,6,4,15,18,-3,18
NorthEast Un,6809,6,5,2,7,12,12,0,17
FC Pune City,6809,7,4,3,7,14,18,-4,15
FC Goa,6809,8,4,3,7,13,17,-4,15
Mumbai City,6810,1,7,4,3,18,9,9,25
Delhi Dynamo,6810,2,5,5,4,23,18,5,20
Kolkata,6810,3,4,8,2,15,12,3,20
NorthEast Un,6810,4,6,2,6,12,11,1,20
Kerala Blast,6810,5,5,4,5,11,15,-4,19
FC Pune City,6810,6,4,5,5,12,14,-2,17
FC Goa,6810,7,4,3,7,12,17,-5,15
Chennaiyin,6810,8,3,5,6,15,22,-7,14
Mumbai City,6811,1,6,5,3,17,9,8,23
NorthEast Un,6811,2,7,2,5,14,9,5,23
Kolkata,6811,3,5,6,3,18,17,1,21
FC Goa,6811,4,6,2,6,14,14,0,20
Delhi Dynamo,6811,5,4,6,4,22,17,5,18
FC Pune City,6811,6,5,3,6,15,17,-2,18
Kerala Blast,6811,7,4,3,7,10,19,-9,15
Chennaiyin,6811,8,3,5,6,13,21,-8,14
Mumbai City,6812,1,6,4,4,17,10,7,22
Kerala Blast,6812,2,6,3,5,17,19,-2,21
Delhi Dynamo,6812,3,5,5,4,23,17,6,20
FC Goa,6812,4,6,2,6,14,16,-2,20
Kolkata,6812,5,4,7,3,21,16,5,19
NorthEast Un,6812,6,5,3,6,12,12,0,18
FC Pune City,6812,7,4,4,6,14,22,-8,16
Chennaiyin,6812,8,3,6,5,15,21,-6,15
Mumbai City,6813,1,7,4,3,18,8,10,25
Kerala Blast,6813,2,6,4,4,15,15,0,22
Delhi Dynamo,6813,3,5,6,3,25,17,8,21
Kolkata,6813,4,5,6,3,18,16,2,21
NorthEast Un,6813,5,4,5,5,11,11,0,17
Chennaiyin,6813,6,3,7,4,16,20,-4,16
FC Pune City,6813,7,4,3,7,14,20,-6,15
FC Goa,6813,8,3,3,8,11,21,-10,12
Kerala Blast,6814,1,7,3,4,18,15,3,24
Mumbai City,6814,2,6,5,3,16,8,8,23
Delhi Dynamo,6814,3,4,7,3,24,19,5,19
NorthEast Un,6814,4,5,3,6,13,12,1,18
Kolkata,6814,5,4,6,4,19,19,0,18
FC Goa,6814,6,5,3,6,15,18,-3,18
Chennaiyin,6814,7,3,6,5,14,21,-7,15
FC Pune City,6814,7,4,3,7,14,21,-7,15
Delhi Dynamo,6815,1,6,6,2,26,16,10,24
Mumbai City,6815,2,6,5,3,18,10,8,23
Kolkata,6815,3,4,7,3,16,14,2,19
FC Pune City,6815,4,5,4,5,14,15,-1,19
Chennaiyin,6815,5,4,6,4,14,17,-3,18
Kerala Blast,6815,6,5,3,6,11,16,-5,18
FC Goa,6815,7,4,3,7,9,16,-7,15
NorthEast Un,6815,8,4,2,8,9,13,-4,14
Mumbai City,6816,1,7,4,3,17,8,9,25
NorthEast Un,6816,2,6,3,5,14,9,5,21
Kolkata,6816,3,4,7,3,14,14,0,19
Kerala Blast,6816,4,5,4,5,11,14,-3,19
Delhi Dynamo,6816,5,4,6,4,22,20,2,18
FC Pune City,6816,6,5,3,6,14,16,-2,18
FC Goa,6816,7,4,3,7,13,17,-4,15
Chennaiyin,6816,8,3,6,5,14,21,-7,15
Mumbai City,6817,1,6,5,3,16,8,8,23
NorthEast Un,6817,2,7,2,5,16,11,5,23
Kolkata,6817,3,5,6,3,21,16,5,21
Delhi Dynamo,6817,4,4,6,4,24,20,4,18
FC Pune City,6817,5,5,3,6,15,20,-5,18
Kerala Blast,6817,6,5,3,6,13,19,-6,18
FC Goa,6817,7,5,2,7,13,18,-5,17
Chennaiyin,6817,8,3,5,6,15,21,-6,14
Mumbai City,6818,1,6,5,3,16,8,8,23
Kolkata,6818,2,5,6,3,17,15,2,21
FC Goa,6818,3,6,2,6,14,17,-3,20
Delhi Dynamo,6818,4,4,7,3,23,17,6,19
Kerala Blast,6818,5,5,4,5,12,15,-3,19
Chennaiyin,6818,6,4,5,5,16,19,-3,17
NorthEast Un,6818,7,4,4,6,10,12,-2,16
FC Pune City,6818,8,4,3,7,12,17,-5,15
Delhi Dynamo,6819,1,6,5,3,28,15,13,23
Mumbai City,6819,2,6,4,4,16,9,7,22
FC Pune City,6819,3,5,4,5,14,15,-1,19
Kerala Blast,6819,4,5,4,5,12,16,-4,19
Kolkata,6819,5,4,6,4,14,15,-1,18
NorthEast Un,6819,6,5,2,7,11,12,-1,17
Chennaiyin,6819,7,4,5,5,15,19,-4,17
FC Goa,6819,8,5,2,7,12,21,-9,17
Mumbai City,6820,1,7,4,3,17,8,9,25
NorthEast Un,6820,2,7,2,5,14,11,3,23
Kolkata,6820,3,5,6,3,16,15,1,21
Delhi Dynamo,6820,4,5,5,4,24,17,7,20
FC Pune City,6820,5,5,4,5,16,16,0,19
Chennaiyin,6820,6,4,5,5,15,18,-3,17
Kerala Blast,6820,7,4,4,6,12,18,-6,16
FC Goa,6820,8,3,2,9,9,20,-11,11
Delhi Dynamo,6821,1,6,6,2,29,18,11,24
Mumbai City,6821,2,6,4,4,17,10,7,22
Kolkata,6821,3,5,6,3,18,14,4,21
NorthEast Un,6821,4,5,3,6,13,15,-2,18
Chennaiyin,6821,5,3,7,4,16,20,-4,16
FC Pune City,6821,6,4,4,6,14,18,-4,16
FC Goa,6821,7,4,4,6,13,18,-5,16
Kerala Blast,6821,8,4,4,6,11,18,-7,16
Mumbai City,6822,1,6,5,3,17,9,8,23
Delhi Dynamo,6822,2,5,6,3,24,17,7,21
NorthEast Un,6822,3,6,2,6,15,13,2,20
Chennaiyin,6822,4,5,5,4,18,20,-2,20
FC Pune City,6822,5,5,4,5,15,16,-1,19
Kolkata,6822,6,3,8,3,16,16,0,17
Kerala Blast,6822,7,4,5,5,12,17,-5,17
FC Goa,6822,8,3,3,8,10,19,-9,12
Mumbai City,6823,1,7,4,3,19,9,10,25
FC Pune City,6823,2,6,3,5,20,15,5,21
Kolkata,6823,3,4,7,3,18,18,0,19
NorthEast Un,6823,4,5,3,6,12,12,0,18
Chennaiyin,6823,5,4,6,4,16,19,-3,18
Kerala Blast,6823,6,5,3,6,11,20,-9,18
Delhi Dynamo,6823,7,4,5,5,25,22,3,17
FC Goa,6823,8,4,3,7,13,19,-6,15
Delhi Dynamo,6824,1,5,7,2,25,17,8,22
Mumbai City,6824,2,6,4,4,17,10,7,22
Kolkata,6824,3,5,7,2,19,13,6,22
Kerala Blast,6824,4,5,4,5,11,15,-4,19
NorthEast Un,6824,5,5,3,6,13,12,1,18
FC Pune City,6824,6,5,3,6,13,17,-4,18
FC Goa,6824,7,4,3,7,11,17,-6,15
Chennaiyin,6824,8,3,5,6,14,22,-8,14
Mumbai City,6825,1,7,4,3,17,8,9,25
Kolkata,6825,2,5,7,2,19,14,5,22
Delhi Dynamo,6825,3,5,5,4,23,16,7,20
Kerala Blast,6825,4,5,5,4,13,16,-3,20
NorthEast Un,6825,5,5,2,7,13,15,-2,17
Chennaiyin,6825,6,4,5,5,17,22,-5,17
FC Pune City,6825,7,4,4,6,13,16,-3,16
FC Goa,6825,8,4,2,8,12,20,-8,14
Delhi Dynamo,6826,1,7,5,2,27,14,13,26
Mumbai City,6826,2,6,4,4,16,9,7,22
Kolkata,6826,3,5,6,3,15,13,2,21
Chennaiyin,6826,4,4,6,4,18,20,-2,18
Kerala Blast,6826,5,5,3,6,11,15,-4,18
NorthEast Un,6826,6,5,2,7,10,14,-4,17
FC Pune City,6826,7,4,3,7,12,17,-5,15
FC Goa,6826,8,4,3,7,12,19,-7,15
Mumbai City,6827,1,6,4,4,16,10,6,22
Delhi Dynamo,6827,2,5,5,4,25,18,7,20
NorthEast Un,6827,3,5,4,5,11,10,1,19
FC Pune City,6827,4,5,4,5,15,15,0,19
Kerala Blast,6827,5,5,4,5,11,16,-5,19
Chennaiyin,6827,6,4,6,4,15,18,-3,18
Kolkata,6827,7,3,8,3,16,16,0,17
FC Goa,6827,8,4,3,7,14,20,-6,15
Mumbai City,6828,1,7,4,3,17,8,9,25
Chennaiyin,6828,2,5,5,4,16,18,-2,20
FC Pune City,6828,3,5,4,5,14,15,-1,19
Kerala Blast,6828,4,5,4,5,11,16,-5,19
Delhi Dynamo,6828,5,4,6,4,23,19,4,18
Kolkata,6828,6,4,6,4,15,16,-1,18
FC Goa,6828,7,5,2,7,14,16,-2,17
NorthEast Un,6828,8,4,3,7,11,13,-2,15
Delhi Dynamo,6829,1,7,5,2,24,14,10,26
Mumbai City,6829,2,6,4,4,16,9,7,22
Kolkata,6829,3,4,7,3,16,15,1,19
Kerala Blast,6829,4,5,4,5,14,15,-1,19
FC Pune City,6829,5,5,3,6,14,19,-5,18
NorthEast Un,6829,6,4,4,6,10,11,-1,16
Chennaiyin,6829,7,3,6,5,14,19,-5,15
FC Goa,6829,8,4,3,7,9,15,-6,15
Mumbai City,6830,1,7,4,3,19,9,10,25
Kerala Blast,6830,2,6,3,5,12,15,-3,21
Delhi Dynamo,6830,3,5,5,4,24,22,2,20
Kolkata,6830,4,4,7,3,16,14,2,19
FC Pune City,6830,5,5,3,6,13,16,-3,18
NorthEast Un,6830,6,5,2,7,13,11,2,17
Chennaiyin,6830,7,4,5,5,14,19,-5,17
FC Goa,6830,8,4,3,7,12,17,-5,15
Kerala Blast,6831,1,7,3,4,14,13,1,24
Delhi Dynamo,6831,2,6,5,3,23,15,8,23
Mumbai City,6831,3,6,4,4,16,9,7,22
FC Goa,6831,4,6,2,6,12,15,-3,20
NorthEast Un,6831,5,5,2,7,10,12,-2,17
Kolkata,6831,6,3,7,4,15,16,-1,16
FC Pune City,6831,7,4,4,6,13,17,-4,16
Chennaiyin,6831,8,3,5,6,13,19,-6,14
Delhi Dynamo,6832,1,6,6,2,27,16,11,24
Mumbai City,6832,2,6,4,4,17,10,7,22
Kolkata,6832,3,5,6,3,18,16,2,21
FC Pune City,6832,4,5,3,6,14,16,-2,18
Kerala Blast,6832,5,5,3,6,11,15,-4,18
FC Goa,6832,6,5,2,7,16,21,-5,17
NorthEast Un,6832,7,4,4,6,10,12,-2,16
Chennaiyin,6832,8,3,6,5,15,22,-7,15
Mumbai City,6833,1,6,5,3,17,9,8,23
Delhi Dynamo,6833,2,5,7,2,25,17,8,22
NorthEast Un,6833,3,5,3,6,11,11,0,18
Kolkata,6833,4,4,6,4,17,18,-1,18
FC Pune City,6833,5,5,3,6,15,17,-2,18
Kerala Blast,6833,6,5,3,6,13,18,-5,18
FC Goa,6833,7,5,2,7,14,16,-2,17
Chennaiyin,6833,8,4,5,5,14,20,-6,17
Mumbai City,6834,1,7,4,3,18,8,10,25
NorthEast Un,6834,2,6,3,5,13,11,2,21
Kerala Blast,6834,3,6,3,5,14,17,-3,21
Delhi Dynamo,6834,4,4,7,3,23,18,5,19
Kolkata,6834,5,4,6,4,19,16,3,18
FC Goa,6834,6,5,3,6,15,16,-1,18
FC Pune City,6834,7,4,3,7,13,20,-7,15
Chennaiyin,6834,8,3,5,6,13,22,-9,14
Mumbai City,6835,1,7,4,3,17,8,9,25
Delhi Dynamo,6835,2,5,5,4,27,18,9,20
Kerala Blast,6835,3,5,5,4,11,14,-3,20
Kolkata,6835,4,4,7,3,15,13,2,19
NorthEast Un,6835,5,5,3,6,12,12,0,18
FC Pune City,6835,6,5,3,6,14,16,-2,18
Chennaiyin,6835,7,4,6,4,14,17,-3,18
FC Goa,6835,8,3,3,8,8,20,-12,12
Mumbai City,6836,1,7,4,3,20,10,10,25
Delhi Dynamo,6836,2,6,5,3,27,19,8,23
Kolkata,6836,3,4,7,3,17,16,1,19
FC Pune City,6836,4,5,4,5,14,15,-1,19
NorthEast Un,6836,5,5,3,6,14,13,1,18
Kerala Blast,6836,6,4,5,5,12,17,-5,17
Chennaiyin,6836,7,3,6,5,14,20,-6,15
FC Goa,6836,8,3,4,7,10,18,-8,13
Mumbai City,6837,1,7,4,3,17,8,9,25
Delhi Dynamo,6837,2,6,5,3,24,16,8,23
Kerala Blast,6837,3,6,4,4,17,19,-2,22
Kolkata,6837,4,5,6,3,16,14,2,21
Chennaiyin,6837,5,4,6,4,17,18,-1,18
NorthEast Un,6837,6,4,4,6,14,15,-1,16
FC Pune City,6837,7,4,3,7,13,17,-4,15
FC Goa,6837,8,3,2,9,9,20,-11,11
Delhi Dynamo,6838,1,6,5,3,26,16,10,23
Mumbai City,6838,2,6,4,4,16,11,5,22
NorthEast Un,6838,3,6,2,6,11,10,1,20
Kolkata,6838,4,4,7,3,16,15,1,19
Chennaiyin,6838,5,4,6,4,16,19,-3,18
Kerala Blast,6838,6,5,3,6,11,15,-4,18
FC Pune City,6838,7,4,4,6,14,18,-4,16
FC Goa,6838,8,4,3,7,12,18,-6,15
Mumbai City,6839,1,6,4,4,18,12,6,22
Delhi Dynamo,6839,2,5,6,3,26,19,7,21
Kerala Blast,6839,3,6,3,5,15,17,-2,21
Kolkata,6839,4,4,8,2,20,18,2,20
FC Goa,6839,5,5,3,6,14,17,-3,18
Chennaiyin,6839,6,4,5,5,15,19,-4,17
FC Pune City,6839,7,4,4,6,16,20,-4,16
NorthEast Un,6839,8,4,3,7,11,13,-2,15
Mumbai City,6840,1,7,4,3,18,9,9,25
NorthEast Un,6840,2,7,2,5,13,9,4,23
Kolkata,6840,3,5,6,3,15,15,0,21
Delhi Dynamo,6840,4,5,5,4,25,19,6,20
Kerala Blast,6840,5,5,3,6,10,15,-5,18
FC Goa,6840,6,5,2,7,16,17,-1,17
FC Pune City,6840,7,4,3,7,12,16,-4,15
Chennaiyin,6840,8,3,5,6,13,22,-9,14
Mumbai City,6841,1,7,4,3,19,9,10,25
Delhi Dynamo,6841,2,6,5,3,27,19,8,23
NorthEast Un,6841,3,6,2,6,16,12,4,20
Kolkata,6841,4,4,8,2,16,13,3,20
FC Pune City,6841,5,5,3,6,13,16,-3,18
Kerala Blast,6841,6,4,4,6,9,18,-9,16
FC Goa,6841,7,4,3,7,11,18,-7,15
Chennaiyin,6841,8,3,5,6,14,20,-6,14
Mumbai City,6842,1,7,4,3,19,8,11,25
Delhi Dynamo,6842,2,6,5,3,25,18,7,23
Kolkata,6842,3,5,6,3,21,14,7,21
Kerala Blast,6842,4,5,4,5,12,17,-5,19
NorthEast Un,6842,5,5,2,7,12,13,-1,17
Chennaiyin,6842,6,4,5,5,15,20,-5,17
FC Pune City,6842,7,4,4,6,13,19,-6,16
FC Goa,6842,8,4,2,8,11,19,-8,14
Kolkata,6843,1,6,6,2,16,12,4,24
Delhi Dynamo,6843,2,5,7,2,28,19,9,22
Mumbai City,6843,3,6,4,4,17,11,6,22
Kerala Blast,6843,4,5,4,5,11,14,-3,19
NorthEast Un,6843,5,5,3,6,14,14,0,18
FC Pune City,6843,6,4,4,6,12,15,-3,16
Chennaiyin,6843,7,3,6,5,15,21,-6,15
FC Goa,6843,8,3,4,7,11,18,-7,13
Mumbai City,6844,1,7,4,3,19,8,11,25
Kerala Blast,6844,2,7,3,4,16,13,3,24
Delhi Dynamo,6844,3,6,5,3,26,19,7,23
Kolkata,6844,4,4,6,4,16,16,0,18
Chennaiyin,6844,5,4,5,5,16,19,-3,17
FC Goa,6844,6,5,2,7,12,17,-5,17
FC Pune City,6844,7,4,3,7,13,19,-6,15
NorthEast Un,6844,8,4,2,8,10,17,-7,14
Mumbai City,6845,1,6,5,3,18,10,8,23
Chennaiyin,6845,2,5,5,4,18,18,0,20
Kerala Blast,6845,3,5,5,4,13,14,-1,20
Delhi Dynamo,6845,4,4,7,3,26,20,6,19
Kolkata,6845,5,3,8,3,15,15,0,17
FC Goa,6845,6,5,2,7,12,19,-7,17
NorthEast Un,6845,7,4,4,6,11,12,-1,16
FC Pune City,6845,8,4,4,6,13,18,-5,16
Mumbai City,6846,1,7,4,3,20,9,11,25
FC Pune City,6846,2,6,3,5,15,14,1,21
Delhi Dynamo,6846,3,5,5,4,24,22,2,20
Kerala Blast,6846,4,5,4,5,12,17,-5,19
NorthEast Un,6846,5,5,2,7,14,12,2,17
Kolkata,6846,6,3,8,3,14,14,0,17
Chennaiyin,6846,7,4,5,5,14,19,-5,17
FC Goa,6846,8,4,3,7,10,16,-6,15
Mumbai City,6847,1,7,4,3,17,8,9,25
FC Pune City,6847,2,6,3,5,15,15,0,21
NorthEast Un,6847,3,6,2,6,13,12,1,20
Delhi Dynamo,6847,4,4,6,4,22,17,5,18
Kolkata,6847,5,4,6,4,17,16,1,18
FC Goa,6847,6,5,3,6,14,16,-2,18
Kerala Blast,6847,7,5,3,6,12,19,-7,18
Chennaiyin,6847,8,3,5,6,14,21,-7,14
Delhi Dynamo,6848,1,6,6,2,27,16,11,24
Kerala Blast,6848,2,7,3,4,13,14,-1,24
Mumbai City,6848,3,6,5,3,17,9,8,23
Kolkata,6848,4,4,6,4,17,17,0,18
FC Goa,6848,5,5,2,7,12,17,-5,17
NorthEast Un,6848,6,4,3,7,12,15,-3,15
Chennaiyin,6848,7,3,6,5,16,21,-5,15
FC Pune City,6848,8,4,3,7,13,18,-5,15
Delhi Dynamo,6849,1,7,5,2,27,17,10,26
Mumbai City,6849,2,6,4,4,17,10,7,22
FC Pune City,6849,3,6,3,5,19,16,3,21
Kolkata,6849,4,4,7,3,19,17,2,19
NorthEast Un,6849,5,5,3,6,13,13,0,18
Chennaiyin,6849,6,4,6,4,16,17,-1,18
Kerala Blast,6849,7,4,3,7,12,23,-11,15
FC Goa,6849,8,3,3,8,8,18,-10,12
Mumbai City,6850,1,7,4,3,21,9,12,25
Delhi Dynamo,6850,2,6,5,3,25,19,6,23
Kolkata,6850,3,4,8,2,15,12,3,20
Kerala Blast,6850,4,5,5,4,12,15,-3,20
NorthEast Un,6850,5,4,4,6,10,11,-1,16
Chennaiyin,6850,6,3,6,5,14,19,-5,15
FC Pune City,6850,7,4,3,7,13,18,-5,15
FC Goa,6850,8,4,3,7,10,17,-7,15
Delhi Dynamo,6851,1,6,5,3,28,19,9,23
Mumbai City,6851,2,6,4,4,18,11,7,22
Kolkata,6851,3,5,7,2,17,14,3,22
Kerala Blast,6851,4,5,4,5,11,15,-4,19
NorthEast Un,6851,5,5,3,6,11,11,0,18
FC Pune City,6851,6,4,5,5,12,14,-2,17
Chennaiyin,6851,7,3,6,5,13,19,-6,15
FC Goa,6851,8,4,2,8,12,19,-7,14
Delhi Dynamo,6852,1,7,5,2,28,15,13,26
Mumbai City,6852,2,6,4,4,17,10,7,22
NorthEast Un,6852,3,6,2,6,12,12,0,20
FC Pune City,6852,4,5,4,5,15,15,0,19
Kerala Blast,6852,5,5,3,6,11,17,-6,18
FC Goa,6852,6,5,2,7,13,18,-5,17
Kolkata,6852,7,3,7,4,16,18,-2,16
Chennaiyin,6852,8,3,5,6,14,21,-7,14
Delhi Dynamo,6853,1,6,6,2,26,16,10,24
Mumbai City,6853,2,6,5,3,17,9,8,23
Kerala Blast,6853,3,6,3,5,14,15,-1,21
Kolkata,6853,4,4,6,4,16,16,0,18
NorthEast Un,6853,5,5,3,6,12,12,0,18
FC Pune City,6853,6,5,3,6,15,18,-3,18
Chennaiyin,6853,7,3,6,5,14,21,-7,15
FC Goa,6853,8,4,2,8,12,19,-7,14
Mumbai City,6854,1,7,4,3,18,8,10,25
Kolkata,6854,2,5,7,2,16,13,3,22
Delhi Dynamo,6854,3,5,6,3,25,17,8,21
FC Pune City,6854,4,5,4,5,13,14,-1,19
Chennaiyin,6854,5,4,6,4,19,21,-2,18
NorthEast Un,6854,6,5,3,6,12,14,-2,18
Kerala Blast,6854,7,4,3,7,9,16,-7,15
FC Goa,6854,8,3,3,8,12,21,-9,12
Mumbai City,6855,1,6,5,3,16,8,8,23
Delhi Dynamo,6855,2,5,7,2,23,14,9,22
Kolkata,6855,3,5,7,2,16,13,3,22
Kerala Blast,6855,4,5,4,5,12,16,-4,19
Chennaiyin,6855,5,4,6,4,15,18,-3,18
FC Pune City,6855,6,4,5,5,14,16,-2,17
NorthEast Un,6855,7,4,3,7,10,13,-3,15
FC Goa,6855,8,3,3,8,9,17,-8,12
Mumbai City,6856,1,7,4,3,18,9,9,25
Kerala Blast,6856,2,6,4,4,14,15,-1,22
Delhi Dynamo,6856,3,5,5,4,23,19,4,20
Kolkata,6856,4,4,7,3,16,16,0,19
FC Pune City,6856,5,5,3,6,15,17,-2,18
NorthEast Un,6856,6,5,2,7,12,12,0,17
Chennaiyin,6856,7,4,5,5,15,19,-4,17
FC Goa,6856,8,4,2,8,11,17,-6,14
Mumbai City,6857,1,7,4,3,19,8,11,25
Kerala Blast,6857,2,6,4,4,14,15,-1,22
NorthEast Un,6857,3,6,3,5,14,11,3,21
Kolkata,6857,4,5,6,3,17,16,1,21
Delhi Dynamo,6857,5,5,5,4,23,20,3,20
Chennaiyin,6857,6,4,5,5,18,20,-2,17
FC Pune City,6857,7,4,3,7,14,18,-4,15
FC Goa,6857,8,3,2,9,11,22,-11,11
Mumbai City,6858,1,6,5,3,19,11,8,23
Delhi Dynamo,6858,2,5,6,3,26,19,7,21
Kerala Blast,6858,3,5,5,4,12,15,-3,20
NorthEast Un,6858,4,5,4,5,13,12,1,19
FC Pune City,6858,5,5,4,5,14,14,0,19
Kolkata,6858,6,3,7,4,16,18,-2,16
Chennaiyin,6858,7,3,6,5,16,21,-5,15
FC Goa,6858,8,4,3,7,11,17,-6,15
Mumbai City,6859,1,6,4,4,17,10,7,22
NorthEast Un,6859,2,6,3,5,17,10,7,21
Delhi Dynamo,6859,3,5,6,3,25,21,4,21
Kolkata,6859,4,4,7,3,16,16,0,19
Kerala Blast,6859,5,5,4,5,11,16,-5,19
FC Pune City,6859,6,4,4,6,13,16,-3,16
FC Goa,6859,7,4,4,6,12,16,-4,16
Chennaiyin,6859,8,3,6,5,13,19,-6,15
Delhi Dynamo,6860,1,6,6,2,27,14,13,24
Mumbai City,6860,2,6,4,4,16,10,6,22
Kolkata,6860,3,5,6,3,17,15,2,21
Chennaiyin,6860,4,5,5,4,16,18,-2,20
FC Pune City,6860,5,5,3,6,15,16,-1,18
NorthEast Un,6860,6,5,2,7,11,15,-4,17
FC Goa,6860,7,4,3,7,10,16,-6,15
Kerala Blast,6860,8,4,3,7,11,19,-8,15
Mumbai City,6861,1,7,4,3,18,8,10,25
Kolkata,6861,2,5,6,3,17,13,4,21
Kerala Blast,6861,3,6,3,5,12,15,-3,21
Chennaiyin,6861,4,5,5,4,18,18,0,20
Delhi Dynamo,6861,5,4,6,4,24,20,4,18
FC Pune City,6861,6,5,3,6,14,17,-3,18
NorthEast Un,6861,7,5,2,7,12,15,-3,17
FC Goa,6861,8,3,3,8,10,19,-9,12
Mumbai City,6862,1,6,5,3,17,9,8,23
FC Goa,6862,2,6,2,6,18,17,1,20
Delhi Dynamo,6862,3,4,7,3,26,20,6,19
Kolkata,6862,4,4,7,3,18,20,-2,19
Kerala Blast,6862,5,4,6,4,11,15,-4,18
Chennaiyin,6862,6,4,5,5,17,21,-4,17
NorthEast Un,6862,7,4,4,6,12,14,-2,16
FC Pune City,6862,8,4,4,6,16,19,-3,16
Mumbai City,6863,1,7,4,3,17,8,9,25
Kolkata,6863,2,6,6,2,18,12,6,24
Delhi Dynamo,6863,3,5,6,3,24,16,8,21
Kerala Blast,6863,4,6,3,5,13,15,-2,21
Chennaiyin,6863,5,4,6,4,16,19,-3,18
NorthEast Un,6863,6,4,3,7,10,12,-2,15
FC Pune City,6863,7,4,3,7,13,20,-7,15
FC Goa,6863,8,3,3,8,10,19,-9,12
Mumbai City,6864,1,7,4,3,19,8,11,25
Kolkata,6864,2,5,6,3,17,14,3,21
Delhi Dynamo,6864,3,4,7,3,23,19,4,19
Kerala Blast,6864,4,5,4,5,14,15,-1,19
FC Goa,6864,5,5,3,6,11,15,-4,18
Chennaiyin,6864,6,4,5,5,14,18,-4,17
FC Pune City,6864,7,4,4,6,12,16,-4,16
NorthEast Un,6864,8,4,3,7,10,15,-5,15
Mumbai City,6865,1,7,4,3,18,8,10,25
Delhi Dynamo,6865,2,5,5,4,24,17,7,20
Kolkata,6865,3,4,8,2,16,13,3,20
Chennaiyin,6865,4,4,6,4,15,18,-3,18
NorthEast Un,6865,5,5,2,7,13,13,0,17
FC Pune City,6865,6,4,5,5,12,14,-2,17
FC Goa,6865,7,4,4,6,11,16,-5,16
Kerala Blast,6865,8,4,4,6,9,19,-10,16
Mumbai City,6866,1,7,4,3,18,8,10,25
Kolkata,6866,2,4,8,2,20,14,6,20
Delhi Dynamo,6866,3,4,7,3,22,17,5,19
NorthEast Un,6866,4,5,4,5,11,10,1,19
FC Pune City,6866,5,5,4,5,17,18,-1,19
FC Goa,6866,6,4,4,6,11,16,-5,16
Kerala Blast,6866,7,4,4,6,13,23,-10,16
Chennaiyin,6866,8,3,5,6,13,19,-6,14
Mumbai City,6867,1,6,4,4,16,9,7,22
Delhi Dynamo,6867,2,5,6,3,23,17,6,21
FC Pune City,6867,3,5,4,5,16,16,0,19
NorthEast Un,6867,4,5,3,6,11,12,-1,18
Chennaiyin,6867,5,4,6,4,16,18,-2,18
FC Goa,6867,6,5,3,6,12,15,-3,18
Kerala Blast,6867,7,5,3,6,12,17,-5,18
Kolkata,6867,8,3,7,4,16,18,-2,16
Mumbai City,6868,1,7,4,3,17,8,9,25
Kolkata,6868,2,4,8,2,17,13,4,20
NorthEast Un,6868,3,6,2,6,12,11,1,20
FC Pune City,6868,4,5,4,5,14,15,-1,19
Delhi Dynamo,6868,5,4,6,4,22,17,5,18
Chennaiyin,6868,6,4,6,4,16,18,-2,18
Kerala Blast,6868,7,4,4,6,9,16,-7,16
FC Goa,6868,8,3,4,7,10,19,-9,13
Mumbai City,6869,1,6,4,4,16,11,5,22
Delhi Dynamo,6869,2,5,5,4,24,17,7,20
NorthEast Un,6869,3,5,4,5,11,9,2,19
Kolkata,6869,4,4,7,3,16,15,1,19
FC Pune City,6869,5,5,4,5,14,15,-1,19
Kerala Blast,6869,6,4,6,4,10,14,-4,18
FC Goa,6869,7,5,2,7,12,16,-4,17
Chennaiyin,6869,8,3,6,5,14,20,-6,15
Delhi Dynamo,6870,1,6,6,2,28,17,11,24
Mumbai City,6870,2,6,5,3,17,9,8,23
Kolkata,6870,3,5,7,2,15,12,3,22
NorthEast Un,6870,4,6,2,6,14,15,-1,20
FC Pune City,6870,5,5,3,6,16,16,0,18
Chennaiyin,6870,6,4,5,5,15,18,-3,17
Kerala Blast,6870,7,4,3,7,12,21,-9,15
FC Goa,6870,8,3,3,8,9,18,-9,12
Mumbai City,6871,1,7,4,3,17,8,9,25
Delhi Dynamo,6871,2,5,6,3,24,17,7,21
Kerala Blast,6871,3,5,5,4,11,14,-3,20
FC Pune City,6871,4,5,4,5,14,14,0,19
NorthEast Un,6871,5,5,3,6,13,12,1,18
Kolkata,6871,6,4,6,4,14,15,-1,18
FC Goa,6871,7,4,3,7,12,16,-4,15
Chennaiyin,6871,8,3,5,6,13,22,-9,14
Mumbai City,6872,1,6,5,3,18,10,8,23
Delhi Dynamo,6872,2,5,7,2,26,17,9,22
Kerala Blast,6872,3,6,4,4,14,15,-1,22
Kolkata,6872,4,4,6,4,17,16,1,18
Chennaiyin,6872,5,4,5,5,15,19,-4,17
FC Goa,6872,6,5,2,7,11,16,-5,17
NorthEast Un,6872,7,4,4,6,11,13,-2,16
FC Pune City,6872,8,4,3,7,12,18,-6,15
Mumbai City,6873,1,7,4,3,17,8,9,25
Delhi Dynamo,6873,2,6,5,3,23,15,8,23
Kerala Blast,6873,3,6,4,4,14,16,-2,22
Chennaiyin,6873,4,5,5,4,18,17,1,20
Kolkata,6873,5,3,8,3,15,15,0,17
FC Pune City,6873,6,4,4,6,13,16,-3,16
NorthEast Un,6873,7,4,3,7,9,11,-2,15
FC Goa,6873,8,3,3,8,8,19,-11,12
Delhi Dynamo,6874,1,6,5,3,26,17,9,23
NorthEast Un,6874,2,7,2,5,15,12,3,23
Mumbai City,6874,3,6,4,4,16,9,7,22
Kolkata,6874,4,4,7,3,15,14,1,19
FC Pune City,6874,5,4,5,5,13,15,-2,17
Chennaiyin,6874,6,4,5,5,16,19,-3,17
Kerala Blast,6874,7,4,4,6,13,20,-7,16
FC Goa,6874,8,4,2,8,13,21,-8,14
Mumbai City,6875,1,7,4,3,19,8,11,25
NorthEast Un,6875,2,7,2,5,12,9,3,23
Kolkata,6875,3,5,7,2,22,17,5,22
Delhi Dynamo,6875,4,5,5,4,23,18,5,20
Chennaiyin,6875,5,4,5,5,15,18,-3,17
FC Pune City,6875,6,4,4,6,13,18,-5,16
Kerala Blast,6875,7,4,4,6,13,19,-6,16
FC Goa,6875,8,3,3,8,10,20,-10,12
Mumbai City,6876,1,7,4,3,19,9,10,25
Kolkata,6876,2,5,7,2,20,15,5,22
Delhi Dynamo,6876,3,5,6,3,27,20,7,21
NorthEast Un,6876,4,6,3,5,13,11,2,21
Kerala Blast,6876,5,5,3,6,10,17,-7,18
FC Pune City,6876,6,4,3,7,12,16,-4,15
Chennaiyin,6876,7,3,6,5,15,20,-5,15
FC Goa,6876,8,3,4,7,14,22,-8,13
Mumbai City,6877,1,6,5,3,17,9,8,23
Delhi Dynamo,6877,2,5,7,2,25,17,8,22
FC Pune City,6877,3,6,3,5,15,14,1,21
Kolkata,6877,4,4,7,3,15,14,1,19
Chennaiyin,6877,5,4,6,4,16,18,-2,18
Kerala Blast,6877,6,4,5,5,10,15,-5,17
NorthEast Un,6877,7,4,4,6,12,14,-2,16
FC Goa,6877,8,3,3,8,9,18,-9,12
Mumbai City,6878,1,7,4,3,21,10,11,25
Delhi Dynamo,6878,2,6,5,3,29,21,8,23
Kerala Blast,6878,3,5,5,4,13,16,-3,20
FC Pune City,6878,4,5,3,6,14,16,-2,18
FC Goa,6878,5,5,2,7,13,17,-4,17
Chennaiyin,6878,6,4,5,5,14,19,-5,17
Kolkata,6878,7,3,7,4,14,16,-2,16
NorthEast Un,6878,8,4,3,7,11,14,-3,15
Kolkata,6879,1,6,6,2,20,13,7,24
Delhi Dynamo,6879,2,6,5,3,25,17,8,23
Mumbai City,6879,3,6,4,4,17,10,7,22
NorthEast Un,6879,4,6,3,5,13,10,3,21
Kerala Blast,6879,5,5,3,6,10,19,-9,18
FC Pune City,6879,6,4,3,7,13,17,-4,15
Chennaiyin,6879,7,3,6,5,14,20,-6,15
FC Goa,6879,8,4,2,8,11,17,-6,14
Mumbai City,6880,1,7,4,3,19,10,9,25
Kolkata,6880,2,6,6,2,17,13,4,24
Delhi Dynamo,6880,3,6,5,3,29,19,10,23
Kerala Blast,6880,4,5,4,5,12,16,-4,19
NorthEast Un,6880,5,5,2,7,12,14,-2,17
Chennaiyin,6880,6,4,5,5,15,18,-3,17
FC Pune City,6880,7,4,4,6,13,16,-3,16
FC Goa,6880,8,3,2,9,10,21,-11,11
Mumbai City,6881,1,6,5,3,16,8,8,23
Delhi Dynamo,6881,2,5,6,3,23,15,8,21
Kolkata,6881,3,4,8,2,17,15,2,20
FC Pune City,6881,4,5,3,6,13,15,-2,18
FC Goa,6881,5,5,3,6,12,16,-4,18
NorthEast Un,6881,6,5,2,7,11,12,-1,17
Chennaiyin,6881,7,4,5,5,14,18,-4,17
Kerala Blast,6881,8,4,4,6,10,17,-7,16
Mumbai City,6882,1,6,5,3,16,8,8,23
Delhi Dynamo,6882,2,5,7,2,23,14,9,22
Kolkata,6882,3,5,6,3,17,13,4,21
NorthEast Un,6882,4,6,3,5,11,9,2,21
Kerala Blast,6882,5,5,4,5,11,15,-4,19
FC Pune City,6882,6,4,4,6,13,18,-5,16
Chennaiyin,6882,7,3,5,6,14,21,-7,14
FC Goa,6882,8,4,2,8,11,18,-7,14
Mumbai City,6883,1,7,4,3,19,9,10,25
FC Pune City,6883,2,6,3,5,16,16,0,21
Delhi Dynamo,6883,3,5,5,4,26,22,4,20
NorthEast Un,6883,4,5,3,6,14,14,0,18
FC Goa,6883,5,5,3,6,12,14,-2,18
Kerala Blast,6883,6,5,3,6,12,17,-5,18
Kolkata,6883,7,3,7,4,15,16,-1,16
Chennaiyin,6883,8,3,6,5,14,20,-6,15
Mumbai City,6884,1,7,4,3,19,8,11,25
Kerala Blast,6884,2,6,4,4,12,13,-1,22
FC Goa,6884,3,6,2,6,16,16,0,20
NorthEast Un,6884,4,5,4,5,12,10,2,19
Kolkata,6884,5,4,6,4,16,17,-1,18
Delhi Dynamo,6884,6,4,5,5,22,21,1,17
FC Pune City,6884,7,4,3,7,14,18,-4,15
Chennaiyin,6884,8,3,6,5,15,23,-8,15
Mumbai City,6885,1,6,5,3,17,9,8,23
Delhi Dynamo,6885,2,5,7,2,27,16,11,22
NorthEast Un,6885,3,6,3,5,13,10,3,21
FC Pune City,6885,4,5,4,5,16,14,2,19
Kolkata,6885,5,4,7,3,16,18,-2,19
Chennaiyin,6885,6,4,5,5,15,20,-5,17
Kerala Blast,6885,7,4,5,5,10,15,-5,17
FC Goa,6885,8,3,2,9,10,22,-12,11
Mumbai City,6886,1,7,4,3,18,8,10,25
Kolkata,6886,2,6,6,2,21,14,7,24
Delhi Dynamo,6886,3,5,5,4,25,19,6,20
Kerala Blast,6886,4,5,4,5,13,17,-4,19
FC Goa,6886,5,5,2,7,12,18,-6,17
NorthEast Un,6886,6,4,4,6,10,12,-2,16
FC Pune City,6886,7,4,3,7,12,17,-5,15
Chennaiyin,6886,8,3,6,5,13,19,-6,15
Delhi Dynamo,6887,1,6,6,2,26,16,10,24
Mumbai City,6887,2,6,5,3,17,9,8,23
FC Pune City,6887,3,5,4,5,16,15,1,19
Kerala Blast,6887,4,4,6,4,12,16,-4,18
FC Goa,6887,5,5,2,7,14,18,-4,17
Chennaiyin,6887,6,4,5,5,15,21,-6,17
Kolkata,6887,7,3,7,4,15,18,-3,16
NorthEast Un,6887,8,4,3,7,9,11,-2,15
Mumbai City,6888,1,7,4,3,19,10,9,25
Delhi Dynamo,6888,2,6,5,3,27,18,9,23
Chennaiyin,6888,3,5,5,4,17,18,-1,20
FC Pune City,6888,4,5,4,5,14,14,0,19
Kerala Blast,6888,5,4,6,4,11,15,-4,18
Kolkata,6888,6,3,8,3,14,15,-1,17
NorthEast Un,6888,7,4,3,7,10,14,-4,15
FC Goa,6888,8,3,3,8,10,18,-8,12
Mumbai City,6889,1,6,5,3,17,9,8,23
Delhi Dynamo,6889,2,5,6,3,26,19,7,21
Kolkata,6889,3,5,6,3,17,13,4,21
NorthEast Un,6889,4,6,2,6,13,12,1,20
FC Goa,6889,5,5,3,6,13,15,-2,18
FC Pune City,6889,6,4,4,6,12,15,-3,16
Kerala Blast,6889,7,4,4,6,9,19,-10,16
Chennaiyin,6889,8,3,6,5,13,18,-5,15
Mumbai City,6890,1,6,4,4,17,10,7,22
Delhi Dynamo,6890,2,5,6,3,23,16,7,21
NorthEast Un,6890,3,6,3,5,13,10,3,21
Kerala Blast,6890,4,5,4,5,13,18,-5,19
FC Pune City,6890,5,5,3,6,15,17,-2,18
Kolkata,6890,6,3,8,3,16,16,0,17
FC Goa,6890,7,4,4,6,12,16,-4,16
Chennaiyin,6890,8,3,6,5,14,20,-6,15
Delhi Dynamo,6891,1,6,6,2,27,17,10,24
Mumbai City,6891,2,6,4,4,17,10,7,22
Chennaiyin,6891,3,5,5,4,20,18,2,20
Kolkata,6891,4,4,8,2,16,14,2,20
Kerala Blast,6891,5,5,5,4,10,13,-3,20
FC Pune City,6891,6,4,4,6,13,16,-3,16
NorthEast Un,6891,7,4,3,7,10,17,-7,15
FC Goa,6891,8,3,3,8,11,19,-8,12
Delhi Dynamo,6892,1,6,6,2,26,17,9,24
Mumbai City,6892,2,6,4,4,17,10,7,22
Kerala Blast,6892,3,5,5,4,12,14,-2,20
Kolkata,6892,4,3,9,2,16,15,1,18
NorthEast Un,6892,5,5,3,6,12,12,0,18
FC Pune City,6892,6,4,5,5,14,16,-2,17
FC Goa,6892,7,4,3,7,11,16,-5,15
Chennaiyin,6892,8,3,5,6,13,21,-8,14
Mumbai City,6893,1,7,4,3,21,9,12,25
Delhi Dynamo,6893,2,6,5,3,31,21,10,23
Kolkata,6893,3,4,8,2,17,15,2,20
FC Pune City,6893,4,4,5,5,13,15,-2,17
Chennaiyin,6893,5,4,5,5,14,18,-4,17
Kerala Blast,6893,6,4,5,5,9,14,-5,17
NorthEast Un,6893,7,4,3,7,10,12,-2,15
FC Goa,6893,8,4,3,7,12,23,-11,15
Delhi Dynamo,6894,1,6,6,2,28,14,14,24
Mumbai City,6894,2,6,5,3,16,8,8,23
Kolkata,6894,3,5,6,3,16,13,3,21
Kerala Blast,6894,4,6,3,5,13,16,-3,21
FC Pune City,6894,5,5,3,6,13,16,-3,18
Chennaiyin,6894,6,4,5,5,15,20,-5,17
NorthEast Un,6894,7,4,2,8,12,16,-4,14
FC Goa,6894,8,4,2,8,10,20,-10,14
Delhi Dynamo,6895,1,6,6,2,25,16,9,24
Mumbai City,6895,2,6,4,4,17,10,7,22
Kerala Blast,6895,3,6,4,4,13,14,-1,22
FC Pune City,6895,4,5,4,5,15,16,-1,19
NorthEast Un,6895,5,5,2,7,12,13,-1,17
FC Goa,6895,6,4,4,6,11,15,-4,16
Kolkata,6895,7,3,6,5,14,18,-4,15
Chennaiyin,6895,8,3,6,5,15,20,-5,15
Mumbai City,6896,1,6,4,4,16,9,7,22
Delhi Dynamo,6896,2,5,6,3,24,17,7,21
Chennaiyin,6896,3,5,5,4,18,20,-2,20
FC Pune City,6896,4,5,4,5,14,15,-1,19
Kolkata,6896,5,3,9,2,15,14,1,18
Kerala Blast,6896,6,4,5,5,12,17,-5,17
NorthEast Un,6896,7,4,4,6,12,13,-1,16
FC Goa,6896,8,4,3,7,13,19,-6,15
Mumbai City,6897,1,6,4,4,17,10,7,22
Delhi Dynamo,6897,2,5,6,3,23,16,7,21
Kerala Blast,6897,3,6,3,5,14,17,-3,21
Kolkata,6897,4,4,7,3,17,16,1,19
NorthEast Un,6897,5,5,3,6,11,11,0,18
FC Pune City,6897,6,5,3,6,16,18,-2,18
Chennaiyin,6897,7,4,5,5,17,20,-3,17
FC Goa,6897,8,4,3,7,12,19,-7,15
Delhi Dynamo,6898,1,6,6,2,25,14,11,24
Mumbai City,6898,2,6,4,4,16,9,7,22
Kerala Blast,6898,3,6,4,4,14,15,-1,22
Kolkata,6898,4,4,7,3,16,15,1,19
Chennaiyin,6898,5,4,5,5,15,19,-4,17
FC Goa,6898,6,5,2,7,10,17,-7,17
NorthEast Un,6898,7,4,3,7,10,13,-3,15
FC Pune City,6898,8,4,3,7,12,16,-4,15
Mumbai City,6899,1,7,4,3,18,9,9,25
Delhi Dynamo,6899,2,6,5,3,27,18,9,23
Kerala Blast,6899,3,6,4,4,16,15,1,22
Kolkata,6899,4,4,7,3,17,15,2,19
FC Goa,6899,5,5,2,7,14,19,-5,17
NorthEast Un,6899,6,4,3,7,11,15,-4,15
Chennaiyin,6899,7,3,6,5,16,22,-6,15
FC Pune City,6899,8,4,3,7,14,20,-6,15
Mumbai City,6900,1,6,5,3,17,9,8,23
Delhi Dynamo,6900,2,5,7,2,24,16,8,22
Kolkata,6900,3,4,7,3,18,15,3,19
Kerala Blast,6900,4,5,4,5,13,15,-2,19
FC Pune City,6900,5,5,3,6,13,17,-4,18
FC Goa,6900,6,5,3,6,12,16,-4,18
Chennaiyin,6900,7,4,5,5,15,19,-4,17
NorthEast Un,6900,8,4,2,8,10,15,-5,14
Delhi Dynamo,6901,1,6,6,2,26,16,10,24
Mumbai City,6901,2,6,5,3,17,9,8,23
Chennaiyin,6901,3,5,5,4,18,20,-2,20
FC Pune City,6901,4,5,4,5,15,16,-1,19
Kerala Blast,6901,5,5,4,5,15,17,-2,19
Kolkata,6901,6,3,8,3,14,16,-2,17
NorthEast Un,6901,7,4,3,7,12,14,-2,15
FC Goa,6901,8,3,3,8,11,20,-9,12
Mumbai City,6902,1,6,5,3,17,9,8,23
Delhi Dynamo,6902,2,5,7,2,26,18,8,22
Kerala Blast,6902,3,6,4,4,16,15,1,22
Kolkata,6902,4,4,8,2,19,15,4,20
Chennaiyin,6902,5,4,6,4,15,18,-3,18
FC Pune City,6902,6,4,4,6,14,18,-4,16
NorthEast Un,6902,7,4,3,7,12,16,-4,15
FC Goa,6902,8,3,3,8,10,20,-10,12
Mumbai City,6903,1,7,4,3,18,9,9,25
NorthEast Un,6903,2,6,3,5,16,11,5,21
Delhi Dynamo,6903,3,5,5,4,25,20,5,20
Kolkata,6903,4,4,7,3,18,18,0,19
FC Pune City,6903,5,5,3,6,16,17,-1,18
FC Goa,6903,6,5,2,7,14,18,-4,17
Kerala Blast,6903,7,4,4,6,11,20,-9,16
Chennaiyin,6903,8,3,6,5,14,19,-5,15
Mumbai City,6904,1,6,5,3,18,10,8,23
Delhi Dynamo,6904,2,5,7,2,26,17,9,22
Kolkata,6904,3,5,6,3,15,13,2,21
Kerala Blast,6904,4,6,3,5,12,14,-2,21
Chennaiyin,6904,5,4,6,4,14,17,-3,18
FC Pune City,6904,6,5,3,6,13,16,-3,18
NorthEast Un,6904,7,4,3,7,9,12,-3,15
FC Goa,6904,8,3,3,8,9,17,-8,12
Delhi Dynamo,6905,1,7,5,2,25,14,11,26
Mumbai City,6905,2,6,4,4,16,10,6,22
Kolkata,6905,3,5,7,2,17,14,3,22
FC Pune City,6905,4,4,5,5,14,16,-2,17
Kerala Blast,6905,5,4,5,5,11,16,-5,17
NorthEast Un,6905,6,4,4,6,11,12,-1,16
Chennaiyin,6905,7,3,6,5,15,20,-5,15
FC Goa,6905,8,4,2,8,9,16,-7,14
Mumbai City,6906,1,7,4,3,18,9,9,25
Delhi Dynamo,6906,2,5,5,4,25,19,6,20
Kolkata,6906,3,4,7,3,16,16,0,19
FC Pune City,6906,4,5,3,6,15,16,-1,18
FC Goa,6906,5,5,3,6,15,18,-3,18
Kerala Blast,6906,6,5,3,6,12,17,-5,18
NorthEast Un,6906,7,5,2,7,11,12,-1,17
Chennaiyin,6906,8,4,5,5,14,19,-5,17
Mumbai City,6907,1,7,4,3,19,9,10,25
Kolkata,6907,2,5,7,2,20,16,4,22
Chennaiyin,6907,3,5,5,4,16,17,-1,20
Delhi Dynamo,6907,4,4,7,3,23,18,5,19
Kerala Blast,6907,5,5,4,5,15,19,-4,19
NorthEast Un,6907,6,5,3,6,12,12,0,18
FC Pune City,6907,7,4,3,7,15,19,-4,15
FC Goa,6907,8,3,3,8,9,19,-10,12
Delhi Dynamo,6908,1,6,6,2,27,15,12,24
Mumbai City,6908,2,6,4,4,16,11,5,22
Kolkata,6908,3,5,6,3,17,15,2,21
Kerala Blast,6908,4,5,5,4,11,13,-2,20
NorthEast Un,6908,5,4,5,5,12,12,0,17
FC Pune City,6908,6,4,4,6,13,16,-3,16
Chennaiyin,6908,7,3,7,4,16,20,-4,16
FC Goa,6908,8,3,3,8,9,19,-10,12
Mumbai City,6909,1,7,4,3,17,8,9,25
Kerala Blast,6909,2,6,3,5,15,16,-1,21
Delhi Dynamo,6909,3,5,5,4,22,16,6,20
Kolkata,6909,4,4,6,4,14,14,0,18
FC Pune City,6909,5,5,3,6,15,18,-3,18
NorthEast Un,6909,6,5,2,7,10,12,-2,17
Chennaiyin,6909,7,4,5,5,14,18,-4,17
FC Goa,6909,8,5,2,7,10,15,-5,17
Delhi Dynamo,6910,1,6,6,2,29,16,13,24
Mumbai City,6910,2,6,5,3,18,10,8,23
Kerala Blast,6910,3,5,5,4,14,17,-3,20
Kolkata,6910,4,3,8,3,15,15,0,17
Chennaiyin,6910,5,4,5,5,18,20,-2,17
FC Pune City,6910,6,4,5,5,13,15,-2,17
FC Goa,6910,7,5,2,7,11,19,-8,17
NorthEast Un,6910,8,4,2,8,11,17,-6,14
Mumbai City,6911,1,7,4,3,19,8,11,25
Kolkata,6911,2,6,6,2,21,13,8,24
Delhi Dynamo,6911,3,5,5,4,24,19,5,20
NorthEast Un,6911,4,6,2,6,12,11,1,20
Chennaiyin,6911,5,4,6,4,16,18,-2,18
Kerala Blast,6911,6,5,3,6,11,19,-8,18
FC Pune City,6911,7,4,3,7,13,19,-6,15
FC Goa,6911,8,3,3,8,10,19,-9,12
Mumbai City,6912,1,7,4,3,17,8,9,25
Delhi Dynamo,6912,2,5,6,3,24,17,7,21
Kolkata,6912,3,4,7,3,18,14,4,19
Kerala Blast,6912,4,5,4,5,13,19,-6,19
NorthEast Un,6912,5,5,3,6,11,11,0,18
FC Pune City,6912,6,5,3,6,16,19,-3,18
FC Goa,6912,7,4,4,6,12,16,-4,16
Chennaiyin,6912,8,3,5,6,14,21,-7,14
Mumbai City,6913,1,6,5,3,18,10,8,23
Delhi Dynamo,6913,2,5,6,3,27,20,7,21
Kolkata,6913,3,4,8,2,19,15,4,20
Chennaiyin,6913,4,5,5,4,16,18,-2,20
Kerala Blast,6913,5,4,6,4,10,14,-4,18
FC Pune City,6913,6,4,5,5,14,16,-2,17
NorthEast Un,6913,7,4,3,7,10,12,-2,15
FC Goa,6913,8,4,2,8,12,21,-9,14
Mumbai City,6914,1,7,4,3,18,8,10,25
Delhi Dynamo,6914,2,5,6,3,25,19,6,21
Kerala Blast,6914,3,5,5,4,12,14,-2,20
Kolkata,6914,4,4,7,3,17,15,2,19
NorthEast Un,6914,5,5,4,5,12,11,1,19
Chennaiyin,6914,6,4,5,5,17,18,-1,17
FC Pune City,6914,7,4,3,7,12,19,-7,15
FC Goa,6914,8,4,2,8,11,20,-9,14
Delhi Dynamo,6915,1,6,6,2,24,15,9,24
Mumbai City,6915,2,6,4,4,16,9,7,22
Kolkata,6915,3,4,7,3,14,13,1,19
NorthEast Un,6915,4,5,3,6,12,12,0,18
Chennaiyin,6915,5,4,5,5,15,19,-4,17
FC Goa,6915,6,5,2,7,11,16,-5,17
Kerala Blast,6915,7,4,5,5,10,15,-5,17
FC Pune City,6915,8,4,4,6,12,15,-3,16
Mumbai City,6916,1,6,5,3,17,9,8,23
Delhi Dynamo,6916,2,5,7,2,24,16,8,22
Kerala Blast,6916,3,6,3,5,14,18,-4,21
Kolkata,6916,4,4,7,3,15,14,1,19
FC Pune City,6916,5,5,4,5,18,18,0,19
Chennaiyin,6916,6,3,7,4,14,18,-4,16
NorthEast Un,6916,7,4,3,7,10,12,-2,15
FC Goa,6916,8,3,4,7,9,16,-7,13
Mumbai City,6917,1,6,5,3,16,8,8,23
Delhi Dynamo,6917,2,5,6,3,22,15,7,21
Kerala Blast,6917,3,6,3,5,12,16,-4,21
Chennaiyin,6917,4,5,5,4,15,17,-2,20
FC Pune City,6917,5,5,4,5,14,14,0,19
NorthEast Un,6917,6,5,2,7,10,11,-1,17
Kolkata,6917,7,3,7,4,14,15,-1,16
FC Goa,6917,8,4,2,8,9,16,-7,14
Mumbai City,6918,1,7,4,3,19,9,10,25
NorthEast Un,6918,2,6,2,6,17,13,4,20
Delhi Dynamo,6918,3,5,5,4,26,23,3,20
Kolkata,6918,4,4,8,2,16,14,2,20
Kerala Blast,6918,5,5,4,5,12,16,-4,19
FC Pune City,6918,6,4,5,5,13,15,-2,17
Chennaiyin,6918,7,3,6,5,15,21,-6,15
FC Goa,6918,8,3,4,7,11,18,-7,13
Mumbai City,6919,1,7,4,3,18,9,9,25
NorthEast Un,6919,2,7,2,5,15,11,4,23
FC Pune City,6919,3,6,3,5,17,14,3,21
Kolkata,6919,4,5,6,3,16,16,0,21
Delhi Dynamo,6919,5,5,5,4,27,21,6,20
Kerala Blast,6919,6,4,3,7,11,20,-9,15
Chennaiyin,6919,7,3,5,6,16,22,-6,14
FC Goa,6919,8,4,2,8,15,22,-7,14
Delhi Dynamo,6920,1,6,6,2,25,15,10,24
Mumbai City,6920,2,6,5,3,17,9,8,23
Kerala Blast,6920,3,6,3,5,15,18,-3,21
Chennaiyin,6920,4,5,5,4,15,17,-2,20
Kolkata,6920,5,4,6,4,19,17,2,18
FC Pune City,6920,6,5,3,6,14,18,-4,18
NorthEast Un,6920,7,4,2,8,9,13,-4,14
FC Goa,6920,8,4,2,8,9,16,-7,14
Mumbai City,6921,1,6,4,4,16,9,7,22
NorthEast Un,6921,2,6,3,5,14,10,4,21
Delhi Dynamo,6921,3,5,5,4,23,18,5,20
Kerala Blast,6921,4,5,5,4,10,13,-3,20
Kolkata,6921,5,4,7,3,16,14,2,19
Chennaiyin,6921,6,4,5,5,16,21,-5,17
FC Pune City,6921,7,4,4,6,12,16,-4,16
FC Goa,6921,8,4,3,7,12,18,-6,15
Mumbai City,6922,1,6,5,3,16,8,8,23
Delhi Dynamo,6922,2,5,7,2,23,15,8,22
Kolkata,6922,3,4,7,3,16,16,0,19
Kerala Blast,6922,4,5,4,5,11,15,-4,19
NorthEast Un,6922,5,5,3,6,10,10,0,18
FC Goa,6922,6,4,4,6,13,16,-3,16
FC Pune City,6922,7,4,4,6,12,16,-4,16
Chennaiyin,6922,8,3,6,5,13,18,-5,15
Kolkata,6923,1,6,6,2,23,17,6,24
Mumbai City,6923,2,6,5,3,16,8,8,23
NorthEast Un,6923,3,6,2,6,12,12,0,20
Delhi Dynamo,6923,4,4,7,3,23,17,6,19
Chennaiyin,6923,5,4,5,5,15,18,-3,17
FC Pune City,6923,6,4,4,6,14,18,-4,16
Kerala Blast,6923,7,4,4,6,12,18,-6,16
FC Goa,6923,8,4,3,7,14,21,-7,15
Delhi Dynamo,6924,1,6,6,2,23,14,9,24
Kerala Blast,6924,2,7,3,4,15,14,1,24
Mumbai City,6924,3,6,4,4,16,9,7,22
Kolkata,6924,4,5,6,3,18,13,5,21
Chennaiyin,6924,5,5,5,4,19,18,1,20
NorthEast Un,6924,6,4,3,7,10,14,-4,15
FC Pune City,6924,7,4,3,7,13,19,-6,15
FC Goa,6924,8,3,2,9,8,21,-13,11
Delhi Dynamo,6925,1,6,6,2,25,16,9,24
Kerala Blast,6925,2,7,3,4,16,13,3,24
Mumbai City,6925,3,6,5,3,16,8,8,23
Kolkata,6925,4,3,8,3,14,14,0,17
Chennaiyin,6925,5,4,5,5,15,19,-4,17
FC Pune City,6925,6,4,4,6,13,18,-5,16
FC Goa,6925,7,4,3,7,10,16,-6,15
NorthEast Un,6925,8,4,2,8,11,16,-5,14
Mumbai City,6926,1,6,5,3,17,9,8,23
Kolkata,6926,2,5,6,3,17,13,4,21
Kerala Blast,6926,3,6,3,5,13,15,-2,21
Delhi Dynamo,6926,4,4,7,3,23,17,6,19
NorthEast Un,6926,5,5,3,6,10,11,-1,18
Chennaiyin,6926,6,4,6,4,14,17,-3,18
FC Pune City,6926,7,5,3,6,13,16,-3,18
FC Goa,6926,8,3,3,8,9,18,-9,12
Mumbai City,6927,1,7,4,3,21,9,12,25
Delhi Dynamo,6927,2,6,5,3,26,20,6,23
NorthEast Un,6927,3,6,2,6,12,11,1,20
Kolkata,6927,4,4,7,3,17,15,2,19
Kerala Blast,6927,5,5,4,5,10,14,-4,19
Chennaiyin,6927,6,4,5,5,15,18,-3,17
FC Pune City,6927,7,4,3,7,12,17,-5,15
FC Goa,6927,8,4,2,8,11,20,-9,14
Mumbai City,6928,1,7,4,3,18,9,9,25
Kolkata,6928,2,4,8,2,18,15,3,20
NorthEast Un,6928,3,5,4,5,12,11,1,19
Delhi Dynamo,6928,4,4,6,4,23,18,5,18
Chennaiyin,6928,5,4,6,4,16,18,-2,18
FC Pune City,6928,6,5,3,6,13,16,-3,18
Kerala Blast,6928,7,4,4,6,10,16,-6,16
FC Goa,6928,8,4,3,7,11,18,-7,15
Delhi Dynamo,6929,1,7,5,2,28,17,11,26
Mumbai City,6929,2,6,4,4,17,11,6,22
Kerala Blast,6929,3,5,5,4,12,15,-3,20
Kolkata,6929,4,4,7,3,17,15,2,19
Chennaiyin,6929,5,4,6,4,15,18,-3,18
NorthEast Un,6929,6,4,4,6,12,13,-1,16
FC Pune City,6929,7,4,3,7,12,17,-5,15
FC Goa,6929,8,4,2,8,11,18,-7,14
Mumbai City,6930,1,6,4,4,16,9,7,22
Kerala Blast,6930,2,6,4,4,14,15,-1,22
Delhi Dynamo,6930,3,5,6,3,23,17,6,21
Kolkata,6930,4,4,6,4,17,15,2,18
FC Goa,6930,5,5,3,6,13,16,-3,18
NorthEast Un,6930,6,5,2,7,11,12,-1,17
Chennaiyin,6930,7,4,5,5,14,19,-5,17
FC Pune City,6930,8,4,4,6,14,19,-5,16
Mumbai City,6931,1,7,4,3,20,9,11,25
Delhi Dynamo,6931,2,5,6,3,26,20,6,21
Kolkata,6931,3,4,8,2,16,14,2,20
NorthEast Un,6931,4,6,2,6,13,12,1,20
Kerala Blast,6931,5,5,3,6,11,17,-6,18
Chennaiyin,6931,6,4,5,5,16,19,-3,17
FC Pune City,6931,7,4,4,6,13,16,-3,16
FC Goa,6931,8,3,4,7,10,18,-8,13
Delhi Dynamo,6932,1,6,5,3,24,15,9,23
Mumbai City,6932,2,6,4,4,16,10,6,22
FC Pune City,6932,3,6,3,5,18,16,2,21
NorthEast Un,6932,4,5,3,6,12,12,0,18
Chennaiyin,6932,5,4,5,5,15,18,-3,17
Kerala Blast,6932,6,4,5,5,12,17,-5,17
FC Goa,6932,7,5,2,7,11,16,-5,17
Kolkata,6932,8,3,7,4,14,18,-4,16
Mumbai City,6933,1,6,5,3,18,10,8,23
Delhi Dynamo,6933,2,5,7,2,27,19,8,22
Kerala Blast,6933,3,6,4,4,16,15,1,22
Kolkata,6933,4,4,7,3,15,14,1,19
FC Goa,6933,5,5,2,7,10,15,-5,17
NorthEast Un,6933,6,4,4,6,15,17,-2,16
Chennaiyin,6933,7,3,6,5,15,20,-5,15
FC Pune City,6933,8,4,3,7,12,18,-6,15
Delhi Dynamo,6934,1,7,5,2,26,15,11,26
Kolkata,6934,2,6,6,2,22,16,6,24
Mumbai City,6934,3,6,4,4,16,10,6,22
NorthEast Un,6934,4,5,3,6,13,13,0,18
FC Pune City,6934,5,5,3,6,18,19,-1,18
Chennaiyin,6934,6,3,7,4,17,21,-4,16
Kerala Blast,6934,7,4,3,7,11,21,-10,15
FC Goa,6934,8,3,3,8,11,19,-8,12
Mumbai City,6935,1,7,4,3,18,9,9,25
Kolkata,6935,2,5,7,2,17,14,3,22
Delhi Dynamo,6935,3,5,6,3,25,17,8,21
NorthEast Un,6935,4,4,5,5,13,13,0,17
Kerala Blast,6935,5,4,5,5,14,19,-5,17
FC Pune City,6935,6,4,4,6,14,17,-3,16
Chennaiyin,6935,7,3,6,5,17,22,-5,15
FC Goa,6935,8,4,3,7,11,18,-7,15
Delhi Dynamo,6936,1,6,5,3,28,17,11,23
Mumbai City,6936,2,6,4,4,18,14,4,22
Kerala Blast,6936,3,6,3,5,13,16,-3,21
Chennaiyin,6936,4,5,5,4,17,19,-2,20
Kolkata,6936,5,4,6,4,18,17,1,18
FC Pune City,6936,6,5,3,6,15,17,-2,18
FC Goa,6936,7,5,2,7,13,18,-5,17
NorthEast Un,6936,8,4,2,8,10,14,-4,14
Kolkata,6937,1,6,6,2,17,13,4,24
Mumbai City,6937,2,6,5,3,17,9,8,23
Delhi Dynamo,6937,3,5,6,3,25,17,8,21
FC Pune City,6937,4,5,3,6,13,15,-2,18
Kerala Blast,6937,5,5,3,6,12,17,-5,18
NorthEast Un,6937,6,5,2,7,12,14,-2,17
Chennaiyin,6937,7,4,5,5,15,18,-3,17
FC Goa,6937,8,4,2,8,11,19,-8,14
Mumbai City,6938,1,7,4,3,17,8,9,25
Kolkata,6938,2,4,8,2,17,14,3,20
Kerala Blast,6938,3,5,4,5,11,15,-4,19
NorthEast Un,6938,4,5,3,6,11,12,-1,18
FC Goa,6938,5,5,3,6,11,15,-4,18
Delhi Dynamo,6938,6,4,5,5,22,18,4,17
Chennaiyin,6938,7,4,5,5,15,18,-3,17
FC Pune City,6938,8,4,4,6,13,17,-4,16
Mumbai City,6939,1,7,4,3,18,8,10,25
Delhi Dynamo,6939,2,5,6,3,25,18,7,21
Kolkata,6939,3,4,8,2,17,13,4,20
Kerala Blast,6939,4,5,5,4,12,15,-3,20
NorthEast Un,6939,5,5,3,6,13,13,0,18
FC Pune City,6939,6,4,5,5,14,16,-2,17
Chennaiyin,6939,7,3,6,5,14,19,-5,15
FC Goa,6939,8,3,3,8,9,20,-11,12
Mumbai City,6940,1,7,4,3,18,9,9,25
Kolkata,6940,2,6,6,2,23,13,10,24
Delhi Dynamo,6940,3,5,6,3,25,17,8,21
Kerala Blast,6940,4,5,4,5,11,17,-6,19
NorthEast Un,6940,5,4,4,6,10,12,-2,16
Chennaiyin,6940,6,3,7,4,14,18,-4,16
FC Pune City,6940,7,4,3,7,14,21,-7,15
FC Goa,6940,8,3,4,7,9,17,-8,13
Mumbai City,6941,1,7,4,3,17,8,9,25
Kolkata,6941,2,6,6,2,19,13,6,24
Delhi Dynamo,6941,3,6,5,3,30,16,14,23
FC Pune City,6941,4,5,3,6,16,15,1,18
Chennaiyin,6941,5,4,6,4,15,17,-2,18
Kerala Blast,6941,6,4,4,6,10,21,-11,16
NorthEast Un,6941,7,4,3,7,10,17,-7,15
FC Goa,6941,8,3,3,8,10,20,-10,12
Mumbai City,6942,1,7,4,3,17,8,9,25
Kolkata,6942,2,5,7,2,19,14,5,22
Delhi Dynamo,6942,3,5,5,4,24,18,6,20
NorthEast Un,6942,4,6,2,6,13,11,2,20
Chennaiyin,6942,5,5,5,4,15,17,-2,20
FC Pune City,6942,6,5,3,6,15,15,0,18
Kerala Blast,6942,7,4,4,6,10,18,-8,16
FC Goa,6942,8,3,2,9,9,21,-12,11
Delhi Dynamo,6943,1,6,6,2,27,16,11,24
Mumbai City,6943,2,6,4,4,16,10,6,22
FC Pune City,6943,3,6,3,5,15,15,0,21
Chennaiyin,6943,4,5,5,4,16,17,-1,20
Kerala Blast,6943,5,5,3,6,12,17,-5,18
NorthEast Un,6943,6,5,2,7,11,12,-1,17
Kolkata,6943,7,3,7,4,16,18,-2,16
FC Goa,6943,8,3,4,7,11,19,-8,13
Delhi Dynamo,6944,1,7,5,2,28,14,14,26
Mumbai City,6944,2,6,4,4,16,9,7,22
Kolkata,6944,3,5,6,3,18,16,2,21
Kerala Blast,6944,4,5,4,5,14,16,-2,19
Chennaiyin,6944,5,4,6,4,18,21,-3,18
NorthEast Un,6944,6,5,2,7,12,14,-2,17
FC Pune City,6944,7,4,4,6,14,18,-4,16
FC Goa,6944,8,3,3,8,11,23,-12,12
Mumbai City,6945,1,7,4,3,18,9,9,25
Kolkata,6945,2,6,6,2,19,14,5,24
Delhi Dynamo,6945,3,5,6,3,26,18,8,21
NorthEast Un,6945,4,6,2,6,12,12,0,20
FC Pune City,6945,5,5,3,6,15,18,-3,18
Chennaiyin,6945,6,3,6,5,15,20,-5,15
Kerala Blast,6945,7,4,3,7,9,16,-7,15
FC Goa,6945,8,3,4,7,11,18,-7,13
Mumbai City,6946,1,6,5,3,20,12,8,23
Delhi Dynamo,6946,2,4,8,2,29,22,7,20
Kolkata,6946,3,4,8,2,17,13,4,20
Kerala Blast,6946,4,5,5,4,10,13,-3,20
NorthEast Un,6946,5,5,3,6,14,13,1,18
FC Pune City,6946,6,4,5,5,13,15,-2,17
FC Goa,6946,7,4,3,7,11,18,-7,15
Chennaiyin,6946,8,3,5,6,13,21,-8,14
Mumbai City,6947,1,7,4,3,18,9,9,25
Delhi Dynamo,6947,2,5,5,4,23,17,6,20
Chennaiyin,6947,3,5,5,4,17,19,-2,20
Kerala Blast,6947,4,5,5,4,13,16,-3,20
FC Pune City,6947,5,5,3,6,17,18,-1,18
FC Goa,6947,6,5,2,7,12,16,-4,17
Kolkata,6947,7,3,7,4,16,19,-3,16
NorthEast Un,6947,8,4,3,7,11,13,-2,15
Delhi Dynamo,6948,1,6,6,2,30,20,10,24
Mumbai City,6948,2,6,5,3,19,11,8,23
FC Pune City,6948,3,6,3,5,15,14,1,21
NorthEast Un,6948,4,6,2,6,17,14,3,20
Kerala Blast,6948,5,5,3,6,10,19,-9,18
Chennaiyin,6948,6,4,5,5,16,20,-4,17
Kolkata,6948,7,3,6,5,14,16,-2,15
FC Goa,6948,8,4,2,8,12,19,-7,14
Mumbai City,6949,1,7,4,3,17,8,9,25
FC Pune City,6949,2,6,3,5,17,17,0,21
Delhi Dynamo,6949,3,5,5,4,23,17,6,20
Kerala Blast,6949,4,5,4,5,13,15,-2,19
FC Goa,6949,5,5,3,6,13,16,-3,18
Kolkata,6949,6,3,8,3,15,15,0,17
NorthEast Un,6949,7,4,3,7,11,15,-4,15
Chennaiyin,6949,8,3,6,5,16,22,-6,15
Mumbai City,6950,1,7,4,3,18,8,10,25
Delhi Dynamo,6950,2,6,5,3,25,16,9,23
Kolkata,6950,3,5,7,2,16,12,4,22
Kerala Blast,6950,4,5,4,5,12,16,-4,19
NorthEast Un,6950,5,5,3,6,13,11,2,18
FC Pune City,6950,6,4,3,7,12,17,-5,15
FC Goa,6950,7,4,3,7,9,17,-8,15
Chennaiyin,6950,8,3,5,6,13,21,-8,14
Mumbai City,6951,1,7,4,3,19,10,9,25
Delhi Dynamo,6951,2,6,5,3,30,19,11,23
Kerala Blast,6951,3,6,4,4,13,15,-2,22
Kolkata,6951,4,4,6,4,14,14,0,18
FC Pune City,6951,5,5,3,6,14,16,-2,18
Chennaiyin,6951,6,4,6,4,17,20,-3,18
NorthEast Un,6951,7,4,3,7,11,13,-2,15
FC Goa,6951,8,3,3,8,12,23,-11,12
Mumbai City,6952,1,6,5,3,17,9,8,23
Kolkata,6952,2,5,7,2,17,13,4,22
Chennaiyin,6952,3,5,5,4,16,17,-1,20
Delhi Dynamo,6952,4,4,7,3,23,17,6,19
NorthEast Un,6952,5,5,3,6,13,12,1,18
FC Pune City,6952,6,4,4,6,13,17,-4,16
Kerala Blast,6952,7,4,4,6,11,18,-7,16
FC Goa,6952,8,4,3,7,10,17,-7,15
Mumbai City,6953,1,7,4,3,18,8,10,25
Kolkata,6953,2,5,7,2,17,13,4,22
Delhi Dynamo,6953,3,5,6,3,24,17,7,21
Kerala Blast,6953,4,5,4,5,12,16,-4,19
NorthEast Un,6953,5,5,3,6,11,11,0,18
FC Pune City,6953,6,4,5,5,13,15,-2,17
Chennaiyin,6953,7,3,6,5,14,19,-5,15
FC Goa,6953,8,3,3,8,9,19,-10,12
Delhi Dynamo,6954,1,6,6,2,29,17,12,24
Mumbai City,6954,2,6,4,4,16,11,5,22
Kerala Blast,6954,3,6,3,5,14,17,-3,21
FC Pune City,6954,4,5,4,5,15,16,-1,19
Kolkata,6954,5,3,7,4,16,17,-1,16
NorthEast Un,6954,6,4,4,6,11,12,-1,16
Chennaiyin,6954,7,3,7,4,14,18,-4,16
FC Goa,6954,8,4,3,7,13,20,-7,15
Delhi Dynamo,6955,1,6,5,3,29,17,12,23
Mumbai City,6955,2,6,4,4,17,11,6,22
NorthEast Un,6955,3,6,3,5,13,10,3,21
Kolkata,6955,4,5,6,3,20,18,2,21
Kerala Blast,6955,5,5,4,5,12,17,-5,19
FC Goa,6955,6,4,3,7,15,21,-6,15
Chennaiyin,6955,7,3,6,5,14,20,-6,15
FC Pune City,6955,8,4,3,7,12,18,-6,15
Mumbai City,6956,1,7,4,3,19,9,10,25
Kolkata,6956,2,6,6,2,17,13,4,24
Delhi Dynamo,6956,3,5,5,4,28,20,8,20
NorthEast Un,6956,4,6,2,6,16,15,1,20
FC Pune City,6956,5,5,3,6,15,16,-1,18
Kerala Blast,6956,6,5,3,6,13,18,-5,18
Chennaiyin,6956,7,3,6,5,17,22,-5,15
FC Goa,6956,8,3,3,8,11,23,-12,12
Delhi Dynamo,6957,1,7,5,2,27,16,11,26
Mumbai City,6957,2,6,4,4,17,10,7,22
Kolkata,6957,3,5,6,3,19,17,2,21
Kerala Blast,6957,4,5,4,5,12,16,-4,19
Chennaiyin,6957,5,4,6,4,17,18,-1,18
FC Pune City,6957,6,4,3,7,14,18,-4,15
NorthEast Un,6957,7,4,3,7,11,15,-4,15
FC Goa,6957,8,4,3,7,11,18,-7,15
Mumbai City,6958,1,6,5,3,17,9,8,23
Delhi Dynamo,6958,2,5,7,2,25,16,9,22
FC Pune City,6958,3,6,3,5,20,16,4,21
NorthEast Un,6958,4,5,4,5,13,11,2,19
FC Goa,6958,5,5,2,7,10,16,-6,17
Kolkata,6958,6,3,7,4,15,18,-3,16
Kerala Blast,6958,7,4,4,6,9,18,-9,16
Chennaiyin,6958,8,3,6,5,14,19,-5,15
Mumbai City,6959,1,7,4,3,18,8,10,25
Delhi Dynamo,6959,2,5,5,4,23,19,4,20
NorthEast Un,6959,3,6,2,6,12,11,1,20
Kerala Blast,6959,4,5,4,5,14,15,-1,19
Kolkata,6959,5,3,8,3,15,16,-1,17
Chennaiyin,6959,6,4,5,5,16,19,-3,17
FC Goa,6959,7,5,2,7,13,17,-4,17
FC Pune City,6959,8,4,4,6,13,19,-6,16
Mumbai City,6960,1,7,4,3,20,9,11,25
Kolkata,6960,2,5,7,2,18,14,4,22
Delhi Dynamo,6960,3,5,6,3,25,20,5,21
FC Pune City,6960,4,5,3,6,16,15,1,18
NorthEast Un,6960,5,4,4,6,10,11,-1,16
Chennaiyin,6960,6,3,7,4,15,19,-4,16
Kerala Blast,6960,7,4,4,6,9,19,-10,16
FC Goa,6960,8,3,5,6,13,19,-6,14
Delhi Dynamo,6961,1,6,5,3,29,19,10,23
Mumbai City,6961,2,6,4,4,17,11,6,22
FC Pune City,6961,3,6,3,5,18,18,0,21
Kerala Blast,6961,4,6,3,5,14,15,-1,21
NorthEast Un,6961,5,5,3,6,12,13,-1,18
Chennaiyin,6961,6,4,6,4,16,19,-3,18
Kolkata,6961,7,3,6,5,16,19,-3,15
FC Goa,6961,8,4,2,8,12,20,-8,14
Mumbai City,6962,1,7,4,3,20,10,10,25
Kolkata,6962,2,6,6,2,17,13,4,24
NorthEast Un,6962,3,6,3,5,14,11,3,21
Kerala Blast,6962,4,5,4,5,16,16,0,19
Delhi Dynamo,6962,5,4,6,4,23,19,4,18
FC Goa,6962,6,4,3,7,10,15,-5,15
FC Pune City,6962,7,4,3,7,12,20,-8,15
Chennaiyin,6962,8,3,5,6,14,22,-8,14
Mumbai City,6963,1,7,4,3,18,8,10,25
Delhi Dynamo,6963,2,6,5,3,26,16,10,23
Kerala Blast,6963,3,6,3,5,14,16,-2,21
Kolkata,6963,4,4,6,4,17,16,1,18
Chennaiyin,6963,5,4,6,4,17,18,-1,18
FC Pune City,6963,6,5,3,6,15,19,-4,18
FC Goa,6963,7,4,3,7,11,18,-7,15
NorthEast Un,6963,8,4,2,8,9,16,-7,14
Mumbai City,6964,1,7,4,3,18,8,10,25
Kerala Blast,6964,2,7,3,4,17,16,1,24
Delhi Dynamo,6964,3,4,6,4,22,18,4,18
NorthEast Un,6964,4,5,3,6,14,16,-2,18
FC Goa,6964,5,5,3,6,13,15,-2,18
FC Pune City,6964,6,4,4,6,14,17,-3,16
Kolkata,6964,6,3,7,4,14,17,-3,16
Chennaiyin,6964,8,3,6,5,15,20,-5,15
Mumbai City,6965,1,7,4,3,19,10,9,25
Delhi Dynamo,6965,2,5,6,3,27,17,10,21
Kerala Blast,6965,3,5,5,4,12,15,-3,20
Kolkata,6965,4,4,6,4,17,16,1,18
NorthEast Un,6965,5,5,3,6,11,13,-2,18
FC Goa,6965,6,5,3,6,11,15,-4,18
FC Pune City,6965,7,4,4,6,15,19,-4,16
Chennaiyin,6965,8,3,5,6,13,20,-7,14
Mumbai City,6966,1,7,4,3,20,9,11,25
Kerala Blast,6966,2,6,4,4,14,15,-1,22
Delhi Dynamo,6966,3,5,5,4,25,20,5,20
Chennaiyin,6966,4,4,6,4,17,20,-3,18
Kolkata,6966,5,3,8,3,17,17,0,17
NorthEast Un,6966,6,5,2,7,12,12,0,17
FC Pune City,6966,7,4,4,6,14,18,-4,16
FC Goa,6966,8,4,3,7,11,19,-8,15
Mumbai City,6967,1,7,4,3,19,8,11,25
Kerala Blast,6967,2,6,4,4,16,14,2,22
Kolkata,6967,3,4,7,3,16,15,1,19
NorthEast Un,6967,4,5,4,5,12,11,1,19
Delhi Dynamo,6967,5,4,6,4,22,19,3,18
FC Pune City,6967,6,4,4,6,12,18,-6,16
FC Goa,6967,7,4,3,7,13,18,-5,15
Chennaiyin,6967,8,3,6,5,14,21,-7,15
Mumbai City,6968,1,7,4,3,20,10,10,25
Kolkata,6968,2,5,7,2,18,15,3,22
Kerala Blast,6968,3,6,3,5,12,15,-3,21
Delhi Dynamo,6968,4,5,5,4,27,22,5,20
NorthEast Un,6968,5,6,2,6,13,11,2,20
FC Pune City,6968,6,4,3,7,13,17,-4,15
FC Goa,6968,7,4,3,7,12,19,-7,15
Chennaiyin,6968,8,3,5,6,14,20,-6,14
Kerala Blast,6969,1,7,3,4,15,16,-1,24
Mumbai City,6969,2,6,4,4,16,10,6,22
Delhi Dynamo,6969,3,5,6,3,24,16,8,21
Kolkata,6969,4,4,7,3,15,14,1,19
NorthEast Un,6969,5,5,3,6,13,13,0,18
FC Pune City,6969,6,4,4,6,15,18,-3,16
Chennaiyin,6969,7,3,7,4,14,18,-4,16
FC Goa,6969,8,3,4,7,8,15,-7,13
Mumbai City,6970,1,7,4,3,18,9,9,25
Kolkata,6970,2,5,7,2,22,15,7,22
Delhi Dynamo,6970,3,5,5,4,25,20,5,20
FC Pune City,6970,4,5,3,6,13,18,-5,18
Kerala Blast,6970,5,5,3,6,12,18,-6,18
NorthEast Un,6970,6,5,2,7,13,13,0,17
Chennaiyin,6970,7,4,5,5,15,19,-4,17
FC Goa,6970,8,4,3,7,11,17,-6,15
Mumbai City,6971,1,7,4,3,18,8,10,25
Delhi Dynamo,6971,2,5,6,3,23,17,6,21
FC Pune City,6971,3,6,3,5,15,15,0,21
Kerala Blast,6971,4,6,3,5,13,16,-3,21
Chennaiyin,6971,5,4,6,4,17,19,-2,18
FC Goa,6971,6,4,3,7,14,17,-3,15
NorthEast Un,6971,7,4,3,7,12,15,-3,15
Kolkata,6971,8,3,6,5,14,19,-5,15
Mumbai City,6972,1,7,4,3,18,9,9,25
Delhi Dynamo,6972,2,5,6,3,26,17,9,21
Kolkata,6972,3,5,6,3,19,19,0,21
Kerala Blast,6972,4,5,4,5,14,16,-2,19
Chennaiyin,6972,5,4,5,5,15,19,-4,17
FC Goa,6972,6,5,2,7,13,18,-5,17
FC Pune City,6972,7,4,4,6,15,18,-3,16
NorthEast Un,6972,8,4,3,7,11,15,-4,15
Mumbai City,6973,1,7,4,3,18,8,10,25
Kolkata,6973,2,4,8,2,16,14,2,20
NorthEast Un,6973,3,6,2,6,14,14,0,20
Kerala Blast,6973,4,5,4,5,12,16,-4,19
Delhi Dynamo,6973,5,4,6,4,25,21,4,18
Chennaiyin,6973,6,4,5,5,17,21,-4,17
FC Pune City,6973,7,4,4,6,13,16,-3,16
FC Goa,6973,8,4,3,7,14,19,-5,15
Delhi Dynamo,6974,1,6,6,2,28,18,10,24
Mumbai City,6974,2,6,4,4,17,10,7,22
Kerala Blast,6974,3,6,3,5,13,16,-3,21
Chennaiyin,6974,4,5,5,4,18,20,-2,20
Kolkata,6974,5,4,6,4,16,15,1,18
NorthEast Un,6974,6,5,3,6,15,14,1,18
FC Pune City,6974,7,4,3,7,13,19,-6,15
FC Goa,6974,8,4,2,8,12,20,-8,14
Mumbai City,6975,1,6,5,3,17,9,8,23
Kolkata,6975,2,5,7,2,22,18,4,22
NorthEast Un,6975,3,6,2,6,14,13,1,20
Kerala Blast,6975,4,5,4,5,14,17,-3,19
Delhi Dynamo,6975,5,4,6,4,24,19,5,18
Chennaiyin,6975,6,4,6,4,17,20,-3,18
FC Pune City,6975,7,4,3,7,15,21,-6,15
FC Goa,6975,8,4,3,7,13,19,-6,15
Delhi Dynamo,6976,1,5,7,2,25,16,9,22
Mumbai City,6976,2,6,4,4,18,12,6,22
Kolkata,6976,3,4,8,2,20,15,5,20
Chennaiyin,6976,4,5,5,4,16,17,-1,20
Kerala Blast,6976,5,4,6,4,13,17,-4,18
NorthEast Un,6976,6,4,4,6,10,12,-2,16
FC Pune City,6976,7,4,4,6,15,21,-6,16
FC Goa,6976,8,3,4,7,9,16,-7,13
Mumbai City,6977,1,6,5,3,16,8,8,23
Delhi Dynamo,6977,2,5,7,2,22,14,8,22
Kolkata,6977,3,5,7,2,19,15,4,22
Kerala Blast,6977,4,6,3,5,13,15,-2,21
NorthEast Un,6977,5,4,4,6,11,12,-1,16
FC Pune City,6977,6,4,4,6,14,18,-4,16
Chennaiyin,6977,7,3,6,5,14,20,-6,15
FC Goa,6977,8,4,2,8,11,18,-7,14
Mumbai City,6978,1,7,4,3,18,9,9,25
Delhi Dynamo,6978,2,6,5,3,24,16,8,23
FC Pune City,6978,3,6,3,5,15,15,0,21
Kerala Blast,6978,4,6,3,5,15,16,-1,21
Chennaiyin,6978,5,4,6,4,15,17,-2,18
Kolkata,6978,6,3,7,4,16,19,-3,16
NorthEast Un,6978,7,4,2,8,10,14,-4,14
FC Goa,6978,8,3,4,7,9,16,-7,13
Delhi Dynamo,6979,1,7,5,2,28,17,11,26
Mumbai City,6979,2,6,4,4,18,11,7,22
Kerala Blast,6979,3,6,3,5,14,15,-1,21
NorthEast Un,6979,4,5,3,6,11,11,0,18
Chennaiyin,6979,5,4,6,4,16,19,-3,18
Kolkata,6979,6,3,7,4,19,20,-1,16
FC Pune City,6979,7,4,4,6,15,20,-5,16
FC Goa,6979,8,4,2,8,13,21,-8,14
Mumbai City,6980,1,7,4,3,17,8,9,25
Delhi Dynamo,6980,2,5,6,3,26,17,9,21
Chennaiyin,6980,3,5,5,4,17,17,0,20
FC Pune City,6980,4,5,4,5,14,15,-1,19
NorthEast Un,6980,5,5,3,6,13,12,1,18
Kolkata,6980,6,4,6,4,15,16,-1,18
Kerala Blast,6980,7,4,4,6,10,17,-7,16
FC Goa,6980,8,4,2,8,11,21,-10,14
Mumbai City,6981,1,7,4,3,19,8,11,25
Delhi Dynamo,6981,2,5,6,3,24,18,6,21
Chennaiyin,6981,3,5,5,4,17,17,0,20
Kerala Blast,6981,4,5,5,4,13,14,-1,20
Kolkata,6981,5,4,7,3,18,16,2,19
FC Pune City,6981,6,4,4,6,12,17,-5,16
NorthEast Un,6981,7,4,3,7,10,14,-4,15
FC Goa,6981,8,4,2,8,13,22,-9,14
Mumbai City,6982,1,7,4,3,18,9,9,25
FC Pune City,6982,2,5,4,5,16,17,-1,19
Delhi Dynamo,6982,3,4,6,4,25,21,4,18
FC Goa,6982,4,5,3,6,14,16,-2,18
NorthEast Un,6982,5,5,3,6,12,14,-2,18
Kolkata,6982,6,3,8,3,17,17,0,17
Chennaiyin,6982,7,4,5,5,16,19,-3,17
Kerala Blast,6982,8,4,5,5,11,16,-5,17
Mumbai City,6983,1,7,4,3,18,9,9,25
Kerala Blast,6983,2,7,3,4,18,14,4,24
Delhi Dynamo,6983,3,5,5,4,24,19,5,20
NorthEast Un,6983,4,5,3,6,14,13,1,18
FC Goa,6983,5,5,2,7,11,16,-5,17
Kolkata,6983,6,3,7,4,14,17,-3,16
FC Pune City,6983,7,4,4,6,13,18,-5,16
Chennaiyin,6983,8,3,6,5,14,20,-6,15
Delhi Dynamo,6984,1,6,6,2,30,19,11,24
Kolkata,6984,2,6,6,2,18,13,5,24
Mumbai City,6984,3,6,5,3,20,12,8,23
Kerala Blast,6984,4,5,4,5,13,15,-2,19
NorthEast Un,6984,5,4,4,6,12,15,-3,16
Chennaiyin,6984,6,3,6,5,15,20,-5,15
FC Pune City,6984,7,4,3,7,13,20,-7,15
FC Goa,6984,8,4,2,8,10,17,-7,14
Mumbai City,6985,1,7,4,3,18,9,9,25
Kolkata,6985,2,6,6,2,16,12,4,24
Delhi Dynamo,6985,3,6,5,3,26,17,9,23
NorthEast Un,6985,4,5,2,7,13,14,-1,17
Chennaiyin,6985,5,4,5,5,15,20,-5,17
FC Pune City,6985,6,4,4,6,13,16,-3,16
Kerala Blast,6985,7,4,4,6,11,18,-7,16
FC Goa,6985,8,4,2,8,11,17,-6,14
Mumbai City,6986,1,6,4,4,16,11,5,22
Kolkata,6986,2,5,7,2,18,14,4,22
Delhi Dynamo,6986,3,5,5,4,24,18,6,20
NorthEast Un,6986,4,5,4,5,15,12,3,19
Kerala Blast,6986,5,5,4,5,12,17,-5,19
FC Goa,6986,6,5,3,6,13,16,-3,18
FC Pune City,6986,7,4,3,7,14,18,-4,15
Chennaiyin,6986,8,3,6,5,16,22,-6,15
Mumbai City,6987,1,7,4,3,18,9,9,25
NorthEast Un,6987,2,7,2,5,14,10,4,23
FC Pune City,6987,3,6,3,5,18,16,2,21
Delhi Dynamo,6987,4,5,5,4,24,17,7,20
Kolkata,6987,5,3,8,3,15,17,-2,17
Kerala Blast,6987,6,4,4,6,12,19,-7,16
FC Goa,6987,7,4,3,7,11,18,-7,15
Chennaiyin,6987,8,3,5,6,15,21,-6,14
Mumbai City,6988,1,7,4,3,18,9,9,25
NorthEast Un,6988,2,6,3,5,14,10,4,21
FC Pune City,6988,3,6,3,5,16,15,1,21
Delhi Dynamo,6988,4,4,6,4,22,18,4,18
Kerala Blast,6988,5,4,5,5,12,17,-5,17
FC Goa,6988,6,4,4,6,13,16,-3,16
Kolkata,6988,7,3,7,4,15,19,-4,16
Chennaiyin,6988,8,3,6,5,14,20,-6,15
Mumbai City,6989,1,7,4,3,18,8,10,25
Kolkata,6989,2,6,6,2,19,14,5,24
Delhi Dynamo,6989,3,5,6,3,22,16,6,21
Chennaiyin,6989,4,5,5,4,18,18,0,20
Kerala Blast,6989,5,5,3,6,14,19,-5,18
NorthEast Un,6989,6,5,2,7,11,12,-1,17
FC Pune City,6989,7,4,3,7,12,18,-6,15
FC Goa,6989,8,3,3,8,9,18,-9,12
Mumbai City,6990,1,7,4,3,18,9,9,25
Delhi Dynamo,6990,2,6,5,3,25,17,8,23
Kerala Blast,6990,3,5,5,4,15,16,-1,20
Kolkata,6990,4,4,7,3,15,14,1,19
NorthEast Un,6990,5,5,2,7,13,14,-1,17
FC Pune City,6990,6,4,4,6,13,16,-3,16
FC Goa,6990,7,4,3,7,11,17,-6,15
Chennaiyin,6990,8,3,6,5,14,21,-7,15
Delhi Dynamo,6991,1,6,5,3,26,18,8,23
Mumbai City,6991,2,6,4,4,16,9,7,22
Kerala Blast,6991,3,6,4,4,13,14,-1,22
Kolkata,6991,4,4,8,2,17,15,2,20
NorthEast Un,6991,5,5,3,6,12,11,1,18
FC Pune City,6991,6,4,4,6,14,18,-4,16
Chennaiyin,6991,7,3,6,5,16,21,-5,15
FC Goa,6991,8,4,2,8,13,21,-8,14
Delhi Dynamo,6992,1,6,6,2,29,16,13,24
Kolkata,6992,2,6,6,2,20,13,7,24
Mumbai City,6992,3,6,4,4,17,10,7,22
Kerala Blast,6992,4,5,3,6,13,17,-4,18
Chennaiyin,6992,5,4,5,5,18,22,-4,17
NorthEast Un,6992,6,5,2,7,12,18,-6,17
FC Pune City,6992,7,4,3,7,13,18,-5,15
FC Goa,6992,8,4,3,7,12,20,-8,15
Delhi Dynamo,6993,1,6,6,2,27,18,9,24
Mumbai City,6993,2,6,5,3,17,9,8,23
Kerala Blast,6993,3,6,3,5,13,15,-2,21
Kolkata,6993,4,4,6,4,15,16,-1,18
FC Pune City,6993,5,5,3,6,15,17,-2,18
Chennaiyin,6993,6,4,5,5,16,20,-4,17
FC Goa,6993,7,5,2,7,13,17,-4,17
NorthEast Un,6993,8,4,2,8,12,16,-4,14
Mumbai City,6994,1,7,4,3,19,8,11,25
Delhi Dynamo,6994,2,5,6,3,25,19,6,21
Kolkata,6994,3,5,6,3,18,15,3,21
Kerala Blast,6994,4,5,4,5,13,16,-3,19
NorthEast Un,6994,5,5,3,6,15,14,1,18
FC Pune City,6994,6,4,4,6,14,18,-4,16
Chennaiyin,6994,7,3,6,5,16,23,-7,15
FC Goa,6994,8,4,3,7,11,18,-7,15
Delhi Dynamo,6995,1,6,5,3,25,17,8,23
Mumbai City,6995,2,6,4,4,16,9,7,22
Kolkata,6995,3,5,7,2,18,14,4,22
Kerala Blast,6995,4,6,3,5,12,16,-4,21
Chennaiyin,6995,5,5,5,4,15,17,-2,20
NorthEast Un,6995,6,5,2,7,11,12,-1,17
FC Pune City,6995,7,4,3,7,14,18,-4,15
FC Goa,6995,8,3,3,8,10,18,-8,12
Mumbai City,6996,1,7,4,3,17,8,9,25
Delhi Dynamo,6996,2,5,6,3,24,16,8,21
Kolkata,6996,3,5,6,3,16,14,2,21
Kerala Blast,6996,4,5,4,5,12,15,-3,19
NorthEast Un,6996,5,5,2,7,11,13,-2,17
Chennaiyin,6996,6,4,5,5,15,20,-5,17
FC Pune City,6996,7,4,4,6,14,17,-3,16
FC Goa,6996,8,4,3,7,11,17,-6,15
Mumbai City,6997,1,6,5,3,17,9,8,23
Delhi Dynamo,6997,2,5,7,2,27,18,9,22
Kolkata,6997,3,5,6,3,16,14,2,21
FC Pune City,6997,4,5,4,5,15,15,0,19
NorthEast Un,6997,5,4,5,5,11,11,0,17
Kerala Blast,6997,6,4,5,5,11,16,-5,17
Chennaiyin,6997,7,3,6,5,13,18,-5,15
FC Goa,6997,8,4,2,8,11,20,-9,14
Mumbai City,6998,1,7,4,3,17,8,9,25
Delhi Dynamo,6998,2,5,6,3,24,16,8,21
Kerala Blast,6998,3,6,3,5,17,18,-1,21
NorthEast Un,6998,4,6,2,6,14,14,0,20
Kolkata,6998,5,4,7,3,18,16,2,19
FC Goa,6998,6,4,4,6,11,16,-5,16
FC Pune City,6998,7,4,3,7,15,22,-7,15
Chennaiyin,6998,8,3,5,6,15,21,-6,14
Mumbai City,6999,1,6,5,3,16,8,8,23
Delhi Dynamo,6999,2,5,7,2,23,15,8,22
Kerala Blast,6999,3,5,5,4,13,16,-3,20
Kolkata,6999,4,4,7,3,16,14,2,19
NorthEast Un,6999,5,4,5,5,10,10,0,17
FC Pune City,6999,6,4,4,6,15,19,-4,16
Chennaiyin,6999,7,3,7,4,13,17,-4,16
FC Goa,6999,8,3,4,7,9,16,-7,13
Mumbai City,7000,1,6,5,3,18,10,8,23
Kolkata,7000,2,5,7,2,18,14,4,22
Delhi Dynamo,7000,3,5,6,3,26,19,7,21
Kerala Blast,7000,4,6,3,5,14,18,-4,21
NorthEast Un,7000,5,6,2,6,12,11,1,20
FC Pune City,7000,6,4,4,6,14,17,-3,16
Chennaiyin,7000,7,3,6,5,14,19,-5,15
FC Goa,7000,8,3,3,8,11,19,-8,12
Mumbai City,7001,1,6,5,3,16,8,8,23
Delhi Dynamo,7001,2,5,6,3,23,16,7,21
Kolkata,7001,3,4,7,3,17,16,1,19
NorthEast Un,7001,4,5,4,5,12,11,1,19
Kerala Blast,7001,5,5,4,5,12,15,-3,19
FC Goa,7001,6,5,2,7,15,16,-1,17
FC Pune City,7001,7,4,4,6,13,17,-4,16
Chennaiyin,7001,8,3,6,5,14,23,-9,15
Mumbai City,7002,1,7,4,3,17,8,9,25
Kolkata,7002,2,5,7,2,17,13,4,22
Delhi Dynamo,7002,3,5,5,4,24,18,6,20
NorthEast Un,7002,4,6,2,6,11,10,1,20
Kerala Blast,7002,5,5,5,4,13,16,-3,20
FC Pune City,7002,6,4,4,6,16,19,-3,16
Chennaiyin,7002,7,3,6,5,13,18,-5,15
FC Goa,7002,8,3,3,8,10,19,-9,12
Mumbai City,7003,1,6,5,3,17,9,8,23
Delhi Dynamo,7003,2,5,7,2,26,17,9,22
Kolkata,7003,3,5,6,3,16,13,3,21
NorthEast Un,7003,4,6,2,6,13,11,2,20
FC Pune City,7003,5,5,3,6,15,17,-2,18
Chennaiyin,7003,6,4,5,5,17,21,-4,17
FC Goa,7003,7,4,3,7,13,20,-7,15
Kerala Blast,7003,8,4,3,7,10,19,-9,15
Mumbai City,7004,1,7,4,3,17,8,9,25
Kolkata,7004,2,6,6,2,18,13,5,24
Delhi Dynamo,7004,3,6,5,3,26,16,10,23
NorthEast Un,7004,4,6,2,6,14,13,1,20
Kerala Blast,7004,5,5,3,6,12,17,-5,18
FC Pune City,7004,6,4,3,7,15,20,-5,15
Chennaiyin,7004,7,3,6,5,14,20,-6,15
FC Goa,7004,8,3,3,8,8,17,-9,12
Mumbai City,7005,1,7,4,3,19,10,9,25
Delhi Dynamo,7005,2,5,6,3,30,19,11,21
Kerala Blast,7005,3,6,3,5,12,16,-4,21
Kolkata,7005,4,4,6,4,16,14,2,18
FC Pune City,7005,5,5,3,6,14,17,-3,18
Chennaiyin,7005,6,4,5,5,14,18,-4,17
NorthEast Un,7005,7,5,2,7,11,16,-5,17
FC Goa,7005,8,4,3,7,11,17,-6,15
Delhi Dynamo,7006,1,6,6,2,31,15,16,24
Mumbai City,7006,2,6,4,4,16,10,6,22
Kolkata,7006,3,5,6,3,18,16,2,21
FC Pune City,7006,4,5,4,5,16,17,-1,19
NorthEast Un,7006,5,4,5,5,12,12,0,17
Kerala Blast,7006,6,4,5,5,12,17,-5,17
Chennaiyin,7006,7,3,6,5,14,23,-9,15
FC Goa,7006,8,4,2,8,13,22,-9,14
Delhi Dynamo,7007,1,6,5,3,28,18,10,23
Mumbai City,7007,2,6,4,4,17,10,7,22
Kolkata,7007,3,4,8,2,16,14,2,20
NorthEast Un,7007,4,6,2,6,12,10,2,20
Kerala Blast,7007,5,5,4,5,11,15,-4,19
FC Pune City,7007,6,4,5,5,13,15,-2,17
Chennaiyin,7007,7,3,6,5,13,19,-6,15
FC Goa,7007,8,3,4,7,12,21,-9,13
Delhi Dynamo,7008,1,6,5,3,27,17,10,23
Mumbai City,7008,2,6,4,4,17,10,7,22
Kolkata,7008,3,5,7,2,21,16,5,22
NorthEast Un,7008,4,6,3,5,13,11,2,21
Kerala Blast,7008,5,5,3,6,12,18,-6,18
FC Pune City,7008,6,4,4,6,14,17,-3,16
Chennaiyin,7008,7,3,6,5,15,20,-5,15
FC Goa,7008,8,4,2,8,12,22,-10,14
Mumbai City,7009,1,7,4,3,18,9,9,25
NorthEast Un,7009,2,7,2,5,14,9,5,23
FC Pune City,7009,3,6,3,5,16,16,0,21
Delhi Dynamo,7009,4,4,6,4,23,19,4,18
Kolkata,7009,5,3,7,4,16,17,-1,16
FC Goa,7009,6,4,4,6,12,17,-5,16
Kerala Blast,7009,7,4,4,6,12,18,-6,16
Chennaiyin,7009,8,3,6,5,15,21,-6,15
Delhi Dynamo,7010,1,6,6,2,25,15,10,24
Mumbai City,7010,2,6,4,4,16,10,6,22
Kolkata,7010,3,5,6,3,20,13,7,21
NorthEast Un,7010,4,5,4,5,12,11,1,19
Kerala Blast,7010,5,5,4,5,13,17,-4,19
FC Goa,7010,6,5,2,7,12,16,-4,17
FC Pune City,7010,7,4,3,7,12,21,-9,15
Chennaiyin,7010,8,3,5,6,14,21,-7,14
Delhi Dynamo,7011,1,7,5,2,29,17,12,26
Mumbai City,7011,2,6,4,4,19,13,6,22
Kerala Blast,7011,3,5,5,4,14,16,-2,20
Kolkata,7011,4,3,8,3,17,17,0,17
FC Pune City,7011,5,4,5,5,15,17,-2,17
NorthEast Un,7011,6,5,2,7,11,13,-2,17
Chennaiyin,7011,7,4,5,5,14,19,-5,17
FC Goa,7011,8,4,2,8,9,16,-7,14
Mumbai City,7012,1,7,4,3,22,11,11,25
FC Pune City,7012,2,6,3,5,16,16,0,21
Chennaiyin,7012,3,5,5,4,19,21,-2,20
Delhi Dynamo,7012,4,4,7,3,24,20,4,19
Kerala Blast,7012,5,5,4,5,13,17,-4,19
Kolkata,7012,6,3,7,4,17,19,-2,16
NorthEast Un,7012,7,4,3,7,12,14,-2,15
FC Goa,7012,8,4,3,7,12,17,-5,15
Delhi Dynamo,7013,1,6,6,2,26,16,10,24
Kolkata,7013,2,6,6,2,20,12,8,24
Mumbai City,7013,3,6,4,4,16,10,6,22
NorthEast Un,7013,4,5,4,5,12,10,2,19
FC Pune City,7013,5,4,4,6,14,20,-6,16
Kerala Blast,7013,6,4,4,6,12,19,-7,16
Chennaiyin,7013,7,3,6,5,13,19,-6,15
FC Goa,7013,8,4,2,8,12,19,-7,14
Mumbai City,7014,1,6,4,4,18,13,5,22
Delhi Dynamo,7014,2,5,6,3,29,21,8,21
NorthEast Un,7014,3,5,4,5,13,11,2,19
Kolkata,7014,4,4,7,3,18,17,1,19
Kerala Blast,7014,5,5,4,5,11,16,-5,19
FC Pune City,7014,6,5,3,6,15,16,-1,18
Chennaiyin,7014,7,4,5,5,16,21,-5,17
FC Goa,7014,8,4,3,7,15,20,-5,15
Mumbai City,7015,1,7,4,3,20,8,12,25
Kerala Blast,7015,2,5,5,4,16,15,1,20
Chennaiyin,7015,3,4,6,4,15,18,-3,18
FC Goa,7015,4,5,3,6,13,16,-3,18
Delhi Dynamo,7015,5,4,5,5,21,20,1,17
Kolkata,7015,6,3,8,3,15,16,-1,17
FC Pune City,7015,7,4,5,5,13,15,-2,17
NorthEast Un,7015,8,5,2,7,10,15,-5,17
Delhi Dynamo,7016,1,6,5,3,25,18,7,23
Kolkata,7016,2,5,7,2,21,14,7,22
Mumbai City,7016,3,6,4,4,17,10,7,22
NorthEast Un,7016,4,5,3,6,13,12,1,18
FC Pune City,7016,5,5,3,6,14,18,-4,18
Kerala Blast,7016,6,5,3,6,10,17,-7,18
Chennaiyin,7016,7,3,7,4,14,18,-4,16
FC Goa,7016,8,3,4,7,10,17,-7,13
Mumbai City,7017,1,6,5,3,17,9,8,23
Delhi Dynamo,7017,2,5,7,2,25,17,8,22
Kolkata,7017,3,4,7,3,15,15,0,19
NorthEast Un,7017,4,5,3,6,12,12,0,18
FC Pune City,7017,5,5,3,6,15,16,-1,18
Kerala Blast,7017,6,5,3,6,11,16,-5,18
Chennaiyin,7017,7,4,5,5,14,18,-4,17
FC Goa,7017,8,4,3,7,9,15,-6,15
Mumbai City,7018,1,6,4,4,17,10,7,22
Kerala Blast,7018,2,6,4,4,17,17,0,22
Delhi Dynamo,7018,3,5,6,3,24,17,7,21
NorthEast Un,7018,4,5,3,6,11,12,-1,18
FC Pune City,7018,5,4,5,5,14,16,-2,17
Kolkata,7018,6,3,7,4,16,18,-2,16
Chennaiyin,7018,7,3,7,4,14,18,-4,16
FC Goa,7018,8,4,4,6,11,16,-5,16
Mumbai City,7019,1,6,5,3,19,11,8,23
NorthEast Un,7019,2,6,3,5,13,10,3,21
Kolkata,7019,3,4,8,2,16,14,2,20
Kerala Blast,7019,4,5,4,5,12,16,-4,19
Delhi Dynamo,7019,5,4,6,4,26,23,3,18
FC Goa,7019,6,5,3,6,14,16,-2,18
FC Pune City,7019,7,4,4,6,12,15,-3,16
Chennaiyin,7019,8,3,5,6,14,21,-7,14
Mumbai City,7020,1,7,4,3,19,10,9,25
Delhi Dynamo,7020,2,6,5,3,31,20,11,23
Kolkata,7020,3,4,8,2,17,15,2,20
Chennaiyin,7020,4,4,6,4,15,17,-2,18
Kerala Blast,7020,5,4,6,4,13,17,-4,18
FC Pune City,7020,6,4,5,5,13,15,-2,17
NorthEast Un,7020,7,4,3,7,12,15,-3,15
FC Goa,7020,8,3,3,8,10,21,-11,12
Mumbai City,7021,1,6,5,3,18,10,8,23
Delhi Dynamo,7021,2,5,7,2,28,19,9,22
Chennaiyin,7021,3,5,5,4,18,18,0,20
FC Pune City,7021,4,5,4,5,13,14,-1,19
Kerala Blast,7021,5,5,4,5,12,15,-3,19
Kolkata,7021,6,3,7,4,14,16,-2,16
NorthEast Un,7021,7,4,3,7,11,15,-4,15
FC Goa,7021,8,4,3,7,13,20,-7,15
Mumbai City,7022,1,7,4,3,18,9,9,25
Delhi Dynamo,7022,2,5,6,3,26,18,8,21
FC Pune City,7022,3,5,4,5,14,15,-1,19
NorthEast Un,7022,4,5,3,6,12,13,-1,18
Kolkata,7022,5,3,8,3,16,16,0,17
FC Goa,7022,6,5,2,7,15,19,-4,17
Chennaiyin,7022,7,4,5,5,17,22,-5,17
Kerala Blast,7022,8,4,4,6,10,16,-6,16
Delhi Dynamo,7023,1,6,5,3,26,16,10,23
Mumbai City,7023,2,6,4,4,16,12,4,22
Kolkata,7023,3,5,7,2,16,13,3,22
NorthEast Un,7023,4,6,3,5,13,10,3,21
Chennaiyin,7023,5,4,6,4,15,18,-3,18
Kerala Blast,7023,6,5,3,6,11,16,-5,18
FC Pune City,7023,7,4,3,7,13,17,-4,15
FC Goa,7023,8,3,3,8,9,17,-8,12
Mumbai City,7024,1,7,4,3,19,8,11,25
Kerala Blast,7024,2,7,3,4,14,14,0,24
Delhi Dynamo,7024,3,5,6,3,22,17,5,21
Kolkata,7024,4,4,7,3,15,14,1,19
NorthEast Un,7024,5,5,2,7,10,12,-2,17
Chennaiyin,7024,6,4,5,5,16,19,-3,17
FC Pune City,7024,7,4,4,6,14,17,-3,16
FC Goa,7024,8,3,3,8,9,18,-9,12
Delhi Dynamo,7025,1,5,7,2,23,15,8,22
Mumbai City,7025,2,6,4,4,17,10,7,22
FC Pune City,7025,3,5,4,5,13,14,-1,19
NorthEast Un,7025,4,5,3,6,12,13,-1,18
Chennaiyin,7025,5,4,6,4,15,17,-2,18
Kolkata,7025,6,3,8,3,14,14,0,17
Kerala Blast,7025,7,4,5,5,12,17,-5,17
FC Goa,7025,8,3,5,6,8,14,-6,14
Delhi Dynamo,7026,1,6,6,2,28,18,10,24
Mumbai City,7026,2,6,4,4,16,10,6,22
Kerala Blast,7026,3,5,5,4,14,16,-2,20
Kolkata,7026,4,4,7,3,18,18,0,19
Chennaiyin,7026,5,4,6,4,15,18,-3,18
NorthEast Un,7026,6,4,5,5,13,13,0,17
FC Pune City,7026,7,4,4,6,12,15,-3,16
FC Goa,7026,8,3,3,8,12,20,-8,12
Mumbai City,7027,1,7,4,3,17,8,9,25
Delhi Dynamo,7027,2,6,5,3,26,15,11,23
Kerala Blast,7027,3,6,4,4,12,14,-2,22
Kolkata,7027,4,4,6,4,14,14,0,18
Chennaiyin,7027,5,4,5,5,15,19,-4,17
FC Goa,7027,6,5,2,7,10,18,-8,17
FC Pune City,7027,7,4,4,6,13,16,-3,16
NorthEast Un,7027,8,4,2,8,10,13,-3,14
Mumbai City,7028,1,7,4,3,17,8,9,25
Delhi Dynamo,7028,2,5,5,4,26,19,7,20
Chennaiyin,7028,3,5,5,4,18,17,1,20
Kerala Blast,7028,4,5,5,4,15,17,-2,20
FC Pune City,7028,5,4,5,5,16,18,-2,17
Kolkata,7028,5,3,8,3,16,18,-2,17
NorthEast Un,7028,7,5,2,7,12,15,-3,17
FC Goa,7028,8,4,2,8,13,21,-8,14
Mumbai City,7029,1,6,4,4,16,9,7,22
Kolkata,7029,2,5,7,2,16,12,4,22
Delhi Dynamo,7029,3,5,5,4,22,16,6,20
Chennaiyin,7029,4,5,5,4,18,18,0,20
NorthEast Un,7029,5,6,2,6,12,13,-1,20
Kerala Blast,7029,6,5,3,6,11,17,-6,18
FC Pune City,7029,7,4,3,7,12,16,-4,15
FC Goa,7029,8,4,3,7,10,16,-6,15
Mumbai City,7030,1,7,4,3,18,9,9,25
NorthEast Un,7030,2,7,2,5,14,9,5,23
Kerala Blast,7030,3,6,3,5,13,15,-2,21
FC Pune City,7030,4,5,3,6,14,17,-3,18
Delhi Dynamo,7030,5,4,5,5,22,19,3,17
Kolkata,7030,6,3,7,4,15,16,-1,16
FC Goa,7030,7,4,4,6,10,15,-5,16
Chennaiyin,7030,8,3,6,5,14,20,-6,15
Mumbai City,7031,1,7,4,3,19,9,10,25
Delhi Dynamo,7031,2,5,6,3,24,17,7,21
Kerala Blast,7031,3,5,5,4,11,14,-3,20
Kolkata,7031,4,4,7,3,16,14,2,19
FC Pune City,7031,5,5,4,5,15,16,-1,19
Chennaiyin,7031,6,4,6,4,16,17,-1,18
NorthEast Un,7031,7,4,4,6,9,10,-1,16
FC Goa,7031,8,3,2,9,8,21,-13,11
Delhi Dynamo,7032,1,6,6,2,25,16,9,24
Mumbai City,7032,2,6,4,4,18,11,7,22
Kolkata,7032,3,4,8,2,15,13,2,20
FC Pune City,7032,4,5,4,5,13,14,-1,19
NorthEast Un,7032,5,5,3,6,11,11,0,18
Chennaiyin,7032,6,4,6,4,15,18,-3,18
Kerala Blast,7032,7,4,3,7,9,16,-7,15
FC Goa,7032,8,3,4,7,9,16,-7,13
Mumbai City,7033,1,7,4,3,18,8,10,25
Delhi Dynamo,7033,2,5,5,4,23,18,5,20
Kerala Blast,7033,3,5,5,4,12,15,-3,20
Kolkata,7033,4,4,7,3,17,14,3,19
Chennaiyin,7033,5,4,6,4,15,18,-3,18
FC Goa,7033,6,5,3,6,11,15,-4,18
FC Pune City,7033,7,4,4,6,14,19,-5,16
NorthEast Un,7033,8,4,2,8,11,14,-3,14
Mumbai City,7034,1,7,4,3,19,10,9,25
Kolkata,7034,2,6,6,2,18,13,5,24
Delhi Dynamo,7034,3,5,5,4,26,19,7,20
NorthEast Un,7034,4,5,4,5,12,11,1,19
FC Pune City,7034,5,5,3,6,14,15,-1,18
Chennaiyin,7034,6,4,6,4,15,17,-2,18
Kerala Blast,7034,7,4,4,6,12,19,-7,16
FC Goa,7034,8,3,2,9,9,21,-12,11
Delhi Dynamo,7035,1,6,6,2,26,17,9,24
Mumbai City,7035,2,6,4,4,16,9,7,22
Kolkata,7035,3,4,8,2,15,13,2,20
Chennaiyin,7035,4,5,5,4,18,20,-2,20
Kerala Blast,7035,5,5,4,5,11,14,-3,19
NorthEast Un,7035,6,5,3,6,11,11,0,18
FC Pune City,7035,7,4,4,6,12,16,-4,16
FC Goa,7035,8,3,2,9,14,23,-9,11
Mumbai City,7036,1,7,4,3,19,10,9,25
Kolkata,7036,2,6,6,2,18,13,5,24
Kerala Blast,7036,3,6,3,5,13,15,-2,21
Delhi Dynamo,7036,4,4,7,3,25,19,6,19
Chennaiyin,7036,5,4,6,4,15,18,-3,18
NorthEast Un,7036,6,4,4,6,11,13,-2,16
FC Pune City,7036,7,4,3,7,12,17,-5,15
FC Goa,7036,8,3,3,8,9,17,-8,12
Mumbai City,7037,1,7,4,3,17,8,9,25
Kerala Blast,7037,2,6,3,5,11,16,-5,21
NorthEast Un,7037,3,6,2,6,18,15,3,20
Delhi Dynamo,7037,4,4,6,4,25,22,3,18
FC Goa,7037,5,5,3,6,13,17,-4,18
Chennaiyin,7037,6,4,5,5,16,18,-2,17
Kolkata,7037,7,3,7,4,15,16,-1,16
FC Pune City,7037,8,4,4,6,12,15,-3,16
Kolkata,7038,1,6,6,2,19,13,6,24
Mumbai City,7038,2,6,5,3,16,8,8,23
Delhi Dynamo,7038,3,4,8,2,23,16,7,20
NorthEast Un,7038,4,5,4,5,12,9,3,19
Kerala Blast,7038,5,5,3,6,11,19,-8,18
FC Pune City,7038,6,4,3,7,13,17,-4,15
Chennaiyin,7038,7,3,6,5,13,18,-5,15
FC Goa,7038,8,4,3,7,12,19,-7,15
Delhi Dynamo,7039,1,6,5,3,26,16,10,23
Mumbai City,7039,2,6,4,4,16,10,6,22
NorthEast Un,7039,3,6,3,5,14,9,5,21
Kolkata,7039,4,5,6,3,17,13,4,21
FC Pune City,7039,5,5,3,6,14,16,-2,18
Kerala Blast,7039,6,5,3,6,11,21,-10,18
Chennaiyin,7039,7,3,6,5,13,19,-6,15
FC Goa,7039,8,4,2,8,11,18,-7,14
Mumbai City,7040,1,7,4,3,18,8,10,25
Kolkata,7040,2,6,6,2,20,14,6,24
Kerala Blast,7040,3,5,4,5,13,17,-4,19
Delhi Dynamo,7040,4,4,6,4,22,18,4,18
Chennaiyin,7040,5,4,6,4,15,17,-2,18
NorthEast Un,7040,6,4,5,5,11,11,0,17
FC Pune City,7040,7,4,3,7,13,18,-5,15
FC Goa,7040,8,4,2,8,9,18,-9,14
Delhi Dynamo,7041,1,6,5,3,26,17,9,23
Mumbai City,7041,2,6,4,4,17,10,7,22
Kerala Blast,7041,3,6,4,4,15,14,1,22
Kolkata,7041,4,5,6,3,18,14,4,21
NorthEast Un,7041,5,6,2,6,13,14,-1,20
Chennaiyin,7041,6,4,5,5,17,20,-3,17
FC Pune City,7041,7,4,4,6,12,16,-4,16
FC Goa,7041,8,3,2,9,9,22,-13,11
Mumbai City,7042,1,7,4,3,18,9,9,25
Delhi Dynamo,7042,2,5,5,4,25,18,7,20
FC Goa,7042,3,6,2,6,14,16,-2,20
Kolkata,7042,4,4,7,3,18,17,1,19
FC Pune City,7042,5,5,3,6,17,17,0,18
Chennaiyin,7042,6,4,5,5,16,21,-5,17
Kerala Blast,7042,7,4,5,5,12,19,-7,17
NorthEast Un,7042,8,4,3,7,11,14,-3,15
Mumbai City,7043,1,7,4,3,20,9,11,25
Kolkata,7043,2,5,6,3,20,15,5,21
Kerala Blast,7043,3,6,3,5,13,16,-3,21
NorthEast Un,7043,4,5,3,6,11,11,0,18
FC Pune City,7043,5,5,3,6,15,18,-3,18
Delhi Dynamo,7043,6,4,5,5,22,21,1,17
FC Goa,7043,7,5,2,7,12,18,-6,17
Chennaiyin,7043,8,3,6,5,14,19,-5,15
Delhi Dynamo,7044,1,6,5,3,27,19,8,23
Mumbai City,7044,2,6,4,4,16,9,7,22
Kolkata,7044,3,5,6,3,19,17,2,21
NorthEast Un,7044,4,6,2,6,17,12,5,20
FC Pune City,7044,5,5,4,5,18,17,1,19
Kerala Blast,7044,6,5,4,5,13,18,-5,19
Chennaiyin,7044,7,3,5,6,14,21,-7,14
FC Goa,7044,8,4,2,8,11,22,-11,14
Mumbai City,7045,1,7,4,3,17,8,9,25
Delhi Dynamo,7045,2,5,6,3,26,19,7,21
FC Pune City,7045,3,5,4,5,15,14,1,19
Kolkata,7045,3,4,7,3,15,14,1,19
FC Goa,7045,5,5,3,6,12,16,-4,18
Chennaiyin,7045,6,4,5,5,16,18,-2,17
Kerala Blast,7045,7,4,4,6,10,18,-8,16
NorthEast Un,7045,8,4,3,7,11,15,-4,15
Mumbai City,7046,1,7,4,3,18,8,10,25
FC Pune City,7046,2,6,3,5,15,15,0,21
Delhi Dynamo,7046,3,5,5,4,23,18,5,20
Chennaiyin,7046,4,5,5,4,16,18,-2,20
Kolkata,7046,5,4,7,3,16,15,1,19
NorthEast Un,7046,6,5,3,6,12,12,0,18
Kerala Blast,7046,7,4,5,5,12,17,-5,17
FC Goa,7046,8,3,2,9,8,17,-9,11
Mumbai City,7047,1,6,4,4,16,9,7,22
NorthEast Un,7047,2,6,3,5,15,13,2,21
Kerala Blast,7047,3,6,3,5,14,17,-3,21
Delhi Dynamo,7047,4,5,5,4,23,19,4,20
Kolkata,7047,5,4,6,4,18,17,1,18
Chennaiyin,7047,6,4,6,4,16,19,-3,18
FC Goa,7047,7,5,2,7,12,15,-3,17
FC Pune City,7047,8,4,3,7,13,18,-5,15
Mumbai City,7048,1,7,4,3,17,8,9,25
FC Pune City,7048,2,6,3,5,14,14,0,21
Delhi Dynamo,7048,3,5,5,4,23,19,4,20
NorthEast Un,7048,4,6,2,6,15,16,-1,20
Kolkata,7048,5,4,6,4,15,15,0,18
Kerala Blast,7048,6,5,3,6,15,17,-2,18
FC Goa,7048,7,5,2,7,12,16,-4,17
Chennaiyin,7048,8,3,5,6,14,20,-6,14
Mumbai City,7049,1,6,5,3,17,9,8,23
Delhi Dynamo,7049,2,5,6,3,23,17,6,21
Kolkata,7049,3,5,6,3,18,14,4,21
Kerala Blast,7049,4,6,3,5,13,15,-2,21
NorthEast Un,7049,5,6,2,6,14,12,2,20
FC Pune City,7049,6,5,3,6,13,18,-5,18
Chennaiyin,7049,7,4,5,5,17,20,-3,17
FC Goa,7049,8,3,2,9,9,19,-10,11
Mumbai City,7050,1,6,5,3,18,10,8,23
Delhi Dynamo,7050,2,5,7,2,25,17,8,22
Kerala Blast,7050,3,5,5,4,12,14,-2,20
Kolkata,7050,4,4,7,3,18,18,0,19
Chennaiyin,7050,5,4,6,4,17,20,-3,18
NorthEast Un,7050,6,4,5,5,12,12,0,17
FC Pune City,7050,7,4,4,6,17,20,-3,16
FC Goa,7050,8,3,3,8,9,17,-8,12
Mumbai City,7051,1,7,4,3,17,8,9,25
Delhi Dynamo,7051,2,6,5,3,25,17,8,23
Kolkata,7051,3,5,7,2,17,12,5,22
Kerala Blast,7051,4,6,4,4,16,14,2,22
NorthEast Un,7051,5,5,2,7,13,17,-4,17
Chennaiyin,7051,6,3,6,5,15,20,-5,15
FC Pune City,7051,7,4,3,7,13,20,-7,15
FC Goa,7051,8,3,3,8,9,17,-8,12
Mumbai City,7052,1,6,5,3,16,8,8,23
Kerala Blast,7052,2,6,4,4,12,13,-1,22
Delhi Dynamo,7052,3,4,8,2,23,16,7,20
NorthEast Un,7052,4,5,4,5,11,9,2,19
FC Goa,7052,5,5,3,6,15,16,-1,18
FC Pune City,7052,6,5,3,6,14,17,-3,18
Kolkata,7052,7,3,6,5,14,18,-4,15
Chennaiyin,7052,8,3,5,6,13,21,-8,14
Mumbai City,7053,1,6,5,3,16,8,8,23
Kolkata,7053,2,5,7,2,18,13,5,22
Delhi Dynamo,7053,3,5,6,3,23,17,6,21
NorthEast Un,7053,4,5,4,5,14,12,2,19
Kerala Blast,7053,5,5,4,5,12,16,-4,19
Chennaiyin,7053,6,3,6,5,14,19,-5,15
FC Pune City,7053,7,4,3,7,12,18,-6,15
FC Goa,7053,8,4,3,7,10,16,-6,15
Mumbai City,7054,1,6,5,3,18,10,8,23
Delhi Dynamo,7054,2,5,6,3,27,18,9,21
Chennaiyin,7054,3,5,5,4,19,19,0,20
Kerala Blast,7054,4,5,5,4,14,16,-2,20
FC Pune City,7054,5,4,5,5,16,18,-2,17
Kolkata,7054,6,3,8,3,15,17,-2,17
NorthEast Un,7054,7,5,2,7,14,16,-2,17
FC Goa,7054,8,4,2,8,11,20,-9,14
Mumbai City,7055,1,6,5,3,18,10,8,23
Delhi Dynamo,7055,2,5,7,2,25,17,8,22
Kerala Blast,7055,3,6,4,4,14,14,0,22
NorthEast Un,7055,4,5,4,5,11,10,1,19
Kolkata,7055,5,4,6,4,16,21,-5,18
Chennaiyin,7055,6,4,5,5,15,19,-4,17
FC Pune City,7055,7,4,3,7,15,19,-4,15
FC Goa,7055,8,4,2,8,13,17,-4,14
Kerala Blast,7056,1,7,3,4,16,14,2,24
Delhi Dynamo,7056,2,6,5,3,25,19,6,23
Mumbai City,7056,3,6,4,4,17,10,7,22
FC Pune City,7056,4,5,3,6,15,17,-2,18
Kolkata,7056,5,4,6,4,14,16,-2,18
Chennaiyin,7056,6,4,6,4,14,17,-3,18
NorthEast Un,7056,7,5,2,7,13,12,1,17
FC Goa,7056,8,3,3,8,8,17,-9,12
Mumbai City,7057,1,6,5,3,17,9,8,23
Delhi Dynamo,7057,2,5,6,3,25,17,8,21
Kolkata,7057,3,5,6,3,16,14,2,21
FC Goa,7057,4,6,2,6,14,14,0,20
Kerala Blast,7057,5,5,4,5,11,15,-4,19
NorthEast Un,7057,6,5,3,6,12,13,-1,18
FC Pune City,7057,7,4,3,7,13,18,-5,15
Chennaiyin,7057,8,3,5,6,14,22,-8,14
Mumbai City,7058,1,7,4,3,18,9,9,25
Kolkata,7058,2,5,7,2,17,13,4,22
Delhi Dynamo,7058,3,5,6,3,27,20,7,21
Kerala Blast,7058,4,5,4,5,13,17,-4,19
NorthEast Un,7058,5,5,3,6,12,12,0,18
FC Pune City,7058,6,4,4,6,14,17,-3,16
Chennaiyin,7058,7,3,6,5,16,21,-5,15
FC Goa,7058,8,3,4,7,15,23,-8,13
Mumbai City,7059,1,7,4,3,19,10,9,25
Kolkata,7059,2,6,6,2,22,15,7,24
NorthEast Un,7059,3,6,2,6,12,11,1,20
Kerala Blast,7059,4,5,4,5,11,15,-4,19
Delhi Dynamo,7059,5,4,6,4,25,20,5,18
FC Pune City,7059,6,4,4,6,13,17,-4,16
Chennaiyin,7059,7,3,6,5,13,19,-6,15
FC Goa,7059,8,3,4,7,12,20,-8,13
Mumbai City,7060,1,7,4,3,18,9,9,25
Delhi Dynamo,7060,2,6,5,3,25,16,9,23
Kolkata,7060,3,5,7,2,20,15,5,22
Kerala Blast,7060,4,5,5,4,15,16,-1,20
NorthEast Un,7060,5,4,4,6,11,12,-1,16
Chennaiyin,7060,6,3,7,4,13,17,-4,16
FC Pune City,7060,7,4,3,7,14,20,-6,15
FC Goa,7060,8,3,3,8,8,19,-11,12
Mumbai City,7061,1,7,4,3,18,8,10,25
Kerala Blast,7061,2,6,4,4,16,14,2,22
Delhi Dynamo,7061,3,5,5,4,24,18,6,20
FC Goa,7061,4,5,3,6,12,15,-3,18
FC Pune City,7061,5,4,5,5,14,16,-2,17
Chennaiyin,7061,6,4,5,5,15,19,-4,17
Kolkata,7061,7,3,8,3,14,18,-4,17
NorthEast Un,7061,8,4,2,8,9,14,-5,14
Mumbai City,7062,1,7,4,3,17,8,9,25
Kolkata,7062,2,5,6,3,19,14,5,21
FC Pune City,7062,3,6,3,5,17,15,2,21
Delhi Dynamo,7062,4,5,5,4,23,18,5,20
NorthEast Un,7062,5,6,2,6,14,14,0,20
Chennaiyin,7062,6,4,5,5,18,19,-1,17
Kerala Blast,7062,7,4,3,7,9,22,-13,15
FC Goa,7062,8,4,2,8,11,18,-7,14
Mumbai City,7063,1,7,4,3,19,9,10,25
Delhi Dynamo,7063,2,5,5,4,27,20,7,20
Kolkata,7063,3,4,7,3,17,17,0,19
Kerala Blast,7063,4,5,4,5,11,15,-4,19
Chennaiyin,7063,5,4,6,4,15,17,-2,18
FC Pune City,7063,6,5,3,6,14,16,-2,18
NorthEast Un,7063,7,5,2,7,11,13,-2,17
FC Goa,7063,8,4,3,7,12,19,-7,15
Mumbai City,7064,1,7,4,3,19,10,9,25
NorthEast Un,7064,2,7,2,5,16,9,7,23
Delhi Dynamo,7064,3,5,5,4,25,20,5,20
Kolkata,7064,4,3,9,2,17,16,1,18
FC Pune City,7064,5,4,5,5,14,16,-2,17
Kerala Blast,7064,6,4,5,5,11,18,-7,17
FC Goa,7064,7,4,3,7,12,18,-6,15
Chennaiyin,7064,8,3,5,6,13,20,-7,14
Mumbai City,7065,1,6,4,4,16,9,7,22
Kolkata,7065,2,5,7,2,18,13,5,22
Delhi Dynamo,7065,3,5,6,3,23,18,5,21
NorthEast Un,7065,4,6,3,5,18,13,5,21
FC Pune City,7065,5,4,4,6,14,18,-4,16
FC Goa,7065,6,4,4,6,11,16,-5,16
Kerala Blast,7065,7,4,4,6,12,20,-8,16
Chennaiyin,7065,8,3,6,5,16,21,-5,15
Mumbai City,7066,1,6,5,3,18,10,8,23
Kolkata,7066,2,5,7,2,17,13,4,22
Kerala Blast,7066,3,6,3,5,13,16,-3,21
Delhi Dynamo,7066,4,4,7,3,24,18,6,19
NorthEast Un,7066,5,5,3,6,13,12,1,18
FC Goa,7066,6,5,3,6,13,17,-4,18
FC Pune City,7066,7,4,3,7,12,17,-5,15
Chennaiyin,7066,8,3,5,6,15,22,-7,14
Mumbai City,7067,1,7,4,3,20,9,11,25
FC Pune City,7067,2,6,3,5,16,15,1,21
Kerala Blast,7067,3,6,3,5,12,15,-3,21
Delhi Dynamo,7067,4,5,5,4,26,20,6,20
Kolkata,7067,5,4,6,4,17,15,2,18
Chennaiyin,7067,6,4,6,4,18,18,0,18
NorthEast Un,7067,7,5,2,7,11,16,-5,17
FC Goa,7067,8,3,3,8,9,21,-12,12
Mumbai City,7068,1,6,4,4,16,10,6,22
Delhi Dynamo,7068,2,5,6,3,23,17,6,21
Kolkata,7068,3,4,8,2,15,13,2,20
NorthEast Un,7068,4,5,4,5,13,10,3,19
FC Pune City,7068,5,5,3,6,14,16,-2,18
Kerala Blast,7068,6,4,5,5,12,17,-5,17
Chennaiyin,7068,7,3,7,4,13,17,-4,16
FC Goa,7068,8,3,5,6,8,14,-6,14
Mumbai City,7069,1,6,5,3,18,10,8,23
Delhi Dynamo,7069,2,4,7,3,26,20,6,19
Kolkata,7069,3,4,7,3,20,16,4,19
FC Pune City,7069,4,5,4,5,14,14,0,19
Kerala Blast,7069,5,5,4,5,12,20,-8,19
NorthEast Un,7069,6,5,3,6,13,13,0,18
FC Goa,7069,7,5,3,6,15,18,-3,18
Chennaiyin,7069,8,3,5,6,13,20,-7,14
Mumbai City,7070,1,7,4,3,19,8,11,25
Kolkata,7070,2,6,6,2,18,14,4,24
Delhi Dynamo,7070,3,5,6,3,25,19,6,21
NorthEast Un,7070,4,6,2,6,13,12,1,20
FC Pune City,7070,5,5,3,6,15,16,-1,18
Chennaiyin,7070,6,4,5,5,16,19,-3,17
Kerala Blast,7070,7,4,3,7,9,17,-8,15
FC Goa,7070,8,3,3,8,10,20,-10,12
Delhi Dynamo,7071,1,6,5,3,29,18,11,23
Mumbai City,7071,2,6,4,4,17,12,5,22
Kerala Blast,7071,3,6,4,4,12,14,-2,22
Chennaiyin,7071,4,4,6,4,16,18,-2,18
FC Pune City,7071,5,5,3,6,14,16,-2,18
NorthEast Un,7071,6,5,2,7,12,14,-2,17
Kolkata,7071,7,3,7,4,13,15,-2,16
FC Goa,7071,8,4,3,7,11,17,-6,15
Delhi Dynamo,7072,1,6,5,3,26,18,8,23
Mumbai City,7072,2,6,4,4,17,10,7,22
Kolkata,7072,3,4,7,3,17,15,2,19
NorthEast Un,7072,4,5,3,6,12,12,0,18
FC Pune City,7072,5,4,5,5,14,16,-2,17
Chennaiyin,7072,6,4,5,5,16,20,-4,17
FC Goa,7072,7,5,2,7,12,17,-5,17
Kerala Blast,7072,8,4,5,5,9,15,-6,17
Mumbai City,7073,1,7,4,3,18,9,9,25
Delhi Dynamo,7073,2,6,5,3,28,18,10,23
Kerala Blast,7073,3,6,3,5,13,16,-3,21
Chennaiyin,7073,4,5,5,4,17,18,-1,20
FC Pune City,7073,5,5,4,5,14,15,-1,19
Kolkata,7073,6,3,7,4,15,18,-3,16
NorthEast Un,7073,7,4,2,8,12,16,-4,14
FC Goa,7073,8,4,2,8,12,19,-7,14
Delhi Dynamo,7074,1,6,6,2,27,17,10,24
Mumbai City,7074,2,6,5,3,17,9,8,23
Chennaiyin,7074,3,5,5,4,16,17,-1,20
FC Pune City,7074,4,5,4,5,15,15,0,19
Kolkata,7074,5,4,6,4,15,16,-1,18
NorthEast Un,7074,6,5,2,7,12,14,-2,17
Kerala Blast,7074,7,4,4,6,11,18,-7,16
FC Goa,7074,8,4,2,8,10,17,-7,14
Mumbai City,7075,1,7,4,3,18,9,9,25
Delhi Dynamo,7075,2,5,5,4,27,20,7,20
Kolkata,7075,3,4,8,2,19,15,4,20
FC Pune City,7075,4,5,4,5,17,16,1,19
Chennaiyin,7075,5,4,6,4,18,20,-2,18
NorthEast Un,7075,6,5,2,7,16,16,0,17
FC Goa,7075,7,4,4,6,14,18,-4,16
Kerala Blast,7075,8,4,3,7,9,24,-15,15
Delhi Dynamo,7076,1,7,5,2,26,16,10,26
Mumbai City,7076,2,6,4,4,16,9,7,22
FC Pune City,7076,3,5,3,6,15,17,-2,18
Kolkata,7076,4,4,6,4,14,16,-2,18
Kerala Blast,7076,5,5,3,6,12,16,-4,18
NorthEast Un,7076,6,5,2,7,12,13,-1,17
Chennaiyin,7076,7,4,5,5,16,20,-4,17
FC Goa,7076,8,5,2,7,13,17,-4,17
Mumbai City,7077,1,7,4,3,20,9,11,25
FC Pune City,7077,2,6,3,5,19,18,1,21
Delhi Dynamo,7077,3,5,5,4,25,20,5,20
Kerala Blast,7077,4,5,4,5,16,21,-5,19
NorthEast Un,7077,5,5,3,6,13,14,-1,18
Chennaiyin,7077,6,4,5,5,15,18,-3,17
Kolkata,7077,7,3,7,4,16,17,-1,16
FC Goa,7077,8,4,3,7,10,17,-7,15
Mumbai City,7078,1,6,4,4,17,10,7,22
Delhi Dynamo,7078,2,5,6,3,24,17,7,21
Kolkata,7078,3,5,6,3,18,16,2,21
Kerala Blast,7078,4,6,3,5,13,15,-2,21
FC Goa,7078,5,6,2,6,14,17,-3,20
NorthEast Un,7078,6,5,3,6,12,12,0,18
FC Pune City,7078,7,4,3,7,13,18,-5,15
Chennaiyin,7078,8,3,5,6,16,22,-6,14
Mumbai City,7079,1,7,4,3,19,8,11,25
NorthEast Un,7079,2,7,2,5,12,9,3,23
Kolkata,7079,3,5,6,3,17,16,1,21
Delhi Dynamo,7079,4,5,5,4,26,18,8,20
Chennaiyin,7079,5,4,5,5,15,19,-4,17
FC Pune City,7079,6,4,4,6,12,16,-4,16
Kerala Blast,7079,7,4,4,6,10,16,-6,16
FC Goa,7079,8,4,2,8,12,21,-9,14
Mumbai City,7080,1,7,4,3,17,8,9,25
Kolkata,7080,2,6,6,2,18,12,6,24
Delhi Dynamo,7080,3,5,5,4,23,17,6,20
Kerala Blast,7080,4,5,4,5,13,15,-2,19
Chennaiyin,7080,5,4,5,5,15,18,-3,17
NorthEast Un,7080,6,5,2,7,10,14,-4,17
FC Pune City,7080,7,4,4,6,13,17,-4,16
FC Goa,7080,8,4,2,8,10,18,-8,14
Mumbai City,7081,1,6,5,3,17,9,8,23
Delhi Dynamo,7081,2,5,6,3,25,16,9,21
NorthEast Un,7081,3,6,3,5,14,9,5,21
Kolkata,7081,4,4,8,2,16,14,2,20
Chennaiyin,7081,5,4,6,4,17,18,-1,18
FC Pune City,7081,6,5,3,6,14,16,-2,18
Kerala Blast,7081,7,4,4,6,11,20,-9,16
FC Goa,7081,8,3,3,8,10,22,-12,12
Mumbai City,7082,1,7,4,3,17,8,9,25
NorthEast Un,7082,2,7,2,5,16,10,6,23
Kolkata,7082,3,5,7,2,16,12,4,22
Delhi Dynamo,7082,4,4,6,4,23,18,5,18
Kerala Blast,7082,5,5,3,6,11,19,-8,18
Chennaiyin,7082,6,3,6,5,14,19,-5,15
FC Pune City,7082,7,4,3,7,13,18,-5,15
FC Goa,7082,8,3,5,6,10,16,-6,14
Mumbai City,7083,1,7,4,3,19,8,11,25
Kerala Blast,7083,2,6,3,5,15,18,-3,21
Delhi Dynamo,7083,3,5,5,4,23,19,4,20
Kolkata,7083,4,4,6,4,17,16,1,18
Chennaiyin,7083,5,4,6,4,15,17,-2,18
FC Pune City,7083,5,5,3,6,15,17,-2,18
NorthEast Un,7083,7,5,2,7,11,14,-3,17
FC Goa,7083,8,4,3,7,10,16,-6,15
Mumbai City,7084,1,7,4,3,17,8,9,25
Delhi Dynamo,7084,2,6,5,3,25,15,10,23
FC Pune City,7084,3,6,3,5,17,15,2,21
Kolkata,7084,4,4,6,4,17,17,0,18
Chennaiyin,7084,5,4,6,4,16,19,-3,18
Kerala Blast,7084,6,5,3,6,10,17,-7,18
FC Goa,7084,7,4,3,7,12,20,-8,15
NorthEast Un,7084,8,4,2,8,9,12,-3,14
Mumbai City,7085,1,6,5,3,17,9,8,23
Delhi Dynamo,7085,2,5,6,3,29,16,13,21
Kolkata,7085,3,5,6,3,16,14,2,21
Kerala Blast,7085,4,5,4,5,12,16,-4,19
NorthEast Un,7085,5,5,3,6,10,10,0,18
Chennaiyin,7085,6,4,6,4,14,17,-3,18
FC Pune City,7085,7,4,4,6,13,16,-3,16
FC Goa,7085,8,4,2,8,9,22,-13,14
Mumbai City,7086,1,7,4,3,18,9,9,25
Delhi Dynamo,7086,2,6,5,3,24,16,8,23
Kerala Blast,7086,3,6,4,4,14,14,0,22
Kolkata,7086,4,3,9,2,15,14,1,18
NorthEast Un,7086,5,5,2,7,11,12,-1,17
Chennaiyin,7086,6,4,5,5,14,19,-5,17
FC Pune City,7086,7,4,4,6,13,17,-4,16
FC Goa,7086,8,3,3,8,8,16,-8,12
Mumbai City,7087,1,7,4,3,18,9,9,25
Delhi Dynamo,7087,2,5,6,3,25,18,7,21
NorthEast Un,7087,3,6,3,5,14,10,4,21
Kerala Blast,7087,4,6,3,5,11,15,-4,21
Chennaiyin,7087,5,4,5,5,15,20,-5,17
Kolkata,7087,6,3,7,4,16,17,-1,16
FC Pune City,7087,7,4,4,6,13,16,-3,16
FC Goa,7087,8,4,2,8,13,20,-7,14
Delhi Dynamo,7088,1,7,5,2,27,16,11,26
Mumbai City,7088,2,6,4,4,17,10,7,22
Kerala Blast,7088,3,4,6,4,13,17,-4,18
Kolkata,7088,4,3,8,3,16,17,-1,17
FC Pune City,7088,5,4,5,5,14,16,-2,17
Chennaiyin,7088,6,4,5,5,15,19,-4,17
FC Goa,7088,7,5,2,7,11,15,-4,17
NorthEast Un,7088,8,4,3,7,12,15,-3,15
Mumbai City,7089,1,6,5,3,16,8,8,23
Kolkata,7089,2,5,7,2,20,13,7,22
Delhi Dynamo,7089,3,4,8,2,25,18,7,20
Kerala Blast,7089,4,5,4,5,11,19,-8,19
Chennaiyin,7089,5,4,6,4,14,17,-3,18
NorthEast Un,7089,6,4,4,6,10,11,-1,16
FC Pune City,7089,7,4,4,6,13,16,-3,16
FC Goa,7089,8,3,4,7,12,19,-7,13
NorthEast Un,7090,1,7,2,5,15,11,4,23
Mumbai City,7090,2,6,4,4,17,13,4,22
Delhi Dynamo,7090,3,5,6,3,29,20,9,21
Kolkata,7090,4,4,8,2,15,13,2,20
Chennaiyin,7090,5,4,5,5,15,19,-4,17
Kerala Blast,7090,6,4,5,5,10,15,-5,17
FC Pune City,7090,7,4,4,6,12,15,-3,16
FC Goa,7090,8,3,4,7,10,17,-7,13
Mumbai City,7091,1,6,5,3,17,9,8,23
Delhi Dynamo,7091,2,5,7,2,27,18,9,22
Kerala Blast,7091,3,6,3,5,17,16,1,21
Kolkata,7091,4,4,7,3,16,18,-2,19
Chennaiyin,7091,5,4,6,4,16,19,-3,18
FC Goa,7091,6,4,4,6,16,18,-2,16
FC Pune City,7091,7,4,4,6,12,18,-6,16
NorthEast Un,7091,8,4,2,8,12,17,-5,14
Mumbai City,7092,1,7,4,3,19,8,11,25
NorthEast Un,7092,2,6,3,5,16,13,3,21
Kolkata,7092,3,4,7,3,15,14,1,19
FC Pune City,7092,4,5,4,5,15,15,0,19
Delhi Dynamo,7092,5,4,5,5,23,21,2,17
Kerala Blast,7092,6,4,5,5,12,18,-6,17
FC Goa,7092,7,4,4,6,10,15,-5,16
Chennaiyin,7092,8,3,6,5,14,20,-6,15
Delhi Dynamo,7093,1,6,6,2,24,15,9,24
Kolkata,7093,2,6,6,2,20,13,7,24
Mumbai City,7093,3,6,4,4,16,9,7,22
NorthEast Un,7093,4,4,5,5,11,11,0,17
Kerala Blast,7093,5,4,5,5,12,17,-5,17
FC Pune City,7093,6,4,4,6,14,20,-6,16
Chennaiyin,7093,7,3,6,5,13,18,-5,15
FC Goa,7093,8,4,2,8,10,17,-7,14
Delhi Dynamo,7094,1,6,6,2,23,14,9,24
Kerala Blast,7094,2,7,3,4,17,14,3,24
Mumbai City,7094,3,6,4,4,16,9,7,22
FC Goa,7094,4,5,3,6,14,15,-1,18
FC Pune City,7094,5,5,3,6,13,16,-3,18
Chennaiyin,7094,6,4,5,5,14,21,-7,17
Kolkata,7094,7,3,6,5,14,17,-3,15
NorthEast Un,7094,8,4,2,8,10,15,-5,14
Mumbai City,7095,1,7,4,3,18,9,9,25
Delhi Dynamo,7095,2,6,5,3,26,16,10,23
Kolkata,7095,3,5,7,2,18,12,6,22
Kerala Blast,7095,4,5,4,5,12,18,-6,19
Chennaiyin,7095,5,4,5,5,15,19,-4,17
FC Pune City,7095,6,4,4,6,14,18,-4,16
FC Goa,7095,7,4,3,7,10,15,-5,15
NorthEast Un,7095,8,4,2,8,9,15,-6,14
Delhi Dynamo,7096,1,6,5,3,25,16,9,23
Mumbai City,7096,2,6,4,4,16,10,6,22
FC Pune City,7096,3,5,4,5,17,16,1,19
Chennaiyin,7096,4,4,6,4,16,19,-3,18
NorthEast Un,7096,5,5,2,7,11,12,-1,17
Kolkata,7096,6,3,8,3,16,18,-2,17
Kerala Blast,7096,7,4,5,5,11,16,-5,17
FC Goa,7096,8,4,4,6,12,17,-5,16
Mumbai City,7097,1,6,5,3,16,8,8,23
Kolkata,7097,2,5,7,2,19,15,4,22
Delhi Dynamo,7097,3,4,7,3,24,19,5,19
FC Pune City,7097,4,5,4,5,14,15,-1,19
Kerala Blast,7097,5,5,3,6,12,18,-6,18
NorthEast Un,7097,6,5,2,7,14,14,0,17
Chennaiyin,7097,7,4,5,5,14,18,-4,17
FC Goa,7097,8,4,3,7,11,17,-6,15
Mumbai City,7098,1,7,4,3,18,9,9,25
FC Pune City,7098,2,6,3,5,16,15,1,21
Delhi Dynamo,7098,3,4,6,4,24,20,4,18
NorthEast Un,7098,4,5,3,6,13,13,0,18
FC Goa,7098,5,5,3,6,12,16,-4,18
Chennaiyin,7098,6,4,5,5,15,18,-3,17
Kerala Blast,7098,7,4,5,5,12,18,-6,17
Kolkata,7098,8,3,7,4,15,16,-1,16
Kolkata,7099,1,6,6,2,19,15,4,24
Mumbai City,7099,2,6,4,4,17,10,7,22
Delhi Dynamo,7099,3,5,5,4,25,22,3,20
NorthEast Un,7099,4,5,4,5,18,15,3,19
Kerala Blast,7099,5,5,4,5,13,17,-4,19
Chennaiyin,7099,6,3,7,4,17,21,-4,16
FC Pune City,7099,7,4,3,7,13,17,-4,15
FC Goa,7099,8,4,3,7,13,18,-5,15
Delhi Dynamo,7100,1,5,7,2,26,18,8,22
Mumbai City,7100,2,6,4,4,17,10,7,22
Kerala Blast,7100,3,6,4,4,14,16,-2,22
Kolkata,7100,4,5,6,3,18,16,2,21
NorthEast Un,7100,5,5,3,6,11,11,0,18
FC Pune City,7100,6,4,4,6,16,19,-3,16
FC Goa,7100,7,4,3,7,11,17,-6,15
Chennaiyin,7100,8,3,5,6,13,19,-6,14
Mumbai City,7101,1,7,4,3,18,8,10,25
Kerala Blast,7101,2,6,4,4,14,16,-2,22
Delhi Dynamo,7101,3,5,5,4,23,19,4,20
NorthEast Un,7101,4,5,4,5,12,10,2,19
Kolkata,7101,5,3,8,3,16,16,0,17
FC Pune City,7101,6,4,4,6,14,17,-3,16
Chennaiyin,7101,7,3,6,5,15,20,-5,15
FC Goa,7101,8,4,3,7,13,19,-6,15
Delhi Dynamo,7102,1,6,5,3,24,17,7,23
Mumbai City,7102,2,6,4,4,16,9,7,22
NorthEast Un,7102,3,6,2,6,14,12,2,20
FC Pune City,7102,4,5,3,6,16,17,-1,18
Kolkata,7102,5,4,6,4,15,16,-1,18
Kerala Blast,7102,6,5,3,6,12,18,-6,18
Chennaiyin,7102,7,4,5,5,15,19,-4,17
FC Goa,7102,8,5,2,7,12,16,-4,17
Mumbai City,7103,1,7,4,3,19,8,11,25
Delhi Dynamo,7103,2,6,5,3,28,17,11,23
FC Pune City,7103,3,6,3,5,18,14,4,21
Kerala Blast,7103,4,6,3,5,14,19,-5,21
Kolkata,7103,5,4,6,4,17,16,1,18
NorthEast Un,7103,6,4,3,7,10,13,-3,15
Chennaiyin,7103,7,3,6,5,14,19,-5,15
FC Goa,7103,8,4,2,8,10,24,-14,14
Mumbai City,7104,1,7,4,3,17,8,9,25
Delhi Dynamo,7104,2,6,5,3,27,16,11,23
Kerala Blast,7104,3,6,3,5,16,20,-4,21
Kolkata,7104,4,4,8,2,20,16,4,20
NorthEast Un,7104,5,5,2,7,12,17,-5,17
FC Pune City,7104,6,4,4,6,14,17,-3,16
Chennaiyin,7104,7,3,6,5,13,18,-5,15
FC Goa,7104,8,3,4,7,11,18,-7,13
Mumbai City,7105,1,7,4,3,17,8,9,25
Delhi Dynamo,7105,2,6,5,3,30,17,13,23
Kerala Blast,7105,3,6,3,5,11,15,-4,21
Kolkata,7105,4,4,7,3,17,17,0,19
Chennaiyin,7105,5,4,5,5,15,19,-4,17
FC Goa,7105,6,5,2,7,15,22,-7,17
FC Pune City,7105,7,4,4,6,13,16,-3,16
NorthEast Un,7105,8,4,2,8,10,14,-4,14
Mumbai City,7106,1,6,5,3,16,8,8,23
Kolkata,7106,2,5,7,2,18,14,4,22
Delhi Dynamo,7106,3,4,6,4,23,18,5,18
FC Pune City,7106,4,5,3,6,14,17,-3,18
Kerala Blast,7106,4,5,3,6,14,17,-3,18
FC Goa,7106,6,5,3,6,12,16,-4,18
NorthEast Un,7106,7,5,2,7,13,16,-3,17
Chennaiyin,7106,8,4,5,5,14,18,-4,17
Mumbai City,7107,1,7,4,3,18,8,10,25
Delhi Dynamo,7107,2,6,5,3,26,17,9,23
Kolkata,7107,3,4,8,2,16,13,3,20
NorthEast Un,7107,4,6,2,6,14,13,1,20
Kerala Blast,7107,5,5,3,6,12,18,-6,18
FC Pune City,7107,6,4,4,6,12,17,-5,16
FC Goa,7107,7,4,3,7,12,18,-6,15
Chennaiyin,7107,8,3,5,6,15,21,-6,14
Delhi Dynamo,7108,1,6,6,2,26,16,10,24
Mumbai City,7108,2,6,5,3,17,9,8,23
Chennaiyin,7108,3,5,5,4,15,17,-2,20
Kolkata,7108,4,4,7,3,16,15,1,19
Kerala Blast,7108,5,5,3,6,11,17,-6,18
NorthEast Un,7108,6,5,2,7,12,13,-1,17
FC Pune City,7108,7,4,4,6,13,16,-3,16
FC Goa,7108,8,4,2,8,10,17,-7,14
Mumbai City,7109,1,7,4,3,17,8,9,25
Chennaiyin,7109,2,5,5,4,19,19,0,20
FC Pune City,7109,3,5,4,5,16,17,-1,19
Delhi Dynamo,7109,4,4,6,4,23,19,4,18
Kolkata,7109,5,4,6,4,17,16,1,18
NorthEast Un,7109,6,5,3,6,12,14,-2,18
FC Goa,7109,7,5,2,7,14,18,-4,17
Kerala Blast,7109,8,4,4,6,11,18,-7,16
Delhi Dynamo,7110,1,6,5,3,25,17,8,23
Mumbai City,7110,2,6,4,4,17,10,7,22
Kerala Blast,7110,3,6,3,5,16,16,0,21
NorthEast Un,7110,4,6,2,6,13,12,1,20
FC Goa,7110,5,6,2,6,13,16,-3,20
Kolkata,7110,6,4,6,4,15,17,-2,18
FC Pune City,7110,7,4,3,7,13,18,-5,15
Chennaiyin,7110,8,3,5,6,14,20,-6,14
Delhi Dynamo,7111,1,7,5,2,25,15,10,26
Mumbai City,7111,2,6,4,4,16,9,7,22
Kerala Blast,7111,3,6,4,4,15,17,-2,22
Kolkata,7111,4,4,7,3,16,15,1,19
Chennaiyin,7111,5,4,6,4,15,18,-3,18
FC Pune City,7111,6,4,4,6,13,16,-3,16
NorthEast Un,7111,7,4,2,8,13,16,-3,14
FC Goa,7111,8,3,4,7,9,16,-7,13
Mumbai City,7112,1,6,5,3,17,9,8,23
NorthEast Un,7112,2,6,2,6,11,10,1,20
Delhi Dynamo,7112,3,4,7,3,23,17,6,19
FC Pune City,7112,4,5,4,5,15,15,0,19
FC Goa,7112,5,5,3,6,13,15,-2,18
Kolkata,7112,6,4,6,4,15,18,-3,18
Chennaiyin,7112,7,4,5,5,14,18,-4,17
Kerala Blast,7112,8,4,4,6,11,17,-6,16
Mumbai City,7113,1,6,5,3,17,9,8,23
Delhi Dynamo,7113,2,5,6,3,23,16,7,21
Kolkata,7113,3,4,7,3,18,16,2,19
Chennaiyin,7113,4,4,6,4,18,17,1,18
FC Goa,7113,5,5,3,6,12,15,-3,18
Kerala Blast,7113,6,5,3,6,12,18,-6,18
NorthEast Un,7113,7,5,2,7,11,15,-4,17
FC Pune City,7113,8,4,4,6,13,18,-5,16
Mumbai City,7114,1,7,4,3,20,9,11,25
Kolkata,7114,2,5,7,2,17,14,3,22
Delhi Dynamo,7114,3,4,7,3,25,21,4,19
NorthEast Un,7114,4,5,3,6,14,15,-1,18
FC Pune City,7114,5,5,3,6,14,16,-2,18
Kerala Blast,7114,6,5,3,6,12,16,-4,18
Chennaiyin,7114,7,3,6,5,14,19,-5,15
FC Goa,7114,8,3,5,6,10,16,-6,14
Mumbai City,7115,1,6,5,3,17,9,8,23
Delhi Dynamo,7115,2,5,7,2,24,16,8,22
Kolkata,7115,3,5,7,2,19,15,4,22
NorthEast Un,7115,4,5,4,5,14,11,3,19
Chennaiyin,7115,5,4,6,4,15,18,-3,18
FC Pune City,7115,6,4,4,6,14,18,-4,16
Kerala Blast,7115,7,4,4,6,11,19,-8,16
FC Goa,7115,8,3,3,8,9,17,-8,12
Mumbai City,7116,1,7,4,3,18,9,9,25
FC Goa,7116,2,6,2,6,14,15,-1,20
Kolkata,7116,3,4,7,3,16,14,2,19
Kerala Blast,7116,4,5,4,5,11,16,-5,19
Delhi Dynamo,7116,5,4,6,4,22,17,5,18
NorthEast Un,7116,6,5,3,6,12,12,0,18
FC Pune City,7116,7,4,5,5,12,14,-2,17
Chennaiyin,7116,8,3,5,6,14,22,-8,14
Mumbai City,7117,1,7,4,3,17,8,9,25
Kerala Blast,7117,2,6,4,4,15,16,-1,22
Kolkata,7117,3,5,6,3,19,17,2,21
Delhi Dynamo,7117,4,5,5,4,23,19,4,20
Chennaiyin,7117,5,5,5,4,17,19,-2,20
NorthEast Un,7117,6,5,2,7,14,13,1,17
FC Pune City,7117,7,4,4,6,14,18,-4,16
FC Goa,7117,8,3,2,9,9,18,-9,11
Mumbai City,7118,1,7,4,3,17,8,9,25
NorthEast Un,7118,2,6,3,5,13,11,2,21
Kolkata,7118,3,4,8,2,15,13,2,20
Delhi Dynamo,7118,4,4,5,5,22,19,3,17
FC Pune City,7118,5,4,5,5,12,14,-2,17
Kerala Blast,7118,6,4,5,5,10,15,-5,17
FC Goa,7118,7,4,4,6,13,17,-4,16
Chennaiyin,7118,8,3,6,5,15,20,-5,15
Kerala Blast,7119,1,7,3,4,16,17,-1,24
Mumbai City,7119,2,6,5,3,16,8,8,23
Delhi Dynamo,7119,3,5,6,3,23,15,8,21
NorthEast Un,7119,4,5,2,7,12,13,-1,17
FC Goa,7119,5,5,2,7,14,17,-3,17
Chennaiyin,7119,6,4,5,5,16,22,-6,17
Kolkata,7119,7,3,7,4,14,16,-2,16
FC Pune City,7119,8,4,4,6,14,17,-3,16
Mumbai City,7120,1,7,4,3,20,9,11,25
Delhi Dynamo,7120,2,6,5,3,26,19,7,23
Kerala Blast,7120,3,5,5,4,13,16,-3,20
Kolkata,7120,4,4,6,4,17,16,1,18
FC Goa,7120,5,5,2,7,12,16,-4,17
NorthEast Un,7120,6,4,4,6,9,11,-2,16
FC Pune City,7120,7,4,4,6,14,19,-5,16
Chennaiyin,7120,8,3,6,5,13,18,-5,15
Mumbai City,7121,1,6,5,3,17,9,8,23
Delhi Dynamo,7121,2,5,6,3,24,18,6,21
NorthEast Un,7121,3,6,3,5,14,11,3,21
Kolkata,7121,4,4,8,2,19,15,4,20
Kerala Blast,7121,5,5,4,5,12,17,-5,19
FC Pune City,7121,6,4,4,6,14,18,-4,16
Chennaiyin,7121,7,3,6,5,15,20,-5,15
FC Goa,7121,8,3,4,7,11,18,-7,13
Mumbai City,7122,1,7,4,3,18,8,10,25
Kolkata,7122,2,5,6,3,19,15,4,21
Delhi Dynamo,7122,3,5,5,4,24,20,4,20
NorthEast Un,7122,4,6,2,6,16,12,4,20
FC Goa,7122,5,6,2,6,17,17,0,20
Kerala Blast,7122,6,5,3,6,11,20,-9,18
FC Pune City,7122,7,4,3,7,13,17,-4,15
Chennaiyin,7122,8,3,5,6,14,23,-9,14
Mumbai City,7123,1,7,4,3,18,9,9,25
Delhi Dynamo,7123,2,5,5,4,28,21,7,20
Kolkata,7123,3,4,7,3,15,13,2,19
NorthEast Un,7123,4,5,4,5,16,15,1,19
Kerala Blast,7123,5,5,4,5,12,16,-4,19
FC Pune City,7123,6,5,3,6,14,17,-3,18
Chennaiyin,7123,7,3,6,5,18,23,-5,15
FC Goa,7123,8,4,3,7,13,20,-7,15
Kolkata,7124,1,6,6,2,20,14,6,24
Mumbai City,7124,2,6,5,3,19,11,8,23
Delhi Dynamo,7124,3,5,7,2,28,18,10,22
Kerala Blast,7124,4,6,3,5,15,15,0,21
Chennaiyin,7124,5,4,6,4,15,18,-3,18
NorthEast Un,7124,6,4,3,7,9,14,-5,15
FC Pune City,7124,7,4,3,7,14,22,-8,15
FC Goa,7124,8,3,3,8,11,19,-8,12
Kolkata,7125,1,6,6,2,22,17,5,24
Mumbai City,7125,2,6,5,3,18,10,8,23
Delhi Dynamo,7125,3,5,7,2,27,19,8,22
NorthEast Un,7125,4,5,4,5,14,12,2,19
Kerala Blast,7125,5,5,3,6,12,19,-7,18
FC Pune City,7125,6,4,3,7,12,16,-4,15
Chennaiyin,7125,7,3,6,5,14,19,-5,15
FC Goa,7125,8,4,2,8,15,22,-7,14
Mumbai City,7126,1,7,4,3,19,9,10,25
Delhi Dynamo,7126,2,5,6,3,26,17,9,21
Chennaiyin,7126,3,5,5,4,20,20,0,20
Kolkata,7126,4,4,7,3,17,16,1,19
Kerala Blast,7126,5,5,4,5,11,16,-5,19
FC Pune City,7126,6,4,4,6,13,16,-3,16
NorthEast Un,7126,7,4,4,6,12,15,-3,16
FC Goa,7126,8,4,2,8,10,19,-9,14
Mumbai City,7127,1,7,4,3,18,9,9,25
Kolkata,7127,2,5,7,2,18,13,5,22
NorthEast Un,7127,3,5,4,5,13,11,2,19
Kerala Blast,7127,4,5,4,5,12,17,-5,19
Delhi Dynamo,7127,5,4,5,5,22,20,2,17
FC Goa,7127,6,5,2,7,11,16,-5,17
FC Pune City,7127,7,4,4,6,12,15,-3,16
Chennaiyin,7127,8,3,6,5,14,19,-5,15
Mumbai City,7128,1,6,4,4,17,10,7,22
Delhi Dynamo,7128,2,5,6,3,24,18,6,21
Kerala Blast,7128,3,6,3,5,11,16,-5,21
NorthEast Un,7128,4,6,2,6,15,11,4,20
FC Goa,7128,5,5,3,6,14,15,-1,18
Chennaiyin,7128,6,4,5,5,15,22,-7,17
Kolkata,7128,7,3,7,4,14,15,-1,16
FC Pune City,7128,8,4,4,6,13,16,-3,16
Delhi Dynamo,7129,1,6,5,3,29,18,11,23
Mumbai City,7129,2,6,4,4,16,11,5,22
Kolkata,7129,3,4,8,2,19,15,4,20
NorthEast Un,7129,4,6,2,6,13,12,1,20
FC Pune City,7129,5,5,4,5,15,16,-1,19
Chennaiyin,7129,6,4,6,4,17,19,-2,18
Kerala Blast,7129,7,4,4,6,10,16,-6,16
FC Goa,7129,8,3,3,8,11,23,-12,12
Mumbai City,7130,1,6,5,3,19,11,8,23
Delhi Dynamo,7130,2,5,7,2,29,19,10,22
FC Pune City,7130,3,6,3,5,20,15,5,21
NorthEast Un,7130,4,6,3,5,14,11,3,21
Kolkata,7130,5,4,6,4,17,19,-2,18
FC Goa,7130,6,5,2,7,12,18,-6,17
Kerala Blast,7130,7,4,3,7,10,21,-11,15
Chennaiyin,7130,8,3,5,6,14,21,-7,14
Mumbai City,7131,1,7,4,3,18,9,9,25
Delhi Dynamo,7131,2,6,5,3,27,17,10,23
Kolkata,7131,3,5,6,3,16,15,1,21
Kerala Blast,7131,4,6,3,5,15,16,-1,21
FC Pune City,7131,5,5,3,6,15,17,-2,18
Chennaiyin,7131,6,4,6,4,15,18,-3,18
NorthEast Un,7131,7,4,2,8,11,15,-4,14
FC Goa,7131,8,3,3,8,10,20,-10,12
Mumbai City,7132,1,7,4,3,18,8,10,25
Delhi Dynamo,7132,2,6,5,3,26,18,8,23
Kolkata,7132,3,5,7,2,18,15,3,22
FC Pune City,7132,4,5,3,6,16,18,-2,18
NorthEast Un,7132,5,5,2,7,14,14,0,17
Chennaiyin,7132,6,4,5,5,16,20,-4,17
FC Goa,7132,7,4,3,7,12,18,-6,15
Kerala Blast,7132,8,4,3,7,10,19,-9,15
Kolkata,7133,1,6,6,2,17,12,5,24
NorthEast Un,7133,2,7,2,5,18,11,7,23
Mumbai City,7133,3,6,4,4,16,9,7,22
Delhi Dynamo,7133,4,5,5,4,25,19,6,20
FC Pune City,7133,5,5,3,6,15,15,0,18
FC Goa,7133,6,5,2,7,11,17,-6,17
Kerala Blast,7133,7,4,3,7,9,21,-12,15
Chennaiyin,7133,8,3,5,6,13,20,-7,14
Delhi Dynamo,7134,1,7,5,2,25,14,11,26
Mumbai City,7134,2,6,4,4,16,9,7,22
Kolkata,7134,3,4,7,3,16,15,1,19
FC Pune City,7134,4,5,4,5,13,14,-1,19
Kerala Blast,7134,5,5,4,5,13,16,-3,19
Chennaiyin,7134,6,4,5,5,16,20,-4,17
FC Goa,7134,7,4,3,7,12,18,-6,15
NorthEast Un,7134,8,4,2,8,10,15,-5,14
Mumbai City,7135,1,7,4,3,17,8,9,25
Delhi Dynamo,7135,2,6,5,3,25,16,9,23
Kolkata,7135,3,5,6,3,16,19,-3,21
NorthEast Un,7135,4,6,2,6,13,11,2,20
FC Pune City,7135,5,5,3,6,15,16,-1,18
FC Goa,7135,6,5,2,7,18,18,0,17
Kerala Blast,7135,7,4,3,7,9,17,-8,15
Chennaiyin,7135,8,3,5,6,15,23,-8,14
Delhi Dynamo,7136,1,6,6,2,25,16,9,24
Kolkata,7136,2,6,6,2,16,12,4,24
Mumbai City,7136,3,6,5,3,17,9,8,23
NorthEast Un,7136,4,5,3,6,11,11,0,18
Kerala Blast,7136,5,4,5,5,11,16,-5,17
FC Pune City,7136,6,4,4,6,14,17,-3,16
FC Goa,7136,7,4,2,8,12,16,-4,14
Chennaiyin,7136,8,3,5,6,13,22,-9,14
Delhi Dynamo,7137,1,6,6,2,25,15,10,24
Mumbai City,7137,2,6,5,3,16,8,8,23
NorthEast Un,7137,3,5,3,6,14,13,1,18
Kolkata,7137,4,3,8,3,16,16,0,17
FC Pune City,7137,5,4,5,5,15,17,-2,17
Kerala Blast,7137,6,4,5,5,13,19,-6,17
Chennaiyin,7137,7,3,7,4,16,20,-4,16
FC Goa,7137,8,4,3,7,12,19,-7,15
Mumbai City,7138,1,7,4,3,17,8,9,25
Delhi Dynamo,7138,2,5,6,3,23,16,7,21
FC Pune City,7138,3,6,3,5,17,15,2,21
NorthEast Un,7138,4,5,3,6,14,14,0,18
Kolkata,7138,5,4,6,4,15,17,-2,18
Chennaiyin,7138,6,4,5,5,18,20,-2,17
Kerala Blast,7138,7,4,4,6,12,19,-7,16
FC Goa,7138,8,4,3,7,11,18,-7,15
Mumbai City,7139,1,7,4,3,19,10,9,25
Delhi Dynamo,7139,2,6,5,3,29,19,10,23
Kerala Blast,7139,3,5,5,4,12,15,-3,20
Kolkata,7139,4,4,6,4,18,18,0,18
NorthEast Un,7139,5,5,3,6,14,14,0,18
FC Goa,7139,6,5,2,7,11,17,-6,17
FC Pune City,7139,7,4,4,6,14,17,-3,16
Chennaiyin,7139,8,3,5,6,13,20,-7,14
Mumbai City,7140,1,6,4,4,17,10,7,22
Kerala Blast,7140,2,6,3,5,13,16,-3,21
Delhi Dynamo,7140,3,5,5,4,23,18,5,20
NorthEast Un,7140,4,6,2,6,12,11,1,20
Kolkata,7140,5,4,6,4,15,15,0,18
FC Pune City,7140,6,5,3,6,13,15,-2,18
Chennaiyin,7140,7,4,5,5,14,18,-4,17
FC Goa,7140,8,5,2,7,11,15,-4,17
Mumbai City,7141,1,7,4,3,17,8,9,25
Kolkata,7141,2,5,6,3,22,16,6,21
Delhi Dynamo,7141,3,5,5,4,24,17,7,20
NorthEast Un,7141,4,5,3,6,13,14,-1,18
Chennaiyin,7141,5,4,5,5,16,20,-4,17
FC Goa,7141,6,5,2,7,12,17,-5,17
Kerala Blast,7141,7,4,5,5,13,21,-8,17
FC Pune City,7141,8,4,4,6,13,17,-4,16
Mumbai City,7142,1,7,4,3,18,9,9,25
FC Pune City,7142,2,6,3,5,17,16,1,21
Kolkata,7142,2,5,6,3,17,16,1,21
Delhi Dynamo,7142,4,4,6,4,23,18,5,18
Kerala Blast,7142,5,5,3,6,10,15,-5,18
NorthEast Un,7142,6,5,2,7,10,11,-1,17
Chennaiyin,7142,7,4,5,5,15,20,-5,17
FC Goa,7142,8,4,3,7,12,17,-5,15
Mumbai City,7143,1,7,4,3,20,8,12,25
Delhi Dynamo,7143,2,5,6,3,28,19,9,21
FC Pune City,7143,3,6,3,5,16,15,1,21
NorthEast Un,7143,4,5,4,5,11,10,1,19
Kolkata,7143,5,4,6,4,15,14,1,18
Chennaiyin,7143,6,4,5,5,15,19,-4,17
Kerala Blast,7143,7,4,4,6,10,18,-8,16
FC Goa,7143,8,4,2,8,10,22,-12,14
Mumbai City,7144,1,7,4,3,19,8,11,25
Delhi Dynamo,7144,2,6,5,3,25,17,8,23
Kolkata,7144,3,4,8,2,19,16,3,20
Chennaiyin,7144,4,5,5,4,18,19,-1,20
FC Pune City,7144,5,4,5,5,18,20,-2,17
Kerala Blast,7144,6,4,5,5,14,20,-6,17
NorthEast Un,7144,7,4,3,7,12,14,-2,15
FC Goa,7144,8,3,3,8,8,19,-11,12
Mumbai City,7145,1,7,4,3,18,9,9,25
NorthEast Un,7145,2,6,3,5,15,12,3,21
Delhi Dynamo,7145,3,4,6,4,23,19,4,18
Kolkata,7145,4,4,6,4,17,17,0,18
FC Goa,7145,5,5,3,6,14,17,-3,18
FC Pune City,7145,6,5,3,6,16,20,-4,18
Kerala Blast,7145,6,5,3,6,16,20,-4,18
Chennaiyin,7145,8,3,6,5,15,20,-5,15
Mumbai City,7146,1,6,5,3,16,8,8,23
Kolkata,7146,2,5,7,2,16,13,3,22
Delhi Dynamo,7146,3,5,6,3,23,16,7,21
FC Goa,7146,4,5,3,6,13,15,-2,18
Kerala Blast,7146,5,5,3,6,14,17,-3,18
NorthEast Un,7146,6,5,2,7,11,13,-2,17
Chennaiyin,7146,7,4,5,5,16,21,-5,17
FC Pune City,7146,8,4,3,7,13,19,-6,15
Mumbai City,7147,1,7,4,3,21,10,11,25
Delhi Dynamo,7147,2,5,6,3,29,20,9,21
FC Pune City,7147,3,6,3,5,16,15,1,21
Kolkata,7147,4,4,7,3,18,15,3,19
NorthEast Un,7147,5,4,5,5,10,10,0,17
Kerala Blast,7147,6,4,5,5,11,16,-5,17
Chennaiyin,7147,7,3,6,5,14,20,-6,15
FC Goa,7147,8,4,2,8,11,24,-13,14
Mumbai City,7148,1,7,4,3,18,9,9,25
Delhi Dynamo,7148,2,6,5,3,27,16,11,23
Kerala Blast,7148,3,6,3,5,13,15,-2,21
Kolkata,7148,4,4,7,3,16,15,1,19
FC Pune City,7148,5,5,4,5,13,14,-1,19
NorthEast Un,7148,6,5,2,7,12,15,-3,17
Chennaiyin,7148,7,3,6,5,16,21,-5,15
FC Goa,7148,8,3,3,8,11,21,-10,12
Mumbai City,7149,1,6,5,3,18,10,8,23
Delhi Dynamo,7149,2,5,7,2,27,19,8,22
Kolkata,7149,3,5,7,2,17,13,4,22
NorthEast Un,7149,4,5,3,6,13,13,0,18
Kerala Blast,7149,5,5,3,6,11,16,-5,18
FC Goa,7149,6,4,4,6,13,18,-5,16
Chennaiyin,7149,7,3,6,5,15,20,-5,15
FC Pune City,7149,8,4,3,7,12,17,-5,15
Mumbai City,7150,1,7,4,3,17,8,9,25
Kolkata,7150,2,5,6,3,17,14,3,21
NorthEast Un,7150,3,6,2,6,15,13,2,20
Chennaiyin,7150,4,5,5,4,19,21,-2,20
Delhi Dynamo,7150,5,4,6,4,22,18,4,18
Kerala Blast,7150,6,5,3,6,11,15,-4,18
FC Goa,7150,7,4,3,7,12,18,-6,15
FC Pune City,7150,7,4,3,7,12,18,-6,15
Delhi Dynamo,7151,1,6,5,3,26,17,9,23
Mumbai City,7151,2,6,4,4,17,11,6,22
Kolkata,7151,3,4,8,2,15,13,2,20
NorthEast Un,7151,4,5,4,5,12,11,1,19
FC Pune City,7151,5,5,3,6,15,16,-1,18
Chennaiyin,7151,6,4,6,4,16,19,-3,18
Kerala Blast,7151,7,4,5,5,12,18,-6,17
FC Goa,7151,8,3,3,8,10,18,-8,12
Mumbai City,7152,1,7,4,3,19,10,9,25
Kerala Blast,7152,2,7,3,4,14,13,1,24
Delhi Dynamo,7152,3,5,5,4,26,20,6,20
NorthEast Un,7152,4,6,2,6,14,11,3,20
FC Pune City,7152,5,5,3,6,14,16,-2,18
FC Goa,7152,6,5,2,7,12,17,-5,17
Kolkata,7152,7,3,6,5,14,18,-4,15
Chennaiyin,7152,8,3,5,6,13,21,-8,14
Mumbai City,7153,1,7,4,3,17,8,9,25
Kolkata,7153,2,5,6,3,18,14,4,21
FC Pune City,7153,3,6,3,5,15,15,0,21
Delhi Dynamo,7153,4,5,5,4,25,19,6,20
NorthEast Un,7153,5,4,4,6,12,15,-3,16
Chennaiyin,7153,6,3,7,4,15,19,-4,16
Kerala Blast,7153,7,4,4,6,12,18,-6,16
FC Goa,7153,8,4,3,7,14,20,-6,15
Mumbai City,7154,1,7,4,3,18,8,10,25
Delhi Dynamo,7154,2,5,6,3,23,17,6,21
FC Pune City,7154,3,6,3,5,16,16,0,21
Chennaiyin,7154,4,5,5,4,16,17,-1,20
Kolkata,7154,5,4,7,3,16,14,2,19
Kerala Blast,7154,6,5,4,5,14,17,-3,19
NorthEast Un,7154,7,4,3,7,9,13,-4,15
FC Goa,7154,8,3,2,9,9,19,-10,11
Mumbai City,7155,1,7,4,3,18,8,10,25
Delhi Dynamo,7155,2,5,5,4,26,18,8,20
NorthEast Un,7155,3,6,2,6,13,13,0,20
Kolkata,7155,4,4,7,3,15,14,1,19
FC Pune City,7155,5,5,4,5,13,14,-1,19
Kerala Blast,7155,6,4,5,5,9,16,-7,17
Chennaiyin,7155,7,3,6,5,13,18,-5,15
FC Goa,7155,8,4,3,7,11,17,-6,15
Mumbai City,7156,1,6,5,3,16,8,8,23
Kolkata,7156,2,4,8,2,14,12,2,20
Delhi Dynamo,7156,3,4,7,3,23,17,6,19
FC Pune City,7156,4,5,4,5,14,15,-1,19
Kerala Blast,7156,5,5,4,5,12,16,-4,19
NorthEast Un,7156,6,5,3,6,18,15,3,18
Chennaiyin,7156,7,4,5,5,16,23,-7,17
FC Goa,7156,8,4,2,8,9,16,-7,14
Mumbai City,7157,1,7,4,3,17,8,9,25
NorthEast Un,7157,2,6,3,5,15,13,2,21
Kerala Blast,7157,3,6,3,5,17,18,-1,21
FC Goa,7157,4,6,2,6,12,14,-2,20
Delhi Dynamo,7157,5,4,6,4,22,17,5,18
FC Pune City,7157,6,5,3,6,15,16,-1,18
Kolkata,7157,7,3,6,5,15,20,-5,15
Chennaiyin,7157,8,3,5,6,15,22,-7,14
Mumbai City,7158,1,7,4,3,19,9,10,25
Delhi Dynamo,7158,2,6,5,3,26,17,9,23
Chennaiyin,7158,3,5,5,4,16,17,-1,20
Kolkata,7158,4,4,7,3,16,15,1,19
Kerala Blast,7158,5,5,4,5,11,14,-3,19
FC Pune City,7158,6,5,3,6,14,16,-2,18
NorthEast Un,7158,7,4,2,8,9,13,-4,14
FC Goa,7158,8,4,2,8,10,20,-10,14
Mumbai City,7159,1,7,4,3,20,8,12,25
Delhi Dynamo,7159,2,5,6,3,25,19,6,21
NorthEast Un,7159,3,6,3,5,13,11,2,21
Kolkata,7159,4,4,6,4,16,17,-1,18
FC Pune City,7159,5,5,3,6,15,17,-2,18
Kerala Blast,7159,6,5,3,6,13,18,-5,18
FC Goa,7159,7,5,2,7,11,17,-6,17
Chennaiyin,7159,8,3,5,6,14,20,-6,14
Mumbai City,7160,1,6,5,3,17,9,8,23
FC Pune City,7160,2,6,3,5,14,14,0,21
Delhi Dynamo,7160,3,4,8,2,24,17,7,20
Kerala Blast,7160,4,5,4,5,11,15,-4,19
NorthEast Un,7160,5,5,3,6,13,13,0,18
Kolkata,7160,6,3,8,3,13,13,0,17
Chennaiyin,7160,7,4,5,5,15,19,-4,17
FC Goa,7160,8,3,4,7,9,16,-7,13
Mumbai City,7161,1,7,4,3,21,9,12,25
Delhi Dynamo,7161,2,6,5,3,27,20,7,23
Kerala Blast,7161,3,5,5,4,12,15,-3,20
FC Pune City,7161,4,5,4,5,17,16,1,19
Chennaiyin,7161,5,4,5,5,16,21,-5,17
Kolkata,7161,6,3,7,4,15,18,-3,16
NorthEast Un,7161,7,4,3,7,12,15,-3,15
FC Goa,7161,8,4,3,7,12,18,-6,15
Mumbai City,7162,1,7,4,3,17,8,9,25
NorthEast Un,7162,2,6,3,5,12,10,2,21
Delhi Dynamo,7162,3,5,5,4,23,17,6,20
FC Pune City,7162,4,5,4,5,18,15,3,19
Kerala Blast,7162,5,4,6,4,10,14,-4,18
Chennaiyin,7162,6,4,5,5,15,19,-4,17
Kolkata,7162,7,3,7,4,13,18,-5,16
FC Goa,7162,8,4,2,8,10,17,-7,14
Mumbai City,7163,1,7,4,3,18,9,9,25
Delhi Dynamo,7163,2,6,5,3,30,17,13,23
Kolkata,7163,3,5,6,3,19,17,2,21
Chennaiyin,7163,4,4,5,5,15,20,-5,17
Kerala Blast,7163,5,4,5,5,10,15,-5,17
FC Goa,7163,6,5,2,7,16,23,-7,17
FC Pune City,7163,7,4,4,6,12,17,-5,16
NorthEast Un,7163,8,4,3,7,9,11,-2,15
Mumbai City,7164,1,7,4,3,18,9,9,25
Kerala Blast,7164,2,7,3,4,16,13,3,24
Delhi Dynamo,7164,3,5,6,3,25,17,8,21
Kolkata,7164,4,4,6,4,19,18,1,18
NorthEast Un,7164,5,5,3,6,11,12,-1,18
Chennaiyin,7164,6,4,5,5,15,19,-4,17
FC Pune City,7164,7,4,3,7,14,22,-8,15
FC Goa,7164,8,4,2,8,10,18,-8,14
Mumbai City,7165,1,7,4,3,17,8,9,25
Kolkata,7165,2,5,7,2,17,14,3,22
NorthEast Un,7165,3,6,3,5,11,9,2,21
Delhi Dynamo,7165,4,5,5,4,23,17,6,20
FC Pune City,7165,5,4,4,6,14,17,-3,16
Chennaiyin,7165,6,3,7,4,15,19,-4,16
Kerala Blast,7165,7,4,4,6,10,16,-6,16
FC Goa,7165,8,3,4,7,12,19,-7,13
Delhi Dynamo,7166,1,6,6,2,25,16,9,24
Kerala Blast,7166,2,7,3,4,16,15,1,24
Mumbai City,7166,3,6,4,4,16,9,7,22
Chennaiyin,7166,4,4,6,4,14,17,-3,18
Kolkata,7166,5,3,8,3,16,17,-1,17
FC Pune City,7166,6,4,4,6,16,19,-3,16
NorthEast Un,7166,7,4,2,8,10,14,-4,14
FC Goa,7166,8,3,5,6,10,16,-6,14
Mumbai City,7167,1,7,4,3,19,8,11,25
Delhi Dynamo,7167,2,5,5,4,22,19,3,20
Kolkata,7167,3,4,8,2,16,13,3,20
NorthEast Un,7167,4,6,2,6,12,11,1,20
Kerala Blast,7167,5,5,3,6,12,18,-6,18
Chennaiyin,7167,6,4,5,5,15,20,-5,17
FC Pune City,7167,7,4,4,6,13,16,-3,16
FC Goa,7167,8,4,3,7,11,15,-4,15
Mumbai City,7168,1,6,4,4,16,10,6,22
Kerala Blast,7168,2,6,3,5,11,16,-5,21
NorthEast Un,7168,3,6,2,6,18,12,6,20
Delhi Dynamo,7168,4,5,5,4,26,22,4,20
Chennaiyin,7168,5,5,5,4,18,18,0,20
FC Pune City,7168,6,5,3,6,13,15,-2,18
FC Goa,7168,7,5,2,7,13,20,-7,17
Kolkata,7168,8,3,6,5,14,16,-2,15
Delhi Dynamo,7169,1,6,6,2,25,15,10,24
Mumbai City,7169,2,6,5,3,17,9,8,23
FC Pune City,7169,3,6,3,5,19,17,2,21
Kerala Blast,7169,4,6,3,5,12,15,-3,21
Chennaiyin,7169,5,4,6,4,18,19,-1,18
Kolkata,7169,6,3,6,5,16,21,-5,15
FC Goa,7169,7,4,3,7,11,17,-6,15
NorthEast Un,7169,8,4,2,8,10,15,-5,14
Mumbai City,7170,1,6,4,4,18,11,7,22
Delhi Dynamo,7170,2,5,6,3,26,21,5,21
NorthEast Un,7170,3,6,3,5,14,9,5,21
Kolkata,7170,4,4,8,2,15,13,2,20
Kerala Blast,7170,5,4,6,4,10,14,-4,18
FC Pune City,7170,6,4,4,6,12,15,-3,16
FC Goa,7170,7,4,4,6,11,16,-5,16
Chennaiyin,7170,8,3,5,6,13,20,-7,14
Mumbai City,7171,1,6,4,4,16,10,6,22
Delhi Dynamo,7171,2,5,6,3,24,16,8,21
Kolkata,7171,3,5,6,3,17,14,3,21
Chennaiyin,7171,4,5,5,4,18,18,0,20
Kerala Blast,7171,5,5,4,5,12,17,-5,19
NorthEast Un,7171,6,5,3,6,10,12,-2,18
FC Pune City,7171,7,4,3,7,14,18,-4,15
FC Goa,7171,8,4,3,7,12,18,-6,15
Mumbai City,7172,1,7,4,3,17,8,9,25
FC Pune City,7172,2,6,3,5,18,16,2,21
Kerala Blast,7172,3,6,3,5,14,18,-4,21
FC Goa,7172,4,6,2,6,17,15,2,20
Delhi Dynamo,7172,5,4,6,4,23,19,4,18
NorthEast Un,7172,6,4,4,6,12,13,-1,16
Kolkata,7172,7,3,6,5,16,19,-3,15
Chennaiyin,7172,8,3,6,5,15,24,-9,15
Delhi Dynamo,7173,1,6,5,3,25,16,9,23
Mumbai City,7173,2,6,4,4,17,11,6,22
Kerala Blast,7173,3,6,4,4,14,14,0,22
Chennaiyin,7173,4,5,5,4,17,17,0,20
NorthEast Un,7173,5,5,3,6,11,11,0,18
FC Pune City,7173,6,5,3,6,13,17,-4,18
Kolkata,7173,7,3,6,5,13,17,-4,15
FC Goa,7173,8,4,2,8,11,18,-7,14
Mumbai City,7174,1,7,4,3,19,9,10,25
Kolkata,7174,2,6,6,2,16,12,4,24
Delhi Dynamo,7174,3,5,6,3,26,19,7,21
Chennaiyin,7174,4,4,6,4,18,19,-1,18
FC Pune City,7174,5,5,3,6,14,16,-2,18
Kerala Blast,7174,6,5,3,6,11,16,-5,18
NorthEast Un,7174,7,4,3,7,10,14,-4,15
FC Goa,7174,8,3,3,8,11,20,-9,12
Mumbai City,7175,1,7,4,3,17,8,9,25
Delhi Dynamo,7175,2,6,5,3,24,16,8,23
Kolkata,7175,3,5,6,3,16,14,2,21
NorthEast Un,7175,4,5,3,6,15,13,2,18
FC Pune City,7175,5,5,3,6,16,18,-2,18
FC Goa,7175,6,5,2,7,12,15,-3,17
Chennaiyin,7175,7,3,6,5,15,21,-6,15
Kerala Blast,7175,8,4,3,7,11,21,-10,15
Mumbai City,7176,1,7,4,3,18,8,10,25
NorthEast Un,7176,2,6,3,5,14,11,3,21
Kerala Blast,7176,3,6,3,5,16,18,-2,21
Chennaiyin,7176,4,4,6,4,15,17,-2,18
Delhi Dynamo,7176,5,4,5,5,24,23,1,17
FC Goa,7176,6,5,2,7,15,19,-4,17
Kolkata,7176,7,3,7,4,15,18,-3,16
FC Pune City,7176,8,4,4,6,13,16,-3,16
Delhi Dynamo,7177,1,5,7,2,26,18,8,22
Mumbai City,7177,2,6,4,4,17,10,7,22
Kerala Blast,7177,3,6,4,4,15,15,0,22
Kolkata,7177,4,4,8,2,19,16,3,20
Chennaiyin,7177,5,4,5,5,15,21,-6,17
FC Pune City,7177,6,4,4,6,15,19,-4,16
FC Goa,7177,7,4,3,7,14,18,-4,15
NorthEast Un,7177,8,4,3,7,11,15,-4,15
Mumbai City,7178,1,6,5,3,17,9,8,23
Delhi Dynamo,7178,2,5,7,2,26,17,9,22
Kerala Blast,7178,3,6,3,5,14,15,-1,21
NorthEast Un,7178,4,5,4,5,13,12,1,19
FC Goa,7178,5,5,2,7,17,17,0,17
FC Pune City,7178,6,4,4,6,12,15,-3,16
Kolkata,7178,7,3,7,4,13,17,-4,16
Chennaiyin,7178,8,3,6,5,14,24,-10,15
Kerala Blast,7179,1,7,3,4,19,16,3,24
Delhi Dynamo,7179,2,6,5,3,26,18,8,23
Mumbai City,7179,3,6,4,4,17,10,7,22
Kolkata,7179,4,4,6,4,17,18,-1,18
FC Pune City,7179,5,5,3,6,14,17,-3,18
FC Goa,7179,6,5,2,7,15,17,-2,17
Chennaiyin,7179,7,4,5,5,14,21,-7,17
NorthEast Un,7179,8,4,2,8,11,16,-5,14
Mumbai City,7180,1,6,4,4,16,9,7,22
Delhi Dynamo,7180,2,5,6,3,23,16,7,21
Kerala Blast,7180,3,6,3,5,14,16,-2,21
Kolkata,7180,4,4,7,3,17,17,0,19
FC Pune City,7180,5,5,4,5,15,16,-1,19
NorthEast Un,7180,6,5,3,6,12,12,0,18
Chennaiyin,7180,7,3,7,4,15,19,-4,16
FC Goa,7180,8,3,4,7,10,17,-7,13
Delhi Dynamo,7181,1,6,6,2,23,14,9,24
Mumbai City,7181,2,6,5,3,16,8,8,23
Kolkata,7181,3,5,7,2,18,14,4,22
Kerala Blast,7181,4,5,5,4,11,14,-3,20
NorthEast Un,7181,5,4,4,6,10,11,-1,16
Chennaiyin,7181,6,3,7,4,16,20,-4,16
FC Pune City,7181,7,4,3,7,12,16,-4,15
FC Goa,7181,8,3,3,8,11,20,-9,12
Mumbai City,7182,1,6,5,3,17,9,8,23
FC Pune City,7182,2,6,3,5,16,14,2,21
Delhi Dynamo,7182,3,4,8,2,25,18,7,20
Kolkata,7182,4,4,7,3,15,15,0,19
Kerala Blast,7182,5,5,4,5,11,15,-4,19
NorthEast Un,7182,6,4,4,6,12,14,-2,16
FC Goa,7182,7,4,3,7,12,17,-5,15
Chennaiyin,7182,8,3,6,5,14,20,-6,15
Mumbai City,7183,1,7,4,3,20,9,11,25
Kerala Blast,7183,2,7,3,4,15,15,0,24
Delhi Dynamo,7183,3,6,5,3,25,19,6,23
Kolkata,7183,4,3,7,4,15,17,-2,16
Chennaiyin,7183,5,3,7,4,14,18,-4,16
FC Pune City,7183,6,4,4,6,13,17,-4,16
NorthEast Un,7183,7,4,3,7,11,13,-2,15
FC Goa,7183,8,4,3,7,11,16,-5,15
Delhi Dynamo,7184,1,6,6,2,26,15,11,24
Mumbai City,7184,2,6,4,4,16,9,7,22
FC Pune City,7184,3,6,3,5,15,15,0,21
NorthEast Un,7184,4,5,4,5,12,11,1,19
Kolkata,7184,5,4,6,4,17,18,-1,18
Kerala Blast,7184,6,4,4,6,13,20,-7,16
Chennaiyin,7184,7,3,6,5,13,18,-5,15
FC Goa,7184,8,4,3,7,11,17,-6,15
Mumbai City,7185,1,7,4,3,17,8,9,25
Delhi Dynamo,7185,2,6,5,3,28,19,9,23
Chennaiyin,7185,3,5,5,4,18,18,0,20
Kolkata,7185,4,4,7,3,16,15,1,19
FC Pune City,7185,5,5,4,5,14,14,0,19
Kerala Blast,7185,6,4,5,5,9,15,-6,17
NorthEast Un,7185,7,4,3,7,11,14,-3,15
FC Goa,7185,8,3,3,8,12,22,-10,12
Mumbai City,7186,1,6,5,3,16,8,8,23
Delhi Dynamo,7186,2,5,6,3,22,15,7,21
Kolkata,7186,3,4,7,3,16,15,1,19
NorthEast Un,7186,4,5,3,6,12,13,-1,18
Chennaiyin,7186,5,4,6,4,16,18,-2,18
Kerala Blast,7186,6,4,6,4,13,17,-4,18
FC Pune City,7186,7,4,4,6,13,16,-3,16
FC Goa,7186,8,4,3,7,9,15,-6,15
Mumbai City,7187,1,6,5,3,16,8,8,23
Kerala Blast,7187,2,6,4,4,14,15,-1,22
Delhi Dynamo,7187,3,4,7,3,22,16,6,19
Kolkata,7187,4,4,7,3,17,15,2,19
NorthEast Un,7187,5,5,4,5,12,11,1,19
Chennaiyin,7187,6,3,7,4,15,19,-4,16
FC Pune City,7187,7,4,4,6,13,17,-4,16
FC Goa,7187,8,3,4,7,10,18,-8,13
Delhi Dynamo,7188,1,5,7,2,25,16,9,22
Mumbai City,7188,2,6,4,4,17,11,6,22
NorthEast Un,7188,3,5,4,5,13,11,2,19
Kolkata,7188,4,4,7,3,16,15,1,19
FC Pune City,7188,5,5,4,5,14,15,-1,19
Kerala Blast,7188,6,4,6,4,12,16,-4,18
FC Goa,7188,7,4,3,7,12,17,-5,15
Chennaiyin,7188,8,3,5,6,14,22,-8,14
Delhi Dynamo,7189,1,6,5,3,25,17,8,23
Mumbai City,7189,2,6,4,4,18,11,7,22
Kolkata,7189,3,5,6,3,17,15,2,21
Chennaiyin,7189,4,5,5,4,17,18,-1,20
FC Pune City,7189,5,5,4,5,15,16,-1,19
Kerala Blast,7189,6,5,4,5,11,15,-4,19
NorthEast Un,7189,7,5,2,7,11,13,-2,17
FC Goa,7189,8,3,2,9,9,18,-9,11
Mumbai City,7190,1,7,4,3,18,8,10,25
Kolkata,7190,2,5,7,2,20,15,5,22
Delhi Dynamo,7190,3,5,6,3,26,20,6,21
NorthEast Un,7190,4,5,3,6,15,14,1,18
Kerala Blast,7190,5,4,5,5,12,18,-6,17
Chennaiyin,7190,6,3,7,4,16,20,-4,16
FC Pune City,7190,7,4,4,6,13,18,-5,16
FC Goa,7190,8,3,4,7,12,19,-7,13
Delhi Dynamo,7191,1,6,5,3,28,16,12,23
Mumbai City,7191,2,6,4,4,16,10,6,22
Kolkata,7191,3,5,6,3,18,15,3,21
NorthEast Un,7191,4,6,3,5,11,9,2,21
Kerala Blast,7191,5,5,4,5,12,16,-4,19
Chennaiyin,7191,6,3,7,4,15,19,-4,16
FC Pune City,7191,7,4,4,6,14,18,-4,16
FC Goa,7191,8,3,3,8,13,24,-11,12
Mumbai City,7192,1,7,4,3,18,8,10,25
Delhi Dynamo,7192,2,6,5,3,27,18,9,23
Kolkata,7192,3,5,6,3,18,14,4,21
FC Pune City,7192,4,5,3,6,14,15,-1,18
Kerala Blast,7192,5,5,3,6,10,18,-8,18
NorthEast Un,7192,6,5,2,7,11,12,-1,17
Chennaiyin,7192,7,3,6,5,16,22,-6,15
FC Goa,7192,8,4,3,7,15,22,-7,15
Delhi Dynamo,7193,1,5,7,2,27,19,8,22
Mumbai City,7193,2,6,4,4,20,13,7,22
Kerala Blast,7193,3,5,5,4,15,18,-3,20
FC Pune City,7193,4,5,4,5,17,16,1,19
Kolkata,7193,5,4,6,4,14,16,-2,18
Chennaiyin,7193,6,4,5,5,16,20,-4,17
NorthEast Un,7193,7,4,4,6,12,14,-2,16
FC Goa,7193,8,4,3,7,12,17,-5,15
Delhi Dynamo,7194,1,6,5,3,30,22,8,23
Mumbai City,7194,2,6,4,4,19,12,7,22
Kerala Blast,7194,3,6,3,5,14,17,-3,21
NorthEast Un,7194,4,6,2,6,12,11,1,20
Kolkata,7194,5,4,7,3,19,16,3,19
FC Pune City,7194,6,5,3,6,14,18,-4,18
Chennaiyin,7194,7,3,6,5,14,19,-5,15
FC Goa,7194,8,3,4,7,13,20,-7,13
Mumbai City,7195,1,7,4,3,19,10,9,25
Kerala Blast,7195,2,7,3,4,15,13,2,24
Delhi Dynamo,7195,3,5,5,4,26,20,6,20
NorthEast Un,7195,4,6,2,6,15,12,3,20
FC Goa,7195,5,5,2,7,12,18,-6,17
Kolkata,7195,6,3,7,4,14,17,-3,16
FC Pune City,7195,7,4,4,6,13,17,-4,16
Chennaiyin,7195,8,3,5,6,16,23,-7,14
Kolkata,7196,1,6,6,2,20,13,7,24
Delhi Dynamo,7196,2,6,5,3,25,16,9,23
Mumbai City,7196,3,6,4,4,16,9,7,22
Kerala Blast,7196,4,6,3,5,13,15,-2,21
Chennaiyin,7196,5,4,6,4,15,17,-2,18
NorthEast Un,7196,6,5,2,7,12,14,-2,17
FC Pune City,7196,7,4,3,7,12,19,-7,15
FC Goa,7196,8,3,3,8,9,19,-10,12
Mumbai City,7197,1,6,5,3,17,9,8,23
NorthEast Un,7197,2,7,2,5,15,10,5,23
Kolkata,7197,3,4,7,3,20,18,2,19
Kerala Blast,7197,4,5,4,5,14,16,-2,19
Delhi Dynamo,7197,5,4,6,4,23,19,4,18
FC Goa,7197,6,5,3,6,15,19,-4,18
Chennaiyin,7197,7,3,6,5,14,20,-6,15
FC Pune City,7197,8,4,3,7,13,20,-7,15
Mumbai City,7198,1,7,4,3,19,8,11,25
Delhi Dynamo,7198,2,6,5,3,26,18,8,23
FC Pune City,7198,3,6,3,5,15,15,0,21
Kolkata,7198,4,4,6,4,15,16,-1,18
Chennaiyin,7198,5,4,6,4,16,18,-2,18
Kerala Blast,7198,6,5,3,6,10,15,-5,18
FC Goa,7198,7,4,3,7,11,18,-7,15
NorthEast Un,7198,8,4,2,8,10,14,-4,14
Mumbai City,7199,1,7,4,3,18,8,10,25
Kolkata,7199,2,5,6,3,17,15,2,21
Kerala Blast,7199,3,5,5,4,12,14,-2,20
Delhi Dynamo,7199,4,4,6,4,25,21,4,18
NorthEast Un,7199,5,4,5,5,12,12,0,17
Chennaiyin,7199,6,3,7,4,13,17,-4,16
FC Pune City,7199,6,4,4,6,13,17,-4,16
FC Goa,7199,8,4,3,7,11,17,-6,15
Mumbai City,7200,1,7,4,3,19,8,11,25
Kolkata,7200,2,4,7,3,14,13,1,19
Delhi Dynamo,7200,3,4,6,4,23,20,3,18
NorthEast Un,7200,4,5,3,6,14,14,0,18
FC Goa,7200,5,5,3,6,13,15,-2,18
FC Pune City,7200,5,5,3,6,13,15,-2,18
Kerala Blast,7200,7,5,3,6,11,17,-6,18
Chennaiyin,7200,8,4,5,5,16,21,-5,17
Mumbai City,7201,1,6,5,3,18,10,8,23
Delhi Dynamo,7201,2,5,7,2,27,17,10,22
Kolkata,7201,3,5,7,2,17,13,4,22
FC Pune City,7201,4,5,3,6,13,15,-2,18
Kerala Blast,7201,5,5,3,6,11,17,-6,18
FC Goa,7201,6,4,4,6,12,16,-4,16
NorthEast Un,7201,7,4,3,7,11,15,-4,15
Chennaiyin,7201,8,3,6,5,14,20,-6,15
Delhi Dynamo,7202,1,7,5,2,25,15,10,26
Mumbai City,7202,2,6,4,4,16,9,7,22
Kolkata,7202,3,5,7,2,19,14,5,22
Kerala Blast,7202,4,5,5,4,10,13,-3,20
Chennaiyin,7202,5,3,7,4,14,18,-4,16
FC Pune City,7202,6,4,4,6,13,18,-5,16
NorthEast Un,7202,7,4,3,7,9,11,-2,15
FC Goa,7202,8,3,3,8,11,19,-8,12
Mumbai City,7203,1,6,5,3,17,9,8,23
Kerala Blast,7203,2,6,4,4,12,14,-2,22
Delhi Dynamo,7203,3,4,8,2,23,16,7,20
NorthEast Un,7203,4,5,3,6,11,11,0,18
FC Pune City,7203,5,4,5,5,14,16,-2,17
Chennaiyin,7203,6,4,5,5,15,18,-3,17
Kolkata,7203,7,3,7,4,14,15,-1,16
FC Goa,7203,8,4,3,7,9,16,-7,15
Delhi Dynamo,7204,1,6,5,3,26,18,8,23
NorthEast Un,7204,2,7,2,5,16,11,5,23
Mumbai City,7204,3,6,4,4,16,10,6,22
Kerala Blast,7204,4,6,3,5,12,15,-3,21
Kolkata,7204,5,4,6,4,16,19,-3,18
FC Goa,7204,6,5,2,7,15,17,-2,17
FC Pune City,7204,7,4,3,7,13,18,-5,15
Chennaiyin,7204,8,3,5,6,14,20,-6,14
Mumbai City,7205,1,7,4,3,18,9,9,25
NorthEast Un,7205,2,7,2,5,12,9,3,23
FC Goa,7205,3,6,2,6,12,14,-2,20
Kerala Blast,7205,4,5,4,5,13,16,-3,19
FC Pune City,7205,5,5,3,6,17,20,-3,18
Delhi Dynamo,7205,6,4,5,5,22,18,4,17
Kolkata,7205,7,3,7,4,17,18,-1,16
Chennaiyin,7205,8,3,5,6,13,20,-7,14
Mumbai City,7206,1,6,5,3,17,9,8,23
Kerala Blast,7206,2,6,3,5,15,18,-3,21
Chennaiyin,7206,3,5,5,4,16,17,-1,20
Delhi Dynamo,7206,4,4,7,3,23,17,6,19
Kolkata,7206,5,4,7,3,17,18,-1,19
FC Goa,7206,6,5,2,7,12,16,-4,17
FC Pune City,7206,7,4,4,6,13,16,-3,16
NorthEast Un,7206,8,4,3,7,12,14,-2,15
Mumbai City,7207,1,7,4,3,18,8,10,25
Kolkata,7207,2,5,6,3,22,15,7,21
FC Pune City,7207,3,6,3,5,15,15,0,21
NorthEast Un,7207,4,5,4,5,12,11,1,19
Delhi Dynamo,7207,5,4,5,5,22,19,3,17
Chennaiyin,7207,6,3,7,4,14,18,-4,16
Kerala Blast,7207,7,4,4,6,11,21,-10,16
FC Goa,7207,8,4,3,7,10,17,-7,15
Mumbai City,7208,1,7,4,3,18,8,10,25
Kolkata,7208,2,4,7,3,17,17,0,19
Kerala Blast,7208,3,5,4,5,14,17,-3,19
Delhi Dynamo,7208,4,4,6,4,23,20,3,18
NorthEast Un,7208,5,5,3,6,14,14,0,18
FC Pune City,7208,6,5,3,6,15,17,-2,18
Chennaiyin,7208,7,4,6,4,14,17,-3,18
FC Goa,7208,8,4,3,7,11,16,-5,15
Mumbai City,7209,1,7,4,3,19,8,11,25
Delhi Dynamo,7209,2,5,6,3,25,20,5,21
Kolkata,7209,3,5,6,3,15,13,2,21
Kerala Blast,7209,4,6,3,5,12,14,-2,21
Chennaiyin,7209,5,4,6,4,15,17,-2,18
FC Pune City,7209,6,5,3,6,13,15,-2,18
NorthEast Un,7209,7,4,4,6,11,13,-2,16
FC Goa,7209,8,3,2,9,9,19,-10,11
Kerala Blast,7210,1,7,3,4,15,15,0,24
Delhi Dynamo,7210,2,5,7,2,28,18,10,22
Mumbai City,7210,3,6,4,4,17,12,5,22
FC Pune City,7210,4,5,3,6,15,17,-2,18
Chennaiyin,7210,5,4,6,4,16,19,-3,18
NorthEast Un,7210,6,4,4,6,11,12,-1,16
Kolkata,7210,7,3,6,5,16,19,-3,15
FC Goa,7210,8,4,3,7,12,18,-6,15
Mumbai City,7211,1,7,4,3,19,10,9,25
Kerala Blast,7211,2,6,4,4,12,13,-1,22
Delhi Dynamo,7211,3,5,5,4,25,19,6,20
Kolkata,7211,4,4,7,3,15,13,2,19
NorthEast Un,7211,5,5,3,6,12,12,0,18
Chennaiyin,7211,6,3,7,4,15,19,-4,16
FC Pune City,7211,7,4,3,7,12,18,-6,15
FC Goa,7211,8,4,3,7,10,16,-6,15
Mumbai City,7212,1,7,4,3,18,9,9,25
Kolkata,7212,2,6,6,2,19,14,5,24
Delhi Dynamo,7212,3,6,5,3,26,18,8,23
NorthEast Un,7212,4,5,3,6,13,13,0,18
Kerala Blast,7212,5,5,3,6,12,16,-4,18
Chennaiyin,7212,6,3,6,5,15,20,-5,15
FC Pune City,7212,7,4,3,7,13,19,-6,15
FC Goa,7212,8,4,2,8,12,19,-7,14
Mumbai City,7213,1,7,4,3,18,9,9,25
Delhi Dynamo,7213,2,6,5,3,24,16,8,23
Kolkata,7213,3,5,7,2,18,13,5,22
FC Pune City,7213,4,5,3,6,15,17,-2,18
Kerala Blast,7213,5,5,3,6,13,19,-6,18
NorthEast Un,7213,6,5,2,7,12,13,-1,17
Chennaiyin,7213,7,3,6,5,15,21,-6,15
FC Goa,7213,8,3,4,7,10,17,-7,13
Kolkata,7214,1,6,6,2,20,14,6,24
Mumbai City,7214,2,6,4,4,18,11,7,22
Delhi Dynamo,7214,3,5,5,4,25,19,6,20
NorthEast Un,7214,4,5,3,6,12,12,0,18
FC Pune City,7214,5,5,3,6,17,18,-1,18
Chennaiyin,7214,6,4,6,4,15,18,-3,18
Kerala Blast,7214,7,5,3,6,11,19,-8,18
FC Goa,7214,8,4,2,8,10,17,-7,14
Mumbai City,7215,1,6,5,3,17,9,8,23
Delhi Dynamo,7215,2,5,7,2,25,17,8,22
Kolkata,7215,3,4,8,2,18,15,3,20
Kerala Blast,7215,4,5,5,4,10,13,-3,20
NorthEast Un,7215,5,5,2,7,11,12,-1,17
FC Pune City,7215,6,4,4,6,13,17,-4,16
FC Goa,7215,7,4,4,6,14,19,-5,16
Chennaiyin,7215,8,3,5,6,15,21,-6,14
Mumbai City,7216,1,7,4,3,18,9,9,25
FC Pune City,7216,2,6,3,5,16,14,2,21
Delhi Dynamo,7216,3,5,5,4,28,19,9,20
NorthEast Un,7216,4,6,2,6,14,13,1,20
Kolkata,7216,5,4,7,3,15,15,0,19
Chennaiyin,7216,6,4,6,4,16,18,-2,18
Kerala Blast,7216,7,4,3,7,10,18,-8,15
FC Goa,7216,8,3,4,7,10,21,-11,13
Delhi Dynamo,7217,1,6,5,3,27,17,10,23
Mumbai City,7217,2,6,4,4,16,9,7,22
Kerala Blast,7217,3,5,5,4,14,17,-3,20
NorthEast Un,7217,4,5,4,5,13,12,1,19
Kolkata,7217,5,4,6,4,19,18,1,18
Chennaiyin,7217,6,3,7,4,15,19,-4,16
FC Pune City,7217,7,4,4,6,13,18,-5,16
FC Goa,7217,8,4,3,7,13,20,-7,15
Delhi Dynamo,7218,1,6,5,3,25,17,8,23
Mumbai City,7218,2,6,4,4,16,9,7,22
NorthEast Un,7218,3,6,2,6,13,12,1,20
Chennaiyin,7218,4,5,5,4,19,21,-2,20
FC Pune City,7218,5,5,4,5,15,15,0,19
Kolkata,7218,6,4,6,4,15,15,0,18
Kerala Blast,7218,7,4,4,6,10,17,-7,16
FC Goa,7218,8,4,2,8,13,20,-7,14
Mumbai City,7219,1,7,4,3,19,9,10,25
Delhi Dynamo,7219,2,5,6,3,25,18,7,21
Kerala Blast,7219,3,6,3,5,15,17,-2,21
Kolkata,7219,4,4,7,3,19,19,0,19
Chennaiyin,7219,5,4,6,4,16,19,-3,18
FC Pune City,7219,6,4,4,6,14,18,-4,16
NorthEast Un,7219,7,4,3,7,13,16,-3,15
FC Goa,7219,8,4,3,7,11,16,-5,15
Mumbai City,7220,1,7,4,3,18,8,10,25
Delhi Dynamo,7220,2,6,5,3,25,16,9,23
Kerala Blast,7220,3,5,4,5,11,15,-4,19
Kolkata,7220,4,4,6,4,16,17,-1,18
NorthEast Un,7220,5,5,3,6,12,13,-1,18
FC Pune City,7220,6,5,3,6,13,15,-2,18
FC Goa,7220,7,5,2,7,14,18,-4,17
Chennaiyin,7220,8,3,5,6,14,21,-7,14
Mumbai City,7221,1,7,4,3,19,9,10,25
Delhi Dynamo,7221,2,6,5,3,27,17,10,23
FC Pune City,7221,3,6,3,5,16,14,2,21
Kolkata,7221,4,4,7,3,18,18,0,19
Kerala Blast,7221,5,5,3,6,11,17,-6,18
Chennaiyin,7221,6,4,5,5,18,19,-1,17
NorthEast Un,7221,7,5,2,7,11,13,-2,17
FC Goa,7221,8,3,3,8,10,23,-13,12
Mumbai City,7222,1,7,4,3,18,9,9,25
NorthEast Un,7222,2,7,2,5,13,10,3,23
FC Pune City,7222,3,6,3,5,14,14,0,21
Kolkata,7222,4,4,7,3,16,15,1,19
Delhi Dynamo,7222,5,4,6,4,25,20,5,18
Chennaiyin,7222,6,4,5,5,15,19,-4,17
Kerala Blast,7222,7,4,3,7,9,16,-7,15
FC Goa,7222,8,3,4,7,13,20,-7,13
Mumbai City,7223,1,7,4,3,20,10,10,25
Kolkata,7223,2,5,7,2,16,12,4,22
NorthEast Un,7223,3,6,3,5,12,10,2,21
Delhi Dynamo,7223,4,5,5,4,28,21,7,20
Kerala Blast,7223,5,5,3,6,11,16,-5,18
FC Pune City,7223,6,4,4,6,13,16,-3,16
Chennaiyin,7223,7,3,6,5,13,18,-5,15
FC Goa,7223,8,4,2,8,10,20,-10,14
Mumbai City,7224,1,6,5,3,17,9,8,23
Kolkata,7224,2,5,7,2,18,14,4,22
Kerala Blast,7224,3,6,3,5,15,17,-2,21
Delhi Dynamo,7224,4,4,8,2,25,18,7,20
NorthEast Un,7224,5,4,4,6,11,12,-1,16
Chennaiyin,7224,6,3,7,4,15,19,-4,16
FC Pune City,7224,6,4,4,6,15,19,-4,16
FC Goa,7224,8,3,4,7,11,19,-8,13
Kolkata,7225,1,6,6,2,18,13,5,24
Mumbai City,7225,2,6,5,3,17,9,8,23
Delhi Dynamo,7225,3,5,7,2,25,16,9,22
Kerala Blast,7225,4,5,4,5,11,15,-4,19
Chennaiyin,7225,5,4,6,4,17,19,-2,18
FC Pune City,7225,6,4,4,6,12,15,-3,16
NorthEast Un,7225,7,4,3,7,9,13,-4,15
FC Goa,7225,8,3,3,8,12,21,-9,12
Mumbai City,7226,1,6,5,3,17,9,8,23
Kolkata,7226,2,5,7,2,21,14,7,22
Delhi Dynamo,7226,3,5,6,3,24,18,6,21
NorthEast Un,7226,4,6,3,5,15,9,6,21
FC Pune City,7226,5,4,4,6,13,17,-4,16
Kerala Blast,7226,6,4,4,6,9,21,-12,16
Chennaiyin,7226,7,3,6,5,14,19,-5,15
FC Goa,7226,8,4,3,7,12,18,-6,15
Mumbai City,7227,1,7,4,3,17,8,9,25
Kerala Blast,7227,2,6,3,5,15,16,-1,21
NorthEast Un,7227,3,6,2,6,13,10,3,20
Delhi Dynamo,7227,4,4,6,4,22,18,4,18
Kolkata,7227,5,4,6,4,19,20,-1,18
FC Pune City,7227,6,5,3,6,17,20,-3,18
Chennaiyin,7227,7,4,6,4,15,18,-3,18
FC Goa,7227,8,3,4,7,11,19,-8,13
Mumbai City,7228,1,7,4,3,19,10,9,25
Kerala Blast,7228,2,6,4,4,15,16,-1,22
Delhi Dynamo,7228,3,5,5,4,25,19,6,20
Kolkata,7228,4,4,8,2,21,16,5,20
NorthEast Un,7228,5,5,3,6,13,13,0,18
Chennaiyin,7228,6,4,6,4,15,18,-3,18
FC Pune City,7228,7,4,3,7,14,22,-8,15
FC Goa,7228,8,3,3,8,10,18,-8,12
Mumbai City,7229,1,7,4,3,19,9,10,25
Delhi Dynamo,7229,2,6,5,3,28,19,9,23
Kerala Blast,7229,3,5,5,4,12,14,-2,20
Kolkata,7229,4,4,7,3,19,15,4,19
Chennaiyin,7229,5,4,6,4,17,18,-1,18
NorthEast Un,7229,6,4,3,7,11,15,-4,15
FC Pune City,7229,7,4,3,7,13,21,-8,15
FC Goa,7229,8,4,3,7,12,20,-8,15
Mumbai City,7230,1,7,4,3,17,8,9,25
Delhi Dynamo,7230,2,6,5,3,24,15,9,23
Kolkata,7230,3,5,7,2,19,15,4,22
NorthEast Un,7230,4,5,3,6,11,11,0,18
Kerala Blast,7230,5,5,3,6,12,17,-5,18
FC Pune City,7230,6,4,4,6,13,17,-4,16
Chennaiyin,7230,7,3,6,5,14,20,-6,15
FC Goa,7230,8,4,2,8,11,18,-7,14
Delhi Dynamo,7231,1,6,6,2,26,16,10,24
Mumbai City,7231,2,6,4,4,17,10,7,22
Kolkata,7231,3,5,6,3,20,17,3,21
Kerala Blast,7231,4,6,3,5,13,18,-5,21
FC Pune City,7231,5,5,3,6,15,16,-1,18
Chennaiyin,7231,6,4,6,4,17,19,-2,18
NorthEast Un,7231,7,4,3,7,9,12,-3,15
FC Goa,7231,8,3,3,8,11,20,-9,12
NorthEast Un,7232,1,7,2,5,18,10,8,23
Mumbai City,7232,2,6,4,4,16,9,7,22
Delhi Dynamo,7232,3,5,5,4,23,19,4,20
Kolkata,7232,4,4,7,3,18,15,3,19
FC Pune City,7232,5,5,3,6,14,16,-2,18
Kerala Blast,7232,6,5,3,6,11,20,-9,18
FC Goa,7232,7,4,4,6,12,17,-5,16
Chennaiyin,7232,8,3,6,5,14,20,-6,15
Kolkata,7233,1,6,6,2,21,13,8,24
Mumbai City,7233,2,6,5,3,16,8,8,23
NorthEast Un,7233,3,6,2,6,11,11,0,20
Delhi Dynamo,7233,4,4,7,3,24,18,6,19
Kerala Blast,7233,5,5,4,5,12,16,-4,19
Chennaiyin,7233,6,4,5,5,16,20,-4,17
FC Pune City,7233,7,4,4,6,12,17,-5,16
FC Goa,7233,8,3,3,8,13,22,-9,12
Mumbai City,7234,1,7,4,3,22,9,13,25
Kerala Blast,7234,2,6,4,4,19,19,0,22
Delhi Dynamo,7234,3,5,6,3,24,21,3,21
NorthEast Un,7234,4,5,4,5,12,11,1,19
Kolkata,7234,5,4,7,3,19,19,0,19
FC Pune City,7234,6,4,3,7,14,19,-5,15
FC Goa,7234,7,4,3,7,13,18,-5,15
Chennaiyin,7234,8,3,5,6,14,21,-7,14
Mumbai City,7235,1,7,4,3,18,8,10,25
Delhi Dynamo,7235,2,5,6,3,26,19,7,21
FC Pune City,7235,3,6,3,5,17,14,3,21
Kerala Blast,7235,4,5,4,5,13,18,-5,19
FC Goa,7235,5,5,3,6,15,18,-3,18
NorthEast Un,7235,6,4,4,6,13,15,-2,16
Chennaiyin,7235,7,3,6,5,16,21,-5,15
Kolkata,7235,8,3,6,5,15,20,-5,15
Mumbai City,7236,1,6,5,3,17,9,8,23
Kolkata,7236,2,5,7,2,18,13,5,22
Chennaiyin,7236,3,5,5,4,18,20,-2,20
Delhi Dynamo,7236,4,4,7,3,22,16,6,19
Kerala Blast,7236,5,5,4,5,10,15,-5,19
FC Pune City,7236,6,5,3,6,14,16,-2,18
NorthEast Un,7236,7,4,3,7,11,13,-2,15
FC Goa,7236,8,4,2,8,11,19,-8,14
Mumbai City,7237,1,6,5,3,17,9,8,23
Kolkata,7237,2,5,7,2,18,13,5,22
Kerala Blast,7237,3,6,3,5,14,16,-2,21
Delhi Dynamo,7237,4,4,8,2,24,17,7,20
Chennaiyin,7237,5,5,5,4,17,18,-1,20
FC Pune City,7237,6,4,4,6,13,17,-4,16
NorthEast Un,7237,7,4,3,7,11,16,-5,15
FC Goa,7237,8,3,3,8,9,17,-8,12
Delhi Dynamo,7238,1,6,6,2,26,16,10,24
Mumbai City,7238,2,6,5,3,18,10,8,23
Kolkata,7238,3,4,8,2,17,14,3,20
Chennaiyin,7238,4,5,5,4,15,17,-2,20
FC Pune City,7238,5,5,3,6,15,16,-1,18
Kerala Blast,7238,6,4,5,5,12,19,-7,17
NorthEast Un,7238,7,4,3,7,10,13,-3,15
FC Goa,7238,8,3,3,8,8,16,-8,12
Mumbai City,7239,1,7,4,3,18,8,10,25
Kolkata,7239,2,5,6,3,16,14,2,21
Delhi Dynamo,7239,3,4,6,4,24,22,2,18
Chennaiyin,7239,4,4,6,4,18,18,0,18
FC Goa,7239,5,5,3,6,15,17,-2,18
NorthEast Un,7239,6,5,3,6,12,15,-3,18
FC Pune City,7239,7,4,4,6,12,15,-3,16
Kerala Blast,7239,8,4,4,6,11,17,-6,16
Mumbai City,7240,1,6,5,3,18,10,8,23
Delhi Dynamo,7240,2,5,7,2,28,19,9,22
Kerala Blast,7240,3,6,3,5,14,16,-2,21
FC Pune City,7240,4,5,4,5,17,18,-1,19
NorthEast Un,7240,5,5,3,6,11,12,-1,18
Kolkata,7240,6,3,7,4,18,21,-3,16
FC Goa,7240,7,4,3,7,14,19,-5,15
Chennaiyin,7240,8,3,6,5,13,18,-5,15
Mumbai City,7241,1,7,4,3,18,9,9,25
Kolkata,7241,2,6,6,2,20,14,6,24
Delhi Dynamo,7241,3,5,6,3,23,16,7,21
Chennaiyin,7241,4,5,5,4,17,18,-1,20
NorthEast Un,7241,5,5,3,6,13,13,0,18
FC Pune City,7241,6,5,3,6,14,17,-3,18
Kerala Blast,7241,7,4,3,7,11,20,-9,15
FC Goa,7241,8,3,2,9,8,17,-9,11
Kolkata,7242,1,6,6,2,20,14,6,24
Delhi Dynamo,7242,2,6,5,3,28,16,12,23
Mumbai City,7242,3,6,4,4,17,14,3,22
Chennaiyin,7242,4,5,5,4,17,19,-2,20
Kerala Blast,7242,5,5,4,5,12,16,-4,19
FC Pune City,7242,6,4,4,6,13,18,-5,16
NorthEast Un,7242,7,4,2,8,10,13,-3,14
FC Goa,7242,8,4,2,8,11,18,-7,14
Mumbai City,7243,1,7,4,3,20,10,10,25
Delhi Dynamo,7243,2,5,5,4,26,20,6,20
Kerala Blast,7243,3,5,4,5,13,15,-2,19
NorthEast Un,7243,4,5,3,6,13,14,-1,18
Chennaiyin,7243,5,4,6,4,16,18,-2,18
FC Pune City,7243,6,5,3,6,14,18,-4,18
Kolkata,7243,7,3,8,3,15,15,0,17
FC Goa,7243,8,4,3,7,10,17,-7,15
Delhi Dynamo,7244,1,6,6,2,25,15,10,24
Mumbai City,7244,2,6,4,4,16,10,6,22
Chennaiyin,7244,3,5,5,4,17,19,-2,20
Kolkata,7244,4,4,7,3,14,13,1,19
Kerala Blast,7244,5,4,6,4,10,14,-4,18
NorthEast Un,7244,6,4,4,6,10,11,-1,16
FC Pune City,7244,7,4,4,6,13,16,-3,16
FC Goa,7244,8,4,2,8,11,18,-7,14
Delhi Dynamo,7245,1,6,6,2,28,18,10,24
Mumbai City,7245,2,6,5,3,18,10,8,23
Kolkata,7245,3,5,7,2,16,13,3,22
NorthEast Un,7245,4,5,3,6,11,11,0,18
Kerala Blast,7245,5,5,3,6,11,16,-5,18
FC Pune City,7245,6,4,4,6,13,17,-4,16
Chennaiyin,7245,7,3,6,5,13,18,-5,15
FC Goa,7245,8,4,2,8,11,18,-7,14
Mumbai City,7246,1,7,4,3,18,9,9,25
FC Pune City,7246,2,6,3,5,19,16,3,21
Kerala Blast,7246,3,6,3,5,19,20,-1,21
NorthEast Un,7246,4,6,2,6,14,14,0,20
Delhi Dynamo,7246,5,4,6,4,22,17,5,18
Kolkata,7246,6,4,6,4,16,20,-4,18
FC Goa,7246,7,4,3,7,10,16,-6,15
Chennaiyin,7246,8,3,5,6,13,19,-6,14
Mumbai City,7247,1,7,4,3,18,9,9,25
Kolkata,7247,2,6,6,2,20,14,6,24
Delhi Dynamo,7247,3,5,5,4,24,18,6,20
NorthEast Un,7247,4,5,2,7,15,14,1,17
FC Goa,7247,5,5,2,7,11,15,-4,17
Chennaiyin,7247,6,4,5,5,15,20,-5,17
FC Pune City,7247,7,4,4,6,13,18,-5,16
Kerala Blast,7247,8,4,4,6,13,21,-8,16
Mumbai City,7248,1,7,4,3,19,10,9,25
Delhi Dynamo,7248,2,5,5,4,26,21,5,20
NorthEast Un,7248,3,6,2,6,13,11,2,20
Kerala Blast,7248,4,5,4,5,12,16,-4,19
FC Pune City,7248,5,4,5,5,13,15,-2,17
FC Goa,7248,6,5,2,7,14,17,-3,17
Chennaiyin,7248,7,4,5,5,14,20,-6,17
Kolkata,7248,8,3,7,4,15,16,-1,16
Mumbai City,7249,1,7,4,3,19,8,11,25
Kerala Blast,7249,2,6,4,4,17,16,1,22
Delhi Dynamo,7249,3,5,5,4,23,21,2,20
Kolkata,7249,4,3,8,3,17,17,0,17
NorthEast Un,7249,5,5,2,7,13,13,0,17
Chennaiyin,7249,6,4,5,5,15,20,-5,17
FC Goa,7249,7,5,2,7,13,18,-5,17
FC Pune City,7249,8,4,4,6,14,18,-4,16
Delhi Dynamo,7250,1,6,6,2,25,15,10,24
Mumbai City,7250,2,6,4,4,16,10,6,22
Kolkata,7250,3,5,7,2,18,14,4,22
Chennaiyin,7250,4,5,5,4,19,18,1,20
Kerala Blast,7250,5,5,4,5,11,15,-4,19
NorthEast Un,7250,6,5,3,6,11,13,-2,18
FC Pune City,7250,7,4,3,7,13,17,-4,15
FC Goa,7250,8,3,2,9,9,20,-11,11
Delhi Dynamo,7251,1,6,6,2,26,17,9,24
Mumbai City,7251,2,6,4,4,16,9,7,22
NorthEast Un,7251,3,6,3,5,12,10,2,21
Kerala Blast,7251,4,6,3,5,13,14,-1,21
Kolkata,7251,5,4,6,4,15,16,-1,18
FC Pune City,7251,6,5,3,6,14,17,-3,18
FC Goa,7251,7,4,2,8,16,19,-3,14
Chennaiyin,7251,8,3,5,6,13,23,-10,14
Mumbai City,7252,1,7,4,3,19,8,11,25
Kolkata,7252,2,5,6,3,19,14,5,21
Delhi Dynamo,7252,3,5,5,4,25,23,2,20
Kerala Blast,7252,4,5,4,5,12,17,-5,19
NorthEast Un,7252,5,5,3,6,16,13,3,18
Chennaiyin,7252,6,4,6,4,16,19,-3,18
FC Pune City,7252,7,4,3,7,12,18,-6,15
FC Goa,7252,8,4,3,7,12,19,-7,15
Mumbai City,7253,1,7,4,3,17,8,9,25
Kerala Blast,7253,2,6,4,4,13,15,-2,22
Delhi Dynamo,7253,3,5,6,3,25,16,9,21
Kolkata,7253,4,4,8,2,19,16,3,20
Chennaiyin,7253,5,4,6,4,18,21,-3,18
FC Pune City,7253,6,4,4,6,14,17,-3,16
NorthEast Un,7253,7,4,2,8,14,19,-5,14
FC Goa,7253,8,3,4,7,10,18,-8,13
Mumbai City,7254,1,7,4,3,18,9,9,25
Kolkata,7254,2,5,7,2,20,15,5,22
Delhi Dynamo,7254,3,5,6,3,24,17,7,21
Kerala Blast,7254,4,5,4,5,13,17,-4,19
Chennaiyin,7254,5,4,6,4,18,19,-1,18
NorthEast Un,7254,6,4,5,5,13,13,0,17
FC Pune City,7254,7,4,3,7,12,18,-6,15
FC Goa,7254,8,3,3,8,11,21,-10,12
Mumbai City,7255,1,7,4,3,17,8,9,25
Delhi Dynamo,7255,2,6,5,3,26,16,10,23
Kerala Blast,7255,3,6,4,4,14,15,-1,22
NorthEast Un,7255,4,5,3,6,14,13,1,18
Kolkata,7255,5,3,7,4,14,16,-2,16
FC Pune City,7255,6,4,4,6,13,16,-3,16
Chennaiyin,7255,7,3,6,5,16,23,-7,15
FC Goa,7255,8,4,3,7,11,18,-7,15
Delhi Dynamo,7256,1,6,5,3,26,17,9,23
Mumbai City,7256,2,6,4,4,17,11,6,22
Kolkata,7256,3,5,7,2,17,12,5,22
NorthEast Un,7256,4,5,3,6,13,13,0,18
Chennaiyin,7256,5,4,5,5,17,21,-4,17
Kerala Blast,7256,6,4,5,5,10,16,-6,17
FC Pune City,7256,7,4,4,6,13,17,-4,16
FC Goa,7256,8,4,3,7,10,16,-6,15
Mumbai City,7257,1,7,4,3,17,8,9,25
FC Pune City,7257,2,6,3,5,15,14,1,21
Kerala Blast,7257,3,6,3,5,13,16,-3,21
Delhi Dynamo,7257,4,5,5,4,22,16,6,20
Kolkata,7257,5,4,6,4,14,15,-1,18
Chennaiyin,7257,6,3,7,4,15,19,-4,16
NorthEast Un,7257,7,4,3,7,11,13,-2,15
FC Goa,7257,8,4,3,7,10,16,-6,15
Mumbai City,7258,1,7,4,3,19,10,9,25
Kerala Blast,7258,2,5,5,4,15,18,-3,20
Delhi Dynamo,7258,3,4,6,4,25,21,4,18
Kolkata,7258,4,4,6,4,18,18,0,18
Chennaiyin,7258,5,4,6,4,17,20,-3,18
FC Goa,7258,6,5,3,6,16,19,-3,18
NorthEast Un,7258,7,4,4,6,12,13,-1,16
FC Pune City,7258,8,4,4,6,14,17,-3,16
Mumbai City,7259,1,7,4,3,20,11,9,25
Kolkata,7259,2,4,8,2,16,14,2,20
Chennaiyin,7259,3,5,5,4,17,18,-1,20
Delhi Dynamo,7259,4,4,6,4,26,23,3,18
NorthEast Un,7259,5,5,3,6,10,11,-1,18
FC Pune City,7259,6,4,5,5,13,15,-2,17
Kerala Blast,7259,7,4,4,6,11,17,-6,16
FC Goa,7259,8,4,3,7,15,19,-4,15
Mumbai City,7260,1,6,5,3,17,9,8,23
Delhi Dynamo,7260,2,5,6,3,23,16,7,21
Kolkata,7260,3,4,8,2,16,13,3,20
NorthEast Un,7260,4,6,2,6,13,10,3,20
Kerala Blast,7260,5,5,4,5,10,14,-4,19
FC Goa,7260,6,5,2,7,11,17,-6,17
FC Pune City,7260,7,4,4,6,13,16,-3,16
Chennaiyin,7260,8,3,5,6,14,22,-8,14
Delhi Dynamo,7261,1,6,6,2,26,16,10,24
Kerala Blast,7261,2,7,3,4,15,15,0,24
Mumbai City,7261,3,6,4,4,17,10,7,22
Kolkata,7261,4,4,6,4,16,16,0,18
FC Pune City,7261,5,5,3,6,15,17,-2,18
Chennaiyin,7261,6,4,5,5,18,22,-4,17
NorthEast Un,7261,7,4,3,7,12,14,-2,15
FC Goa,7261,8,4,2,8,11,20,-9,14
Delhi Dynamo,7262,1,6,6,2,23,14,9,24
Mumbai City,7262,2,6,4,4,16,9,7,22
Kerala Blast,7262,3,6,3,5,18,17,1,21
NorthEast Un,7262,4,5,3,6,13,11,2,18
Kolkata,7262,5,4,6,4,19,19,0,18
Chennaiyin,7262,6,4,5,5,15,19,-4,17
FC Goa,7262,7,5,2,7,12,17,-5,17
FC Pune City,7262,8,4,3,7,13,23,-10,15
Mumbai City,7263,1,7,4,3,20,9,11,25
NorthEast Un,7263,2,6,3,5,14,12,2,21
Delhi Dynamo,7263,3,5,5,4,25,20,5,20
Kerala Blast,7263,4,5,5,4,13,16,-3,20
Kolkata,7263,5,4,7,3,17,16,1,19
FC Pune City,7263,6,4,3,7,14,18,-4,15
Chennaiyin,7263,7,3,6,5,14,19,-5,15
FC Goa,7263,8,4,3,7,10,17,-7,15
Mumbai City,7264,1,7,4,3,18,9,9,25
Delhi Dynamo,7264,2,6,5,3,25,16,9,23
Kolkata,7264,3,5,6,3,19,16,3,21
Kerala Blast,7264,4,6,3,5,13,16,-3,21
FC Pune City,7264,5,5,3,6,15,17,-2,18
Chennaiyin,7264,6,4,5,5,15,19,-4,17
NorthEast Un,7264,7,4,2,8,10,14,-4,14
FC Goa,7264,8,4,2,8,10,18,-8,14
Mumbai City,7265,1,7,4,3,19,9,10,25
Kolkata,7265,2,6,6,2,18,14,4,24
NorthEast Un,7265,3,6,3,5,14,10,4,21
Delhi Dynamo,7265,4,4,6,4,24,21,3,18
Kerala Blast,7265,5,5,3,6,11,17,-6,18
FC Pune City,7265,6,4,3,7,12,16,-4,15
Chennaiyin,7265,7,3,6,5,13,18,-5,15
FC Goa,7265,8,4,3,7,11,17,-6,15
Mumbai City,7266,1,6,5,3,18,10,8,23
Delhi Dynamo,7266,2,5,7,2,26,17,9,22
Kerala Blast,7266,3,6,3,5,15,16,-1,21
Kolkata,7266,4,4,8,2,18,15,3,20
Chennaiyin,7266,5,4,5,5,16,18,-2,17
FC Pune City,7266,6,4,4,6,14,17,-3,16
NorthEast Un,7266,7,4,3,7,11,18,-7,15
FC Goa,7266,8,4,3,7,10,17,-7,15
Mumbai City,7267,1,7,4,3,19,10,9,25
Kolkata,7267,2,4,8,2,20,16,4,20
NorthEast Un,7267,3,6,2,6,14,11,3,20
FC Pune City,7267,4,5,4,5,16,17,-1,19
Kerala Blast,7267,5,5,4,5,12,16,-4,19
Delhi Dynamo,7267,6,4,5,5,25,23,2,17
FC Goa,7267,7,5,2,7,12,19,-7,17
Chennaiyin,7267,8,3,5,6,13,19,-6,14
Mumbai City,7268,1,7,4,3,18,9,9,25
Delhi Dynamo,7268,2,5,6,3,23,16,7,21
NorthEast Un,7268,3,6,2,6,11,10,1,20
Kolkata,7268,4,4,7,3,16,15,1,19
Kerala Blast,7268,5,5,4,5,14,15,-1,19
FC Goa,7268,6,4,4,6,12,17,-5,16
Chennaiyin,7268,7,3,6,5,15,20,-5,15
FC Pune City,7268,8,4,3,7,12,19,-7,15
Mumbai City,7269,1,7,4,3,17,8,9,25
NorthEast Un,7269,2,7,2,5,15,11,4,23
Kerala Blast,7269,3,6,3,5,17,15,2,21
Delhi Dynamo,7269,4,5,5,4,24,17,7,20
Kolkata,7269,5,4,6,4,15,15,0,18
FC Pune City,7269,6,5,3,6,13,19,-6,18
Chennaiyin,7269,7,3,5,6,16,22,-6,14
FC Goa,7269,8,4,2,8,11,21,-10,14
Mumbai City,7270,1,6,4,4,16,9,7,22
Delhi Dynamo,7270,2,5,6,3,25,18,7,21
Kerala Blast,7270,3,5,5,4,13,16,-3,20
Chennaiyin,7270,4,4,6,4,16,17,-1,18
FC Pune City,7270,5,5,3,6,13,15,-2,18
Kolkata,7270,6,3,8,3,19,19,0,17
NorthEast Un,7270,7,4,5,5,10,10,0,17
FC Goa,7270,8,4,3,7,14,22,-8,15
Mumbai City,7271,1,7,4,3,20,11,9,25
NorthEast Un,7271,2,6,3,5,14,12,2,21
Delhi Dynamo,7271,3,5,5,4,29,20,9,20
Kerala Blast,7271,4,4,6,4,16,20,-4,18
Kolkata,7271,5,3,8,3,14,15,-1,17
FC Pune City,7271,6,4,5,5,16,18,-2,17
Chennaiyin,7271,7,3,6,5,15,20,-5,15
FC Goa,7271,8,4,3,7,12,20,-8,15
Mumbai City,7272,1,6,5,3,16,8,8,23
Kolkata,7272,2,5,6,3,20,16,4,21
FC Pune City,7272,3,6,3,5,17,16,1,21
NorthEast Un,7272,4,6,2,6,13,12,1,20
Delhi Dynamo,7272,5,4,7,3,22,16,6,19
Chennaiyin,7272,6,4,5,5,16,21,-5,17
FC Goa,7272,7,4,3,7,12,17,-5,15
Kerala Blast,7272,8,4,3,7,12,22,-10,15
Mumbai City,7273,1,7,4,3,18,9,9,25
Delhi Dynamo,7273,2,5,6,3,25,18,7,21
Kolkata,7273,3,4,7,3,18,17,1,19
Kerala Blast,7273,4,5,4,5,13,17,-4,19
NorthEast Un,7273,5,5,2,7,13,14,-1,17
FC Pune City,7273,6,4,5,5,17,19,-2,17
Chennaiyin,7273,7,4,5,5,16,20,-4,17
FC Goa,7273,8,4,3,7,10,16,-6,15
Mumbai City,7274,1,6,5,3,17,9,8,23
Delhi Dynamo,7274,2,5,6,3,25,17,8,21
Kolkata,7274,3,4,7,3,17,15,2,19
FC Pune City,7274,4,5,4,5,14,15,-1,19
Kerala Blast,7274,5,5,4,5,11,16,-5,19
NorthEast Un,7274,6,5,3,6,11,11,0,18
Chennaiyin,7274,7,3,7,4,15,19,-4,16
FC Goa,7274,8,3,4,7,12,20,-8,13
Mumbai City,7275,1,6,4,4,17,11,6,22
Delhi Dynamo,7275,2,5,6,3,25,19,6,21
Kolkata,7275,3,4,7,3,15,14,1,19
FC Pune City,7275,4,5,4,5,13,14,-1,19
Kerala Blast,7275,5,5,4,5,11,14,-3,19
NorthEast Un,7275,6,5,2,7,13,13,0,17
Chennaiyin,7275,7,4,5,5,15,21,-6,17
FC Goa,7275,8,4,4,6,13,16,-3,16
Mumbai City,7276,1,7,4,3,18,8,10,25
Delhi Dynamo,7276,2,5,5,4,23,18,5,20
Kolkata,7276,3,4,8,2,16,13,3,20
NorthEast Un,7276,4,6,2,6,11,11,0,20
Kerala Blast,7276,5,5,4,5,11,14,-3,19
FC Goa,7276,6,5,2,7,11,16,-5,17
FC Pune City,7276,7,4,4,6,13,17,-4,16
Chennaiyin,7276,8,3,5,6,13,19,-6,14
Kolkata,7277,1,6,6,2,16,12,4,24
Mumbai City,7277,2,6,5,3,17,9,8,23
NorthEast Un,7277,3,5,4,5,12,11,1,19
Kerala Blast,7277,4,5,4,5,14,18,-4,19
Delhi Dynamo,7277,5,4,6,4,23,19,4,18
FC Goa,7277,6,5,2,7,14,18,-4,17
FC Pune City,7277,7,4,3,7,14,18,-4,15
Chennaiyin,7277,8,3,6,5,15,20,-5,15
Delhi Dynamo,7278,1,6,5,3,28,21,7,23
Mumbai City,7278,2,6,4,4,19,12,7,22
NorthEast Un,7278,3,6,2,6,16,12,4,20
FC Pune City,7278,4,5,4,5,16,15,1,19
Kerala Blast,7278,5,5,4,5,11,17,-6,19
Kolkata,7278,6,3,9,2,15,14,1,18
FC Goa,7278,7,4,3,7,11,18,-7,15
Chennaiyin,7278,8,3,5,6,16,23,-7,14
Mumbai City,7279,1,6,5,3,17,9,8,23
Delhi Dynamo,7279,2,5,7,2,25,16,9,22
Kolkata,7279,3,5,7,2,20,13,7,22
Kerala Blast,7279,4,6,3,5,13,16,-3,21
NorthEast Un,7279,5,5,3,6,12,13,-1,18
Chennaiyin,7279,6,4,5,5,15,19,-4,17
FC Pune City,7279,7,4,3,7,12,19,-7,15
FC Goa,7279,8,3,3,8,9,18,-9,12
Mumbai City,7280,1,7,4,3,19,9,10,25
Delhi Dynamo,7280,2,5,6,3,26,18,8,21
NorthEast Un,7280,3,5,4,5,11,10,1,19
Kerala Blast,7280,4,5,4,5,13,17,-4,19
Kolkata,7280,5,3,8,3,17,17,0,17
FC Goa,7280,6,5,2,7,12,19,-7,17
FC Pune City,7280,7,4,4,6,15,18,-3,16
Chennaiyin,7280,8,3,6,5,13,18,-5,15
Mumbai City,7281,1,7,4,3,18,8,10,25
Delhi Dynamo,7281,2,5,6,3,23,16,7,21
Kolkata,7281,3,4,8,2,18,16,2,20
Kerala Blast,7281,4,4,6,4,11,15,-4,18
NorthEast Un,7281,5,4,4,6,9,11,-2,16
FC Pune City,7281,6,4,4,6,14,17,-3,16
Chennaiyin,7281,7,3,7,4,14,18,-4,16
FC Goa,7281,8,3,5,6,11,17,-6,14
Mumbai City,7282,1,6,5,3,17,9,8,23
Kerala Blast,7282,2,6,4,4,13,15,-2,22
Delhi Dynamo,7282,3,5,6,3,25,18,7,21
Chennaiyin,7282,4,5,5,4,16,18,-2,20
FC Pune City,7282,5,5,3,6,13,15,-2,18
Kolkata,7282,6,3,8,3,15,15,0,17
NorthEast Un,7282,7,5,2,7,14,15,-1,17
FC Goa,7282,8,3,3,8,9,17,-8,12
Mumbai City,7283,1,7,4,3,17,8,9,25
Delhi Dynamo,7283,2,6,5,3,26,18,8,23
Kolkata,7283,3,5,7,2,21,17,4,22
Kerala Blast,7283,4,5,4,5,13,18,-5,19
FC Pune City,7283,5,4,5,5,15,17,-2,17
NorthEast Un,7283,6,4,3,7,12,14,-2,15
Chennaiyin,7283,7,3,6,5,13,18,-5,15
FC Goa,7283,8,4,2,8,10,17,-7,14
Mumbai City,7284,1,7,4,3,18,8,10,25
FC Goa,7284,2,6,2,6,19,16,3,20
Kerala Blast,7284,3,5,5,4,13,15,-2,20
NorthEast Un,7284,4,5,4,5,13,11,2,19
Delhi Dynamo,7284,5,4,5,5,23,22,1,17
FC Pune City,7284,6,4,5,5,15,17,-2,17
Kolkata,7284,7,3,7,4,15,19,-4,16
Chennaiyin,7284,8,3,6,5,14,22,-8,15
Delhi Dynamo,7285,1,6,6,2,29,19,10,24
Mumbai City,7285,2,6,5,3,17,9,8,23
Kolkata,7285,3,5,7,2,18,14,4,22
Kerala Blast,7285,4,6,4,4,13,14,-1,22
Chennaiyin,7285,5,3,7,4,15,19,-4,16
NorthEast Un,7285,6,4,3,7,13,15,-2,15
FC Pune City,7285,7,4,3,7,12,18,-6,15
FC Goa,7285,8,3,3,8,11,20,-9,12
Mumbai City,7286,1,7,4,3,21,10,11,25
Kolkata,7286,2,6,6,2,21,15,6,24
Delhi Dynamo,7286,3,6,5,3,27,21,6,23
FC Pune City,7286,4,5,3,6,16,18,-2,18
Kerala Blast,7286,5,5,3,6,12,17,-5,18
Chennaiyin,7286,6,3,7,4,14,18,-4,16
NorthEast Un,7286,7,4,3,7,10,13,-3,15
FC Goa,7286,8,3,3,8,10,19,-9,12
Mumbai City,7287,1,7,4,3,19,9,10,25
Kolkata,7287,2,5,7,2,17,13,4,22
Delhi Dynamo,7287,3,5,5,4,27,21,6,20
NorthEast Un,7287,4,6,2,6,14,13,1,20
Chennaiyin,7287,5,4,5,5,16,19,-3,17
Kerala Blast,7287,6,4,5,5,11,17,-6,17
FC Pune City,7287,7,4,4,6,13,16,-3,16
FC Goa,7287,8,4,2,8,13,22,-9,14
Mumbai City,7288,1,7,4,3,18,8,10,25
Delhi Dynamo,7288,2,6,5,3,25,18,7,23
Kolkata,7288,3,5,6,3,20,13,7,21
NorthEast Un,7288,4,5,3,6,13,13,0,18
FC Pune City,7288,5,5,3,6,14,18,-4,18
FC Goa,7288,6,5,2,7,11,15,-4,17
Kerala Blast,7288,7,4,4,6,11,20,-9,16
Chennaiyin,7288,8,3,5,6,13,20,-7,14
Mumbai City,7289,1,7,4,3,21,9,12,25
Delhi Dynamo,7289,2,6,5,3,26,21,5,23
Kolkata,7289,3,5,6,3,19,17,2,21
NorthEast Un,7289,4,6,2,6,12,11,1,20
FC Pune City,7289,5,5,3,6,14,16,-2,18
Kerala Blast,7289,6,5,3,6,12,17,-5,18
Chennaiyin,7289,7,4,5,5,16,20,-4,17
FC Goa,7289,8,3,2,9,12,21,-9,11
Mumbai City,7290,1,6,5,3,18,10,8,23
NorthEast Un,7290,2,7,2,5,16,11,5,23
Delhi Dynamo,7290,3,5,6,3,24,17,7,21
FC Pune City,7290,4,5,4,5,14,15,-1,19
Kolkata,7290,5,4,7,3,15,18,-3,19
Kerala Blast,7290,6,5,3,6,15,17,-2,18
Chennaiyin,7290,7,3,6,5,15,21,-6,15
FC Goa,7290,8,3,3,8,9,17,-8,12
Mumbai City,7291,1,6,5,3,19,11,8,23
Kolkata,7291,2,5,7,2,19,13,6,22
Chennaiyin,7291,3,5,5,4,18,18,0,20
Kerala Blast,7291,4,5,5,4,14,16,-2,20
Delhi Dynamo,7291,5,4,6,4,24,23,1,18
NorthEast Un,7291,6,5,3,6,13,13,0,18
FC Pune City,7291,7,4,3,7,12,19,-7,15
FC Goa,7291,8,4,2,8,13,19,-6,14
Mumbai City,7292,1,7,4,3,18,8,10,25
Kolkata,7292,2,4,8,2,16,14,2,20
Chennaiyin,7292,3,5,5,4,15,17,-2,20
Delhi Dynamo,7292,4,4,6,4,23,19,4,18
Kerala Blast,7292,5,4,6,4,12,16,-4,18
NorthEast Un,7292,6,4,4,6,12,13,-1,16
FC Pune City,7292,7,4,4,6,14,17,-3,16
FC Goa,7292,8,4,3,7,9,15,-6,15
Mumbai City,7293,1,6,5,3,17,9,8,23
NorthEast Un,7293,2,6,2,6,18,15,3,20
Delhi Dynamo,7293,3,4,7,3,24,20,4,19
Kerala Blast,7293,4,5,4,5,12,18,-6,19
FC Pune City,7293,5,5,3,6,15,16,-1,18
FC Goa,7293,6,5,3,6,13,15,-2,18
Chennaiyin,7293,7,4,5,5,17,19,-2,17
Kolkata,7293,8,3,7,4,13,17,-4,16
Mumbai City,7294,1,7,4,3,22,8,14,25
Kerala Blast,7294,2,6,3,5,15,16,-1,21
FC Goa,7294,3,6,2,6,19,17,2,20
Delhi Dynamo,7294,4,5,5,4,25,26,-1,20
Kolkata,7294,5,4,6,4,19,20,-1,18
FC Pune City,7294,6,5,3,6,16,18,-2,18
Chennaiyin,7294,7,4,5,5,15,21,-6,17
NorthEast Un,7294,8,4,2,8,11,16,-5,14
Mumbai City,7295,1,6,4,4,17,10,7,22
Kerala Blast,7295,2,6,4,4,14,14,0,22
Delhi Dynamo,7295,3,5,5,4,23,22,1,20
NorthEast Un,7295,4,6,2,6,12,11,1,20
FC Pune City,7295,5,5,3,6,13,16,-3,18
Kolkata,7295,6,3,8,3,14,14,0,17
Chennaiyin,7295,7,4,5,5,16,18,-2,17
FC Goa,7295,8,4,3,7,13,17,-4,15
Mumbai City,7296,1,6,5,3,18,10,8,23
Kolkata,7296,2,4,8,2,14,12,2,20
Kerala Blast,7296,3,5,5,4,10,13,-3,20
Delhi Dynamo,7296,4,4,7,3,25,19,6,19
NorthEast Un,7296,5,5,3,6,14,12,2,18
Chennaiyin,7296,6,4,5,5,16,22,-6,17
FC Pune City,7296,7,4,4,6,12,15,-3,16
FC Goa,7296,8,4,3,7,11,17,-6,15
Mumbai City,7297,1,6,5,3,17,9,8,23
Delhi Dynamo,7297,2,5,7,2,27,16,11,22
Kerala Blast,7297,3,5,5,4,10,13,-3,20
Kolkata,7297,4,3,8,3,14,16,-2,17
FC Pune City,7297,5,4,5,5,13,15,-2,17
FC Goa,7297,6,4,4,6,13,16,-3,16
Chennaiyin,7297,7,3,7,4,14,18,-4,16
NorthEast Un,7297,8,4,3,7,9,14,-5,15
Mumbai City,7298,1,7,4,3,19,10,9,25
Kolkata,7298,2,6,6,2,22,14,8,24
Delhi Dynamo,7298,3,5,5,4,26,21,5,20
NorthEast Un,7298,4,6,2,6,14,13,1,20
Kerala Blast,7298,5,5,4,5,13,19,-6,19
FC Pune City,7298,6,4,4,6,13,17,-4,16
FC Goa,7298,7,4,2,8,13,19,-6,14
Chennaiyin,7298,8,3,5,6,15,22,-7,14
Mumbai City,7299,1,6,5,3,18,10,8,23
Kerala Blast,7299,2,6,4,4,15,14,1,22
Delhi Dynamo,7299,3,5,6,3,26,21,5,21
NorthEast Un,7299,4,6,2,6,16,14,2,20
Kolkata,7299,5,3,8,3,14,15,-1,17
Chennaiyin,7299,6,4,5,5,15,18,-3,17
FC Pune City,7299,7,4,4,6,12,16,-4,16
FC Goa,7299,8,4,2,8,11,19,-8,14
Mumbai City,7300,1,6,5,3,17,9,8,23
Delhi Dynamo,7300,2,5,6,3,25,18,7,21
Kolkata,7300,3,5,6,3,19,14,5,21
NorthEast Un,7300,4,6,3,5,14,11,3,21
FC Pune City,7300,5,5,3,6,14,17,-3,18
Kerala Blast,7300,6,5,3,6,10,16,-6,18
Chennaiyin,7300,7,3,6,5,15,20,-5,15
FC Goa,7300,8,4,2,8,11,20,-9,14
Mumbai City,7301,1,7,4,3,22,9,13,25
Delhi Dynamo,7301,2,5,5,4,24,22,2,20
Kolkata,7301,3,4,8,2,16,14,2,20
Kerala Blast,7301,4,5,5,4,11,14,-3,20
Chennaiyin,7301,5,4,6,4,15,18,-3,18
NorthEast Un,7301,6,5,2,7,10,11,-1,17
FC Pune City,7301,7,4,4,6,13,16,-3,16
FC Goa,7301,8,3,4,7,12,19,-7,13
Delhi Dynamo,7302,1,6,6,2,26,15,11,24
Kolkata,7302,2,6,6,2,18,12,6,24
Mumbai City,7302,3,6,5,3,17,9,8,23
NorthEast Un,7302,4,6,2,6,13,14,-1,20
Kerala Blast,7302,5,5,3,6,10,17,-7,18
FC Pune City,7302,6,4,3,7,12,16,-4,15
Chennaiyin,7302,7,3,6,5,15,20,-5,15
FC Goa,7302,8,3,3,8,8,16,-8,12
Delhi Dynamo,7303,1,7,5,2,27,16,11,26
Mumbai City,7303,2,6,4,4,16,9,7,22
Kerala Blast,7303,3,5,5,4,13,14,-1,20
FC Pune City,7303,4,5,4,5,15,15,0,19
NorthEast Un,7303,5,5,2,7,11,15,-4,17
FC Goa,7303,6,5,2,7,15,20,-5,17
Kolkata,7303,7,3,7,4,15,17,-2,16
Chennaiyin,7303,8,3,5,6,15,21,-6,14
Delhi Dynamo,7304,1,6,5,3,26,15,11,23
Mumbai City,7304,2,6,4,4,16,10,6,22
NorthEast Un,7304,3,6,3,5,13,11,2,21
Kolkata,7304,4,4,8,2,16,14,2,20
Chennaiyin,7304,5,4,6,4,14,17,-3,18
Kerala Blast,7304,6,4,5,5,14,19,-5,17
FC Pune City,7304,7,4,4,6,14,17,-3,16
FC Goa,7304,8,3,3,8,9,19,-10,12
Mumbai City,7305,1,6,5,3,16,8,8,23
Kolkata,7305,2,5,7,2,16,13,3,22
Delhi Dynamo,7305,3,5,6,3,23,17,6,21
Kerala Blast,7305,4,5,4,5,11,15,-4,19
NorthEast Un,7305,5,5,3,6,15,14,1,18
FC Pune City,7305,6,4,5,5,14,16,-2,17
Chennaiyin,7305,7,3,7,4,17,21,-4,16
FC Goa,7305,8,3,3,8,9,17,-8,12
Mumbai City,7306,1,7,4,3,18,9,9,25
FC Pune City,7306,2,6,3,5,17,16,1,21
NorthEast Un,7306,3,6,2,6,17,16,1,20
Kolkata,7306,4,4,6,4,16,16,0,18
Chennaiyin,7306,5,4,6,4,17,19,-2,18
FC Goa,7306,6,5,3,6,12,16,-4,18
Delhi Dynamo,7306,7,4,5,5,26,22,4,17
Kerala Blast,7306,8,4,3,7,10,19,-9,15
Delhi Dynamo,7307,1,6,6,2,25,15,10,24
Mumbai City,7307,2,6,4,4,17,10,7,22
Kerala Blast,7307,3,5,5,4,13,16,-3,20
Kolkata,7307,4,3,8,3,17,17,0,17
Chennaiyin,7307,5,4,5,5,18,20,-2,17
FC Pune City,7307,6,4,5,5,16,18,-2,17
NorthEast Un,7307,7,4,4,6,9,13,-4,16
FC Goa,7307,8,4,3,7,12,18,-6,15
Mumbai City,7308,1,6,5,3,18,10,8,23
Delhi Dynamo,7308,2,5,6,3,27,18,9,21
Kerala Blast,7308,3,5,4,5,11,16,-5,19
Kolkata,7308,4,4,6,4,16,17,-1,18
NorthEast Un,7308,5,5,3,6,12,13,-1,18
FC Pune City,7308,6,5,3,6,15,17,-2,18
Chennaiyin,7308,7,4,5,5,17,20,-3,17
FC Goa,7308,8,5,2,7,14,19,-5,17
Mumbai City,7309,1,6,5,3,16,8,8,23
Delhi Dynamo,7309,2,5,7,2,26,18,8,22
Kolkata,7309,3,5,6,3,17,16,1,21
Chennaiyin,7309,4,5,5,4,15,17,-2,20
FC Pune City,7309,5,5,3,6,14,15,-1,18
Kerala Blast,7309,6,5,3,6,12,17,-5,18
NorthEast Un,7309,7,5,2,7,13,14,-1,17
FC Goa,7309,8,3,3,8,11,19,-8,12
Delhi Dynamo,7310,1,6,6,2,25,16,9,24
Mumbai City,7310,2,6,4,4,16,9,7,22
Kolkata,7310,3,5,7,2,18,13,5,22
Chennaiyin,7310,4,4,5,5,18,20,-2,17
FC Pune City,7310,5,4,5,5,13,15,-2,17
NorthEast Un,7310,6,5,2,7,12,14,-2,17
Kerala Blast,7310,7,4,4,6,10,19,-9,16
FC Goa,7310,8,4,3,7,13,19,-6,15
Mumbai City,7311,1,6,5,3,19,11,8,23
Kolkata,7311,2,5,7,2,19,15,4,22
Delhi Dynamo,7311,3,5,6,3,26,19,7,21
NorthEast Un,7311,4,5,4,5,14,12,2,19
Chennaiyin,7311,5,4,6,4,16,19,-3,18
FC Pune City,7311,6,4,5,5,14,16,-2,17
Kerala Blast,7311,7,4,5,5,12,18,-6,17
FC Goa,7311,8,3,2,9,9,19,-10,11
Mumbai City,7312,1,7,4,3,17,8,9,25
Kolkata,7312,2,6,6,2,21,17,4,24
Delhi Dynamo,7312,3,5,5,4,23,18,5,20
NorthEast Un,7312,4,6,2,6,13,10,3,20
Chennaiyin,7312,5,5,5,4,15,17,-2,20
FC Pune City,7312,6,4,4,6,14,17,-3,16
Kerala Blast,7312,7,4,4,6,10,17,-7,16
FC Goa,7312,8,3,2,9,11,20,-9,11
Kerala Blast,7313,1,7,3,4,15,15,0,24
Mumbai City,7313,2,6,5,3,17,9,8,23
Delhi Dynamo,7313,3,5,7,2,25,15,10,22
Kolkata,7313,4,4,7,3,19,18,1,19
Chennaiyin,7313,5,4,6,4,15,18,-3,18
NorthEast Un,7313,6,4,3,7,9,12,-3,15
FC Pune City,7313,7,4,3,7,15,19,-4,15
FC Goa,7313,8,3,4,7,11,20,-9,13
Delhi Dynamo,7314,1,6,5,3,25,18,7,23
Mumbai City,7314,2,6,4,4,16,9,7,22
FC Pune City,7314,3,5,4,5,16,15,1,19
FC Goa,7314,4,5,3,6,17,20,-3,18
Kerala Blast,7314,5,4,6,4,11,15,-4,18
Kolkata,7314,6,3,8,3,16,18,-2,17
NorthEast Un,7314,7,4,4,6,10,11,-1,16
Chennaiyin,7314,8,3,6,5,16,21,-5,15
Mumbai City,7315,1,7,4,3,17,8,9,25
Delhi Dynamo,7315,2,5,6,3,27,16,11,21
Kolkata,7315,3,5,6,3,17,14,3,21
Kerala Blast,7315,4,5,4,5,11,17,-6,19
NorthEast Un,7315,5,5,3,6,14,12,2,18
Chennaiyin,7315,6,4,6,4,15,18,-3,18
FC Pune City,7315,7,4,4,6,13,17,-4,16
FC Goa,7315,8,3,3,8,9,21,-12,12
Delhi Dynamo,7316,1,6,5,3,25,16,9,23
Mumbai City,7316,2,6,4,4,17,10,7,22
FC Pune City,7316,3,6,3,5,16,14,2,21
Kolkata,7316,4,5,6,3,16,15,1,21
Kerala Blast,7316,5,5,3,6,11,16,-5,18
Chennaiyin,7316,6,4,5,5,18,19,-1,17
NorthEast Un,7316,7,5,2,7,11,13,-2,17
FC Goa,7316,8,4,2,8,10,21,-11,14
Mumbai City,7317,1,7,4,3,18,9,9,25
Kerala Blast,7317,2,7,3,4,15,16,-1,24
Kolkata,7317,3,5,6,3,19,17,2,21
Delhi Dynamo,7317,4,5,5,4,25,19,6,20
FC Goa,7317,5,5,2,7,15,18,-3,17
NorthEast Un,7317,6,4,3,7,10,12,-2,15
FC Pune City,7317,7,4,3,7,14,18,-4,15
Chennaiyin,7317,8,3,6,5,14,21,-7,15
Mumbai City,7318,1,7,4,3,18,8,10,25
Kolkata,7318,2,5,7,2,17,14,3,22
Delhi Dynamo,7318,3,5,6,3,22,16,6,21
Chennaiyin,7318,4,4,6,4,16,18,-2,18
Kerala Blast,7318,5,4,5,5,11,16,-5,17
NorthEast Un,7318,6,4,4,6,11,13,-2,16
FC Pune City,7318,7,4,4,6,14,17,-3,16
FC Goa,7318,8,3,4,7,9,16,-7,13
Mumbai City,7319,1,7,4,3,18,9,9,25
Kerala Blast,7319,2,6,4,4,15,15,0,22
NorthEast Un,7319,3,6,3,5,14,11,3,21
Delhi Dynamo,7319,4,5,5,4,24,19,5,20
Kolkata,7319,5,3,7,4,15,18,-3,16
FC Pune City,7319,6,4,4,6,15,19,-4,16
Chennaiyin,7319,7,3,6,5,14,19,-5,15
FC Goa,7319,8,4,3,7,11,16,-5,15
Delhi Dynamo,7320,1,6,5,3,31,20,11,23
Mumbai City,7320,2,6,4,4,18,13,5,22
NorthEast Un,7320,3,6,2,6,16,12,4,20
Kolkata,7320,4,4,7,3,16,15,1,19
FC Pune City,7320,5,5,4,5,15,16,-1,19
Chennaiyin,7320,6,4,5,5,15,19,-4,17
FC Goa,7320,7,5,2,7,12,18,-6,17
Kerala Blast,7320,8,4,3,7,11,21,-10,15
Mumbai City,7321,1,7,4,3,18,8,10,25
Delhi Dynamo,7321,2,5,6,3,25,19,6,21
NorthEast Un,7321,3,5,4,5,13,11,2,19
Kerala Blast,7321,4,5,4,5,11,15,-4,19
Kolkata,7321,5,4,6,4,15,16,-1,18
FC Pune City,7321,6,5,3,6,13,15,-2,18
Chennaiyin,7321,7,4,5,5,14,19,-5,17
FC Goa,7321,8,4,2,8,11,17,-6,14
Mumbai City,7322,1,7,4,3,20,8,12,25
Delhi Dynamo,7322,2,6,5,3,27,19,8,23
Kolkata,7322,3,4,7,3,15,14,1,19
FC Pune City,7322,4,5,4,5,14,15,-1,19
Kerala Blast,7322,5,5,4,5,11,15,-4,19
Chennaiyin,7322,6,4,6,4,16,19,-3,18
NorthEast Un,7322,7,4,3,7,12,14,-2,15
FC Goa,7322,8,3,3,8,9,20,-11,12
Mumbai City,7323,1,6,5,3,17,9,8,23
Kolkata,7323,2,5,7,2,19,15,4,22
Delhi Dynamo,7323,3,4,8,2,23,16,7,20
NorthEast Un,7323,4,4,5,5,11,11,0,17
Kerala Blast,7323,5,4,5,5,13,18,-5,17
FC Pune City,7323,6,4,4,6,15,19,-4,16
FC Goa,7323,7,4,4,6,12,17,-5,16
Chennaiyin,7323,8,3,6,5,15,20,-5,15
Mumbai City,7324,1,6,5,3,17,9,8,23
Kolkata,7324,2,5,7,2,21,15,6,22
Delhi Dynamo,7324,3,5,6,3,25,18,7,21
FC Pune City,7324,4,5,3,6,14,16,-2,18
FC Goa,7324,5,5,3,6,13,17,-4,18
Kerala Blast,7324,6,5,3,6,12,18,-6,18
NorthEast Un,7324,7,5,2,7,11,14,-3,17
Chennaiyin,7324,8,3,5,6,13,19,-6,14
Mumbai City,7325,1,6,5,3,18,10,8,23
Delhi Dynamo,7325,2,5,6,3,26,19,7,21
Kolkata,7325,3,5,6,3,15,15,0,21
Kerala Blast,7325,4,6,3,5,11,14,-3,21
Chennaiyin,7325,5,4,6,4,17,20,-3,18
NorthEast Un,7325,6,5,2,7,12,13,-1,17
FC Goa,7325,7,4,3,7,14,18,-4,15
FC Pune City,7325,8,4,3,7,12,16,-4,15
Mumbai City,7326,1,6,5,3,17,9,8,23
Delhi Dynamo,7326,2,5,7,2,24,15,9,22
Kolkata,7326,3,5,7,2,19,14,5,22
NorthEast Un,7326,4,5,3,6,10,10,0,18
FC Pune City,7326,5,5,3,6,14,17,-3,18
Kerala Blast,7326,6,5,3,6,10,16,-6,18
Chennaiyin,7326,7,4,5,5,18,20,-2,17
FC Goa,7326,8,3,3,8,11,22,-11,12
Mumbai City,7327,1,7,4,3,17,8,9,25
NorthEast Un,7327,2,7,2,5,19,13,6,23
Kolkata,7327,3,5,7,2,18,15,3,22
Delhi Dynamo,7327,4,5,5,4,27,22,5,20
FC Pune City,7327,5,5,4,5,16,17,-1,19
Kerala Blast,7327,6,4,3,7,9,18,-9,15
FC Goa,7327,7,4,2,8,13,19,-6,14
Chennaiyin,7327,8,3,5,6,15,22,-7,14
Mumbai City,7328,1,7,4,3,18,8,10,25
Kerala Blast,7328,2,6,4,4,15,14,1,22
NorthEast Un,7328,3,6,2,6,13,14,-1,20
Kolkata,7328,4,4,7,3,15,16,-1,19
Delhi Dynamo,7328,5,4,6,4,24,20,4,18
FC Goa,7328,6,5,3,6,14,16,-2,18
FC Pune City,7328,7,4,3,7,14,19,-5,15
Chennaiyin,7328,8,3,5,6,14,20,-6,14
Mumbai City,7329,1,6,5,3,17,9,8,23
Kolkata,7329,2,5,7,2,16,13,3,22
Delhi Dynamo,7329,3,4,7,3,24,19,5,19
NorthEast Un,7329,4,5,3,6,12,11,1,18
FC Pune City,7329,5,5,3,6,14,16,-2,18
Chennaiyin,7329,6,4,5,5,14,19,-5,17
FC Goa,7329,7,4,4,6,12,16,-4,16
Kerala Blast,7329,8,4,4,6,12,18,-6,16
Delhi Dynamo,7330,1,6,5,3,23,15,8,23
Mumbai City,7330,2,6,4,4,16,9,7,22
NorthEast Un,7330,3,6,3,5,12,9,3,21
Kerala Blast,7330,4,5,4,5,15,18,-3,19
Chennaiyin,7330,5,4,6,4,15,17,-2,18
Kolkata,7330,6,3,8,3,16,16,0,17
FC Pune City,7330,7,4,4,6,15,20,-5,16
FC Goa,7330,8,4,2,8,10,18,-8,14
Delhi Dynamo,7331,1,6,6,2,25,14,11,24
Mumbai City,7331,2,6,5,3,16,8,8,23
Kerala Blast,7331,3,6,3,5,13,16,-3,21
Kolkata,7331,4,4,8,2,19,16,3,20
FC Pune City,7331,5,4,4,6,15,19,-4,16
NorthEast Un,7331,6,4,3,7,10,14,-4,15
Chennaiyin,7331,7,3,6,5,14,19,-5,15
FC Goa,7331,8,4,3,7,11,17,-6,15
Kerala Blast,7332,1,7,3,4,15,15,0,24
Delhi Dynamo,7332,2,6,5,3,27,18,9,23
Mumbai City,7332,3,6,4,4,16,9,7,22
Kolkata,7332,4,4,7,3,16,15,1,19
NorthEast Un,7332,5,5,3,6,15,14,1,18
FC Pune City,7332,6,4,3,7,13,17,-4,15
Chennaiyin,7332,7,3,6,5,15,21,-6,15
FC Goa,7332,8,4,3,7,11,19,-8,15
Delhi Dynamo,7333,1,6,5,3,27,17,10,23
Mumbai City,7333,2,6,4,4,17,10,7,22
Kolkata,7333,3,4,7,3,18,18,0,19
Kerala Blast,7333,4,5,4,5,14,18,-4,19
NorthEast Un,7333,5,5,2,7,14,16,-2,17
FC Pune City,7333,6,4,5,5,13,15,-2,17
FC Goa,7333,7,5,2,7,14,17,-3,17
Chennaiyin,7333,8,4,5,5,14,20,-6,17
Mumbai City,7334,1,7,4,3,17,8,9,25
Kerala Blast,7334,2,7,3,4,15,14,1,24
Delhi Dynamo,7334,3,5,6,3,26,17,9,21
Kolkata,7334,4,4,6,4,17,18,-1,18
Chennaiyin,7334,5,4,6,4,16,17,-1,18
NorthEast Un,7334,6,4,4,6,10,11,-1,16
FC Pune City,7334,7,4,3,7,14,19,-5,15
FC Goa,7334,8,4,2,8,10,21,-11,14
Mumbai City,7335,1,6,4,4,16,11,5,22
Delhi Dynamo,7335,2,5,6,3,25,16,9,21
Kolkata,7335,3,4,8,2,17,15,2,20
NorthEast Un,7335,4,5,3,6,11,12,-1,18
Chennaiyin,7335,5,4,6,4,18,20,-2,18
Kerala Blast,7335,6,5,3,6,12,17,-5,18
FC Pune City,7335,7,4,4,6,13,16,-3,16
FC Goa,7335,8,4,4,6,14,19,-5,16
Delhi Dynamo,7336,1,6,6,2,26,15,11,24
Mumbai City,7336,2,6,4,4,17,11,6,22
Kerala Blast,7336,3,5,5,4,13,16,-3,20
NorthEast Un,7336,4,5,4,5,12,9,3,19
Kolkata,7336,5,4,7,3,16,14,2,19
Chennaiyin,7336,6,4,5,5,14,20,-6,17
FC Pune City,7336,7,4,3,7,14,19,-5,15
FC Goa,7336,8,4,2,8,9,17,-8,14
Delhi Dynamo,7337,1,6,6,2,29,18,11,24
Kolkata,7337,2,6,6,2,23,13,10,24
Mumbai City,7337,3,6,4,4,17,11,6,22
NorthEast Un,7337,4,4,5,5,13,13,0,17
Kerala Blast,7337,5,4,5,5,9,17,-8,17
Chennaiyin,7337,6,3,7,4,16,20,-4,16
FC Pune City,7337,7,4,4,6,12,18,-6,16
FC Goa,7337,8,3,3,8,11,20,-9,12
Delhi Dynamo,7338,1,7,5,2,27,14,13,26
Mumbai City,7338,2,6,4,4,16,10,6,22
NorthEast Un,7338,3,6,2,6,11,11,0,20
Kolkata,7338,4,4,7,3,17,15,2,19
FC Pune City,7338,5,5,3,6,14,16,-2,18
Kerala Blast,7338,6,5,3,6,12,18,-6,18
FC Goa,7338,7,4,3,7,10,17,-7,15
Chennaiyin,7338,8,3,5,6,13,19,-6,14
Mumbai City,7339,1,7,4,3,18,8,10,25
Delhi Dynamo,7339,2,5,5,4,27,21,6,20
Kolkata,7339,3,4,8,2,14,12,2,20
Kerala Blast,7339,4,5,5,4,13,15,-2,20
NorthEast Un,7339,5,5,3,6,16,15,1,18
FC Pune City,7339,6,4,4,6,13,16,-3,16
Chennaiyin,7339,7,3,6,5,16,21,-5,15
FC Goa,7339,8,4,3,7,11,20,-9,15
Mumbai City,7340,1,7,4,3,17,8,9,25
Kolkata,7340,2,6,6,2,17,12,5,24
NorthEast Un,7340,3,7,2,5,14,10,4,23
Delhi Dynamo,7340,4,5,5,4,24,17,7,20
FC Pune City,7340,5,5,3,6,13,15,-2,18
Kerala Blast,7340,6,4,3,7,10,18,-8,15
Chennaiyin,7340,7,3,5,6,14,21,-7,14
FC Goa,7340,8,4,2,8,11,19,-8,14
Mumbai City,7341,1,6,5,3,16,8,8,23
Kerala Blast,7341,2,5,5,4,13,16,-3,20
Delhi Dynamo,7341,3,4,7,3,22,16,6,19
FC Pune City,7341,4,5,4,5,16,17,-1,19
FC Goa,7341,5,5,3,6,14,15,-1,18
NorthEast Un,7341,6,5,3,6,12,13,-1,18
Chennaiyin,7341,7,4,5,5,15,19,-4,17
Kolkata,7341,8,3,6,5,15,19,-4,15
Delhi Dynamo,7342,1,6,5,3,26,18,8,23
Mumbai City,7342,2,6,4,4,16,11,5,22
Kolkata,7342,3,4,8,2,17,14,3,20
FC Pune City,7342,4,5,4,5,15,16,-1,19
Chennaiyin,7342,5,4,6,4,15,17,-2,18
Kerala Blast,7342,6,5,3,6,11,16,-5,18
NorthEast Un,7342,7,5,2,7,12,13,-1,17
FC Goa,7342,8,3,4,7,9,16,-7,13
Mumbai City,7343,1,6,5,3,16,8,8,23
Kerala Blast,7343,2,6,4,4,16,16,0,22
Delhi Dynamo,7343,3,5,6,3,25,16,9,21
Kolkata,7343,4,5,6,3,18,18,0,21
NorthEast Un,7343,5,5,3,6,12,13,-1,18
Chennaiyin,7343,6,4,6,4,15,17,-2,18
FC Pune City,7343,7,4,3,7,12,16,-4,15
FC Goa,7343,8,3,3,8,9,19,-10,12
Mumbai City,7344,1,6,5,3,18,10,8,23
Delhi Dynamo,7344,2,5,6,3,26,19,7,21
NorthEast Un,7344,3,6,3,5,15,12,3,21
Kerala Blast,7344,4,6,3,5,12,15,-3,21
Kolkata,7344,5,4,6,4,15,14,1,18
Chennaiyin,7344,6,4,6,4,15,18,-3,18
FC Pune City,7344,7,4,3,7,12,17,-5,15
FC Goa,7344,8,4,2,8,9,17,-8,14
Mumbai City,7345,1,7,4,3,18,9,9,25
Delhi Dynamo,7345,2,5,6,3,24,17,7,21
Kerala Blast,7345,3,5,5,4,12,14,-2,20
FC Pune City,7345,4,5,3,6,16,16,0,18
Chennaiyin,7345,5,4,6,4,18,19,-1,18
Kolkata,7345,6,3,8,3,13,16,-3,17
NorthEast Un,7345,7,4,3,7,10,14,-4,15
FC Goa,7345,8,3,5,6,11,17,-6,14
Mumbai City,7346,1,6,5,3,19,11,8,23
Kolkata,7346,2,5,6,3,17,13,4,21
Kerala Blast,7346,3,6,3,5,12,15,-3,21
Delhi Dynamo,7346,4,4,7,3,27,21,6,19
FC Pune City,7346,5,5,3,6,13,15,-2,18
NorthEast Un,7346,6,4,4,6,11,13,-2,16
Chennaiyin,7346,7,3,7,4,15,19,-4,16
FC Goa,7346,8,4,3,7,12,19,-7,15
Delhi Dynamo,7347,1,7,5,2,27,17,10,26
Mumbai City,7347,2,6,4,4,17,10,7,22
Kerala Blast,7347,3,5,5,4,13,16,-3,20
Kolkata,7347,4,4,7,3,19,16,3,19
Chennaiyin,7347,5,4,6,4,17,19,-2,18
FC Pune City,7347,6,4,4,6,14,19,-5,16
FC Goa,7347,7,4,3,7,13,19,-6,15
NorthEast Un,7347,8,4,2,8,11,15,-4,14
Mumbai City,7348,1,6,5,3,17,9,8,23
Delhi Dynamo,7348,2,5,6,3,24,16,8,21
NorthEast Un,7348,3,6,2,6,13,12,1,20
Kolkata,7348,4,4,7,3,18,18,0,19
FC Goa,7348,5,5,2,7,16,18,-2,17
FC Pune City,7348,6,4,5,5,13,15,-2,17
Chennaiyin,7348,7,4,5,5,15,21,-6,17
Kerala Blast,7348,8,4,4,6,10,17,-7,16
Mumbai City,7349,1,7,4,3,18,8,10,25
Kolkata,7349,2,5,6,3,15,14,1,21
NorthEast Un,7349,3,6,2,6,12,14,-2,20
Delhi Dynamo,7349,4,4,6,4,23,19,4,18
Chennaiyin,7349,5,4,6,4,18,18,0,18
FC Pune City,7349,6,4,4,6,13,16,-3,16
FC Goa,7349,7,4,4,6,12,16,-4,16
Kerala Blast,7349,8,4,4,6,10,16,-6,16
Mumbai City,7350,1,6,5,3,17,9,8,23
Kolkata,7350,2,5,7,2,22,15,7,22
Delhi Dynamo,7350,3,5,6,3,25,19,6,21
Kerala Blast,7350,4,5,4,5,11,18,-7,19
NorthEast Un,7350,5,5,3,6,13,12,1,18
FC Pune City,7350,6,4,5,5,13,15,-2,17
Chennaiyin,7350,7,3,7,4,13,17,-4,16
FC Goa,7350,8,3,3,8,11,20,-9,12
Delhi Dynamo,7351,1,6,6,2,25,15,10,24
Mumbai City,7351,2,6,5,3,17,9,8,23
Kolkata,7351,3,5,7,2,18,14,4,22
Chennaiyin,7351,4,5,5,4,17,18,-1,20
FC Pune City,7351,5,5,3,6,13,15,-2,18
Kerala Blast,7351,6,4,5,5,10,15,-5,17
NorthEast Un,7351,7,4,3,7,9,12,-3,15
FC Goa,7351,8,3,2,9,10,21,-11,11
Mumbai City,7352,1,7,4,3,18,8,10,25
Delhi Dynamo,7352,2,6,5,3,26,19,7,23
Kolkata,7352,3,5,6,3,17,14,3,21
Kerala Blast,7352,4,5,4,5,12,16,-4,19
NorthEast Un,7352,5,5,2,7,12,14,-2,17
FC Goa,7352,6,5,2,7,12,17,-5,17
FC Pune City,7352,7,4,4,6,14,17,-3,16
Chennaiyin,7352,8,3,5,6,14,20,-6,14
Mumbai City,7353,1,6,5,3,18,10,8,23
Delhi Dynamo,7353,2,5,7,2,26,17,9,22
Kolkata,7353,3,4,7,3,16,15,1,19
Kerala Blast,7353,4,5,4,5,12,15,-3,19
NorthEast Un,7353,5,5,3,6,11,12,-1,18
FC Pune City,7353,6,4,5,5,14,16,-2,17
Chennaiyin,7353,7,3,7,4,15,19,-4,16
FC Goa,7353,8,3,4,7,10,18,-8,13
Mumbai City,7354,1,6,5,3,17,9,8,23
Delhi Dynamo,7354,2,5,6,3,26,20,6,21
Kerala Blast,7354,3,6,3,5,17,15,2,21
NorthEast Un,7354,4,6,2,6,14,12,2,20
Kolkata,7354,5,4,6,4,18,19,-1,18
Chennaiyin,7354,6,4,6,4,14,17,-3,18
FC Pune City,7354,7,5,3,6,15,19,-4,18
FC Goa,7354,8,3,3,8,10,20,-10,12
Mumbai City,7355,1,7,4,3,18,8,10,25
NorthEast Un,7355,2,7,2,5,15,11,4,23
Delhi Dynamo,7355,3,5,5,4,24,19,5,20
Kolkata,7355,4,4,7,3,18,16,2,19
FC Pune City,7355,5,5,4,5,16,17,-1,19
Kerala Blast,7355,6,4,4,6,10,17,-7,16
Chennaiyin,7355,7,3,6,5,14,20,-6,15
FC Goa,7355,8,3,4,7,10,17,-7,13
Mumbai City,7356,1,7,4,3,18,8,10,25
Delhi Dynamo,7356,2,6,5,3,25,17,8,23
Kolkata,7356,3,5,6,3,19,16,3,21
NorthEast Un,7356,4,6,2,6,13,13,0,20
FC Pune City,7356,5,5,3,6,16,18,-2,18
Kerala Blast,7356,6,5,3,6,11,16,-5,18
Chennaiyin,7356,7,3,5,6,14,21,-7,14
FC Goa,7356,8,4,2,8,11,18,-7,14
Delhi Dynamo,7357,1,6,5,3,28,19,9,23
Mumbai City,7357,2,6,4,4,18,12,6,22
Kolkata,7357,3,5,6,3,17,14,3,21
Kerala Blast,7357,4,6,3,5,13,17,-4,21
FC Pune City,7357,5,5,3,6,14,16,-2,18
NorthEast Un,7357,6,5,2,7,14,15,-1,17
FC Goa,7357,7,5,2,7,11,15,-4,17
Chennaiyin,7357,8,3,5,6,13,20,-7,14
Mumbai City,7358,1,6,5,3,17,9,8,23
NorthEast Un,7358,2,5,4,5,14,11,3,19
Kolkata,7358,3,4,7,3,15,15,0,19
FC Pune City,7358,4,5,4,5,13,14,-1,19
Kerala Blast,7358,5,5,4,5,13,15,-2,19
Delhi Dynamo,7358,6,4,6,4,23,21,2,18
FC Goa,7358,7,5,2,7,13,17,-4,17
Chennaiyin,7358,8,3,6,5,14,20,-6,15
Mumbai City,7359,1,7,4,3,18,8,10,25
NorthEast Un,7359,2,6,2,6,12,10,2,20
FC Goa,7359,3,6,2,6,14,17,-3,20
FC Pune City,7359,4,5,4,5,16,15,1,19
Kolkata,7359,5,4,6,4,17,18,-1,18
Delhi Dynamo,7359,6,4,5,5,23,21,2,17
Chennaiyin,7359,7,4,5,5,15,19,-4,17
Kerala Blast,7359,8,4,4,6,12,19,-7,16
Delhi Dynamo,7360,1,5,7,2,26,18,8,22
Mumbai City,7360,2,6,4,4,17,10,7,22
Kerala Blast,7360,3,6,4,4,13,15,-2,22
Kolkata,7360,4,5,6,3,19,15,4,21
Chennaiyin,7360,5,4,6,4,16,19,-3,18
NorthEast Un,7360,6,4,4,6,13,14,-1,16
FC Pune City,7360,7,4,3,7,13,18,-5,15
FC Goa,7360,8,3,4,7,12,20,-8,13
Mumbai City,7361,1,6,5,3,19,11,8,23
Delhi Dynamo,7361,2,5,7,2,26,18,8,22
Kolkata,7361,3,4,7,3,15,14,1,19
FC Pune City,7361,4,5,4,5,15,16,-1,19
Kerala Blast,7361,5,5,4,5,14,18,-4,19
Chennaiyin,7361,6,4,5,5,16,20,-4,17
NorthEast Un,7361,7,4,3,7,10,13,-3,15
FC Goa,7361,8,4,3,7,12,17,-5,15
Delhi Dynamo,7362,1,6,5,3,30,18,12,23
Mumbai City,7362,2,6,4,4,17,13,4,22
Kerala Blast,7362,3,6,4,4,12,13,-1,22
FC Pune City,7362,4,5,4,5,14,14,0,19
NorthEast Un,7362,5,5,3,6,10,11,-1,18
Kolkata,7362,6,3,7,4,15,17,-2,16
Chennaiyin,7362,7,3,7,4,14,18,-4,16
FC Goa,7362,8,3,4,7,13,21,-8,13
Delhi Dynamo,7363,1,6,6,2,29,17,12,24
Mumbai City,7363,2,6,5,3,18,10,8,23
Kolkata,7363,3,5,6,3,16,14,2,21
NorthEast Un,7363,4,5,3,6,11,12,-1,18
Chennaiyin,7363,5,4,5,5,15,19,-4,17
Kerala Blast,7363,6,4,5,5,10,15,-5,17
FC Pune City,7363,7,4,4,6,14,17,-3,16
FC Goa,7363,8,4,2,8,10,19,-9,14
Mumbai City,7364,1,7,4,3,20,8,12,25
NorthEast Un,7364,2,6,2,6,14,12,2,20
Kerala Blast,7364,3,5,5,4,13,15,-2,20
Kolkata,7364,4,4,7,3,16,16,0,19
Delhi Dynamo,7364,5,4,6,4,22,21,1,18
FC Goa,7364,6,5,3,6,13,15,-2,18
FC Pune City,7364,7,4,4,6,13,17,-4,16
Chennaiyin,7364,8,3,5,6,14,21,-7,14
Mumbai City,7365,1,7,4,3,17,8,9,25
Kerala Blast,7365,2,6,4,4,14,15,-1,22
FC Goa,7365,3,6,2,6,12,15,-3,20
Delhi Dynamo,7365,4,4,6,4,22,17,5,18
FC Pune City,7365,5,5,3,6,16,16,0,18
Chennaiyin,7365,6,4,5,5,17,19,-2,17
Kolkata,7365,7,3,7,4,14,17,-3,16
NorthEast Un,7365,8,4,3,7,10,15,-5,15
Mumbai City,7366,1,7,4,3,18,9,9,25
Kerala Blast,7366,2,7,3,4,13,13,0,24
Kolkata,7366,3,5,6,3,17,15,2,21
Chennaiyin,7366,4,5,5,4,17,18,-1,20
Delhi Dynamo,7366,5,4,6,4,24,19,5,18
NorthEast Un,7366,6,5,2,7,10,12,-2,17
FC Pune City,7366,7,4,3,7,13,18,-5,15
FC Goa,7366,8,3,3,8,12,20,-8,12
Mumbai City,7367,1,6,5,3,17,9,8,23
Delhi Dynamo,7367,2,5,6,3,29,21,8,21
NorthEast Un,7367,3,6,3,5,14,12,2,21
Kolkata,7367,4,4,8,2,15,13,2,20
Kerala Blast,7367,5,5,4,5,12,14,-2,19
Chennaiyin,7367,6,3,6,5,13,19,-6,15
FC Goa,7367,6,4,3,7,13,19,-6,15
FC Pune City,7367,8,4,3,7,12,18,-6,15
Mumbai City,7368,1,6,4,4,17,11,6,22
Delhi Dynamo,7368,2,5,5,4,25,18,7,20
Kolkata,7368,3,4,8,2,16,14,2,20
NorthEast Un,7368,4,6,2,6,12,12,0,20
Kerala Blast,7368,5,5,4,5,11,15,-4,19
Chennaiyin,7368,6,4,5,5,15,18,-3,17
FC Goa,7368,7,5,2,7,11,16,-5,17
FC Pune City,7368,8,4,4,6,14,17,-3,16
Mumbai City,7369,1,6,5,3,16,8,8,23
Kolkata,7369,2,5,7,2,16,12,4,22
Delhi Dynamo,7369,3,5,6,3,24,17,7,21
NorthEast Un,7369,4,6,2,6,15,14,1,20
FC Pune City,7369,5,5,4,5,15,14,1,19
Chennaiyin,7369,6,4,5,5,16,21,-5,17
Kerala Blast,7369,7,4,3,7,9,19,-10,15
FC Goa,7369,8,4,2,8,10,16,-6,14
Mumbai City,7370,1,7,4,3,21,8,13,25
Kerala Blast,7370,2,6,4,4,15,14,1,22
Delhi Dynamo,7370,3,5,5,4,24,21,3,20
NorthEast Un,7370,4,6,2,6,12,11,1,20
FC Pune City,7370,5,5,4,5,16,16,0,19
Kolkata,7370,6,3,7,4,15,19,-4,16
Chennaiyin,7370,7,3,6,5,14,20,-6,15
FC Goa,7370,8,3,4,7,11,19,-8,13
Kolkata,7371,1,6,6,2,19,13,6,24
Mumbai City,7371,2,6,5,3,17,9,8,23
Delhi Dynamo,7371,3,5,7,2,26,17,9,22
NorthEast Un,7371,4,5,3,6,12,12,0,18
FC Pune City,7371,5,5,3,6,14,17,-3,18
Kerala Blast,7371,6,5,3,6,10,16,-6,18
Chennaiyin,7371,7,3,5,6,14,21,-7,14
FC Goa,7371,8,4,2,8,11,18,-7,14
Mumbai City,7372,1,7,4,3,18,8,10,25
Kolkata,7372,2,4,8,2,16,14,2,20
NorthEast Un,7372,3,6,2,6,12,10,2,20
Kerala Blast,7372,4,5,4,5,12,17,-5,19
Delhi Dynamo,7372,5,4,6,4,22,18,4,18
FC Pune City,7372,6,5,3,6,15,16,-1,18
FC Goa,7372,7,4,4,6,12,16,-4,16
Chennaiyin,7372,8,3,5,6,13,21,-8,14
Mumbai City,7373,1,7,4,3,17,8,9,25
NorthEast Un,7373,2,6,3,5,15,11,4,21
Kolkata,7373,3,5,6,3,17,15,2,21
Delhi Dynamo,7373,4,5,5,4,24,19,5,20
FC Pune City,7373,5,5,4,5,16,15,1,19
Kerala Blast,7373,6,4,4,6,11,19,-8,16
Chennaiyin,7373,7,3,6,5,14,21,-7,15
FC Goa,7373,8,4,2,8,13,19,-6,14
Mumbai City,7374,1,7,4,3,19,10,9,25
NorthEast Un,7374,2,7,2,5,21,11,10,23
Delhi Dynamo,7374,3,5,5,4,26,21,5,20
FC Pune City,7374,4,5,3,6,14,15,-1,18
Kolkata,7374,5,4,6,4,16,18,-2,18
Kerala Blast,7374,6,5,3,6,11,19,-8,18
FC Goa,7374,7,4,3,7,11,16,-5,15
Chennaiyin,7374,8,3,6,5,13,21,-8,15
Mumbai City,7375,1,7,4,3,18,8,10,25
Delhi Dynamo,7375,2,6,5,3,26,18,8,23
Kolkata,7375,3,5,6,3,18,17,1,21
Kerala Blast,7375,4,6,3,5,13,15,-2,21
NorthEast Un,7375,5,5,2,7,10,11,-1,17
FC Goa,7375,6,5,2,7,14,19,-5,17
FC Pune City,7375,7,4,3,7,13,18,-5,15
Chennaiyin,7375,8,3,5,6,13,19,-6,14
Delhi Dynamo,7376,1,6,6,2,27,16,11,24
Mumbai City,7376,2,6,5,3,17,9,8,23
Kolkata,7376,3,5,6,3,16,14,2,21
Kerala Blast,7376,4,5,4,5,16,18,-2,19
FC Goa,7376,5,5,2,7,14,16,-2,17
Chennaiyin,7376,6,4,5,5,15,21,-6,17
NorthEast Un,7376,7,4,3,7,12,16,-4,15
FC Pune City,7376,8,4,3,7,13,20,-7,15
NorthEast Un,7377,1,7,2,5,19,10,9,23
Mumbai City,7377,2,6,5,3,17,9,8,23
Delhi Dynamo,7377,3,4,7,3,23,20,3,19
Kolkata,7377,4,4,7,3,16,15,1,19
FC Pune City,7377,5,5,3,6,15,17,-2,18
FC Goa,7377,6,5,3,6,12,15,-3,18
Kerala Blast,7377,7,4,4,6,11,20,-9,16
Chennaiyin,7377,8,3,5,6,14,21,-7,14
Mumbai City,7378,1,7,4,3,20,9,11,25
FC Pune City,7378,2,6,3,5,14,14,0,21
Delhi Dynamo,7378,3,5,5,4,24,20,4,20
Kolkata,7378,4,4,7,3,17,15,2,19
Kerala Blast,7378,5,5,3,6,10,16,-6,18
Chennaiyin,7378,6,3,7,4,16,20,-4,16
FC Goa,7378,7,4,4,6,12,17,-5,16
NorthEast Un,7378,8,4,3,7,12,14,-2,15
Mumbai City,7379,1,7,4,3,17,8,9,25
Delhi Dynamo,7379,2,5,6,3,24,17,7,21
Kolkata,7379,3,5,6,3,21,19,2,21
Kerala Blast,7379,4,5,4,5,14,22,-8,19
Chennaiyin,7379,5,4,6,4,16,19,-3,18
NorthEast Un,7379,6,4,4,6,15,16,-1,16
FC Pune City,7379,7,4,4,6,13,17,-4,16
FC Goa,7379,8,4,2,8,14,16,-2,14
Mumbai City,7380,1,7,4,3,17,8,9,25
Kerala Blast,7380,2,6,4,4,13,15,-2,22
Chennaiyin,7380,3,5,5,4,18,19,-1,20
Delhi Dynamo,7380,4,4,6,4,22,18,4,18
Kolkata,7380,5,4,6,4,15,16,-1,18
NorthEast Un,7380,6,5,2,7,12,13,-1,17
FC Pune City,7380,7,4,4,6,14,18,-4,16
FC Goa,7380,8,4,3,7,13,17,-4,15
Mumbai City,7381,1,7,4,3,19,10,9,25
Delhi Dynamo,7381,2,5,5,4,25,19,6,20
Chennaiyin,7381,3,5,5,4,19,19,0,20
FC Pune City,7381,4,5,4,5,17,16,1,19
Kolkata,7381,5,3,9,2,18,17,1,18
NorthEast Un,7381,6,5,2,7,11,13,-2,17
Kerala Blast,7381,7,4,4,6,10,18,-8,16
FC Goa,7381,8,4,3,7,13,20,-7,15
Mumbai City,7382,1,7,4,3,18,9,9,25
Delhi Dynamo,7382,2,5,5,4,25,20,5,20
Kolkata,7382,3,4,8,2,16,13,3,20
NorthEast Un,7382,4,5,4,5,13,10,3,19
FC Pune City,7382,5,5,3,6,14,16,-2,18
Kerala Blast,7382,6,4,5,5,10,16,-6,17
Chennaiyin,7382,7,3,7,4,14,18,-4,16
FC Goa,7382,8,3,4,7,11,19,-8,13
Kerala Blast,7383,1,7,3,4,14,14,0,24
Mumbai City,7383,2,6,5,3,16,8,8,23
Delhi Dynamo,7383,3,4,7,3,23,17,6,19
Kolkata,7383,4,4,7,3,16,14,2,19
NorthEast Un,7383,5,5,2,7,11,13,-2,17
Chennaiyin,7383,6,4,5,5,14,20,-6,17
FC Goa,7383,7,4,4,6,12,15,-3,16
FC Pune City,7383,8,4,3,7,14,19,-5,15
Delhi Dynamo,7384,1,6,6,2,28,19,9,24
Kerala Blast,7384,2,7,3,4,15,13,2,24
Mumbai City,7384,3,6,5,3,18,10,8,23
Kolkata,7384,4,4,6,4,14,15,-1,18
FC Goa,7384,5,5,2,7,14,18,-4,17
NorthEast Un,7384,6,4,3,7,11,14,-3,15
FC Pune City,7384,7,4,3,7,12,17,-5,15
Chennaiyin,7384,8,3,6,5,15,21,-6,15
Delhi Dynamo,7385,1,6,6,2,25,15,10,24
Mumbai City,7385,2,6,5,3,16,8,8,23
Kolkata,7385,3,5,7,2,19,14,5,22
Kerala Blast,7385,4,6,3,5,18,19,-1,21
Chennaiyin,7385,5,5,5,4,18,19,-1,20
FC Pune City,7385,6,4,3,7,12,17,-5,15
NorthEast Un,7385,7,4,2,8,11,18,-7,14
FC Goa,7385,8,3,3,8,10,19,-9,12
Mumbai City,7386,1,6,4,4,17,10,7,22
Delhi Dynamo,7386,2,5,6,3,24,17,7,21
Kerala Blast,7386,3,6,3,5,11,14,-3,21
Chennaiyin,7386,4,5,5,4,17,19,-2,20
Kolkata,7386,5,4,7,3,14,13,1,19
NorthEast Un,7386,6,5,2,7,11,12,-1,17
FC Pune City,7386,7,4,4,6,12,15,-3,16
FC Goa,7386,8,4,3,7,11,17,-6,15
Mumbai City,7387,1,7,4,3,21,9,12,25
Chennaiyin,7387,2,5,5,4,18,17,1,20
Kerala Blast,7387,3,5,5,4,14,16,-2,20
NorthEast Un,7387,4,5,3,6,12,12,0,18
Kolkata,7387,5,4,6,4,16,17,-1,18
Delhi Dynamo,7387,6,4,5,5,23,25,-2,17
FC Goa,7387,7,5,2,7,13,18,-5,17
FC Pune City,7387,8,4,4,6,14,17,-3,16
Mumbai City,7388,1,7,4,3,20,9,11,25
Delhi Dynamo,7388,2,6,5,3,24,18,6,23
Kerala Blast,7388,3,6,4,4,12,14,-2,22
FC Pune City,7388,4,5,3,6,14,15,-1,18
NorthEast Un,7388,5,5,2,7,12,12,0,17
Kolkata,7388,6,3,8,3,14,15,-1,17
FC Goa,7388,7,4,3,7,13,19,-6,15
Chennaiyin,7388,8,3,5,6,16,23,-7,14
Mumbai City,7389,1,7,4,3,18,8,10,25
Kolkata,7389,2,5,6,3,20,15,5,21
Delhi Dynamo,7389,3,4,7,3,22,17,5,19
NorthEast Un,7389,4,5,4,5,12,11,1,19
Chennaiyin,7389,5,3,7,4,14,18,-4,16
FC Pune City,7389,6,4,4,6,14,19,-5,16
FC Goa,7389,7,4,4,6,11,16,-5,16
Kerala Blast,7389,8,4,4,6,11,18,-7,16
Delhi Dynamo,7390,1,6,6,2,27,16,11,24
Kolkata,7390,2,6,6,2,18,13,5,24
Mumbai City,7390,3,6,4,4,16,10,6,22
NorthEast Un,7390,4,5,3,6,12,12,0,18
Chennaiyin,7390,5,4,6,4,17,18,-1,18
Kerala Blast,7390,6,5,3,6,12,17,-5,18
FC Pune City,7390,7,4,3,7,12,17,-5,15
FC Goa,7390,8,3,3,8,10,21,-11,12
Mumbai City,7391,1,7,4,3,20,8,12,25
NorthEast Un,7391,2,7,2,5,14,9,5,23
FC Pune City,7391,3,6,3,5,17,15,2,21
Delhi Dynamo,7391,4,5,5,4,22,19,3,20
Kolkata,7391,5,4,6,4,17,20,-3,18
Chennaiyin,7391,6,4,5,5,14,18,-4,17
Kerala Blast,7391,7,4,3,7,11,21,-10,15
FC Goa,7391,8,4,2,8,11,16,-5,14
Mumbai City,7392,1,6,5,3,17,9,8,23
Delhi Dynamo,7392,2,4,8,2,24,17,7,20
Kolkata,7392,3,4,7,3,17,17,0,19
FC Pune City,7392,4,5,4,5,14,15,-1,19
FC Goa,7392,5,5,3,6,16,18,-2,18
Kerala Blast,7392,6,5,3,6,12,17,-5,18
Chennaiyin,7392,7,4,5,5,16,20,-4,17
NorthEast Un,7392,8,4,3,7,10,13,-3,15
Mumbai City,7393,1,7,4,3,18,9,9,25
Kolkata,7393,2,5,7,2,18,15,3,22
Delhi Dynamo,7393,3,5,5,4,26,20,6,20
NorthEast Un,7393,4,6,2,6,15,15,0,20
Kerala Blast,7393,5,5,4,5,15,16,-1,19
FC Pune City,7393,6,4,5,5,14,16,-2,17
Chennaiyin,7393,7,3,6,5,13,19,-6,15
FC Goa,7393,8,3,3,8,9,18,-9,12
Mumbai City,7394,1,6,5,3,16,8,8,23
Kolkata,7394,2,5,6,3,18,14,4,21
NorthEast Un,7394,3,6,3,5,13,11,2,21
Delhi Dynamo,7394,4,4,7,3,23,17,6,19
Kerala Blast,7394,5,5,4,5,11,15,-4,19
FC Pune City,7394,6,5,3,6,13,17,-4,18
FC Goa,7394,7,4,3,7,12,17,-5,15
Chennaiyin,7394,8,3,5,6,13,20,-7,14
Mumbai City,7395,1,7,4,3,17,8,9,25
Kolkata,7395,2,6,6,2,17,12,5,24
Delhi Dynamo,7395,3,5,6,3,25,18,7,21
Chennaiyin,7395,4,5,5,4,17,17,0,20
NorthEast Un,7395,5,5,3,6,12,13,-1,18
FC Pune City,7395,6,4,4,6,13,17,-4,16
Kerala Blast,7395,7,4,4,6,11,17,-6,16
FC Goa,7395,8,3,2,9,10,20,-10,11
Mumbai City,7396,1,7,4,3,18,8,10,25
Delhi Dynamo,7396,2,6,5,3,23,16,7,23
NorthEast Un,7396,3,6,2,6,12,10,2,20
Kerala Blast,7396,4,5,4,5,14,17,-3,19
Kolkata,7396,5,4,6,4,17,17,0,18
FC Pune City,7396,6,4,4,6,13,18,-5,16
Chennaiyin,7396,7,3,6,5,15,20,-5,15
FC Goa,7396,8,4,3,7,11,17,-6,15
Mumbai City,7397,1,6,5,3,17,9,8,23
Delhi Dynamo,7397,2,5,7,2,23,15,8,22
FC Pune City,7397,3,6,3,5,17,15,2,21
Chennaiyin,7397,4,5,5,4,17,19,-2,20
Kolkata,7397,5,4,7,3,15,16,-1,19
Kerala Blast,7397,6,5,3,6,12,17,-5,18
NorthEast Un,7397,7,4,2,8,10,13,-3,14
FC Goa,7397,8,3,4,7,11,18,-7,13
Mumbai City,7398,1,7,4,3,18,9,9,25
Kerala Blast,7398,2,6,4,4,14,15,-1,22
NorthEast Un,7398,3,6,2,6,16,15,1,20
Delhi Dynamo,7398,4,4,6,4,25,21,4,18
FC Goa,7398,5,5,3,6,13,16,-3,18
Kolkata,7398,6,3,8,3,14,15,-1,17
FC Pune City,7398,7,4,4,6,14,17,-3,16
Chennaiyin,7398,8,3,5,6,15,21,-6,14
Delhi Dynamo,7399,1,7,5,2,30,15,15,26
Mumbai City,7399,2,6,4,4,17,11,6,22
Kolkata,7399,3,5,6,3,17,14,3,21
NorthEast Un,7399,4,5,3,6,10,11,-1,18
FC Pune City,7399,5,5,3,6,14,16,-2,18
FC Goa,7399,6,5,2,7,15,20,-5,17
Chennaiyin,7399,7,3,6,5,14,22,-8,15
Kerala Blast,7399,8,4,3,7,9,17,-8,15
Delhi Dynamo,7400,1,6,6,2,25,15,10,24
Mumbai City,7400,2,6,5,3,17,9,8,23
Kerala Blast,7400,3,5,5,4,13,15,-2,20
FC Pune City,7400,4,5,3,6,14,17,-3,18
FC Goa,7400,5,5,2,7,16,18,-2,17
Kolkata,7400,6,3,7,4,15,17,-2,16
NorthEast Un,7400,7,4,4,6,12,14,-2,16
Chennaiyin,7400,8,3,6,5,16,23,-7,15
Mumbai City,7401,1,7,4,3,20,10,10,25
FC Pune City,7401,2,6,3,5,16,16,0,21
Delhi Dynamo,7401,3,5,5,4,26,21,5,20
NorthEast Un,7401,4,6,2,6,13,10,3,20
Chennaiyin,7401,5,5,5,4,15,17,-2,20
Kolkata,7401,6,4,6,4,18,18,0,18
Kerala Blast,7401,7,5,3,6,11,16,-5,18
FC Goa,7401,8,3,2,9,9,20,-11,11
Mumbai City,7402,1,6,5,3,16,8,8,23
Delhi Dynamo,7402,2,5,6,3,25,18,7,21
Kerala Blast,7402,3,6,3,5,12,15,-3,21
NorthEast Un,7402,4,6,2,6,15,12,3,20
Kolkata,7402,5,4,7,3,18,19,-1,19
Chennaiyin,7402,6,4,5,5,16,19,-3,17
FC Pune City,7402,7,4,4,6,15,18,-3,16
FC Goa,7402,8,4,2,8,11,19,-8,14
Mumbai City,7403,1,7,4,3,20,11,9,25
Kolkata,7403,2,5,6,3,17,16,1,21
Kerala Blast,7403,3,6,3,5,13,16,-3,21
FC Goa,7403,4,6,2,6,16,18,-2,20
Delhi Dynamo,7403,5,4,6,4,25,20,5,18
NorthEast Un,7403,6,5,3,6,11,11,0,18
FC Pune City,7403,7,4,3,7,12,16,-4,15
Chennaiyin,7403,8,3,5,6,15,21,-6,14
Kerala Blast,7404,1,7,3,4,17,13,4,24
Mumbai City,7404,2,6,5,3,17,9,8,23
Kolkata,7404,3,4,7,3,15,16,-1,19
Delhi Dynamo,7404,4,4,6,4,23,18,5,18
NorthEast Un,7404,5,5,3,6,11,13,-2,18
FC Goa,7404,6,5,2,7,12,17,-5,17
FC Pune City,7404,7,4,4,6,13,17,-4,16
Chennaiyin,7404,8,3,6,5,15,20,-5,15
Kerala Blast,7405,1,7,3,4,15,15,0,24
Mumbai City,7405,2,6,5,3,18,10,8,23
FC Goa,7405,3,6,2,6,16,16,0,20
Delhi Dynamo,7405,4,4,6,4,24,20,4,18
Kolkata,7405,5,4,6,4,16,16,0,18
NorthEast Un,7405,6,5,3,6,11,11,0,18
FC Pune City,7405,7,4,3,7,13,18,-5,15
Chennaiyin,7405,8,3,6,5,14,21,-7,15
Delhi Dynamo,7406,1,6,6,2,26,15,11,24
Kolkata,7406,2,6,6,2,20,13,7,24
Mumbai City,7406,3,6,4,4,16,11,5,22
Kerala Blast,7406,4,6,3,5,12,15,-3,21
NorthEast Un,7406,5,5,2,7,10,12,-2,17
Chennaiyin,7406,6,3,6,5,14,19,-5,15
FC Pune City,7406,7,4,3,7,12,17,-5,15
FC Goa,7406,8,3,4,7,11,19,-8,13
Mumbai City,7407,1,6,5,3,17,9,8,23
Delhi Dynamo,7407,2,5,6,3,25,17,8,21
Kolkata,7407,3,4,8,2,16,13,3,20
Kerala Blast,7407,4,5,4,5,12,15,-3,19
NorthEast Un,7407,5,5,3,6,12,13,-1,18
FC Goa,7407,6,5,2,7,12,17,-5,17
FC Pune City,7407,7,4,4,6,13,17,-4,16
Chennaiyin,7407,8,3,6,5,14,20,-6,15
Mumbai City,7408,1,7,4,3,17,8,9,25
NorthEast Un,7408,2,6,3,5,14,12,2,21
Kolkata,7408,3,4,7,3,16,16,0,19
FC Pune City,7408,4,5,4,5,14,15,-1,19
Kerala Blast,7408,5,5,4,5,13,16,-3,19
Delhi Dynamo,7408,6,4,6,4,22,17,5,18
Chennaiyin,7408,7,4,5,5,17,20,-3,17
FC Goa,7408,8,3,3,8,11,20,-9,12
Mumbai City,7409,1,7,4,3,19,8,11,25
Kolkata,7409,2,5,6,3,17,14,3,21
Chennaiyin,7409,3,5,5,4,17,19,-2,20
Kerala Blast,7409,4,5,4,5,15,16,-1,19
Delhi Dynamo,7409,5,4,6,4,22,19,3,18
NorthEast Un,7409,6,5,3,6,13,13,0,18
FC Pune City,7409,7,5,3,6,14,19,-5,18
FC Goa,7409,8,3,3,8,10,19,-9,12
Delhi Dynamo,7410,1,6,6,2,26,17,9,24
Mumbai City,7410,2,6,5,3,17,9,8,23
Kerala Blast,7410,3,6,4,4,13,14,-1,22
Chennaiyin,7410,4,5,5,4,18,19,-1,20
Kolkata,7410,5,3,8,3,15,16,-1,17
FC Pune City,7410,6,4,5,5,14,16,-2,17
NorthEast Un,7410,7,4,2,8,11,15,-4,14
FC Goa,7410,8,3,3,8,11,19,-8,12
Mumbai City,7411,1,7,4,3,19,9,10,25
Delhi Dynamo,7411,2,5,6,3,23,17,6,21
Kolkata,7411,3,5,6,3,17,15,2,21
NorthEast Un,7411,4,5,4,5,13,10,3,19
Kerala Blast,7411,5,5,4,5,14,19,-5,19
FC Pune City,7411,6,5,3,6,15,16,-1,18
Chennaiyin,7411,7,4,5,5,17,23,-6,17
FC Goa,7411,8,3,2,9,11,20,-9,11
Mumbai City,7412,1,7,4,3,18,8,10,25
Delhi Dynamo,7412,2,5,5,4,22,18,4,20
Kolkata,7412,3,4,7,3,16,15,1,19
NorthEast Un,7412,4,5,3,6,12,11,1,18
Chennaiyin,7412,5,4,6,4,15,18,-3,18
FC Pune City,7412,6,4,5,5,12,14,-2,17
Kerala Blast,7412,7,4,5,5,9,16,-7,17
FC Goa,7412,8,4,3,7,11,15,-4,15
Mumbai City,7413,1,7,4,3,18,8,10,25
NorthEast Un,7413,2,7,2,5,14,10,4,23
Delhi Dynamo,7413,3,5,5,4,24,18,6,20
Kerala Blast,7413,4,5,4,5,12,16,-4,19
FC Pune City,7413,5,5,3,6,15,18,-3,18
Kolkata,7413,6,3,8,3,18,18,0,17
Chennaiyin,7413,7,4,5,5,16,19,-3,17
FC Goa,7413,8,3,3,8,11,21,-10,12
Mumbai City,7414,1,6,5,3,17,9,8,23
Kolkata,7414,2,5,7,2,16,13,3,22
NorthEast Un,7414,3,6,3,5,13,10,3,21
Delhi Dynamo,7414,4,4,7,3,23,18,5,19
Kerala Blast,7414,5,5,4,5,12,15,-3,19
Chennaiyin,7414,6,3,6,5,14,19,-5,15
FC Pune City,7414,7,4,3,7,12,17,-5,15
FC Goa,7414,8,3,5,6,11,17,-6,14
Delhi Dynamo,7415,1,7,5,2,29,17,12,26
Mumbai City,7415,2,6,4,4,17,11,6,22
FC Pune City,7415,3,6,3,5,16,16,0,21
Chennaiyin,7415,4,4,6,4,15,18,-3,18
Kerala Blast,7415,5,5,3,6,11,16,-5,18
NorthEast Un,7415,6,5,2,7,10,11,-1,17
Kolkata,7415,7,3,6,5,14,18,-4,15
FC Goa,7415,8,4,3,7,14,19,-5,15
Delhi Dynamo,7416,1,7,5,2,27,17,10,26
Kolkata,7416,2,6,6,2,20,14,6,24
Mumbai City,7416,3,6,4,4,18,11,7,22
Kerala Blast,7416,4,5,4,5,13,16,-3,19
Chennaiyin,7416,5,4,6,4,17,19,-2,18
FC Pune City,7416,6,4,4,6,12,15,-3,16
NorthEast Un,7416,7,4,2,8,11,16,-5,14
FC Goa,7416,8,3,3,8,9,19,-10,12
Mumbai City,7417,1,7,4,3,18,9,9,25
NorthEast Un,7417,2,6,2,6,19,13,6,20
FC Pune City,7417,3,5,3,6,14,15,-1,18
Kolkata,7417,4,4,6,4,16,18,-2,18
FC Goa,7417,5,5,3,6,14,16,-2,18
Chennaiyin,7417,6,4,6,4,16,19,-3,18
Kerala Blast,7417,7,5,3,6,11,18,-7,18
Delhi Dynamo,7417,8,4,5,5,25,25,0,17
Mumbai City,7418,1,7,4,3,19,10,9,25
FC Pune City,7418,2,6,3,5,18,16,2,21
Kerala Blast,7418,3,6,3,5,13,16,-3,21
Delhi Dynamo,7418,4,5,5,4,27,22,5,20
NorthEast Un,7418,5,6,2,6,15,12,3,20
Kolkata,7418,6,3,7,4,15,17,-2,16
FC Goa,7418,7,4,3,7,9,17,-8,15
Chennaiyin,7418,8,3,5,6,13,19,-6,14
Mumbai City,7419,1,7,4,3,20,8,12,25
Delhi Dynamo,7419,2,5,5,4,23,21,2,20
Kolkata,7419,3,4,7,3,20,16,4,19
Kerala Blast,7419,4,5,4,5,12,18,-6,19
NorthEast Un,7419,5,5,2,7,11,12,-1,17
FC Pune City,7419,6,4,5,5,14,16,-2,17
Chennaiyin,7419,7,4,5,5,14,18,-4,17
FC Goa,7419,8,5,2,7,13,18,-5,17
Mumbai City,7420,1,7,4,3,18,9,9,25
Kolkata,7420,2,5,6,3,17,14,3,21
Delhi Dynamo,7420,3,5,5,4,24,18,6,20
Kerala Blast,7420,4,5,4,5,11,16,-5,19
NorthEast Un,7420,5,5,3,6,13,13,0,18
Chennaiyin,7420,6,4,6,4,15,18,-3,18
FC Pune City,7420,7,4,3,7,12,17,-5,15
FC Goa,7420,8,4,3,7,10,15,-5,15
Mumbai City,7421,1,7,4,3,21,9,12,25
Kolkata,7421,2,5,7,2,17,13,4,22
Delhi Dynamo,7421,3,5,6,3,24,20,4,21
Kerala Blast,7421,4,5,3,6,10,17,-7,18
NorthEast Un,7421,5,5,2,7,11,11,0,17
Chennaiyin,7421,6,4,5,5,14,18,-4,17
FC Pune City,7421,7,4,4,6,12,15,-3,16
FC Goa,7421,8,4,3,7,11,17,-6,15
Mumbai City,7422,1,7,4,3,17,8,9,25
Kolkata,7422,2,5,6,3,17,15,2,21
Kerala Blast,7422,3,6,3,5,13,15,-2,21
FC Goa,7422,4,6,2,6,12,15,-3,20
Delhi Dynamo,7422,5,4,6,4,23,18,5,18
NorthEast Un,7422,6,4,4,6,11,13,-2,16
FC Pune City,7422,7,4,3,7,12,16,-4,15
Chennaiyin,7422,8,3,6,5,13,18,-5,15
Kolkata,7423,1,6,6,2,27,14,13,24
Delhi Dynamo,7423,2,6,6,2,26,17,9,24
Mumbai City,7423,3,6,5,3,17,9,8,23
FC Pune City,7423,4,5,3,6,18,24,-6,18
Kerala Blast,7423,5,5,3,6,13,22,-9,18
NorthEast Un,7423,6,5,2,7,11,11,0,17
FC Goa,7423,7,4,2,8,12,19,-7,14
Chennaiyin,7423,8,3,5,6,13,21,-8,14
Mumbai City,7424,1,7,4,3,17,8,9,25
Delhi Dynamo,7424,2,6,5,3,26,15,11,23
Kerala Blast,7424,3,6,3,5,12,16,-4,21
Chennaiyin,7424,4,5,5,4,17,19,-2,20
Kolkata,7424,5,4,7,3,17,15,2,19
NorthEast Un,7424,6,5,2,7,12,14,-2,17
FC Pune City,7424,7,4,4,6,13,16,-3,16
FC Goa,7424,8,3,2,9,9,20,-11,11
Mumbai City,7425,1,7,4,3,17,8,9,25
Kolkata,7425,2,6,6,2,16,12,4,24
Delhi Dynamo,7425,3,4,7,3,22,16,6,19
NorthEast Un,7425,4,5,3,6,14,14,0,18
Chennaiyin,7425,5,4,6,4,18,19,-1,18
FC Pune City,7425,6,5,3,6,14,16,-2,18
Kerala Blast,7425,7,4,3,7,11,20,-9,15
FC Goa,7425,8,3,4,7,10,17,-7,13
Mumbai City,7426,1,7,4,3,20,9,11,25
NorthEast Un,7426,2,6,2,6,13,11,2,20
Kolkata,7426,3,4,7,3,14,13,1,19
Delhi Dynamo,7426,4,4,6,4,23,21,2,18
FC Goa,7426,5,5,3,6,12,16,-4,18
FC Pune City,7426,6,4,5,5,14,16,-2,17
Chennaiyin,7426,7,4,5,5,15,19,-4,17
Kerala Blast,7426,8,4,4,6,12,18,-6,16
Mumbai City,7427,1,6,5,3,16,8,8,23
Delhi Dynamo,7427,2,4,8,2,25,18,7,20
Kolkata,7427,3,4,8,2,16,14,2,20
Kerala Blast,7427,4,4,6,4,10,14,-4,18
NorthEast Un,7427,5,4,5,5,13,13,0,17
FC Goa,7427,6,4,4,6,16,19,-3,16
FC Pune City,7427,7,4,4,6,12,15,-3,16
Chennaiyin,7427,8,3,6,5,15,22,-7,15
Mumbai City,7428,1,7,4,3,19,10,9,25
Delhi Dynamo,7428,2,6,5,3,32,17,15,23
Kerala Blast,7428,3,6,4,4,14,16,-2,22
Chennaiyin,7428,4,5,5,4,19,19,0,20
Kolkata,7428,5,4,7,3,18,17,1,19
FC Pune City,7428,6,4,3,7,15,20,-5,15
NorthEast Un,7428,7,4,2,8,11,17,-6,14
FC Goa,7428,8,4,2,8,11,23,-12,14
Mumbai City,7429,1,7,4,3,20,9,11,25
NorthEast Un,7429,2,6,3,5,16,10,6,21
FC Pune City,7429,3,6,3,5,16,14,2,21
Delhi Dynamo,7429,4,5,5,4,23,20,3,20
Kolkata,7429,5,4,6,4,15,16,-1,18
FC Goa,7429,6,5,2,7,12,17,-5,17
Chennaiyin,7429,7,3,6,5,15,20,-5,15
Kerala Blast,7429,8,4,3,7,9,20,-11,15
Mumbai City,7430,1,7,4,3,18,8,10,25
NorthEast Un,7430,2,7,2,5,16,13,3,23
Kerala Blast,7430,3,6,3,5,18,19,-1,21
Delhi Dynamo,7430,4,4,6,4,23,19,4,18
Kolkata,7430,5,3,8,3,15,16,-1,17
Chennaiyin,7430,6,4,5,5,17,21,-4,17
FC Pune City,7430,7,4,4,6,16,20,-4,16
FC Goa,7430,8,3,4,7,10,17,-7,13
Mumbai City,7431,1,7,4,3,19,9,10,25
Kerala Blast,7431,2,6,3,5,14,16,-2,21
Delhi Dynamo,7431,3,5,5,4,27,21,6,20
Kolkata,7431,4,4,7,3,18,17,1,19
FC Pune City,7431,5,5,4,5,16,17,-1,19
NorthEast Un,7431,6,5,3,6,16,17,-1,18
Chennaiyin,7431,7,4,6,4,16,19,-3,18
FC Goa,7431,8,3,2,9,10,20,-10,11
Mumbai City,7432,1,6,5,3,17,9,8,23
Chennaiyin,7432,2,5,5,4,17,19,-2,20
Delhi Dynamo,7432,3,4,7,3,23,18,5,19
FC Pune City,7432,4,5,4,5,14,15,-1,19
Kerala Blast,7432,5,5,4,5,12,15,-3,19
Kolkata,7432,6,4,6,4,15,15,0,18
NorthEast Un,7432,7,5,2,7,13,14,-1,17
FC Goa,7432,8,4,3,7,11,17,-6,15
Mumbai City,7433,1,7,4,3,18,8,10,25
Delhi Dynamo,7433,2,6,5,3,27,16,11,23
Kerala Blast,7433,3,5,4,5,12,15,-3,19
FC Pune City,7433,4,5,3,6,14,16,-2,18
Chennaiyin,7433,5,4,6,4,16,19,-3,18
NorthEast Un,7433,6,5,2,7,11,13,-2,17
Kolkata,7433,7,3,7,4,14,16,-2,16
FC Goa,7433,8,4,3,7,10,19,-9,15
Mumbai City,7434,1,7,4,3,20,11,9,25
Kerala Blast,7434,2,7,3,4,12,13,-1,24
Delhi Dynamo,7434,3,6,5,3,29,20,9,23
Kolkata,7434,4,4,7,3,16,13,3,19
Chennaiyin,7434,5,3,7,4,16,20,-4,16
NorthEast Un,7434,6,4,3,7,12,14,-2,15
FC Pune City,7434,7,4,3,7,12,18,-6,15
FC Goa,7434,8,3,4,7,10,18,-8,13
Mumbai City,7435,1,6,5,3,18,10,8,23
Kolkata,7435,2,5,7,2,19,14,5,22
Delhi Dynamo,7435,3,5,6,3,24,17,7,21
NorthEast Un,7435,4,6,2,6,12,12,0,20
Kerala Blast,7435,5,5,4,5,14,18,-4,19
FC Pune City,7435,6,4,4,6,14,18,-4,16
FC Goa,7435,7,4,3,7,12,18,-6,15
Chennaiyin,7435,8,3,5,6,14,20,-6,14
Mumbai City,7436,1,7,4,3,20,9,11,25
Delhi Dynamo,7436,2,5,6,3,25,19,6,21
FC Pune City,7436,3,6,3,5,18,15,3,21
NorthEast Un,7436,4,5,4,5,15,13,2,19
Kolkata,7436,5,4,7,3,16,18,-2,19
Kerala Blast,7436,6,4,4,6,11,17,-6,16
FC Goa,7436,7,4,3,7,11,17,-6,15
Chennaiyin,7436,8,3,5,6,14,22,-8,14
Mumbai City,7437,1,6,5,3,18,10,8,23
Delhi Dynamo,7437,2,5,7,2,25,17,8,22
Chennaiyin,7437,3,5,5,4,18,19,-1,20
Kerala Blast,7437,4,5,4,5,15,18,-3,19
Kolkata,7437,5,4,6,4,15,17,-2,18
FC Pune City,7437,6,5,3,6,14,17,-3,18
NorthEast Un,7437,7,4,4,6,12,13,-1,16
FC Goa,7437,8,4,2,8,13,19,-6,14
Mumbai City,7438,1,7,4,3,19,8,11,25
Delhi Dynamo,7438,2,6,5,3,25,18,7,23
Kolkata,7438,3,5,6,3,16,13,3,21
Kerala Blast,7438,4,6,3,5,13,16,-3,21
NorthEast Un,7438,5,5,2,7,14,14,0,17
Chennaiyin,7438,6,4,5,5,17,22,-5,17
FC Pune City,7438,7,4,3,7,13,18,-5,15
FC Goa,7438,8,4,2,8,11,19,-8,14
Mumbai City,7439,1,7,4,3,18,9,9,25
Kolkata,7439,2,5,7,2,17,14,3,22
Delhi Dynamo,7439,3,4,7,3,26,20,6,19
Kerala Blast,7439,4,5,4,5,11,14,-3,19
Chennaiyin,7439,5,4,6,4,16,19,-3,18
FC Pune City,7439,6,4,5,5,14,16,-2,17
NorthEast Un,7439,7,4,4,6,12,14,-2,16
FC Goa,7439,8,3,3,8,11,19,-8,12
Delhi Dynamo,7440,1,5,7,2,27,18,9,22
Mumbai City,7440,2,6,4,4,17,11,6,22
Kerala Blast,7440,3,6,4,4,12,14,-2,22
Kolkata,7440,4,4,8,2,19,17,2,20
Chennaiyin,7440,5,4,6,4,16,18,-2,18
NorthEast Un,7440,6,4,4,6,11,12,-1,16
FC Pune City,7440,7,4,3,7,14,18,-4,15
FC Goa,7440,8,3,4,7,12,20,-8,13
Mumbai City,7441,1,7,4,3,18,9,9,25
Delhi Dynamo,7441,2,5,6,3,26,19,7,21
Chennaiyin,7441,3,5,5,4,17,19,-2,20
FC Pune City,7441,4,5,4,5,14,15,-1,19
NorthEast Un,7441,5,5,3,6,15,14,1,18
Kerala Blast,7441,6,5,3,6,15,17,-2,18
Kolkata,7441,7,3,7,4,15,21,-6,16
FC Goa,7441,8,4,2,8,11,17,-6,14
Mumbai City,7442,1,7,4,3,17,8,9,25
Kolkata,7442,2,5,6,3,17,16,1,21
NorthEast Un,7442,3,6,2,6,13,15,-2,20
FC Pune City,7442,4,5,4,5,16,16,0,19
Delhi Dynamo,7442,5,4,6,4,24,19,5,18
Chennaiyin,7442,6,4,5,5,17,18,-1,17
Kerala Blast,7442,7,4,4,6,13,19,-6,16
FC Goa,7442,8,4,3,7,12,18,-6,15
Delhi Dynamo,7443,1,6,6,2,25,16,9,24
Mumbai City,7443,2,6,5,3,18,10,8,23
Kerala Blast,7443,3,6,4,4,15,13,2,22
Kolkata,7443,4,4,7,3,20,18,2,19
Chennaiyin,7443,5,4,6,4,15,17,-2,18
FC Pune City,7443,6,5,3,6,17,20,-3,18
NorthEast Un,7443,7,4,3,7,9,13,-4,15
FC Goa,7443,8,3,2,9,9,21,-12,11
Mumbai City,7444,1,6,5,3,16,8,8,23
Kolkata,7444,2,5,6,3,17,13,4,21
NorthEast Un,7444,3,6,3,5,13,11,2,21
Delhi Dynamo,7444,4,4,7,3,23,17,6,19
FC Pune City,7444,5,5,4,5,16,17,-1,19
Kerala Blast,7444,6,4,4,6,12,18,-6,16
Chennaiyin,7444,7,3,6,5,14,19,-5,15
FC Goa,7444,8,4,3,7,10,18,-8,15
Mumbai City,7445,1,7,4,3,18,9,9,25
Delhi Dynamo,7445,2,6,5,3,27,18,9,23
Kolkata,7445,3,4,7,3,19,16,3,19
Chennaiyin,7445,4,4,6,4,17,18,-1,18
FC Pune City,7445,5,5,3,6,15,17,-2,18
Kerala Blast,7445,6,5,3,6,13,20,-7,18
NorthEast Un,7445,7,5,2,7,11,15,-4,17
FC Goa,7445,8,3,4,7,12,19,-7,13
Mumbai City,7446,1,7,4,3,17,8,9,25
Chennaiyin,7446,2,5,5,4,16,18,-2,20
Delhi Dynamo,7446,3,4,7,3,23,17,6,19
FC Pune City,7446,4,5,4,5,15,15,0,19
Kolkata,7446,4,4,7,3,15,15,0,19
Kerala Blast,7446,6,5,4,5,12,16,-4,19
NorthEast Un,7446,7,4,3,7,9,11,-2,15
FC Goa,7446,8,3,4,7,11,18,-7,13
Mumbai City,7447,1,6,5,3,17,9,8,23
Delhi Dynamo,7447,2,5,6,3,25,18,7,21
Kolkata,7447,3,5,6,3,17,14,3,21
Kerala Blast,7447,4,5,4,5,12,15,-3,19
NorthEast Un,7447,5,5,2,7,11,14,-3,17
Chennaiyin,7447,6,4,5,5,15,19,-4,17
FC Goa,7447,7,5,2,7,12,16,-4,17
FC Pune City,7447,8,4,4,6,12,16,-4,16
Mumbai City,7448,1,6,5,3,16,8,8,23
Kolkata,7448,2,5,7,2,19,15,4,22
Delhi Dynamo,7448,3,4,7,3,24,20,4,19
NorthEast Un,7448,4,5,4,5,14,11,3,19
FC Pune City,7448,5,5,4,5,15,15,0,19
Chennaiyin,7448,6,3,7,4,15,19,-4,16
Kerala Blast,7448,7,4,4,6,10,18,-8,16
FC Goa,7448,8,3,4,7,14,21,-7,13
Mumbai City,7449,1,7,4,3,18,9,9,25
NorthEast Un,7449,2,6,3,5,15,11,4,21
Kerala Blast,7449,3,6,3,5,15,18,-3,21
Delhi Dynamo,7449,4,5,5,4,26,19,7,20
Kolkata,7449,5,4,6,4,17,18,-1,18
Chennaiyin,7449,6,3,7,4,16,20,-4,16
FC Goa,7449,7,4,3,7,13,19,-6,15
FC Pune City,7449,7,4,3,7,13,19,-6,15
Mumbai City,7450,1,6,5,3,18,10,8,23
Delhi Dynamo,7450,2,5,6,3,25,21,4,21
Kerala Blast,7450,3,6,3,5,11,14,-3,21
NorthEast Un,7450,4,6,2,6,16,10,6,20
Kolkata,7450,5,4,7,3,15,14,1,19
FC Pune City,7450,6,5,3,6,14,16,-2,18
FC Goa,7450,7,4,3,7,11,17,-6,15
Chennaiyin,7450,8,3,5,6,14,22,-8,14
Delhi Dynamo,7451,1,6,6,2,27,18,9,24
Mumbai City,7451,2,6,4,4,18,11,7,22
Kerala Blast,7451,3,6,4,4,14,16,-2,22
Kolkata,7451,4,4,7,3,17,14,3,19
NorthEast Un,7451,5,5,3,6,14,14,0,18
Chennaiyin,7451,6,4,5,5,16,20,-4,17
FC Pune City,7451,7,4,3,7,13,19,-6,15
FC Goa,7451,8,4,2,8,10,17,-7,14
Mumbai City,7452,1,6,5,3,17,9,8,23
Kerala Blast,7452,2,6,4,4,15,16,-1,22
Delhi Dynamo,7452,3,5,6,3,25,17,8,21
NorthEast Un,7452,4,5,3,6,13,12,1,18
Kolkata,7452,5,3,8,3,16,17,-1,17
Chennaiyin,7452,6,4,5,5,15,19,-4,17
FC Pune City,7452,7,4,4,6,14,17,-3,16
FC Goa,7452,8,4,3,7,12,20,-8,15
Mumbai City,7453,1,7,4,3,17,8,9,25
NorthEast Un,7453,2,7,2,5,14,10,4,23
Kolkata,7453,3,5,6,3,18,15,3,21
Delhi Dynamo,7453,4,4,6,4,22,17,5,18
FC Pune City,7453,5,5,3,6,13,15,-2,18
Kerala Blast,7453,6,5,3,6,12,17,-5,18
FC Goa,7453,7,4,3,7,12,19,-7,15
Chennaiyin,7453,8,3,5,6,14,21,-7,14
Mumbai City,7454,1,7,4,3,17,8,9,25
Delhi Dynamo,7454,2,5,6,3,24,17,7,21
Kolkata,7454,3,4,8,2,17,15,2,20
FC Pune City,7454,4,5,4,5,13,14,-1,19
Kerala Blast,7454,5,5,3,6,12,17,-5,18
Chennaiyin,7454,6,3,7,4,16,20,-4,16
NorthEast Un,7454,7,4,3,7,10,12,-2,15
FC Goa,7454,8,3,5,6,13,19,-6,14
Mumbai City,7455,1,7,4,3,19,10,9,25
Delhi Dynamo,7455,2,5,6,3,25,18,7,21
Kerala Blast,7455,3,5,5,4,13,16,-3,20
Kolkata,7455,4,4,6,4,16,17,-1,18
FC Goa,7455,5,5,2,7,14,16,-2,17
Chennaiyin,7455,6,4,5,5,17,22,-5,17
NorthEast Un,7455,7,4,4,6,12,14,-2,16
FC Pune City,7455,8,4,4,6,14,17,-3,16
Delhi Dynamo,7456,1,6,5,3,27,20,7,23
Mumbai City,7456,2,6,4,4,17,11,6,22
Kolkata,7456,3,5,6,3,18,15,3,21
Kerala Blast,7456,4,5,5,4,12,15,-3,20
NorthEast Un,7456,5,5,3,6,14,13,1,18
Chennaiyin,7456,6,4,6,4,16,18,-2,18
FC Pune City,7456,7,4,4,6,14,18,-4,16
FC Goa,7456,8,3,3,8,9,17,-8,12
Delhi Dynamo,7457,1,7,5,2,31,16,15,26
Mumbai City,7457,2,6,4,4,17,11,6,22
Kerala Blast,7457,3,5,5,4,14,16,-2,20
Kolkata,7457,4,4,7,3,17,17,0,19
NorthEast Un,7457,5,5,3,6,13,12,1,18
FC Goa,7457,6,5,2,7,12,20,-8,17
FC Pune City,7457,7,4,3,7,15,20,-5,15
Chennaiyin,7457,8,3,5,6,14,21,-7,14
Delhi Dynamo,7458,1,6,5,3,24,17,7,23
Mumbai City,7458,2,6,4,4,16,9,7,22
Kerala Blast,7458,3,6,4,4,11,13,-2,22
NorthEast Un,7458,4,5,3,6,12,10,2,18
Kolkata,7458,5,4,6,4,16,15,1,18
Chennaiyin,7458,6,4,5,5,14,18,-4,17
FC Goa,7458,7,5,2,7,10,16,-6,17
FC Pune City,7458,8,4,3,7,13,18,-5,15
Mumbai City,7459,1,6,5,3,17,9,8,23
Delhi Dynamo,7459,2,5,6,3,27,20,7,21
Kerala Blast,7459,3,5,5,4,12,14,-2,20
NorthEast Un,7459,4,5,3,6,15,16,-1,18
Kolkata,7459,5,3,8,3,13,13,0,17
FC Pune City,7459,6,4,5,5,12,14,-2,17
Chennaiyin,7459,7,3,7,4,16,20,-4,16
FC Goa,7459,8,4,3,7,12,18,-6,15
Delhi Dynamo,7460,1,6,6,2,25,16,9,24
Mumbai City,7460,2,6,4,4,17,10,7,22
Kolkata,7460,3,4,8,2,17,14,3,20
Kerala Blast,7460,4,5,5,4,12,14,-2,20
NorthEast Un,7460,5,5,3,6,12,13,-1,18
FC Pune City,7460,6,4,4,6,13,17,-4,16
FC Goa,7460,7,4,3,7,15,18,-3,15
Chennaiyin,7460,8,3,5,6,15,24,-9,14
Mumbai City,7461,1,7,4,3,18,9,9,25
Delhi Dynamo,7461,2,5,6,3,26,18,8,21
Kolkata,7461,3,5,6,3,16,15,1,21
NorthEast Un,7461,4,5,4,5,14,13,1,19
Kerala Blast,7461,5,5,4,5,13,17,-4,19
FC Goa,7461,6,5,2,7,12,17,-5,17
FC Pune City,7461,7,4,3,7,13,17,-4,15
Chennaiyin,7461,8,3,5,6,15,21,-6,14
Mumbai City,7462,1,7,4,3,18,8,10,25
Kolkata,7462,2,5,6,3,19,15,4,21
NorthEast Un,7462,3,5,4,5,14,13,1,19
Kerala Blast,7462,4,5,4,5,11,17,-6,19
Delhi Dynamo,7462,5,4,6,4,24,20,4,18
FC Pune City,7462,6,5,3,6,13,15,-2,18
Chennaiyin,7462,7,3,7,4,14,18,-4,16
FC Goa,7462,8,3,4,7,11,18,-7,13
Mumbai City,7463,1,7,4,3,21,8,13,25
Delhi Dynamo,7463,2,5,6,3,25,21,4,21
NorthEast Un,7463,3,5,4,5,12,11,1,19
Kerala Blast,7463,4,5,4,5,13,16,-3,19
Chennaiyin,7463,5,4,6,4,16,19,-3,18
Kolkata,7463,6,3,8,3,16,16,0,17
FC Pune City,7463,7,4,4,6,14,18,-4,16
FC Goa,7463,8,4,2,8,12,20,-8,14
Mumbai City,7464,1,7,4,3,18,9,9,25
Delhi Dynamo,7464,2,6,5,3,24,16,8,23
Kerala Blast,7464,3,5,5,4,13,16,-3,20
Kolkata,7464,4,4,7,3,18,15,3,19
FC Goa,7464,5,5,2,7,11,15,-4,17
FC Pune City,7464,6,4,4,6,14,20,-6,16
NorthEast Un,7464,7,4,3,7,11,13,-2,15
Chennaiyin,7464,8,3,6,5,13,18,-5,15
Mumbai City,7465,1,7,4,3,18,8,10,25
Delhi Dynamo,7465,2,6,5,3,24,16,8,23
Kolkata,7465,3,5,6,3,20,16,4,21
FC Pune City,7465,4,5,4,5,16,17,-1,19
Kerala Blast,7465,5,5,4,5,12,17,-5,19
Chennaiyin,7465,6,4,6,4,15,17,-2,18
NorthEast Un,7465,7,4,2,8,10,14,-4,14
FC Goa,7465,8,3,3,8,9,19,-10,12
Mumbai City,7466,1,6,5,3,17,9,8,23
Delhi Dynamo,7466,2,5,7,2,29,18,11,22
Kerala Blast,7466,3,5,5,4,14,15,-1,20
Kolkata,7466,4,3,9,2,17,16,1,18
NorthEast Un,7466,5,5,3,6,17,17,0,18
FC Pune City,7466,6,4,5,5,14,16,-2,17
FC Goa,7466,7,4,3,7,12,21,-9,15
Chennaiyin,7466,8,3,5,6,14,22,-8,14
Mumbai City,7467,1,6,5,3,16,8,8,23
Delhi Dynamo,7467,2,5,6,3,24,17,7,21
FC Goa,7467,3,6,2,6,12,15,-3,20
Kerala Blast,7467,4,5,4,5,12,15,-3,19
NorthEast Un,7467,5,5,3,6,13,13,0,18
Kolkata,7467,6,3,8,3,14,14,0,17
FC Pune City,7467,7,4,4,6,14,18,-4,16
Chennaiyin,7467,8,3,6,5,15,20,-5,15
Mumbai City,7468,1,6,5,3,19,11,8,23
Kolkata,7468,2,5,6,3,18,16,2,21
Kerala Blast,7468,3,6,3,5,13,16,-3,21
Delhi Dynamo,7468,4,4,6,4,24,24,0,18
FC Pune City,7468,5,5,3,6,15,16,-1,18
FC Goa,7468,6,5,2,7,16,17,-1,17
NorthEast Un,7468,7,5,2,7,11,12,-1,17
Chennaiyin,7468,8,4,5,5,14,18,-4,17
Mumbai City,7469,1,6,5,3,17,9,8,23
Kolkata,7469,2,5,6,3,21,16,5,21
Kerala Blast,7469,3,6,3,5,13,18,-5,21
Delhi Dynamo,7469,4,4,8,2,24,17,7,20
Chennaiyin,7469,5,5,5,4,17,19,-2,20
NorthEast Un,7469,6,4,3,7,10,12,-2,15
FC Pune City,7469,7,4,3,7,14,19,-5,15
FC Goa,7469,8,4,3,7,13,19,-6,15
Mumbai City,7470,1,7,4,3,20,9,11,25
Delhi Dynamo,7470,2,6,5,3,30,21,9,23
Kerala Blast,7470,3,5,5,4,13,16,-3,20
FC Pune City,7470,4,5,3,6,13,15,-2,18
Kolkata,7470,5,3,8,3,14,14,0,17
NorthEast Un,7470,6,4,4,6,12,14,-2,16
Chennaiyin,7470,7,3,7,4,13,17,-4,16
FC Goa,7470,8,3,4,7,10,19,-9,13
Mumbai City,7471,1,7,4,3,20,9,11,25
NorthEast Un,7471,2,6,3,5,14,10,4,21
Delhi Dynamo,7471,3,5,5,4,23,20,3,20
FC Pune City,7471,4,5,4,5,14,14,0,19
Kolkata,7471,5,4,6,4,16,16,0,18
Chennaiyin,7471,6,3,7,4,14,18,-4,16
Kerala Blast,7471,7,4,4,6,11,19,-8,16
FC Goa,7471,8,4,3,7,10,16,-6,15
Mumbai City,7472,1,7,4,3,18,9,9,25
Kolkata,7472,2,5,7,2,16,12,4,22
Delhi Dynamo,7472,3,5,6,3,29,19,10,21
NorthEast Un,7472,4,5,4,5,15,14,1,19
FC Pune City,7472,5,4,4,6,13,16,-3,16
Chennaiyin,7472,6,3,7,4,16,20,-4,16
Kerala Blast,7472,7,4,4,6,11,18,-7,16
FC Goa,7472,8,3,4,7,10,20,-10,13
Mumbai City,7473,1,7,4,3,18,9,9,25
Kolkata,7473,2,6,6,2,18,13,5,24
Delhi Dynamo,7473,3,6,5,3,28,18,10,23
Kerala Blast,7473,4,6,3,5,12,14,-2,21
NorthEast Un,7473,5,5,2,7,11,13,-2,17
FC Pune City,7473,6,4,3,7,12,17,-5,15
FC Goa,7473,7,4,2,8,14,20,-6,14
Chennaiyin,7473,8,3,5,6,13,22,-9,14
Mumbai City,7474,1,7,4,3,17,8,9,25
Kerala Blast,7474,2,6,4,4,15,16,-1,22
Kolkata,7474,3,4,8,2,19,17,2,20
Delhi Dynamo,7474,4,4,6,4,23,19,4,18
FC Goa,7474,5,5,3,6,13,16,-3,18
Chennaiyin,7474,6,4,5,5,15,18,-3,17
NorthEast Un,7474,7,4,3,7,10,13,-3,15
FC Pune City,7474,8,4,3,7,15,20,-5,15
Delhi Dynamo,7475,1,6,5,3,26,17,9,23
Mumbai City,7475,2,6,4,4,17,10,7,22
Kerala Blast,7475,3,6,3,5,13,16,-3,21
NorthEast Un,7475,4,6,2,6,12,11,1,20
Kolkata,7475,5,4,7,3,16,16,0,19
Chennaiyin,7475,6,4,5,5,16,20,-4,17
FC Pune City,7475,7,4,4,6,13,16,-3,16
FC Goa,7475,8,4,2,8,13,20,-7,14
Delhi Dynamo,7476,1,7,5,2,26,15,11,26
Kolkata,7476,2,6,6,2,19,15,4,24
Mumbai City,7476,3,6,4,4,17,10,7,22
NorthEast Un,7476,4,6,2,6,13,11,2,20
FC Pune City,7476,5,4,4,6,14,17,-3,16
Kerala Blast,7476,6,4,4,6,11,17,-6,16
FC Goa,7476,7,4,2,8,10,17,-7,14
Chennaiyin,7476,8,3,5,6,13,21,-8,14
Mumbai City,7477,1,7,4,3,19,10,9,25
Delhi Dynamo,7477,2,6,5,3,28,19,9,23
Kerala Blast,7477,3,6,3,5,12,15,-3,21
FC Pune City,7477,4,5,4,5,15,16,-1,19
FC Goa,7477,5,5,2,7,14,18,-4,17
Kolkata,7477,6,3,7,4,15,17,-2,16
NorthEast Un,7477,7,4,3,7,11,13,-2,15
Chennaiyin,7477,8,3,6,5,14,20,-6,15
Mumbai City,7478,1,7,4,3,18,8,10,25
Kerala Blast,7478,2,5,5,4,12,15,-3,20
NorthEast Un,7478,3,5,4,5,13,10,3,19
Delhi Dynamo,7478,4,4,6,4,24,22,2,18
FC Pune City,7478,5,5,3,6,14,15,-1,18
Chennaiyin,7478,6,4,6,4,15,18,-3,18
Kolkata,7478,7,3,7,4,14,19,-5,16
FC Goa,7478,8,4,3,7,16,19,-3,15
Mumbai City,7479,1,7,4,3,17,8,9,25
Delhi Dynamo,7479,2,5,6,3,25,16,9,21
Kolkata,7479,3,4,7,3,16,16,0,19
FC Pune City,7479,4,5,4,5,14,14,0,19
Kerala Blast,7479,5,5,4,5,11,15,-4,19
Chennaiyin,7479,6,4,6,4,18,20,-2,18
NorthEast Un,7479,7,4,3,7,10,13,-3,15
FC Goa,7479,8,3,4,7,12,21,-9,13
Mumbai City,7480,1,7,4,3,19,8,11,25
Delhi Dynamo,7480,2,5,6,3,26,19,7,21
NorthEast Un,7480,3,5,4,5,11,10,1,19
Kolkata,7480,4,4,7,3,16,16,0,19
Chennaiyin,7480,5,4,6,4,15,18,-3,18
FC Pune City,7480,6,4,5,5,12,14,-2,17
Kerala Blast,7480,7,4,4,6,10,16,-6,16
FC Goa,7480,8,4,2,8,13,21,-8,14
Mumbai City,7481,1,6,5,3,18,10,8,23
Delhi Dynamo,7481,2,5,6,3,27,21,6,21
FC Pune City,7481,3,6,3,5,17,16,1,21
NorthEast Un,7481,4,5,3,6,13,10,3,18
FC Goa,7481,5,5,2,7,16,20,-4,17
Chennaiyin,7481,6,4,5,5,15,19,-4,17
Kerala Blast,7481,7,4,5,5,11,17,-6,17
Kolkata,7481,8,3,7,4,16,20,-4,16
Mumbai City,7482,1,6,4,4,16,9,7,22
Delhi Dynamo,7482,2,5,6,3,23,16,7,21
Kolkata,7482,3,5,6,3,19,15,4,21
NorthEast Un,7482,4,6,3,5,14,10,4,21
Kerala Blast,7482,5,4,5,5,11,17,-6,17
FC Goa,7482,6,4,4,6,12,16,-4,16
FC Pune City,7482,7,4,4,6,12,17,-5,16
Chennaiyin,7482,8,3,6,5,14,21,-7,15
Delhi Dynamo,7483,1,6,5,3,24,16,8,23
Mumbai City,7483,2,6,4,4,16,9,7,22
Kolkata,7483,3,5,7,2,16,13,3,22
Kerala Blast,7483,4,5,4,5,10,14,-4,19
NorthEast Un,7483,5,4,4,6,11,12,-1,16
Chennaiyin,7483,6,3,7,4,15,19,-4,16
FC Goa,7483,7,4,4,6,10,15,-5,16
FC Pune City,7483,8,4,3,7,13,17,-4,15
Mumbai City,7484,1,7,4,3,17,8,9,25
Delhi Dynamo,7484,2,6,5,3,25,16,9,23
Chennaiyin,7484,3,5,5,4,16,17,-1,20
Kolkata,7484,4,4,7,3,18,16,2,19
FC Pune City,7484,5,5,3,6,16,19,-3,18
NorthEast Un,7484,6,5,2,7,10,12,-2,17
Kerala Blast,7484,7,4,4,6,10,17,-7,16
FC Goa,7484,8,4,2,8,12,19,-7,14
Delhi Dynamo,7485,1,6,5,3,26,18,8,23
Mumbai City,7485,2,6,4,4,16,9,7,22
FC Pune City,7485,3,6,3,5,17,16,1,21
Kolkata,7485,4,5,6,3,16,15,1,21
Chennaiyin,7485,5,5,5,4,17,17,0,20
Kerala Blast,7485,6,4,4,6,11,17,-6,16
NorthEast Un,7485,7,4,3,7,12,14,-2,15
FC Goa,7485,8,4,2,8,10,19,-9,14
Delhi Dynamo,7486,1,6,5,3,28,19,9,23
Mumbai City,7486,2,6,4,4,19,12,7,22
Kerala Blast,7486,3,5,5,4,11,14,-3,20
FC Pune City,7486,4,5,3,6,14,16,-2,18
Chennaiyin,7486,5,4,6,4,15,18,-3,18
Kolkata,7486,6,3,8,3,13,13,0,17
FC Goa,7486,7,4,4,6,10,15,-5,16
NorthEast Un,7486,8,4,3,7,10,13,-3,15
Mumbai City,7487,1,7,4,3,19,8,11,25
Kerala Blast,7487,2,6,4,4,14,14,0,22
NorthEast Un,7487,3,6,3,5,17,13,4,21
Delhi Dynamo,7487,4,5,5,4,25,23,2,20
Kolkata,7487,5,4,7,3,15,16,-1,19
FC Pune City,7487,6,4,3,7,13,17,-4,15
Chennaiyin,7487,7,3,6,5,15,20,-5,15
FC Goa,7487,8,3,4,7,10,17,-7,13
Delhi Dynamo,7488,1,7,5,2,27,17,10,26
Mumbai City,7488,2,6,4,4,16,9,7,22
Kerala Blast,7488,3,6,3,5,16,18,-2,21
NorthEast Un,7488,4,6,2,6,15,13,2,20
FC Pune City,7488,5,5,3,6,17,18,-1,18
Kolkata,7488,6,4,6,4,14,17,-3,18
Chennaiyin,7488,7,3,6,5,14,19,-5,15
FC Goa,7488,8,3,3,8,10,18,-8,12
Mumbai City,7489,1,7,4,3,18,8,10,25
Delhi Dynamo,7489,2,5,5,4,25,20,5,20
Kolkata,7489,3,4,8,2,15,13,2,20
Chennaiyin,7489,4,5,5,4,18,19,-1,20
Kerala Blast,7489,5,5,5,4,12,15,-3,20
NorthEast Un,7489,6,5,3,6,14,14,0,18
FC Pune City,7489,7,4,3,7,13,17,-4,15
FC Goa,7489,8,3,3,8,11,20,-9,12
Kolkata,7490,1,6,6,2,20,13,7,24
Delhi Dynamo,7490,2,6,5,3,25,18,7,23
Mumbai City,7490,3,6,4,4,16,9,7,22
Chennaiyin,7490,4,5,5,4,17,19,-2,20
Kerala Blast,7490,5,5,4,5,12,16,-4,19
NorthEast Un,7490,6,5,2,7,14,12,2,17
FC Pune City,7490,7,4,4,6,12,18,-6,16
FC Goa,7490,8,3,2,9,10,21,-11,11
Mumbai City,7491,1,7,4,3,19,8,11,25
Delhi Dynamo,7491,2,6,5,3,26,18,8,23
Kolkata,7491,3,4,7,3,17,16,1,19
Kerala Blast,7491,4,5,4,5,12,16,-4,19
Chennaiyin,7491,5,4,6,4,18,20,-2,18
FC Pune City,7491,6,5,3,6,14,16,-2,18
NorthEast Un,7491,7,4,3,7,12,16,-4,15
FC Goa,7491,8,3,4,7,13,21,-8,13
Mumbai City,7492,1,7,4,3,18,8,10,25
Kerala Blast,7492,2,6,3,5,13,15,-2,21
Delhi Dynamo,7492,3,4,7,3,22,17,5,19
Kolkata,7492,4,4,6,4,14,14,0,18
Chennaiyin,7492,5,4,6,4,18,19,-1,18
FC Pune City,7492,6,5,3,6,13,16,-3,18
NorthEast Un,7492,7,4,4,6,11,12,-1,16
FC Goa,7492,8,4,3,7,11,19,-8,15
Mumbai City,7493,1,7,4,3,21,11,10,25
Delhi Dynamo,7493,2,6,5,3,28,21,7,23
FC Pune City,7493,3,5,3,6,15,17,-2,18
Kerala Blast,7493,4,5,3,6,14,16,-2,18
Kolkata,7493,5,4,6,4,16,20,-4,18
NorthEast Un,7493,6,5,2,7,12,14,-2,17
FC Goa,7493,7,5,2,7,14,17,-3,17
Chennaiyin,7493,8,4,5,5,16,20,-4,17
Mumbai City,7494,1,7,4,3,19,9,10,25
Delhi Dynamo,7494,2,6,5,3,27,19,8,23
Kolkata,7494,3,5,7,2,18,14,4,22
Kerala Blast,7494,4,6,3,5,14,16,-2,21
Chennaiyin,7494,5,4,6,4,17,18,-1,18
NorthEast Un,7494,6,4,3,7,11,14,-3,15
FC Pune City,7494,7,4,3,7,12,18,-6,15
FC Goa,7494,8,3,3,8,12,22,-10,12
Mumbai City,7495,1,7,4,3,17,8,9,25
Kolkata,7495,2,6,6,2,17,13,4,24
NorthEast Un,7495,3,6,3,5,15,10,5,21
Delhi Dynamo,7495,4,5,5,4,25,21,4,20
Kerala Blast,7495,5,5,4,5,10,14,-4,19
FC Pune City,7495,6,4,3,7,13,17,-4,15
FC Goa,7495,7,4,2,8,14,18,-4,14
Chennaiyin,7495,8,3,5,6,13,23,-10,14
Mumbai City,7496,1,6,5,3,18,10,8,23
Delhi Dynamo,7496,2,5,6,3,25,18,7,21
Kolkata,7496,3,4,8,2,21,18,3,20
Kerala Blast,7496,4,5,5,4,16,17,-1,20
Chennaiyin,7496,5,5,5,4,16,18,-2,20
FC Pune City,7496,6,4,4,6,14,18,-4,16
FC Goa,7496,7,4,3,7,12,17,-5,15
NorthEast Un,7496,8,4,2,8,10,16,-6,14
Mumbai City,7497,1,6,4,4,18,11,7,22
Kerala Blast,7497,2,6,4,4,15,15,0,22
Delhi Dynamo,7497,3,5,6,3,25,18,7,21
NorthEast Un,7497,4,6,2,6,13,13,0,20
Chennaiyin,7497,5,4,5,5,16,20,-4,17
Kolkata,7497,5,3,8,3,16,20,-4,17
FC Pune City,7497,7,4,4,6,13,17,-4,16
FC Goa,7497,8,4,3,7,14,16,-2,15
Mumbai City,7498,1,7,4,3,19,9,10,25
NorthEast Un,7498,2,6,3,5,15,12,3,21
Kolkata,7498,3,4,7,3,17,16,1,19
Kerala Blast,7498,4,5,4,5,13,17,-4,19
Delhi Dynamo,7498,5,4,6,4,22,18,4,18
Chennaiyin,7498,6,4,5,5,14,19,-5,17
FC Pune City,7498,7,4,4,6,14,17,-3,16
FC Goa,7498,8,4,3,7,10,16,-6,15
Mumbai City,7499,1,7,4,3,20,9,11,25
Delhi Dynamo,7499,2,6,5,3,31,20,11,23
Kolkata,7499,3,4,8,2,15,13,2,20
Kerala Blast,7499,4,5,4,5,13,16,-3,19
Chennaiyin,7499,5,4,5,5,17,21,-4,17
FC Pune City,7499,6,4,4,6,12,16,-4,16
FC Goa,7499,7,4,3,7,13,19,-6,15
NorthEast Un,7499,8,4,3,7,11,18,-7,15
Mumbai City,7500,1,7,4,3,18,8,10,25
Kolkata,7500,2,5,6,3,15,13,2,21
Kerala Blast,7500,3,6,3,5,13,15,-2,21
NorthEast Un,7500,4,5,3,6,13,14,-1,18
FC Goa,7500,5,5,3,6,12,16,-4,18
Delhi Dynamo,7500,6,4,5,5,24,21,3,17
Chennaiyin,7500,7,3,7,4,14,18,-4,16
FC Pune City,7500,8,4,3,7,12,16,-4,15
Kolkata,7501,1,6,6,2,19,12,7,24
Mumbai City,7501,2,6,5,3,19,11,8,23
NorthEast Un,7501,3,5,4,5,12,10,2,19
Kerala Blast,7501,4,5,4,5,12,18,-6,19
Delhi Dynamo,7501,5,4,6,4,24,22,2,18
Chennaiyin,7501,6,4,6,4,18,19,-1,18
FC Pune City,7501,7,4,3,7,13,17,-4,15
FC Goa,7501,8,4,2,8,13,21,-8,14
Mumbai City,7502,1,7,4,3,20,8,12,25
Delhi Dynamo,7502,2,5,6,3,28,20,8,21
FC Pune City,7502,3,5,4,5,14,14,0,19
NorthEast Un,7502,4,5,3,6,15,14,1,18
Chennaiyin,7502,5,4,6,4,18,20,-2,18
Kerala Blast,7502,6,4,5,5,11,18,-7,17
Kolkata,7502,7,3,7,4,15,17,-2,16
FC Goa,7502,8,4,3,7,11,21,-10,15
Mumbai City,7503,1,7,4,3,19,9,10,25
Kolkata,7503,2,5,6,3,18,16,2,21
Kerala Blast,7503,3,6,3,5,13,17,-4,21
NorthEast Un,7503,4,6,2,6,12,10,2,20
FC Pune City,7503,5,5,3,6,18,19,-1,18
Delhi Dynamo,7503,6,4,5,5,22,20,2,17
FC Goa,7503,7,5,2,7,10,15,-5,17
Chennaiyin,7503,8,3,5,6,13,19,-6,14
Delhi Dynamo,7504,1,7,5,2,28,15,13,26
Mumbai City,7504,2,6,4,4,16,9,7,22
Kerala Blast,7504,3,6,4,4,14,13,1,22
Kolkata,7504,4,4,6,4,17,18,-1,18
Chennaiyin,7504,5,4,6,4,17,20,-3,18
NorthEast Un,7504,6,4,4,6,11,12,-1,16
FC Pune City,7504,7,4,3,7,14,20,-6,15
FC Goa,7504,8,4,2,8,11,21,-10,14
Delhi Dynamo,7505,1,6,6,2,25,16,9,24
Mumbai City,7505,2,6,4,4,17,10,7,22
NorthEast Un,7505,3,5,3,6,13,13,0,18
Kolkata,7505,4,4,6,4,15,16,-1,18
FC Pune City,7505,5,5,3,6,14,16,-2,18
Kerala Blast,7505,6,5,3,6,11,16,-5,18
Chennaiyin,7505,7,4,5,5,17,21,-4,17
FC Goa,7505,8,5,2,7,13,17,-4,17
Mumbai City,7506,1,6,5,3,17,9,8,23
Kerala Blast,7506,2,5,5,4,11,14,-3,20
Delhi Dynamo,7506,3,4,7,3,23,18,5,19
NorthEast Un,7506,4,5,4,5,13,11,2,19
Chennaiyin,7506,5,4,6,4,16,18,-2,18
FC Pune City,7506,6,4,5,5,14,16,-2,17
Kolkata,7506,7,3,7,4,14,15,-1,16
FC Goa,7506,8,4,3,7,9,16,-7,15
Mumbai City,7507,1,7,4,3,18,9,9,25
Kerala Blast,7507,2,6,4,4,16,16,0,22
Delhi Dynamo,7507,3,5,6,3,24,17,7,21
Kolkata,7507,4,4,7,3,18,16,2,19
NorthEast Un,7507,5,4,4,6,12,13,-1,16
Chennaiyin,7507,6,3,7,4,14,18,-4,16
FC Goa,7507,7,4,3,7,11,16,-5,15
FC Pune City,7507,8,4,3,7,13,21,-8,15
Mumbai City,7508,1,7,4,3,18,9,9,25
Kolkata,7508,2,5,7,2,17,14,3,22
NorthEast Un,7508,3,6,3,5,17,10,7,21
Delhi Dynamo,7508,4,5,5,4,26,21,5,20
FC Pune City,7508,5,5,3,6,13,15,-2,18
Kerala Blast,7508,6,4,4,6,10,16,-6,16
FC Goa,7508,7,4,3,7,13,20,-7,15
Chennaiyin,7508,8,3,5,6,13,22,-9,14
Mumbai City,7509,1,7,4,3,19,10,9,25
Kerala Blast,7509,2,6,3,5,14,18,-4,21
Kolkata,7509,3,4,7,3,18,17,1,19
FC Goa,7509,4,5,3,6,15,16,-1,18
NorthEast Un,7509,5,5,3,6,12,13,-1,18
Delhi Dynamo,7509,6,4,5,5,24,20,4,17
Chennaiyin,7509,7,3,7,4,15,19,-4,16
FC Pune City,7509,8,4,4,6,13,17,-4,16
Mumbai City,7510,1,6,5,3,16,8,8,23
Delhi Dynamo,7510,2,5,6,3,24,16,8,21
Chennaiyin,7510,3,5,5,4,15,17,-2,20
Kerala Blast,7510,4,5,5,4,14,16,-2,20
NorthEast Un,7510,5,5,3,6,11,11,0,18
FC Pune City,7510,6,5,3,6,17,18,-1,18
Kolkata,7510,7,3,8,3,14,16,-2,17
FC Goa,7510,8,3,3,8,10,19,-9,12
Mumbai City,7511,1,6,5,3,18,10,8,23
Delhi Dynamo,7511,2,5,6,3,26,19,7,21
Kolkata,7511,3,5,6,3,18,13,5,21
NorthEast Un,7511,4,6,3,5,15,12,3,21
Chennaiyin,7511,5,4,6,4,17,19,-2,18
FC Pune City,7511,6,5,3,6,13,17,-4,18
Kerala Blast,7511,7,5,3,6,10,16,-6,18
FC Goa,7511,8,3,2,9,9,20,-11,11
Delhi Dynamo,7512,1,6,5,3,26,16,10,23
NorthEast Un,7512,2,7,2,5,16,10,6,23
Mumbai City,7512,3,6,4,4,16,10,6,22
FC Pune City,7512,4,6,3,5,16,15,1,21
Kerala Blast,7512,5,5,3,6,13,18,-5,18
FC Goa,7512,6,5,2,7,14,20,-6,17
Kolkata,7512,7,3,6,5,15,20,-5,15
Chennaiyin,7512,8,3,5,6,16,23,-7,14
Mumbai City,7513,1,7,4,3,17,8,9,25
Kolkata,7513,2,5,7,2,19,15,4,22
Delhi Dynamo,7513,3,5,5,4,24,19,5,20
Kerala Blast,7513,4,5,4,5,14,16,-2,19
NorthEast Un,7513,5,5,3,6,13,12,1,18
Chennaiyin,7513,6,4,6,4,14,17,-3,18
FC Pune City,7513,7,4,3,7,14,21,-7,15
FC Goa,7513,8,3,4,7,8,15,-7,13
Mumbai City,7514,1,7,4,3,17,8,9,25
Delhi Dynamo,7514,2,6,5,3,24,15,9,23
Kerala Blast,7514,3,6,3,5,15,15,0,21
Kolkata,7514,4,4,7,3,16,15,1,19
FC Pune City,7514,5,5,3,6,14,16,-2,18
Chennaiyin,7514,6,4,5,5,16,19,-3,17
FC Goa,7514,7,4,3,7,10,15,-5,15
NorthEast Un,7514,8,4,2,8,9,18,-9,14
Mumbai City,7515,1,7,4,3,18,9,9,25
Kerala Blast,7515,2,7,3,4,14,14,0,24
Delhi Dynamo,7515,3,5,6,3,25,17,8,21
FC Goa,7515,4,5,3,6,14,17,-3,18
FC Pune City,7515,4,5,3,6,14,17,-3,18
NorthEast Un,7515,6,5,2,7,10,12,-2,17
Kolkata,7515,7,3,6,5,14,16,-2,15
Chennaiyin,7515,8,3,5,6,14,21,-7,14
Delhi Dynamo,7516,1,7,5,2,26,14,12,26
Mumbai City,7516,2,6,4,4,16,9,7,22
Kerala Blast,7516,3,6,3,5,12,15,-3,21
FC Pune City,7516,4,5,4,5,15,15,0,19
Kolkata,7516,5,3,7,4,15,16,-1,16
Chennaiyin,7516,6,3,7,4,15,19,-4,16
NorthEast Un,7516,7,4,3,7,10,14,-4,15
FC Goa,7516,8,4,3,7,11,18,-7,15
Delhi Dynamo,7517,1,6,5,3,28,20,8,23
Mumbai City,7517,2,6,4,4,16,11,5,22
Kolkata,7517,3,4,7,3,16,14,2,19
FC Pune City,7517,4,5,4,5,14,15,-1,19
NorthEast Un,7517,5,5,3,6,15,12,3,18
Chennaiyin,7517,6,4,6,4,15,18,-3,18
Kerala Blast,7517,7,4,5,5,10,16,-6,17
FC Goa,7517,8,3,4,7,10,18,-8,13
Delhi Dynamo,7518,1,6,5,3,26,17,9,23
Mumbai City,7518,2,6,4,4,17,10,7,22
Kolkata,7518,3,4,8,2,16,14,2,20
NorthEast Un,7518,4,5,4,5,10,9,1,19
FC Pune City,7518,5,4,5,5,14,16,-2,17
Kerala Blast,7518,6,4,5,5,9,14,-5,17
Chennaiyin,7518,7,3,6,5,15,20,-5,15
FC Goa,7518,8,4,3,7,12,19,-7,15
Mumbai City,7519,1,7,4,3,18,9,9,25
Kerala Blast,7519,2,6,3,5,17,18,-1,21
FC Pune City,7519,3,5,4,5,16,16,0,19
Delhi Dynamo,7519,4,4,6,4,23,19,4,18
NorthEast Un,7519,5,5,3,6,13,12,1,18
FC Goa,7519,6,5,3,6,15,16,-1,18
Kolkata,7519,7,3,7,4,15,20,-5,16
Chennaiyin,7519,8,3,6,5,13,20,-7,15
Mumbai City,7520,1,7,4,3,18,8,10,25
Kerala Blast,7520,2,7,3,4,15,13,2,24
Delhi Dynamo,7520,3,6,5,3,25,16,9,23
Chennaiyin,7520,4,4,6,4,15,17,-2,18
Kolkata,7520,5,3,8,3,15,17,-2,17
FC Pune City,7520,6,4,4,6,13,17,-4,16
NorthEast Un,7520,7,4,2,8,9,13,-4,14
FC Goa,7520,8,3,4,7,9,18,-9,13
Mumbai City,7521,1,7,4,3,17,8,9,25
Kerala Blast,7521,2,6,4,4,15,16,-1,22
Chennaiyin,7521,3,5,5,4,18,17,1,20
Delhi Dynamo,7521,4,4,7,3,23,17,6,19
FC Pune City,7521,5,5,4,5,16,17,-1,19
Kolkata,7521,6,3,7,4,16,18,-2,16
NorthEast Un,7521,7,4,3,7,10,12,-2,15
FC Goa,7521,8,3,4,7,10,20,-10,13
Mumbai City,7522,1,7,4,3,18,8,10,25
Delhi Dynamo,7522,2,5,6,3,26,18,8,21
Kolkata,7522,3,4,8,2,17,15,2,20
Kerala Blast,7522,4,5,4,5,11,16,-5,19
NorthEast Un,7522,5,5,3,6,12,12,0,18
FC Pune City,7522,6,5,3,6,16,17,-1,18
Chennaiyin,7522,7,4,5,5,16,19,-3,17
FC Goa,7522,8,3,3,8,11,22,-11,12
Mumbai City,7523,1,7,4,3,18,9,9,25
Delhi Dynamo,7523,2,6,5,3,28,17,11,23
Kerala Blast,7523,3,6,3,5,13,15,-2,21
Kolkata,7523,4,4,6,4,16,17,-1,18
Chennaiyin,7523,5,4,6,4,16,18,-2,18
FC Pune City,7523,6,5,3,6,14,16,-2,18
FC Goa,7523,7,4,3,7,12,18,-6,15
NorthEast Un,7523,8,4,2,8,11,18,-7,14
Mumbai City,7524,1,7,4,3,21,9,12,25
Kolkata,7524,2,4,8,2,18,15,3,20
Kerala Blast,7524,3,5,5,4,17,20,-3,20
NorthEast Un,7524,4,5,4,5,14,13,1,19
Delhi Dynamo,7524,5,4,5,5,23,23,0,17
Chennaiyin,7524,6,3,7,4,15,19,-4,16
FC Goa,7524,7,4,4,6,12,16,-4,16
FC Pune City,7524,8,4,3,7,15,20,-5,15
Mumbai City,7525,1,6,4,4,16,10,6,22
Delhi Dynamo,7525,2,5,6,3,24,17,7,21
FC Pune City,7525,3,6,3,5,16,14,2,21
NorthEast Un,7525,4,5,4,5,12,11,1,19
Kolkata,7525,5,4,6,4,18,18,0,18
Kerala Blast,7525,6,5,3,6,11,15,-4,18
Chennaiyin,7525,7,3,7,4,16,20,-4,16
FC Goa,7525,8,4,3,7,13,21,-8,15
Mumbai City,7526,1,6,5,3,17,9,8,23
NorthEast Un,7526,2,7,2,5,15,10,5,23
Delhi Dynamo,7526,3,5,6,3,24,19,5,21
Kolkata,7526,4,5,6,3,17,13,4,21
FC Pune City,7526,5,4,4,6,14,19,-5,16
Kerala Blast,7526,6,4,4,6,11,17,-6,16
Chennaiyin,7526,7,3,6,5,14,19,-5,15
FC Goa,7526,8,4,3,7,10,16,-6,15
Mumbai City,7527,1,6,4,4,17,10,7,22
Delhi Dynamo,7527,2,5,5,4,23,18,5,20
Kerala Blast,7527,3,5,5,4,14,16,-2,20
Kolkata,7527,4,4,7,3,17,15,2,19
NorthEast Un,7527,5,5,3,6,13,13,0,18
Chennaiyin,7527,6,4,6,4,16,18,-2,18
FC Goa,7527,7,5,3,6,10,14,-4,18
FC Pune City,7527,8,4,3,7,12,18,-6,15
Mumbai City,7528,1,7,4,3,20,8,12,25
Kerala Blast,7528,2,5,5,4,10,13,-3,20
Chennaiyin,7528,3,4,6,4,14,17,-3,18
FC Goa,7528,4,5,3,6,11,14,-3,18
Delhi Dynamo,7528,5,4,5,5,22,22,0,17
NorthEast Un,7528,6,5,2,7,12,12,0,17
Kolkata,7528,7,3,8,3,14,15,-1,17
FC Pune City,7528,8,4,5,5,13,15,-2,17
Delhi Dynamo,7529,1,6,6,2,28,17,11,24
Mumbai City,7529,2,6,4,4,18,11,7,22
Kerala Blast,7529,3,6,4,4,14,15,-1,22
FC Pune City,7529,4,5,4,5,17,18,-1,19
NorthEast Un,7529,5,5,3,6,12,11,1,18
Kolkata,7529,6,4,6,4,16,16,0,18
Chennaiyin,7529,7,3,5,6,13,21,-8,14
FC Goa,7529,8,4,2,8,10,19,-9,14
Mumbai City,7530,1,7,4,3,19,9,10,25
Kolkata,7530,2,5,6,3,17,14,3,21
Kerala Blast,7530,3,6,3,5,13,16,-3,21
Delhi Dynamo,7530,4,4,7,3,26,21,5,19
FC Pune City,7530,5,5,3,6,14,16,-2,18
Chennaiyin,7530,6,4,6,4,17,20,-3,18
NorthEast Un,7530,7,4,3,7,14,16,-2,15
FC Goa,7530,8,3,4,7,10,18,-8,13
Delhi Dynamo,7531,1,6,5,3,26,17,9,23
Mumbai City,7531,2,6,4,4,16,10,6,22
Kerala Blast,7531,3,6,4,4,11,13,-2,22
NorthEast Un,7531,4,5,3,6,12,12,0,18
Chennaiyin,7531,5,4,6,4,15,18,-3,18
FC Pune City,7531,6,4,5,5,13,15,-2,17
Kolkata,7531,7,3,7,4,16,17,-1,16
FC Goa,7531,8,4,2,8,12,19,-7,14
Mumbai City,7532,1,7,4,3,19,9,10,25
Delhi Dynamo,7532,2,5,5,4,25,21,4,20
Kerala Blast,7532,3,5,5,4,11,14,-3,20
NorthEast Un,7532,4,5,3,6,11,10,1,18
Chennaiyin,7532,5,4,6,4,15,18,-3,18
Kolkata,7532,6,3,8,3,16,16,0,17
FC Pune City,7532,7,4,5,5,14,16,-2,17
FC Goa,7532,8,3,4,7,13,20,-7,13
Mumbai City,7533,1,7,4,3,18,8,10,25
Delhi Dynamo,7533,2,6,5,3,24,17,7,23
Kolkata,7533,3,4,8,2,17,15,2,20
NorthEast Un,7533,4,5,3,6,12,11,1,18
FC Pune City,7533,5,4,5,5,14,16,-2,17
Chennaiyin,7533,6,4,5,5,15,20,-5,17
Kerala Blast,7533,7,4,5,5,9,14,-5,17
FC Goa,7533,8,3,3,8,10,18,-8,12
Mumbai City,7534,1,7,4,3,17,8,9,25
Kolkata,7534,2,5,6,3,17,15,2,21
Kerala Blast,7534,3,6,3,5,13,14,-1,21
Delhi Dynamo,7534,4,5,5,4,23,17,6,20
NorthEast Un,7534,5,6,2,6,14,11,3,20
Chennaiyin,7534,6,4,5,5,16,21,-5,17
FC Pune City,7534,7,4,3,7,13,18,-5,15
FC Goa,7534,8,4,2,8,11,20,-9,14
Mumbai City,7535,1,7,4,3,18,9,9,25
Delhi Dynamo,7535,2,5,5,4,24,19,5,20
Kolkata,7535,3,4,8,2,19,15,4,20
NorthEast Un,7535,4,6,2,6,14,11,3,20
FC Pune City,7535,5,5,3,6,15,18,-3,18
Chennaiyin,7535,6,4,6,4,14,17,-3,18
Kerala Blast,7535,7,4,4,6,13,20,-7,16
FC Goa,7535,8,3,4,7,9,17,-8,13
Mumbai City,7536,1,7,4,3,18,8,10,25
Kolkata,7536,2,5,6,3,18,13,5,21
Delhi Dynamo,7536,3,4,7,3,24,19,5,19
NorthEast Un,7536,4,5,4,5,13,12,1,19
Kerala Blast,7536,5,5,4,5,12,17,-5,19
FC Pune City,7536,6,5,3,6,13,16,-3,18
Chennaiyin,7536,7,3,6,5,15,20,-5,15
FC Goa,7536,8,3,4,7,11,19,-8,13
Mumbai City,7537,1,7,4,3,19,9,10,25
Kolkata,7537,2,5,7,2,20,14,6,22
Delhi Dynamo,7537,3,4,7,3,24,19,5,19
NorthEast Un,7537,4,5,4,5,11,10,1,19
Chennaiyin,7537,5,3,7,4,14,18,-4,16
FC Pune City,7537,6,4,4,6,12,16,-4,16
Kerala Blast,7537,7,4,4,6,10,18,-8,16
FC Goa,7537,8,3,5,6,11,17,-6,14
Mumbai City,7538,1,6,4,4,17,10,7,22
Kolkata,7538,2,5,7,2,19,14,5,22
Delhi Dynamo,7538,3,5,6,3,25,18,7,21
Kerala Blast,7538,4,6,3,5,12,16,-4,21
NorthEast Un,7538,5,6,2,6,13,12,1,20
FC Pune City,7538,6,4,4,6,14,17,-3,16
Chennaiyin,7538,7,3,6,5,15,20,-5,15
FC Goa,7538,8,3,4,7,11,19,-8,13
Mumbai City,7539,1,6,5,3,17,9,8,23
Kolkata,7539,2,5,6,3,20,17,3,21
NorthEast Un,7539,3,6,2,6,14,12,2,20
Delhi Dynamo,7539,4,4,7,3,22,16,6,19
FC Goa,7539,5,5,3,6,11,15,-4,18
Chennaiyin,7539,6,4,5,5,15,19,-4,17
FC Pune City,7539,7,4,4,6,14,17,-3,16
Kerala Blast,7539,8,4,4,6,13,21,-8,16
Delhi Dynamo,7540,1,6,5,3,27,17,10,23
Mumbai City,7540,2,6,4,4,17,10,7,22
NorthEast Un,7540,3,6,3,5,13,10,3,21
Kerala Blast,7540,4,6,3,5,13,16,-3,21
Kolkata,7540,5,4,6,4,15,18,-3,18
Chennaiyin,7540,6,4,6,4,14,17,-3,18
FC Pune City,7540,7,4,3,7,14,18,-4,15
FC Goa,7540,8,4,2,8,11,18,-7,14
Mumbai City,7541,1,7,4,3,17,8,9,25
Kolkata,7541,2,5,6,3,18,14,4,21
Delhi Dynamo,7541,3,5,5,4,25,19,6,20
Kerala Blast,7541,4,5,5,4,14,17,-3,20
NorthEast Un,7541,5,5,3,6,15,15,0,18
Chennaiyin,7541,6,4,5,5,17,19,-2,17
FC Pune City,7541,7,4,4,6,16,21,-5,16
FC Goa,7541,8,4,2,8,9,18,-9,14
Mumbai City,7542,1,7,4,3,17,8,9,25
Kolkata,7542,2,6,6,2,20,14,6,24
Delhi Dynamo,7542,3,5,6,3,25,17,8,21
Chennaiyin,7542,4,4,6,4,15,18,-3,18
NorthEast Un,7542,5,4,5,5,11,11,0,17
Kerala Blast,7542,6,4,5,5,11,16,-5,17
FC Pune City,7542,7,4,4,6,12,15,-3,16
FC Goa,7542,8,3,2,9,11,23,-12,11
Mumbai City,7543,1,7,4,3,20,8,12,25
Delhi Dynamo,7543,2,5,5,4,27,22,5,20
Chennaiyin,7543,3,5,5,4,15,17,-2,20
Kolkata,7543,4,4,7,3,17,15,2,19
Kerala Blast,7543,5,5,4,5,11,16,-5,19
NorthEast Un,7543,6,5,3,6,11,11,0,18
FC Pune City,7543,7,4,4,6,12,15,-3,16
FC Goa,7543,8,4,2,8,12,21,-9,14
Mumbai City,7544,1,7,4,3,20,8,12,25
NorthEast Un,7544,2,7,2,5,17,12,5,23
Delhi Dynamo,7544,3,5,5,4,24,22,2,20
Kolkata,7544,4,4,8,2,16,14,2,20
Kerala Blast,7544,5,5,4,5,13,17,-4,19
FC Goa,7544,6,4,3,7,15,18,-3,15
FC Pune City,7544,7,4,3,7,13,17,-4,15
Chennaiyin,7544,8,3,5,6,17,27,-10,14
Delhi Dynamo,7545,1,6,5,3,25,17,8,23
Mumbai City,7545,2,6,4,4,17,10,7,22
FC Pune City,7545,3,6,3,5,15,15,0,21
Kerala Blast,7545,4,5,4,5,13,16,-3,19
Kolkata,7545,5,3,8,3,15,15,0,17
NorthEast Un,7545,6,5,2,7,12,14,-2,17
Chennaiyin,7545,7,4,5,5,16,20,-4,17
FC Goa,7545,8,4,3,7,11,17,-6,15
Mumbai City,7546,1,6,5,3,16,8,8,23
NorthEast Un,7546,2,7,2,5,16,9,7,23
Delhi Dynamo,7546,3,5,6,3,24,18,6,21
Kolkata,7546,4,5,6,3,20,16,4,21
Kerala Blast,7546,5,5,3,6,12,21,-9,18
FC Goa,7546,6,5,2,7,15,19,-4,17
FC Pune City,7546,7,4,3,7,13,17,-4,15
Chennaiyin,7546,8,3,5,6,15,23,-8,14
Delhi Dynamo,7547,1,7,5,2,27,16,11,26
Mumbai City,7547,2,6,4,4,17,10,7,22
Kerala Blast,7547,3,6,4,4,15,13,2,22
Kolkata,7547,4,5,6,3,19,21,-2,21
Chennaiyin,7547,5,4,6,4,16,19,-3,18
NorthEast Un,7547,6,4,4,6,10,11,-1,16
FC Pune City,7547,7,4,3,7,14,18,-4,15
FC Goa,7547,8,3,2,9,12,22,-10,11
Mumbai City,7548,1,7,4,3,17,8,9,25
Delhi Dynamo,7548,2,5,6,3,25,17,8,21
Kolkata,7548,3,5,6,3,19,17,2,21
Chennaiyin,7548,4,5,5,4,18,19,-1,20
Kerala Blast,7548,5,5,4,5,14,18,-4,19
FC Pune City,7548,6,4,4,6,13,17,-4,16
FC Goa,7548,7,4,3,7,13,19,-6,15
NorthEast Un,7548,8,4,2,8,14,18,-4,14
Delhi Dynamo,7549,1,6,6,2,27,16,11,24
Mumbai City,7549,2,6,5,3,17,9,8,23
Kolkata,7549,3,4,8,2,15,13,2,20
NorthEast Un,7549,4,5,3,6,12,12,0,18
Chennaiyin,7549,5,4,6,4,16,18,-2,18
FC Pune City,7549,6,4,5,5,14,16,-2,17
Kerala Blast,7549,7,4,4,6,10,16,-6,16
FC Goa,7549,8,3,3,8,8,19,-11,12
Delhi Dynamo,7550,1,5,7,2,24,15,9,22
Mumbai City,7550,2,6,4,4,16,10,6,22
Kolkata,7550,3,5,7,2,15,12,3,22
NorthEast Un,7550,4,6,3,5,14,12,2,21
Kerala Blast,7550,5,5,3,6,13,17,-4,18
Chennaiyin,7550,6,4,5,5,17,20,-3,17
FC Pune City,7550,7,4,3,7,12,17,-5,15
FC Goa,7550,8,3,4,7,10,18,-8,13
Delhi Dynamo,7551,1,7,5,2,25,15,10,26
Mumbai City,7551,2,6,4,4,17,10,7,22
Kolkata,7551,3,5,6,3,17,17,0,21
Kerala Blast,7551,4,5,4,5,12,16,-4,19
FC Pune City,7551,5,4,4,6,12,15,-3,16
Chennaiyin,7551,6,3,7,4,14,18,-4,16
NorthEast Un,7551,7,4,3,7,10,12,-2,15
FC Goa,7551,8,4,3,7,11,15,-4,15
Mumbai City,7552,1,7,4,3,19,9,10,25
Kerala Blast,7552,2,7,3,4,13,13,0,24
Kolkata,7552,3,4,7,3,15,15,0,19
Delhi Dynamo,7552,4,4,6,4,24,21,3,18
Chennaiyin,7552,5,4,6,4,14,17,-3,18
NorthEast Un,7552,6,5,2,7,12,12,0,17
FC Pune City,7552,7,4,3,7,12,16,-4,15
FC Goa,7552,8,3,5,6,10,16,-6,14
Mumbai City,7553,1,7,4,3,18,8,10,25
NorthEast Un,7553,2,6,3,5,13,11,2,21
Kerala Blast,7553,3,6,3,5,15,16,-1,21
Delhi Dynamo,7553,4,5,5,4,24,19,5,20
Kolkata,7553,5,4,6,4,14,16,-2,18
Chennaiyin,7553,6,3,7,4,15,19,-4,16
FC Goa,7553,7,4,3,7,13,18,-5,15
FC Pune City,7553,7,4,3,7,13,18,-5,15
Mumbai City,7554,1,7,4,3,18,8,10,25
Delhi Dynamo,7554,2,5,6,3,26,18,8,21
NorthEast Un,7554,3,6,3,5,16,11,5,21
Kerala Blast,7554,4,5,4,5,10,15,-5,19
Kolkata,7554,5,4,6,4,16,16,0,18
FC Goa,7554,6,5,2,7,13,19,-6,17
FC Pune City,7554,7,4,4,6,12,16,-4,16
Chennaiyin,7554,8,3,5,6,14,22,-8,14
Delhi Dynamo,7555,1,6,5,3,28,18,10,23
NorthEast Un,7555,2,7,2,5,16,12,4,23
Mumbai City,7555,3,6,4,4,17,10,7,22
Kolkata,7555,4,4,7,3,17,16,1,19
FC Pune City,7555,5,5,3,6,15,17,-2,18
FC Goa,7555,6,5,2,7,14,19,-5,17
Kerala Blast,7555,7,4,4,6,13,19,-6,16
Chennaiyin,7555,8,3,5,6,13,22,-9,14
Mumbai City,7556,1,6,4,4,17,10,7,22
Delhi Dynamo,7556,2,5,6,3,23,17,6,21
NorthEast Un,7556,3,6,3,5,16,13,3,21
Kerala Blast,7556,4,6,3,5,14,17,-3,21
FC Pune City,7556,5,5,3,6,14,15,-1,18
FC Goa,7556,6,5,3,6,14,17,-3,18
Kolkata,7556,7,3,6,5,17,21,-4,15
Chennaiyin,7556,8,3,6,5,15,20,-5,15
Mumbai City,7557,1,7,4,3,18,8,10,25
NorthEast Un,7557,2,6,3,5,14,9,5,21
Kolkata,7557,3,5,6,3,19,17,2,21
Delhi Dynamo,7557,4,5,5,4,23,20,3,20
Kerala Blast,7557,5,4,5,5,10,15,-5,17
FC Pune City,7557,6,4,4,6,14,17,-3,16
Chennaiyin,7557,7,3,6,5,14,19,-5,15
FC Goa,7557,8,4,3,7,11,18,-7,15
Kolkata,7558,1,6,6,2,18,13,5,24
Mumbai City,7558,2,6,5,3,17,9,8,23
Delhi Dynamo,7558,3,5,6,3,24,18,6,21
NorthEast Un,7558,4,6,2,6,12,12,0,20
Chennaiyin,7558,5,4,5,5,16,18,-2,17
FC Pune City,7558,6,4,4,6,13,16,-3,16
Kerala Blast,7558,7,4,4,6,9,15,-6,16
FC Goa,7558,8,4,2,8,10,18,-8,14
Mumbai City,7559,1,6,5,3,17,9,8,23
Delhi Dynamo,7559,2,5,6,3,25,19,6,21
Kolkata,7559,3,5,6,3,16,13,3,21
Kerala Blast,7559,4,5,4,5,11,16,-5,19
NorthEast Un,7559,5,5,3,6,12,12,0,18
FC Pune City,7559,6,5,3,6,14,16,-2,18
Chennaiyin,7559,7,4,5,5,15,18,-3,17
FC Goa,7559,8,4,2,8,10,17,-7,14
Delhi Dynamo,7560,1,6,6,2,30,18,12,24
Mumbai City,7560,2,6,5,3,19,11,8,23
NorthEast Un,7560,3,6,2,6,13,13,0,20
Kolkata,7560,4,4,7,3,18,17,1,19
Kerala Blast,7560,5,5,3,6,12,17,-5,18
Chennaiyin,7560,6,4,5,5,14,18,-4,17
FC Pune City,7560,7,4,4,6,13,16,-3,16
FC Goa,7560,8,4,2,8,11,20,-9,14
Mumbai City,7561,1,7,4,3,18,9,9,25
Delhi Dynamo,7561,2,6,5,3,29,17,12,23
Kolkata,7561,3,4,8,2,15,13,2,20
Kerala Blast,7561,4,5,4,5,11,14,-3,19
Chennaiyin,7561,5,3,7,4,13,17,-4,16
FC Pune City,7561,6,4,4,6,12,16,-4,16
NorthEast Un,7561,7,4,4,6,9,14,-5,16
FC Goa,7561,8,3,4,7,10,17,-7,13
Mumbai City,7562,1,7,4,3,19,8,11,25
NorthEast Un,7562,2,6,3,5,18,11,7,21
Kolkata,7562,3,4,8,2,18,13,5,20
Delhi Dynamo,7562,4,5,5,4,24,20,4,20
FC Pune City,7562,5,4,5,5,14,16,-2,17
Kerala Blast,7562,6,4,5,5,12,20,-8,17
FC Goa,7562,7,4,3,7,10,17,-7,15
Chennaiyin,7562,8,3,5,6,13,23,-10,14
Delhi Dynamo,7563,1,6,6,2,26,16,10,24
Kerala Blast,7563,2,7,3,4,18,16,2,24
Mumbai City,7563,3,6,4,4,17,10,7,22
Kolkata,7563,4,4,7,3,15,16,-1,19
Chennaiyin,7563,5,4,6,4,15,18,-3,18
FC Pune City,7563,6,4,4,6,14,17,-3,16
NorthEast Un,7563,7,4,3,7,12,15,-3,15
FC Goa,7563,8,3,3,8,9,18,-9,12
Delhi Dynamo,7564,1,6,6,2,25,15,10,24
Mumbai City,7564,2,6,5,3,17,9,8,23
Kolkata,7564,3,4,8,2,17,14,3,20
FC Pune City,7564,4,5,4,5,14,14,0,19
Kerala Blast,7564,5,5,3,6,12,19,-7,18
Chennaiyin,7564,6,4,5,5,18,20,-2,17
FC Goa,7564,7,4,3,7,11,18,-7,15
NorthEast Un,7564,8,4,2,8,9,14,-5,14
Mumbai City,7565,1,6,5,3,16,8,8,23
NorthEast Un,7565,2,6,3,5,12,10,2,21
Delhi Dynamo,7565,3,4,7,3,23,17,6,19
FC Pune City,7565,4,5,4,5,15,16,-1,19
Kolkata,7565,5,4,6,4,17,16,1,18
Kerala Blast,7565,6,4,5,5,10,17,-7,17
FC Goa,7565,7,4,4,6,13,17,-4,16
Chennaiyin,7565,8,3,6,5,15,20,-5,15
Mumbai City,7566,1,7,4,3,18,8,10,25
Kolkata,7566,2,6,6,2,21,14,7,24
Delhi Dynamo,7566,3,4,7,3,23,18,5,19
Kerala Blast,7566,4,5,4,5,10,15,-5,19
Chennaiyin,7566,5,4,6,4,15,17,-2,18
NorthEast Un,7566,6,4,4,6,10,12,-2,16
FC Pune City,7566,7,4,3,7,13,18,-5,15
FC Goa,7566,8,3,4,7,10,18,-8,13
Mumbai City,7567,1,7,4,3,19,9,10,25
Kerala Blast,7567,2,6,4,4,15,15,0,22
Delhi Dynamo,7567,3,4,7,3,24,19,5,19
FC Pune City,7567,4,5,4,5,14,15,-1,19
NorthEast Un,7567,5,5,3,6,14,12,2,18
Kolkata,7567,6,3,7,4,15,18,-3,16
FC Goa,7567,7,4,4,6,12,16,-4,16
Chennaiyin,7567,8,3,5,6,14,23,-9,14
Mumbai City,7568,1,7,4,3,19,8,11,25
Kolkata,7568,2,4,7,3,19,17,2,19
NorthEast Un,7568,3,5,4,5,10,9,1,19
Delhi Dynamo,7568,4,4,6,4,22,19,3,18
FC Pune City,7568,5,5,3,6,15,18,-3,18
Kerala Blast,7568,6,5,3,6,13,18,-5,18
Chennaiyin,7568,7,3,7,4,14,18,-4,16
FC Goa,7568,8,4,4,6,12,17,-5,16
Delhi Dynamo,7569,1,6,5,3,27,17,10,23
Mumbai City,7569,2,6,4,4,16,10,6,22
Kerala Blast,7569,3,6,3,5,11,15,-4,21
Kolkata,7569,4,4,6,4,18,15,3,18
FC Pune City,7569,5,5,3,6,14,16,-2,18
NorthEast Un,7569,6,5,2,7,11,12,-1,17
Chennaiyin,7569,7,4,5,5,14,18,-4,17
FC Goa,7569,8,5,2,7,12,20,-8,17
Mumbai City,7570,1,7,4,3,18,9,9,25
NorthEast Un,7570,2,6,2,6,14,11,3,20
Kolkata,7570,3,4,7,3,16,16,0,19
Delhi Dynamo,7570,4,4,6,4,24,20,4,18
FC Goa,7570,5,5,3,6,16,18,-2,18
Chennaiyin,7570,6,4,5,5,16,20,-4,17
Kerala Blast,7570,7,4,5,5,10,16,-6,17
FC Pune City,7570,8,4,4,6,13,17,-4,16
Delhi Dynamo,7571,1,7,5,2,27,15,12,26
Mumbai City,7571,2,6,4,4,17,10,7,22
Kolkata,7571,3,4,7,3,16,15,1,19
FC Pune City,7571,4,5,4,5,15,14,1,19
NorthEast Un,7571,5,5,3,6,12,12,0,18
Kerala Blast,7571,6,4,4,6,10,18,-8,16
Chennaiyin,7571,7,3,6,5,16,21,-5,15
FC Goa,7571,8,4,3,7,11,19,-8,15
Kolkata,7572,1,6,6,2,19,13,6,24
Mumbai City,7572,2,6,5,3,18,10,8,23
Delhi Dynamo,7572,3,5,7,2,26,16,10,22
Kerala Blast,7572,4,6,3,5,15,18,-3,21
Chennaiyin,7572,5,4,6,4,14,17,-3,18
FC Pune City,7572,6,4,3,7,14,19,-5,15
NorthEast Un,7572,7,4,2,8,11,16,-5,14
FC Goa,7572,8,3,4,7,8,16,-8,13
Delhi Dynamo,7573,1,5,7,2,25,17,8,22
Mumbai City,7573,2,6,4,4,17,10,7,22
Kerala Blast,7573,3,5,5,4,11,14,-3,20
FC Pune City,7573,4,5,4,5,16,16,0,19
Chennaiyin,7573,5,4,6,4,14,17,-3,18
NorthEast Un,7573,6,4,5,5,10,10,0,17
Kolkata,7573,7,3,6,5,14,17,-3,15
FC Goa,7573,8,4,3,7,10,16,-6,15
Mumbai City,7574,1,6,5,3,17,9,8,23
Kerala Blast,7574,2,6,4,4,14,13,1,22
Chennaiyin,7574,3,5,5,4,17,19,-2,20
Delhi Dynamo,7574,4,4,7,3,23,17,6,19
NorthEast Un,7574,5,5,3,6,11,11,0,18
Kolkata,7574,6,4,6,4,16,18,-2,18
FC Goa,7574,7,4,3,7,14,19,-5,15
FC Pune City,7574,8,4,3,7,12,18,-6,15
Mumbai City,7575,1,6,5,3,17,9,8,23
Delhi Dynamo,7575,2,5,7,2,29,19,10,22
Kolkata,7575,3,4,8,2,15,13,2,20
Chennaiyin,7575,4,5,5,4,17,18,-1,20
FC Pune City,7575,5,5,4,5,14,14,0,19
NorthEast Un,7575,6,5,3,6,15,15,0,18
Kerala Blast,7575,7,4,3,7,10,18,-8,15
FC Goa,7575,8,3,3,8,10,21,-11,12
Mumbai City,7576,1,7,4,3,18,8,10,25
FC Pune City,7576,2,6,3,5,16,14,2,21
NorthEast Un,7576,3,5,3,6,11,11,0,18
FC Goa,7576,4,5,3,6,16,17,-1,18
Delhi Dynamo,7576,5,4,5,5,23,20,3,17
Kolkata,7576,6,3,8,3,14,14,0,17
Chennaiyin,7576,7,4,5,5,15,22,-7,17
Kerala Blast,7576,8,4,5,5,9,16,-7,17
Mumbai City,7577,1,6,5,3,16,8,8,23
Delhi Dynamo,7577,2,5,6,3,24,19,5,21
Kerala Blast,7577,3,6,3,5,12,15,-3,21
NorthEast Un,7577,4,5,3,6,12,12,0,18
FC Goa,7577,5,5,3,6,15,16,-1,18
Kolkata,7577,6,3,7,4,15,17,-2,16
FC Pune City,7577,7,4,4,6,13,16,-3,16
Chennaiyin,7577,8,3,7,4,15,19,-4,16
Mumbai City,7578,1,7,4,3,17,8,9,25
Kolkata,7578,2,6,6,2,22,15,7,24
Delhi Dynamo,7578,3,6,5,3,26,15,11,23
NorthEast Un,7578,4,6,2,6,13,14,-1,20
Kerala Blast,7578,5,5,3,6,11,17,-6,18
FC Pune City,7578,6,4,3,7,14,19,-5,15
FC Goa,7578,7,4,2,8,11,18,-7,14
Chennaiyin,7578,8,3,5,6,14,22,-8,14
Mumbai City,7579,1,6,5,3,16,8,8,23
Delhi Dynamo,7579,2,5,7,2,26,18,8,22
Chennaiyin,7579,3,5,5,4,16,17,-1,20
NorthEast Un,7579,4,5,3,6,13,11,2,18
Kolkata,7579,5,3,8,3,15,15,0,17
FC Pune City,7579,6,4,5,5,14,16,-2,17
Kerala Blast,7579,7,4,5,5,11,18,-7,17
FC Goa,7579,8,4,2,8,12,20,-8,14
Delhi Dynamo,7580,1,6,6,2,25,16,9,24
Mumbai City,7580,2,6,4,4,17,10,7,22
Kolkata,7580,3,5,6,3,18,16,2,21
Kerala Blast,7580,4,6,3,5,14,17,-3,21
NorthEast Un,7580,5,5,4,5,14,13,1,19
FC Pune City,7580,6,4,3,7,13,17,-4,15
Chennaiyin,7580,7,3,6,5,17,22,-5,15
FC Goa,7580,8,4,2,8,11,18,-7,14
Mumbai City,7581,1,7,4,3,19,9,10,25
Delhi Dynamo,7581,2,5,6,3,24,18,6,21
Kerala Blast,7581,3,6,3,5,13,16,-3,21
Chennaiyin,7581,4,5,5,4,16,17,-1,20
Kolkata,7581,5,4,7,3,18,17,1,19
FC Pune City,7581,6,4,4,6,13,16,-3,16
NorthEast Un,7581,7,4,3,7,10,14,-4,15
FC Goa,7581,8,4,2,8,12,18,-6,14
Mumbai City,7582,1,6,5,3,17,9,8,23
Kolkata,7582,2,5,7,2,20,16,4,22
Delhi Dynamo,7582,3,5,6,3,25,17,8,21
Chennaiyin,7582,4,5,5,4,20,18,2,20
FC Pune City,7582,5,5,3,6,16,17,-1,18
Kerala Blast,7582,6,5,3,6,11,18,-7,18
FC Goa,7582,7,4,3,7,12,19,-7,15
NorthEast Un,7582,8,4,2,8,9,16,-7,14
Mumbai City,7583,1,7,4,3,18,8,10,25
Delhi Dynamo,7583,2,5,5,4,25,19,6,20
FC Goa,7583,3,6,2,6,15,17,-2,20
Kerala Blast,7583,4,5,4,5,11,15,-4,19
Kolkata,7583,5,4,6,4,17,16,1,18
FC Pune City,7583,6,5,3,6,14,17,-3,18
NorthEast Un,7583,7,4,4,6,11,13,-2,16
Chennaiyin,7583,8,3,6,5,14,20,-6,15
Mumbai City,7584,1,6,4,4,17,10,7,22
Delhi Dynamo,7584,2,5,6,3,24,17,7,21
Kolkata,7584,3,4,8,2,17,14,3,20
Kerala Blast,7584,4,5,5,4,14,17,-3,20
NorthEast Un,7584,5,5,2,7,14,15,-1,17
Chennaiyin,7584,6,4,5,5,15,21,-6,17
FC Goa,7584,7,4,4,6,11,14,-3,16
FC Pune City,7584,8,4,4,6,14,18,-4,16
Mumbai City,7585,1,7,4,3,18,9,9,25
Kolkata,7585,2,6,6,2,22,15,7,24
Delhi Dynamo,7585,3,5,5,4,25,17,8,20
NorthEast Un,7585,4,6,2,6,11,11,0,20
FC Pune City,7585,5,5,3,6,14,15,-1,18
Chennaiyin,7585,6,4,5,5,16,19,-3,17
Kerala Blast,7585,7,4,3,7,11,20,-9,15
FC Goa,7585,8,4,2,8,11,22,-11,14
Mumbai City,7586,1,7,4,3,24,12,12,25
Kerala Blast,7586,2,6,3,5,14,15,-1,21
Delhi Dynamo,7586,3,5,5,4,30,25,5,20
Kolkata,7586,4,4,8,2,16,14,2,20
Chennaiyin,7586,5,5,5,4,16,18,-2,20
NorthEast Un,7586,6,5,2,7,12,14,-2,17
FC Pune City,7586,7,4,4,6,14,18,-4,16
FC Goa,7586,8,3,3,8,10,20,-10,12
Delhi Dynamo,7587,1,6,5,3,25,16,9,23
Mumbai City,7587,2,6,4,4,16,9,7,22
Kerala Blast,7587,3,5,4,5,15,17,-2,19
Kolkata,7587,3,4,7,3,15,17,-2,19
Chennaiyin,7587,5,4,6,4,16,19,-3,18
FC Pune City,7587,6,4,5,5,14,16,-2,17
NorthEast Un,7587,7,5,2,7,12,15,-3,17
FC Goa,7587,8,4,3,7,13,17,-4,15
Mumbai City,7588,1,7,4,3,18,9,9,25
Kolkata,7588,2,4,8,2,20,16,4,20
Chennaiyin,7588,3,5,5,4,18,17,1,20
Kerala Blast,7588,4,5,5,4,12,15,-3,20
Delhi Dynamo,7588,5,4,7,3,24,18,6,19
NorthEast Un,7588,6,4,4,6,9,12,-3,16
FC Pune City,7588,7,4,3,7,12,18,-6,15
FC Goa,7588,8,3,4,7,12,20,-8,13
Delhi Dynamo,7589,1,7,5,2,25,15,10,26
Mumbai City,7589,2,6,4,4,16,9,7,22
FC Pune City,7589,3,6,3,5,17,15,2,21
Kolkata,7589,4,4,7,3,15,14,1,19
NorthEast Un,7589,5,5,3,6,15,14,1,18
Kerala Blast,7589,6,4,4,6,12,20,-8,16
FC Goa,7589,7,4,3,7,10,15,-5,15
Chennaiyin,7589,8,3,5,6,14,22,-8,14
Mumbai City,7590,1,7,4,3,18,8,10,25
Delhi Dynamo,7590,2,6,5,3,26,19,7,23
Kolkata,7590,3,5,6,3,20,16,4,21
Chennaiyin,7590,4,5,5,4,20,18,2,20
Kerala Blast,7590,5,5,4,5,17,20,-3,19
NorthEast Un,7590,6,5,2,7,13,16,-3,17
FC Pune City,7590,7,4,4,6,15,18,-3,16
FC Goa,7590,8,3,2,9,10,24,-14,11
Mumbai City,7591,1,7,4,3,17,8,9,25
NorthEast Un,7591,2,7,2,5,14,11,3,23
Kolkata,7591,3,4,8,2,16,14,2,20
Delhi Dynamo,7591,4,4,5,5,22,18,4,17
FC Pune City,7591,5,4,5,5,14,16,-2,17
Chennaiyin,7591,6,4,5,5,15,19,-4,17
Kerala Blast,7591,7,4,4,6,12,18,-6,16
FC Goa,7591,8,4,3,7,12,18,-6,15
Mumbai City,7592,1,6,5,3,19,11,8,23
Kolkata,7592,2,5,7,2,19,16,3,22
Chennaiyin,7592,3,5,5,4,19,20,-1,20
Delhi Dynamo,7592,4,4,7,3,25,21,4,19
NorthEast Un,7592,5,5,3,6,13,11,2,18
FC Pune City,7592,6,5,3,6,14,16,-2,18
Kerala Blast,7592,7,4,5,5,12,17,-5,17
FC Goa,7592,8,3,3,8,13,22,-9,12
Mumbai City,7593,1,6,5,3,17,9,8,23
Kolkata,7593,2,4,8,2,17,14,3,20
Delhi Dynamo,7593,3,4,7,3,25,19,6,19
FC Pune City,7593,4,5,4,5,13,14,-1,19
NorthEast Un,7593,5,5,3,6,12,13,-1,18
Kerala Blast,7593,6,5,3,6,12,17,-5,18
FC Goa,7593,7,4,4,6,15,19,-4,16
Chennaiyin,7593,8,3,6,5,14,20,-6,15
Mumbai City,7594,1,6,5,3,16,8,8,23
Delhi Dynamo,7594,2,4,8,2,23,16,7,20
Kolkata,7594,3,4,8,2,19,17,2,20
NorthEast Un,7594,4,5,4,5,14,12,2,19
Kerala Blast,7594,5,5,4,5,14,18,-4,19
Chennaiyin,7594,6,4,6,4,17,18,-1,18
FC Pune City,7594,7,4,4,6,16,20,-4,16
FC Goa,7594,8,3,3,8,10,20,-10,12
Mumbai City,7595,1,7,4,3,18,9,9,25
Kerala Blast,7595,2,6,3,5,13,16,-3,21
Delhi Dynamo,7595,3,5,5,4,27,20,7,20
NorthEast Un,7595,4,6,2,6,15,13,2,20
Kolkata,7595,5,4,7,3,18,17,1,19
FC Goa,7595,6,5,2,7,12,18,-6,17
FC Pune City,7595,7,4,4,6,14,18,-4,16
Chennaiyin,7595,8,3,5,6,13,19,-6,14
Mumbai City,7596,1,7,4,3,17,8,9,25
Kolkata,7596,2,5,7,2,20,13,7,22
NorthEast Un,7596,3,6,3,5,12,10,2,21
Delhi Dynamo,7596,4,4,7,3,21,15,6,19
FC Pune City,7596,5,5,3,6,14,18,-4,18
FC Goa,7596,6,4,4,6,10,15,-5,16
Kerala Blast,7596,7,4,3,7,10,19,-9,15
Chennaiyin,7596,8,3,5,6,13,19,-6,14
Mumbai City,7597,1,7,4,3,19,9,10,25
Kolkata,7597,2,5,7,2,20,15,5,22
Delhi Dynamo,7597,3,5,5,4,25,19,6,20
Kerala Blast,7597,4,5,5,4,15,17,-2,20
NorthEast Un,7597,5,5,3,6,13,13,0,18
Chennaiyin,7597,6,4,5,5,14,18,-4,17
FC Pune City,7597,7,4,3,7,12,19,-7,15
FC Goa,7597,8,4,2,8,10,18,-8,14
Delhi Dynamo,7598,1,6,5,3,26,17,9,23
Mumbai City,7598,2,6,4,4,16,9,7,22
Kolkata,7598,3,4,7,3,17,16,1,19
FC Pune City,7598,4,5,4,5,14,14,0,19
Kerala Blast,7598,5,5,4,5,12,16,-4,19
NorthEast Un,7598,6,5,3,6,11,12,-1,18
Chennaiyin,7598,7,4,6,4,16,19,-3,18
FC Goa,7598,8,3,3,8,12,21,-9,12
Mumbai City,7599,1,7,4,3,18,8,10,25
Delhi Dynamo,7599,2,5,6,3,26,19,7,21
Kolkata,7599,3,5,6,3,18,15,3,21
FC Pune City,7599,4,5,4,5,16,17,-1,19
NorthEast Un,7599,5,5,3,6,15,15,0,18
Chennaiyin,7599,6,4,5,5,16,21,-5,17
Kerala Blast,7599,7,4,4,6,12,19,-7,16
FC Goa,7599,8,4,2,8,12,19,-7,14
Mumbai City,7600,1,7,4,3,18,8,10,25
Delhi Dynamo,7600,2,5,6,3,27,21,6,21
Kerala Blast,7600,3,5,5,4,11,14,-3,20
FC Pune City,7600,4,5,4,5,16,15,1,19
NorthEast Un,7600,5,5,2,7,12,13,-1,17
Kolkata,7600,6,3,7,4,16,19,-3,16
FC Goa,7600,7,4,4,6,15,20,-5,16
Chennaiyin,7600,8,3,6,5,13,18,-5,15
Mumbai City,7601,1,7,4,3,18,9,9,25
Delhi Dynamo,7601,2,5,5,4,27,19,8,20
Chennaiyin,7601,3,5,5,4,17,17,0,20
Kolkata,7601,4,3,9,2,20,19,1,18
FC Pune City,7601,5,4,5,5,16,18,-2,17
NorthEast Un,7601,6,5,2,7,11,15,-4,17
Kerala Blast,7601,7,4,5,5,14,19,-5,17
FC Goa,7601,8,4,3,7,12,19,-7,15
Delhi Dynamo,7602,1,6,5,3,26,18,8,23
Mumbai City,7602,2,6,4,4,17,10,7,22
FC Pune City,7602,3,6,3,5,16,16,0,21
NorthEast Un,7602,4,6,2,6,13,10,3,20
FC Goa,7602,5,6,2,6,15,16,-1,20
Kolkata,7602,6,3,7,4,15,17,-2,16
Kerala Blast,7602,7,4,4,6,11,19,-8,16
Chennaiyin,7602,8,3,5,6,13,20,-7,14
Mumbai City,7603,1,6,5,3,16,8,8,23
Delhi Dynamo,7603,2,5,6,3,24,15,9,21
Kerala Blast,7603,3,6,3,5,14,19,-5,21
Kolkata,7603,4,4,8,2,20,16,4,20
NorthEast Un,7603,5,5,3,6,11,11,0,18
Chennaiyin,7603,6,4,6,4,14,17,-3,18
FC Pune City,7603,7,4,4,6,14,17,-3,16
FC Goa,7603,8,3,3,8,10,20,-10,12
Mumbai City,7604,1,7,4,3,18,9,9,25
Delhi Dynamo,7604,2,5,6,3,25,16,9,21
Kolkata,7604,3,5,6,3,18,17,1,21
FC Pune City,7604,4,5,3,6,15,17,-2,18
NorthEast Un,7604,5,4,4,6,10,13,-3,16
Chennaiyin,7604,6,3,7,4,14,18,-4,16
FC Goa,7604,7,4,4,6,10,14,-4,16
Kerala Blast,7604,8,4,4,6,10,16,-6,16
Mumbai City,7605,1,7,4,3,18,9,9,25
Delhi Dynamo,7605,2,5,6,3,28,18,10,21
Kolkata,7605,3,5,6,3,19,14,5,21
FC Pune City,7605,4,5,3,6,14,17,-3,18
NorthEast Un,7605,5,4,5,5,13,13,0,17
FC Goa,7605,6,5,2,7,10,18,-8,17
Kerala Blast,7605,7,4,4,6,10,18,-8,16
Chennaiyin,7605,8,3,6,5,14,19,-5,15
Mumbai City,7606,1,7,4,3,19,9,10,25
Delhi Dynamo,7606,2,5,6,3,26,18,8,21
Chennaiyin,7606,3,5,5,4,17,19,-2,20
Kolkata,7606,4,4,7,3,14,15,-1,19
Kerala Blast,7606,5,5,4,5,13,16,-3,19
NorthEast Un,7606,6,5,3,6,13,13,0,18
FC Pune City,7606,7,5,3,6,16,17,-1,18
FC Goa,7606,8,3,2,9,9,20,-11,11
Mumbai City,7607,1,6,5,3,17,9,8,23
Delhi Dynamo,7607,2,5,6,3,25,18,7,21
Kolkata,7607,3,4,8,2,18,16,2,20
FC Pune City,7607,4,5,4,5,17,17,0,19
FC Goa,7607,5,5,3,6,13,16,-3,18
Kerala Blast,7607,6,5,3,6,13,19,-6,18
Chennaiyin,7607,7,4,5,5,16,19,-3,17
NorthEast Un,7607,8,4,2,8,11,16,-5,14
Mumbai City,7608,1,7,4,3,19,10,9,25
NorthEast Un,7608,2,7,2,5,16,10,6,23
FC Pune City,7608,3,6,3,5,16,14,2,21
Delhi Dynamo,7608,4,5,5,4,24,20,4,20
Kolkata,7608,5,4,7,3,16,16,0,19
Kerala Blast,7608,6,4,4,6,10,18,-8,16
Chennaiyin,7608,7,3,6,5,15,20,-5,15
FC Goa,7608,8,3,3,8,10,18,-8,12
Mumbai City,7609,1,7,4,3,18,9,9,25
Delhi Dynamo,7609,2,5,5,4,23,17,6,20
Kerala Blast,7609,3,5,5,4,13,16,-3,20
Kolkata,7609,4,4,7,3,16,14,2,19
FC Goa,7609,5,5,3,6,12,16,-4,18
Chennaiyin,7609,6,3,7,4,15,19,-4,16
FC Pune City,7609,7,4,4,6,13,17,-4,16
NorthEast Un,7609,8,4,3,7,12,14,-2,15
Delhi Dynamo,7610,1,6,6,2,25,15,10,24
Mumbai City,7610,2,6,4,4,16,10,6,22
Kolkata,7610,3,4,8,2,18,13,5,20
Kerala Blast,7610,4,5,5,4,12,14,-2,20
Chennaiyin,7610,5,4,6,4,18,20,-2,18
NorthEast Un,7610,6,4,4,6,12,14,-2,16
FC Pune City,7610,7,4,3,7,12,20,-8,15
FC Goa,7610,8,3,4,7,11,18,-7,13
Kolkata,7611,1,6,6,2,21,14,7,24
Mumbai City,7611,2,6,5,3,17,9,8,23
Delhi Dynamo,7611,3,5,7,2,25,15,10,22
NorthEast Un,7611,4,5,3,6,12,14,-2,18
Kerala Blast,7611,5,4,5,5,12,18,-6,17
FC Pune City,7611,6,4,4,6,14,19,-5,16
Chennaiyin,7611,7,3,6,5,13,18,-5,15
FC Goa,7611,8,3,4,7,9,16,-7,13
Delhi Dynamo,7612,1,6,6,2,26,17,9,24
Mumbai City,7612,2,6,5,3,17,9,8,23
FC Pune City,7612,3,6,3,5,18,16,2,21
Chennaiyin,7612,4,5,5,4,19,18,1,20
Kerala Blast,7612,5,5,4,5,14,19,-5,19
Kolkata,7612,6,4,6,4,16,16,0,18
NorthEast Un,7612,7,4,3,7,12,16,-4,15
FC Goa,7612,8,3,2,9,9,20,-11,11
Mumbai City,7613,1,6,5,3,16,8,8,23
Delhi Dynamo,7613,2,5,7,2,26,16,10,22
Kolkata,7613,3,4,8,2,18,13,5,20
Chennaiyin,7613,4,5,5,4,19,19,0,20
Kerala Blast,7613,5,5,3,6,12,20,-8,18
NorthEast Un,7613,6,5,2,7,14,17,-3,17
FC Pune City,7613,7,4,4,6,13,17,-4,16
FC Goa,7613,8,3,4,7,10,18,-8,13
Delhi Dynamo,7614,1,7,5,2,25,14,11,26
Mumbai City,7614,2,6,4,4,16,9,7,22
Kolkata,7614,3,5,6,3,17,14,3,21
NorthEast Un,7614,4,5,3,6,10,10,0,18
Chennaiyin,7614,5,4,5,5,16,20,-4,17
Kerala Blast,7614,6,4,5,5,9,14,-5,17
FC Pune City,7614,7,4,4,6,13,17,-4,16
FC Goa,7614,8,4,2,8,11,19,-8,14
Mumbai City,7615,1,7,4,3,17,8,9,25
Delhi Dynamo,7615,2,5,6,3,25,17,8,21
Kerala Blast,7615,3,5,5,4,15,17,-2,20
Kolkata,7615,4,4,7,3,18,16,2,19
NorthEast Un,7615,5,5,4,5,13,11,2,19
Chennaiyin,7615,6,4,5,5,16,21,-5,17
FC Pune City,7615,7,4,4,6,14,19,-5,16
FC Goa,7615,8,3,3,8,12,21,-9,12
Mumbai City,7616,1,7,4,3,18,8,10,25
NorthEast Un,7616,2,6,3,5,16,13,3,21
Kolkata,7616,3,4,8,2,16,13,3,20
Delhi Dynamo,7616,4,4,7,3,26,21,5,19
Kerala Blast,7616,5,5,4,5,12,15,-3,19
Chennaiyin,7616,6,4,5,5,14,18,-4,17
FC Pune City,7616,7,4,4,6,13,18,-5,16
FC Goa,7616,8,3,3,8,9,18,-9,12
Mumbai City,7617,1,6,5,3,16,8,8,23
Delhi Dynamo,7617,2,5,7,2,29,16,13,22
Kolkata,7617,3,5,7,2,17,14,3,22
Kerala Blast,7617,4,6,3,5,14,15,-1,21
Chennaiyin,7617,5,4,5,5,15,20,-5,17
NorthEast Un,7617,6,4,3,7,12,15,-3,15
FC Pune City,7617,7,4,3,7,13,18,-5,15
FC Goa,7617,8,4,3,7,10,20,-10,15
Mumbai City,7618,1,7,4,3,18,9,9,25
Delhi Dynamo,7618,2,6,5,3,25,17,8,23
Kolkata,7618,3,4,7,3,17,18,-1,19
NorthEast Un,7618,4,5,3,6,12,11,1,18
Kerala Blast,7618,5,5,3,6,13,19,-6,18
Chennaiyin,7618,6,3,7,4,14,18,-4,16
FC Pune City,7618,7,4,4,6,13,17,-4,16
FC Goa,7618,8,4,3,7,14,17,-3,15
Delhi Dynamo,7619,1,6,5,3,25,15,10,23
Mumbai City,7619,2,6,4,4,16,10,6,22
NorthEast Un,7619,3,6,2,6,11,10,1,20
Kolkata,7619,4,4,7,3,17,18,-1,19
FC Pune City,7619,5,5,4,5,16,17,-1,19
Kerala Blast,7619,6,5,3,6,13,18,-5,18
FC Goa,7619,7,5,2,7,13,17,-4,17
Chennaiyin,7619,8,3,5,6,13,19,-6,14
Mumbai City,7620,1,7,4,3,19,9,10,25
NorthEast Un,7620,2,7,2,5,12,9,3,23
Kolkata,7620,3,4,7,3,16,16,0,19
Delhi Dynamo,7620,4,4,6,4,23,19,4,18
FC Goa,7620,5,5,3,6,13,16,-3,18
Kerala Blast,7620,6,5,3,6,12,17,-5,18
FC Pune City,7620,7,4,4,6,14,17,-3,16
Chennaiyin,7620,8,3,5,6,14,20,-6,14
Mumbai City,7621,1,7,4,3,20,9,11,25
Kolkata,7621,2,4,8,2,15,13,2,20
Kerala Blast,7621,3,5,5,4,15,14,1,20
Delhi Dynamo,7621,4,4,7,3,24,20,4,19
Chennaiyin,7621,5,4,6,4,15,18,-3,18
NorthEast Un,7621,6,4,4,6,12,13,-1,16
FC Pune City,7621,7,4,3,7,13,21,-8,15
FC Goa,7621,8,3,5,6,9,15,-6,14
Mumbai City,7622,1,7,4,3,18,9,9,25
Delhi Dynamo,7622,2,6,5,3,26,16,10,23
NorthEast Un,7622,3,6,2,6,14,13,1,20
Kolkata,7622,4,4,7,3,16,16,0,19
FC Pune City,7622,5,5,3,6,16,18,-2,18
Kerala Blast,7622,6,5,3,6,12,16,-4,18
Chennaiyin,7622,7,4,5,5,18,23,-5,17
FC Goa,7622,8,3,3,8,11,20,-9,12
Mumbai City,7623,1,6,5,3,18,10,8,23
Delhi Dynamo,7623,2,5,6,3,26,18,8,21
FC Pune City,7623,3,6,3,5,15,14,1,21
Kerala Blast,7623,4,6,3,5,14,17,-3,21
Chennaiyin,7623,5,5,5,4,17,19,-2,20
NorthEast Un,7623,6,5,2,7,15,16,-1,17
Kolkata,7623,7,3,7,4,14,16,-2,16
FC Goa,7623,8,3,3,8,9,18,-9,12
Delhi Dynamo,7624,1,7,5,2,27,15,12,26
Mumbai City,7624,2,6,4,4,17,10,7,22
Kolkata,7624,3,4,8,2,16,14,2,20
Kerala Blast,7624,4,5,4,5,11,15,-4,19
Chennaiyin,7624,5,4,6,4,15,18,-3,18
FC Pune City,7624,6,4,5,5,13,15,-2,17
NorthEast Un,7624,7,4,3,7,10,14,-4,15
FC Goa,7624,8,3,3,8,10,18,-8,12
Mumbai City,7625,1,7,4,3,19,9,10,25
FC Pune City,7625,2,6,3,5,19,14,5,21
Chennaiyin,7625,3,5,5,4,16,18,-2,20
Delhi Dynamo,7625,4,4,6,4,24,20,4,18
NorthEast Un,7625,5,5,3,6,11,11,0,18
Kerala Blast,7625,6,4,5,5,11,18,-7,17
Kolkata,7625,7,3,7,4,16,20,-4,16
FC Goa,7625,8,4,3,7,12,18,-6,15
Mumbai City,7626,1,7,4,3,18,8,10,25
Kerala Blast,7626,2,7,3,4,18,17,1,24
Delhi Dynamo,7626,3,6,5,3,25,17,8,23
Kolkata,7626,4,4,7,3,17,16,1,19
FC Pune City,7626,5,4,4,6,15,19,-4,16
Chennaiyin,7626,6,3,7,4,13,17,-4,16
NorthEast Un,7626,7,4,3,7,11,14,-3,15
FC Goa,7626,8,3,3,8,9,18,-9,12
Mumbai City,7627,1,7,4,3,19,9,10,25
Kolkata,7627,2,4,8,2,14,12,2,20
Chennaiyin,7627,3,5,5,4,16,18,-2,20
FC Pune City,7627,4,5,4,5,14,14,0,19
Delhi Dynamo,7627,5,4,6,4,24,20,4,18
Kerala Blast,7627,6,5,3,6,11,17,-6,18
NorthEast Un,7627,7,5,2,7,13,14,-1,17
FC Goa,7627,8,3,4,7,9,16,-7,13
Delhi Dynamo,7628,1,6,6,2,27,17,10,24
Mumbai City,7628,2,6,4,4,16,10,6,22
Kolkata,7628,3,4,7,3,17,16,1,19
Kerala Blast,7628,4,5,4,5,12,15,-3,19
NorthEast Un,7628,5,5,3,6,11,12,-1,18
FC Pune City,7628,6,5,3,6,14,16,-2,18
Chennaiyin,7628,7,3,6,5,14,19,-5,15
FC Goa,7628,8,4,3,7,13,19,-6,15
Mumbai City,7629,1,6,5,3,16,8,8,23
Delhi Dynamo,7629,2,5,6,3,25,19,6,21
Kolkata,7629,3,5,6,3,17,16,1,21
Kerala Blast,7629,4,6,3,5,16,16,0,21
NorthEast Un,7629,5,5,2,7,14,16,-2,17
Chennaiyin,7629,6,4,5,5,17,21,-4,17
FC Goa,7629,7,5,2,7,15,19,-4,17
FC Pune City,7629,8,4,3,7,13,18,-5,15
Mumbai City,7630,1,6,5,3,17,9,8,23
Delhi Dynamo,7630,2,5,7,2,23,15,8,22
FC Pune City,7630,3,6,3,5,16,16,0,21
Kolkata,7630,4,4,7,3,17,16,1,19
Kerala Blast,7630,5,5,3,6,10,15,-5,18
NorthEast Un,7630,6,5,2,7,10,11,-1,17
FC Goa,7630,7,4,4,6,12,15,-3,16
Chennaiyin,7630,8,3,5,6,13,21,-8,14
Mumbai City,7631,1,7,4,3,18,9,9,25
Kerala Blast,7631,2,6,3,5,12,15,-3,21
Delhi Dynamo,7631,3,5,5,4,24,19,5,20
NorthEast Un,7631,4,6,2,6,14,11,3,20
Kolkata,7631,5,4,7,3,16,15,1,19
Chennaiyin,7631,6,4,6,4,17,20,-3,18
FC Pune City,7631,7,4,3,7,13,17,-4,15
FC Goa,7631,8,3,4,7,10,18,-8,13
Mumbai City,7632,1,7,4,3,18,9,9,25
Kolkata,7632,2,5,7,2,18,12,6,22
Kerala Blast,7632,3,5,5,4,14,16,-2,20
NorthEast Un,7632,4,5,4,5,15,14,1,19
Chennaiyin,7632,5,4,6,4,17,19,-2,18
Delhi Dynamo,7632,6,4,5,5,24,20,4,17
FC Pune City,7632,7,4,3,7,13,20,-7,15
FC Goa,7632,8,4,2,8,10,19,-9,14
Mumbai City,7633,1,7,4,3,20,9,11,25
Kolkata,7633,2,6,6,2,17,12,5,24
Kerala Blast,7633,3,6,3,5,11,15,-4,21
Delhi Dynamo,7633,4,5,5,4,26,22,4,20
NorthEast Un,7633,5,6,2,6,13,12,1,20
FC Pune City,7633,6,4,3,7,12,16,-4,15
FC Goa,7633,7,4,2,8,12,17,-5,14
Chennaiyin,7633,8,3,5,6,13,21,-8,14
Mumbai City,7634,1,6,5,3,17,9,8,23
Kolkata,7634,2,5,7,2,20,16,4,22
Delhi Dynamo,7634,3,5,6,3,25,17,8,21
Kerala Blast,7634,4,5,4,5,13,17,-4,19
NorthEast Un,7634,5,4,4,6,13,15,-2,16
Chennaiyin,7634,6,3,7,4,14,18,-4,16
FC Goa,7634,7,4,4,6,11,16,-5,16
FC Pune City,7634,8,4,3,7,13,18,-5,15
Delhi Dynamo,7635,1,7,5,2,29,17,12,26
Mumbai City,7635,2,6,4,4,17,10,7,22
Kolkata,7635,3,5,7,2,18,14,4,22
NorthEast Un,7635,4,5,3,6,12,12,0,18
Kerala Blast,7635,5,5,3,6,12,17,-5,18
Chennaiyin,7635,6,3,7,4,14,18,-4,16
FC Pune City,7635,7,4,3,7,13,18,-5,15
FC Goa,7635,8,3,4,7,11,20,-9,13
Mumbai City,7636,1,7,4,3,18,9,9,25
Kolkata,7636,2,6,6,2,22,13,9,24
Delhi Dynamo,7636,3,5,5,4,26,20,6,20
Chennaiyin,7636,4,5,5,4,18,17,1,20
FC Pune City,7636,5,5,3,6,14,16,-2,18
Kerala Blast,7636,6,5,3,6,12,20,-8,18
NorthEast Un,7636,7,4,2,8,12,16,-4,14
FC Goa,7636,8,4,2,8,10,21,-11,14
Delhi Dynamo,7637,1,6,5,3,25,15,10,23
Mumbai City,7637,2,6,4,4,16,10,6,22
Kolkata,7637,3,5,6,3,18,15,3,21
NorthEast Un,7637,4,6,2,6,11,11,0,20
Kerala Blast,7637,5,5,4,5,12,16,-4,19
Chennaiyin,7637,6,4,5,5,14,18,-4,17
FC Pune City,7637,7,4,4,6,14,17,-3,16
FC Goa,7637,8,4,2,8,10,18,-8,14
Mumbai City,7638,1,7,4,3,19,8,11,25
Kolkata,7638,2,5,7,2,18,15,3,22
Delhi Dynamo,7638,3,5,6,3,24,19,5,21
FC Pune City,7638,4,5,3,6,17,19,-2,18
Chennaiyin,7638,5,4,5,5,16,20,-4,17
NorthEast Un,7638,6,4,4,6,11,14,-3,16
Kerala Blast,7638,7,4,4,6,13,19,-6,16
FC Goa,7638,8,4,3,7,12,16,-4,15
Mumbai City,7639,1,7,4,3,19,9,10,25
Kolkata,7639,2,5,7,2,19,14,5,22
Delhi Dynamo,7639,3,4,7,3,24,19,5,19
Kerala Blast,7639,4,5,4,5,13,16,-3,19
FC Pune City,7639,5,5,3,6,16,19,-3,18
Chennaiyin,7639,6,4,5,5,15,22,-7,17
FC Goa,7639,7,4,3,7,14,17,-3,15
NorthEast Un,7639,8,4,3,7,11,15,-4,15
Delhi Dynamo,7640,1,6,6,2,26,17,9,24
Mumbai City,7640,2,6,4,4,18,11,7,22
FC Pune City,7640,3,6,3,5,16,15,1,21
Kolkata,7640,4,4,7,3,17,17,0,19
Kerala Blast,7640,5,5,4,5,12,15,-3,19
NorthEast Un,7640,6,5,3,6,12,12,0,18
Chennaiyin,7640,7,3,6,5,14,20,-6,15
FC Goa,7640,8,3,3,8,10,18,-8,12
Mumbai City,7641,1,7,4,3,17,8,9,25
Kerala Blast,7641,2,6,4,4,16,15,1,22
Kolkata,7641,3,5,6,3,17,14,3,21
NorthEast Un,7641,4,6,2,6,15,17,-2,20
Delhi Dynamo,7641,5,4,6,4,24,19,5,18
FC Pune City,7641,6,4,4,6,13,17,-4,16
FC Goa,7641,7,4,3,7,12,17,-5,15
Chennaiyin,7641,8,3,5,6,16,23,-7,14
Mumbai City,7642,1,7,4,3,18,8,10,25
Delhi Dynamo,7642,2,5,6,3,24,18,6,21
Kolkata,7642,3,4,8,2,15,13,2,20
Chennaiyin,7642,4,5,5,4,16,17,-1,20
Kerala Blast,7642,5,5,5,4,13,14,-1,20
NorthEast Un,7642,6,4,3,7,11,14,-3,15
FC Pune City,7642,7,4,3,7,12,18,-6,15
FC Goa,7642,8,3,4,7,10,17,-7,13
Delhi Dynamo,7643,1,6,6,2,26,17,9,24
Mumbai City,7643,2,6,4,4,17,10,7,22
Kolkata,7643,3,4,7,3,19,18,1,19
NorthEast Un,7643,4,5,4,5,12,11,1,19
Kerala Blast,7643,5,5,4,5,12,16,-4,19
FC Pune City,7643,6,5,3,6,14,16,-2,18
Chennaiyin,7643,7,4,5,5,17,21,-4,17
FC Goa,7643,8,3,3,8,13,21,-8,12
Mumbai City,7644,1,6,5,3,17,9,8,23
Delhi Dynamo,7644,2,5,6,3,24,18,6,21
Chennaiyin,7644,3,5,5,4,18,17,1,20
Kolkata,7644,4,4,7,3,14,13,1,19
FC Pune City,7644,5,5,4,5,14,14,0,19
Kerala Blast,7644,6,5,4,5,10,15,-5,19
NorthEast Un,7644,7,5,3,6,11,12,-1,18
FC Goa,7644,8,3,2,9,9,19,-10,11
Mumbai City,7645,1,7,4,3,18,9,9,25
Kolkata,7645,2,5,6,3,18,15,3,21
NorthEast Un,7645,3,6,2,6,14,13,1,20
Kerala Blast,7645,4,5,4,5,12,18,-6,19
Chennaiyin,7645,5,4,6,4,19,20,-1,18
Delhi Dynamo,7645,6,4,5,5,22,20,2,17
FC Pune City,7645,7,4,4,6,13,16,-3,16
FC Goa,7645,8,4,3,7,14,19,-5,15
Delhi Dynamo,7646,1,7,5,2,29,17,12,26
Mumbai City,7646,2,6,4,4,17,12,5,22
Kolkata,7646,3,4,8,2,16,14,2,20
NorthEast Un,7646,4,5,2,7,17,16,1,17
Chennaiyin,7646,5,4,5,5,16,21,-5,17
Kerala Blast,7646,6,4,5,5,12,19,-7,17
FC Pune City,7646,7,4,4,6,13,16,-3,16
FC Goa,7646,8,4,3,7,11,16,-5,15
Mumbai City,7647,1,7,4,3,17,8,9,25
Kerala Blast,7647,2,6,4,4,13,15,-2,22
Delhi Dynamo,7647,3,5,6,3,26,17,9,21
Kolkata,7647,4,4,6,4,17,17,0,18
FC Pune City,7647,5,4,4,6,12,15,-3,16
Chennaiyin,7647,6,3,7,4,17,21,-4,16
FC Goa,7647,7,4,4,6,13,18,-5,16
NorthEast Un,7647,8,4,3,7,12,16,-4,15
Mumbai City,7648,1,7,4,3,20,9,11,25
Delhi Dynamo,7648,2,5,6,3,24,19,5,21
Kerala Blast,7648,3,6,3,5,14,16,-2,21
NorthEast Un,7648,4,6,2,6,14,11,3,20
FC Goa,7648,5,5,3,6,11,14,-3,18
Kolkata,7648,6,3,7,4,16,17,-1,16
FC Pune City,7648,7,4,4,6,14,19,-5,16
Chennaiyin,7648,8,3,5,6,13,21,-8,14
Mumbai City,7649,1,7,4,3,18,9,9,25
NorthEast Un,7649,2,6,2,6,15,11,4,20
Chennaiyin,7649,3,5,5,4,15,17,-2,20
Kolkata,7649,4,4,7,3,17,16,1,19
Kerala Blast,7649,5,5,3,6,12,17,-5,18
Delhi Dynamo,7649,6,4,5,5,23,22,1,17
FC Goa,7649,7,5,2,7,11,15,-4,17
FC Pune City,7649,8,4,4,6,14,18,-4,16
Delhi Dynamo,7650,1,6,6,2,25,15,10,24
Kolkata,7650,2,6,6,2,18,12,6,24
Mumbai City,7650,3,6,5,3,16,8,8,23
Kerala Blast,7650,4,5,4,5,12,15,-3,19
NorthEast Un,7650,5,4,4,6,10,12,-2,16
Chennaiyin,7650,6,3,6,5,13,19,-6,15
FC Pune City,7650,7,4,3,7,12,19,-7,15
FC Goa,7650,8,4,2,8,11,17,-6,14
Delhi Dynamo,7651,1,6,6,2,25,16,9,24
Mumbai City,7651,2,6,4,4,17,10,7,22
NorthEast Un,7651,3,5,4,5,14,13,1,19
Kerala Blast,7651,4,5,4,5,12,16,-4,19
FC Pune City,7651,5,5,3,6,14,16,-2,18
FC Goa,7651,6,5,2,7,12,16,-4,17
Kolkata,7651,7,3,7,4,13,15,-2,16
Chennaiyin,7651,8,3,6,5,16,21,-5,15
Mumbai City,7652,1,7,4,3,18,8,10,25
NorthEast Un,7652,2,6,3,5,14,11,3,21
FC Pune City,7652,3,6,3,5,15,15,0,21
Kolkata,7652,4,4,7,3,18,15,3,19
Delhi Dynamo,7652,5,4,6,4,23,20,3,18
Kerala Blast,7652,6,4,4,6,12,20,-8,16
Chennaiyin,7652,7,3,6,5,13,18,-5,15
FC Goa,7652,8,3,5,6,10,16,-6,14
Mumbai City,7653,1,7,4,3,18,8,10,25
Kerala Blast,7653,2,6,4,4,12,13,-1,22
Chennaiyin,7653,3,5,5,4,17,19,-2,20
Delhi Dynamo,7653,4,4,6,4,22,18,4,18
Kolkata,7653,5,3,9,2,14,13,1,18
FC Pune City,7653,6,4,4,6,12,16,-4,16
NorthEast Un,7653,7,4,3,7,11,13,-2,15
FC Goa,7653,8,4,3,7,11,17,-6,15
Delhi Dynamo,7654,1,6,6,2,26,16,10,24
Mumbai City,7654,2,6,5,3,16,8,8,23
Kerala Blast,7654,3,6,3,5,15,18,-3,21
Kolkata,7654,4,4,6,4,16,16,0,18
FC Pune City,7654,5,5,3,6,15,17,-2,18
Chennaiyin,7654,6,4,5,5,16,20,-4,17
FC Goa,7654,7,5,2,7,13,18,-5,17
NorthEast Un,7654,8,4,2,8,10,14,-4,14
Delhi Dynamo,7655,1,6,5,3,26,18,8,23
Mumbai City,7655,2,6,4,4,17,10,7,22
FC Pune City,7655,3,6,3,5,17,16,1,21
Chennaiyin,7655,4,5,5,4,18,18,0,20
Kerala Blast,7655,5,5,4,5,13,17,-4,19
Kolkata,7655,6,3,7,4,17,19,-2,16
NorthEast Un,7655,7,4,3,7,11,14,-3,15
FC Goa,7655,8,4,3,7,11,18,-7,15
Mumbai City,7656,1,6,5,3,18,10,8,23
Kerala Blast,7656,2,6,4,4,15,13,2,22
Delhi Dynamo,7656,3,5,6,3,24,17,7,21
Kolkata,7656,4,4,8,2,18,12,6,20
NorthEast Un,7656,5,5,2,7,11,14,-3,17
Chennaiyin,7656,6,4,5,5,16,20,-4,17
FC Pune City,7656,7,4,4,6,12,17,-5,16
FC Goa,7656,8,4,2,8,10,21,-11,14
Delhi Dynamo,7657,1,6,6,2,27,15,12,24
Mumbai City,7657,2,6,5,3,17,9,8,23
Kerala Blast,7657,3,6,4,4,15,16,-1,22
Kolkata,7657,4,4,7,3,17,18,-1,19
FC Goa,7657,5,5,2,7,16,20,-4,17
NorthEast Un,7657,6,4,3,7,12,14,-2,15
FC Pune City,7657,7,4,3,7,13,18,-5,15
Chennaiyin,7657,8,3,6,5,15,22,-7,15
Delhi Dynamo,7658,1,5,7,2,23,14,9,22
Mumbai City,7658,2,6,4,4,16,10,6,22
FC Pune City,7658,3,6,3,5,18,16,2,21
NorthEast Un,7658,4,5,4,5,13,12,1,19
Kerala Blast,7658,5,5,4,5,17,18,-1,19
FC Goa,7658,6,5,3,6,12,15,-3,18
Kolkata,7658,7,3,6,5,13,21,-8,15
Chennaiyin,7658,8,3,5,6,15,21,-6,14
Mumbai City,7659,1,6,5,3,18,10,8,23
Kerala Blast,7659,2,6,4,4,15,14,1,22
FC Pune City,7659,3,5,4,5,14,15,-1,19
Delhi Dynamo,7659,4,4,6,4,24,19,5,18
Chennaiyin,7659,5,4,6,4,14,17,-3,18
FC Goa,7659,6,5,3,6,11,15,-4,18
NorthEast Un,7659,7,5,2,7,10,13,-3,17
Kolkata,7659,8,3,6,5,13,16,-3,15
Kerala Blast,7660,1,7,3,4,16,16,0,24
Mumbai City,7660,2,6,4,4,17,10,7,22
Delhi Dynamo,7660,3,5,5,4,23,18,5,20
FC Goa,7660,4,6,2,6,12,15,-3,20
NorthEast Un,7660,5,5,3,6,12,11,1,18
Kolkata,7660,6,3,7,4,15,17,-2,16
FC Pune City,7660,7,4,4,6,14,17,-3,16
Chennaiyin,7660,8,3,6,5,14,19,-5,15
Delhi Dynamo,7661,1,6,5,3,28,17,11,23
Mumbai City,7661,2,6,4,4,17,11,6,22
FC Pune City,7661,3,6,3,5,15,15,0,21
Chennaiyin,7661,4,5,5,4,20,19,1,20
NorthEast Un,7661,5,6,2,6,12,13,-1,20
Kolkata,7661,6,3,7,4,15,16,-1,16
Kerala Blast,7661,7,4,4,6,9,15,-6,16
FC Goa,7661,8,4,2,8,12,22,-10,14
Mumbai City,7662,1,6,5,3,16,8,8,23
Kerala Blast,7662,2,6,4,4,14,14,0,22
Delhi Dynamo,7662,3,4,6,4,21,18,3,18
NorthEast Un,7662,4,5,3,6,12,11,1,18
FC Goa,7662,5,5,3,6,14,16,-2,18
Chennaiyin,7662,6,4,6,4,17,20,-3,18
Kolkata,7662,7,3,7,4,15,18,-3,16
FC Pune City,7662,8,4,4,6,15,19,-4,16
Mumbai City,7663,1,6,4,4,16,10,6,22
Delhi Dynamo,7663,2,5,5,4,23,20,3,20
Kerala Blast,7663,3,5,5,4,14,16,-2,20
FC Pune City,7663,4,5,4,5,16,17,-1,19
NorthEast Un,7663,5,5,3,6,15,12,3,18
Kolkata,7663,6,3,8,3,19,19,0,17
Chennaiyin,7663,7,3,7,4,13,17,-4,16
FC Goa,7663,8,4,4,6,12,17,-5,16
Delhi Dynamo,7664,1,7,5,2,29,17,12,26
Mumbai City,7664,2,6,4,4,19,12,7,22
Chennaiyin,7664,3,5,5,4,18,20,-2,20
Kerala Blast,7664,4,5,5,4,12,15,-3,20
FC Pune City,7664,5,5,3,6,14,15,-1,18
Kolkata,7664,6,3,7,4,15,18,-3,16
NorthEast Un,7664,7,4,3,7,11,13,-2,15
FC Goa,7664,8,4,2,8,13,21,-8,14
Mumbai City,7665,1,7,4,3,17,8,9,25
Delhi Dynamo,7665,2,6,5,3,27,18,9,23
Kolkata,7665,3,5,6,3,16,15,1,21
NorthEast Un,7665,4,6,2,6,17,17,0,20
FC Pune City,7665,5,5,4,5,14,14,0,19
Kerala Blast,7665,6,4,4,6,10,16,-6,16
FC Goa,7665,7,4,2,8,12,17,-5,14
Chennaiyin,7665,8,3,5,6,15,23,-8,14
Mumbai City,7666,1,7,4,3,19,8,11,25
Delhi Dynamo,7666,2,5,6,3,23,17,6,21
Kerala Blast,7666,3,5,5,4,12,14,-2,20
NorthEast Un,7666,4,5,4,5,12,10,2,19
FC Pune City,7666,5,5,3,6,15,18,-3,18
FC Goa,7666,6,5,2,7,15,19,-4,17
Kolkata,7666,7,3,7,4,16,17,-1,16
Chennaiyin,7666,8,3,5,6,15,24,-9,14
Delhi Dynamo,7667,1,6,6,2,28,16,12,24
Mumbai City,7667,2,6,4,4,16,11,5,22
Kolkata,7667,3,5,6,3,17,14,3,21
Kerala Blast,7667,4,6,3,5,11,15,-4,21
Chennaiyin,7667,5,5,5,4,17,18,-1,20
FC Pune City,7667,6,5,3,6,15,17,-2,18
NorthEast Un,7667,7,4,2,8,11,15,-4,14
FC Goa,7667,8,3,3,8,9,18,-9,12
Mumbai City,7668,1,7,4,3,18,8,10,25
Delhi Dynamo,7668,2,6,5,3,25,17,8,23
FC Pune City,7668,3,6,3,5,17,16,1,21
Kolkata,7668,4,4,6,4,16,16,0,18
Kerala Blast,7668,5,5,3,6,10,16,-6,18
FC Goa,7668,6,5,2,7,12,17,-5,17
NorthEast Un,7668,7,4,3,7,11,13,-2,15
Chennaiyin,7668,8,3,6,5,15,21,-6,15
Mumbai City,7669,1,6,5,3,17,9,8,23
Delhi Dynamo,7669,2,5,7,2,25,16,9,22
Kolkata,7669,3,5,7,2,16,13,3,22
NorthEast Un,7669,4,5,4,5,15,12,3,19
Chennaiyin,7669,5,4,6,4,16,19,-3,18
Kerala Blast,7669,6,5,3,6,11,18,-7,18
FC Pune City,7669,7,4,3,7,12,16,-4,15
FC Goa,7669,8,3,3,8,10,19,-9,12
Mumbai City,7670,1,6,4,4,16,9,7,22
Delhi Dynamo,7670,2,5,6,3,24,19,5,21
NorthEast Un,7670,3,6,3,5,17,12,5,21
Kolkata,7670,4,5,6,3,16,15,1,21
Chennaiyin,7670,5,4,6,4,16,19,-3,18
Kerala Blast,7670,6,5,3,6,13,18,-5,18
FC Pune City,7670,7,4,3,7,14,19,-5,15
FC Goa,7670,8,4,3,7,12,17,-5,15
Delhi Dynamo,7671,1,7,5,2,30,16,14,26
Mumbai City,7671,2,6,4,4,16,9,7,22
Kolkata,7671,3,4,7,3,18,17,1,19
Kerala Blast,7671,4,5,4,5,11,15,-4,19
FC Pune City,7671,5,5,3,6,13,15,-2,18
NorthEast Un,7671,6,5,2,7,12,12,0,17
FC Goa,7671,7,5,2,7,15,23,-8,17
Chennaiyin,7671,8,3,5,6,13,21,-8,14
Mumbai City,7672,1,6,5,3,16,8,8,23
FC Goa,7672,2,6,2,6,13,16,-3,20
Delhi Dynamo,7672,3,4,7,3,24,18,6,19
Kolkata,7672,4,4,7,3,16,14,2,19
NorthEast Un,7672,5,5,4,5,12,11,1,19
FC Pune City,7672,6,5,3,6,15,16,-1,18
Kerala Blast,7672,7,4,5,5,11,18,-7,17
Chennaiyin,7672,8,3,5,6,13,19,-6,14
Mumbai City,7673,1,6,5,3,16,8,8,23
Delhi Dynamo,7673,2,5,6,3,24,19,5,21
Kerala Blast,7673,3,6,3,5,14,16,-2,21
Kolkata,7673,4,4,7,3,15,14,1,19
NorthEast Un,7673,5,5,3,6,14,13,1,18
FC Pune City,7673,6,4,4,6,13,16,-3,16
Chennaiyin,7673,7,3,7,4,14,18,-4,16
FC Goa,7673,8,4,3,7,12,18,-6,15
Delhi Dynamo,7674,1,6,6,2,29,20,9,24
Kolkata,7674,2,6,6,2,19,12,7,24
Mumbai City,7674,3,6,5,3,18,10,8,23
Kerala Blast,7674,4,5,4,5,13,18,-5,19
NorthEast Un,7674,5,5,3,6,13,13,0,18
FC Pune City,7674,6,4,3,7,14,19,-5,15
Chennaiyin,7674,7,3,5,6,15,21,-6,14
FC Goa,7674,8,4,2,8,12,20,-8,14
Mumbai City,7675,1,6,4,4,17,10,7,22
NorthEast Un,7675,2,6,3,5,15,11,4,21
FC Pune City,7675,3,6,3,5,16,14,2,21
Delhi Dynamo,7675,4,5,5,4,24,18,6,20
Chennaiyin,7675,5,4,6,4,18,20,-2,18
FC Goa,7675,6,5,2,7,15,18,-3,17
Kolkata,7675,7,3,7,4,15,19,-4,16
Kerala Blast,7675,8,4,4,6,11,21,-10,16
Mumbai City,7676,1,6,5,3,17,9,8,23
Kolkata,7676,2,5,7,2,18,12,6,22
Delhi Dynamo,7676,3,4,7,3,23,19,4,19
Kerala Blast,7676,4,5,4,5,12,18,-6,19
NorthEast Un,7676,5,5,3,6,14,12,2,18
FC Pune City,7676,6,4,4,6,13,17,-4,16
FC Goa,7676,7,4,4,6,10,15,-5,16
Chennaiyin,7676,8,3,6,5,14,19,-5,15
Mumbai City,7677,1,7,4,3,19,9,10,25
Delhi Dynamo,7677,2,6,5,3,26,17,9,23
Kolkata,7677,3,5,7,2,15,12,3,22
FC Pune City,7677,4,5,4,5,13,14,-1,19
Kerala Blast,7677,5,5,3,6,11,15,-4,18
Chennaiyin,7677,6,4,5,5,15,18,-3,17
NorthEast Un,7677,7,4,2,8,9,15,-6,14
FC Goa,7677,8,4,2,8,9,17,-8,14
Delhi Dynamo,7678,1,5,7,2,25,16,9,22
Mumbai City,7678,2,6,4,4,16,10,6,22
Kolkata,7678,3,5,7,2,17,14,3,22
Kerala Blast,7678,4,5,4,5,10,17,-7,19
NorthEast Un,7678,5,5,3,6,14,13,1,18
Chennaiyin,7678,6,4,5,5,16,19,-3,17
FC Pune City,7678,7,4,3,7,13,17,-4,15
FC Goa,7678,8,4,3,7,12,17,-5,15
Mumbai City,7679,1,7,4,3,17,8,9,25
Kerala Blast,7679,2,6,4,4,15,17,-2,22
NorthEast Un,7679,3,6,2,6,13,11,2,20
Delhi Dynamo,7679,4,4,6,4,21,17,4,18
FC Pune City,7679,5,5,3,6,17,19,-2,18
Chennaiyin,7679,6,4,5,5,14,18,-4,17
Kolkata,7679,7,3,7,4,14,17,-3,16
FC Goa,7679,8,4,3,7,11,15,-4,15
Mumbai City,7680,1,6,5,3,17,9,8,23
Delhi Dynamo,7680,2,5,7,2,24,16,8,22
FC Pune City,7680,3,6,3,5,16,14,2,21
Kerala Blast,7680,4,6,3,5,14,17,-3,21
Chennaiyin,7680,5,4,6,4,16,19,-3,18
Kolkata,7680,6,3,7,4,16,19,-3,16
NorthEast Un,7680,7,4,2,8,12,15,-3,14
FC Goa,7680,8,3,5,6,11,17,-6,14
Mumbai City,7681,1,6,5,3,16,8,8,23
Delhi Dynamo,7681,2,5,7,2,25,16,9,22
Kerala Blast,7681,3,6,4,4,13,15,-2,22
Kolkata,7681,4,3,8,3,15,15,0,17
NorthEast Un,7681,5,4,4,6,12,13,-1,16
FC Pune City,7681,6,4,4,6,14,17,-3,16
Chennaiyin,7681,7,3,7,4,15,19,-4,16
FC Goa,7681,8,4,3,7,12,19,-7,15
Mumbai City,7682,1,6,5,3,17,9,8,23
FC Pune City,7682,2,6,3,5,16,16,0,21
Delhi Dynamo,7682,3,4,8,2,24,17,7,20
NorthEast Un,7682,4,5,4,5,15,14,1,19
Kolkata,7682,5,3,8,3,16,16,0,17
Chennaiyin,7682,6,3,7,4,16,20,-4,16
Kerala Blast,7682,7,4,4,6,11,17,-6,16
FC Goa,7682,8,3,5,6,11,17,-6,14
Delhi Dynamo,7683,1,6,5,3,25,18,7,23
Mumbai City,7683,2,6,4,4,17,10,7,22
Kolkata,7683,3,4,8,2,17,14,3,20
NorthEast Un,7683,4,6,2,6,16,13,3,20
FC Pune City,7683,5,5,4,5,14,15,-1,19
Kerala Blast,7683,6,5,3,6,13,18,-5,18
Chennaiyin,7683,7,4,5,5,16,21,-5,17
FC Goa,7683,8,3,3,8,9,18,-9,12
Delhi Dynamo,7684,1,6,6,2,26,15,11,24
Mumbai City,7684,2,6,4,4,17,12,5,22
Kerala Blast,7684,3,5,5,4,17,16,1,20
FC Pune City,7684,4,5,4,5,19,18,1,19
FC Goa,7684,5,5,2,7,14,16,-2,17
Chennaiyin,7684,6,4,5,5,15,18,-3,17
Kolkata,7684,7,3,7,4,15,21,-6,16
NorthEast Un,7684,8,4,3,7,9,16,-7,15
Mumbai City,7685,1,6,5,3,18,10,8,23
Delhi Dynamo,7685,2,5,7,2,26,17,9,22
Kolkata,7685,3,5,6,3,15,13,2,21
Kerala Blast,7685,4,5,4,5,11,15,-4,19
NorthEast Un,7685,5,5,3,6,12,13,-1,18
FC Pune City,7685,6,5,3,6,13,15,-2,18
FC Goa,7685,7,4,3,7,13,15,-2,15
Chennaiyin,7685,8,3,5,6,13,23,-10,14
Mumbai City,7686,1,7,4,3,18,8,10,25
NorthEast Un,7686,2,6,3,5,15,11,4,21
FC Pune City,7686,3,6,3,5,16,15,1,21
Delhi Dynamo,7686,4,5,5,4,23,18,5,20
Kolkata,7686,5,4,7,3,17,17,0,19
Chennaiyin,7686,6,4,6,4,18,21,-3,18
Kerala Blast,7686,7,4,4,6,11,19,-8,16
FC Goa,7686,8,3,2,9,13,22,-9,11
Mumbai City,7687,1,7,4,3,17,8,9,25
Kolkata,7687,2,4,8,2,17,14,3,20
Delhi Dynamo,7687,3,4,7,3,24,18,6,19
FC Pune City,7687,4,5,4,5,14,15,-1,19
Chennaiyin,7687,5,4,6,4,14,17,-3,18
Kerala Blast,7687,6,5,3,6,13,18,-5,18
NorthEast Un,7687,7,4,3,7,12,15,-3,15
FC Goa,7687,8,3,5,6,9,15,-6,14
Delhi Dynamo,7688,1,5,7,2,28,18,10,22
Mumbai City,7688,2,6,4,4,16,11,5,22
Kerala Blast,7688,3,5,5,4,11,13,-2,20
Kolkata,7688,4,4,7,3,17,15,2,19
Chennaiyin,7688,5,4,6,4,15,18,-3,18
FC Pune City,7688,6,5,3,6,14,17,-3,18
NorthEast Un,7688,7,4,5,5,12,12,0,17
FC Goa,7688,8,3,3,8,11,20,-9,12
Mumbai City,7689,1,6,4,4,17,10,7,22
Kerala Blast,7689,2,6,4,4,13,15,-2,22
Delhi Dynamo,7689,3,5,6,3,24,18,6,21
Kolkata,7689,4,4,7,3,17,16,1,19
Chennaiyin,7689,5,4,6,4,15,18,-3,18
NorthEast Un,7689,6,5,2,7,11,11,0,17
FC Goa,7689,7,4,4,6,12,17,-5,16
FC Pune City,7689,8,4,3,7,14,18,-4,15
Mumbai City,7690,1,7,4,3,18,9,9,25
Delhi Dynamo,7690,2,5,6,3,30,18,12,21
NorthEast Un,7690,3,5,3,6,14,13,1,18
FC Pune City,7690,4,5,3,6,18,18,0,18
Kolkata,7690,5,4,6,4,17,18,-1,18
Kerala Blast,7690,6,5,3,6,12,19,-7,18
Chennaiyin,7690,7,4,5,5,15,21,-6,17
FC Goa,7690,8,5,2,7,12,20,-8,17
Mumbai City,7691,1,6,5,3,16,8,8,23
Delhi Dynamo,7691,2,5,7,2,24,16,8,22
Kerala Blast,7691,3,5,5,4,11,14,-3,20
Kolkata,7691,4,4,7,3,17,16,1,19
Chennaiyin,7691,5,4,5,5,16,20,-4,17
NorthEast Un,7691,6,4,4,6,11,12,-1,16
FC Pune City,7691,7,4,4,6,14,17,-3,16
FC Goa,7691,8,4,3,7,11,17,-6,15
Kolkata,7692,1,6,6,2,19,14,5,24
Mumbai City,7692,2,6,4,4,16,10,6,22
Delhi Dynamo,7692,3,5,6,3,24,17,7,21
Kerala Blast,7692,4,6,3,5,13,16,-3,21
Chennaiyin,7692,5,5,5,4,18,18,0,20
NorthEast Un,7692,6,5,2,7,13,13,0,17
FC Pune City,7692,7,4,3,7,12,17,-5,15
FC Goa,7692,8,3,3,8,11,21,-10,12
Mumbai City,7693,1,7,4,3,19,9,10,25
FC Pune City,7693,2,6,3,5,16,14,2,21
Delhi Dynamo,7693,3,5,5,4,26,21,5,20
Kolkata,7693,4,4,7,3,17,14,3,19
Chennaiyin,7693,5,4,6,4,16,17,-1,18
Kerala Blast,7693,6,5,3,6,12,21,-9,18
NorthEast Un,7693,7,4,3,7,12,14,-2,15
FC Goa,7693,8,4,3,7,10,18,-8,15
Delhi Dynamo,7694,1,6,6,2,28,16,12,24
Mumbai City,7694,2,6,5,3,17,9,8,23
Kerala Blast,7694,3,6,3,5,15,17,-2,21
Kolkata,7694,4,4,6,4,14,14,0,18
Chennaiyin,7694,5,4,6,4,16,19,-3,18
FC Pune City,7694,6,5,3,6,14,17,-3,18
NorthEast Un,7694,7,4,3,7,13,15,-2,15
FC Goa,7694,8,4,2,8,10,20,-10,14
Mumbai City,7695,1,6,5,3,16,8,8,23
Kolkata,7695,2,5,7,2,17,14,3,22
Delhi Dynamo,7695,3,4,8,2,21,14,7,20
Kerala Blast,7695,4,5,5,4,11,14,-3,20
NorthEast Un,7695,5,5,3,6,10,10,0,18
FC Pune City,7695,6,4,4,6,14,17,-3,16
Chennaiyin,7695,7,3,6,5,14,19,-5,15
FC Goa,7695,8,3,4,7,10,17,-7,13
Mumbai City,7696,1,7,4,3,18,8,10,25
Kolkata,7696,2,6,6,2,19,13,6,24
Delhi Dynamo,7696,3,5,6,3,24,17,7,21
NorthEast Un,7696,4,6,3,5,14,11,3,21
Kerala Blast,7696,5,5,3,6,11,17,-6,18
FC Pune City,7696,6,4,3,7,12,17,-5,15
Chennaiyin,7696,7,3,6,5,16,22,-6,15
FC Goa,7696,8,3,3,8,12,21,-9,12
Mumbai City,7697,1,7,4,3,19,9,10,25
NorthEast Un,7697,2,6,3,5,15,11,4,21
Delhi Dynamo,7697,3,5,5,4,25,20,5,20
Kerala Blast,7697,4,5,5,4,13,15,-2,20
FC Pune City,7697,5,5,3,6,14,16,-2,18
Chennaiyin,7697,6,4,5,5,15,19,-4,17
Kolkata,7697,7,3,7,4,15,17,-2,16
FC Goa,7697,8,4,2,8,10,19,-9,14
Delhi Dynamo,7698,1,6,5,3,27,18,9,23
Mumbai City,7698,2,6,4,4,17,11,6,22
Kolkata,7698,3,5,7,2,18,15,3,22
NorthEast Un,7698,4,6,2,6,13,12,1,20
FC Pune City,7698,5,5,3,6,15,16,-1,18
Kerala Blast,7698,6,5,3,6,12,17,-5,18
FC Goa,7698,7,4,3,7,13,19,-6,15
Chennaiyin,7698,8,3,5,6,15,22,-7,14
Mumbai City,7699,1,7,4,3,18,8,10,25
Kolkata,7699,2,6,6,2,19,15,4,24
Delhi Dynamo,7699,3,5,6,3,24,18,6,21
Chennaiyin,7699,4,5,5,4,16,17,-1,20
NorthEast Un,7699,5,5,3,6,11,11,0,18
Kerala Blast,7699,6,5,3,6,12,16,-4,18
FC Pune City,7699,7,4,3,7,13,18,-5,15
FC Goa,7699,8,3,2,9,10,20,-10,11
Mumbai City,7700,1,6,5,3,18,10,8,23
Kerala Blast,7700,2,6,3,5,14,17,-3,21
FC Goa,7700,3,6,2,6,14,15,-1,20
Kolkata,7700,4,4,7,3,16,15,1,19
Delhi Dynamo,7700,5,4,6,4,25,20,5,18
NorthEast Un,7700,6,5,2,7,12,13,-1,17
Chennaiyin,7700,7,4,5,5,15,21,-6,17
FC Pune City,7700,8,4,4,6,13,16,-3,16
Mumbai City,7701,1,6,5,3,16,8,8,23
Kerala Blast,7701,2,6,4,4,16,16,0,22
Delhi Dynamo,7701,3,5,6,3,24,18,6,21
NorthEast Un,7701,4,5,4,5,15,13,2,19
FC Pune City,7701,5,5,3,6,16,20,-4,18
Kolkata,7701,6,3,7,4,17,18,-1,16
Chennaiyin,7701,7,3,6,5,13,18,-5,15
FC Goa,7701,8,4,3,7,11,17,-6,15
Mumbai City,7702,1,7,4,3,17,8,9,25
Kolkata,7702,2,5,7,2,21,15,6,22
Delhi Dynamo,7702,3,5,6,3,22,15,7,21
Chennaiyin,7702,4,5,5,4,16,17,-1,20
Kerala Blast,7702,5,5,4,5,15,20,-5,19
FC Pune City,7702,6,4,5,5,17,19,-2,17
NorthEast Un,7702,7,4,2,8,10,13,-3,14
FC Goa,7702,8,3,3,8,8,19,-11,12
Mumbai City,7703,1,6,5,3,17,9,8,23
Delhi Dynamo,7703,2,5,6,3,24,18,6,21
NorthEast Un,7703,3,6,3,5,12,9,3,21
Kolkata,7703,4,4,7,3,19,18,1,19
Kerala Blast,7703,5,5,4,5,12,17,-5,19
FC Goa,7703,6,5,2,7,15,16,-1,17
FC Pune City,7703,7,4,4,6,14,17,-3,16
Chennaiyin,7703,8,3,5,6,13,22,-9,14
Mumbai City,7704,1,7,4,3,17,8,9,25
Delhi Dynamo,7704,2,6,5,3,25,16,9,23
Kolkata,7704,3,5,7,2,16,13,3,22
NorthEast Un,7704,4,5,3,6,14,13,1,18
Kerala Blast,7704,5,5,3,6,10,16,-6,18
Chennaiyin,7704,6,3,7,4,17,21,-4,16
FC Pune City,7704,7,4,3,7,12,16,-4,15
FC Goa,7704,8,3,4,7,11,19,-8,13
Mumbai City,7705,1,6,5,3,17,9,8,23
Kerala Blast,7705,2,6,3,5,14,15,-1,21
NorthEast Un,7705,3,6,2,6,12,13,-1,20
Delhi Dynamo,7705,4,4,7,3,24,18,6,19
Kolkata,7705,5,4,7,3,14,13,1,19
FC Pune City,7705,6,5,3,6,14,16,-2,18
Chennaiyin,7705,7,3,6,5,15,20,-5,15
FC Goa,7705,8,3,5,6,11,17,-6,14
Mumbai City,7706,1,6,5,3,17,9,8,23
Kolkata,7706,2,5,6,3,17,14,3,21
Kerala Blast,7706,3,6,3,5,14,17,-3,21
Delhi Dynamo,7706,4,4,7,3,23,18,5,19
NorthEast Un,7706,5,5,3,6,15,14,1,18
Chennaiyin,7706,6,4,6,4,18,20,-2,18
FC Pune City,7706,7,4,3,7,13,19,-6,15
FC Goa,7706,8,4,3,7,11,17,-6,15
Mumbai City,7707,1,6,5,3,16,8,8,23
NorthEast Un,7707,2,7,2,5,13,9,4,23
Delhi Dynamo,7707,3,5,6,3,23,15,8,21
Kerala Blast,7707,4,5,4,5,12,17,-5,19
Kolkata,7707,5,4,6,4,15,16,-1,18
Chennaiyin,7707,6,4,5,5,18,20,-2,17
FC Pune City,7707,7,4,4,6,13,16,-3,16
FC Goa,7707,8,4,2,8,12,21,-9,14
Mumbai City,7708,1,6,5,3,17,9,8,23
Delhi Dynamo,7708,2,5,7,2,26,18,8,22
Kerala Blast,7708,3,6,4,4,14,16,-2,22
Kolkata,7708,4,4,8,2,16,12,4,20
Chennaiyin,7708,5,4,6,4,15,18,-3,18
NorthEast Un,7708,6,4,3,7,12,14,-2,15
FC Pune City,7708,7,4,3,7,13,19,-6,15
FC Goa,7708,8,3,4,7,11,18,-7,13
Mumbai City,7709,1,7,4,3,18,9,9,25
Delhi Dynamo,7709,2,5,5,4,25,19,6,20
FC Goa,7709,3,6,2,6,13,15,-2,20
Kolkata,7709,4,4,7,3,18,17,1,19
NorthEast Un,7709,5,5,3,6,15,15,0,18
Kerala Blast,7709,6,5,3,6,14,18,-4,18
FC Pune City,7709,7,4,4,6,13,17,-4,16
Chennaiyin,7709,8,3,6,5,15,21,-6,15
Mumbai City,7710,1,7,4,3,19,9,10,25
Kolkata,7710,2,5,6,3,16,14,2,21
Kerala Blast,7710,3,5,4,5,11,16,-5,19
Delhi Dynamo,7710,4,4,6,4,24,21,3,18
NorthEast Un,7710,5,5,3,6,12,12,0,18
FC Goa,7710,6,5,2,7,13,16,-3,17
Chennaiyin,7710,7,4,5,5,15,19,-4,17
FC Pune City,7710,8,4,4,6,13,16,-3,16
Mumbai City,7711,1,7,4,3,18,9,9,25
Delhi Dynamo,7711,2,6,5,3,27,18,9,23
Kolkata,7711,3,4,8,2,17,14,3,20
FC Pune City,7711,4,5,4,5,15,16,-1,19
Chennaiyin,7711,5,4,6,4,15,18,-3,18
Kerala Blast,7711,6,5,3,6,13,19,-6,18
NorthEast Un,7711,7,4,2,8,11,15,-4,14
FC Goa,7711,8,3,4,7,12,19,-7,13
Delhi Dynamo,7712,1,7,5,2,27,17,10,26
Mumbai City,7712,2,6,4,4,18,11,7,22
Kolkata,7712,3,5,7,2,19,15,4,22
NorthEast Un,7712,4,5,3,6,13,12,1,18
Kerala Blast,7712,5,4,6,4,13,17,-4,18
FC Pune City,7712,6,4,4,6,14,17,-3,16
Chennaiyin,7712,7,3,6,5,15,21,-6,15
FC Goa,7712,8,3,3,8,10,19,-9,12
Mumbai City,7713,1,7,4,3,20,9,11,25
Kolkata,7713,2,6,6,2,20,15,5,24
Delhi Dynamo,7713,3,4,7,3,24,20,4,19
NorthEast Un,7713,4,5,4,5,13,12,1,19
FC Pune City,7713,5,5,3,6,14,17,-3,18
Kerala Blast,7713,6,4,4,6,11,17,-6,16
FC Goa,7713,7,4,3,7,13,18,-5,15
Chennaiyin,7713,8,3,5,6,15,22,-7,14
Delhi Dynamo,7714,1,6,6,2,27,18,9,24
Mumbai City,7714,2,6,4,4,17,10,7,22
NorthEast Un,7714,3,6,3,5,16,11,5,21
Kerala Blast,7714,4,6,3,5,12,15,-3,21
FC Goa,7714,5,5,2,7,16,19,-3,17
Kolkata,7714,6,3,7,4,15,16,-1,16
FC Pune City,7714,7,4,4,6,13,16,-3,16
Chennaiyin,7714,8,3,5,6,14,25,-11,14
Mumbai City,7715,1,6,4,4,16,10,6,22
Kerala Blast,7715,2,6,4,4,16,16,0,22
Delhi Dynamo,7715,3,5,6,3,25,17,8,21
NorthEast Un,7715,4,6,2,6,15,14,1,20
Kolkata,7715,5,4,7,3,16,15,1,19
FC Pune City,7715,6,5,3,6,15,19,-4,18
FC Goa,7715,7,4,3,7,9,15,-6,15
Chennaiyin,7715,8,3,5,6,14,20,-6,14
Mumbai City,7716,1,7,4,3,19,10,9,25
Delhi Dynamo,7716,2,5,6,3,27,20,7,21
Kerala Blast,7716,3,5,4,5,11,15,-4,19
NorthEast Un,7716,4,5,3,6,12,12,0,18
FC Pune City,7716,5,5,3,6,14,16,-2,18
Kolkata,7716,6,3,8,3,15,15,0,17
Chennaiyin,7716,7,4,5,5,16,20,-4,17
FC Goa,7716,8,4,3,7,12,18,-6,15
Mumbai City,7717,1,6,5,3,16,8,8,23
Kolkata,7717,2,5,6,3,18,15,3,21
FC Pune City,7717,3,6,3,5,16,16,0,21
Delhi Dynamo,7717,4,4,6,4,21,19,2,18
Chennaiyin,7717,5,4,6,4,16,18,-2,18
Kerala Blast,7717,6,5,3,6,12,17,-5,18
NorthEast Un,7717,7,5,2,7,13,13,0,17
FC Goa,7717,8,4,3,7,11,17,-6,15
Mumbai City,7718,1,7,4,3,21,9,12,25
NorthEast Un,7718,2,6,3,5,13,10,3,21
Kolkata,7718,3,4,7,3,18,17,1,19
Kerala Blast,7718,4,5,4,5,12,15,-3,19
Delhi Dynamo,7718,5,4,6,4,25,23,2,18
FC Pune City,7718,6,5,3,6,13,16,-3,18
FC Goa,7718,7,4,4,6,17,21,-4,16
Chennaiyin,7718,8,3,5,6,15,23,-8,14
Mumbai City,7719,1,7,4,3,20,8,12,25
Kolkata,7719,2,5,7,2,19,15,4,22
Delhi Dynamo,7719,3,5,5,4,23,20,3,20
NorthEast Un,7719,4,5,3,6,11,11,0,18
Kerala Blast,7719,5,4,6,4,10,14,-4,18
FC Goa,7719,6,5,2,7,14,20,-6,17
FC Pune City,7719,7,4,4,6,14,17,-3,16
Chennaiyin,7719,8,3,5,6,15,21,-6,14
Mumbai City,7720,1,6,5,3,16,8,8,23
Delhi Dynamo,7720,2,5,6,3,22,15,7,21
Kolkata,7720,3,5,6,3,18,16,2,21
NorthEast Un,7720,4,6,2,6,11,12,-1,20
FC Pune City,7720,5,5,3,6,14,15,-1,18
Kerala Blast,7720,6,5,3,6,13,17,-4,18
Chennaiyin,7720,7,4,5,5,14,18,-4,17
FC Goa,7720,8,4,2,8,11,18,-7,14
Mumbai City,7721,1,7,4,3,19,8,11,25
Kerala Blast,7721,2,6,3,5,14,15,-1,21
NorthEast Un,7721,3,6,2,6,14,14,0,20
Delhi Dynamo,7721,4,4,6,4,21,18,3,18
Kolkata,7721,5,4,6,4,15,15,0,18
FC Pune City,7721,6,5,3,6,14,16,-2,18
FC Goa,7721,7,5,3,6,10,14,-4,18
Chennaiyin,7721,8,3,5,6,14,21,-7,14
Mumbai City,7722,1,7,4,3,21,11,10,25
Delhi Dynamo,7722,2,5,5,4,31,20,11,20
Kerala Blast,7722,3,5,5,4,12,15,-3,20
NorthEast Un,7722,4,5,3,6,11,13,-2,18
Kolkata,7722,5,3,8,3,13,13,0,17
FC Pune City,7722,6,4,5,5,13,15,-2,17
Chennaiyin,7722,7,4,5,5,17,20,-3,17
FC Goa,7722,8,4,3,7,11,22,-11,15
Mumbai City,7723,1,6,5,3,17,9,8,23
FC Goa,7723,2,6,2,6,15,17,-2,20
Delhi Dynamo,7723,3,4,7,3,26,20,6,19
FC Pune City,7723,4,5,4,5,16,17,-1,19
Kolkata,7723,5,3,8,3,15,16,-1,17
Chennaiyin,7723,6,4,5,5,16,19,-3,17
Kerala Blast,7723,7,4,5,5,11,16,-5,17
NorthEast Un,7723,8,4,4,6,12,14,-2,16
Delhi Dynamo,7724,1,6,6,2,28,17,11,24
Mumbai City,7724,2,6,5,3,18,10,8,23
Kolkata,7724,3,4,7,3,17,15,2,19
FC Pune City,7724,4,5,4,5,15,16,-1,19
Kerala Blast,7724,5,5,4,5,12,17,-5,19
Chennaiyin,7724,6,4,6,4,17,17,0,18
NorthEast Un,7724,7,4,2,8,11,17,-6,14
FC Goa,7724,8,3,4,7,9,18,-9,13
Mumbai City,7725,1,6,4,4,16,10,6,22
Delhi Dynamo,7725,2,5,6,3,25,17,8,21
Kerala Blast,7725,3,6,3,5,13,16,-3,21
Kolkata,7725,4,4,7,3,19,16,3,19
FC Pune City,7725,5,5,4,5,13,14,-1,19
FC Goa,7725,6,5,2,7,13,20,-7,17
NorthEast Un,7725,7,4,4,6,12,13,-1,16
Chennaiyin,7725,8,3,6,5,14,19,-5,15
Mumbai City,7726,1,6,5,3,19,11,8,23
Delhi Dynamo,7726,2,5,7,2,26,18,8,22
Kerala Blast,7726,3,6,4,4,13,15,-2,22
Chennaiyin,7726,4,5,5,4,17,19,-2,20
FC Pune City,7726,5,5,3,6,15,16,-1,18
Kolkata,7726,6,3,7,4,15,20,-5,16
FC Goa,7726,7,4,3,7,14,17,-3,15
NorthEast Un,7726,8,4,2,8,11,14,-3,14
Mumbai City,7727,1,7,4,3,18,9,9,25
Delhi Dynamo,7727,2,6,5,3,27,17,10,23
Kolkata,7727,3,5,6,3,19,16,3,21
Chennaiyin,7727,4,4,6,4,17,19,-2,18
Kerala Blast,7727,5,4,5,5,13,20,-7,17
FC Pune City,7727,6,4,4,6,14,17,-3,16
NorthEast Un,7727,7,4,4,6,12,15,-3,16
FC Goa,7727,8,4,2,8,12,19,-7,14
Mumbai City,7728,1,7,4,3,18,8,10,25
Kolkata,7728,2,5,7,2,21,16,5,22
NorthEast Un,7728,3,6,2,6,14,10,4,20
Delhi Dynamo,7728,4,5,5,4,22,19,3,20
Chennaiyin,7728,5,4,6,4,14,17,-3,18
Kerala Blast,7728,6,5,3,6,13,19,-6,18
FC Pune City,7728,7,4,3,7,14,20,-6,15
FC Goa,7728,8,3,4,7,10,17,-7,13
Mumbai City,7729,1,7,4,3,18,8,10,25
Kolkata,7729,2,6,6,2,19,12,7,24
NorthEast Un,7729,3,6,2,6,14,12,2,20
Delhi Dynamo,7729,4,4,6,4,21,18,3,18
Kerala Blast,7729,5,5,3,6,12,17,-5,18
Chennaiyin,7729,6,4,5,5,16,20,-4,17
FC Goa,7729,7,4,3,7,9,15,-6,15
FC Pune City,7729,8,4,3,7,13,20,-7,15
Kolkata,7730,1,6,6,2,16,12,4,24
Mumbai City,7730,2,6,5,3,16,8,8,23
Delhi Dynamo,7730,3,4,7,3,22,16,6,19
Kerala Blast,7730,4,5,4,5,11,15,-4,19
NorthEast Un,7730,5,5,3,6,11,11,0,18
Chennaiyin,7730,6,4,5,5,14,18,-4,17
FC Pune City,7730,7,4,3,7,12,16,-4,15
FC Goa,7730,8,4,3,7,10,16,-6,15
Mumbai City,7731,1,7,4,3,18,9,9,25
Delhi Dynamo,7731,2,6,5,3,28,18,10,23
Kolkata,7731,3,5,7,2,17,14,3,22
FC Pune City,7731,4,5,4,5,16,16,0,19
Kerala Blast,7731,5,5,3,6,12,17,-5,18
Chennaiyin,7731,6,4,5,5,16,21,-5,17
FC Goa,7731,7,4,2,8,13,18,-5,14
NorthEast Un,7731,8,4,2,8,11,18,-7,14
Delhi Dynamo,7732,1,6,6,2,26,15,11,24
Kolkata,7732,2,6,6,2,22,13,9,24
Mumbai City,7732,3,6,4,4,16,10,6,22
Kerala Blast,7732,4,6,3,5,15,18,-3,21
Chennaiyin,7732,5,4,6,4,15,18,-3,18
FC Pune City,7732,6,4,3,7,12,20,-8,15
NorthEast Un,7732,7,4,2,8,14,18,-4,14
FC Goa,7732,8,3,4,7,9,17,-8,13
Mumbai City,7733,1,6,5,3,19,11,8,23
Delhi Dynamo,7733,2,5,7,2,26,18,8,22
FC Pune City,7733,3,6,3,5,16,15,1,21
Chennaiyin,7733,4,5,5,4,19,18,1,20
Kolkata,7733,5,4,7,3,18,14,4,19
NorthEast Un,7733,6,5,3,6,11,13,-2,18
Kerala Blast,7733,7,4,3,7,10,21,-11,15
FC Goa,7733,8,3,3,8,10,19,-9,12
Mumbai City,7734,1,7,4,3,17,8,9,25
Kolkata,7734,2,5,7,2,17,14,3,22
NorthEast Un,7734,3,5,4,5,11,10,1,19
Delhi Dynamo,7734,4,4,6,4,21,16,5,18
FC Pune City,7734,5,5,3,6,15,15,0,18
Chennaiyin,7734,6,3,7,4,15,19,-4,16
FC Goa,7734,7,4,4,6,12,17,-5,16
Kerala Blast,7734,8,4,3,7,9,18,-9,15
Mumbai City,7735,1,7,4,3,17,8,9,25
NorthEast Un,7735,2,6,3,5,12,10,2,21
Delhi Dynamo,7735,3,5,5,4,24,16,8,20
Kolkata,7735,4,4,8,2,18,16,2,20
FC Pune City,7735,5,5,4,5,13,14,-1,19
Chennaiyin,7735,6,3,7,4,16,20,-4,16
Kerala Blast,7735,7,4,4,6,11,17,-6,16
FC Goa,7735,8,3,3,8,12,22,-10,12
Mumbai City,7736,1,7,4,3,17,8,9,25
Kerala Blast,7736,2,7,3,4,15,15,0,24
Delhi Dynamo,7736,3,5,6,3,25,17,8,21
NorthEast Un,7736,4,5,3,6,14,13,1,18
Kolkata,7736,5,4,6,4,14,16,-2,18
FC Pune City,7736,6,4,3,7,14,18,-4,15
Chennaiyin,7736,7,3,6,5,15,21,-6,15
FC Goa,7736,8,4,3,7,11,17,-6,15
Mumbai City,7737,1,7,4,3,17,8,9,25
Kolkata,7737,2,5,7,2,20,15,5,22
Delhi Dynamo,7737,3,5,6,3,22,15,7,21
FC Pune City,7737,4,5,3,6,15,17,-2,18
Chennaiyin,7737,5,4,6,4,16,19,-3,18
Kerala Blast,7737,6,5,3,6,12,17,-5,18
NorthEast Un,7737,7,4,3,7,10,14,-4,15
FC Goa,7737,8,3,4,7,12,19,-7,13
Mumbai City,7738,1,7,4,3,18,8,10,25
FC Pune City,7738,2,6,3,5,16,15,1,21
Kolkata,7738,3,4,7,3,16,15,1,19
Delhi Dynamo,7738,4,4,6,4,22,18,4,18
Kerala Blast,7738,5,5,3,6,16,19,-3,18
NorthEast Un,7738,6,5,3,6,13,16,-3,18
FC Goa,7738,7,4,4,6,12,17,-5,16
Chennaiyin,7738,8,3,6,5,14,19,-5,15
Mumbai City,7739,1,7,4,3,20,8,12,25
Delhi Dynamo,7739,2,5,6,3,27,21,6,21
Kolkata,7739,3,5,6,3,20,14,6,21
Kerala Blast,7739,4,6,3,5,13,16,-3,21
Chennaiyin,7739,5,3,7,4,14,18,-4,16
FC Goa,7739,6,4,4,6,14,19,-5,16
NorthEast Un,7739,7,4,3,7,9,13,-4,15
FC Pune City,7739,8,4,3,7,12,20,-8,15
Mumbai City,7740,1,7,4,3,17,8,9,25
NorthEast Un,7740,2,6,3,5,13,10,3,21
Kolkata,7740,3,4,8,2,15,13,2,20
Delhi Dynamo,7740,4,4,6,4,21,17,4,18
Kerala Blast,7740,5,4,5,5,11,16,-5,17
FC Goa,7740,6,4,4,6,13,15,-2,16
FC Pune City,7740,7,4,4,6,14,17,-3,16
Chennaiyin,7740,8,3,6,5,14,22,-8,15
Mumbai City,7741,1,7,4,3,18,9,9,25
Delhi Dynamo,7741,2,6,5,3,25,17,8,23
Kerala Blast,7741,3,6,4,4,13,15,-2,22
Kolkata,7741,4,4,7,3,16,14,2,19
NorthEast Un,7741,5,5,3,6,12,11,1,18
Chennaiyin,7741,6,4,5,5,14,19,-5,17
FC Pune City,7741,7,4,3,7,13,18,-5,15
FC Goa,7741,8,3,3,8,8,16,-8,12
NorthEast Un,7742,1,7,2,5,17,11,6,23
Mumbai City,7742,2,6,4,4,16,9,7,22
Delhi Dynamo,7742,3,5,5,4,23,18,5,20
FC Pune City,7742,4,5,4,5,14,15,-1,19
Kerala Blast,7742,5,5,3,6,10,17,-7,18
Kolkata,7742,6,3,8,3,16,16,0,17
FC Goa,7742,7,4,4,6,12,17,-5,16
Chennaiyin,7742,8,3,6,5,15,20,-5,15
Delhi Dynamo,7743,1,7,5,2,26,15,11,26
Mumbai City,7743,2,6,4,4,17,10,7,22
Kolkata,7743,3,5,7,2,17,13,4,22
Kerala Blast,7743,4,6,3,5,12,15,-3,21
Chennaiyin,7743,5,4,5,5,15,19,-4,17
FC Pune City,7743,6,4,3,7,13,17,-4,15
FC Goa,7743,7,4,3,7,9,16,-7,15
NorthEast Un,7743,8,4,2,8,10,14,-4,14
Kolkata,7744,1,6,6,2,22,12,10,24
Mumbai City,7744,2,6,5,3,16,8,8,23
Kerala Blast,7744,3,6,3,5,13,20,-7,21
Delhi Dynamo,7744,4,4,7,3,23,17,6,19
NorthEast Un,7744,5,5,3,6,15,12,3,18
FC Goa,7744,6,5,2,7,12,18,-6,17
FC Pune City,7744,7,4,3,7,12,17,-5,15
Chennaiyin,7744,8,3,5,6,14,23,-9,14
Mumbai City,7745,1,7,4,3,17,8,9,25
Delhi Dynamo,7745,2,5,6,3,26,18,8,21
Kerala Blast,7745,3,5,4,5,10,15,-5,19
Kolkata,7745,4,4,6,4,15,15,0,18
FC Pune City,7745,5,5,3,6,14,15,-1,18
Chennaiyin,7745,6,4,5,5,17,19,-2,17
FC Goa,7745,7,5,2,7,13,19,-6,17
NorthEast Un,7745,8,4,4,6,11,14,-3,16
Mumbai City,7746,1,7,4,3,18,9,9,25
Delhi Dynamo,7746,2,5,6,3,24,17,7,21
NorthEast Un,7746,3,6,2,6,13,12,1,20
FC Pune City,7746,4,5,4,5,15,16,-1,19
FC Goa,7746,5,5,3,6,14,16,-2,18
Kerala Blast,7746,6,4,5,5,11,16,-5,17
Kolkata,7746,7,3,7,4,13,15,-2,16
Chennaiyin,7746,8,3,5,6,16,23,-7,14
Mumbai City,7747,1,6,5,3,18,10,8,23
Kolkata,7747,2,5,7,2,17,14,3,22
Delhi Dynamo,7747,3,4,7,3,26,20,6,19
FC Pune City,7747,4,5,3,6,16,17,-1,18
FC Goa,7747,5,5,3,6,14,18,-4,18
NorthEast Un,7747,6,4,5,5,13,13,0,17
Kerala Blast,7747,7,4,4,6,11,18,-7,16
Chennaiyin,7747,8,3,6,5,16,21,-5,15
Mumbai City,7748,1,7,4,3,18,9,9,25
NorthEast Un,7748,2,6,3,5,14,11,3,21
FC Goa,7748,3,6,2,6,13,15,-2,20
Kerala Blast,7748,4,5,5,4,12,15,-3,20
FC Pune City,7748,5,5,3,6,15,17,-2,18
Delhi Dynamo,7748,6,4,5,5,23,19,4,17
Kolkata,7748,7,3,7,4,16,18,-2,16
Chennaiyin,7748,8,3,5,6,14,21,-7,14
Delhi Dynamo,7749,1,6,6,2,30,15,15,24
Mumbai City,7749,2,6,5,3,17,9,8,23
Kolkata,7749,3,5,6,3,17,15,2,21
Kerala Blast,7749,4,5,4,5,11,16,-5,19
Chennaiyin,7749,5,4,6,4,18,19,-1,18
NorthEast Un,7749,6,5,2,7,14,19,-5,17
FC Pune City,7749,7,4,4,6,13,17,-4,16
FC Goa,7749,8,3,3,8,8,18,-10,12
Mumbai City,7750,1,6,5,3,16,8,8,23
Kolkata,7750,2,5,7,2,18,12,6,22
Delhi Dynamo,7750,3,5,6,3,25,18,7,21
NorthEast Un,7750,4,6,2,6,13,12,1,20
Chennaiyin,7750,5,5,5,4,17,18,-1,20
Kerala Blast,7750,6,5,4,5,10,14,-4,19
FC Pune City,7750,7,4,3,7,12,17,-5,15
FC Goa,7750,8,3,2,9,10,22,-12,11
Mumbai City,7751,1,7,4,3,17,8,9,25
NorthEast Un,7751,2,6,3,5,15,12,3,21
Delhi Dynamo,7751,3,5,5,4,25,20,5,20
Kerala Blast,7751,4,5,4,5,12,16,-4,19
Kolkata,7751,5,4,6,4,16,17,-1,18
FC Pune City,7751,6,5,3,6,15,17,-2,18
FC Goa,7751,7,5,2,7,13,17,-4,17
Chennaiyin,7751,8,3,5,6,13,19,-6,14
NorthEast Un,7752,1,7,2,5,18,12,6,23
Mumbai City,7752,2,6,4,4,18,11,7,22
Delhi Dynamo,7752,3,5,5,4,25,20,5,20
Kolkata,7752,4,4,7,3,16,14,2,19
FC Pune City,7752,5,5,4,5,14,14,0,19
Kerala Blast,7752,6,4,5,5,10,16,-6,17
Chennaiyin,7752,7,3,6,5,14,20,-6,15
FC Goa,7752,8,4,3,7,9,17,-8,15
Mumbai City,7753,1,7,4,3,19,10,9,25
Delhi Dynamo,7753,2,5,6,3,26,19,7,21
Chennaiyin,7753,3,5,5,4,19,19,0,20
Kerala Blast,7753,4,4,6,4,10,14,-4,18
Kolkata,7753,5,3,8,3,14,15,-1,17
FC Pune City,7753,6,4,5,5,14,16,-2,17
NorthEast Un,7753,7,4,3,7,12,15,-3,15
FC Goa,7753,8,4,3,7,11,17,-6,15
Mumbai City,7754,1,7,4,3,20,9,11,25
Kolkata,7754,2,5,6,3,19,16,3,21
Delhi Dynamo,7754,3,5,5,4,25,21,4,20
NorthEast Un,7754,4,6,2,6,14,16,-2,20
Chennaiyin,7754,5,4,6,4,19,19,0,18
FC Pune City,7754,6,5,3,6,15,19,-4,18
Kerala Blast,7754,7,5,3,6,13,17,-4,18
FC Goa,7754,8,3,3,8,10,18,-8,12
Delhi Dynamo,7755,1,6,5,3,25,17,8,23
Mumbai City,7755,2,6,4,4,16,10,6,22
NorthEast Un,7755,3,5,4,5,12,10,2,19
Kolkata,7755,4,4,7,3,16,16,0,19
FC Pune City,7755,5,5,4,5,14,14,0,19
Chennaiyin,7755,6,4,6,4,15,17,-2,18
Kerala Blast,7755,7,4,5,5,10,15,-5,17
FC Goa,7755,8,3,3,8,11,20,-9,12
Mumbai City,7756,1,6,5,3,17,9,8,23
Kerala Blast,7756,2,6,4,4,13,15,-2,22
NorthEast Un,7756,3,6,3,5,14,11,3,21
Kolkata,7756,4,4,7,3,15,13,2,19
Delhi Dynamo,7756,5,4,6,4,23,20,3,18
Chennaiyin,7756,6,4,5,5,16,19,-3,17
FC Pune City,7756,7,4,3,7,13,18,-5,15
FC Goa,7756,8,4,3,7,11,17,-6,15
Mumbai City,7757,1,6,5,3,18,10,8,23
Kerala Blast,7757,2,6,4,4,16,16,0,22
Delhi Dynamo,7757,3,5,6,3,26,18,8,21
FC Pune City,7757,4,5,4,5,15,16,-1,19
NorthEast Un,7757,5,5,2,7,13,13,0,17
Chennaiyin,7757,6,4,5,5,17,20,-3,17
FC Goa,7757,7,5,2,7,12,19,-7,17
Kolkata,7757,8,3,6,5,15,20,-5,15
Mumbai City,7758,1,7,4,3,20,10,10,25
Kerala Blast,7758,2,6,4,4,14,13,1,22
Delhi Dynamo,7758,3,5,5,4,26,22,4,20
NorthEast Un,7758,4,5,4,5,12,9,3,19
Chennaiyin,7758,5,4,6,4,15,18,-3,18
Kolkata,7758,6,3,8,3,14,15,-1,17
FC Pune City,7758,7,4,4,6,12,17,-5,16
FC Goa,7758,8,3,3,8,11,20,-9,12
Delhi Dynamo,7759,1,6,6,2,25,15,10,24
Kolkata,7759,2,6,6,2,18,14,4,24
Mumbai City,7759,3,6,5,3,16,8,8,23
Kerala Blast,7759,4,4,5,5,11,16,-5,17
NorthEast Un,7759,5,4,4,6,13,15,-2,16
FC Pune City,7759,6,4,4,6,12,15,-3,16
Chennaiyin,7759,7,3,7,4,14,18,-4,16
FC Goa,7759,8,3,3,8,10,18,-8,12
Mumbai City,7760,1,7,4,3,18,9,9,25
Kolkata,7760,2,6,6,2,18,14,4,24
NorthEast Un,7760,3,5,4,5,13,11,2,19
Delhi Dynamo,7760,4,4,6,4,23,19,4,18
Kerala Blast,7760,5,4,5,5,12,17,-5,17
FC Pune City,7760,6,4,4,6,12,15,-3,16
FC Goa,7760,7,4,3,7,11,16,-5,15
Chennaiyin,7760,8,3,6,5,14,20,-6,15
Mumbai City,7761,1,7,4,3,20,9,11,25
Delhi Dynamo,7761,2,6,5,3,27,19,8,23
Kolkata,7761,3,4,8,2,19,17,2,20
NorthEast Un,7761,4,5,3,6,11,11,0,18
Chennaiyin,7761,5,4,6,4,16,19,-3,18
FC Pune City,7761,6,4,5,5,13,15,-2,17
Kerala Blast,7761,7,4,4,6,12,18,-6,16
FC Goa,7761,8,3,3,8,13,23,-10,12
Delhi Dynamo,7762,1,6,6,2,26,17,9,24
Mumbai City,7762,2,6,5,3,17,9,8,23
Kerala Blast,7762,3,5,5,4,10,13,-3,20
Chennaiyin,7762,4,4,6,4,18,18,0,18
FC Pune City,7762,5,5,3,6,13,15,-2,18
Kolkata,7762,6,3,8,3,13,13,0,17
NorthEast Un,7762,7,4,4,6,10,11,-1,16
FC Goa,7762,8,3,3,8,10,21,-11,12
Mumbai City,7763,1,6,5,3,18,10,8,23
Kerala Blast,7763,2,6,4,4,15,16,-1,22
Delhi Dynamo,7763,3,5,6,3,27,18,9,21
FC Goa,7763,4,5,3,6,12,16,-4,18
FC Pune City,7763,5,4,5,5,14,16,-2,17
Kolkata,7763,6,3,7,4,15,16,-1,16
Chennaiyin,7763,7,3,7,4,15,19,-4,16
NorthEast Un,7763,8,4,3,7,11,16,-5,15
Mumbai City,7764,1,7,4,3,17,8,9,25
Delhi Dynamo,7764,2,6,5,3,24,16,8,23
Kolkata,7764,3,5,7,2,16,13,3,22
Kerala Blast,7764,4,5,4,5,10,14,-4,19
NorthEast Un,7764,5,5,2,7,12,12,0,17
FC Pune City,7764,6,4,5,5,12,14,-2,17
Chennaiyin,7764,7,3,6,5,15,21,-6,15
FC Goa,7764,8,3,3,8,11,19,-8,12
Mumbai City,7765,1,6,4,4,16,9,7,22
Kolkata,7765,2,5,7,2,17,13,4,22
Kerala Blast,7765,3,6,4,4,16,14,2,22
Delhi Dynamo,7765,4,5,6,3,23,17,6,21
NorthEast Un,7765,5,6,2,6,13,13,0,20
Chennaiyin,7765,6,4,5,5,14,19,-5,17
FC Pune City,7765,7,4,3,7,12,17,-5,15
FC Goa,7765,8,3,3,8,9,18,-9,12
Mumbai City,7766,1,6,5,3,20,12,8,23
Kolkata,7766,2,5,7,2,18,15,3,22
Delhi Dynamo,7766,3,5,6,3,29,20,9,21
Kerala Blast,7766,4,5,4,5,15,19,-4,19
Chennaiyin,7766,5,4,6,4,14,17,-3,18
NorthEast Un,7766,6,5,2,7,12,13,-1,17
FC Pune City,7766,7,4,5,5,17,19,-2,17
FC Goa,7766,8,3,3,8,8,18,-10,12
Mumbai City,7767,1,6,5,3,16,8,8,23
Delhi Dynamo,7767,2,5,7,2,25,16,9,22
Kerala Blast,7767,3,6,4,4,11,13,-2,22
Kolkata,7767,4,4,7,3,17,14,3,19
FC Pune City,7767,5,5,3,6,14,16,-2,18
NorthEast Un,7767,6,4,4,6,11,12,-1,16
Chennaiyin,7767,7,3,6,5,15,21,-6,15
FC Goa,7767,8,4,2,8,12,21,-9,14
Mumbai City,7768,1,7,4,3,19,8,11,25
NorthEast Un,7768,2,6,3,5,17,11,6,21
Delhi Dynamo,7768,3,5,5,4,24,22,2,20
Kerala Blast,7768,4,5,5,4,15,15,0,20
FC Pune City,7768,5,4,5,5,13,15,-2,17
Chennaiyin,7768,6,4,5,5,18,21,-3,17
Kolkata,7768,7,3,8,3,14,17,-3,17
FC Goa,7768,8,3,3,8,11,22,-11,12
Mumbai City,7769,1,7,4,3,17,8,9,25
Delhi Dynamo,7769,2,5,5,4,22,16,6,20
FC Goa,7769,3,6,2,6,14,15,-1,20
Kolkata,7769,4,4,7,3,16,14,2,19
Kerala Blast,7769,5,5,4,5,11,14,-3,19
FC Pune City,7769,6,5,3,6,13,16,-3,18
Chennaiyin,7769,7,4,5,5,15,21,-6,17
NorthEast Un,7769,8,4,2,8,10,14,-4,14
Mumbai City,7770,1,6,5,3,17,9,8,23
Delhi Dynamo,7770,2,5,6,3,26,20,6,21
Kolkata,7770,3,4,8,2,17,13,4,20
Kerala Blast,7770,4,5,5,4,12,15,-3,20
NorthEast Un,7770,5,5,4,5,12,10,2,19
FC Goa,7770,6,4,3,7,13,18,-5,15
FC Pune City,7770,7,4,3,7,14,20,-6,15
Chennaiyin,7770,8,3,6,5,13,19,-6,15
Mumbai City,7771,1,7,4,3,18,9,9,25
NorthEast Un,7771,2,7,2,5,15,11,4,23
FC Goa,7771,3,6,2,6,14,15,-1,20
Kolkata,7771,4,4,6,4,17,18,-1,18
FC Pune City,7771,5,5,3,6,16,17,-1,18
Kerala Blast,7771,6,5,3,6,14,20,-6,18
Delhi Dynamo,7771,7,4,5,5,23,19,4,17
Chennaiyin,7771,8,3,5,6,14,22,-8,14
NorthEast Un,7772,1,7,2,5,19,10,9,23
Delhi Dynamo,7772,2,6,5,3,26,19,7,23
Mumbai City,7772,3,6,4,4,17,10,7,22
Kerala Blast,7772,4,5,4,5,15,18,-3,19
Kolkata,7772,5,3,8,3,17,18,-1,17
FC Pune City,7772,6,4,4,6,14,19,-5,16
FC Goa,7772,7,4,3,7,11,17,-6,15
Chennaiyin,7772,8,3,6,5,13,21,-8,15
Delhi Dynamo,7773,1,7,5,2,27,15,12,26
Kolkata,7773,2,6,6,2,19,14,5,24
Mumbai City,7773,3,6,4,4,17,11,6,22
Kerala Blast,7773,4,5,4,5,13,16,-3,19
Chennaiyin,7773,5,4,6,4,14,17,-3,18
FC Pune City,7773,6,4,4,6,14,18,-4,16
NorthEast Un,7773,7,4,2,8,9,14,-5,14
FC Goa,7773,8,3,3,8,8,16,-8,12
Mumbai City,7774,1,7,4,3,17,8,9,25
Kolkata,7774,2,5,7,2,18,12,6,22
Delhi Dynamo,7774,3,5,6,3,24,15,9,21
Kerala Blast,7774,4,5,4,5,14,19,-5,19
NorthEast Un,7774,5,4,5,5,12,12,0,17
Chennaiyin,7774,6,3,7,4,15,19,-4,16
FC Pune City,7774,7,4,3,7,12,18,-6,15
FC Goa,7774,8,3,4,7,9,18,-9,13
Mumbai City,7775,1,7,4,3,19,10,9,25
Kerala Blast,7775,2,5,5,4,11,14,-3,20
Kolkata,7775,3,4,7,3,17,16,1,19
Delhi Dynamo,7775,4,4,6,4,23,18,5,18
FC Goa,7775,5,5,3,6,12,15,-3,18
NorthEast Un,7775,6,5,2,7,10,12,-2,17
Chennaiyin,7775,7,4,5,5,16,19,-3,17
FC Pune City,7775,8,4,4,6,13,17,-4,16
Delhi Dynamo,7776,1,6,6,2,27,15,12,24
Mumbai City,7776,2,6,5,3,16,8,8,23
Kerala Blast,7776,3,6,4,4,12,13,-1,22
Kolkata,7776,4,4,8,2,17,15,2,20
NorthEast Un,7776,5,4,3,7,11,13,-2,15
FC Pune City,7776,6,4,3,7,13,18,-5,15
Chennaiyin,7776,7,3,6,5,14,21,-7,15
FC Goa,7776,8,4,3,7,13,20,-7,15
Mumbai City,7777,1,7,4,3,17,8,9,25
Kolkata,7777,2,6,6,2,21,17,4,24
Kerala Blast,7777,3,6,3,5,15,16,-1,21
Delhi Dynamo,7777,4,4,6,4,22,19,3,18
NorthEast Un,7777,5,5,3,6,12,11,1,18
Chennaiyin,7777,6,3,7,4,13,17,-4,16
FC Pune City,7777,7,4,3,7,13,18,-5,15
FC Goa,7777,8,3,4,7,11,18,-7,13
Mumbai City,7778,1,6,5,3,16,8,8,23
Kolkata,7778,2,5,7,2,17,13,4,22
Delhi Dynamo,7778,3,4,7,3,22,16,6,19
NorthEast Un,7778,4,5,3,6,10,10,0,18
FC Goa,7778,5,5,3,6,12,15,-3,18
Chennaiyin,7778,6,4,5,5,14,19,-5,17
FC Pune City,7778,7,4,4,6,12,15,-3,16
Kerala Blast,7778,8,4,4,6,10,17,-7,16
Mumbai City,7779,1,7,4,3,22,11,11,25
Delhi Dynamo,7779,2,6,5,3,29,22,7,23
FC Pune City,7779,3,5,3,6,14,15,-1,18
Kolkata,7779,4,4,6,4,15,17,-2,18
Kerala Blast,7779,5,5,3,6,14,18,-4,18
NorthEast Un,7779,6,5,2,7,12,13,-1,17
Chennaiyin,7779,7,4,5,5,14,18,-4,17
FC Goa,7779,8,5,2,7,11,17,-6,17
Mumbai City,7780,1,7,4,3,17,8,9,25
Delhi Dynamo,7780,2,5,6,3,24,17,7,21
Kolkata,7780,3,4,8,2,21,16,5,20
FC Pune City,7780,4,5,4,5,14,15,-1,19
Kerala Blast,7780,5,5,4,5,14,18,-4,19
NorthEast Un,7780,6,4,4,6,13,14,-1,16
Chennaiyin,7780,7,3,6,5,15,20,-5,15
FC Goa,7780,8,4,2,8,10,20,-10,14
Mumbai City,7781,1,7,4,3,19,10,9,25
FC Pune City,7781,2,5,4,5,15,16,-1,19
Kerala Blast,7781,3,5,4,5,12,16,-4,19
Delhi Dynamo,7781,4,4,6,4,25,20,5,18
Kolkata,7781,5,3,9,2,16,15,1,18
Chennaiyin,7781,6,4,6,4,16,19,-3,18
NorthEast Un,7781,7,5,2,7,14,15,-1,17
FC Goa,7781,8,3,5,6,11,17,-6,14
Mumbai City,7782,1,7,4,3,18,9,9,25
Delhi Dynamo,7782,2,6,5,3,28,16,12,23
Kolkata,7782,3,5,6,3,19,15,4,21
Chennaiyin,7782,4,4,6,4,17,19,-2,18
FC Pune City,7782,5,5,3,6,13,18,-5,18
Kerala Blast,7782,6,4,4,6,10,16,-6,16
FC Goa,7782,7,4,3,7,12,18,-6,15
NorthEast Un,7782,8,4,3,7,11,17,-6,15
Delhi Dynamo,7783,1,5,7,2,25,16,9,22
Mumbai City,7783,2,6,4,4,16,10,6,22
Kerala Blast,7783,3,6,4,4,19,15,4,22
Kolkata,7783,4,4,7,3,15,17,-2,19
Chennaiyin,7783,5,4,5,5,17,23,-6,17
FC Goa,7783,6,4,4,6,14,17,-3,16
FC Pune City,7783,7,4,4,6,14,18,-4,16
NorthEast Un,7783,8,4,3,7,11,15,-4,15
Kolkata,7784,1,6,6,2,20,15,5,24
Mumbai City,7784,2,6,4,4,17,10,7,22
Delhi Dynamo,7784,3,5,6,3,25,19,6,21
NorthEast Un,7784,4,5,3,6,14,13,1,18
FC Pune City,7784,5,5,3,6,15,18,-3,18
Kerala Blast,7784,6,5,3,6,13,18,-5,18
Chennaiyin,7784,7,3,6,5,15,20,-5,15
FC Goa,7784,8,4,3,7,12,18,-6,15
Mumbai City,7785,1,6,5,3,16,8,8,23
Delhi Dynamo,7785,2,5,7,2,26,17,9,22
FC Pune City,7785,3,6,3,5,16,14,2,21
NorthEast Un,7785,4,5,4,5,15,13,2,19
Kolkata,7785,5,4,6,4,16,18,-2,18
Kerala Blast,7785,6,5,3,6,12,17,-5,18
Chennaiyin,7785,7,3,6,5,14,19,-5,15
FC Goa,7785,8,4,2,8,11,20,-9,14
Mumbai City,7786,1,6,4,4,16,10,6,22
Delhi Dynamo,7786,2,5,6,3,27,19,8,21
Kerala Blast,7786,3,6,3,5,14,17,-3,21
Chennaiyin,7786,4,5,5,4,15,17,-2,20
Kolkata,7786,5,4,7,3,18,16,2,19
FC Pune City,7786,6,5,3,6,13,15,-2,18
NorthEast Un,7786,7,4,3,7,12,15,-3,15
FC Goa,7786,8,4,3,7,13,19,-6,15
Delhi Dynamo,7787,1,5,7,2,29,18,11,22
Mumbai City,7787,2,6,4,4,17,13,4,22
Kolkata,7787,3,5,6,3,17,16,1,21
Kerala Blast,7787,4,5,4,5,12,16,-4,19
FC Goa,7787,5,5,3,6,13,15,-2,18
Chennaiyin,7787,6,4,5,5,15,19,-4,17
NorthEast Un,7787,7,4,4,6,12,14,-2,16
FC Pune City,7787,8,4,3,7,13,17,-4,15
Mumbai City,7788,1,6,5,3,16,8,8,23
Kerala Blast,7788,2,6,4,4,11,13,-2,22
NorthEast Un,7788,3,6,2,6,14,11,3,20
Delhi Dynamo,7788,4,4,7,3,22,18,4,19
Kolkata,7788,5,4,6,4,14,16,-2,18
FC Goa,7788,6,5,3,6,12,14,-2,18
FC Pune City,7788,7,4,4,6,12,15,-3,16
Chennaiyin,7788,8,3,5,6,13,19,-6,14
Mumbai City,7789,1,6,5,3,16,8,8,23
Delhi Dynamo,7789,2,5,6,3,23,15,8,21
Chennaiyin,7789,3,5,5,4,16,17,-1,20
Kerala Blast,7789,4,5,5,4,14,17,-3,20
FC Pune City,7789,5,5,4,5,15,16,-1,19
NorthEast Un,7789,6,5,2,7,12,14,-2,17
Kolkata,7789,7,3,7,4,15,16,-1,16
FC Goa,7789,8,4,2,8,9,17,-8,14
Mumbai City,7790,1,6,5,3,18,10,8,23
Kolkata,7790,2,5,6,3,19,16,3,21
NorthEast Un,7790,3,6,2,6,13,13,0,20
Delhi Dynamo,7790,4,4,7,3,24,18,6,19
FC Pune City,7790,5,5,3,6,14,17,-3,18
Kerala Blast,7790,6,5,3,6,13,18,-5,18
FC Goa,7790,7,4,4,6,11,15,-4,16
Chennaiyin,7790,8,3,6,5,13,18,-5,15
Mumbai City,7791,1,7,4,3,18,9,9,25
Delhi Dynamo,7791,2,5,6,3,23,16,7,21
Kerala Blast,7791,3,5,4,5,13,15,-2,19
NorthEast Un,7791,4,5,3,6,10,10,0,18
Chennaiyin,7791,5,4,6,4,16,19,-3,18
Kolkata,7791,6,3,8,3,15,15,0,17
FC Pune City,7791,7,4,4,6,13,18,-5,16
FC Goa,7791,8,4,3,7,11,17,-6,15
Mumbai City,7792,1,7,4,3,19,9,10,25
Delhi Dynamo,7792,2,6,5,3,26,19,7,23
Kolkata,7792,3,5,6,3,17,15,2,21
Kerala Blast,7792,4,5,4,5,12,16,-4,19
NorthEast Un,7792,5,5,3,6,13,12,1,18
Chennaiyin,7792,6,4,6,4,15,18,-3,18
FC Pune City,7792,7,4,4,6,14,17,-3,16
FC Goa,7792,8,3,2,9,9,19,-10,11
Mumbai City,7793,1,6,5,3,17,9,8,23
Delhi Dynamo,7793,2,5,7,2,24,16,8,22
FC Pune City,7793,3,6,3,5,16,16,0,21
Kerala Blast,7793,4,5,4,5,13,17,-4,19
FC Goa,7793,5,5,3,6,13,17,-4,18
NorthEast Un,7793,6,4,4,6,11,12,-1,16
Kolkata,7793,7,3,6,5,16,18,-2,15
Chennaiyin,7793,8,3,6,5,15,20,-5,15
Mumbai City,7794,1,7,4,3,19,10,9,25
Kolkata,7794,2,5,7,2,22,13,9,22
Delhi Dynamo,7794,3,5,5,4,25,21,4,20
NorthEast Un,7794,4,6,2,6,16,12,4,20
Kerala Blast,7794,5,5,3,6,11,20,-9,18
Chennaiyin,7794,6,4,5,5,16,21,-5,17
FC Pune City,7794,7,4,4,6,14,17,-3,16
FC Goa,7794,8,4,2,8,11,20,-9,14
Mumbai City,7795,1,6,5,3,16,8,8,23
FC Pune City,7795,2,6,3,5,15,15,0,21
Delhi Dynamo,7795,3,4,7,3,22,17,5,19
NorthEast Un,7795,4,5,4,5,12,10,2,19
Kolkata,7795,5,4,6,4,16,16,0,18
FC Goa,7795,6,5,3,6,12,15,-3,18
Chennaiyin,7795,7,3,7,4,14,18,-4,16
Kerala Blast,7795,8,4,3,7,12,20,-8,15
Delhi Dynamo,7796,1,6,6,2,26,17,9,24
Mumbai City,7796,2,6,4,4,17,10,7,22
Kolkata,7796,3,5,7,2,18,13,5,22
Kerala Blast,7796,4,6,4,4,13,14,-1,22
NorthEast Un,7796,5,4,4,6,11,13,-2,16
Chennaiyin,7796,6,3,6,5,16,21,-5,15
FC Pune City,7796,7,4,3,7,12,18,-6,15
FC Goa,7796,8,4,2,8,12,19,-7,14
Mumbai City,7797,1,7,4,3,19,9,10,25
Kolkata,7797,2,6,6,2,19,13,6,24
Delhi Dynamo,7797,3,6,5,3,28,17,11,23
NorthEast Un,7797,4,6,2,6,12,12,0,20
FC Pune City,7797,5,5,3,6,14,15,-1,18
Kerala Blast,7797,6,4,3,7,10,18,-8,15
Chennaiyin,7797,7,3,5,6,15,21,-6,14
FC Goa,7797,8,4,2,8,10,22,-12,14
Mumbai City,7798,1,6,5,3,17,9,8,23
Kolkata,7798,2,4,8,2,16,14,2,20
NorthEast Un,7798,3,6,2,6,14,13,1,20
Chennaiyin,7798,4,5,5,4,17,18,-1,20
Delhi Dynamo,7798,5,4,7,3,25,20,5,19
FC Pune City,7798,6,5,3,6,14,16,-2,18
Kerala Blast,7798,7,4,4,6,10,16,-6,16
FC Goa,7798,8,3,4,7,12,19,-7,13
Mumbai City,7799,1,7,4,3,17,8,9,25
Kolkata,7799,2,6,6,2,21,14,7,24
Delhi Dynamo,7799,3,6,5,3,24,16,8,23
NorthEast Un,7799,4,6,2,6,14,13,1,20
FC Pune City,7799,5,4,4,6,13,17,-4,16
Kerala Blast,7799,6,4,4,6,12,19,-7,16
Chennaiyin,7799,7,3,5,6,14,20,-6,14
FC Goa,7799,8,4,2,8,10,18,-8,14
Mumbai City,7800,1,7,4,3,19,9,10,25
Kolkata,7800,2,5,7,2,18,15,3,22
Delhi Dynamo,7800,3,5,6,3,24,18,6,21
Kerala Blast,7800,4,5,4,5,15,19,-4,19
FC Pune City,7800,5,5,3,6,17,19,-2,18
Chennaiyin,7800,6,4,5,5,20,21,-1,17
NorthEast Un,7800,7,4,3,7,12,17,-5,15
FC Goa,7800,8,4,2,8,12,19,-7,14
Mumbai City,7801,1,7,4,3,19,9,10,25
Kerala Blast,7801,2,6,4,4,12,14,-2,22
Delhi Dynamo,7801,3,5,5,4,26,21,5,20
Kolkata,7801,4,4,7,3,15,14,1,19
Chennaiyin,7801,5,4,6,4,15,18,-3,18
FC Goa,7801,6,5,2,7,13,18,-5,17
NorthEast Un,7801,7,4,3,7,11,13,-2,15
FC Pune City,7801,8,4,3,7,13,17,-4,15
Mumbai City,7802,1,6,5,3,17,9,8,23
Delhi Dynamo,7802,2,5,6,3,23,16,7,21
NorthEast Un,7802,3,6,2,6,12,12,0,20
Kerala Blast,7802,4,5,4,5,11,15,-4,19
Chennaiyin,7802,5,4,6,4,17,19,-2,18
FC Pune City,7802,6,4,5,5,13,15,-2,17
Kolkata,7802,7,3,7,4,13,15,-2,16
FC Goa,7802,8,4,3,7,11,16,-5,15
Kerala Blast,7803,1,7,3,4,14,14,0,24
Mumbai City,7803,2,6,5,3,16,8,8,23
Delhi Dynamo,7803,3,5,7,2,23,15,8,22
Kolkata,7803,4,4,7,3,17,16,1,19
Chennaiyin,7803,5,4,6,4,15,18,-3,18
NorthEast Un,7803,6,4,3,7,9,11,-2,15
FC Pune City,7803,7,4,3,7,14,19,-5,15
FC Goa,7803,8,3,4,7,11,18,-7,13
Kolkata,7804,1,6,6,2,19,14,5,24
Delhi Dynamo,7804,2,6,5,3,27,21,6,23
Mumbai City,7804,3,6,4,4,17,10,7,22
Chennaiyin,7804,4,5,5,4,18,19,-1,20
Kerala Blast,7804,5,5,4,5,12,17,-5,19
NorthEast Un,7804,6,5,2,7,13,13,0,17
FC Pune City,7804,7,4,4,6,13,16,-3,16
FC Goa,7804,8,3,2,9,13,22,-9,11
Mumbai City,7805,1,6,4,4,16,10,6,22
Delhi Dynamo,7805,2,5,6,3,25,17,8,21
FC Pune City,7805,3,6,3,5,15,15,0,21
NorthEast Un,7805,4,6,2,6,13,12,1,20
Kerala Blast,7805,5,5,4,5,12,16,-4,19
FC Goa,7805,6,5,3,6,13,15,-2,18
Kolkata,7805,7,3,7,4,15,17,-2,16
Chennaiyin,7805,8,3,5,6,13,20,-7,14
Mumbai City,7806,1,6,5,3,17,9,8,23
Delhi Dynamo,7806,2,5,7,2,24,16,8,22
Kolkata,7806,3,4,8,2,18,16,2,20
FC Pune City,7806,4,4,5,5,13,15,-2,17
Kerala Blast,7806,5,4,5,5,10,15,-5,17
NorthEast Un,7806,6,4,4,6,9,10,-1,16
FC Goa,7806,7,4,4,6,12,17,-5,16
Chennaiyin,7806,8,3,6,5,13,18,-5,15
Mumbai City,7807,1,7,4,3,19,9,10,25
Kolkata,7807,2,5,7,2,17,14,3,22
Kerala Blast,7807,3,6,3,5,16,18,-2,21
Delhi Dynamo,7807,4,4,6,4,23,19,4,18
NorthEast Un,7807,5,5,3,6,14,15,-1,18
Chennaiyin,7807,6,3,7,4,14,18,-4,16
FC Pune City,7807,7,4,3,7,13,17,-4,15
FC Goa,7807,8,3,5,6,9,15,-6,14
Mumbai City,7808,1,6,5,3,16,8,8,23
Delhi Dynamo,7808,2,5,7,2,25,15,10,22
Kerala Blast,7808,3,6,4,4,15,15,0,22
Chennaiyin,7808,4,4,6,4,14,17,-3,18
Kolkata,7808,5,3,8,3,16,20,-4,17
NorthEast Un,7808,6,4,4,6,10,11,-1,16
FC Pune City,7808,7,4,4,6,13,18,-5,16
FC Goa,7808,8,4,2,8,13,18,-5,14
Delhi Dynamo,7809,1,6,6,2,24,15,9,24
Mumbai City,7809,2,6,4,4,17,10,7,22
Kolkata,7809,3,4,8,2,15,13,2,20
Kerala Blast,7809,4,5,5,4,13,15,-2,20
FC Pune City,7809,5,4,5,5,13,15,-2,17
Chennaiyin,7809,6,4,5,5,14,20,-6,17
FC Goa,7809,7,4,3,7,11,15,-4,15
NorthEast Un,7809,8,4,2,8,9,13,-4,14
Mumbai City,7810,1,7,4,3,22,9,13,25
Kolkata,7810,2,5,6,3,16,14,2,21
Kerala Blast,7810,3,6,3,5,12,14,-2,21
Delhi Dynamo,7810,4,4,7,3,23,21,2,19
Chennaiyin,7810,5,4,6,4,14,17,-3,18
NorthEast Un,7810,6,4,4,6,9,10,-1,16
FC Pune City,7810,7,4,3,7,13,18,-5,15
FC Goa,7810,8,4,3,7,10,16,-6,15
Mumbai City,7811,1,7,4,3,17,8,9,25
FC Pune City,7811,2,6,3,5,14,14,0,21
Kolkata,7811,3,4,6,4,17,16,1,18
Chennaiyin,7811,4,4,6,4,17,19,-2,18
FC Goa,7811,5,5,3,6,11,15,-4,18
Kerala Blast,7811,6,5,3,6,14,20,-6,18
Delhi Dynamo,7811,7,4,5,5,22,20,2,17
NorthEast Un,7811,8,5,2,7,16,16,0,17
Mumbai City,7812,1,6,5,3,16,8,8,23
Chennaiyin,7812,2,5,5,4,18,19,-1,20
Kerala Blast,7812,3,5,5,4,13,16,-3,20
Delhi Dynamo,7812,4,4,7,3,21,17,4,19
Kolkata,7812,5,3,9,2,14,13,1,18
NorthEast Un,7812,6,5,2,7,16,16,0,17
FC Pune City,7812,7,4,5,5,14,16,-2,17
FC Goa,7812,8,3,4,7,8,15,-7,13
Mumbai City,7813,1,7,4,3,18,8,10,25
Kolkata,7813,2,5,7,2,20,16,4,22
Delhi Dynamo,7813,3,5,6,3,24,17,7,21
Kerala Blast,7813,4,5,4,5,16,21,-5,19
Chennaiyin,7813,5,4,6,4,18,20,-2,18
FC Pune City,7813,6,5,3,6,15,17,-2,18
NorthEast Un,7813,7,4,2,8,13,18,-5,14
FC Goa,7813,8,3,4,7,11,18,-7,13
Mumbai City,7814,1,7,4,3,17,8,9,25
Kolkata,7814,2,6,6,2,18,13,5,24
NorthEast Un,7814,3,6,3,5,15,12,3,21
Delhi Dynamo,7814,4,4,6,4,24,19,5,18
FC Pune City,7814,5,5,3,6,14,16,-2,18
Kerala Blast,7814,6,4,4,6,11,18,-7,16
FC Goa,7814,7,4,3,7,12,18,-6,15
Chennaiyin,7814,8,3,5,6,14,21,-7,14
Delhi Dynamo,7815,1,7,5,2,28,16,12,26
Mumbai City,7815,2,6,4,4,17,11,6,22
Kolkata,7815,3,5,7,2,18,15,3,22
Kerala Blast,7815,4,6,3,5,14,16,-2,21
Chennaiyin,7815,5,3,7,4,15,19,-4,16
NorthEast Un,7815,6,4,3,7,12,15,-3,15
FC Pune City,7815,7,4,3,7,13,18,-5,15
FC Goa,7815,8,3,4,7,10,17,-7,13
Mumbai City,7816,1,6,5,3,16,8,8,23
Delhi Dynamo,7816,2,5,6,3,22,16,6,21
Kolkata,7816,3,4,8,2,19,14,5,20
Kerala Blast,7816,4,5,4,5,13,20,-7,19
FC Pune City,7816,5,4,5,5,12,14,-2,17
Chennaiyin,7816,6,3,7,4,14,18,-4,16
FC Goa,7816,7,4,4,6,10,14,-4,16
NorthEast Un,7816,8,4,3,7,11,13,-2,15
Mumbai City,7817,1,7,4,3,18,9,9,25
Kerala Blast,7817,2,6,4,4,18,14,4,22
Delhi Dynamo,7817,3,5,6,3,24,17,7,21
Kolkata,7817,4,5,6,3,20,15,5,21
Chennaiyin,7817,5,4,6,4,16,19,-3,18
NorthEast Un,7817,6,4,5,5,12,12,0,17
FC Pune City,7817,7,4,3,7,12,21,-9,15
FC Goa,7817,8,3,2,9,10,23,-13,11
Mumbai City,7818,1,7,4,3,18,9,9,25
FC Pune City,7818,2,6,3,5,15,15,0,21
Kolkata,7818,3,4,7,3,15,14,1,19
Delhi Dynamo,7818,4,4,6,4,24,21,3,18
Chennaiyin,7818,5,4,6,4,15,18,-3,18
Kerala Blast,7818,6,5,3,6,12,17,-5,18
FC Goa,7818,7,4,4,6,13,16,-3,16
NorthEast Un,7818,8,4,3,7,12,14,-2,15
Mumbai City,7819,1,7,4,3,17,8,9,25
Kolkata,7819,2,6,6,2,17,13,4,24
Delhi Dynamo,7819,3,4,7,3,24,18,6,19
NorthEast Un,7819,4,5,4,5,14,13,1,19
FC Pune City,7819,5,5,3,6,16,18,-2,18
Chennaiyin,7819,6,4,5,5,17,19,-2,17
Kerala Blast,7819,7,4,4,6,12,18,-6,16
FC Goa,7819,8,3,3,8,9,19,-10,12
Mumbai City,7820,1,7,4,3,18,8,10,25
Delhi Dynamo,7820,2,5,6,3,25,19,6,21
Kolkata,7820,3,5,6,3,16,14,2,21
NorthEast Un,7820,4,5,4,5,14,12,2,19
Chennaiyin,7820,5,4,6,4,15,18,-3,18
FC Pune City,7820,6,4,4,6,13,17,-4,16
Kerala Blast,7820,7,4,4,6,10,17,-7,16
FC Goa,7820,8,4,2,8,11,17,-6,14
Delhi Dynamo,7821,1,6,5,3,25,17,8,23
Mumbai City,7821,2,6,4,4,16,9,7,22
Kolkata,7821,3,5,6,3,18,14,4,21
Kerala Blast,7821,4,5,4,5,14,17,-3,19
NorthEast Un,7821,5,5,3,6,12,11,1,18
FC Pune City,7821,6,5,3,6,13,17,-4,18
Chennaiyin,7821,7,4,5,5,14,19,-5,17
FC Goa,7821,8,4,2,8,11,19,-8,14
Kerala Blast,7822,1,7,3,4,17,14,3,24
Mumbai City,7822,2,6,5,3,17,9,8,23
Delhi Dynamo,7822,3,5,7,2,27,16,11,22
Chennaiyin,7822,4,4,6,4,17,20,-3,18
Kolkata,7822,5,3,7,4,15,17,-2,16
FC Goa,7822,6,4,4,6,13,18,-5,16
FC Pune City,7822,6,4,4,6,13,18,-5,16
NorthEast Un,7822,8,4,2,8,9,16,-7,14
Mumbai City,7823,1,6,5,3,19,11,8,23
NorthEast Un,7823,2,7,2,5,15,10,5,23
Kolkata,7823,3,5,6,3,17,16,1,21
Delhi Dynamo,7823,4,4,6,4,24,20,4,18
FC Pune City,7823,5,5,3,6,13,16,-3,18
FC Goa,7823,6,5,2,7,14,16,-2,17
Chennaiyin,7823,7,4,5,5,14,18,-4,17
Kerala Blast,7823,8,4,3,7,10,19,-9,15
Mumbai City,7824,1,7,4,3,18,8,10,25
Delhi Dynamo,7824,2,5,5,4,24,18,6,20
Kerala Blast,7824,3,5,5,4,12,15,-3,20
FC Pune City,7824,4,5,3,6,15,16,-1,18
Chennaiyin,7824,5,4,6,4,16,18,-2,18
Kolkata,7824,6,3,8,3,14,15,-1,17
NorthEast Un,7824,7,4,4,6,10,12,-2,16
FC Goa,7824,8,4,3,7,10,17,-7,15
Mumbai City,7825,1,7,4,3,17,8,9,25
NorthEast Un,7825,2,7,2,5,12,9,3,23
Kolkata,7825,3,4,7,3,15,14,1,19
FC Pune City,7825,4,5,3,6,14,15,-1,18
Kerala Blast,7825,5,5,3,6,10,16,-6,18
Delhi Dynamo,7825,6,4,5,5,21,18,3,17
Chennaiyin,7825,7,4,5,5,15,19,-4,17
FC Goa,7825,8,4,3,7,12,17,-5,15
NorthEast Un,7826,1,7,2,5,13,9,4,23
Mumbai City,7826,2,6,4,4,16,11,5,22
Kolkata,7826,3,5,6,3,21,14,7,21
Delhi Dynamo,7826,4,5,5,4,26,19,7,20
FC Goa,7826,5,6,2,6,16,19,-3,20
FC Pune City,7826,6,5,3,6,13,17,-4,18
Kerala Blast,7826,7,4,3,7,9,19,-10,15
Chennaiyin,7826,8,3,5,6,15,21,-6,14
Mumbai City,7827,1,7,4,3,19,10,9,25
Delhi Dynamo,7827,2,6,5,3,25,17,8,23
Kolkata,7827,3,5,7,2,18,13,5,22
Chennaiyin,7827,4,5,5,4,17,17,0,20
Kerala Blast,7827,5,5,4,5,12,17,-5,19
FC Pune City,7827,6,4,4,6,14,17,-3,16
NorthEast Un,7827,7,4,3,7,10,14,-4,15
FC Goa,7827,8,3,2,9,8,18,-10,11
Mumbai City,7828,1,6,5,3,17,9,8,23
Delhi Dynamo,7828,2,5,7,2,24,16,8,22
Kolkata,7828,3,4,8,2,17,15,2,20
Kerala Blast,7828,4,4,6,4,10,14,-4,18
Chennaiyin,7828,5,4,5,5,15,20,-5,17
FC Pune City,7828,6,4,4,6,13,16,-3,16
FC Goa,7828,7,4,4,6,12,16,-4,16
NorthEast Un,7828,8,4,3,7,10,12,-2,15
Delhi Dynamo,7829,1,6,6,2,23,14,9,24
Mumbai City,7829,2,6,5,3,16,8,8,23
FC Pune City,7829,3,6,3,5,14,14,0,21
Chennaiyin,7829,4,5,5,4,16,18,-2,20
Kolkata,7829,5,3,8,3,15,15,0,17
Kerala Blast,7829,6,4,5,5,11,16,-5,17
NorthEast Un,7829,7,4,3,7,10,12,-2,15
FC Goa,7829,8,3,3,8,10,18,-8,12
Mumbai City,7830,1,7,4,3,19,10,9,25
Kolkata,7830,2,5,6,3,18,14,4,21
Delhi Dynamo,7830,3,5,5,4,24,18,6,20
FC Pune City,7830,4,5,4,5,13,14,-1,19
Kerala Blast,7830,5,5,4,5,11,16,-5,19
NorthEast Un,7830,6,5,2,7,12,14,-2,17
Chennaiyin,7830,7,4,5,5,16,21,-5,17
FC Goa,7830,8,4,2,8,11,17,-6,14
Delhi Dynamo,7831,1,6,6,2,25,15,10,24
Mumbai City,7831,2,6,4,4,16,9,7,22
Kolkata,7831,3,5,6,3,18,14,4,21
Kerala Blast,7831,4,6,3,5,14,15,-1,21
NorthEast Un,7831,5,5,3,6,11,11,0,18
Chennaiyin,7831,6,4,5,5,16,19,-3,17
FC Pune City,7831,7,4,3,7,12,19,-7,15
FC Goa,7831,8,4,2,8,10,20,-10,14
Mumbai City,7832,1,7,4,3,19,9,10,25
Delhi Dynamo,7832,2,4,7,3,23,18,5,19
Kolkata,7832,3,4,7,3,18,14,4,19
FC Pune City,7832,4,5,4,5,15,15,0,19
FC Goa,7832,5,5,3,6,13,16,-3,18
Kerala Blast,7832,6,5,3,6,11,20,-9,18
NorthEast Un,7832,7,4,4,6,10,11,-1,16
Chennaiyin,7832,8,3,6,5,14,20,-6,15
Mumbai City,7833,1,7,4,3,19,10,9,25
Kerala Blast,7833,2,7,3,4,15,14,1,24
Delhi Dynamo,7833,3,5,6,3,26,17,9,21
Kolkata,7833,4,4,7,3,14,15,-1,19
NorthEast Un,7833,5,5,2,7,11,14,-3,17
Chennaiyin,7833,6,4,5,5,14,18,-4,17
FC Pune City,7833,7,4,3,7,12,16,-4,15
FC Goa,7833,8,3,4,7,8,15,-7,13
Delhi Dynamo,7834,1,6,5,3,23,15,8,23
Mumbai City,7834,2,6,4,4,16,9,7,22
Kolkata,7834,3,5,6,3,16,14,2,21
Kerala Blast,7834,4,6,3,5,14,16,-2,21
NorthEast Un,7834,5,5,3,6,10,12,-2,18
Chennaiyin,7834,6,3,7,4,15,19,-4,16
FC Pune City,7834,7,4,3,7,13,17,-4,15
FC Goa,7834,8,4,3,7,12,17,-5,15
Mumbai City,7835,1,7,4,3,20,8,12,25
Kolkata,7835,2,6,6,2,19,12,7,24
Kerala Blast,7835,3,6,3,5,13,17,-4,21
Delhi Dynamo,7835,4,4,6,4,22,21,1,18
Chennaiyin,7835,5,4,5,5,16,19,-3,17
FC Goa,7835,6,5,2,7,12,16,-4,17
NorthEast Un,7835,7,4,3,7,11,14,-3,15
FC Pune City,7835,8,4,3,7,13,19,-6,15
Delhi Dynamo,7836,1,6,5,3,24,15,9,23
Mumbai City,7836,2,6,4,4,16,10,6,22
Kerala Blast,7836,3,6,4,4,13,15,-2,22
FC Goa,7836,4,6,2,6,14,15,-1,20
Kolkata,7836,5,4,7,3,18,16,2,19
NorthEast Un,7836,6,5,2,7,13,13,0,17
FC Pune City,7836,7,4,3,7,15,20,-5,15
Chennaiyin,7836,8,3,5,6,16,25,-9,14
Mumbai City,7837,1,7,4,3,19,9,10,25
Kolkata,7837,2,5,6,3,20,15,5,21
NorthEast Un,7837,3,6,3,5,14,10,4,21
FC Pune City,7837,4,6,3,5,15,15,0,21
Delhi Dynamo,7837,5,4,5,5,24,22,2,17
FC Goa,7837,6,5,2,7,14,18,-4,17
Kerala Blast,7837,7,4,4,6,10,18,-8,16
Chennaiyin,7837,8,3,5,6,14,23,-9,14
Mumbai City,7838,1,7,4,3,17,8,9,25
Kerala Blast,7838,2,7,3,4,15,14,1,24
Delhi Dynamo,7838,3,6,5,3,25,16,9,23
Kolkata,7838,4,4,6,4,14,14,0,18
FC Pune City,7838,5,5,3,6,14,16,-2,18
Chennaiyin,7838,6,4,5,5,15,18,-3,17
NorthEast Un,7838,7,4,2,8,10,16,-6,14
FC Goa,7838,8,4,2,8,9,17,-8,14
Mumbai City,7839,1,6,4,4,17,10,7,22
Delhi Dynamo,7839,2,5,6,3,24,19,5,21
Kerala Blast,7839,3,6,3,5,14,15,-1,21
Kolkata,7839,4,4,7,3,17,16,1,19
Chennaiyin,7839,5,4,6,4,17,18,-1,18
NorthEast Un,7839,6,5,2,7,12,15,-3,17
FC Pune City,7839,7,4,4,6,13,16,-3,16
FC Goa,7839,8,4,4,6,12,17,-5,16
Mumbai City,7840,1,7,4,3,18,8,10,25
Kerala Blast,7840,2,6,4,4,14,14,0,22
Kolkata,7840,3,4,8,2,15,12,3,20
Delhi Dynamo,7840,4,4,6,4,23,19,4,18
NorthEast Un,7840,5,5,3,6,10,10,0,18
FC Pune City,7840,6,4,4,6,13,18,-5,16
Chennaiyin,7840,7,3,6,5,15,20,-5,15
FC Goa,7840,8,4,3,7,13,20,-7,15
Mumbai City,7841,1,7,4,3,18,9,9,25
Kolkata,7841,2,5,7,2,22,17,5,22
Kerala Blast,7841,3,6,3,5,15,18,-3,21
NorthEast Un,7841,4,5,3,6,13,12,1,18
Delhi Dynamo,7841,5,4,5,5,22,20,2,17
FC Pune City,7841,6,4,4,6,16,19,-3,16
Chennaiyin,7841,7,3,7,4,15,19,-4,16
FC Goa,7841,8,4,3,7,10,17,-7,15
Delhi Dynamo,7842,1,6,6,2,27,18,9,24
Mumbai City,7842,2,6,4,4,18,11,7,22
Kolkata,7842,3,5,6,3,15,13,2,21
Kerala Blast,7842,4,5,4,5,12,15,-3,19
FC Goa,7842,5,5,3,6,12,15,-3,18
FC Pune City,7842,6,4,4,6,13,16,-3,16
NorthEast Un,7842,7,4,3,7,10,13,-3,15
Chennaiyin,7842,8,3,6,5,13,19,-6,15
Delhi Dynamo,7843,1,6,6,2,25,15,10,24
Kerala Blast,7843,2,7,3,4,15,16,-1,24
Mumbai City,7843,3,6,5,3,17,9,8,23
FC Pune City,7843,4,5,3,6,17,16,1,18
NorthEast Un,7843,5,5,2,7,13,13,0,17
FC Goa,7843,6,5,2,7,11,17,-6,17
Kolkata,7843,7,3,6,5,16,21,-5,15
Chennaiyin,7843,8,3,5,6,15,22,-7,14
Mumbai City,7844,1,6,5,3,16,8,8,23
Delhi Dynamo,7844,2,5,6,3,24,18,6,21
NorthEast Un,7844,3,6,3,5,14,11,3,21
FC Pune City,7844,4,6,3,5,15,15,0,21
Kolkata,7844,5,3,8,3,14,14,0,17
Kerala Blast,7844,6,4,4,6,10,16,-6,16
FC Goa,7844,7,4,3,7,13,18,-5,15
Chennaiyin,7844,8,3,6,5,15,21,-6,15
Mumbai City,7845,1,7,4,3,19,9,10,25
Kerala Blast,7845,2,6,4,4,14,15,-1,22
Delhi Dynamo,7845,3,5,6,3,25,17,8,21
Chennaiyin,7845,4,5,5,4,18,19,-1,20
FC Pune City,7845,5,4,5,5,13,15,-2,17
Kolkata,7845,6,3,7,4,13,17,-4,16
NorthEast Un,7845,7,4,3,7,11,14,-3,15
FC Goa,7845,8,4,2,8,12,19,-7,14
Mumbai City,7846,1,6,5,3,18,10,8,23
Delhi Dynamo,7846,2,5,6,3,24,17,7,21
FC Pune City,7846,3,5,4,5,14,15,-1,19
FC Goa,7846,4,5,3,6,14,15,-1,18
Chennaiyin,7846,5,4,6,4,15,17,-2,18
Kolkata,7846,6,3,8,3,16,19,-3,17
Kerala Blast,7846,7,4,5,5,12,17,-5,17
NorthEast Un,7846,8,4,3,7,11,14,-3,15
Mumbai City,7847,1,7,4,3,18,8,10,25
FC Pune City,7847,2,6,3,5,18,16,2,21
Delhi Dynamo,7847,3,4,6,4,22,18,4,18
FC Goa,7847,4,5,3,6,15,15,0,18
Kolkata,7847,5,4,6,4,17,19,-2,18
NorthEast Un,7847,6,5,3,6,12,14,-2,18
Kerala Blast,7847,7,5,3,6,16,22,-6,18
Chennaiyin,7847,8,3,6,5,13,19,-6,15
Mumbai City,7848,1,7,4,3,17,8,9,25
Delhi Dynamo,7848,2,5,6,3,24,16,8,21
FC Pune City,7848,3,6,3,5,17,14,3,21
Kerala Blast,7848,4,5,4,5,16,18,-2,19
NorthEast Un,7848,5,5,3,6,12,13,-1,18
Kolkata,7848,6,3,8,3,17,19,-2,17
FC Goa,7848,7,4,3,7,12,18,-6,15
Chennaiyin,7848,8,3,5,6,13,22,-9,14
Mumbai City,7849,1,7,4,3,17,8,9,25
Kolkata,7849,2,5,6,3,17,16,1,21
Kerala Blast,7849,3,6,3,5,15,16,-1,21
Delhi Dynamo,7849,4,4,7,3,25,19,6,19
FC Pune City,7849,5,5,3,6,16,17,-1,18
Chennaiyin,7849,6,4,5,5,14,20,-6,17
NorthEast Un,7849,7,4,3,7,11,14,-3,15
FC Goa,7849,8,4,3,7,15,20,-5,15
Delhi Dynamo,7850,1,6,6,2,24,15,9,24
Mumbai City,7850,2,6,4,4,16,9,7,22
Kolkata,7850,3,5,6,3,18,16,2,21
FC Pune City,7850,4,6,3,5,17,15,2,21
NorthEast Un,7850,5,5,3,6,11,10,1,18
Chennaiyin,7850,6,4,5,5,16,19,-3,17
Kerala Blast,7850,7,4,4,6,12,20,-8,16
FC Goa,7850,8,3,3,8,9,19,-10,12
Mumbai City,7851,1,7,4,3,18,8,10,25
Kerala Blast,7851,2,6,4,4,12,14,-2,22
Delhi Dynamo,7851,3,5,6,3,24,18,6,21
Chennaiyin,7851,4,5,5,4,18,18,0,20
Kolkata,7851,5,4,6,4,15,16,-1,18
FC Pune City,7851,6,4,4,6,13,16,-3,16
NorthEast Un,7851,7,4,3,7,13,15,-2,15
FC Goa,7851,8,4,2,8,10,18,-8,14
Kerala Blast,7852,1,7,3,4,17,16,1,24
Delhi Dynamo,7852,2,6,5,3,24,16,8,23
Mumbai City,7852,3,6,4,4,16,10,6,22
Kolkata,7852,4,4,6,4,16,18,-2,18
FC Pune City,7852,5,5,3,6,15,17,-2,18
NorthEast Un,7852,6,5,2,7,12,12,0,17
FC Goa,7852,7,4,3,7,13,18,-5,15
Chennaiyin,7852,8,3,6,5,15,21,-6,15
Delhi Dynamo,7853,1,6,5,3,27,16,11,23
Mumbai City,7853,2,6,4,4,17,10,7,22
Kolkata,7853,3,4,7,3,16,15,1,19
FC Pune City,7853,4,5,4,5,13,14,-1,19
NorthEast Un,7853,5,5,3,6,12,12,0,18
Chennaiyin,7853,6,4,6,4,16,19,-3,18
Kerala Blast,7853,7,4,5,5,12,17,-5,17
FC Goa,7853,8,3,4,7,9,19,-10,13
Delhi Dynamo,7854,1,6,5,3,29,15,14,23
Mumbai City,7854,2,6,4,4,16,10,6,22
Kolkata,7854,3,5,7,2,17,13,4,22
NorthEast Un,7854,4,6,2,6,11,12,-1,20
Kerala Blast,7854,5,5,4,5,13,16,-3,19
FC Pune City,7854,6,4,5,5,13,15,-2,17
Chennaiyin,7854,7,3,5,6,13,20,-7,14
FC Goa,7854,8,4,2,8,11,22,-11,14
Delhi Dynamo,7855,1,6,5,3,24,16,8,23
Mumbai City,7855,2,6,4,4,17,10,7,22
Kolkata,7855,3,5,6,3,18,15,3,21
Kerala Blast,7855,4,6,3,5,13,17,-4,21
FC Pune City,7855,5,5,3,6,14,15,-1,18
Chennaiyin,7855,6,4,6,4,16,19,-3,18
NorthEast Un,7855,7,5,2,7,11,12,-1,17
FC Goa,7855,8,3,3,8,10,19,-9,12
Mumbai City,7856,1,6,5,3,17,9,8,23
Chennaiyin,7856,2,5,5,4,15,17,-2,20
Delhi Dynamo,7856,3,4,7,3,22,16,6,19
Kolkata,7856,4,4,6,4,16,14,2,18
NorthEast Un,7856,5,5,3,6,11,10,1,18
FC Pune City,7856,6,5,3,6,14,17,-3,18
Kerala Blast,7856,7,5,3,6,12,19,-7,18
FC Goa,7856,8,5,2,7,10,15,-5,17
Mumbai City,7857,1,7,4,3,18,8,10,25
Kerala Blast,7857,2,6,4,4,14,14,0,22
Kolkata,7857,3,5,6,3,16,14,2,21
Delhi Dynamo,7857,4,4,6,4,22,18,4,18
NorthEast Un,7857,5,4,5,5,11,11,0,17
Chennaiyin,7857,6,3,7,4,14,18,-4,16
FC Pune City,7857,7,4,3,7,13,19,-6,15
FC Goa,7857,8,4,3,7,10,16,-6,15
Delhi Dynamo,7858,1,5,7,2,24,16,8,22
Mumbai City,7858,2,6,4,4,16,9,7,22
Kolkata,7858,3,5,6,3,17,14,3,21
Kerala Blast,7858,4,6,3,5,11,14,-3,21
NorthEast Un,7858,5,5,4,5,11,10,1,19
Chennaiyin,7858,6,3,7,4,14,18,-4,16
FC Pune City,7858,7,4,3,7,12,17,-5,15
FC Goa,7858,8,3,4,7,11,18,-7,13
Mumbai City,7859,1,7,4,3,22,8,14,25
Delhi Dynamo,7859,2,5,5,4,27,26,1,20
Kolkata,7859,3,4,7,3,16,15,1,19
Kerala Blast,7859,4,5,4,5,11,15,-4,19
NorthEast Un,7859,5,5,3,6,12,12,0,18
FC Goa,7859,6,5,3,6,14,18,-4,18
FC Pune City,7859,7,4,4,6,14,17,-3,16
Chennaiyin,7859,8,3,6,5,13,18,-5,15
Mumbai City,7860,1,6,5,3,16,8,8,23
Delhi Dynamo,7860,2,5,7,2,24,16,8,22
Kolkata,7860,3,5,7,2,18,14,4,22
Kerala Blast,7860,4,5,4,5,13,15,-2,19
FC Pune City,7860,5,4,5,5,13,15,-2,17
Chennaiyin,7860,6,4,5,5,15,19,-4,17
FC Goa,7860,7,4,3,7,10,17,-7,15
NorthEast Un,7860,8,4,2,8,11,16,-5,14
Mumbai City,7861,1,6,5,3,17,9,8,23
Kolkata,7861,2,5,7,2,15,12,3,22
Delhi Dynamo,7861,3,4,8,2,24,17,7,20
NorthEast Un,7861,4,5,4,5,11,9,2,19
Chennaiyin,7861,5,4,5,5,15,19,-4,17
Kerala Blast,7861,6,4,5,5,12,17,-5,17
FC Pune City,7861,7,4,4,6,15,18,-3,16
FC Goa,7861,8,3,4,7,10,18,-8,13
Delhi Dynamo,7862,1,6,6,2,25,14,11,24
Mumbai City,7862,2,6,4,4,16,11,5,22
Kerala Blast,7862,3,6,3,5,13,16,-3,21
Kolkata,7862,4,4,7,3,18,17,1,19
FC Goa,7862,5,5,2,7,12,16,-4,17
Chennaiyin,7862,6,4,5,5,15,20,-5,17
FC Pune City,7862,7,4,4,6,15,18,-3,16
NorthEast Un,7862,8,4,3,7,10,12,-2,15
Delhi Dynamo,7863,1,7,5,2,27,15,12,26
Kolkata,7863,2,5,7,2,23,16,7,22
Mumbai City,7863,3,6,4,4,16,10,6,22
FC Pune City,7863,4,5,3,6,15,19,-4,18
Kerala Blast,7863,5,4,5,5,10,15,-5,17
NorthEast Un,7863,6,4,4,6,10,12,-2,16
Chennaiyin,7863,7,3,6,5,14,21,-7,15
FC Goa,7863,8,4,2,8,13,20,-7,14
Mumbai City,7864,1,7,4,3,18,9,9,25
NorthEast Un,7864,2,6,3,5,16,12,4,21
Kolkata,7864,3,4,8,2,18,15,3,20
Delhi Dynamo,7864,4,4,7,3,25,19,6,19
FC Pune City,7864,5,5,3,6,15,17,-2,18
Kerala Blast,7864,6,4,4,6,11,20,-9,16
Chennaiyin,7864,7,3,6,5,14,19,-5,15
FC Goa,7864,8,3,5,6,11,17,-6,14
Mumbai City,7865,1,7,4,3,18,9,9,25
Kolkata,7865,2,4,8,2,16,14,2,20
NorthEast Un,7865,3,5,4,5,13,11,2,19
Kerala Blast,7865,4,4,6,4,13,17,-4,18
Delhi Dynamo,7865,5,4,5,5,24,21,3,17
FC Pune City,7865,6,4,5,5,14,16,-2,17
FC Goa,7865,7,5,2,7,13,18,-5,17
Chennaiyin,7865,8,3,6,5,14,19,-5,15
Mumbai City,7866,1,6,4,4,16,10,6,22
Kerala Blast,7866,2,6,3,5,15,16,-1,21
Delhi Dynamo,7866,3,5,5,4,25,19,6,20
Kolkata,7866,4,4,8,2,17,15,2,20
FC Goa,7866,5,5,3,6,15,17,-2,18
NorthEast Un,7866,6,5,2,7,11,13,-2,17
Chennaiyin,7866,7,4,5,5,14,19,-5,17
FC Pune City,7866,8,4,4,6,13,17,-4,16
Mumbai City,7867,1,7,4,3,17,8,9,25
Delhi Dynamo,7867,2,5,5,4,22,18,4,20
Kolkata,7867,3,4,7,3,15,14,1,19
Kerala Blast,7867,4,5,4,5,12,15,-3,19
FC Goa,7867,5,5,3,6,14,16,-2,18
NorthEast Un,7867,6,5,2,7,13,13,0,17
FC Pune City,7867,7,4,5,5,12,14,-2,17
Chennaiyin,7867,8,3,6,5,16,23,-7,15
Delhi Dynamo,7868,1,6,5,3,29,20,9,23
Mumbai City,7868,2,6,4,4,17,10,7,22
Kolkata,7868,3,5,6,3,18,14,4,21
Kerala Blast,7868,4,6,3,5,12,16,-4,21
NorthEast Un,7868,5,5,3,6,14,15,-1,18
FC Goa,7868,6,5,2,7,12,17,-5,17
Chennaiyin,7868,7,3,6,5,14,19,-5,15
FC Pune City,7868,8,4,3,7,12,17,-5,15
Mumbai City,7869,1,7,4,3,17,8,9,25
Delhi Dynamo,7869,2,5,6,3,23,15,8,21
NorthEast Un,7869,3,5,4,5,11,10,1,19
Kolkata,7869,4,3,9,2,15,14,1,18
Chennaiyin,7869,5,4,6,4,14,17,-3,18
FC Pune City,7869,6,4,5,5,14,16,-2,17
Kerala Blast,7869,7,4,5,5,11,16,-5,17
FC Goa,7869,8,3,3,8,9,18,-9,12
Delhi Dynamo,7870,1,6,6,2,26,15,11,24
Mumbai City,7870,2,6,5,3,16,8,8,23
Kolkata,7870,3,5,6,3,19,15,4,21
FC Pune City,7870,4,5,4,5,15,16,-1,19
NorthEast Un,7870,5,5,3,6,14,14,0,18
Kerala Blast,7870,6,4,4,6,14,22,-8,16
Chennaiyin,7870,7,3,6,5,14,19,-5,15
FC Goa,7870,8,4,2,8,9,18,-9,14
Mumbai City,7871,1,7,4,3,18,9,9,25
Kolkata,7871,2,6,6,2,19,14,5,24
Delhi Dynamo,7871,3,6,5,3,29,20,9,23
Chennaiyin,7871,4,4,6,4,18,18,0,18
Kerala Blast,7871,5,5,3,6,12,17,-5,18
NorthEast Un,7871,6,5,2,7,13,17,-4,17
FC Pune City,7871,7,4,3,7,13,18,-5,15
FC Goa,7871,8,3,3,8,11,20,-9,12
Mumbai City,7872,1,7,4,3,19,8,11,25
Kolkata,7872,2,6,6,2,21,13,8,24
Kerala Blast,7872,3,6,3,5,16,16,0,21
NorthEast Un,7872,4,5,3,6,12,14,-2,18
Delhi Dynamo,7872,5,4,5,5,23,22,1,17
Chennaiyin,7872,6,3,7,4,14,18,-4,16
FC Pune City,7872,7,4,3,7,12,19,-7,15
FC Goa,7872,8,4,3,7,11,18,-7,15
Kolkata,7873,1,6,6,2,19,13,6,24
Delhi Dynamo,7873,2,6,5,3,25,16,9,23
Mumbai City,7873,3,6,4,4,17,10,7,22
Kerala Blast,7873,4,5,4,5,12,15,-3,19
NorthEast Un,7873,5,5,2,7,11,13,-2,17
Chennaiyin,7873,6,4,5,5,15,20,-5,17
FC Pune City,7873,7,4,4,6,13,17,-4,16
FC Goa,7873,8,4,2,8,11,19,-8,14
Mumbai City,7874,1,7,4,3,18,9,9,25
Delhi Dynamo,7874,2,5,6,3,27,17,10,21
Kolkata,7874,3,5,6,3,19,15,4,21
NorthEast Un,7874,4,4,5,5,10,10,0,17
FC Goa,7874,5,5,2,7,12,18,-6,17
Kerala Blast,7874,6,4,5,5,11,19,-8,17
FC Pune City,7874,7,4,4,6,15,18,-3,16
Chennaiyin,7874,8,3,6,5,13,19,-6,15
Delhi Dynamo,7875,1,6,6,2,29,18,11,24
Mumbai City,7875,2,6,5,3,17,9,8,23
Kolkata,7875,3,4,8,2,17,15,2,20
NorthEast Un,7875,4,6,2,6,14,12,2,20
Kerala Blast,7875,5,5,3,6,13,15,-2,18
Chennaiyin,7875,6,4,5,5,16,21,-5,17
FC Pune City,7875,7,4,4,6,13,19,-6,16
FC Goa,7875,8,3,3,8,13,23,-10,12
Mumbai City,7876,1,7,4,3,17,8,9,25
Kolkata,7876,2,5,7,2,16,13,3,22
Chennaiyin,7876,3,5,5,4,16,18,-2,20
Delhi Dynamo,7876,4,4,6,4,26,21,5,18
NorthEast Un,7876,5,5,3,6,13,12,1,18
FC Pune City,7876,6,5,3,6,13,15,-2,18
Kerala Blast,7876,7,4,4,6,10,17,-7,16
FC Goa,7876,8,4,2,8,13,20,-7,14
Delhi Dynamo,7877,1,7,5,2,31,15,16,26
Kolkata,7877,2,6,6,2,19,14,5,24
Mumbai City,7877,3,6,4,4,16,12,4,22
NorthEast Un,7877,4,6,2,6,13,12,1,20
FC Pune City,7877,5,5,3,6,14,16,-2,18
Kerala Blast,7877,6,4,3,7,11,19,-8,15
Chennaiyin,7877,7,3,5,6,15,22,-7,14
FC Goa,7877,8,4,2,8,13,22,-9,14
Delhi Dynamo,7878,1,6,6,2,26,16,10,24
Mumbai City,7878,2,6,5,3,18,10,8,23
Kolkata,7878,3,5,6,3,18,15,3,21
Kerala Blast,7878,4,5,4,5,15,17,-2,19
Chennaiyin,7878,5,4,6,4,16,19,-3,18
FC Pune City,7878,6,5,3,6,13,18,-5,18
NorthEast Un,7878,7,4,3,7,10,12,-2,15
FC Goa,7878,8,3,3,8,11,20,-9,12
Delhi Dynamo,7879,1,6,5,3,26,18,8,23
Mumbai City,7879,2,6,4,4,16,9,7,22
Kolkata,7879,3,5,6,3,20,22,-2,21
Chennaiyin,7879,4,5,5,4,18,18,0,20
NorthEast Un,7879,5,6,2,6,15,16,-1,20
FC Pune City,7879,6,5,3,6,20,19,1,18
Kerala Blast,7879,7,5,3,6,13,17,-4,18
FC Goa,7879,8,3,2,9,10,19,-9,11
Mumbai City,7880,1,7,4,3,18,8,10,25
Kolkata,7880,2,5,7,2,17,14,3,22
NorthEast Un,7880,3,5,4,5,11,10,1,19
Kerala Blast,7880,4,5,4,5,11,15,-4,19
Delhi Dynamo,7880,5,4,6,4,23,19,4,18
Chennaiyin,7880,6,4,6,4,16,18,-2,18
FC Pune City,7880,7,4,4,6,13,16,-3,16
FC Goa,7880,8,3,3,8,12,21,-9,12
Mumbai City,7881,1,7,4,3,18,8,10,25
Delhi Dynamo,7881,2,6,5,3,29,17,12,23
Kerala Blast,7881,3,5,5,4,13,16,-3,20
Kolkata,7881,4,3,9,2,17,16,1,18
NorthEast Un,7881,5,5,2,7,14,15,-1,17
FC Pune City,7881,6,4,5,5,16,18,-2,17
FC Goa,7881,7,4,3,7,13,20,-7,15
Chennaiyin,7881,8,3,5,6,15,25,-10,14
Mumbai City,7882,1,7,4,3,19,9,10,25
NorthEast Un,7882,2,6,3,5,13,10,3,21
Delhi Dynamo,7882,3,4,6,4,22,18,4,18
Kolkata,7882,4,4,6,4,17,17,0,18
FC Pune City,7882,5,5,3,6,14,16,-2,18
FC Goa,7882,6,5,3,6,13,16,-3,18
Kerala Blast,7882,7,5,3,6,11,17,-6,18
Chennaiyin,7882,8,3,6,5,15,21,-6,15
Mumbai City,7883,1,6,5,3,17,9,8,23
NorthEast Un,7883,2,6,3,5,13,10,3,21
Delhi Dynamo,7883,3,4,7,3,22,17,5,19
FC Pune City,7883,4,5,4,5,13,14,-1,19
Kerala Blast,7883,5,5,4,5,12,16,-4,19
FC Goa,7883,6,5,3,6,12,14,-2,18
Kolkata,7883,7,3,6,5,15,18,-3,15
Chennaiyin,7883,8,3,6,5,14,20,-6,15
Mumbai City,7884,1,6,5,3,16,8,8,23
Delhi Dynamo,7884,2,4,7,3,23,18,5,19
NorthEast Un,7884,3,5,4,5,13,12,1,19
FC Goa,7884,4,5,3,6,14,15,-1,18
Kolkata,7884,5,4,6,4,14,16,-2,18
Kerala Blast,7884,6,5,3,6,13,15,-2,18
FC Pune City,7884,7,5,3,6,13,18,-5,18
Chennaiyin,7884,8,3,7,4,15,19,-4,16
Mumbai City,7885,1,7,4,3,18,8,10,25
Delhi Dynamo,7885,2,5,5,4,25,17,8,20
Kolkata,7885,3,4,7,3,17,17,0,19
Chennaiyin,7885,4,4,6,4,20,19,1,18
NorthEast Un,7885,5,5,3,6,13,15,-2,18
Kerala Blast,7885,6,4,5,5,13,19,-6,17
FC Goa,7885,7,5,2,7,13,21,-8,17
FC Pune City,7885,8,4,4,6,15,18,-3,16
Mumbai City,7886,1,7,4,3,17,8,9,25
NorthEast Un,7886,2,5,4,5,12,10,2,19
Kerala Blast,7886,3,5,4,5,10,14,-4,19
Kolkata,7886,4,4,6,4,14,14,0,18
FC Pune City,7886,5,5,3,6,13,15,-2,18
Chennaiyin,7886,6,4,6,4,15,18,-3,18
Delhi Dynamo,7886,7,4,5,5,23,20,3,17
FC Goa,7886,8,5,2,7,12,17,-5,17
Mumbai City,7887,1,6,4,4,16,9,7,22
Kolkata,7887,2,5,6,3,18,14,4,21
Delhi Dynamo,7887,3,5,5,4,24,19,5,20
NorthEast Un,7887,4,5,4,5,12,11,1,19
Kerala Blast,7887,5,5,4,5,13,17,-4,19
FC Pune City,7887,6,5,3,6,15,19,-4,18
Chennaiyin,7887,7,3,7,4,13,17,-4,16
FC Goa,7887,8,4,3,7,12,17,-5,15
Delhi Dynamo,7888,1,6,5,3,28,20,8,23
Mumbai City,7888,2,6,4,4,17,10,7,22
NorthEast Un,7888,3,6,2,6,15,14,1,20
Kolkata,7888,4,4,7,3,18,15,3,19
Chennaiyin,7888,5,4,5,5,17,19,-2,17
FC Pune City,7888,6,4,5,5,13,15,-2,17
FC Goa,7888,7,5,2,7,14,19,-5,17
Kerala Blast,7888,8,4,4,6,10,20,-10,16
Mumbai City,7889,1,6,5,3,17,9,8,23
FC Pune City,7889,2,6,3,5,15,15,0,21
Delhi Dynamo,7889,3,4,8,2,24,17,7,20
NorthEast Un,7889,4,5,4,5,11,10,1,19
Kerala Blast,7889,5,5,4,5,10,14,-4,19
Chennaiyin,7889,6,4,5,5,16,20,-4,17
Kolkata,7889,7,3,6,5,14,17,-3,15
FC Goa,7889,8,4,3,7,13,18,-5,15
Delhi Dynamo,7890,1,6,6,2,25,15,10,24
Mumbai City,7890,2,6,4,4,16,9,7,22
Kolkata,7890,3,4,7,3,16,14,2,19
NorthEast Un,7890,4,5,4,5,11,10,1,19
Kerala Blast,7890,5,5,4,5,10,15,-5,19
FC Goa,7890,6,5,2,7,11,16,-5,17
FC Pune City,7890,7,4,4,6,13,16,-3,16
Chennaiyin,7890,8,3,5,6,13,20,-7,14
Mumbai City,7891,1,6,5,3,18,10,8,23
Delhi Dynamo,7891,2,5,7,2,27,18,9,22
Kerala Blast,7891,3,6,3,5,16,15,1,21
NorthEast Un,7891,4,5,3,6,13,13,0,18
Kolkata,7891,5,4,6,4,15,17,-2,18
Chennaiyin,7891,6,4,6,4,14,17,-3,18
FC Pune City,7891,7,5,3,6,14,18,-4,18
FC Goa,7891,8,3,3,8,8,17,-9,12
Mumbai City,7892,1,7,4,3,18,8,10,25
Delhi Dynamo,7892,2,5,5,4,23,18,5,20
Kerala Blast,7892,3,5,5,4,14,16,-2,20
Kolkata,7892,4,4,7,3,15,15,0,19
NorthEast Un,7892,5,5,3,6,12,14,-2,18
Chennaiyin,7892,6,4,5,5,17,19,-2,17
FC Pune City,7892,7,4,4,6,13,16,-3,16
FC Goa,7892,8,4,3,7,12,18,-6,15
Mumbai City,7893,1,7,4,3,18,8,10,25
Kolkata,7893,2,6,6,2,19,13,6,24
Delhi Dynamo,7893,3,5,5,4,23,18,5,20
FC Pune City,7893,4,5,3,6,15,17,-2,18
Kerala Blast,7893,5,5,3,6,11,17,-6,18
NorthEast Un,7893,6,5,2,7,11,12,-1,17
Chennaiyin,7893,7,4,5,5,15,19,-4,17
FC Goa,7893,8,4,2,8,11,19,-8,14
Mumbai City,7894,1,7,4,3,20,11,9,25
Delhi Dynamo,7894,2,6,5,3,28,18,10,23
Kolkata,7894,3,5,6,3,19,17,2,21
Kerala Blast,7894,4,5,4,5,12,15,-3,19
NorthEast Un,7894,5,5,2,7,10,13,-3,17
FC Goa,7894,6,5,2,7,15,20,-5,17
FC Pune City,7894,7,4,4,6,13,17,-4,16
Chennaiyin,7894,8,3,5,6,14,20,-6,14
Mumbai City,7895,1,7,4,3,20,10,10,25
Kolkata,7895,2,5,6,3,19,16,3,21
Kerala Blast,7895,3,6,3,5,15,17,-2,21
Delhi Dynamo,7895,4,5,5,4,28,21,7,20
NorthEast Un,7895,5,6,2,6,14,14,0,20
Chennaiyin,7895,6,4,6,4,16,18,-2,18
FC Pune City,7895,7,4,3,7,15,20,-5,15
FC Goa,7895,8,3,3,8,8,19,-11,12
Mumbai City,7896,1,7,4,3,20,9,11,25
Kolkata,7896,2,5,6,3,22,16,6,21
Delhi Dynamo,7896,3,5,5,4,26,20,6,20
NorthEast Un,7896,4,6,2,6,15,11,4,20
FC Pune City,7896,5,5,3,6,16,20,-4,18
Kerala Blast,7896,6,5,3,6,13,20,-7,18
Chennaiyin,7896,7,4,5,5,15,21,-6,17
FC Goa,7896,8,4,2,8,10,20,-10,14
Mumbai City,7897,1,7,4,3,17,8,9,25
FC Pune City,7897,2,6,3,5,15,15,0,21
Delhi Dynamo,7897,3,5,5,4,24,19,5,20
Chennaiyin,7897,4,5,5,4,16,17,-1,20
Kolkata,7897,5,4,7,3,15,14,1,19
NorthEast Un,7897,6,5,3,6,13,13,0,18
Kerala Blast,7897,7,4,4,6,11,17,-6,16
FC Goa,7897,8,3,3,8,10,18,-8,12
Mumbai City,7898,1,6,4,4,17,10,7,22
Delhi Dynamo,7898,2,5,6,3,24,17,7,21
NorthEast Un,7898,3,6,3,5,15,11,4,21
FC Goa,7898,4,6,2,6,12,15,-3,20
FC Pune City,7898,5,5,4,5,14,15,-1,19
Kolkata,7898,6,3,8,3,16,16,0,17
Kerala Blast,7898,7,4,4,6,11,18,-7,16
Chennaiyin,7898,8,3,5,6,13,20,-7,14
Delhi Dynamo,7899,1,7,5,2,27,15,12,26
Kolkata,7899,2,6,6,2,18,12,6,24
Mumbai City,7899,3,6,4,4,16,10,6,22
NorthEast Un,7899,4,5,3,6,15,13,2,18
Kerala Blast,7899,5,5,3,6,12,21,-9,18
Chennaiyin,7899,6,3,7,4,16,20,-4,16
FC Pune City,7899,7,4,3,7,14,18,-4,15
FC Goa,7899,8,3,3,8,10,19,-9,12
Delhi Dynamo,7900,1,7,5,2,32,16,16,26
Mumbai City,7900,2,6,4,4,18,11,7,22
Kerala Blast,7900,3,6,4,4,13,14,-1,22
FC Pune City,7900,4,5,3,6,14,17,-3,18
Kolkata,7900,5,3,8,3,15,15,0,17
Chennaiyin,7900,6,3,6,5,14,19,-5,15
FC Goa,7900,7,4,3,7,10,17,-7,15
NorthEast Un,7900,8,4,3,7,9,16,-7,15
Delhi Dynamo,7901,1,6,6,2,26,17,9,24
Mumbai City,7901,2,6,4,4,16,9,7,22
Kolkata,7901,3,5,6,3,18,14,4,21
FC Pune City,7901,4,5,4,5,14,15,-1,19
NorthEast Un,7901,5,5,3,6,11,11,0,18
Kerala Blast,7901,6,4,4,6,9,16,-7,16
Chennaiyin,7901,7,3,6,5,15,20,-5,15
FC Goa,7901,8,4,3,7,13,20,-7,15
Mumbai City,7902,1,7,4,3,20,9,11,25
Kolkata,7902,2,4,7,3,19,17,2,19
NorthEast Un,7902,3,5,4,5,12,10,2,19
Delhi Dynamo,7902,4,4,6,4,23,21,2,18
Kerala Blast,7902,5,4,6,4,12,16,-4,18
Chennaiyin,7902,6,3,7,4,14,18,-4,16
FC Pune City,7902,7,4,4,6,13,17,-4,16
FC Goa,7902,8,4,4,6,12,17,-5,16
Kolkata,7903,1,6,6,2,19,13,6,24
Mumbai City,7903,2,6,4,4,17,12,5,22
NorthEast Un,7903,3,6,3,5,13,10,3,21
Delhi Dynamo,7903,4,5,5,4,25,19,6,20
FC Pune City,7903,5,5,3,6,13,16,-3,18
FC Goa,7903,6,5,2,7,11,15,-4,17
Chennaiyin,7903,7,3,6,5,13,18,-5,15
Kerala Blast,7903,8,4,3,7,11,19,-8,15
Delhi Dynamo,7904,1,6,5,3,30,20,10,23
Mumbai City,7904,2,6,4,4,17,10,7,22
Kolkata,7904,3,5,7,2,17,14,3,22
Kerala Blast,7904,4,6,3,5,14,17,-3,21
NorthEast Un,7904,5,5,2,7,14,16,-2,17
Chennaiyin,7904,6,4,5,5,15,19,-4,17
FC Pune City,7904,7,4,4,6,12,15,-3,16
FC Goa,7904,8,4,2,8,11,19,-8,14
Mumbai City,7905,1,7,4,3,18,9,9,25
Kerala Blast,7905,2,7,3,4,16,13,3,24
Delhi Dynamo,7905,3,5,5,4,23,17,6,20
Kolkata,7905,4,4,7,3,16,15,1,19
Chennaiyin,7905,5,4,6,4,16,19,-3,18
NorthEast Un,7905,6,5,2,7,11,14,-3,17
FC Pune City,7905,7,4,4,6,12,17,-5,16
FC Goa,7905,8,3,3,8,11,19,-8,12
Mumbai City,7906,1,6,5,3,17,9,8,23
Delhi Dynamo,7906,2,5,6,3,26,18,8,21
NorthEast Un,7906,3,6,3,5,14,10,4,21
Kerala Blast,7906,4,5,4,5,12,16,-4,19
Kolkata,7906,5,4,6,4,20,21,-1,18
FC Pune City,7906,6,5,3,6,16,17,-1,18
FC Goa,7906,7,5,2,7,13,21,-8,17
Chennaiyin,7906,8,3,5,6,15,21,-6,14
Mumbai City,7907,1,7,4,3,18,8,10,25
Kerala Blast,7907,2,5,5,4,11,14,-3,20
Delhi Dynamo,7907,3,4,7,3,23,18,5,19
Kolkata,7907,4,4,7,3,16,15,1,19
Chennaiyin,7907,5,4,5,5,15,19,-4,17
NorthEast Un,7907,6,4,4,6,10,11,-1,16
FC Pune City,7907,7,4,4,6,15,18,-3,16
FC Goa,7907,8,4,4,6,11,16,-5,16
Mumbai City,7908,1,6,5,3,17,9,8,23
Delhi Dynamo,7908,2,5,6,3,25,16,9,21
Kolkata,7908,3,5,6,3,17,14,3,21
Kerala Blast,7908,4,6,3,5,12,15,-3,21
NorthEast Un,7908,5,5,3,6,11,11,0,18
FC Pune City,7908,6,5,3,6,14,16,-2,18
Chennaiyin,7908,7,3,7,4,16,20,-4,16
FC Goa,7908,8,3,3,8,11,22,-11,12
Kolkata,7909,1,6,6,2,20,15,5,24
Mumbai City,7909,2,6,5,3,16,8,8,23
Delhi Dynamo,7909,3,4,7,3,21,15,6,19
NorthEast Un,7909,4,5,4,5,10,9,1,19
Kerala Blast,7909,5,4,5,5,9,15,-6,17
FC Pune City,7909,6,4,4,6,13,16,-3,16
Chennaiyin,7909,7,3,6,5,14,19,-5,15
FC Goa,7909,8,4,3,7,12,18,-6,15
Kerala Blast,7910,1,7,3,4,13,14,-1,24
Mumbai City,7910,2,6,5,3,16,8,8,23
FC Goa,7910,3,6,2,6,15,17,-2,20
Delhi Dynamo,7910,4,4,6,4,22,18,4,18
Kolkata,7910,5,4,6,4,16,15,1,18
NorthEast Un,7910,6,5,3,6,13,13,0,18
Chennaiyin,7910,7,3,6,5,16,21,-5,15
FC Pune City,7910,8,4,3,7,12,17,-5,15
Mumbai City,7911,1,7,4,3,17,8,9,25
Kolkata,7911,2,6,6,2,19,12,7,24
Delhi Dynamo,7911,3,6,5,3,27,19,8,23
Kerala Blast,7911,4,6,3,5,13,16,-3,21
Chennaiyin,7911,5,5,5,4,18,19,-1,20
FC Pune City,7911,6,4,3,7,12,18,-6,15
NorthEast Un,7911,7,4,2,8,13,18,-5,14
FC Goa,7911,8,3,2,9,10,19,-9,11
Mumbai City,7912,1,7,4,3,17,8,9,25
Kolkata,7912,2,5,6,3,20,17,3,21
NorthEast Un,7912,3,6,2,6,16,13,3,20
Chennaiyin,7912,4,5,5,4,17,18,-1,20
Delhi Dynamo,7912,5,4,6,4,23,18,5,18
FC Pune City,7912,6,5,3,6,19,19,0,18
Kerala Blast,7912,7,5,3,6,15,24,-9,18
FC Goa,7912,8,3,3,8,11,21,-10,12
Mumbai City,7913,1,7,4,3,18,8,10,25
Kolkata,7913,2,6,6,2,19,14,5,24
Kerala Blast,7913,3,5,4,5,11,16,-5,19
Chennaiyin,7913,4,4,6,4,16,19,-3,18
Delhi Dynamo,7913,5,4,5,5,22,19,3,17
NorthEast Un,7913,6,5,2,7,12,13,-1,17
FC Pune City,7913,7,4,4,6,14,17,-3,16
FC Goa,7913,8,4,3,7,11,17,-6,15
Delhi Dynamo,7914,1,5,7,2,25,16,9,22
Mumbai City,7914,2,6,4,4,16,10,6,22
Kolkata,7914,3,5,7,2,15,12,3,22
Kerala Blast,7914,4,5,4,5,11,14,-3,19
NorthEast Un,7914,5,5,3,6,11,12,-1,18
FC Pune City,7914,6,4,5,5,12,14,-2,17
Chennaiyin,7914,7,3,6,5,13,18,-5,15
FC Goa,7914,8,3,4,7,9,16,-7,13
Mumbai City,7915,1,7,4,3,19,10,9,25
Kolkata,7915,2,6,6,2,18,14,4,24
NorthEast Un,7915,3,6,2,6,13,13,0,20
Delhi Dynamo,7915,4,4,6,4,24,19,5,18
FC Pune City,7915,5,5,3,6,15,16,-1,18
Kerala Blast,7915,6,5,3,6,15,20,-5,18
Chennaiyin,7915,7,3,6,5,14,19,-5,15
FC Goa,7915,8,3,4,7,9,16,-7,13
Delhi Dynamo,7916,1,6,5,3,26,18,8,23
Mumbai City,7916,2,6,4,4,16,9,7,22
Kerala Blast,7916,3,6,3,5,13,15,-2,21
Chennaiyin,7916,4,5,5,4,18,17,1,20
Kolkata,7916,5,4,7,3,17,17,0,19
FC Goa,7916,6,5,2,7,13,19,-6,17
FC Pune City,7916,7,4,4,6,15,18,-3,16
NorthEast Un,7916,8,4,2,8,11,16,-5,14
Mumbai City,7917,1,7,4,3,18,9,9,25
Kolkata,7917,2,5,7,2,19,15,4,22
Delhi Dynamo,7917,3,5,6,3,25,18,7,21
NorthEast Un,7917,4,6,3,5,14,11,3,21
Kerala Blast,7917,5,5,3,6,13,17,-4,18
FC Pune City,7917,6,4,4,6,13,18,-5,16
Chennaiyin,7917,7,3,6,5,14,19,-5,15
FC Goa,7917,8,3,3,8,10,19,-9,12
Delhi Dynamo,7918,1,7,5,2,28,16,12,26
Mumbai City,7918,2,6,4,4,17,11,6,22
FC Pune City,7918,3,5,4,5,14,14,0,19
NorthEast Un,7918,4,5,3,6,11,12,-1,18
Kolkata,7918,5,3,8,3,15,16,-1,17
FC Goa,7918,6,5,2,7,14,17,-3,17
Kerala Blast,7918,7,4,5,5,11,17,-6,17
Chennaiyin,7918,8,3,5,6,13,20,-7,14
Mumbai City,7919,1,6,5,3,18,10,8,23
Delhi Dynamo,7919,2,5,7,2,25,17,8,22
Kolkata,7919,3,5,6,3,21,15,6,21
Kerala Blast,7919,4,5,4,5,10,17,-7,19
Chennaiyin,7919,5,4,6,4,16,19,-3,18
FC Goa,7919,6,4,4,6,13,17,-4,16
FC Pune City,7919,7,4,4,6,13,18,-5,16
NorthEast Un,7919,8,4,2,8,9,12,-3,14
Mumbai City,7920,1,7,4,3,21,8,13,25
Delhi Dynamo,7920,2,5,5,4,24,22,2,20
NorthEast Un,7920,3,6,2,6,14,15,-1,20
FC Pune City,7920,4,5,4,5,14,15,-1,19
Kolkata,7920,5,3,8,3,14,14,0,17
Chennaiyin,7920,6,4,5,5,19,21,-2,17
Kerala Blast,7920,7,4,5,5,10,15,-5,17
FC Goa,7920,8,4,3,7,12,18,-6,15
Mumbai City,7921,1,7,4,3,21,8,13,25
Kerala Blast,7921,2,6,3,5,15,18,-3,21
Kolkata,7921,3,4,8,2,19,14,5,20
Chennaiyin,7921,4,5,5,4,17,18,-1,20
Delhi Dynamo,7921,5,4,5,5,22,24,-2,17
NorthEast Un,7921,6,5,2,7,14,16,-2,17
FC Pune City,7921,7,4,4,6,14,19,-5,16
FC Goa,7921,8,4,3,7,10,15,-5,15
Mumbai City,7922,1,7,4,3,17,8,9,25
Kolkata,7922,2,6,6,2,20,13,7,24
Delhi Dynamo,7922,3,6,5,3,28,18,10,23
Kerala Blast,7922,4,6,3,5,12,17,-5,21
Chennaiyin,7922,5,4,6,4,15,18,-3,18
NorthEast Un,7922,6,4,3,7,13,15,-2,15
FC Pune City,7922,7,4,3,7,13,18,-5,15
FC Goa,7922,8,3,2,9,9,20,-11,11
Delhi Dynamo,7923,1,6,6,2,28,14,14,24
Mumbai City,7923,2,6,4,4,16,10,6,22
FC Pune City,7923,3,6,3,5,18,16,2,21
Kolkata,7923,4,5,6,3,16,14,2,21
NorthEast Un,7923,5,5,4,5,10,9,1,19
Kerala Blast,7923,6,4,4,6,10,18,-8,16
Chennaiyin,7923,7,3,5,6,13,19,-6,14
FC Goa,7923,8,4,2,8,9,20,-11,14
Delhi Dynamo,7924,1,6,6,2,24,15,9,24
Mumbai City,7924,2,6,4,4,16,9,7,22
Kolkata,7924,3,5,7,2,17,14,3,22
Chennaiyin,7924,4,4,6,4,16,18,-2,18
Kerala Blast,7924,5,4,5,5,12,17,-5,17
NorthEast Un,7924,6,4,4,6,12,14,-2,16
FC Pune City,7924,7,4,4,6,13,16,-3,16
FC Goa,7924,8,3,4,7,9,16,-7,13
Mumbai City,7925,1,6,5,3,17,9,8,23
Delhi Dynamo,7925,2,5,6,3,25,18,7,21
Kolkata,7925,3,5,6,3,16,14,2,21
FC Pune City,7925,4,6,3,5,14,14,0,21
NorthEast Un,7925,5,6,2,6,13,13,0,20
Kerala Blast,7925,6,5,3,6,11,15,-4,18
FC Goa,7925,7,4,2,8,13,19,-6,14
Chennaiyin,7925,8,3,5,6,15,22,-7,14
Delhi Dynamo,7926,1,6,5,3,25,17,8,23
Mumbai City,7926,2,6,4,4,17,10,7,22
NorthEast Un,7926,3,6,3,5,13,11,2,21
Kerala Blast,7926,4,5,5,4,12,14,-2,20
FC Pune City,7926,5,4,5,5,12,14,-2,17
Kolkata,7926,6,3,7,4,14,17,-3,16
Chennaiyin,7926,7,3,6,5,14,19,-5,15
FC Goa,7926,8,4,3,7,12,17,-5,15
Mumbai City,7927,1,7,4,3,18,9,9,25
Kerala Blast,7927,2,6,3,5,12,15,-3,21
Delhi Dynamo,7927,3,5,5,4,24,18,6,20
Kolkata,7927,4,4,7,3,15,14,1,19
NorthEast Un,7927,5,5,3,6,12,12,0,18
FC Goa,7927,6,5,2,7,10,15,-5,17
FC Pune City,7927,7,4,4,6,14,17,-3,16
Chennaiyin,7927,8,3,6,5,14,19,-5,15
Delhi Dynamo,7928,1,6,5,3,26,16,10,23
Mumbai City,7928,2,6,4,4,16,10,6,22
Kolkata,7928,3,5,6,3,17,15,2,21
NorthEast Un,7928,4,5,4,5,13,12,1,19
Kerala Blast,7928,5,5,4,5,11,15,-4,19
Chennaiyin,7928,6,4,6,4,16,18,-2,18
FC Pune City,7928,7,4,3,7,12,18,-6,15
FC Goa,7928,8,4,2,8,11,18,-7,14
Mumbai City,7929,1,6,5,3,16,8,8,23
Delhi Dynamo,7929,2,5,6,3,24,17,7,21
FC Pune City,7929,3,6,3,5,14,14,0,21
NorthEast Un,7929,4,6,2,6,16,14,2,20
Kolkata,7929,5,4,6,4,16,18,-2,18
Chennaiyin,7929,6,4,6,4,17,20,-3,18
FC Goa,7929,7,4,3,7,13,17,-4,15
Kerala Blast,7929,8,4,3,7,12,20,-8,15
Mumbai City,7930,1,7,4,3,17,8,9,25
Delhi Dynamo,7930,2,6,5,3,25,17,8,23
Kerala Blast,7930,3,5,5,4,12,13,-1,20
Kolkata,7930,4,3,8,3,13,15,-2,17
FC Pune City,7930,5,4,5,5,12,14,-2,17
Chennaiyin,7930,6,4,5,5,15,19,-4,17
NorthEast Un,7930,7,4,3,7,10,13,-3,15
FC Goa,7930,8,4,3,7,11,16,-5,15
Mumbai City,7931,1,6,5,3,16,8,8,23
Delhi Dynamo,7931,2,4,8,2,21,14,7,20
Kerala Blast,7931,3,5,5,4,14,16,-2,20
NorthEast Un,7931,4,5,4,5,12,9,3,19
Kolkata,7931,5,4,7,3,18,19,-1,19
Chennaiyin,7931,6,4,5,5,14,20,-6,17
FC Goa,7931,7,4,3,7,13,16,-3,15
FC Pune City,7931,8,4,3,7,15,21,-6,15
Delhi Dynamo,7932,1,6,6,2,26,17,9,24
Mumbai City,7932,2,6,4,4,17,10,7,22
Kolkata,7932,3,5,6,3,19,16,3,21
FC Pune City,7932,4,5,3,6,13,17,-4,18
Kerala Blast,7932,5,5,3,6,12,18,-6,18
FC Goa,7932,6,5,2,7,16,17,-1,17
Chennaiyin,7932,7,4,5,5,15,20,-5,17
NorthEast Un,7932,8,4,3,7,12,15,-3,15
Mumbai City,7933,1,6,5,3,17,9,8,23
Delhi Dynamo,7933,2,5,6,3,25,16,9,21
NorthEast Un,7933,3,6,3,5,13,10,3,21
FC Pune City,7933,4,6,3,5,17,15,2,21
Kolkata,7933,5,4,6,4,16,17,-1,18
Kerala Blast,7933,6,5,3,6,12,19,-7,18
Chennaiyin,7933,7,3,6,5,14,20,-6,15
FC Goa,7933,8,4,2,8,12,20,-8,14
Mumbai City,7934,1,7,4,3,18,9,9,25
Delhi Dynamo,7934,2,5,6,3,25,18,7,21
Kolkata,7934,3,4,7,3,16,14,2,19
FC Pune City,7934,4,5,4,5,13,14,-1,19
NorthEast Un,7934,5,5,3,6,11,11,0,18
Kerala Blast,7934,6,4,5,5,9,15,-6,17
Chennaiyin,7934,7,3,6,5,14,19,-5,15
FC Goa,7934,8,3,5,6,11,17,-6,14
Kolkata,7935,1,6,6,2,20,15,5,24
Mumbai City,7935,2,6,5,3,17,9,8,23
Delhi Dynamo,7935,3,5,7,2,26,16,10,22
FC Pune City,7935,4,5,3,6,16,18,-2,18
Kerala Blast,7935,5,5,3,6,12,18,-6,18
NorthEast Un,7935,6,5,2,7,11,14,-3,17
FC Goa,7935,7,4,3,7,13,18,-5,15
Chennaiyin,7935,8,3,5,6,14,21,-7,14
Mumbai City,7936,1,7,4,3,17,8,9,25
Kolkata,7936,2,6,6,2,19,13,6,24
Kerala Blast,7936,3,6,3,5,13,16,-3,21
Delhi Dynamo,7936,4,5,5,4,23,17,6,20
Chennaiyin,7936,5,4,6,4,16,19,-3,18
NorthEast Un,7936,6,5,2,7,10,13,-3,17
FC Pune City,7936,7,4,3,7,13,17,-4,15
FC Goa,7936,8,3,3,8,11,19,-8,12
Mumbai City,7937,1,7,4,3,19,8,11,25
Kerala Blast,7937,2,6,4,4,14,15,-1,22
Delhi Dynamo,7937,3,5,6,3,23,18,5,21
Kolkata,7937,4,4,8,2,17,15,2,20
Chennaiyin,7937,5,4,5,5,16,22,-6,17
NorthEast Un,7937,6,4,3,7,11,13,-2,15
FC Goa,7937,7,4,3,7,13,17,-4,15
FC Pune City,7937,8,4,3,7,14,19,-5,15
Mumbai City,7938,1,7,4,3,19,9,10,25
Kerala Blast,7938,2,6,4,4,13,15,-2,22
Delhi Dynamo,7938,3,5,5,4,23,20,3,20
FC Pune City,7938,4,5,3,6,15,15,0,18
NorthEast Un,7938,5,5,3,6,12,12,0,18
Kolkata,7938,6,4,6,4,14,16,-2,18
FC Goa,7938,7,5,2,7,13,15,-2,17
Chennaiyin,7938,8,3,5,6,13,20,-7,14
Mumbai City,7939,1,7,4,3,20,8,12,25
Kerala Blast,7939,2,7,3,4,16,16,0,24
Chennaiyin,7939,3,5,5,4,17,17,0,20
Kolkata,7939,4,4,7,3,17,16,1,19
Delhi Dynamo,7939,5,4,5,5,23,24,-1,17
NorthEast Un,7939,6,5,2,7,12,16,-4,17
FC Pune City,7939,7,4,4,6,13,16,-3,16
FC Goa,7939,8,4,2,8,14,19,-5,14
Mumbai City,7940,1,7,4,3,18,9,9,25
Kerala Blast,7940,2,6,4,4,14,15,-1,22
Chennaiyin,7940,3,5,5,4,17,18,-1,20
Delhi Dynamo,7940,4,4,7,3,23,17,6,19
Kolkata,7940,5,3,7,4,14,16,-2,16
NorthEast Un,7940,6,4,4,6,12,14,-2,16
FC Pune City,7940,7,4,4,6,14,18,-4,16
FC Goa,7940,8,4,3,7,10,15,-5,15
Mumbai City,7941,1,7,4,3,17,8,9,25
Kolkata,7941,2,5,7,2,17,12,5,22
Kerala Blast,7941,3,6,4,4,14,13,1,22
Delhi Dynamo,7941,4,4,7,3,22,16,6,19
Chennaiyin,7941,5,4,5,5,15,19,-4,17
NorthEast Un,7941,6,4,3,7,10,13,-3,15
FC Pune City,7941,7,4,3,7,12,18,-6,15
FC Goa,7941,8,4,3,7,10,18,-8,15
Delhi Dynamo,7942,1,7,5,2,27,15,12,26
Kolkata,7942,2,6,6,2,19,13,6,24
Mumbai City,7942,3,6,4,4,16,9,7,22
Chennaiyin,7942,4,4,6,4,15,17,-2,18
Kerala Blast,7942,5,4,5,5,12,18,-6,17
FC Pune City,7942,6,4,4,6,14,17,-3,16
NorthEast Un,7942,7,4,4,6,10,13,-3,16
FC Goa,7942,8,3,2,9,8,19,-11,11
Mumbai City,7943,1,7,4,3,18,8,10,25
Delhi Dynamo,7943,2,6,5,3,25,18,7,23
NorthEast Un,7943,3,6,2,6,17,11,6,20
Kolkata,7943,4,4,7,3,16,17,-1,19
FC Pune City,7943,5,5,3,6,17,18,-1,18
Kerala Blast,7943,6,5,3,6,14,21,-7,18
Chennaiyin,7943,7,3,6,5,13,20,-7,15
FC Goa,7943,8,3,4,7,11,18,-7,13
Mumbai City,7944,1,7,4,3,17,8,9,25
Delhi Dynamo,7944,2,6,5,3,25,16,9,23
Kolkata,7944,3,5,6,3,19,16,3,21
FC Pune City,7944,4,5,3,6,14,15,-1,18
Chennaiyin,7944,5,4,6,4,15,17,-2,18
Kerala Blast,7944,6,5,3,6,11,18,-7,18
FC Goa,7944,7,4,3,7,12,18,-6,15
NorthEast Un,7944,8,4,2,8,9,14,-5,14
Kolkata,7945,1,6,6,2,17,13,4,24
Mumbai City,7945,2,6,5,3,17,9,8,23
Delhi Dynamo,7945,3,5,7,2,29,19,10,22
NorthEast Un,7945,4,5,4,5,12,11,1,19
Chennaiyin,7945,5,4,6,4,16,18,-2,18
Kerala Blast,7945,6,5,3,6,10,15,-5,18
FC Pune City,7945,7,4,3,7,13,17,-4,15
FC Goa,7945,8,3,2,9,11,23,-12,11
Mumbai City,7946,1,7,4,3,17,8,9,25
NorthEast Un,7946,2,6,3,5,13,11,2,21
Kerala Blast,7946,3,5,5,4,11,14,-3,20
Kolkata,7946,4,4,7,3,17,15,2,19
Delhi Dynamo,7946,5,4,6,4,22,17,5,18
FC Goa,7946,6,4,4,6,10,15,-5,16
Chennaiyin,7946,7,3,6,5,14,19,-5,15
FC Pune City,7946,8,4,3,7,12,17,-5,15
Delhi Dynamo,7947,1,7,5,2,28,16,12,26
Mumbai City,7947,2,6,4,4,17,10,7,22
Kerala Blast,7947,3,6,4,4,12,14,-2,22
Kolkata,7947,4,5,6,3,17,15,2,21
Chennaiyin,7947,5,4,6,4,16,19,-3,18
FC Pune City,7947,6,4,4,6,14,17,-3,16
NorthEast Un,7947,7,4,3,7,10,14,-4,15
FC Goa,7947,8,3,2,9,11,20,-9,11
Delhi Dynamo,7948,1,6,6,2,29,16,13,24
Kerala Blast,7948,2,7,3,4,15,14,1,24
Mumbai City,7948,3,6,4,4,17,10,7,22
Kolkata,7948,4,5,6,3,16,14,2,21
NorthEast Un,7948,5,5,3,6,12,13,-1,18
Chennaiyin,7948,6,4,5,5,15,20,-5,17
FC Pune City,7948,7,4,3,7,14,18,-4,15
FC Goa,7948,8,3,2,9,9,22,-13,11
Delhi Dynamo,7949,1,6,5,3,25,16,9,23
Mumbai City,7949,2,6,4,4,16,9,7,22
Kolkata,7949,3,4,7,3,17,14,3,19
NorthEast Un,7949,4,5,4,5,11,9,2,19
FC Pune City,7949,5,5,4,5,13,14,-1,19
Kerala Blast,7949,6,4,5,5,9,16,-7,17
Chennaiyin,7949,7,3,7,4,13,17,-4,16
FC Goa,7949,8,3,4,7,9,18,-9,13
Mumbai City,7950,1,6,5,3,16,8,8,23
Delhi Dynamo,7950,2,5,7,2,24,16,8,22
Kolkata,7950,3,5,7,2,18,15,3,22
Kerala Blast,7950,4,5,4,5,13,17,-4,19
FC Pune City,7950,5,4,5,5,16,18,-2,17
Chennaiyin,7950,6,4,5,5,14,19,-5,17
FC Goa,7950,7,4,3,7,12,17,-5,15
NorthEast Un,7950,8,4,2,8,11,14,-3,14
Mumbai City,7951,1,7,4,3,19,8,11,25
Delhi Dynamo,7951,2,6,5,3,27,19,8,23
FC Pune City,7951,3,5,4,5,14,15,-1,19
Kerala Blast,7951,4,5,3,6,10,16,-6,18
Chennaiyin,7951,5,4,5,5,17,19,-2,17
NorthEast Un,7951,6,5,2,7,12,15,-3,17
FC Goa,7951,7,5,2,7,14,19,-5,17
Kolkata,7951,8,3,7,4,15,17,-2,16
Delhi Dynamo,7952,1,5,7,2,25,16,9,22
Mumbai City,7952,2,6,4,4,16,10,6,22
Kolkata,7952,3,5,6,3,19,13,6,21
NorthEast Un,7952,4,5,3,6,11,11,0,18
FC Pune City,7952,5,5,3,6,14,17,-3,18
FC Goa,7952,6,5,3,6,11,15,-4,18
Kerala Blast,7952,7,5,3,6,10,18,-8,18
Chennaiyin,7952,8,3,5,6,13,19,-6,14
Mumbai City,7953,1,6,5,3,19,11,8,23
Delhi Dynamo,7953,2,5,6,3,27,19,8,21
NorthEast Un,7953,3,6,2,6,14,11,3,20
FC Pune City,7953,4,5,4,5,15,16,-1,19
Kerala Blast,7953,5,5,4,5,11,16,-5,19
Chennaiyin,7953,6,4,6,4,15,18,-3,18
Kolkata,7953,7,3,6,5,14,17,-3,15
FC Goa,7953,8,4,3,7,10,17,-7,15
Delhi Dynamo,7954,1,6,6,2,25,16,9,24
Mumbai City,7954,2,6,4,4,16,9,7,22
Kerala Blast,7954,3,6,4,4,14,15,-1,22
Kolkata,7954,4,4,7,3,16,16,0,19
NorthEast Un,7954,5,5,2,7,13,14,-1,17
FC Pune City,7954,6,4,5,5,13,15,-2,17
Chennaiyin,7954,7,3,6,5,16,21,-5,15
FC Goa,7954,8,3,4,7,11,18,-7,13
Delhi Dynamo,7955,1,6,5,3,27,16,11,23
Mumbai City,7955,2,6,4,4,17,10,7,22
Kolkata,7955,3,5,6,3,17,15,2,21
NorthEast Un,7955,4,6,2,6,11,10,1,20
Chennaiyin,7955,5,5,5,4,16,17,-1,20
FC Pune City,7955,6,5,3,6,14,17,-3,18
Kerala Blast,7955,7,5,3,6,12,16,-4,18
FC Goa,7955,8,3,2,9,10,23,-13,11
Mumbai City,7956,1,7,4,3,20,11,9,25
Delhi Dynamo,7956,2,5,6,3,27,19,8,21
FC Pune City,7956,3,6,3,5,17,14,3,21
Kolkata,7956,4,4,7,3,15,16,-1,19
Kerala Blast,7956,5,5,4,5,13,17,-4,19
NorthEast Un,7956,6,4,4,6,11,13,-2,16
Chennaiyin,7956,7,3,6,5,15,20,-5,15
FC Goa,7956,8,4,2,8,11,19,-8,14
Delhi Dynamo,7957,1,6,5,3,27,17,10,23
Mumbai City,7957,2,6,4,4,16,12,4,22
NorthEast Un,7957,3,5,3,6,11,10,1,18
Kerala Blast,7957,4,4,6,4,10,14,-4,18
Kolkata,7957,5,3,8,3,14,14,0,17
FC Pune City,7957,6,4,5,5,14,16,-2,17
Chennaiyin,7957,7,4,5,5,15,19,-4,17
FC Goa,7957,8,5,2,7,12,17,-5,17
Mumbai City,7958,1,6,5,3,18,10,8,23
Delhi Dynamo,7958,2,5,7,2,26,18,8,22
FC Pune City,7958,3,6,3,5,17,15,2,21
Kerala Blast,7958,4,6,3,5,14,18,-4,21
NorthEast Un,7958,5,5,3,6,11,12,-1,18
Kolkata,7958,6,3,7,4,14,15,-1,16
FC Goa,7958,7,4,3,7,13,18,-5,15
Chennaiyin,7958,8,3,5,6,15,22,-7,14
Mumbai City,7959,1,7,4,3,20,8,12,25
Delhi Dynamo,7959,2,6,5,3,23,18,5,23
Kerala Blast,7959,3,6,4,4,12,14,-2,22
FC Pune City,7959,4,5,4,5,14,14,0,19
Chennaiyin,7959,5,4,6,4,15,18,-3,18
Kolkata,7959,6,3,7,4,13,15,-2,16
NorthEast Un,7959,7,4,3,7,11,13,-2,15
FC Goa,7959,8,3,3,8,8,16,-8,12
Mumbai City,7960,1,7,4,3,19,9,10,25
Kolkata,7960,2,6,6,2,18,12,6,24
Delhi Dynamo,7960,3,5,5,4,23,19,4,20
Kerala Blast,7960,4,5,4,5,11,16,-5,19
FC Goa,7960,5,5,2,7,12,16,-4,17
Chennaiyin,7960,6,4,5,5,14,19,-5,17
FC Pune City,7960,7,4,4,6,13,16,-3,16
NorthEast Un,7960,8,4,2,8,9,12,-3,14
Mumbai City,7961,1,7,4,3,20,10,10,25
Kerala Blast,7961,2,6,4,4,14,14,0,22
Kolkata,7961,3,5,6,3,21,18,3,21
NorthEast Un,7961,4,6,2,6,13,11,2,20
Delhi Dynamo,7961,5,4,6,4,25,22,3,18
FC Pune City,7961,6,4,4,6,13,18,-5,16
FC Goa,7961,7,4,3,7,12,18,-6,15
Chennaiyin,7961,8,3,5,6,13,20,-7,14
Delhi Dynamo,7962,1,6,5,3,27,19,8,23
Mumbai City,7962,2,6,4,4,18,12,6,22
Kerala Blast,7962,3,6,3,5,14,17,-3,21
FC Goa,7962,4,6,2,6,14,16,-2,20
Kolkata,7962,5,4,7,3,18,16,2,19
FC Pune City,7962,6,4,4,6,14,18,-4,16
NorthEast Un,7962,7,4,3,7,10,12,-2,15
Chennaiyin,7962,8,3,6,5,14,19,-5,15
Mumbai City,7963,1,6,5,3,17,9,8,23
Delhi Dynamo,7963,2,5,6,3,26,19,7,21
Kolkata,7963,3,4,8,2,16,14,2,20
NorthEast Un,7963,3,6,2,6,16,14,2,20
Kerala Blast,7963,5,5,4,5,12,17,-5,19
Chennaiyin,7963,6,4,6,4,17,19,-2,18
FC Pune City,7963,7,4,4,6,12,15,-3,16
FC Goa,7963,8,3,3,8,11,20,-9,12
Delhi Dynamo,7964,1,6,6,2,28,17,11,24
Mumbai City,7964,2,6,5,3,16,8,8,23
Kolkata,7964,3,4,7,3,17,16,1,19
Kerala Blast,7964,4,5,4,5,12,17,-5,19
Chennaiyin,7964,5,4,6,4,16,19,-3,18
FC Pune City,7964,6,4,4,6,13,16,-3,16
NorthEast Un,7964,7,4,3,7,13,17,-4,15
FC Goa,7964,8,4,3,7,12,17,-5,15
Mumbai City,7965,1,7,4,3,20,8,12,25
Kerala Blast,7965,2,6,3,5,13,14,-1,21
Delhi Dynamo,7965,3,5,5,4,23,19,4,20
NorthEast Un,7965,4,5,3,6,10,10,0,18
Kolkata,7965,5,4,6,4,18,19,-1,18
FC Pune City,7965,6,5,3,6,13,17,-4,18
Chennaiyin,7965,7,3,7,4,13,17,-4,16
FC Goa,7965,8,4,3,7,12,18,-6,15
Mumbai City,7966,1,7,4,3,20,9,11,25
Kolkata,7966,2,6,6,2,20,12,8,24
Delhi Dynamo,7966,3,6,5,3,26,20,6,23
Kerala Blast,7966,4,6,3,5,14,16,-2,21
NorthEast Un,7966,5,5,2,7,11,13,-2,17
FC Pune City,7966,6,4,3,7,12,20,-8,15
Chennaiyin,7966,7,3,5,6,13,19,-6,14
FC Goa,7966,8,4,2,8,10,17,-7,14
Delhi Dynamo,7967,1,6,6,2,27,17,10,24
Mumbai City,7967,2,6,4,4,17,10,7,22
Kolkata,7967,3,5,6,3,19,16,3,21
NorthEast Un,7967,4,6,2,6,13,13,0,20
FC Pune City,7967,5,5,3,6,16,17,-1,18
Kerala Blast,7967,6,5,3,6,12,19,-7,18
FC Goa,7967,7,4,3,7,12,18,-6,15
Chennaiyin,7967,8,3,5,6,14,20,-6,14
Kerala Blast,7968,1,7,3,4,15,13,2,24
Delhi Dynamo,7968,2,6,5,3,24,15,9,23
Mumbai City,7968,3,6,4,4,16,10,6,22
FC Pune City,7968,4,5,3,6,13,17,-4,18
FC Goa,7968,5,5,3,6,12,16,-4,18
NorthEast Un,7968,6,5,2,7,11,11,0,17
Kolkata,7968,7,3,7,4,14,16,-2,16
Chennaiyin,7968,8,3,5,6,14,21,-7,14
Mumbai City,7969,1,7,4,3,18,8,10,25
Kolkata,7969,2,6,6,2,21,14,7,24
Kerala Blast,7969,3,6,3,5,14,18,-4,21
Delhi Dynamo,7969,4,5,5,4,23,18,5,20
Chennaiyin,7969,5,4,6,4,16,19,-3,18
FC Pune City,7969,6,4,3,7,13,18,-5,15
FC Goa,7969,7,4,3,7,12,18,-6,15
NorthEast Un,7969,8,4,2,8,10,14,-4,14
Mumbai City,7970,1,6,4,4,17,11,6,22
Kerala Blast,7970,2,6,4,4,16,16,0,22
Delhi Dynamo,7970,3,5,5,4,25,18,7,20
NorthEast Un,7970,4,6,2,6,12,11,1,20
Kolkata,7970,5,3,8,3,18,18,0,17
Chennaiyin,7970,6,4,5,5,15,19,-4,17
FC Goa,7970,7,5,2,7,13,18,-5,17
FC Pune City,7970,8,4,4,6,14,19,-5,16
Mumbai City,7971,1,7,4,3,18,9,9,25
Delhi Dynamo,7971,2,5,6,3,26,19,7,21
Kolkata,7971,3,5,6,3,21,15,6,21
NorthEast Un,7971,4,5,3,6,15,12,3,18
FC Pune City,7971,5,5,3,6,16,18,-2,18
FC Goa,7971,6,4,4,6,10,15,-5,16
Kerala Blast,7971,7,4,4,6,10,20,-10,16
Chennaiyin,7971,8,3,6,5,13,21,-8,15
Delhi Dynamo,7972,1,5,7,2,24,16,8,22
Mumbai City,7972,2,6,4,4,17,10,7,22
Chennaiyin,7972,3,5,5,4,16,18,-2,20
Kolkata,7972,4,4,6,4,16,16,0,18
NorthEast Un,7972,5,5,3,6,12,12,0,18
FC Pune City,7972,6,5,3,6,14,16,-2,18
Kerala Blast,7972,7,5,3,6,12,18,-6,18
FC Goa,7972,8,4,3,7,12,17,-5,15
Mumbai City,7973,1,6,5,3,16,8,8,23
Delhi Dynamo,7973,2,5,6,3,25,18,7,21
FC Pune City,7973,3,6,3,5,16,15,1,21
Kolkata,7973,4,4,7,3,19,17,2,19
FC Goa,7973,5,5,3,6,13,16,-3,18
Chennaiyin,7973,6,4,5,5,14,18,-4,17
Kerala Blast,7973,7,4,4,6,11,19,-8,16
NorthEast Un,7973,8,4,3,7,10,13,-3,15
Delhi Dynamo,7974,1,6,5,3,25,16,9,23
Mumbai City,7974,2,6,4,4,16,9,7,22
FC Goa,7974,3,6,2,6,14,15,-1,20
Kolkata,7974,4,4,7,3,15,15,0,19
FC Pune City,7974,5,5,4,5,13,14,-1,19
NorthEast Un,7974,6,4,4,6,10,12,-2,16
Kerala Blast,7974,7,4,4,6,10,17,-7,16
Chennaiyin,7974,8,3,6,5,13,18,-5,15
Mumbai City,7975,1,7,4,3,20,10,10,25
Kolkata,7975,2,4,8,2,16,13,3,20
Kerala Blast,7975,3,5,5,4,12,15,-3,20
Delhi Dynamo,7975,4,4,7,3,25,20,5,19
NorthEast Un,7975,5,5,4,5,12,11,1,19
FC Goa,7975,6,4,4,6,13,15,-2,16
FC Pune City,7975,7,4,3,7,12,17,-5,15
Chennaiyin,7975,8,3,5,6,13,22,-9,14
Mumbai City,7976,1,7,4,3,20,10,10,25
Kolkata,7976,2,4,8,2,18,14,4,20
Kerala Blast,7976,3,5,5,4,14,15,-1,20
Delhi Dynamo,7976,4,4,7,3,25,20,5,19
NorthEast Un,7976,5,5,4,5,12,11,1,19
Chennaiyin,7976,6,4,5,5,18,22,-4,17
FC Pune City,7976,7,4,4,6,13,18,-5,16
FC Goa,7976,8,3,3,8,13,23,-10,12
Kolkata,7977,1,6,6,2,19,14,5,24
Delhi Dynamo,7977,2,6,5,3,24,16,8,23
Mumbai City,7977,3,6,4,4,16,9,7,22
NorthEast Un,7977,4,6,3,5,15,12,3,21
Kerala Blast,7977,5,5,4,5,12,17,-5,19
FC Pune City,7977,6,4,3,7,12,16,-4,15
Chennaiyin,7977,7,3,6,5,16,21,-5,15
FC Goa,7977,8,3,3,8,10,19,-9,12
Delhi Dynamo,7978,1,6,6,2,26,15,11,24
Mumbai City,7978,2,6,4,4,16,10,6,22
FC Pune City,7978,3,6,3,5,16,15,1,21
Kolkata,7978,4,4,6,4,16,14,2,18
FC Goa,7978,5,5,3,6,14,17,-3,18
Kerala Blast,7978,6,5,3,6,12,19,-7,18
NorthEast Un,7978,7,4,3,7,10,14,-4,15
Chennaiyin,7978,8,3,6,5,16,22,-6,15
Mumbai City,7979,1,7,4,3,18,8,10,25
Kerala Blast,7979,2,6,4,4,14,15,-1,22
Delhi Dynamo,7979,3,5,6,3,25,19,6,21
NorthEast Un,7979,4,5,4,5,15,12,3,19
FC Pune City,7979,5,5,3,6,14,15,-1,18
FC Goa,7979,6,5,2,7,15,18,-3,17
Kolkata,7979,7,3,6,5,13,18,-5,15
Chennaiyin,7979,8,3,5,6,14,23,-9,14
Mumbai City,7980,1,7,4,3,19,10,9,25
Kolkata,7980,2,5,7,2,18,14,4,22
Delhi Dynamo,7980,3,5,5,4,26,21,5,20
Kerala Blast,7980,4,5,4,5,11,16,-5,19
NorthEast Un,7980,5,5,3,6,11,13,-2,18
Chennaiyin,7980,6,4,5,5,14,18,-4,17
FC Goa,7980,7,4,3,7,14,17,-3,15
FC Pune City,7980,8,4,3,7,12,16,-4,15
Mumbai City,7981,1,7,4,3,18,8,10,25
Delhi Dynamo,7981,2,5,6,3,23,17,6,21
Kolkata,7981,3,4,8,2,20,16,4,20
Kerala Blast,7981,4,5,4,5,13,17,-4,19
FC Pune City,7981,5,5,3,6,13,17,-4,18
NorthEast Un,7981,6,5,2,7,11,12,-1,17
Chennaiyin,7981,7,4,5,5,15,19,-4,17
FC Goa,7981,8,3,4,7,12,19,-7,13
Mumbai City,7982,1,7,4,3,19,8,11,25
Kolkata,7982,2,5,6,3,16,15,1,21
Delhi Dynamo,7982,3,4,7,3,23,19,4,19
NorthEast Un,7982,4,5,3,6,14,14,0,18
FC Goa,7982,5,5,3,6,14,16,-2,18
FC Pune City,7982,5,5,3,6,14,16,-2,18
Chennaiyin,7982,7,4,5,5,17,22,-5,17
Kerala Blast,7982,8,4,3,7,10,17,-7,15
Mumbai City,7983,1,6,5,3,17,9,8,23
NorthEast Un,7983,2,6,3,5,13,11,2,21
Delhi Dynamo,7983,3,4,8,2,23,16,7,20
Kerala Blast,7983,4,5,4,5,13,16,-3,19
Kolkata,7983,5,4,6,4,17,17,0,18
FC Goa,7983,6,5,3,6,15,17,-2,18
FC Pune City,7983,7,4,4,6,13,17,-4,16
Chennaiyin,7983,8,3,5,6,16,24,-8,14
Mumbai City,7984,1,6,5,3,17,9,8,23
Kerala Blast,7984,2,6,4,4,13,15,-2,22
Kolkata,7984,3,4,8,2,18,14,4,20
Delhi Dynamo,7984,4,4,6,4,23,18,5,18
NorthEast Un,7984,5,5,3,6,11,11,0,18
FC Goa,7984,6,5,2,7,10,17,-7,17
FC Pune City,7984,7,4,4,6,12,15,-3,16
Chennaiyin,7984,8,3,6,5,13,18,-5,15
Mumbai City,7985,1,6,4,4,16,10,6,22
Delhi Dynamo,7985,2,5,6,3,24,16,8,21
NorthEast Un,7985,3,6,2,6,12,12,0,20
Kolkata,7985,4,4,7,3,17,15,2,19
FC Pune City,7985,5,5,4,5,14,15,-1,19
FC Goa,7985,6,5,3,6,12,16,-4,18
Chennaiyin,7985,7,4,5,5,16,19,-3,17
Kerala Blast,7985,8,4,3,7,9,17,-8,15
Mumbai City,7986,1,7,4,3,18,8,10,25
Kerala Blast,7986,2,6,4,4,15,15,0,22
Delhi Dynamo,7986,3,4,7,3,23,18,5,19
FC Goa,7986,4,5,3,6,17,18,-1,18
FC Pune City,7986,5,5,3,6,13,16,-3,18
Chennaiyin,7986,6,4,5,5,16,21,-5,17
Kolkata,7986,7,3,7,4,17,20,-3,16
NorthEast Un,7986,8,4,3,7,11,14,-3,15
Mumbai City,7987,1,6,4,4,16,9,7,22
FC Pune City,7987,2,6,3,5,17,16,1,21
Kerala Blast,7987,3,6,3,5,19,20,-1,21
Delhi Dynamo,7987,4,5,5,4,23,17,6,20
NorthEast Un,7987,5,6,2,6,14,14,0,20
Chennaiyin,7987,6,4,5,5,17,20,-3,17
FC Goa,7987,7,5,2,7,12,18,-6,17
Kolkata,7987,8,3,6,5,15,19,-4,15
Mumbai City,7988,1,6,4,4,16,10,6,22
Delhi Dynamo,7988,2,5,6,3,24,16,8,21
Kolkata,7988,3,4,8,2,17,14,3,20
Chennaiyin,7988,4,5,5,4,17,18,-1,20
FC Pune City,7988,5,4,5,5,14,16,-2,17
Kerala Blast,7988,6,4,5,5,11,17,-6,17
NorthEast Un,7988,7,4,4,6,11,13,-2,16
FC Goa,7988,8,4,3,7,11,17,-6,15
Mumbai City,7989,1,7,4,3,18,9,9,25
Delhi Dynamo,7989,2,6,5,3,26,17,9,23
Kolkata,7989,3,4,8,2,17,15,2,20
FC Pune City,7989,4,5,4,5,16,17,-1,19
Chennaiyin,7989,5,4,6,4,14,17,-3,18
Kerala Blast,7989,6,4,5,5,12,17,-5,17
NorthEast Un,7989,7,4,3,7,9,11,-2,15
FC Goa,7989,8,3,3,8,10,19,-9,12
Mumbai City,7990,1,7,4,3,17,8,9,25
Delhi Dynamo,7990,2,5,6,3,25,16,9,21
Chennaiyin,7990,3,5,5,4,17,18,-1,20
Kerala Blast,7990,4,5,5,4,12,15,-3,20
FC Pune City,7990,5,5,3,6,14,15,-1,18
Kolkata,7990,6,3,8,3,15,16,-1,17
NorthEast Un,7990,7,4,3,7,10,15,-5,15
FC Goa,7990,8,3,4,7,11,18,-7,13
Mumbai City,7991,1,7,4,3,19,8,11,25
Kerala Blast,7991,2,6,3,5,14,17,-3,21
NorthEast Un,7991,3,6,2,6,13,14,-1,20
FC Pune City,7991,4,5,4,5,17,16,1,19
Delhi Dynamo,7991,5,4,6,4,22,19,3,18
Kolkata,7991,6,3,7,4,15,17,-2,16
FC Goa,7991,7,4,4,6,12,16,-4,16
Chennaiyin,7991,8,3,6,5,15,20,-5,15
Mumbai City,7992,1,6,5,3,17,9,8,23
Delhi Dynamo,7992,2,5,7,2,25,16,9,22
NorthEast Un,7992,3,6,3,5,13,9,4,21
Kerala Blast,7992,4,6,3,5,12,16,-4,21
Kolkata,7992,5,3,8,3,16,16,0,17
FC Pune City,7992,6,4,4,6,15,18,-3,16
Chennaiyin,7992,7,3,6,5,15,21,-6,15
FC Goa,7992,8,3,4,7,12,20,-8,13
Mumbai City,7993,1,7,4,3,19,9,10,25
Kolkata,7993,2,5,7,2,19,15,4,22
Kerala Blast,7993,3,6,3,5,17,18,-1,21
Delhi Dynamo,7993,4,5,5,4,23,18,5,20
NorthEast Un,7993,5,6,2,6,12,12,0,20
FC Pune City,7993,6,4,4,6,14,18,-4,16
Chennaiyin,7993,7,3,6,5,14,19,-5,15
FC Goa,7993,8,3,3,8,9,18,-9,12
Delhi Dynamo,7994,1,7,5,2,29,18,11,26
Kerala Blast,7994,2,7,3,4,17,15,2,24
Mumbai City,7994,3,6,4,4,17,11,6,22
Kolkata,7994,4,5,6,3,18,15,3,21
Chennaiyin,7994,5,3,7,4,17,21,-4,16
NorthEast Un,7994,6,4,3,7,12,15,-3,15
FC Pune City,7994,7,4,3,7,12,18,-6,15
FC Goa,7994,8,3,3,8,12,21,-9,12
Mumbai City,7995,1,7,4,3,18,8,10,25
Kerala Blast,7995,2,7,3,4,16,14,2,24
Delhi Dynamo,7995,3,5,5,4,25,19,6,20
Kolkata,7995,4,4,6,4,16,17,-1,18
Chennaiyin,7995,5,4,6,4,15,18,-3,18
NorthEast Un,7995,6,5,2,7,10,12,-2,17
FC Goa,7995,7,4,3,7,14,19,-5,15
FC Pune City,7995,8,4,3,7,12,19,-7,15
Mumbai City,7996,1,7,4,3,18,8,10,25
NorthEast Un,7996,2,6,3,5,13,9,4,21
FC Pune City,7996,3,6,3,5,15,14,1,21
Delhi Dynamo,7996,4,5,5,4,23,18,5,20
Kolkata,7996,5,4,6,4,15,18,-3,18
Kerala Blast,7996,6,4,4,6,9,15,-6,16
FC Goa,7996,7,4,3,7,13,18,-5,15
Chennaiyin,7996,8,3,6,5,14,20,-6,15
Kerala Blast,7997,1,7,3,4,13,14,-1,24
Mumbai City,7997,2,6,5,3,16,8,8,23
Delhi Dynamo,7997,3,5,6,3,25,19,6,21
NorthEast Un,7997,4,5,3,6,12,11,1,18
Chennaiyin,7997,5,4,6,4,16,17,-1,18
Kolkata,7997,6,3,8,3,19,19,0,17
FC Pune City,7997,7,4,4,6,15,18,-3,16
FC Goa,7997,8,3,3,8,12,22,-10,12
Delhi Dynamo,7998,1,6,5,3,23,16,7,23
Mumbai City,7998,2,6,4,4,16,9,7,22
Kerala Blast,7998,3,5,5,4,12,15,-3,20
Kolkata,7998,4,4,7,3,16,16,0,19
NorthEast Un,7998,5,5,3,6,12,11,1,18
Chennaiyin,7998,6,4,6,4,15,18,-3,18
FC Goa,7998,7,4,3,7,12,16,-4,15
FC Pune City,7998,8,4,3,7,12,17,-5,15
Mumbai City,7999,1,6,5,3,17,9,8,23
Delhi Dynamo,7999,2,5,6,3,23,16,7,21
Kolkata,7999,3,5,6,3,21,17,4,21
Chennaiyin,7999,4,4,6,4,16,19,-3,18
FC Goa,7999,5,5,3,6,12,16,-4,18
NorthEast Un,7999,6,5,2,7,11,12,-1,17
FC Pune City,7999,7,4,4,6,14,18,-4,16
Kerala Blast,7999,8,4,4,6,12,19,-7,16
Mumbai City,8000,1,7,4,3,18,8,10,25
Delhi Dynamo,8000,2,6,5,3,30,16,14,23
Kolkata,8000,3,5,6,3,16,14,2,21
FC Pune City,8000,4,5,3,6,15,16,-1,18
Chennaiyin,8000,5,4,6,4,14,17,-3,18
NorthEast Un,8000,6,5,2,7,11,15,-4,17
Kerala Blast,8000,7,4,3,7,10,18,-8,15
FC Goa,8000,8,4,3,7,9,19,-10,15
Delhi Dynamo,8001,1,6,6,2,27,18,9,24
Mumbai City,8001,2,6,5,3,18,10,8,23
Kolkata,8001,3,5,7,2,20,13,7,22
Chennaiyin,8001,4,4,6,4,16,18,-2,18
FC Pune City,8001,5,5,3,6,13,17,-4,18
Kerala Blast,8001,6,5,3,6,12,17,-5,18
NorthEast Un,8001,7,4,2,8,10,16,-6,14
FC Goa,8001,8,3,4,7,11,18,-7,13
Mumbai City,8002,1,6,5,3,16,8,8,23
Kerala Blast,8002,2,6,4,4,15,16,-1,22
Kolkata,8002,3,5,6,3,17,15,2,21
Chennaiyin,8002,4,5,5,4,17,17,0,20
Delhi Dynamo,8002,5,4,7,3,22,18,4,19
NorthEast Un,8002,6,5,3,6,13,13,0,18
FC Pune City,8002,7,4,3,7,13,18,-5,15
FC Goa,8002,8,3,3,8,10,18,-8,12
Delhi Dynamo,8003,1,6,6,2,26,15,11,24
Mumbai City,8003,2,6,4,4,17,11,6,22
Kolkata,8003,3,4,8,2,19,16,3,20
Chennaiyin,8003,4,5,5,4,18,18,0,20
Kerala Blast,8003,5,5,4,5,12,17,-5,19
FC Pune City,8003,6,4,4,6,15,18,-3,16
NorthEast Un,8003,7,4,3,7,10,15,-5,15
FC Goa,8003,8,3,4,7,11,18,-7,13
Mumbai City,8004,1,6,5,3,17,9,8,23
Kolkata,8004,2,5,7,2,18,15,3,22
Delhi Dynamo,8004,3,5,6,3,25,18,7,21
NorthEast Un,8004,4,5,4,5,13,12,1,19
Kerala Blast,8004,5,5,4,5,14,15,-1,19
Chennaiyin,8004,6,4,6,4,17,20,-3,18
FC Pune City,8004,7,4,3,7,13,20,-7,15
FC Goa,8004,8,3,3,8,13,21,-8,12
Mumbai City,8005,1,6,5,3,16,8,8,23
Chennaiyin,8005,2,5,5,4,16,18,-2,20
Delhi Dynamo,8005,3,4,7,3,22,18,4,19
Kerala Blast,8005,4,5,4,5,10,14,-4,19
Kolkata,8005,5,4,6,4,17,15,2,18
NorthEast Un,8005,6,5,3,6,12,10,2,18
FC Pune City,8005,7,5,3,6,14,18,-4,18
FC Goa,8005,8,4,3,7,11,17,-6,15
Delhi Dynamo,8006,1,6,5,3,27,17,10,23
Mumbai City,8006,2,6,4,4,17,10,7,22
Kolkata,8006,3,5,6,3,18,14,4,21
NorthEast Un,8006,4,6,2,6,12,12,0,20
FC Pune City,8006,5,5,4,5,14,15,-1,19
Chennaiyin,8006,6,4,6,4,16,18,-2,18
Kerala Blast,8006,7,4,4,6,11,18,-7,16
FC Goa,8006,8,3,3,8,9,20,-11,12
Delhi Dynamo,8007,1,6,5,3,24,16,8,23
Mumbai City,8007,2,6,4,4,17,10,7,22
Kolkata,8007,3,5,6,3,16,15,1,21
Kerala Blast,8007,4,6,3,5,12,15,-3,21
NorthEast Un,8007,5,5,2,7,11,12,-1,17
Chennaiyin,8007,6,4,5,5,15,19,-4,17
FC Goa,8007,7,5,2,7,12,16,-4,17
FC Pune City,8007,8,4,3,7,13,17,-4,15
Mumbai City,8008,1,7,4,3,19,8,11,25
Delhi Dynamo,8008,2,5,6,3,22,17,5,21
NorthEast Un,8008,3,5,4,5,11,10,1,19
FC Pune City,8008,4,5,4,5,14,15,-1,19
Kerala Blast,8008,5,5,4,5,12,16,-4,19
Kolkata,8008,6,3,8,3,19,19,0,17
Chennaiyin,8008,7,3,6,5,14,19,-5,15
FC Goa,8008,8,3,4,7,13,20,-7,13
Mumbai City,8009,1,6,5,3,19,11,8,23
Delhi Dynamo,8009,2,5,6,3,27,20,7,21
NorthEast Un,8009,3,6,3,5,15,9,6,21
Kolkata,8009,4,4,7,3,16,16,0,19
Kerala Blast,8009,5,5,3,6,13,20,-7,18
FC Goa,8009,6,5,2,7,13,18,-5,17
FC Pune City,8009,7,4,4,6,15,19,-4,16
Chennaiyin,8009,8,3,6,5,14,19,-5,15
Delhi Dynamo,8010,1,5,7,2,25,17,8,22
Mumbai City,8010,2,6,4,4,16,9,7,22
Kolkata,8010,3,5,6,3,16,14,2,21
FC Pune City,8010,4,6,3,5,15,14,1,21
NorthEast Un,8010,5,5,3,6,14,15,-1,18
Chennaiyin,8010,6,4,5,5,15,21,-6,17
FC Goa,8010,7,4,3,7,13,17,-4,15
Kerala Blast,8010,8,4,3,7,11,18,-7,15
Mumbai City,8011,1,6,5,3,16,8,8,23
Delhi Dynamo,8011,2,5,6,3,25,15,10,21
NorthEast Un,8011,3,6,3,5,14,12,2,21
Kerala Blast,8011,4,6,3,5,13,15,-2,21
Kolkata,8011,5,4,7,3,15,15,0,19
FC Pune City,8011,6,4,4,6,12,15,-3,16
Chennaiyin,8011,7,3,7,4,16,20,-4,16
FC Goa,8011,8,3,3,8,10,21,-11,12
Mumbai City,8012,1,7,4,3,17,8,9,25
Delhi Dynamo,8012,2,5,6,3,28,18,10,21
FC Pune City,8012,3,6,3,5,18,16,2,21
NorthEast Un,8012,4,5,4,5,14,12,2,19
Kerala Blast,8012,5,5,4,5,14,18,-4,19
Kolkata,8012,6,4,6,4,16,18,-2,18
Chennaiyin,8012,7,3,5,6,14,22,-8,14
FC Goa,8012,8,4,2,8,11,20,-9,14
Mumbai City,8013,1,7,4,3,22,8,14,25
Kerala Blast,8013,2,6,4,4,14,16,-2,22
Delhi Dynamo,8013,3,5,5,4,26,24,2,20
NorthEast Un,8013,4,6,2,6,13,12,1,20
Kolkata,8013,5,3,8,3,16,17,-1,17
FC Goa,8013,6,5,2,7,14,19,-5,17
FC Pune City,8013,7,4,4,6,13,16,-3,16
Chennaiyin,8013,8,3,5,6,14,20,-6,14
Mumbai City,8014,1,6,5,3,16,8,8,23
Delhi Dynamo,8014,2,5,6,3,24,18,6,21
Kolkata,8014,3,5,6,3,16,13,3,21
Chennaiyin,8014,4,4,6,4,15,18,-3,18
FC Pune City,8014,5,5,3,6,13,16,-3,18
Kerala Blast,8014,6,5,3,6,10,15,-5,18
NorthEast Un,8014,7,5,2,7,13,13,0,17
FC Goa,8014,8,4,3,7,10,16,-6,15
Mumbai City,8015,1,7,4,3,20,9,11,25
Chennaiyin,8015,2,5,5,4,15,17,-2,20
Kolkata,8015,3,4,6,4,18,15,3,18
Delhi Dynamo,8015,4,4,6,4,24,22,2,18
NorthEast Un,8015,5,5,3,6,13,12,1,18
FC Pune City,8015,6,5,3,6,13,16,-3,18
Kerala Blast,8015,7,5,3,6,11,20,-9,18
FC Goa,8015,8,5,2,7,12,15,-3,17
Mumbai City,8016,1,7,4,3,17,8,9,25
Delhi Dynamo,8016,2,5,6,3,25,16,9,21
Chennaiyin,8016,3,5,5,4,18,18,0,20
Kolkata,8016,4,4,7,3,17,15,2,19
FC Pune City,8016,5,5,4,5,17,18,-1,19
NorthEast Un,8016,6,5,2,7,13,15,-2,17
Kerala Blast,8016,7,4,5,5,13,20,-7,17
FC Goa,8016,8,3,3,8,9,19,-10,12
Mumbai City,8017,1,7,4,3,17,8,9,25
Delhi Dynamo,8017,2,6,5,3,28,18,10,23
Kolkata,8017,3,5,6,3,16,15,1,21
NorthEast Un,8017,4,6,2,6,14,13,1,20
Kerala Blast,8017,5,5,4,5,12,16,-4,19
Chennaiyin,8017,6,4,5,5,16,18,-2,17
FC Pune City,8017,7,4,4,6,13,16,-3,16
FC Goa,8017,8,3,2,9,10,22,-12,11
Delhi Dynamo,8018,1,7,5,2,27,15,12,26
Mumbai City,8018,2,6,4,4,17,10,7,22
Kolkata,8018,3,5,7,2,17,12,5,22
FC Pune City,8018,4,5,3,6,13,17,-4,18
Kerala Blast,8018,5,5,3,6,10,15,-5,18
Chennaiyin,8018,6,4,5,5,16,20,-4,17
FC Goa,8018,7,4,3,7,10,17,-7,15
NorthEast Un,8018,8,4,2,8,10,14,-4,14
Delhi Dynamo,8019,1,6,6,2,25,16,9,24
Mumbai City,8019,2,6,5,3,17,9,8,23
Chennaiyin,8019,3,5,5,4,16,17,-1,20
FC Pune City,8019,4,5,4,5,15,16,-1,19
Kolkata,8019,5,4,6,4,15,17,-2,18
NorthEast Un,8019,6,5,2,7,14,14,0,17
Kerala Blast,8019,7,4,4,6,11,19,-8,16
FC Goa,8019,8,4,2,8,11,16,-5,14
Mumbai City,8020,1,6,5,3,17,9,8,23
NorthEast Un,8020,2,6,2,6,12,11,1,20
Kolkata,8020,3,4,7,3,16,16,0,19
FC Pune City,8020,4,5,4,5,15,15,0,19
Kerala Blast,8020,5,5,4,5,12,16,-4,19
Delhi Dynamo,8020,6,4,6,4,22,17,5,18
FC Goa,8020,7,5,3,6,14,15,-1,18
Chennaiyin,8020,8,3,5,6,14,23,-9,14
Mumbai City,8021,1,7,4,3,19,8,11,25
Kerala Blast,8021,2,6,4,4,13,15,-2,22
NorthEast Un,8021,3,6,3,5,16,12,4,21
Delhi Dynamo,8021,4,5,5,4,24,20,4,20
Kolkata,8021,5,4,6,4,16,16,0,18
FC Pune City,8021,6,5,3,6,14,16,-2,18
FC Goa,8021,7,4,2,8,12,19,-7,14
Chennaiyin,8021,8,3,5,6,16,24,-8,14
Mumbai City,8022,1,7,4,3,18,9,9,25
FC Pune City,8022,2,5,4,5,16,15,1,19
Kerala Blast,8022,3,5,4,5,14,18,-4,19
Delhi Dynamo,8022,4,4,6,4,22,18,4,18
FC Goa,8022,5,5,3,6,13,16,-3,18
NorthEast Un,8022,6,4,5,5,11,11,0,17
Kolkata,8022,7,3,8,3,15,17,-2,17
Chennaiyin,8022,8,3,6,5,14,19,-5,15
Kerala Blast,8023,1,7,3,4,13,14,-1,24
Delhi Dynamo,8023,2,6,5,3,24,15,9,23
Mumbai City,8023,3,6,4,4,16,9,7,22
Kolkata,8023,4,4,6,4,21,18,3,18
NorthEast Un,8023,5,5,3,6,11,11,0,18
Chennaiyin,8023,6,3,7,4,15,19,-4,16
FC Pune City,8023,7,4,3,7,13,20,-7,15
FC Goa,8023,8,4,3,7,12,19,-7,15
Delhi Dynamo,8024,1,6,5,3,27,18,9,23
Kolkata,8024,2,5,7,2,23,13,10,22
Mumbai City,8024,3,6,4,4,16,9,7,22
Kerala Blast,8024,4,6,4,4,15,13,2,22
NorthEast Un,8024,5,6,2,6,14,14,0,20
Chennaiyin,8024,6,3,6,5,14,19,-5,15
FC Pune City,8024,7,4,3,7,12,24,-12,15
FC Goa,8024,8,3,3,8,10,21,-11,12
Mumbai City,8025,1,7,4,3,18,8,10,25
Kolkata,8025,2,6,6,2,18,12,6,24
Chennaiyin,8025,3,5,5,4,17,18,-1,20
Kerala Blast,8025,4,5,4,5,12,17,-5,19
NorthEast Un,8025,5,5,3,6,14,13,1,18
Delhi Dynamo,8025,6,4,5,5,23,21,2,17
FC Pune City,8025,7,4,3,7,13,18,-5,15
FC Goa,8025,8,4,2,8,10,18,-8,14
Mumbai City,8026,1,6,5,3,18,10,8,23
Kolkata,8026,2,5,7,2,19,15,4,22
NorthEast Un,8026,3,6,2,6,16,11,5,20
Chennaiyin,8026,4,5,5,4,19,21,-2,20
Delhi Dynamo,8026,5,4,7,3,25,22,3,19
FC Pune City,8026,6,4,4,6,12,16,-4,16
Kerala Blast,8026,7,4,4,6,11,18,-7,16
FC Goa,8026,8,3,4,7,14,21,-7,13
Delhi Dynamo,8027,1,7,5,2,26,15,11,26
Mumbai City,8027,2,6,4,4,16,10,6,22
Kolkata,8027,3,5,6,3,18,16,2,21
NorthEast Un,8027,4,6,2,6,15,12,3,20
FC Goa,8027,5,5,2,7,13,16,-3,17
FC Pune City,8027,6,4,4,6,14,19,-5,16
Kerala Blast,8027,7,4,4,6,10,17,-7,16
Chennaiyin,8027,8,3,5,6,15,22,-7,14
Kolkata,8028,1,6,6,2,19,12,7,24
Mumbai City,8028,2,6,4,4,17,10,7,22
Delhi Dynamo,8028,3,5,6,3,23,17,6,21
Chennaiyin,8028,4,5,5,4,19,19,0,20
NorthEast Un,8028,5,5,3,6,13,15,-2,18
Kerala Blast,8028,6,5,3,6,13,19,-6,18
FC Pune City,8028,7,4,3,7,13,17,-4,15
FC Goa,8028,8,4,2,8,11,19,-8,14
Mumbai City,8029,1,6,5,3,17,9,8,23
Kerala Blast,8029,2,6,4,4,13,14,-1,22
NorthEast Un,8029,3,6,3,5,15,11,4,21
Delhi Dynamo,8029,4,4,7,3,25,21,4,19
Kolkata,8029,5,4,7,3,18,16,2,19
Chennaiyin,8029,6,3,6,5,16,21,-5,15
FC Pune City,8029,7,4,3,7,13,19,-6,15
FC Goa,8029,8,3,5,6,13,19,-6,14
Mumbai City,8030,1,7,4,3,18,9,9,25
Delhi Dynamo,8030,2,5,5,4,25,19,6,20
Kolkata,8030,3,4,7,3,16,14,2,19
NorthEast Un,8030,4,5,4,5,11,10,1,19
FC Pune City,8030,5,5,4,5,14,15,-1,19
Kerala Blast,8030,6,4,5,5,11,17,-6,17
Chennaiyin,8030,7,3,7,4,13,17,-4,16
FC Goa,8030,8,3,4,7,11,18,-7,13
Delhi Dynamo,8031,1,6,6,2,24,15,9,24
Mumbai City,8031,2,6,5,3,17,9,8,23
Kerala Blast,8031,3,6,4,4,15,17,-2,22
Kolkata,8031,4,5,6,3,21,14,7,21
Chennaiyin,8031,5,5,5,4,21,20,1,20
FC Pune City,8031,6,4,4,6,13,18,-5,16
NorthEast Un,8031,7,4,2,8,13,16,-3,14
FC Goa,8031,8,3,2,9,9,24,-15,11
Kolkata,8032,1,6,6,2,19,15,4,24
Delhi Dynamo,8032,2,6,5,3,27,18,9,23
Mumbai City,8032,3,6,4,4,16,11,5,22
Kerala Blast,8032,4,5,4,5,10,14,-4,19
NorthEast Un,8032,5,5,2,7,13,15,-2,17
Chennaiyin,8032,6,4,5,5,18,22,-4,17
FC Pune City,8032,7,4,4,6,13,16,-3,16
FC Goa,8032,8,4,2,8,15,20,-5,14
Mumbai City,8033,1,7,4,3,18,9,9,25
Chennaiyin,8033,2,5,5,4,17,17,0,20
NorthEast Un,8033,3,6,2,6,14,14,0,20
Kolkata,8033,4,4,7,3,16,14,2,19
Kerala Blast,8033,5,5,3,6,14,18,-4,18
Delhi Dynamo,8033,6,4,5,5,25,21,4,17
FC Goa,8033,7,5,2,7,11,17,-6,17
FC Pune City,8033,8,4,4,6,12,17,-5,16
Mumbai City,8034,1,6,5,3,17,9,8,23
NorthEast Un,8034,2,7,2,5,15,9,6,23
Delhi Dynamo,8034,3,4,7,3,24,20,4,19
FC Pune City,8034,4,5,4,5,15,16,-1,19
Kolkata,8034,5,3,8,3,17,17,0,17
Kerala Blast,8034,6,4,5,5,11,17,-6,17
FC Goa,8034,7,4,4,6,15,18,-3,16
Chennaiyin,8034,8,3,5,6,13,21,-8,14
Mumbai City,8035,1,7,4,3,17,8,9,25
Kolkata,8035,2,5,7,2,17,14,3,22
Delhi Dynamo,8035,3,4,7,3,23,17,6,19
Kerala Blast,8035,4,5,4,5,14,16,-2,19
Chennaiyin,8035,5,4,5,5,15,19,-4,17
NorthEast Un,8035,6,4,4,6,11,12,-1,16
FC Goa,8035,7,4,4,6,13,18,-5,16
FC Pune City,8035,8,4,3,7,13,19,-6,15
Delhi Dynamo,8036,1,6,6,2,29,17,12,24
Kolkata,8036,2,5,7,2,20,15,5,22
Mumbai City,8036,3,6,4,4,16,11,5,22
NorthEast Un,8036,4,5,4,5,12,11,1,19
Kerala Blast,8036,5,4,5,5,10,17,-7,17
FC Pune City,8036,6,4,4,6,13,16,-3,16
Chennaiyin,8036,7,3,6,5,15,20,-5,15
FC Goa,8036,8,3,4,7,14,22,-8,13
Kolkata,8037,1,6,6,2,17,12,5,24
Mumbai City,8037,2,6,5,3,17,9,8,23
Delhi Dynamo,8037,3,5,6,3,25,17,8,21
FC Pune City,8037,4,5,3,6,13,15,-2,18
Kerala Blast,8037,5,5,3,6,12,16,-4,18
Chennaiyin,8037,6,4,5,5,20,22,-2,17
NorthEast Un,8037,7,5,2,7,12,17,-5,17
FC Goa,8037,8,4,2,8,12,20,-8,14
Mumbai City,8038,1,7,4,3,18,9,9,25
Delhi Dynamo,8038,2,6,5,3,26,16,10,23
Kolkata,8038,3,5,6,3,19,16,3,21
Kerala Blast,8038,4,6,3,5,12,18,-6,21
Chennaiyin,8038,5,4,5,5,16,19,-3,17
FC Goa,8038,6,5,2,7,13,16,-3,17
FC Pune City,8038,7,4,3,7,13,17,-4,15
NorthEast Un,8038,8,4,2,8,10,16,-6,14
Mumbai City,8039,1,7,4,3,17,8,9,25
Delhi Dynamo,8039,2,6,5,3,25,17,8,23
Kerala Blast,8039,3,6,4,4,14,15,-1,22
Kolkata,8039,4,3,9,2,14,13,1,18
Chennaiyin,8039,5,4,5,5,15,19,-4,17
FC Pune City,8039,6,4,4,6,14,18,-4,16
FC Goa,8039,7,4,3,7,12,17,-5,15
NorthEast Un,8039,8,4,2,8,10,14,-4,14
Delhi Dynamo,8040,1,7,5,2,29,15,14,26
Mumbai City,8040,2,6,4,4,16,10,6,22
Kerala Blast,8040,3,6,4,4,17,16,1,22
Kolkata,8040,4,4,7,3,17,16,1,19
Chennaiyin,8040,5,4,6,4,17,19,-2,18
FC Pune City,8040,6,4,4,6,15,21,-6,16
NorthEast Un,8040,7,4,2,8,10,14,-4,14
FC Goa,8040,8,3,4,7,10,20,-10,13
Mumbai City,8041,1,7,4,3,18,9,9,25
Kolkata,8041,2,5,6,3,18,15,3,21
Delhi Dynamo,8041,3,5,5,4,26,17,9,20
NorthEast Un,8041,4,6,2,6,11,11,0,20
Chennaiyin,8041,5,4,6,4,17,19,-2,18
Kerala Blast,8041,6,5,3,6,13,18,-5,18
FC Pune City,8041,7,4,3,7,15,20,-5,15
FC Goa,8041,8,4,3,7,11,20,-9,15
Delhi Dynamo,8042,1,6,6,2,29,19,10,24
Mumbai City,8042,2,6,5,3,18,10,8,23
Kerala Blast,8042,3,6,4,4,12,14,-2,22
Kolkata,8042,4,5,6,3,17,13,4,21
NorthEast Un,8042,5,4,4,6,12,13,-1,16
FC Pune City,8042,6,4,3,7,13,18,-5,15
Chennaiyin,8042,7,3,6,5,14,20,-6,15
FC Goa,8042,8,4,2,8,11,19,-8,14
Mumbai City,8043,1,7,4,3,17,8,9,25
Kolkata,8043,2,6,6,2,21,13,8,24
Delhi Dynamo,8043,3,5,6,3,23,15,8,21
Kerala Blast,8043,4,6,3,5,15,19,-4,21
NorthEast Un,8043,5,5,2,7,12,13,-1,17
FC Pune City,8043,6,4,3,7,13,19,-6,15
FC Goa,8043,7,4,3,7,10,16,-6,15
Chennaiyin,8043,8,3,5,6,14,22,-8,14
Mumbai City,8044,1,7,4,3,18,9,9,25
Delhi Dynamo,8044,2,5,5,4,23,17,6,20
Kolkata,8044,3,4,7,3,16,20,-4,19
Kerala Blast,8044,4,5,4,5,13,17,-4,19
NorthEast Un,8044,5,5,3,6,10,10,0,18
FC Goa,8044,6,5,2,7,15,15,0,17
FC Pune City,8044,7,4,5,5,15,17,-2,17
Chennaiyin,8044,8,3,6,5,13,18,-5,15
Delhi Dynamo,8045,1,6,5,3,27,18,9,23
Mumbai City,8045,2,6,4,4,17,10,7,22
Kolkata,8045,3,4,8,2,16,13,3,20
FC Pune City,8045,4,5,4,5,15,15,0,19
NorthEast Un,8045,5,5,3,6,13,14,-1,18
FC Goa,8045,6,5,2,7,12,18,-6,17
Kerala Blast,8045,7,4,5,5,11,17,-6,17
Chennaiyin,8045,8,3,5,6,14,20,-6,14
Mumbai City,8046,1,7,4,3,19,10,9,25
Kolkata,8046,2,5,7,2,19,14,5,22
Kerala Blast,8046,3,6,3,5,15,16,-1,21
Delhi Dynamo,8046,4,4,6,4,26,23,3,18
Chennaiyin,8046,5,4,6,4,14,17,-3,18
NorthEast Un,8046,6,4,4,6,11,13,-2,16
FC Goa,8046,7,4,3,7,15,19,-4,15
FC Pune City,8046,8,4,3,7,13,20,-7,15
Mumbai City,8047,1,7,4,3,18,9,9,25
Delhi Dynamo,8047,2,6,5,3,29,17,12,23
Kolkata,8047,3,4,7,3,18,17,1,19
FC Pune City,8047,4,4,5,5,14,16,-2,17
FC Goa,8047,5,5,2,7,14,19,-5,17
Kerala Blast,8047,6,4,5,5,11,18,-7,17
NorthEast Un,8047,7,4,4,6,10,12,-2,16
Chennaiyin,8047,8,3,6,5,14,20,-6,15
Kerala Blast,8048,1,7,3,4,14,13,1,24
Mumbai City,8048,2,6,4,4,16,9,7,22
Delhi Dynamo,8048,3,5,6,3,24,19,5,21
NorthEast Un,8048,4,6,2,6,14,12,2,20
Kolkata,8048,5,4,6,4,17,17,0,18
FC Goa,8048,6,5,3,6,16,18,-2,18
FC Pune City,8048,7,4,3,7,12,18,-6,15
Chennaiyin,8048,8,3,5,6,14,21,-7,14
Delhi Dynamo,8049,1,6,5,3,27,18,9,23
Mumbai City,8049,2,6,4,4,18,11,7,22
Kerala Blast,8049,3,6,3,5,15,17,-2,21
FC Pune City,8049,4,5,4,5,15,16,-1,19
FC Goa,8049,5,5,3,6,13,17,-4,18
Kolkata,8049,6,3,8,3,17,18,-1,17
Chennaiyin,8049,7,4,5,5,17,19,-2,17
NorthEast Un,8049,8,4,2,8,11,17,-6,14
Mumbai City,8050,1,6,5,3,16,8,8,23
NorthEast Un,8050,2,7,2,5,19,12,7,23
Delhi Dynamo,8050,3,5,6,3,25,17,8,21
Kerala Blast,8050,4,5,4,5,12,16,-4,19
Kolkata,8050,5,4,6,4,18,19,-1,18
Chennaiyin,8050,6,4,5,5,18,26,-8,17
FC Pune City,8050,7,4,4,6,14,17,-3,16
FC Goa,8050,8,4,2,8,15,22,-7,14
Kerala Blast,8051,1,7,3,4,15,14,1,24
Mumbai City,8051,2,6,5,3,16,8,8,23
Delhi Dynamo,8051,3,4,8,2,23,16,7,20
NorthEast Un,8051,4,5,3,6,13,13,0,18
FC Pune City,8051,5,5,3,6,14,17,-3,18
Kolkata,8051,6,3,7,4,15,17,-2,16
Chennaiyin,8051,7,3,6,5,15,20,-5,15
FC Goa,8051,8,3,5,6,11,17,-6,14
Mumbai City,8052,1,7,4,3,19,8,11,25
Delhi Dynamo,8052,2,6,5,3,29,19,10,23
Kerala Blast,8052,3,6,3,5,18,18,0,21
Chennaiyin,8052,4,5,5,4,16,18,-2,20
FC Pune City,8052,5,5,3,6,14,16,-2,18
Kolkata,8052,6,4,6,4,17,20,-3,18
NorthEast Un,8052,7,4,2,8,12,17,-5,14
FC Goa,8052,8,4,2,8,11,20,-9,14
Mumbai City,8053,1,7,4,3,17,8,9,25
Delhi Dynamo,8053,2,5,6,3,23,15,8,21
Kolkata,8053,3,5,6,3,17,16,1,21
Kerala Blast,8053,4,6,3,5,14,17,-3,21
FC Goa,8053,5,5,2,7,14,19,-5,17
NorthEast Un,8053,6,4,4,6,11,12,-1,16
FC Pune City,8053,7,4,3,7,13,17,-4,15
Chennaiyin,8053,8,3,6,5,16,21,-5,15
Mumbai City,8054,1,6,5,3,18,10,8,23
Delhi Dynamo,8054,2,5,7,2,27,18,9,22
FC Pune City,8054,3,6,3,5,18,14,4,21
Chennaiyin,8054,4,5,5,4,18,19,-1,20
Kerala Blast,8054,5,5,4,5,13,18,-5,19
Kolkata,8054,6,3,8,3,17,19,-2,17
NorthEast Un,8054,7,4,3,7,13,16,-3,15
FC Goa,8054,8,3,3,8,10,20,-10,12
Mumbai City,8055,1,6,5,3,17,9,8,23
Delhi Dynamo,8055,2,5,7,2,26,17,9,22
Chennaiyin,8055,3,5,5,4,15,17,-2,20
Kolkata,8055,4,4,7,3,15,15,0,19
FC Pune City,8055,5,5,4,5,14,14,0,19
Kerala Blast,8055,6,5,3,6,11,17,-6,18
FC Goa,8055,7,4,3,7,10,15,-5,15
NorthEast Un,8055,8,4,2,8,11,15,-4,14
Mumbai City,8056,1,7,4,3,19,9,10,25
Kolkata,8056,2,6,6,2,18,13,5,24
Kerala Blast,8056,3,5,4,5,14,16,-2,19
NorthEast Un,8056,4,5,3,6,13,15,-2,18
Delhi Dynamo,8056,5,4,5,5,23,21,2,17
FC Pune City,8056,6,4,4,6,12,15,-3,16
Chennaiyin,8056,7,3,7,4,16,20,-4,16
FC Goa,8056,8,4,3,7,11,17,-6,15
Mumbai City,8057,1,7,4,3,18,9,9,25
Delhi Dynamo,8057,2,6,5,3,26,17,9,23
NorthEast Un,8057,3,6,2,6,14,12,2,20
Kolkata,8057,4,4,7,3,15,14,1,19
FC Pune City,8057,5,5,3,6,13,15,-2,18
Kerala Blast,8057,6,5,3,6,10,15,-5,18
Chennaiyin,8057,7,4,5,5,18,20,-2,17
FC Goa,8057,8,3,3,8,9,21,-12,12
Kolkata,8058,1,6,6,2,19,14,5,24
Mumbai City,8058,2,6,5,3,16,8,8,23
Delhi Dynamo,8058,3,5,7,2,23,15,8,22
Kerala Blast,8058,4,5,4,5,14,16,-2,19
Chennaiyin,8058,5,4,5,5,15,18,-3,17
FC Pune City,8058,6,4,4,6,14,18,-4,16
NorthEast Un,8058,7,4,3,7,10,15,-5,15
FC Goa,8058,8,4,2,8,9,16,-7,14
Delhi Dynamo,8059,1,6,5,3,26,17,9,23
NorthEast Un,8059,2,7,2,5,13,10,3,23
Mumbai City,8059,3,6,4,4,17,10,7,22
Kolkata,8059,4,4,8,2,16,13,3,20
Kerala Blast,8059,5,5,4,5,12,16,-4,19
Chennaiyin,8059,6,4,5,5,15,19,-4,17
FC Pune City,8059,7,4,3,7,12,17,-5,15
FC Goa,8059,8,3,3,8,10,19,-9,12
Delhi Dynamo,8060,1,6,5,3,25,17,8,23
Mumbai City,8060,2,6,4,4,17,11,6,22
Kerala Blast,8060,3,6,3,5,12,15,-3,21
Chennaiyin,8060,4,5,5,4,15,17,-2,20
FC Pune City,8060,5,5,4,5,14,15,-1,19
Kolkata,8060,6,3,8,3,17,17,0,17
NorthEast Un,8060,7,5,2,7,11,11,0,17
FC Goa,8060,8,3,3,8,10,18,-8,12
Mumbai City,8061,1,6,4,4,18,12,6,22
Kolkata,8061,2,5,7,2,16,13,3,22
Kerala Blast,8061,3,6,4,4,15,14,1,22
Delhi Dynamo,8061,4,5,6,3,27,19,8,21
NorthEast Un,8061,5,6,2,6,13,11,2,20
Chennaiyin,8061,6,4,5,5,14,20,-6,17
FC Pune City,8061,7,4,3,7,14,20,-6,15
FC Goa,8061,8,3,3,8,10,18,-8,12
Delhi Dynamo,8062,1,6,6,2,25,16,9,24
Mumbai City,8062,2,6,4,4,17,10,7,22
Kolkata,8062,3,5,7,2,18,14,4,22
NorthEast Un,8062,4,6,3,5,11,9,2,21
FC Pune City,8062,5,5,3,6,16,18,-2,18
Chennaiyin,8062,6,4,5,5,16,19,-3,17
Kerala Blast,8062,7,4,3,7,11,19,-8,15
FC Goa,8062,8,3,3,8,11,20,-9,12
Mumbai City,8063,1,7,4,3,18,8,10,25
Kerala Blast,8063,2,5,5,4,12,15,-3,20
Delhi Dynamo,8063,3,4,7,3,23,18,5,19
Chennaiyin,8063,4,4,6,4,16,19,-3,18
Kolkata,8063,5,3,8,3,13,14,-1,17
NorthEast Un,8063,6,4,4,6,12,13,-1,16
FC Pune City,8063,7,4,4,6,13,16,-3,16
FC Goa,8063,8,4,4,6,12,16,-4,16
Mumbai City,8064,1,6,5,3,16,8,8,23
Delhi Dynamo,8064,2,5,6,3,23,18,5,21
Kerala Blast,8064,3,6,3,5,12,15,-3,21
Kolkata,8064,4,4,8,2,18,16,2,20
FC Goa,8064,5,4,4,6,15,17,-2,16
FC Pune City,8064,6,4,4,6,15,18,-3,16
Chennaiyin,8064,7,3,7,4,15,19,-4,16
NorthEast Un,8064,8,4,3,7,10,13,-3,15
Delhi Dynamo,8065,1,7,5,2,30,18,12,26
Kolkata,8065,2,6,6,2,22,15,7,24
Mumbai City,8065,3,6,4,4,18,12,6,22
NorthEast Un,8065,4,5,2,7,13,15,-2,17
Chennaiyin,8065,5,4,5,5,14,18,-4,17
FC Pune City,8065,6,4,4,6,15,18,-3,16
Kerala Blast,8065,7,4,4,6,12,21,-9,16
FC Goa,8065,8,4,2,8,11,18,-7,14
Delhi Dynamo,8066,1,7,5,2,26,14,12,26
Mumbai City,8066,2,6,4,4,16,9,7,22
Kerala Blast,8066,3,6,4,4,12,13,-1,22
Kolkata,8066,4,3,9,2,16,15,1,18
Chennaiyin,8066,5,4,6,4,18,18,0,18
FC Pune City,8066,6,4,4,6,13,17,-4,16
NorthEast Un,8066,7,4,2,8,9,17,-8,14
FC Goa,8066,8,3,4,7,11,18,-7,13
Mumbai City,8067,1,7,4,3,18,9,9,25
Kerala Blast,8067,2,7,3,4,15,14,1,24
Delhi Dynamo,8067,3,4,6,4,26,23,3,18
NorthEast Un,8067,4,5,3,6,15,13,2,18
Kolkata,8067,5,4,6,4,19,20,-1,18
FC Pune City,8067,6,5,3,6,16,19,-3,18
Chennaiyin,8067,7,3,7,4,14,18,-4,16
FC Goa,8067,8,3,4,7,11,18,-7,13
Mumbai City,8068,1,7,4,3,19,8,11,25
NorthEast Un,8068,2,6,3,5,15,13,2,21
Kerala Blast,8068,3,6,3,5,17,17,0,21
Kolkata,8068,4,4,7,3,18,16,2,19
Delhi Dynamo,8068,5,4,6,4,22,19,3,18
Chennaiyin,8068,6,4,6,4,17,19,-2,18
FC Pune City,8068,7,4,3,7,12,20,-8,15
FC Goa,8068,8,3,4,7,9,17,-8,13
Mumbai City,8069,1,7,4,3,19,9,10,25
Delhi Dynamo,8069,2,5,6,3,26,17,9,21
Kerala Blast,8069,3,5,5,4,10,13,-3,20
Kolkata,8069,4,4,6,4,16,18,-2,18
NorthEast Un,8069,5,5,3,6,10,13,-3,18
FC Pune City,8069,6,4,4,6,13,16,-3,16
FC Goa,8069,7,4,4,6,12,15,-3,16
Chennaiyin,8069,8,3,6,5,13,18,-5,15
Mumbai City,8070,1,6,5,3,17,9,8,23
Kerala Blast,8070,2,6,3,5,13,15,-2,21
Kolkata,8070,3,4,7,3,16,15,1,19
Delhi Dynamo,8070,4,4,6,4,23,19,4,18
NorthEast Un,8070,5,5,3,6,13,12,1,18
FC Goa,8070,6,5,3,6,12,16,-4,18
Chennaiyin,8070,7,3,7,4,16,20,-4,16
FC Pune City,8070,8,4,4,6,15,19,-4,16
Mumbai City,8071,1,6,4,4,18,11,7,22
Delhi Dynamo,8071,2,5,6,3,26,19,7,21
Kerala Blast,8071,3,5,5,4,12,14,-2,20
Kolkata,8071,4,4,7,3,16,15,1,19
NorthEast Un,8071,5,5,4,5,11,10,1,19
FC Pune City,8071,6,4,4,6,14,18,-4,16
FC Goa,8071,7,4,4,6,12,17,-5,16
Chennaiyin,8071,8,3,6,5,15,20,-5,15
Mumbai City,8072,1,7,4,3,18,9,9,25
Kolkata,8072,2,5,7,2,18,13,5,22
FC Pune City,8072,3,5,4,5,16,17,-1,19
Delhi Dynamo,8072,4,4,6,4,23,18,5,18
NorthEast Un,8072,5,5,3,6,14,13,1,18
Kerala Blast,8072,6,5,3,6,12,19,-7,18
FC Goa,8072,7,5,2,7,10,15,-5,17
Chennaiyin,8072,8,3,5,6,15,22,-7,14
Delhi Dynamo,8073,1,6,5,3,28,20,8,23
Mumbai City,8073,2,6,4,4,16,9,7,22
Kerala Blast,8073,3,6,4,4,13,15,-2,22
NorthEast Un,8073,4,6,2,6,16,11,5,20
Kolkata,8073,5,3,8,3,18,18,0,17
FC Pune City,8073,6,4,5,5,15,17,-2,17
FC Goa,8073,7,4,3,7,14,22,-8,15
Chennaiyin,8073,8,3,5,6,14,22,-8,14
Kerala Blast,8074,1,7,3,4,15,13,2,24
Mumbai City,8074,2,6,5,3,17,9,8,23
Delhi Dynamo,8074,3,5,6,3,25,20,5,21
Kolkata,8074,4,5,6,3,17,14,3,21
NorthEast Un,8074,5,5,3,6,15,15,0,18
Chennaiyin,8074,6,3,7,4,16,20,-4,16
FC Pune City,8074,7,4,3,7,12,17,-5,15
FC Goa,8074,8,3,3,8,11,20,-9,12
Mumbai City,8075,1,7,4,3,18,9,9,25
Kolkata,8075,2,6,6,2,20,13,7,24
Delhi Dynamo,8075,3,6,5,3,26,18,8,23
Kerala Blast,8075,4,5,4,5,11,15,-4,19
NorthEast Un,8075,5,5,3,6,14,13,1,18
Chennaiyin,8075,6,4,5,5,16,21,-5,17
FC Pune City,8075,7,4,3,7,13,19,-6,15
FC Goa,8075,8,3,2,9,10,20,-10,11
Mumbai City,8076,1,7,4,3,19,8,11,25
Kolkata,8076,2,5,7,2,18,14,4,22
Delhi Dynamo,8076,3,5,6,3,23,17,6,21
NorthEast Un,8076,4,5,3,6,12,12,0,18
FC Pune City,8076,5,5,3,6,15,18,-3,18
Chennaiyin,8076,6,4,5,5,15,21,-6,17
FC Goa,8076,7,4,3,7,12,17,-5,15
Kerala Blast,8076,8,4,3,7,11,18,-7,15
Delhi Dynamo,8077,1,6,6,2,28,17,11,24
Mumbai City,8077,2,6,4,4,17,10,7,22
Kerala Blast,8077,3,6,3,5,12,15,-3,21
Kolkata,8077,4,4,7,3,16,16,0,19
Chennaiyin,8077,5,4,6,4,16,19,-3,18
NorthEast Un,8077,6,4,4,6,12,13,-1,16
FC Pune City,8077,7,4,4,6,15,18,-3,16
FC Goa,8077,8,4,2,8,11,19,-8,14
Mumbai City,8078,1,6,5,3,16,8,8,23
Delhi Dynamo,8078,2,5,6,3,23,15,8,21
Kerala Blast,8078,3,6,3,5,12,16,-4,21
Kolkata,8078,4,4,8,2,19,16,3,20
NorthEast Un,8078,5,5,2,7,11,12,-1,17
Chennaiyin,8078,6,4,5,5,14,19,-5,17
FC Pune City,8078,7,4,4,6,14,17,-3,16
FC Goa,8078,8,4,3,7,10,16,-6,15
Mumbai City,8079,1,6,4,4,17,10,7,22
Delhi Dynamo,8079,2,5,6,3,23,17,6,21
NorthEast Un,8079,3,6,2,6,14,13,1,20
Kerala Blast,8079,4,5,5,4,13,14,-1,20
FC Pune City,8079,5,5,4,5,18,16,2,19
Kolkata,8079,6,3,7,4,14,18,-4,16
FC Goa,8079,7,4,4,6,10,15,-5,16
Chennaiyin,8079,8,3,6,5,15,21,-6,15
Mumbai City,8080,1,6,4,4,16,9,7,22
Delhi Dynamo,8080,2,5,6,3,22,15,7,21
Kolkata,8080,3,5,6,3,19,15,4,21
NorthEast Un,8080,4,6,3,5,13,11,2,21
Chennaiyin,8080,5,4,5,5,16,19,-3,17
FC Goa,8080,6,5,2,7,11,16,-5,17
FC Pune City,8080,7,4,4,6,13,17,-4,16
Kerala Blast,8080,8,4,4,6,10,18,-8,16
Delhi Dynamo,8081,1,6,6,2,28,15,13,24
Mumbai City,8081,2,6,5,3,16,8,8,23
Kerala Blast,8081,3,5,4,5,11,14,-3,19
Kolkata,8081,4,4,6,4,16,16,0,18
NorthEast Un,8081,5,5,3,6,13,14,-1,18
FC Pune City,8081,6,5,3,6,13,16,-3,18
Chennaiyin,8081,7,3,6,5,16,23,-7,15
FC Goa,8081,8,4,3,7,14,21,-7,15
Mumbai City,8082,1,6,5,3,16,8,8,23
Delhi Dynamo,8082,2,4,8,2,22,15,7,20
Kerala Blast,8082,3,5,5,4,10,13,-3,20
NorthEast Un,8082,4,5,4,5,10,9,1,19
FC Pune City,8082,5,5,4,5,15,15,0,19
FC Goa,8082,6,5,3,6,15,18,-3,18
Kolkata,8082,7,3,6,5,16,19,-3,15
Chennaiyin,8082,8,3,5,6,14,21,-7,14
Mumbai City,8083,1,7,4,3,17,8,9,25
Kolkata,8083,2,5,7,2,17,12,5,22
NorthEast Un,8083,3,6,3,5,17,13,4,21
Delhi Dynamo,8083,4,5,5,4,26,19,7,20
Chennaiyin,8083,5,4,6,4,19,20,-1,18
Kerala Blast,8083,6,5,3,6,10,17,-7,18
FC Pune City,8083,7,4,3,7,12,17,-5,15
FC Goa,8083,8,3,3,8,9,21,-12,12
Mumbai City,8084,1,6,4,4,18,11,7,22
Delhi Dynamo,8084,2,5,6,3,26,19,7,21
Kolkata,8084,3,5,6,3,16,13,3,21
FC Pune City,8084,4,5,4,5,14,15,-1,19
Chennaiyin,8084,5,4,6,4,15,17,-2,18
Kerala Blast,8084,6,4,5,5,10,16,-6,17
NorthEast Un,8084,7,4,4,6,10,12,-2,16
FC Goa,8084,8,4,3,7,10,16,-6,15
Mumbai City,8085,1,7,4,3,19,10,9,25
NorthEast Un,8085,2,7,2,5,20,11,9,23
Kolkata,8085,3,5,6,3,15,14,1,21
Delhi Dynamo,8085,4,4,6,4,26,22,4,18
Chennaiyin,8085,5,4,5,5,14,22,-8,17
FC Pune City,8085,6,4,4,6,12,15,-3,16
Kerala Blast,8085,7,4,4,6,9,16,-7,16
FC Goa,8085,8,4,3,7,11,16,-5,15
Delhi Dynamo,8086,1,7,5,2,27,16,11,26
Mumbai City,8086,2,6,4,4,16,10,6,22
FC Pune City,8086,3,6,3,5,17,16,1,21
Kolkata,8086,4,4,6,4,15,16,-1,18
Kerala Blast,8086,5,5,3,6,15,22,-7,18
NorthEast Un,8086,6,5,2,7,14,15,-1,17
FC Goa,8086,7,4,3,7,13,17,-4,15
Chennaiyin,8086,8,3,6,5,14,19,-5,15
Mumbai City,8087,1,7,4,3,19,9,10,25
Delhi Dynamo,8087,2,5,5,4,23,20,3,20
Chennaiyin,8087,3,5,5,4,19,20,-1,20
Kolkata,8087,4,4,7,3,16,15,1,19
FC Pune City,8087,5,5,4,5,15,15,0,19
NorthEast Un,8087,6,5,3,6,15,14,1,18
Kerala Blast,8087,7,4,4,6,11,18,-7,16
FC Goa,8087,8,4,2,8,12,19,-7,14
Mumbai City,8088,1,7,4,3,20,8,12,25
Kerala Blast,8088,2,5,5,4,12,14,-2,20
FC Pune City,8088,3,5,4,5,14,15,-1,19
NorthEast Un,8088,4,5,3,6,11,11,0,18
Chennaiyin,8088,5,4,6,4,15,17,-2,18
Delhi Dynamo,8088,6,4,5,5,21,21,0,17
Kolkata,8088,7,3,8,3,17,17,0,17
FC Goa,8088,8,4,3,7,11,18,-7,15
Mumbai City,8089,1,7,4,3,18,8,10,25
Delhi Dynamo,8089,2,6,5,3,26,17,9,23
Kolkata,8089,3,5,6,3,15,13,2,21
Kerala Blast,8089,4,5,4,5,11,15,-4,19
FC Pune City,8089,5,4,4,6,12,15,-3,16
Chennaiyin,8089,6,3,7,4,15,19,-4,16
NorthEast Un,8089,7,4,3,7,11,15,-4,15
FC Goa,8089,8,4,3,7,11,17,-6,15
Mumbai City,8090,1,6,5,3,17,9,8,23
Kerala Blast,8090,2,6,4,4,12,13,-1,22
Delhi Dynamo,8090,3,5,6,3,25,18,7,21
NorthEast Un,8090,4,6,2,6,16,13,3,20
Kolkata,8090,5,4,6,4,16,16,0,18
FC Goa,8090,6,5,2,7,12,17,-5,17
FC Pune City,8090,7,4,4,6,12,16,-4,16
Chennaiyin,8090,8,3,5,6,15,23,-8,14
Mumbai City,8091,1,6,4,4,18,11,7,22
Delhi Dynamo,8091,2,5,6,3,25,18,7,21
Kerala Blast,8091,3,6,3,5,14,18,-4,21
FC Pune City,8091,4,5,4,5,14,14,0,19
FC Goa,8091,5,5,3,6,13,17,-4,18
NorthEast Un,8091,6,5,2,7,12,13,-1,17
Chennaiyin,8091,7,4,5,5,16,20,-4,17
Kolkata,8091,8,3,7,4,14,15,-1,16
Mumbai City,8092,1,7,4,3,22,11,11,25
Kolkata,8092,2,5,6,3,19,14,5,21
NorthEast Un,8092,3,6,3,5,13,11,2,21
Delhi Dynamo,8092,4,4,6,4,26,23,3,18
FC Pune City,8092,5,5,3,6,14,17,-3,18
Chennaiyin,8092,6,3,7,4,15,19,-4,16
FC Goa,8092,7,4,4,6,11,16,-5,16
Kerala Blast,8092,8,4,3,7,9,18,-9,15
Mumbai City,8093,1,7,4,3,19,8,11,25
Delhi Dynamo,8093,2,5,5,4,28,21,7,20
NorthEast Un,8093,3,6,2,6,12,12,0,20
Kolkata,8093,4,4,7,3,17,15,2,19
Chennaiyin,8093,5,4,6,4,15,17,-2,18
FC Pune City,8093,6,5,3,6,13,15,-2,18
Kerala Blast,8093,7,5,3,6,11,17,-6,18
FC Goa,8093,8,3,4,7,11,21,-10,13
Mumbai City,8094,1,7,4,3,20,9,11,25
Delhi Dynamo,8094,2,5,5,4,26,21,5,20
Kerala Blast,8094,3,5,5,4,15,18,-3,20
NorthEast Un,8094,4,5,3,6,14,14,0,18
Kolkata,8094,5,3,8,3,18,18,0,17
FC Pune City,8094,6,4,5,5,15,17,-2,17
FC Goa,8094,7,5,2,7,15,19,-4,17
Chennaiyin,8094,8,3,6,5,15,22,-7,15
Mumbai City,8095,1,7,4,3,18,9,9,25
Delhi Dynamo,8095,2,6,5,3,28,19,9,23
FC Pune City,8095,3,5,4,5,14,15,-1,19
Kerala Blast,8095,4,5,4,5,11,15,-4,19
Kolkata,8095,5,4,6,4,16,15,1,18
NorthEast Un,8095,6,5,2,7,12,14,-2,17
FC Goa,8095,7,5,2,7,13,18,-5,17
Chennaiyin,8095,8,3,5,6,14,21,-7,14
Delhi Dynamo,8096,1,6,6,2,28,17,11,24
Mumbai City,8096,2,6,4,4,17,10,7,22
NorthEast Un,8096,3,6,3,5,14,11,3,21
FC Pune City,8096,4,6,3,5,15,15,0,21
Kolkata,8096,5,4,6,4,15,16,-1,18
FC Goa,8096,6,5,2,7,13,17,-4,17
Kerala Blast,8096,7,4,3,7,10,19,-9,15
Chennaiyin,8096,8,3,5,6,13,20,-7,14
Mumbai City,8097,1,7,4,3,18,8,10,25
Kerala Blast,8097,2,6,3,5,13,18,-5,21
Delhi Dynamo,8097,3,4,7,3,24,19,5,19
NorthEast Un,8097,4,5,4,5,17,13,4,19
Kolkata,8097,5,3,8,3,14,15,-1,17
FC Pune City,8097,6,4,4,6,13,16,-3,16
Chennaiyin,8097,7,3,7,4,16,20,-4,16
FC Goa,8097,8,3,5,6,11,17,-6,14
Mumbai City,8098,1,7,4,3,17,8,9,25
Kerala Blast,8098,2,6,4,4,15,14,1,22
Delhi Dynamo,8098,3,5,5,4,23,18,5,20
NorthEast Un,8098,4,5,4,5,15,13,2,19
FC Pune City,8098,5,5,3,6,14,18,-4,18
Chennaiyin,8098,6,3,7,4,16,20,-4,16
FC Goa,8098,7,4,3,7,12,16,-4,15
Kolkata,8098,8,3,6,5,14,19,-5,15
Mumbai City,8099,1,6,5,3,17,9,8,23
Kolkata,8099,2,5,7,2,19,14,5,22
Delhi Dynamo,8099,3,5,6,3,25,18,7,21
NorthEast Un,8099,4,6,2,6,13,12,1,20
Chennaiyin,8099,5,5,5,4,17,18,-1,20
FC Pune City,8099,6,4,5,5,13,15,-2,17
Kerala Blast,8099,7,4,4,6,10,17,-7,16
FC Goa,8099,8,3,2,9,11,22,-11,11
Mumbai City,8100,1,6,5,3,17,9,8,23
NorthEast Un,8100,2,6,3,5,15,11,4,21
FC Pune City,8100,3,6,3,5,15,14,1,21
Delhi Dynamo,8100,4,4,7,3,23,19,4,19
FC Goa,8100,5,5,3,6,14,16,-2,18
Kerala Blast,8100,6,5,3,6,10,17,-7,18
Kolkata,8100,7,3,7,4,13,14,-1,16
Chennaiyin,8100,8,3,5,6,16,23,-7,14
Mumbai City,8101,1,7,4,3,17,8,9,25
Delhi Dynamo,8101,2,5,5,4,25,18,7,20
Chennaiyin,8101,3,5,5,4,17,18,-1,20
Kolkata,8101,4,4,7,3,16,15,1,19
Kerala Blast,8101,5,5,4,5,10,16,-6,19
FC Pune City,8101,6,5,3,6,16,16,0,18
NorthEast Un,8101,7,5,3,6,13,13,0,18
FC Goa,8101,8,3,3,8,9,19,-10,12
Mumbai City,8102,1,7,4,3,18,9,9,25
Kolkata,8102,2,5,6,3,19,18,1,21
NorthEast Un,8102,3,5,4,5,10,9,1,19
Delhi Dynamo,8102,4,4,6,4,23,18,5,18
FC Pune City,8102,5,5,3,6,17,19,-2,18
Chennaiyin,8102,6,4,6,4,15,17,-2,18
Kerala Blast,8102,7,4,4,6,10,16,-6,16
FC Goa,8102,8,4,3,7,12,18,-6,15
Delhi Dynamo,8103,1,6,6,2,26,16,10,24
Mumbai City,8103,2,6,4,4,17,10,7,22
Kolkata,8103,3,5,6,3,17,15,2,21
Kerala Blast,8103,4,6,3,5,13,16,-3,21
FC Pune City,8103,5,5,3,6,14,15,-1,18
Chennaiyin,8103,6,4,6,4,15,18,-3,18
NorthEast Un,8103,7,4,4,6,10,12,-2,16
FC Goa,8103,8,3,2,9,10,20,-10,11
Mumbai City,8104,1,6,5,3,16,8,8,23
Kerala Blast,8104,2,6,4,4,12,14,-2,22
Delhi Dynamo,8104,3,4,8,2,22,15,7,20
Kolkata,8104,4,4,7,3,18,17,1,19
NorthEast Un,8104,5,4,5,5,10,10,0,17
Chennaiyin,8104,6,3,7,4,16,20,-4,16
FC Pune City,8104,7,4,3,7,14,18,-4,15
FC Goa,8104,8,3,5,6,12,18,-6,14
Mumbai City,8105,1,6,5,3,16,8,8,23
Kolkata,8105,2,5,7,2,16,12,4,22
Delhi Dynamo,8105,3,4,7,3,23,19,4,19
Kerala Blast,8105,4,5,4,5,11,14,-3,19
NorthEast Un,8105,5,5,3,6,13,12,1,18
FC Goa,8105,6,4,4,6,12,16,-4,16
FC Pune City,8105,6,4,4,6,12,16,-4,16
Chennaiyin,8105,8,3,6,5,14,20,-6,15
Mumbai City,8106,1,6,4,4,16,9,7,22
Kolkata,8106,2,5,6,3,16,13,3,21
Delhi Dynamo,8106,3,5,5,4,22,17,5,20
NorthEast Un,8106,4,5,3,6,11,12,-1,18
Chennaiyin,8106,5,4,6,4,16,18,-2,18
FC Goa,8106,6,5,3,6,12,15,-3,18
Kerala Blast,8106,7,4,5,5,11,17,-6,17
FC Pune City,8106,8,4,4,6,13,16,-3,16
Mumbai City,8107,1,7,4,3,18,9,9,25
FC Pune City,8107,2,6,3,5,16,16,0,21
Kerala Blast,8107,3,6,3,5,13,14,-1,21
NorthEast Un,8107,4,5,3,6,12,13,-1,18
Chennaiyin,8107,5,4,6,4,15,18,-3,18
Delhi Dynamo,8107,6,4,5,5,22,19,3,17
FC Goa,8107,7,5,2,7,11,16,-5,17
Kolkata,8107,8,3,6,5,16,18,-2,15
Kolkata,8108,1,6,6,2,20,13,7,24
Mumbai City,8108,2,6,4,4,16,10,6,22
Delhi Dynamo,8108,3,5,6,3,24,16,8,21
Kerala Blast,8108,4,6,3,5,12,15,-3,21
NorthEast Un,8108,5,5,3,6,10,11,-1,18
Chennaiyin,8108,6,3,7,4,14,18,-4,16
FC Pune City,8108,7,4,3,7,12,16,-4,15
FC Goa,8108,8,3,4,7,11,20,-9,13
Mumbai City,8109,1,7,4,3,20,9,11,25
Delhi Dynamo,8109,2,5,5,4,27,23,4,20
NorthEast Un,8109,3,5,4,5,16,12,4,19
Kolkata,8109,4,4,7,3,17,16,1,19
Kerala Blast,8109,5,5,4,5,13,18,-5,19
FC Goa,8109,6,5,2,7,14,20,-6,17
FC Pune City,8109,7,4,4,6,16,19,-3,16
Chennaiyin,8109,8,3,6,5,16,22,-6,15
Mumbai City,8110,1,7,4,3,19,8,11,25
Kolkata,8110,2,6,6,2,16,12,4,24
Delhi Dynamo,8110,3,5,5,4,22,19,3,20
NorthEast Un,8110,4,5,4,5,11,9,2,19
Kerala Blast,8110,5,5,4,5,11,15,-4,19
Chennaiyin,8110,6,4,6,4,15,18,-3,18
FC Pune City,8110,7,4,3,7,13,17,-4,15
FC Goa,8110,8,3,2,9,9,18,-9,11
Delhi Dynamo,8111,1,6,5,3,30,18,12,23
Mumbai City,8111,2,6,4,4,17,11,6,22
Kerala Blast,8111,3,6,3,5,13,15,-2,21
NorthEast Un,8111,4,6,2,6,13,14,-1,20
Kolkata,8111,5,4,7,3,16,13,3,19
Chennaiyin,8111,6,4,5,5,16,21,-5,17
FC Pune City,8111,7,4,4,6,13,17,-4,16
FC Goa,8111,8,4,2,8,12,21,-9,14
Delhi Dynamo,8112,1,6,6,2,29,19,10,24
Mumbai City,8112,2,6,5,3,17,9,8,23
Kolkata,8112,3,5,7,2,15,12,3,22
Chennaiyin,8112,4,4,5,5,17,21,-4,17
Kerala Blast,8112,5,4,5,5,11,16,-5,17
FC Pune City,8112,6,4,4,6,13,16,-3,16
NorthEast Un,8112,7,4,3,7,14,16,-2,15
FC Goa,8112,8,4,3,7,12,19,-7,15
Mumbai City,8113,1,7,4,3,19,9,10,25
Kolkata,8113,2,5,7,2,18,14,4,22
Delhi Dynamo,8113,3,5,5,4,23,18,5,20
FC Pune City,8113,4,5,4,5,14,14,0,19
NorthEast Un,8113,5,5,3,6,11,11,0,18
FC Goa,8113,6,5,2,7,12,17,-5,17
Kerala Blast,8113,7,4,4,6,10,17,-7,16
Chennaiyin,8113,8,3,5,6,14,21,-7,14
Delhi Dynamo,8114,1,6,6,2,28,17,11,24
Mumbai City,8114,2,6,4,4,17,10,7,22
Kolkata,8114,3,5,7,2,17,14,3,22
Kerala Blast,8114,4,5,4,5,12,16,-4,19
Chennaiyin,8114,5,4,6,4,15,17,-2,18
NorthEast Un,8114,6,4,5,5,12,12,0,17
FC Pune City,8114,7,4,3,7,13,17,-4,15
FC Goa,8114,8,3,3,8,10,21,-11,12
Mumbai City,8115,1,6,5,3,18,10,8,23
Delhi Dynamo,8115,2,5,6,3,26,18,8,21
FC Pune City,8115,3,6,3,5,14,14,0,21
FC Goa,8115,4,6,2,6,16,17,-1,20
NorthEast Un,8115,5,5,3,6,12,13,-1,18
Kolkata,8115,6,3,7,4,15,16,-1,16
Kerala Blast,8115,7,4,4,6,10,16,-6,16
Chennaiyin,8115,8,3,6,5,14,21,-7,15
Mumbai City,8116,1,7,4,3,17,8,9,25
Delhi Dynamo,8116,2,5,5,4,25,17,8,20
NorthEast Un,8116,3,6,2,6,14,14,0,20
FC Pune City,8116,4,5,3,6,16,18,-2,18
Kolkata,8116,4,4,6,4,16,18,-2,18
Kerala Blast,8116,6,5,3,6,17,20,-3,18
Chennaiyin,8116,7,4,5,5,15,18,-3,17
FC Goa,8116,8,5,2,7,11,18,-7,17
Mumbai City,8117,1,7,4,3,19,10,9,25
Delhi Dynamo,8117,2,6,5,3,28,20,8,23
Kolkata,8117,3,5,6,3,16,13,3,21
FC Pune City,8117,4,6,3,5,17,16,1,21
NorthEast Un,8117,5,5,3,6,12,12,0,18
Kerala Blast,8117,6,4,4,6,12,20,-8,16
FC Goa,8117,7,4,2,8,12,18,-6,14
Chennaiyin,8117,8,3,5,6,13,20,-7,14
Mumbai City,8118,1,6,5,3,17,9,8,23
Kolkata,8118,2,5,6,3,19,14,5,21
Delhi Dynamo,8118,3,4,7,3,25,20,5,19
Kerala Blast,8118,4,5,4,5,13,19,-6,19
FC Goa,8118,5,5,3,6,12,15,-3,18
NorthEast Un,8118,6,4,4,6,11,13,-2,16
FC Pune City,8118,7,4,4,6,15,18,-3,16
Chennaiyin,8118,8,3,7,4,13,17,-4,16
Kolkata,8119,1,6,6,2,23,16,7,24
Mumbai City,8119,2,6,5,3,17,9,8,23
NorthEast Un,8119,3,6,3,5,14,10,4,21
Delhi Dynamo,8119,4,4,7,3,24,19,5,19
Kerala Blast,8119,5,5,4,5,14,17,-3,19
FC Goa,8119,6,4,3,7,13,18,-5,15
FC Pune City,8119,7,4,3,7,12,20,-8,15
Chennaiyin,8119,8,3,5,6,13,21,-8,14
Delhi Dynamo,8120,1,6,5,3,24,17,7,23
Mumbai City,8120,2,6,4,4,16,9,7,22
Kolkata,8120,3,5,7,2,16,13,3,22
NorthEast Un,8120,4,6,3,5,14,10,4,21
FC Pune City,8120,5,4,4,6,13,16,-3,16
Kerala Blast,8120,6,4,4,6,9,16,-7,16
FC Goa,8120,7,4,3,7,10,15,-5,15
Chennaiyin,8120,8,3,6,5,13,19,-6,15
Mumbai City,8121,1,6,5,3,16,8,8,23
Kerala Blast,8121,2,6,3,5,17,16,1,21
Delhi Dynamo,8121,3,4,7,3,23,17,6,19
Kolkata,8121,4,4,7,3,18,16,2,19
FC Pune City,8121,5,5,3,6,15,18,-3,18
NorthEast Un,8121,6,5,3,6,13,17,-4,18
Chennaiyin,8121,7,3,7,4,15,19,-4,16
FC Goa,8121,8,3,5,6,10,16,-6,14
Delhi Dynamo,8122,1,6,6,2,24,14,10,24
Mumbai City,8122,2,6,4,4,16,10,6,22
NorthEast Un,8122,3,5,4,5,14,12,2,19
Kolkata,8122,4,4,7,3,16,16,0,19
Kerala Blast,8122,5,5,4,5,12,17,-5,19
FC Goa,8122,6,5,2,7,13,16,-3,17
FC Pune City,8122,7,4,3,7,13,17,-4,15
Chennaiyin,8122,8,3,6,5,16,22,-6,15
Mumbai City,8123,1,7,4,3,18,9,9,25
Delhi Dynamo,8123,2,5,6,3,26,16,10,21
Kolkata,8123,3,4,7,3,18,16,2,19
FC Pune City,8123,4,5,4,5,15,16,-1,19
FC Goa,8123,5,5,3,6,12,15,-3,18
Kerala Blast,8123,6,5,3,6,11,17,-6,18
NorthEast Un,8123,7,5,2,7,11,16,-5,17
Chennaiyin,8123,8,3,5,6,15,21,-6,14
Mumbai City,8124,1,7,4,3,20,8,12,25
Kolkata,8124,2,5,6,3,17,15,2,21
Delhi Dynamo,8124,3,4,7,3,23,20,3,19
Kerala Blast,8124,4,5,4,5,13,18,-5,19
FC Goa,8124,5,5,3,6,12,15,-3,18
NorthEast Un,8124,6,4,4,6,13,14,-1,16
FC Pune City,8124,7,4,4,6,14,17,-3,16
Chennaiyin,8124,8,3,6,5,14,19,-5,15
Mumbai City,8125,1,7,4,3,17,8,9,25
Kerala Blast,8125,2,6,3,5,12,16,-4,21
NorthEast Un,8125,3,6,2,6,12,11,1,20
FC Goa,8125,4,6,2,6,15,18,-3,20
Kolkata,8125,5,4,6,4,17,15,2,18
FC Pune City,8125,6,5,3,6,13,15,-2,18
Delhi Dynamo,8125,7,4,5,5,22,18,4,17
Chennaiyin,8125,8,3,5,6,15,22,-7,14
Mumbai City,8126,1,7,4,3,18,8,10,25
Delhi Dynamo,8126,2,5,6,3,25,18,7,21
Kolkata,8126,3,5,6,3,16,14,2,21
FC Pune City,8126,4,6,3,5,16,16,0,21
Kerala Blast,8126,5,5,3,6,14,18,-4,18
NorthEast Un,8126,6,4,4,6,13,15,-2,16
Chennaiyin,8126,7,3,6,5,14,19,-5,15
FC Goa,8126,8,4,2,8,10,18,-8,14
Mumbai City,8127,1,7,4,3,20,8,12,25
Delhi Dynamo,8127,2,5,5,4,25,22,3,20
Kolkata,8127,3,4,8,2,17,15,2,20
NorthEast Un,8127,4,5,4,5,14,13,1,19
FC Pune City,8127,5,5,3,6,16,18,-2,18
Chennaiyin,8127,6,4,6,4,15,18,-3,18
Kerala Blast,8127,7,4,5,5,14,19,-5,17
FC Goa,8127,8,3,3,8,9,17,-8,12
Mumbai City,8128,1,7,4,3,17,8,9,25
Kerala Blast,8128,2,6,4,4,16,14,2,22
Delhi Dynamo,8128,3,5,6,3,25,17,8,21
Kolkata,8128,4,4,7,3,15,15,0,19
Chennaiyin,8128,5,4,6,4,16,19,-3,18
NorthEast Un,8128,6,4,4,6,12,15,-3,16
FC Pune City,8128,7,4,3,7,12,18,-6,15
FC Goa,8128,8,4,2,8,11,18,-7,14
Mumbai City,8129,1,6,5,3,17,9,8,23
Delhi Dynamo,8129,2,5,6,3,26,18,8,21
FC Goa,8129,3,6,2,6,13,15,-2,20
Kolkata,8129,4,4,7,3,16,16,0,19
NorthEast Un,8129,5,5,3,6,14,14,0,18
Kerala Blast,8129,6,4,6,4,9,13,-4,18
FC Pune City,8129,7,4,4,6,14,17,-3,16
Chennaiyin,8129,8,3,5,6,15,22,-7,14
Mumbai City,8130,1,6,4,4,16,10,6,22
Delhi Dynamo,8130,2,5,5,4,23,18,5,20
FC Goa,8130,3,6,2,6,16,15,1,20
Kerala Blast,8130,4,5,5,4,12,14,-2,20
FC Pune City,8130,5,5,4,5,14,15,-1,19
NorthEast Un,8130,6,5,3,6,10,10,0,18
Chennaiyin,8130,7,4,5,5,14,18,-4,17
Kolkata,8130,8,3,6,5,16,21,-5,15
Mumbai City,8131,1,7,4,3,19,8,11,25
Kolkata,8131,2,5,6,3,18,17,1,21
Delhi Dynamo,8131,3,5,5,4,23,20,3,20
Chennaiyin,8131,4,5,5,4,18,18,0,20
Kerala Blast,8131,5,5,4,5,13,17,-4,19
NorthEast Un,8131,6,5,3,6,14,14,0,18
FC Pune City,8131,7,5,3,6,14,15,-1,18
FC Goa,8131,8,3,2,9,10,20,-10,11
Mumbai City,8132,1,7,4,3,20,9,11,25
Kerala Blast,8132,2,7,3,4,13,13,0,24
Delhi Dynamo,8132,3,5,6,3,27,22,5,21
FC Pune City,8132,4,5,3,6,13,15,-2,18
FC Goa,8132,5,5,3,6,15,18,-3,18
Chennaiyin,8132,6,4,5,5,17,20,-3,17
Kolkata,8132,7,3,6,5,14,18,-4,15
NorthEast Un,8132,8,4,2,8,12,16,-4,14
Delhi Dynamo,8133,1,6,6,2,24,15,9,24
Mumbai City,8133,2,6,4,4,16,9,7,22
FC Pune City,8133,3,5,4,5,18,17,1,19
Kerala Blast,8133,4,5,4,5,12,16,-4,19
Kolkata,8133,5,4,6,4,15,18,-3,18
FC Goa,8133,6,5,3,6,12,15,-3,18
NorthEast Un,8133,7,4,3,7,11,13,-2,15
Chennaiyin,8133,8,3,6,5,15,20,-5,15
Mumbai City,8134,1,7,4,3,17,8,9,25
Delhi Dynamo,8134,2,5,5,4,24,16,8,20
Kerala Blast,8134,3,5,5,4,10,13,-3,20
NorthEast Un,8134,4,5,4,5,12,11,1,19
Kolkata,8134,5,3,8,3,14,14,0,17
FC Goa,8134,6,5,2,7,12,18,-6,17
FC Pune City,8134,7,4,4,6,12,15,-3,16
Chennaiyin,8134,8,3,6,5,15,21,-6,15
Delhi Dynamo,8135,1,6,6,2,27,15,12,24
Kolkata,8135,2,5,7,2,20,14,6,22
Mumbai City,8135,3,6,4,4,16,10,6,22
Kerala Blast,8135,4,5,4,5,12,17,-5,19
Chennaiyin,8135,5,4,6,4,16,19,-3,18
NorthEast Un,8135,6,4,4,6,11,14,-3,16
FC Pune City,8135,7,4,3,7,13,19,-6,15
FC Goa,8135,8,3,4,7,10,17,-7,13
Mumbai City,8136,1,7,4,3,19,10,9,25
Kerala Blast,8136,2,6,3,5,12,15,-3,21
NorthEast Un,8136,3,6,2,6,15,11,4,20
FC Pune City,8136,4,5,4,5,15,16,-1,19
FC Goa,8136,5,5,3,6,12,16,-4,18
Delhi Dynamo,8136,6,4,5,5,25,24,1,17
Kolkata,8136,7,3,7,4,15,16,-1,16
Chennaiyin,8136,8,3,6,5,13,18,-5,15
Mumbai City,8137,1,7,4,3,19,9,10,25
Delhi Dynamo,8137,2,5,6,3,24,18,6,21
Kerala Blast,8137,3,5,5,4,11,14,-3,20
Kolkata,8137,4,4,7,3,15,16,-1,19
NorthEast Un,8137,5,4,4,6,10,11,-1,16
FC Goa,8137,6,4,4,6,12,15,-3,16
Chennaiyin,8137,7,3,7,4,14,18,-4,16
FC Pune City,8137,8,4,3,7,12,16,-4,15
Delhi Dynamo,8138,1,6,5,3,24,16,8,23
NorthEast Un,8138,2,7,2,5,15,12,3,23
Mumbai City,8138,3,6,4,4,17,10,7,22
Kolkata,8138,4,4,8,2,15,12,3,20
Kerala Blast,8138,5,5,3,6,12,18,-6,18
FC Pune City,8138,6,4,4,6,12,15,-3,16
Chennaiyin,8138,7,3,6,5,15,20,-5,15
FC Goa,8138,8,3,4,7,9,16,-7,13
Mumbai City,8139,1,7,4,3,18,9,9,25
Kolkata,8139,2,6,6,2,21,13,8,24
Delhi Dynamo,8139,3,5,5,4,26,19,7,20
Kerala Blast,8139,4,5,3,6,11,17,-6,18
NorthEast Un,8139,5,5,2,7,14,16,-2,17
FC Goa,8139,6,5,2,7,13,17,-4,17
Chennaiyin,8139,7,4,5,5,16,22,-6,17
FC Pune City,8139,8,4,3,7,12,18,-6,15
Mumbai City,8140,1,6,5,3,16,8,8,23
Delhi Dynamo,8140,2,5,6,3,23,15,8,21
Kolkata,8140,3,5,6,3,17,15,2,21
NorthEast Un,8140,4,6,3,5,12,10,2,21
FC Pune City,8140,5,5,4,5,14,14,0,19
Kerala Blast,8140,6,4,5,5,10,15,-5,17
Chennaiyin,8140,7,3,6,5,14,19,-5,15
FC Goa,8140,8,3,3,8,10,20,-10,12
Delhi Dynamo,8141,1,6,5,3,24,17,7,23
Mumbai City,8141,2,6,4,4,16,9,7,22
Kolkata,8141,3,5,7,2,17,14,3,22
NorthEast Un,8141,4,6,2,6,15,12,3,20
Chennaiyin,8141,5,5,5,4,18,19,-1,20
FC Pune City,8141,6,4,4,6,13,16,-3,16
Kerala Blast,8141,7,4,4,6,9,16,-7,16
FC Goa,8141,8,3,3,8,10,19,-9,12
Mumbai City,8142,1,7,4,3,17,8,9,25
Kolkata,8142,2,5,6,3,17,15,2,21
Delhi Dynamo,8142,3,5,5,4,23,18,5,20
NorthEast Un,8142,4,6,2,6,15,11,4,20
Kerala Blast,8142,5,5,3,6,13,19,-6,18
Chennaiyin,8142,6,4,5,5,15,20,-5,17
FC Goa,8142,7,5,2,7,13,18,-5,17
FC Pune City,8142,8,4,3,7,13,17,-4,15
Mumbai City,8143,1,6,5,3,17,9,8,23
Delhi Dynamo,8143,2,5,7,2,27,16,11,22
FC Pune City,8143,3,5,4,5,15,16,-1,19
NorthEast Un,8143,4,5,3,6,12,12,0,18
Chennaiyin,8143,5,4,6,4,17,19,-2,18
Kerala Blast,8143,6,5,3,6,12,17,-5,18
Kolkata,8143,7,3,7,4,14,16,-2,16
FC Goa,8143,8,4,3,7,11,20,-9,15
Mumbai City,8144,1,6,5,3,17,9,8,23
Kerala Blast,8144,2,6,4,4,16,16,0,22
Kolkata,8144,3,4,8,2,19,16,3,20
Delhi Dynamo,8144,4,4,6,4,25,20,5,18
FC Goa,8144,5,5,3,6,13,16,-3,18
NorthEast Un,8144,6,5,2,7,12,13,-1,17
Chennaiyin,8144,7,4,5,5,14,19,-5,17
FC Pune City,8144,8,4,3,7,12,19,-7,15
Mumbai City,8145,1,6,5,3,17,9,8,23
NorthEast Un,8145,2,7,2,5,14,9,5,23
Delhi Dynamo,8145,3,5,6,3,23,18,5,21
Kerala Blast,8145,4,6,3,5,18,15,3,21
FC Goa,8145,5,5,2,7,11,16,-5,17
Kolkata,8145,6,3,7,4,15,16,-1,16
FC Pune City,8145,7,4,4,6,13,22,-9,16
Chennaiyin,8145,8,3,5,6,14,20,-6,14
Mumbai City,8146,1,7,4,3,19,9,10,25
Delhi Dynamo,8146,2,5,5,4,24,19,5,20
NorthEast Un,8146,3,6,2,6,13,12,1,20
Kolkata,8146,4,4,7,3,16,14,2,19
Kerala Blast,8146,5,5,3,6,11,17,-6,18
Chennaiyin,8146,6,4,5,5,16,20,-4,17
FC Goa,8146,7,5,2,7,13,17,-4,17
FC Pune City,8146,8,4,4,6,12,16,-4,16
Mumbai City,8147,1,6,5,3,18,10,8,23
Delhi Dynamo,8147,2,5,7,2,26,17,9,22
Kolkata,8147,3,5,7,2,20,16,4,22
Kerala Blast,8147,4,5,4,5,12,16,-4,19
Chennaiyin,8147,5,4,6,4,19,18,1,18
FC Pune City,8147,6,5,3,6,14,17,-3,18
NorthEast Un,8147,7,4,2,8,9,17,-8,14
FC Goa,8147,8,3,4,7,11,18,-7,13
Mumbai City,8148,1,7,4,3,19,10,9,25
Delhi Dynamo,8148,2,6,5,3,29,18,11,23
Kerala Blast,8148,3,6,3,5,12,17,-5,21
Kolkata,8148,4,4,7,3,18,15,3,19
FC Pune City,8148,5,5,3,6,14,16,-2,18
Chennaiyin,8148,6,4,5,5,18,22,-4,17
FC Goa,8148,7,4,3,7,15,20,-5,15
NorthEast Un,8148,8,4,2,8,10,17,-7,14
Mumbai City,8149,1,7,4,3,18,9,9,25
Kerala Blast,8149,2,7,3,4,16,15,1,24
Delhi Dynamo,8149,3,6,5,3,26,17,9,23
FC Pune City,8149,4,5,3,6,16,19,-3,18
Chennaiyin,8149,5,4,6,4,14,17,-3,18
Kolkata,8149,6,3,6,5,16,19,-3,15
FC Goa,8149,7,4,3,7,10,16,-6,15
NorthEast Un,8149,8,4,2,8,10,14,-4,14
Mumbai City,8150,1,7,4,3,18,9,9,25
Kerala Blast,8150,2,7,3,4,14,15,-1,24
Delhi Dynamo,8150,3,5,5,4,24,19,5,20
NorthEast Un,8150,4,6,2,6,15,12,3,20
Kolkata,8150,5,3,8,3,15,15,0,17
FC Pune City,8150,6,4,4,6,13,16,-3,16
Chennaiyin,8150,7,3,6,5,13,19,-6,15
FC Goa,8150,8,3,4,7,8,15,-7,13
Mumbai City,8151,1,7,4,3,18,8,10,25
Delhi Dynamo,8151,2,6,5,3,24,17,7,23
Kolkata,8151,3,4,8,2,17,15,2,20
NorthEast Un,8151,4,6,2,6,13,12,1,20
FC Pune City,8151,5,5,3,6,15,17,-2,18
Kerala Blast,8151,6,4,4,6,12,18,-6,16
FC Goa,8151,7,4,3,7,12,16,-4,15
Chennaiyin,8151,8,3,5,6,13,21,-8,14
Kerala Blast,8152,1,7,3,4,15,13,2,24
Delhi Dynamo,8152,2,6,5,3,24,17,7,23
Mumbai City,8152,3,6,4,4,17,10,7,22
Kolkata,8152,4,5,6,3,18,17,1,21
Chennaiyin,8152,5,3,7,4,15,19,-4,16
NorthEast Un,8152,6,4,3,7,9,11,-2,15
FC Pune City,8152,7,4,3,7,13,18,-5,15
FC Goa,8152,8,4,3,7,12,18,-6,15
Mumbai City,8153,1,7,4,3,18,8,10,25
Kolkata,8153,2,5,7,2,17,12,5,22
Kerala Blast,8153,3,6,4,4,14,14,0,22
Delhi Dynamo,8153,4,5,6,3,27,20,7,21
Chennaiyin,8153,5,5,5,4,17,19,-2,20
NorthEast Un,8153,6,4,3,7,13,16,-3,15
FC Pune City,8153,7,4,3,7,12,19,-7,15
FC Goa,8153,8,3,2,9,11,21,-10,11
Mumbai City,8154,1,7,4,3,18,8,10,25
Kolkata,8154,2,4,8,2,17,15,2,20
NorthEast Un,8154,3,6,2,6,13,13,0,20
FC Pune City,8154,4,5,3,6,14,16,-2,18
FC Goa,8154,5,5,3,6,15,18,-3,18
Delhi Dynamo,8154,6,4,5,5,25,22,3,17
Chennaiyin,8154,7,4,5,5,16,20,-4,17
Kerala Blast,8154,8,4,4,6,12,18,-6,16
Mumbai City,8155,1,7,4,3,21,9,12,25
Delhi Dynamo,8155,2,5,6,3,25,21,4,21
Kerala Blast,8155,3,6,3,5,12,15,-3,21
Kolkata,8155,4,4,7,3,18,16,2,19
Chennaiyin,8155,5,4,6,4,15,18,-3,18
FC Pune City,8155,6,4,4,6,15,19,-4,16
NorthEast Un,8155,7,4,3,7,9,11,-2,15
FC Goa,8155,8,4,3,7,12,18,-6,15
Mumbai City,8156,1,7,4,3,17,8,9,25
Delhi Dynamo,8156,2,5,6,3,23,16,7,21
Kolkata,8156,3,4,8,2,15,12,3,20
NorthEast Un,8156,3,6,2,6,15,12,3,20
FC Pune City,8156,5,5,3,6,15,16,-1,18
FC Goa,8156,6,4,4,6,11,15,-4,16
Kerala Blast,8156,7,4,4,6,9,19,-10,16
Chennaiyin,8156,8,3,5,6,15,22,-7,14
Kerala Blast,8157,1,7,3,4,16,14,2,24
Mumbai City,8157,2,6,4,4,17,10,7,22
Delhi Dynamo,8157,3,5,5,4,24,18,6,20
Chennaiyin,8157,4,5,5,4,17,17,0,20
NorthEast Un,8157,5,5,2,7,10,13,-3,17
FC Goa,8157,6,5,2,7,12,17,-5,17
Kolkata,8157,7,3,7,4,15,17,-2,16
FC Pune City,8157,8,4,4,6,13,18,-5,16
Mumbai City,8158,1,7,4,3,18,8,10,25
NorthEast Un,8158,2,6,3,5,13,10,3,21
Kolkata,8158,3,4,7,3,18,15,3,19
FC Goa,8158,4,5,3,6,14,17,-3,18
Kerala Blast,8158,5,5,3,6,11,20,-9,18
Delhi Dynamo,8158,6,4,5,5,23,20,3,17
FC Pune City,8158,7,4,4,6,12,15,-3,16
Chennaiyin,8158,8,3,7,4,13,17,-4,16
Mumbai City,8159,1,6,5,3,16,8,8,23
Delhi Dynamo,8159,2,5,7,2,24,15,9,22
FC Pune City,8159,3,6,3,5,16,14,2,21
Kolkata,8159,4,4,6,4,15,17,-2,18
Kerala Blast,8159,5,5,3,6,13,16,-3,18
FC Goa,8159,6,5,3,6,11,15,-4,18
Chennaiyin,8159,7,4,5,5,15,19,-4,17
NorthEast Un,8159,8,4,2,8,10,16,-6,14
Mumbai City,8160,1,7,4,3,19,9,10,25
Delhi Dynamo,8160,2,6,5,3,28,18,10,23
FC Pune City,8160,3,5,4,5,14,14,0,19
NorthEast Un,8160,4,5,3,6,12,14,-2,18
FC Goa,8160,5,5,2,7,14,18,-4,17
Kerala Blast,8160,6,4,5,5,11,16,-5,17
Kolkata,8160,7,3,7,4,14,18,-4,16
Chennaiyin,8160,8,3,6,5,15,20,-5,15
Delhi Dynamo,8161,1,6,5,3,25,17,8,23
Mumbai City,8161,2,6,4,4,16,10,6,22
NorthEast Un,8161,3,6,3,5,15,10,5,21
FC Pune City,8161,4,5,4,5,14,15,-1,19
Kerala Blast,8161,5,5,4,5,12,16,-4,19
Chennaiyin,8161,6,3,7,4,14,18,-4,16
Kolkata,8161,7,3,6,5,14,17,-3,15
FC Goa,8161,8,4,3,7,10,17,-7,15
Delhi Dynamo,8162,1,6,5,3,30,18,12,23
Mumbai City,8162,2,6,4,4,16,11,5,22
Kolkata,8162,3,5,7,2,16,13,3,22
Kerala Blast,8162,4,6,3,5,18,15,3,21
NorthEast Un,8162,5,6,2,6,12,12,0,20
Chennaiyin,8162,6,4,5,5,16,19,-3,17
FC Pune City,8162,7,4,3,7,12,21,-9,15
FC Goa,8162,8,3,3,8,11,22,-11,12
Mumbai City,8163,1,7,4,3,17,8,9,25
Delhi Dynamo,8163,2,5,6,3,28,21,7,21
Kerala Blast,8163,3,5,5,4,14,17,-3,20
FC Pune City,8163,4,5,4,5,19,15,4,19
NorthEast Un,8163,5,5,3,6,15,15,0,18
Chennaiyin,8163,6,4,5,5,14,18,-4,17
Kolkata,8163,7,3,8,3,16,21,-5,17
FC Goa,8163,8,3,3,8,11,19,-8,12
Mumbai City,8164,1,7,4,3,19,10,9,25
Delhi Dynamo,8164,2,6,5,3,25,17,8,23
Kolkata,8164,3,5,7,2,18,14,4,22
Kerala Blast,8164,4,5,4,5,12,16,-4,19
NorthEast Un,8164,5,5,2,7,11,13,-2,17
Chennaiyin,8164,6,4,5,5,16,20,-4,17
FC Pune City,8164,7,4,4,6,12,15,-3,16
FC Goa,8164,8,3,3,8,10,18,-8,12
Mumbai City,8165,1,7,4,3,20,11,9,25
Kolkata,8165,2,6,6,2,18,13,5,24
NorthEast Un,8165,3,6,3,5,11,9,2,21
Delhi Dynamo,8165,4,5,5,4,26,20,6,20
Kerala Blast,8165,5,5,4,5,11,14,-3,19
Chennaiyin,8165,6,4,5,5,16,19,-3,17
FC Pune City,8165,7,4,3,7,12,18,-6,15
FC Goa,8165,8,3,2,9,11,21,-10,11
Mumbai City,8166,1,6,5,3,17,9,8,23
Kerala Blast,8166,2,6,3,5,15,18,-3,21
FC Goa,8166,3,6,2,6,20,15,5,20
Delhi Dynamo,8166,4,4,7,3,23,19,4,19
NorthEast Un,8166,5,5,3,6,13,13,0,18
FC Pune City,8166,6,5,3,6,13,15,-2,18
Chennaiyin,8166,7,4,5,5,14,20,-6,17
Kolkata,8166,8,3,6,5,16,22,-6,15
Delhi Dynamo,8167,1,6,6,2,25,15,10,24
Mumbai City,8167,2,6,5,3,17,9,8,23
Kolkata,8167,3,5,7,2,19,12,7,22
Kerala Blast,8167,4,5,4,5,13,16,-3,19
Chennaiyin,8167,5,4,5,5,15,21,-6,17
FC Pune City,8167,6,4,4,6,13,19,-6,16
FC Goa,8167,7,4,3,7,12,17,-5,15
NorthEast Un,8167,8,4,2,8,9,14,-5,14
Mumbai City,8168,1,6,4,4,16,10,6,22
Delhi Dynamo,8168,2,5,6,3,26,18,8,21
Kolkata,8168,3,5,6,3,18,15,3,21
NorthEast Un,8168,4,6,2,6,17,15,2,20
Chennaiyin,8168,5,5,5,4,19,20,-1,20
Kerala Blast,8168,6,5,3,6,12,18,-6,18
FC Goa,8168,7,4,3,7,13,19,-6,15
FC Pune City,8168,7,4,3,7,13,19,-6,15
Mumbai City,8169,1,7,4,3,18,9,9,25
Delhi Dynamo,8169,2,5,6,3,24,17,7,21
FC Pune City,8169,3,5,4,5,16,16,0,19
Kerala Blast,8169,4,5,4,5,14,18,-4,19
Kolkata,8169,5,4,6,4,15,16,-1,18
NorthEast Un,8169,6,5,2,7,12,14,-2,17
Chennaiyin,8169,7,4,5,5,17,21,-4,17
FC Goa,8169,8,4,3,7,12,17,-5,15
Mumbai City,8170,1,7,4,3,19,9,10,25
Delhi Dynamo,8170,2,5,6,3,25,17,8,21
FC Pune City,8170,3,5,4,5,14,15,-1,19
Kerala Blast,8170,4,5,4,5,10,16,-6,19
Kolkata,8170,5,4,6,4,16,15,1,18
NorthEast Un,8170,6,5,3,6,13,14,-1,18
Chennaiyin,8170,7,4,5,5,18,20,-2,17
FC Goa,8170,8,4,2,8,10,19,-9,14
Mumbai City,8171,1,6,4,4,16,9,7,22
Delhi Dynamo,8171,2,5,5,4,23,18,5,20
Kolkata,8171,3,4,8,2,18,15,3,20
NorthEast Un,8171,4,6,2,6,11,11,0,20
Chennaiyin,8171,5,5,5,4,16,17,-1,20
FC Pune City,8171,6,5,4,5,15,16,-1,19
Kerala Blast,8171,7,4,4,6,12,18,-6,16
FC Goa,8171,8,4,2,8,11,18,-7,14
Mumbai City,8172,1,6,5,3,16,8,8,23
Delhi Dynamo,8172,2,5,6,3,24,17,7,21
NorthEast Un,8172,3,6,3,5,13,10,3,21
FC Pune City,8172,4,5,4,5,14,14,0,19
Kolkata,8172,5,4,6,4,15,15,0,18
FC Goa,8172,6,5,2,7,11,16,-5,17
Kerala Blast,8172,7,4,5,5,9,15,-6,17
Chennaiyin,8172,8,3,5,6,13,20,-7,14
Delhi Dynamo,8173,1,7,5,2,29,16,13,26
Mumbai City,8173,2,6,4,4,17,11,6,22
Kerala Blast,8173,3,5,5,4,12,15,-3,20
Kolkata,8173,4,4,7,3,16,14,2,19
NorthEast Un,8173,5,5,3,6,13,14,-1,18
Chennaiyin,8173,6,4,5,5,14,19,-5,17
FC Pune City,8173,7,4,3,7,14,19,-5,15
FC Goa,8173,8,4,2,8,9,16,-7,14
Kolkata,8174,1,6,6,2,19,13,6,24
Mumbai City,8174,2,6,4,4,16,12,4,22
Delhi Dynamo,8174,3,5,6,3,26,17,9,21
Chennaiyin,8174,4,5,5,4,20,21,-1,20
Kerala Blast,8174,5,4,5,5,13,19,-6,17
NorthEast Un,8174,6,4,4,6,12,14,-2,16
FC Pune City,8174,7,4,4,6,14,18,-4,16
FC Goa,8174,8,4,2,8,13,19,-6,14
Delhi Dynamo,8175,1,7,5,2,31,15,16,26
Mumbai City,8175,2,6,4,4,16,11,5,22
Kolkata,8175,3,4,7,3,15,14,1,19
Kerala Blast,8175,4,5,4,5,11,16,-5,19
NorthEast Un,8175,5,5,2,7,12,12,0,17
Chennaiyin,8175,6,4,5,5,14,18,-4,17
FC Goa,8175,7,5,2,7,11,20,-9,17
FC Pune City,8175,8,4,3,7,13,17,-4,15
Delhi Dynamo,8176,1,6,6,2,29,17,12,24
Mumbai City,8176,2,6,4,4,17,11,6,22
NorthEast Un,8176,3,5,4,5,14,12,2,19
Kolkata,8176,4,4,7,3,14,15,-1,19
Kerala Blast,8176,5,4,6,4,11,15,-4,18
FC Goa,8176,6,5,2,7,13,17,-4,17
FC Pune City,8176,7,4,4,6,13,16,-3,16
Chennaiyin,8176,8,3,5,6,13,21,-8,14
Mumbai City,8177,1,7,4,3,20,10,10,25
Delhi Dynamo,8177,2,5,5,4,25,19,6,20
Kerala Blast,8177,3,5,5,4,13,16,-3,20
NorthEast Un,8177,4,5,4,5,11,10,1,19
FC Pune City,8177,5,5,4,5,16,17,-1,19
Chennaiyin,8177,6,3,7,4,14,18,-4,16
Kolkata,8177,7,3,6,5,14,16,-2,15
FC Goa,8177,8,4,3,7,10,17,-7,15
Mumbai City,8178,1,6,5,3,16,8,8,23
Delhi Dynamo,8178,2,5,7,2,23,15,8,22
NorthEast Un,8178,3,6,3,5,15,13,2,21
Kolkata,8178,4,4,8,2,15,13,2,20
Kerala Blast,8178,5,4,5,5,13,18,-5,17
FC Pune City,8178,6,4,4,6,13,16,-3,16
FC Goa,8178,7,4,3,7,11,15,-4,15
Chennaiyin,8178,8,3,5,6,14,22,-8,14
Delhi Dynamo,8179,1,6,5,3,24,16,8,23
NorthEast Un,8179,2,7,2,5,16,12,4,23
Mumbai City,8179,3,6,4,4,16,9,7,22
Kolkata,8179,4,4,7,3,17,17,0,19
FC Pune City,8179,5,5,4,5,15,16,-1,19
FC Goa,8179,6,4,3,7,11,16,-5,15
Chennaiyin,8179,7,3,6,5,15,21,-6,15
Kerala Blast,8179,8,4,3,7,11,18,-7,15
Delhi Dynamo,8180,1,6,6,2,29,17,12,24
Mumbai City,8180,2,6,5,3,18,10,8,23
Kolkata,8180,3,5,6,3,19,16,3,21
FC Pune City,8180,4,5,4,5,14,15,-1,19
NorthEast Un,8180,5,5,3,6,12,11,1,18
Kerala Blast,8180,6,4,5,5,11,17,-6,17
Chennaiyin,8180,7,3,6,5,13,20,-7,15
FC Goa,8180,8,3,3,8,11,21,-10,12
Delhi Dynamo,8181,1,6,5,3,24,17,7,23
Mumbai City,8181,2,6,4,4,16,9,7,22
Kerala Blast,8181,3,6,3,5,14,14,0,21
NorthEast Un,8181,4,6,2,6,12,11,1,20
Kolkata,8181,5,3,8,3,14,14,0,17
Chennaiyin,8181,6,4,5,5,15,20,-5,17
FC Pune City,8181,7,4,4,6,13,19,-6,16
FC Goa,8181,8,4,3,7,12,16,-4,15
NorthEast Un,8182,1,7,2,5,18,13,5,23
Mumbai City,8182,2,6,4,4,16,10,6,22
Delhi Dynamo,8182,3,5,5,4,25,20,5,20
Kerala Blast,8182,4,5,4,5,13,16,-3,19
FC Pune City,8182,5,5,3,6,15,16,-1,18
Kolkata,8182,6,3,8,3,14,16,-2,17
FC Goa,8182,7,4,4,6,11,16,-5,16
Chennaiyin,8182,8,3,6,5,16,21,-5,15
Delhi Dynamo,8183,1,6,6,2,25,16,9,24
Mumbai City,8183,2,6,4,4,16,9,7,22
Kolkata,8183,3,4,8,2,16,14,2,20
Chennaiyin,8183,4,5,5,4,17,17,0,20
Kerala Blast,8183,5,5,4,5,11,18,-7,19
FC Pune City,8183,6,5,3,6,17,16,1,18
NorthEast Un,8183,7,4,3,7,11,15,-4,15
FC Goa,8183,8,3,3,8,10,18,-8,12
Mumbai City,8184,1,6,5,3,18,10,8,23
Delhi Dynamo,8184,2,5,6,3,28,19,9,21
Kolkata,8184,3,4,8,2,18,16,2,20
FC Pune City,8184,4,5,4,5,16,16,0,19
Chennaiyin,8184,5,4,6,4,16,19,-3,18
Kerala Blast,8184,6,5,3,6,13,18,-5,18
NorthEast Un,8184,7,5,2,7,13,14,-1,17
FC Goa,8184,8,3,4,7,11,21,-10,13
Mumbai City,8185,1,7,4,3,20,10,10,25
Kolkata,8185,2,5,6,3,17,15,2,21
Kerala Blast,8185,3,6,3,5,11,14,-3,21
Delhi Dynamo,8185,4,5,5,4,26,21,5,20
NorthEast Un,8185,5,5,3,6,12,11,1,18
FC Goa,8185,6,5,2,7,13,18,-5,17
Chennaiyin,8185,7,3,6,5,14,19,-5,15
FC Pune City,8185,8,4,3,7,12,17,-5,15
Mumbai City,8186,1,6,5,3,17,9,8,23
FC Pune City,8186,2,6,3,5,17,16,1,21
NorthEast Un,8186,3,6,2,6,13,12,1,20
Delhi Dynamo,8186,4,4,6,4,25,21,4,18
Chennaiyin,8186,5,4,6,4,15,18,-3,18
Kerala Blast,8186,6,5,3,6,14,17,-3,18
Kolkata,8186,7,3,7,4,15,19,-4,16
FC Goa,8186,8,4,4,6,14,18,-4,16
Delhi Dynamo,8187,1,7,5,2,27,15,12,26
Mumbai City,8187,2,6,4,4,17,12,5,22
Kerala Blast,8187,3,6,4,4,13,14,-1,22
FC Pune City,8187,4,5,3,6,14,16,-2,18
NorthEast Un,8187,5,4,4,6,10,11,-1,16
Kolkata,8187,6,3,7,4,14,16,-2,16
Chennaiyin,8187,7,3,6,5,14,19,-5,15
FC Goa,8187,8,4,3,7,11,17,-6,15
Delhi Dynamo,8188,1,6,6,2,24,14,10,24
Mumbai City,8188,2,6,4,4,16,10,6,22
Kolkata,8188,3,5,6,3,22,18,4,21
NorthEast Un,8188,4,5,4,5,13,11,2,19
FC Pune City,8188,5,5,4,5,15,16,-1,19
Kerala Blast,8188,6,4,5,5,15,20,-5,17
Chennaiyin,8188,7,3,6,5,14,20,-6,15
FC Goa,8188,8,3,3,8,10,20,-10,12
Kolkata,8189,1,6,6,2,19,12,7,24
Mumbai City,8189,2,6,4,4,17,10,7,22
Delhi Dynamo,8189,3,5,5,4,25,20,5,20
Kerala Blast,8189,4,5,4,5,16,20,-4,19
NorthEast Un,8189,5,5,3,6,11,12,-1,18
Chennaiyin,8189,6,4,6,4,15,17,-2,18
FC Pune City,8189,7,4,4,6,16,20,-4,16
FC Goa,8189,8,4,2,8,11,19,-8,14
Mumbai City,8190,1,7,4,3,17,8,9,25
Kerala Blast,8190,2,6,4,4,11,13,-2,22
Kolkata,8190,3,4,7,3,15,13,2,19
Delhi Dynamo,8190,4,4,6,4,24,19,5,18
NorthEast Un,8190,5,5,3,6,12,12,0,18
Chennaiyin,8190,6,4,5,5,14,20,-6,17
FC Goa,8190,7,4,4,6,12,15,-3,16
FC Pune City,8190,8,4,3,7,12,17,-5,15
Mumbai City,8191,1,7,4,3,19,10,9,25
Kolkata,8191,2,6,6,2,19,14,5,24
NorthEast Un,8191,3,5,4,5,14,12,2,19
Delhi Dynamo,8191,4,4,5,5,24,21,3,17
FC Goa,8191,5,5,2,7,11,16,-5,17
Kerala Blast,8191,5,4,5,5,11,16,-5,17
FC Pune City,8191,7,4,4,6,13,16,-3,16
Chennaiyin,8191,8,3,6,5,14,20,-6,15
Delhi Dynamo,8192,1,7,5,2,25,14,11,26
Mumbai City,8192,2,6,4,4,16,10,6,22
Kerala Blast,8192,3,6,4,4,14,14,0,22
Kolkata,8192,4,5,6,3,16,13,3,21
Chennaiyin,8192,5,4,6,4,15,17,-2,18
FC Pune City,8192,6,4,4,6,12,16,-4,16
NorthEast Un,8192,7,4,3,7,10,14,-4,15
FC Goa,8192,8,3,2,9,8,18,-10,11
Mumbai City,8193,1,7,4,3,20,8,12,25
Delhi Dynamo,8193,2,6,5,3,24,18,6,23
Kolkata,8193,3,4,8,2,19,17,2,20
NorthEast Un,8193,4,6,2,6,11,10,1,20
Kerala Blast,8193,5,5,3,6,13,18,-5,18
FC Pune City,8193,6,4,4,6,14,17,-3,16
FC Goa,8193,7,4,3,7,12,18,-6,15
Chennaiyin,8193,8,3,5,6,13,20,-7,14
Mumbai City,8194,1,7,4,3,19,8,11,25
Kolkata,8194,2,5,7,2,17,14,3,22
Delhi Dynamo,8194,3,5,6,3,23,18,5,21
Kerala Blast,8194,4,5,3,6,10,15,-5,18
NorthEast Un,8194,5,5,2,7,11,13,-2,17
Chennaiyin,8194,6,4,5,5,16,19,-3,17
FC Pune City,8194,7,4,4,6,13,16,-3,16
FC Goa,8194,8,4,3,7,11,17,-6,15
Mumbai City,8195,1,6,5,3,17,9,8,23
Delhi Dynamo,8195,2,5,6,3,24,17,7,21
Chennaiyin,8195,3,5,5,4,19,18,1,20
Kolkata,8195,4,4,7,3,16,15,1,19
Kerala Blast,8195,5,5,4,5,13,16,-3,19
NorthEast Un,8195,6,5,3,6,13,15,-2,18
FC Pune City,8195,7,4,4,6,12,16,-4,16
FC Goa,8195,8,4,2,8,12,20,-8,14
Delhi Dynamo,8196,1,6,6,2,28,15,13,24
Mumbai City,8196,2,6,5,3,16,8,8,23
Kolkata,8196,3,5,7,2,19,15,4,22
NorthEast Un,8196,4,6,2,6,13,13,0,20
FC Pune City,8196,5,4,4,6,13,17,-4,16
Kerala Blast,8196,6,4,4,6,11,17,-6,16
Chennaiyin,8196,7,3,6,5,15,20,-5,15
FC Goa,8196,8,3,4,7,11,21,-10,13
Mumbai City,8197,1,6,5,3,18,10,8,23
Delhi Dynamo,8197,2,5,6,3,25,18,7,21
Kolkata,8197,3,4,8,2,18,16,2,20
Chennaiyin,8197,4,5,5,4,17,17,0,20
FC Pune City,8197,5,4,5,5,15,17,-2,17
Kerala Blast,8197,6,4,5,5,13,18,-5,17
NorthEast Un,8197,7,4,3,7,9,12,-3,15
FC Goa,8197,8,4,3,7,11,18,-7,15
Delhi Dynamo,8198,1,6,5,3,26,17,9,23
Mumbai City,8198,2,6,4,4,16,10,6,22
NorthEast Un,8198,3,6,3,5,14,12,2,21
Kolkata,8198,4,3,9,2,16,15,1,18
Kerala Blast,8198,5,4,6,4,11,15,-4,18
FC Pune City,8198,6,4,5,5,14,16,-2,17
Chennaiyin,8198,7,3,6,5,14,19,-5,15
FC Goa,8198,8,3,4,7,9,16,-7,13
Kerala Blast,8199,1,7,3,4,19,16,3,24
Mumbai City,8199,2,6,5,3,18,10,8,23
Delhi Dynamo,8199,3,5,6,3,24,19,5,21
Kolkata,8199,4,3,8,3,15,15,0,17
NorthEast Un,8199,5,5,2,7,13,15,-2,17
Chennaiyin,8199,6,4,5,5,15,19,-4,17
FC Pune City,8199,7,4,4,6,15,19,-4,16
FC Goa,8199,8,4,3,7,11,17,-6,15
Mumbai City,8200,1,6,5,3,17,9,8,23
Kerala Blast,8200,2,6,4,4,13,14,-1,22
Delhi Dynamo,8200,3,5,6,3,27,19,8,21
Chennaiyin,8200,4,4,6,4,16,19,-3,18
Kolkata,8200,5,3,8,3,15,15,0,17
NorthEast Un,8200,6,5,2,7,12,14,-2,17
FC Pune City,8200,7,4,4,6,12,15,-3,16
FC Goa,8200,8,4,3,7,13,20,-7,15
Delhi Dynamo,8201,1,6,6,2,25,16,9,24
Mumbai City,8201,2,6,4,4,16,9,7,22
Kerala Blast,8201,3,6,4,4,21,20,1,22
Chennaiyin,8201,4,4,6,4,17,19,-2,18
Kolkata,8201,5,3,8,3,15,16,-1,17
FC Pune City,8201,6,4,5,5,18,20,-2,17
NorthEast Un,8201,7,4,4,6,12,15,-3,16
FC Goa,8201,8,3,3,8,10,19,-9,12
Mumbai City,8202,1,7,4,3,20,10,10,25
Kerala Blast,8202,2,7,3,4,17,15,2,24
Delhi Dynamo,8202,3,6,5,3,28,21,7,23
FC Pune City,8202,4,5,3,6,14,18,-4,18
NorthEast Un,8202,5,5,2,7,16,16,0,17
Chennaiyin,8202,6,4,5,5,16,22,-6,17
Kolkata,8202,7,3,7,4,16,17,-1,16
FC Goa,8202,8,3,3,8,11,19,-8,12
Mumbai City,8203,1,6,5,3,17,9,8,23
Delhi Dynamo,8203,2,5,7,2,25,16,9,22
Kolkata,8203,3,5,7,2,23,18,5,22
NorthEast Un,8203,4,5,3,6,11,11,0,18
Kerala Blast,8203,5,5,3,6,13,18,-5,18
Chennaiyin,8203,6,4,5,5,14,18,-4,17
FC Pune City,8203,7,4,3,7,14,20,-6,15
FC Goa,8203,8,4,3,7,12,19,-7,15
Mumbai City,8204,1,7,4,3,19,8,11,25
Kolkata,8204,2,5,6,3,16,16,0,21
Delhi Dynamo,8204,3,5,5,4,23,19,4,20
Kerala Blast,8204,4,5,4,5,11,14,-3,19
NorthEast Un,8204,5,5,2,7,11,12,-1,17
Chennaiyin,8204,6,4,5,5,15,19,-4,17
FC Goa,8204,7,5,2,7,13,17,-4,17
FC Pune City,8204,8,4,4,6,13,16,-3,16
Mumbai City,8205,1,6,4,4,17,10,7,22
Kolkata,8205,2,5,6,3,17,15,2,21
Delhi Dynamo,8205,3,5,5,4,23,18,5,20
Chennaiyin,8205,4,5,5,4,17,18,-1,20
FC Pune City,8205,5,5,3,6,14,16,-2,18
Kerala Blast,8205,6,5,3,6,14,18,-4,18
NorthEast Un,8205,7,5,2,7,12,14,-2,17
FC Goa,8205,8,5,2,7,12,17,-5,17
Delhi Dynamo,8206,1,7,5,2,26,15,11,26
Mumbai City,8206,2,6,4,4,16,9,7,22
Kolkata,8206,3,5,7,2,16,13,3,22
NorthEast Un,8206,4,5,3,6,11,10,1,18
FC Pune City,8206,5,5,3,6,13,15,-2,18
Kerala Blast,8206,6,4,4,6,10,17,-7,16
Chennaiyin,8206,7,3,6,5,14,19,-5,15
FC Goa,8206,8,4,2,8,11,19,-8,14
Mumbai City,8207,1,7,4,3,18,9,9,25
Delhi Dynamo,8207,2,6,5,3,28,18,10,23
Kolkata,8207,3,5,6,3,18,15,3,21
Kerala Blast,8207,4,6,3,5,12,15,-3,21
Chennaiyin,8207,5,5,5,4,16,17,-1,20
NorthEast Un,8207,6,5,2,7,11,13,-2,17
FC Pune City,8207,7,4,3,7,12,16,-4,15
FC Goa,8207,8,3,2,9,10,22,-12,11
Mumbai City,8208,1,7,4,3,18,8,10,25
Kolkata,8208,2,5,6,3,18,15,3,21
Kerala Blast,8208,3,5,4,5,11,15,-4,19
Chennaiyin,8208,4,4,6,4,17,18,-1,18
FC Goa,8208,5,5,3,6,13,15,-2,18
NorthEast Un,8208,6,5,3,6,10,12,-2,18
Delhi Dynamo,8208,7,4,5,5,21,20,1,17
FC Pune City,8208,8,4,3,7,13,18,-5,15
Delhi Dynamo,8209,1,6,5,3,26,18,8,23
Mumbai City,8209,2,6,4,4,16,9,7,22
Kerala Blast,8209,3,6,4,4,15,16,-1,22
FC Pune City,8209,4,5,3,6,15,17,-2,18
Kolkata,8209,5,3,8,3,17,17,0,17
NorthEast Un,8209,6,5,2,7,11,13,-2,17
Chennaiyin,8209,7,4,5,5,15,18,-3,17
FC Goa,8209,8,4,3,7,12,19,-7,15
Mumbai City,8210,1,7,4,3,18,9,9,25
Kolkata,8210,2,5,6,3,18,16,2,21
Delhi Dynamo,8210,3,4,7,3,23,17,6,19
FC Pune City,8210,4,5,3,6,15,18,-3,18
FC Goa,8210,5,5,3,6,13,16,-3,18
Kerala Blast,8210,6,5,3,6,13,18,-5,18
NorthEast Un,8210,7,4,4,6,11,12,-1,16
Chennaiyin,8210,8,3,6,5,15,20,-5,15
Mumbai City,8211,1,7,4,3,18,9,9,25
Kolkata,8211,2,5,7,2,17,12,5,22
Delhi Dynamo,8211,3,5,5,4,25,20,5,20
Kerala Blast,8211,4,5,4,5,12,15,-3,19
NorthEast Un,8211,5,5,2,7,14,15,-1,17
Chennaiyin,8211,6,4,5,5,16,21,-5,17
FC Pune City,8211,7,4,4,6,13,18,-5,16
FC Goa,8211,8,4,3,7,11,16,-5,15
Delhi Dynamo,8212,1,7,5,2,32,17,15,26
Mumbai City,8212,2,6,4,4,18,13,5,22
FC Pune City,8212,3,5,4,5,14,15,-1,19
Kolkata,8212,4,4,6,4,16,18,-2,18
Chennaiyin,8212,5,4,6,4,17,20,-3,18
NorthEast Un,8212,6,5,2,7,15,16,-1,17
Kerala Blast,8212,7,4,4,6,12,20,-8,16
FC Goa,8212,8,4,3,7,14,19,-5,15
Mumbai City,8213,1,7,4,3,19,10,9,25
Kolkata,8213,2,5,6,3,19,14,5,21
NorthEast Un,8213,3,6,3,5,14,11,3,21
Delhi Dynamo,8213,4,4,7,3,26,20,6,19
FC Pune City,8213,5,5,3,6,14,17,-3,18
Kerala Blast,8213,6,5,3,6,11,16,-5,18
Chennaiyin,8213,7,3,6,5,13,19,-6,15
FC Goa,8213,8,3,4,7,10,19,-9,13
Delhi Dynamo,8214,1,6,6,2,27,17,10,24
Mumbai City,8214,2,6,5,3,18,10,8,23
Kolkata,8214,3,5,7,2,19,13,6,22
NorthEast Un,8214,4,6,2,6,15,13,2,20
FC Pune City,8214,5,5,3,6,13,15,-2,18
Chennaiyin,8214,6,4,5,5,16,20,-4,17
Kerala Blast,8214,7,4,3,7,10,20,-10,15
FC Goa,8214,8,3,3,8,9,19,-10,12
Delhi Dynamo,8215,1,6,5,3,26,17,9,23
Mumbai City,8215,2,6,4,4,16,9,7,22
Kerala Blast,8215,3,6,4,4,12,13,-1,22
NorthEast Un,8215,4,5,3,6,10,10,0,18
FC Pune City,8215,5,5,3,6,14,17,-3,18
Kolkata,8215,6,3,8,3,15,15,0,17
Chennaiyin,8215,7,3,6,5,13,18,-5,15
FC Goa,8215,8,4,3,7,12,19,-7,15
Mumbai City,8216,1,7,4,3,17,8,9,25
Delhi Dynamo,8216,2,5,6,3,23,16,7,21
Kolkata,8216,3,5,6,3,16,13,3,21
Kerala Blast,8216,4,5,4,5,14,14,0,19
NorthEast Un,8216,5,4,5,5,11,11,0,17
Chennaiyin,8216,6,3,7,4,17,21,-4,16
FC Goa,8216,7,4,3,7,12,18,-6,15
FC Pune City,8216,8,4,3,7,12,21,-9,15
Delhi Dynamo,8217,1,7,5,2,27,15,12,26
Mumbai City,8217,2,6,4,4,16,9,7,22
NorthEast Un,8217,3,6,2,6,14,12,2,20
Kolkata,8217,4,4,7,3,18,16,2,19
FC Pune City,8217,5,5,4,5,17,15,2,19
Chennaiyin,8217,6,3,6,5,14,20,-6,15
FC Goa,8217,7,4,3,7,12,18,-6,15
Kerala Blast,8217,8,4,3,7,10,23,-13,15
Mumbai City,8218,1,6,5,3,17,9,8,23
Kolkata,8218,2,5,7,2,18,13,5,22
Kerala Blast,8218,3,6,4,4,14,15,-1,22
Delhi Dynamo,8218,4,4,8,2,22,15,7,20
Chennaiyin,8218,5,5,5,4,20,18,2,20
NorthEast Un,8218,6,4,3,7,11,15,-4,15
FC Pune City,8218,7,4,3,7,12,17,-5,15
FC Goa,8218,8,3,3,8,8,20,-12,12
Delhi Dynamo,8219,1,7,5,2,27,16,11,26
Mumbai City,8219,2,6,4,4,18,11,7,22
Kolkata,8219,3,4,8,2,18,15,3,20
FC Pune City,8219,4,5,4,5,16,17,-1,19
Chennaiyin,8219,5,4,6,4,17,20,-3,18
NorthEast Un,8219,6,5,2,7,13,14,-1,17
Kerala Blast,8219,7,4,3,7,11,20,-9,15
FC Goa,8219,8,3,4,7,11,18,-7,13
Delhi Dynamo,8220,1,6,5,3,26,18,8,23
Mumbai City,8220,2,6,4,4,17,10,7,22
Kolkata,8220,3,4,8,2,17,14,3,20
Kerala Blast,8220,4,5,5,4,16,16,0,20
FC Goa,8220,5,5,3,6,12,16,-4,18
FC Pune City,8220,6,4,4,6,12,16,-4,16
Chennaiyin,8220,7,3,6,5,14,19,-5,15
NorthEast Un,8220,8,4,3,7,13,18,-5,15
Mumbai City,8221,1,7,4,3,17,8,9,25
Delhi Dynamo,8221,2,5,6,3,25,17,8,21
Kerala Blast,8221,3,5,5,4,13,16,-3,20
Kolkata,8221,4,3,9,2,15,14,1,18
FC Pune City,8221,5,4,5,5,13,15,-2,17
Chennaiyin,8221,6,4,5,5,16,19,-3,17
FC Goa,8221,7,4,4,6,10,15,-5,16
NorthEast Un,8221,8,4,2,8,13,18,-5,14
Mumbai City,8222,1,7,4,3,18,8,10,25
Delhi Dynamo,8222,2,6,5,3,25,18,7,23
Kolkata,8222,3,5,6,3,21,15,6,21
NorthEast Un,8222,4,5,3,6,11,11,0,18
Kerala Blast,8222,5,5,3,6,11,20,-9,18
FC Goa,8222,6,5,2,7,13,18,-5,17
FC Pune City,8222,7,4,3,7,14,18,-4,15
Chennaiyin,8222,8,3,6,5,14,19,-5,15
Mumbai City,8223,1,7,4,3,19,10,9,25
Kerala Blast,8223,2,6,4,4,12,13,-1,22
Kolkata,8223,3,5,6,3,17,14,3,21
Delhi Dynamo,8223,4,5,5,4,27,20,7,20
NorthEast Un,8223,5,5,2,7,11,12,-1,17
Chennaiyin,8223,6,4,5,5,15,20,-5,17
FC Pune City,8223,7,4,4,6,13,16,-3,16
FC Goa,8223,8,4,2,8,12,21,-9,14
Delhi Dynamo,8224,1,6,6,2,28,15,13,24
Mumbai City,8224,2,6,5,3,17,9,8,23
Kolkata,8224,3,5,6,3,20,15,5,21
FC Pune City,8224,4,5,4,5,16,17,-1,19
Kerala Blast,8224,5,5,4,5,11,18,-7,19
NorthEast Un,8224,6,5,2,7,11,13,-2,17
Chennaiyin,8224,7,3,6,5,13,19,-6,15
FC Goa,8224,8,3,3,8,8,18,-10,12
Mumbai City,8225,1,7,4,3,17,8,9,25
Kerala Blast,8225,2,7,3,4,15,16,-1,24
Delhi Dynamo,8225,3,5,6,3,24,16,8,21
FC Goa,8225,4,5,3,6,17,16,1,18
FC Pune City,8225,5,5,3,6,15,16,-1,18
Chennaiyin,8225,6,4,5,5,14,22,-8,17
Kolkata,8225,7,3,6,5,17,21,-4,15
NorthEast Un,8225,8,4,2,8,10,14,-4,14
Kerala Blast,8226,1,7,3,4,14,14,0,24
Mumbai City,8226,2,6,5,3,18,10,8,23
Delhi Dynamo,8226,3,5,6,3,24,18,6,21
Kolkata,8226,4,5,6,3,15,13,2,21
NorthEast Un,8226,5,5,3,6,12,12,0,18
FC Pune City,8226,6,4,3,7,12,16,-4,15
Chennaiyin,8226,7,3,6,5,13,18,-5,15
FC Goa,8226,8,4,2,8,9,16,-7,14
Delhi Dynamo,8227,1,6,5,3,27,19,8,23
Mumbai City,8227,2,6,4,4,18,11,7,22
FC Pune City,8227,3,5,4,5,16,17,-1,19
Kerala Blast,8227,4,5,4,5,12,16,-4,19
FC Goa,8227,5,5,3,6,11,15,-4,18
Kolkata,8227,6,3,8,3,15,15,0,17
NorthEast Un,8227,7,5,2,7,13,14,-1,17
Chennaiyin,8227,8,3,6,5,14,19,-5,15
NorthEast Un,8228,1,7,2,5,13,10,3,23
Mumbai City,8228,2,6,4,4,17,12,5,22
Delhi Dynamo,8228,3,5,6,3,25,16,9,21
Kolkata,8228,4,5,6,3,17,15,2,21
Kerala Blast,8228,5,5,3,6,13,15,-2,18
FC Pune City,8228,6,5,3,6,14,19,-5,18
FC Goa,8228,7,4,3,7,11,17,-6,15
Chennaiyin,8228,8,3,5,6,15,21,-6,14
Mumbai City,8229,1,7,4,3,18,9,9,25
Kolkata,8229,2,6,6,2,20,14,6,24
Delhi Dynamo,8229,3,5,6,3,24,17,7,21
Chennaiyin,8229,4,5,5,4,20,20,0,20
FC Pune City,8229,5,5,3,6,16,18,-2,18
Kerala Blast,8229,6,5,3,6,13,18,-5,18
NorthEast Un,8229,7,4,3,7,11,17,-6,15
FC Goa,8229,8,3,2,9,11,20,-9,11
Mumbai City,8230,1,7,4,3,20,8,12,25
Delhi Dynamo,8230,2,5,6,3,23,19,4,21
Kolkata,8230,3,4,8,2,16,14,2,20
Chennaiyin,8230,4,5,5,4,18,18,0,20
Kerala Blast,8230,5,5,5,4,11,14,-3,20
NorthEast Un,8230,6,4,4,6,10,13,-3,16
FC Pune City,8230,7,4,3,7,12,16,-4,15
FC Goa,8230,8,3,3,8,10,18,-8,12
Mumbai City,8231,1,7,4,3,17,8,9,25
Delhi Dynamo,8231,2,6,5,3,24,15,9,23
Kerala Blast,8231,3,6,4,4,14,15,-1,22
Kolkata,8231,4,5,6,3,19,15,4,21
NorthEast Un,8231,5,5,3,6,11,11,0,18
FC Pune City,8231,6,4,3,7,12,18,-6,15
Chennaiyin,8231,7,3,5,6,13,20,-7,14
FC Goa,8231,8,4,2,8,10,18,-8,14
Mumbai City,8232,1,7,4,3,18,9,9,25
Kolkata,8232,2,5,6,3,18,15,3,21
Kerala Blast,8232,3,5,4,5,13,16,-3,19
FC Goa,8232,4,5,3,6,13,15,-2,18
Chennaiyin,8232,5,4,6,4,14,17,-3,18
Delhi Dynamo,8232,6,4,5,5,23,21,2,17
NorthEast Un,8232,7,5,2,7,11,13,-2,17
FC Pune City,8232,8,4,4,6,13,17,-4,16
Mumbai City,8233,1,7,4,3,18,9,9,25
NorthEast Un,8233,2,6,3,5,18,14,4,21
Kerala Blast,8233,3,5,5,4,13,16,-3,20
Delhi Dynamo,8233,4,4,6,4,25,22,3,18
Kolkata,8233,5,4,6,4,16,15,1,18
FC Goa,8233,6,5,3,6,14,16,-2,18
FC Pune City,8233,7,4,4,6,13,18,-5,16
Chennaiyin,8233,8,3,5,6,15,22,-7,14
Delhi Dynamo,8234,1,6,5,3,26,19,7,23
Mumbai City,8234,2,6,4,4,17,10,7,22
Kerala Blast,8234,3,6,4,4,13,14,-1,22
NorthEast Un,8234,4,5,3,6,16,16,0,18
FC Pune City,8234,5,5,3,6,14,16,-2,18
Kolkata,8234,6,3,7,4,15,16,-1,16
Chennaiyin,8234,7,3,7,4,17,21,-4,16
FC Goa,8234,8,4,3,7,12,18,-6,15
Mumbai City,8235,1,6,4,4,16,9,7,22
Kerala Blast,8235,2,6,4,4,16,14,2,22
Delhi Dynamo,8235,3,5,5,4,24,21,3,20
Kolkata,8235,4,4,8,2,17,15,2,20
NorthEast Un,8235,5,5,3,6,12,14,-2,18
FC Goa,8235,6,5,2,7,16,19,-3,17
FC Pune City,8235,7,4,4,6,12,16,-4,16
Chennaiyin,8235,8,3,6,5,14,19,-5,15
Mumbai City,8236,1,6,5,3,17,9,8,23
NorthEast Un,8236,2,6,3,5,13,9,4,21
Delhi Dynamo,8236,3,4,8,2,24,17,7,20
Kolkata,8236,4,4,7,3,16,16,0,19
Kerala Blast,8236,5,5,4,5,12,17,-5,19
FC Pune City,8236,6,4,4,6,15,18,-3,16
FC Goa,8236,7,4,4,6,13,17,-4,16
Chennaiyin,8236,8,3,5,6,14,21,-7,14
Mumbai City,8237,1,7,4,3,17,8,9,25
Delhi Dynamo,8237,2,6,5,3,23,15,8,23
Kolkata,8237,3,4,8,2,17,15,2,20
Kerala Blast,8237,4,5,4,5,14,16,-2,19
NorthEast Un,8237,5,5,3,6,12,10,2,18
Chennaiyin,8237,6,4,5,5,17,20,-3,17
FC Pune City,8237,7,4,4,6,15,20,-5,16
FC Goa,8237,8,3,3,8,8,19,-11,12
Delhi Dynamo,8238,1,6,6,2,27,18,9,24
Kolkata,8238,2,6,6,2,18,12,6,24
Mumbai City,8238,3,6,4,4,17,10,7,22
FC Pune City,8238,4,5,3,6,15,17,-2,18
NorthEast Un,8238,5,5,2,7,12,13,-1,17
Chennaiyin,8238,6,4,5,5,14,19,-5,17
FC Goa,8238,7,4,3,7,11,16,-5,15
Kerala Blast,8238,8,4,3,7,10,19,-9,15
Delhi Dynamo,8239,1,6,6,2,27,16,11,24
Mumbai City,8239,2,6,5,3,16,8,8,23
Kerala Blast,8239,3,6,4,4,12,14,-2,22
Kolkata,8239,4,4,7,3,17,16,1,19
FC Pune City,8239,5,4,4,6,13,16,-3,16
Chennaiyin,8239,6,3,7,4,15,19,-4,16
NorthEast Un,8239,7,4,3,7,12,14,-2,15
FC Goa,8239,8,3,4,7,10,19,-9,13
Delhi Dynamo,8240,1,7,5,2,27,15,12,26
Mumbai City,8240,2,6,4,4,17,10,7,22
Kolkata,8240,3,5,6,3,20,14,6,21
Kerala Blast,8240,4,5,4,5,13,19,-6,19
Chennaiyin,8240,5,4,6,4,17,20,-3,18
NorthEast Un,8240,6,4,4,6,10,11,-1,16
FC Pune City,8240,7,4,3,7,12,18,-6,15
FC Goa,8240,8,4,2,8,12,21,-9,14
Mumbai City,8241,1,7,4,3,18,9,9,25
Kerala Blast,8241,2,7,3,4,19,15,4,24
Kolkata,8241,3,5,6,3,19,19,0,21
Delhi Dynamo,8241,4,5,5,4,24,18,6,20
NorthEast Un,8241,5,5,2,7,13,12,1,17
FC Goa,8241,6,5,2,7,15,19,-4,17
FC Pune City,8241,7,4,3,7,13,20,-7,15
Chennaiyin,8241,8,3,5,6,14,23,-9,14
Mumbai City,8242,1,6,5,3,16,8,8,23
Delhi Dynamo,8242,2,5,7,2,24,16,8,22
Kolkata,8242,3,4,7,3,16,15,1,19
FC Goa,8242,4,5,3,6,14,17,-3,18
FC Pune City,8242,4,5,3,6,14,17,-3,18
NorthEast Un,8242,6,5,2,7,11,12,-1,17
Chennaiyin,8242,7,4,5,5,16,20,-4,17
Kerala Blast,8242,8,4,4,6,11,17,-6,16
Mumbai City,8243,1,7,4,3,17,8,9,25
NorthEast Un,8243,2,7,2,5,14,10,4,23
Kolkata,8243,3,4,7,3,17,16,1,19
Delhi Dynamo,8243,4,4,6,4,21,16,5,18
Kerala Blast,8243,5,4,5,5,10,16,-6,17
FC Pune City,8243,6,4,4,6,14,17,-3,16
FC Goa,8243,7,4,4,6,12,17,-5,16
Chennaiyin,8243,8,3,6,5,15,20,-5,15
Delhi Dynamo,8244,1,6,6,2,23,14,9,24
Mumbai City,8244,2,6,4,4,16,9,7,22
Chennaiyin,8244,3,5,5,4,17,17,0,20
Kolkata,8244,4,4,7,3,15,15,0,19
Kerala Blast,8244,5,5,4,5,11,14,-3,19
NorthEast Un,8244,6,5,3,6,10,11,-1,18
FC Pune City,8244,7,4,5,5,13,15,-2,17
FC Goa,8244,8,3,2,9,8,18,-10,11
Mumbai City,8245,1,6,5,3,16,8,8,23
Kerala Blast,8245,2,6,4,4,17,14,3,22
Delhi Dynamo,8245,3,5,6,3,24,18,6,21
Kolkata,8245,4,4,7,3,15,14,1,19
NorthEast Un,8245,5,5,2,7,13,16,-3,17
Chennaiyin,8245,6,4,5,5,15,19,-4,17
FC Pune City,8245,7,4,4,6,13,17,-4,16
FC Goa,8245,8,4,3,7,10,17,-7,15
Mumbai City,8246,1,7,4,3,18,8,10,25
Delhi Dynamo,8246,2,6,5,3,26,16,10,23
Kerala Blast,8246,3,6,4,4,12,13,-1,22
FC Pune City,8246,4,5,4,5,15,15,0,19
NorthEast Un,8246,5,5,2,7,11,14,-3,17
Chennaiyin,8246,6,4,5,5,14,19,-5,17
Kolkata,8246,7,3,7,4,14,16,-2,16
FC Goa,8246,8,3,3,8,8,17,-9,12
Mumbai City,8247,1,7,4,3,17,8,9,25
Delhi Dynamo,8247,2,5,6,3,25,15,10,21
Kolkata,8247,3,4,7,3,16,14,2,19
FC Pune City,8247,4,5,4,5,13,14,-1,19
NorthEast Un,8247,5,5,3,6,11,14,-3,18
Kerala Blast,8247,6,4,5,5,10,16,-6,17
Chennaiyin,8247,7,3,6,5,14,19,-5,15
FC Goa,8247,8,3,5,6,10,16,-6,14
Mumbai City,8248,1,6,5,3,16,8,8,23
Delhi Dynamo,8248,2,4,7,3,23,17,6,19
NorthEast Un,8248,3,5,4,5,14,13,1,19
FC Pune City,8248,4,5,4,5,13,14,-1,19
FC Goa,8248,5,5,3,6,14,15,-1,18
Kerala Blast,8248,6,4,6,4,13,17,-4,18
Kolkata,8248,7,3,7,4,15,16,-1,16
Chennaiyin,8248,8,3,6,5,14,22,-8,15
Mumbai City,8249,1,6,4,4,17,10,7,22
Kolkata,8249,2,5,7,2,17,14,3,22
Delhi Dynamo,8249,3,5,6,3,24,17,7,21
Chennaiyin,8249,4,5,5,4,17,19,-2,20
Kerala Blast,8249,5,5,4,5,11,15,-4,19
FC Pune City,8249,6,4,4,6,15,18,-3,16
NorthEast Un,8249,7,4,3,7,11,13,-2,15
FC Goa,8249,8,4,3,7,10,16,-6,15
Mumbai City,8250,1,6,5,3,18,10,8,23
Delhi Dynamo,8250,2,5,7,2,27,19,8,22
Kolkata,8250,3,5,6,3,17,15,2,21
Kerala Blast,8250,4,6,3,5,14,16,-2,21
FC Pune City,8250,5,5,3,6,13,15,-2,18
Chennaiyin,8250,6,4,6,4,17,20,-3,18
NorthEast Un,8250,7,4,4,6,12,14,-2,16
FC Goa,8250,8,3,2,9,11,20,-9,11
Mumbai City,8251,1,6,5,3,18,10,8,23
Kerala Blast,8251,2,6,4,4,16,16,0,22
NorthEast Un,8251,3,6,3,5,14,10,4,21
Delhi Dynamo,8251,4,4,7,3,24,18,6,19
FC Pune City,8251,5,5,3,6,16,19,-3,18
Chennaiyin,8251,6,4,5,5,15,21,-6,17
Kolkata,8251,7,3,6,5,16,20,-4,15
FC Goa,8251,8,4,3,7,12,17,-5,15
Mumbai City,8252,1,7,4,3,17,8,9,25
Delhi Dynamo,8252,2,6,5,3,27,15,12,23
Kerala Blast,8252,3,4,6,4,11,15,-4,18
Kolkata,8252,4,3,8,3,17,17,0,17
FC Pune City,8252,5,4,5,5,14,16,-2,17
Chennaiyin,8252,6,4,5,5,17,20,-3,17
FC Goa,8252,7,5,2,7,14,21,-7,17
NorthEast Un,8252,8,4,3,7,9,14,-5,15
Delhi Dynamo,8253,1,6,6,2,25,16,9,24
Mumbai City,8253,2,6,4,4,16,9,7,22
Kolkata,8253,3,4,8,2,15,13,2,20
NorthEast Un,8253,4,5,4,5,11,10,1,19
FC Pune City,8253,5,5,3,6,14,15,-1,18
Kerala Blast,8253,6,4,5,5,10,16,-6,17
Chennaiyin,8253,7,3,6,5,13,18,-5,15
FC Goa,8253,8,3,4,7,9,16,-7,13
Mumbai City,8254,1,7,4,3,19,9,10,25
Kolkata,8254,2,6,6,2,19,13,6,24
Delhi Dynamo,8254,3,5,5,4,24,20,4,20
FC Pune City,8254,4,5,3,6,16,16,0,18
Kerala Blast,8254,5,5,3,6,11,18,-7,18
NorthEast Un,8254,6,5,2,7,14,14,0,17
FC Goa,8254,7,5,2,7,12,17,-5,17
Chennaiyin,8254,8,3,5,6,14,22,-8,14
Mumbai City,8255,1,6,5,3,16,8,8,23
Delhi Dynamo,8255,2,5,7,2,30,17,13,22
Kerala Blast,8255,3,5,5,4,12,15,-3,20
FC Pune City,8255,4,5,3,6,14,15,-1,18
NorthEast Un,8255,5,4,5,5,14,14,0,17
Kolkata,8255,6,3,8,3,15,16,-1,17
Chennaiyin,8255,7,3,6,5,13,20,-7,15
FC Goa,8255,8,4,3,7,13,22,-9,15
Mumbai City,8256,1,7,4,3,18,8,10,25
Kolkata,8256,2,5,7,2,19,14,5,22
NorthEast Un,8256,3,6,3,5,14,11,3,21
Delhi Dynamo,8256,4,4,6,4,23,20,3,18
FC Goa,8256,5,5,3,6,13,15,-2,18
Kerala Blast,8256,6,5,3,6,11,17,-6,18
FC Pune City,8256,7,4,3,7,14,20,-6,15
Chennaiyin,8256,8,3,5,6,14,21,-7,14
Delhi Dynamo,8257,1,6,5,3,24,17,7,23
Mumbai City,8257,2,6,4,4,16,9,7,22
NorthEast Un,8257,3,6,3,5,17,12,5,21
Kerala Blast,8257,4,5,5,4,14,15,-1,20
Kolkata,8257,5,3,8,3,16,17,-1,17
Chennaiyin,8257,6,4,5,5,18,23,-5,17
FC Pune City,8257,7,4,4,6,13,18,-5,16
FC Goa,8257,8,4,2,8,13,20,-7,14
Mumbai City,8258,1,7,4,3,18,8,10,25
Delhi Dynamo,8258,2,6,5,3,24,17,7,23
Kolkata,8258,3,4,7,3,17,17,0,19
NorthEast Un,8258,4,5,3,6,12,11,1,18
FC Pune City,8258,5,4,5,5,13,15,-2,17
Chennaiyin,8258,6,4,5,5,16,21,-5,17
Kerala Blast,8258,7,4,5,5,10,15,-5,17
FC Goa,8258,8,4,2,8,13,19,-6,14
Delhi Dynamo,8259,1,7,5,2,26,15,11,26
Mumbai City,8259,2,6,4,4,17,10,7,22
Kolkata,8259,3,5,7,2,17,14,3,22
NorthEast Un,8259,4,6,2,6,11,10,1,20
FC Pune City,8259,5,5,3,6,14,16,-2,18
Chennaiyin,8259,6,4,5,5,14,18,-4,17
Kerala Blast,8259,7,4,4,6,12,18,-6,16
FC Goa,8259,8,3,2,9,8,18,-10,11
Mumbai City,8260,1,6,4,4,19,12,7,22
Delhi Dynamo,8260,2,5,6,3,28,21,7,21
Kolkata,8260,3,5,6,3,20,16,4,21
FC Pune City,8260,4,6,3,5,17,15,2,21
NorthEast Un,8260,5,6,2,6,14,14,0,20
Kerala Blast,8260,6,5,3,6,13,19,-6,18
FC Goa,8260,7,4,3,7,12,20,-8,15
Chennaiyin,8260,8,3,5,6,16,22,-6,14
Mumbai City,8261,1,7,4,3,17,8,9,25
Delhi Dynamo,8261,2,5,5,4,22,17,5,20
NorthEast Un,8261,3,6,2,6,12,11,1,20
Kolkata,8261,4,4,7,3,19,15,4,19
Kerala Blast,8261,5,5,4,5,13,17,-4,19
FC Goa,8261,6,5,3,6,13,16,-3,18
FC Pune City,8261,7,4,4,6,14,20,-6,16
Chennaiyin,8261,8,3,5,6,13,19,-6,14
Delhi Dynamo,8262,1,6,6,2,27,17,10,24
Mumbai City,8262,2,6,5,3,16,8,8,23
Kerala Blast,8262,3,6,3,5,15,17,-2,21
FC Pune City,8262,4,5,4,5,15,16,-1,19
Chennaiyin,8262,5,4,6,4,14,17,-3,18
Kolkata,8262,6,3,8,3,16,17,-1,17
NorthEast Un,8262,7,4,3,7,11,14,-3,15
FC Goa,8262,8,3,3,8,11,19,-8,12
Mumbai City,8263,1,7,4,3,17,8,9,25
NorthEast Un,8263,2,6,3,5,12,10,2,21
Delhi Dynamo,8263,3,5,5,4,25,18,7,20
FC Pune City,8263,4,5,4,5,14,15,-1,19
Chennaiyin,8263,5,4,6,4,16,17,-1,18
Kerala Blast,8263,6,5,3,6,11,15,-4,18
Kolkata,8263,7,3,7,4,15,18,-3,16
FC Goa,8263,8,4,2,8,12,21,-9,14
Mumbai City,8264,1,7,4,3,18,8,10,25
Kolkata,8264,2,5,7,2,18,14,4,22
NorthEast Un,8264,3,6,3,5,17,12,5,21
Kerala Blast,8264,4,5,4,5,12,16,-4,19
Delhi Dynamo,8264,5,4,6,4,23,22,1,18
Chennaiyin,8264,6,4,6,4,15,18,-3,18
FC Pune City,8264,7,4,3,7,12,16,-4,15
FC Goa,8264,8,3,3,8,10,19,-9,12
Mumbai City,8265,1,6,5,3,17,9,8,23
Delhi Dynamo,8265,2,5,6,3,24,19,5,21
FC Pune City,8265,3,6,3,5,16,15,1,21
Kerala Blast,8265,4,6,3,5,12,16,-4,21
Chennaiyin,8265,5,5,5,4,17,18,-1,20
Kolkata,8265,6,4,6,4,17,17,0,18
NorthEast Un,8265,7,5,2,7,12,12,0,17
FC Goa,8265,8,3,2,9,11,20,-9,11
Mumbai City,8266,1,6,5,3,16,8,8,23
Kolkata,8266,2,5,6,3,18,14,4,21
Kerala Blast,8266,3,6,3,5,14,16,-2,21
Delhi Dynamo,8266,4,4,7,3,23,17,6,19
NorthEast Un,8266,5,5,3,6,13,12,1,18
FC Pune City,8266,6,5,3,6,14,17,-3,18
Chennaiyin,8266,7,4,5,5,15,21,-6,17
FC Goa,8266,8,4,2,8,12,20,-8,14
Delhi Dynamo,8267,1,7,5,2,27,15,12,26
Mumbai City,8267,2,6,4,4,17,10,7,22
Kerala Blast,8267,3,6,4,4,14,15,-1,22
Kolkata,8267,4,3,8,3,15,15,0,17
NorthEast Un,8267,5,5,2,7,12,13,-1,17
FC Pune City,8267,6,4,4,6,13,17,-4,16
Chennaiyin,8267,7,3,6,5,13,19,-6,15
FC Goa,8267,8,4,3,7,9,16,-7,15
Mumbai City,8268,1,7,4,3,18,9,9,25
Delhi Dynamo,8268,2,5,6,3,26,19,7,21
NorthEast Un,8268,3,6,2,6,13,12,1,20
Kolkata,8268,4,4,7,3,16,15,1,19
Kerala Blast,8268,5,5,4,5,11,15,-4,19
FC Goa,8268,6,5,3,6,14,18,-4,18
FC Pune City,8268,7,4,3,7,13,17,-4,15
Chennaiyin,8268,8,3,5,6,14,20,-6,14
Mumbai City,8269,1,7,4,3,17,8,9,25
Delhi Dynamo,8269,2,6,5,3,28,18,10,23
Kerala Blast,8269,3,6,4,4,14,15,-1,22
Kolkata,8269,4,3,8,3,15,16,-1,17
FC Pune City,8269,5,4,4,6,14,17,-3,16
NorthEast Un,8269,6,4,4,6,12,15,-3,16
Chennaiyin,8269,7,3,7,4,17,21,-4,16
FC Goa,8269,8,3,4,7,14,21,-7,13
Delhi Dynamo,8270,1,6,5,3,24,17,7,23
Mumbai City,8270,2,6,4,4,16,9,7,22
Kolkata,8270,3,4,7,3,17,16,1,19
FC Pune City,8270,4,5,4,5,15,16,-1,19
NorthEast Un,8270,5,5,3,6,10,10,0,18
Kerala Blast,8270,6,4,6,4,12,16,-4,18
Chennaiyin,8270,7,3,6,5,15,20,-5,15
FC Goa,8270,8,4,3,7,13,18,-5,15
Mumbai City,8271,1,6,4,4,17,11,6,22
Delhi Dynamo,8271,2,5,6,3,26,18,8,21
Kolkata,8271,3,4,8,2,19,16,3,20
Kerala Blast,8271,4,5,4,5,14,19,-5,19
FC Goa,8271,5,5,3,6,15,19,-4,18
NorthEast Un,8271,6,4,5,5,12,12,0,17
FC Pune City,8271,7,4,4,6,15,18,-3,16
Chennaiyin,8271,8,3,6,5,16,21,-5,15
Kolkata,8272,1,6,6,2,18,13,5,24
Delhi Dynamo,8272,2,6,5,3,26,17,9,23
Mumbai City,8272,3,6,4,4,17,10,7,22
Kerala Blast,8272,4,6,3,5,12,14,-2,21
NorthEast Un,8272,5,5,2,7,11,13,-2,17
Chennaiyin,8272,6,4,5,5,18,21,-3,17
FC Pune City,8272,7,4,3,7,12,18,-6,15
FC Goa,8272,8,4,2,8,13,21,-8,14
Mumbai City,8273,1,6,5,3,17,9,8,23
Kerala Blast,8273,2,5,4,5,13,17,-4,19
Delhi Dynamo,8273,3,4,6,4,23,18,5,18
Kolkata,8273,4,4,6,4,18,18,0,18
NorthEast Un,8273,5,5,3,6,10,11,-1,18
FC Pune City,8273,6,5,3,6,16,18,-2,18
Chennaiyin,8273,7,4,6,4,15,17,-2,18
FC Goa,8273,8,5,3,6,11,15,-4,18
Mumbai City,8274,1,7,4,3,18,9,9,25
Kolkata,8274,2,4,8,2,15,13,2,20
Kerala Blast,8274,3,5,5,4,13,15,-2,20
Delhi Dynamo,8274,4,4,6,4,23,19,4,18
FC Goa,8274,5,5,3,6,13,16,-3,18
NorthEast Un,8274,6,4,4,6,10,12,-2,16
FC Pune City,8274,7,4,4,6,14,17,-3,16
Chennaiyin,8274,8,3,6,5,14,19,-5,15
Mumbai City,8275,1,7,4,3,20,11,9,25
NorthEast Un,8275,2,6,2,6,14,11,3,20
Chennaiyin,8275,3,5,5,4,17,18,-1,20
FC Pune City,8275,4,5,4,5,16,16,0,19
Delhi Dynamo,8275,5,4,6,4,26,23,3,18
Kolkata,8275,6,3,8,3,16,17,-1,17
Kerala Blast,8275,7,4,5,5,11,16,-5,17
FC Goa,8275,8,3,4,7,11,19,-8,13
Mumbai City,8276,1,7,4,3,19,9,10,25
Delhi Dynamo,8276,2,5,5,4,24,19,5,20
Chennaiyin,8276,3,5,5,4,15,17,-2,20
Kerala Blast,8276,4,5,4,5,11,16,-5,19
FC Pune City,8276,5,5,3,6,14,15,-1,18
NorthEast Un,8276,6,5,2,7,12,12,0,17
Kolkata,8276,7,3,8,3,13,14,-1,17
FC Goa,8276,8,4,3,7,10,16,-6,15
Delhi Dynamo,8277,1,6,6,2,27,17,10,24
Mumbai City,8277,2,6,5,3,18,10,8,23
Kolkata,8277,3,5,7,2,17,13,4,22
Kerala Blast,8277,4,5,4,5,15,17,-2,19
FC Pune City,8277,5,4,5,5,14,16,-2,17
NorthEast Un,8277,6,5,2,7,13,15,-2,17
Chennaiyin,8277,7,3,5,6,15,22,-7,14
FC Goa,8277,8,4,2,8,10,19,-9,14
Mumbai City,8278,1,7,4,3,19,8,11,25
Delhi Dynamo,8278,2,6,5,3,25,19,6,23
Kolkata,8278,3,5,7,2,19,12,7,22
Kerala Blast,8278,4,6,3,5,15,18,-3,21
NorthEast Un,8278,5,5,2,7,12,13,-1,17
FC Pune City,8278,6,4,4,6,12,18,-6,16
Chennaiyin,8278,7,3,6,5,14,19,-5,15
FC Goa,8278,8,3,3,8,10,19,-9,12
Mumbai City,8279,1,7,4,3,19,9,10,25
NorthEast Un,8279,2,6,3,5,13,11,2,21
Kerala Blast,8279,3,6,3,5,15,15,0,21
Delhi Dynamo,8279,4,5,5,4,26,19,7,20
Kolkata,8279,5,4,7,3,15,16,-1,19
FC Pune City,8279,6,4,4,6,12,15,-3,16
Chennaiyin,8279,7,3,7,4,13,17,-4,16
FC Goa,8279,8,3,3,8,8,19,-11,12
Delhi Dynamo,8280,1,7,5,2,29,14,15,26
Mumbai City,8280,2,6,4,4,16,13,3,22
FC Pune City,8280,3,6,3,5,14,14,0,21
Chennaiyin,8280,4,5,5,4,16,18,-2,20
Kerala Blast,8280,5,5,4,5,13,17,-4,19
Kolkata,8280,6,3,7,4,14,15,-1,16
NorthEast Un,8280,7,4,3,7,11,13,-2,15
FC Goa,8280,8,3,3,8,9,18,-9,12
Mumbai City,8281,1,7,4,3,19,8,11,25
Delhi Dynamo,8281,2,6,5,3,24,17,7,23
Kerala Blast,8281,3,6,3,5,15,18,-3,21
Kolkata,8281,4,4,8,2,18,16,2,20
Chennaiyin,8281,5,4,5,5,14,18,-4,17
FC Pune City,8281,6,4,4,6,14,17,-3,16
FC Goa,8281,7,4,3,7,10,17,-7,15
NorthEast Un,8281,8,4,2,8,10,13,-3,14
Mumbai City,8282,1,6,5,3,18,10,8,23
Kolkata,8282,2,5,6,3,18,15,3,21
Kerala Blast,8282,3,6,3,5,13,16,-3,21
FC Goa,8282,4,6,2,6,15,17,-2,20
Delhi Dynamo,8282,5,4,7,3,27,22,5,19
NorthEast Un,8282,6,4,4,6,12,13,-1,16
Chennaiyin,8282,7,3,6,5,15,20,-5,15
FC Pune City,8282,8,4,3,7,14,19,-5,15
Mumbai City,8283,1,6,4,4,16,9,7,22
Kolkata,8283,2,5,7,2,15,12,3,22
Delhi Dynamo,8283,3,5,6,3,25,18,7,21
Kerala Blast,8283,4,5,5,4,12,15,-3,20
Chennaiyin,8283,5,4,5,5,16,18,-2,17
FC Goa,8283,6,5,2,7,11,16,-5,17
NorthEast Un,8283,7,4,4,6,13,16,-3,16
FC Pune City,8283,8,4,3,7,12,16,-4,15
Delhi Dynamo,8284,1,6,5,3,25,15,10,23
NorthEast Un,8284,2,7,2,5,16,13,3,23
Mumbai City,8284,3,6,4,4,16,10,6,22
Kerala Blast,8284,4,6,3,5,16,19,-3,21
Kolkata,8284,5,4,6,4,20,18,2,18
FC Goa,8284,6,5,2,7,12,18,-6,17
FC Pune City,8284,7,4,3,7,15,21,-6,15
Chennaiyin,8284,8,3,5,6,15,21,-6,14
Mumbai City,8285,1,6,5,3,16,8,8,23
Delhi Dynamo,8285,2,5,7,2,27,17,10,22
Kolkata,8285,3,5,6,3,19,14,5,21
NorthEast Un,8285,4,5,4,5,12,10,2,19
FC Pune City,8285,5,5,4,5,14,15,-1,19
Chennaiyin,8285,6,4,6,4,15,17,-2,18
Kerala Blast,8285,7,4,4,6,9,19,-10,16
FC Goa,8285,8,3,2,9,10,22,-12,11
Mumbai City,8286,1,7,4,3,19,10,9,25
Kerala Blast,8286,2,6,3,5,13,14,-1,21
Delhi Dynamo,8286,3,5,5,4,26,19,7,20
NorthEast Un,8286,4,6,2,6,12,12,0,20
Kolkata,8286,5,4,7,3,15,15,0,19
FC Goa,8286,6,5,2,7,12,17,-5,17
FC Pune City,8286,7,4,4,6,13,17,-4,16
Chennaiyin,8286,8,3,5,6,14,20,-6,14
Mumbai City,8287,1,7,4,3,18,8,10,25
Kolkata,8287,2,5,7,2,18,14,4,22
Kerala Blast,8287,3,5,5,4,12,15,-3,20
Delhi Dynamo,8287,4,4,6,4,24,20,4,18
NorthEast Un,8287,5,5,2,7,12,14,-2,17
Chennaiyin,8287,6,4,5,5,18,21,-3,17
FC Pune City,8287,7,4,4,6,12,15,-3,16
FC Goa,8287,8,4,3,7,13,20,-7,15
Mumbai City,8288,1,6,5,3,17,9,8,23
Delhi Dynamo,8288,2,5,7,2,24,16,8,22
Kerala Blast,8288,3,6,3,5,13,16,-3,21
NorthEast Un,8288,4,5,4,5,11,10,1,19
FC Pune City,8288,5,5,3,6,16,16,0,18
Kolkata,8288,6,4,6,4,16,17,-1,18
Chennaiyin,8288,7,4,6,4,16,19,-3,18
FC Goa,8288,8,3,2,9,10,20,-10,11
Mumbai City,8289,1,7,4,3,17,8,9,25
Kolkata,8289,2,5,6,3,17,16,1,21
Kerala Blast,8289,3,6,3,5,12,16,-4,21
Delhi Dynamo,8289,4,5,5,4,23,18,5,20
FC Goa,8289,5,5,3,6,14,14,0,18
Chennaiyin,8289,6,3,7,4,14,18,-4,16
NorthEast Un,8289,7,4,3,7,11,13,-2,15
FC Pune City,8289,8,4,3,7,13,18,-5,15
Mumbai City,8290,1,7,4,3,18,8,10,25
Delhi Dynamo,8290,2,5,6,3,25,17,8,21
FC Pune City,8290,3,5,4,5,14,14,0,19
Kerala Blast,8290,4,5,4,5,13,17,-4,19
Kolkata,8290,5,3,8,3,14,15,-1,17
Chennaiyin,8290,6,4,5,5,15,19,-4,17
FC Goa,8290,7,5,2,7,13,19,-6,17
NorthEast Un,8290,8,4,3,7,10,13,-3,15
Mumbai City,8291,1,7,4,3,18,8,10,25
Delhi Dynamo,8291,2,5,6,3,25,18,7,21
Kerala Blast,8291,3,6,3,5,13,16,-3,21
Kolkata,8291,4,4,6,4,16,17,-1,18
FC Pune City,8291,5,5,3,6,15,17,-2,18
FC Goa,8291,6,5,3,6,13,16,-3,18
NorthEast Un,8291,7,4,3,7,10,13,-3,15
Chennaiyin,8291,8,3,6,5,13,18,-5,15
Delhi Dynamo,8292,1,6,5,3,26,19,7,23
Mumbai City,8292,2,6,4,4,17,10,7,22
Kolkata,8292,3,5,6,3,19,16,3,21
NorthEast Un,8292,4,6,2,6,13,12,1,20
Kerala Blast,8292,5,5,3,6,12,18,-6,18
FC Goa,8292,6,5,2,7,16,18,-2,17
Chennaiyin,8292,7,4,5,5,16,20,-4,17
FC Pune City,8292,8,4,3,7,13,19,-6,15
Mumbai City,8293,1,6,5,3,17,9,8,23
Kolkata,8293,2,5,7,2,16,13,3,22
NorthEast Un,8293,3,6,2,6,13,10,3,20
Delhi Dynamo,8293,4,4,7,3,22,18,4,19
Kerala Blast,8293,5,5,4,5,12,15,-3,19
Chennaiyin,8293,6,4,6,4,15,18,-3,18
FC Pune City,8293,7,4,3,7,14,19,-5,15
FC Goa,8293,8,3,4,7,9,16,-7,13
Mumbai City,8294,1,7,4,3,21,8,13,25
NorthEast Un,8294,2,7,2,5,14,10,4,23
Delhi Dynamo,8294,3,5,5,4,24,22,2,20
Kolkata,8294,4,4,7,3,16,15,1,19
FC Pune City,8294,5,5,3,6,13,15,-2,18
Kerala Blast,8294,6,5,3,6,11,16,-5,18
Chennaiyin,8294,7,4,5,5,16,19,-3,17
FC Goa,8294,8,3,3,8,10,20,-10,12
Mumbai City,8295,1,6,5,3,18,10,8,23
Delhi Dynamo,8295,2,5,7,2,25,16,9,22
FC Pune City,8295,3,6,3,5,16,14,2,21
Kolkata,8295,4,4,6,4,17,17,0,18
NorthEast Un,8295,5,5,3,6,13,13,0,18
Chennaiyin,8295,6,4,5,5,14,19,-5,17
Kerala Blast,8295,7,4,4,6,13,21,-8,16
FC Goa,8295,8,4,3,7,10,16,-6,15
Mumbai City,8296,1,7,4,3,19,8,11,25
Delhi Dynamo,8296,2,6,5,3,25,18,7,23
Kolkata,8296,3,4,7,3,15,15,0,19
Kerala Blast,8296,4,5,4,5,11,14,-3,19
NorthEast Un,8296,5,4,4,6,10,11,-1,16
Chennaiyin,8296,6,3,7,4,15,19,-4,16
FC Pune City,8296,7,4,4,6,13,17,-4,16
FC Goa,8296,8,4,3,7,12,18,-6,15
Delhi Dynamo,8297,1,7,5,2,32,17,15,26
Mumbai City,8297,2,6,4,4,17,12,5,22
Kolkata,8297,3,5,7,2,16,13,3,22
NorthEast Un,8297,4,5,3,6,13,13,0,18
FC Pune City,8297,5,4,5,5,14,16,-2,17
Chennaiyin,8297,6,4,5,5,15,19,-4,17
Kerala Blast,8297,7,4,5,5,10,15,-5,17
FC Goa,8297,8,3,2,9,8,20,-12,11
Mumbai City,8298,1,7,4,3,19,9,10,25
Kolkata,8298,2,6,6,2,18,14,4,24
Delhi Dynamo,8298,3,5,6,3,25,18,7,21
Kerala Blast,8298,4,6,3,5,16,16,0,21
Chennaiyin,8298,5,5,5,4,17,18,-1,20
NorthEast Un,8298,6,4,3,7,12,15,-3,15
FC Pune City,8298,7,4,3,7,13,20,-7,15
FC Goa,8298,8,3,2,9,8,18,-10,11
Mumbai City,8299,1,7,4,3,18,9,9,25
Delhi Dynamo,8299,2,6,5,3,29,19,10,23
Chennaiyin,8299,3,5,5,4,16,17,-1,20
Kolkata,8299,4,4,7,3,16,15,1,19
Kerala Blast,8299,5,5,4,5,17,18,-1,19
FC Pune City,8299,6,5,3,6,15,17,-2,18
FC Goa,8299,7,4,2,8,12,20,-8,14
NorthEast Un,8299,8,4,2,8,11,19,-8,14
Delhi Dynamo,8300,1,7,5,2,28,16,12,26
Mumbai City,8300,2,6,4,4,17,10,7,22
Kolkata,8300,3,4,8,2,22,15,7,20
FC Pune City,8300,4,5,4,5,18,19,-1,19
Chennaiyin,8300,5,4,6,4,16,18,-2,18
Kerala Blast,8300,6,5,3,6,12,22,-10,18
NorthEast Un,8300,7,4,2,8,10,15,-5,14
FC Goa,8300,8,3,4,7,9,17,-8,13
Delhi Dynamo,8301,1,7,5,2,28,18,10,26
Mumbai City,8301,2,6,4,4,17,10,7,22
FC Pune City,8301,3,5,4,5,17,15,2,19
Kolkata,8301,4,4,7,3,16,17,-1,19
Chennaiyin,8301,5,4,6,4,16,19,-3,18
NorthEast Un,8301,6,5,2,7,12,13,-1,17
Kerala Blast,8301,7,4,5,5,11,16,-5,17
FC Goa,8301,8,3,3,8,11,20,-9,12
Delhi Dynamo,8302,1,7,5,2,28,18,10,26
Mumbai City,8302,2,6,4,4,17,10,7,22
Kolkata,8302,3,4,7,3,15,14,1,19
NorthEast Un,8302,4,5,3,6,13,13,0,18
FC Pune City,8302,5,5,3,6,14,17,-3,18
Kerala Blast,8302,6,5,3,6,13,17,-4,18
Chennaiyin,8302,7,3,7,4,15,19,-4,16
FC Goa,8302,8,3,4,7,12,19,-7,13
Mumbai City,8303,1,7,4,3,17,8,9,25
Delhi Dynamo,8303,2,6,5,3,26,17,9,23
NorthEast Un,8303,3,6,2,6,14,12,2,20
Kolkata,8303,4,4,7,3,17,16,1,19
Kerala Blast,8303,5,5,4,5,13,16,-3,19
Chennaiyin,8303,6,4,5,5,15,19,-4,17
FC Pune City,8303,7,4,3,7,14,19,-5,15
FC Goa,8303,8,4,2,8,10,19,-9,14
Mumbai City,8304,1,7,4,3,18,8,10,25
Kerala Blast,8304,2,7,3,4,14,15,-1,24
Delhi Dynamo,8304,3,5,6,3,23,17,6,21
Kolkata,8304,4,5,6,3,18,15,3,21
Chennaiyin,8304,5,4,6,4,16,19,-3,18
NorthEast Un,8304,6,4,4,6,11,12,-1,16
FC Pune City,8304,7,4,3,7,14,18,-4,15
FC Goa,8304,8,3,2,9,9,19,-10,11
Mumbai City,8305,1,7,4,3,19,8,11,25
Kerala Blast,8305,2,6,4,4,15,14,1,22
Delhi Dynamo,8305,3,4,7,3,22,18,4,19
FC Goa,8305,4,5,3,6,12,14,-2,18
FC Pune City,8305,5,4,5,5,13,15,-2,17
NorthEast Un,8305,6,4,4,6,11,13,-2,16
Kolkata,8305,7,3,7,4,13,17,-4,16
Chennaiyin,8305,8,3,6,5,14,20,-6,15
Kolkata,8306,1,6,6,2,21,14,7,24
Mumbai City,8306,2,6,5,3,16,8,8,23
Delhi Dynamo,8306,3,4,7,3,23,21,2,19
Kerala Blast,8306,4,5,4,5,12,16,-4,19
NorthEast Un,8306,5,5,3,6,14,10,4,18
Chennaiyin,8306,6,4,5,5,14,18,-4,17
FC Pune City,8306,7,4,3,7,13,19,-6,15
FC Goa,8306,8,4,3,7,12,19,-7,15
Mumbai City,8307,1,6,5,3,17,9,8,23
Kolkata,8307,2,5,7,2,25,16,9,22
Delhi Dynamo,8307,3,5,6,3,26,17,9,21
Kerala Blast,8307,4,5,5,4,13,16,-3,20
Chennaiyin,8307,5,4,6,4,16,19,-3,18
NorthEast Un,8307,6,4,3,7,12,16,-4,15
FC Pune City,8307,7,4,3,7,14,19,-5,15
FC Goa,8307,8,4,3,7,10,21,-11,15
Mumbai City,8308,1,7,4,3,19,8,11,25
Delhi Dynamo,8308,2,5,5,4,24,20,4,20
NorthEast Un,8308,3,5,4,5,12,10,2,19
FC Pune City,8308,4,5,4,5,16,16,0,19
Kolkata,8308,5,4,6,4,16,16,0,18
Kerala Blast,8308,6,4,5,5,11,17,-6,17
Chennaiyin,8308,7,3,7,4,15,19,-4,16
FC Goa,8308,8,4,3,7,12,19,-7,15
Mumbai City,8309,1,7,4,3,18,9,9,25
Delhi Dynamo,8309,2,5,6,3,26,18,8,21
Kolkata,8309,3,5,6,3,18,16,2,21
Kerala Blast,8309,4,6,3,5,14,14,0,21
Chennaiyin,8309,5,5,5,4,16,18,-2,20
FC Goa,8309,6,4,3,7,15,21,-6,15
FC Pune City,8309,7,4,3,7,12,18,-6,15
NorthEast Un,8309,8,4,2,8,9,14,-5,14
Delhi Dynamo,8310,1,6,6,2,26,17,9,24
Mumbai City,8310,2,6,4,4,17,10,7,22
Kolkata,8310,3,5,6,3,19,16,3,21
NorthEast Un,8310,4,5,3,6,11,11,0,18
FC Goa,8310,5,5,2,7,13,17,-4,17
Chennaiyin,8310,6,4,5,5,14,19,-5,17
FC Pune City,8310,7,4,4,6,14,17,-3,16
Kerala Blast,8310,8,4,4,6,11,18,-7,16
Kerala Blast,8311,1,7,3,4,19,16,3,24
Mumbai City,8311,2,6,4,4,16,10,6,22
Delhi Dynamo,8311,3,5,5,4,23,16,7,20
NorthEast Un,8311,4,6,2,6,13,13,0,20
FC Pune City,8311,5,5,3,6,16,20,-4,18
Kolkata,8311,6,3,7,4,14,15,-1,16
FC Goa,8311,7,4,4,6,9,14,-5,16
Chennaiyin,8311,8,3,6,5,13,19,-6,15
Mumbai City,8312,1,7,4,3,19,9,10,25
Delhi Dynamo,8312,2,5,6,3,25,19,6,21
Kolkata,8312,3,4,7,3,17,16,1,19
Kerala Blast,8312,4,5,4,5,14,17,-3,19
NorthEast Un,8312,5,5,3,6,12,13,-1,18
FC Pune City,8312,6,5,3,6,14,16,-2,18
Chennaiyin,8312,7,3,6,5,15,20,-5,15
FC Goa,8312,8,4,3,7,12,18,-6,15
Mumbai City,8313,1,7,4,3,17,8,9,25
Delhi Dynamo,8313,2,5,6,3,25,16,9,21
Kolkata,8313,3,5,6,3,18,13,5,21
Kerala Blast,8313,4,5,4,5,14,20,-6,19
FC Goa,8313,5,5,3,6,11,14,-3,18
NorthEast Un,8313,6,5,2,7,14,17,-3,17
FC Pune City,8313,7,4,4,6,14,17,-3,16
Chennaiyin,8313,8,3,5,6,14,22,-8,14
Mumbai City,8314,1,7,4,3,18,9,9,25
Kerala Blast,8314,2,7,3,4,15,14,1,24
Kolkata,8314,3,5,6,3,17,15,2,21
Delhi Dynamo,8314,4,5,5,4,25,19,6,20
NorthEast Un,8314,5,5,2,7,11,13,-2,17
Chennaiyin,8314,6,4,5,5,16,19,-3,17
FC Pune City,8314,7,4,3,7,13,18,-5,15
FC Goa,8314,8,4,2,8,11,19,-8,14
Delhi Dynamo,8315,1,7,5,2,26,16,10,26
Mumbai City,8315,2,6,4,4,17,10,7,22
NorthEast Un,8315,3,6,2,6,14,11,3,20
Kolkata,8315,4,4,7,3,16,15,1,19
Kerala Blast,8315,5,5,3,6,10,15,-5,18
FC Pune City,8315,6,4,4,6,13,16,-3,16
FC Goa,8315,7,4,3,7,11,17,-6,15
Chennaiyin,8315,8,3,6,5,14,21,-7,15
Mumbai City,8316,1,6,4,4,16,11,5,22
Delhi Dynamo,8316,2,5,6,3,27,19,8,21
Kolkata,8316,3,5,6,3,18,16,2,21
FC Pune City,8316,4,5,4,5,16,16,0,19
Kerala Blast,8316,5,5,4,5,13,16,-3,19
NorthEast Un,8316,6,5,2,7,12,14,-2,17
Chennaiyin,8316,7,4,5,5,17,20,-3,17
FC Goa,8316,8,4,3,7,13,20,-7,15
Mumbai City,8317,1,6,5,3,16,8,8,23
Delhi Dynamo,8317,2,5,6,3,25,17,8,21
Kerala Blast,8317,3,6,3,5,13,15,-2,21
Kolkata,8317,4,4,6,4,14,15,-1,18
NorthEast Un,8317,5,5,3,6,12,13,-1,18
FC Pune City,8317,6,5,3,6,14,16,-2,18
Chennaiyin,8317,7,4,6,4,15,18,-3,18
FC Goa,8317,8,4,2,8,11,18,-7,14
Delhi Dynamo,8318,1,6,5,3,29,20,9,23
Mumbai City,8318,2,6,4,4,17,11,6,22
Kolkata,8318,3,5,7,2,17,14,3,22
Kerala Blast,8318,4,5,5,4,14,16,-2,20
NorthEast Un,8318,5,5,2,7,13,15,-2,17
FC Goa,8318,6,5,2,7,16,19,-3,17
FC Pune City,8318,7,4,4,6,13,16,-3,16
Chennaiyin,8318,8,3,5,6,14,22,-8,14
Mumbai City,8319,1,7,4,3,19,9,10,25
Kolkata,8319,2,5,6,3,18,16,2,21
Delhi Dynamo,8319,3,5,5,4,24,20,4,20
FC Pune City,8319,4,5,4,5,16,14,2,19
Kerala Blast,8319,5,5,4,5,11,17,-6,19
NorthEast Un,8319,6,5,2,7,12,13,-1,17
FC Goa,8319,7,5,2,7,12,17,-5,17
Chennaiyin,8319,8,3,5,6,14,20,-6,14
Mumbai City,8320,1,7,4,3,18,9,9,25
Delhi Dynamo,8320,2,6,5,3,29,18,11,23
Kerala Blast,8320,3,6,4,4,15,16,-1,22
Kolkata,8320,4,3,8,3,20,21,-1,17
FC Pune City,8320,5,4,4,6,13,16,-3,16
Chennaiyin,8320,6,3,7,4,15,19,-4,16
NorthEast Un,8320,7,4,3,7,10,15,-5,15
FC Goa,8320,8,4,3,7,16,22,-6,15
Mumbai City,8321,1,6,5,3,17,9,8,23
Kerala Blast,8321,2,6,4,4,15,17,-2,22
Delhi Dynamo,8321,3,4,7,3,23,19,4,19
NorthEast Un,8321,4,5,4,5,15,12,3,19
Chennaiyin,8321,5,4,6,4,17,20,-3,18
Kolkata,8321,6,3,8,3,14,14,0,17
FC Pune City,8321,7,4,4,6,13,16,-3,16
FC Goa,8321,8,3,4,7,11,18,-7,13
Mumbai City,8322,1,6,5,3,19,11,8,23
Delhi Dynamo,8322,2,4,8,2,27,20,7,20
Kolkata,8322,3,4,8,2,17,13,4,20
Kerala Blast,8322,4,5,5,4,12,14,-2,20
NorthEast Un,8322,5,5,3,6,12,13,-1,18
FC Pune City,8322,6,4,4,6,13,18,-5,16
FC Goa,8322,7,4,4,6,11,16,-5,16
Chennaiyin,8322,8,3,5,6,13,19,-6,14
Mumbai City,8323,1,7,4,3,18,8,10,25
NorthEast Un,8323,2,7,2,5,16,10,6,23
FC Pune City,8323,3,6,3,5,16,15,1,21
Delhi Dynamo,8323,4,5,5,4,23,18,5,20
Kolkata,8323,5,3,8,3,16,17,-1,17
Kerala Blast,8323,6,4,4,6,12,20,-8,16
Chennaiyin,8323,7,3,6,5,14,19,-5,15
FC Goa,8323,8,3,4,7,9,17,-8,13
Mumbai City,8324,1,7,4,3,19,9,10,25
Kerala Blast,8324,2,6,3,5,12,15,-3,21
FC Goa,8324,3,6,2,6,15,18,-3,20
NorthEast Un,8324,4,5,4,5,11,10,1,19
Delhi Dynamo,8324,5,4,6,4,24,20,4,18
Kolkata,8324,6,4,6,4,17,16,1,18
Chennaiyin,8324,7,3,6,5,14,19,-5,15
FC Pune City,8324,8,4,3,7,13,18,-5,15
NorthEast Un,8325,1,7,2,5,13,10,3,23
Kolkata,8325,2,5,7,2,21,14,7,22
Mumbai City,8325,3,6,4,4,16,10,6,22
Delhi Dynamo,8325,4,5,6,3,25,17,8,21
Kerala Blast,8325,5,5,3,6,12,19,-7,18
Chennaiyin,8325,6,3,6,5,14,19,-5,15
FC Pune City,8325,7,4,3,7,15,21,-6,15
FC Goa,8325,8,3,5,6,11,17,-6,14
Mumbai City,8326,1,6,5,3,17,9,8,23
Kolkata,8326,2,5,7,2,23,16,7,22
NorthEast Un,8326,3,6,2,6,12,10,2,20
Chennaiyin,8326,4,5,5,4,15,17,-2,20
Delhi Dynamo,8326,5,4,6,4,22,20,2,18
Kerala Blast,8326,6,5,3,6,11,19,-8,18
FC Pune City,8326,7,4,4,6,15,18,-3,16
FC Goa,8326,8,4,2,8,13,19,-6,14
Delhi Dynamo,8327,1,7,5,2,25,14,11,26
Mumbai City,8327,2,6,4,4,16,10,6,22
Kolkata,8327,3,4,8,2,14,12,2,20
FC Pune City,8327,4,5,4,5,16,15,1,19
Kerala Blast,8327,5,5,3,6,11,18,-7,18
NorthEast Un,8327,6,5,2,7,10,11,-1,17
Chennaiyin,8327,7,4,5,5,14,18,-4,17
FC Goa,8327,8,3,3,8,8,16,-8,12
Delhi Dynamo,8328,1,6,6,2,25,15,10,24
Mumbai City,8328,2,6,5,3,17,9,8,23
Kolkata,8328,3,5,6,3,19,16,3,21
Kerala Blast,8328,4,5,4,5,12,18,-6,19
Chennaiyin,8328,5,4,5,5,18,21,-3,17
FC Goa,8328,6,5,2,7,12,17,-5,17
NorthEast Un,8328,7,4,3,7,12,15,-3,15
FC Pune City,8328,8,4,3,7,13,17,-4,15
Mumbai City,8329,1,6,5,3,16,8,8,23
Delhi Dynamo,8329,2,5,6,3,23,15,8,21
Kolkata,8329,3,5,6,3,19,17,2,21
NorthEast Un,8329,4,5,3,6,12,13,-1,18
Chennaiyin,8329,5,4,6,4,15,18,-3,18
FC Goa,8329,6,5,2,7,11,16,-5,17
FC Pune City,8329,7,4,4,6,14,17,-3,16
Kerala Blast,8329,8,4,4,6,13,19,-6,16
Delhi Dynamo,8330,1,7,5,2,28,17,11,26
Mumbai City,8330,2,6,4,4,17,10,7,22
Chennaiyin,8330,3,5,5,4,20,19,1,20
Kolkata,8330,4,4,7,3,16,15,1,19
Kerala Blast,8330,5,5,4,5,12,15,-3,19
NorthEast Un,8330,6,5,2,7,12,16,-4,17
FC Pune City,8330,7,4,3,7,14,19,-5,15
FC Goa,8330,8,4,2,8,12,20,-8,14
Delhi Dynamo,8331,1,6,6,2,28,18,10,24
Mumbai City,8331,2,6,4,4,17,10,7,22
Chennaiyin,8331,3,5,5,4,16,17,-1,20
Kerala Blast,8331,4,5,5,4,12,15,-3,20
FC Pune City,8331,5,5,3,6,15,17,-2,18
Kolkata,8331,6,3,7,4,15,16,-1,16
NorthEast Un,8331,7,4,4,6,11,13,-2,16
FC Goa,8331,8,4,2,8,12,20,-8,14
Mumbai City,8332,1,7,4,3,18,9,9,25
NorthEast Un,8332,2,6,2,6,13,11,2,20
Chennaiyin,8332,3,5,5,4,19,19,0,20
Kerala Blast,8332,4,5,4,5,11,15,-4,19
Delhi Dynamo,8332,5,4,6,4,22,18,4,18
FC Pune City,8332,6,5,3,6,14,15,-1,18
Kolkata,8332,7,3,7,4,14,16,-2,16
FC Goa,8332,8,4,3,7,10,18,-8,15
Delhi Dynamo,8333,1,6,6,2,28,17,11,24
Mumbai City,8333,2,6,5,3,18,10,8,23
Kolkata,8333,3,5,7,2,16,13,3,22
Kerala Blast,8333,4,5,4,5,11,14,-3,19
NorthEast Un,8333,5,5,2,7,14,13,1,17
FC Pune City,8333,6,4,4,6,13,16,-3,16
FC Goa,8333,7,4,3,7,9,17,-8,15
Chennaiyin,8333,8,3,5,6,13,22,-9,14
Mumbai City,8334,1,7,4,3,18,8,10,25
Delhi Dynamo,8334,2,6,5,3,25,16,9,23
FC Pune City,8334,3,6,3,5,16,14,2,21
NorthEast Un,8334,4,5,3,6,12,12,0,18
Kolkata,8334,5,3,8,3,14,15,-1,17
Kerala Blast,8334,6,4,5,5,10,16,-6,17
FC Goa,8334,7,4,3,7,12,19,-7,15
Chennaiyin,8334,8,3,5,6,15,22,-7,14
Mumbai City,8335,1,6,5,3,18,10,8,23
NorthEast Un,8335,2,6,3,5,14,9,5,21
Kolkata,8335,3,4,8,2,18,15,3,20
Delhi Dynamo,8335,4,4,7,3,24,20,4,19
Kerala Blast,8335,5,5,4,5,12,17,-5,19
Chennaiyin,8335,6,4,5,5,15,19,-4,17
FC Pune City,8335,7,4,4,6,13,16,-3,16
FC Goa,8335,8,3,4,7,11,19,-8,13
Mumbai City,8336,1,7,4,3,18,9,9,25
Delhi Dynamo,8336,2,5,5,4,25,20,5,20
NorthEast Un,8336,3,6,2,6,13,12,1,20
Kolkata,8336,4,4,7,3,16,16,0,19
FC Pune City,8336,5,5,3,6,15,17,-2,18
FC Goa,8336,6,5,2,7,13,16,-3,17
Chennaiyin,8336,7,4,5,5,14,18,-4,17
Kerala Blast,8336,8,4,4,6,12,18,-6,16
Delhi Dynamo,8337,1,7,5,2,27,15,12,26
Mumbai City,8337,2,6,4,4,17,10,7,22
Kolkata,8337,3,5,6,3,18,14,4,21
FC Pune City,8337,4,5,3,6,14,17,-3,18
Kerala Blast,8337,5,5,3,6,11,18,-7,18
Chennaiyin,8337,6,4,5,5,15,20,-5,17
FC Goa,8337,7,5,2,7,13,18,-5,17
NorthEast Un,8337,8,4,2,8,9,12,-3,14
Mumbai City,8338,1,7,4,3,19,10,9,25
Delhi Dynamo,8338,2,5,5,4,27,18,9,20
Kolkata,8338,3,4,7,3,18,16,2,19
NorthEast Un,8338,4,5,3,6,11,11,0,18
FC Pune City,8338,5,5,3,6,14,17,-3,18
Chennaiyin,8338,6,4,5,5,15,19,-4,17
Kerala Blast,8338,7,4,5,5,12,17,-5,17
FC Goa,8338,8,5,2,7,11,19,-8,17
Mumbai City,8339,1,7,4,3,19,10,9,25
Kolkata,8339,2,6,6,2,20,14,6,24
NorthEast Un,8339,3,6,3,5,17,13,4,21
Delhi Dynamo,8339,4,5,5,4,25,20,5,20
Kerala Blast,8339,5,5,3,6,14,20,-6,18
Chennaiyin,8339,6,3,7,4,14,18,-4,16
FC Pune City,8339,7,4,3,7,14,18,-4,15
FC Goa,8339,8,3,3,8,8,18,-10,12
Mumbai City,8340,1,6,4,4,17,10,7,22
Delhi Dynamo,8340,2,5,6,3,24,18,6,21
Kolkata,8340,3,4,8,2,19,16,3,20
NorthEast Un,8340,4,6,2,6,14,11,3,20
Chennaiyin,8340,5,4,6,4,16,19,-3,18
Kerala Blast,8340,6,5,3,6,13,17,-4,18
FC Pune City,8340,7,4,4,6,14,20,-6,16
FC Goa,8340,8,3,5,6,12,18,-6,14
Delhi Dynamo,8341,1,6,5,3,25,17,8,23
Mumbai City,8341,2,6,4,4,17,10,7,22
Kerala Blast,8341,3,5,4,5,15,19,-4,19
NorthEast Un,8341,4,5,3,6,14,13,1,18
FC Pune City,8341,5,5,3,6,17,19,-2,18
Kolkata,8341,5,4,6,4,17,19,-2,18
FC Goa,8341,7,5,2,7,19,19,0,17
Chennaiyin,8341,8,4,5,5,16,24,-8,17
Mumbai City,8342,1,6,5,3,19,11,8,23
Kolkata,8342,2,5,6,3,19,16,3,21
Delhi Dynamo,8342,3,4,8,2,26,19,7,20
NorthEast Un,8342,4,5,4,5,12,10,2,19
Kerala Blast,8342,5,5,4,5,13,17,-4,19
FC Goa,8342,6,5,3,6,14,18,-4,18
FC Pune City,8342,7,4,3,7,13,18,-5,15
Chennaiyin,8342,8,3,5,6,15,22,-7,14
Mumbai City,8343,1,7,4,3,18,8,10,25
Kerala Blast,8343,2,6,3,5,12,15,-3,21
NorthEast Un,8343,3,6,2,6,12,11,1,20
Delhi Dynamo,8343,4,4,6,4,23,19,4,18
Kolkata,8343,5,4,6,4,17,15,2,18
Chennaiyin,8343,6,4,6,4,16,19,-3,18
FC Goa,8343,7,4,4,6,13,18,-5,16
FC Pune City,8343,8,4,3,7,13,19,-6,15
Mumbai City,8344,1,7,4,3,18,9,9,25
Kerala Blast,8344,2,6,3,5,14,17,-3,21
Delhi Dynamo,8344,3,5,5,4,24,18,6,20
Chennaiyin,8344,4,5,5,4,21,20,1,20
FC Pune City,8344,5,5,4,5,15,16,-1,19
NorthEast Un,8344,6,5,2,7,12,15,-3,17
Kolkata,8344,7,3,7,4,15,16,-1,16
FC Goa,8344,8,4,2,8,12,20,-8,14
Delhi Dynamo,8345,1,6,5,3,26,17,9,23
Mumbai City,8345,2,6,4,4,18,11,7,22
Kolkata,8345,3,4,7,3,15,13,2,19
Kerala Blast,8345,4,5,4,5,11,16,-5,19
NorthEast Un,8345,5,5,3,6,11,11,0,18
FC Pune City,8345,6,4,5,5,13,15,-2,17
FC Goa,8345,7,5,2,7,13,16,-3,17
Chennaiyin,8345,8,3,6,5,14,22,-8,15
Delhi Dynamo,8346,1,6,5,3,26,17,9,23
Mumbai City,8346,2,6,4,4,16,9,7,22
FC Pune City,8346,3,6,3,5,17,16,1,21
Chennaiyin,8346,4,5,5,4,16,17,-1,20
Kolkata,8346,5,4,7,3,16,15,1,19
NorthEast Un,8346,6,5,3,6,11,12,-1,18
Kerala Blast,8346,7,4,4,6,10,17,-7,16
FC Goa,8346,8,3,3,8,9,18,-9,12
Mumbai City,8347,1,6,5,3,17,9,8,23
Delhi Dynamo,8347,2,4,7,3,22,17,5,19
Kolkata,8347,3,4,7,3,17,15,2,19
Kerala Blast,8347,4,5,4,5,11,15,-4,19
NorthEast Un,8347,5,5,3,6,11,10,1,18
FC Pune City,8347,6,5,3,6,14,17,-3,18
Chennaiyin,8347,7,4,5,5,14,18,-4,17
FC Goa,8347,8,4,4,6,10,15,-5,16
Mumbai City,8348,1,6,5,3,18,10,8,23
NorthEast Un,8348,2,6,3,5,15,11,4,21
Kerala Blast,8348,3,6,3,5,16,17,-1,21
Delhi Dynamo,8348,4,4,7,3,25,20,5,19
FC Pune City,8348,5,5,3,6,15,20,-5,18
FC Goa,8348,6,5,2,7,12,15,-3,17
Chennaiyin,8348,7,4,5,5,14,19,-5,17
Kolkata,8348,8,3,6,5,15,18,-3,15
Mumbai City,8349,1,7,4,3,20,9,11,25
Delhi Dynamo,8349,2,6,5,3,25,19,6,23
FC Pune City,8349,3,5,4,5,14,15,-1,19
Kolkata,8349,4,3,9,2,13,12,1,18
NorthEast Un,8349,5,5,3,6,12,12,0,18
Kerala Blast,8349,6,4,5,5,11,16,-5,17
FC Goa,8349,7,4,3,7,11,16,-5,15
Chennaiyin,8349,8,3,5,6,14,21,-7,14
Mumbai City,8350,1,7,4,3,18,8,10,25
Kolkata,8350,2,5,6,3,15,13,2,21
Kerala Blast,8350,3,6,3,5,16,17,-1,21
Delhi Dynamo,8350,4,5,5,4,24,18,6,20
NorthEast Un,8350,5,6,2,6,15,15,0,20
FC Goa,8350,6,5,2,7,11,17,-6,17
FC Pune City,8350,7,4,3,7,13,17,-4,15
Chennaiyin,8350,8,3,5,6,14,21,-7,14
Mumbai City,8351,1,7,4,3,18,8,10,25
Kerala Blast,8351,2,7,3,4,16,15,1,24
Delhi Dynamo,8351,3,4,7,3,25,20,5,19
Kolkata,8351,4,4,6,4,15,15,0,18
NorthEast Un,8351,5,5,3,6,13,13,0,18
Chennaiyin,8351,6,4,5,5,14,19,-5,17
FC Pune City,8351,7,4,3,7,15,20,-5,15
FC Goa,8351,8,4,3,7,11,17,-6,15
Mumbai City,8352,1,7,4,3,19,10,9,25
NorthEast Un,8352,2,6,3,5,14,12,2,21
Delhi Dynamo,8352,3,5,5,4,31,23,8,20
FC Pune City,8352,4,5,4,5,13,14,-1,19
Kolkata,8352,5,3,9,2,15,14,1,18
Kerala Blast,8352,6,4,5,5,10,15,-5,17
FC Goa,8352,7,4,3,7,14,22,-8,15
Chennaiyin,8352,8,3,5,6,15,21,-6,14
Delhi Dynamo,8353,1,7,5,2,30,16,14,26
Mumbai City,8353,2,6,4,4,17,11,6,22
Kerala Blast,8353,3,6,3,5,15,16,-1,21
Kolkata,8353,4,4,7,3,18,17,1,19
Chennaiyin,8353,5,3,7,4,15,19,-4,16
FC Pune City,8353,5,4,4,6,15,19,-4,16
NorthEast Un,8353,7,4,3,7,12,16,-4,15
FC Goa,8353,8,4,3,7,10,18,-8,15
Delhi Dynamo,8354,1,7,5,2,26,16,10,26
Mumbai City,8354,2,6,4,4,17,10,7,22
Kerala Blast,8354,3,5,4,5,11,15,-4,19
Kolkata,8354,4,4,6,4,15,16,-1,18
FC Pune City,8354,5,5,3,6,14,16,-2,18
FC Goa,8354,6,5,2,7,11,15,-4,17
NorthEast Un,8354,7,4,4,6,11,12,-1,16
Chennaiyin,8354,8,3,6,5,13,18,-5,15
Delhi Dynamo,8355,1,6,6,2,25,16,9,24
Mumbai City,8355,2,6,5,3,17,9,8,23
Kolkata,8355,3,5,6,3,16,14,2,21
FC Pune City,8355,4,5,3,6,16,17,-1,18
Kerala Blast,8355,5,5,3,6,12,19,-7,18
FC Goa,8355,6,5,2,7,12,15,-3,17
Chennaiyin,8355,7,4,5,5,14,19,-5,17
NorthEast Un,8355,8,4,2,8,11,14,-3,14
Mumbai City,8356,1,7,4,3,19,9,10,25
Delhi Dynamo,8356,2,5,6,3,25,19,6,21
Kolkata,8356,3,5,6,3,19,15,4,21
Kerala Blast,8356,4,6,3,5,14,17,-3,21
Chennaiyin,8356,5,3,7,4,15,19,-4,16
FC Goa,8356,6,4,4,6,10,15,-5,16
NorthEast Un,8356,7,4,3,7,12,14,-2,15
FC Pune City,8356,8,4,3,7,13,19,-6,15
Mumbai City,8357,1,7,4,3,18,9,9,25
Kerala Blast,8357,2,6,4,4,12,14,-2,22
Delhi Dynamo,8357,3,4,7,3,24,18,6,19
Kolkata,8357,4,4,7,3,16,14,2,19
NorthEast Un,8357,5,5,3,6,13,12,1,18
FC Pune City,8357,6,4,4,6,12,16,-4,16
FC Goa,8357,7,4,4,6,9,14,-5,16
Chennaiyin,8357,8,3,5,6,13,20,-7,14
Mumbai City,8358,1,7,4,3,17,8,9,25
NorthEast Un,8358,2,6,3,5,12,10,2,21
Kerala Blast,8358,3,6,3,5,14,17,-3,21
Delhi Dynamo,8358,4,5,5,4,22,16,6,20
FC Pune City,8358,5,5,3,6,14,16,-2,18
Chennaiyin,8358,6,3,7,4,14,18,-4,16
Kolkata,8358,7,3,6,5,16,20,-4,15
FC Goa,8358,8,4,3,7,14,18,-4,15
Delhi Dynamo,8359,1,6,6,2,26,17,9,24
Mumbai City,8359,2,6,4,4,16,9,7,22
Kolkata,8359,3,5,7,2,17,13,4,22
Kerala Blast,8359,4,5,4,5,13,14,-1,19
NorthEast Un,8359,5,5,3,6,12,12,0,18
Chennaiyin,8359,6,4,5,5,14,18,-4,17
FC Pune City,8359,7,4,3,7,13,20,-7,15
FC Goa,8359,8,4,2,8,10,18,-8,14
Mumbai City,8360,1,6,5,3,17,9,8,23
Kerala Blast,8360,2,6,4,4,16,17,-1,22
Delhi Dynamo,8360,3,4,6,4,22,17,5,18
FC Pune City,8360,4,5,3,6,16,18,-2,18
FC Goa,8360,5,5,3,6,12,15,-3,18
Kolkata,8360,6,3,8,3,17,17,0,17
Chennaiyin,8360,7,4,5,5,18,20,-2,17
NorthEast Un,8360,8,5,2,7,11,16,-5,17
Mumbai City,8361,1,7,4,3,18,9,9,25
Kerala Blast,8361,2,5,5,4,12,14,-2,20
Kolkata,8361,3,4,6,4,17,16,1,18
NorthEast Un,8361,4,5,3,6,13,12,1,18
Chennaiyin,8361,5,4,6,4,17,20,-3,18
FC Goa,8361,6,5,3,6,13,17,-4,18
Delhi Dynamo,8361,7,4,5,5,24,21,3,17
FC Pune City,8361,8,4,4,6,14,19,-5,16
Mumbai City,8362,1,6,4,4,17,10,7,22
Delhi Dynamo,8362,2,5,6,3,25,18,7,21
Kerala Blast,8362,3,6,3,5,14,17,-3,21
Chennaiyin,8362,4,5,5,4,17,17,0,20
NorthEast Un,8362,5,6,2,6,13,13,0,20
FC Pune City,8362,6,5,3,6,17,18,-1,18
Kolkata,8362,7,3,6,5,16,20,-4,15
FC Goa,8362,8,4,3,7,11,17,-6,15
Mumbai City,8363,1,6,5,3,17,9,8,23
Kolkata,8363,2,5,7,2,20,14,6,22
Delhi Dynamo,8363,3,5,6,3,24,17,7,21
FC Pune City,8363,4,5,3,6,17,20,-3,18
NorthEast Un,8363,5,5,3,6,12,15,-3,18
Kerala Blast,8363,6,5,3,6,14,18,-4,18
Chennaiyin,8363,7,3,7,4,15,19,-4,16
FC Goa,8363,8,3,4,7,9,16,-7,13
Mumbai City,8364,1,7,4,3,20,8,12,25
Delhi Dynamo,8364,2,6,5,3,27,19,8,23
Kerala Blast,8364,3,5,5,4,12,15,-3,20
Kolkata,8364,4,3,8,3,17,17,0,17
FC Pune City,8364,5,4,5,5,14,16,-2,17
NorthEast Un,8364,6,4,4,6,11,13,-2,16
Chennaiyin,8364,7,3,6,5,15,20,-5,15
FC Goa,8364,8,4,3,7,14,22,-8,15
Mumbai City,8365,1,7,4,3,20,10,10,25
Kolkata,8365,2,6,6,2,18,14,4,24
Delhi Dynamo,8365,3,4,7,3,25,20,5,19
NorthEast Un,8365,4,5,4,5,12,11,1,19
Kerala Blast,8365,5,5,4,5,11,15,-4,19
FC Pune City,8365,6,4,3,7,12,16,-4,15
Chennaiyin,8365,7,3,6,5,14,19,-5,15
FC Goa,8365,8,3,4,7,12,19,-7,13
Mumbai City,8366,1,7,4,3,18,9,9,25
NorthEast Un,8366,2,7,2,5,16,10,6,23
FC Pune City,8366,3,5,4,5,15,15,0,19
Kerala Blast,8366,4,5,4,5,12,16,-4,19
FC Goa,8366,5,5,3,6,13,15,-2,18
Delhi Dynamo,8366,6,4,5,5,24,21,3,17
Kolkata,8366,7,3,7,4,13,16,-3,16
Chennaiyin,8366,8,3,5,6,13,22,-9,14
Delhi Dynamo,8367,1,6,5,3,24,17,7,23
Mumbai City,8367,2,6,4,4,17,10,7,22
Kolkata,8367,3,5,7,2,19,14,5,22
FC Pune City,8367,4,5,4,5,14,15,-1,19
NorthEast Un,8367,5,5,3,6,12,11,1,18
Kerala Blast,8367,6,5,3,6,11,17,-6,18
Chennaiyin,8367,7,3,7,4,15,19,-4,16
FC Goa,8367,8,3,3,8,9,18,-9,12
Mumbai City,8368,1,7,4,3,20,9,11,25
Delhi Dynamo,8368,2,5,6,3,25,19,6,21
Kolkata,8368,3,4,7,3,19,17,2,19
FC Pune City,8368,4,5,4,5,13,14,-1,19
Kerala Blast,8368,5,5,3,6,14,20,-6,18
NorthEast Un,8368,6,4,4,6,12,13,-1,16
Chennaiyin,8368,7,3,7,4,13,17,-4,16
FC Goa,8368,8,4,3,7,11,18,-7,15
Mumbai City,8369,1,7,4,3,21,8,13,25
Kolkata,8369,2,5,7,2,20,14,6,22
Kerala Blast,8369,3,6,4,4,14,16,-2,22
Chennaiyin,8369,4,5,5,4,16,17,-1,20
Delhi Dynamo,8369,5,4,6,4,25,24,1,18
NorthEast Un,8369,6,4,3,7,14,17,-3,15
FC Pune City,8369,7,4,3,7,12,18,-6,15
FC Goa,8369,8,4,2,8,11,19,-8,14
NorthEast Un,8370,1,7,2,5,17,10,7,23
Mumbai City,8370,2,6,4,4,18,11,7,22
Delhi Dynamo,8370,3,5,5,4,25,21,4,20
Kolkata,8370,4,4,8,2,14,12,2,20
FC Goa,8370,5,5,3,6,12,16,-4,18
Kerala Blast,8370,6,4,5,5,11,16,-5,17
FC Pune City,8370,7,4,4,6,13,16,-3,16
Chennaiyin,8370,8,3,5,6,14,22,-8,14
Mumbai City,8371,1,6,5,3,17,9,8,23
Kolkata,8371,2,4,8,2,19,16,3,20
Kerala Blast,8371,3,5,5,4,12,15,-3,20
Delhi Dynamo,8371,4,4,7,3,24,18,6,19
Chennaiyin,8371,5,4,6,4,16,18,-2,18
FC Pune City,8371,6,4,5,5,15,17,-2,17
NorthEast Un,8371,7,5,2,7,11,13,-2,17
FC Goa,8371,8,3,4,7,11,19,-8,13
Mumbai City,8372,1,7,4,3,17,8,9,25
Kerala Blast,8372,2,6,4,4,14,16,-2,22
Delhi Dynamo,8372,3,5,5,4,23,18,5,20
Kolkata,8372,4,4,7,3,16,15,1,19
NorthEast Un,8372,5,5,3,6,12,11,1,18
FC Goa,8372,6,5,2,7,15,17,-2,17
FC Pune City,8372,7,4,4,6,13,16,-3,16
Chennaiyin,8372,8,3,5,6,13,22,-9,14
Mumbai City,8373,1,7,4,3,18,8,10,25
Kolkata,8373,2,5,7,2,20,13,7,22
Delhi Dynamo,8373,3,5,6,3,22,16,6,21
FC Pune City,8373,4,4,5,5,14,16,-2,17
Chennaiyin,8373,5,4,5,5,15,19,-4,17
Kerala Blast,8373,6,4,5,5,11,17,-6,17
NorthEast Un,8373,7,4,3,7,10,13,-3,15
FC Goa,8373,8,4,3,7,10,18,-8,15
Mumbai City,8374,1,6,4,4,16,9,7,22
Delhi Dynamo,8374,2,5,6,3,23,16,7,21
Kolkata,8374,3,5,6,3,21,15,6,21
NorthEast Un,8374,4,5,4,5,13,11,2,19
Kerala Blast,8374,5,5,4,5,12,17,-5,19
Chennaiyin,8374,6,4,5,5,14,19,-5,17
FC Goa,8374,7,5,2,7,10,15,-5,17
FC Pune City,8374,8,4,3,7,14,21,-7,15
Mumbai City,8375,1,7,4,3,18,9,9,25
Delhi Dynamo,8375,2,6,5,3,28,18,10,23
Kolkata,8375,3,4,7,3,17,17,0,19
FC Pune City,8375,4,5,4,5,15,15,0,19
NorthEast Un,8375,5,5,3,6,13,14,-1,18
Kerala Blast,8375,6,4,4,6,11,17,-6,16
Chennaiyin,8375,7,3,6,5,15,20,-5,15
FC Goa,8375,8,4,3,7,12,19,-7,15
Mumbai City,8376,1,7,4,3,19,9,10,25
Kolkata,8376,2,6,6,2,23,13,10,24
Delhi Dynamo,8376,3,5,6,3,25,19,6,21
NorthEast Un,8376,4,5,3,6,13,13,0,18
FC Pune City,8376,5,5,3,6,14,18,-4,18
Kerala Blast,8376,6,5,3,6,11,19,-8,18
Chennaiyin,8376,7,4,5,5,15,19,-4,17
FC Goa,8376,8,3,2,9,9,19,-10,11
Mumbai City,8377,1,7,4,3,18,8,10,25
Delhi Dynamo,8377,2,5,6,3,22,16,6,21
Kolkata,8377,3,5,6,3,19,14,5,21
Kerala Blast,8377,4,6,3,5,12,15,-3,21
FC Goa,8377,5,5,3,6,13,17,-4,18
NorthEast Un,8377,6,4,3,7,10,12,-2,15
Chennaiyin,8377,7,3,6,5,17,22,-5,15
FC Pune City,8377,8,4,3,7,12,19,-7,15
Kerala Blast,8378,1,7,3,4,16,13,3,24
Mumbai City,8378,2,6,5,3,18,10,8,23
Delhi Dynamo,8378,3,5,7,2,25,17,8,22
FC Pune City,8378,4,5,3,6,13,15,-2,18
Kolkata,8378,5,3,7,4,13,16,-3,16
Chennaiyin,8378,6,3,7,4,14,18,-4,16
NorthEast Un,8378,7,4,3,7,9,13,-4,15
FC Goa,8378,8,3,5,6,10,16,-6,14
Mumbai City,8379,1,7,4,3,18,9,9,25
Delhi Dynamo,8379,2,6,5,3,26,16,10,23
Kolkata,8379,3,4,7,3,16,15,1,19
Chennaiyin,8379,4,4,6,4,16,19,-3,18
NorthEast Un,8379,5,5,2,7,12,12,0,17
Kerala Blast,8379,6,4,5,5,11,17,-6,17
FC Pune City,8379,7,4,4,6,14,17,-3,16
FC Goa,8379,8,4,3,7,12,20,-8,15
Mumbai City,8380,1,7,4,3,17,8,9,25
Kerala Blast,8380,2,6,4,4,13,14,-1,22
Delhi Dynamo,8380,3,5,6,3,25,18,7,21
FC Goa,8380,4,5,3,6,17,16,1,18
Kolkata,8380,5,4,6,4,15,16,-1,18
Chennaiyin,8380,6,4,5,5,15,22,-7,17
FC Pune City,8380,7,4,4,6,13,17,-4,16
NorthEast Un,8380,8,4,2,8,11,15,-4,14
Delhi Dynamo,8381,1,7,5,2,26,16,10,26
Mumbai City,8381,2,6,4,4,16,9,7,22
Kolkata,8381,3,4,7,3,17,14,3,19
FC Pune City,8381,4,5,4,5,14,15,-1,19
Kerala Blast,8381,5,5,3,6,11,18,-7,18
NorthEast Un,8381,6,5,2,7,11,12,-1,17
FC Goa,8381,7,5,2,7,12,17,-5,17
Chennaiyin,8381,8,3,5,6,13,19,-6,14
NorthEast Un,8382,1,7,2,5,12,9,3,23
Mumbai City,8382,2,6,4,4,16,12,4,22
Delhi Dynamo,8382,3,5,6,3,27,17,10,21
FC Pune City,8382,4,6,3,5,15,14,1,21
Kerala Blast,8382,5,5,3,6,11,16,-5,18
Chennaiyin,8382,6,4,5,5,14,18,-4,17
Kolkata,8382,7,3,7,4,15,17,-2,16
FC Goa,8382,8,3,4,7,11,18,-7,13
Delhi Dynamo,8383,1,7,5,2,27,14,13,26
Mumbai City,8383,2,6,4,4,16,10,6,22
Kerala Blast,8383,3,6,4,4,13,15,-2,22
Kolkata,8383,4,4,6,4,17,17,0,18
Chennaiyin,8383,5,4,6,4,18,20,-2,18
FC Pune City,8383,6,5,3,6,15,17,-2,18
NorthEast Un,8383,7,4,3,7,10,13,-3,15
FC Goa,8383,8,3,3,8,11,21,-10,12
Delhi Dynamo,8384,1,6,6,2,26,17,9,24
Mumbai City,8384,2,6,5,3,17,9,8,23
Kerala Blast,8384,3,6,4,4,16,14,2,22
Kolkata,8384,4,4,8,2,15,13,2,20
Chennaiyin,8384,5,4,6,4,17,18,-1,18
FC Pune City,8384,6,4,3,7,12,18,-6,15
NorthEast Un,8384,7,4,2,8,11,18,-7,14
FC Goa,8384,8,3,4,7,9,16,-7,13
Delhi Dynamo,8385,1,7,5,2,27,16,11,26
Mumbai City,8385,2,6,4,4,16,10,6,22
Kerala Blast,8385,3,6,4,4,15,14,1,22
Kolkata,8385,4,4,6,4,17,16,1,18
NorthEast Un,8385,5,5,3,6,10,10,0,18
Chennaiyin,8385,6,4,5,5,16,18,-2,17
FC Pune City,8385,7,4,3,7,12,20,-8,15
FC Goa,8385,8,4,2,8,12,21,-9,14
Mumbai City,8386,1,7,4,3,17,8,9,25
Kolkata,8386,2,5,6,3,18,15,3,21
Kerala Blast,8386,3,6,3,5,15,16,-1,21
FC Goa,8386,4,6,2,6,14,17,-3,20
Delhi Dynamo,8386,5,4,5,5,22,19,3,17
Chennaiyin,8386,6,4,5,5,17,20,-3,17
NorthEast Un,8386,7,5,2,7,12,15,-3,17
FC Pune City,8386,8,4,3,7,12,17,-5,15
Mumbai City,8387,1,7,4,3,19,9,10,25
Kerala Blast,8387,2,7,3,4,13,14,-1,24
Delhi Dynamo,8387,3,5,6,3,25,19,6,21
Kolkata,8387,4,3,8,3,15,15,0,17
Chennaiyin,8387,5,4,5,5,15,19,-4,17
FC Pune City,8387,6,4,4,6,13,16,-3,16
NorthEast Un,8387,7,4,3,7,12,14,-2,15
FC Goa,8387,8,4,3,7,11,17,-6,15
Mumbai City,8388,1,6,5,3,17,9,8,23
FC Goa,8388,2,6,2,6,13,14,-1,20
Delhi Dynamo,8388,3,4,7,3,23,17,6,19
FC Pune City,8388,4,5,4,5,15,15,0,19
Kerala Blast,8388,5,5,4,5,13,18,-5,19
NorthEast Un,8388,6,5,3,6,14,13,1,18
Kolkata,8388,7,3,8,3,14,15,-1,17
Chennaiyin,8388,8,3,5,6,14,22,-8,14
Mumbai City,8389,1,7,4,3,18,8,10,25
Kolkata,8389,2,5,6,3,16,13,3,21
Kerala Blast,8389,3,6,3,5,13,16,-3,21
Delhi Dynamo,8389,4,4,7,3,24,19,5,19
NorthEast Un,8389,5,5,3,6,13,13,0,18
Chennaiyin,8389,6,4,5,5,18,20,-2,17
FC Pune City,8389,7,4,3,7,13,18,-5,15
FC Goa,8389,8,4,3,7,11,19,-8,15
Delhi Dynamo,8390,1,6,6,2,26,17,9,24
Mumbai City,8390,2,6,5,3,18,10,8,23
Chennaiyin,8390,3,5,5,4,20,20,0,20
Kerala Blast,8390,4,5,5,4,14,17,-3,20
FC Pune City,8390,5,5,3,6,16,17,-1,18
Kolkata,8390,6,3,8,3,14,15,-1,17
NorthEast Un,8390,7,4,3,7,15,17,-2,15
FC Goa,8390,8,3,3,8,9,19,-10,12
Mumbai City,8391,1,6,4,4,17,10,7,22
Delhi Dynamo,8391,2,5,5,4,24,20,4,20
Chennaiyin,8391,3,5,5,4,17,18,-1,20
Kerala Blast,8391,4,5,5,4,14,17,-3,20
Kolkata,8391,5,4,7,3,18,18,0,19
NorthEast Un,8391,6,5,2,7,12,13,-1,17
FC Goa,8391,7,5,2,7,14,16,-2,17
FC Pune City,8391,8,4,4,6,15,19,-4,16
Mumbai City,8392,1,7,4,3,18,8,10,25
Delhi Dynamo,8392,2,6,5,3,29,20,9,23
Kolkata,8392,3,5,7,2,19,15,4,22
Kerala Blast,8392,4,5,4,5,11,14,-3,19
NorthEast Un,8392,5,5,3,6,12,12,0,18
FC Pune City,8392,6,4,4,6,13,17,-4,16
Chennaiyin,8392,7,3,5,6,15,21,-6,14
FC Goa,8392,8,4,2,8,15,25,-10,14
Delhi Dynamo,8393,1,6,5,3,26,17,9,23
Mumbai City,8393,2,6,4,4,16,9,7,22
NorthEast Un,8393,3,6,2,6,14,12,2,20
Kolkata,8393,4,4,7,3,17,16,1,19
Kerala Blast,8393,5,5,4,5,14,18,-4,19
Chennaiyin,8393,6,4,5,5,15,19,-4,17
FC Goa,8393,7,5,2,7,13,18,-5,17
FC Pune City,8393,8,4,3,7,12,18,-6,15
Delhi Dynamo,8394,1,6,6,2,23,14,9,24
Kerala Blast,8394,2,7,3,4,14,13,1,24
Mumbai City,8394,3,6,5,3,16,8,8,23
FC Pune City,8394,4,5,3,6,15,15,0,18
Chennaiyin,8394,5,4,5,5,16,18,-2,17
Kolkata,8394,6,3,7,4,14,17,-3,16
FC Goa,8394,7,4,3,7,10,16,-6,15
NorthEast Un,8394,8,4,2,8,9,16,-7,14
Mumbai City,8395,1,7,4,3,19,9,10,25
NorthEast Un,8395,2,7,2,5,17,11,6,23
Kolkata,8395,3,5,7,2,18,14,4,22
Delhi Dynamo,8395,4,5,5,4,25,21,4,20
FC Pune City,8395,5,5,3,6,14,17,-3,18
Chennaiyin,8395,6,4,5,5,15,19,-4,17
Kerala Blast,8395,7,4,4,6,14,20,-6,16
FC Goa,8395,8,3,2,9,9,20,-11,11
Mumbai City,8396,1,7,4,3,20,10,10,25
Kerala Blast,8396,2,6,3,5,12,15,-3,21
Delhi Dynamo,8396,3,5,5,4,24,19,5,20
Kolkata,8396,4,4,7,3,15,14,1,19
NorthEast Un,8396,5,5,3,6,10,10,0,18
FC Pune City,8396,6,5,3,6,13,15,-2,18
Chennaiyin,8396,7,3,7,4,13,17,-4,16
FC Goa,8396,8,3,4,7,8,15,-7,13
Delhi Dynamo,8397,1,6,5,3,25,17,8,23
Mumbai City,8397,2,6,4,4,16,9,7,22
Kolkata,8397,3,5,6,3,16,16,0,21
Kerala Blast,8397,4,5,4,5,14,17,-3,19
NorthEast Un,8397,5,5,2,7,14,15,-1,17
Chennaiyin,8397,6,4,5,5,15,19,-4,17
FC Goa,8397,7,5,2,7,14,18,-4,17
FC Pune City,8397,8,4,4,6,13,16,-3,16
Mumbai City,8398,1,7,4,3,18,9,9,25
Delhi Dynamo,8398,2,6,5,3,26,17,9,23
Chennaiyin,8398,3,5,5,4,19,18,1,20
Kerala Blast,8398,4,5,5,4,14,16,-2,20
Kolkata,8398,5,3,8,3,16,16,0,17
FC Pune City,8398,6,4,4,6,14,18,-4,16
NorthEast Un,8398,7,4,3,7,11,14,-3,15
FC Goa,8398,8,4,2,8,11,21,-10,14
Delhi Dynamo,8399,1,6,5,3,24,16,8,23
Mumbai City,8399,2,6,4,4,16,9,7,22
Kolkata,8399,3,4,8,2,17,15,2,20
Chennaiyin,8399,4,5,5,4,15,17,-2,20
Kerala Blast,8399,5,5,4,5,11,18,-7,19
FC Pune City,8399,6,5,3,6,17,16,1,18
FC Goa,8399,7,4,3,7,11,17,-6,15
NorthEast Un,8399,8,4,2,8,9,12,-3,14
Mumbai City,8400,1,7,4,3,17,8,9,25
Delhi Dynamo,8400,2,6,5,3,28,15,13,23
Chennaiyin,8400,3,5,5,4,19,19,0,20
Kolkata,8400,4,4,7,3,16,15,1,19
Kerala Blast,8400,5,5,4,5,12,16,-4,19
FC Pune City,8400,6,5,3,6,15,17,-2,18
NorthEast Un,8400,7,4,3,7,11,16,-5,15
FC Goa,8400,8,3,3,8,10,22,-12,12
Mumbai City,8401,1,7,4,3,17,8,9,25
Delhi Dynamo,8401,2,5,6,3,23,16,7,21
Kerala Blast,8401,3,6,3,5,12,15,-3,21
Chennaiyin,8401,4,5,5,4,17,17,0,20
Kolkata,8401,5,4,6,4,17,17,0,18
FC Pune City,8401,6,5,3,6,16,18,-2,18
FC Goa,8401,7,4,3,7,9,17,-8,15
NorthEast Un,8401,8,4,2,8,10,13,-3,14
Delhi Dynamo,8402,1,7,5,2,30,15,15,26
Mumbai City,8402,2,6,4,4,16,13,3,22
Kerala Blast,8402,3,5,4,5,13,17,-4,19
NorthEast Un,8402,4,5,3,6,12,12,0,18
Kolkata,8402,5,4,6,4,15,17,-2,18
FC Pune City,8402,6,4,4,6,14,17,-3,16
Chennaiyin,8402,7,3,7,4,14,18,-4,16
FC Goa,8402,8,4,3,7,12,17,-5,15
Delhi Dynamo,8403,1,6,6,2,26,15,11,24
Mumbai City,8403,2,6,4,4,16,10,6,22
Kerala Blast,8403,3,6,4,4,12,13,-1,22
Chennaiyin,8403,4,5,5,4,20,20,0,20
Kolkata,8403,5,4,7,3,18,14,4,19
FC Pune City,8403,6,4,4,6,13,19,-6,16
NorthEast Un,8403,7,4,3,7,12,17,-5,15
FC Goa,8403,8,3,3,8,9,18,-9,12
Delhi Dynamo,8404,1,6,5,3,27,18,9,23
Mumbai City,8404,2,6,4,4,17,10,7,22
Kerala Blast,8404,3,6,4,4,14,13,1,22
NorthEast Un,8404,4,6,3,5,14,10,4,21
Kolkata,8404,5,4,7,3,17,16,1,19
Chennaiyin,8404,6,3,6,5,13,19,-6,15
FC Pune City,8404,7,4,3,7,14,21,-7,15
FC Goa,8404,8,3,4,7,9,18,-9,13
Mumbai City,8405,1,7,4,3,17,8,9,25
Delhi Dynamo,8405,2,6,5,3,26,15,11,23
Kolkata,8405,3,5,6,3,17,13,4,21
FC Pune City,8405,4,5,3,6,13,15,-2,18
Kerala Blast,8405,5,5,3,6,12,18,-6,18
Chennaiyin,8405,6,4,5,5,17,19,-2,17
NorthEast Un,8405,7,5,2,7,12,16,-4,17
FC Goa,8405,8,4,2,8,10,20,-10,14
Mumbai City,8406,1,6,5,3,16,8,8,23
NorthEast Un,8406,2,6,3,5,14,11,3,21
FC Pune City,8406,3,5,4,5,17,16,1,19
Delhi Dynamo,8406,4,4,6,4,23,19,4,18
Kerala Blast,8406,5,5,3,6,12,20,-8,18
Kolkata,8406,6,3,8,3,17,17,0,17
Chennaiyin,8406,7,3,7,4,14,18,-4,16
FC Goa,8406,8,4,4,6,13,17,-4,16
Mumbai City,8407,1,7,4,3,18,9,9,25
Kolkata,8407,2,5,6,3,21,16,5,21
Delhi Dynamo,8407,3,5,5,4,25,18,7,20
NorthEast Un,8407,4,6,2,6,14,13,1,20
FC Pune City,8407,5,5,4,5,16,14,2,19
Chennaiyin,8407,6,4,5,5,17,21,-4,17
Kerala Blast,8407,7,4,4,6,9,19,-10,16
FC Goa,8407,8,4,2,8,11,21,-10,14
Delhi Dynamo,8408,1,7,5,2,26,14,12,26
Kerala Blast,8408,2,7,3,4,15,14,1,24
Mumbai City,8408,3,6,4,4,16,11,5,22
Kolkata,8408,4,4,6,4,17,16,1,18
Chennaiyin,8408,5,4,6,4,16,19,-3,18
NorthEast Un,8408,6,4,3,7,10,13,-3,15
FC Pune City,8408,7,4,3,7,12,18,-6,15
FC Goa,8408,8,4,2,8,10,17,-7,14
Mumbai City,8409,1,6,4,4,18,11,7,22
Delhi Dynamo,8409,2,5,6,3,25,19,6,21
Kolkata,8409,3,4,7,3,17,16,1,19
Kerala Blast,8409,4,5,4,5,14,17,-3,19
Chennaiyin,8409,5,4,6,4,16,19,-3,18
NorthEast Un,8409,6,5,2,7,13,14,-1,17
FC Pune City,8409,7,4,5,5,15,17,-2,17
FC Goa,8409,8,4,4,6,11,16,-5,16
Mumbai City,8410,1,6,4,4,18,11,7,22
Kolkata,8410,2,5,6,3,18,15,3,21
Delhi Dynamo,8410,3,5,5,4,25,21,4,20
NorthEast Un,8410,4,6,2,6,15,13,2,20
Chennaiyin,8410,5,5,5,4,17,18,-1,20
FC Goa,8410,6,5,2,7,10,15,-5,17
FC Pune City,8410,7,4,4,6,15,19,-4,16
Kerala Blast,8410,8,4,4,6,12,18,-6,16
Mumbai City,8411,1,6,4,4,17,10,7,22
Delhi Dynamo,8411,2,5,6,3,24,17,7,21
Kolkata,8411,3,5,6,3,19,16,3,21
Chennaiyin,8411,4,4,6,4,18,19,-1,18
FC Pune City,8411,5,5,3,6,13,16,-3,18
NorthEast Un,8411,6,4,5,5,14,14,0,17
FC Goa,8411,7,5,2,7,11,18,-7,17
Kerala Blast,8411,8,4,4,6,13,19,-6,16
Mumbai City,8412,1,6,5,3,17,9,8,23
Delhi Dynamo,8412,2,5,7,2,26,16,10,22
Kolkata,8412,3,5,6,3,18,15,3,21
Kerala Blast,8412,4,5,4,5,13,16,-3,19
FC Pune City,8412,5,5,3,6,14,18,-4,18
Chennaiyin,8412,6,4,5,5,16,19,-3,17
NorthEast Un,8412,7,4,3,7,10,15,-5,15
FC Goa,8412,8,4,3,7,12,18,-6,15
Mumbai City,8413,1,7,4,3,18,9,9,25
Delhi Dynamo,8413,2,5,5,4,25,19,6,20
Kolkata,8413,3,4,8,2,16,14,2,20
Kerala Blast,8413,4,5,5,4,12,15,-3,20
NorthEast Un,8413,5,4,4,6,12,13,-1,16
FC Pune City,8413,6,4,4,6,14,17,-3,16
Chennaiyin,8413,7,3,7,4,13,17,-4,16
FC Goa,8413,8,4,3,7,10,16,-6,15
Delhi Dynamo,8414,1,6,6,2,26,16,10,24
Mumbai City,8414,2,6,5,3,17,9,8,23
Kolkata,8414,3,4,8,2,17,12,5,20
NorthEast Un,8414,4,6,2,6,13,12,1,20
FC Pune City,8414,5,5,4,5,14,15,-1,19
FC Goa,8414,6,4,3,7,9,16,-7,15
Kerala Blast,8414,7,4,3,7,11,21,-10,15
Chennaiyin,8414,8,3,5,6,13,19,-6,14
Mumbai City,8415,1,7,4,3,19,9,10,25
NorthEast Un,8415,2,5,4,5,15,13,2,19
Kolkata,8415,3,4,7,3,16,15,1,19
FC Pune City,8415,4,5,4,5,14,15,-1,19
Delhi Dynamo,8415,5,4,6,4,22,19,3,18
Kerala Blast,8415,6,4,6,4,14,18,-4,18
FC Goa,8415,7,4,3,7,11,15,-4,15
Chennaiyin,8415,8,3,6,5,15,22,-7,15
Delhi Dynamo,8416,1,6,6,2,25,15,10,24
Mumbai City,8416,2,6,5,3,16,8,8,23
Kerala Blast,8416,3,6,4,4,14,14,0,22
Kolkata,8416,4,4,8,2,16,14,2,20
Chennaiyin,8416,5,5,5,4,16,17,-1,20
FC Pune City,8416,6,4,4,6,13,17,-4,16
NorthEast Un,8416,7,4,2,8,10,16,-6,14
FC Goa,8416,8,3,2,9,8,17,-9,11
Mumbai City,8417,1,7,4,3,19,10,9,25
Delhi Dynamo,8417,2,6,5,3,27,17,10,23
Kolkata,8417,3,4,8,2,16,14,2,20
FC Pune City,8417,4,5,4,5,14,15,-1,19
Kerala Blast,8417,5,5,3,6,13,15,-2,18
Chennaiyin,8417,6,4,5,5,16,19,-3,17
FC Goa,8417,7,4,3,7,11,19,-8,15
NorthEast Un,8417,8,4,2,8,9,16,-7,14
Delhi Dynamo,8418,1,5,7,2,24,16,8,22
Mumbai City,8418,2,6,4,4,17,10,7,22
Kolkata,8418,3,4,8,2,15,13,2,20
FC Pune City,8418,4,5,4,5,14,15,-1,19
Chennaiyin,8418,5,4,5,5,15,19,-4,17
NorthEast Un,8418,6,4,4,6,10,11,-1,16
FC Goa,8418,7,4,4,6,10,15,-5,16
Kerala Blast,8418,8,4,4,6,9,15,-6,16
Delhi Dynamo,8419,1,7,5,2,28,17,11,26
Mumbai City,8419,2,6,4,4,17,10,7,22
Kolkata,8419,3,5,7,2,20,17,3,22
Kerala Blast,8419,4,5,4,5,13,17,-4,19
NorthEast Un,8419,5,4,4,6,11,12,-1,16
FC Pune City,8419,6,4,4,6,15,18,-3,16
Chennaiyin,8419,7,3,7,4,15,19,-4,16
FC Goa,8419,8,3,3,8,11,20,-9,12
Mumbai City,8420,1,7,4,3,18,9,9,25
Delhi Dynamo,8420,2,6,5,3,26,16,10,23
Kerala Blast,8420,3,6,3,5,11,15,-4,21
Kolkata,8420,4,4,8,2,17,14,3,20
FC Pune City,8420,5,4,4,6,13,16,-3,16
Chennaiyin,8420,6,3,7,4,15,19,-4,16
NorthEast Un,8420,7,4,3,7,10,14,-4,15
FC Goa,8420,8,3,4,7,10,17,-7,13
Mumbai City,8421,1,7,4,3,17,8,9,25
Kolkata,8421,2,5,7,2,18,15,3,22
Delhi Dynamo,8421,3,5,5,4,24,18,6,20
NorthEast Un,8421,4,6,2,6,13,10,3,20
FC Pune City,8421,5,5,3,6,14,16,-2,18
Kerala Blast,8421,6,5,3,6,11,16,-5,18
Chennaiyin,8421,7,4,5,5,15,18,-3,17
FC Goa,8421,8,3,3,8,9,20,-11,12
Kolkata,8422,1,5,7,2,19,13,6,22
Mumbai City,8422,2,6,4,4,17,11,6,22
Delhi Dynamo,8422,3,5,5,4,27,20,7,20
NorthEast Un,8422,4,6,2,6,15,16,-1,20
Kerala Blast,8422,5,5,3,6,13,16,-3,18
FC Pune City,8422,6,5,3,6,14,18,-4,18
FC Goa,8422,7,4,4,6,11,16,-5,16
Chennaiyin,8422,8,3,6,5,14,20,-6,15
Mumbai City,8423,1,6,5,3,17,9,8,23
Delhi Dynamo,8423,2,4,7,3,26,21,5,19
NorthEast Un,8423,3,5,4,5,13,12,1,19
Kolkata,8423,4,4,7,3,17,19,-2,19
Kerala Blast,8423,5,5,4,5,13,16,-3,19
FC Goa,8423,6,5,3,6,16,16,0,18
Chennaiyin,8423,7,3,7,4,14,18,-4,16
FC Pune City,8423,8,4,3,7,13,18,-5,15
Mumbai City,8424,1,7,4,3,17,8,9,25
NorthEast Un,8424,2,6,3,5,11,9,2,21
Kolkata,8424,3,4,7,3,16,14,2,19
FC Pune City,8424,4,5,3,6,14,16,-2,18
Kerala Blast,8424,5,5,3,6,11,17,-6,18
Delhi Dynamo,8424,6,4,5,5,21,18,3,17
Chennaiyin,8424,7,3,7,4,15,19,-4,16
FC Goa,8424,8,4,4,6,13,17,-4,16
Mumbai City,8425,1,7,4,3,19,9,10,25
Delhi Dynamo,8425,2,5,6,3,27,21,6,21
Kolkata,8425,3,4,7,3,17,16,1,19
NorthEast Un,8425,4,5,3,6,15,14,1,18
Kerala Blast,8425,5,5,3,6,11,17,-6,18
FC Pune City,8425,6,4,4,6,14,17,-3,16
Chennaiyin,8425,7,3,7,4,16,20,-4,16
FC Goa,8425,8,4,4,6,14,19,-5,16
Mumbai City,8426,1,6,5,3,16,8,8,23
NorthEast Un,8426,2,6,2,6,15,14,1,20
Kolkata,8426,3,4,7,3,17,17,0,19
Kerala Blast,8426,4,5,4,5,11,14,-3,19
Delhi Dynamo,8426,5,4,6,4,24,19,5,18
FC Pune City,8426,6,5,3,6,14,17,-3,18
FC Goa,8426,7,5,2,7,14,17,-3,17
Chennaiyin,8426,8,4,5,5,15,20,-5,17
Kolkata,8427,1,6,6,2,22,14,8,24
Mumbai City,8427,2,6,5,3,18,10,8,23
Delhi Dynamo,8427,3,5,6,3,26,19,7,21
NorthEast Un,8427,4,6,2,6,13,13,0,20
Kerala Blast,8427,5,5,4,5,13,16,-3,19
FC Pune City,8427,6,4,4,6,13,16,-3,16
Chennaiyin,8427,7,3,6,5,15,20,-5,15
FC Goa,8427,8,3,3,8,10,22,-12,12
Mumbai City,8428,1,7,4,3,22,8,14,25
Delhi Dynamo,8428,2,5,5,4,24,22,2,20
NorthEast Un,8428,3,6,2,6,11,11,0,20
Kerala Blast,8428,4,5,5,4,13,15,-2,20
Kolkata,8428,5,4,7,3,16,14,2,19
FC Pune City,8428,6,5,4,5,14,15,-1,19
Chennaiyin,8428,7,3,5,6,15,21,-6,14
FC Goa,8428,8,4,2,8,12,21,-9,14
Delhi Dynamo,8429,1,7,5,2,30,14,16,26
Kolkata,8429,2,6,6,2,18,13,5,24
Mumbai City,8429,3,6,4,4,16,11,5,22
NorthEast Un,8429,4,6,2,6,12,10,2,20
FC Pune City,8429,5,5,3,6,13,16,-3,18
Chennaiyin,8429,6,3,6,5,15,20,-5,15
Kerala Blast,8429,7,4,3,7,10,18,-8,15
FC Goa,8429,8,3,3,8,10,22,-12,12
Mumbai City,8430,1,7,4,3,19,10,9,25
FC Pune City,8430,2,6,3,5,17,15,2,21
Kerala Blast,8430,3,6,3,5,13,18,-5,21
Delhi Dynamo,8430,4,4,6,4,23,19,4,18
Kolkata,8430,5,4,6,4,14,14,0,18
NorthEast Un,8430,6,5,2,7,12,13,-1,17
Chennaiyin,8430,7,4,5,5,15,21,-6,17
FC Goa,8430,8,4,3,7,12,15,-3,15
Mumbai City,8431,1,6,4,4,17,11,6,22
Kolkata,8431,2,5,6,3,17,15,2,21
Kerala Blast,8431,3,6,3,5,14,16,-2,21
Delhi Dynamo,8431,4,5,5,4,24,18,6,20
NorthEast Un,8431,5,6,2,6,13,10,3,20
Chennaiyin,8431,6,4,5,5,15,19,-4,17
FC Goa,8431,7,5,2,7,13,18,-5,17
FC Pune City,8431,8,4,3,7,13,19,-6,15
Mumbai City,8432,1,7,4,3,19,10,9,25
Kolkata,8432,2,5,6,3,16,13,3,21
NorthEast Un,8432,3,6,2,6,15,11,4,20
Chennaiyin,8432,4,5,5,4,16,18,-2,20
Delhi Dynamo,8432,5,4,6,4,25,22,3,18
Kerala Blast,8432,6,5,3,6,12,17,-5,18
FC Goa,8432,7,4,3,7,12,18,-6,15
FC Pune City,8432,7,4,3,7,12,18,-6,15
Mumbai City,8433,1,6,4,4,16,9,7,22
Delhi Dynamo,8433,2,5,5,4,24,18,6,20
Kerala Blast,8433,3,5,5,4,16,14,2,20
Kolkata,8433,4,4,8,2,15,13,2,20
FC Pune City,8433,5,4,5,5,12,14,-2,17
Chennaiyin,8433,6,4,5,5,16,20,-4,17
FC Goa,8433,7,5,2,7,13,17,-4,17
NorthEast Un,8433,8,5,2,7,13,20,-7,17
Mumbai City,8434,1,7,4,3,18,8,10,25
NorthEast Un,8434,2,7,2,5,17,13,4,23
Kerala Blast,8434,3,6,3,5,15,17,-2,21
Delhi Dynamo,8434,4,5,5,4,24,20,4,20
Kolkata,8434,5,4,7,3,17,15,2,19
Chennaiyin,8434,6,4,5,5,16,20,-4,17
FC Pune City,8434,7,4,3,7,12,18,-6,15
FC Goa,8434,8,3,3,8,11,19,-8,12
Mumbai City,8435,1,6,5,3,17,9,8,23
Kolkata,8435,2,5,7,2,18,14,4,22
Delhi Dynamo,8435,3,4,7,3,24,19,5,19
Kerala Blast,8435,4,5,4,5,13,14,-1,19
NorthEast Un,8435,5,5,3,6,12,14,-2,18
FC Pune City,8435,6,5,3,6,14,17,-3,18
Chennaiyin,8435,7,3,6,5,14,19,-5,15
FC Goa,8435,8,4,3,7,12,18,-6,15
Mumbai City,8436,1,7,4,3,18,9,9,25
FC Pune City,8436,2,6,3,5,17,16,1,21
Kerala Blast,8436,3,6,3,5,13,15,-2,21
Delhi Dynamo,8436,4,4,6,4,24,19,5,18
NorthEast Un,8436,5,5,3,6,12,13,-1,18
Chennaiyin,8436,6,4,5,5,17,19,-2,17
Kolkata,8436,7,3,7,4,15,17,-2,16
FC Goa,8436,8,4,3,7,11,19,-8,15
Mumbai City,8437,1,6,5,3,17,9,8,23
Delhi Dynamo,8437,2,5,7,2,25,17,8,22
Chennaiyin,8437,3,5,5,4,17,17,0,20
Kolkata,8437,4,4,7,3,18,16,2,19
FC Pune City,8437,5,5,4,5,16,17,-1,19
NorthEast Un,8437,6,5,2,7,12,13,-1,17
Kerala Blast,8437,7,4,3,7,12,20,-8,15
FC Goa,8437,8,4,3,7,10,18,-8,15
Mumbai City,8438,1,6,5,3,16,8,8,23
FC Goa,8438,2,6,2,6,15,16,-1,20
Delhi Dynamo,8438,3,4,7,3,23,18,5,19
FC Pune City,8438,4,5,4,5,16,16,0,19
Kerala Blast,8438,5,5,4,5,12,16,-4,19
Kolkata,8438,6,4,6,4,15,17,-2,18
Chennaiyin,8438,7,4,5,5,14,18,-4,17
NorthEast Un,8438,8,4,3,7,10,12,-2,15
Mumbai City,8439,1,6,5,3,18,10,8,23
Delhi Dynamo,8439,2,5,7,2,27,17,10,22
Kolkata,8439,3,5,7,2,20,16,4,22
NorthEast Un,8439,4,5,4,5,12,11,1,19
Kerala Blast,8439,5,5,4,5,12,15,-3,19
Chennaiyin,8439,6,3,6,5,14,20,-6,15
FC Pune City,8439,6,4,3,7,14,20,-6,15
FC Goa,8439,8,4,2,8,11,19,-8,14
Kolkata,8440,1,6,6,2,19,13,6,24
Delhi Dynamo,8440,2,6,5,3,26,16,10,23
Mumbai City,8440,3,6,4,4,16,11,5,22
NorthEast Un,8440,4,6,3,5,13,11,2,21
FC Pune City,8440,5,4,4,6,13,16,-3,16
Chennaiyin,8440,6,3,7,4,15,19,-4,16
Kerala Blast,8440,7,4,4,6,9,16,-7,16
FC Goa,8440,8,3,3,8,9,18,-9,12
Mumbai City,8441,1,7,4,3,17,8,9,25
Delhi Dynamo,8441,2,6,5,3,24,15,9,23
Kerala Blast,8441,3,6,3,5,14,15,-1,21
NorthEast Un,8441,4,5,3,6,11,10,1,18
Kolkata,8441,5,4,6,4,14,16,-2,18
FC Pune City,8441,6,5,3,6,14,17,-3,18
Chennaiyin,8441,7,3,7,4,13,17,-4,16
FC Goa,8441,8,3,3,8,8,17,-9,12
Delhi Dynamo,8442,1,6,5,3,26,15,11,23
Mumbai City,8442,2,6,4,4,16,9,7,22
Kerala Blast,8442,3,5,5,4,10,13,-3,20
Kolkata,8442,4,4,7,3,18,17,1,19
NorthEast Un,8442,5,5,3,6,10,13,-3,18
Chennaiyin,8442,6,4,5,5,15,19,-4,17
FC Goa,8442,7,5,2,7,13,17,-4,17
FC Pune City,8442,8,4,3,7,14,19,-5,15
Mumbai City,8443,1,7,4,3,17,8,9,25
Kolkata,8443,2,5,7,2,17,14,3,22
NorthEast Un,8443,3,6,3,5,13,11,2,21
Delhi Dynamo,8443,4,5,5,4,25,18,7,20
Kerala Blast,8443,5,4,5,5,11,16,-5,17
FC Pune City,8443,6,4,4,6,15,18,-3,16
Chennaiyin,8443,7,3,6,5,15,20,-5,15
FC Goa,8443,8,3,4,7,11,19,-8,13
Mumbai City,8444,1,7,4,3,21,8,13,25
Kerala Blast,8444,2,6,4,4,15,16,-1,22
Delhi Dynamo,8444,3,5,5,4,24,21,3,20
FC Pune City,8444,4,5,3,6,13,15,-2,18
Chennaiyin,8444,5,4,6,4,14,17,-3,18
FC Goa,8444,6,5,3,6,11,15,-4,18
Kolkata,8444,7,3,6,5,16,19,-3,15
NorthEast Un,8444,8,4,3,7,11,14,-3,15
Mumbai City,8445,1,6,5,3,17,9,8,23
Kolkata,8445,2,5,6,3,19,15,4,21
NorthEast Un,8445,3,6,2,6,15,15,0,20
Delhi Dynamo,8445,4,4,7,3,25,19,6,19
FC Goa,8445,5,5,3,6,14,17,-3,18
Chennaiyin,8445,6,4,5,5,17,19,-2,17
FC Pune City,8445,7,4,4,6,12,16,-4,16
Kerala Blast,8445,8,4,4,6,10,19,-9,16
Mumbai City,8446,1,6,5,3,16,8,8,23
Delhi Dynamo,8446,2,5,7,2,25,16,9,22
Kolkata,8446,3,5,6,3,18,16,2,21
NorthEast Un,8446,4,5,4,5,11,10,1,19
FC Goa,8446,5,5,2,7,15,19,-4,17
FC Pune City,8446,6,4,4,6,16,19,-3,16
Kerala Blast,8446,7,4,4,6,12,20,-8,16
Chennaiyin,8446,8,3,6,5,15,20,-5,15
Mumbai City,8447,1,6,5,3,17,9,8,23
Kolkata,8447,2,5,7,2,18,14,4,22
Delhi Dynamo,8447,3,5,6,3,24,17,7,21
Kerala Blast,8447,4,6,3,5,14,15,-1,21
NorthEast Un,8447,5,5,3,6,12,13,-1,18
Chennaiyin,8447,6,4,6,4,17,19,-2,18
FC Pune City,8447,7,4,3,7,14,20,-6,15
FC Goa,8447,8,3,3,8,10,19,-9,12
Kolkata,8448,1,6,6,2,18,13,5,24
Mumbai City,8448,2,6,5,3,18,10,8,23
NorthEast Un,8448,3,7,2,5,15,10,5,23
Delhi Dynamo,8448,4,5,6,3,26,17,9,21
Kerala Blast,8448,5,5,3,6,12,18,-6,18
FC Pune City,8448,6,4,3,7,12,17,-5,15
Chennaiyin,8448,7,3,5,6,15,21,-6,14
FC Goa,8448,8,4,2,8,10,20,-10,14
Mumbai City,8449,1,7,4,3,19,9,10,25
Delhi Dynamo,8449,2,5,6,3,25,18,7,21
Kerala Blast,8449,3,6,3,5,12,15,-3,21
Kolkata,8449,4,4,8,2,17,15,2,20
NorthEast Un,8449,5,5,2,7,11,12,-1,17
Chennaiyin,8449,6,4,5,5,17,20,-3,17
FC Pune City,8449,7,4,4,6,14,17,-3,16
FC Goa,8449,8,3,4,7,12,21,-9,13
Mumbai City,8450,1,7,4,3,20,10,10,25
Kolkata,8450,2,6,6,2,17,13,4,24
Delhi Dynamo,8450,3,5,5,4,28,20,8,20
NorthEast Un,8450,4,6,2,6,15,13,2,20
Kerala Blast,8450,5,5,4,5,14,17,-3,19
Chennaiyin,8450,6,4,5,5,18,22,-4,17
FC Pune City,8450,7,4,4,6,13,16,-3,16
FC Goa,8450,8,3,2,9,10,24,-14,11
Mumbai City,8451,1,7,4,3,18,8,10,25
FC Pune City,8451,2,6,3,5,16,16,0,21
Delhi Dynamo,8451,3,4,6,4,23,20,3,18
NorthEast Un,8451,4,5,3,6,13,12,1,18
Kolkata,8451,5,4,6,4,14,15,-1,18
FC Goa,8451,6,5,3,6,15,18,-3,18
Chennaiyin,8451,7,4,5,5,17,21,-4,17
Kerala Blast,8451,8,4,4,6,12,18,-6,16
Delhi Dynamo,8452,1,5,7,2,25,15,10,22
Mumbai City,8452,2,6,4,4,16,11,5,22
Kolkata,8452,3,5,7,2,16,13,3,22
Kerala Blast,8452,4,6,4,4,14,13,1,22
Chennaiyin,8452,5,5,5,4,17,19,-2,20
NorthEast Un,8452,6,4,3,7,9,11,-2,15
FC Pune City,8452,7,4,3,7,13,20,-7,15
FC Goa,8452,8,3,3,8,11,19,-8,12
Delhi Dynamo,8453,1,6,6,2,26,16,10,24
Mumbai City,8453,2,6,4,4,17,10,7,22
FC Pune City,8453,3,6,3,5,16,15,1,21
Kerala Blast,8453,4,6,3,5,14,17,-3,21
NorthEast Un,8453,5,5,3,6,11,11,0,18
Kolkata,8453,6,3,7,4,18,20,-2,16
Chennaiyin,8453,7,3,6,5,15,20,-5,15
FC Goa,8453,8,3,4,7,13,21,-8,13
Delhi Dynamo,8454,1,6,6,2,25,16,9,24
Mumbai City,8454,2,6,5,3,17,9,8,23
Kolkata,8454,3,5,6,3,22,16,6,21
Kerala Blast,8454,4,6,3,5,17,16,1,21
Chennaiyin,8454,5,5,5,4,17,17,0,20
FC Pune City,8454,6,4,3,7,13,22,-9,15
FC Goa,8454,7,4,2,8,12,19,-7,14
NorthEast Un,8454,8,4,2,8,9,17,-8,14
Mumbai City,8455,1,7,4,3,18,8,10,25
Delhi Dynamo,8455,2,5,6,3,23,17,6,21
Kolkata,8455,3,5,6,3,16,14,2,21
Kerala Blast,8455,4,5,4,5,12,16,-4,19
FC Pune City,8455,5,5,3,6,15,17,-2,18
Chennaiyin,8455,6,4,6,4,14,17,-3,18
NorthEast Un,8455,7,4,4,6,11,12,-1,16
FC Goa,8455,8,3,3,8,8,16,-8,12
Delhi Dynamo,8456,1,6,5,3,27,17,10,23
Mumbai City,8456,2,6,4,4,16,10,6,22
NorthEast Un,8456,3,6,3,5,14,12,2,21
Kolkata,8456,4,4,7,3,16,15,1,19
FC Pune City,8456,5,5,4,5,15,16,-1,19
FC Goa,8456,6,5,2,7,12,18,-6,17
Kerala Blast,8456,7,4,4,6,10,16,-6,16
Chennaiyin,8456,8,3,5,6,15,21,-6,14
Mumbai City,8457,1,7,4,3,19,10,9,25
Kolkata,8457,2,6,6,2,19,14,5,24
Delhi Dynamo,8457,3,5,6,3,29,18,11,21
NorthEast Un,8457,4,5,3,6,12,13,-1,18
FC Pune City,8457,5,5,3,6,14,17,-3,18
Kerala Blast,8457,6,5,3,6,13,17,-4,18
Chennaiyin,8457,7,3,5,6,14,21,-7,14
FC Goa,8457,8,4,2,8,11,21,-10,14
Mumbai City,8458,1,7,4,3,17,8,9,25
Delhi Dynamo,8458,2,5,6,3,23,16,7,21
Kerala Blast,8458,3,5,5,4,12,14,-2,20
NorthEast Un,8458,4,5,4,5,13,10,3,19
FC Pune City,8458,5,5,3,6,16,18,-2,18
Kolkata,8458,6,3,7,4,17,19,-2,16
FC Goa,8458,7,4,3,7,11,17,-6,15
Chennaiyin,8458,8,3,6,5,14,21,-7,15
Delhi Dynamo,8459,1,6,6,2,27,17,10,24
Mumbai City,8459,2,6,5,3,17,9,8,23
Kerala Blast,8459,3,5,4,5,12,14,-2,19
Kolkata,8459,4,4,6,4,18,18,0,18
FC Pune City,8459,5,5,3,6,13,17,-4,18
NorthEast Un,8459,6,4,4,6,11,13,-2,16
Chennaiyin,8459,7,3,7,4,15,19,-4,16
FC Goa,8459,8,4,3,7,13,19,-6,15
Kolkata,8460,1,6,6,2,17,12,5,24
Mumbai City,8460,2,6,4,4,16,11,5,22
Delhi Dynamo,8460,3,5,6,3,26,18,8,21
Kerala Blast,8460,4,6,3,5,12,15,-3,21
Chennaiyin,8460,5,4,6,4,18,20,-2,18
NorthEast Un,8460,6,5,2,7,12,13,-1,17
FC Pune City,8460,7,4,3,7,12,17,-5,15
FC Goa,8460,8,3,4,7,12,19,-7,13
Mumbai City,8461,1,7,4,3,18,8,10,25
Delhi Dynamo,8461,2,5,6,3,23,16,7,21
FC Pune City,8461,3,6,3,5,15,14,1,21
NorthEast Un,8461,4,5,4,5,13,10,3,19
Kerala Blast,8461,5,5,4,5,11,16,-5,19
Kolkata,8461,6,4,6,4,14,14,0,18
FC Goa,8461,7,4,2,8,10,17,-7,14
Chennaiyin,8461,8,3,5,6,13,22,-9,14
Delhi Dynamo,8462,1,6,5,3,25,18,7,23
Mumbai City,8462,2,6,4,4,17,10,7,22
Kerala Blast,8462,3,6,3,5,13,15,-2,21
Chennaiyin,8462,4,5,5,4,16,18,-2,20
FC Pune City,8462,5,5,3,6,16,16,0,18
Kolkata,8462,6,4,6,4,15,19,-4,18
NorthEast Un,8462,7,5,2,7,12,12,0,17
FC Goa,8462,8,4,2,8,11,17,-6,14
Mumbai City,8463,1,7,4,3,18,9,9,25
Kolkata,8463,2,5,7,2,17,14,3,22
Delhi Dynamo,8463,3,5,6,3,28,21,7,21
FC Pune City,8463,4,5,4,5,14,15,-1,19
Chennaiyin,8463,5,4,6,4,15,18,-3,18
Kerala Blast,8463,6,5,3,6,11,16,-5,18
NorthEast Un,8463,7,4,4,6,11,12,-1,16
FC Goa,8463,8,3,2,9,12,21,-9,11
Mumbai City,8464,1,7,4,3,18,8,10,25
Kolkata,8464,2,5,6,3,16,14,2,21
Delhi Dynamo,8464,3,5,5,4,23,18,5,20
FC Pune City,8464,4,5,4,5,14,15,-1,19
Kerala Blast,8464,5,5,4,5,11,14,-3,19
Chennaiyin,8464,6,4,5,5,18,19,-1,17
NorthEast Un,8464,7,5,2,7,11,16,-5,17
FC Goa,8464,8,4,2,8,10,17,-7,14
Delhi Dynamo,8465,1,6,5,3,25,17,8,23
Mumbai City,8465,2,6,4,4,17,10,7,22
Kolkata,8465,3,5,6,3,18,16,2,21
Kerala Blast,8465,4,6,3,5,15,17,-2,21
FC Goa,8465,5,6,2,6,13,16,-3,20
NorthEast Un,8465,6,5,2,7,13,15,-2,17
FC Pune City,8465,7,4,3,7,14,18,-4,15
Chennaiyin,8465,8,3,5,6,13,19,-6,14
Mumbai City,8466,1,7,4,3,17,8,9,25
Delhi Dynamo,8466,2,6,5,3,25,16,9,23
Kerala Blast,8466,3,6,4,4,16,17,-1,22
Kolkata,8466,4,4,6,4,17,18,-1,18
FC Pune City,8466,5,5,3,6,14,16,-2,18
Chennaiyin,8466,6,4,6,4,16,19,-3,18
NorthEast Un,8466,7,4,3,7,10,13,-3,15
FC Goa,8466,8,3,3,8,11,19,-8,12
Mumbai City,8467,1,6,5,3,17,9,8,23
Delhi Dynamo,8467,2,5,7,2,25,16,9,22
Kolkata,8467,3,5,6,3,17,19,-2,21
Kerala Blast,8467,4,5,4,5,12,16,-4,19
FC Goa,8467,5,5,2,7,16,16,0,17
Chennaiyin,8467,6,4,5,5,15,20,-5,17
FC Pune City,8467,7,4,4,6,14,17,-3,16
NorthEast Un,8467,8,4,3,7,10,13,-3,15
Mumbai City,8468,1,7,4,3,18,9,9,25
Kerala Blast,8468,2,7,3,4,14,13,1,24
Delhi Dynamo,8468,3,5,5,4,25,18,7,20
FC Pune City,8468,4,5,3,6,15,18,-3,18
NorthEast Un,8468,5,5,2,7,12,13,-1,17
Kolkata,8468,6,3,7,4,14,16,-2,16
FC Goa,8468,7,4,4,6,11,16,-5,16
Chennaiyin,8468,8,3,6,5,15,21,-6,15
Mumbai City,8469,1,7,4,3,20,10,10,25
Kolkata,8469,2,6,6,2,20,15,5,24
NorthEast Un,8469,3,6,3,5,12,10,2,21
Delhi Dynamo,8469,4,5,5,4,26,21,5,20
Chennaiyin,8469,5,4,6,4,15,18,-3,18
Kerala Blast,8469,6,5,3,6,11,16,-5,18
FC Pune City,8469,7,4,3,7,13,18,-5,15
FC Goa,8469,8,3,2,9,11,20,-9,11
Mumbai City,8470,1,7,4,3,18,9,9,25
Delhi Dynamo,8470,2,5,6,3,25,17,8,21
Kolkata,8470,3,5,6,3,19,18,1,21
Kerala Blast,8470,4,5,4,5,14,19,-5,19
FC Goa,8470,5,5,2,7,12,16,-4,17
NorthEast Un,8470,6,4,4,6,12,13,-1,16
FC Pune City,8470,7,4,4,6,17,20,-3,16
Chennaiyin,8470,8,3,6,5,15,20,-5,15
Mumbai City,8471,1,7,4,3,18,9,9,25
NorthEast Un,8471,2,6,3,5,16,11,5,21
Kerala Blast,8471,3,5,4,5,12,17,-5,19
Delhi Dynamo,8471,4,4,6,4,25,21,4,18
FC Pune City,8471,5,5,3,6,15,16,-1,18
Kolkata,8471,5,4,6,4,15,16,-1,18
FC Goa,8471,7,4,4,6,13,17,-4,16
Chennaiyin,8471,8,3,6,5,14,21,-7,15
Mumbai City,8472,1,7,4,3,17,8,9,25
FC Pune City,8472,2,6,3,5,17,15,2,21
NorthEast Un,8472,3,6,2,6,13,12,1,20
Delhi Dynamo,8472,4,4,6,4,23,18,5,18
Kolkata,8472,5,4,6,4,15,18,-3,18
Kerala Blast,8472,6,5,3,6,13,17,-4,18
Chennaiyin,8472,7,4,5,5,16,20,-4,17
FC Goa,8472,8,4,3,7,13,19,-6,15
Mumbai City,8473,1,6,5,3,16,8,8,23
Delhi Dynamo,8473,2,5,6,3,23,16,7,21
Kolkata,8473,3,5,6,3,20,17,3,21
NorthEast Un,8473,4,5,4,5,13,11,2,19
FC Goa,8473,5,5,2,7,15,16,-1,17
Kerala Blast,8473,6,4,5,5,13,20,-7,17
FC Pune City,8473,7,4,4,6,14,18,-4,16
Chennaiyin,8473,8,3,6,5,13,21,-8,15
Delhi Dynamo,8474,1,6,6,2,25,16,9,24
Mumbai City,8474,2,6,4,4,17,10,7,22
Chennaiyin,8474,3,5,5,4,17,18,-1,20
Kerala Blast,8474,4,5,5,4,15,17,-2,20
Kolkata,8474,5,4,7,3,18,16,2,19
FC Pune City,8474,6,4,4,6,15,19,-4,16
NorthEast Un,8474,7,4,3,7,11,15,-4,15
FC Goa,8474,8,4,2,8,11,18,-7,14
Delhi Dynamo,8475,1,6,6,2,27,14,13,24
Mumbai City,8475,2,6,5,3,16,8,8,23
Kolkata,8475,3,4,8,2,17,14,3,20
NorthEast Un,8475,4,5,3,6,12,11,1,18
FC Pune City,8475,5,4,5,5,15,17,-2,17
Kerala Blast,8475,6,4,4,6,11,19,-8,16
Chennaiyin,8475,7,3,6,5,14,21,-7,15
FC Goa,8475,8,4,3,7,12,20,-8,15
Mumbai City,8476,1,7,4,3,20,10,10,25
Kolkata,8476,2,5,7,2,18,15,3,22
Delhi Dynamo,8476,3,5,6,3,28,21,7,21
Kerala Blast,8476,4,5,4,5,12,15,-3,19
FC Pune City,8476,5,5,3,6,15,17,-2,18
Chennaiyin,8476,6,4,6,4,16,19,-3,18
NorthEast Un,8476,7,4,2,8,12,17,-5,14
FC Goa,8476,8,3,4,7,10,17,-7,13
Delhi Dynamo,8477,1,6,6,2,25,16,9,24
Mumbai City,8477,2,6,5,3,17,9,8,23
Kolkata,8477,3,4,8,2,15,12,3,20
Kerala Blast,8477,4,5,4,5,10,15,-5,19
Chennaiyin,8477,5,4,6,4,15,18,-3,18
NorthEast Un,8477,6,5,2,7,11,11,0,17
FC Pune City,8477,7,4,4,6,12,15,-3,16
FC Goa,8477,8,3,3,8,10,19,-9,12
Delhi Dynamo,8478,1,6,6,2,24,15,9,24
Mumbai City,8478,2,6,4,4,16,9,7,22
Kolkata,8478,3,5,7,2,18,14,4,22
Kerala Blast,8478,4,6,3,5,13,16,-3,21
Chennaiyin,8478,5,4,5,5,18,19,-1,17
FC Pune City,8478,6,4,3,7,12,16,-4,15
FC Goa,8478,7,4,3,7,11,16,-5,15
NorthEast Un,8478,8,4,3,7,10,17,-7,15
Mumbai City,8479,1,7,4,3,17,8,9,25
Kerala Blast,8479,2,6,4,4,13,14,-1,22
NorthEast Un,8479,3,5,3,6,10,10,0,18
FC Goa,8479,4,5,3,6,10,14,-4,18
Delhi Dynamo,8479,5,4,5,5,21,17,4,17
Kolkata,8479,6,3,8,3,13,14,-1,17
FC Pune City,8479,7,4,5,5,13,15,-2,17
Chennaiyin,8479,8,3,6,5,13,18,-5,15
Mumbai City,8480,1,7,4,3,18,8,10,25
Kerala Blast,8480,2,6,4,4,14,15,-1,22
Delhi Dynamo,8480,3,5,5,4,24,20,4,20
NorthEast Un,8480,4,6,2,6,16,14,2,20
Kolkata,8480,5,4,7,3,16,15,1,19
Chennaiyin,8480,6,4,5,5,17,20,-3,17
FC Pune City,8480,7,4,3,7,14,19,-5,15
FC Goa,8480,8,4,2,8,11,19,-8,14
Kerala Blast,8481,1,7,3,4,17,13,4,24
Mumbai City,8481,2,6,5,3,17,9,8,23
Delhi Dynamo,8481,3,5,6,3,24,18,6,21
NorthEast Un,8481,4,6,2,6,14,12,2,20
Kolkata,8481,5,4,6,4,15,18,-3,18
FC Pune City,8481,6,5,3,6,13,17,-4,18
Chennaiyin,8481,7,3,6,5,15,20,-5,15
FC Goa,8481,8,3,3,8,10,18,-8,12
Mumbai City,8482,1,7,4,3,18,8,10,25
Kolkata,8482,2,5,7,2,18,14,4,22
NorthEast Un,8482,3,6,3,5,14,12,2,21
Delhi Dynamo,8482,4,5,5,4,26,19,7,20
FC Pune City,8482,5,5,3,6,14,17,-3,18
Kerala Blast,8482,6,4,5,5,11,16,-5,17
Chennaiyin,8482,7,3,5,6,14,21,-7,14
FC Goa,8482,8,4,2,8,11,19,-8,14
Mumbai City,8483,1,7,4,3,18,8,10,25
Kolkata,8483,2,5,6,3,21,19,2,21
Kerala Blast,8483,3,6,3,5,17,20,-3,21
Delhi Dynamo,8483,4,5,5,4,25,20,5,20
NorthEast Un,8483,5,6,2,6,16,14,2,20
FC Goa,8483,6,5,2,7,14,19,-5,17
FC Pune City,8483,7,4,3,7,15,19,-4,15
Chennaiyin,8483,8,3,5,6,15,22,-7,14
Delhi Dynamo,8484,1,6,6,2,25,16,9,24
Mumbai City,8484,2,6,5,3,17,9,8,23
Kolkata,8484,3,5,7,2,18,14,4,22
NorthEast Un,8484,4,5,3,6,14,13,1,18
Kerala Blast,8484,5,5,3,6,13,20,-7,18
FC Pune City,8484,6,4,3,7,14,18,-4,15
Chennaiyin,8484,7,3,6,5,14,19,-5,15
FC Goa,8484,8,4,3,7,9,15,-6,15
Mumbai City,8485,1,6,5,3,16,8,8,23
Delhi Dynamo,8485,2,5,7,2,25,16,9,22
Kerala Blast,8485,3,6,4,4,14,13,1,22
FC Pune City,8485,4,5,4,5,13,14,-1,19
NorthEast Un,8485,5,5,2,7,16,15,1,17
Chennaiyin,8485,6,4,5,5,16,23,-7,17
FC Goa,8485,7,4,3,7,11,16,-5,15
Kolkata,8485,8,3,6,5,13,19,-6,15
Mumbai City,8486,1,7,4,3,18,9,9,25
NorthEast Un,8486,2,7,2,5,16,11,5,23
Kolkata,8486,3,5,7,2,17,14,3,22
Delhi Dynamo,8486,4,5,5,4,28,21,7,20
Kerala Blast,8486,5,5,3,6,11,16,-5,18
FC Pune City,8486,6,4,4,6,13,16,-3,16
Chennaiyin,8486,7,3,5,6,14,21,-7,14
FC Goa,8486,8,4,2,8,13,22,-9,14
Mumbai City,8487,1,7,4,3,20,10,10,25
Delhi Dynamo,8487,2,5,5,4,27,21,6,20
Kolkata,8487,3,4,7,3,16,14,2,19
Kerala Blast,8487,4,5,4,5,11,15,-4,19
NorthEast Un,8487,5,5,3,6,13,14,-1,18
FC Pune City,8487,6,5,3,6,13,16,-3,18
FC Goa,8487,7,5,3,6,12,16,-4,18
Chennaiyin,8487,8,3,5,6,14,20,-6,14
Mumbai City,8488,1,7,4,3,17,8,9,25
Kolkata,8488,2,6,6,2,18,13,5,24
Delhi Dynamo,8488,3,5,6,3,26,18,8,21
Kerala Blast,8488,4,5,4,5,11,14,-3,19
NorthEast Un,8488,5,5,3,6,15,14,1,18
FC Pune City,8488,6,4,4,6,12,16,-4,16
FC Goa,8488,7,4,2,8,13,18,-5,14
Chennaiyin,8488,8,3,5,6,13,24,-11,14
Mumbai City,8489,1,7,4,3,19,9,10,25
Kolkata,8489,2,5,6,3,16,14,2,21
Delhi Dynamo,8489,3,5,5,4,24,19,5,20
Kerala Blast,8489,4,5,4,5,15,17,-2,19
NorthEast Un,8489,5,5,3,6,12,12,0,18
Chennaiyin,8489,6,4,5,5,14,18,-4,17
FC Goa,8489,7,5,2,7,10,15,-5,17
FC Pune City,8489,8,4,3,7,13,19,-6,15
Kerala Blast,8490,1,7,3,4,19,19,0,24
Mumbai City,8490,2,6,5,3,17,9,8,23
NorthEast Un,8490,3,6,2,6,15,12,3,20
Kolkata,8490,4,4,7,3,17,16,1,19
Delhi Dynamo,8490,5,4,6,4,22,18,4,18
FC Goa,8490,6,4,4,6,11,16,-5,16
FC Pune City,8490,7,4,3,7,14,19,-5,15
Chennaiyin,8490,8,3,6,5,14,20,-6,15
Mumbai City,8491,1,7,4,3,18,9,9,25
Delhi Dynamo,8491,2,6,5,3,28,20,8,23
Kolkata,8491,3,5,7,2,17,14,3,22
Kerala Blast,8491,4,5,5,4,16,18,-2,20
Chennaiyin,8491,5,4,6,4,18,18,0,18
FC Pune City,8491,6,4,4,6,14,17,-3,16
NorthEast Un,8491,7,4,2,8,14,21,-7,14
FC Goa,8491,8,3,3,8,11,19,-8,12
Mumbai City,8492,1,7,4,3,17,8,9,25
NorthEast Un,8492,2,7,2,5,13,10,3,23
Kolkata,8492,3,5,7,2,15,12,3,22
Delhi Dynamo,8492,4,5,5,4,24,18,6,20
Kerala Blast,8492,5,5,4,5,11,15,-4,19
FC Pune City,8492,6,4,3,7,13,17,-4,15
Chennaiyin,8492,7,3,5,6,14,20,-6,14
FC Goa,8492,8,4,2,8,11,18,-7,14
Mumbai City,8493,1,7,4,3,19,9,10,25
Delhi Dynamo,8493,2,6,5,3,27,19,8,23
Kerala Blast,8493,3,6,3,5,16,21,-5,21
Kolkata,8493,4,4,7,3,20,16,4,19
FC Pune City,8493,5,5,3,6,13,16,-3,18
NorthEast Un,8493,6,5,2,7,12,13,-1,17
Chennaiyin,8493,7,4,5,5,15,19,-4,17
FC Goa,8493,8,3,3,8,10,19,-9,12
Mumbai City,8494,1,6,5,3,17,9,8,23
Delhi Dynamo,8494,2,5,6,3,23,20,3,21
Kerala Blast,8494,3,6,3,5,14,17,-3,21
NorthEast Un,8494,4,6,2,6,20,13,7,20
FC Pune City,8494,5,5,4,5,15,16,-1,19
FC Goa,8494,6,5,2,7,12,17,-5,17
Kolkata,8494,7,3,7,4,14,15,-1,16
Chennaiyin,8494,8,3,5,6,16,24,-8,14
Mumbai City,8495,1,7,4,3,17,8,9,25
Delhi Dynamo,8495,2,6,5,3,27,16,11,23
NorthEast Un,8495,3,6,2,6,13,12,1,20
FC Pune City,8495,4,5,4,5,17,17,0,19
Kerala Blast,8495,5,5,3,6,14,20,-6,18
FC Goa,8495,6,5,2,7,11,18,-7,17
Kolkata,8495,7,3,7,4,15,17,-2,16
Chennaiyin,8495,8,3,5,6,13,19,-6,14
Mumbai City,8496,1,6,5,3,17,9,8,23
Delhi Dynamo,8496,2,5,6,3,23,16,7,21
Kolkata,8496,3,4,8,2,20,16,4,20
NorthEast Un,8496,4,6,2,6,12,11,1,20
FC Pune City,8496,5,5,4,5,18,16,2,19
Chennaiyin,8496,6,4,5,5,17,20,-3,17
FC Goa,8496,7,4,3,7,12,19,-7,15
Kerala Blast,8496,8,4,3,7,9,21,-12,15
Kolkata,8497,1,6,6,2,23,15,8,24
Mumbai City,8497,2,6,5,3,16,8,8,23
Delhi Dynamo,8497,3,5,7,2,22,14,8,22
Kerala Blast,8497,4,5,3,6,16,18,-2,18
Chennaiyin,8497,5,4,6,4,16,19,-3,18
FC Pune City,8497,6,5,3,6,13,17,-4,18
NorthEast Un,8497,7,4,4,6,11,15,-4,16
FC Goa,8497,8,3,2,9,10,21,-11,11
Delhi Dynamo,8498,1,6,5,3,24,16,8,23
Mumbai City,8498,2,6,4,4,16,9,7,22
Chennaiyin,8498,3,5,5,4,20,19,1,20
FC Pune City,8498,4,5,4,5,16,16,0,19
Kerala Blast,8498,5,5,4,5,14,16,-2,19
Kolkata,8498,6,3,9,2,15,14,1,18
NorthEast Un,8498,7,5,2,7,11,18,-7,17
FC Goa,8498,8,3,3,8,11,19,-8,12
Mumbai City,8499,1,7,4,3,20,9,11,25
Kolkata,8499,2,6,6,2,22,13,9,24
Delhi Dynamo,8499,3,5,6,3,24,19,5,21
Kerala Blast,8499,4,5,4,5,12,18,-6,19
FC Pune City,8499,5,4,4,6,13,17,-4,16
NorthEast Un,8499,6,4,3,7,10,12,-2,15
Chennaiyin,8499,7,3,6,5,14,20,-6,15
FC Goa,8499,8,4,3,7,13,20,-7,15
Kolkata,8500,1,6,6,2,20,14,6,24
Mumbai City,8500,2,6,4,4,17,11,6,22
Delhi Dynamo,8500,3,5,6,3,25,19,6,21
FC Pune City,8500,4,5,3,6,16,15,1,18
Kerala Blast,8500,5,5,3,6,11,20,-9,18
FC Goa,8500,6,5,2,7,17,20,-3,17
Chennaiyin,8500,7,4,5,5,16,20,-4,17
NorthEast Un,8500,8,4,3,7,9,12,-3,15
Mumbai City,8501,1,6,5,3,17,9,8,23
Delhi Dynamo,8501,2,5,7,2,26,16,10,22
NorthEast Un,8501,3,5,3,6,12,13,-1,18
Kolkata,8501,4,3,8,3,15,16,-1,17
FC Pune City,8501,5,4,5,5,14,16,-2,17
Chennaiyin,8501,6,4,5,5,15,18,-3,17
Kerala Blast,8501,7,4,5,5,11,16,-5,17
FC Goa,8501,8,5,2,7,12,18,-6,17
Mumbai City,8502,1,6,5,3,17,9,8,23
Delhi Dynamo,8502,2,5,7,2,24,16,8,22
Kerala Blast,8502,3,6,4,4,15,15,0,22
FC Pune City,8502,4,5,4,5,13,14,-1,19
Chennaiyin,8502,5,4,6,4,16,18,-2,18
Kolkata,8502,6,3,7,4,14,16,-2,16
NorthEast Un,8502,7,4,3,7,12,16,-4,15
FC Goa,8502,8,3,4,7,10,17,-7,13
Mumbai City,8503,1,7,4,3,18,8,10,25
FC Pune City,8503,2,6,3,5,18,16,2,21
Chennaiyin,8503,3,5,5,4,20,17,3,20
Delhi Dynamo,8503,4,4,6,4,22,19,3,18
NorthEast Un,8503,5,5,3,6,11,13,-2,18
Kolkata,8503,6,3,8,3,15,15,0,17
Kerala Blast,8503,7,4,5,5,11,18,-7,17
FC Goa,8503,8,3,4,7,11,20,-9,13
Mumbai City,8504,1,6,5,3,16,8,8,23
NorthEast Un,8504,2,7,2,5,14,11,3,23
Kolkata,8504,3,5,6,3,16,17,-1,21
Delhi Dynamo,8504,4,4,6,4,22,17,5,18
FC Goa,8504,5,5,3,6,14,14,0,18
Kerala Blast,8504,6,5,3,6,11,17,-6,18
FC Pune City,8504,7,4,3,7,13,17,-4,15
Chennaiyin,8504,8,3,6,5,14,19,-5,15
Mumbai City,8505,1,7,4,3,17,8,9,25
Delhi Dynamo,8505,2,5,6,3,24,17,7,21
Kolkata,8505,3,5,6,3,16,14,2,21
Kerala Blast,8505,4,6,3,5,12,14,-2,21
Chennaiyin,8505,5,4,6,4,15,17,-2,18
NorthEast Un,8505,6,4,3,7,10,13,-3,15
FC Pune City,8505,7,4,3,7,12,17,-5,15
FC Goa,8505,8,4,3,7,11,17,-6,15
Delhi Dynamo,8506,1,6,6,2,28,18,10,24
Mumbai City,8506,2,6,5,3,18,10,8,23
Kolkata,8506,3,4,7,3,16,16,0,19
Kerala Blast,8506,4,5,4,5,13,16,-3,19
FC Pune City,8506,5,5,3,6,14,16,-2,18
Chennaiyin,8506,6,4,6,4,15,18,-3,18
NorthEast Un,8506,7,4,3,7,10,12,-2,15
FC Goa,8506,8,3,4,7,11,19,-8,13
Mumbai City,8507,1,7,4,3,17,8,9,25
Delhi Dynamo,8507,2,4,7,3,26,20,6,19
NorthEast Un,8507,3,5,4,5,14,12,2,19
Kerala Blast,8507,4,5,4,5,12,17,-5,19
FC Pune City,8507,5,5,3,6,14,15,-1,18
Kolkata,8507,6,3,8,3,16,17,-1,17
Chennaiyin,8507,7,3,7,4,14,18,-4,16
FC Goa,8507,8,3,5,6,12,18,-6,14
Mumbai City,8508,1,7,4,3,19,9,10,25
Kerala Blast,8508,2,7,3,4,16,13,3,24
Delhi Dynamo,8508,3,4,6,4,22,18,4,18
FC Pune City,8508,4,5,3,6,14,15,-1,18
NorthEast Un,8508,5,5,3,6,11,12,-1,18
Chennaiyin,8508,6,4,6,4,16,19,-3,18
Kolkata,8508,7,3,6,5,13,19,-6,15
FC Goa,8508,8,4,3,7,10,16,-6,15
Mumbai City,8509,1,7,4,3,18,9,9,25
Chennaiyin,8509,2,5,5,4,16,17,-1,20
Kolkata,8509,3,4,7,3,17,14,3,19
Delhi Dynamo,8509,4,4,6,4,22,17,5,18
FC Pune City,8509,5,5,3,6,13,17,-4,18
FC Goa,8509,6,5,2,7,10,15,-5,17
Kerala Blast,8509,6,4,5,5,10,15,-5,17
NorthEast Un,8509,8,4,4,6,9,11,-2,16
Mumbai City,8510,1,7,4,3,19,9,10,25
Delhi Dynamo,8510,2,6,5,3,27,18,9,23
Kerala Blast,8510,3,5,5,4,13,15,-2,20
Kolkata,8510,4,4,7,3,17,16,1,19
FC Pune City,8510,5,5,4,5,14,15,-1,19
NorthEast Un,8510,6,5,2,7,12,14,-2,17
Chennaiyin,8510,7,3,6,5,13,18,-5,15
FC Goa,8510,8,3,3,8,9,19,-10,12
Delhi Dynamo,8511,1,7,5,2,27,16,11,26
Mumbai City,8511,2,6,4,4,17,10,7,22
Kolkata,8511,3,5,6,3,20,14,6,21
NorthEast Un,8511,4,5,3,6,11,10,1,18
Chennaiyin,8511,5,4,6,4,16,19,-3,18
FC Pune City,8511,6,4,4,6,12,19,-7,16
Kerala Blast,8511,7,4,4,6,10,17,-7,16
FC Goa,8511,8,4,2,8,12,20,-8,14
Mumbai City,8512,1,7,4,3,20,10,10,25
Kolkata,8512,2,5,6,3,17,15,2,21
Delhi Dynamo,8512,3,5,5,4,26,22,4,20
Chennaiyin,8512,4,5,5,4,17,19,-2,20
NorthEast Un,8512,5,5,3,6,15,13,2,18
FC Pune City,8512,6,5,3,6,15,16,-1,18
Kerala Blast,8512,7,4,4,6,10,18,-8,16
FC Goa,8512,8,4,2,8,11,18,-7,14
Delhi Dynamo,8513,1,6,5,3,25,17,8,23
Mumbai City,8513,2,6,4,4,17,11,6,22
Kolkata,8513,3,5,7,2,18,15,3,22
FC Pune City,8513,4,5,4,5,13,14,-1,19
Chennaiyin,8513,5,4,6,4,18,21,-3,18
Kerala Blast,8513,6,5,3,6,13,16,-3,18
FC Goa,8513,7,4,3,7,13,18,-5,15
NorthEast Un,8513,8,4,2,8,12,17,-5,14
Mumbai City,8514,1,7,4,3,18,9,9,25
Delhi Dynamo,8514,2,5,5,4,24,18,6,20
Kolkata,8514,3,4,7,3,15,14,1,19
Kerala Blast,8514,4,5,4,5,13,15,-2,19
Chennaiyin,8514,5,4,6,4,16,18,-2,18
FC Pune City,8514,6,5,3,6,14,16,-2,18
NorthEast Un,8514,7,5,3,6,12,14,-2,18
FC Goa,8514,8,4,2,8,10,18,-8,14
Mumbai City,8515,1,7,4,3,17,8,9,25
Delhi Dynamo,8515,2,6,5,3,28,19,9,23
FC Pune City,8515,3,6,3,5,16,15,1,21
NorthEast Un,8515,4,6,2,6,16,13,3,20
Kolkata,8515,5,3,8,3,17,18,-1,17
Kerala Blast,8515,6,4,4,6,10,17,-7,16
FC Goa,8515,7,4,3,7,17,22,-5,15
Chennaiyin,8515,8,3,5,6,14,23,-9,14
Mumbai City,8516,1,6,5,3,17,9,8,23
Delhi Dynamo,8516,2,5,6,3,27,21,6,21
NorthEast Un,8516,3,6,2,6,17,14,3,20
Kerala Blast,8516,4,5,5,4,14,16,-2,20
Kolkata,8516,5,3,9,2,17,16,1,18
FC Pune City,8516,6,4,5,5,14,16,-2,17
FC Goa,8516,7,4,3,7,13,19,-6,15
Chennaiyin,8516,8,3,5,6,13,21,-8,14
Mumbai City,8517,1,6,5,3,18,10,8,23
Delhi Dynamo,8517,2,5,7,2,28,18,10,22
Kerala Blast,8517,3,6,3,5,14,15,-1,21
NorthEast Un,8517,4,5,3,6,12,13,-1,18
Chennaiyin,8517,5,4,6,4,19,21,-2,18
FC Pune City,8517,6,4,4,6,13,16,-3,16
Kolkata,8517,7,3,7,4,15,21,-6,16
FC Goa,8517,8,4,3,7,16,21,-5,15
Mumbai City,8518,1,7,4,3,19,8,11,25
Kolkata,8518,2,5,7,2,15,12,3,22
Delhi Dynamo,8518,3,5,6,3,25,19,6,21
Kerala Blast,8518,4,5,4,5,11,15,-4,19
Chennaiyin,8518,5,4,5,5,16,20,-4,17
FC Pune City,8518,6,4,4,6,12,15,-3,16
FC Goa,8518,7,4,3,7,12,16,-4,15
NorthEast Un,8518,8,4,3,7,11,16,-5,15
Mumbai City,8519,1,7,4,3,19,9,10,25
NorthEast Un,8519,2,7,2,5,15,9,6,23
Delhi Dynamo,8519,3,5,5,4,26,21,5,20
Kolkata,8519,4,4,8,2,17,15,2,20
FC Pune City,8519,5,5,3,6,15,16,-1,18
Kerala Blast,8519,6,4,4,6,10,17,-7,16
Chennaiyin,8519,7,3,6,5,13,18,-5,15
FC Goa,8519,8,3,4,7,9,19,-10,13
Delhi Dynamo,8520,1,6,5,3,27,19,8,23
Mumbai City,8520,2,6,4,4,17,11,6,22
Kolkata,8520,3,5,6,3,15,13,2,21
NorthEast Un,8520,4,6,2,6,14,10,4,20
Chennaiyin,8520,5,5,5,4,18,18,0,20
Kerala Blast,8520,6,5,4,5,12,17,-5,19
FC Pune City,8520,7,4,4,6,14,17,-3,16
FC Goa,8520,8,3,2,9,10,22,-12,11
Mumbai City,8521,1,6,4,4,16,9,7,22
Delhi Dynamo,8521,2,5,6,3,24,17,7,21
FC Goa,8521,3,6,2,6,14,17,-3,20
Kolkata,8521,4,4,7,3,16,14,2,19
Kerala Blast,8521,5,4,6,4,10,14,-4,18
Chennaiyin,8521,6,4,5,5,17,20,-3,17
NorthEast Un,8521,7,4,4,6,12,14,-2,16
FC Pune City,8521,8,4,4,6,12,16,-4,16
Mumbai City,8522,1,7,4,3,20,9,11,25
Delhi Dynamo,8522,2,5,6,3,28,21,7,21
FC Pune City,8522,3,6,3,5,16,15,1,21
Kolkata,8522,3,5,6,3,16,15,1,21
NorthEast Un,8522,5,5,3,6,14,13,1,18
Kerala Blast,8522,6,5,3,6,10,15,-5,18
Chennaiyin,8522,7,3,5,6,14,22,-8,14
FC Goa,8522,8,4,2,8,11,19,-8,14
Mumbai City,8523,1,6,5,3,18,10,8,23
Delhi Dynamo,8523,2,5,6,3,25,17,8,21
Kerala Blast,8523,3,5,5,4,11,14,-3,20
FC Pune City,8523,4,5,4,5,14,14,0,19
NorthEast Un,8523,5,5,3,6,13,13,0,18
Chennaiyin,8523,6,4,6,4,17,19,-2,18
Kolkata,8523,7,3,7,4,13,17,-4,16
FC Goa,8523,8,4,2,8,11,18,-7,14
Mumbai City,8524,1,7,4,3,21,8,13,25
NorthEast Un,8524,2,5,4,5,16,12,4,19
Kerala Blast,8524,3,5,4,5,10,17,-7,19
Delhi Dynamo,8524,4,4,6,4,23,22,1,18
FC Pune City,8524,5,5,3,6,15,17,-2,18
Kolkata,8524,6,3,8,3,17,17,0,17
Chennaiyin,8524,7,3,7,4,18,22,-4,16
FC Goa,8524,8,4,4,6,15,20,-5,16
Delhi Dynamo,8525,1,6,5,3,26,20,6,23
NorthEast Un,8525,2,7,2,5,16,10,6,23
Mumbai City,8525,3,6,4,4,17,10,7,22
Kolkata,8525,4,4,8,2,19,17,2,20
Kerala Blast,8525,5,5,4,5,13,17,-4,19
FC Pune City,8525,6,4,4,6,14,18,-4,16
Chennaiyin,8525,7,3,6,5,14,19,-5,15
FC Goa,8525,8,3,3,8,11,19,-8,12
Mumbai City,8526,1,7,4,3,18,9,9,25
Kolkata,8526,2,6,6,2,20,16,4,24
Delhi Dynamo,8526,3,4,7,3,24,18,6,19
Chennaiyin,8526,4,4,6,4,18,19,-1,18
FC Pune City,8526,5,5,3,6,16,17,-1,18
Kerala Blast,8526,6,5,3,6,14,20,-6,18
NorthEast Un,8526,7,4,3,7,13,17,-4,15
FC Goa,8526,8,3,4,7,10,17,-7,13
Mumbai City,8527,1,6,5,3,16,8,8,23
Delhi Dynamo,8527,2,5,7,2,26,17,9,22
Kolkata,8527,3,4,8,2,17,14,3,20
Kerala Blast,8527,4,5,5,4,12,15,-3,20
NorthEast Un,8527,5,5,2,7,15,14,1,17
FC Pune City,8527,6,4,4,6,13,17,-4,16
FC Goa,8527,7,4,4,6,12,16,-4,16
Chennaiyin,8527,8,3,5,6,13,23,-10,14
Mumbai City,8528,1,7,4,3,21,9,12,25
FC Pune City,8528,2,6,3,5,19,14,5,21
Kolkata,8528,3,5,6,3,16,15,1,21
NorthEast Un,8528,4,6,2,6,13,17,-4,20
Delhi Dynamo,8528,5,4,6,4,23,21,2,18
Kerala Blast,8528,6,5,3,6,15,18,-3,18
Chennaiyin,8528,7,3,6,5,15,20,-5,15
FC Goa,8528,8,3,4,7,9,17,-8,13
Mumbai City,8529,1,6,5,3,17,9,8,23
Delhi Dynamo,8529,2,5,6,3,26,20,6,21
NorthEast Un,8529,3,6,2,6,16,12,4,20
Kolkata,8529,4,4,6,4,17,17,0,18
FC Pune City,8529,5,5,3,6,16,17,-1,18
Chennaiyin,8529,6,4,6,4,14,17,-3,18
Kerala Blast,8529,7,5,3,6,12,20,-8,18
FC Goa,8529,8,4,3,7,11,17,-6,15
Mumbai City,8530,1,7,4,3,18,8,10,25
Kerala Blast,8530,2,6,4,4,13,15,-2,22
Delhi Dynamo,8530,3,5,6,3,23,16,7,21
Kolkata,8530,4,4,7,3,17,18,-1,19
FC Goa,8530,5,5,2,7,16,16,0,17
Chennaiyin,8530,6,4,5,5,14,22,-8,17
NorthEast Un,8530,7,4,3,7,9,11,-2,15
FC Pune City,8530,8,4,3,7,15,19,-4,15
Kerala Blast,8531,1,7,3,4,16,16,0,24
Mumbai City,8531,2,6,4,4,16,9,7,22
Delhi Dynamo,8531,3,5,5,4,23,19,4,20
Kolkata,8531,4,4,6,4,18,16,2,18
NorthEast Un,8531,5,5,3,6,14,13,1,18
FC Pune City,8531,6,5,3,6,14,16,-2,18
Chennaiyin,8531,7,4,6,4,16,19,-3,18
FC Goa,8531,8,4,2,8,12,21,-9,14
Mumbai City,8532,1,7,4,3,18,9,9,25
Delhi Dynamo,8532,2,6,5,3,26,18,8,23
FC Pune City,8532,3,6,3,5,19,18,1,21
Kolkata,8532,4,4,7,3,17,16,1,19
NorthEast Un,8532,5,5,3,6,12,11,1,18
Chennaiyin,8532,6,3,7,4,13,17,-4,16
Kerala Blast,8532,7,4,4,6,12,20,-8,16
FC Goa,8532,8,3,3,8,9,17,-8,12
Kerala Blast,8533,1,7,3,4,17,17,0,24
Mumbai City,8533,2,6,5,3,17,9,8,23
Delhi Dynamo,8533,3,4,7,3,23,17,6,19
FC Goa,8533,4,5,3,6,12,15,-3,18
NorthEast Un,8533,5,5,2,7,11,12,-1,17
Chennaiyin,8533,6,4,5,5,14,18,-4,17
Kolkata,8533,7,3,7,4,15,17,-2,16
FC Pune City,8533,8,4,4,6,13,17,-4,16
Mumbai City,8534,1,7,4,3,20,8,12,25
Kerala Blast,8534,2,7,3,4,16,15,1,24
Delhi Dynamo,8534,3,5,6,3,24,19,5,21
Kolkata,8534,4,4,7,3,18,16,2,19
NorthEast Un,8534,5,5,3,6,12,12,0,18
Chennaiyin,8534,6,4,5,5,16,20,-4,17
FC Pune City,8534,7,4,3,7,12,19,-7,15
FC Goa,8534,8,3,3,8,12,21,-9,12
Delhi Dynamo,8535,1,6,6,2,27,16,11,24
Mumbai City,8535,2,6,5,3,17,9,8,23
Kerala Blast,8535,3,6,4,4,14,16,-2,22
Kolkata,8535,4,3,8,3,17,17,0,17
NorthEast Un,8535,5,4,4,6,10,11,-1,16
FC Pune City,8535,6,4,4,6,14,17,-3,16
Chennaiyin,8535,7,3,7,4,14,18,-4,16
FC Goa,8535,8,3,4,7,12,21,-9,13
Mumbai City,8536,1,6,5,3,16,8,8,23
Delhi Dynamo,8536,2,5,6,3,22,16,6,21
NorthEast Un,8536,3,6,2,6,15,11,4,20
Kolkata,8536,4,4,7,3,15,15,0,19
FC Pune City,8536,5,4,5,5,12,14,-2,17
FC Goa,8536,6,5,2,7,12,15,-3,17
Chennaiyin,8536,7,4,5,5,15,20,-5,17
Kerala Blast,8536,8,4,4,6,10,18,-8,16
Mumbai City,8537,1,7,4,3,17,8,9,25
Delhi Dynamo,8537,2,5,6,3,23,15,8,21
Kerala Blast,8537,3,5,5,4,12,14,-2,20
FC Pune City,8537,4,5,4,5,13,14,-1,19
NorthEast Un,8537,5,4,5,5,11,11,0,17
FC Goa,8537,6,5,2,7,11,17,-6,17
Kolkata,8537,7,3,6,5,14,17,-3,15
Chennaiyin,8537,8,3,6,5,14,19,-5,15
Mumbai City,8538,1,6,5,3,16,8,8,23
Delhi Dynamo,8538,2,5,6,3,23,16,7,21
Kerala Blast,8538,3,6,3,5,13,16,-3,21
NorthEast Un,8538,4,6,2,6,15,12,3,20
Kolkata,8538,5,4,7,3,17,16,1,19
FC Pune City,8538,6,5,4,5,15,16,-1,19
Chennaiyin,8538,7,3,6,5,15,22,-7,15
FC Goa,8538,8,3,3,8,12,20,-8,12
Delhi Dynamo,8539,1,6,6,2,29,17,12,24
Mumbai City,8539,2,6,5,3,18,10,8,23
NorthEast Un,8539,3,6,2,6,12,12,0,20
Kolkata,8539,4,4,7,3,16,15,1,19
Chennaiyin,8539,5,4,5,5,17,19,-2,17
Kerala Blast,8539,6,4,5,5,9,14,-5,17
FC Pune City,8539,7,4,4,6,14,17,-3,16
FC Goa,8539,8,4,2,8,10,21,-11,14
Delhi Dynamo,8540,1,6,6,2,27,17,10,24
Kolkata,8540,2,6,6,2,19,14,5,24
Mumbai City,8540,3,6,4,4,17,10,7,22
Kerala Blast,8540,4,5,4,5,12,15,-3,19
Chennaiyin,8540,5,4,6,4,17,19,-2,18
NorthEast Un,8540,6,4,5,5,11,11,0,17
FC Pune City,8540,7,4,3,7,14,19,-5,15
FC Goa,8540,8,3,2,9,11,23,-12,11
Delhi Dynamo,8541,1,6,6,2,28,16,12,24
Mumbai City,8541,2,6,5,3,18,10,8,23
Kolkata,8541,3,5,7,2,21,15,6,22
Kerala Blast,8541,4,5,4,5,13,17,-4,19
FC Pune City,8541,5,5,3,6,14,16,-2,18
NorthEast Un,8541,6,5,2,7,12,13,-1,17
Chennaiyin,8541,7,3,5,6,14,21,-7,14
FC Goa,8541,8,4,2,8,10,22,-12,14
Mumbai City,8542,1,7,4,3,18,9,9,25
Delhi Dynamo,8542,2,6,5,3,28,19,9,23
NorthEast Un,8542,3,6,2,6,15,13,2,20
Kolkata,8542,4,4,7,3,18,17,1,19
Kerala Blast,8542,5,5,4,5,12,16,-4,19
FC Goa,8542,6,5,2,7,13,19,-6,17
FC Pune City,8542,7,4,3,7,13,17,-4,15
Chennaiyin,8542,8,3,5,6,15,22,-7,14
Mumbai City,8543,1,6,5,3,18,10,8,23
Kerala Blast,8543,2,6,4,4,12,14,-2,22
Delhi Dynamo,8543,3,5,6,3,25,17,8,21
Kolkata,8543,4,4,7,3,14,14,0,19
NorthEast Un,8543,5,5,3,6,10,10,0,18
Chennaiyin,8543,6,4,6,4,16,18,-2,18
FC Pune City,8543,7,4,3,7,13,17,-4,15
FC Goa,8543,8,4,2,8,11,19,-8,14
Mumbai City,8544,1,6,4,4,17,10,7,22
Delhi Dynamo,8544,2,5,6,3,25,21,4,21
Kolkata,8544,3,5,6,3,18,14,4,21
Kerala Blast,8544,4,5,4,5,14,19,-5,19
NorthEast Un,8544,5,5,3,6,15,13,2,18
FC Goa,8544,6,5,3,6,11,15,-4,18
FC Pune City,8544,7,4,4,6,14,17,-3,16
Chennaiyin,8544,8,3,6,5,14,19,-5,15
Mumbai City,8545,1,6,5,3,17,9,8,23
Delhi Dynamo,8545,2,5,6,3,23,16,7,21
Kerala Blast,8545,3,5,5,4,15,18,-3,20
Kolkata,8545,4,4,7,3,17,14,3,19
FC Pune City,8545,5,4,5,5,16,18,-2,17
FC Goa,8545,6,5,2,7,12,19,-7,17
NorthEast Un,8545,7,4,4,6,12,13,-1,16
Chennaiyin,8545,8,3,6,5,16,21,-5,15
Delhi Dynamo,8546,1,6,6,2,30,16,14,24
Mumbai City,8546,2,6,4,4,17,13,4,22
NorthEast Un,8546,3,6,3,5,13,11,2,21
Kerala Blast,8546,4,6,3,5,13,15,-2,21
Kolkata,8546,5,4,7,3,14,14,0,19
FC Pune City,8546,6,4,4,6,12,15,-3,16
Chennaiyin,8546,7,3,5,6,14,20,-6,14
FC Goa,8546,8,4,2,8,10,19,-9,14
Mumbai City,8547,1,6,5,3,16,8,8,23
Delhi Dynamo,8547,2,5,6,3,23,16,7,21
Chennaiyin,8547,3,5,5,4,16,18,-2,20
Kolkata,8547,4,4,7,3,15,16,-1,19
NorthEast Un,8547,5,5,3,6,11,10,1,18
FC Pune City,8547,6,4,5,5,13,15,-2,17
Kerala Blast,8547,7,4,5,5,10,15,-5,17
FC Goa,8547,8,4,2,8,13,19,-6,14
Mumbai City,8548,1,7,4,3,18,9,9,25
Kolkata,8548,2,5,7,2,18,13,5,22
Delhi Dynamo,8548,3,5,5,4,25,19,6,20
FC Goa,8548,4,5,3,6,11,15,-4,18
Kerala Blast,8548,5,5,3,6,11,17,-6,18
NorthEast Un,8548,6,5,2,7,11,12,-1,17
Chennaiyin,8548,7,4,5,5,14,18,-4,17
FC Pune City,8548,8,4,3,7,12,17,-5,15
Delhi Dynamo,8549,1,6,6,2,27,17,10,24
Mumbai City,8549,2,6,5,3,17,9,8,23
Kolkata,8549,3,5,6,3,16,14,2,21
Kerala Blast,8549,4,5,5,4,11,14,-3,20
NorthEast Un,8549,5,4,4,6,12,13,-1,16
FC Pune City,8549,6,4,4,6,13,16,-3,16
Chennaiyin,8549,7,3,6,5,13,18,-5,15
FC Goa,8549,8,4,2,8,9,17,-8,14
Delhi Dynamo,8550,1,6,6,2,27,17,10,24
Kolkata,8550,2,6,6,2,19,14,5,24
Mumbai City,8550,3,6,5,3,17,9,8,23
Kerala Blast,8550,4,5,4,5,14,16,-2,19
Chennaiyin,8550,5,4,6,4,16,18,-2,18
NorthEast Un,8550,6,4,3,7,12,15,-3,15
FC Pune City,8550,7,4,3,7,12,18,-6,15
FC Goa,8550,8,3,3,8,12,22,-10,12
Delhi Dynamo,8551,1,5,7,2,26,18,8,22
Mumbai City,8551,2,6,4,4,18,11,7,22
Kolkata,8551,3,5,6,3,21,16,5,21
NorthEast Un,8551,4,5,3,6,14,12,2,18
FC Pune City,8551,5,5,3,6,16,18,-2,18
Kerala Blast,8551,6,5,3,6,11,19,-8,18
Chennaiyin,8551,7,4,5,5,17,23,-6,17
FC Goa,8551,8,4,3,7,12,18,-6,15
Mumbai City,8552,1,6,5,3,17,9,8,23
Delhi Dynamo,8552,2,5,6,3,29,19,10,21
NorthEast Un,8552,3,6,2,6,15,13,2,20
Chennaiyin,8552,4,5,5,4,17,18,-1,20
FC Pune City,8552,5,5,4,5,17,18,-1,19
Kerala Blast,8552,6,5,4,5,14,17,-3,19
Kolkata,8552,7,3,7,4,18,20,-2,16
FC Goa,8552,8,3,3,8,10,23,-13,12
Delhi Dynamo,8553,1,6,5,3,27,19,8,23
Mumbai City,8553,2,6,4,4,16,9,7,22
NorthEast Un,8553,3,6,2,6,16,12,4,20
Kolkata,8553,4,4,7,3,15,14,1,19
FC Pune City,8553,5,5,3,6,15,15,0,18
Chennaiyin,8553,6,4,6,4,17,19,-2,18
Kerala Blast,8553,7,4,4,6,10,20,-10,16
FC Goa,8553,8,4,3,7,12,20,-8,15
Mumbai City,8554,1,6,5,3,16,8,8,23
Kolkata,8554,2,5,6,3,19,16,3,21
Delhi Dynamo,8554,3,4,8,2,25,18,7,20
Kerala Blast,8554,4,5,4,5,12,17,-5,19
FC Goa,8554,5,5,3,6,13,17,-4,18
Chennaiyin,8554,6,4,5,5,17,20,-3,17
NorthEast Un,8554,7,4,4,6,14,16,-2,16
FC Pune City,8554,8,4,3,7,13,17,-4,15
Delhi Dynamo,8555,1,6,5,3,25,15,10,23
Mumbai City,8555,2,6,4,4,16,10,6,22
Kolkata,8555,3,4,8,2,18,15,3,20
NorthEast Un,8555,4,6,2,6,13,14,-1,20
FC Pune City,8555,5,5,3,6,14,16,-2,18
Chennaiyin,8555,6,4,5,5,18,19,-1,17
Kerala Blast,8555,7,4,4,6,11,19,-8,16
FC Goa,8555,8,4,3,7,10,17,-7,15
Kerala Blast,8556,1,7,3,4,17,14,3,24
Mumbai City,8556,2,6,5,3,18,10,8,23
Delhi Dynamo,8556,3,5,7,2,25,16,9,22
Chennaiyin,8556,4,4,6,4,15,18,-3,18
Kolkata,8556,5,4,6,4,14,17,-3,18
NorthEast Un,8556,6,4,4,6,10,12,-2,16
FC Pune City,8556,7,4,3,7,13,19,-6,15
FC Goa,8556,8,4,2,8,11,17,-6,14
Mumbai City,8557,1,7,4,3,18,8,10,25
Delhi Dynamo,8557,2,6,5,3,27,17,10,23
Kerala Blast,8557,3,6,4,4,13,14,-1,22
Kolkata,8557,4,5,6,3,19,16,3,21
Chennaiyin,8557,5,5,5,4,19,21,-2,20
FC Pune City,8557,6,4,4,6,12,16,-4,16
NorthEast Un,8557,7,4,2,8,10,14,-4,14
FC Goa,8557,8,3,2,9,13,25,-12,11
Mumbai City,8558,1,6,5,3,17,9,8,23
Delhi Dynamo,8558,2,5,7,2,24,15,9,22
FC Pune City,8558,3,5,4,5,14,14,0,19
Kolkata,8558,4,4,6,4,15,16,-1,18
NorthEast Un,8558,5,4,5,5,11,11,0,17
Kerala Blast,8558,6,4,5,5,10,15,-5,17
Chennaiyin,8558,7,3,7,4,14,18,-4,16
FC Goa,8558,8,4,3,7,10,17,-7,15
Mumbai City,8559,1,7,4,3,17,8,9,25
Delhi Dynamo,8559,2,5,5,4,24,17,7,20
Kolkata,8559,3,4,8,2,16,14,2,20
Kerala Blast,8559,4,5,5,4,12,15,-3,20
Chennaiyin,8559,5,4,6,4,16,19,-3,18
FC Pune City,8559,6,4,5,5,13,15,-2,17
NorthEast Un,8559,7,4,3,7,11,14,-3,15
FC Goa,8559,8,4,2,8,11,18,-7,14
Mumbai City,8560,1,7,4,3,18,8,10,25
Kolkata,8560,2,5,6,3,15,16,-1,21
Kerala Blast,8560,3,6,3,5,14,15,-1,21
Delhi Dynamo,8560,4,5,5,4,23,19,4,20
FC Pune City,8560,5,5,3,6,17,18,-1,18
FC Goa,8560,6,5,2,7,13,15,-2,17
NorthEast Un,8560,7,4,3,7,10,12,-2,15
Chennaiyin,8560,8,3,6,5,13,20,-7,15
Delhi Dynamo,8561,1,7,5,2,28,16,12,26
Kolkata,8561,2,6,6,2,20,13,7,24
Mumbai City,8561,3,6,4,4,16,10,6,22
FC Pune City,8561,4,5,3,6,14,16,-2,18
Chennaiyin,8561,5,4,5,5,15,19,-4,17
Kerala Blast,8561,6,4,4,6,9,16,-7,16
NorthEast Un,8561,7,4,3,7,11,14,-3,15
FC Goa,8561,8,4,2,8,11,20,-9,14
Mumbai City,8562,1,7,4,3,17,8,9,25
Delhi Dynamo,8562,2,5,6,3,25,16,9,21
FC Pune City,8562,3,5,4,5,16,17,-1,19
NorthEast Un,8562,4,5,3,6,12,12,0,18
Kolkata,8562,5,3,8,3,15,16,-1,17
Chennaiyin,8562,6,4,5,5,15,19,-4,17
FC Goa,8562,7,5,2,7,12,18,-6,17
Kerala Blast,8562,8,4,4,6,13,19,-6,16
Delhi Dynamo,8563,1,6,6,2,27,17,10,24
Mumbai City,8563,2,6,4,4,16,10,6,22
FC Pune City,8563,3,6,3,5,17,15,2,21
Chennaiyin,8563,4,5,5,4,15,17,-2,20
Kolkata,8563,5,4,6,4,18,18,0,18
NorthEast Un,8563,6,4,4,6,12,13,-1,16
Kerala Blast,8563,7,4,4,6,10,19,-9,16
FC Goa,8563,8,4,2,8,11,17,-6,14
Mumbai City,8564,1,7,4,3,17,8,9,25
Delhi Dynamo,8564,2,5,6,3,24,16,8,21
Kolkata,8564,3,4,8,2,18,15,3,20
NorthEast Un,8564,4,5,4,5,13,11,2,19
FC Pune City,8564,5,4,5,5,14,16,-2,17
Kerala Blast,8564,6,4,5,5,11,17,-6,17
Chennaiyin,8564,7,3,7,4,13,17,-4,16
FC Goa,8564,8,3,3,8,10,20,-10,12
Delhi Dynamo,8565,1,6,5,3,25,16,9,23
Mumbai City,8565,2,6,4,4,16,9,7,22
Kerala Blast,8565,3,6,3,5,14,16,-2,21
NorthEast Un,8565,4,6,2,6,14,12,2,20
Kolkata,8565,5,4,7,3,15,14,1,19
FC Goa,8565,6,5,2,7,11,16,-5,17
FC Pune City,8565,7,4,4,6,12,17,-5,16
Chennaiyin,8565,8,3,5,6,14,21,-7,14
Mumbai City,8566,1,6,5,3,16,8,8,23
NorthEast Un,8566,2,6,3,5,16,12,4,21
FC Goa,8566,3,6,2,6,14,17,-3,20
Delhi Dynamo,8566,4,4,7,3,24,18,6,19
FC Pune City,8566,5,5,4,5,15,15,0,19
Kolkata,8566,6,4,6,4,17,17,0,18
Kerala Blast,8566,7,4,4,6,9,16,-7,16
Chennaiyin,8566,8,3,5,6,15,23,-8,14
Mumbai City,8567,1,7,4,3,20,9,11,25
Kolkata,8567,2,5,6,3,18,14,4,21
Kerala Blast,8567,3,6,3,5,13,17,-4,21
Delhi Dynamo,8567,4,5,5,4,23,20,3,20
FC Goa,8567,5,6,2,6,14,15,-1,20
Chennaiyin,8567,6,4,5,5,14,19,-5,17
FC Pune City,8567,7,4,3,7,12,17,-5,15
NorthEast Un,8567,8,4,2,8,11,14,-3,14
Mumbai City,8568,1,7,4,3,17,8,9,25
NorthEast Un,8568,2,6,3,5,12,9,3,21
FC Pune City,8568,3,5,4,5,15,15,0,19
Kerala Blast,8568,4,5,4,5,12,16,-4,19
Delhi Dynamo,8568,5,4,6,4,21,16,5,18
Kolkata,8568,6,4,6,4,16,18,-2,18
Chennaiyin,8568,7,4,6,4,15,18,-3,18
FC Goa,8568,8,3,3,8,11,19,-8,12
Delhi Dynamo,8569,1,7,5,2,28,14,14,26
Mumbai City,8569,2,6,4,4,16,11,5,22
Kerala Blast,8569,3,5,4,5,13,16,-3,19
Kolkata,8569,4,4,6,4,17,17,0,18
Chennaiyin,8569,5,4,6,4,17,20,-3,18
FC Pune City,8569,6,5,3,6,13,16,-3,18
NorthEast Un,8569,7,4,3,7,12,14,-2,15
FC Goa,8569,8,4,3,7,11,19,-8,15
Delhi Dynamo,8570,1,6,6,2,25,16,9,24
Kolkata,8570,2,6,6,2,17,12,5,24
Mumbai City,8570,3,6,5,3,17,9,8,23
NorthEast Un,8570,4,5,2,7,13,15,-2,17
Chennaiyin,8570,5,4,5,5,15,18,-3,17
FC Pune City,8570,6,4,4,6,13,16,-3,16
Kerala Blast,8570,7,4,4,6,12,18,-6,16
FC Goa,8570,8,4,2,8,9,17,-8,14
Mumbai City,8571,1,7,4,3,18,8,10,25
FC Pune City,8571,2,6,3,5,15,15,0,21
Kerala Blast,8571,3,6,3,5,12,14,-2,21
NorthEast Un,8571,4,6,2,6,15,11,4,20
Delhi Dynamo,8571,5,4,6,4,22,21,1,18
Chennaiyin,8571,6,4,5,5,17,20,-3,17
Kolkata,8571,7,3,6,5,14,17,-3,15
FC Goa,8571,8,4,3,7,11,18,-7,15
Mumbai City,8572,1,6,5,3,17,9,8,23
NorthEast Un,8572,2,7,2,5,15,11,4,23
Delhi Dynamo,8572,3,5,6,3,25,17,8,21
Kolkata,8572,4,4,8,2,19,17,2,20
FC Pune City,8572,5,5,3,6,16,18,-2,18
Kerala Blast,8572,6,4,4,6,11,17,-6,16
FC Goa,8572,7,4,3,7,11,19,-8,15
Chennaiyin,8572,8,3,5,6,15,21,-6,14
Delhi Dynamo,8573,1,5,7,2,24,15,9,22
Mumbai City,8573,2,6,4,4,16,10,6,22
Kerala Blast,8573,3,5,5,4,14,16,-2,20
Kolkata,8573,4,4,7,3,15,14,1,19
FC Pune City,8573,5,5,4,5,15,16,-1,19
NorthEast Un,8573,6,4,4,6,12,14,-2,16
Chennaiyin,8573,7,3,7,4,16,20,-4,16
FC Goa,8573,8,3,4,7,9,16,-7,13
Mumbai City,8574,1,7,4,3,18,8,10,25
Kerala Blast,8574,2,6,3,5,17,16,1,21
NorthEast Un,8574,3,5,4,5,13,12,1,19
Delhi Dynamo,8574,4,4,6,4,22,18,4,18
Kolkata,8574,5,4,6,4,15,17,-2,18
Chennaiyin,8574,6,4,6,4,17,20,-3,18
FC Pune City,8574,7,5,3,6,14,18,-4,18
FC Goa,8574,8,4,2,8,12,19,-7,14
Mumbai City,8575,1,7,4,3,19,8,11,25
Kolkata,8575,2,5,6,3,17,13,4,21
Delhi Dynamo,8575,3,4,7,3,22,18,4,19
NorthEast Un,8575,4,5,4,5,13,11,2,19
FC Pune City,8575,5,5,3,6,14,16,-2,18
Kerala Blast,8575,6,5,3,6,11,17,-6,18
Chennaiyin,8575,7,3,6,5,15,20,-5,15
FC Goa,8575,8,4,3,7,10,18,-8,15
Mumbai City,8576,1,6,5,3,17,9,8,23
Kolkata,8576,2,5,6,3,20,15,5,21
NorthEast Un,8576,3,6,3,5,14,10,4,21
Delhi Dynamo,8576,4,4,7,3,24,19,5,19
Kerala Blast,8576,5,5,4,5,12,17,-5,19
FC Goa,8576,6,5,3,6,12,16,-4,18
FC Pune City,8576,7,4,3,7,12,18,-6,15
Chennaiyin,8576,8,3,5,6,13,20,-7,14
Kolkata,8577,1,6,6,2,22,15,7,24
Mumbai City,8577,2,6,4,4,16,9,7,22
Delhi Dynamo,8577,3,5,6,3,24,17,7,21
NorthEast Un,8577,4,6,3,5,15,12,3,21
FC Pune City,8577,5,5,3,6,15,17,-2,18
Chennaiyin,8577,6,4,5,5,15,20,-5,17
Kerala Blast,8577,7,4,4,6,13,22,-9,16
FC Goa,8577,8,3,3,8,9,17,-8,12
Delhi Dynamo,8578,1,6,5,3,25,17,8,23
Mumbai City,8578,2,6,4,4,17,10,7,22
FC Pune City,8578,3,6,3,5,15,15,0,21
Kerala Blast,8578,4,5,4,5,15,18,-3,19
Chennaiyin,8578,5,4,6,4,14,17,-3,18
Kolkata,8578,6,3,7,4,15,17,-2,16
FC Goa,8578,7,4,4,6,11,16,-5,16
NorthEast Un,8578,8,4,3,7,11,13,-2,15
Mumbai City,8579,1,6,5,3,17,9,8,23
Delhi Dynamo,8579,2,5,7,2,27,16,11,22
Kolkata,8579,3,4,7,3,19,17,2,19
Kerala Blast,8579,4,5,4,5,11,16,-5,19
FC Goa,8579,5,5,3,6,11,15,-4,18
FC Pune City,8579,6,4,5,5,14,16,-2,17
Chennaiyin,8579,7,4,5,5,14,18,-4,17
NorthEast Un,8579,8,4,2,8,10,16,-6,14
Mumbai City,8580,1,7,4,3,17,8,9,25
Kolkata,8580,2,5,7,2,17,13,4,22
NorthEast Un,8580,3,6,3,5,14,12,2,21
Delhi Dynamo,8580,4,5,5,4,22,16,6,20
Kerala Blast,8580,5,5,4,5,11,15,-4,19
FC Pune City,8580,6,4,4,6,13,17,-4,16
FC Goa,8580,7,4,2,8,10,16,-6,14
Chennaiyin,8580,8,3,5,6,16,23,-7,14
Mumbai City,8581,1,6,5,3,16,8,8,23
Kerala Blast,8581,2,6,4,4,16,16,0,22
Chennaiyin,8581,3,5,5,4,17,19,-2,20
Delhi Dynamo,8581,4,4,7,3,23,17,6,19
FC Pune City,8581,5,5,3,6,15,17,-2,18
Kolkata,8581,6,3,8,3,14,14,0,17
NorthEast Un,8581,7,5,2,7,13,16,-3,17
FC Goa,8581,8,3,4,7,11,18,-7,13
Delhi Dynamo,8582,1,6,5,3,26,16,10,23
Mumbai City,8582,2,6,4,4,16,11,5,22
NorthEast Un,8582,3,6,3,5,14,12,2,21
Kolkata,8582,4,5,6,3,18,18,0,21
FC Pune City,8582,5,5,4,5,18,17,1,19
Kerala Blast,8582,6,4,4,6,12,18,-6,16
Chennaiyin,8582,7,3,6,5,15,20,-5,15
FC Goa,8582,8,4,2,8,10,17,-7,14
Delhi Dynamo,8583,1,6,5,3,28,16,12,23
Mumbai City,8583,2,6,4,4,17,12,5,22
FC Pune City,8583,3,6,3,5,16,14,2,21
FC Goa,8583,4,5,3,6,11,14,-3,18
Kerala Blast,8583,5,4,5,5,10,17,-7,17
Kolkata,8583,6,3,7,4,14,16,-2,16
NorthEast Un,8583,7,4,4,6,10,13,-3,16
Chennaiyin,8583,8,3,7,4,14,18,-4,16
Mumbai City,8584,1,7,4,3,20,8,12,25
Kerala Blast,8584,2,6,4,4,14,14,0,22
Delhi Dynamo,8584,3,5,6,3,23,19,4,21
NorthEast Un,8584,4,5,3,6,11,11,0,18
FC Pune City,8584,5,5,3,6,13,16,-3,18
Kolkata,8584,6,3,7,4,13,15,-2,16
Chennaiyin,8584,7,3,6,5,14,19,-5,15
FC Goa,8584,8,3,5,6,10,16,-6,14
Mumbai City,8585,1,7,4,3,17,8,9,25
Kolkata,8585,2,5,6,3,18,16,2,21
FC Pune City,8585,3,6,3,5,15,14,1,21
Delhi Dynamo,8585,4,5,5,4,23,18,5,20
NorthEast Un,8585,5,5,4,5,12,10,2,19
Kerala Blast,8585,6,4,4,6,12,18,-6,16
Chennaiyin,8585,7,3,6,5,13,19,-6,15
FC Goa,8585,8,4,2,8,11,18,-7,14
Mumbai City,8586,1,7,4,3,20,9,11,25
Delhi Dynamo,8586,2,5,6,3,25,19,6,21
Kerala Blast,8586,3,6,3,5,13,16,-3,21
FC Pune City,8586,4,5,4,5,17,17,0,19
Kolkata,8586,5,3,8,3,15,15,0,17
Chennaiyin,8586,6,3,7,4,15,19,-4,16
NorthEast Un,8586,7,4,3,7,12,16,-4,15
FC Goa,8586,8,3,5,6,8,14,-6,14
Mumbai City,8587,1,6,5,3,16,8,8,23
Delhi Dynamo,8587,2,5,6,3,23,15,8,21
Kolkata,8587,3,5,6,3,19,17,2,21
Kerala Blast,8587,4,6,3,5,16,18,-2,21
Chennaiyin,8587,5,4,6,4,16,18,-2,18
FC Goa,8587,6,5,2,7,12,17,-5,17
NorthEast Un,8587,7,4,3,7,9,12,-3,15
FC Pune City,8587,8,4,3,7,13,19,-6,15
Delhi Dynamo,8588,1,6,6,2,28,16,12,24
Mumbai City,8588,2,6,5,3,16,8,8,23
FC Pune City,8588,3,6,3,5,16,16,0,21
Chennaiyin,8588,4,4,6,4,14,17,-3,18
Kolkata,8588,5,3,8,3,16,16,0,17
Kerala Blast,8588,6,4,5,5,13,18,-5,17
NorthEast Un,8588,7,4,4,6,11,13,-2,16
FC Goa,8588,8,3,3,8,11,21,-10,12
Mumbai City,8589,1,7,4,3,19,9,10,25
Delhi Dynamo,8589,2,5,5,4,25,21,4,20
Kolkata,8589,3,4,7,3,17,14,3,19
FC Pune City,8589,4,5,4,5,15,16,-1,19
FC Goa,8589,5,5,3,6,13,16,-3,18
Chennaiyin,8589,6,4,5,5,18,20,-2,17
NorthEast Un,8589,7,5,2,7,13,15,-2,17
Kerala Blast,8589,8,4,4,6,10,19,-9,16
Mumbai City,8590,1,7,4,3,19,9,10,25
Delhi Dynamo,8590,2,6,5,3,28,20,8,23
Chennaiyin,8590,3,5,5,4,18,20,-2,20
Kerala Blast,8590,4,4,6,4,11,15,-4,18
FC Pune City,8590,5,4,5,5,13,15,-2,17
Kolkata,8590,5,3,8,3,13,15,-2,17
NorthEast Un,8590,7,4,3,7,11,14,-3,15
FC Goa,8590,8,4,2,8,16,21,-5,14
Mumbai City,8591,1,7,4,3,19,9,10,25
Delhi Dynamo,8591,2,5,6,3,24,18,6,21
Kerala Blast,8591,3,5,5,4,14,17,-3,20
Kolkata,8591,4,4,6,4,19,19,0,18
NorthEast Un,8591,5,4,4,6,12,13,-1,16
FC Pune City,8591,6,4,4,6,14,17,-3,16
Chennaiyin,8591,7,3,7,4,16,20,-4,16
FC Goa,8591,8,4,4,6,13,18,-5,16
Mumbai City,8592,1,7,4,3,21,9,12,25
NorthEast Un,8592,2,6,3,5,14,10,4,21
Kolkata,8592,3,5,6,3,16,14,2,21
Kerala Blast,8592,4,5,4,5,10,14,-4,19
Delhi Dynamo,8592,5,4,5,5,23,24,-1,17
Chennaiyin,8592,6,4,5,5,15,19,-4,17
FC Goa,8592,7,5,2,7,12,17,-5,17
FC Pune City,8592,8,4,3,7,12,16,-4,15
Mumbai City,8593,1,7,4,3,18,9,9,25
NorthEast Un,8593,2,7,2,5,14,11,3,23
Kolkata,8593,3,4,7,3,16,16,0,19
FC Pune City,8593,4,5,4,5,14,15,-1,19
Kerala Blast,8593,5,5,3,6,13,16,-3,18
Delhi Dynamo,8593,6,4,5,5,23,19,4,17
FC Goa,8593,7,5,2,7,12,16,-4,17
Chennaiyin,8593,8,3,5,6,13,21,-8,14
Delhi Dynamo,8594,1,6,6,2,24,15,9,24
Mumbai City,8594,2,6,5,3,16,8,8,23
FC Pune City,8594,3,5,4,5,15,14,1,19
Kerala Blast,8594,4,5,4,5,13,17,-4,19
NorthEast Un,8594,5,5,2,7,11,12,-1,17
Chennaiyin,8594,6,4,5,5,15,20,-5,17
Kolkata,8594,7,3,7,4,16,19,-3,16
FC Goa,8594,8,4,3,7,13,18,-5,15
Delhi Dynamo,8595,1,6,5,3,26,17,9,23
Mumbai City,8595,2,6,4,4,18,12,6,22
Kerala Blast,8595,3,6,3,5,14,17,-3,21
Kolkata,8595,4,4,8,2,17,15,2,20
NorthEast Un,8595,5,6,2,6,13,11,2,20
Chennaiyin,8595,6,4,5,5,16,20,-4,17
FC Pune City,8595,7,4,4,6,14,17,-3,16
FC Goa,8595,8,3,3,8,10,19,-9,12
Mumbai City,8596,1,6,4,4,16,10,6,22
Kolkata,8596,2,5,7,2,17,14,3,22
NorthEast Un,8596,3,6,3,5,12,10,2,21
Delhi Dynamo,8596,4,5,5,4,23,17,6,20
Kerala Blast,8596,5,4,5,5,12,17,-5,17
FC Pune City,8596,6,4,4,6,16,19,-3,16
Chennaiyin,8596,7,3,7,4,15,19,-4,16
FC Goa,8596,8,4,3,7,12,17,-5,15
Delhi Dynamo,8597,1,7,5,2,30,15,15,26
Mumbai City,8597,2,6,4,4,16,9,7,22
Kolkata,8597,3,4,8,2,17,13,4,20
FC Pune City,8597,4,5,4,5,15,16,-1,19
Chennaiyin,8597,5,4,5,5,16,19,-3,17
Kerala Blast,8597,6,4,4,6,10,18,-8,16
NorthEast Un,8597,7,4,3,7,10,13,-3,15
FC Goa,8597,8,4,3,7,10,21,-11,15
Mumbai City,8598,1,6,5,3,17,9,8,23
NorthEast Un,8598,2,6,2,6,13,12,1,20
Delhi Dynamo,8598,3,4,6,4,24,19,5,18
Kolkata,8598,4,3,9,2,16,15,1,18
FC Goa,8598,5,5,3,6,15,18,-3,18
FC Pune City,8598,6,4,5,5,13,15,-2,17
Chennaiyin,8598,7,4,5,5,16,21,-5,17
Kerala Blast,8598,8,4,5,5,13,18,-5,17
Mumbai City,8599,1,6,5,3,17,9,8,23
Kolkata,8599,2,5,7,2,16,13,3,22
Delhi Dynamo,8599,3,5,6,3,25,17,8,21
NorthEast Un,8599,4,5,3,6,11,12,-1,18
Chennaiyin,8599,5,4,6,4,17,19,-2,18
FC Pune City,8599,6,5,3,6,14,16,-2,18
FC Goa,8599,7,4,3,7,11,18,-7,15
Kerala Blast,8599,7,4,3,7,11,18,-7,15
Mumbai City,8600,1,7,4,3,18,9,9,25
Kolkata,8600,2,5,7,2,22,16,6,22
Delhi Dynamo,8600,3,5,5,4,25,19,6,20
NorthEast Un,8600,4,5,3,6,12,12,0,18
FC Pune City,8600,5,5,3,6,15,17,-2,18
Chennaiyin,8600,6,4,6,4,15,18,-3,18
Kerala Blast,8600,7,4,4,6,12,19,-7,16
FC Goa,8600,8,4,2,8,12,21,-9,14
Mumbai City,8601,1,7,4,3,18,9,9,25
Kerala Blast,8601,2,6,4,4,14,15,-1,22
Chennaiyin,8601,3,5,5,4,17,19,-2,20
Delhi Dynamo,8601,4,4,6,4,23,18,5,18
Kolkata,8601,5,4,6,4,15,15,0,18
FC Pune City,8601,6,5,3,6,15,17,-2,18
NorthEast Un,8601,7,4,4,6,10,11,-1,16
FC Goa,8601,8,4,2,8,11,19,-8,14
Mumbai City,8602,1,6,4,4,16,10,6,22
Delhi Dynamo,8602,2,5,5,4,25,18,7,20
Kolkata,8602,3,4,8,2,16,14,2,20
NorthEast Un,8602,4,6,2,6,13,14,-1,20
FC Pune City,8602,5,5,4,5,15,15,0,19
Kerala Blast,8602,6,5,4,5,14,17,-3,19
FC Goa,8602,7,5,2,7,13,17,-4,17
Chennaiyin,8602,8,3,5,6,14,21,-7,14
Mumbai City,8603,1,7,4,3,19,9,10,25
Delhi Dynamo,8603,2,5,6,3,26,20,6,21
NorthEast Un,8603,3,6,3,5,18,14,4,21
Kolkata,8603,4,4,7,3,17,16,1,19
Kerala Blast,8603,5,5,3,6,16,19,-3,18
FC Pune City,8603,6,5,3,6,13,17,-4,18
Chennaiyin,8603,7,4,5,5,14,20,-6,17
FC Goa,8603,8,3,3,8,9,17,-8,12
Mumbai City,8604,1,7,4,3,17,8,9,25
Kolkata,8604,2,5,6,3,21,15,6,21
NorthEast Un,8604,3,6,3,5,14,11,3,21
Delhi Dynamo,8604,4,5,5,4,23,17,6,20
Kerala Blast,8604,5,5,4,5,13,17,-4,19
Chennaiyin,8604,6,3,7,4,17,21,-4,16
FC Pune City,8604,7,4,4,6,13,20,-7,16
FC Goa,8604,8,3,3,8,10,19,-9,12
Mumbai City,8605,1,6,5,3,17,9,8,23
Delhi Dynamo,8605,2,5,6,3,25,18,7,21
FC Pune City,8605,3,6,3,5,14,14,0,21
Kolkata,8605,4,4,7,3,16,15,1,19
NorthEast Un,8605,5,5,3,6,13,14,-1,18
FC Goa,8605,6,5,3,6,13,15,-2,18
Chennaiyin,8605,7,3,6,5,14,19,-5,15
Kerala Blast,8605,8,4,3,7,11,19,-8,15
Mumbai City,8606,1,6,5,3,18,10,8,23
NorthEast Un,8606,2,6,3,5,14,10,4,21
Kolkata,8606,3,4,8,2,15,13,2,20
Delhi Dynamo,8606,4,4,6,4,24,21,3,18
FC Pune City,8606,5,5,3,6,15,16,-1,18
FC Goa,8606,6,5,3,6,13,17,-4,18
Kerala Blast,8606,7,4,4,6,11,18,-7,16
Chennaiyin,8606,8,3,6,5,14,19,-5,15
Mumbai City,8607,1,6,5,3,18,10,8,23
Kolkata,8607,2,5,7,2,19,14,5,22
Delhi Dynamo,8607,3,5,6,3,27,21,6,21
Kerala Blast,8607,4,5,5,4,11,14,-3,20
NorthEast Un,8607,5,5,4,5,12,10,2,19
Chennaiyin,8607,6,4,6,4,14,17,-3,18
FC Pune City,8607,7,4,3,7,12,17,-5,15
FC Goa,8607,8,3,2,9,11,21,-10,11
Delhi Dynamo,8608,1,6,5,3,23,17,6,23
Mumbai City,8608,2,6,4,4,16,9,7,22
Kerala Blast,8608,3,6,4,4,15,15,0,22
NorthEast Un,8608,4,5,3,6,13,12,1,18
Kolkata,8608,5,3,8,3,16,17,-1,17
Chennaiyin,8608,6,4,5,5,14,19,-5,17
FC Pune City,8608,7,4,4,6,14,18,-4,16
FC Goa,8608,8,4,3,7,12,16,-4,15
Mumbai City,8609,1,7,4,3,19,10,9,25
Kolkata,8609,2,5,7,2,20,15,5,22
Delhi Dynamo,8609,3,5,6,3,27,19,8,21
Chennaiyin,8609,4,5,5,4,15,17,-2,20
Kerala Blast,8609,5,5,3,6,13,21,-8,18
NorthEast Un,8609,6,5,2,7,14,15,-1,17
FC Pune City,8609,7,4,4,6,15,18,-3,16
FC Goa,8609,8,3,3,8,8,16,-8,12
Mumbai City,8610,1,6,5,3,17,9,8,23
Delhi Dynamo,8610,2,5,7,2,23,15,8,22
Kolkata,8610,3,5,7,2,18,15,3,22
Kerala Blast,8610,4,5,4,5,13,16,-3,19
Chennaiyin,8610,5,4,6,4,14,17,-3,18
NorthEast Un,8610,6,4,3,7,10,12,-2,15
FC Pune City,8610,7,4,3,7,12,17,-5,15
FC Goa,8610,8,3,5,6,10,16,-6,14
Delhi Dynamo,8611,1,6,6,2,27,15,12,24
Mumbai City,8611,2,6,4,4,17,10,7,22
Kerala Blast,8611,3,6,4,4,16,15,1,22
FC Pune City,8611,4,5,3,6,16,17,-1,18
Kolkata,8611,5,3,8,3,15,17,-2,17
NorthEast Un,8611,6,4,4,6,11,14,-3,16
Chennaiyin,8611,7,3,6,5,15,20,-5,15
FC Goa,8611,8,4,3,7,10,19,-9,15
Mumbai City,8612,1,6,5,3,16,8,8,23
Delhi Dynamo,8612,2,5,7,2,25,16,9,22
Kerala Blast,8612,3,6,3,5,12,14,-2,21
Kolkata,8612,4,4,6,4,15,15,0,18
FC Pune City,8612,5,5,3,6,13,15,-2,18
FC Goa,8612,6,5,3,6,15,19,-4,18
Chennaiyin,8612,7,4,5,5,17,20,-3,17
NorthEast Un,8612,8,4,2,8,9,15,-6,14
Mumbai City,8613,1,7,4,3,19,9,10,25
FC Pune City,8613,2,6,3,5,14,14,0,21
Delhi Dynamo,8613,3,4,7,3,25,20,5,19
NorthEast Un,8613,4,5,4,5,12,11,1,19
Kolkata,8613,5,3,8,3,14,14,0,17
Chennaiyin,8613,6,3,7,4,14,18,-4,16
Kerala Blast,8613,7,4,4,6,10,16,-6,16
FC Goa,8613,8,3,5,6,10,16,-6,14
Mumbai City,8614,1,6,4,4,16,9,7,22
Kolkata,8614,2,5,7,2,21,16,5,22
Delhi Dynamo,8614,3,5,5,4,27,21,6,20
NorthEast Un,8614,4,6,2,6,14,13,1,20
Chennaiyin,8614,5,5,5,4,16,18,-2,20
Kerala Blast,8614,6,5,3,6,13,18,-5,18
FC Goa,8614,7,4,3,7,14,20,-6,15
FC Pune City,8614,8,4,3,7,13,19,-6,15
Mumbai City,8615,1,7,4,3,18,9,9,25
Delhi Dynamo,8615,2,5,5,4,25,17,8,20
Kolkata,8615,3,4,8,2,17,13,4,20
Kerala Blast,8615,4,5,4,5,12,16,-4,19
NorthEast Un,8615,5,5,3,6,11,11,0,18
FC Pune City,8615,6,5,3,6,15,19,-4,18
Chennaiyin,8615,7,3,7,4,14,18,-4,16
FC Goa,8615,8,3,4,7,9,18,-9,13
Delhi Dynamo,8616,1,6,5,3,26,18,8,23
Mumbai City,8616,2,6,4,4,17,10,7,22
Kolkata,8616,3,5,7,2,16,13,3,22
Kerala Blast,8616,4,6,3,5,12,14,-2,21
Chennaiyin,8616,5,5,5,4,17,19,-2,20
NorthEast Un,8616,6,5,2,7,12,13,-1,17
FC Pune City,8616,7,4,4,6,12,16,-4,16
FC Goa,8616,8,3,2,9,11,20,-9,11
Mumbai City,8617,1,6,5,3,16,8,8,23
FC Pune City,8617,2,6,3,5,18,15,3,21
Chennaiyin,8617,3,5,5,4,17,17,0,20
Delhi Dynamo,8617,4,4,6,4,24,19,5,18
Kolkata,8617,5,4,6,4,15,17,-2,18
Kerala Blast,8617,6,5,3,6,13,19,-6,18
NorthEast Un,8617,7,5,2,7,12,14,-2,17
FC Goa,8617,8,5,2,7,12,18,-6,17
Mumbai City,8618,1,6,5,3,19,11,8,23
Delhi Dynamo,8618,2,5,7,2,28,19,9,22
Kolkata,8618,3,5,7,2,18,14,4,22
NorthEast Un,8618,4,5,3,6,14,15,-1,18
Chennaiyin,8618,5,4,5,5,16,19,-3,17
Kerala Blast,8618,6,4,5,5,13,19,-6,17
FC Pune City,8618,7,4,4,6,14,17,-3,16
FC Goa,8618,8,3,4,7,11,19,-8,13
Mumbai City,8619,1,7,4,3,20,9,11,25
Delhi Dynamo,8619,2,6,5,3,26,20,6,23
Kerala Blast,8619,3,6,4,4,12,14,-2,22
FC Goa,8619,4,5,2,7,13,16,-3,17
NorthEast Un,8619,5,4,4,6,12,13,-1,16
Kolkata,8619,6,3,7,4,16,18,-2,16
FC Pune City,8619,7,4,4,6,16,19,-3,16
Chennaiyin,8619,8,3,6,5,15,21,-6,15
Mumbai City,8620,1,7,4,3,19,10,9,25
Delhi Dynamo,8620,2,5,5,4,25,18,7,20
Chennaiyin,8620,3,5,5,4,20,21,-1,20
FC Pune City,8620,4,5,4,5,14,15,-1,19
Kerala Blast,8620,5,5,4,5,12,15,-3,19
Kolkata,8620,6,3,8,3,15,15,0,17
NorthEast Un,8620,7,5,2,7,12,15,-3,17
FC Goa,8620,8,4,2,8,11,19,-8,14
Mumbai City,8621,1,7,4,3,19,9,10,25
Kolkata,8621,2,6,6,2,19,14,5,24
Delhi Dynamo,8621,3,6,5,3,27,20,7,23
Kerala Blast,8621,4,5,4,5,13,18,-5,19
Chennaiyin,8621,5,4,5,5,15,19,-4,17
NorthEast Un,8621,6,4,3,7,13,15,-2,15
FC Pune City,8621,7,4,3,7,12,16,-4,15
FC Goa,8621,8,4,2,8,12,19,-7,14
Mumbai City,8622,1,6,5,3,18,10,8,23
Delhi Dynamo,8622,2,5,6,3,28,21,7,21
Kolkata,8622,3,5,6,3,19,15,4,21
Kerala Blast,8622,4,5,5,4,14,17,-3,20
NorthEast Un,8622,5,5,4,5,14,11,3,19
Chennaiyin,8622,6,3,7,4,13,17,-4,16
FC Pune City,8622,7,4,4,6,13,18,-5,16
FC Goa,8622,8,3,3,8,9,19,-10,12
Delhi Dynamo,8623,1,6,6,2,26,16,10,24
Mumbai City,8623,2,6,4,4,16,9,7,22
FC Pune City,8623,3,5,4,5,17,17,0,19
Kolkata,8623,4,4,6,4,20,21,-1,18
Chennaiyin,8623,5,4,6,4,17,20,-3,18
NorthEast Un,8623,6,4,5,5,14,14,0,17
Kerala Blast,8623,7,4,5,5,15,20,-5,17
FC Goa,8623,8,4,2,8,12,20,-8,14
Mumbai City,8624,1,6,5,3,16,8,8,23
Delhi Dynamo,8624,2,5,7,2,25,15,10,22
Kolkata,8624,3,4,8,2,17,15,2,20
Kerala Blast,8624,4,5,4,5,14,18,-4,19
FC Pune City,8624,5,4,5,5,14,16,-2,17
NorthEast Un,8624,6,4,4,6,12,13,-1,16
Chennaiyin,8624,7,3,7,4,13,17,-4,16
FC Goa,8624,8,3,4,7,9,18,-9,13
Mumbai City,8625,1,7,4,3,18,9,9,25
Kolkata,8625,2,5,6,3,19,16,3,21
Delhi Dynamo,8625,3,5,5,4,25,19,6,20
FC Pune City,8625,4,5,4,5,16,17,-1,19
Kerala Blast,8625,5,5,4,5,12,17,-5,19
FC Goa,8625,6,5,2,7,13,16,-3,17
NorthEast Un,8625,7,4,3,7,12,15,-3,15
Chennaiyin,8625,8,3,6,5,14,20,-6,15
Mumbai City,8626,1,7,4,3,19,9,10,25
Delhi Dynamo,8626,2,5,6,3,25,19,6,21
Kolkata,8626,3,4,7,3,17,15,2,19
NorthEast Un,8626,4,5,4,5,10,9,1,19
FC Pune City,8626,5,4,5,5,14,16,-2,17
Chennaiyin,8626,6,3,7,4,14,18,-4,16
Kerala Blast,8626,7,4,4,6,11,18,-7,16
FC Goa,8626,8,4,3,7,12,18,-6,15
Delhi Dynamo,8627,1,6,5,3,29,16,13,23
Mumbai City,8627,2,6,4,4,17,11,6,22
FC Pune City,8627,3,6,3,5,15,15,0,21
Chennaiyin,8627,4,5,5,4,15,17,-2,20
Kerala Blast,8627,5,5,4,5,12,16,-4,19
Kolkata,8627,6,3,8,3,14,14,0,17
NorthEast Un,8627,7,5,2,7,11,12,-1,17
FC Goa,8627,8,3,3,8,9,21,-12,12
Delhi Dynamo,8628,1,6,6,2,28,17,11,24
Mumbai City,8628,2,6,5,3,18,10,8,23
Kolkata,8628,3,5,6,3,17,15,2,21
Kerala Blast,8628,4,5,4,5,13,16,-3,19
NorthEast Un,8628,5,5,3,6,13,12,1,18
Chennaiyin,8628,6,3,6,5,13,19,-6,15
FC Pune City,8628,6,4,3,7,13,19,-6,15
FC Goa,8628,8,4,3,7,11,18,-7,15
Delhi Dynamo,8629,1,7,5,2,27,16,11,26
Mumbai City,8629,2,6,4,4,16,9,7,22
Kerala Blast,8629,3,6,3,5,16,16,0,21
Kolkata,8629,4,4,6,4,17,15,2,18
FC Pune City,8629,5,5,3,6,14,18,-4,18
Chennaiyin,8629,6,4,5,5,16,20,-4,17
FC Goa,8629,7,5,2,7,12,17,-5,17
NorthEast Un,8629,8,4,2,8,11,18,-7,14
Delhi Dynamo,8630,1,5,7,2,22,14,8,22
Mumbai City,8630,2,6,4,4,16,9,7,22
Kolkata,8630,3,4,8,2,16,13,3,20
NorthEast Un,8630,4,5,4,5,14,10,4,19
FC Pune City,8630,5,5,3,6,14,16,-2,18
Chennaiyin,8630,6,4,6,4,15,18,-3,18
Kerala Blast,8630,7,4,4,6,10,20,-10,16
FC Goa,8630,8,3,4,7,8,15,-7,13
Mumbai City,8631,1,6,5,3,17,9,8,23
FC Pune City,8631,2,6,3,5,15,14,1,21
Kerala Blast,8631,3,6,3,5,12,16,-4,21
Delhi Dynamo,8631,4,4,7,3,23,17,6,19
FC Goa,8631,5,5,3,6,13,17,-4,18
Chennaiyin,8631,6,4,5,5,15,19,-4,17
Kolkata,8631,7,3,7,4,15,16,-1,16
NorthEast Un,8631,8,4,3,7,11,13,-2,15
Mumbai City,8632,1,7,4,3,19,8,11,25
Kolkata,8632,2,5,7,2,18,14,4,22
Delhi Dynamo,8632,3,5,5,4,22,20,2,20
Kerala Blast,8632,4,5,4,5,12,16,-4,19
FC Pune City,8632,5,5,3,6,14,17,-3,18
NorthEast Un,8632,6,5,2,7,13,12,1,17
Chennaiyin,8632,7,4,5,5,15,19,-4,17
FC Goa,8632,8,4,2,8,10,17,-7,14
Mumbai City,8633,1,7,4,3,18,8,10,25
Kolkata,8633,2,5,7,2,22,14,8,22
NorthEast Un,8633,3,6,3,5,14,11,3,21
Delhi Dynamo,8633,4,4,6,4,22,19,3,18
Kerala Blast,8633,5,4,5,5,9,14,-5,17
FC Pune City,8633,6,4,4,6,12,18,-6,16
Chennaiyin,8633,7,3,6,5,14,20,-6,15
FC Goa,8633,8,4,3,7,12,19,-7,15
Mumbai City,8634,1,7,4,3,19,9,10,25
Delhi Dynamo,8634,2,6,5,3,30,18,12,23
Kolkata,8634,3,4,7,3,16,15,1,19
FC Pune City,8634,4,5,4,5,13,14,-1,19
Kerala Blast,8634,5,5,4,5,12,15,-3,19
NorthEast Un,8634,6,5,3,6,13,14,-1,18
Chennaiyin,8634,7,4,5,5,18,20,-2,17
FC Goa,8634,8,3,2,9,10,26,-16,11
Mumbai City,8635,1,6,5,3,17,9,8,23
Kolkata,8635,2,5,7,2,15,12,3,22
Kerala Blast,8635,3,6,4,4,11,13,-2,22
Delhi Dynamo,8635,4,4,6,4,22,19,3,18
Chennaiyin,8635,5,4,6,4,16,18,-2,18
NorthEast Un,8635,6,5,2,7,10,12,-2,17
FC Goa,8635,7,4,3,7,12,16,-4,15
FC Pune City,8635,7,4,3,7,12,16,-4,15
Delhi Dynamo,8636,1,6,6,2,26,15,11,24
Mumbai City,8636,2,6,4,4,16,9,7,22
Kolkata,8636,3,4,7,3,16,15,1,19
Kerala Blast,8636,4,5,4,5,12,16,-4,19
FC Pune City,8636,5,4,5,5,13,15,-2,17
Chennaiyin,8636,6,4,5,5,15,20,-5,17
FC Goa,8636,7,5,2,7,13,19,-6,17
NorthEast Un,8636,8,4,3,7,10,12,-2,15
Mumbai City,8637,1,7,4,3,19,9,10,25
Kerala Blast,8637,2,7,3,4,17,14,3,24
Delhi Dynamo,8637,3,5,6,3,24,18,6,21
NorthEast Un,8637,4,5,2,7,13,14,-1,17
Kolkata,8637,5,3,8,3,15,18,-3,17
FC Pune City,8637,6,4,4,6,13,16,-3,16
FC Goa,8637,7,4,4,6,11,16,-5,16
Chennaiyin,8637,8,3,5,6,14,21,-7,14
Delhi Dynamo,8638,1,6,5,3,31,21,10,23
Mumbai City,8638,2,6,4,4,18,13,5,22
NorthEast Un,8638,3,6,3,5,15,11,4,21
Kolkata,8638,4,4,8,2,19,15,4,20
FC Pune City,8638,5,4,5,5,12,14,-2,17
Kerala Blast,8638,6,4,5,5,13,18,-5,17
Chennaiyin,8638,7,3,6,5,13,19,-6,15
FC Goa,8638,8,4,2,8,11,21,-10,14
Mumbai City,8639,1,7,4,3,18,8,10,25
Kolkata,8639,2,6,6,2,18,13,5,24
Delhi Dynamo,8639,3,6,5,3,28,18,10,23
Chennaiyin,8639,4,5,5,4,19,19,0,20
FC Pune City,8639,5,5,3,6,13,15,-2,18
Kerala Blast,8639,6,5,3,6,10,16,-6,18
NorthEast Un,8639,7,4,2,8,10,18,-8,14
FC Goa,8639,8,3,2,9,12,21,-9,11
Mumbai City,8640,1,7,4,3,19,8,11,25
Kolkata,8640,2,5,7,2,22,18,4,22
Kerala Blast,8640,3,5,4,5,10,14,-4,19
Delhi Dynamo,8640,4,4,6,4,22,20,2,18
NorthEast Un,8640,5,5,3,6,13,12,1,18
Chennaiyin,8640,6,4,6,4,16,18,-2,18
FC Pune City,8640,7,4,4,6,14,18,-4,16
FC Goa,8640,8,3,4,7,12,20,-8,13
Delhi Dynamo,8641,1,6,6,2,28,17,11,24
Mumbai City,8641,2,6,4,4,17,10,7,22
Kolkata,8641,3,5,7,2,19,14,5,22
Kerala Blast,8641,4,5,5,4,12,14,-2,20
Chennaiyin,8641,5,4,5,5,17,21,-4,17
FC Pune City,8641,6,4,4,6,12,15,-3,16
FC Goa,8641,7,4,3,7,14,20,-6,15
NorthEast Un,8641,8,4,2,8,10,18,-8,14
Mumbai City,8642,1,6,5,3,17,9,8,23
Delhi Dynamo,8642,2,5,7,2,24,16,8,22
Kolkata,8642,3,5,6,3,19,15,4,21
Kerala Blast,8642,4,6,3,5,14,16,-2,21
Chennaiyin,8642,5,4,6,4,18,20,-2,18
NorthEast Un,8642,6,4,3,7,12,16,-4,15
FC Pune City,8642,7,4,3,7,14,20,-6,15
FC Goa,8642,8,4,3,7,10,16,-6,15
Mumbai City,8643,1,6,4,4,16,9,7,22
NorthEast Un,8643,2,6,3,5,11,9,2,21
Delhi Dynamo,8643,3,5,5,4,23,17,6,20
Kolkata,8643,4,4,8,2,15,13,2,20
Kerala Blast,8643,5,5,5,4,12,15,-3,20
Chennaiyin,8643,6,4,5,5,17,20,-3,17
FC Pune City,8643,7,4,4,6,15,18,-3,16
FC Goa,8643,8,4,2,8,12,20,-8,14
Mumbai City,8644,1,7,4,3,18,8,10,25
NorthEast Un,8644,2,7,2,5,15,11,4,23
Delhi Dynamo,8644,3,5,5,4,24,18,6,20
Kerala Blast,8644,4,5,4,5,11,16,-5,19
Kolkata,8644,5,3,8,3,14,14,0,17
FC Goa,8644,6,5,2,7,12,17,-5,17
FC Pune City,8644,7,4,4,6,13,16,-3,16
Chennaiyin,8644,8,3,5,6,14,21,-7,14
Mumbai City,8645,1,6,5,3,18,10,8,23
Kerala Blast,8645,2,6,4,4,14,14,0,22
Delhi Dynamo,8645,3,5,6,3,24,17,7,21
Kolkata,8645,4,4,7,3,17,18,-1,19
FC Goa,8645,5,5,3,6,13,15,-2,18
NorthEast Un,8645,6,5,2,7,10,11,-1,17
Chennaiyin,8645,7,3,6,5,13,18,-5,15
FC Pune City,8645,8,4,3,7,13,19,-6,15
Mumbai City,8646,1,6,5,3,16,8,8,23
Delhi Dynamo,8646,2,5,6,3,27,17,10,21
Kolkata,8646,3,4,8,2,17,13,4,20
NorthEast Un,8646,4,5,4,5,13,12,1,19
Kerala Blast,8646,5,4,6,4,10,14,-4,18
FC Pune City,8646,6,4,4,6,13,18,-5,16
Chennaiyin,8646,7,3,6,5,15,21,-6,15
FC Goa,8646,8,4,3,7,12,20,-8,15
Mumbai City,8647,1,7,4,3,19,9,10,25
Kerala Blast,8647,2,6,4,4,12,14,-2,22
Kolkata,8647,3,5,6,3,18,14,4,21
NorthEast Un,8647,4,6,3,5,14,12,2,21
Delhi Dynamo,8647,5,4,5,5,23,20,3,17
FC Goa,8647,6,5,2,7,11,17,-6,17
FC Pune City,8647,7,4,3,7,13,17,-4,15
Chennaiyin,8647,8,3,5,6,14,21,-7,14
Mumbai City,8648,1,7,4,3,18,9,9,25
Delhi Dynamo,8648,2,5,6,3,26,17,9,21
Kolkata,8648,3,5,6,3,22,15,7,21
Kerala Blast,8648,4,6,3,5,17,16,1,21
Chennaiyin,8648,5,3,7,4,16,20,-4,16
NorthEast Un,8648,6,4,4,6,11,15,-4,16
FC Goa,8648,7,4,3,7,12,20,-8,15
FC Pune City,8648,8,4,3,7,13,23,-10,15
Delhi Dynamo,8649,1,6,6,2,26,16,10,24
Kerala Blast,8649,2,7,3,4,16,14,2,24
Mumbai City,8649,3,6,4,4,17,10,7,22
Chennaiyin,8649,4,5,5,4,17,17,0,20
FC Pune City,8649,5,5,3,6,17,19,-2,18
NorthEast Un,8649,6,4,3,7,10,14,-4,15
Kolkata,8649,7,3,6,5,17,22,-5,15
FC Goa,8649,8,4,2,8,11,19,-8,14
Mumbai City,8650,1,6,4,4,16,9,7,22
Delhi Dynamo,8650,2,5,6,3,22,16,6,21
NorthEast Un,8650,3,6,2,6,14,12,2,20
Kolkata,8650,4,4,7,3,17,16,1,19
Kerala Blast,8650,5,5,4,5,16,18,-2,19
Chennaiyin,8650,6,4,6,4,14,17,-3,18
FC Pune City,8650,6,5,3,6,14,17,-3,18
FC Goa,8650,8,3,4,7,8,16,-8,13
Mumbai City,8651,1,7,4,3,17,8,9,25
Kolkata,8651,2,5,7,2,18,12,6,22
Kerala Blast,8651,3,5,5,4,11,14,-3,20
NorthEast Un,8651,4,5,4,5,12,10,2,19
Delhi Dynamo,8651,5,4,6,4,25,21,4,18
Chennaiyin,8651,6,4,6,4,15,18,-3,18
FC Pune City,8651,7,4,3,7,13,19,-6,15
FC Goa,8651,8,3,3,8,12,21,-9,12
Mumbai City,8652,1,7,4,3,18,9,9,25
Delhi Dynamo,8652,2,6,5,3,28,20,8,23
Kerala Blast,8652,3,6,3,5,12,16,-4,21
NorthEast Un,8652,4,6,2,6,15,13,2,20
Kolkata,8652,5,4,6,4,15,15,0,18
FC Pune City,8652,6,5,3,6,13,15,-2,18
FC Goa,8652,7,4,2,8,13,19,-6,14
Chennaiyin,8652,8,3,5,6,13,20,-7,14
Delhi Dynamo,8653,1,6,5,3,27,18,9,23
NorthEast Un,8653,2,7,2,5,17,11,6,23
Mumbai City,8653,3,6,4,4,17,11,6,22
FC Pune City,8653,4,5,4,5,13,14,-1,19
FC Goa,8653,5,5,2,7,11,16,-5,17
Kerala Blast,8653,6,4,5,5,10,16,-6,17
Kolkata,8653,7,3,7,4,14,15,-1,16
Chennaiyin,8653,8,3,5,6,14,22,-8,14
Mumbai City,8654,1,6,4,4,17,10,7,22
Delhi Dynamo,8654,2,5,6,3,23,19,4,21
FC Pune City,8654,3,6,3,5,17,14,3,21
NorthEast Un,8654,4,5,4,5,12,9,3,19
Chennaiyin,8654,5,4,6,4,17,18,-1,18
Kerala Blast,8654,6,5,3,6,10,17,-7,18
Kolkata,8654,7,3,7,4,13,17,-4,16
FC Goa,8654,8,4,3,7,13,18,-5,15
Delhi Dynamo,8655,1,6,6,2,26,16,10,24
Mumbai City,8655,2,6,5,3,18,10,8,23
FC Pune City,8655,3,5,4,5,18,16,2,19
Kerala Blast,8655,4,5,4,5,12,19,-7,19
Kolkata,8655,5,3,8,3,16,16,0,17
FC Goa,8655,6,5,2,7,12,15,-3,17
Chennaiyin,8655,7,4,5,5,14,20,-6,17
NorthEast Un,8655,8,4,2,8,10,14,-4,14
Mumbai City,8656,1,7,4,3,17,8,9,25
Delhi Dynamo,8656,2,5,6,3,24,17,7,21
Kerala Blast,8656,3,5,5,4,10,13,-3,20
NorthEast Un,8656,4,5,4,5,14,12,2,19
FC Pune City,8656,5,5,3,6,14,15,-1,18
Kolkata,8656,6,3,8,3,14,15,-1,17
FC Goa,8656,7,4,3,7,12,17,-5,15
Chennaiyin,8656,8,3,5,6,15,23,-8,14
Mumbai City,8657,1,7,4,3,19,8,11,25
Kerala Blast,8657,2,6,4,4,14,15,-1,22
NorthEast Un,8657,3,6,2,6,11,10,1,20
Kolkata,8657,4,4,7,3,16,17,-1,19
Delhi Dynamo,8657,5,4,6,4,24,21,3,18
FC Pune City,8657,6,5,3,6,16,17,-1,18
FC Goa,8657,7,4,3,7,14,19,-5,15
Chennaiyin,8657,8,3,5,6,13,20,-7,14
Delhi Dynamo,8658,1,6,6,2,25,15,10,24
Mumbai City,8658,2,6,4,4,16,9,7,22
Kerala Blast,8658,3,6,4,4,13,14,-1,22
Kolkata,8658,4,3,9,2,15,14,1,18
NorthEast Un,8658,5,5,3,6,11,11,0,18
Chennaiyin,8658,6,4,5,5,14,18,-4,17
FC Pune City,8658,7,4,4,6,13,17,-4,16
FC Goa,8658,8,3,3,8,10,19,-9,12
Mumbai City,8659,1,7,4,3,18,8,10,25
Delhi Dynamo,8659,2,5,6,3,25,18,7,21
NorthEast Un,8659,3,6,2,6,14,13,1,20
Kerala Blast,8659,4,5,4,5,12,15,-3,19
FC Goa,8659,5,5,3,6,16,15,1,18
FC Pune City,8659,6,5,3,6,14,17,-3,18
Kolkata,8659,7,3,7,4,14,16,-2,16
Chennaiyin,8659,8,3,5,6,13,24,-11,14
Delhi Dynamo,8660,1,6,6,2,30,17,13,24
Mumbai City,8660,2,6,4,4,17,11,6,22
NorthEast Un,8660,3,6,3,5,13,11,2,21
FC Pune City,8660,4,6,3,5,15,15,0,21
Kolkata,8660,5,4,7,3,16,15,1,19
Kerala Blast,8660,6,4,4,6,10,16,-6,16
FC Goa,8660,7,4,2,8,13,20,-7,14
Chennaiyin,8660,8,3,5,6,14,23,-9,14
Mumbai City,8661,1,6,4,4,16,11,5,22
Delhi Dynamo,8661,2,5,6,3,26,17,9,21
Kolkata,8661,3,5,6,3,20,16,4,21
NorthEast Un,8661,4,6,2,6,13,11,2,20
FC Goa,8661,5,5,3,6,14,17,-3,18
Chennaiyin,8661,6,4,5,5,15,19,-4,17
FC Pune City,8661,7,4,4,6,17,21,-4,16
Kerala Blast,8661,8,4,4,6,13,22,-9,16
Delhi Dynamo,8662,1,6,6,2,31,19,12,24
Mumbai City,8662,2,6,4,4,18,11,7,22
Kerala Blast,8662,3,5,5,4,11,14,-3,20
NorthEast Un,8662,4,5,4,5,14,12,2,19
Kolkata,8662,5,4,7,3,14,13,1,19
FC Pune City,8662,6,4,5,5,13,15,-2,17
Chennaiyin,8662,7,3,5,6,14,21,-7,14
FC Goa,8662,8,4,2,8,10,20,-10,14
Mumbai City,8663,1,7,4,3,18,9,9,25
NorthEast Un,8663,2,7,2,5,15,9,6,23
FC Pune City,8663,3,6,3,5,16,15,1,21
Delhi Dynamo,8663,4,5,5,4,26,19,7,20
Kolkata,8663,5,4,6,4,16,16,0,18
Kerala Blast,8663,6,5,3,6,11,17,-6,18
Chennaiyin,8663,7,4,5,5,16,21,-5,17
FC Goa,8663,8,3,2,9,10,22,-12,11
Delhi Dynamo,8664,1,6,5,3,25,16,9,23
Mumbai City,8664,2,6,4,4,17,10,7,22
Kerala Blast,8664,3,5,5,4,14,15,-1,20
FC Goa,8664,4,5,3,6,11,15,-4,18
Kolkata,8664,5,3,8,3,15,17,-2,17
FC Pune City,8664,6,4,5,5,12,14,-2,17
NorthEast Un,8664,7,4,4,6,11,13,-2,16
Chennaiyin,8664,8,3,6,5,14,19,-5,15
Mumbai City,8665,1,7,4,3,19,9,10,25
NorthEast Un,8665,2,7,2,5,17,11,6,23
Kolkata,8665,3,4,8,2,18,15,3,20
Kerala Blast,8665,4,5,4,5,14,21,-7,19
Delhi Dynamo,8665,5,4,6,4,23,19,4,18
FC Pune City,8665,6,4,4,6,13,16,-3,16
FC Goa,8665,7,4,3,7,13,19,-6,15
Chennaiyin,8665,8,3,5,6,15,22,-7,14
Mumbai City,8666,1,7,4,3,19,9,10,25
Delhi Dynamo,8666,2,5,6,3,27,20,7,21
Kerala Blast,8666,3,6,3,5,13,16,-3,21
Kolkata,8666,4,4,8,2,16,14,2,20
Chennaiyin,8666,5,4,5,5,16,19,-3,17
FC Pune City,8666,6,4,4,6,14,17,-3,16
FC Goa,8666,7,4,4,6,14,19,-5,16
NorthEast Un,8666,8,4,2,8,10,15,-5,14
Delhi Dynamo,8667,1,6,6,2,26,16,10,24
Mumbai City,8667,2,6,4,4,16,9,7,22
Kolkata,8667,3,5,6,3,16,15,1,21
FC Pune City,8667,4,5,3,6,16,18,-2,18
Kerala Blast,8667,5,5,3,6,13,17,-4,18
Chennaiyin,8667,6,4,5,5,16,19,-3,17
FC Goa,8667,7,5,2,7,13,18,-5,17
NorthEast Un,8667,8,4,3,7,10,14,-4,15
Mumbai City,8668,1,7,4,3,19,8,11,25
Delhi Dynamo,8668,2,5,6,3,26,19,7,21
FC Pune City,8668,3,6,3,5,18,15,3,21
Kerala Blast,8668,4,5,4,5,11,17,-6,19
Kolkata,8668,5,3,8,3,16,17,-1,17
NorthEast Un,8668,6,4,4,6,13,14,-1,16
FC Goa,8668,7,4,3,7,13,19,-6,15
Chennaiyin,8668,8,3,6,5,14,21,-7,15
Mumbai City,8669,1,7,4,3,20,11,9,25
Kolkata,8669,2,6,6,2,21,15,6,24
NorthEast Un,8669,3,5,4,5,16,15,1,19
Delhi Dynamo,8669,4,4,6,4,29,24,5,18
FC Goa,8669,5,5,2,7,11,16,-5,17
Kerala Blast,8669,6,4,5,5,14,21,-7,17
FC Pune City,8669,7,4,4,6,14,17,-3,16
Chennaiyin,8669,8,3,5,6,13,19,-6,14
Delhi Dynamo,8670,1,7,5,2,24,14,10,26
Mumbai City,8670,2,6,4,4,16,9,7,22
Kolkata,8670,3,5,6,3,19,15,4,21
Kerala Blast,8670,4,5,4,5,14,17,-3,19
NorthEast Un,8670,5,5,3,6,11,11,0,18
Chennaiyin,8670,6,3,6,5,14,19,-5,15
FC Goa,8670,7,4,3,7,10,16,-6,15
FC Pune City,8670,8,4,3,7,13,20,-7,15
Delhi Dynamo,8671,1,6,6,2,24,15,9,24
Mumbai City,8671,2,6,4,4,16,9,7,22
Chennaiyin,8671,3,5,5,4,17,18,-1,20
Kerala Blast,8671,4,5,4,5,15,16,-1,19
Kolkata,8671,5,4,6,4,17,19,-2,18
FC Pune City,8671,6,5,3,6,15,18,-3,18
NorthEast Un,8671,7,4,3,7,11,13,-2,15
FC Goa,8671,8,4,3,7,12,19,-7,15
Mumbai City,8672,1,6,5,3,16,8,8,23
Delhi Dynamo,8672,2,4,8,2,25,18,7,20
Chennaiyin,8672,3,5,5,4,17,19,-2,20
FC Pune City,8672,4,5,4,5,15,16,-1,19
Kerala Blast,8672,5,5,4,5,13,17,-4,19
Kolkata,8672,6,3,9,2,16,15,1,18
NorthEast Un,8672,7,4,3,7,14,16,-2,15
FC Goa,8672,8,3,4,7,11,18,-7,13
Mumbai City,8673,1,6,5,3,17,9,8,23
Kolkata,8673,2,5,6,3,18,14,4,21
NorthEast Un,8673,3,6,3,5,16,13,3,21
Delhi Dynamo,8673,4,4,7,3,24,18,6,19
Chennaiyin,8673,5,4,6,4,19,21,-2,18
FC Pune City,8673,6,4,4,6,12,16,-4,16
Kerala Blast,8673,7,4,4,6,10,18,-8,16
FC Goa,8673,8,4,3,7,13,20,-7,15
Mumbai City,8674,1,7,4,3,20,8,12,25
Kolkata,8674,2,5,7,2,17,14,3,22
Delhi Dynamo,8674,3,5,6,3,28,24,4,21
Kerala Blast,8674,4,5,5,4,13,16,-3,20
Chennaiyin,8674,5,4,6,4,14,17,-3,18
NorthEast Un,8674,6,4,4,6,13,14,-1,16
FC Pune City,8674,7,4,4,6,13,16,-3,16
FC Goa,8674,8,3,2,9,12,21,-9,11
Mumbai City,8675,1,6,4,4,17,10,7,22
Delhi Dynamo,8675,2,5,6,3,24,18,6,21
Kolkata,8675,3,4,8,2,19,15,4,20
NorthEast Un,8675,4,5,4,5,14,12,2,19
FC Pune City,8675,5,5,4,5,15,16,-1,19
Chennaiyin,8675,6,3,7,4,14,18,-4,16
Kerala Blast,8675,7,4,4,6,11,19,-8,16
FC Goa,8675,8,3,5,6,10,16,-6,14
Kerala Blast,8676,1,7,3,4,16,14,2,24
Mumbai City,8676,2,6,4,4,17,11,6,22
Delhi Dynamo,8676,3,5,5,4,24,20,4,20
NorthEast Un,8676,4,5,3,6,15,13,2,18
FC Goa,8676,5,5,3,6,14,15,-1,18
FC Pune City,8676,6,5,3,6,13,18,-5,18
Kolkata,8676,7,3,7,4,13,14,-1,16
Chennaiyin,8676,8,3,6,5,16,23,-7,15
Delhi Dynamo,8677,1,6,6,2,27,15,12,24
Mumbai City,8677,2,6,5,3,16,8,8,23
Kerala Blast,8677,3,5,4,5,12,17,-5,19
Kolkata,8677,4,3,9,2,19,18,1,18
NorthEast Un,8677,5,5,2,7,11,14,-3,17
Chennaiyin,8677,6,4,5,5,16,20,-4,17
FC Pune City,8677,7,4,4,6,14,17,-3,16
FC Goa,8677,8,4,3,7,14,20,-6,15
Mumbai City,8678,1,6,5,3,17,9,8,23
Kolkata,8678,2,5,7,2,18,13,5,22
Delhi Dynamo,8678,3,5,6,3,25,18,7,21
NorthEast Un,8678,4,6,2,6,14,10,4,20
Kerala Blast,8678,5,5,5,4,13,16,-3,20
Chennaiyin,8678,6,4,5,5,15,21,-6,17
FC Pune City,8678,7,4,4,6,14,18,-4,16
FC Goa,8678,8,3,2,9,10,21,-11,11
Mumbai City,8679,1,7,4,3,17,8,9,25
Delhi Dynamo,8679,2,5,6,3,23,16,7,21
Kolkata,8679,3,4,7,3,19,17,2,19
Kerala Blast,8679,4,5,4,5,13,20,-7,19
FC Pune City,8679,5,5,3,6,18,18,0,18
Chennaiyin,8679,6,4,6,4,16,18,-2,18
NorthEast Un,8679,7,4,5,5,10,10,0,17
FC Goa,8679,8,3,3,8,11,20,-9,12
Mumbai City,8680,1,6,5,3,17,9,8,23
NorthEast Un,8680,2,7,2,5,16,11,5,23
Delhi Dynamo,8680,3,5,6,3,26,17,9,21
FC Pune City,8680,4,6,3,5,16,15,1,21
Kolkata,8680,5,4,6,4,17,16,1,18
FC Goa,8680,6,5,2,7,12,18,-6,17
Kerala Blast,8680,7,4,3,7,11,21,-10,15
Chennaiyin,8680,8,3,5,6,14,22,-8,14
Mumbai City,8681,1,6,5,3,17,9,8,23
NorthEast Un,8681,2,7,2,5,13,10,3,23
Delhi Dynamo,8681,3,5,6,3,23,16,7,21
Kolkata,8681,4,4,7,3,18,16,2,19
FC Pune City,8681,5,5,3,6,16,19,-3,18
Kerala Blast,8681,6,5,3,6,11,16,-5,18
Chennaiyin,8681,7,4,5,5,14,18,-4,17
FC Goa,8681,8,3,3,8,8,16,-8,12
Delhi Dynamo,8682,1,7,5,2,26,15,11,26
Mumbai City,8682,2,6,4,4,16,9,7,22
Kolkata,8682,3,5,7,2,17,14,3,22
Kerala Blast,8682,4,5,4,5,12,16,-4,19
Chennaiyin,8682,5,4,5,5,17,20,-3,17
FC Pune City,8682,6,4,3,7,13,17,-4,15
NorthEast Un,8682,7,4,3,7,10,14,-4,15
FC Goa,8682,8,4,3,7,12,18,-6,15
Mumbai City,8683,1,7,4,3,19,8,11,25
Delhi Dynamo,8683,2,6,5,3,25,19,6,23
Kolkata,8683,3,5,6,3,18,14,4,21
FC Pune City,8683,4,5,3,6,14,18,-4,18
FC Goa,8683,5,5,2,7,11,16,-5,17
NorthEast Un,8683,6,4,4,6,12,13,-1,16
Kerala Blast,8683,7,4,4,6,11,17,-6,16
Chennaiyin,8683,8,3,6,5,15,20,-5,15
Mumbai City,8684,1,6,5,3,17,9,8,23
Delhi Dynamo,8684,2,5,7,2,25,16,9,22
Kolkata,8684,3,5,6,3,17,14,3,21
Chennaiyin,8684,4,5,5,4,16,18,-2,20
Kerala Blast,8684,5,4,5,5,9,15,-6,17
NorthEast Un,8684,6,4,4,6,11,12,-1,16
FC Pune City,8684,7,4,4,6,12,15,-3,16
FC Goa,8684,8,4,2,8,10,18,-8,14
Mumbai City,8685,1,7,4,3,18,9,9,25
Delhi Dynamo,8685,2,5,6,3,25,17,8,21
Kolkata,8685,3,4,8,2,18,15,3,20
Kerala Blast,8685,4,5,5,4,12,14,-2,20
Chennaiyin,8685,5,4,6,4,17,19,-2,18
FC Pune City,8685,6,4,4,6,13,17,-4,16
NorthEast Un,8685,7,4,3,7,10,14,-4,15
FC Goa,8685,8,3,4,7,11,19,-8,13
Delhi Dynamo,8686,1,7,5,2,27,15,12,26
Kolkata,8686,2,6,6,2,20,13,7,24
Mumbai City,8686,3,6,4,4,17,10,7,22
Kerala Blast,8686,4,5,3,6,11,15,-4,18
NorthEast Un,8686,5,5,2,7,10,12,-2,17
Chennaiyin,8686,6,4,5,5,15,20,-5,17
FC Pune City,8686,7,4,3,7,13,18,-5,15
FC Goa,8686,8,4,2,8,11,21,-10,14
Mumbai City,8687,1,7,4,3,17,8,9,25
Delhi Dynamo,8687,2,4,7,3,24,18,6,19
NorthEast Un,8687,3,5,4,5,13,11,2,19
Kolkata,8687,4,4,7,3,15,14,1,19
FC Goa,8687,5,5,3,6,14,17,-3,18
Kerala Blast,8687,6,4,6,4,11,15,-4,18
FC Pune City,8687,7,4,4,6,13,16,-3,16
Chennaiyin,8687,8,3,5,6,13,21,-8,14
Delhi Dynamo,8688,1,6,6,2,26,15,11,24
Mumbai City,8688,2,6,4,4,16,9,7,22
Kolkata,8688,3,5,7,2,18,14,4,22
Chennaiyin,8688,4,5,5,4,16,17,-1,20
NorthEast Un,8688,5,5,3,6,11,12,-1,18
Kerala Blast,8688,6,5,3,6,10,16,-6,18
FC Pune City,8688,7,4,4,6,14,17,-3,16
FC Goa,8688,8,3,2,9,8,19,-11,11
Delhi Dynamo,8689,1,6,6,2,26,14,12,24
Mumbai City,8689,2,6,5,3,16,8,8,23
Kolkata,8689,3,4,7,3,17,16,1,19
Chennaiyin,8689,4,4,6,4,17,19,-2,18
FC Pune City,8689,5,4,5,5,14,16,-2,17
NorthEast Un,8689,6,5,2,7,11,13,-2,17
Kerala Blast,8689,7,4,4,6,9,16,-7,16
FC Goa,8689,8,4,3,7,11,19,-8,15
Delhi Dynamo,8690,1,6,6,2,24,15,9,24
Mumbai City,8690,2,6,5,3,17,9,8,23
Kolkata,8690,3,5,7,2,17,14,3,22
NorthEast Un,8690,4,5,3,6,12,11,1,18
Kerala Blast,8690,5,4,6,4,10,14,-4,18
FC Pune City,8690,6,4,4,6,13,16,-3,16
FC Goa,8690,7,4,2,8,13,18,-5,14
Chennaiyin,8690,8,3,5,6,14,23,-9,14
Mumbai City,8691,1,6,4,4,17,10,7,22
Delhi Dynamo,8691,2,5,5,4,26,20,6,20
NorthEast Un,8691,3,6,2,6,16,13,3,20
Kolkata,8691,4,4,7,3,17,16,1,19
Kerala Blast,8691,5,5,4,5,14,20,-6,19
Chennaiyin,8691,6,4,6,4,15,18,-3,18
FC Pune City,8691,7,4,5,5,14,16,-2,17
FC Goa,8691,8,4,3,7,11,17,-6,15
Mumbai City,8692,1,7,4,3,18,8,10,25
Kolkata,8692,2,5,7,2,19,12,7,22
Delhi Dynamo,8692,3,4,7,3,24,19,5,19
NorthEast Un,8692,4,5,4,5,13,11,2,19
Kerala Blast,8692,5,5,4,5,11,18,-7,19
FC Goa,8692,6,4,4,6,14,16,-2,16
FC Pune City,8692,7,4,3,7,12,17,-5,15
Chennaiyin,8692,8,3,5,6,13,23,-10,14
Mumbai City,8693,1,6,4,4,17,10,7,22
Kolkata,8693,2,5,7,2,17,13,4,22
Delhi Dynamo,8693,3,5,6,3,24,21,3,21
NorthEast Un,8693,4,6,2,6,16,11,5,20
FC Pune City,8693,5,5,3,6,14,16,-2,18
Chennaiyin,8693,6,4,5,5,15,19,-4,17
FC Goa,8693,7,4,4,6,11,16,-5,16
Kerala Blast,8693,8,4,3,7,10,18,-8,15
Mumbai City,8694,1,7,4,3,18,9,9,25
FC Pune City,8694,2,6,3,5,17,17,0,21
NorthEast Un,8694,3,5,4,5,14,11,3,19
Kerala Blast,8694,4,5,4,5,13,17,-4,19
Delhi Dynamo,8694,5,4,6,4,23,18,5,18
FC Goa,8694,6,5,2,7,13,18,-5,17
Chennaiyin,8694,7,4,5,5,17,23,-6,17
Kolkata,8694,8,3,6,5,14,16,-2,15
Mumbai City,8695,1,7,4,3,19,9,10,25
Delhi Dynamo,8695,2,6,5,3,29,19,10,23
Kerala Blast,8695,3,5,4,5,13,17,-4,19
Kolkata,8695,4,3,8,3,16,16,0,17
FC Goa,8695,5,5,2,7,15,18,-3,17
Chennaiyin,8695,6,4,5,5,15,20,-5,17
NorthEast Un,8695,7,5,2,7,10,15,-5,17
FC Pune City,8695,8,4,4,6,13,16,-3,16
Mumbai City,8696,1,6,5,3,16,8,8,23
Kolkata,8696,2,5,7,2,20,17,3,22
Delhi Dynamo,8696,3,5,6,3,29,17,12,21
Chennaiyin,8696,4,5,5,4,17,19,-2,20
FC Pune City,8696,5,5,3,6,14,16,-2,18
Kerala Blast,8696,6,5,3,6,12,16,-4,18
NorthEast Un,8696,7,5,2,7,13,15,-2,17
FC Goa,8696,8,3,3,8,14,27,-13,12
NorthEast Un,8697,1,7,2,5,15,12,3,23
Mumbai City,8697,2,6,4,4,18,11,7,22
Delhi Dynamo,8697,3,5,6,3,25,18,7,21
Kolkata,8697,4,5,6,3,18,13,5,21
Kerala Blast,8697,5,5,4,5,12,16,-4,19
FC Pune City,8697,6,4,4,6,12,15,-3,16
FC Goa,8697,7,4,3,7,11,19,-8,15
Chennaiyin,8697,8,3,5,6,14,21,-7,14
Delhi Dynamo,8698,1,5,7,2,24,16,8,22
Mumbai City,8698,2,6,4,4,17,10,7,22
Kerala Blast,8698,3,6,4,4,12,13,-1,22
FC Pune City,8698,4,5,3,6,13,16,-3,18
FC Goa,8698,5,5,3,6,12,15,-3,18
NorthEast Un,8698,6,4,5,5,11,11,0,17
Kolkata,8698,7,3,6,5,13,15,-2,15
Chennaiyin,8698,8,3,6,5,15,21,-6,15
Kolkata,8699,1,6,6,2,19,13,6,24
Delhi Dynamo,8699,2,5,7,2,27,18,9,22
Mumbai City,8699,3,6,4,4,16,10,6,22
NorthEast Un,8699,4,5,4,5,13,12,1,19
Chennaiyin,8699,5,4,6,4,15,18,-3,18
Kerala Blast,8699,6,5,3,6,10,16,-6,18
FC Pune City,8699,7,4,3,7,12,17,-5,15
FC Goa,8699,8,3,3,8,11,19,-8,12
Mumbai City,8700,1,6,5,3,17,9,8,23
Delhi Dynamo,8700,2,5,7,2,26,18,8,22
NorthEast Un,8700,3,6,3,5,15,13,2,21
Kolkata,8700,4,4,8,2,17,14,3,20
Kerala Blast,8700,5,5,3,6,11,17,-6,18
FC Pune City,8700,6,4,4,6,14,17,-3,16
FC Goa,8700,7,4,3,7,13,17,-4,15
Chennaiyin,8700,8,3,5,6,15,23,-8,14
Mumbai City,8701,1,7,4,3,17,8,9,25
Kolkata,8701,2,5,6,3,16,14,2,21
Delhi Dynamo,8701,3,4,7,3,25,19,6,19
Kerala Blast,8701,4,5,4,5,12,14,-2,19
FC Goa,8701,5,5,3,6,13,16,-3,18
Chennaiyin,8701,6,4,5,5,16,20,-4,17
NorthEast Un,8701,7,4,4,6,12,14,-2,16
FC Pune City,8701,8,4,3,7,13,19,-6,15
Mumbai City,8702,1,7,4,3,17,8,9,25
Delhi Dynamo,8702,2,6,5,3,26,16,10,23
Kerala Blast,8702,3,6,4,4,15,16,-1,22
FC Pune City,8702,4,5,4,5,16,17,-1,19
Chennaiyin,8702,5,4,6,4,16,18,-2,18
Kolkata,8702,6,3,6,5,16,19,-3,15
FC Goa,8702,7,4,3,7,10,18,-8,15
NorthEast Un,8702,8,4,2,8,11,15,-4,14
Mumbai City,8703,1,6,4,4,16,9,7,22
Delhi Dynamo,8703,2,5,6,3,23,16,7,21
Kolkata,8703,3,5,6,3,16,13,3,21
FC Pune City,8703,4,6,3,5,15,15,0,21
NorthEast Un,8703,5,4,5,5,11,11,0,17
FC Goa,8703,6,5,2,7,10,15,-5,17
Kerala Blast,8703,7,4,4,6,10,17,-7,16
Chennaiyin,8703,8,3,6,5,14,19,-5,15
Mumbai City,8704,1,6,5,3,17,9,8,23
Delhi Dynamo,8704,2,5,6,3,27,17,10,21
NorthEast Un,8704,3,6,3,5,11,9,2,21
Kerala Blast,8704,4,6,3,5,12,15,-3,21
Kolkata,8704,5,4,6,4,16,16,0,18
FC Pune City,8704,6,5,3,6,14,16,-2,18
Chennaiyin,8704,7,3,6,5,13,22,-9,15
FC Goa,8704,8,4,2,8,14,20,-6,14
Mumbai City,8705,1,6,4,4,17,10,7,22
Delhi Dynamo,8705,2,5,6,3,25,18,7,21
Kerala Blast,8705,3,5,5,4,11,14,-3,20
NorthEast Un,8705,4,5,4,5,12,11,1,19
FC Pune City,8705,5,5,4,5,14,15,-1,19
Chennaiyin,8705,6,4,6,4,16,19,-3,18
Kolkata,8705,7,3,6,5,15,17,-2,15
FC Goa,8705,8,4,3,7,13,19,-6,15
Mumbai City,8706,1,7,4,3,19,10,9,25
NorthEast Un,8706,2,6,3,5,13,11,2,21
Delhi Dynamo,8706,3,5,5,4,27,20,7,20
Kolkata,8706,4,4,7,3,18,18,0,19
Kerala Blast,8706,5,5,4,5,11,14,-3,19
FC Pune City,8706,6,5,3,6,15,17,-2,18
Chennaiyin,8706,7,3,6,5,14,19,-5,15
FC Goa,8706,8,3,4,7,12,20,-8,13
Mumbai City,8707,1,7,4,3,17,8,9,25
Kolkata,8707,2,5,6,3,17,14,3,21
NorthEast Un,8707,3,5,4,5,11,10,1,19
Kerala Blast,8707,4,5,4,5,13,17,-4,19
Delhi Dynamo,8707,5,4,6,4,22,17,5,18
FC Pune City,8707,6,4,4,6,14,17,-3,16
Chennaiyin,8707,7,3,7,4,14,18,-4,16
FC Goa,8707,8,4,3,7,10,17,-7,15
Delhi Dynamo,8708,1,7,5,2,26,14,12,26
Mumbai City,8708,2,6,4,4,16,10,6,22
Kerala Blast,8708,3,6,4,4,14,15,-1,22
Kolkata,8708,4,4,8,2,17,14,3,20
NorthEast Un,8708,5,4,3,7,10,14,-4,15
FC Goa,8708,6,4,3,7,13,18,-5,15
FC Pune City,8708,6,4,3,7,13,18,-5,15
Chennaiyin,8708,8,3,6,5,16,22,-6,15
Delhi Dynamo,8709,1,5,7,2,23,15,8,22
Mumbai City,8709,2,6,4,4,16,9,7,22
Kolkata,8709,3,5,6,3,17,16,1,21
NorthEast Un,8709,4,5,4,5,11,10,1,19
FC Pune City,8709,5,5,4,5,14,14,0,19
Chennaiyin,8709,6,4,6,4,17,18,-1,18
Kerala Blast,8709,7,4,4,6,10,16,-6,16
FC Goa,8709,8,3,3,8,10,20,-10,12
Mumbai City,8710,1,6,5,3,16,8,8,23
Delhi Dynamo,8710,2,5,6,3,23,15,8,21
Kolkata,8710,3,5,6,3,21,14,7,21
FC Goa,8710,4,6,2,6,12,15,-3,20
Kerala Blast,8710,5,5,4,5,11,17,-6,19
NorthEast Un,8710,6,5,2,7,11,13,-2,17
FC Pune City,8710,7,4,4,6,13,18,-5,16
Chennaiyin,8710,8,3,5,6,14,21,-7,14
Delhi Dynamo,8711,1,6,6,2,26,16,10,24
Mumbai City,8711,2,6,4,4,17,11,6,22
Kerala Blast,8711,3,4,6,4,10,14,-4,18
Kolkata,8711,4,3,8,3,17,17,0,17
FC Pune City,8711,5,4,5,5,13,15,-2,17
Chennaiyin,8711,6,4,5,5,15,19,-4,17
FC Goa,8711,7,5,2,7,12,17,-5,17
NorthEast Un,8711,8,4,4,6,11,12,-1,16
Mumbai City,8712,1,6,5,3,16,8,8,23
Kolkata,8712,2,4,8,2,20,16,4,20
Delhi Dynamo,8712,3,4,7,3,22,18,4,19
FC Pune City,8712,4,5,4,5,15,16,-1,19
NorthEast Un,8712,5,5,3,6,13,11,2,18
Chennaiyin,8712,6,4,6,4,14,17,-3,18
Kerala Blast,8712,7,4,4,6,11,19,-8,16
FC Goa,8712,8,3,5,6,12,18,-6,14
Mumbai City,8713,1,7,4,3,17,8,9,25
Kolkata,8713,2,5,7,2,16,13,3,22
Kerala Blast,8713,3,6,3,5,12,14,-2,21
NorthEast Un,8713,4,6,2,6,12,10,2,20
Delhi Dynamo,8713,5,4,5,5,21,18,3,17
Chennaiyin,8713,6,4,5,5,16,18,-2,17
FC Pune City,8713,7,4,3,7,12,17,-5,15
FC Goa,8713,8,4,3,7,10,18,-8,15
Delhi Dynamo,8714,1,7,5,2,30,17,13,26
Mumbai City,8714,2,6,4,4,17,11,6,22
Kolkata,8714,3,4,8,2,18,15,3,20
Chennaiyin,8714,4,5,5,4,17,19,-2,20
FC Pune City,8714,5,5,4,5,17,18,-1,19
Kerala Blast,8714,6,5,4,5,13,16,-3,19
NorthEast Un,8714,7,4,2,8,14,18,-4,14
FC Goa,8714,8,3,2,9,8,20,-12,11
Mumbai City,8715,1,7,4,3,18,8,10,25
Kolkata,8715,2,6,6,2,22,16,6,24
Delhi Dynamo,8715,3,6,5,3,25,17,8,23
Kerala Blast,8715,4,6,3,5,15,18,-3,21
Chennaiyin,8715,5,4,6,4,18,18,0,18
FC Pune City,8715,6,4,3,7,15,21,-6,15
NorthEast Un,8715,7,4,2,8,10,16,-6,14
FC Goa,8715,8,3,3,8,10,19,-9,12
Mumbai City,8716,1,7,4,3,18,9,9,25
Kolkata,8716,2,6,6,2,20,14,6,24
NorthEast Un,8716,3,6,3,5,12,9,3,21
Delhi Dynamo,8716,4,4,7,3,24,18,6,19
Kerala Blast,8716,5,5,3,6,11,19,-8,18
FC Pune City,8716,6,4,3,7,15,19,-4,15
Chennaiyin,8716,7,3,6,5,13,18,-5,15
FC Goa,8716,8,3,4,7,10,17,-7,13
Mumbai City,8717,1,7,4,3,18,8,10,25
Kolkata,8717,2,6,6,2,21,13,8,24
Kerala Blast,8717,3,6,3,5,12,17,-5,21
NorthEast Un,8717,4,6,2,6,12,10,2,20
Delhi Dynamo,8717,5,4,6,4,22,18,4,18
Chennaiyin,8717,6,4,5,5,16,19,-3,17
FC Pune City,8717,7,4,3,7,12,18,-6,15
FC Goa,8717,8,3,3,8,9,19,-10,12
Mumbai City,8718,1,6,5,3,17,9,8,23
Delhi Dynamo,8718,2,5,7,2,24,16,8,22
Kolkata,8718,3,4,7,3,18,16,2,19
FC Goa,8718,4,5,3,6,13,15,-2,18
FC Pune City,8718,5,5,3,6,13,17,-4,18
Chennaiyin,8718,6,4,5,5,16,20,-4,17
Kerala Blast,8718,7,4,5,5,14,19,-5,17
NorthEast Un,8718,8,4,3,7,13,16,-3,15
Delhi Dynamo,8719,1,6,5,3,28,18,10,23
Mumbai City,8719,2,6,4,4,18,12,6,22
Chennaiyin,8719,3,5,5,4,17,17,0,20
Kolkata,8719,4,4,7,3,18,18,0,19
FC Pune City,8719,5,5,3,6,15,17,-2,18
NorthEast Un,8719,6,5,3,6,11,13,-2,18
Kerala Blast,8719,7,4,5,5,11,16,-5,17
FC Goa,8719,8,4,2,8,12,19,-7,14
Mumbai City,8720,1,7,4,3,19,10,9,25
Kerala Blast,8720,2,5,5,4,13,16,-3,20
Delhi Dynamo,8720,3,4,7,3,23,17,6,19
NorthEast Un,8720,4,5,4,5,11,10,1,19
Kolkata,8720,5,4,6,4,21,16,5,18
FC Goa,8720,6,5,3,6,12,14,-2,18
FC Pune City,8720,7,4,4,6,13,21,-8,16
Chennaiyin,8720,8,3,5,6,14,22,-8,14
Delhi Dynamo,8721,1,5,7,2,23,15,8,22
Mumbai City,8721,2,6,4,4,17,10,7,22
NorthEast Un,8721,3,5,4,5,11,10,1,19
Kerala Blast,8721,4,5,4,5,13,17,-4,19
FC Pune City,8721,5,5,3,6,16,17,-1,18
Kolkata,8721,5,4,6,4,16,17,-1,18
Chennaiyin,8721,7,4,5,5,15,19,-4,17
FC Goa,8721,8,4,3,7,10,16,-6,15
Mumbai City,8722,1,7,4,3,19,9,10,25
Kolkata,8722,2,5,7,2,19,16,3,22
Kerala Blast,8722,3,6,3,5,14,17,-3,21
Delhi Dynamo,8722,4,5,5,4,26,20,6,20
Chennaiyin,8722,5,5,5,4,20,19,1,20
NorthEast Un,8722,6,5,2,7,12,14,-2,17
FC Pune City,8722,7,4,4,6,12,15,-3,16
FC Goa,8722,8,3,2,9,13,25,-12,11
Delhi Dynamo,8723,1,6,6,2,29,16,13,24
Mumbai City,8723,2,6,5,3,17,9,8,23
FC Pune City,8723,3,6,3,5,14,14,0,21
Kerala Blast,8723,4,5,4,5,11,15,-4,19
Chennaiyin,8723,5,4,5,5,17,19,-2,17
Kolkata,8723,6,3,7,4,14,15,-1,16
NorthEast Un,8723,7,4,3,7,11,16,-5,15
FC Goa,8723,8,4,3,7,11,20,-9,15
Delhi Dynamo,8724,1,6,5,3,28,20,8,23
Mumbai City,8724,2,6,4,4,18,11,7,22
Kolkata,8724,3,5,7,2,18,14,4,22
Kerala Blast,8724,4,6,3,5,12,16,-4,21
Chennaiyin,8724,5,5,5,4,16,17,-1,20
NorthEast Un,8724,6,5,2,7,12,11,1,17
FC Pune City,8724,7,4,3,7,14,18,-4,15
FC Goa,8724,8,3,3,8,10,21,-11,12
Mumbai City,8725,1,6,5,3,16,8,8,23
Delhi Dynamo,8725,2,5,6,3,24,17,7,21
NorthEast Un,8725,3,6,3,5,15,11,4,21
Kolkata,8725,4,4,7,3,16,14,2,19
FC Pune City,8725,5,5,4,5,14,15,-1,19
Kerala Blast,8725,6,4,5,5,12,18,-6,17
Chennaiyin,8725,7,3,7,4,14,18,-4,16
FC Goa,8725,8,3,3,8,9,19,-10,12
Mumbai City,8726,1,7,4,3,19,9,10,25
Delhi Dynamo,8726,2,6,5,3,26,18,8,23
Kerala Blast,8726,3,6,3,5,13,17,-4,21
NorthEast Un,8726,4,6,2,6,15,11,4,20
Kolkata,8726,5,4,6,4,16,14,2,18
Chennaiyin,8726,6,3,6,5,14,20,-6,15
FC Pune City,8726,7,4,3,7,13,20,-7,15
FC Goa,8726,8,4,3,7,10,17,-7,15
Mumbai City,8727,1,6,5,3,17,9,8,23
Kolkata,8727,2,4,8,2,16,14,2,20
Delhi Dynamo,8727,3,4,7,3,25,19,6,19
NorthEast Un,8727,4,5,4,5,11,10,1,19
Kerala Blast,8727,5,5,4,5,13,16,-3,19
FC Goa,8727,6,5,3,6,14,17,-3,18
FC Pune City,8727,7,4,4,6,14,18,-4,16
Chennaiyin,8727,8,3,5,6,14,21,-7,14
Mumbai City,8728,1,7,4,3,18,8,10,25
Kolkata,8728,2,6,6,2,17,12,5,24
Delhi Dynamo,8728,3,5,6,3,24,18,6,21
NorthEast Un,8728,4,6,2,6,15,11,4,20
FC Pune City,8728,5,5,3,6,15,16,-1,18
Chennaiyin,8728,6,4,5,5,15,18,-3,17
Kerala Blast,8728,7,4,3,7,10,22,-12,15
FC Goa,8728,8,3,3,8,9,18,-9,12
Mumbai City,8729,1,7,4,3,18,9,9,25
Kerala Blast,8729,2,6,3,5,14,16,-2,21
Delhi Dynamo,8729,3,5,5,4,24,17,7,20
Kolkata,8729,4,4,7,3,17,15,2,19
NorthEast Un,8729,5,5,3,6,12,12,0,18
FC Pune City,8729,6,5,3,6,13,17,-4,18
Chennaiyin,8729,7,3,6,5,15,20,-5,15
FC Goa,8729,8,4,3,7,10,17,-7,15
Delhi Dynamo,8730,1,6,6,2,26,16,10,24
Mumbai City,8730,2,6,5,3,16,8,8,23
Kolkata,8730,3,5,6,3,17,16,1,21
FC Pune City,8730,4,5,3,6,14,16,-2,18
NorthEast Un,8730,5,4,4,6,12,13,-1,16
Chennaiyin,8730,6,3,7,4,17,21,-4,16
Kerala Blast,8730,7,4,4,6,10,17,-7,16
FC Goa,8730,8,4,3,7,14,19,-5,15
Mumbai City,8731,1,7,4,3,19,8,11,25
Kolkata,8731,2,6,6,2,17,12,5,24
Delhi Dynamo,8731,3,5,6,3,22,17,5,21
Kerala Blast,8731,4,6,3,5,15,16,-1,21
Chennaiyin,8731,5,4,6,4,15,17,-2,18
NorthEast Un,8731,6,4,3,7,10,13,-3,15
FC Pune City,8731,7,4,3,7,12,19,-7,15
FC Goa,8731,8,3,3,8,8,16,-8,12
Mumbai City,8732,1,7,4,3,18,9,9,25
Kolkata,8732,2,5,6,3,17,16,1,21
Kerala Blast,8732,3,6,3,5,14,16,-2,21
Delhi Dynamo,8732,4,5,5,4,24,18,6,20
Chennaiyin,8732,5,4,6,4,17,20,-3,18
NorthEast Un,8732,6,5,2,7,15,15,0,17
FC Pune City,8732,7,4,3,7,14,19,-5,15
FC Goa,8732,8,4,3,7,10,16,-6,15
Delhi Dynamo,8733,1,6,5,3,24,16,8,23
Mumbai City,8733,2,6,4,4,17,10,7,22
FC Pune City,8733,3,5,4,5,17,18,-1,19
Kolkata,8733,4,4,6,4,16,16,0,18
NorthEast Un,8733,5,5,3,6,12,12,0,18
Chennaiyin,8733,6,4,5,5,16,20,-4,17
Kerala Blast,8733,7,4,5,5,13,18,-5,17
FC Goa,8733,8,5,2,7,12,17,-5,17
Mumbai City,8734,1,7,4,3,19,8,11,25
Kerala Blast,8734,2,6,4,4,13,14,-1,22
FC Goa,8734,3,6,2,6,14,14,0,20
NorthEast Un,8734,4,5,4,5,12,10,2,19
Delhi Dynamo,8734,5,4,6,4,21,18,3,18
Kolkata,8734,6,3,7,4,14,17,-3,16
FC Pune City,8734,7,4,4,6,12,16,-4,16
Chennaiyin,8734,8,3,5,6,14,22,-8,14
Mumbai City,8735,1,7,4,3,20,8,12,25
Delhi Dynamo,8735,2,5,6,3,25,20,5,21
Kolkata,8735,3,4,8,2,15,13,2,20
NorthEast Un,8735,4,5,3,6,14,13,1,18
Chennaiyin,8735,5,4,5,5,15,19,-4,17
Kerala Blast,8735,6,4,5,5,11,18,-7,17
FC Pune City,8735,7,4,4,6,13,16,-3,16
FC Goa,8735,8,4,3,7,10,16,-6,15
Delhi Dynamo,8736,1,6,6,2,26,16,10,24
Mumbai City,8736,2,6,4,4,17,10,7,22
Kolkata,8736,3,5,6,3,15,13,2,21
FC Pune City,8736,4,5,4,5,14,15,-1,19
Kerala Blast,8736,5,5,4,5,12,16,-4,19
Chennaiyin,8736,6,4,6,4,15,18,-3,18
NorthEast Un,8736,7,4,4,6,12,13,-1,16
FC Goa,8736,8,3,2,9,8,18,-10,11
Mumbai City,8737,1,7,4,3,19,8,11,25
NorthEast Un,8737,2,6,2,6,12,11,1,20
FC Goa,8737,3,6,2,6,15,17,-2,20
Kerala Blast,8737,4,5,4,5,14,16,-2,19
Delhi Dynamo,8737,5,4,5,5,23,23,0,17
Kolkata,8737,6,3,8,3,15,15,0,17
Chennaiyin,8737,7,4,5,5,15,18,-3,17
FC Pune City,8737,8,4,4,6,13,18,-5,16
Mumbai City,8738,1,7,4,3,20,10,10,25
Kolkata,8738,2,6,6,2,19,12,7,24
Delhi Dynamo,8738,3,5,5,4,25,23,2,20
Chennaiyin,8738,4,5,5,4,16,18,-2,20
Kerala Blast,8738,5,5,4,5,14,16,-2,19
FC Pune City,8738,6,4,4,6,13,16,-3,16
FC Goa,8738,7,4,2,8,13,19,-6,14
NorthEast Un,8738,8,4,2,8,10,16,-6,14
Mumbai City,8739,1,7,4,3,17,8,9,25
Kolkata,8739,2,5,7,2,18,15,3,22
Delhi Dynamo,8739,3,5,6,3,26,18,8,21
NorthEast Un,8739,4,6,3,5,16,14,2,21
Kerala Blast,8739,5,5,4,5,15,18,-3,19
Chennaiyin,8739,6,3,6,5,16,21,-5,15
FC Pune City,8739,7,4,3,7,13,18,-5,15
FC Goa,8739,8,3,3,8,11,20,-9,12
Mumbai City,8740,1,7,4,3,17,8,9,25
Delhi Dynamo,8740,2,5,6,3,26,18,8,21
Chennaiyin,8740,3,5,5,4,17,18,-1,20
Kolkata,8740,4,4,7,3,17,16,1,19
Kerala Blast,8740,5,5,4,5,14,18,-4,19
FC Pune City,8740,6,5,3,6,14,17,-3,18
NorthEast Un,8740,7,4,3,7,11,13,-2,15
FC Goa,8740,8,4,2,8,13,21,-8,14
Mumbai City,8741,1,6,5,3,18,10,8,23
Kerala Blast,8741,2,5,5,4,12,14,-2,20
Delhi Dynamo,8741,3,4,7,3,25,19,6,19
NorthEast Un,8741,4,5,4,5,15,10,5,19
FC Goa,8741,5,5,3,6,13,16,-3,18
Kolkata,8741,6,3,8,3,16,17,-1,17
FC Pune City,8741,7,4,4,6,14,18,-4,16
Chennaiyin,8741,8,3,6,5,14,23,-9,15
Delhi Dynamo,8742,1,6,6,2,28,16,12,24
Kolkata,8742,2,6,6,2,21,12,9,24
Mumbai City,8742,3,6,5,3,16,8,8,23
Kerala Blast,8742,4,6,3,5,15,17,-2,21
Chennaiyin,8742,5,5,5,4,18,18,0,20
FC Pune City,8742,6,4,3,7,13,20,-7,15
NorthEast Un,8742,7,4,2,8,12,20,-8,14
FC Goa,8742,8,3,2,9,8,20,-12,11
Delhi Dynamo,8743,1,6,6,2,29,16,13,24
Kerala Blast,8743,2,7,3,4,17,14,3,24
Mumbai City,8743,3,6,5,3,17,9,8,23
FC Pune City,8743,4,5,3,6,13,17,-4,18
Chennaiyin,8743,5,4,5,5,18,20,-2,17
Kolkata,8743,6,3,7,4,14,15,-1,16
FC Goa,8743,7,4,3,7,10,19,-9,15
NorthEast Un,8743,8,4,2,8,11,19,-8,14
Mumbai City,8744,1,7,4,3,17,8,9,25
NorthEast Un,8744,2,6,3,5,15,12,3,21
Delhi Dynamo,8744,3,4,7,3,23,17,6,19
Kerala Blast,8744,4,5,4,5,13,16,-3,19
FC Pune City,8744,5,5,3,6,15,18,-3,18
Kolkata,8744,6,3,7,4,15,17,-2,16
FC Goa,8744,7,4,4,6,13,17,-4,16
Chennaiyin,8744,8,3,6,5,15,21,-6,15
Mumbai City,8745,1,6,5,3,17,9,8,23
Delhi Dynamo,8745,2,5,6,3,25,18,7,21
NorthEast Un,8745,3,5,4,5,14,12,2,19
Kolkata,8745,4,4,7,3,17,16,1,19
Kerala Blast,8745,5,5,4,5,12,18,-6,19
FC Pune City,8745,6,5,3,6,17,17,0,18
Chennaiyin,8745,7,3,6,5,15,20,-5,15
FC Goa,8745,8,4,3,7,10,17,-7,15
Mumbai City,8746,1,7,4,3,18,8,10,25
Delhi Dynamo,8746,2,6,5,3,26,18,8,23
FC Pune City,8746,3,6,3,5,17,16,1,21
Kolkata,8746,4,4,7,3,19,16,3,19
NorthEast Un,8746,5,5,3,6,12,12,0,18
Chennaiyin,8746,6,4,5,5,14,18,-4,17
Kerala Blast,8746,7,4,5,5,10,16,-6,17
FC Goa,8746,8,3,2,9,8,20,-12,11
Mumbai City,8747,1,7,4,3,20,10,10,25
Kolkata,8747,2,5,7,2,16,13,3,22
Delhi Dynamo,8747,3,5,6,3,25,19,6,21
NorthEast Un,8747,4,5,3,6,10,10,0,18
Kerala Blast,8747,5,5,3,6,10,15,-5,18
Chennaiyin,8747,6,4,5,5,14,19,-5,17
FC Pune City,8747,7,4,3,7,12,16,-4,15
FC Goa,8747,8,4,3,7,12,17,-5,15
Mumbai City,8748,1,7,4,3,18,9,9,25
Delhi Dynamo,8748,2,5,5,4,24,18,6,20
Kolkata,8748,3,4,8,2,15,12,3,20
Kerala Blast,8748,4,5,5,4,12,15,-3,20
FC Pune City,8748,5,4,5,5,13,15,-2,17
Chennaiyin,8748,6,4,5,5,15,18,-3,17
FC Goa,8748,7,5,2,7,11,17,-6,17
NorthEast Un,8748,8,4,2,8,10,14,-4,14
Mumbai City,8749,1,6,5,3,16,8,8,23
Delhi Dynamo,8749,2,5,6,3,25,16,9,21
Kerala Blast,8749,3,6,3,5,13,16,-3,21
Kolkata,8749,4,4,6,4,17,17,0,18
FC Pune City,8749,5,5,3,6,14,17,-3,18
FC Goa,8749,6,5,3,6,13,16,-3,18
Chennaiyin,8749,7,3,7,4,15,19,-4,16
NorthEast Un,8749,8,4,3,7,10,14,-4,15
Mumbai City,8750,1,7,4,3,18,9,9,25
NorthEast Un,8750,2,6,3,5,13,11,2,21
Delhi Dynamo,8750,3,5,5,4,25,19,6,20
Kolkata,8750,4,4,8,2,17,14,3,20
Kerala Blast,8750,5,4,6,4,10,14,-4,18
FC Pune City,8750,6,4,5,5,13,15,-2,17
Chennaiyin,8750,7,3,5,6,14,20,-6,14
FC Goa,8750,8,4,2,8,12,20,-8,14
Mumbai City,8751,1,7,4,3,20,8,12,25
Delhi Dynamo,8751,2,6,5,3,23,18,5,23
Kolkata,8751,3,4,8,2,15,13,2,20
FC Pune City,8751,4,5,3,6,16,16,0,18
Chennaiyin,8751,5,4,6,4,17,20,-3,18
Kerala Blast,8751,6,4,5,5,11,18,-7,17
NorthEast Un,8751,7,4,3,7,10,12,-2,15
FC Goa,8751,8,3,4,7,10,17,-7,13
Mumbai City,8752,1,7,4,3,17,8,9,25
Delhi Dynamo,8752,2,6,5,3,23,15,8,23
Kolkata,8752,3,5,7,2,18,14,4,22
Kerala Blast,8752,4,5,5,4,12,15,-3,20
NorthEast Un,8752,5,5,2,7,11,12,-1,17
Chennaiyin,8752,6,4,5,5,17,20,-3,17
FC Pune City,8752,7,4,4,6,13,17,-4,16
FC Goa,8752,8,3,2,9,10,20,-10,11
Delhi Dynamo,8753,1,6,5,3,27,21,6,23
Kolkata,8753,2,5,7,2,19,12,7,22
Mumbai City,8753,3,6,4,4,18,11,7,22
NorthEast Un,8753,4,6,2,6,14,12,2,20
Kerala Blast,8753,5,5,5,4,12,14,-2,20
Chennaiyin,8753,6,4,5,5,14,18,-4,17
FC Pune City,8753,7,4,4,6,13,16,-3,16
FC Goa,8753,8,3,2,9,9,22,-13,11
Mumbai City,8754,1,7,4,3,18,8,10,25
Delhi Dynamo,8754,2,6,5,3,24,16,8,23
Kolkata,8754,3,4,8,2,18,14,4,20
NorthEast Un,8754,4,6,2,6,13,12,1,20
FC Pune City,8754,5,5,3,6,14,17,-3,18
Kerala Blast,8754,6,4,4,6,11,18,-7,16
Chennaiyin,8754,7,3,6,5,15,20,-5,15
FC Goa,8754,8,3,4,7,10,18,-8,13
Delhi Dynamo,8755,1,7,5,2,25,15,10,26
Mumbai City,8755,2,6,4,4,16,9,7,22
Kolkata,8755,3,4,7,3,16,16,0,19
NorthEast Un,8755,4,5,3,6,13,13,0,18
Kerala Blast,8755,5,5,3,6,14,17,-3,18
FC Goa,8755,6,5,2,7,15,15,0,17
FC Pune City,8755,7,4,4,6,12,17,-5,16
Chennaiyin,8755,8,3,6,5,15,24,-9,15
Mumbai City,8756,1,7,4,3,18,9,9,25
Kolkata,8756,2,5,6,3,17,14,3,21
FC Pune City,8756,3,6,3,5,19,18,1,21
Delhi Dynamo,8756,4,5,5,4,25,21,4,20
NorthEast Un,8756,5,6,2,6,17,13,4,20
Chennaiyin,8756,6,4,6,4,16,18,-2,18
Kerala Blast,8756,7,4,3,7,13,22,-9,15
FC Goa,8756,8,3,3,8,8,18,-10,12
Mumbai City,8757,1,6,5,3,16,8,8,23
Delhi Dynamo,8757,2,5,6,3,24,17,7,21
NorthEast Un,8757,3,6,3,5,17,12,5,21
FC Pune City,8757,4,5,3,6,14,16,-2,18
Kolkata,8757,4,4,6,4,14,16,-2,18
Kerala Blast,8757,6,5,3,6,12,19,-7,18
FC Goa,8757,7,5,2,7,13,17,-4,17
Chennaiyin,8757,8,3,6,5,15,20,-5,15
Mumbai City,8758,1,7,4,3,17,8,9,25
Delhi Dynamo,8758,2,5,5,4,24,17,7,20
FC Pune City,8758,3,5,4,5,15,16,-1,19
NorthEast Un,8758,4,5,3,6,10,11,-1,18
Chennaiyin,8758,5,4,6,4,15,18,-3,18
Kerala Blast,8758,6,5,3,6,13,17,-4,18
Kolkata,8758,7,3,8,3,16,17,-1,17
FC Goa,8758,8,4,3,7,12,18,-6,15
Delhi Dynamo,8759,1,6,5,3,28,18,10,23
Mumbai City,8759,2,6,4,4,16,10,6,22
FC Pune City,8759,3,6,3,5,19,17,2,21
NorthEast Un,8759,4,6,2,6,14,11,3,20
Kolkata,8759,5,4,7,3,18,17,1,19
Kerala Blast,8759,6,5,3,6,13,20,-7,18
FC Goa,8759,7,4,3,7,11,19,-8,15
Chennaiyin,8759,8,3,5,6,13,20,-7,14
Mumbai City,8760,1,7,4,3,18,9,9,25
Delhi Dynamo,8760,2,6,5,3,26,17,9,23
Kolkata,8760,3,4,7,3,16,16,0,19
Kerala Blast,8760,4,5,4,5,11,15,-4,19
FC Pune City,8760,5,5,3,6,14,16,-2,18
NorthEast Un,8760,6,5,2,7,13,12,1,17
FC Goa,8760,7,4,3,7,11,16,-5,15
Chennaiyin,8760,8,3,6,5,13,21,-8,15
Mumbai City,8761,1,7,4,3,18,9,9,25
Kerala Blast,8761,2,6,4,4,14,14,0,22
Delhi Dynamo,8761,3,5,5,4,26,20,6,20
Kolkata,8761,4,4,8,2,17,14,3,20
NorthEast Un,8761,5,5,2,7,13,15,-2,17
Chennaiyin,8761,6,4,5,5,16,19,-3,17
FC Pune City,8761,7,4,3,7,12,18,-6,15
FC Goa,8761,8,4,3,7,11,18,-7,15
Mumbai City,8762,1,7,4,3,18,9,9,25
Delhi Dynamo,8762,2,6,5,3,29,19,10,23
Kolkata,8762,3,5,7,2,17,14,3,22
FC Pune City,8762,4,5,3,6,14,16,-2,18
Kerala Blast,8762,5,5,3,6,12,16,-4,18
NorthEast Un,8762,6,4,3,7,12,15,-3,15
Chennaiyin,8762,7,3,6,5,15,21,-6,15
FC Goa,8762,8,4,3,7,12,19,-7,15
Mumbai City,8763,1,7,4,3,21,12,9,25
NorthEast Un,8763,2,6,3,5,13,10,3,21
Delhi Dynamo,8763,3,5,5,4,28,22,6,20
Kolkata,8763,4,4,8,2,19,16,3,20
FC Pune City,8763,5,5,4,5,14,15,-1,19
Chennaiyin,8763,6,4,5,5,16,20,-4,17
Kerala Blast,8763,7,4,4,6,12,19,-7,16
FC Goa,8763,8,3,3,8,12,21,-9,12
Mumbai City,8764,1,7,4,3,18,9,9,25
Chennaiyin,8764,2,5,5,4,16,18,-2,20
Kerala Blast,8764,3,5,4,5,11,15,-4,19
Delhi Dynamo,8764,4,4,6,4,23,18,5,18
Kolkata,8764,5,4,6,4,15,16,-1,18
FC Pune City,8764,6,5,3,6,13,16,-3,18
FC Goa,8764,7,5,2,7,13,16,-3,17
NorthEast Un,8764,8,4,4,6,10,11,-1,16
Kerala Blast,8765,1,7,3,4,14,15,-1,24
Mumbai City,8765,2,6,5,3,17,9,8,23
Delhi Dynamo,8765,3,4,7,3,24,19,5,19
FC Pune City,8765,4,5,3,6,15,17,-2,18
FC Goa,8765,5,5,3,6,12,15,-3,18
NorthEast Un,8765,6,5,2,7,13,14,-1,17
Chennaiyin,8765,7,4,5,5,15,19,-4,17
Kolkata,8765,8,3,6,5,16,18,-2,15
Mumbai City,8766,1,6,4,4,16,9,7,22
Delhi Dynamo,8766,2,5,6,3,22,16,6,21
Kolkata,8766,3,5,6,3,18,15,3,21
NorthEast Un,8766,4,6,3,5,14,11,3,21
Kerala Blast,8766,5,5,3,6,16,17,-1,18
FC Goa,8766,6,5,3,6,13,16,-3,18
Chennaiyin,8766,7,3,6,5,15,21,-6,15
FC Pune City,8766,8,4,3,7,14,23,-9,15
Kolkata,8767,1,6,6,2,18,13,5,24
Mumbai City,8767,2,6,5,3,17,9,8,23
NorthEast Un,8767,3,7,2,5,17,12,5,23
Delhi Dynamo,8767,4,4,6,4,25,22,3,18
Kerala Blast,8767,5,5,3,6,11,17,-6,18
FC Goa,8767,6,5,2,7,14,17,-3,17
FC Pune City,8767,7,4,3,7,13,18,-5,15
Chennaiyin,8767,8,3,5,6,14,21,-7,14
Delhi Dynamo,8768,1,6,5,3,25,19,6,23
Mumbai City,8768,2,6,4,4,16,9,7,22
NorthEast Un,8768,3,6,2,6,14,13,1,20
Kerala Blast,8768,4,5,5,4,15,16,-1,20
FC Pune City,8768,5,5,4,5,15,15,0,19
Kolkata,8768,6,3,8,3,17,18,-1,17
FC Goa,8768,7,4,3,7,12,18,-6,15
Chennaiyin,8768,8,3,5,6,13,19,-6,14
Mumbai City,8769,1,7,4,3,18,8,10,25
Delhi Dynamo,8769,2,5,5,4,23,18,5,20
Kolkata,8769,3,4,8,2,17,14,3,20
NorthEast Un,8769,4,5,3,6,14,13,1,18
FC Pune City,8769,5,5,3,6,14,17,-3,18
Chennaiyin,8769,6,4,5,5,15,19,-4,17
Kerala Blast,8769,7,4,5,5,13,18,-5,17
FC Goa,8769,8,4,3,7,10,17,-7,15
Mumbai City,8770,1,6,5,3,17,9,8,23
Delhi Dynamo,8770,2,5,6,3,23,16,7,21
Chennaiyin,8770,3,5,5,4,15,17,-2,20
Kerala Blast,8770,4,5,4,5,11,14,-3,19
Kolkata,8770,5,4,6,4,19,17,2,18
NorthEast Un,8770,6,5,2,7,10,11,-1,17
FC Goa,8770,7,5,2,7,11,16,-5,17
FC Pune City,8770,8,4,4,6,13,19,-6,16
Mumbai City,8771,1,7,4,3,18,9,9,25
Kolkata,8771,2,5,6,3,18,16,2,21
NorthEast Un,8771,3,6,2,6,13,12,1,20
Kerala Blast,8771,4,5,4,5,11,17,-6,19
Delhi Dynamo,8771,5,4,6,4,24,19,5,18
FC Pune City,8771,6,4,4,6,14,17,-3,16
FC Goa,8771,7,4,4,6,13,16,-3,16
Chennaiyin,8771,8,3,6,5,15,20,-5,15
Mumbai City,8772,1,7,4,3,18,8,10,25
Kerala Blast,8772,2,7,3,4,14,15,-1,24
Delhi Dynamo,8772,3,5,5,4,25,20,5,20
NorthEast Un,8772,4,6,2,6,13,10,3,20
Kolkata,8772,5,3,8,3,16,16,0,17
Chennaiyin,8772,6,4,5,5,15,18,-3,17
FC Pune City,8772,7,4,4,6,13,16,-3,16
FC Goa,8772,8,3,3,8,9,20,-11,12
Delhi Dynamo,8773,1,6,6,2,28,17,11,24
Mumbai City,8773,2,6,4,4,16,11,5,22
Kolkata,8773,3,5,7,2,15,12,3,22
Kerala Blast,8773,4,5,5,4,12,14,-2,20
NorthEast Un,8773,5,5,3,6,15,14,1,18
Chennaiyin,8773,6,4,5,5,14,20,-6,17
FC Pune City,8773,7,4,4,6,13,16,-3,16
FC Goa,8773,8,3,2,9,8,17,-9,11
Mumbai City,8774,1,7,4,3,18,8,10,25
Delhi Dynamo,8774,2,5,6,3,23,17,6,21
NorthEast Un,8774,3,6,3,5,12,10,2,21
Kolkata,8774,4,5,6,3,19,20,-1,21
FC Pune City,8774,5,5,4,5,17,15,2,19
Kerala Blast,8774,6,4,4,6,12,18,-6,16
Chennaiyin,8774,7,3,6,5,14,19,-5,15
FC Goa,8774,8,3,3,8,11,19,-8,12
Mumbai City,8775,1,7,4,3,20,9,11,25
Kolkata,8775,2,5,7,2,20,17,3,22
Delhi Dynamo,8775,3,5,6,3,25,20,5,21
NorthEast Un,8775,4,6,3,5,16,13,3,21
FC Pune City,8775,5,4,4,6,13,16,-3,16
Kerala Blast,8775,6,4,4,6,13,20,-7,16
FC Goa,8775,7,4,3,7,12,18,-6,15
Chennaiyin,8775,8,3,5,6,14,20,-6,14
Delhi Dynamo,8776,1,6,5,3,26,16,10,23
Kolkata,8776,2,5,7,2,21,14,7,22
Mumbai City,8776,3,6,4,4,16,10,6,22
NorthEast Un,8776,4,6,2,6,13,12,1,20
FC Pune City,8776,5,5,3,6,15,19,-4,18
Kerala Blast,8776,6,5,3,6,14,20,-6,18
FC Goa,8776,7,4,3,7,10,18,-8,15
Chennaiyin,8776,8,3,5,6,14,20,-6,14
Delhi Dynamo,8777,1,6,5,3,26,17,9,23
Mumbai City,8777,2,6,4,4,16,9,7,22
NorthEast Un,8777,3,6,3,5,14,12,2,21
Kerala Blast,8777,4,5,5,4,14,17,-3,20
FC Pune City,8777,5,5,4,5,17,17,0,19
Kolkata,8777,6,3,7,4,15,17,-2,16
FC Goa,8777,7,4,3,7,13,18,-5,15
Chennaiyin,8777,8,3,5,6,15,23,-8,14
Delhi Dynamo,8778,1,6,5,3,27,19,8,23
Mumbai City,8778,2,6,4,4,18,11,7,22
FC Pune City,8778,3,6,3,5,15,15,0,21
Kerala Blast,8778,4,6,3,5,14,14,0,21
Chennaiyin,8778,5,5,5,4,17,19,-2,20
Kolkata,8778,6,4,6,4,16,19,-3,18
NorthEast Un,8778,7,5,2,7,11,12,-1,17
FC Goa,8778,8,3,2,9,12,21,-9,11
Delhi Dynamo,8779,1,6,6,2,30,20,10,24
Mumbai City,8779,2,6,4,4,18,11,7,22
Kolkata,8779,3,5,7,2,17,13,4,22
Chennaiyin,8779,4,5,5,4,15,17,-2,20
NorthEast Un,8779,5,5,3,6,12,12,0,18
Kerala Blast,8779,6,4,5,5,12,17,-5,17
FC Pune City,8779,7,4,4,6,14,18,-4,16
FC Goa,8779,8,3,2,9,10,20,-10,11
Mumbai City,8780,1,7,4,3,18,9,9,25
Kolkata,8780,2,5,7,2,16,13,3,22
Delhi Dynamo,8780,3,5,5,4,25,19,6,20
Kerala Blast,8780,4,5,4,5,15,17,-2,19
NorthEast Un,8780,5,5,3,6,16,15,1,18
FC Goa,8780,6,5,3,6,13,17,-4,18
FC Pune City,8780,7,4,3,7,13,19,-6,15
Chennaiyin,8780,8,3,5,6,16,23,-7,14
Kerala Blast,8781,1,7,3,4,18,13,5,24
Delhi Dynamo,8781,2,6,5,3,25,17,8,23
Mumbai City,8781,3,6,4,4,16,9,7,22
Chennaiyin,8781,4,5,5,4,16,18,-2,20
Kolkata,8781,5,4,7,3,16,15,1,19
NorthEast Un,8781,6,5,2,7,12,15,-3,17
FC Pune City,8781,7,4,3,7,13,21,-8,15
FC Goa,8781,8,3,3,8,9,17,-8,12
Mumbai City,8782,1,6,5,3,16,8,8,23
NorthEast Un,8782,2,6,3,5,14,12,2,21
Delhi Dynamo,8782,3,4,8,2,24,17,7,20
Kolkata,8782,4,4,8,2,17,15,2,20
FC Pune City,8782,5,4,5,5,14,16,-2,17
Kerala Blast,8782,6,4,5,5,12,17,-5,17
FC Goa,8782,7,4,3,7,10,16,-6,15
Chennaiyin,8782,8,3,5,6,14,20,-6,14
Mumbai City,8783,1,7,4,3,17,8,9,25
Kolkata,8783,2,5,6,3,18,15,3,21
NorthEast Un,8783,3,5,4,5,13,12,1,19
Kerala Blast,8783,4,5,4,5,13,17,-4,19
Delhi Dynamo,8783,5,4,6,4,22,17,5,18
FC Goa,8783,6,5,2,7,11,15,-4,17
FC Pune City,8783,7,4,4,6,12,16,-4,16
Chennaiyin,8783,8,3,6,5,14,20,-6,15
Mumbai City,8784,1,6,5,3,18,10,8,23
Delhi Dynamo,8784,2,5,6,3,26,19,7,21
FC Pune City,8784,3,6,3,5,17,15,2,21
NorthEast Un,8784,4,5,3,6,13,12,1,18
Kolkata,8784,5,4,6,4,17,19,-2,18
Kerala Blast,8784,6,5,3,6,12,17,-5,18
FC Goa,8784,7,5,2,7,12,18,-6,17
Chennaiyin,8784,8,3,6,5,14,19,-5,15
Delhi Dynamo,8785,1,6,5,3,24,16,8,23
Mumbai City,8785,2,6,4,4,17,10,7,22
NorthEast Un,8785,3,6,2,6,12,11,1,20
Kolkata,8785,4,4,6,4,20,22,-2,18
FC Pune City,8785,5,5,3,6,16,18,-2,18
Chennaiyin,8785,6,4,6,4,16,19,-3,18
Kerala Blast,8785,7,5,3,6,12,19,-7,18
FC Goa,8785,8,4,3,7,17,19,-2,15
Mumbai City,8786,1,6,5,3,17,9,8,23
Delhi Dynamo,8786,2,5,6,3,23,16,7,21
NorthEast Un,8786,3,6,2,6,12,11,1,20
Kolkata,8786,4,4,7,3,16,16,0,19
Chennaiyin,8786,5,4,6,4,15,17,-2,18
FC Pune City,8786,6,4,5,5,13,15,-2,17
Kerala Blast,8786,7,4,4,6,11,19,-8,16
FC Goa,8786,8,4,3,7,11,15,-4,15
Delhi Dynamo,8787,1,5,7,2,24,16,8,22
Mumbai City,8787,2,6,4,4,17,10,7,22
Kerala Blast,8787,3,6,4,4,14,14,0,22
FC Pune City,8787,4,5,4,5,15,16,-1,19
FC Goa,8787,5,5,3,6,18,17,1,18
Chennaiyin,8787,6,4,5,5,16,24,-8,17
Kolkata,8787,7,3,6,5,15,18,-3,15
NorthEast Un,8787,8,4,3,7,10,14,-4,15
Delhi Dynamo,8788,1,6,5,3,24,16,8,23
Mumbai City,8788,2,6,4,4,17,10,7,22
Kolkata,8788,3,5,6,3,17,15,2,21
NorthEast Un,8788,4,6,3,5,11,9,2,21
Kerala Blast,8788,5,6,3,5,14,17,-3,21
Chennaiyin,8788,6,4,6,4,16,18,-2,18
FC Pune City,8788,7,4,3,7,14,18,-4,15
FC Goa,8788,8,3,2,9,10,20,-10,11
Mumbai City,8789,1,7,4,3,17,8,9,25
Kolkata,8789,2,5,6,3,18,15,3,21
Kerala Blast,8789,3,6,3,5,11,14,-3,21
Delhi Dynamo,8789,4,5,5,4,22,17,5,20
NorthEast Un,8789,5,5,3,6,11,10,1,18
Chennaiyin,8789,6,4,6,4,16,19,-3,18
FC Pune City,8789,7,4,3,7,12,19,-7,15
FC Goa,8789,8,4,2,8,13,18,-5,14
Mumbai City,8790,1,7,4,3,17,8,9,25
Kerala Blast,8790,2,6,4,4,11,13,-2,22
FC Pune City,8790,3,5,4,5,14,14,0,19
NorthEast Un,8790,4,5,3,6,12,11,1,18
Kolkata,8790,5,4,6,4,14,15,-1,18
Delhi Dynamo,8790,6,4,5,5,21,18,3,17
FC Goa,8790,7,5,2,7,12,15,-3,17
Chennaiyin,8790,8,3,6,5,14,21,-7,15
Mumbai City,8791,1,7,4,3,19,10,9,25
Kolkata,8791,2,6,6,2,21,14,7,24
Kerala Blast,8791,3,5,4,5,14,19,-5,19
NorthEast Un,8791,4,5,3,6,13,13,0,18
Delhi Dynamo,8791,5,4,5,5,24,21,3,17
Chennaiyin,8791,6,4,5,5,14,18,-4,17
FC Goa,8791,7,5,2,7,11,15,-4,17
FC Pune City,8791,8,4,3,7,12,18,-6,15
Delhi Dynamo,8792,1,6,6,2,30,17,13,24
Mumbai City,8792,2,6,4,4,16,11,5,22
Kerala Blast,8792,3,6,4,4,16,14,2,22
FC Pune City,8792,4,5,4,5,14,15,-1,19
Chennaiyin,8792,5,4,5,5,15,20,-5,17
Kolkata,8792,6,3,7,4,16,21,-5,16
NorthEast Un,8792,7,4,3,7,11,13,-2,15
FC Goa,8792,8,4,3,7,15,22,-7,15
Delhi Dynamo,8793,1,6,6,2,25,16,9,24
Mumbai City,8793,2,6,4,4,16,9,7,22
Kolkata,8793,3,4,7,3,15,14,1,19
FC Pune City,8793,4,5,4,5,15,16,-1,19
NorthEast Un,8793,5,5,3,6,11,11,0,18
FC Goa,8793,6,4,4,6,11,16,-5,16
Kerala Blast,8793,7,4,4,6,10,16,-6,16
Chennaiyin,8793,8,3,6,5,14,19,-5,15
Mumbai City,8794,1,6,5,3,17,9,8,23
Delhi Dynamo,8794,2,5,7,2,24,16,8,22
Kolkata,8794,3,5,7,2,19,12,7,22
Kerala Blast,8794,4,6,3,5,12,15,-3,21
Chennaiyin,8794,5,4,5,5,16,20,-4,17
NorthEast Un,8794,6,4,3,7,11,13,-2,15
FC Goa,8794,7,4,3,7,10,16,-6,15
FC Pune City,8794,8,4,3,7,12,20,-8,15
Mumbai City,8795,1,6,5,3,17,9,8,23
Kolkata,8795,2,5,7,2,20,15,5,22
Delhi Dynamo,8795,3,4,8,2,24,17,7,20
NorthEast Un,8795,4,5,3,6,13,12,1,18
Kerala Blast,8795,5,5,3,6,15,18,-3,18
Chennaiyin,8795,6,4,5,5,15,19,-4,17
FC Goa,8795,7,4,4,6,11,16,-5,16
FC Pune City,8795,8,4,3,7,14,23,-9,15
Mumbai City,8796,1,7,4,3,18,8,10,25
NorthEast Un,8796,2,6,2,6,19,13,6,20
Kerala Blast,8796,3,5,5,4,12,15,-3,20
Kolkata,8796,4,4,7,3,15,14,1,19
FC Pune City,8796,5,5,4,5,14,15,-1,19
Delhi Dynamo,8796,6,4,5,5,22,23,-1,17
FC Goa,8796,7,5,2,7,11,16,-5,17
Chennaiyin,8796,8,3,5,6,14,21,-7,14
Mumbai City,8797,1,6,5,3,16,8,8,23
Delhi Dynamo,8797,2,5,6,3,24,18,6,21
Kerala Blast,8797,3,6,3,5,13,16,-3,21
NorthEast Un,8797,4,6,2,6,15,13,2,20
FC Pune City,8797,5,5,3,6,14,16,-2,18
Chennaiyin,8797,6,4,5,5,15,19,-4,17
Kolkata,8797,7,3,7,4,15,16,-1,16
FC Goa,8797,8,4,3,7,10,16,-6,15
Delhi Dynamo,8798,1,6,6,2,28,16,12,24
Kolkata,8798,2,6,6,2,20,13,7,24
Mumbai City,8798,3,6,4,4,17,12,5,22
Kerala Blast,8798,4,6,3,5,12,15,-3,21
NorthEast Un,8798,5,4,4,6,10,12,-2,16
Chennaiyin,8798,6,3,6,5,13,18,-5,15
FC Pune City,8798,7,4,3,7,12,17,-5,15
FC Goa,8798,8,4,2,8,10,19,-9,14
Mumbai City,8799,1,7,4,3,19,8,11,25
Delhi Dynamo,8799,2,5,6,3,24,18,6,21
Kolkata,8799,3,5,6,3,17,16,1,21
Kerala Blast,8799,4,6,3,5,12,15,-3,21
FC Pune City,8799,5,5,3,6,15,16,-1,18
Chennaiyin,8799,6,4,6,4,15,18,-3,18
NorthEast Un,8799,7,4,4,6,9,10,-1,16
FC Goa,8799,8,3,2,9,10,20,-10,11
Mumbai City,8800,1,7,4,3,18,8,10,25
Delhi Dynamo,8800,2,6,5,3,24,16,8,23
Kolkata,8800,3,5,6,3,21,15,6,21
FC Goa,8800,4,5,2,7,12,16,-4,17
Chennaiyin,8800,5,4,5,5,15,20,-5,17
Kerala Blast,8800,6,4,5,5,12,20,-8,17
FC Pune City,8800,7,4,4,6,13,17,-4,16
NorthEast Un,8800,8,4,3,7,11,14,-3,15
Mumbai City,8801,1,7,4,3,18,9,9,25
Kolkata,8801,2,5,7,2,17,12,5,22
NorthEast Un,8801,3,6,3,5,16,14,2,21
Delhi Dynamo,8801,4,4,6,4,28,23,5,18
Chennaiyin,8801,5,4,6,4,15,18,-3,18
FC Pune City,8801,6,4,4,6,13,17,-4,16
Kerala Blast,8801,7,4,4,6,11,18,-7,16
FC Goa,8801,8,3,4,7,11,18,-7,13
Mumbai City,8802,1,6,5,3,16,8,8,23
Kolkata,8802,2,4,8,2,16,13,3,20
Delhi Dynamo,8802,3,4,6,4,23,18,5,18
NorthEast Un,8802,4,5,3,6,11,12,-1,18
Chennaiyin,8802,5,4,6,4,18,20,-2,18
FC Pune City,8802,6,4,5,5,14,16,-2,17
Kerala Blast,8802,7,4,5,5,10,16,-6,17
FC Goa,8802,8,4,4,6,13,18,-5,16
Mumbai City,8803,1,7,4,3,20,10,10,25
Delhi Dynamo,8803,2,5,6,3,29,21,8,21
Kerala Blast,8803,3,6,3,5,15,18,-3,21
NorthEast Un,8803,4,5,3,6,16,14,2,18
FC Pune City,8803,5,5,3,6,17,17,0,18
FC Goa,8803,6,5,2,7,13,17,-4,17
Chennaiyin,8803,7,4,5,5,15,20,-5,17
Kolkata,8803,8,3,6,5,15,23,-8,15
Delhi Dynamo,8804,1,7,5,2,31,17,14,26
Mumbai City,8804,2,6,4,4,17,12,5,22
Chennaiyin,8804,3,5,5,4,16,17,-1,20
Kolkata,8804,4,4,7,3,18,17,1,19
FC Pune City,8804,5,4,5,5,13,15,-2,17
Kerala Blast,8804,6,4,5,5,10,15,-5,17
NorthEast Un,8804,7,4,3,7,10,13,-3,15
FC Goa,8804,8,4,2,8,12,21,-9,14
Mumbai City,8805,1,7,4,3,18,9,9,25
Kolkata,8805,2,5,6,3,18,14,4,21
Kerala Blast,8805,3,5,4,5,13,15,-2,19
NorthEast Un,8805,4,5,3,6,12,12,0,18
FC Goa,8805,5,5,3,6,14,15,-1,18
Chennaiyin,8805,6,4,6,4,16,18,-2,18
Delhi Dynamo,8805,7,4,5,5,22,22,0,17
FC Pune City,8805,8,4,3,7,13,21,-8,15
Delhi Dynamo,8806,1,6,5,3,25,19,6,23
Mumbai City,8806,2,6,4,4,17,10,7,22
Kolkata,8806,3,5,7,2,20,16,4,22
NorthEast Un,8806,4,6,2,6,16,13,3,20
Kerala Blast,8806,5,5,5,4,13,15,-2,20
FC Pune City,8806,6,4,4,6,12,16,-4,16
Chennaiyin,8806,7,3,6,5,15,21,-6,15
FC Goa,8806,8,3,3,8,11,19,-8,12
Delhi Dynamo,8807,1,6,6,2,30,19,11,24
Mumbai City,8807,2,6,4,4,18,11,7,22
NorthEast Un,8807,3,6,3,5,14,12,2,21
FC Pune City,8807,4,5,4,5,13,14,-1,19
Chennaiyin,8807,5,4,5,5,17,19,-2,17
Kerala Blast,8807,6,4,5,5,11,16,-5,17
Kolkata,8807,7,3,7,4,15,16,-1,16
FC Goa,8807,8,4,2,8,12,23,-11,14
Mumbai City,8808,1,7,4,3,19,8,11,25
Delhi Dynamo,8808,2,4,7,3,22,18,4,19
Kolkata,8808,3,4,7,3,16,15,1,19
NorthEast Un,8808,4,5,4,5,11,10,1,19
Kerala Blast,8808,5,5,4,5,14,17,-3,19
Chennaiyin,8808,6,4,6,4,15,18,-3,18
FC Pune City,8808,7,4,3,7,12,17,-5,15
FC Goa,8808,8,4,3,7,11,17,-6,15
Mumbai City,8809,1,7,4,3,17,8,9,25
Kerala Blast,8809,2,6,4,4,14,16,-2,22
Delhi Dynamo,8809,3,5,6,3,24,15,9,21
Chennaiyin,8809,4,4,6,4,15,18,-3,18
Kolkata,8809,5,3,8,3,15,15,0,17
NorthEast Un,8809,6,4,4,6,11,12,-1,16
FC Pune City,8809,7,4,4,6,14,17,-3,16
FC Goa,8809,8,4,2,8,9,18,-9,14
Mumbai City,8810,1,7,4,3,18,9,9,25
Kolkata,8810,2,5,7,2,17,13,4,22
Delhi Dynamo,8810,3,5,6,3,26,18,8,21
Kerala Blast,8810,4,4,6,4,9,13,-4,18
NorthEast Un,8810,5,4,4,6,10,12,-2,16
FC Pune City,8810,6,4,4,6,13,16,-3,16
FC Goa,8810,7,4,3,7,18,17,1,15
Chennaiyin,8810,8,3,6,5,13,26,-13,15
Delhi Dynamo,8811,1,6,5,3,25,18,7,23
NorthEast Un,8811,2,7,2,5,16,10,6,23
Mumbai City,8811,3,6,4,4,16,10,6,22
Kolkata,8811,4,5,6,3,19,16,3,21
Kerala Blast,8811,5,5,3,6,10,16,-6,18
FC Goa,8811,6,5,2,7,14,19,-5,17
FC Pune City,8811,7,4,3,7,12,17,-5,15
Chennaiyin,8811,8,3,5,6,15,21,-6,14
Mumbai City,8812,1,7,4,3,18,8,10,25
FC Pune City,8812,2,6,3,5,17,16,1,21
Delhi Dynamo,8812,3,4,7,3,24,19,5,19
Kerala Blast,8812,4,5,4,5,13,17,-4,19
NorthEast Un,8812,5,5,3,6,14,14,0,18
Chennaiyin,8812,6,4,5,5,15,19,-4,17
Kolkata,8812,7,3,7,4,17,20,-3,16
FC Goa,8812,8,4,3,7,11,16,-5,15
Mumbai City,8813,1,7,4,3,19,8,11,25
NorthEast Un,8813,2,7,2,5,19,10,9,23
Kolkata,8813,3,4,7,3,18,17,1,19
Delhi Dynamo,8813,4,4,6,4,21,20,1,18
Kerala Blast,8813,5,4,5,5,10,15,-5,17
FC Pune City,8813,6,4,4,6,14,18,-4,16
FC Goa,8813,7,4,4,6,11,15,-4,16
Chennaiyin,8813,8,3,6,5,13,22,-9,15
Mumbai City,8814,1,7,4,3,19,9,10,25
Delhi Dynamo,8814,2,5,6,3,25,18,7,21
Kolkata,8814,3,4,8,2,18,16,2,20
Chennaiyin,8814,4,5,5,4,16,18,-2,20
Kerala Blast,8814,5,5,4,5,15,15,0,19
NorthEast Un,8814,6,5,3,6,11,11,0,18
FC Pune City,8814,7,4,4,6,13,20,-7,16
FC Goa,8814,8,3,2,9,11,21,-10,11
Delhi Dynamo,8815,1,6,6,2,27,18,9,24
Mumbai City,8815,2,6,4,4,17,10,7,22
Kerala Blast,8815,3,6,3,5,16,19,-3,21
NorthEast Un,8815,4,5,3,6,12,12,0,18
FC Pune City,8815,5,5,3,6,16,18,-2,18
Kolkata,8815,6,3,7,4,15,16,-1,16
FC Goa,8815,7,4,4,6,14,18,-4,16
Chennaiyin,8815,8,3,6,5,14,20,-6,15
Mumbai City,8816,1,6,4,4,17,10,7,22
Delhi Dynamo,8816,2,5,5,4,25,19,6,20
FC Goa,8816,3,6,2,6,16,16,0,20
NorthEast Un,8816,4,6,2,6,12,13,-1,20
Kolkata,8816,5,4,7,3,16,15,1,19
Chennaiyin,8816,6,4,5,5,17,19,-2,17
FC Pune City,8816,7,4,5,5,14,16,-2,17
Kerala Blast,8816,8,4,4,6,11,20,-9,16
Mumbai City,8817,1,6,5,3,17,9,8,23
Delhi Dynamo,8817,2,5,6,3,26,18,8,21
Kolkata,8817,3,5,6,3,19,17,2,21
Kerala Blast,8817,4,5,4,5,13,17,-4,19
FC Goa,8817,5,5,3,6,13,17,-4,18
NorthEast Un,8817,6,5,2,7,15,14,1,17
FC Pune City,8817,7,4,4,6,13,16,-3,16
Chennaiyin,8817,8,3,6,5,14,22,-8,15
Delhi Dynamo,8818,1,6,5,3,24,17,7,23
Mumbai City,8818,2,6,4,4,16,9,7,22
FC Pune City,8818,3,6,3,5,17,16,1,21
Kolkata,8818,4,4,7,3,15,15,0,19
Kerala Blast,8818,5,5,4,5,12,16,-4,19
FC Goa,8818,6,5,2,7,16,17,-1,17
Chennaiyin,8818,7,4,5,5,15,22,-7,17
NorthEast Un,8818,8,4,2,8,10,13,-3,14
Mumbai City,8819,1,7,4,3,19,10,9,25
Kolkata,8819,2,6,6,2,17,12,5,24
NorthEast Un,8819,3,6,2,6,13,11,2,20
Chennaiyin,8819,4,5,5,4,15,17,-2,20
Delhi Dynamo,8819,5,4,5,5,24,21,3,17
FC Pune City,8819,6,4,4,6,12,16,-4,16
Kerala Blast,8819,7,4,4,6,9,15,-6,16
FC Goa,8819,8,4,2,8,9,16,-7,14
Mumbai City,8820,1,6,5,3,16,8,8,23
Kolkata,8820,2,5,7,2,20,17,3,22
NorthEast Un,8820,3,6,2,6,13,11,2,20
FC Pune City,8820,4,5,4,5,15,15,0,19
Delhi Dynamo,8820,5,4,6,4,22,17,5,18
Chennaiyin,8820,6,4,5,5,15,19,-4,17
FC Goa,8820,7,5,2,7,15,20,-5,17
Kerala Blast,8820,8,4,3,7,9,18,-9,15
Mumbai City,8821,1,7,4,3,18,8,10,25
Kolkata,8821,2,5,6,3,15,13,2,21
Delhi Dynamo,8821,3,5,5,4,22,19,3,20
NorthEast Un,8821,4,5,4,5,12,9,3,19
Kerala Blast,8821,5,5,4,5,10,14,-4,19
FC Pune City,8821,6,5,3,6,13,15,-2,18
Chennaiyin,8821,7,3,6,5,14,20,-6,15
FC Goa,8821,8,4,2,8,11,17,-6,14
Mumbai City,8822,1,6,5,3,17,9,8,23
Delhi Dynamo,8822,2,5,6,3,23,16,7,21
Kolkata,8822,3,5,6,3,18,14,4,21
Chennaiyin,8822,4,4,6,4,17,18,-1,18
NorthEast Un,8822,5,5,3,6,11,13,-2,18
Kerala Blast,8822,6,4,5,5,11,18,-7,17
FC Pune City,8822,7,4,4,6,13,17,-4,16
FC Goa,8822,8,4,3,7,11,16,-5,15
Mumbai City,8823,1,7,4,3,19,10,9,25
Kerala Blast,8823,2,7,3,4,15,16,-1,24
Delhi Dynamo,8823,3,5,5,4,24,19,5,20
FC Pune City,8823,4,5,3,6,17,17,0,18
Kolkata,8823,5,4,6,4,14,16,-2,18
NorthEast Un,8823,6,5,2,7,13,14,-1,17
Chennaiyin,8823,7,4,5,5,17,21,-4,17
FC Goa,8823,8,4,2,8,11,17,-6,14
Mumbai City,8824,1,7,4,3,18,9,9,25
Kolkata,8824,2,5,7,2,19,13,6,22
Kerala Blast,8824,3,5,4,5,13,17,-4,19
Delhi Dynamo,8824,4,4,6,4,24,21,3,18
FC Pune City,8824,5,5,3,6,15,19,-4,18
NorthEast Un,8824,6,5,2,7,14,14,0,17
Chennaiyin,8824,7,4,5,5,16,19,-3,17
FC Goa,8824,8,4,3,7,10,17,-7,15
Mumbai City,8825,1,6,4,4,16,9,7,22
Delhi Dynamo,8825,2,5,5,4,24,19,5,20
NorthEast Un,8825,3,6,2,6,14,13,1,20
Kolkata,8825,4,4,7,3,15,16,-1,19
FC Goa,8825,5,5,3,6,14,15,-1,18
Chennaiyin,8825,6,4,6,4,14,17,-3,18
Kerala Blast,8825,7,5,3,6,14,18,-4,18
FC Pune City,8825,8,4,4,6,12,16,-4,16
Delhi Dynamo,8826,1,6,6,2,26,14,12,24
Kerala Blast,8826,2,7,3,4,17,16,1,24
Mumbai City,8826,3,6,4,4,16,12,4,22
Kolkata,8826,4,5,6,3,17,16,1,21
Chennaiyin,8826,5,4,6,4,15,17,-2,18
FC Pune City,8826,6,4,3,7,16,20,-4,15
NorthEast Un,8826,7,4,3,7,10,14,-4,15
FC Goa,8826,8,3,3,8,8,16,-8,12
Mumbai City,8827,1,6,5,3,18,10,8,23
Delhi Dynamo,8827,2,5,7,2,25,16,9,22
NorthEast Un,8827,3,6,2,6,13,12,1,20
Kerala Blast,8827,4,5,4,5,13,16,-3,19
FC Goa,8827,5,5,3,6,13,15,-2,18
Kolkata,8827,6,3,8,3,15,17,-2,17
FC Pune City,8827,7,4,4,6,12,16,-4,16
Chennaiyin,8827,8,3,5,6,15,22,-7,14
Mumbai City,8828,1,6,4,4,16,11,5,22
Delhi Dynamo,8828,2,5,5,4,24,17,7,20
Kerala Blast,8828,3,5,5,4,13,16,-3,20
NorthEast Un,8828,4,5,4,5,11,10,1,19
Kolkata,8828,5,4,6,4,16,15,1,18
FC Goa,8828,6,5,3,6,12,15,-3,18
Chennaiyin,8828,7,3,7,4,14,18,-4,16
FC Pune City,8828,8,4,4,6,13,17,-4,16
Delhi Dynamo,8829,1,6,6,2,25,15,10,24
Mumbai City,8829,2,6,4,4,17,10,7,22
Kerala Blast,8829,3,5,5,4,12,15,-3,20
Kolkata,8829,4,4,7,3,15,14,1,19
FC Pune City,8829,5,4,5,5,14,16,-2,17
Chennaiyin,8829,6,4,5,5,14,18,-4,17
NorthEast Un,8829,7,4,4,6,10,11,-1,16
FC Goa,8829,8,4,2,8,9,17,-8,14
Delhi Dynamo,8830,1,6,5,3,25,18,7,23
Mumbai City,8830,2,6,4,4,16,10,6,22
Kerala Blast,8830,3,6,3,5,15,16,-1,21
NorthEast Un,8830,4,6,2,6,14,14,0,20
Kolkata,8830,5,4,7,3,18,16,2,19
FC Goa,8830,6,5,2,7,15,17,-2,17
FC Pune City,8830,7,4,4,6,14,17,-3,16
Chennaiyin,8830,8,3,5,6,13,22,-9,14
Mumbai City,8831,1,7,4,3,18,8,10,25
Delhi Dynamo,8831,2,6,5,3,25,17,8,23
Kolkata,8831,3,5,6,3,21,16,5,21
NorthEast Un,8831,4,5,3,6,11,11,0,18
Chennaiyin,8831,5,4,5,5,14,18,-4,17
Kerala Blast,8831,6,4,5,5,10,15,-5,17
FC Pune City,8831,7,4,4,6,13,19,-6,16
FC Goa,8831,8,4,2,8,10,18,-8,14
Mumbai City,8832,1,6,5,3,18,10,8,23
Kerala Blast,8832,2,6,4,4,14,13,1,22
NorthEast Un,8832,3,6,3,5,12,9,3,21
Delhi Dynamo,8832,4,4,6,4,23,19,4,18
Chennaiyin,8832,5,4,5,5,14,18,-4,17
FC Goa,8832,6,5,2,7,11,15,-4,17
Kolkata,8832,7,3,7,4,14,16,-2,16
FC Pune City,8832,8,4,4,6,13,19,-6,16
Mumbai City,8833,1,7,4,3,18,9,9,25
Delhi Dynamo,8833,2,5,5,4,27,19,8,20
FC Pune City,8833,3,5,4,5,19,16,3,19
NorthEast Un,8833,4,5,3,6,13,13,0,18
Chennaiyin,8833,5,4,6,4,16,18,-2,18
Kolkata,8833,6,4,6,4,15,21,-6,18
Kerala Blast,8833,7,4,5,5,10,15,-5,17
FC Goa,8833,8,4,3,7,11,18,-7,15
Delhi Dynamo,8834,1,7,5,2,26,14,12,26
Mumbai City,8834,2,6,4,4,16,9,7,22
Kolkata,8834,3,5,7,2,18,13,5,22
Chennaiyin,8834,4,5,5,4,18,19,-1,20
Kerala Blast,8834,5,5,4,5,12,14,-2,19
NorthEast Un,8834,6,5,2,7,12,15,-3,17
FC Pune City,8834,7,4,3,7,13,21,-8,15
FC Goa,8834,8,3,2,9,8,18,-10,11
Mumbai City,8835,1,7,4,3,18,9,9,25
Kerala Blast,8835,2,6,4,4,15,16,-1,22
Delhi Dynamo,8835,3,5,6,3,27,19,8,21
Kolkata,8835,4,3,8,3,14,14,0,17
NorthEast Un,8835,5,5,2,7,13,15,-2,17
FC Pune City,8835,6,4,4,6,14,18,-4,16
FC Goa,8835,7,4,4,6,12,17,-5,16
Chennaiyin,8835,8,3,6,5,14,19,-5,15
Mumbai City,8836,1,7,4,3,20,9,11,25
Delhi Dynamo,8836,2,6,5,3,26,19,7,23
Kerala Blast,8836,3,6,4,4,13,15,-2,22
Kolkata,8836,4,4,6,4,18,17,1,18
Chennaiyin,8836,5,4,5,5,17,20,-3,17
FC Goa,8836,6,5,2,7,12,18,-6,17
NorthEast Un,8836,7,4,3,7,11,14,-3,15
FC Pune City,8836,8,4,3,7,12,17,-5,15
Mumbai City,8837,1,7,4,3,20,9,11,25
NorthEast Un,8837,2,6,2,6,15,13,2,20
Kolkata,8837,3,4,7,3,16,13,3,19
Kerala Blast,8837,4,5,4,5,11,15,-4,19
Delhi Dynamo,8837,5,4,6,4,24,22,2,18
FC Goa,8837,6,5,3,6,13,16,-3,18
FC Pune City,8837,7,5,3,6,13,17,-4,18
Chennaiyin,8837,8,3,5,6,15,22,-7,14
Mumbai City,8838,1,6,5,3,17,9,8,23
Kerala Blast,8838,2,6,3,5,15,18,-3,21
Delhi Dynamo,8838,3,4,8,2,23,16,7,20
FC Pune City,8838,4,5,4,5,16,16,0,19
Kolkata,8838,5,3,8,3,14,14,0,17
NorthEast Un,8838,6,4,4,6,10,12,-2,16
FC Goa,8838,7,4,4,6,10,15,-5,16
Chennaiyin,8838,8,3,6,5,14,19,-5,15
Delhi Dynamo,8839,1,6,6,2,25,16,9,24
Mumbai City,8839,2,6,4,4,16,9,7,22
Kerala Blast,8839,3,5,5,4,14,15,-1,20
Kolkata,8839,4,4,7,3,16,15,1,19
FC Pune City,8839,5,4,4,6,13,16,-3,16
Chennaiyin,8839,6,3,7,4,15,19,-4,16
FC Goa,8839,7,4,4,6,13,18,-5,16
NorthEast Un,8839,8,4,3,7,10,14,-4,15
Mumbai City,8840,1,6,5,3,17,9,8,23
Kolkata,8840,2,5,7,2,21,13,8,22
NorthEast Un,8840,3,6,3,5,12,10,2,21
Delhi Dynamo,8840,4,4,7,3,24,20,4,19
FC Pune City,8840,5,4,5,5,14,16,-2,17
Chennaiyin,8840,6,4,5,5,15,19,-4,17
Kerala Blast,8840,7,4,4,6,11,18,-7,16
FC Goa,8840,8,4,2,8,14,23,-9,14
Delhi Dynamo,8841,1,6,5,3,25,17,8,23
Mumbai City,8841,2,6,4,4,17,10,7,22
NorthEast Un,8841,3,6,3,5,11,9,2,21
Kerala Blast,8841,4,5,5,4,12,13,-1,20
FC Pune City,8841,5,5,4,5,13,14,-1,19
FC Goa,8841,6,5,2,7,12,16,-4,17
Kolkata,8841,7,3,6,5,13,17,-4,15
Chennaiyin,8841,8,3,5,6,13,20,-7,14
Mumbai City,8842,1,7,4,3,21,8,13,25
Delhi Dynamo,8842,2,5,6,3,24,20,4,21
Kolkata,8842,3,4,8,2,20,16,4,20
Kerala Blast,8842,4,5,5,4,13,15,-2,20
NorthEast Un,8842,5,5,3,6,13,14,-1,18
Chennaiyin,8842,6,3,6,5,17,22,-5,15
FC Pune City,8842,7,4,3,7,13,20,-7,15
FC Goa,8842,8,3,5,6,11,17,-6,14
Mumbai City,8843,1,6,5,3,16,8,8,23
Kerala Blast,8843,2,6,4,4,13,14,-1,22
Delhi Dynamo,8843,3,5,6,3,26,18,8,21
Kolkata,8843,4,4,8,2,17,14,3,20
Chennaiyin,8843,5,4,6,4,17,20,-3,18
FC Goa,8843,6,4,4,6,14,19,-5,16
FC Pune City,8843,7,4,3,7,12,17,-5,15
NorthEast Un,8843,8,4,2,8,11,16,-5,14
Delhi Dynamo,8844,1,5,7,2,27,18,9,22
Mumbai City,8844,2,6,4,4,18,12,6,22
Kerala Blast,8844,3,5,5,4,12,14,-2,20
NorthEast Un,8844,4,5,4,5,11,10,1,19
FC Pune City,8844,5,5,3,6,17,18,-1,18
FC Goa,8844,6,5,3,6,13,15,-2,18
Kolkata,8844,7,3,7,4,14,17,-3,16
Chennaiyin,8844,8,3,5,6,13,21,-8,14
Mumbai City,8845,1,6,4,4,16,9,7,22
Kerala Blast,8845,2,6,4,4,11,13,-2,22
Delhi Dynamo,8845,3,5,6,3,23,16,7,21
Kolkata,8845,4,4,8,2,18,15,3,20
Chennaiyin,8845,5,4,6,4,15,18,-3,18
NorthEast Un,8845,6,5,2,7,11,12,-1,17
FC Pune City,8845,7,4,4,6,13,16,-3,16
FC Goa,8845,8,3,4,7,11,19,-8,13
Mumbai City,8846,1,6,5,3,18,10,8,23
Delhi Dynamo,8846,2,5,6,3,25,18,7,21
FC Pune City,8846,3,6,3,5,15,14,1,21
NorthEast Un,8846,4,6,2,6,14,12,2,20
Kolkata,8846,5,4,7,3,17,16,1,19
Kerala Blast,8846,6,5,3,6,11,17,-6,18
Chennaiyin,8846,7,4,5,5,15,19,-4,17
FC Goa,8846,8,3,3,8,10,19,-9,12
Mumbai City,8847,1,7,4,3,22,9,13,25
Delhi Dynamo,8847,2,6,5,3,25,21,4,23
Kolkata,8847,3,5,7,2,17,14,3,22
FC Pune City,8847,4,5,4,5,15,16,-1,19
NorthEast Un,8847,5,5,3,6,10,10,0,18
Chennaiyin,8847,6,3,6,5,13,18,-5,15
Kerala Blast,8847,7,4,3,7,11,18,-7,15
FC Goa,8847,8,4,2,8,10,17,-7,14
Delhi Dynamo,8848,1,7,5,2,31,14,17,26
Mumbai City,8848,2,6,4,4,16,12,4,22
Kolkata,8848,3,4,8,2,18,14,4,20
FC Pune City,8848,4,5,4,5,14,15,-1,19
Chennaiyin,8848,5,4,6,4,15,18,-3,18
NorthEast Un,8848,6,5,2,7,10,13,-3,17
Kerala Blast,8848,7,4,4,6,10,16,-6,16
FC Goa,8848,8,3,3,8,9,21,-12,12
Mumbai City,8849,1,7,4,3,17,8,9,25
Delhi Dynamo,8849,2,5,6,3,24,17,7,21
Kolkata,8849,3,5,6,3,18,14,4,21
NorthEast Un,8849,4,6,3,5,14,11,3,21
FC Pune City,8849,5,5,3,6,14,17,-3,18
FC Goa,8849,6,5,2,7,12,15,-3,17
Kerala Blast,8849,7,4,3,7,10,20,-10,15
Chennaiyin,8849,8,3,5,6,13,20,-7,14
Mumbai City,8850,1,6,5,3,18,10,8,23
Kerala Blast,8850,2,6,4,4,12,14,-2,22
Delhi Dynamo,8850,3,5,6,3,27,20,7,21
NorthEast Un,8850,4,5,4,5,13,12,1,19
Chennaiyin,8850,5,4,6,4,16,19,-3,18
Kolkata,8850,6,3,7,4,16,18,-2,16
FC Pune City,8850,7,4,4,6,13,16,-3,16
FC Goa,8850,8,4,2,8,15,21,-6,14
Mumbai City,8851,1,7,4,3,18,9,9,25
Kolkata,8851,2,5,6,3,20,17,3,21
Chennaiyin,8851,3,5,5,4,18,19,-1,20
Delhi Dynamo,8851,4,4,7,3,25,19,6,19
FC Pune City,8851,5,5,3,6,15,17,-2,18
Kerala Blast,8851,6,5,3,6,14,18,-4,18
NorthEast Un,8851,7,4,3,7,11,16,-5,15
FC Goa,8851,8,4,3,7,12,18,-6,15
Delhi Dynamo,8852,1,6,5,3,26,16,10,23
Mumbai City,8852,2,6,4,4,17,10,7,22
Kolkata,8852,3,5,7,2,18,13,5,22
Kerala Blast,8852,4,6,3,5,14,17,-3,21
NorthEast Un,8852,5,6,2,6,13,10,3,20
FC Pune City,8852,6,4,3,7,12,18,-6,15
FC Goa,8852,7,4,3,7,10,17,-7,15
Chennaiyin,8852,8,3,5,6,13,22,-9,14
Mumbai City,8853,1,6,5,3,19,11,8,23
Delhi Dynamo,8853,2,5,6,3,28,20,8,21
Kolkata,8853,3,5,6,3,19,14,5,21
Kerala Blast,8853,4,6,3,5,15,18,-3,21
NorthEast Un,8853,5,6,2,6,14,13,1,20
FC Pune City,8853,6,5,3,6,14,18,-4,18
Chennaiyin,8853,7,4,5,5,16,19,-3,17
FC Goa,8853,8,3,2,9,10,22,-12,11
Mumbai City,8854,1,7,4,3,18,8,10,25
Kolkata,8854,2,5,7,2,21,17,4,22
NorthEast Un,8854,3,6,3,5,13,10,3,21
Kerala Blast,8854,4,4,6,4,14,18,-4,18
Delhi Dynamo,8854,5,4,5,5,22,20,2,17
FC Goa,8854,6,5,2,7,11,16,-5,17
FC Pune City,8854,7,4,4,6,15,19,-4,16
Chennaiyin,8854,8,3,5,6,13,19,-6,14
Mumbai City,8855,1,7,4,3,18,9,9,25
Delhi Dynamo,8855,2,5,5,4,25,19,6,20
NorthEast Un,8855,3,6,2,6,12,10,2,20
Chennaiyin,8855,4,5,5,4,16,17,-1,20
Kolkata,8855,5,4,7,3,15,14,1,19
FC Pune City,8855,6,5,4,5,14,15,-1,19
Kerala Blast,8855,7,4,4,6,10,16,-6,16
FC Goa,8855,8,3,3,8,10,20,-10,12
Mumbai City,8856,1,7,4,3,18,9,9,25
Kerala Blast,8856,2,6,4,4,14,15,-1,22
Delhi Dynamo,8856,3,5,5,4,26,17,9,20
NorthEast Un,8856,4,5,4,5,12,11,1,19
FC Pune City,8856,5,5,3,6,15,17,-2,18
FC Goa,8856,6,5,2,7,14,21,-7,17
Kolkata,8856,7,3,6,5,15,18,-3,15
Chennaiyin,8856,8,3,6,5,15,21,-6,15
Mumbai City,8857,1,7,4,3,19,9,10,25
Kolkata,8857,2,5,7,2,17,12,5,22
NorthEast Un,8857,3,5,4,5,13,10,3,19
Delhi Dynamo,8857,4,4,6,4,24,22,2,18
FC Goa,8857,5,5,3,6,14,15,-1,18
FC Pune City,8857,6,4,4,6,13,16,-3,16
Kerala Blast,8857,7,4,4,6,10,20,-10,16
Chennaiyin,8857,8,3,6,5,13,19,-6,15
Mumbai City,8858,1,7,4,3,20,10,10,25
Delhi Dynamo,8858,2,5,5,4,25,20,5,20
NorthEast Un,8858,3,6,2,6,12,11,1,20
Kerala Blast,8858,4,5,4,5,15,17,-2,19
Kolkata,8858,5,3,9,2,15,14,1,18
Chennaiyin,8858,6,4,5,5,15,18,-3,17
FC Pune City,8858,7,4,4,6,14,19,-5,16
FC Goa,8858,8,4,3,7,10,17,-7,15
Mumbai City,8859,1,7,4,3,18,8,10,25
Delhi Dynamo,8859,2,6,5,3,26,16,10,23
NorthEast Un,8859,3,6,2,6,16,10,6,20
FC Pune City,8859,4,5,4,5,14,14,0,19
Kerala Blast,8859,5,5,4,5,11,18,-7,19
Kolkata,8859,6,4,6,4,15,17,-2,18
Chennaiyin,8859,7,3,5,6,14,21,-7,14
FC Goa,8859,8,4,2,8,11,21,-10,14
Mumbai City,8860,1,6,5,3,18,10,8,23
Delhi Dynamo,8860,2,5,6,3,26,18,8,21
Kolkata,8860,3,5,6,3,17,13,4,21
Chennaiyin,8860,4,5,5,4,24,20,4,20
NorthEast Un,8860,5,5,3,6,12,16,-4,18
Kerala Blast,8860,6,4,5,5,10,17,-7,17
FC Pune City,8860,7,4,4,6,12,15,-3,16
FC Goa,8860,8,4,2,8,12,22,-10,14
Delhi Dynamo,8861,1,7,5,2,26,16,10,26
Mumbai City,8861,2,6,4,4,17,10,7,22
Kolkata,8861,3,4,7,3,18,17,1,19
FC Pune City,8861,4,5,4,5,17,18,-1,19
NorthEast Un,8861,5,5,3,6,14,13,1,18
Kerala Blast,8861,6,4,6,4,14,18,-4,18
FC Goa,8861,7,4,2,8,10,16,-6,14
Chennaiyin,8861,8,3,5,6,14,22,-8,14
Delhi Dynamo,8862,1,6,6,2,26,17,9,24
Mumbai City,8862,2,6,5,3,17,9,8,23
Kolkata,8862,3,5,7,2,19,14,5,22
Kerala Blast,8862,4,5,4,5,12,17,-5,19
Chennaiyin,8862,5,3,7,4,13,17,-4,16
FC Pune City,8862,5,4,4,6,13,17,-4,16
NorthEast Un,8862,7,4,3,7,11,13,-2,15
FC Goa,8862,8,3,4,7,11,18,-7,13
Mumbai City,8863,1,7,4,3,18,8,10,25
Delhi Dynamo,8863,2,5,6,3,24,16,8,21
Kerala Blast,8863,3,5,5,4,15,13,2,20
NorthEast Un,8863,4,5,4,5,11,10,1,19
FC Pune City,8863,5,4,5,5,13,15,-2,17
Kolkata,8863,6,3,8,3,16,21,-5,17
Chennaiyin,8863,7,3,6,5,15,20,-5,15
FC Goa,8863,8,3,4,7,11,20,-9,13
Mumbai City,8864,1,7,4,3,18,9,9,25
Kerala Blast,8864,2,6,3,5,14,17,-3,21
Delhi Dynamo,8864,3,5,5,4,24,18,6,20
Kolkata,8864,4,4,8,2,16,14,2,20
Chennaiyin,8864,5,5,5,4,16,17,-1,20
FC Pune City,8864,6,4,4,6,13,16,-3,16
FC Goa,8864,7,4,3,7,11,17,-6,15
NorthEast Un,8864,8,4,2,8,12,16,-4,14
Delhi Dynamo,8865,1,7,5,2,28,16,12,26
Mumbai City,8865,2,6,4,4,17,10,7,22
Kolkata,8865,3,4,8,2,16,13,3,20
FC Pune City,8865,4,5,4,5,16,15,1,19
NorthEast Un,8865,5,4,4,6,12,15,-3,16
Kerala Blast,8865,6,4,4,6,12,21,-9,16
Chennaiyin,8865,7,3,6,5,14,19,-5,15
FC Goa,8865,8,4,3,7,11,17,-6,15
Mumbai City,8866,1,7,4,3,18,8,10,25
Kerala Blast,8866,2,6,4,4,13,14,-1,22
Delhi Dynamo,8866,3,5,6,3,23,17,6,21
Kolkata,8866,4,4,8,2,16,14,2,20
NorthEast Un,8866,5,5,2,7,11,12,-1,17
Chennaiyin,8866,6,3,6,5,15,20,-5,15
FC Pune City,8866,7,4,3,7,13,18,-5,15
FC Goa,8866,8,3,5,6,10,16,-6,14
Mumbai City,8867,1,6,5,3,18,10,8,23
Kerala Blast,8867,2,6,4,4,17,16,1,22
Delhi Dynamo,8867,3,5,6,3,24,19,5,21
Kolkata,8867,4,5,6,3,18,15,3,21
Chennaiyin,8867,5,4,5,5,18,20,-2,17
NorthEast Un,8867,6,5,2,7,12,16,-4,17
FC Pune City,8867,7,4,4,6,14,18,-4,16
FC Goa,8867,8,4,2,8,11,18,-7,14
Mumbai City,8868,1,7,4,3,17,8,9,25
Kolkata,8868,2,5,6,3,16,13,3,21
Kerala Blast,8868,3,5,5,4,12,15,-3,20
NorthEast Un,8868,4,5,4,5,15,13,2,19
Delhi Dynamo,8868,5,4,5,5,22,19,3,17
FC Goa,8868,6,5,2,7,11,17,-6,17
FC Pune City,8868,7,4,4,6,13,16,-3,16
Chennaiyin,8868,8,3,6,5,16,21,-5,15
Mumbai City,8869,1,7,4,3,17,8,9,25
NorthEast Un,8869,2,6,3,5,14,12,2,21
Delhi Dynamo,8869,3,5,5,4,23,17,6,20
Kolkata,8869,4,4,7,3,15,16,-1,19
FC Pune City,8869,5,5,4,5,14,15,-1,19
Kerala Blast,8869,6,4,4,6,12,19,-7,16
FC Goa,8869,7,4,3,7,13,16,-3,15
Chennaiyin,8869,8,3,6,5,14,19,-5,15
Mumbai City,8870,1,7,4,3,18,9,9,25
Delhi Dynamo,8870,2,5,5,4,25,19,6,20
Kolkata,8870,3,4,8,2,17,14,3,20
FC Pune City,8870,4,5,4,5,15,16,-1,19
NorthEast Un,8870,5,5,3,6,15,14,1,18
FC Goa,8870,6,5,2,7,11,17,-6,17
Kerala Blast,8870,7,4,4,6,11,18,-7,16
Chennaiyin,8870,8,3,6,5,16,21,-5,15
Mumbai City,8871,1,7,4,3,22,8,14,25
Delhi Dynamo,8871,2,6,5,3,24,20,4,23
Kolkata,8871,3,5,7,2,16,13,3,22
Kerala Blast,8871,4,6,3,5,14,17,-3,21
NorthEast Un,8871,5,5,2,7,12,13,-1,17
FC Pune City,8871,6,4,4,6,13,16,-3,16
Chennaiyin,8871,7,3,5,6,13,20,-7,14
FC Goa,8871,8,4,2,8,9,16,-7,14
Mumbai City,8872,1,6,5,3,17,9,8,23
Kolkata,8872,2,5,7,2,17,14,3,22
Delhi Dynamo,8872,3,4,8,2,22,15,7,20
Kerala Blast,8872,4,5,5,4,13,16,-3,20
NorthEast Un,8872,5,5,4,5,11,10,1,19
FC Pune City,8872,6,4,3,7,14,18,-4,15
FC Goa,8872,7,4,3,7,9,15,-6,15
Chennaiyin,8872,8,3,5,6,13,19,-6,14
Mumbai City,8873,1,7,4,3,18,8,10,25
Kolkata,8873,2,4,8,2,18,15,3,20
Kerala Blast,8873,3,5,5,4,14,14,0,20
NorthEast Un,8873,4,5,4,5,14,13,1,19
Delhi Dynamo,8873,5,4,5,5,23,20,3,17
FC Goa,8873,6,5,2,7,12,18,-6,17
FC Pune City,8873,7,4,4,6,13,19,-6,16
Chennaiyin,8873,8,3,6,5,16,21,-5,15
Mumbai City,8874,1,6,4,4,16,9,7,22
Kolkata,8874,2,5,7,2,21,15,6,22
Delhi Dynamo,8874,3,5,6,3,23,18,5,21
Kerala Blast,8874,4,5,4,5,14,18,-4,19
NorthEast Un,8874,5,5,3,6,13,11,2,18
Chennaiyin,8874,6,4,5,5,15,19,-4,17
FC Goa,8874,7,4,4,6,12,17,-5,16
FC Pune City,8874,8,4,3,7,14,21,-7,15
Mumbai City,8875,1,7,4,3,17,8,9,25
Kerala Blast,8875,2,6,3,5,13,14,-1,21
Delhi Dynamo,8875,3,5,5,4,24,17,7,20
Kolkata,8875,4,4,7,3,19,16,3,19
NorthEast Un,8875,5,5,3,6,12,12,0,18
Chennaiyin,8875,6,4,6,4,15,18,-3,18
FC Pune City,8875,7,5,3,6,14,19,-5,18
FC Goa,8875,8,3,3,8,9,19,-10,12
Mumbai City,8876,1,6,5,3,17,9,8,23
Delhi Dynamo,8876,2,5,7,2,24,16,8,22
Kolkata,8876,3,5,7,2,19,15,4,22
Kerala Blast,8876,4,5,5,4,13,16,-3,20
NorthEast Un,8876,5,4,4,6,12,13,-1,16
FC Pune City,8876,6,4,4,6,12,15,-3,16
Chennaiyin,8876,7,3,6,5,15,21,-6,15
FC Goa,8876,8,4,2,8,12,19,-7,14
Delhi Dynamo,8877,1,6,5,3,27,17,10,23
Mumbai City,8877,2,6,4,4,16,10,6,22
Kolkata,8877,3,5,6,3,20,16,4,21
FC Pune City,8877,4,6,3,5,15,15,0,21
NorthEast Un,8877,5,5,3,6,12,12,0,18
Kerala Blast,8877,6,5,3,6,11,17,-6,18
Chennaiyin,8877,7,3,7,4,15,19,-4,16
FC Goa,8877,8,3,3,8,11,21,-10,12
Mumbai City,8878,1,7,4,3,17,8,9,25
Delhi Dynamo,8878,2,5,5,4,23,20,3,20
Kerala Blast,8878,3,5,5,4,13,14,-1,20
FC Pune City,8878,4,5,4,5,16,15,1,19
NorthEast Un,8878,5,5,2,7,14,15,-1,17
Chennaiyin,8878,6,4,5,5,16,18,-2,17
FC Goa,8878,7,5,2,7,11,16,-5,17
Kolkata,8878,8,3,7,4,13,17,-4,16
Delhi Dynamo,8879,1,6,6,2,24,15,9,24
Mumbai City,8879,2,6,5,3,16,8,8,23
Kolkata,8879,3,4,8,2,16,14,2,20
Kerala Blast,8879,4,5,5,4,12,14,-2,20
NorthEast Un,8879,5,4,4,6,11,12,-1,16
Chennaiyin,8879,6,3,6,5,16,21,-5,15
FC Pune City,8879,7,4,3,7,12,17,-5,15
FC Goa,8879,8,4,3,7,14,20,-6,15
Mumbai City,8880,1,7,4,3,19,9,10,25
Kolkata,8880,2,5,6,3,22,17,5,21
Chennaiyin,8880,3,5,5,4,19,21,-2,20
Kerala Blast,8880,4,5,4,5,13,16,-3,19
Delhi Dynamo,8880,5,4,6,4,23,19,4,18
NorthEast Un,8880,6,5,3,6,15,15,0,18
FC Goa,8880,7,4,3,7,12,18,-6,15
FC Pune City,8880,8,4,3,7,13,21,-8,15
Mumbai City,8881,1,6,4,4,16,9,7,22
Delhi Dynamo,8881,2,5,6,3,23,16,7,21
Chennaiyin,8881,3,5,5,4,19,17,2,20
Kolkata,8881,4,4,7,3,16,15,1,19
FC Pune City,8881,5,5,4,5,16,16,0,19
NorthEast Un,8881,6,5,3,6,12,11,1,18
Kerala Blast,8881,7,5,3,6,12,19,-7,18
FC Goa,8881,8,4,2,8,9,20,-11,14
Delhi Dynamo,8882,1,6,5,3,25,17,8,23
Mumbai City,8882,2,6,4,4,17,10,7,22
Kerala Blast,8882,3,6,4,4,15,14,1,22
Kolkata,8882,4,4,7,3,16,13,3,19
Chennaiyin,8882,5,4,6,4,16,19,-3,18
NorthEast Un,8882,6,5,2,7,12,15,-3,17
FC Goa,8882,7,4,3,7,11,17,-6,15
FC Pune City,8882,8,4,3,7,12,19,-7,15
Mumbai City,8883,1,7,4,3,19,9,10,25
Kerala Blast,8883,2,5,5,4,12,14,-2,20
Delhi Dynamo,8883,3,4,7,3,28,23,5,19
Kolkata,8883,4,4,7,3,19,19,0,19
Chennaiyin,8883,5,4,6,4,15,18,-3,18
FC Pune City,8883,6,4,4,6,16,19,-3,16
FC Goa,8883,7,4,4,6,13,17,-4,16
NorthEast Un,8883,8,4,3,7,13,16,-3,15
Delhi Dynamo,8884,1,7,5,2,27,15,12,26
Mumbai City,8884,2,6,4,4,16,10,6,22
Kolkata,8884,3,5,6,3,19,16,3,21
FC Pune City,8884,4,5,4,5,17,16,1,19
NorthEast Un,8884,5,5,2,7,12,14,-2,17
Chennaiyin,8884,6,4,5,5,15,18,-3,17
Kerala Blast,8884,7,4,4,6,11,21,-10,16
FC Goa,8884,8,4,2,8,10,17,-7,14
Mumbai City,8885,1,7,4,3,18,8,10,25
Kolkata,8885,2,6,6,2,19,15,4,24
Delhi Dynamo,8885,3,5,6,3,24,18,6,21
Kerala Blast,8885,4,6,3,5,14,14,0,21
NorthEast Un,8885,5,5,2,7,11,14,-3,17
Chennaiyin,8885,6,3,6,5,13,18,-5,15
FC Pune City,8885,6,4,3,7,13,18,-5,15
FC Goa,8885,8,3,4,7,11,18,-7,13
Delhi Dynamo,8886,1,7,5,2,29,16,13,26
Mumbai City,8886,2,6,4,4,18,13,5,22
Chennaiyin,8886,3,5,5,4,16,17,-1,20
Kolkata,8886,4,4,7,3,17,15,2,19
NorthEast Un,8886,5,5,2,7,11,12,-1,17
Kerala Blast,8886,6,4,5,5,10,16,-6,17
FC Pune City,8886,7,4,4,6,13,17,-4,16
FC Goa,8886,8,4,2,8,11,19,-8,14
Mumbai City,8887,1,7,4,3,19,9,10,25
Kerala Blast,8887,2,7,3,4,17,15,2,24
Delhi Dynamo,8887,3,4,6,4,22,20,2,18
NorthEast Un,8887,4,5,3,6,14,13,1,18
Kolkata,8887,5,3,8,3,15,16,-1,17
FC Pune City,8887,6,4,4,6,15,19,-4,16
FC Goa,8887,7,4,4,6,9,14,-5,16
Chennaiyin,8887,8,3,6,5,14,19,-5,15
Delhi Dynamo,8888,1,7,5,2,27,14,13,26
Mumbai City,8888,2,6,4,4,16,10,6,22
Kerala Blast,8888,3,5,5,4,14,17,-3,20
Kolkata,8888,4,3,8,3,16,16,0,17
NorthEast Un,8888,5,5,2,7,11,12,-1,17
FC Pune City,8888,6,4,5,5,14,16,-2,17
Chennaiyin,8888,7,4,5,5,16,20,-4,17
FC Goa,8888,8,4,2,8,11,20,-9,14
Mumbai City,8889,1,6,4,4,16,9,7,22
Delhi Dynamo,8889,2,5,5,4,24,20,4,20
NorthEast Un,8889,3,6,2,6,14,12,2,20
Kolkata,8889,4,4,7,3,15,16,-1,19
Kerala Blast,8889,5,5,4,5,12,16,-4,19
FC Pune City,8889,6,5,3,6,15,16,-1,18
Chennaiyin,8889,7,4,6,4,15,18,-3,18
FC Goa,8889,8,4,3,7,12,16,-4,15
Mumbai City,8890,1,7,4,3,17,8,9,25
Kolkata,8890,2,5,7,2,18,15,3,22
Kerala Blast,8890,3,6,3,5,13,16,-3,21
Delhi Dynamo,8890,4,4,6,4,21,16,5,18
NorthEast Un,8890,5,5,3,6,13,10,3,18
FC Goa,8890,6,5,3,6,13,17,-4,18
FC Pune City,8890,7,4,3,7,13,17,-4,15
Chennaiyin,8890,8,3,5,6,14,23,-9,14
Delhi Dynamo,8891,1,6,6,2,26,16,10,24
Kolkata,8891,2,6,6,2,23,14,9,24
Mumbai City,8891,3,6,5,3,17,9,8,23
Kerala Blast,8891,4,6,3,5,14,16,-2,21
Chennaiyin,8891,5,4,6,4,17,19,-2,18
FC Pune City,8891,6,4,3,7,13,21,-8,15
NorthEast Un,8891,7,4,2,8,11,17,-6,14
FC Goa,8891,8,3,3,8,9,18,-9,12
Mumbai City,8892,1,6,5,3,17,9,8,23
Kolkata,8892,2,5,6,3,18,16,2,21
NorthEast Un,8892,3,6,3,5,13,11,2,21
Delhi Dynamo,8892,4,4,7,3,22,16,6,19
Chennaiyin,8892,5,4,6,4,15,18,-3,18
Kerala Blast,8892,6,5,3,6,14,17,-3,18
FC Pune City,8892,7,4,3,7,13,19,-6,15
FC Goa,8892,8,4,3,7,10,16,-6,15
Mumbai City,8893,1,7,4,3,17,8,9,25
Kolkata,8893,2,5,7,2,18,12,6,22
Delhi Dynamo,8893,3,5,6,3,26,17,9,21
Chennaiyin,8893,4,5,5,4,17,19,-2,20
Kerala Blast,8893,5,5,4,5,12,19,-7,19
FC Pune City,8893,6,5,3,6,17,17,0,18
NorthEast Un,8893,7,4,2,8,12,18,-6,14
FC Goa,8893,8,3,3,8,10,19,-9,12
Mumbai City,8894,1,6,5,3,17,9,8,23
NorthEast Un,8894,2,7,2,5,20,14,6,23
Delhi Dynamo,8894,3,5,6,3,26,22,4,21
Kerala Blast,8894,4,5,4,5,11,15,-4,19
Kolkata,8894,5,4,6,4,15,14,1,18
Chennaiyin,8894,6,4,5,5,20,23,-3,17
FC Pune City,8894,7,4,4,6,12,16,-4,16
FC Goa,8894,8,4,2,8,13,21,-8,14
Mumbai City,8895,1,7,4,3,19,10,9,25
Kerala Blast,8895,2,6,4,4,15,17,-2,22
FC Pune City,8895,3,5,4,5,16,16,0,19
Delhi Dynamo,8895,4,4,6,4,25,21,4,18
Kolkata,8895,5,4,6,4,17,18,-1,18
FC Goa,8895,6,5,2,7,15,18,-3,17
NorthEast Un,8895,7,4,4,6,11,12,-1,16
Chennaiyin,8895,8,3,6,5,13,19,-6,15
Mumbai City,8896,1,7,4,3,19,9,10,25
Kerala Blast,8896,2,5,5,4,12,13,-1,20
NorthEast Un,8896,3,5,4,5,10,9,1,19
Delhi Dynamo,8896,4,4,6,4,23,19,4,18
Kolkata,8896,5,3,9,2,16,15,1,18
Chennaiyin,8896,6,4,6,4,14,17,-3,18
FC Pune City,8896,7,4,4,6,13,18,-5,16
FC Goa,8896,8,3,4,7,11,18,-7,13
Delhi Dynamo,8897,1,7,5,2,28,15,13,26
Mumbai City,8897,2,6,4,4,16,11,5,22
Kolkata,8897,3,5,7,2,19,15,4,22
NorthEast Un,8897,4,5,3,6,11,10,1,18
Kerala Blast,8897,5,5,3,6,13,19,-6,18
Chennaiyin,8897,6,3,7,4,14,18,-4,16
FC Pune City,8897,6,4,4,6,14,18,-4,16
FC Goa,8897,8,3,3,8,11,20,-9,12
Mumbai City,8898,1,7,4,3,18,8,10,25
Delhi Dynamo,8898,2,6,5,3,27,18,9,23
NorthEast Un,8898,3,6,2,6,15,14,1,20
FC Pune City,8898,4,5,4,5,15,15,0,19
Kerala Blast,8898,5,5,4,5,11,16,-5,19
Kolkata,8898,6,4,6,4,16,17,-1,18
Chennaiyin,8898,7,3,5,6,13,20,-7,14
FC Goa,8898,8,4,2,8,11,18,-7,14
Mumbai City,8899,1,7,4,3,21,9,12,25
Delhi Dynamo,8899,2,5,5,4,25,21,4,20
Kerala Blast,8899,3,5,5,4,12,15,-3,20
NorthEast Un,8899,4,5,3,6,12,12,0,18
Kolkata,8899,5,4,6,4,15,16,-1,18
Chennaiyin,8899,6,4,5,5,16,19,-3,17
FC Goa,8899,7,5,2,7,13,18,-5,17
FC Pune City,8899,8,4,4,6,13,17,-4,16
Mumbai City,8900,1,7,4,3,20,9,11,25
Delhi Dynamo,8900,2,5,5,4,23,19,4,20
Kerala Blast,8900,3,5,5,4,13,16,-3,20
Kolkata,8900,4,4,7,3,16,16,0,19
NorthEast Un,8900,5,5,3,6,12,11,1,18
FC Goa,8900,6,5,3,6,12,15,-3,18
FC Pune City,8900,7,4,3,7,16,20,-4,15
Chennaiyin,8900,8,3,6,5,14,20,-6,15
Mumbai City,8901,1,7,4,3,18,8,10,25
FC Pune City,8901,2,6,3,5,15,14,1,21
Chennaiyin,8901,3,5,5,4,19,17,2,20
Kerala Blast,8901,4,5,4,5,11,15,-4,19
Delhi Dynamo,8901,5,4,6,4,22,18,4,18
Kolkata,8901,6,3,8,3,14,15,-1,17
NorthEast Un,8901,7,5,2,7,12,15,-3,17
FC Goa,8901,8,3,4,7,9,18,-9,13
Delhi Dynamo,8902,1,6,6,2,25,15,10,24
Kerala Blast,8902,2,7,3,4,17,15,2,24
Mumbai City,8902,3,6,5,3,17,9,8,23
Kolkata,8902,4,4,6,4,18,20,-2,18
FC Goa,8902,5,5,2,7,14,19,-5,17
NorthEast Un,8902,6,4,3,7,10,12,-2,15
Chennaiyin,8902,7,3,6,5,15,20,-5,15
FC Pune City,8902,8,4,3,7,14,20,-6,15
Mumbai City,8903,1,6,5,3,16,8,8,23
Delhi Dynamo,8903,2,5,7,2,26,16,10,22
Kerala Blast,8903,3,6,3,5,14,17,-3,21
FC Pune City,8903,4,5,3,6,15,17,-2,18
NorthEast Un,8903,5,5,3,6,12,14,-2,18
FC Goa,8903,6,5,3,6,14,17,-3,18
Kolkata,8903,7,3,6,5,15,17,-2,15
Chennaiyin,8903,8,3,6,5,15,21,-6,15
Delhi Dynamo,8904,1,6,6,2,27,16,11,24
Mumbai City,8904,2,6,4,4,16,11,5,22
Kerala Blast,8904,3,5,5,4,14,17,-3,20
NorthEast Un,8904,4,5,4,5,13,12,1,19
Kolkata,8904,5,3,9,2,18,17,1,18
FC Pune City,8904,6,4,4,6,15,18,-3,16
FC Goa,8904,7,4,3,7,10,16,-6,15
Chennaiyin,8904,8,3,5,6,13,19,-6,14
Mumbai City,8905,1,7,4,3,19,9,10,25
Delhi Dynamo,8905,2,5,6,3,25,18,7,21
NorthEast Un,8905,3,6,3,5,12,10,2,21
Kolkata,8905,4,4,7,3,18,16,2,19
Kerala Blast,8905,5,5,3,6,12,19,-7,18
FC Goa,8905,6,5,2,7,13,16,-3,17
FC Pune City,8905,7,4,4,6,14,18,-4,16
Chennaiyin,8905,8,3,5,6,13,20,-7,14
Mumbai City,8906,1,6,4,4,17,11,6,22
Kerala Blast,8906,2,6,3,5,17,17,0,21
Delhi Dynamo,8906,3,5,5,4,25,18,7,20
Kolkata,8906,4,4,8,2,18,14,4,20
NorthEast Un,8906,5,5,3,6,13,14,-1,18
Chennaiyin,8906,6,3,7,4,15,19,-4,16
FC Goa,8906,7,4,4,6,10,15,-5,16
FC Pune City,8906,8,4,4,6,14,21,-7,16
Mumbai City,8907,1,7,4,3,21,8,13,25
NorthEast Un,8907,2,6,3,5,13,11,2,21
Delhi Dynamo,8907,3,5,5,4,24,21,3,20
Kolkata,8907,4,4,7,3,16,14,2,19
FC Pune City,8907,5,5,4,5,15,14,1,19
Kerala Blast,8907,6,5,4,5,12,18,-6,19
Chennaiyin,8907,7,3,5,6,14,20,-6,14
FC Goa,8907,8,4,2,8,10,19,-9,14
Delhi Dynamo,8908,1,7,5,2,29,15,14,26
Mumbai City,8908,2,6,4,4,17,11,6,22
Kolkata,8908,3,5,7,2,16,13,3,22
Kerala Blast,8908,4,6,3,5,11,14,-3,21
Chennaiyin,8908,5,4,6,4,17,19,-2,18
FC Pune City,8908,6,4,3,7,12,16,-4,15
NorthEast Un,8908,7,4,3,7,11,16,-5,15
FC Goa,8908,8,3,3,8,9,18,-9,12
Delhi Dynamo,8909,1,6,5,3,24,17,7,23
Mumbai City,8909,2,6,4,4,17,10,7,22
NorthEast Un,8909,3,6,3,5,13,10,3,21
Kolkata,8909,4,4,7,3,18,15,3,19
Kerala Blast,8909,5,4,6,4,13,17,-4,18
Chennaiyin,8909,6,4,5,5,15,18,-3,17
FC Pune City,8909,7,4,4,6,14,19,-5,16
FC Goa,8909,8,4,2,8,10,18,-8,14
Mumbai City,8910,1,6,5,3,17,9,8,23
Delhi Dynamo,8910,2,5,6,3,26,19,7,21
NorthEast Un,8910,3,6,3,5,15,13,2,21
FC Pune City,8910,4,5,4,5,14,15,-1,19
Kolkata,8910,5,4,6,4,21,15,6,18
Chennaiyin,8910,6,4,6,4,17,19,-2,18
Kerala Blast,8910,7,4,4,6,11,23,-12,16
FC Goa,8910,8,4,2,8,12,20,-8,14
Mumbai City,8911,1,7,4,3,19,9,10,25
FC Goa,8911,2,6,2,6,16,18,-2,20
Kerala Blast,8911,3,5,5,4,12,14,-2,20
Delhi Dynamo,8911,4,4,6,4,23,19,4,18
FC Pune City,8911,5,5,3,6,13,16,-3,18
Chennaiyin,8911,6,4,5,5,16,21,-5,17
Kolkata,8911,7,3,7,4,16,17,-1,16
NorthEast Un,8911,8,4,4,6,10,11,-1,16
Mumbai City,8912,1,7,4,3,18,9,9,25
Kerala Blast,8912,2,5,5,4,13,16,-3,20
Delhi Dynamo,8912,3,4,7,3,25,19,6,19
FC Pune City,8912,4,5,4,5,14,14,0,19
Chennaiyin,8912,5,4,6,4,16,19,-3,18
Kolkata,8912,6,3,8,3,16,17,-1,17
NorthEast Un,8912,7,4,4,6,13,14,-1,16
FC Goa,8912,8,3,4,7,11,18,-7,13
Delhi Dynamo,8913,1,6,5,3,28,21,7,23
Mumbai City,8913,2,6,4,4,19,12,7,22
Kolkata,8913,3,4,8,2,16,14,2,20
NorthEast Un,8913,4,6,2,6,14,12,2,20
FC Pune City,8913,5,4,5,5,13,15,-2,17
Chennaiyin,8913,6,4,5,5,14,18,-4,17
Kerala Blast,8913,7,4,5,5,10,15,-5,17
FC Goa,8913,8,4,2,8,9,16,-7,14
Mumbai City,8914,1,7,4,3,19,8,11,25
Kolkata,8914,2,5,6,3,19,16,3,21
Delhi Dynamo,8914,3,5,5,4,24,20,4,20
Chennaiyin,8914,4,5,5,4,16,18,-2,20
NorthEast Un,8914,5,5,2,7,13,15,-2,17
FC Goa,8914,6,5,2,7,11,15,-4,17
FC Pune City,8914,7,4,4,6,15,19,-4,16
Kerala Blast,8914,8,4,4,6,12,18,-6,16
Mumbai City,8915,1,7,4,3,19,8,11,25
Kolkata,8915,2,5,7,2,17,14,3,22
Kerala Blast,8915,3,6,4,4,16,17,-1,22
Delhi Dynamo,8915,4,5,6,3,24,18,6,21
Chennaiyin,8915,5,4,6,4,18,19,-1,18
FC Pune City,8915,6,4,3,7,13,17,-4,15
NorthEast Un,8915,7,4,3,7,11,16,-5,15
FC Goa,8915,8,3,3,8,10,19,-9,12
Mumbai City,8916,1,6,5,3,17,9,8,23
Kerala Blast,8916,2,6,4,4,14,16,-2,22
Delhi Dynamo,8916,3,4,7,3,25,19,6,19
Kolkata,8916,4,4,7,3,15,16,-1,19
NorthEast Un,8916,5,5,3,6,12,12,0,18
Chennaiyin,8916,6,4,5,5,15,18,-3,17
FC Goa,8916,7,5,2,7,14,18,-4,17
FC Pune City,8916,8,4,3,7,13,17,-4,15
Mumbai City,8917,1,7,4,3,17,8,9,25
Kerala Blast,8917,2,7,3,4,16,13,3,24
Delhi Dynamo,8917,3,5,6,3,24,16,8,21
Kolkata,8917,4,4,7,3,17,14,3,19
Chennaiyin,8917,5,4,6,4,17,18,-1,18
FC Pune City,8917,6,4,3,7,12,19,-7,15
FC Goa,8917,7,3,5,6,11,17,-6,14
NorthEast Un,8917,8,4,2,8,9,18,-9,14
Mumbai City,8918,1,7,4,3,18,9,9,25
Kolkata,8918,2,5,6,3,18,14,4,21
NorthEast Un,8918,3,6,3,5,13,11,2,21
Delhi Dynamo,8918,4,5,5,4,26,20,6,20
Kerala Blast,8918,5,5,4,5,12,16,-4,19
Chennaiyin,8918,6,3,6,5,15,20,-5,15
FC Pune City,8918,7,4,3,7,14,20,-6,15
FC Goa,8918,8,4,3,7,12,18,-6,15
Delhi Dynamo,8919,1,6,6,2,31,18,13,24
Mumbai City,8919,2,6,4,4,18,12,6,22
Kolkata,8919,3,5,7,2,17,14,3,22
NorthEast Un,8919,4,5,4,5,11,10,1,19
FC Pune City,8919,5,5,3,6,15,17,-2,18
Chennaiyin,8919,6,3,7,4,13,17,-4,16
Kerala Blast,8919,7,4,3,7,10,17,-7,15
FC Goa,8919,8,3,4,7,10,20,-10,13
Mumbai City,8920,1,6,4,4,17,10,7,22
FC Pune City,8920,2,6,3,5,16,16,0,21
Delhi Dynamo,8920,3,5,5,4,24,20,4,20
NorthEast Un,8920,4,6,2,6,14,10,4,20
FC Goa,8920,5,6,2,6,13,15,-2,20
Kerala Blast,8920,6,5,3,6,12,18,-6,18
Chennaiyin,8920,7,4,5,5,14,18,-4,17
Kolkata,8920,8,3,6,5,14,17,-3,15
Mumbai City,8921,1,6,5,3,16,8,8,23
Delhi Dynamo,8921,2,5,7,2,23,15,8,22
Kolkata,8921,3,5,7,2,20,16,4,22
NorthEast Un,8921,4,6,2,6,14,11,3,20
Kerala Blast,8921,5,5,4,5,13,18,-5,19
Chennaiyin,8921,6,4,5,5,15,20,-5,17
FC Pune City,8921,7,4,3,7,16,20,-4,15
FC Goa,8921,8,3,3,8,10,19,-9,12
Mumbai City,8922,1,7,4,3,17,8,9,25
Delhi Dynamo,8922,2,5,5,4,25,16,9,20
FC Pune City,8922,3,5,4,5,15,15,0,19
Kolkata,8922,3,4,7,3,15,15,0,19
Kerala Blast,8922,5,5,4,5,12,15,-3,19
NorthEast Un,8922,6,5,3,6,11,12,-1,18
Chennaiyin,8922,7,4,6,4,16,19,-3,18
FC Goa,8922,8,3,3,8,10,21,-11,12
Kolkata,8923,1,6,6,2,18,13,5,24
Mumbai City,8923,2,6,5,3,18,10,8,23
Delhi Dynamo,8923,3,5,6,3,27,20,7,21
Chennaiyin,8923,4,5,5,4,16,18,-2,20
NorthEast Un,8923,5,5,3,6,14,13,1,18
Kerala Blast,8923,6,4,5,5,11,16,-5,17
FC Pune City,8923,7,4,4,6,12,16,-4,16
FC Goa,8923,8,3,2,9,9,19,-10,11
Mumbai City,8924,1,7,4,3,20,8,12,25
Delhi Dynamo,8924,2,5,6,3,23,19,4,21
FC Pune City,8924,3,5,4,5,16,16,0,19
Kolkata,8924,3,4,7,3,16,16,0,19
Chennaiyin,8924,5,4,6,4,16,19,-3,18
Kerala Blast,8924,6,4,6,4,12,16,-4,18
NorthEast Un,8924,7,4,4,6,11,12,-1,16
FC Goa,8924,8,3,3,8,10,18,-8,12
Mumbai City,8925,1,7,4,3,18,9,9,25
Delhi Dynamo,8925,2,5,6,3,25,17,8,21
Kolkata,8925,3,4,7,3,16,15,1,19
NorthEast Un,8925,4,5,3,6,11,11,0,18
Chennaiyin,8925,5,4,5,5,14,19,-5,17
FC Goa,8925,5,5,2,7,14,19,-5,17
Kerala Blast,8925,7,4,5,5,12,17,-5,17
FC Pune City,8925,8,4,4,6,14,17,-3,16
Mumbai City,8926,1,6,4,4,17,10,7,22
Delhi Dynamo,8926,2,5,5,4,23,18,5,20
FC Goa,8926,3,6,2,6,17,15,2,20
NorthEast Un,8926,4,6,2,6,13,11,2,20
FC Pune City,8926,5,5,4,5,14,15,-1,19
Kolkata,8926,6,4,6,4,15,17,-2,18
Chennaiyin,8926,7,4,5,5,16,23,-7,17
Kerala Blast,8926,8,4,4,6,9,15,-6,16
Mumbai City,8927,1,7,4,3,18,8,10,25
FC Pune City,8927,2,6,3,5,14,14,0,21
Kerala Blast,8927,3,6,3,5,13,14,-1,21
Delhi Dynamo,8927,4,5,5,4,25,19,6,20
FC Goa,8927,5,5,3,6,12,16,-4,18
NorthEast Un,8927,6,5,2,7,12,14,-2,17
Kolkata,8927,7,3,7,4,14,17,-3,16
Chennaiyin,8927,8,3,5,6,14,20,-6,14
Kerala Blast,8928,1,7,3,4,13,14,-1,24
Mumbai City,8928,2,6,5,3,17,9,8,23
Delhi Dynamo,8928,3,5,6,3,25,17,8,21
Kolkata,8928,4,4,7,3,17,16,1,19
NorthEast Un,8928,5,5,2,7,12,14,-2,17
Chennaiyin,8928,6,4,5,5,15,18,-3,17
FC Pune City,8928,7,4,3,7,14,18,-4,15
FC Goa,8928,8,4,3,7,10,17,-7,15
Delhi Dynamo,8929,1,7,5,2,27,14,13,26
Mumbai City,8929,2,6,4,4,16,10,6,22
FC Pune City,8929,3,5,4,5,15,15,0,19
NorthEast Un,8929,4,5,3,6,12,14,-2,18
Kolkata,8929,5,4,6,4,15,19,-4,18
Kerala Blast,8929,6,4,5,5,10,15,-5,17
FC Goa,8929,7,4,3,7,14,17,-3,15
Chennaiyin,8929,8,3,6,5,16,21,-5,15
Mumbai City,8930,1,6,5,3,16,8,8,23
Delhi Dynamo,8930,2,5,6,3,25,17,8,21
Kolkata,8930,3,5,6,3,18,15,3,21
NorthEast Un,8930,4,6,3,5,17,15,2,21
FC Pune City,8930,5,5,3,6,15,16,-1,18
Kerala Blast,8930,6,5,3,6,12,19,-7,18
Chennaiyin,8930,7,3,7,4,16,20,-4,16
FC Goa,8930,8,3,3,8,9,18,-9,12
Delhi Dynamo,8931,1,6,6,2,28,18,10,24
Mumbai City,8931,2,6,5,3,18,10,8,23
Kolkata,8931,3,5,7,2,20,15,5,22
FC Pune City,8931,4,5,3,6,16,16,0,18
Kerala Blast,8931,5,4,5,5,11,18,-7,17
NorthEast Un,8931,6,4,4,6,10,12,-2,16
Chennaiyin,8931,7,3,6,5,14,20,-6,15
FC Goa,8931,8,4,2,8,14,22,-8,14
Mumbai City,8932,1,6,4,4,18,11,7,22
Delhi Dynamo,8932,2,5,6,3,25,19,6,21
NorthEast Un,8932,3,6,3,5,14,10,4,21
Kolkata,8932,4,4,8,2,19,16,3,20
Kerala Blast,8932,5,4,5,5,11,17,-6,17
FC Goa,8932,6,4,4,6,14,16,-2,16
FC Pune City,8932,7,4,4,6,14,18,-4,16
Chennaiyin,8932,8,3,6,5,13,21,-8,15
Mumbai City,8933,1,7,4,3,20,9,11,25
Kolkata,8933,2,5,7,2,18,15,3,22
Kerala Blast,8933,3,5,4,5,12,15,-3,19
Delhi Dynamo,8933,4,4,6,4,24,22,2,18
Chennaiyin,8933,5,4,6,4,16,18,-2,18
FC Pune City,8933,6,4,4,6,13,16,-3,16
FC Goa,8933,7,4,4,6,13,17,-4,16
NorthEast Un,8933,8,4,3,7,10,14,-4,15
Mumbai City,8934,1,7,4,3,19,9,10,25
Delhi Dynamo,8934,2,5,5,4,23,18,5,20
Kolkata,8934,3,4,8,2,16,14,2,20
NorthEast Un,8934,4,6,2,6,13,11,2,20
Kerala Blast,8934,5,5,4,5,10,14,-4,19
Chennaiyin,8934,6,4,5,5,16,21,-5,17
FC Pune City,8934,7,4,4,6,14,17,-3,16
FC Goa,8934,8,4,2,8,10,17,-7,14
Mumbai City,8935,1,7,4,3,18,9,9,25
Delhi Dynamo,8935,2,6,5,3,27,19,8,23
Kolkata,8935,3,5,6,3,17,15,2,21
NorthEast Un,8935,4,6,2,6,15,13,2,20
FC Pune City,8935,5,5,3,6,13,16,-3,18
Chennaiyin,8935,6,4,5,5,19,20,-1,17
Kerala Blast,8935,7,4,3,7,10,17,-7,15
FC Goa,8935,8,4,2,8,11,21,-10,14
Delhi Dynamo,8936,1,6,6,2,27,16,11,24
Mumbai City,8936,2,6,4,4,16,10,6,22
Kerala Blast,8936,3,6,4,4,11,13,-2,22
Chennaiyin,8936,4,4,6,4,15,18,-3,18
Kolkata,8936,5,3,7,4,15,16,-1,16
FC Pune City,8936,6,4,4,6,14,17,-3,16
FC Goa,8936,7,4,4,6,11,16,-5,16
NorthEast Un,8936,8,4,3,7,10,13,-3,15
Mumbai City,8937,1,7,4,3,18,8,10,25
Delhi Dynamo,8937,2,4,7,3,24,19,5,19
NorthEast Un,8937,3,5,4,5,16,14,2,19
Kolkata,8937,4,4,7,3,15,16,-1,19
FC Pune City,8937,5,5,3,6,18,18,0,18
Chennaiyin,8937,6,4,6,4,18,21,-3,18
Kerala Blast,8937,7,5,3,6,13,19,-6,18
FC Goa,8937,8,3,4,7,11,18,-7,13
Mumbai City,8938,1,7,4,3,20,8,12,25
Kolkata,8938,2,5,7,2,19,13,6,22
Chennaiyin,8938,3,5,5,4,16,17,-1,20
Kerala Blast,8938,4,5,4,5,12,17,-5,19
Delhi Dynamo,8938,5,4,6,4,24,23,1,18
NorthEast Un,8938,6,5,3,6,14,13,1,18
FC Pune City,8938,7,4,3,7,13,19,-6,15
FC Goa,8938,8,3,4,7,10,18,-8,13
Mumbai City,8939,1,6,5,3,16,8,8,23
Kolkata,8939,2,5,7,2,18,14,4,22
Delhi Dynamo,8939,3,5,6,3,26,19,7,21
NorthEast Un,8939,4,5,3,6,14,11,3,18
Chennaiyin,8939,5,4,6,4,14,17,-3,18
FC Pune City,8939,6,4,5,5,13,15,-2,17
Kerala Blast,8939,7,4,5,5,10,15,-5,17
FC Goa,8939,8,3,3,8,10,22,-12,12
Mumbai City,8940,1,7,4,3,19,10,9,25
Kolkata,8940,2,5,7,2,15,12,3,22
Delhi Dynamo,8940,3,5,5,4,26,18,8,20
Chennaiyin,8940,4,5,5,4,18,18,0,20
Kerala Blast,8940,5,5,4,5,10,15,-5,19
FC Pune City,8940,6,5,3,6,14,15,-1,18
NorthEast Un,8940,7,5,2,7,10,13,-3,17
FC Goa,8940,8,3,2,9,9,20,-11,11
Mumbai City,8941,1,7,4,3,18,8,10,25
Kolkata,8941,2,5,7,2,21,15,6,22
Delhi Dynamo,8941,3,5,5,4,26,19,7,20
NorthEast Un,8941,4,6,2,6,13,13,0,20
Chennaiyin,8941,5,5,5,4,18,19,-1,20
FC Pune City,8941,6,4,4,6,13,18,-5,16
Kerala Blast,8941,7,4,4,6,10,17,-7,16
FC Goa,8941,8,3,3,8,13,23,-10,12
Mumbai City,8942,1,7,4,3,19,9,10,25
Kolkata,8942,2,5,7,2,16,13,3,22
Kerala Blast,8942,3,6,4,4,13,13,0,22
Chennaiyin,8942,4,5,5,4,17,19,-2,20
Delhi Dynamo,8942,5,4,7,3,26,21,5,19
NorthEast Un,8942,6,4,3,7,12,14,-2,15
FC Pune City,8942,7,4,3,7,12,18,-6,15
FC Goa,8942,8,3,3,8,12,20,-8,12
Mumbai City,8943,1,7,4,3,18,8,10,25
NorthEast Un,8943,2,7,2,5,19,12,7,23
Kolkata,8943,3,5,7,2,15,12,3,22
FC Pune City,8943,4,5,3,6,15,16,-1,18
Delhi Dynamo,8943,5,4,5,5,23,21,2,17
Chennaiyin,8943,6,4,5,5,14,18,-4,17
FC Goa,8943,7,4,3,7,9,15,-6,15
Kerala Blast,8943,8,4,3,7,11,22,-11,15
Mumbai City,8944,1,6,4,4,18,11,7,22
Delhi Dynamo,8944,2,5,6,3,25,19,6,21
FC Pune City,8944,3,6,3,5,15,15,0,21
Kolkata,8944,4,4,6,4,18,18,0,18
FC Goa,8944,5,5,3,6,13,15,-2,18
Kerala Blast,8944,6,5,3,6,13,18,-5,18
NorthEast Un,8944,7,5,2,7,13,13,0,17
Chennaiyin,8944,8,4,5,5,14,20,-6,17
Mumbai City,8945,1,6,5,3,17,9,8,23
Delhi Dynamo,8945,2,5,7,2,26,17,9,22
Kolkata,8945,3,4,7,3,17,16,1,19
FC Pune City,8945,4,5,4,5,13,14,-1,19
NorthEast Un,8945,5,5,3,6,12,13,-1,18
Chennaiyin,8945,6,4,5,5,15,18,-3,17
Kerala Blast,8945,7,4,4,6,11,17,-6,16
FC Goa,8945,8,4,3,7,12,19,-7,15
Mumbai City,8946,1,7,4,3,22,11,11,25
Delhi Dynamo,8946,2,5,6,3,28,23,5,21
Kolkata,8946,3,5,6,3,21,16,5,21
FC Pune City,8946,4,5,3,6,16,17,-1,18
Kerala Blast,8946,5,5,3,6,13,19,-6,18
NorthEast Un,8946,6,5,2,7,12,14,-2,17
Chennaiyin,8946,7,4,5,5,17,20,-3,17
FC Goa,8946,8,4,3,7,13,22,-9,15
Mumbai City,8947,1,7,4,3,19,8,11,25
Delhi Dynamo,8947,2,5,5,4,23,20,3,20
Kolkata,8947,3,4,8,2,16,14,2,20
FC Pune City,8947,4,5,4,5,16,17,-1,19
Chennaiyin,8947,5,4,6,4,18,21,-3,18
Kerala Blast,8947,6,5,3,6,15,20,-5,18
NorthEast Un,8947,7,5,2,7,15,14,1,17
FC Goa,8947,8,3,4,7,9,17,-8,13
Mumbai City,8948,1,6,5,3,17,9,8,23
Delhi Dynamo,8948,2,5,6,3,25,18,7,21
Chennaiyin,8948,3,5,5,4,17,18,-1,20
Kerala Blast,8948,4,5,4,5,12,16,-4,19
Kolkata,8948,5,4,6,4,15,16,-1,18
FC Pune City,8948,6,5,3,6,14,17,-3,18
FC Goa,8948,7,5,2,7,14,17,-3,17
NorthEast Un,8948,8,4,3,7,11,14,-3,15
Mumbai City,8949,1,6,5,3,17,9,8,23
Delhi Dynamo,8949,2,4,7,3,23,18,5,19
NorthEast Un,8949,3,5,4,5,13,11,2,19
Chennaiyin,8949,4,4,6,4,15,18,-3,18
Kerala Blast,8949,5,4,6,4,10,14,-4,18
Kolkata,8949,6,3,8,3,14,14,0,17
FC Pune City,8949,7,4,5,5,14,16,-2,17
FC Goa,8949,8,4,3,7,9,15,-6,15
Mumbai City,8950,1,7,4,3,17,8,9,25
Kolkata,8950,2,5,7,2,16,13,3,22
Delhi Dynamo,8950,3,5,5,4,24,20,4,20
NorthEast Un,8950,4,6,2,6,15,11,4,20
Kerala Blast,8950,5,5,5,4,13,16,-3,20
FC Pune City,8950,6,4,4,6,13,16,-3,16
Chennaiyin,8950,7,3,6,5,15,21,-6,15
FC Goa,8950,8,3,3,8,12,20,-8,12
Kerala Blast,8951,1,7,3,4,18,15,3,24
Mumbai City,8951,2,6,5,3,18,10,8,23
Delhi Dynamo,8951,3,4,7,3,23,17,6,19
Kolkata,8951,4,4,6,4,17,19,-2,18
Chennaiyin,8951,5,4,6,4,14,17,-3,18
NorthEast Un,8951,6,5,3,6,10,13,-3,18
FC Pune City,8951,7,4,3,7,13,17,-4,15
FC Goa,8951,8,4,3,7,10,15,-5,15
Delhi Dynamo,8952,1,6,5,3,25,18,7,23
Mumbai City,8952,2,6,4,4,17,10,7,22
Kerala Blast,8952,3,6,4,4,13,14,-1,22
NorthEast Un,8952,4,5,4,5,11,9,2,19
Kolkata,8952,5,4,7,3,14,14,0,19
Chennaiyin,8952,6,3,7,4,14,18,-4,16
FC Pune City,8952,7,4,3,7,13,17,-4,15
FC Goa,8952,8,3,4,7,10,17,-7,13
Delhi Dynamo,8953,1,6,5,3,29,17,12,23
NorthEast Un,8953,2,7,2,5,15,10,5,23
Mumbai City,8953,3,6,4,4,17,12,5,22
FC Pune City,8953,4,5,4,5,15,16,-1,19
Kerala Blast,8953,5,5,3,6,10,15,-5,18
Kolkata,8953,6,3,7,4,15,17,-2,16
Chennaiyin,8953,7,3,6,5,15,21,-6,15
FC Goa,8953,8,4,3,7,11,19,-8,15
Mumbai City,8954,1,7,4,3,18,9,9,25
Delhi Dynamo,8954,2,6,5,3,27,19,8,23
Kerala Blast,8954,3,6,4,4,13,15,-2,22
NorthEast Un,8954,4,5,3,6,12,11,1,18
FC Pune City,8954,5,5,3,6,14,16,-2,18
Kolkata,8954,6,3,7,4,13,14,-1,16
Chennaiyin,8954,7,3,6,5,14,20,-6,15
FC Goa,8954,8,3,4,7,12,19,-7,13
Mumbai City,8955,1,6,5,3,16,8,8,23
Kolkata,8955,2,5,7,2,17,14,3,22
Delhi Dynamo,8955,3,4,7,3,23,17,6,19
Kerala Blast,8955,4,5,4,5,12,16,-4,19
NorthEast Un,8955,5,5,3,6,13,13,0,18
FC Pune City,8955,6,4,4,6,13,16,-3,16
FC Goa,8955,7,4,4,6,11,16,-5,16
Chennaiyin,8955,8,3,6,5,13,18,-5,15
Delhi Dynamo,8956,1,6,6,2,29,18,11,24
Mumbai City,8956,2,6,4,4,16,9,7,22
Kolkata,8956,3,5,7,2,16,13,3,22
Kerala Blast,8956,4,5,4,5,13,16,-3,19
NorthEast Un,8956,5,4,5,5,14,14,0,17
FC Pune City,8956,6,4,3,7,12,17,-5,15
Chennaiyin,8956,7,3,6,5,15,21,-6,15
FC Goa,8956,8,4,3,7,14,21,-7,15
Delhi Dynamo,8957,1,6,6,2,25,16,9,24
Mumbai City,8957,2,6,4,4,16,9,7,22
Kerala Blast,8957,3,6,4,4,15,17,-2,22
Kolkata,8957,4,4,6,4,19,17,2,18
FC Goa,8957,5,5,3,6,15,17,-2,18
Chennaiyin,8957,6,4,5,5,15,20,-5,17
FC Pune City,8957,7,4,4,6,14,20,-6,16
NorthEast Un,8957,8,4,2,8,11,14,-3,14
Mumbai City,8958,1,7,4,3,18,8,10,25
Kolkata,8958,2,5,6,3,18,17,1,21
Kerala Blast,8958,3,5,5,4,15,15,0,20
NorthEast Un,8958,4,5,3,6,15,14,1,18
Chennaiyin,8958,5,4,6,4,17,19,-2,18
Delhi Dynamo,8958,6,4,5,5,21,20,1,17
FC Pune City,8958,7,4,4,6,13,17,-4,16
FC Goa,8958,8,4,3,7,10,17,-7,15
Mumbai City,8959,1,7,4,3,19,9,10,25
Kerala Blast,8959,2,6,4,4,14,15,-1,22
Delhi Dynamo,8959,3,5,6,3,25,18,7,21
Kolkata,8959,4,4,6,4,18,16,2,18
Chennaiyin,8959,5,3,7,4,16,20,-4,16
FC Goa,8959,6,4,4,6,13,18,-5,16
FC Pune City,8959,6,4,4,6,13,18,-5,16
NorthEast Un,8959,8,4,3,7,10,14,-4,15
Mumbai City,8960,1,6,5,3,17,9,8,23
Delhi Dynamo,8960,2,5,7,2,25,17,8,22
Kolkata,8960,3,5,6,3,18,16,2,21
Kerala Blast,8960,4,5,4,5,16,21,-5,19
FC Pune City,8960,5,5,3,6,16,17,-1,18
NorthEast Un,8960,6,4,5,5,14,14,0,17
Chennaiyin,8960,7,3,6,5,16,21,-5,15
FC Goa,8960,8,4,2,8,11,18,-7,14
Delhi Dynamo,8961,1,6,6,2,29,19,10,24
Mumbai City,8961,2,6,5,3,17,9,8,23
Kolkata,8961,3,5,7,2,19,13,6,22
Kerala Blast,8961,4,5,4,5,12,17,-5,19
Chennaiyin,8961,5,4,5,5,15,19,-4,17
FC Pune City,8961,6,4,4,6,13,16,-3,16
FC Goa,8961,7,4,3,7,10,17,-7,15
NorthEast Un,8961,8,4,2,8,13,18,-5,14
Mumbai City,8962,1,7,4,3,18,9,9,25
Delhi Dynamo,8962,2,5,6,3,24,17,7,21
Kolkata,8962,3,4,8,2,20,16,4,20
NorthEast Un,8962,4,5,4,5,11,10,1,19
Kerala Blast,8962,5,5,4,5,11,17,-6,19
FC Pune City,8962,6,4,4,6,15,18,-3,16
FC Goa,8962,7,4,3,7,14,17,-3,15
Chennaiyin,8962,8,3,5,6,13,22,-9,14
Delhi Dynamo,8963,1,6,6,2,26,15,11,24
Mumbai City,8963,2,6,5,3,17,9,8,23
Kolkata,8963,3,5,6,3,17,16,1,21
NorthEast Un,8963,4,6,2,6,13,12,1,20
FC Pune City,8963,5,5,3,6,15,18,-3,18
Kerala Blast,8963,6,5,3,6,13,17,-4,18
Chennaiyin,8963,7,4,5,5,15,19,-4,17
FC Goa,8963,8,3,2,9,8,18,-10,11
Delhi Dynamo,8964,1,7,5,2,25,14,11,26
Mumbai City,8964,2,6,4,4,16,9,7,22
Chennaiyin,8964,3,5,5,4,18,18,0,20
Kerala Blast,8964,4,5,4,5,12,16,-4,19
FC Pune City,8964,5,5,3,6,16,18,-2,18
NorthEast Un,8964,6,5,2,7,10,14,-4,17
Kolkata,8964,7,3,7,4,15,16,-1,16
FC Goa,8964,8,4,2,8,11,18,-7,14
Mumbai City,8965,1,6,5,3,16,8,8,23
Kolkata,8965,2,5,6,3,19,16,3,21
NorthEast Un,8965,3,6,3,5,13,10,3,21
Delhi Dynamo,8965,4,4,8,2,24,17,7,20
FC Pune City,8965,5,5,3,6,15,18,-3,18
Chennaiyin,8965,6,4,5,5,15,20,-5,17
FC Goa,8965,7,4,3,7,13,18,-5,15
Kerala Blast,8965,8,4,3,7,9,17,-8,15
Mumbai City,8966,1,6,5,3,17,9,8,23
FC Pune City,8966,2,6,3,5,17,14,3,21
Delhi Dynamo,8966,3,4,7,3,25,19,6,19
Kolkata,8966,4,4,7,3,14,15,-1,19
Kerala Blast,8966,5,5,4,5,10,15,-5,19
Chennaiyin,8966,6,4,6,4,15,17,-2,18
NorthEast Un,8966,7,4,4,6,11,12,-1,16
FC Goa,8966,8,4,2,8,10,18,-8,14
Mumbai City,8967,1,7,4,3,18,9,9,25
Delhi Dynamo,8967,2,6,5,3,26,17,9,23
FC Pune City,8967,3,5,4,5,14,15,-1,19
Kerala Blast,8967,4,4,6,4,9,13,-4,18
FC Goa,8967,5,5,2,7,12,16,-4,17
Chennaiyin,8967,6,4,5,5,15,20,-5,17
Kolkata,8967,7,3,7,4,14,16,-2,16
NorthEast Un,8967,8,4,3,7,11,13,-2,15
Delhi Dynamo,8968,1,6,6,2,27,17,10,24
Mumbai City,8968,2,6,5,3,17,9,8,23
Kolkata,8968,3,5,7,2,19,15,4,22
Kerala Blast,8968,4,6,3,5,16,17,-1,21
NorthEast Un,8968,5,5,2,7,13,16,-3,17
FC Pune City,8968,6,4,4,6,14,17,-3,16
Chennaiyin,8968,7,3,6,5,14,20,-6,15
FC Goa,8968,8,3,3,8,10,19,-9,12
Mumbai City,8969,1,6,5,3,16,8,8,23
Kerala Blast,8969,2,6,4,4,15,16,-1,22
NorthEast Un,8969,3,6,2,6,12,12,0,20
Delhi Dynamo,8969,4,4,7,3,22,16,6,19
Kolkata,8969,5,3,8,3,15,16,-1,17
FC Pune City,8969,6,4,4,6,13,16,-3,16
FC Goa,8969,7,4,4,6,12,16,-4,16
Chennaiyin,8969,8,3,6,5,15,20,-5,15
Mumbai City,8970,1,6,5,3,16,8,8,23
Delhi Dynamo,8970,2,5,7,2,24,16,8,22
Kolkata,8970,3,5,7,2,20,17,3,22
FC Pune City,8970,4,5,4,5,15,16,-1,19
NorthEast Un,8970,5,5,3,6,14,13,1,18
Chennaiyin,8970,6,4,5,5,16,21,-5,17
Kerala Blast,8970,7,4,4,6,13,19,-6,16
FC Goa,8970,8,3,3,8,12,20,-8,12
Delhi Dynamo,8971,1,6,5,3,25,17,8,23
Mumbai City,8971,2,6,4,4,18,11,7,22
Kerala Blast,8971,3,6,4,4,14,14,0,22
Kolkata,8971,4,4,6,4,17,17,0,18
NorthEast Un,8971,5,5,3,6,10,10,0,18
FC Pune City,8971,6,5,3,6,14,17,-3,18
FC Goa,8971,7,5,2,7,13,19,-6,17
Chennaiyin,8971,8,3,5,6,15,21,-6,14
Kolkata,8972,1,6,6,2,20,13,7,24
Delhi Dynamo,8972,2,6,5,3,25,16,9,23
Mumbai City,8972,3,6,4,4,16,10,6,22
FC Pune City,8972,4,5,3,6,16,17,-1,18
Chennaiyin,8972,5,4,6,4,15,17,-2,18
Kerala Blast,8972,6,5,3,6,14,21,-7,18
NorthEast Un,8972,7,5,2,7,12,14,-2,17
FC Goa,8972,8,3,3,8,8,18,-10,12
Mumbai City,8973,1,7,4,3,18,9,9,25
Delhi Dynamo,8973,2,6,5,3,27,16,11,23
Kolkata,8973,3,5,6,3,16,13,3,21
Kerala Blast,8973,4,6,3,5,12,15,-3,21
FC Pune City,8973,5,5,3,6,13,16,-3,18
Chennaiyin,8973,6,3,7,4,17,21,-4,16
NorthEast Un,8973,7,4,3,7,11,13,-2,15
FC Goa,8973,8,3,3,8,10,21,-11,12
Mumbai City,8974,1,7,4,3,17,8,9,25
Delhi Dynamo,8974,2,5,5,4,24,17,7,20
Kolkata,8974,3,4,8,2,18,15,3,20
FC Pune City,8974,4,5,4,5,14,15,-1,19
FC Goa,8974,5,5,3,6,12,16,-4,18
Kerala Blast,8974,6,5,3,6,13,19,-6,18
Chennaiyin,8974,7,4,5,5,17,20,-3,17
NorthEast Un,8974,8,4,2,8,11,16,-5,14
Mumbai City,8975,1,6,5,3,17,9,8,23
Delhi Dynamo,8975,2,4,8,2,25,18,7,20
NorthEast Un,8975,3,5,3,6,13,12,1,18
Kolkata,8975,4,4,6,4,15,16,-1,18
FC Pune City,8975,5,5,3,6,14,16,-2,18
Chennaiyin,8975,6,4,6,4,16,19,-3,18
Kerala Blast,8975,7,5,3,6,13,18,-5,18
FC Goa,8975,8,4,4,6,14,19,-5,16
Mumbai City,8976,1,7,4,3,19,9,10,25
Kolkata,8976,2,5,6,3,18,17,1,21
Delhi Dynamo,8976,3,5,5,4,23,18,5,20
FC Goa,8976,4,6,2,6,14,14,0,20
FC Pune City,8976,5,5,3,6,16,17,-1,18
Chennaiyin,8976,6,4,5,5,16,19,-3,17
Kerala Blast,8976,7,4,4,6,12,20,-8,16
NorthEast Un,8976,8,4,3,7,10,14,-4,15
Mumbai City,8977,1,6,5,3,17,9,8,23
NorthEast Un,8977,2,6,3,5,14,12,2,21
Kolkata,8977,3,4,7,3,14,13,1,19
Kerala Blast,8977,4,5,4,5,11,15,-4,19
Delhi Dynamo,8977,5,4,6,4,23,18,5,18
Chennaiyin,8977,6,4,6,4,17,19,-2,18
FC Goa,8977,7,5,2,7,10,16,-6,17
FC Pune City,8977,8,4,3,7,13,17,-4,15
Mumbai City,8978,1,7,4,3,19,8,11,25
Delhi Dynamo,8978,2,6,5,3,25,19,6,23
Kerala Blast,8978,3,5,4,5,12,15,-3,19
NorthEast Un,8978,4,5,3,6,12,12,0,18
FC Pune City,8978,5,5,3,6,14,16,-2,18
FC Goa,8978,6,5,2,7,14,18,-4,17
Kolkata,8978,7,3,7,4,14,16,-2,16
Chennaiyin,8978,8,3,6,5,14,20,-6,15
Mumbai City,8979,1,6,4,4,16,10,6,22
Kolkata,8979,2,5,7,2,19,15,4,22
Delhi Dynamo,8979,3,5,6,3,26,18,8,21
Chennaiyin,8979,4,5,5,4,18,18,0,20
Kerala Blast,8979,5,5,4,5,13,16,-3,19
NorthEast Un,8979,6,5,2,7,13,16,-3,17
FC Pune City,8979,7,4,4,6,14,18,-4,16
FC Goa,8979,8,3,4,7,10,18,-8,13
Mumbai City,8980,1,6,5,3,19,11,8,23
Delhi Dynamo,8980,2,5,7,2,29,20,9,22
Kolkata,8980,3,4,7,3,17,16,1,19
NorthEast Un,8980,4,5,4,5,12,11,1,19
Kerala Blast,8980,5,5,4,5,13,17,-4,19
FC Pune City,8980,6,4,4,6,16,19,-3,16
Chennaiyin,8980,7,3,6,5,14,19,-5,15
FC Goa,8980,8,4,3,7,11,18,-7,15
Mumbai City,8981,1,7,4,3,17,8,9,25
Kerala Blast,8981,2,6,3,5,13,15,-2,21
Delhi Dynamo,8981,3,4,7,3,22,16,6,19
NorthEast Un,8981,4,5,4,5,13,11,2,19
FC Pune City,8981,5,4,4,6,13,16,-3,16
Chennaiyin,8981,6,3,7,4,16,20,-4,16
Kolkata,8981,7,3,7,4,14,18,-4,16
FC Goa,8981,8,4,4,6,12,16,-4,16
Delhi Dynamo,8982,1,6,6,2,29,16,13,24
Mumbai City,8982,2,6,5,3,18,10,8,23
Kerala Blast,8982,3,6,4,4,14,14,0,22
NorthEast Un,8982,4,5,3,6,11,12,-1,18
FC Pune City,8982,5,4,4,6,14,17,-3,16
Kolkata,8982,6,3,7,4,16,20,-4,16
Chennaiyin,8982,7,3,6,5,15,20,-5,15
FC Goa,8982,8,4,3,7,13,21,-8,15
Delhi Dynamo,8983,1,6,6,2,26,17,9,24
Kolkata,8983,2,6,6,2,19,15,4,24
Mumbai City,8983,3,6,4,4,17,10,7,22
NorthEast Un,8983,4,6,2,6,16,11,5,20
Chennaiyin,8983,5,4,5,5,14,19,-5,17
FC Pune City,8983,6,4,4,6,12,15,-3,16
Kerala Blast,8983,7,4,4,6,11,20,-9,16
FC Goa,8983,8,3,3,8,10,18,-8,12
Mumbai City,8984,1,6,5,3,18,10,8,23
Delhi Dynamo,8984,2,5,6,3,25,19,6,21
Kolkata,8984,3,5,6,3,16,14,2,21
Chennaiyin,8984,4,5,5,4,16,17,-1,20
Kerala Blast,8984,5,5,4,5,13,17,-4,19
NorthEast Un,8984,6,5,3,6,13,12,1,18
FC Pune City,8984,7,5,3,6,14,15,-1,18
FC Goa,8984,8,3,2,9,9,20,-11,11
Mumbai City,8985,1,7,4,3,18,9,9,25
Delhi Dynamo,8985,2,5,5,4,24,19,5,20
Kolkata,8985,3,4,7,3,16,15,1,19
FC Pune City,8985,4,5,4,5,13,14,-1,19
Kerala Blast,8985,5,5,4,5,14,18,-4,19
NorthEast Un,8985,6,5,2,7,13,14,-1,17
Chennaiyin,8985,7,4,5,5,16,20,-4,17
FC Goa,8985,8,4,3,7,14,19,-5,15
Kolkata,8986,1,6,6,2,18,13,5,24
Delhi Dynamo,8986,2,6,5,3,24,17,7,23
Mumbai City,8986,3,6,4,4,16,10,6,22
Chennaiyin,8986,4,5,5,4,20,19,1,20
Kerala Blast,8986,5,5,4,5,12,16,-4,19
NorthEast Un,8986,6,5,2,7,14,14,0,17
FC Pune City,8986,7,4,4,6,12,15,-3,16
FC Goa,8986,8,3,2,9,10,22,-12,11
Mumbai City,8987,1,7,4,3,17,8,9,25
Kerala Blast,8987,2,6,4,4,15,15,0,22
Kolkata,8987,3,4,7,3,17,15,2,19
Delhi Dynamo,8987,4,4,6,4,26,21,5,18
NorthEast Un,8987,5,5,3,6,13,14,-1,18
Chennaiyin,8987,6,4,5,5,17,21,-4,17
FC Goa,8987,7,5,2,7,16,21,-5,17
FC Pune City,8987,8,4,3,7,13,19,-6,15
Mumbai City,8988,1,6,4,4,17,10,7,22
Delhi Dynamo,8988,2,5,5,4,23,21,2,20
Kolkata,8988,3,4,8,2,16,14,2,20
FC Pune City,8988,4,5,4,5,15,15,0,19
Kerala Blast,8988,5,5,4,5,12,17,-5,19
Chennaiyin,8988,6,4,6,4,16,18,-2,18
NorthEast Un,8988,7,5,2,7,14,14,0,17
FC Goa,8988,8,4,3,7,11,15,-4,15
Mumbai City,8989,1,7,4,3,18,8,10,25
Delhi Dynamo,8989,2,5,6,3,26,19,7,21
Kolkata,8989,3,4,7,3,15,14,1,19
NorthEast Un,8989,4,5,4,5,13,12,1,19
FC Pune City,8989,5,5,4,5,13,14,-1,19
Kerala Blast,8989,6,5,3,6,11,16,-5,18
Chennaiyin,8989,7,3,6,5,15,20,-5,15
FC Goa,8989,8,4,2,8,13,21,-8,14
Delhi Dynamo,8990,1,6,6,2,29,17,12,24
Mumbai City,8990,2,6,5,3,18,10,8,23
Kerala Blast,8990,3,6,4,4,14,15,-1,22
Kolkata,8990,4,5,6,3,20,16,4,21
FC Pune City,8990,5,4,4,6,14,18,-4,16
Chennaiyin,8990,6,3,6,5,16,21,-5,15
NorthEast Un,8990,7,4,3,7,10,15,-5,15
FC Goa,8990,8,4,2,8,12,21,-9,14
Mumbai City,8991,1,7,4,3,19,9,10,25
NorthEast Un,8991,2,6,3,5,12,9,3,21
Delhi Dynamo,8991,3,5,5,4,25,20,5,20
Kolkata,8991,4,4,7,3,17,17,0,19
FC Pune City,8991,5,5,4,5,14,14,0,19
Chennaiyin,8991,6,4,6,4,15,18,-3,18
Kerala Blast,8991,7,4,4,6,11,17,-6,16
FC Goa,8991,8,3,3,8,11,20,-9,12
Mumbai City,8992,1,7,4,3,17,8,9,25
Delhi Dynamo,8992,2,6,5,3,31,18,13,23
Kolkata,8992,3,5,6,3,20,14,6,21
Kerala Blast,8992,4,6,3,5,16,18,-2,21
FC Pune City,8992,5,5,3,6,15,18,-3,18
Chennaiyin,8992,6,4,5,5,15,19,-4,17
NorthEast Un,8992,7,4,2,8,12,17,-5,14
FC Goa,8992,8,4,2,8,11,25,-14,14
Mumbai City,8993,1,7,4,3,19,9,10,25
Delhi Dynamo,8993,2,5,6,3,25,17,8,21
Kolkata,8993,3,4,8,2,16,14,2,20
Kerala Blast,8993,4,5,5,4,12,15,-3,20
FC Pune City,8993,5,4,5,5,14,16,-2,17
NorthEast Un,8993,6,5,2,7,10,13,-3,17
Chennaiyin,8993,7,3,6,5,13,18,-5,15
FC Goa,8993,8,3,4,7,8,15,-7,13
Mumbai City,8994,1,7,4,3,18,8,10,25
Delhi Dynamo,8994,2,5,6,3,24,17,7,21
Kolkata,8994,3,5,6,3,18,15,3,21
Chennaiyin,8994,4,5,5,4,18,17,1,20
Kerala Blast,8994,5,4,5,5,11,17,-6,17
FC Pune City,8994,6,4,4,6,14,17,-3,16
NorthEast Un,8994,7,4,3,7,9,14,-5,15
FC Goa,8994,8,4,3,7,10,17,-7,15
Delhi Dynamo,8995,1,7,5,2,26,15,11,26
Mumbai City,8995,2,6,4,4,17,10,7,22
Kerala Blast,8995,3,6,3,5,11,16,-5,21
NorthEast Un,8995,4,6,2,6,13,10,3,20
FC Pune City,8995,5,5,3,6,15,16,-1,18
Kolkata,8995,6,3,6,5,15,18,-3,15
Chennaiyin,8995,7,3,6,5,15,20,-5,15
FC Goa,8995,8,4,3,7,12,19,-7,15
Delhi Dynamo,8996,1,6,6,2,25,16,9,24
Mumbai City,8996,2,6,4,4,16,9,7,22
Kolkata,8996,3,5,7,2,18,13,5,22
Kerala Blast,8996,4,5,4,5,13,17,-4,19
FC Pune City,8996,5,4,5,5,12,14,-2,17
NorthEast Un,8996,6,4,4,6,11,14,-3,16
Chennaiyin,8996,7,3,7,4,16,20,-4,16
FC Goa,8996,8,3,3,8,11,19,-8,12
Delhi Dynamo,8997,1,6,5,3,25,17,8,23
Mumbai City,8997,2,6,4,4,17,10,7,22
Chennaiyin,8997,3,5,5,4,16,17,-1,20
FC Pune City,8997,4,5,4,5,16,16,0,19
Kerala Blast,8997,5,5,4,5,12,17,-5,19
NorthEast Un,8997,6,5,3,6,11,12,-1,18
Kolkata,8997,7,3,8,3,17,17,0,17
FC Goa,8997,8,3,3,8,10,18,-8,12
Mumbai City,8998,1,6,5,3,17,9,8,23
Delhi Dynamo,8998,2,5,7,2,24,16,8,22
Kerala Blast,8998,3,6,4,4,13,14,-1,22
Chennaiyin,8998,4,5,5,4,18,17,1,20
Kolkata,8998,5,3,8,3,15,15,0,17
FC Pune City,8998,6,4,4,6,13,17,-4,16
FC Goa,8998,7,4,3,7,11,17,-6,15
NorthEast Un,8998,8,4,2,8,10,16,-6,14
Mumbai City,8999,1,6,5,3,17,9,8,23
Delhi Dynamo,8999,2,5,6,3,25,17,8,21
Kerala Blast,8999,3,5,5,4,12,15,-3,20
Kolkata,8999,4,4,7,3,17,16,1,19
FC Pune City,8999,5,5,4,5,13,14,-1,19
NorthEast Un,8999,6,5,3,6,11,11,0,18
Chennaiyin,8999,7,4,6,4,16,17,-1,18
FC Goa,8999,8,3,2,9,9,21,-12,11
Mumbai City,9000,1,7,4,3,19,9,10,25
Kerala Blast,9000,2,7,3,4,16,14,2,24
Delhi Dynamo,9000,3,5,5,4,28,22,6,20
NorthEast Un,9000,4,5,3,6,12,12,0,18
FC Goa,9000,5,5,2,7,13,19,-6,17
Kolkata,9000,6,3,7,4,15,18,-3,16
FC Pune City,9000,7,4,4,6,14,18,-4,16
Chennaiyin,9000,8,3,6,5,13,18,-5,15
Mumbai City,9001,1,7,4,3,18,9,9,25
Kolkata,9001,2,5,7,2,17,14,3,22
Kerala Blast,9001,3,6,4,4,14,15,-1,22
Delhi Dynamo,9001,4,5,5,4,24,19,5,20
Chennaiyin,9001,5,4,5,5,17,18,-1,17
NorthEast Un,9001,6,5,2,7,11,14,-3,17
FC Pune City,9001,7,4,3,7,13,18,-5,15
FC Goa,9001,8,4,2,8,11,18,-7,14
Delhi Dynamo,9002,1,6,5,3,27,18,9,23
Mumbai City,9002,2,6,4,4,17,10,7,22
Kerala Blast,9002,3,6,4,4,14,15,-1,22
NorthEast Un,9002,4,5,3,6,12,12,0,18
Chennaiyin,9002,5,4,6,4,16,19,-3,18
Kolkata,9002,6,3,8,3,15,15,0,17
FC Pune City,9002,7,4,4,6,14,18,-4,16
FC Goa,9002,8,4,2,8,11,19,-8,14
Mumbai City,9003,1,7,4,3,17,8,9,25
Delhi Dynamo,9003,2,6,5,3,26,17,9,23
Kerala Blast,9003,3,6,3,5,13,16,-3,21
Kolkata,9003,4,4,8,2,18,15,3,20
Chennaiyin,9003,5,3,7,4,15,19,-4,16
FC Pune City,9003,6,4,4,6,14,18,-4,16
NorthEast Un,9003,7,4,3,7,12,14,-2,15
FC Goa,9003,8,3,4,7,11,19,-8,13
Mumbai City,9004,1,6,5,3,17,9,8,23
Kerala Blast,9004,2,6,3,5,17,17,0,21
FC Goa,9004,3,6,2,6,17,15,2,20
Delhi Dynamo,9004,4,4,7,3,23,18,5,19
Kolkata,9004,5,4,7,3,18,17,1,19
NorthEast Un,9004,6,5,3,6,11,12,-1,18
FC Pune City,9004,7,4,4,6,14,20,-6,16
Chennaiyin,9004,8,3,5,6,13,22,-9,14
Mumbai City,9005,1,7,4,3,18,8,10,25
Delhi Dynamo,9005,2,6,5,3,26,18,8,23
Kerala Blast,9005,3,6,4,4,11,13,-2,22
Chennaiyin,9005,4,5,5,4,16,18,-2,20
FC Pune City,9005,5,5,4,5,14,14,0,19
Kolkata,9005,6,3,6,5,14,21,-7,15
NorthEast Un,9005,7,4,2,8,11,14,-3,14
FC Goa,9005,8,4,2,8,15,19,-4,14
Mumbai City,9006,1,6,5,3,18,10,8,23
Kolkata,9006,2,5,7,2,20,14,6,22
Delhi Dynamo,9006,3,5,6,3,27,20,7,21
Kerala Blast,9006,4,6,3,5,12,16,-4,21
FC Goa,9006,5,5,3,6,15,16,-1,18
Chennaiyin,9006,6,4,5,5,17,19,-2,17
FC Pune City,9006,7,4,3,7,12,18,-6,15
NorthEast Un,9006,8,4,2,8,9,17,-8,14
Mumbai City,9007,1,7,4,3,21,9,12,25
Kerala Blast,9007,2,7,3,4,13,13,0,24
Delhi Dynamo,9007,3,5,6,3,26,21,5,21
Kolkata,9007,4,5,6,3,17,15,2,21
Chennaiyin,9007,5,4,6,4,16,19,-3,18
FC Pune City,9007,6,4,3,7,14,18,-4,15
NorthEast Un,9007,7,4,3,7,11,15,-4,15
FC Goa,9007,8,3,3,8,10,18,-8,12
Kerala Blast,9008,1,7,3,4,15,16,-1,24
Mumbai City,9008,2,6,5,3,16,8,8,23
Kolkata,9008,3,5,6,3,18,13,5,21
Delhi Dynamo,9008,4,4,7,3,22,17,5,19
Chennaiyin,9008,5,4,6,4,15,17,-2,18
NorthEast Un,9008,6,4,3,7,10,13,-3,15
FC Pune City,9008,7,4,3,7,15,20,-5,15
FC Goa,9008,8,4,3,7,10,17,-7,15
Mumbai City,9009,1,6,4,4,16,9,7,22
Delhi Dynamo,9009,2,5,6,3,23,17,6,21
Kolkata,9009,3,5,6,3,18,14,4,21
FC Goa,9009,4,6,2,6,15,16,-1,20
Kerala Blast,9009,5,5,4,5,12,16,-4,19
Chennaiyin,9009,6,4,5,5,14,19,-5,17
FC Pune City,9009,7,4,4,6,13,18,-5,16
NorthEast Un,9009,8,4,3,7,10,12,-2,15
Delhi Dynamo,9010,1,6,6,2,26,14,12,24
Mumbai City,9010,2,6,4,4,16,11,5,22
Kolkata,9010,3,5,6,3,18,14,4,21
Kerala Blast,9010,4,6,3,5,12,16,-4,21
NorthEast Un,9010,5,5,3,6,13,11,2,18
Chennaiyin,9010,6,4,5,5,15,22,-7,17
FC Pune City,9010,7,4,3,7,12,16,-4,15
FC Goa,9010,8,4,2,8,11,19,-8,14
Mumbai City,9011,1,7,4,3,18,8,10,25
Delhi Dynamo,9011,2,6,5,3,27,16,11,23
Kerala Blast,9011,3,5,5,4,14,17,-3,20
Kolkata,9011,4,3,9,2,19,18,1,18
FC Pune City,9011,5,4,5,5,15,17,-2,17
NorthEast Un,9011,6,4,3,7,11,13,-2,15
Chennaiyin,9011,7,3,6,5,14,19,-5,15
FC Goa,9011,8,4,3,7,11,21,-10,15
Mumbai City,9012,1,7,4,3,20,9,11,25
Kolkata,9012,2,5,6,3,18,14,4,21
NorthEast Un,9012,3,6,3,5,14,12,2,21
Delhi Dynamo,9012,4,5,5,4,27,21,6,20
FC Pune City,9012,5,5,3,6,13,15,-2,18
Chennaiyin,9012,6,3,7,4,16,20,-4,16
FC Goa,9012,7,4,3,7,12,20,-8,15
Kerala Blast,9012,8,4,3,7,9,18,-9,15
Mumbai City,9013,1,7,4,3,17,8,9,25
Kolkata,9013,2,5,6,3,17,14,3,21
Delhi Dynamo,9013,3,5,5,4,25,20,5,20
Chennaiyin,9013,4,5,5,4,18,18,0,20
FC Pune City,9013,5,5,4,5,15,15,0,19
Kerala Blast,9013,6,5,4,5,11,16,-5,19
NorthEast Un,9013,7,5,2,7,11,13,-2,17
FC Goa,9013,8,3,2,9,12,22,-10,11
Mumbai City,9014,1,7,4,3,17,8,9,25
Kerala Blast,9014,2,6,4,4,13,15,-2,22
Delhi Dynamo,9014,3,5,5,4,24,20,4,20
Kolkata,9014,4,4,8,2,16,14,2,20
Chennaiyin,9014,5,4,6,4,15,17,-2,18
FC Goa,9014,6,4,4,6,13,16,-3,16
FC Pune City,9014,7,4,3,7,14,18,-4,15
NorthEast Un,9014,8,4,2,8,9,13,-4,14
Delhi Dynamo,9015,1,6,6,2,25,15,10,24
Mumbai City,9015,2,6,5,3,16,8,8,23
Kolkata,9015,3,4,8,2,19,15,4,20
Chennaiyin,9015,4,5,5,4,15,17,-2,20
FC Pune City,9015,5,5,4,5,14,14,0,19
Kerala Blast,9015,6,5,3,6,12,20,-8,18
NorthEast Un,9015,7,4,2,8,11,15,-4,14
FC Goa,9015,8,3,3,8,10,18,-8,12
Mumbai City,9016,1,6,5,3,17,9,8,23
Delhi Dynamo,9016,2,5,7,2,26,16,10,22
FC Pune City,9016,3,5,4,5,14,15,-1,19
NorthEast Un,9016,4,5,3,6,11,12,-1,18
Chennaiyin,9016,5,4,6,4,16,18,-2,18
Kerala Blast,9016,6,4,5,5,9,14,-5,17
Kolkata,9016,7,3,7,4,14,15,-1,16
FC Goa,9016,8,4,3,7,10,18,-8,15
Mumbai City,9017,1,7,4,3,18,9,9,25
Chennaiyin,9017,2,5,5,4,18,17,1,20
Delhi Dynamo,9017,3,4,7,3,26,20,6,19
Kolkata,9017,4,4,6,4,15,15,0,18
NorthEast Un,9017,5,5,3,6,13,15,-2,18
FC Pune City,9017,6,5,3,6,14,17,-3,18
Kerala Blast,9017,7,5,3,6,13,17,-4,18
FC Goa,9017,8,4,3,7,12,19,-7,15
Delhi Dynamo,9018,1,6,6,2,25,15,10,24
Mumbai City,9018,2,6,4,4,16,9,7,22
Kolkata,9018,3,5,6,3,17,13,4,21
FC Pune City,9018,4,5,4,5,14,15,-1,19
Kerala Blast,9018,5,5,4,5,13,18,-5,19
NorthEast Un,9018,6,5,3,6,14,14,0,18
FC Goa,9018,7,4,2,8,11,18,-7,14
Chennaiyin,9018,8,3,5,6,15,23,-8,14
Mumbai City,9019,1,7,4,3,19,9,10,25
Kolkata,9019,2,5,7,2,17,13,4,22
Delhi Dynamo,9019,3,5,5,4,24,18,6,20
NorthEast Un,9019,4,5,4,5,13,12,1,19
FC Pune City,9019,5,5,3,6,16,17,-1,18
Chennaiyin,9019,6,4,6,4,16,19,-3,18
Kerala Blast,9019,7,4,4,6,10,18,-8,16
FC Goa,9019,8,3,3,8,8,17,-9,12
Delhi Dynamo,9020,1,5,7,2,24,16,8,22
Mumbai City,9020,2,6,4,4,16,9,7,22
Kolkata,9020,3,5,7,2,18,14,4,22
Kerala Blast,9020,4,5,4,5,14,19,-5,19
NorthEast Un,9020,5,5,3,6,14,14,0,18
FC Pune City,9020,6,5,3,6,15,17,-2,18
Chennaiyin,9020,7,4,5,5,16,18,-2,17
FC Goa,9020,8,3,3,8,9,19,-10,12
Mumbai City,9021,1,7,4,3,18,8,10,25
Kolkata,9021,2,5,6,3,17,16,1,21
FC Goa,9021,3,6,2,6,15,16,-1,20
Delhi Dynamo,9021,4,4,6,4,24,20,4,18
Chennaiyin,9021,5,4,5,5,15,18,-3,17
Kerala Blast,9021,6,4,5,5,11,16,-5,17
NorthEast Un,9021,7,4,4,6,12,14,-2,16
FC Pune City,9021,8,4,4,6,13,17,-4,16
Mumbai City,9022,1,7,4,3,19,8,11,25
Delhi Dynamo,9022,2,5,6,3,24,18,6,21
NorthEast Un,9022,3,5,4,5,11,10,1,19
FC Pune City,9022,4,5,4,5,15,16,-1,19
Kerala Blast,9022,5,4,5,5,11,16,-5,17
Kolkata,9022,6,3,7,4,16,17,-1,16
Chennaiyin,9022,7,3,7,4,14,18,-4,16
FC Goa,9022,8,4,3,7,11,18,-7,15
Mumbai City,9023,1,6,5,3,18,10,8,23
Delhi Dynamo,9023,2,5,6,3,30,21,9,21
Kerala Blast,9023,3,5,5,4,13,15,-2,20
NorthEast Un,9023,4,5,4,5,14,13,1,19
Kolkata,9023,5,4,6,4,15,17,-2,18
FC Goa,9023,6,5,2,7,15,20,-5,17
FC Pune City,9023,7,4,4,6,13,17,-4,16
Chennaiyin,9023,8,3,6,5,15,20,-5,15
Mumbai City,9024,1,7,4,3,19,10,9,25
Delhi Dynamo,9024,2,5,6,3,28,18,10,21
Kerala Blast,9024,3,6,3,5,15,18,-3,21
Kolkata,9024,4,4,6,4,18,17,1,18
FC Goa,9024,5,5,3,6,13,15,-2,18
NorthEast Un,9024,6,5,3,6,12,15,-3,18
Chennaiyin,9024,7,3,6,5,13,19,-6,15
FC Pune City,9024,8,4,3,7,12,18,-6,15
Mumbai City,9025,1,7,4,3,17,8,9,25
Delhi Dynamo,9025,2,6,5,3,25,15,10,23
Kerala Blast,9025,3,6,4,4,13,14,-1,22
FC Pune City,9025,4,5,3,6,14,16,-2,18
FC Goa,9025,5,5,2,7,11,16,-5,17
NorthEast Un,9025,6,4,4,6,10,12,-2,16
Kolkata,9025,7,3,6,5,13,17,-4,15
Chennaiyin,9025,8,3,6,5,13,18,-5,15
Mumbai City,9026,1,7,4,3,20,10,10,25
Delhi Dynamo,9026,2,6,5,3,29,20,9,23
Kolkata,9026,3,4,7,3,15,14,1,19
FC Pune City,9026,4,5,4,5,14,15,-1,19
NorthEast Un,9026,5,5,3,6,11,12,-1,18
Kerala Blast,9026,6,4,6,4,10,14,-4,18
Chennaiyin,9026,7,3,6,5,14,19,-5,15
FC Goa,9026,8,3,3,8,11,20,-9,12
Mumbai City,9027,1,7,4,3,19,10,9,25
Delhi Dynamo,9027,2,5,6,3,26,18,8,21
Kolkata,9027,3,5,6,3,16,14,2,21
Kerala Blast,9027,4,6,3,5,12,15,-3,21
NorthEast Un,9027,5,5,3,6,10,10,0,18
FC Pune City,9027,6,4,3,7,13,17,-4,15
Chennaiyin,9027,7,3,6,5,13,18,-5,15
FC Goa,9027,8,4,3,7,11,18,-7,15
Mumbai City,9028,1,7,4,3,19,8,11,25
Delhi Dynamo,9028,2,6,5,3,23,17,6,23
Kerala Blast,9028,3,6,4,4,18,16,2,22
Kolkata,9028,4,4,7,3,17,15,2,19
NorthEast Un,9028,5,5,2,7,11,15,-4,17
Chennaiyin,9028,6,3,6,5,13,18,-5,15
FC Pune City,9028,7,4,3,7,12,18,-6,15
FC Goa,9028,8,4,3,7,9,15,-6,15
Delhi Dynamo,9029,1,6,5,3,26,15,11,23
Mumbai City,9029,2,6,4,4,16,10,6,22
NorthEast Un,9029,3,6,2,6,11,12,-1,20
Kolkata,9029,4,4,7,3,18,18,0,19
FC Pune City,9029,5,5,3,6,15,17,-2,18
Kerala Blast,9029,6,5,3,6,13,17,-4,18
Chennaiyin,9029,7,4,5,5,16,18,-2,17
FC Goa,9029,8,4,3,7,10,18,-8,15
Mumbai City,9030,1,7,4,3,18,8,10,25
Delhi Dynamo,9030,2,5,5,4,24,18,6,20
Kolkata,9030,3,4,7,3,17,14,3,19
NorthEast Un,9030,4,5,4,5,12,10,2,19
Kerala Blast,9030,5,4,6,4,11,15,-4,18
FC Goa,9030,6,5,2,7,10,17,-7,17
FC Pune City,9030,7,4,4,6,13,18,-5,16
Chennaiyin,9030,8,3,6,5,14,19,-5,15
Delhi Dynamo,9031,1,6,6,2,25,14,11,24
Mumbai City,9031,2,6,4,4,16,10,6,22
Kerala Blast,9031,3,6,3,5,12,16,-4,21
Kolkata,9031,4,4,6,4,17,17,0,18
FC Pune City,9031,5,5,3,6,14,15,-1,18
FC Goa,9031,6,5,3,6,11,15,-4,18
Chennaiyin,9031,7,4,5,5,16,18,-2,17
NorthEast Un,9031,8,4,2,8,9,15,-6,14
Mumbai City,9032,1,6,5,3,16,8,8,23
Delhi Dynamo,9032,2,5,7,2,22,14,8,22
Kolkata,9032,3,5,7,2,17,13,4,22
Kerala Blast,9032,4,4,5,5,10,16,-6,17
Chennaiyin,9032,5,4,5,5,15,22,-7,17
NorthEast Un,9032,6,4,4,6,10,11,-1,16
FC Pune City,9032,7,4,4,6,14,17,-3,16
FC Goa,9032,8,4,3,7,12,15,-3,15
Mumbai City,9033,1,7,4,3,19,8,11,25
Kerala Blast,9033,2,6,4,4,15,15,0,22
Delhi Dynamo,9033,3,5,6,3,24,19,5,21
NorthEast Un,9033,4,5,3,6,15,17,-2,18
FC Pune City,9033,5,4,5,5,13,15,-2,17
FC Goa,9033,6,5,2,7,10,15,-5,17
Kolkata,9033,7,3,7,4,14,15,-1,16
Chennaiyin,9033,8,3,5,6,14,20,-6,14
Mumbai City,9034,1,7,4,3,18,8,10,25
Kolkata,9034,2,5,6,3,16,13,3,21
Kerala Blast,9034,3,5,5,4,12,15,-3,20
Delhi Dynamo,9034,4,4,7,3,21,16,5,19
NorthEast Un,9034,5,5,4,5,12,11,1,19
Chennaiyin,9034,6,4,5,5,17,20,-3,17
FC Pune City,9034,7,4,4,6,13,17,-4,16
FC Goa,9034,8,3,3,8,9,18,-9,12
Delhi Dynamo,9035,1,6,6,2,26,17,9,24
Mumbai City,9035,2,6,4,4,17,10,7,22
Kerala Blast,9035,3,6,3,5,13,16,-3,21
Kolkata,9035,4,4,7,3,17,15,2,19
NorthEast Un,9035,5,5,3,6,11,12,-1,18
Chennaiyin,9035,6,4,5,5,14,18,-4,17
FC Pune City,9035,7,4,4,6,14,17,-3,16
FC Goa,9035,8,4,2,8,11,18,-7,14
Mumbai City,9036,1,6,5,3,17,9,8,23
NorthEast Un,9036,2,7,2,5,14,11,3,23
Delhi Dynamo,9036,3,5,6,3,26,19,7,21
Kolkata,9036,4,4,6,4,14,14,0,18
FC Pune City,9036,5,5,3,6,13,16,-3,18
Kerala Blast,9036,6,5,3,6,12,16,-4,18
Chennaiyin,9036,7,3,6,5,13,18,-5,15
FC Goa,9036,8,4,3,7,11,17,-6,15
Mumbai City,9037,1,7,4,3,19,9,10,25
Delhi Dynamo,9037,2,5,5,4,27,22,5,20
Chennaiyin,9037,3,5,5,4,17,18,-1,20
Kolkata,9037,4,4,7,3,17,16,1,19
Kerala Blast,9037,5,5,4,5,12,16,-4,19
FC Pune City,9037,6,5,3,6,14,16,-2,18
NorthEast Un,9037,7,5,2,7,13,14,-1,17
FC Goa,9037,8,4,2,8,13,21,-8,14
Mumbai City,9038,1,7,4,3,18,8,10,25
NorthEast Un,9038,2,6,3,5,13,10,3,21
Kolkata,9038,3,4,7,3,17,16,1,19
Delhi Dynamo,9038,4,4,6,4,21,18,3,18
FC Pune City,9038,5,5,3,6,15,16,-1,18
FC Goa,9038,6,5,3,6,12,15,-3,18
Kerala Blast,9038,7,4,4,6,11,19,-8,16
Chennaiyin,9038,8,3,6,5,15,20,-5,15
Mumbai City,9039,1,7,4,3,20,8,12,25
NorthEast Un,9039,2,7,2,5,20,12,8,23
Kolkata,9039,3,4,7,3,17,16,1,19
Kerala Blast,9039,4,5,4,5,13,17,-4,19
Delhi Dynamo,9039,5,4,6,4,23,25,-2,18
FC Pune City,9039,6,4,4,6,15,18,-3,16
FC Goa,9039,7,4,4,6,11,16,-5,16
Chennaiyin,9039,8,3,5,6,15,22,-7,14
Mumbai City,9040,1,6,5,3,16,8,8,23
Delhi Dynamo,9040,2,5,7,2,25,15,10,22
Kerala Blast,9040,3,6,4,4,12,13,-1,22
FC Pune City,9040,4,5,4,5,14,14,0,19
Kolkata,9040,5,4,6,4,14,15,-1,18
NorthEast Un,9040,6,5,3,6,11,12,-1,18
Chennaiyin,9040,7,3,5,6,13,19,-6,14
FC Goa,9040,8,4,2,8,9,18,-9,14
Mumbai City,9041,1,6,5,3,17,9,8,23
Kolkata,9041,2,5,7,2,15,12,3,22
Delhi Dynamo,9041,3,4,7,3,24,18,6,19
FC Pune City,9041,4,5,3,6,13,15,-2,18
Kerala Blast,9041,5,5,3,6,12,16,-4,18
NorthEast Un,9041,6,5,2,7,11,13,-2,17
Chennaiyin,9041,7,4,5,5,14,18,-4,17
FC Goa,9041,8,4,4,6,11,16,-5,16
Delhi Dynamo,9042,1,6,6,2,26,16,10,24
Mumbai City,9042,2,6,4,4,17,10,7,22
Kolkata,9042,3,4,7,3,17,16,1,19
NorthEast Un,9042,4,5,4,5,12,11,1,19
Kerala Blast,9042,5,5,4,5,14,17,-3,19
FC Pune City,9042,6,5,3,6,15,18,-3,18
FC Goa,9042,7,4,3,7,11,18,-7,15
Chennaiyin,9042,8,3,5,6,13,19,-6,14
Mumbai City,9043,1,7,4,3,17,8,9,25
Delhi Dynamo,9043,2,6,5,3,27,15,12,23
Chennaiyin,9043,3,5,5,4,16,18,-2,20
FC Pune City,9043,4,5,4,5,18,16,2,19
Kolkata,9043,5,4,7,3,17,15,2,19
NorthEast Un,9043,6,5,2,7,14,17,-3,17
Kerala Blast,9043,7,4,3,7,12,23,-11,15
FC Goa,9043,8,4,2,8,9,18,-9,14
Mumbai City,9044,1,7,4,3,18,8,10,25
Delhi Dynamo,9044,2,6,5,3,24,17,7,23
Kolkata,9044,3,5,7,2,21,16,5,22
Kerala Blast,9044,4,5,4,5,11,16,-5,19
NorthEast Un,9044,5,4,4,6,11,12,-1,16
Chennaiyin,9044,6,3,6,5,13,18,-5,15
FC Pune City,9044,6,4,3,7,13,18,-5,15
FC Goa,9044,8,4,3,7,12,18,-6,15
Delhi Dynamo,9045,1,6,6,2,28,17,11,24
Mumbai City,9045,2,6,4,4,17,11,6,22
Kolkata,9045,3,4,7,3,15,15,0,19
FC Pune City,9045,4,5,3,6,14,15,-1,18
FC Goa,9045,5,5,3,6,14,17,-3,18
Chennaiyin,9045,6,4,5,5,16,20,-4,17
Kerala Blast,9045,7,4,5,5,12,18,-6,17
NorthEast Un,9045,8,4,3,7,12,15,-3,15
Mumbai City,9046,1,6,5,3,17,9,8,23
Delhi Dynamo,9046,2,5,7,2,26,18,8,22
Kolkata,9046,3,5,6,3,18,14,4,21
Kerala Blast,9046,4,5,4,5,12,18,-6,19
Chennaiyin,9046,5,4,6,4,16,18,-2,18
NorthEast Un,9046,6,4,5,5,12,12,0,17
FC Pune City,9046,7,4,3,7,12,16,-4,15
FC Goa,9046,8,4,2,8,11,19,-8,14
Mumbai City,9047,1,7,4,3,20,8,12,25
Kolkata,9047,2,6,6,2,19,14,5,24
Delhi Dynamo,9047,3,6,5,3,27,21,6,23
Kerala Blast,9047,4,5,4,5,11,15,-4,19
NorthEast Un,9047,5,5,2,7,14,15,-1,17
FC Pune City,9047,6,4,4,6,13,17,-4,16
Chennaiyin,9047,7,3,5,6,15,22,-7,14
FC Goa,9047,8,4,2,8,11,18,-7,14
Mumbai City,9048,1,6,5,3,16,8,8,23
Delhi Dynamo,9048,2,5,6,3,23,15,8,21
Kolkata,9048,3,4,8,2,16,14,2,20
FC Pune City,9048,4,5,3,6,13,15,-2,18
FC Goa,9048,5,5,3,6,11,14,-3,18
Chennaiyin,9048,6,4,5,5,16,20,-4,17
Kerala Blast,9048,7,4,5,5,13,18,-5,17
NorthEast Un,9048,8,4,3,7,12,16,-4,15
Delhi Dynamo,9049,1,6,6,2,28,17,11,24
Kolkata,9049,2,6,6,2,23,12,11,24
Mumbai City,9049,3,6,5,3,17,9,8,23
FC Pune City,9049,4,5,3,6,13,17,-4,18
Kerala Blast,9049,5,5,3,6,10,17,-7,18
NorthEast Un,9049,6,5,2,7,12,13,-1,17
Chennaiyin,9049,7,3,6,5,16,21,-5,15
FC Goa,9049,8,3,3,8,11,24,-13,12
Mumbai City,9050,1,7,4,3,18,9,9,25
NorthEast Un,9050,2,6,3,5,14,12,2,21
Kolkata,9050,3,4,8,2,17,15,2,20
Delhi Dynamo,9050,4,4,6,4,27,22,5,18
Kerala Blast,9050,5,4,6,4,13,17,-4,18
Chennaiyin,9050,6,4,5,5,16,19,-3,17
FC Pune City,9050,7,4,4,6,14,17,-3,16
FC Goa,9050,8,3,4,7,12,20,-8,13
Mumbai City,9051,1,7,4,3,18,8,10,25
Kolkata,9051,2,6,6,2,19,13,6,24
Delhi Dynamo,9051,3,4,7,3,27,22,5,19
NorthEast Un,9051,4,5,3,6,14,14,0,18
FC Pune City,9051,5,5,3,6,14,16,-2,18
Kerala Blast,9051,6,5,3,6,13,18,-5,18
FC Goa,9051,7,4,3,7,16,21,-5,15
Chennaiyin,9051,8,3,5,6,14,23,-9,14
Mumbai City,9052,1,7,4,3,19,9,10,25
Kolkata,9052,2,5,7,2,19,12,7,22
Kerala Blast,9052,3,6,4,4,12,14,-2,22
Delhi Dynamo,9052,4,4,6,4,24,20,4,18
NorthEast Un,9052,5,5,3,6,11,11,0,18
Chennaiyin,9052,6,3,7,4,13,17,-4,16
FC Pune City,9052,7,4,3,7,12,18,-6,15
FC Goa,9052,8,3,4,7,10,19,-9,13
Mumbai City,9053,1,7,4,3,19,10,9,25
Kerala Blast,9053,2,7,3,4,17,15,2,24
Delhi Dynamo,9053,3,6,5,3,26,18,8,23
Kolkata,9053,4,5,6,3,18,15,3,21
NorthEast Un,9053,5,5,2,7,13,13,0,17
FC Pune City,9053,6,4,3,7,14,21,-7,15
Chennaiyin,9053,7,3,5,6,14,21,-7,14
FC Goa,9053,8,4,2,8,10,18,-8,14
Delhi Dynamo,9054,1,6,6,2,27,16,11,24
Mumbai City,9054,2,6,4,4,17,11,6,22
Kolkata,9054,3,5,7,2,17,13,4,22
NorthEast Un,9054,4,5,4,5,12,11,1,19
Chennaiyin,9054,5,4,6,4,15,18,-3,18
Kerala Blast,9054,6,5,3,6,11,15,-4,18
FC Pune City,9054,7,4,3,7,12,18,-6,15
FC Goa,9054,8,3,3,8,9,18,-9,12
Mumbai City,9055,1,6,5,3,17,9,8,23
Kerala Blast,9055,2,6,4,4,16,16,0,22
NorthEast Un,9055,3,6,3,5,16,12,4,21
Delhi Dynamo,9055,4,4,7,3,24,20,4,19
FC Pune City,9055,5,5,3,6,17,17,0,18
FC Goa,9055,6,5,3,6,14,17,-3,18
Kolkata,9055,7,3,6,5,15,21,-6,15
Chennaiyin,9055,8,3,5,6,15,22,-7,14
Delhi Dynamo,9056,1,6,6,2,24,14,10,24
Kolkata,9056,2,6,6,2,19,13,6,24
Mumbai City,9056,3,6,4,4,16,9,7,22
Chennaiyin,9056,4,5,5,4,17,18,-1,20
NorthEast Un,9056,5,5,2,7,11,13,-2,17
FC Pune City,9056,6,4,4,6,13,17,-4,16
Kerala Blast,9056,7,4,4,6,10,17,-7,16
FC Goa,9056,8,3,3,8,9,18,-9,12
Mumbai City,9057,1,6,5,3,20,12,8,23
Kerala Blast,9057,2,6,4,4,14,14,0,22
Delhi Dynamo,9057,3,5,6,3,27,20,7,21
Kolkata,9057,4,4,6,4,14,15,-1,18
Chennaiyin,9057,5,4,6,4,14,17,-3,18
FC Goa,9057,6,5,3,6,10,14,-4,18
NorthEast Un,9057,7,4,3,7,11,13,-2,15
FC Pune City,9057,8,4,3,7,12,17,-5,15
Mumbai City,9058,1,7,4,3,18,9,9,25
Delhi Dynamo,9058,2,5,6,3,27,17,10,21
Kolkata,9058,3,4,8,2,18,15,3,20
FC Pune City,9058,4,5,3,6,14,17,-3,18
NorthEast Un,9058,5,4,5,5,10,10,0,17
Kerala Blast,9058,6,4,5,5,11,16,-5,17
Chennaiyin,9058,7,3,7,4,15,19,-4,16
FC Goa,9058,8,3,4,7,10,20,-10,13
Mumbai City,9059,1,7,4,3,17,8,9,25
FC Pune City,9059,2,6,3,5,16,15,1,21
Kerala Blast,9059,3,6,3,5,12,15,-3,21
Delhi Dynamo,9059,4,4,7,3,24,18,6,19
Kolkata,9059,5,4,6,4,16,17,-1,18
Chennaiyin,9059,6,4,6,4,14,17,-3,18
NorthEast Un,9059,7,4,4,6,11,12,-1,16
FC Goa,9059,8,3,3,8,10,18,-8,12
Mumbai City,9060,1,7,4,3,19,10,9,25
Delhi Dynamo,9060,2,6,5,3,27,17,10,23
Kolkata,9060,3,5,6,3,18,15,3,21
Kerala Blast,9060,4,5,3,6,15,17,-2,18
FC Pune City,9060,5,5,3,6,13,15,-2,18
NorthEast Un,9060,6,5,2,7,11,16,-5,17
FC Goa,9060,7,5,2,7,11,18,-7,17
Chennaiyin,9060,8,3,5,6,14,20,-6,14
Kolkata,9061,1,6,6,2,22,18,4,24
Delhi Dynamo,9061,2,6,5,3,29,17,12,23
Mumbai City,9061,3,6,4,4,17,12,5,22
Chennaiyin,9061,4,4,6,4,19,21,-2,18
FC Pune City,9061,5,5,3,6,15,17,-2,18
Kerala Blast,9061,6,5,3,6,13,17,-4,18
NorthEast Un,9061,7,5,2,7,14,17,-3,17
FC Goa,9061,8,3,3,8,11,21,-10,12
Mumbai City,9062,1,6,5,3,16,8,8,23
Delhi Dynamo,9062,2,4,8,2,23,16,7,20
NorthEast Un,9062,3,5,4,5,16,13,3,19
Kerala Blast,9062,4,5,4,5,14,20,-6,19
Chennaiyin,9062,5,4,6,4,17,19,-2,18
FC Pune City,9062,6,5,3,6,14,16,-2,18
Kolkata,9062,7,3,7,4,16,18,-2,16
FC Goa,9062,8,4,3,7,12,18,-6,15
Mumbai City,9063,1,6,5,3,18,10,8,23
Kerala Blast,9063,2,6,4,4,13,14,-1,22
Delhi Dynamo,9063,3,5,6,3,24,17,7,21
Kolkata,9063,4,4,7,3,16,17,-1,19
FC Goa,9063,5,5,3,6,12,14,-2,18
Chennaiyin,9063,6,4,6,4,15,18,-3,18
FC Pune City,9063,7,4,3,7,13,18,-5,15
NorthEast Un,9063,8,4,2,8,10,13,-3,14
Delhi Dynamo,9064,1,7,5,2,28,16,12,26
Mumbai City,9064,2,6,4,4,16,10,6,22
FC Pune City,9064,3,5,4,5,15,16,-1,19
Chennaiyin,9064,4,4,6,4,16,19,-3,18
Kerala Blast,9064,5,4,6,4,10,14,-4,18
Kolkata,9064,6,3,8,3,15,15,0,17
NorthEast Un,9064,7,4,3,7,10,13,-3,15
FC Goa,9064,8,3,4,7,12,19,-7,13
Mumbai City,9065,1,7,4,3,18,9,9,25
Delhi Dynamo,9065,2,5,5,4,23,18,5,20
Kolkata,9065,3,4,8,2,17,13,4,20
FC Pune City,9065,4,5,4,5,14,15,-1,19
FC Goa,9065,5,5,2,7,13,18,-5,17
Kerala Blast,9065,6,4,5,5,10,15,-5,17
NorthEast Un,9065,7,4,4,6,10,11,-1,16
Chennaiyin,9065,8,3,6,5,14,20,-6,15
Mumbai City,9066,1,6,5,3,16,8,8,23
Delhi Dynamo,9066,2,4,8,2,23,16,7,20
Kerala Blast,9066,3,5,4,5,11,16,-5,19
Kolkata,9066,4,4,6,4,15,15,0,18
FC Pune City,9066,5,5,3,6,14,15,-1,18
FC Goa,9066,6,5,3,6,12,15,-3,18
NorthEast Un,9066,7,4,5,5,12,12,0,17
Chennaiyin,9066,8,3,6,5,14,20,-6,15
Delhi Dynamo,9067,1,7,5,2,28,15,13,26
Kerala Blast,9067,2,7,3,4,14,14,0,24
Mumbai City,9067,3,6,4,4,16,9,7,22
Kolkata,9067,4,5,6,3,18,13,5,21
Chennaiyin,9067,5,4,5,5,16,21,-5,17
FC Pune City,9067,6,4,3,7,12,18,-6,15
NorthEast Un,9067,7,4,2,8,12,16,-4,14
FC Goa,9067,8,4,2,8,11,21,-10,14
Mumbai City,9068,1,7,4,3,17,8,9,25
Kerala Blast,9068,2,6,3,5,13,14,-1,21
Delhi Dynamo,9068,3,4,7,3,23,17,6,19
Kolkata,9068,4,4,6,4,14,15,-1,18
NorthEast Un,9068,5,5,3,6,11,12,-1,18
FC Pune City,9068,6,5,3,6,14,16,-2,18
FC Goa,9068,7,5,3,6,12,15,-3,18
Chennaiyin,9068,8,3,5,6,13,20,-7,14
Mumbai City,9069,1,6,4,4,16,10,6,22
Delhi Dynamo,9069,2,5,6,3,25,17,8,21
FC Pune City,9069,3,6,3,5,16,15,1,21
Kolkata,9069,4,4,6,4,15,17,-2,18
Chennaiyin,9069,5,4,6,4,15,18,-3,18
NorthEast Un,9069,6,4,5,5,12,12,0,17
FC Goa,9069,7,5,2,7,13,17,-4,17
Kerala Blast,9069,8,4,4,6,11,17,-6,16
Mumbai City,9070,1,7,4,3,22,9,13,25
Kolkata,9070,2,5,6,3,18,17,1,21
Kerala Blast,9070,3,6,3,5,11,14,-3,21
Delhi Dynamo,9070,4,5,5,4,25,22,3,20
NorthEast Un,9070,5,5,3,6,10,10,0,18
Chennaiyin,9070,6,4,6,4,15,18,-3,18
FC Pune City,9070,7,4,3,7,14,18,-4,15
FC Goa,9070,8,4,2,8,13,20,-7,14
Delhi Dynamo,9071,1,6,6,2,26,16,10,24
Mumbai City,9071,2,6,5,3,17,9,8,23
Kolkata,9071,3,4,7,3,16,14,2,19
NorthEast Un,9071,4,5,3,6,13,12,1,18
FC Goa,9071,5,5,2,7,12,17,-5,17
Kerala Blast,9071,6,4,5,5,10,17,-7,17
FC Pune City,9071,7,4,4,6,12,16,-4,16
Chennaiyin,9071,8,3,6,5,15,20,-5,15
Mumbai City,9072,1,6,5,3,19,11,8,23
Delhi Dynamo,9072,2,4,8,2,29,22,7,20
Kolkata,9072,3,4,8,2,18,15,3,20
Kerala Blast,9072,4,5,5,4,15,15,0,20
NorthEast Un,9072,5,5,4,5,15,13,2,19
FC Pune City,9072,6,4,4,6,13,19,-6,16
Chennaiyin,9072,7,3,6,5,16,22,-6,15
FC Goa,9072,8,3,4,7,12,20,-8,13
Mumbai City,9073,1,7,4,3,20,10,10,25
Delhi Dynamo,9073,2,5,6,3,29,21,8,21
Kerala Blast,9073,3,6,3,5,13,15,-2,21
Kolkata,9073,4,4,7,3,17,15,2,19
NorthEast Un,9073,5,5,3,6,11,12,-1,18
Chennaiyin,9073,6,4,5,5,14,18,-4,17
FC Pune City,9073,7,4,4,6,13,17,-4,16
FC Goa,9073,8,4,2,8,12,21,-9,14
Delhi Dynamo,9074,1,6,5,3,27,16,11,23
Mumbai City,9074,2,6,4,4,16,9,7,22
Kolkata,9074,3,3,9,2,16,15,1,18
Kerala Blast,9074,4,4,6,4,11,15,-4,18
FC Pune City,9074,5,4,5,5,13,15,-2,17
Chennaiyin,9074,6,3,7,4,15,19,-4,16
FC Goa,9074,7,4,4,6,12,16,-4,16
NorthEast Un,9074,8,4,4,6,9,14,-5,16
Delhi Dynamo,9075,1,6,6,2,27,17,10,24
Mumbai City,9075,2,6,5,3,17,9,8,23
Kerala Blast,9075,3,5,4,5,14,18,-4,19
NorthEast Un,9075,4,5,3,6,11,12,-1,18
Kolkata,9075,5,3,8,3,14,14,0,17
FC Pune City,9075,6,4,5,5,16,18,-2,17
Chennaiyin,9075,7,3,6,5,14,19,-5,15
FC Goa,9075,8,4,3,7,12,18,-6,15
Mumbai City,9076,1,7,4,3,19,10,9,25
Kolkata,9076,2,6,6,2,21,14,7,24
NorthEast Un,9076,3,6,2,6,15,11,4,20
Chennaiyin,9076,4,4,6,4,16,19,-3,18
FC Pune City,9076,5,5,3,6,15,18,-3,18
Delhi Dynamo,9076,6,4,5,5,24,24,0,17
FC Goa,9076,7,4,3,7,13,18,-5,15
Kerala Blast,9076,8,4,3,7,9,18,-9,15
Delhi Dynamo,9077,1,6,6,2,26,17,9,24
Mumbai City,9077,2,6,5,3,18,10,8,23
Kerala Blast,9077,3,6,4,4,16,17,-1,22
Kolkata,9077,4,3,8,3,14,14,0,17
FC Pune City,9077,5,4,5,5,14,16,-2,17
NorthEast Un,9077,6,5,2,7,11,13,-2,17
FC Goa,9077,7,4,3,7,13,19,-6,15
Chennaiyin,9077,8,3,5,6,16,22,-6,14
Delhi Dynamo,9078,1,5,7,2,24,16,8,22
Mumbai City,9078,2,6,4,4,16,9,7,22
Kerala Blast,9078,3,5,5,4,15,18,-3,20
Kolkata,9078,4,4,7,3,16,15,1,19
FC Goa,9078,5,5,3,6,13,15,-2,18
Chennaiyin,9078,6,4,5,5,14,20,-6,17
NorthEast Un,9078,7,4,4,6,12,13,-1,16
FC Pune City,9078,8,4,3,7,15,19,-4,15
Delhi Dynamo,9079,1,6,5,3,24,16,8,23
Mumbai City,9079,2,6,4,4,17,10,7,22
Kolkata,9079,3,5,6,3,16,14,2,21
FC Pune City,9079,4,6,3,5,15,14,1,21
Kerala Blast,9079,5,5,3,6,11,16,-5,18
FC Goa,9079,6,5,2,7,12,18,-6,17
NorthEast Un,9079,7,4,3,7,11,13,-2,15
Chennaiyin,9079,8,3,6,5,16,21,-5,15
Mumbai City,9080,1,6,5,3,16,8,8,23
Delhi Dynamo,9080,2,5,6,3,24,16,8,21
Kerala Blast,9080,3,6,3,5,14,17,-3,21
Kolkata,9080,4,4,7,3,16,15,1,19
FC Pune City,9080,5,5,4,5,15,15,0,19
NorthEast Un,9080,6,5,3,6,11,12,-1,18
Chennaiyin,9080,7,3,7,4,13,17,-4,16
FC Goa,9080,8,3,3,8,11,20,-9,12
Kerala Blast,9081,1,7,3,4,13,14,-1,24
Mumbai City,9081,2,6,4,4,16,9,7,22
Delhi Dynamo,9081,3,5,6,3,24,18,6,21
Kolkata,9081,4,5,6,3,19,15,4,21
Chennaiyin,9081,5,4,6,4,17,18,-1,18
NorthEast Un,9081,6,5,2,7,12,14,-2,17
FC Pune City,9081,7,4,3,7,14,19,-5,15
FC Goa,9081,8,3,4,7,11,19,-8,13
Mumbai City,9082,1,7,4,3,18,8,10,25
Delhi Dynamo,9082,2,6,5,3,28,18,10,23
Kolkata,9082,3,5,7,2,22,16,6,22
FC Pune City,9082,4,5,3,6,14,17,-3,18
Chennaiyin,9082,5,4,5,5,14,18,-4,17
NorthEast Un,9082,6,5,2,7,12,16,-4,17
FC Goa,9082,7,4,3,7,12,18,-6,15
Kerala Blast,9082,8,4,3,7,11,20,-9,15
Mumbai City,9083,1,7,4,3,20,10,10,25
NorthEast Un,9083,2,6,3,5,16,11,5,21
Delhi Dynamo,9083,3,5,5,4,27,21,6,20
Kolkata,9083,4,4,8,2,16,13,3,20
Kerala Blast,9083,5,4,6,4,11,15,-4,18
FC Pune City,9083,6,4,5,5,14,16,-2,17
Chennaiyin,9083,7,3,5,6,15,23,-8,14
FC Goa,9083,8,4,2,8,11,21,-10,14
Delhi Dynamo,9084,1,6,5,3,29,19,10,23
Mumbai City,9084,2,6,4,4,18,12,6,22
NorthEast Un,9084,3,6,3,5,16,13,3,21
Kerala Blast,9084,4,6,3,5,15,18,-3,21
Kolkata,9084,5,4,6,4,15,15,0,18
Chennaiyin,9084,6,3,7,4,16,20,-4,16
FC Pune City,9084,7,4,3,7,14,19,-5,15
FC Goa,9084,8,4,3,7,10,17,-7,15
Delhi Dynamo,9085,1,5,7,2,25,17,8,22
Mumbai City,9085,2,6,4,4,17,10,7,22
Kolkata,9085,3,5,6,3,16,14,2,21
Kerala Blast,9085,4,6,3,5,13,17,-4,21
FC Pune City,9085,5,5,3,6,15,16,-1,18
Chennaiyin,9085,6,4,6,4,16,18,-2,18
NorthEast Un,9085,7,4,3,7,9,12,-3,15
FC Goa,9085,8,3,4,7,11,18,-7,13
Delhi Dynamo,9086,1,6,6,2,25,16,9,24
Mumbai City,9086,2,6,4,4,16,9,7,22
FC Pune City,9086,3,5,4,5,15,16,-1,19
Kolkata,9086,4,4,7,3,16,18,-2,19
NorthEast Un,9086,5,5,3,6,11,12,-1,18
Kerala Blast,9086,6,5,3,6,14,16,-2,18
Chennaiyin,9086,7,4,5,5,16,20,-4,17
FC Goa,9086,8,4,2,8,13,19,-6,14
Delhi Dynamo,9087,1,6,6,2,26,16,10,24
Mumbai City,9087,2,6,4,4,16,10,6,22
Kerala Blast,9087,3,6,4,4,11,13,-2,22
FC Pune City,9087,4,5,3,6,15,15,0,18
NorthEast Un,9087,5,5,3,6,13,13,0,18
Kolkata,9087,6,3,8,3,13,15,-2,17
Chennaiyin,9087,7,4,5,5,15,19,-4,17
FC Goa,9087,8,3,3,8,8,16,-8,12
Delhi Dynamo,9088,1,6,6,2,28,17,11,24
Mumbai City,9088,2,6,4,4,16,10,6,22
Kolkata,9088,3,4,7,3,17,16,1,19
NorthEast Un,9088,4,5,4,5,13,12,1,19
FC Pune City,9088,5,5,4,5,15,16,-1,19
Kerala Blast,9088,6,4,4,6,10,16,-6,16
FC Goa,9088,7,4,3,7,15,19,-4,15
Chennaiyin,9088,8,3,6,5,14,22,-8,15
Mumbai City,9089,1,7,4,3,18,9,9,25
Kolkata,9089,2,5,7,2,19,14,5,22
Delhi Dynamo,9089,3,5,5,4,27,18,9,20
FC Pune City,9089,4,5,4,5,17,17,0,19
Kerala Blast,9089,5,5,3,6,12,18,-6,18
Chennaiyin,9089,6,3,7,4,13,17,-4,16
NorthEast Un,9089,7,4,3,7,9,15,-6,15
FC Goa,9089,8,4,3,7,10,17,-7,15
Mumbai City,9090,1,6,5,3,16,8,8,23
Delhi Dynamo,9090,2,5,7,2,23,15,8,22
Kolkata,9090,3,5,6,3,21,15,6,21
NorthEast Un,9090,4,5,4,5,12,10,2,19
FC Pune City,9090,5,5,3,6,15,17,-2,18
Kerala Blast,9090,6,5,3,6,12,22,-10,18
Chennaiyin,9090,7,3,7,4,15,19,-4,16
FC Goa,9090,8,3,3,8,12,20,-8,12
Delhi Dynamo,9091,1,6,5,3,27,15,12,23
Mumbai City,9091,2,6,4,4,16,10,6,22
Kolkata,9091,3,5,6,3,19,14,5,21
NorthEast Un,9091,4,6,2,6,12,11,1,20
Chennaiyin,9091,5,5,5,4,16,18,-2,20
Kerala Blast,9091,6,5,4,5,11,15,-4,19
FC Pune City,9091,7,4,4,6,12,16,-4,16
FC Goa,9091,8,3,2,9,8,22,-14,11
Delhi Dynamo,9092,1,6,6,2,25,14,11,24
Mumbai City,9092,2,6,4,4,16,10,6,22
FC Pune City,9092,3,5,4,5,17,18,-1,19
NorthEast Un,9092,4,5,3,6,12,13,-1,18
FC Goa,9092,5,5,3,6,11,14,-3,18
Kerala Blast,9092,6,5,3,6,14,18,-4,18
Kolkata,9092,7,3,7,4,14,16,-2,16
Chennaiyin,9092,8,3,6,5,15,21,-6,15
Mumbai City,9093,1,7,4,3,18,9,9,25
Kolkata,9093,2,5,7,2,16,13,3,22
Delhi Dynamo,9093,3,5,6,3,23,16,7,21
Kerala Blast,9093,4,5,4,5,11,15,-4,19
FC Pune City,9093,5,5,3,6,14,16,-2,18
Chennaiyin,9093,6,4,5,5,14,18,-4,17
NorthEast Un,9093,7,4,3,7,10,12,-2,15
FC Goa,9093,8,4,2,8,9,16,-7,14
Mumbai City,9094,1,7,4,3,19,8,11,25
NorthEast Un,9094,2,6,3,5,12,10,2,21
FC Goa,9094,3,6,2,6,13,16,-3,20
Kolkata,9094,4,4,7,3,19,16,3,19
FC Pune City,9094,5,5,3,6,14,17,-3,18
Delhi Dynamo,9094,6,4,5,5,23,21,2,17
Kerala Blast,9094,7,4,5,5,11,17,-6,17
Chennaiyin,9094,8,3,5,6,13,19,-6,14
Delhi Dynamo,9095,1,6,5,3,23,16,7,23
Mumbai City,9095,2,6,4,4,16,9,7,22
Kolkata,9095,3,5,6,3,19,15,4,21
Kerala Blast,9095,4,6,3,5,14,18,-4,21
NorthEast Un,9095,5,6,2,6,12,10,2,20
Chennaiyin,9095,6,3,6,5,14,19,-5,15
FC Pune City,9095,7,4,3,7,13,18,-5,15
FC Goa,9095,8,4,3,7,10,16,-6,15
Mumbai City,9096,1,7,4,3,18,8,10,25
Kerala Blast,9096,2,6,4,4,15,16,-1,22
Delhi Dynamo,9096,3,5,5,4,23,17,6,20
NorthEast Un,9096,4,5,2,7,10,11,-1,17
FC Pune City,9096,5,4,5,5,14,16,-2,17
Chennaiyin,9096,6,4,5,5,15,19,-4,17
FC Goa,9096,7,5,2,7,12,18,-6,17
Kolkata,9096,8,3,7,4,15,17,-2,16
Mumbai City,9097,1,6,5,3,17,9,8,23
Delhi Dynamo,9097,2,5,6,3,25,18,7,21
NorthEast Un,9097,3,6,3,5,13,9,4,21
Kolkata,9097,4,5,6,3,17,16,1,21
Kerala Blast,9097,5,5,4,5,13,14,-1,19
FC Pune City,9097,6,5,3,6,16,20,-4,18
Chennaiyin,9097,7,4,5,5,14,18,-4,17
FC Goa,9097,8,3,2,9,8,19,-11,11
Mumbai City,9098,1,7,4,3,19,9,10,25
Delhi Dynamo,9098,2,5,6,3,24,18,6,21
Kerala Blast,9098,3,6,3,5,13,15,-2,21
FC Pune City,9098,4,5,4,5,13,14,-1,19
Kolkata,9098,5,3,7,4,15,17,-2,16
NorthEast Un,9098,6,4,4,6,9,11,-2,16
Chennaiyin,9098,7,3,7,4,15,19,-4,16
FC Goa,9098,8,4,3,7,14,19,-5,15
Mumbai City,9099,1,6,5,3,17,9,8,23
Delhi Dynamo,9099,2,5,6,3,25,19,6,21
Kolkata,9099,3,5,6,3,17,15,2,21
Kerala Blast,9099,4,6,3,5,13,16,-3,21
NorthEast Un,9099,5,6,2,6,13,11,2,20
FC Pune City,9099,6,5,3,6,14,16,-2,18
Chennaiyin,9099,7,4,5,5,15,19,-4,17
FC Goa,9099,8,3,2,9,11,20,-9,11
Mumbai City,9100,1,7,4,3,18,9,9,25
Kerala Blast,9100,2,6,3,5,12,14,-2,21
NorthEast Un,9100,3,6,2,6,14,12,2,20
Kolkata,9100,4,4,7,3,15,15,0,19
Delhi Dynamo,9100,5,4,6,4,23,19,4,18
FC Goa,9100,6,4,4,6,13,17,-4,16
FC Pune City,9100,7,4,4,6,12,16,-4,16
Chennaiyin,9100,8,3,6,5,16,21,-5,15
Mumbai City,9101,1,6,5,3,18,10,8,23
Delhi Dynamo,9101,2,5,7,2,25,17,8,22
Kolkata,9101,3,5,7,2,19,15,4,22
Kerala Blast,9101,4,6,3,5,15,15,0,21
Chennaiyin,9101,5,4,5,5,17,20,-3,17
FC Goa,9101,6,4,4,6,12,17,-5,16
FC Pune City,9101,7,4,3,7,12,18,-6,15
NorthEast Un,9101,8,4,2,8,11,17,-6,14
Delhi Dynamo,9102,1,7,5,2,28,18,10,26
Mumbai City,9102,2,6,4,4,18,11,7,22
Kolkata,9102,3,4,8,2,19,16,3,20
Kerala Blast,9102,4,5,4,5,14,17,-3,19
FC Pune City,9102,5,5,3,6,14,17,-3,18
NorthEast Un,9102,6,5,2,7,14,14,0,17
Chennaiyin,9102,7,4,5,5,16,22,-6,17
FC Goa,9102,8,3,3,8,12,20,-8,12
Mumbai City,9103,1,7,4,3,19,8,11,25
Kerala Blast,9103,2,6,4,4,12,14,-2,22
Delhi Dynamo,9103,3,4,6,4,22,21,1,18
Kolkata,9103,4,4,6,4,16,16,0,18
NorthEast Un,9103,5,5,3,6,13,13,0,18
FC Goa,9103,6,5,3,6,14,16,-2,18
FC Pune City,9103,7,4,4,6,14,17,-3,16
Chennaiyin,9103,8,3,6,5,16,21,-5,15
Mumbai City,9104,1,7,4,3,17,8,9,25
Kolkata,9104,2,5,6,3,20,17,3,21
Delhi Dynamo,9104,3,5,5,4,24,18,6,20
Kerala Blast,9104,4,5,4,5,13,19,-6,19
Chennaiyin,9104,5,4,6,4,16,19,-3,18
FC Goa,9104,6,5,2,7,13,16,-3,17
FC Pune City,9104,7,4,4,6,13,16,-3,16
NorthEast Un,9104,8,4,3,7,12,15,-3,15
Mumbai City,9105,1,7,4,3,18,8,10,25
Kolkata,9105,2,5,7,2,18,14,4,22
NorthEast Un,9105,3,6,3,5,14,12,2,21
Delhi Dynamo,9105,4,4,6,4,22,18,4,18
FC Goa,9105,5,5,3,6,12,16,-4,18
Kerala Blast,9105,6,5,3,6,14,20,-6,18
FC Pune City,9105,7,4,3,7,16,20,-4,15
Chennaiyin,9105,8,3,5,6,15,21,-6,14
Mumbai City,9106,1,6,5,3,16,8,8,23
Kerala Blast,9106,2,6,3,5,18,16,2,21
Kolkata,9106,3,4,8,2,19,17,2,20
Delhi Dynamo,9106,4,4,7,3,24,19,5,19
FC Goa,9106,5,5,3,6,15,17,-2,18
NorthEast Un,9106,6,4,4,6,12,13,-1,16
FC Pune City,9106,7,4,4,6,13,21,-8,16
Chennaiyin,9106,8,3,6,5,14,20,-6,15
Delhi Dynamo,9107,1,6,5,3,23,16,7,23
Mumbai City,9107,2,6,4,4,16,9,7,22
NorthEast Un,9107,3,6,3,5,13,9,4,21
Kolkata,9107,4,5,6,3,17,14,3,21
FC Pune City,9107,5,5,3,6,13,16,-3,18
Kerala Blast,9107,6,5,3,6,11,17,-6,18
Chennaiyin,9107,7,3,7,4,13,17,-4,16
FC Goa,9107,8,3,3,8,8,16,-8,12
Delhi Dynamo,9108,1,7,5,2,28,15,13,26
Mumbai City,9108,2,6,4,4,16,11,5,22
FC Pune City,9108,3,6,3,5,17,15,2,21
Chennaiyin,9108,4,5,5,4,19,18,1,20
Kolkata,9108,5,4,6,4,17,20,-3,18
Kerala Blast,9108,6,5,3,6,13,17,-4,18
FC Goa,9108,7,4,2,8,13,20,-7,14
NorthEast Un,9108,8,4,2,8,10,17,-7,14
Delhi Dynamo,9109,1,6,6,2,29,18,11,24
Mumbai City,9109,2,6,5,3,17,9,8,23
Kerala Blast,9109,3,6,3,5,13,14,-1,21
Kolkata,9109,4,4,7,3,15,15,0,19
FC Goa,9109,5,5,2,7,12,16,-4,17
NorthEast Un,9109,6,5,2,7,14,19,-5,17
FC Pune City,9109,7,4,4,6,12,15,-3,16
Chennaiyin,9109,8,3,5,6,14,20,-6,14
Mumbai City,9110,1,6,5,3,16,8,8,23
NorthEast Un,9110,2,6,3,5,12,10,2,21
Delhi Dynamo,9110,3,4,7,3,23,17,6,19
Kolkata,9110,4,4,7,3,17,16,1,19
Kerala Blast,9110,5,5,3,6,12,15,-3,18
FC Pune City,9110,6,5,3,6,13,17,-4,18
FC Goa,9110,7,4,4,6,11,16,-5,16
Chennaiyin,9110,8,3,6,5,13,18,-5,15
Mumbai City,9111,1,7,4,3,19,9,10,25
Kolkata,9111,2,5,7,2,16,13,3,22
NorthEast Un,9111,3,6,3,5,14,12,2,21
Delhi Dynamo,9111,4,5,5,4,27,20,7,20
Kerala Blast,9111,5,5,4,5,13,17,-4,19
Chennaiyin,9111,6,4,6,4,15,18,-3,18
FC Pune City,9111,7,4,3,7,13,17,-4,15
FC Goa,9111,8,3,2,9,9,20,-11,11
Delhi Dynamo,9112,1,5,7,2,26,18,8,22
Mumbai City,9112,2,6,4,4,17,10,7,22
Kolkata,9112,3,5,6,3,16,15,1,21
FC Pune City,9112,4,5,4,5,15,15,0,19
Kerala Blast,9112,5,5,4,5,13,17,-4,19
NorthEast Un,9112,6,5,3,6,14,14,0,18
Chennaiyin,9112,7,4,5,5,15,19,-4,17
FC Goa,9112,8,3,3,8,9,17,-8,12
Mumbai City,9113,1,7,4,3,18,8,10,25
Delhi Dynamo,9113,2,5,5,4,24,19,5,20
Kolkata,9113,3,4,8,2,16,14,2,20
NorthEast Un,9113,4,6,2,6,14,13,1,20
Chennaiyin,9113,5,5,5,4,17,19,-2,20
Kerala Blast,9113,6,5,4,5,13,17,-4,19
FC Pune City,9113,7,4,4,6,14,17,-3,16
FC Goa,9113,8,3,2,9,10,19,-9,11
Mumbai City,9114,1,7,4,3,18,8,10,25
NorthEast Un,9114,2,6,3,5,16,12,4,21
Kolkata,9114,3,4,7,3,18,16,2,19
Delhi Dynamo,9114,4,4,6,4,22,20,2,18
Chennaiyin,9114,5,4,6,4,16,18,-2,18
FC Pune City,9114,6,5,3,6,16,19,-3,18
Kerala Blast,9114,7,4,4,6,15,21,-6,16
FC Goa,9114,8,4,3,7,10,17,-7,15
Mumbai City,9115,1,7,4,3,19,8,11,25
NorthEast Un,9115,2,6,3,5,14,11,3,21
FC Pune City,9115,3,6,3,5,17,16,1,21
Delhi Dynamo,9115,4,4,6,4,22,19,3,18
Kerala Blast,9115,5,4,5,5,15,20,-5,17
FC Goa,9115,6,4,4,6,11,14,-3,16
Kolkata,9115,7,3,7,4,16,20,-4,16
Chennaiyin,9115,8,3,6,5,13,19,-6,15
Mumbai City,9116,1,7,4,3,17,8,9,25
Kolkata,9116,2,5,7,2,19,15,4,22
Delhi Dynamo,9116,3,5,6,3,24,17,7,21
NorthEast Un,9116,4,5,4,5,10,9,1,19
FC Pune City,9116,5,5,3,6,14,15,-1,18
Chennaiyin,9116,6,3,7,4,13,17,-4,16
Kerala Blast,9116,7,4,4,6,12,19,-7,16
FC Goa,9116,8,3,3,8,10,19,-9,12
Mumbai City,9117,1,7,4,3,18,8,10,25
Delhi Dynamo,9117,2,6,5,3,27,17,10,23
FC Pune City,9117,3,5,4,5,16,17,-1,19
Kerala Blast,9117,4,5,4,5,14,18,-4,19
NorthEast Un,9117,5,5,3,6,13,13,0,18
Chennaiyin,9117,6,4,5,5,14,19,-5,17
Kolkata,9117,7,3,7,4,17,18,-1,16
FC Goa,9117,8,4,2,8,9,18,-9,14
Mumbai City,9118,1,6,5,3,18,10,8,23
Kerala Blast,9118,2,6,4,4,14,14,0,22
Delhi Dynamo,9118,3,5,6,3,25,18,7,21
Kolkata,9118,4,3,8,3,14,15,-1,17
FC Pune City,9118,5,4,5,5,13,15,-2,17
NorthEast Un,9118,6,5,2,7,12,14,-2,17
Chennaiyin,9118,7,4,5,5,16,20,-4,17
FC Goa,9118,8,4,3,7,11,17,-6,15
Mumbai City,9119,1,6,5,3,18,10,8,23
Delhi Dynamo,9119,2,5,7,2,27,17,10,22
Kerala Blast,9119,3,5,5,4,11,14,-3,20
Kolkata,9119,4,3,8,3,15,15,0,17
FC Pune City,9119,5,4,5,5,14,16,-2,17
FC Goa,9119,6,5,2,7,14,17,-3,17
NorthEast Un,9119,7,4,4,6,11,12,-1,16
Chennaiyin,9119,8,3,6,5,13,22,-9,15
Mumbai City,9120,1,6,5,3,16,8,8,23
Delhi Dynamo,9120,2,5,7,2,26,16,10,22
Kolkata,9120,3,5,7,2,17,12,5,22
Kerala Blast,9120,4,6,4,4,16,14,2,22
NorthEast Un,9120,5,4,4,6,12,15,-3,16
Chennaiyin,9120,6,3,6,5,14,19,-5,15
FC Pune City,9120,7,4,3,7,13,19,-6,15
FC Goa,9120,8,4,2,8,9,20,-11,14
Mumbai City,9121,1,6,5,3,17,9,8,23
Delhi Dynamo,9121,2,5,7,2,25,16,9,22
Kerala Blast,9121,3,6,4,4,13,14,-1,22
Kolkata,9121,4,4,7,3,16,14,2,19
NorthEast Un,9121,5,5,4,5,13,11,2,19
FC Pune City,9121,6,4,3,7,13,19,-6,15
FC Goa,9121,7,4,3,7,10,16,-6,15
Chennaiyin,9121,8,3,5,6,13,21,-8,14
Mumbai City,9122,1,6,4,4,16,9,7,22
Kolkata,9122,2,5,7,2,19,16,3,22
Kerala Blast,9122,3,6,3,5,13,15,-2,21
Delhi Dynamo,9122,4,5,5,4,24,18,6,20
NorthEast Un,9122,5,5,3,6,11,11,0,18
Chennaiyin,9122,6,3,7,4,13,17,-4,16
FC Goa,9122,7,4,4,6,12,17,-5,16
FC Pune City,9122,8,4,3,7,13,18,-5,15
Mumbai City,9123,1,7,4,3,17,8,9,25
Kolkata,9123,2,5,7,2,22,17,5,22
NorthEast Un,9123,3,6,2,6,15,11,4,20
Chennaiyin,9123,4,4,6,4,15,18,-3,18
Kerala Blast,9123,5,5,3,6,12,20,-8,18
Delhi Dynamo,9123,6,4,5,5,23,20,3,17
FC Goa,9123,7,4,4,6,13,18,-5,16
FC Pune City,9123,8,4,3,7,14,19,-5,15
Mumbai City,9124,1,7,4,3,18,8,10,25
Delhi Dynamo,9124,2,5,6,3,25,18,7,21
Kolkata,9124,3,5,6,3,19,15,4,21
FC Pune City,9124,4,5,4,5,14,15,-1,19
Kerala Blast,9124,5,5,4,5,13,17,-4,19
Chennaiyin,9124,6,4,5,5,16,20,-4,17
NorthEast Un,9124,7,4,3,7,12,16,-4,15
FC Goa,9124,8,4,2,8,11,19,-8,14
Delhi Dynamo,9125,1,6,6,2,28,16,12,24
Mumbai City,9125,2,6,4,4,16,12,4,22
FC Pune City,9125,3,5,4,5,14,15,-1,19
Kerala Blast,9125,4,5,4,5,14,17,-3,19
FC Goa,9125,5,5,3,6,13,16,-3,18
NorthEast Un,9125,6,5,2,7,13,14,-1,17
Chennaiyin,9125,7,4,5,5,16,20,-4,17
Kolkata,9125,8,3,6,5,14,18,-4,15
Delhi Dynamo,9126,1,6,6,2,24,15,9,24
Mumbai City,9126,2,6,4,4,16,9,7,22
Kolkata,9126,3,5,6,3,16,15,1,21
Chennaiyin,9126,4,5,5,4,18,17,1,20
Kerala Blast,9126,5,5,4,5,15,18,-3,19
NorthEast Un,9126,6,4,4,6,12,13,-1,16
FC Pune City,9126,7,4,3,7,13,18,-5,15
FC Goa,9126,8,4,2,8,10,19,-9,14
Delhi Dynamo,9127,1,6,6,2,27,16,11,24
Mumbai City,9127,2,6,4,4,16,9,7,22
Kolkata,9127,3,4,8,2,16,14,2,20
FC Pune City,9127,4,5,4,5,14,15,-1,19
NorthEast Un,9127,5,5,3,6,11,11,0,18
Kerala Blast,9127,6,5,3,6,11,16,-5,18
Chennaiyin,9127,7,4,5,5,15,18,-3,17
FC Goa,9127,8,3,3,8,9,20,-11,12
Delhi Dynamo,9128,1,5,7,2,26,18,8,22
Mumbai City,9128,2,6,4,4,18,11,7,22
Kolkata,9128,3,5,6,3,19,15,4,21
Kerala Blast,9128,4,5,4,5,12,17,-5,19
FC Pune City,9128,5,5,3,6,14,16,-2,18
Chennaiyin,9128,6,4,5,5,17,20,-3,17
NorthEast Un,9128,7,4,4,6,11,13,-2,16
FC Goa,9128,8,4,3,7,12,19,-7,15
Delhi Dynamo,9129,1,6,6,2,28,16,12,24
Mumbai City,9129,2,6,5,3,17,9,8,23
FC Pune City,9129,3,6,3,5,17,14,3,21
Chennaiyin,9129,4,5,5,4,17,19,-2,20
Kolkata,9129,5,4,7,3,14,15,-1,19
Kerala Blast,9129,6,5,4,5,11,16,-5,19
NorthEast Un,9129,7,4,2,8,12,17,-5,14
FC Goa,9129,8,3,2,9,9,19,-10,11
Mumbai City,9130,1,6,5,3,17,9,8,23
Delhi Dynamo,9130,2,5,7,2,27,16,11,22
Kolkata,9130,3,4,7,3,17,15,2,19
FC Pune City,9130,4,5,4,5,15,16,-1,19
Chennaiyin,9130,5,4,6,4,16,18,-2,18
Kerala Blast,9130,6,4,5,5,12,18,-6,17
NorthEast Un,9130,7,4,4,6,12,14,-2,16
FC Goa,9130,8,3,4,7,10,20,-10,13
Mumbai City,9131,1,7,4,3,17,8,9,25
Delhi Dynamo,9131,2,5,6,3,23,16,7,21
Kolkata,9131,3,5,6,3,17,15,2,21
Kerala Blast,9131,4,5,4,5,13,15,-2,19
NorthEast Un,9131,5,5,3,6,10,10,0,18
FC Goa,9131,6,5,3,6,13,15,-2,18
FC Pune City,9131,7,4,3,7,13,21,-8,15
Chennaiyin,9131,8,3,5,6,13,19,-6,14
Mumbai City,9132,1,6,4,4,16,9,7,22
Delhi Dynamo,9132,2,5,6,3,26,19,7,21
Kolkata,9132,3,4,7,3,14,15,-1,19
NorthEast Un,9132,4,5,3,6,13,13,0,18
FC Goa,9132,5,5,3,6,15,16,-1,18
FC Pune City,9132,6,5,3,6,14,15,-1,18
Chennaiyin,9132,7,4,5,5,15,20,-5,17
Kerala Blast,9132,8,4,5,5,9,15,-6,17
Mumbai City,9133,1,7,4,3,19,8,11,25
Kolkata,9133,2,5,6,3,19,17,2,21
Delhi Dynamo,9133,3,5,5,4,23,19,4,20
NorthEast Un,9133,4,6,2,6,14,12,2,20
FC Goa,9133,5,6,2,6,13,15,-2,20
Kerala Blast,9133,6,5,3,6,12,17,-5,18
FC Pune City,9133,7,4,3,7,15,19,-4,15
Chennaiyin,9133,8,3,5,6,14,22,-8,14
Delhi Dynamo,9134,1,6,5,3,25,18,7,23
Mumbai City,9134,2,6,4,4,17,10,7,22
Chennaiyin,9134,3,5,5,4,20,19,1,20
NorthEast Un,9134,4,6,2,6,14,13,1,20
FC Pune City,9134,5,5,4,5,18,15,3,19
Kolkata,9134,6,3,9,2,15,14,1,18
Kerala Blast,9134,7,4,4,6,10,21,-11,16
FC Goa,9134,8,3,3,8,10,19,-9,12
Mumbai City,9135,1,6,5,3,17,9,8,23
Delhi Dynamo,9135,2,5,6,3,25,18,7,21
Kolkata,9135,3,5,6,3,18,15,3,21
Kerala Blast,9135,4,5,5,4,12,15,-3,20
NorthEast Un,9135,5,5,3,6,13,13,0,18
Chennaiyin,9135,6,4,5,5,17,20,-3,17
FC Pune City,9135,7,4,4,6,14,17,-3,16
FC Goa,9135,8,4,2,8,12,21,-9,14
Mumbai City,9136,1,6,5,3,18,10,8,23
Delhi Dynamo,9136,2,5,7,2,26,18,8,22
Kolkata,9136,3,5,6,3,19,14,5,21
Kerala Blast,9136,4,5,4,5,11,18,-7,19
Chennaiyin,9136,5,4,6,4,15,18,-3,18
FC Pune City,9136,6,4,4,6,13,17,-4,16
NorthEast Un,9136,7,4,3,7,11,13,-2,15
FC Goa,9136,8,4,3,7,11,16,-5,15
Delhi Dynamo,9137,1,6,5,3,27,16,11,23
Mumbai City,9137,2,6,4,4,17,12,5,22
FC Goa,9137,3,6,2,6,14,17,-3,20
FC Pune City,9137,4,5,4,5,14,15,-1,19
Kolkata,9137,5,4,6,4,20,18,2,18
NorthEast Un,9137,6,5,3,6,13,13,0,18
Kerala Blast,9137,7,4,4,6,12,21,-9,16
Chennaiyin,9137,8,3,6,5,16,21,-5,15
Mumbai City,9138,1,7,4,3,17,8,9,25
Delhi Dynamo,9138,2,5,6,3,26,17,9,21
NorthEast Un,9138,3,5,4,5,12,11,1,19
FC Pune City,9138,4,5,4,5,15,16,-1,19
Kerala Blast,9138,5,5,4,5,12,16,-4,19
Chennaiyin,9138,6,4,5,5,17,19,-2,17
Kolkata,9138,7,3,7,4,15,16,-1,16
FC Goa,9138,8,4,2,8,10,21,-11,14
Mumbai City,9139,1,7,4,3,21,8,13,25
Kerala Blast,9139,2,6,4,4,12,14,-2,22
Delhi Dynamo,9139,3,5,6,3,25,21,4,21
Kolkata,9139,4,4,8,2,16,14,2,20
Chennaiyin,9139,5,4,5,5,14,18,-4,17
NorthEast Un,9139,6,4,3,7,11,13,-2,15
FC Pune City,9139,7,4,3,7,13,17,-4,15
FC Goa,9139,8,4,3,7,11,18,-7,15
Delhi Dynamo,9140,1,6,5,3,28,21,7,23
Mumbai City,9140,2,6,4,4,18,11,7,22
NorthEast Un,9140,3,6,2,6,15,13,2,20
Kolkata,9140,4,4,7,3,16,15,1,19
FC Pune City,9140,5,5,4,5,14,15,-1,19
Chennaiyin,9140,6,4,5,5,15,18,-3,17
Kerala Blast,9140,7,4,4,6,12,18,-6,16
FC Goa,9140,8,4,3,7,11,18,-7,15
Kolkata,9141,1,6,6,2,18,14,4,24
Delhi Dynamo,9141,2,6,5,3,30,19,11,23
Mumbai City,9141,3,6,4,4,18,12,6,22
NorthEast Un,9141,4,5,4,5,13,12,1,19
Chennaiyin,9141,5,4,6,4,18,17,1,18
FC Pune City,9141,6,5,3,6,15,16,-1,18
Kerala Blast,9141,7,4,4,6,13,20,-7,16
FC Goa,9141,8,3,2,9,8,23,-15,11
Mumbai City,9142,1,7,4,3,17,8,9,25
Kolkata,9142,2,6,6,2,24,16,8,24
Delhi Dynamo,9142,3,6,5,3,26,16,10,23
Kerala Blast,9142,4,5,4,5,14,18,-4,19
Chennaiyin,9142,5,4,5,5,15,20,-5,17
NorthEast Un,9142,6,4,3,7,11,13,-2,15
FC Pune City,9142,7,4,3,7,13,20,-7,15
FC Goa,9142,8,4,2,8,12,21,-9,14
Mumbai City,9143,1,7,4,3,20,9,11,25
Delhi Dynamo,9143,2,5,6,3,27,21,6,21
Chennaiyin,9143,3,5,5,4,17,18,-1,20
Kolkata,9143,4,4,7,3,16,15,1,19
FC Pune City,9143,5,5,4,5,14,15,-1,19
Kerala Blast,9143,6,5,3,6,10,15,-5,18
NorthEast Un,9143,7,4,3,7,12,15,-3,15
FC Goa,9143,8,4,2,8,11,19,-8,14
Delhi Dynamo,9144,1,6,5,3,26,16,10,23
Mumbai City,9144,2,6,4,4,16,9,7,22
NorthEast Un,9144,3,6,2,6,13,12,1,20
Chennaiyin,9144,4,5,5,4,17,19,-2,20
Kolkata,9144,5,4,7,3,16,16,0,19
Kerala Blast,9144,6,5,4,5,12,15,-3,19
FC Pune City,9144,7,4,4,6,13,16,-3,16
FC Goa,9144,8,3,3,8,11,21,-10,12
Mumbai City,9145,1,6,4,4,17,10,7,22
NorthEast Un,9145,2,6,3,5,12,10,2,21
Delhi Dynamo,9145,3,5,5,4,25,19,6,20
Kolkata,9145,4,4,7,3,17,16,1,19
FC Pune City,9145,5,5,3,6,14,16,-2,18
FC Goa,9145,6,5,3,6,14,17,-3,18
Kerala Blast,9145,7,5,3,6,10,15,-5,18
Chennaiyin,9145,8,3,6,5,13,19,-6,15
Mumbai City,9146,1,7,4,3,18,8,10,25
Kerala Blast,9146,2,6,4,4,15,15,0,22
NorthEast Un,9146,3,6,3,5,14,10,4,21
Kolkata,9146,4,5,6,3,18,15,3,21
Delhi Dynamo,9146,5,4,6,4,23,20,3,18
Chennaiyin,9146,6,3,6,5,13,19,-6,15
FC Pune City,9146,7,4,3,7,13,20,-7,15
FC Goa,9146,8,3,4,7,10,17,-7,13
Mumbai City,9147,1,7,4,3,17,8,9,25
Kolkata,9147,2,5,7,2,16,12,4,22
Delhi Dynamo,9147,3,5,6,3,22,15,7,21
Kerala Blast,9147,4,5,4,5,11,16,-5,19
NorthEast Un,9147,5,5,2,7,11,12,-1,17
Chennaiyin,9147,6,4,5,5,15,19,-4,17
FC Pune City,9147,7,4,3,7,13,18,-5,15
FC Goa,9147,8,4,3,7,10,15,-5,15
Delhi Dynamo,9148,1,6,5,3,26,17,9,23
Mumbai City,9148,2,6,4,4,16,10,6,22
FC Pune City,9148,3,5,4,5,15,16,-1,19
Kerala Blast,9148,4,5,4,5,12,16,-4,19
NorthEast Un,9148,5,5,3,6,12,12,0,18
FC Goa,9148,6,5,3,6,15,18,-3,18
Kolkata,9148,7,3,7,4,17,18,-1,16
Chennaiyin,9148,8,3,6,5,15,21,-6,15
Delhi Dynamo,9149,1,6,5,3,26,17,9,23
Mumbai City,9149,2,6,4,4,18,12,6,22
FC Pune City,9149,3,6,3,5,16,15,1,21
Kerala Blast,9149,4,6,3,5,12,15,-3,21
Kolkata,9149,5,4,6,4,16,16,0,18
Chennaiyin,9149,6,4,5,5,15,20,-5,17
FC Goa,9149,7,5,2,7,12,17,-5,17
NorthEast Un,9149,8,4,2,8,10,13,-3,14
Mumbai City,9150,1,7,4,3,20,8,12,25
Kolkata,9150,2,6,6,2,20,13,7,24
Delhi Dynamo,9150,3,5,6,3,23,19,4,21
Chennaiyin,9150,4,5,5,4,17,17,0,20
Kerala Blast,9150,5,5,4,5,11,16,-5,19
NorthEast Un,9150,6,4,4,6,10,12,-2,16
FC Pune City,9150,7,4,3,7,12,18,-6,15
FC Goa,9150,8,3,2,9,10,20,-10,11
Mumbai City,9151,1,6,5,3,17,9,8,23
Delhi Dynamo,9151,2,5,6,3,26,18,8,21
Kerala Blast,9151,3,5,5,4,11,14,-3,20
Kolkata,9151,4,4,7,3,18,15,3,19
NorthEast Un,9151,5,5,2,7,11,12,-1,17
Chennaiyin,9151,6,4,5,5,15,19,-4,17
FC Goa,9151,7,5,2,7,13,19,-6,17
FC Pune City,9151,8,4,4,6,14,19,-5,16
Mumbai City,9152,1,7,4,3,18,9,9,25
NorthEast Un,9152,2,6,3,5,14,10,4,21
Delhi Dynamo,9152,3,5,5,4,25,20,5,20
Kolkata,9152,4,4,8,2,16,13,3,20
FC Pune City,9152,5,4,5,5,12,14,-2,17
Chennaiyin,9152,6,3,7,4,15,19,-4,16
Kerala Blast,9152,7,4,4,6,9,17,-8,16
FC Goa,9152,8,3,4,7,12,19,-7,13
Delhi Dynamo,9153,1,6,5,3,24,16,8,23
Mumbai City,9153,2,6,4,4,16,9,7,22
Kolkata,9153,3,5,6,3,16,13,3,21
NorthEast Un,9153,4,6,3,5,13,11,2,21
FC Pune City,9153,5,5,3,6,14,17,-3,18
FC Goa,9153,6,5,2,7,11,15,-4,17
Kerala Blast,9153,7,4,4,6,11,17,-6,16
Chennaiyin,9153,8,3,5,6,13,20,-7,14
Delhi Dynamo,9154,1,7,5,2,27,17,10,26
Mumbai City,9154,2,6,4,4,18,11,7,22
FC Pune City,9154,3,6,3,5,16,15,1,21
Chennaiyin,9154,4,5,5,4,16,17,-1,20
Kerala Blast,9154,5,5,4,5,14,18,-4,19
NorthEast Un,9154,6,4,3,7,11,13,-2,15
Kolkata,9154,7,3,6,5,14,17,-3,15
FC Goa,9154,8,4,2,8,9,17,-8,14
Delhi Dynamo,9155,1,6,6,2,25,16,9,24
Mumbai City,9155,2,6,4,4,18,11,7,22
NorthEast Un,9155,3,6,3,5,13,10,3,21
Kolkata,9155,4,4,8,2,18,15,3,20
Chennaiyin,9155,5,4,5,5,15,19,-4,17
Kerala Blast,9155,6,4,5,5,12,17,-5,17
FC Pune City,9155,7,4,4,6,14,18,-4,16
FC Goa,9155,8,3,3,8,9,18,-9,12
Mumbai City,9156,1,6,5,3,17,9,8,23
Kerala Blast,9156,2,6,4,4,15,16,-1,22
Delhi Dynamo,9156,3,4,7,3,23,18,5,19
NorthEast Un,9156,4,5,3,6,12,11,1,18
Kolkata,9156,5,3,8,3,17,19,-2,17
FC Goa,9156,6,4,4,6,13,16,-3,16
Chennaiyin,9156,7,3,7,4,15,19,-4,16
FC Pune City,9156,8,4,4,6,13,17,-4,16
Mumbai City,9157,1,7,4,3,18,8,10,25
Delhi Dynamo,9157,2,6,5,3,28,18,10,23
Kolkata,9157,3,5,7,2,17,14,3,22
Kerala Blast,9157,4,5,4,5,12,16,-4,19
Chennaiyin,9157,5,4,5,5,15,21,-6,17
FC Pune City,9157,6,4,4,6,13,16,-3,16
FC Goa,9157,7,4,3,7,15,22,-7,15
NorthEast Un,9157,8,4,2,8,9,12,-3,14
Mumbai City,9158,1,7,4,3,17,8,9,25
Kerala Blast,9158,2,7,3,4,13,13,0,24
FC Goa,9158,3,6,2,6,14,16,-2,20
NorthEast Un,9158,4,5,3,6,11,11,0,18
FC Pune City,9158,5,5,3,6,14,17,-3,18
Delhi Dynamo,9158,6,4,5,5,23,20,3,17
Kolkata,9158,7,3,6,5,14,16,-2,15
Chennaiyin,9158,8,3,6,5,14,19,-5,15
Mumbai City,9159,1,6,5,3,17,9,8,23
Delhi Dynamo,9159,2,5,6,3,23,17,6,21
Kolkata,9159,3,5,6,3,15,13,2,21
NorthEast Un,9159,4,5,3,6,13,12,1,18
FC Pune City,9159,5,5,3,6,16,17,-1,18
FC Goa,9159,6,5,3,6,14,17,-3,18
Kerala Blast,9159,7,4,4,6,12,19,-7,16
Chennaiyin,9159,8,3,6,5,17,23,-6,15
Mumbai City,9160,1,7,4,3,17,8,9,25
Delhi Dynamo,9160,2,5,6,3,23,16,7,21
FC Pune City,9160,3,5,4,5,15,15,0,19
Kolkata,9160,3,4,7,3,15,15,0,19
NorthEast Un,9160,5,5,2,7,11,12,-1,17
Chennaiyin,9160,6,4,5,5,17,21,-4,17
Kerala Blast,9160,7,4,5,5,10,15,-5,17
FC Goa,9160,8,4,3,7,13,19,-6,15
Mumbai City,9161,1,7,4,3,19,9,10,25
Kerala Blast,9161,2,6,3,5,15,18,-3,21
Delhi Dynamo,9161,3,4,7,3,23,18,5,19
Kolkata,9161,4,4,7,3,17,15,2,19
Chennaiyin,9161,5,4,6,4,15,18,-3,18
FC Pune City,9161,6,5,3,6,14,17,-3,18
NorthEast Un,9161,7,4,3,7,10,12,-2,15
FC Goa,9161,8,3,5,6,10,16,-6,14
Mumbai City,9162,1,7,4,3,17,8,9,25
Delhi Dynamo,9162,2,6,5,3,23,15,8,23
Kolkata,9162,3,4,7,3,16,15,1,19
FC Pune City,9162,4,5,4,5,14,15,-1,19
Kerala Blast,9162,5,5,4,5,13,17,-4,19
Chennaiyin,9162,6,4,5,5,17,20,-3,17
FC Goa,9162,7,4,3,7,12,18,-6,15
NorthEast Un,9162,8,4,2,8,10,14,-4,14
Delhi Dynamo,9163,1,7,5,2,26,16,10,26
Mumbai City,9163,2,6,4,4,16,9,7,22
Kolkata,9163,3,4,8,2,17,14,3,20
FC Pune City,9163,4,5,4,5,16,17,-1,19
NorthEast Un,9163,5,5,3,6,13,13,0,18
Kerala Blast,9163,6,4,5,5,13,18,-5,17
Chennaiyin,9163,7,3,6,5,13,18,-5,15
FC Goa,9163,8,3,3,8,10,19,-9,12
Delhi Dynamo,9164,1,6,6,2,24,15,9,24
Mumbai City,9164,2,6,5,3,17,9,8,23
Kolkata,9164,3,5,6,3,22,16,6,21
Kerala Blast,9164,4,6,3,5,13,20,-7,21
NorthEast Un,9164,5,5,2,7,13,14,-1,17
FC Goa,9164,6,5,2,7,13,16,-3,17
FC Pune City,9164,7,4,3,7,14,20,-6,15
Chennaiyin,9164,8,3,5,6,16,22,-6,14
Mumbai City,9165,1,7,4,3,21,11,10,25
Delhi Dynamo,9165,2,6,5,3,26,19,7,23
Kolkata,9165,3,4,8,2,15,13,2,20
NorthEast Un,9165,4,5,3,6,12,11,1,18
FC Pune City,9165,5,4,5,5,13,15,-2,17
Chennaiyin,9165,6,3,7,4,14,18,-4,16
Kerala Blast,9165,7,4,4,6,10,17,-7,16
FC Goa,9165,8,3,4,7,9,16,-7,13
Mumbai City,9166,1,6,5,3,16,8,8,23
NorthEast Un,9166,2,7,2,5,14,10,4,23
Kolkata,9166,3,5,6,3,16,13,3,21
Delhi Dynamo,9166,4,4,7,3,22,16,6,19
FC Pune City,9166,5,5,3,6,13,15,-2,18
Chennaiyin,9166,6,4,5,5,15,20,-5,17
FC Goa,9166,7,4,3,7,11,17,-6,15
Kerala Blast,9166,8,4,3,7,10,18,-8,15
Mumbai City,9167,1,6,5,3,17,9,8,23
Kerala Blast,9167,2,6,4,4,14,14,0,22
Delhi Dynamo,9167,3,5,6,3,25,17,8,21
Kolkata,9167,4,5,6,3,19,15,4,21
Chennaiyin,9167,5,5,5,4,18,18,0,20
NorthEast Un,9167,6,5,2,7,10,13,-3,17
FC Pune City,9167,7,4,4,6,14,18,-4,16
FC Goa,9167,8,3,2,9,11,24,-13,11
Kerala Blast,9168,1,7,3,4,16,16,0,24
Mumbai City,9168,2,6,5,3,18,10,8,23
Delhi Dynamo,9168,3,4,8,2,24,17,7,20
FC Pune City,9168,4,5,3,6,14,16,-2,18
NorthEast Un,9168,5,4,4,6,11,13,-2,16
Chennaiyin,9168,6,3,7,4,14,18,-4,16
FC Goa,9168,7,4,4,6,10,15,-5,16
Kolkata,9168,8,3,6,5,16,18,-2,15
Mumbai City,9169,1,7,4,3,19,8,11,25
Delhi Dynamo,9169,2,5,6,3,24,18,6,21
Kolkata,9169,3,5,6,3,18,16,2,21
FC Pune City,9169,4,5,4,5,15,15,0,19
Kerala Blast,9169,5,5,4,5,12,17,-5,19
NorthEast Un,9169,6,5,2,7,10,12,-2,17
Chennaiyin,9169,7,4,5,5,16,19,-3,17
FC Goa,9169,8,3,3,8,11,20,-9,12
Mumbai City,9170,1,7,4,3,19,9,10,25
Kolkata,9170,2,5,7,2,19,14,5,22
Kerala Blast,9170,3,6,3,5,17,17,0,21
Chennaiyin,9170,4,5,5,4,16,17,-1,20
Delhi Dynamo,9170,5,4,6,4,26,22,4,18
NorthEast Un,9170,6,5,2,7,13,15,-2,17
FC Pune City,9170,7,4,3,7,14,23,-9,15
FC Goa,9170,8,3,4,7,11,18,-7,13
Mumbai City,9171,1,6,5,3,17,9,8,23
Kolkata,9171,2,5,7,2,21,17,4,22
Delhi Dynamo,9171,3,4,8,2,23,16,7,20
Kerala Blast,9171,4,5,5,4,15,18,-3,20
NorthEast Un,9171,5,5,4,5,13,12,1,19
Chennaiyin,9171,6,4,5,5,16,20,-4,17
FC Pune City,9171,7,4,3,7,14,18,-4,15
FC Goa,9171,8,3,3,8,10,19,-9,12
Delhi Dynamo,9172,1,6,6,2,31,16,15,24
Kolkata,9172,2,5,7,2,18,14,4,22
Mumbai City,9172,3,6,4,4,17,13,4,22
FC Pune City,9172,4,5,3,6,16,16,0,18
Chennaiyin,9172,5,4,5,5,15,21,-6,17
NorthEast Un,9172,6,4,4,6,11,12,-1,16
Kerala Blast,9172,7,4,4,6,11,20,-9,16
FC Goa,9172,8,4,3,7,12,19,-7,15
Mumbai City,9173,1,7,4,3,19,8,11,25
NorthEast Un,9173,2,6,3,5,14,11,3,21
Kolkata,9173,3,4,8,2,16,14,2,20
Kerala Blast,9173,4,5,4,5,14,17,-3,19
Delhi Dynamo,9173,5,4,6,4,22,20,2,18
FC Goa,9173,6,4,4,6,14,16,-2,16
FC Pune City,9173,7,4,4,6,13,17,-4,16
Chennaiyin,9173,8,3,5,6,14,23,-9,14
Mumbai City,9174,1,7,4,3,18,8,10,25
Delhi Dynamo,9174,2,5,6,3,23,17,6,21
Kolkata,9174,3,5,6,3,20,17,3,21
Chennaiyin,9174,4,4,6,4,15,18,-3,18
Kerala Blast,9174,5,4,5,5,10,16,-6,17
FC Pune City,9174,6,4,4,6,14,17,-3,16
FC Goa,9174,7,4,4,6,11,16,-5,16
NorthEast Un,9174,8,4,3,7,10,12,-2,15
Delhi Dynamo,9175,1,7,5,2,25,14,11,26
Kerala Blast,9175,2,7,3,4,14,14,0,24
Mumbai City,9175,3,6,4,4,16,9,7,22
Kolkata,9175,4,4,7,3,16,13,3,19
Chennaiyin,9175,5,4,6,4,15,17,-2,18
FC Pune City,9175,6,4,4,6,13,16,-3,16
NorthEast Un,9175,7,4,2,8,9,15,-6,14
FC Goa,9175,8,3,3,8,8,18,-10,12
Mumbai City,9176,1,6,5,3,17,9,8,23
Delhi Dynamo,9176,2,5,7,2,26,18,8,22
Kolkata,9176,3,5,7,2,18,14,4,22
FC Pune City,9176,4,5,3,6,14,17,-3,18
NorthEast Un,9176,5,5,2,7,13,13,0,17
Chennaiyin,9176,6,4,5,5,15,20,-5,17
FC Goa,9176,7,4,4,6,14,18,-4,16
Kerala Blast,9176,8,4,3,7,10,18,-8,15
Mumbai City,9177,1,7,4,3,18,9,9,25
Delhi Dynamo,9177,2,5,6,3,26,16,10,21
FC Pune City,9177,3,6,3,5,14,14,0,21
NorthEast Un,9177,4,5,4,5,13,12,1,19
Chennaiyin,9177,5,4,5,5,16,19,-3,17
Kerala Blast,9177,6,4,5,5,12,17,-5,17
Kolkata,9177,7,3,7,4,16,17,-1,16
FC Goa,9177,8,4,2,8,11,22,-11,14
Delhi Dynamo,9178,1,6,5,3,25,16,9,23
Mumbai City,9178,2,6,4,4,16,10,6,22
Kolkata,9178,3,5,6,3,16,14,2,21
NorthEast Un,9178,4,5,3,6,10,10,0,18
FC Pune City,9178,5,5,3,6,15,16,-1,18
Chennaiyin,9178,6,4,6,4,15,18,-3,18
Kerala Blast,9178,7,4,4,6,10,17,-7,16
FC Goa,9178,8,4,3,7,12,18,-6,15
Kolkata,9179,1,6,6,2,17,13,4,24
Delhi Dynamo,9179,2,5,7,2,24,16,8,22
Mumbai City,9179,3,6,4,4,16,9,7,22
NorthEast Un,9179,4,5,4,5,15,13,2,19
Kerala Blast,9179,5,4,5,5,13,18,-5,17
FC Pune City,9179,6,4,4,6,14,17,-3,16
Chennaiyin,9179,7,3,6,5,16,22,-6,15
FC Goa,9179,8,3,4,7,12,19,-7,13
Mumbai City,9180,1,7,4,3,17,8,9,25
Kerala Blast,9180,2,6,3,5,12,14,-2,21
Chennaiyin,9180,3,5,5,4,18,20,-2,20
Delhi Dynamo,9180,4,4,7,3,22,16,6,19
Kolkata,9180,5,4,7,3,16,15,1,19
FC Pune City,9180,6,5,3,6,14,16,-2,18
NorthEast Un,9180,7,4,3,7,11,14,-3,15
FC Goa,9180,8,3,4,7,11,18,-7,13
Mumbai City,9181,1,6,5,3,17,9,8,23
Delhi Dynamo,9181,2,5,7,2,25,17,8,22
Kerala Blast,9181,3,5,5,4,13,16,-3,20
Kolkata,9181,4,4,6,4,19,15,4,18
Chennaiyin,9181,5,4,6,4,16,18,-2,18
NorthEast Un,9181,6,4,5,5,13,13,0,17
FC Pune City,9181,7,4,4,6,13,20,-7,16
FC Goa,9181,8,4,2,8,9,17,-8,14
Kolkata,9182,1,6,6,2,19,14,5,24
Mumbai City,9182,2,6,4,4,18,13,5,22
Delhi Dynamo,9182,3,5,5,4,27,21,6,20
NorthEast Un,9182,4,6,2,6,16,14,2,20
FC Pune City,9182,5,5,3,6,14,15,-1,18
Kerala Blast,9182,6,5,3,6,13,19,-6,18
Chennaiyin,9182,7,3,6,5,16,21,-5,15
FC Goa,9182,8,4,3,7,11,17,-6,15
Delhi Dynamo,9183,1,6,5,3,27,17,10,23
Mumbai City,9183,2,6,4,4,16,11,5,22
FC Goa,9183,3,6,2,6,16,14,2,20
Kerala Blast,9183,4,5,5,4,12,15,-3,20
Kolkata,9183,5,3,8,3,17,19,-2,17
FC Pune City,9183,6,4,5,5,16,18,-2,17
NorthEast Un,9183,7,5,2,7,11,13,-2,17
Chennaiyin,9183,8,3,5,6,13,21,-8,14
Mumbai City,9184,1,7,4,3,18,9,9,25
Delhi Dynamo,9184,2,5,5,4,25,18,7,20
NorthEast Un,9184,3,6,2,6,13,11,2,20
FC Pune City,9184,4,5,3,6,15,18,-3,18
Kolkata,9184,4,4,6,4,15,18,-3,18
Kerala Blast,9184,6,5,3,6,14,18,-4,18
Chennaiyin,9184,7,4,5,5,15,19,-4,17
FC Goa,9184,7,5,2,7,15,19,-4,17
Mumbai City,9185,1,7,4,3,19,8,11,25
NorthEast Un,9185,2,6,3,5,12,10,2,21
Kerala Blast,9185,3,5,4,5,11,15,-4,19
Delhi Dynamo,9185,4,4,6,4,22,19,3,18
Kolkata,9185,5,3,8,3,16,16,0,17
FC Pune City,9185,6,4,4,6,14,17,-3,16
Chennaiyin,9185,7,3,7,4,15,19,-4,16
FC Goa,9185,8,4,4,6,13,18,-5,16
Mumbai City,9186,1,6,4,4,16,9,7,22
Kerala Blast,9186,2,6,4,4,14,16,-2,22
Delhi Dynamo,9186,3,5,6,3,24,17,7,21
Kolkata,9186,4,5,6,3,20,14,6,21
NorthEast Un,9186,5,5,4,5,14,12,2,19
Chennaiyin,9186,6,4,5,5,18,21,-3,17
FC Pune City,9186,7,4,3,7,13,20,-7,15
FC Goa,9186,8,4,2,8,11,21,-10,14
Mumbai City,9187,1,6,5,3,18,10,8,23
Delhi Dynamo,9187,2,5,6,3,26,20,6,21
Kerala Blast,9187,3,6,3,5,12,15,-3,21
Kolkata,9187,4,4,7,3,15,16,-1,19
NorthEast Un,9187,5,5,3,6,14,13,1,18
FC Goa,9187,6,5,2,7,15,16,-1,17
FC Pune City,9187,7,4,4,6,13,16,-3,16
Chennaiyin,9187,8,3,6,5,14,21,-7,15
Mumbai City,9188,1,7,4,3,17,8,9,25
Delhi Dynamo,9188,2,5,5,4,25,18,7,20
FC Goa,9188,3,6,2,6,14,17,-3,20
Kerala Blast,9188,4,5,5,4,11,14,-3,20
Kolkata,9188,5,4,7,3,15,14,1,19
Chennaiyin,9188,6,4,5,5,15,18,-3,17
FC Pune City,9188,7,4,3,7,12,16,-4,15
NorthEast Un,9188,8,4,3,7,10,14,-4,15
Delhi Dynamo,9189,1,6,6,2,28,18,10,24
Kolkata,9189,2,6,6,2,18,13,5,24
Mumbai City,9189,3,6,4,4,16,9,7,22
FC Pune City,9189,4,5,3,6,14,16,-2,18
NorthEast Un,9189,5,5,3,6,11,13,-2,18
Chennaiyin,9189,6,4,5,5,16,20,-4,17
Kerala Blast,9189,7,4,3,7,10,17,-7,15
FC Goa,9189,8,4,2,8,15,22,-7,14
Mumbai City,9190,1,6,5,3,16,8,8,23
NorthEast Un,9190,2,7,2,5,14,11,3,23
Kolkata,9190,3,5,7,2,21,14,7,22
Delhi Dynamo,9190,4,4,7,3,22,16,6,19
FC Pune City,9190,5,5,3,6,16,19,-3,18
Chennaiyin,9190,6,4,5,5,17,20,-3,17
Kerala Blast,9190,7,4,3,7,12,22,-10,15
FC Goa,9190,8,3,4,7,10,18,-8,13
Mumbai City,9191,1,7,4,3,22,9,13,25
Chennaiyin,9191,2,5,5,4,17,18,-1,20
Delhi Dynamo,9191,3,4,7,3,23,21,2,19
FC Pune City,9191,4,5,4,5,14,14,0,19
Kerala Blast,9191,5,4,6,4,12,16,-4,18
NorthEast Un,9191,6,4,4,6,12,14,-2,16
Kolkata,9191,7,3,7,4,15,18,-3,16
FC Goa,9191,8,4,3,7,12,17,-5,15
Mumbai City,9192,1,6,5,3,18,10,8,23
NorthEast Un,9192,2,5,4,5,10,9,1,19
FC Pune City,9192,3,5,4,5,15,15,0,19
Delhi Dynamo,9192,4,4,6,4,24,19,5,18
Kolkata,9192,5,4,6,4,16,18,-2,18
Chennaiyin,9192,6,4,6,4,14,17,-3,18
FC Goa,9192,7,5,2,7,13,17,-4,17
Kerala Blast,9192,8,4,5,5,9,14,-5,17
Mumbai City,9193,1,6,4,4,16,9,7,22
Delhi Dynamo,9193,2,5,6,3,23,17,6,21
Kerala Blast,9193,3,6,3,5,13,15,-2,21
Chennaiyin,9193,4,5,5,4,16,18,-2,20
NorthEast Un,9193,5,5,3,6,12,12,0,18
FC Pune City,9193,6,5,3,6,14,16,-2,18
FC Goa,9193,7,5,2,7,11,15,-4,17
Kolkata,9193,8,3,6,5,14,17,-3,15
Mumbai City,9194,1,6,5,3,18,10,8,23
Delhi Dynamo,9194,2,5,6,3,27,19,8,21
Kerala Blast,9194,3,5,5,4,11,14,-3,20
Kolkata,9194,4,4,7,3,17,15,2,19
FC Pune City,9194,5,5,4,5,16,17,-1,19
FC Goa,9194,6,5,2,7,13,19,-6,17
NorthEast Un,9194,7,4,3,7,9,12,-3,15
Chennaiyin,9194,8,3,6,5,14,19,-5,15
Mumbai City,9195,1,7,4,3,17,8,9,25
Delhi Dynamo,9195,2,5,6,3,23,16,7,21
FC Pune City,9195,3,5,4,5,16,16,0,19
Kerala Blast,9195,4,5,4,5,15,17,-2,19
NorthEast Un,9195,5,5,3,6,12,14,-2,18
Kolkata,9195,6,3,8,3,13,14,-1,17
FC Goa,9195,7,5,2,7,12,16,-4,17
Chennaiyin,9195,8,3,5,6,14,21,-7,14
Mumbai City,9196,1,7,4,3,20,8,12,25
Kerala Blast,9196,2,6,4,4,14,15,-1,22
Kolkata,9196,3,4,8,2,18,14,4,20
Delhi Dynamo,9196,4,4,6,4,23,21,2,18
NorthEast Un,9196,5,5,3,6,13,12,1,18
FC Goa,9196,6,5,3,6,13,17,-4,18
FC Pune City,9196,7,4,3,7,12,19,-7,15
Chennaiyin,9196,8,3,5,6,14,21,-7,14
Mumbai City,9197,1,7,4,3,19,8,11,25
NorthEast Un,9197,2,6,3,5,13,11,2,21
Delhi Dynamo,9197,3,5,5,4,23,18,5,20
Kolkata,9197,4,4,8,2,17,13,4,20
FC Pune City,9197,5,4,5,5,14,16,-2,17
Kerala Blast,9197,6,4,5,5,12,19,-7,17
Chennaiyin,9197,7,3,6,5,13,18,-5,15
FC Goa,9197,8,3,4,7,8,16,-8,13
Mumbai City,9198,1,7,4,3,17,8,9,25
Delhi Dynamo,9198,2,6,5,3,24,15,9,23
Kerala Blast,9198,3,5,4,5,16,16,0,19
FC Pune City,9198,4,5,4,5,14,15,-1,19
Chennaiyin,9198,5,4,5,5,17,20,-3,17
FC Goa,9198,6,5,2,7,12,17,-5,17
Kolkata,9198,7,3,7,4,13,19,-6,16
NorthEast Un,9198,8,4,3,7,11,14,-3,15
Mumbai City,9199,1,6,5,3,17,9,8,23
Delhi Dynamo,9199,2,5,7,2,25,16,9,22
Kerala Blast,9199,3,6,4,4,11,13,-2,22
NorthEast Un,9199,4,5,3,6,14,11,3,18
Kolkata,9199,5,3,8,3,14,16,-2,17
Chennaiyin,9199,6,4,5,5,15,22,-7,17
FC Pune City,9199,7,4,4,6,13,16,-3,16
FC Goa,9199,8,4,2,8,12,18,-6,14
Delhi Dynamo,9200,1,6,6,2,26,15,11,24
Mumbai City,9200,2,6,4,4,16,10,6,22
Kerala Blast,9200,3,5,5,4,15,18,-3,20
Kolkata,9200,4,4,7,3,16,15,1,19
Chennaiyin,9200,5,4,6,4,15,17,-2,18
FC Goa,9200,6,4,4,6,9,14,-5,16
FC Pune City,9200,7,4,3,7,14,18,-4,15
NorthEast Un,9200,8,4,3,7,11,15,-4,15
Mumbai City,9201,1,7,4,3,17,8,9,25
Delhi Dynamo,9201,2,6,5,3,27,19,8,23
Kerala Blast,9201,3,6,4,4,13,14,-1,22
Kolkata,9201,4,5,6,3,17,15,2,21
Chennaiyin,9201,5,4,5,5,18,22,-4,17
NorthEast Un,9201,6,4,3,7,13,15,-2,15
FC Pune City,9201,7,4,3,7,12,17,-5,15
FC Goa,9201,8,4,2,8,14,21,-7,14
Mumbai City,9202,1,6,5,3,18,10,8,23
Kolkata,9202,2,5,7,2,18,14,4,22
Delhi Dynamo,9202,3,5,6,3,27,19,8,21
NorthEast Un,9202,4,6,3,5,14,11,3,21
Kerala Blast,9202,5,4,5,5,11,17,-6,17
FC Pune City,9202,6,4,4,6,13,16,-3,16
FC Goa,9202,7,4,3,7,12,20,-8,15
Chennaiyin,9202,8,3,5,6,14,20,-6,14
Mumbai City,9203,1,6,5,3,17,9,8,23
NorthEast Un,9203,2,7,2,5,20,13,7,23
Delhi Dynamo,9203,3,5,6,3,25,22,3,21
FC Pune City,9203,4,6,3,5,14,14,0,21
Kerala Blast,9203,5,5,3,6,13,16,-3,18
FC Goa,9203,6,5,2,7,12,16,-4,17
Kolkata,9203,7,3,6,5,13,17,-4,15
Chennaiyin,9203,8,3,5,6,15,22,-7,14
Mumbai City,9204,1,6,5,3,17,9,8,23
Kerala Blast,9204,2,6,4,4,13,13,0,22
Delhi Dynamo,9204,3,5,6,3,24,17,7,21
Chennaiyin,9204,4,5,5,4,15,17,-2,20
Kolkata,9204,5,4,7,3,17,16,1,19
FC Pune City,9204,6,4,4,6,14,18,-4,16
NorthEast Un,9204,7,4,3,7,10,12,-2,15
FC Goa,9204,8,4,2,8,9,17,-8,14
Mumbai City,9205,1,7,4,3,18,9,9,25
Kolkata,9205,2,4,7,3,19,14,5,19
FC Pune City,9205,3,5,4,5,14,15,-1,19
Delhi Dynamo,9205,4,4,6,4,25,20,5,18
NorthEast Un,9205,5,5,3,6,12,13,-1,18
FC Goa,9205,6,5,3,6,11,15,-4,18
Chennaiyin,9205,7,4,5,5,15,18,-3,17
Kerala Blast,9205,8,4,4,6,9,19,-10,16
Mumbai City,9206,1,6,5,3,18,10,8,23
Kolkata,9206,2,5,6,3,19,17,2,21
Delhi Dynamo,9206,3,4,8,2,23,16,7,20
NorthEast Un,9206,4,5,4,5,11,10,1,19
FC Pune City,9206,5,5,3,6,15,16,-1,18
Chennaiyin,9206,6,4,6,4,16,18,-2,18
FC Goa,9206,7,4,3,7,12,19,-7,15
Kerala Blast,9206,8,4,3,7,11,19,-8,15
Mumbai City,9207,1,6,5,3,16,8,8,23
Kerala Blast,9207,2,6,3,5,13,14,-1,21
Delhi Dynamo,9207,3,4,8,2,22,15,7,20
FC Pune City,9207,4,5,4,5,16,17,-1,19
Chennaiyin,9207,5,4,6,4,15,17,-2,18
NorthEast Un,9207,6,4,4,6,10,11,-1,16
Kolkata,9207,7,3,7,4,16,20,-4,16
FC Goa,9207,8,4,3,7,10,16,-6,15
Mumbai City,9208,1,7,4,3,17,8,9,25
Kolkata,9208,2,6,6,2,22,14,8,24
Delhi Dynamo,9208,3,5,5,4,23,17,6,20
Kerala Blast,9208,4,5,4,5,14,18,-4,19
NorthEast Un,9208,5,5,3,6,13,13,0,18
Chennaiyin,9208,6,4,5,5,15,19,-4,17
FC Pune City,9208,7,4,3,7,14,22,-8,15
FC Goa,9208,8,4,2,8,10,17,-7,14
Mumbai City,9209,1,7,4,3,17,8,9,25
Kolkata,9209,2,5,6,3,18,14,4,21
Kerala Blast,9209,3,6,3,5,12,15,-3,21
Delhi Dynamo,9209,4,5,5,4,28,20,8,20
Chennaiyin,9209,5,5,5,4,17,18,-1,20
FC Pune City,9209,6,5,3,6,15,16,-1,18
NorthEast Un,9209,7,5,2,7,14,17,-3,17
FC Goa,9209,8,3,2,9,9,22,-13,11
Delhi Dynamo,9210,1,7,5,2,27,14,13,26
Mumbai City,9210,2,6,4,4,16,11,5,22
Kerala Blast,9210,3,6,3,5,15,17,-2,21
NorthEast Un,9210,4,5,3,6,14,12,2,18
Chennaiyin,9210,5,4,6,4,18,20,-2,18
Kolkata,9210,6,4,6,4,17,19,-2,18
FC Pune City,9210,7,5,3,6,16,19,-3,18
FC Goa,9210,8,3,2,9,10,21,-11,11
Delhi Dynamo,9211,1,6,5,3,24,18,6,23
Mumbai City,9211,2,6,4,4,16,9,7,22
Kerala Blast,9211,3,6,4,4,13,15,-2,22
NorthEast Un,9211,4,6,2,6,18,14,4,20
Kolkata,9211,5,4,8,2,15,13,2,20
FC Pune City,9211,6,4,4,6,12,15,-3,16
Chennaiyin,9211,7,3,6,5,15,21,-6,15
FC Goa,9211,8,3,3,8,8,16,-8,12
Mumbai City,9212,1,7,4,3,17,8,9,25
NorthEast Un,9212,2,6,2,6,13,10,3,20
Chennaiyin,9212,3,5,5,4,17,19,-2,20
Kolkata,9212,4,4,7,3,16,15,1,19
Kerala Blast,9212,5,5,4,5,10,15,-5,19
Delhi Dynamo,9212,6,4,5,5,22,21,1,17
FC Pune City,9212,7,4,5,5,14,16,-2,17
FC Goa,9212,8,4,2,8,14,19,-5,14
NorthEast Un,9213,1,7,2,5,14,10,4,23
Mumbai City,9213,2,6,4,4,17,10,7,22
Delhi Dynamo,9213,3,5,6,3,24,17,7,21
Kolkata,9213,4,4,7,3,15,16,-1,19
Kerala Blast,9213,5,5,3,6,14,18,-4,18
FC Goa,9213,6,4,4,6,13,16,-3,16
FC Pune City,9213,7,4,4,6,15,19,-4,16
Chennaiyin,9213,8,3,6,5,14,20,-6,15
Mumbai City,9214,1,7,4,3,18,8,10,25
Kerala Blast,9214,2,7,3,4,13,13,0,24
Delhi Dynamo,9214,3,6,5,3,25,16,9,23
NorthEast Un,9214,4,5,2,7,11,12,-1,17
FC Goa,9214,5,5,2,7,13,17,-4,17
FC Pune City,9214,6,4,4,6,13,16,-3,16
Kolkata,9214,7,3,7,4,14,18,-4,16
Chennaiyin,9214,8,3,5,6,14,21,-7,14
Mumbai City,9215,1,7,4,3,17,8,9,25
Kolkata,9215,2,5,6,3,18,15,3,21
FC Goa,9215,3,6,2,6,15,16,-1,20
NorthEast Un,9215,4,5,4,5,13,12,1,19
Delhi Dynamo,9215,5,4,6,4,23,18,5,18
FC Pune City,9215,6,5,3,6,14,16,-2,18
Chennaiyin,9215,7,3,6,5,15,22,-7,15
Kerala Blast,9215,8,4,3,7,9,17,-8,15
Mumbai City,9216,1,6,5,3,16,8,8,23
Delhi Dynamo,9216,2,5,6,3,24,16,8,21
Kolkata,9216,3,5,6,3,20,16,4,21
Kerala Blast,9216,4,5,4,5,10,15,-5,19
NorthEast Un,9216,5,5,2,7,12,13,-1,17
FC Goa,9216,6,5,2,7,15,17,-2,17
Chennaiyin,9216,7,4,5,5,16,21,-5,17
FC Pune City,9216,8,4,4,6,12,19,-7,16
Mumbai City,9217,1,6,5,3,17,9,8,23
Delhi Dynamo,9217,2,5,6,3,25,17,8,21
NorthEast Un,9217,3,6,3,5,14,11,3,21
Kerala Blast,9217,4,4,6,4,12,16,-4,18
Kolkata,9217,5,3,8,3,15,15,0,17
FC Pune City,9217,6,4,5,5,15,17,-2,17
FC Goa,9217,7,5,2,7,14,18,-4,17
Chennaiyin,9217,8,3,5,6,14,23,-9,14
Mumbai City,9218,1,6,4,4,16,10,6,22
Delhi Dynamo,9218,2,5,6,3,25,17,8,21
Kerala Blast,9218,3,5,5,4,11,14,-3,20
Kolkata,9218,4,4,7,3,16,15,1,19
FC Pune City,9218,5,5,3,6,14,16,-2,18
NorthEast Un,9218,6,4,5,5,11,11,0,17
FC Goa,9218,7,5,2,7,11,15,-4,17
Chennaiyin,9218,8,3,6,5,13,19,-6,15
Mumbai City,9219,1,7,4,3,18,8,10,25
FC Pune City,9219,2,6,3,5,17,15,2,21
NorthEast Un,9219,3,5,4,5,12,11,1,19
Kerala Blast,9219,4,5,4,5,12,16,-4,19
Delhi Dynamo,9219,5,4,6,4,22,18,4,18
FC Goa,9219,6,5,3,6,14,16,-2,18
Chennaiyin,9219,7,3,6,5,15,20,-5,15
Kolkata,9219,8,3,6,5,13,19,-6,15
Mumbai City,9220,1,7,4,3,18,9,9,25
Delhi Dynamo,9220,2,6,5,3,24,16,8,23
Kerala Blast,9220,3,6,3,5,14,18,-4,21
Kolkata,9220,4,4,7,3,17,16,1,19
FC Pune City,9220,5,5,3,6,17,18,-1,18
Chennaiyin,9220,6,3,7,4,13,17,-4,16
NorthEast Un,9220,7,4,3,7,10,12,-2,15
FC Goa,9220,8,3,4,7,8,15,-7,13
Mumbai City,9221,1,6,4,4,17,10,7,22
Delhi Dynamo,9221,2,5,6,3,26,19,7,21
Kolkata,9221,3,4,6,4,15,15,0,18
NorthEast Un,9221,4,5,3,6,12,13,-1,18
Chennaiyin,9221,5,4,6,4,16,18,-2,18
FC Pune City,9221,6,5,3,6,13,16,-3,18
FC Goa,9221,7,5,3,6,13,17,-4,18
Kerala Blast,9221,8,5,3,6,11,15,-4,18
Mumbai City,9222,1,7,4,3,17,8,9,25
Kerala Blast,9222,2,6,4,4,16,15,1,22
Kolkata,9222,3,5,6,3,15,14,1,21
NorthEast Un,9222,4,6,2,6,13,14,-1,20
Delhi Dynamo,9222,5,4,5,5,21,19,2,17
FC Pune City,9222,6,4,4,6,13,16,-3,16
FC Goa,9222,7,4,3,7,12,16,-4,15
Chennaiyin,9222,8,3,6,5,15,20,-5,15
Mumbai City,9223,1,6,4,4,18,11,7,22
Kolkata,9223,2,5,7,2,19,14,5,22
Delhi Dynamo,9223,3,5,6,3,26,19,7,21
FC Pune City,9223,4,5,3,6,13,16,-3,18
Kerala Blast,9223,5,5,3,6,10,16,-6,18
NorthEast Un,9223,6,5,2,7,10,11,-1,17
Chennaiyin,9223,7,4,5,5,14,18,-4,17
FC Goa,9223,8,4,4,6,13,18,-5,16
Delhi Dynamo,9224,1,6,6,2,24,15,9,24
Mumbai City,9224,2,6,4,4,16,9,7,22
Kolkata,9224,3,5,6,3,18,15,3,21
Chennaiyin,9224,4,5,5,4,17,19,-2,20
FC Pune City,9224,5,5,4,5,13,14,-1,19
Kerala Blast,9224,6,5,4,5,10,15,-5,19
NorthEast Un,9224,7,4,3,7,9,11,-2,15
FC Goa,9224,8,3,2,9,13,22,-9,11
Delhi Dynamo,9225,1,7,5,2,31,19,12,26
Mumbai City,9225,2,6,4,4,18,12,6,22
Kolkata,9225,3,5,6,3,19,14,5,21
FC Pune City,9225,4,5,4,5,14,15,-1,19
Kerala Blast,9225,5,5,4,5,10,14,-4,19
NorthEast Un,9225,6,5,2,7,13,14,-1,17
Chennaiyin,9225,7,3,5,6,15,21,-6,14
FC Goa,9225,8,4,2,8,11,22,-11,14
Delhi Dynamo,9226,1,7,5,2,27,15,12,26
Mumbai City,9226,2,6,4,4,16,9,7,22
Kolkata,9226,3,5,6,3,17,14,3,21
Kerala Blast,9226,4,6,3,5,11,14,-3,21
NorthEast Un,9226,5,6,2,6,12,12,0,20
Chennaiyin,9226,6,4,5,5,15,19,-4,17
FC Pune City,9226,7,4,3,7,13,18,-5,15
FC Goa,9226,8,3,2,9,9,19,-10,11
Mumbai City,9227,1,6,5,3,16,8,8,23
NorthEast Un,9227,2,6,2,6,14,13,1,20
Delhi Dynamo,9227,3,4,7,3,23,18,5,19
Kolkata,9227,4,4,7,3,15,14,1,19
FC Pune City,9227,5,5,3,6,15,16,-1,18
Chennaiyin,9227,6,4,6,4,17,19,-2,18
Kerala Blast,9227,7,5,3,6,12,18,-6,18
FC Goa,9227,8,3,5,6,12,18,-6,14
Delhi Dynamo,9228,1,6,6,2,25,15,10,24
Mumbai City,9228,2,6,5,3,17,9,8,23
Kerala Blast,9228,3,6,3,5,14,18,-4,21
Kolkata,9228,4,4,7,3,20,16,4,19
FC Goa,9228,5,5,2,7,14,17,-3,17
FC Pune City,9228,6,4,4,6,13,18,-5,16
NorthEast Un,9228,7,4,3,7,10,13,-3,15
Chennaiyin,9228,8,3,6,5,14,21,-7,15
Mumbai City,9229,1,6,5,3,17,9,8,23
NorthEast Un,9229,2,6,3,5,13,10,3,21
Delhi Dynamo,9229,3,4,7,3,23,18,5,19
FC Pune City,9229,4,5,4,5,15,16,-1,19
Kolkata,9229,5,3,8,3,15,16,-1,17
Chennaiyin,9229,6,3,7,4,14,18,-4,16
FC Goa,9229,7,4,4,6,11,15,-4,16
Kerala Blast,9229,8,4,4,6,9,15,-6,16
Mumbai City,9230,1,7,4,3,18,8,10,25
Kolkata,9230,2,5,7,2,15,12,3,22
Delhi Dynamo,9230,3,5,5,4,24,20,4,20
NorthEast Un,9230,4,5,4,5,12,10,2,19
FC Pune City,9230,5,5,3,6,13,15,-2,18
Kerala Blast,9230,6,4,4,6,9,15,-6,16
Chennaiyin,9230,7,3,6,5,13,18,-5,15
FC Goa,9230,8,4,3,7,10,16,-6,15
Mumbai City,9231,1,7,4,3,20,8,12,25
Kolkata,9231,2,6,6,2,18,12,6,24
Delhi Dynamo,9231,3,6,5,3,24,19,5,23
Kerala Blast,9231,4,6,3,5,13,17,-4,21
Chennaiyin,9231,5,4,5,5,17,20,-3,17
FC Pune City,9231,6,4,3,7,13,17,-4,15
NorthEast Un,9231,7,4,2,8,11,15,-4,14
FC Goa,9231,8,4,2,8,11,19,-8,14
Delhi Dynamo,9232,1,6,5,3,24,16,8,23
Mumbai City,9232,2,6,4,4,16,9,7,22
Kolkata,9232,3,4,7,3,18,14,4,19
Kerala Blast,9232,4,5,4,5,13,20,-7,19
FC Pune City,9232,5,5,3,6,15,17,-2,18
FC Goa,9232,6,5,3,6,11,15,-4,18
Chennaiyin,9232,7,4,5,5,14,18,-4,17
NorthEast Un,9232,8,4,3,7,11,13,-2,15
Mumbai City,9233,1,6,5,3,16,8,8,23
Kerala Blast,9233,2,6,3,5,15,18,-3,21
NorthEast Un,9233,3,6,2,6,13,16,-3,20
Delhi Dynamo,9233,4,4,7,3,23,17,6,19
Kolkata,9233,5,4,6,4,18,18,0,18
FC Goa,9233,6,5,3,6,13,17,-4,18
Chennaiyin,9233,7,4,5,5,19,19,0,17
FC Pune City,9233,8,4,3,7,14,18,-4,15
Kolkata,9234,1,6,6,2,20,12,8,24
Mumbai City,9234,2,6,5,3,18,10,8,23
Delhi Dynamo,9234,3,5,6,3,26,19,7,21
Kerala Blast,9234,4,5,4,5,11,15,-4,19
Chennaiyin,9234,5,4,6,4,15,17,-2,18
NorthEast Un,9234,6,4,4,6,11,12,-1,16
FC Pune City,9234,7,4,3,7,12,19,-7,15
FC Goa,9234,8,4,2,8,10,19,-9,14
Delhi Dynamo,9235,1,6,5,3,25,17,8,23
Mumbai City,9235,2,6,4,4,16,9,7,22
Kolkata,9235,3,5,6,3,21,16,5,21
Chennaiyin,9235,4,5,5,4,17,18,-1,20
Kerala Blast,9235,5,5,3,6,14,18,-4,18
NorthEast Un,9235,6,5,2,7,12,13,-1,17
FC Goa,9235,7,5,2,7,14,20,-6,17
FC Pune City,9235,8,4,3,7,14,22,-8,15
Delhi Dynamo,9236,1,6,5,3,25,17,8,23
Mumbai City,9236,2,6,4,4,17,10,7,22
Kolkata,9236,3,5,7,2,17,13,4,22
FC Pune City,9236,4,5,4,5,13,14,-1,19
NorthEast Un,9236,5,5,3,6,12,12,0,18
Chennaiyin,9236,6,4,6,4,16,18,-2,18
Kerala Blast,9236,7,4,3,7,9,17,-8,15
FC Goa,9236,8,4,2,8,10,18,-8,14
Delhi Dynamo,9237,1,6,6,2,29,15,14,24
Mumbai City,9237,2,6,5,3,16,8,8,23
Kolkata,9237,3,5,7,2,15,12,3,22
FC Pune City,9237,4,5,3,6,13,15,-2,18
Kerala Blast,9237,5,5,3,6,11,16,-5,18
Chennaiyin,9237,6,4,5,5,15,19,-4,17
FC Goa,9237,7,4,3,7,11,20,-9,15
NorthEast Un,9237,8,4,2,8,10,15,-5,14
Delhi Dynamo,9238,1,6,6,2,27,17,10,24
Mumbai City,9238,2,6,5,3,17,9,8,23
NorthEast Un,9238,3,6,2,6,16,13,3,20
Kolkata,9238,4,4,7,3,16,16,0,19
Kerala Blast,9238,5,5,4,5,12,15,-3,19
FC Pune City,9238,6,4,4,6,14,17,-3,16
Chennaiyin,9238,7,3,6,5,14,21,-7,15
FC Goa,9238,8,3,4,7,9,17,-8,13
Mumbai City,9239,1,6,5,3,17,9,8,23
Kolkata,9239,2,5,7,2,20,14,6,22
Chennaiyin,9239,3,5,5,4,19,18,1,20
Delhi Dynamo,9239,4,4,7,3,23,17,6,19
NorthEast Un,9239,5,5,3,6,12,12,0,18
Kerala Blast,9239,6,5,3,6,13,17,-4,18
FC Pune City,9239,7,4,3,7,12,20,-8,15
FC Goa,9239,8,4,3,7,10,19,-9,15
Delhi Dynamo,9240,1,7,5,2,27,14,13,26
Mumbai City,9240,2,6,4,4,16,11,5,22
Kolkata,9240,3,5,6,3,18,16,2,21
Kerala Blast,9240,4,5,3,6,15,19,-4,18
NorthEast Un,9240,5,5,2,7,12,13,-1,17
FC Goa,9240,6,5,2,7,15,17,-2,17
Chennaiyin,9240,7,4,5,5,14,22,-8,17
FC Pune City,9240,8,4,3,7,14,19,-5,15
Mumbai City,9241,1,6,5,3,16,8,8,23
Kolkata,9241,2,5,7,2,20,12,8,22
Delhi Dynamo,9241,3,5,6,3,22,16,6,21
NorthEast Un,9241,4,6,3,5,12,9,3,21
Kerala Blast,9241,5,5,3,6,12,20,-8,18
FC Goa,9241,6,4,3,7,12,15,-3,15
FC Pune City,9241,7,4,3,7,14,20,-6,15
Chennaiyin,9241,8,3,6,5,13,21,-8,15
Delhi Dynamo,9242,1,6,6,2,26,15,11,24
Mumbai City,9242,2,6,4,4,16,10,6,22
Kolkata,9242,3,4,7,3,17,16,1,19
NorthEast Un,9242,4,5,4,5,12,11,1,19
Kerala Blast,9242,5,4,6,4,11,15,-4,18
FC Goa,9242,6,5,2,7,17,20,-3,17
FC Pune City,9242,7,4,4,6,13,16,-3,16
Chennaiyin,9242,8,3,5,6,14,23,-9,14
Mumbai City,9243,1,7,4,3,19,10,9,25
Delhi Dynamo,9243,2,6,5,3,26,17,9,23
Chennaiyin,9243,3,5,5,4,17,17,0,20
Kolkata,9243,4,4,7,3,14,13,1,19
Kerala Blast,9243,5,5,4,5,11,15,-4,19
FC Pune City,9243,6,4,5,5,13,15,-2,17
NorthEast Un,9243,7,4,2,8,9,14,-5,14
FC Goa,9243,8,4,2,8,9,17,-8,14
Mumbai City,9244,1,7,4,3,19,8,11,25
Delhi Dynamo,9244,2,5,5,4,24,20,4,20
Kerala Blast,9244,3,5,5,4,15,16,-1,20
Chennaiyin,9244,4,5,5,4,17,19,-2,20
NorthEast Un,9244,5,5,3,6,12,12,0,18
Kolkata,9244,6,4,6,4,15,17,-2,18
FC Pune City,9244,7,4,4,6,14,18,-4,16
FC Goa,9244,8,4,2,8,13,19,-6,14
Mumbai City,9245,1,6,5,3,17,9,8,23
Kolkata,9245,2,4,8,2,17,15,2,20
Chennaiyin,9245,3,5,5,4,17,18,-1,20
Kerala Blast,9245,4,5,4,5,14,18,-4,19
Delhi Dynamo,9245,5,4,6,4,25,21,4,18
FC Pune City,9245,6,4,5,5,17,19,-2,17
NorthEast Un,9245,7,5,2,7,11,13,-2,17
FC Goa,9245,8,4,3,7,13,18,-5,15
Mumbai City,9246,1,6,5,3,17,9,8,23
Delhi Dynamo,9246,2,5,6,3,27,19,8,21
FC Goa,9246,3,6,2,6,12,15,-3,20
Kolkata,9246,4,4,7,3,15,13,2,19
FC Pune City,9246,5,4,5,5,13,15,-2,17
Kerala Blast,9246,6,4,5,5,10,16,-6,17
NorthEast Un,9246,7,4,4,6,12,14,-2,16
Chennaiyin,9246,8,3,6,5,14,19,-5,15
Mumbai City,9247,1,6,5,3,16,8,8,23
Delhi Dynamo,9247,2,5,6,3,25,17,8,21
Kolkata,9247,3,5,6,3,19,16,3,21
NorthEast Un,9247,4,6,3,5,13,11,2,21
Kerala Blast,9247,5,5,4,5,13,17,-4,19
FC Goa,9247,6,5,2,7,12,17,-5,17
FC Pune City,9247,7,4,3,7,14,20,-6,15
Chennaiyin,9247,8,3,5,6,13,19,-6,14
Delhi Dynamo,9248,1,7,5,2,29,16,13,26
Mumbai City,9248,2,6,4,4,16,10,6,22
Kerala Blast,9248,3,6,4,4,13,15,-2,22
Kolkata,9248,4,3,8,3,18,18,0,17
Chennaiyin,9248,5,4,5,5,14,19,-5,17
FC Pune City,9248,6,4,4,6,16,19,-3,16
NorthEast Un,9248,7,4,3,7,11,14,-3,15
FC Goa,9248,8,4,3,7,11,17,-6,15
Mumbai City,9249,1,7,4,3,19,10,9,25
NorthEast Un,9249,2,6,3,5,13,9,4,21
Delhi Dynamo,9249,3,5,5,4,27,21,6,20
Kolkata,9249,4,4,7,3,18,16,2,19
Chennaiyin,9249,5,4,6,4,14,17,-3,18
FC Pune City,9249,6,4,5,5,15,17,-2,17
Kerala Blast,9249,7,4,4,6,12,20,-8,16
FC Goa,9249,8,4,2,8,12,20,-8,14
Mumbai City,9250,1,7,4,3,18,8,10,25
Kerala Blast,9250,2,6,4,4,16,15,1,22
Delhi Dynamo,9250,3,5,6,3,23,17,6,21
Kolkata,9250,4,4,6,4,15,16,-1,18
Chennaiyin,9250,5,4,5,5,17,20,-3,17
FC Goa,9250,6,5,2,7,14,18,-4,17
NorthEast Un,9250,7,4,4,6,11,13,-2,16
FC Pune City,9250,8,4,3,7,12,19,-7,15
Mumbai City,9251,1,7,4,3,19,9,10,25
Kolkata,9251,2,6,6,2,21,13,8,24
Delhi Dynamo,9251,3,6,5,3,27,18,9,23
FC Pune City,9251,4,5,3,6,14,16,-2,18
NorthEast Un,9251,5,5,2,7,11,13,-2,17
Chennaiyin,9251,6,4,5,5,16,20,-4,17
Kerala Blast,9251,7,4,3,7,9,19,-10,15
FC Goa,9251,8,4,2,8,12,21,-9,14
Mumbai City,9252,1,6,5,3,18,10,8,23
Delhi Dynamo,9252,2,5,7,2,26,18,8,22
Kerala Blast,9252,3,6,3,5,14,14,0,21
Chennaiyin,9252,4,5,5,4,17,18,-1,20
Kolkata,9252,5,4,6,4,15,17,-2,18
FC Pune City,9252,6,5,3,6,14,17,-3,18
NorthEast Un,9252,7,5,2,7,11,13,-2,17
FC Goa,9252,8,3,3,8,10,18,-8,12
Kolkata,9253,1,6,6,2,19,12,7,24
Mumbai City,9253,2,6,4,4,17,10,7,22
Delhi Dynamo,9253,3,5,6,3,24,17,7,21
Chennaiyin,9253,4,5,5,4,19,18,1,20
Kerala Blast,9253,5,5,4,5,12,16,-4,19
NorthEast Un,9253,6,5,2,7,11,13,-2,17
FC Pune City,9253,7,4,4,6,13,18,-5,16
FC Goa,9253,8,3,3,8,10,21,-11,12
Delhi Dynamo,9254,1,7,5,2,28,15,13,26
Mumbai City,9254,2,6,4,4,17,11,6,22
Kolkata,9254,3,5,6,3,22,17,5,21
Kerala Blast,9254,4,5,4,5,15,22,-7,19
Chennaiyin,9254,5,4,5,5,15,19,-4,17
FC Goa,9254,6,5,2,7,12,16,-4,17
NorthEast Un,9254,7,4,3,7,11,14,-3,15
FC Pune City,9254,8,4,3,7,14,20,-6,15
Kerala Blast,9255,1,7,3,4,14,14,0,24
Mumbai City,9255,2,6,5,3,17,9,8,23
Delhi Dynamo,9255,3,4,7,3,24,18,6,19
FC Pune City,9255,4,5,3,6,15,17,-2,18
Chennaiyin,9255,5,4,6,4,14,17,-3,18
Kolkata,9255,6,3,7,4,14,15,-1,16
FC Goa,9255,7,4,4,6,10,15,-5,16
NorthEast Un,9255,8,4,3,7,10,13,-3,15
Mumbai City,9256,1,7,4,3,19,10,9,25
NorthEast Un,9256,2,7,2,5,15,11,4,23
Delhi Dynamo,9256,3,5,5,4,25,19,6,20
Kolkata,9256,4,4,7,3,14,13,1,19
Kerala Blast,9256,5,5,3,6,12,17,-5,18
Chennaiyin,9256,6,4,5,5,16,20,-4,17
FC Pune City,9256,7,4,4,6,13,16,-3,16
FC Goa,9256,8,4,2,8,10,18,-8,14
Mumbai City,9257,1,7,4,3,18,8,10,25
Delhi Dynamo,9257,2,5,5,4,24,17,7,20
NorthEast Un,9257,3,6,2,6,11,11,0,20
Kolkata,9257,4,4,7,3,17,16,1,19
Kerala Blast,9257,5,5,4,5,12,15,-3,19
Chennaiyin,9257,6,4,6,4,15,17,-2,18
FC Pune City,9257,7,4,4,6,14,18,-4,16
FC Goa,9257,8,3,4,7,9,18,-9,13
Delhi Dynamo,9258,1,6,6,2,27,17,10,24
Mumbai City,9258,2,6,4,4,17,11,6,22
NorthEast Un,9258,3,5,4,5,16,14,2,19
FC Pune City,9258,4,5,4,5,16,16,0,19
Kolkata,9258,5,3,9,2,15,14,1,18
Chennaiyin,9258,6,4,5,5,16,19,-3,17
Kerala Blast,9258,7,4,5,5,14,20,-6,17
FC Goa,9258,8,3,3,8,8,18,-10,12
Delhi Dynamo,9259,1,6,6,2,25,15,10,24
Kerala Blast,9259,2,7,3,4,17,17,0,24
Mumbai City,9259,3,6,4,4,16,10,6,22
Kolkata,9259,4,3,8,3,16,17,-1,17
NorthEast Un,9259,5,5,2,7,12,13,-1,17
FC Pune City,9259,6,4,4,6,15,18,-3,16
Chennaiyin,9259,7,3,6,5,17,22,-5,15
FC Goa,9259,8,3,5,6,15,21,-6,14
Mumbai City,9260,1,7,4,3,17,8,9,25
Kolkata,9260,2,5,6,3,18,15,3,21
Kerala Blast,9260,3,6,3,5,13,16,-3,21
Delhi Dynamo,9260,4,4,7,3,22,16,6,19
FC Goa,9260,5,5,3,6,14,17,-3,18
Chennaiyin,9260,6,4,5,5,15,20,-5,17
NorthEast Un,9260,7,4,3,7,9,11,-2,15
FC Pune City,9260,8,4,3,7,12,17,-5,15
Kolkata,9261,1,5,7,2,22,14,8,22
Mumbai City,9261,2,6,4,4,16,10,6,22
Delhi Dynamo,9261,3,5,6,3,25,19,6,21
Kerala Blast,9261,4,6,3,5,13,19,-6,21
NorthEast Un,9261,5,5,2,7,14,13,1,17
Chennaiyin,9261,6,4,5,5,16,21,-5,17
FC Pune City,9261,7,4,4,6,13,16,-3,16
FC Goa,9261,8,4,3,7,13,20,-7,15
Mumbai City,9262,1,7,4,3,18,9,9,25
Delhi Dynamo,9262,2,6,5,3,27,18,9,23
Kolkata,9262,3,5,6,3,17,13,4,21
FC Pune City,9262,4,6,3,5,15,15,0,21
NorthEast Un,9262,5,5,3,6,12,13,-1,18
Chennaiyin,9262,6,3,6,5,13,18,-5,15
Kerala Blast,9262,7,4,3,7,11,19,-8,15
FC Goa,9262,8,4,2,8,10,18,-8,14
Mumbai City,9263,1,6,4,4,16,10,6,22
Delhi Dynamo,9263,2,5,6,3,24,17,7,21
FC Pune City,9263,3,6,3,5,16,16,0,21
Kerala Blast,9263,4,5,4,5,15,19,-4,19
NorthEast Un,9263,5,5,3,6,16,15,1,18
Chennaiyin,9263,6,4,5,5,16,22,-6,17
Kolkata,9263,7,3,7,4,15,16,-1,16
FC Goa,9263,8,4,4,6,12,15,-3,16
Delhi Dynamo,9264,1,6,6,2,25,16,9,24
Mumbai City,9264,2,6,5,3,17,9,8,23
Kerala Blast,9264,3,4,6,4,11,15,-4,18
Kolkata,9264,4,3,8,3,18,18,0,17
FC Pune City,9264,5,4,5,5,16,18,-2,17
Chennaiyin,9264,6,4,5,5,15,19,-4,17
FC Goa,9264,7,5,2,7,12,17,-5,17
NorthEast Un,9264,8,4,3,7,10,12,-2,15
Mumbai City,9265,1,7,4,3,18,9,9,25
Kolkata,9265,2,5,6,3,16,14,2,21
Kerala Blast,9265,3,5,4,5,13,18,-5,19
Delhi Dynamo,9265,4,4,6,4,24,20,4,18
NorthEast Un,9265,5,5,3,6,13,12,1,18
FC Pune City,9265,6,5,3,6,16,17,-1,18
Chennaiyin,9265,7,4,6,4,15,18,-3,18
FC Goa,9265,8,3,4,7,10,17,-7,13
Mumbai City,9266,1,7,4,3,20,9,11,25
Kolkata,9266,2,5,7,2,17,12,5,22
Delhi Dynamo,9266,3,5,6,3,24,19,5,21
NorthEast Un,9266,4,5,3,6,10,10,0,18
Kerala Blast,9266,5,4,6,4,10,14,-4,18
FC Pune City,9266,6,4,4,6,13,16,-3,16
Chennaiyin,9266,7,3,6,5,14,19,-5,15
FC Goa,9266,8,3,4,7,10,19,-9,13
Delhi Dynamo,9267,1,6,6,2,25,16,9,24
Mumbai City,9267,2,6,4,4,17,10,7,22
Kerala Blast,9267,3,6,4,4,13,15,-2,22
Kolkata,9267,4,4,7,3,19,15,4,19
NorthEast Un,9267,5,5,2,7,13,13,0,17
Chennaiyin,9267,6,4,5,5,17,20,-3,17
FC Pune City,9267,7,4,3,7,13,20,-7,15
FC Goa,9267,8,4,3,7,10,18,-8,15
Mumbai City,9268,1,7,4,3,19,9,10,25
Delhi Dynamo,9268,2,5,6,3,25,19,6,21
Kolkata,9268,3,4,6,4,19,17,2,18
Chennaiyin,9268,4,4,6,4,18,19,-1,18
NorthEast Un,9268,5,5,3,6,13,14,-1,18
FC Pune City,9268,6,5,3,6,14,18,-4,18
Kerala Blast,9268,7,5,3,6,13,20,-7,18
FC Goa,9268,8,4,3,7,12,17,-5,15
Mumbai City,9269,1,6,5,3,18,10,8,23
NorthEast Un,9269,2,6,3,5,17,11,6,21
FC Pune City,9269,3,6,3,5,15,14,1,21
Delhi Dynamo,9269,4,4,7,3,26,23,3,19
Kolkata,9269,5,3,8,3,16,16,0,17
FC Goa,9269,6,4,4,6,13,18,-5,16
Kerala Blast,9269,7,4,4,6,11,19,-8,16
Chennaiyin,9269,8,3,6,5,15,20,-5,15
Mumbai City,9270,1,7,4,3,18,8,10,25
FC Goa,9270,2,6,2,6,12,14,-2,20
FC Pune City,9270,3,5,4,5,14,15,-1,19
Delhi Dynamo,9270,4,4,6,4,22,18,4,18
NorthEast Un,9270,5,4,5,5,12,12,0,17
Kolkata,9270,6,3,8,3,15,16,-1,17
Kerala Blast,9270,7,4,5,5,12,17,-5,17
Chennaiyin,9270,8,3,6,5,13,18,-5,15
Delhi Dynamo,9271,1,6,5,3,27,19,8,23
NorthEast Un,9271,2,7,2,5,17,11,6,23
Mumbai City,9271,3,6,4,4,17,13,4,22
Kolkata,9271,4,5,7,2,19,16,3,22
FC Pune City,9271,5,5,4,5,15,16,-1,19
Kerala Blast,9271,6,4,3,7,13,20,-7,15
Chennaiyin,9271,7,3,5,6,14,20,-6,14
FC Goa,9271,8,4,2,8,10,17,-7,14
Delhi Dynamo,9272,1,6,5,3,29,19,10,23
Mumbai City,9272,2,6,4,4,16,11,5,22
NorthEast Un,9272,3,5,4,5,15,13,2,19
FC Pune City,9272,4,5,4,5,15,15,0,19
Kerala Blast,9272,5,4,6,4,10,14,-4,18
Kolkata,9272,6,3,8,3,14,15,-1,17
FC Goa,9272,7,4,3,7,14,19,-5,15
Chennaiyin,9272,8,3,6,5,16,23,-7,15
Mumbai City,9273,1,7,4,3,18,8,10,25
Delhi Dynamo,9273,2,5,6,3,24,17,7,21
Kolkata,9273,3,5,6,3,16,14,2,21
Kerala Blast,9273,4,5,4,5,14,18,-4,19
Chennaiyin,9273,5,4,5,5,16,20,-4,17
FC Goa,9273,6,5,2,7,11,17,-6,17
NorthEast Un,9273,7,4,4,6,12,13,-1,16
FC Pune City,9273,8,4,3,7,14,18,-4,15
Delhi Dynamo,9274,1,6,6,2,27,15,12,24
Mumbai City,9274,2,6,5,3,17,9,8,23
Kolkata,9274,3,5,6,3,17,14,3,21
Chennaiyin,9274,4,4,6,4,18,20,-2,18
Kerala Blast,9274,5,5,3,6,11,17,-6,18
NorthEast Un,9274,6,5,2,7,15,17,-2,17
FC Pune City,9274,7,4,3,7,12,17,-5,15
FC Goa,9274,8,4,3,7,10,18,-8,15
Mumbai City,9275,1,6,5,3,17,9,8,23
Kolkata,9275,2,5,7,2,20,16,4,22
Delhi Dynamo,9275,3,4,7,3,23,20,3,19
NorthEast Un,9275,4,5,3,6,11,11,0,18
Kerala Blast,9275,5,5,3,6,16,18,-2,18
Chennaiyin,9275,6,4,6,4,14,17,-3,18
FC Goa,9275,7,4,4,6,13,15,-2,16
FC Pune City,9275,8,4,3,7,12,20,-8,15
Mumbai City,9276,1,6,4,4,16,11,5,22
Delhi Dynamo,9276,2,5,6,3,27,18,9,21
NorthEast Un,9276,3,6,2,6,14,13,1,20
Kerala Blast,9276,4,5,4,5,11,15,-4,19
Chennaiyin,9276,5,4,6,4,16,19,-3,18
Kolkata,9276,6,3,8,3,14,14,0,17
FC Pune City,9276,7,4,4,6,13,16,-3,16
FC Goa,9276,8,4,4,6,12,17,-5,16
Mumbai City,9277,1,6,5,3,17,9,8,23
Delhi Dynamo,9277,2,5,6,3,25,17,8,21
Kerala Blast,9277,3,6,3,5,13,16,-3,21
NorthEast Un,9277,4,5,3,6,10,10,0,18
FC Pune City,9277,5,5,3,6,16,17,-1,18
Kolkata,9277,5,4,6,4,16,17,-1,18
FC Goa,9277,7,5,2,7,13,18,-5,17
Chennaiyin,9277,8,3,6,5,13,19,-6,15
Mumbai City,9278,1,7,4,3,18,9,9,25
Chennaiyin,9278,2,5,5,4,16,18,-2,20
FC Pune City,9278,3,5,4,5,14,15,-1,19
Delhi Dynamo,9278,4,4,6,4,23,19,4,18
NorthEast Un,9278,5,5,3,6,11,10,1,18
Kerala Blast,9278,6,4,6,4,12,16,-4,18
Kolkata,9278,7,3,7,4,16,17,-1,16
FC Goa,9278,8,4,3,7,12,18,-6,15
Mumbai City,9279,1,7,4,3,18,8,10,25
Kerala Blast,9279,2,7,3,4,12,13,-1,24
Delhi Dynamo,9279,3,4,7,3,24,19,5,19
Chennaiyin,9279,4,4,6,4,16,18,-2,18
Kolkata,9279,5,3,7,4,13,14,-1,16
FC Pune City,9279,6,4,4,6,12,15,-3,16
FC Goa,9279,7,4,4,6,12,17,-5,16
NorthEast Un,9279,8,4,3,7,10,13,-3,15
Delhi Dynamo,9280,1,6,5,3,26,16,10,23
Mumbai City,9280,2,6,4,4,16,10,6,22
Kolkata,9280,3,5,6,3,18,16,2,21
NorthEast Un,9280,4,6,3,5,15,13,2,21
Kerala Blast,9280,5,6,3,5,17,17,0,21
Chennaiyin,9280,6,3,7,4,16,20,-4,16
FC Pune City,9280,7,4,3,7,13,19,-6,15
FC Goa,9280,8,3,3,8,10,20,-10,12
Delhi Dynamo,9281,1,6,5,3,26,16,10,23
Mumbai City,9281,2,6,4,4,16,11,5,22
Kerala Blast,9281,3,5,5,4,13,14,-1,20
FC Pune City,9281,4,5,4,5,15,15,0,19
Kolkata,9281,5,3,8,3,14,15,-1,17
NorthEast Un,9281,6,5,2,7,11,14,-3,17
Chennaiyin,9281,7,4,5,5,15,19,-4,17
FC Goa,9281,8,4,3,7,11,17,-6,15
Mumbai City,9282,1,7,4,3,19,8,11,25
Delhi Dynamo,9282,2,6,5,3,27,19,8,23
FC Pune City,9282,3,5,4,5,15,16,-1,19
Chennaiyin,9282,4,4,6,4,20,21,-1,18
Kolkata,9282,5,4,6,4,16,17,-1,18
NorthEast Un,9282,6,5,2,7,13,17,-4,17
Kerala Blast,9282,7,4,4,6,10,17,-7,16
FC Goa,9282,8,4,3,7,15,20,-5,15
Mumbai City,9283,1,7,4,3,18,8,10,25
Delhi Dynamo,9283,2,6,5,3,29,18,11,23
Kolkata,9283,3,5,7,2,17,12,5,22
NorthEast Un,9283,4,6,2,6,13,12,1,20
Kerala Blast,9283,5,5,3,6,11,18,-7,18
FC Pune City,9283,6,4,3,7,13,18,-5,15
FC Goa,9283,7,4,3,7,12,19,-7,15
Chennaiyin,9283,8,3,5,6,13,21,-8,14
Delhi Dynamo,9284,1,7,5,2,27,16,11,26
Mumbai City,9284,2,6,4,4,16,10,6,22
Kolkata,9284,3,4,8,2,16,14,2,20
NorthEast Un,9284,4,5,3,6,13,12,1,18
FC Pune City,9284,5,4,5,5,13,15,-2,17
Kerala Blast,9284,6,4,5,5,9,15,-6,17
Chennaiyin,9284,7,3,6,5,14,20,-6,15
FC Goa,9284,8,4,2,8,12,18,-6,14
Mumbai City,9285,1,7,4,3,18,9,9,25
NorthEast Un,9285,2,5,4,5,16,12,4,19
Kerala Blast,9285,3,5,4,5,14,17,-3,19
Delhi Dynamo,9285,4,4,6,4,23,21,2,18
FC Pune City,9285,5,5,3,6,15,16,-1,18
Kolkata,9285,6,4,6,4,15,17,-2,18
FC Goa,9285,7,5,3,6,13,16,-3,18
Chennaiyin,9285,8,3,6,5,15,21,-6,15
Mumbai City,9286,1,7,4,3,18,8,10,25
Kerala Blast,9286,2,6,4,4,15,15,0,22
NorthEast Un,9286,3,6,3,5,14,10,4,21
Delhi Dynamo,9286,4,4,6,4,23,21,2,18
FC Pune City,9286,5,5,3,6,16,16,0,18
FC Goa,9286,6,4,4,6,13,18,-5,16
Chennaiyin,9286,7,3,6,5,14,19,-5,15
Kolkata,9286,8,3,6,5,14,20,-6,15
Mumbai City,9287,1,7,4,3,18,8,10,25
Delhi Dynamo,9287,2,5,6,3,25,19,6,21
Kolkata,9287,3,4,7,3,14,14,0,19
Kerala Blast,9287,4,5,4,5,12,16,-4,19
NorthEast Un,9287,5,5,3,6,14,13,1,18
Chennaiyin,9287,6,4,5,5,16,20,-4,17
FC Pune City,9287,7,4,4,6,13,16,-3,16
FC Goa,9287,8,4,3,7,11,17,-6,15
Mumbai City,9288,1,7,4,3,17,8,9,25
Kolkata,9288,2,5,6,3,19,15,4,21
Kerala Blast,9288,3,6,3,5,12,18,-6,21
Delhi Dynamo,9288,4,5,5,4,24,20,4,20
NorthEast Un,9288,5,5,3,6,15,13,2,18
FC Pune City,9288,6,5,3,6,16,17,-1,18
Chennaiyin,9288,7,3,6,5,15,20,-5,15
FC Goa,9288,8,4,2,8,10,17,-7,14
Delhi Dynamo,9289,1,6,5,3,24,16,8,23
Mumbai City,9289,2,6,4,4,16,9,7,22
Kerala Blast,9289,3,6,4,4,13,14,-1,22
Kolkata,9289,4,4,7,3,16,16,0,19
FC Pune City,9289,5,5,3,6,15,17,-2,18
FC Goa,9289,6,5,2,7,10,15,-5,17
NorthEast Un,9289,7,4,3,7,11,13,-2,15
Chennaiyin,9289,8,3,6,5,14,19,-5,15
Mumbai City,9290,1,6,4,4,17,10,7,22
Kerala Blast,9290,2,6,4,4,13,15,-2,22
Delhi Dynamo,9290,3,5,5,4,23,17,6,20
Kolkata,9290,4,4,6,4,15,15,0,18
Chennaiyin,9290,5,4,6,4,17,18,-1,18
FC Goa,9290,6,5,3,6,12,16,-4,18
NorthEast Un,9290,7,5,2,7,11,14,-3,17
FC Pune City,9290,8,4,4,6,13,16,-3,16
Mumbai City,9291,1,7,4,3,18,9,9,25
NorthEast Un,9291,2,6,3,5,15,12,3,21
Kerala Blast,9291,3,5,4,5,11,16,-5,19
FC Goa,9291,4,5,3,6,16,16,0,18
Delhi Dynamo,9291,5,4,5,5,23,21,2,17
Kolkata,9291,6,3,8,3,14,14,0,17
FC Pune City,9291,7,4,5,5,12,14,-2,17
Chennaiyin,9291,8,3,6,5,15,22,-7,15
Delhi Dynamo,9292,1,6,6,2,26,16,10,24
Mumbai City,9292,2,6,5,3,16,8,8,23
Kerala Blast,9292,3,5,4,5,13,17,-4,19
NorthEast Un,9292,4,5,3,6,12,13,-1,18
Chennaiyin,9292,5,4,6,4,16,18,-2,18
Kolkata,9292,6,3,8,3,16,16,0,17
FC Pune City,9292,7,4,4,6,16,19,-3,16
FC Goa,9292,8,4,2,8,12,20,-8,14
Mumbai City,9293,1,6,5,3,16,8,8,23
Delhi Dynamo,9293,2,5,7,2,25,15,10,22
FC Pune City,9293,3,6,3,5,16,15,1,21
Kolkata,9293,4,4,7,3,16,13,3,19
Chennaiyin,9293,5,4,5,5,16,20,-4,17
FC Goa,9293,6,4,4,6,11,16,-5,16
Kerala Blast,9293,7,4,4,6,11,20,-9,16
NorthEast Un,9293,8,4,3,7,11,15,-4,15
Mumbai City,9294,1,7,4,3,21,9,12,25
Delhi Dynamo,9294,2,6,5,3,27,20,7,23
Kolkata,9294,3,5,7,2,17,14,3,22
Kerala Blast,9294,4,5,5,4,12,15,-3,20
Chennaiyin,9294,5,4,6,4,17,17,0,18
FC Pune City,9294,6,4,4,6,14,17,-3,16
NorthEast Un,9294,7,4,2,8,10,17,-7,14
FC Goa,9294,8,3,3,8,8,17,-9,12
Mumbai City,9295,1,7,4,3,17,8,9,25
Kolkata,9295,2,6,6,2,19,14,5,24
Delhi Dynamo,9295,3,5,6,3,24,17,7,21
NorthEast Un,9295,4,5,4,5,13,12,1,19
Kerala Blast,9295,5,5,4,5,13,17,-4,19
Chennaiyin,9295,6,4,5,5,15,19,-4,17
FC Pune City,9295,7,4,3,7,15,20,-5,15
FC Goa,9295,8,3,2,9,9,18,-9,11
Mumbai City,9296,1,7,4,3,18,9,9,25
Kerala Blast,9296,2,6,4,4,15,16,-1,22
Delhi Dynamo,9296,3,4,7,3,27,21,6,19
Kolkata,9296,4,4,7,3,15,13,2,19
FC Pune City,9296,5,4,5,5,14,16,-2,17
Chennaiyin,9296,6,4,5,5,14,18,-4,17
NorthEast Un,9296,7,4,3,7,13,16,-3,15
FC Goa,9296,8,4,3,7,11,18,-7,15
Mumbai City,9297,1,7,4,3,17,8,9,25
Delhi Dynamo,9297,2,6,5,3,25,16,9,23
FC Pune City,9297,3,6,3,5,15,14,1,21
NorthEast Un,9297,4,6,2,6,14,13,1,20
Kolkata,9297,5,4,6,4,14,16,-2,18
FC Goa,9297,6,5,2,7,12,16,-4,17
Kerala Blast,9297,7,4,3,7,11,18,-7,15
Chennaiyin,9297,8,3,5,6,13,20,-7,14
Delhi Dynamo,9298,1,6,6,2,30,16,14,24
Mumbai City,9298,2,6,5,3,17,9,8,23
Kolkata,9298,3,5,7,2,18,13,5,22
Kerala Blast,9298,4,6,3,5,13,15,-2,21
Chennaiyin,9298,5,4,5,5,15,21,-6,17
FC Pune City,9298,6,4,4,6,14,17,-3,16
NorthEast Un,9298,7,4,2,8,11,18,-7,14
FC Goa,9298,8,4,2,8,11,20,-9,14
Delhi Dynamo,9299,1,6,5,3,26,16,10,23
Kolkata,9299,2,5,7,2,18,12,6,22
Mumbai City,9299,3,6,4,4,16,10,6,22
Kerala Blast,9299,4,5,4,5,11,16,-5,19
Chennaiyin,9299,5,4,6,4,15,18,-3,18
NorthEast Un,9299,6,5,2,7,12,13,-1,17
FC Pune City,9299,7,4,4,6,12,17,-5,16
FC Goa,9299,8,3,4,7,9,17,-8,13
Delhi Dynamo,9300,1,6,5,3,26,17,9,23
Mumbai City,9300,2,6,4,4,16,9,7,22
FC Pune City,9300,3,5,4,5,15,15,0,19
NorthEast Un,9300,4,5,3,6,14,14,0,18
Kerala Blast,9300,5,4,6,4,14,18,-4,18
FC Goa,9300,6,5,2,7,13,17,-4,17
Chennaiyin,9300,7,4,5,5,15,21,-6,17
Kolkata,9300,8,3,7,4,15,17,-2,16
Delhi Dynamo,9301,1,7,5,2,27,16,11,26
Mumbai City,9301,2,6,4,4,17,11,6,22
NorthEast Un,9301,3,6,2,6,12,10,2,20
Kolkata,9301,4,4,6,4,17,18,-1,18
FC Pune City,9301,5,5,3,6,14,17,-3,18
Kerala Blast,9301,6,5,3,6,10,15,-5,18
FC Goa,9301,7,5,2,7,16,19,-3,17
Chennaiyin,9301,8,3,5,6,15,22,-7,14
Mumbai City,9302,1,7,4,3,19,8,11,25
Delhi Dynamo,9302,2,5,6,3,24,19,5,21
Chennaiyin,9302,3,5,5,4,17,18,-1,20
Kerala Blast,9302,4,5,4,5,12,16,-4,19
NorthEast Un,9302,5,5,3,6,12,11,1,18
FC Pune City,9302,6,5,3,6,16,17,-1,18
Kolkata,9302,7,3,7,4,16,20,-4,16
FC Goa,9302,8,4,2,8,13,20,-7,14
Delhi Dynamo,9303,1,6,6,2,27,16,11,24
Mumbai City,9303,2,6,5,3,17,9,8,23
Kolkata,9303,3,4,8,2,20,18,2,20
Kerala Blast,9303,4,5,4,5,16,19,-3,19
NorthEast Un,9303,5,4,4,6,10,11,-1,16
FC Pune City,9303,6,4,4,6,14,18,-4,16
Chennaiyin,9303,7,3,6,5,13,19,-6,15
FC Goa,9303,8,4,3,7,15,22,-7,15
Mumbai City,9304,1,6,4,4,16,9,7,22
Delhi Dynamo,9304,2,5,5,4,22,19,3,20
NorthEast Un,9304,3,6,2,6,13,11,2,20
Kolkata,9304,4,4,7,3,18,17,1,19
FC Pune City,9304,5,5,4,5,15,16,-1,19
Chennaiyin,9304,6,4,6,4,16,19,-3,18
Kerala Blast,9304,7,4,5,5,11,16,-5,17
FC Goa,9304,8,4,3,7,14,18,-4,15
Mumbai City,9305,1,7,4,3,19,9,10,25
Kolkata,9305,2,6,6,2,21,15,6,24
Kerala Blast,9305,3,5,4,5,12,17,-5,19
Delhi Dynamo,9305,4,4,6,4,23,21,2,18
Chennaiyin,9305,5,4,6,4,17,20,-3,18
NorthEast Un,9305,6,4,4,6,10,11,-1,16
FC Pune City,9305,7,4,3,7,13,17,-4,15
FC Goa,9305,8,4,3,7,14,19,-5,15
Mumbai City,9306,1,7,4,3,18,9,9,25
Kolkata,9306,2,5,7,2,20,16,4,22
NorthEast Un,9306,3,6,3,5,13,11,2,21
Delhi Dynamo,9306,4,4,6,4,23,18,5,18
Kerala Blast,9306,5,5,3,6,12,18,-6,18
FC Goa,9306,6,4,4,6,12,17,-5,16
FC Pune City,9306,7,4,3,7,13,17,-4,15
Chennaiyin,9306,8,3,6,5,14,19,-5,15
Mumbai City,9307,1,7,4,3,18,9,9,25
NorthEast Un,9307,2,7,2,5,17,11,6,23
Delhi Dynamo,9307,3,5,5,4,27,17,10,20
Kolkata,9307,4,4,7,3,17,16,1,19
FC Pune City,9307,5,5,3,6,16,17,-1,18
Kerala Blast,9307,6,5,3,6,11,18,-7,18
Chennaiyin,9307,7,3,6,5,15,22,-7,15
FC Goa,9307,8,3,4,7,10,21,-11,13
Delhi Dynamo,9308,1,5,7,2,26,18,8,22
Mumbai City,9308,2,6,4,4,17,10,7,22
Kolkata,9308,3,5,6,3,16,13,3,21
Kerala Blast,9308,4,5,5,4,11,14,-3,20
NorthEast Un,9308,5,5,4,5,11,10,1,19
Chennaiyin,9308,6,4,5,5,14,18,-4,17
FC Pune City,9308,7,4,4,6,13,17,-4,16
FC Goa,9308,8,3,3,8,10,18,-8,12
Mumbai City,9309,1,7,4,3,19,10,9,25
Kolkata,9309,2,5,6,3,18,16,2,21
Delhi Dynamo,9309,3,5,5,4,26,19,7,20
NorthEast Un,9309,4,6,2,6,13,11,2,20
FC Pune City,9309,5,5,3,6,16,16,0,18
Kerala Blast,9309,6,5,3,6,11,19,-8,18
Chennaiyin,9309,7,4,5,5,16,20,-4,17
FC Goa,9309,8,4,2,8,11,19,-8,14
Mumbai City,9310,1,7,4,3,17,8,9,25
Delhi Dynamo,9310,2,5,6,3,28,17,11,21
Kerala Blast,9310,3,6,3,5,13,15,-2,21
Chennaiyin,9310,4,5,5,4,16,18,-2,20
Kolkata,9310,5,4,6,4,16,16,0,18
FC Pune City,9310,6,5,3,6,13,16,-3,18
NorthEast Un,9310,7,4,3,7,11,14,-3,15
FC Goa,9310,8,4,2,8,11,21,-10,14
Mumbai City,9311,1,6,5,3,18,10,8,23
Kerala Blast,9311,2,6,4,4,14,16,-2,22
Kolkata,9311,3,5,6,3,19,16,3,21
Delhi Dynamo,9311,4,4,7,3,26,20,6,19
NorthEast Un,9311,5,5,3,6,13,13,0,18
Chennaiyin,9311,6,4,5,5,17,20,-3,17
FC Pune City,9311,7,4,4,6,13,17,-4,16
FC Goa,9311,8,4,2,8,12,20,-8,14
Mumbai City,9312,1,7,4,3,17,8,9,25
Delhi Dynamo,9312,2,6,5,3,24,15,9,23
Kerala Blast,9312,3,6,3,5,12,15,-3,21
Kolkata,9312,4,4,6,4,16,17,-1,18
FC Pune City,9312,5,5,3,6,14,17,-3,18
NorthEast Un,9312,6,5,2,7,11,11,0,17
FC Goa,9312,7,5,2,7,14,18,-4,17
Chennaiyin,9312,8,3,5,6,15,22,-7,14
Delhi Dynamo,9313,1,7,5,2,30,17,13,26
Mumbai City,9313,2,6,4,4,18,13,5,22
Kerala Blast,9313,3,5,5,4,11,14,-3,20
Kolkata,9313,4,4,7,3,16,14,2,19
Chennaiyin,9313,5,4,5,5,14,18,-4,17
FC Goa,9313,6,5,2,7,11,17,-6,17
FC Pune City,9313,7,4,4,6,12,16,-4,16
NorthEast Un,9313,8,4,2,8,9,12,-3,14
Mumbai City,9314,1,7,4,3,17,8,9,25
Kerala Blast,9314,2,6,3,5,14,16,-2,21
Delhi Dynamo,9314,3,5,5,4,24,18,6,20
Chennaiyin,9314,4,4,6,4,18,19,-1,18
Kolkata,9314,4,4,6,4,18,19,-1,18
FC Pune City,9314,6,5,3,6,15,17,-2,18
NorthEast Un,9314,7,5,2,7,13,14,-1,17
FC Goa,9314,8,4,3,7,11,19,-8,15
Kerala Blast,9315,1,7,3,4,13,13,0,24
Mumbai City,9315,2,6,5,3,18,10,8,23
Delhi Dynamo,9315,3,5,6,3,27,18,9,21
Kolkata,9315,4,4,7,3,15,15,0,19
NorthEast Un,9315,5,5,3,6,12,12,0,18
Chennaiyin,9315,6,4,6,4,17,20,-3,18
FC Pune City,9315,7,4,4,6,13,16,-3,16
FC Goa,9315,8,3,2,9,10,21,-11,11
Mumbai City,9316,1,7,4,3,19,10,9,25
Delhi Dynamo,9316,2,5,6,3,28,18,10,21
NorthEast Un,9316,3,6,3,5,13,10,3,21
FC Pune City,9316,4,6,3,5,15,15,0,21
Kolkata,9316,5,4,7,3,15,14,1,19
Kerala Blast,9316,6,4,4,6,9,15,-6,16
Chennaiyin,9316,7,3,5,6,13,21,-8,14
FC Goa,9316,8,4,2,8,10,19,-9,14
Mumbai City,9317,1,6,5,3,16,8,8,23
Kerala Blast,9317,2,6,4,4,16,15,1,22
Delhi Dynamo,9317,3,5,6,3,23,16,7,21
Chennaiyin,9317,4,5,5,4,16,17,-1,20
Kolkata,9317,5,4,6,4,15,16,-1,18
FC Pune City,9317,6,5,3,6,14,18,-4,18
NorthEast Un,9317,7,4,3,7,11,13,-2,15
FC Goa,9317,8,4,2,8,10,18,-8,14
Mumbai City,9318,1,7,4,3,18,9,9,25
Delhi Dynamo,9318,2,5,5,4,25,21,4,20
Kolkata,9318,3,4,8,2,15,12,3,20
Chennaiyin,9318,4,5,5,4,19,18,1,20
FC Pune City,9318,5,5,4,5,14,15,-1,19
NorthEast Un,9318,6,5,3,6,13,13,0,18
Kerala Blast,9318,7,4,4,6,11,18,-7,16
FC Goa,9318,8,3,3,8,11,20,-9,12
Mumbai City,9319,1,7,4,3,18,8,10,25
Delhi Dynamo,9319,2,5,6,3,22,16,6,21
FC Pune City,9319,3,6,3,5,16,14,2,21
NorthEast Un,9319,4,5,4,5,12,11,1,19
Kolkata,9319,5,3,8,3,15,17,-2,17
Kerala Blast,9319,6,4,4,6,11,17,-6,16
Chennaiyin,9319,7,3,6,5,14,19,-5,15
FC Goa,9319,8,4,3,7,10,16,-6,15
Delhi Dynamo,9320,1,6,6,2,24,15,9,24
Kerala Blast,9320,2,7,3,4,15,14,1,24
Mumbai City,9320,3,6,4,4,16,9,7,22
Kolkata,9320,4,4,6,4,14,15,-1,18
FC Goa,9320,5,5,2,7,11,15,-4,17
NorthEast Un,9320,6,4,4,6,11,13,-2,16
Chennaiyin,9320,7,3,6,5,13,18,-5,15
FC Pune City,9320,8,4,3,7,12,17,-5,15
Mumbai City,9321,1,7,4,3,18,9,9,25
Kerala Blast,9321,2,6,4,4,16,17,-1,22
Delhi Dynamo,9321,3,5,6,3,25,18,7,21
Chennaiyin,9321,4,5,5,4,17,18,-1,20
FC Pune City,9321,5,4,5,5,17,19,-2,17
Kolkata,9321,6,3,7,4,16,17,-1,16
NorthEast Un,9321,7,4,3,7,11,14,-3,15
FC Goa,9321,8,4,2,8,10,18,-8,14
Mumbai City,9322,1,7,4,3,18,8,10,25
Delhi Dynamo,9322,2,6,5,3,24,16,8,23
Kerala Blast,9322,3,6,4,4,12,13,-1,22
Kolkata,9322,4,4,7,3,16,14,2,19
NorthEast Un,9322,5,5,2,7,12,14,-2,17
FC Pune City,9322,6,4,4,6,12,16,-4,16
FC Goa,9322,7,4,3,7,11,17,-6,15
Chennaiyin,9322,8,3,5,6,15,22,-7,14
Mumbai City,9323,1,7,4,3,18,9,9,25
Kolkata,9323,2,4,8,2,19,15,4,20
Delhi Dynamo,9323,3,4,7,3,22,16,6,19
Kerala Blast,9323,4,5,4,5,13,17,-4,19
FC Pune City,9323,5,4,5,5,15,17,-2,17
NorthEast Un,9323,6,4,4,6,9,12,-3,16
Chennaiyin,9323,7,3,7,4,14,18,-4,16
FC Goa,9323,8,3,5,6,10,16,-6,14
Mumbai City,9324,1,7,4,3,20,10,10,25
Delhi Dynamo,9324,2,6,5,3,32,23,9,23
FC Pune City,9324,3,6,3,5,16,14,2,21
Kolkata,9324,4,4,7,3,17,16,1,19
Kerala Blast,9324,5,5,3,6,11,17,-6,18
Chennaiyin,9324,6,3,6,5,15,20,-5,15
NorthEast Un,9324,7,4,3,7,12,17,-5,15
FC Goa,9324,8,4,3,7,14,20,-6,15
Mumbai City,9325,1,7,4,3,18,9,9,25
FC Pune City,9325,2,6,3,5,17,15,2,21
Delhi Dynamo,9325,3,4,7,3,23,17,6,19
Kolkata,9325,4,4,7,3,18,18,0,19
Kerala Blast,9325,5,5,4,5,11,15,-4,19
Chennaiyin,9325,6,4,6,4,16,19,-3,18
NorthEast Un,9325,7,4,4,6,10,11,-1,16
FC Goa,9325,8,3,3,8,11,20,-9,12
Mumbai City,9326,1,7,4,3,18,9,9,25
NorthEast Un,9326,2,6,2,6,14,14,0,20
Kolkata,9326,3,4,7,3,17,18,-1,19
Kerala Blast,9326,4,5,4,5,15,18,-3,19
FC Goa,9326,5,5,3,6,15,17,-2,18
Delhi Dynamo,9326,6,4,5,5,24,20,4,17
FC Pune City,9326,7,4,5,5,16,18,-2,17
Chennaiyin,9326,8,3,6,5,16,21,-5,15
Mumbai City,9327,1,7,4,3,17,8,9,25
Delhi Dynamo,9327,2,6,5,3,27,15,12,23
Kerala Blast,9327,3,6,4,4,14,14,0,22
Kolkata,9327,4,3,8,3,14,14,0,17
NorthEast Un,9327,5,5,2,7,12,14,-2,17
Chennaiyin,9327,6,4,5,5,16,20,-4,17
FC Pune City,9327,7,4,4,6,12,17,-5,16
FC Goa,9327,8,4,2,8,9,19,-10,14
Delhi Dynamo,9328,1,6,5,3,28,17,11,23
Mumbai City,9328,2,6,4,4,16,10,6,22
Kolkata,9328,3,5,7,2,17,13,4,22
Chennaiyin,9328,4,5,5,4,17,17,0,20
Kerala Blast,9328,5,5,4,5,11,14,-3,19
FC Pune City,9328,6,5,3,6,13,15,-2,18
NorthEast Un,9328,7,5,2,7,11,15,-4,17
FC Goa,9328,8,3,2,9,10,22,-12,11
Kolkata,9329,1,6,6,2,20,13,7,24
NorthEast Un,9329,2,7,2,5,16,12,4,23
Mumbai City,9329,3,6,4,4,17,10,7,22
Delhi Dynamo,9329,4,5,6,3,25,19,6,21
Kerala Blast,9329,5,5,3,6,13,17,-4,18
Chennaiyin,9329,6,4,5,5,16,20,-4,17
FC Pune City,9329,7,4,3,7,14,21,-7,15
FC Goa,9329,8,3,3,8,9,18,-9,12
Mumbai City,9330,1,7,4,3,21,8,13,25
Delhi Dynamo,9330,2,5,6,3,23,20,3,21
Kolkata,9330,3,5,6,3,18,16,2,21
Kerala Blast,9330,4,5,4,5,11,15,-4,19
NorthEast Un,9330,5,5,3,6,11,11,0,18
FC Pune City,9330,6,4,4,6,13,17,-4,16
Chennaiyin,9330,7,3,6,5,15,20,-5,15
FC Goa,9330,8,4,3,7,14,19,-5,15
Delhi Dynamo,9331,1,6,6,2,26,15,11,24
Mumbai City,9331,2,6,5,3,17,9,8,23
Kolkata,9331,3,4,7,3,14,13,1,19
FC Pune City,9331,4,5,4,5,13,14,-1,19
Kerala Blast,9331,5,5,3,6,10,15,-5,18
Chennaiyin,9331,6,3,7,4,14,18,-4,16
NorthEast Un,9331,7,4,3,7,9,11,-2,15
FC Goa,9331,8,4,3,7,10,18,-8,15
Mumbai City,9332,1,7,4,3,21,10,11,25
NorthEast Un,9332,2,6,3,5,15,12,3,21
Kolkata,9332,3,5,6,3,16,16,0,21
Delhi Dynamo,9332,4,4,6,4,26,24,2,18
FC Goa,9332,5,5,3,6,14,15,-1,18
Kerala Blast,9332,6,5,3,6,11,15,-4,18
FC Pune City,9332,7,4,3,7,13,18,-5,15
Chennaiyin,9332,8,3,6,5,14,20,-6,15
Mumbai City,9333,1,7,4,3,20,10,10,25
Kolkata,9333,2,5,7,2,18,13,5,22
Delhi Dynamo,9333,3,5,5,4,24,21,3,20
Chennaiyin,9333,4,5,5,4,16,17,-1,20
FC Pune City,9333,5,5,3,6,16,19,-3,18
NorthEast Un,9333,6,5,2,7,10,11,-1,17
FC Goa,9333,7,4,3,7,11,16,-5,15
Kerala Blast,9333,8,4,3,7,10,18,-8,15
Delhi Dynamo,9334,1,6,6,2,27,18,9,24
Mumbai City,9334,2,6,4,4,18,11,7,22
Kerala Blast,9334,3,6,4,4,15,13,2,22
Kolkata,9334,4,4,7,3,17,16,1,19
FC Goa,9334,5,5,2,7,13,18,-5,17
NorthEast Un,9334,6,4,4,6,11,14,-3,16
Chennaiyin,9334,7,3,6,5,13,18,-5,15
FC Pune City,9334,8,4,3,7,12,18,-6,15
Mumbai City,9335,1,7,4,3,20,11,9,25
NorthEast Un,9335,2,6,3,5,15,10,5,21
Kerala Blast,9335,3,5,5,4,10,13,-3,20
Kolkata,9335,4,4,7,3,14,13,1,19
Delhi Dynamo,9335,5,4,5,5,25,23,2,17
FC Pune City,9335,6,4,5,5,12,14,-2,17
Chennaiyin,9335,7,3,6,5,16,22,-6,15
FC Goa,9335,8,4,3,7,12,18,-6,15
Mumbai City,9336,1,7,4,3,18,8,10,25
Delhi Dynamo,9336,2,5,6,3,26,20,6,21
NorthEast Un,9336,3,6,3,5,15,11,4,21
Kolkata,9336,4,3,9,2,14,13,1,18
FC Pune City,9336,5,4,5,5,13,15,-2,17
Kerala Blast,9336,6,4,5,5,9,16,-7,17
Chennaiyin,9336,7,3,6,5,14,19,-5,15
FC Goa,9336,8,3,4,7,11,18,-7,13
Mumbai City,9337,1,7,4,3,18,9,9,25
Kolkata,9337,2,5,7,2,19,16,3,22
Delhi Dynamo,9337,3,5,5,4,24,17,7,20
Kerala Blast,9337,4,5,4,5,12,16,-4,19
FC Pune City,9337,5,5,3,6,15,17,-2,18
Chennaiyin,9337,6,4,5,5,15,19,-4,17
FC Goa,9337,7,5,2,7,11,16,-5,17
NorthEast Un,9337,8,4,2,8,9,13,-4,14
Mumbai City,9338,1,6,5,3,17,9,8,23
Delhi Dynamo,9338,2,5,7,2,27,19,8,22
Kerala Blast,9338,3,6,4,4,12,14,-2,22
Kolkata,9338,4,5,6,3,18,16,2,21
Chennaiyin,9338,5,4,6,4,19,20,-1,18
NorthEast Un,9338,6,4,4,6,13,14,-1,16
FC Pune City,9338,7,4,3,7,14,18,-4,15
FC Goa,9338,8,3,3,8,13,23,-10,12
Delhi Dynamo,9339,1,5,7,2,25,17,8,22
Mumbai City,9339,2,6,4,4,16,9,7,22
Kerala Blast,9339,3,6,4,4,16,16,0,22
Kolkata,9339,4,4,8,2,17,14,3,20
NorthEast Un,9339,5,5,3,6,14,15,-1,18
FC Goa,9339,6,4,4,6,12,16,-4,16
FC Pune City,9339,7,4,3,7,13,19,-6,15
Chennaiyin,9339,8,3,5,6,14,21,-7,14
Mumbai City,9340,1,7,4,3,17,8,9,25
Delhi Dynamo,9340,2,5,6,3,24,17,7,21
Kolkata,9340,3,5,6,3,19,16,3,21
NorthEast Un,9340,4,5,3,6,14,13,1,18
Kerala Blast,9340,5,5,3,6,13,19,-6,18
Chennaiyin,9340,6,3,7,4,16,20,-4,16
FC Goa,9340,7,4,4,6,14,18,-4,16
FC Pune City,9340,8,4,3,7,13,19,-6,15
Mumbai City,9341,1,7,4,3,17,8,9,25
Delhi Dynamo,9341,2,6,5,3,23,15,8,23
Kolkata,9341,3,5,7,2,19,14,5,22
NorthEast Un,9341,4,5,3,6,11,11,0,18
Kerala Blast,9341,5,4,6,4,14,18,-4,18
FC Pune City,9341,6,4,4,6,14,19,-5,16
Chennaiyin,9341,7,3,5,6,13,19,-6,14
FC Goa,9341,8,4,2,8,9,16,-7,14
Kerala Blast,9342,1,7,3,4,16,15,1,24
Mumbai City,9342,2,6,5,3,17,9,8,23
Delhi Dynamo,9342,3,5,7,2,25,17,8,22
FC Pune City,9342,4,5,3,6,15,17,-2,18
FC Goa,9342,5,5,3,6,10,14,-4,18
NorthEast Un,9342,6,4,3,7,12,14,-2,15
Kolkata,9342,7,3,6,5,15,19,-4,15
Chennaiyin,9342,8,3,6,5,14,19,-5,15
Kolkata,9343,1,6,6,2,20,13,7,24
Mumbai City,9343,2,6,4,4,17,10,7,22
Delhi Dynamo,9343,3,5,6,3,24,17,7,21
NorthEast Un,9343,4,5,4,5,11,10,1,19
FC Pune City,9343,5,5,3,6,13,17,-4,18
Chennaiyin,9343,6,4,5,5,15,19,-4,17
Kerala Blast,9343,7,4,4,6,11,17,-6,16
FC Goa,9343,8,4,2,8,11,19,-8,14
Mumbai City,9344,1,7,4,3,17,8,9,25
Delhi Dynamo,9344,2,5,5,4,26,18,8,20
Chennaiyin,9344,3,5,5,4,17,17,0,20
NorthEast Un,9344,4,6,2,6,13,13,0,20
Kolkata,9344,5,4,6,4,15,15,0,18
FC Pune City,9344,6,5,3,6,15,16,-1,18
Kerala Blast,9344,7,5,3,6,10,17,-7,18
FC Goa,9344,8,4,2,8,10,19,-9,14
Delhi Dynamo,9345,1,6,6,2,29,17,12,24
Mumbai City,9345,2,6,4,4,17,13,4,22
Kolkata,9345,3,5,6,3,17,15,2,21
Chennaiyin,9345,4,5,5,4,16,18,-2,20
Kerala Blast,9345,5,5,4,5,12,16,-4,19
FC Pune City,9345,6,4,4,6,13,16,-3,16
NorthEast Un,9345,7,4,3,7,10,13,-3,15
FC Goa,9345,8,4,2,8,13,19,-6,14
Delhi Dynamo,9346,1,6,6,2,28,18,10,24
Mumbai City,9346,2,6,5,3,18,10,8,23
Kerala Blast,9346,3,5,5,4,13,16,-3,20
Kolkata,9346,4,4,7,3,16,17,-1,19
FC Pune City,9346,5,5,3,6,18,18,0,18
Chennaiyin,9346,6,4,6,4,15,18,-3,18
NorthEast Un,9346,7,4,4,6,10,11,-1,16
FC Goa,9346,8,3,2,9,10,20,-10,11
Mumbai City,9347,1,7,4,3,18,9,9,25
Delhi Dynamo,9347,2,5,6,3,23,16,7,21
FC Pune City,9347,3,6,3,5,15,15,0,21
Chennaiyin,9347,4,4,6,4,15,18,-3,18
Kolkata,9347,5,3,8,3,14,14,0,17
Kerala Blast,9347,6,4,5,5,12,17,-5,17
NorthEast Un,9347,7,4,3,7,12,14,-2,15
FC Goa,9347,8,3,5,6,9,15,-6,14
Mumbai City,9348,1,7,4,3,19,9,10,25
Delhi Dynamo,9348,2,5,6,3,27,18,9,21
Kolkata,9348,3,5,6,3,21,19,2,21
Kerala Blast,9348,4,5,4,5,14,18,-4,19
NorthEast Un,9348,5,5,3,6,16,15,1,18
FC Pune City,9348,6,4,4,6,14,18,-4,16
Chennaiyin,9348,7,3,6,5,15,21,-6,15
FC Goa,9348,8,4,3,7,11,19,-8,15
Mumbai City,9349,1,7,4,3,17,8,9,25
Kolkata,9349,2,5,7,2,18,14,4,22
Delhi Dynamo,9349,3,5,5,4,26,20,6,20
FC Pune City,9349,4,5,3,6,14,15,-1,18
Chennaiyin,9349,5,4,6,4,15,18,-3,18
NorthEast Un,9349,6,5,2,7,14,15,-1,17
Kerala Blast,9349,7,4,4,6,10,17,-7,16
FC Goa,9349,8,4,3,7,11,18,-7,15
Mumbai City,9350,1,7,4,3,18,9,9,25
Delhi Dynamo,9350,2,5,6,3,27,18,9,21
Kerala Blast,9350,3,6,3,5,13,14,-1,21
Kolkata,9350,4,4,8,2,17,15,2,20
NorthEast Un,9350,5,5,2,7,11,13,-2,17
Chennaiyin,9350,6,4,5,5,15,20,-5,17
FC Pune City,9350,7,4,4,6,14,19,-5,16
FC Goa,9350,8,3,4,7,12,19,-7,13
Mumbai City,9351,1,7,4,3,17,8,9,25
NorthEast Un,9351,2,6,3,5,16,13,3,21
FC Pune City,9351,3,6,3,5,15,14,1,21
Delhi Dynamo,9351,4,5,5,4,23,18,5,20
Kolkata,9351,5,4,6,4,15,17,-2,18
FC Goa,9351,6,5,2,7,13,16,-3,17
Kerala Blast,9351,7,4,4,6,10,17,-7,16
Chennaiyin,9351,8,3,5,6,16,22,-6,14
Delhi Dynamo,9352,1,6,5,3,28,18,10,23
Mumbai City,9352,2,6,4,4,18,11,7,22
NorthEast Un,9352,3,6,3,5,12,9,3,21
Kolkata,9352,4,4,7,3,16,15,1,19
Kerala Blast,9352,5,5,4,5,12,17,-5,19
FC Goa,9352,6,5,2,7,13,19,-6,17
FC Pune City,9352,7,4,4,6,13,16,-3,16
Chennaiyin,9352,8,3,5,6,14,21,-7,14
Mumbai City,9353,1,7,4,3,19,9,10,25
Kolkata,9353,2,6,6,2,18,12,6,24
Delhi Dynamo,9353,3,5,6,3,25,18,7,21
Kerala Blast,9353,4,5,4,5,13,18,-5,19
Chennaiyin,9353,5,4,5,5,15,19,-4,17
NorthEast Un,9353,6,4,4,6,12,13,-1,16
FC Pune City,9353,7,4,3,7,12,17,-5,15
FC Goa,9353,8,4,2,8,10,18,-8,14
Mumbai City,9354,1,7,4,3,18,9,9,25
NorthEast Un,9354,2,6,3,5,15,11,4,21
FC Pune City,9354,3,6,3,5,15,15,0,21
Delhi Dynamo,9354,4,4,6,4,23,20,3,18
Kolkata,9354,5,4,6,4,17,17,0,18
Chennaiyin,9354,6,4,6,4,17,19,-2,18
FC Goa,9354,7,4,3,7,12,19,-7,15
Kerala Blast,9354,8,4,3,7,11,18,-7,15
Mumbai City,9355,1,7,4,3,18,8,10,25
Delhi Dynamo,9355,2,5,6,3,26,18,8,21
Kerala Blast,9355,3,6,3,5,12,16,-4,21
FC Pune City,9355,4,5,3,6,15,16,-1,18
Kolkata,9355,5,4,6,4,14,15,-1,18
Chennaiyin,9355,6,4,5,5,17,20,-3,17
FC Goa,9355,7,5,2,7,13,19,-6,17
NorthEast Un,9355,8,4,3,7,11,14,-3,15
Mumbai City,9356,1,7,4,3,18,9,9,25
NorthEast Un,9356,2,6,3,5,16,13,3,21
Delhi Dynamo,9356,3,5,5,4,27,18,9,20
Kolkata,9356,4,4,6,4,15,16,-1,18
FC Pune City,9356,5,5,3,6,14,17,-3,18
Kerala Blast,9356,6,5,3,6,13,18,-5,18
FC Goa,9356,7,5,2,7,13,20,-7,17
Chennaiyin,9356,8,3,6,5,17,22,-5,15
Mumbai City,9357,1,6,5,3,17,9,8,23
NorthEast Un,9357,2,7,2,5,14,11,3,23
Delhi Dynamo,9357,3,5,6,3,25,18,7,21
FC Pune City,9357,4,6,3,5,16,15,1,21
Kolkata,9357,5,4,7,3,15,15,0,19
Chennaiyin,9357,6,4,5,5,16,20,-4,17
Kerala Blast,9357,7,4,4,6,9,15,-6,16
FC Goa,9357,8,3,2,9,10,19,-9,11
Mumbai City,9358,1,7,4,3,18,8,10,25
Kerala Blast,9358,2,7,3,4,14,13,1,24
Delhi Dynamo,9358,3,4,6,4,23,19,4,18
Kolkata,9358,4,4,6,4,16,16,0,18
Chennaiyin,9358,5,4,6,4,16,18,-2,18
FC Goa,9358,6,5,2,7,12,18,-6,17
NorthEast Un,9358,7,4,4,6,11,14,-3,16
FC Pune City,9358,8,4,3,7,13,17,-4,15
Mumbai City,9359,1,7,4,3,18,8,10,25
Delhi Dynamo,9359,2,6,5,3,24,16,8,23
Kerala Blast,9359,3,5,5,4,13,15,-2,20
Chennaiyin,9359,4,4,6,4,14,17,-3,18
Kolkata,9359,5,3,8,3,17,17,0,17
FC Pune City,9359,6,4,4,6,15,19,-4,16
NorthEast Un,9359,7,4,3,7,9,11,-2,15
FC Goa,9359,8,4,3,7,10,17,-7,15
Mumbai City,9360,1,6,4,4,17,11,6,22
Delhi Dynamo,9360,2,5,6,3,26,18,8,21
FC Goa,9360,3,6,2,6,14,16,-2,20
Kolkata,9360,4,4,7,3,17,16,1,19
NorthEast Un,9360,5,5,3,6,12,12,0,18
FC Pune City,9360,6,5,3,6,16,18,-2,18
Chennaiyin,9360,7,4,5,5,14,18,-4,17
Kerala Blast,9360,8,4,4,6,11,18,-7,16
Mumbai City,9361,1,6,5,3,16,8,8,23
Kolkata,9361,2,5,6,3,19,17,2,21
Delhi Dynamo,9361,3,4,7,3,22,16,6,19
Kerala Blast,9361,4,5,4,5,13,18,-5,19
NorthEast Un,9361,5,5,3,6,12,11,1,18
FC Goa,9361,6,5,3,6,15,16,-1,18
FC Pune City,9361,7,4,4,6,15,20,-5,16
Chennaiyin,9361,8,3,6,5,14,20,-6,15
Mumbai City,9362,1,6,5,3,17,9,8,23
Delhi Dynamo,9362,2,4,7,3,23,17,6,19
Kolkata,9362,3,4,7,3,19,18,1,19
FC Pune City,9362,4,5,4,5,17,18,-1,19
Kerala Blast,9362,5,5,4,5,13,17,-4,19
NorthEast Un,9362,6,5,3,6,11,11,0,18
Chennaiyin,9362,7,4,6,4,14,17,-3,18
FC Goa,9362,8,3,4,7,10,17,-7,13
Mumbai City,9363,1,7,4,3,19,8,11,25
Kerala Blast,9363,2,7,3,4,13,14,-1,24
NorthEast Un,9363,3,6,2,6,13,12,1,20
Kolkata,9363,4,4,7,3,16,13,3,19
Delhi Dynamo,9363,5,4,5,5,22,20,2,17
FC Goa,9363,6,5,2,7,12,19,-7,17
FC Pune City,9363,7,4,4,6,13,16,-3,16
Chennaiyin,9363,8,3,5,6,16,22,-6,14
Kolkata,9364,1,6,6,2,21,16,5,24
Delhi Dynamo,9364,2,5,7,2,27,19,8,22
Mumbai City,9364,3,6,4,4,16,9,7,22
Kerala Blast,9364,4,5,4,5,13,17,-4,19
NorthEast Un,9364,5,5,3,6,13,12,1,18
FC Pune City,9364,6,4,4,6,12,16,-4,16
FC Goa,9364,7,4,3,7,14,20,-6,15
Chennaiyin,9364,8,3,5,6,14,21,-7,14
Delhi Dynamo,9365,1,7,5,2,28,17,11,26
Mumbai City,9365,2,6,4,4,17,11,6,22
Kolkata,9365,3,4,7,3,15,13,2,19
Kerala Blast,9365,4,4,6,4,12,16,-4,18
FC Goa,9365,5,5,2,7,13,16,-3,17
Chennaiyin,9365,6,4,5,5,15,21,-6,17
FC Pune City,9365,7,4,4,6,14,18,-4,16
NorthEast Un,9365,8,4,3,7,12,14,-2,15
Delhi Dynamo,9366,1,5,7,2,25,16,9,22
Mumbai City,9366,2,6,4,4,16,10,6,22
Kolkata,9366,3,5,7,2,19,15,4,22
NorthEast Un,9366,4,5,4,5,14,11,3,19
Kerala Blast,9366,5,5,4,5,14,19,-5,19
FC Goa,9366,6,4,4,6,15,18,-3,16
FC Pune City,9366,7,4,3,7,16,20,-4,15
Chennaiyin,9366,8,3,5,6,14,24,-10,14
Delhi Dynamo,9367,1,6,6,2,29,17,12,24
Kolkata,9367,2,5,7,2,21,15,6,22
Mumbai City,9367,3,6,4,4,17,11,6,22
NorthEast Un,9367,4,6,3,5,16,14,2,21
FC Pune City,9367,5,4,5,5,14,16,-2,17
Chennaiyin,9367,6,4,5,5,17,21,-4,17
Kerala Blast,9367,7,4,4,6,10,19,-9,16
FC Goa,9367,8,3,2,9,10,21,-11,11
Mumbai City,9368,1,6,5,3,18,10,8,23
Delhi Dynamo,9368,2,5,7,2,26,18,8,22
Kolkata,9368,3,5,7,2,15,12,3,22
Kerala Blast,9368,4,6,3,5,14,15,-1,21
Chennaiyin,9368,5,4,5,5,14,19,-5,17
FC Pune City,9368,6,4,3,7,13,17,-4,15
NorthEast Un,9368,7,4,3,7,10,14,-4,15
FC Goa,9368,8,4,3,7,11,16,-5,15
Delhi Dynamo,9369,1,6,6,2,28,16,12,24
Mumbai City,9369,2,6,4,4,17,11,6,22
Kolkata,9369,3,5,6,3,16,14,2,21
NorthEast Un,9369,4,5,3,6,11,11,0,18
FC Goa,9369,5,5,2,7,13,18,-5,17
Chennaiyin,9369,6,4,5,5,14,20,-6,17
FC Pune City,9369,7,4,4,6,14,17,-3,16
Kerala Blast,9369,8,4,4,6,11,17,-6,16
Delhi Dynamo,9370,1,7,5,2,24,14,10,26
Kolkata,9370,2,6,6,2,19,13,6,24
Mumbai City,9370,3,6,4,4,16,9,7,22
FC Pune City,9370,4,5,3,6,14,17,-3,18
Kerala Blast,9370,5,5,3,6,12,18,-6,18
NorthEast Un,9370,6,5,2,7,12,13,-1,17
FC Goa,9370,7,4,2,8,12,18,-6,14
Chennaiyin,9370,8,3,5,6,15,22,-7,14
Mumbai City,9371,1,6,4,4,17,11,6,22
Delhi Dynamo,9371,2,5,6,3,25,17,8,21
Kolkata,9371,3,5,6,3,17,13,4,21
NorthEast Un,9371,4,6,3,5,14,12,2,21
FC Pune City,9371,5,6,3,5,15,14,1,21
Chennaiyin,9371,6,4,5,5,17,21,-4,17
Kerala Blast,9371,7,4,4,6,10,18,-8,16
FC Goa,9371,8,3,3,8,10,19,-9,12
Mumbai City,9372,1,6,4,4,16,10,6,22
Kerala Blast,9372,2,6,4,4,16,15,1,22
Delhi Dynamo,9372,3,5,6,3,24,18,6,21
Kolkata,9372,4,4,7,3,18,16,2,19
NorthEast Un,9372,5,5,3,6,12,10,2,18
Chennaiyin,9372,6,4,6,4,14,17,-3,18
FC Pune City,9372,7,4,4,6,12,17,-5,16
FC Goa,9372,8,3,4,7,9,18,-9,13
Mumbai City,9373,1,7,4,3,17,8,9,25
Kolkata,9373,2,5,6,3,17,14,3,21
FC Pune City,9373,3,6,3,5,15,15,0,21
Chennaiyin,9373,4,5,5,4,18,17,1,20
NorthEast Un,9373,5,6,2,6,13,12,1,20
Delhi Dynamo,9373,6,4,6,4,25,20,5,18
Kerala Blast,9373,7,4,3,7,10,17,-7,15
FC Goa,9373,8,3,3,8,11,23,-12,12
Mumbai City,9374,1,6,5,3,18,10,8,23
Delhi Dynamo,9374,2,5,6,3,25,17,8,21
Kolkata,9374,3,4,8,2,18,15,3,20
FC Pune City,9374,4,5,4,5,14,15,-1,19
NorthEast Un,9374,5,5,3,6,13,13,0,18
FC Goa,9374,6,5,2,7,12,18,-6,17
Kerala Blast,9374,7,4,4,6,10,17,-7,16
Chennaiyin,9374,8,3,6,5,16,21,-5,15
Mumbai City,9375,1,7,4,3,19,10,9,25
NorthEast Un,9375,2,5,4,5,12,10,2,19
Kolkata,9375,3,4,7,3,17,17,0,19
Kerala Blast,9375,4,5,4,5,12,16,-4,19
Delhi Dynamo,9375,5,4,6,4,26,22,4,18
FC Pune City,9375,6,5,3,6,15,16,-1,18
FC Goa,9375,7,4,4,6,15,18,-3,16
Chennaiyin,9375,8,3,6,5,15,22,-7,15
Mumbai City,9376,1,7,4,3,18,9,9,25
Delhi Dynamo,9376,2,6,5,3,27,18,9,23
Kolkata,9376,3,5,6,3,19,16,3,21
FC Pune City,9376,4,5,3,6,15,18,-3,18
NorthEast Un,9376,5,5,2,7,13,13,0,17
Chennaiyin,9376,6,4,5,5,15,19,-4,17
FC Goa,9376,7,5,2,7,12,17,-5,17
Kerala Blast,9376,8,4,3,7,10,19,-9,15
Delhi Dynamo,9377,1,6,6,2,29,17,12,24
Kolkata,9377,2,6,6,2,17,12,5,24
Mumbai City,9377,3,6,4,4,16,9,7,22
NorthEast Un,9377,4,5,3,6,15,16,-1,18
Kerala Blast,9377,5,5,3,6,11,17,-6,18
Chennaiyin,9377,6,4,5,5,17,20,-3,17
FC Pune City,9377,7,4,3,7,12,17,-5,15
FC Goa,9377,8,4,2,8,11,20,-9,14
Mumbai City,9378,1,6,5,3,18,10,8,23
Kolkata,9378,2,5,7,2,18,15,3,22
Delhi Dynamo,9378,3,4,7,3,25,19,6,19
Kerala Blast,9378,4,5,4,5,12,16,-4,19
NorthEast Un,9378,5,5,3,6,15,14,1,18
FC Goa,9378,6,5,3,6,12,16,-4,18
FC Pune City,9378,7,4,4,6,14,17,-3,16
Chennaiyin,9378,8,3,5,6,14,21,-7,14
Mumbai City,9379,1,7,4,3,18,8,10,25
Kolkata,9379,2,5,6,3,18,16,2,21
NorthEast Un,9379,3,6,3,5,11,9,2,21
Delhi Dynamo,9379,4,4,7,3,22,17,5,19
FC Goa,9379,5,4,4,6,14,17,-3,16
FC Pune City,9379,6,4,4,6,13,17,-4,16
Kerala Blast,9379,7,4,4,6,11,18,-7,16
Chennaiyin,9379,8,3,6,5,15,20,-5,15
Mumbai City,9380,1,6,5,3,16,8,8,23
Kerala Blast,9380,2,6,4,4,16,14,2,22
Delhi Dynamo,9380,3,5,6,3,24,18,6,21
Kolkata,9380,4,4,7,3,17,18,-1,19
Chennaiyin,9380,5,4,6,4,16,18,-2,18
FC Pune City,9380,6,4,5,5,13,15,-2,17
NorthEast Un,9380,7,4,3,7,12,15,-3,15
FC Goa,9380,8,4,2,8,12,20,-8,14
Delhi Dynamo,9381,1,5,7,2,26,15,11,22
Mumbai City,9381,2,6,4,4,16,12,4,22
Kolkata,9381,3,5,6,3,16,14,2,21
NorthEast Un,9381,4,6,3,5,12,10,2,21
FC Pune City,9381,5,5,3,6,15,15,0,18
FC Goa,9381,6,4,4,6,9,14,-5,16
Chennaiyin,9381,7,3,6,5,13,18,-5,15
Kerala Blast,9381,8,4,3,7,10,19,-9,15
Mumbai City,9382,1,7,4,3,19,9,10,25
Kerala Blast,9382,2,7,3,4,14,15,-1,24
Delhi Dynamo,9382,3,5,6,3,28,21,7,21
NorthEast Un,9382,4,5,3,6,15,13,2,18
Kolkata,9382,5,4,6,4,17,16,1,18
FC Pune City,9382,6,5,3,6,14,16,-2,18
Chennaiyin,9382,7,3,5,6,15,23,-8,14
FC Goa,9382,8,4,2,8,13,22,-9,14
Mumbai City,9383,1,7,4,3,19,9,10,25
Kolkata,9383,2,6,6,2,18,13,5,24
NorthEast Un,9383,3,6,3,5,12,10,2,21
Delhi Dynamo,9383,4,4,6,4,23,19,4,18
FC Pune City,9383,5,4,4,6,13,16,-3,16
Kerala Blast,9383,6,4,4,6,11,18,-7,16
FC Goa,9383,7,4,3,7,11,16,-5,15
Chennaiyin,9383,8,3,6,5,14,20,-6,15
Mumbai City,9384,1,6,5,3,16,8,8,23
Delhi Dynamo,9384,2,5,6,3,23,16,7,21
FC Goa,9384,3,6,2,6,17,17,0,20
Kolkata,9384,4,4,7,3,16,15,1,19
FC Pune City,9384,5,5,4,5,16,16,0,19
NorthEast Un,9384,6,5,2,7,12,13,-1,17
Chennaiyin,9384,7,4,5,5,16,23,-7,17
Kerala Blast,9384,8,4,3,7,11,19,-8,15
Mumbai City,9385,1,6,4,4,16,10,6,22
Delhi Dynamo,9385,2,5,6,3,27,21,6,21
NorthEast Un,9385,3,5,4,5,13,12,1,19
Kolkata,9385,4,3,9,2,18,17,1,18
Chennaiyin,9385,5,4,6,4,17,18,-1,18
FC Pune City,9385,6,4,5,5,13,15,-2,17
Kerala Blast,9385,7,4,5,5,13,18,-5,17
FC Goa,9385,8,4,3,7,15,21,-6,15
Delhi Dynamo,9386,1,6,5,3,24,15,9,23
Mumbai City,9386,2,6,4,4,16,10,6,22
Kerala Blast,9386,3,6,4,4,14,16,-2,22
Kolkata,9386,4,4,6,4,15,17,-2,18
Chennaiyin,9386,5,4,6,4,15,18,-3,18
NorthEast Un,9386,6,5,2,7,12,13,-1,17
FC Pune City,9386,7,4,4,6,13,16,-3,16
FC Goa,9386,8,4,3,7,11,15,-4,15
Delhi Dynamo,9387,1,5,7,2,24,16,8,22
Mumbai City,9387,2,6,4,4,16,9,7,22
Kolkata,9387,3,5,7,2,19,15,4,22
Chennaiyin,9387,4,5,5,4,19,19,0,20
FC Pune City,9387,5,5,3,6,18,20,-2,18
Kerala Blast,9387,6,5,3,6,13,19,-6,18
NorthEast Un,9387,7,4,3,7,12,14,-2,15
FC Goa,9387,8,3,4,7,10,19,-9,13
Delhi Dynamo,9388,1,6,6,2,24,15,9,24
Mumbai City,9388,2,6,4,4,16,9,7,22
Kolkata,9388,3,4,8,2,18,14,4,20
NorthEast Un,9388,4,5,4,5,15,14,1,19
Kerala Blast,9388,5,5,4,5,13,19,-6,19
Chennaiyin,9388,6,4,5,5,16,20,-4,17
FC Pune City,9388,7,4,4,6,13,16,-3,16
FC Goa,9388,8,3,3,8,10,18,-8,12
Mumbai City,9389,1,7,4,3,19,10,9,25
Delhi Dynamo,9389,2,5,5,4,27,20,7,20
NorthEast Un,9389,3,6,2,6,11,10,1,20
Kolkata,9389,4,4,7,3,14,13,1,19
FC Pune City,9389,5,5,4,5,14,15,-1,19
Chennaiyin,9389,6,4,5,5,15,19,-4,17
Kerala Blast,9389,7,4,4,6,10,16,-6,16
FC Goa,9389,8,4,3,7,12,19,-7,15
Delhi Dynamo,9390,1,6,5,3,24,17,7,23
Mumbai City,9390,2,6,4,4,16,9,7,22
Kolkata,9390,3,5,6,3,17,14,3,21
Chennaiyin,9390,4,4,6,4,18,19,-1,18
FC Pune City,9390,5,5,3,6,15,18,-3,18
Kerala Blast,9390,6,5,3,6,12,17,-5,18
NorthEast Un,9390,7,5,2,7,14,15,-1,17
FC Goa,9390,8,4,3,7,10,17,-7,15
Mumbai City,9391,1,6,5,3,18,10,8,23
Delhi Dynamo,9391,2,5,7,2,28,16,12,22
Kolkata,9391,3,5,7,2,18,13,5,22
Kerala Blast,9391,4,6,4,4,14,15,-1,22
NorthEast Un,9391,5,5,2,7,13,19,-6,17
FC Pune City,9391,6,4,3,7,14,20,-6,15
FC Goa,9391,7,4,3,7,9,15,-6,15
Chennaiyin,9391,8,3,5,6,15,21,-6,14
Mumbai City,9392,1,7,4,3,17,8,9,25
Delhi Dynamo,9392,2,5,6,3,22,15,7,21
Kolkata,9392,3,5,6,3,17,14,3,21
NorthEast Un,9392,4,5,3,6,12,11,1,18
FC Pune City,9392,5,4,4,6,14,17,-3,16
Chennaiyin,9392,6,3,7,4,13,17,-4,16
FC Goa,9392,7,4,4,6,9,14,-5,16
Kerala Blast,9392,8,4,4,6,11,19,-8,16
Mumbai City,9393,1,7,4,3,18,8,10,25
Delhi Dynamo,9393,2,5,6,3,25,18,7,21
Kolkata,9393,3,5,6,3,17,14,3,21
FC Pune City,9393,4,5,4,5,15,16,-1,19
NorthEast Un,9393,5,5,3,6,12,12,0,18
Chennaiyin,9393,6,3,7,4,13,17,-4,16
Kerala Blast,9393,7,4,4,6,12,19,-7,16
FC Goa,9393,8,3,4,7,9,17,-8,13
Mumbai City,9394,1,7,4,3,19,8,11,25
Kolkata,9394,2,6,6,2,21,14,7,24
Delhi Dynamo,9394,3,6,5,3,27,19,8,23
Chennaiyin,9394,4,5,5,4,17,18,-1,20
Kerala Blast,9394,5,5,3,6,14,18,-4,18
NorthEast Un,9394,6,5,2,7,14,15,-1,17
FC Pune City,9394,7,4,3,7,12,19,-7,15
FC Goa,9394,8,3,2,9,9,22,-13,11
Mumbai City,9395,1,7,4,3,20,10,10,25
Delhi Dynamo,9395,2,6,5,3,29,18,11,23
Kolkata,9395,3,5,6,3,20,16,4,21
Chennaiyin,9395,4,5,5,4,19,19,0,20
FC Pune City,9395,5,5,3,6,16,19,-3,18
Kerala Blast,9395,6,5,3,6,13,17,-4,18
NorthEast Un,9395,7,5,2,7,12,16,-4,17
FC Goa,9395,8,3,2,9,8,22,-14,11
Mumbai City,9396,1,7,4,3,20,9,11,25
Kolkata,9396,2,6,6,2,21,15,6,24
NorthEast Un,9396,3,6,3,5,14,10,4,21
Delhi Dynamo,9396,4,5,5,4,25,20,5,20
Kerala Blast,9396,5,5,4,5,12,17,-5,19
FC Pune City,9396,6,4,3,7,15,19,-4,15
FC Goa,9396,7,4,2,8,11,19,-8,14
Chennaiyin,9396,8,3,5,6,14,23,-9,14
Mumbai City,9397,1,6,5,3,17,9,8,23
NorthEast Un,9397,2,7,2,5,17,10,7,23
Delhi Dynamo,9397,3,5,6,3,24,18,6,21
Kolkata,9397,4,4,8,2,19,17,2,20
Kerala Blast,9397,5,5,3,6,12,18,-6,18
FC Pune City,9397,6,4,4,6,13,16,-3,16
Chennaiyin,9397,7,3,6,5,13,19,-6,15
FC Goa,9397,8,3,4,7,11,19,-8,13
Mumbai City,9398,1,7,4,3,18,9,9,25
Delhi Dynamo,9398,2,5,5,4,24,21,3,20
Kerala Blast,9398,3,5,5,4,13,16,-3,20
NorthEast Un,9398,4,5,4,5,15,10,5,19
FC Pune City,9398,5,4,5,5,14,16,-2,17
Kolkata,9398,6,3,7,4,16,20,-4,16
Chennaiyin,9398,7,3,7,4,15,19,-4,16
FC Goa,9398,8,4,3,7,15,19,-4,15
Mumbai City,9399,1,7,4,3,18,8,10,25
NorthEast Un,9399,2,6,3,5,15,10,5,21
FC Pune City,9399,3,6,3,5,14,14,0,21
Delhi Dynamo,9399,4,5,5,4,25,19,6,20
Kerala Blast,9399,5,5,4,5,12,16,-4,19
FC Goa,9399,6,5,2,7,12,20,-8,17
Kolkata,9399,7,3,6,5,14,16,-2,15
Chennaiyin,9399,8,3,5,6,15,22,-7,14
Mumbai City,9400,1,7,4,3,18,8,10,25
Kolkata,9400,2,5,6,3,17,14,3,21
NorthEast Un,9400,3,5,4,5,12,9,3,19
Kerala Blast,9400,4,5,4,5,13,16,-3,19
Delhi Dynamo,9400,5,4,6,4,22,20,2,18
FC Pune City,9400,6,5,3,6,13,17,-4,18
Chennaiyin,9400,7,3,6,5,13,18,-5,15
FC Goa,9400,8,4,3,7,10,16,-6,15
Mumbai City,9401,1,6,5,3,18,10,8,23
Kerala Blast,9401,2,6,4,4,14,14,0,22
Chennaiyin,9401,3,5,5,4,17,18,-1,20
Delhi Dynamo,9401,4,4,6,4,24,19,5,18
Kolkata,9401,5,4,6,4,17,18,-1,18
NorthEast Un,9401,6,5,2,7,11,14,-3,17
FC Goa,9401,7,5,2,7,11,16,-5,17
FC Pune City,9401,8,4,4,6,16,19,-3,16
Mumbai City,9402,1,6,5,3,16,8,8,23
Kerala Blast,9402,2,5,5,4,12,14,-2,20
Delhi Dynamo,9402,3,4,7,3,24,19,5,19
Kolkata,9402,4,3,9,2,14,13,1,18
Chennaiyin,9402,5,4,6,4,16,19,-3,18
FC Pune City,9402,6,4,5,5,13,15,-2,17
NorthEast Un,9402,7,4,4,6,12,14,-2,16
FC Goa,9402,8,4,3,7,13,18,-5,15
Mumbai City,9403,1,7,4,3,17,8,9,25
Kolkata,9403,2,6,6,2,23,15,8,24
Delhi Dynamo,9403,3,4,7,3,24,18,6,19
Kerala Blast,9403,4,5,4,5,15,20,-5,19
Chennaiyin,9403,5,4,5,5,17,20,-3,17
FC Pune City,9403,6,4,4,6,17,22,-5,16
NorthEast Un,9403,7,4,3,7,13,16,-3,15
FC Goa,9403,8,4,3,7,13,20,-7,15
Mumbai City,9404,1,7,4,3,19,9,10,25
FC Pune City,9404,2,5,4,5,15,16,-1,19
Kolkata,9404,3,4,6,4,15,15,0,18
NorthEast Un,9404,4,5,3,6,13,13,0,18
Chennaiyin,9404,5,4,6,4,16,18,-2,18
FC Goa,9404,6,5,3,6,12,15,-3,18
Delhi Dynamo,9404,7,4,5,5,23,21,2,17
Kerala Blast,9404,8,4,5,5,12,18,-6,17
Mumbai City,9405,1,7,4,3,19,10,9,25
Kolkata,9405,2,5,7,2,20,15,5,22
Delhi Dynamo,9405,3,5,5,4,25,20,5,20
Chennaiyin,9405,4,5,5,4,15,17,-2,20
NorthEast Un,9405,5,5,3,6,13,11,2,18
Kerala Blast,9405,6,4,5,5,13,19,-6,17
FC Pune City,9405,7,4,4,6,15,19,-4,16
FC Goa,9405,8,3,3,8,9,18,-9,12
Delhi Dynamo,9406,1,6,5,3,26,18,8,23
Mumbai City,9406,2,6,4,4,17,10,7,22
Kolkata,9406,3,4,7,3,16,15,1,19
Chennaiyin,9406,4,4,6,4,14,17,-3,18
FC Goa,9406,5,5,3,6,11,14,-3,18
FC Pune City,9406,6,4,5,5,13,15,-2,17
Kerala Blast,9406,7,4,5,5,13,19,-6,17
NorthEast Un,9406,8,4,3,7,13,15,-2,15
Mumbai City,9407,1,6,5,3,16,8,8,23
Delhi Dynamo,9407,2,5,6,3,24,16,8,21
FC Pune City,9407,3,6,3,5,15,14,1,21
Kolkata,9407,4,4,7,3,16,16,0,19
NorthEast Un,9407,5,5,3,6,11,12,-1,18
Chennaiyin,9407,6,4,6,4,17,19,-2,18
Kerala Blast,9407,7,4,5,5,10,15,-5,17
FC Goa,9407,8,3,3,8,11,20,-9,12
Mumbai City,9408,1,7,4,3,19,8,11,25
Kolkata,9408,2,5,6,3,18,15,3,21
FC Goa,9408,3,6,2,6,13,14,-1,20
NorthEast Un,9408,4,5,3,6,12,12,0,18
FC Pune City,9408,5,5,3,6,14,18,-4,18
Delhi Dynamo,9408,6,4,5,5,22,20,2,17
Chennaiyin,9408,7,4,5,5,14,19,-5,17
Kerala Blast,9408,8,4,4,6,12,18,-6,16
Delhi Dynamo,9409,1,7,5,2,31,18,13,26
Mumbai City,9409,2,6,4,4,16,11,5,22
Kolkata,9409,3,5,7,2,16,13,3,22
Kerala Blast,9409,4,6,3,5,13,15,-2,21
NorthEast Un,9409,5,5,2,7,15,17,-2,17
FC Pune City,9409,6,4,3,7,13,17,-4,15
FC Goa,9409,7,4,3,7,13,19,-6,15
Chennaiyin,9409,8,3,5,6,16,23,-7,14
Mumbai City,9410,1,7,4,3,17,8,9,25
Delhi Dynamo,9410,2,5,5,4,27,17,10,20
Chennaiyin,9410,3,5,5,4,16,17,-1,20
Kolkata,9410,4,4,7,3,16,14,2,19
NorthEast Un,9410,5,5,3,6,12,12,0,18
FC Pune City,9410,6,4,5,5,14,16,-2,17
Kerala Blast,9410,7,4,5,5,12,18,-6,17
FC Goa,9410,8,4,2,8,10,22,-12,14
Delhi Dynamo,9411,1,5,7,2,24,16,8,22
Mumbai City,9411,2,6,4,4,16,9,7,22
Kerala Blast,9411,3,6,3,5,12,14,-2,21
Kolkata,9411,4,4,7,3,15,15,0,19
Chennaiyin,9411,5,4,6,4,15,18,-3,18
FC Pune City,9411,6,4,4,6,13,17,-4,16
FC Goa,9411,7,4,4,6,12,16,-4,16
NorthEast Un,9411,8,4,3,7,10,12,-2,15
Mumbai City,9412,1,6,4,4,16,9,7,22
Delhi Dynamo,9412,2,5,6,3,24,17,7,21
Kerala Blast,9412,3,6,3,5,15,15,0,21
FC Pune City,9412,4,6,3,5,14,14,0,21
FC Goa,9412,5,5,3,6,15,16,-1,18
NorthEast Un,9412,6,5,2,7,13,15,-2,17
Chennaiyin,9412,7,4,5,5,16,22,-6,17
Kolkata,9412,8,3,6,5,15,20,-5,15
Mumbai City,9413,1,7,4,3,18,9,9,25
NorthEast Un,9413,2,7,2,5,15,9,6,23
Delhi Dynamo,9413,3,5,5,4,24,19,5,20
Kolkata,9413,4,4,7,3,15,14,1,19
Kerala Blast,9413,5,5,4,5,12,16,-4,19
Chennaiyin,9413,6,4,5,5,14,19,-5,17
FC Pune City,9413,7,4,4,6,13,16,-3,16
FC Goa,9413,8,3,3,8,8,17,-9,12
Mumbai City,9414,1,7,4,3,20,11,9,25
Delhi Dynamo,9414,2,5,6,3,26,18,8,21
FC Pune City,9414,3,6,3,5,17,16,1,21
Chennaiyin,9414,4,5,5,4,19,21,-2,20
Kerala Blast,9414,5,5,4,5,13,17,-4,19
Kolkata,9414,6,3,7,4,14,16,-2,16
NorthEast Un,9414,7,4,3,7,12,15,-3,15
FC Goa,9414,8,3,4,7,9,16,-7,13
Mumbai City,9415,1,7,4,3,19,8,11,25
Kolkata,9415,2,5,6,3,16,14,2,21
Kerala Blast,9415,3,5,4,5,11,16,-5,19
Delhi Dynamo,9415,4,4,6,4,21,18,3,18
NorthEast Un,9415,5,5,3,6,11,11,0,18
Chennaiyin,9415,6,4,6,4,16,19,-3,18
FC Goa,9415,7,4,4,6,11,15,-4,16
FC Pune City,9415,8,4,3,7,13,17,-4,15
Mumbai City,9416,1,7,4,3,19,8,11,25
NorthEast Un,9416,2,7,2,5,15,12,3,23
Kolkata,9416,3,5,6,3,19,15,4,21
Delhi Dynamo,9416,4,5,5,4,25,21,4,20
Kerala Blast,9416,5,5,3,6,12,19,-7,18
Chennaiyin,9416,6,4,5,5,14,18,-4,17
FC Pune City,9416,7,4,3,7,12,16,-4,15
FC Goa,9416,8,4,2,8,11,18,-7,14
Mumbai City,9417,1,6,5,3,18,10,8,23
Delhi Dynamo,9417,2,5,7,2,26,17,9,22
Kerala Blast,9417,3,6,4,4,14,14,0,22
Chennaiyin,9417,4,4,6,4,14,17,-3,18
FC Pune City,9417,5,5,3,6,13,17,-4,18
Kolkata,9417,6,3,7,4,15,16,-1,16
NorthEast Un,9417,7,4,3,7,10,13,-3,15
FC Goa,9417,8,4,3,7,12,18,-6,15
Delhi Dynamo,9418,1,7,5,2,27,17,10,26
Mumbai City,9418,2,6,4,4,17,10,7,22
Kolkata,9418,3,5,6,3,16,14,2,21
Kerala Blast,9418,4,6,3,5,15,15,0,21
FC Pune City,9418,5,5,3,6,15,17,-2,18
Chennaiyin,9418,6,4,5,5,16,18,-2,17
NorthEast Un,9418,7,4,2,8,9,16,-7,14
FC Goa,9418,8,4,2,8,11,19,-8,14
Mumbai City,9419,1,6,5,3,17,9,8,23
Kerala Blast,9419,2,6,4,4,14,14,0,22
Delhi Dynamo,9419,3,4,7,3,24,18,6,19
Kolkata,9419,4,4,7,3,17,16,1,19
NorthEast Un,9419,5,5,3,6,13,14,-1,18
Chennaiyin,9419,6,3,7,4,15,19,-4,16
FC Pune City,9419,7,4,4,6,13,17,-4,16
FC Goa,9419,8,3,5,6,11,17,-6,14
Delhi Dynamo,9420,1,7,5,2,27,15,12,26
Kerala Blast,9420,2,7,3,4,16,15,1,24
Mumbai City,9420,3,6,4,4,16,10,6,22
Kolkata,9420,4,4,6,4,17,16,1,18
NorthEast Un,9420,5,5,2,7,14,17,-3,17
Chennaiyin,9420,6,3,6,5,15,20,-5,15
FC Pune City,9420,7,4,3,7,13,19,-6,15
FC Goa,9420,8,4,3,7,9,15,-6,15
Mumbai City,9421,1,7,4,3,21,8,13,25
FC Pune City,9421,2,5,4,5,14,14,0,19
Kerala Blast,9421,3,5,4,5,13,17,-4,19
Kolkata,9421,4,3,9,2,18,17,1,18
Delhi Dynamo,9421,5,4,6,4,22,22,0,18
FC Goa,9421,6,5,3,6,16,18,-2,18
Chennaiyin,9421,7,4,5,5,16,20,-4,17
NorthEast Un,9421,8,4,3,7,10,14,-4,15
Mumbai City,9422,1,6,4,4,17,10,7,22
Delhi Dynamo,9422,2,5,6,3,25,18,7,21
Kerala Blast,9422,3,6,3,5,15,16,-1,21
NorthEast Un,9422,4,6,2,6,13,14,-1,20
Kolkata,9422,5,4,7,3,17,16,1,19
Chennaiyin,9422,6,4,6,4,18,19,-1,18
FC Pune City,9422,7,4,3,7,13,19,-6,15
FC Goa,9422,8,3,5,6,12,18,-6,14
Mumbai City,9423,1,7,4,3,17,8,9,25
Kolkata,9423,2,5,7,2,18,14,4,22
NorthEast Un,9423,3,5,4,5,12,11,1,19
Delhi Dynamo,9423,4,4,6,4,22,17,5,18
Kerala Blast,9423,5,5,3,6,11,17,-6,18
Chennaiyin,9423,6,3,7,4,14,18,-4,16
FC Goa,9423,7,4,4,6,11,16,-5,16
FC Pune City,9423,8,4,3,7,13,17,-4,15
Delhi Dynamo,9424,1,6,5,3,25,17,8,23
Mumbai City,9424,2,6,4,4,16,9,7,22
Kerala Blast,9424,3,6,3,5,13,15,-2,21
Kolkata,9424,4,4,7,3,19,18,1,19
FC Pune City,9424,5,5,3,6,16,19,-3,18
Chennaiyin,9424,6,4,6,4,15,18,-3,18
FC Goa,9424,7,4,4,6,13,18,-5,16
NorthEast Un,9424,8,4,2,8,10,13,-3,14
Mumbai City,9425,1,6,5,3,17,9,8,23
Kolkata,9425,2,5,7,2,18,14,4,22
Delhi Dynamo,9425,3,5,6,3,23,16,7,21
Kerala Blast,9425,4,5,4,5,14,17,-3,19
FC Goa,9425,5,5,2,7,12,16,-4,17
NorthEast Un,9425,6,4,4,6,12,13,-1,16
FC Pune City,9425,7,4,4,6,12,17,-5,16
Chennaiyin,9425,8,3,6,5,15,21,-6,15
Mumbai City,9426,1,6,5,3,17,9,8,23
Kolkata,9426,2,5,7,2,22,15,7,22
Delhi Dynamo,9426,3,5,6,3,26,18,8,21
NorthEast Un,9426,4,6,2,6,12,11,1,20
Kerala Blast,9426,5,5,4,5,13,17,-4,19
Chennaiyin,9426,6,4,6,4,16,19,-3,18
FC Pune City,9426,7,4,3,7,12,16,-4,15
FC Goa,9426,8,3,3,8,13,26,-13,12
Mumbai City,9427,1,7,4,3,19,8,11,25
Delhi Dynamo,9427,2,6,5,3,27,17,10,23
Kolkata,9427,3,5,7,2,17,13,4,22
Chennaiyin,9427,4,4,5,5,14,18,-4,17
Kerala Blast,9427,5,4,5,5,13,18,-5,17
FC Pune City,9427,6,4,4,6,13,17,-4,16
NorthEast Un,9427,7,4,3,7,11,16,-5,15
FC Goa,9427,8,4,3,7,9,16,-7,15
Mumbai City,9428,1,7,4,3,17,8,9,25
Delhi Dynamo,9428,2,5,6,3,25,17,8,21
Kerala Blast,9428,3,5,4,5,12,17,-5,19
NorthEast Un,9428,4,5,3,6,13,12,1,18
FC Pune City,9428,5,5,3,6,15,17,-2,18
Kolkata,9428,6,3,8,3,18,18,0,17
Chennaiyin,9428,7,4,5,5,14,18,-4,17
FC Goa,9428,8,4,3,7,12,19,-7,15
Mumbai City,9429,1,7,4,3,17,8,9,25
Delhi Dynamo,9429,2,5,6,3,23,16,7,21
Kerala Blast,9429,3,5,5,4,12,13,-1,20
Kolkata,9429,4,4,7,3,16,17,-1,19
NorthEast Un,9429,5,4,5,5,10,10,0,17
FC Pune City,9429,6,4,4,6,14,17,-3,16
Chennaiyin,9429,7,3,7,4,14,18,-4,16
FC Goa,9429,8,3,4,7,9,16,-7,13
Kolkata,9430,1,6,6,2,20,13,7,24
Mumbai City,9430,2,6,5,3,19,11,8,23
Delhi Dynamo,9430,3,5,6,3,26,18,8,21
NorthEast Un,9430,4,6,3,5,12,10,2,21
Kerala Blast,9430,5,5,4,5,12,15,-3,19
Chennaiyin,9430,6,4,5,5,15,19,-4,17
FC Pune City,9430,7,4,3,7,12,19,-7,15
FC Goa,9430,8,3,2,9,10,21,-11,11
Mumbai City,9431,1,7,4,3,19,10,9,25
Delhi Dynamo,9431,2,6,5,3,29,20,9,23
Kerala Blast,9431,3,6,4,4,14,16,-2,22
Kolkata,9431,4,5,6,3,18,14,4,21
NorthEast Un,9431,5,5,2,7,12,13,-1,17
FC Pune City,9431,6,4,4,6,13,18,-5,16
FC Goa,9431,7,4,2,8,13,19,-6,14
Chennaiyin,9431,8,3,5,6,13,21,-8,14
Mumbai City,9432,1,6,5,3,18,10,8,23
Delhi Dynamo,9432,2,5,7,2,27,17,10,22
Chennaiyin,9432,3,5,5,4,20,17,3,20
Kerala Blast,9432,4,5,5,4,12,14,-2,20
Kolkata,9432,5,4,6,4,15,15,0,18
FC Pune City,9432,6,4,4,6,12,16,-4,16
NorthEast Un,9432,7,4,3,7,11,15,-4,15
FC Goa,9432,8,4,3,7,9,20,-11,15
Delhi Dynamo,9433,1,7,5,2,27,16,11,26
Mumbai City,9433,2,6,4,4,16,9,7,22
FC Pune City,9433,3,5,4,5,16,15,1,19
Kolkata,9433,3,4,7,3,16,15,1,19
NorthEast Un,9433,5,5,3,6,14,15,-1,18
Kerala Blast,9433,6,4,4,6,10,19,-9,16
Chennaiyin,9433,7,3,6,5,14,19,-5,15
FC Goa,9433,8,4,3,7,10,15,-5,15
Mumbai City,9434,1,6,4,4,16,10,6,22
Kerala Blast,9434,2,6,4,4,13,15,-2,22
Delhi Dynamo,9434,3,5,5,4,23,16,7,20
Kolkata,9434,4,4,7,3,17,15,2,19
NorthEast Un,9434,5,5,4,5,11,10,1,19
FC Goa,9434,6,5,3,6,13,15,-2,18
FC Pune City,9434,7,4,3,7,13,18,-5,15
Chennaiyin,9434,8,3,6,5,14,21,-7,15
Mumbai City,9435,1,7,4,3,19,10,9,25
Delhi Dynamo,9435,2,5,6,3,25,18,7,21
Kolkata,9435,3,5,6,3,20,16,4,21
Kerala Blast,9435,4,6,3,5,11,16,-5,21
NorthEast Un,9435,5,5,3,6,11,11,0,18
FC Pune City,9435,6,5,3,6,14,16,-2,18
Chennaiyin,9435,7,3,5,6,13,19,-6,14
FC Goa,9435,8,4,2,8,11,18,-7,14
Mumbai City,9436,1,7,4,3,20,8,12,25
FC Pune City,9436,2,6,3,5,18,17,1,21
Delhi Dynamo,9436,3,5,5,4,22,19,3,20
NorthEast Un,9436,4,6,2,6,14,11,3,20
Chennaiyin,9436,5,5,5,4,15,17,-2,20
Kolkata,9436,6,3,7,4,17,19,-2,16
Kerala Blast,9436,7,4,4,6,12,20,-8,16
FC Goa,9436,8,4,2,8,10,17,-7,14
Delhi Dynamo,9437,1,6,5,3,23,15,8,23
Mumbai City,9437,2,6,4,4,16,9,7,22
Kolkata,9437,3,4,8,2,16,12,4,20
Chennaiyin,9437,4,5,5,4,17,18,-1,20
FC Pune City,9437,5,5,4,5,14,14,0,19
NorthEast Un,9437,6,5,3,6,11,11,0,18
Kerala Blast,9437,7,4,4,6,10,19,-9,16
FC Goa,9437,8,3,3,8,9,18,-9,12
Mumbai City,9438,1,7,4,3,20,10,10,25
Kerala Blast,9438,2,6,4,4,17,14,3,22
Delhi Dynamo,9438,3,4,7,3,26,21,5,19
Kolkata,9438,4,4,7,3,18,16,2,19
FC Goa,9438,5,5,3,6,13,16,-3,18
Chennaiyin,9438,6,4,5,5,14,18,-4,17
NorthEast Un,9438,7,4,3,7,11,14,-3,15
FC Pune City,9438,8,4,3,7,12,22,-10,15
Mumbai City,9439,1,7,4,3,17,8,9,25
NorthEast Un,9439,2,7,2,5,12,9,3,23
Kolkata,9439,3,5,7,2,19,16,3,22
Delhi Dynamo,9439,4,4,6,4,21,16,5,18
FC Pune City,9439,5,5,3,6,13,15,-2,18
Chennaiyin,9439,6,4,5,5,15,19,-4,17
Kerala Blast,9439,7,4,3,7,11,18,-7,15
FC Goa,9439,8,3,4,7,11,18,-7,13
Mumbai City,9440,1,7,4,3,17,8,9,25
Kolkata,9440,2,5,6,3,18,16,2,21
FC Goa,9440,3,6,2,6,15,16,-1,20
Kerala Blast,9440,4,5,4,5,12,16,-4,19
Delhi Dynamo,9440,5,4,6,4,23,18,5,18
NorthEast Un,9440,6,4,5,5,12,12,0,17
Chennaiyin,9440,7,3,6,5,13,18,-5,15
FC Pune City,9440,8,4,3,7,12,18,-6,15
NorthEast Un,9441,1,7,2,5,15,9,6,23
Mumbai City,9441,2,6,4,4,17,10,7,22
Kolkata,9441,3,5,6,3,20,14,6,21
Delhi Dynamo,9441,4,5,6,3,24,20,4,21
Chennaiyin,9441,5,4,5,5,14,18,-4,17
FC Pune City,9441,6,4,4,6,12,16,-4,16
Kerala Blast,9441,7,4,4,6,10,19,-9,16
FC Goa,9441,8,4,3,7,10,16,-6,15
Mumbai City,9442,1,7,4,3,18,9,9,25
FC Pune City,9442,2,6,3,5,15,14,1,21
Delhi Dynamo,9442,3,5,5,4,23,19,4,20
Kerala Blast,9442,4,5,4,5,10,15,-5,19
NorthEast Un,9442,5,5,3,6,13,11,2,18
Kolkata,9442,6,3,7,4,13,15,-2,16
Chennaiyin,9442,7,3,7,4,15,19,-4,16
FC Goa,9442,8,4,3,7,11,16,-5,15
Kerala Blast,9443,1,7,3,4,16,16,0,24
Mumbai City,9443,2,6,5,3,16,8,8,23
Delhi Dynamo,9443,3,4,7,3,23,17,6,19
Kolkata,9443,4,4,7,3,14,13,1,19
Chennaiyin,9443,5,4,6,4,15,18,-3,18
FC Pune City,9443,6,4,4,6,14,17,-3,16
NorthEast Un,9443,7,4,3,7,12,15,-3,15
FC Goa,9443,8,4,3,7,10,16,-6,15
Mumbai City,9444,1,7,4,3,17,8,9,25
NorthEast Un,9444,2,6,3,5,13,11,2,21
Kolkata,9444,3,5,6,3,17,17,0,21
Delhi Dynamo,9444,4,4,5,5,23,19,4,17
Chennaiyin,9444,5,4,5,5,17,19,-2,17
FC Goa,9444,6,5,2,7,13,18,-5,17
Kerala Blast,9444,7,4,5,5,10,15,-5,17
FC Pune City,9444,8,4,4,6,15,18,-3,16
Mumbai City,9445,1,7,4,3,18,9,9,25
Delhi Dynamo,9445,2,5,6,3,28,21,7,21
Kerala Blast,9445,3,5,5,4,13,16,-3,20
Kolkata,9445,4,4,7,3,14,15,-1,19
Chennaiyin,9445,5,4,6,4,14,17,-3,18
FC Pune City,9445,6,4,4,6,14,17,-3,16
NorthEast Un,9445,7,4,3,7,12,14,-2,15
FC Goa,9445,8,4,3,7,14,18,-4,15
Mumbai City,9446,1,7,4,3,18,9,9,25
Delhi Dynamo,9446,2,5,5,4,25,18,7,20
FC Pune City,9446,3,5,4,5,13,14,-1,19
NorthEast Un,9446,4,5,3,6,14,14,0,18
Kolkata,9446,5,3,8,3,15,17,-2,17
FC Goa,9446,6,5,2,7,13,16,-3,17
Chennaiyin,9446,7,4,5,5,15,20,-5,17
Kerala Blast,9446,8,4,5,5,13,18,-5,17
Delhi Dynamo,9447,1,6,5,3,26,16,10,23
Mumbai City,9447,2,6,4,4,16,9,7,22
Kolkata,9447,3,4,8,2,17,15,2,20
NorthEast Un,9447,4,6,2,6,12,12,0,20
Kerala Blast,9447,5,5,3,6,13,17,-4,18
FC Pune City,9447,6,4,4,6,13,17,-4,16
FC Goa,9447,7,4,4,6,11,16,-5,16
Chennaiyin,9447,8,3,6,5,14,20,-6,15
Mumbai City,9448,1,7,4,3,18,8,10,25
Delhi Dynamo,9448,2,6,5,3,26,19,7,23
Kolkata,9448,3,5,7,2,16,13,3,22
Kerala Blast,9448,4,6,3,5,13,14,-1,21
NorthEast Un,9448,5,4,3,7,11,14,-3,15
FC Goa,9448,6,4,3,7,14,19,-5,15
FC Pune City,9448,7,4,3,7,12,17,-5,15
Chennaiyin,9448,8,3,6,5,15,21,-6,15
Delhi Dynamo,9449,1,6,5,3,27,19,8,23
Mumbai City,9449,2,6,4,4,17,10,7,22
Chennaiyin,9449,3,5,5,4,16,17,-1,20
Kerala Blast,9449,4,5,4,5,13,17,-4,19
NorthEast Un,9449,5,5,3,6,13,13,0,18
Kolkata,9449,6,4,6,4,16,17,-1,18
FC Pune City,9449,7,5,3,6,16,18,-2,18
FC Goa,9449,8,4,2,8,12,19,-7,14
Mumbai City,9450,1,7,4,3,18,9,9,25
Delhi Dynamo,9450,2,5,6,3,23,16,7,21
Kolkata,9450,3,5,6,3,16,14,2,21
Kerala Blast,9450,4,6,3,5,14,16,-2,21
Chennaiyin,9450,5,4,6,4,16,19,-3,18
NorthEast Un,9450,6,4,3,7,10,12,-2,15
FC Pune City,9450,7,4,3,7,13,18,-5,15
FC Goa,9450,8,4,3,7,10,16,-6,15
Delhi Dynamo,9451,1,5,7,2,26,18,8,22
Mumbai City,9451,2,6,4,4,17,10,7,22
NorthEast Un,9451,3,6,3,5,14,10,4,21
FC Pune City,9451,4,5,4,5,15,15,0,19
Kerala Blast,9451,5,4,5,5,12,19,-7,17
FC Goa,9451,6,4,4,6,15,17,-2,16
Kolkata,9451,7,3,7,4,15,20,-5,16
Chennaiyin,9451,8,3,6,5,14,19,-5,15
Delhi Dynamo,9452,1,6,6,2,27,16,11,24
Mumbai City,9452,2,6,5,3,17,9,8,23
NorthEast Un,9452,3,6,2,6,14,13,1,20
Kolkata,9452,4,4,7,3,18,17,1,19
FC Pune City,9452,5,5,4,5,16,17,-1,19
Kerala Blast,9452,6,5,3,6,11,17,-6,18
Chennaiyin,9452,7,3,6,5,14,19,-5,15
FC Goa,9452,8,3,3,8,8,17,-9,12
Delhi Dynamo,9453,1,6,6,2,28,16,12,24
Mumbai City,9453,2,6,4,4,17,12,5,22
Kolkata,9453,3,4,8,2,16,13,3,20
Kerala Blast,9453,4,5,5,4,13,14,-1,20
NorthEast Un,9453,5,5,4,5,11,10,1,19
FC Pune City,9453,6,4,4,6,12,17,-5,16
Chennaiyin,9453,7,3,5,6,13,19,-6,14
FC Goa,9453,8,4,2,8,9,18,-9,14
Mumbai City,9454,1,7,4,3,19,8,11,25
NorthEast Un,9454,2,6,3,5,15,10,5,21
Kolkata,9454,3,5,6,3,18,16,2,21
Delhi Dynamo,9454,4,5,5,4,28,21,7,20
Kerala Blast,9454,5,4,5,5,10,15,-5,17
FC Goa,9454,6,5,2,7,13,20,-7,17
FC Pune City,9454,7,4,4,6,14,19,-5,16
Chennaiyin,9454,8,3,5,6,13,21,-8,14
Mumbai City,9455,1,7,4,3,20,8,12,25
Kerala Blast,9455,2,6,4,4,14,15,-1,22
Delhi Dynamo,9455,3,5,6,3,22,18,4,21
Kolkata,9455,4,4,6,4,16,16,0,18
Chennaiyin,9455,5,4,6,4,15,18,-3,18
FC Pune City,9455,6,4,4,6,14,18,-4,16
FC Goa,9455,7,4,4,6,11,16,-5,16
NorthEast Un,9455,8,4,2,8,9,12,-3,14
Mumbai City,9456,1,7,4,3,18,9,9,25
Kolkata,9456,2,5,6,3,18,15,3,21
Delhi Dynamo,9456,3,5,5,4,26,18,8,20
NorthEast Un,9456,4,5,4,5,12,11,1,19
Kerala Blast,9456,5,5,4,5,13,16,-3,19
Chennaiyin,9456,6,3,7,4,17,21,-4,16
FC Pune City,9456,7,4,3,7,12,18,-6,15
FC Goa,9456,8,4,3,7,14,22,-8,15
Delhi Dynamo,9457,1,5,7,2,25,16,9,22
Mumbai City,9457,2,6,4,4,17,11,6,22
Kolkata,9457,3,4,7,3,18,17,1,19
Chennaiyin,9457,4,4,6,4,15,18,-3,18
Kerala Blast,9457,5,4,6,4,13,17,-4,18
NorthEast Un,9457,6,4,4,6,11,12,-1,16
FC Pune City,9457,7,4,4,6,13,16,-3,16
FC Goa,9457,8,4,4,6,12,17,-5,16
Mumbai City,9458,1,7,4,3,21,9,12,25
Delhi Dynamo,9458,2,5,6,3,23,19,4,21
FC Pune City,9458,3,6,3,5,15,15,0,21
Kolkata,9458,4,4,7,3,16,14,2,19
Kerala Blast,9458,5,4,5,5,12,17,-5,17
NorthEast Un,9458,6,4,4,6,11,12,-1,16
Chennaiyin,9458,7,3,6,5,14,20,-6,15
FC Goa,9458,8,4,3,7,10,16,-6,15
Delhi Dynamo,9459,1,7,5,2,29,16,13,26
Mumbai City,9459,2,6,4,4,17,10,7,22
Kerala Blast,9459,3,6,4,4,11,13,-2,22
FC Pune City,9459,4,5,3,6,14,15,-1,18
NorthEast Un,9459,5,5,3,6,10,13,-3,18
FC Goa,9459,6,5,2,7,13,16,-3,17
Kolkata,9459,7,3,6,5,13,16,-3,15
Chennaiyin,9459,8,3,5,6,13,21,-8,14
Mumbai City,9460,1,6,5,3,17,9,8,23
Delhi Dynamo,9460,2,5,7,2,26,16,10,22
FC Pune City,9460,3,6,3,5,17,16,1,21
Kolkata,9460,4,4,6,4,16,15,1,18
Chennaiyin,9460,5,4,6,4,17,18,-1,18
Kerala Blast,9460,6,5,3,6,11,18,-7,18
NorthEast Un,9460,7,4,3,7,10,14,-4,15
FC Goa,9460,8,4,3,7,10,18,-8,15
Delhi Dynamo,9461,1,6,5,3,26,17,9,23
Mumbai City,9461,2,6,4,4,17,11,6,22
Kerala Blast,9461,3,6,4,4,17,15,2,22
FC Pune City,9461,4,5,4,5,15,16,-1,19
Chennaiyin,9461,5,4,6,4,16,18,-2,18
NorthEast Un,9461,6,5,3,6,12,14,-2,18
Kolkata,9461,7,3,6,5,17,21,-4,15
FC Goa,9461,8,4,2,8,12,20,-8,14
Kolkata,9462,1,6,6,2,22,14,8,24
Mumbai City,9462,2,6,5,3,16,8,8,23
Delhi Dynamo,9462,3,4,8,2,22,15,7,20
Kerala Blast,9462,4,5,4,5,12,16,-4,19
NorthEast Un,9462,5,4,4,6,10,11,-1,16
FC Pune City,9462,6,4,4,6,13,19,-6,16
Chennaiyin,9462,7,3,6,5,14,19,-5,15
FC Goa,9462,8,4,3,7,11,18,-7,15
Delhi Dynamo,9463,1,6,6,2,27,16,11,24
Mumbai City,9463,2,6,4,4,16,11,5,22
Kerala Blast,9463,3,6,4,4,13,14,-1,22
Kolkata,9463,4,4,7,3,15,15,0,19
NorthEast Un,9463,5,5,3,6,10,10,0,18
Chennaiyin,9463,6,3,6,5,14,19,-5,15
FC Pune City,9463,6,4,3,7,14,19,-5,15
FC Goa,9463,8,4,3,7,13,18,-5,15
Delhi Dynamo,9464,1,6,5,3,25,17,8,23
Mumbai City,9464,2,6,4,4,17,10,7,22
Kerala Blast,9464,3,5,4,5,12,17,-5,19
Kolkata,9464,4,3,9,2,18,17,1,18
FC Goa,9464,5,5,3,6,14,16,-2,18
NorthEast Un,9464,6,5,2,7,12,14,-2,17
Chennaiyin,9464,7,4,5,5,17,21,-4,17
FC Pune City,9464,8,4,4,6,16,19,-3,16
Mumbai City,9465,1,7,4,3,20,8,12,25
Delhi Dynamo,9465,2,6,5,3,27,18,9,23
Kerala Blast,9465,3,5,5,4,17,19,-2,20
NorthEast Un,9465,4,5,3,6,16,19,-3,18
FC Pune City,9465,5,4,5,5,13,15,-2,17
Chennaiyin,9465,6,4,5,5,16,19,-3,17
Kolkata,9465,7,3,7,4,13,16,-3,16
FC Goa,9465,8,4,2,8,10,18,-8,14
Mumbai City,9466,1,7,4,3,19,9,10,25
Kolkata,9466,2,5,7,2,17,13,4,22
Delhi Dynamo,9466,3,5,5,4,26,19,7,20
NorthEast Un,9466,4,5,4,5,12,11,1,19
Kerala Blast,9466,5,5,4,5,13,17,-4,19
Chennaiyin,9466,6,3,6,5,16,21,-5,15
FC Pune City,9466,7,4,3,7,13,18,-5,15
FC Goa,9466,8,4,3,7,13,21,-8,15
Delhi Dynamo,9467,1,7,5,2,26,15,11,26
Mumbai City,9467,2,6,4,4,17,11,6,22
FC Pune City,9467,3,6,3,5,15,15,0,21
Kolkata,9467,4,4,7,3,16,15,1,19
Chennaiyin,9467,5,4,6,4,20,22,-2,18
NorthEast Un,9467,6,5,2,7,12,14,-2,17
Kerala Blast,9467,7,4,3,7,9,16,-7,15
FC Goa,9467,8,3,4,7,12,19,-7,13
Kolkata,9468,1,6,6,2,19,12,7,24
Delhi Dynamo,9468,2,6,5,3,29,18,11,23
Mumbai City,9468,3,6,4,4,16,11,5,22
NorthEast Un,9468,4,5,4,5,13,11,2,19
Kerala Blast,9468,5,5,4,5,11,16,-5,19
Chennaiyin,9468,6,4,6,4,16,18,-2,18
FC Pune City,9468,7,4,3,7,13,17,-4,15
FC Goa,9468,8,3,2,9,9,23,-14,11
Mumbai City,9469,1,6,5,3,19,11,8,23
Kolkata,9469,2,5,7,2,18,15,3,22
Delhi Dynamo,9469,3,5,6,3,26,20,6,21
Kerala Blast,9469,4,6,3,5,15,16,-1,21
Chennaiyin,9469,5,3,7,4,15,19,-4,16
FC Pune City,9469,5,4,4,6,15,19,-4,16
NorthEast Un,9469,7,4,3,7,11,14,-3,15
FC Goa,9469,8,4,3,7,11,16,-5,15
Mumbai City,9470,1,7,4,3,18,9,9,25
Delhi Dynamo,9470,2,6,5,3,26,16,10,23
Kolkata,9470,3,5,7,2,18,14,4,22
NorthEast Un,9470,4,5,3,6,11,13,-2,18
Chennaiyin,9470,5,3,7,4,14,18,-4,16
FC Pune City,9470,6,4,4,6,13,17,-4,16
Kerala Blast,9470,7,4,4,6,10,16,-6,16
FC Goa,9470,8,3,4,7,10,17,-7,13
Mumbai City,9471,1,7,4,3,17,8,9,25
Kolkata,9471,2,5,7,2,16,13,3,22
NorthEast Un,9471,3,6,3,5,15,13,2,21
Delhi Dynamo,9471,4,5,5,4,23,17,6,20
Kerala Blast,9471,5,5,4,5,13,17,-4,19
FC Pune City,9471,6,4,3,7,13,17,-4,15
Chennaiyin,9471,7,3,6,5,15,20,-5,15
FC Goa,9471,8,4,2,8,9,16,-7,14
Mumbai City,9472,1,7,4,3,20,10,10,25
Delhi Dynamo,9472,2,5,6,3,26,19,7,21
Kolkata,9472,3,4,8,2,20,18,2,20
Chennaiyin,9472,4,4,6,4,16,17,-1,18
FC Pune City,9472,5,4,5,5,15,17,-2,17
Kerala Blast,9472,6,4,5,5,12,17,-5,17
NorthEast Un,9472,7,4,3,7,10,15,-5,15
FC Goa,9472,8,3,5,6,10,16,-6,14
Mumbai City,9473,1,6,5,3,17,9,8,23
Delhi Dynamo,9473,2,4,7,3,23,18,5,19
FC Pune City,9473,3,5,4,5,18,17,1,19
Kerala Blast,9473,4,5,4,5,12,18,-6,19
FC Goa,9473,5,5,3,6,14,14,0,18
Kolkata,9473,6,3,8,3,16,16,0,17
NorthEast Un,9473,7,5,2,7,12,13,-1,17
Chennaiyin,9473,8,4,5,5,15,22,-7,17
Mumbai City,9474,1,6,5,3,17,9,8,23
Delhi Dynamo,9474,2,5,6,3,23,18,5,21
Kolkata,9474,3,5,6,3,18,15,3,21
NorthEast Un,9474,4,6,2,6,15,13,2,20
Kerala Blast,9474,5,5,4,5,13,16,-3,19
Chennaiyin,9474,6,4,5,5,16,21,-5,17
FC Pune City,9474,7,4,4,6,14,19,-5,16
FC Goa,9474,8,4,2,8,11,16,-5,14
Mumbai City,9475,1,7,4,3,18,8,10,25
Delhi Dynamo,9475,2,5,6,3,25,17,8,21
Kolkata,9475,3,4,7,3,17,16,1,19
NorthEast Un,9475,4,5,3,6,12,13,-1,18
Chennaiyin,9475,5,4,6,4,16,18,-2,18
Kerala Blast,9475,6,5,3,6,13,18,-5,18
FC Pune City,9475,7,4,4,6,13,17,-4,16
FC Goa,9475,8,4,3,7,11,18,-7,15
Mumbai City,9476,1,7,4,3,17,8,9,25
Delhi Dynamo,9476,2,5,6,3,28,18,10,21
Chennaiyin,9476,3,5,5,4,19,20,-1,20
Kerala Blast,9476,4,5,5,4,11,14,-3,20
Kolkata,9476,5,4,7,3,15,15,0,19
FC Pune City,9476,6,5,3,6,15,15,0,18
NorthEast Un,9476,7,4,4,6,15,17,-2,16
FC Goa,9476,8,3,2,9,9,22,-13,11
Delhi Dynamo,9477,1,6,6,2,29,16,13,24
Mumbai City,9477,2,6,4,4,17,11,6,22
Kolkata,9477,3,4,8,2,15,12,3,20
Kerala Blast,9477,4,5,5,4,13,16,-3,20
Chennaiyin,9477,5,4,5,5,16,19,-3,17
FC Pune City,9477,6,4,4,6,15,19,-4,16
NorthEast Un,9477,7,4,3,7,10,13,-3,15
FC Goa,9477,8,4,3,7,10,19,-9,15
Mumbai City,9478,1,6,5,3,17,9,8,23
Delhi Dynamo,9478,2,5,7,2,26,17,9,22
Kolkata,9478,3,5,6,3,18,14,4,21
Kerala Blast,9478,4,5,4,5,12,16,-4,19
Chennaiyin,9478,5,4,6,4,14,17,-3,18
FC Pune City,9478,6,4,4,6,13,18,-5,16
NorthEast Un,9478,7,4,3,7,9,13,-4,15
FC Goa,9478,8,4,3,7,12,17,-5,15
Mumbai City,9479,1,6,5,3,17,9,8,23
NorthEast Un,9479,2,7,2,5,16,11,5,23
Delhi Dynamo,9479,3,5,6,3,25,20,5,21
FC Pune City,9479,4,6,3,5,17,17,0,21
Kolkata,9479,5,4,6,4,16,16,0,18
Chennaiyin,9479,6,3,6,5,13,18,-5,15
FC Goa,9479,7,4,3,7,10,16,-6,15
Kerala Blast,9479,8,4,3,7,11,18,-7,15
Mumbai City,9480,1,7,4,3,18,9,9,25
Kolkata,9480,2,4,7,3,15,13,2,19
FC Pune City,9480,3,5,4,5,14,14,0,19
Delhi Dynamo,9480,4,4,6,4,24,19,5,18
NorthEast Un,9480,5,5,3,6,15,15,0,18
Chennaiyin,9480,6,4,6,4,15,18,-3,18
Kerala Blast,9480,7,5,3,6,12,19,-7,18
FC Goa,9480,8,4,3,7,9,15,-6,15
Delhi Dynamo,9481,1,6,5,3,25,17,8,23
Mumbai City,9481,2,6,4,4,17,10,7,22
NorthEast Un,9481,3,6,2,6,12,12,0,20
FC Pune City,9481,4,5,4,5,15,15,0,19
Kolkata,9481,5,3,8,3,14,15,-1,17
Chennaiyin,9481,6,4,5,5,15,18,-3,17
FC Goa,9481,7,5,2,7,11,15,-4,17
Kerala Blast,9481,8,4,4,6,9,16,-7,16
Mumbai City,9482,1,6,5,3,17,9,8,23
Kerala Blast,9482,2,6,4,4,15,13,2,22
Delhi Dynamo,9482,3,4,6,4,23,18,5,18
Chennaiyin,9482,4,4,6,4,17,19,-2,18
FC Goa,9482,5,5,3,6,13,17,-4,18
FC Pune City,9482,6,4,5,5,13,15,-2,17
NorthEast Un,9482,7,5,2,7,12,17,-5,17
Kolkata,9482,8,3,7,4,16,18,-2,16
Mumbai City,9483,1,6,4,4,18,12,6,22
Delhi Dynamo,9483,2,5,6,3,26,19,7,21
Kolkata,9483,3,4,8,2,16,14,2,20
FC Pune City,9483,4,5,4,5,15,16,-1,19
FC Goa,9483,5,5,3,6,12,15,-3,18
Chennaiyin,9483,6,4,5,5,16,18,-2,17
NorthEast Un,9483,7,4,4,6,10,13,-3,16
Kerala Blast,9483,8,4,4,6,10,16,-6,16
Mumbai City,9484,1,6,5,3,18,10,8,23
Kolkata,9484,2,5,7,2,16,13,3,22
Delhi Dynamo,9484,3,5,6,3,26,19,7,21
Kerala Blast,9484,4,6,3,5,12,15,-3,21
FC Goa,9484,5,5,3,6,14,17,-3,18
Chennaiyin,9484,6,4,5,5,17,19,-2,17
FC Pune City,9484,7,4,3,7,13,17,-4,15
NorthEast Un,9484,8,4,2,8,9,15,-6,14
Mumbai City,9485,1,7,4,3,19,10,9,25
Delhi Dynamo,9485,2,6,5,3,28,20,8,23
Kolkata,9485,3,5,7,2,20,14,6,22
FC Pune City,9485,4,5,4,5,14,15,-1,19
Kerala Blast,9485,5,5,3,6,11,18,-7,18
NorthEast Un,9485,6,5,2,7,13,13,0,17
FC Goa,9485,7,4,2,8,15,21,-6,14
Chennaiyin,9485,8,3,5,6,14,23,-9,14
Mumbai City,9486,1,7,4,3,17,8,9,25
Kerala Blast,9486,2,7,3,4,15,15,0,24
Delhi Dynamo,9486,3,5,6,3,25,17,8,21
NorthEast Un,9486,4,5,2,7,12,15,-3,17
Kolkata,9486,5,3,7,4,16,18,-2,16
FC Pune City,9486,6,4,4,6,15,18,-3,16
FC Goa,9486,7,4,4,6,11,15,-4,16
Chennaiyin,9486,8,3,6,5,14,19,-5,15
Mumbai City,9487,1,7,4,3,17,8,9,25
Kerala Blast,9487,2,7,3,4,16,15,1,24
Delhi Dynamo,9487,3,6,5,3,25,16,9,23
Chennaiyin,9487,4,5,5,4,16,18,-2,20
FC Pune City,9487,5,5,3,6,16,17,-1,18
Kolkata,9487,6,3,6,5,15,20,-5,15
NorthEast Un,9487,7,4,2,8,11,15,-4,14
FC Goa,9487,8,4,2,8,11,18,-7,14
Delhi Dynamo,9488,1,6,6,2,28,16,12,24
Mumbai City,9488,2,6,4,4,17,11,6,22
Kerala Blast,9488,3,5,5,4,12,14,-2,20
FC Pune City,9488,4,5,3,6,14,17,-3,18
Kolkata,9488,5,3,8,3,15,15,0,17
NorthEast Un,9488,6,4,4,6,11,14,-3,16
Chennaiyin,9488,7,3,7,4,16,20,-4,16
FC Goa,9488,8,3,5,6,10,16,-6,14
Mumbai City,9489,1,6,4,4,16,9,7,22
Delhi Dynamo,9489,2,5,6,3,23,16,7,21
Kerala Blast,9489,3,6,3,5,17,18,-1,21
Chennaiyin,9489,4,5,5,4,17,17,0,20
Kolkata,9489,5,4,6,4,16,16,0,18
FC Pune City,9489,6,5,3,6,17,19,-2,18
FC Goa,9489,7,5,2,7,10,16,-6,17
NorthEast Un,9489,8,4,3,7,11,16,-5,15
Kerala Blast,9490,1,7,3,4,16,14,2,24
Mumbai City,9490,2,6,5,3,18,10,8,23
Delhi Dynamo,9490,3,5,7,2,26,17,9,22
Chennaiyin,9490,4,5,5,4,17,19,-2,20
Kolkata,9490,5,3,8,3,14,16,-2,17
FC Pune City,9490,6,4,4,6,13,16,-3,16
NorthEast Un,9490,7,4,3,7,12,15,-3,15
FC Goa,9490,8,3,3,8,9,18,-9,12
Mumbai City,9491,1,7,4,3,19,9,10,25
NorthEast Un,9491,2,6,3,5,12,10,2,21
Kerala Blast,9491,3,6,3,5,12,15,-3,21
Kolkata,9491,4,4,6,4,19,18,1,18
Chennaiyin,9491,5,4,6,4,15,17,-2,18
Delhi Dynamo,9491,6,4,5,5,22,19,3,17
FC Goa,9491,7,5,2,7,12,18,-6,17
FC Pune City,9491,8,4,3,7,14,19,-5,15
Mumbai City,9492,1,7,4,3,19,10,9,25
Kolkata,9492,2,6,6,2,19,13,6,24
Delhi Dynamo,9492,3,5,6,3,26,18,8,21
Kerala Blast,9492,4,5,4,5,11,16,-5,19
Chennaiyin,9492,5,4,6,4,16,19,-3,18
FC Pune City,9492,6,4,4,6,14,18,-4,16
NorthEast Un,9492,7,4,3,7,10,13,-3,15
FC Goa,9492,8,3,3,8,10,18,-8,12
Mumbai City,9493,1,7,4,3,18,9,9,25
Delhi Dynamo,9493,2,5,5,4,25,18,7,20
Kolkata,9493,3,4,7,3,15,17,-2,19
FC Pune City,9493,4,5,3,6,17,16,1,18
NorthEast Un,9493,5,5,3,6,14,14,0,18
FC Goa,9493,6,5,3,6,12,16,-4,18
Kerala Blast,9493,7,5,3,6,13,19,-6,18
Chennaiyin,9493,8,3,6,5,16,21,-5,15
Delhi Dynamo,9494,1,5,7,2,25,16,9,22
Mumbai City,9494,2,6,4,4,16,10,6,22
Kerala Blast,9494,3,5,5,4,17,15,2,20
NorthEast Un,9494,4,5,4,5,14,12,2,19
Kolkata,9494,5,3,9,2,14,13,1,18
Chennaiyin,9494,6,4,5,5,15,20,-5,17
FC Pune City,9494,7,4,4,6,13,21,-8,16
FC Goa,9494,8,3,4,7,10,17,-7,13
Mumbai City,9495,1,7,4,3,19,8,11,25
Kolkata,9495,2,5,6,3,18,17,1,21
Kerala Blast,9495,3,6,3,5,13,15,-2,21
Delhi Dynamo,9495,4,5,5,4,24,20,4,20
NorthEast Un,9495,5,6,2,6,13,11,2,20
FC Goa,9495,6,5,2,7,16,20,-4,17
FC Pune City,9495,7,4,3,7,13,18,-5,15
Chennaiyin,9495,8,3,5,6,16,23,-7,14
Mumbai City,9496,1,7,4,3,18,8,10,25
Delhi Dynamo,9496,2,6,5,3,27,17,10,23
Kolkata,9496,3,5,6,3,17,14,3,21
Kerala Blast,9496,4,6,3,5,13,15,-2,21
NorthEast Un,9496,5,5,2,7,11,12,-1,17
FC Goa,9496,6,5,2,7,13,19,-6,17
FC Pune City,9496,7,4,3,7,13,20,-7,15
Chennaiyin,9496,8,3,5,6,14,21,-7,14
Mumbai City,9497,1,6,5,3,16,8,8,23
FC Pune City,9497,2,6,3,5,16,16,0,21
Delhi Dynamo,9497,3,4,7,3,24,18,6,19
Kolkata,9497,4,4,6,4,17,17,0,18
Chennaiyin,9497,5,4,6,4,17,19,-2,18
FC Goa,9497,6,5,3,6,14,18,-4,18
Kerala Blast,9497,7,5,3,6,13,18,-5,18
NorthEast Un,9497,8,4,3,7,12,15,-3,15
Mumbai City,9498,1,7,4,3,17,8,9,25
NorthEast Un,9498,2,6,2,6,11,12,-1,20
Kolkata,9498,3,4,7,3,17,14,3,19
Delhi Dynamo,9498,4,4,6,4,23,18,5,18
Chennaiyin,9498,5,4,6,4,16,17,-1,18
Kerala Blast,9498,6,4,5,5,11,16,-5,17
FC Pune City,9498,7,4,4,6,13,18,-5,16
FC Goa,9498,8,4,4,6,11,16,-5,16
Mumbai City,9499,1,6,5,3,17,9,8,23
Delhi Dynamo,9499,2,5,6,3,25,18,7,21
NorthEast Un,9499,3,6,2,6,14,12,2,20
Kolkata,9499,4,4,7,3,16,14,2,19
Kerala Blast,9499,5,5,3,6,12,20,-8,18
Chennaiyin,9499,6,4,5,5,15,19,-4,17
FC Goa,9499,7,5,2,7,13,17,-4,17
FC Pune City,9499,8,4,4,6,14,17,-3,16
Mumbai City,9500,1,6,5,3,19,11,8,23
Kolkata,9500,2,5,6,3,20,13,7,21
Delhi Dynamo,9500,3,4,7,3,25,20,5,19
NorthEast Un,9500,4,5,3,6,11,10,1,18
FC Pune City,9500,5,5,3,6,15,17,-2,18
FC Goa,9500,6,5,3,6,12,15,-3,18
Kerala Blast,9500,7,5,3,6,10,20,-10,18
Chennaiyin,9500,8,3,6,5,13,19,-6,15
Delhi Dynamo,9501,1,6,6,2,24,15,9,24
Mumbai City,9501,2,6,5,3,16,8,8,23
Kolkata,9501,3,5,7,2,19,12,7,22
FC Pune City,9501,4,5,4,5,14,14,0,19
Chennaiyin,9501,5,4,6,4,18,19,-1,18
Kerala Blast,9501,6,5,3,6,13,18,-5,18
NorthEast Un,9501,7,4,3,7,12,17,-5,15
FC Goa,9501,8,3,2,9,8,21,-13,11
Kolkata,9502,1,6,6,2,18,12,6,24
Mumbai City,9502,2,6,4,4,17,11,6,22
Delhi Dynamo,9502,3,5,5,4,24,18,6,20
NorthEast Un,9502,4,6,2,6,13,13,0,20
Kerala Blast,9502,5,5,4,5,13,15,-2,19
Chennaiyin,9502,6,4,5,5,16,20,-4,17
FC Pune City,9502,7,4,4,6,13,18,-5,16
FC Goa,9502,8,4,2,8,10,17,-7,14
Mumbai City,9503,1,6,5,3,16,8,8,23
Kolkata,9503,2,5,7,2,21,15,6,22
Delhi Dynamo,9503,3,5,6,3,24,18,6,21
Kerala Blast,9503,4,6,3,5,15,17,-2,21
NorthEast Un,9503,5,6,2,6,16,11,5,20
Chennaiyin,9503,6,4,5,5,14,21,-7,17
FC Pune City,9503,7,4,3,7,12,19,-7,15
FC Goa,9503,8,3,3,8,11,20,-9,12
Mumbai City,9504,1,7,4,3,17,8,9,25
Kolkata,9504,2,5,6,3,18,15,3,21
FC Goa,9504,3,6,2,6,15,17,-2,20
NorthEast Un,9504,4,5,4,5,11,10,1,19
Kerala Blast,9504,5,5,4,5,13,18,-5,19
Delhi Dynamo,9504,6,4,6,4,22,17,5,18
FC Pune City,9504,7,4,3,7,13,18,-5,15
Chennaiyin,9504,8,3,5,6,15,21,-6,14
Mumbai City,9505,1,6,4,4,16,9,7,22
NorthEast Un,9505,2,6,3,5,14,11,3,21
Delhi Dynamo,9505,3,5,5,4,27,22,5,20
Kolkata,9505,4,4,7,3,15,14,1,19
FC Pune City,9505,5,4,5,5,14,16,-2,17
Chennaiyin,9505,6,4,5,5,15,19,-4,17
FC Goa,9505,7,5,2,7,15,20,-5,17
Kerala Blast,9505,8,4,5,5,13,18,-5,17
Delhi Dynamo,9506,1,6,6,2,29,19,10,24
Mumbai City,9506,2,6,4,4,17,10,7,22
Kolkata,9506,3,5,6,3,19,18,1,21
Kerala Blast,9506,4,5,4,5,13,17,-4,19
NorthEast Un,9506,5,5,3,6,15,15,0,18
FC Pune City,9506,6,5,3,6,14,15,-1,18
FC Goa,9506,7,4,3,7,13,19,-6,15
Chennaiyin,9506,8,3,5,6,14,21,-7,14
Mumbai City,9507,1,7,4,3,18,8,10,25
Kerala Blast,9507,2,7,3,4,16,14,2,24
Delhi Dynamo,9507,3,5,6,3,25,18,7,21
Kolkata,9507,4,5,6,3,16,15,1,21
NorthEast Un,9507,5,5,3,6,12,13,-1,18
Chennaiyin,9507,6,4,5,5,15,20,-5,17
FC Pune City,9507,7,4,3,7,14,18,-4,15
FC Goa,9507,8,3,2,9,10,20,-10,11
Delhi Dynamo,9508,1,7,5,2,32,19,13,26
Mumbai City,9508,2,6,4,4,19,12,7,22
Kolkata,9508,3,5,7,2,18,14,4,22
NorthEast Un,9508,4,5,3,6,13,12,1,18
Chennaiyin,9508,5,4,6,4,15,18,-3,18
FC Pune City,9508,6,4,4,6,12,16,-4,16
Kerala Blast,9508,7,4,4,6,10,17,-7,16
FC Goa,9508,8,3,3,8,10,21,-11,12
Delhi Dynamo,9509,1,7,5,2,28,17,11,26
Mumbai City,9509,2,6,4,4,16,10,6,22
Kolkata,9509,3,5,6,3,18,14,4,21
NorthEast Un,9509,4,6,2,6,12,11,1,20
Kerala Blast,9509,5,5,3,6,11,16,-5,18
Chennaiyin,9509,6,4,5,5,15,18,-3,17
FC Pune City,9509,7,4,3,7,14,20,-6,15
FC Goa,9509,8,4,2,8,11,19,-8,14
Mumbai City,9510,1,7,4,3,18,9,9,25
NorthEast Un,9510,2,6,3,5,12,10,2,21
Delhi Dynamo,9510,3,5,5,4,26,19,7,20
Kolkata,9510,4,4,7,3,17,15,2,19
FC Pune City,9510,5,5,4,5,15,16,-1,19
FC Goa,9510,6,5,2,7,13,19,-6,17
Chennaiyin,9510,7,3,6,5,15,20,-5,15
Kerala Blast,9510,8,4,3,7,9,17,-8,15
Mumbai City,9511,1,7,4,3,19,10,9,25
Kolkata,9511,2,5,6,3,19,15,4,21
Kerala Blast,9511,3,6,3,5,14,18,-4,21
FC Goa,9511,4,6,2,6,16,17,-1,20
NorthEast Un,9511,5,5,3,6,12,11,1,18
Delhi Dynamo,9511,6,4,5,5,24,22,2,17
Chennaiyin,9511,7,3,6,5,15,20,-5,15
FC Pune City,9511,8,4,3,7,14,20,-6,15
Mumbai City,9512,1,7,4,3,18,9,9,25
Delhi Dynamo,9512,2,5,5,4,26,22,4,20
Kerala Blast,9512,3,5,5,4,13,16,-3,20
FC Pune City,9512,4,5,4,5,15,16,-1,19
NorthEast Un,9512,5,5,3,6,15,13,2,18
Chennaiyin,9512,6,4,6,4,16,19,-3,18
Kolkata,9512,7,3,8,3,14,14,0,17
FC Goa,9512,8,3,3,8,10,18,-8,12
Mumbai City,9513,1,6,5,3,17,9,8,23
Delhi Dynamo,9513,2,5,7,2,28,18,10,22
Chennaiyin,9513,3,5,5,4,16,17,-1,20
Kerala Blast,9513,4,5,4,5,13,18,-5,19
NorthEast Un,9513,5,5,3,6,14,13,1,18
FC Pune City,9513,6,5,3,6,16,18,-2,18
Kolkata,9513,7,3,7,4,16,20,-4,16
FC Goa,9513,8,4,2,8,13,20,-7,14
Mumbai City,9514,1,7,4,3,17,8,9,25
Delhi Dynamo,9514,2,5,6,3,25,18,7,21
Chennaiyin,9514,3,5,5,4,16,18,-2,20
Kerala Blast,9514,4,5,5,4,13,16,-3,20
Kolkata,9514,5,4,7,3,21,17,4,19
FC Pune City,9514,6,4,4,6,13,19,-6,16
FC Goa,9514,7,4,3,7,12,18,-6,15
NorthEast Un,9514,8,4,2,8,12,15,-3,14
Mumbai City,9515,1,7,4,3,20,8,12,25
Chennaiyin,9515,2,5,5,4,17,19,-2,20
Delhi Dynamo,9515,3,4,7,3,23,20,3,19
FC Pune City,9515,4,5,4,5,13,14,-1,19
Kerala Blast,9515,5,4,6,4,9,13,-4,18
Kolkata,9515,6,3,8,3,13,13,0,17
NorthEast Un,9515,7,4,4,6,10,11,-1,16
FC Goa,9515,8,3,4,7,11,18,-7,13
Delhi Dynamo,9516,1,5,7,2,26,16,10,22
Mumbai City,9516,2,6,4,4,17,12,5,22
Kerala Blast,9516,3,5,4,5,11,15,-4,19
FC Pune City,9516,4,5,3,6,15,16,-1,18
NorthEast Un,9516,5,5,3,6,11,12,-1,18
Chennaiyin,9516,6,4,6,4,16,18,-2,18
Kolkata,9516,7,3,7,4,14,16,-2,16
FC Goa,9516,8,4,4,6,11,16,-5,16
Mumbai City,9517,1,7,4,3,18,8,10,25
Kolkata,9517,2,6,6,2,21,13,8,24
Delhi Dynamo,9517,3,5,6,3,24,17,7,21
Kerala Blast,9517,4,6,3,5,11,15,-4,21
NorthEast Un,9517,5,5,2,7,10,12,-2,17
Chennaiyin,9517,6,3,6,5,14,19,-5,15
FC Pune City,9517,7,4,3,7,12,17,-5,15
FC Goa,9517,8,3,4,7,11,20,-9,13
Delhi Dynamo,9518,1,6,6,2,28,16,12,24
Mumbai City,9518,2,6,5,3,17,9,8,23
Kolkata,9518,3,5,6,3,20,14,6,21
NorthEast Un,9518,4,5,3,6,12,13,-1,18
FC Pune City,9518,5,5,3,6,15,18,-3,18
Kerala Blast,9518,6,5,3,6,10,16,-6,18
Chennaiyin,9518,7,3,6,5,15,21,-6,15
FC Goa,9518,8,4,2,8,11,21,-10,14
Mumbai City,9519,1,7,4,3,18,9,9,25
Delhi Dynamo,9519,2,5,6,3,24,17,7,21
Kerala Blast,9519,3,6,3,5,14,17,-3,21
Kolkata,9519,4,4,7,3,19,19,0,19
FC Goa,9519,5,5,3,6,15,15,0,18
FC Pune City,9519,6,4,4,6,17,20,-3,16
NorthEast Un,9519,7,4,3,7,12,15,-3,15
Chennaiyin,9519,8,3,6,5,15,22,-7,15
Mumbai City,9520,1,7,4,3,17,8,9,25
NorthEast Un,9520,2,6,2,6,11,10,1,20
FC Goa,9520,3,6,2,6,17,17,0,20
Delhi Dynamo,9520,4,4,5,5,22,19,3,17
Kolkata,9520,5,3,8,3,18,18,0,17
FC Pune City,9520,6,4,5,5,14,16,-2,17
Kerala Blast,9520,7,4,5,5,10,15,-5,17
Chennaiyin,9520,8,4,5,5,14,20,-6,17
Mumbai City,9521,1,6,5,3,16,8,8,23
Kerala Blast,9521,2,6,4,4,14,15,-1,22
Delhi Dynamo,9521,3,5,6,3,25,17,8,21
FC Goa,9521,4,5,3,6,14,17,-3,18
FC Pune City,9521,5,5,3,6,13,16,-3,18
Kolkata,9521,6,3,8,3,16,16,0,17
NorthEast Un,9521,7,4,3,7,11,14,-3,15
Chennaiyin,9521,8,3,6,5,15,21,-6,15
Mumbai City,9522,1,6,5,3,16,8,8,23
NorthEast Un,9522,2,6,3,5,13,10,3,21
Kolkata,9522,3,4,8,2,15,12,3,20
Delhi Dynamo,9522,4,4,7,3,23,17,6,19
FC Pune City,9522,5,5,4,5,14,15,-1,19
Chennaiyin,9522,6,4,5,5,14,18,-4,17
FC Goa,9522,7,4,3,7,10,16,-6,15
Kerala Blast,9522,8,4,3,7,10,19,-9,15
Mumbai City,9523,1,7,4,3,19,9,10,25
NorthEast Un,9523,2,6,3,5,15,12,3,21
Delhi Dynamo,9523,3,5,5,4,26,20,6,20
Kolkata,9523,4,4,7,3,15,13,2,19
FC Pune City,9523,5,5,4,5,15,16,-1,19
Kerala Blast,9523,6,5,4,5,12,16,-4,19
Chennaiyin,9523,7,4,5,5,17,21,-4,17
FC Goa,9523,8,3,2,9,9,21,-12,11
Mumbai City,9524,1,7,4,3,19,9,10,25
Kolkata,9524,2,6,6,2,19,13,6,24
Kerala Blast,9524,3,6,3,5,14,15,-1,21
Delhi Dynamo,9524,4,5,5,4,26,19,7,20
Chennaiyin,9524,5,4,5,5,18,21,-3,17
NorthEast Un,9524,6,5,2,7,12,15,-3,17
FC Pune City,9524,7,4,3,7,12,18,-6,15
FC Goa,9524,8,4,2,8,13,23,-10,14
Mumbai City,9525,1,6,5,3,18,10,8,23
Kerala Blast,9525,2,6,4,4,12,14,-2,22
FC Goa,9525,3,6,2,6,18,16,2,20
Delhi Dynamo,9525,4,4,6,4,25,22,3,18
Kolkata,9525,5,4,6,4,15,16,-1,18
NorthEast Un,9525,6,5,2,7,13,13,0,17
Chennaiyin,9525,7,4,5,5,16,22,-6,17
FC Pune City,9525,8,4,4,6,13,17,-4,16
Mumbai City,9526,1,6,5,3,17,9,8,23
Delhi Dynamo,9526,2,5,7,2,25,16,9,22
Kolkata,9526,3,5,6,3,18,15,3,21
Kerala Blast,9526,4,6,3,5,14,17,-3,21
FC Pune City,9526,5,5,3,6,15,17,-2,18
Chennaiyin,9526,6,4,6,4,15,18,-3,18
NorthEast Un,9526,7,4,2,8,9,13,-4,14
FC Goa,9526,8,3,4,7,10,18,-8,13
Delhi Dynamo,9527,1,7,5,2,28,15,13,26
Mumbai City,9527,2,6,4,4,16,9,7,22
Kolkata,9527,3,5,6,3,19,14,5,21
FC Pune City,9527,4,5,3,6,13,16,-3,18
Kerala Blast,9527,5,5,3,6,14,18,-4,18
Chennaiyin,9527,6,3,7,4,14,18,-4,16
FC Goa,9527,7,4,3,7,11,18,-7,15
NorthEast Un,9527,8,4,3,7,9,16,-7,15
Mumbai City,9528,1,7,4,3,19,8,11,25
Delhi Dynamo,9528,2,6,5,3,27,19,8,23
Kolkata,9528,3,5,7,2,16,13,3,22
Kerala Blast,9528,4,6,3,5,11,14,-3,21
Chennaiyin,9528,5,4,6,4,15,18,-3,18
FC Pune City,9528,6,4,3,7,12,16,-4,15
NorthEast Un,9528,7,4,2,8,11,14,-3,14
FC Goa,9528,8,3,4,7,10,19,-9,13
Mumbai City,9529,1,7,4,3,18,9,9,25
Kolkata,9529,2,5,6,3,19,15,4,21
Delhi Dynamo,9529,3,4,7,3,22,16,6,19
FC Pune City,9529,4,5,3,6,14,16,-2,18
FC Goa,9529,5,5,3,6,11,14,-3,18
Kerala Blast,9529,6,5,3,6,11,18,-7,18
NorthEast Un,9529,7,4,4,6,9,11,-2,16
Chennaiyin,9529,8,3,6,5,13,18,-5,15
Delhi Dynamo,9530,1,6,5,3,26,19,7,23
Mumbai City,9530,2,6,4,4,17,10,7,22
NorthEast Un,9530,3,6,3,5,14,10,4,21
Kolkata,9530,4,5,6,3,18,15,3,21
FC Pune City,9530,5,5,3,6,14,16,-2,18
FC Goa,9530,6,5,2,7,14,18,-4,17
Chennaiyin,9530,7,3,6,5,14,20,-6,15
Kerala Blast,9530,8,4,3,7,11,20,-9,15
Delhi Dynamo,9531,1,5,7,2,23,15,8,22
Mumbai City,9531,2,6,4,4,16,9,7,22
Kolkata,9531,3,5,7,2,17,14,3,22
FC Pune City,9531,4,5,4,5,15,16,-1,19
NorthEast Un,9531,5,4,5,5,12,12,0,17
Chennaiyin,9531,6,3,7,4,15,19,-4,16
Kerala Blast,9531,7,4,4,6,11,17,-6,16
FC Goa,9531,8,3,4,7,10,17,-7,13
Mumbai City,9532,1,7,4,3,19,8,11,25
Delhi Dynamo,9532,2,5,5,4,24,20,4,20
Kolkata,9532,3,4,8,2,17,15,2,20
NorthEast Un,9532,4,6,2,6,13,11,2,20
FC Pune City,9532,5,5,4,5,15,16,-1,19
Kerala Blast,9532,6,5,3,6,10,15,-5,18
FC Goa,9532,7,4,3,7,13,18,-5,15
Chennaiyin,9532,8,3,5,6,14,22,-8,14
Mumbai City,9533,1,6,5,3,16,8,8,23
NorthEast Un,9533,2,7,2,5,14,9,5,23
Delhi Dynamo,9533,3,5,6,3,23,18,5,21
Kolkata,9533,4,5,6,3,17,14,3,21
Chennaiyin,9533,5,4,5,5,15,18,-3,17
FC Pune City,9533,6,4,4,6,15,19,-4,16
Kerala Blast,9533,7,4,4,6,11,17,-6,16
FC Goa,9533,8,4,2,8,10,18,-8,14
Kolkata,9534,1,6,6,2,20,13,7,24
Mumbai City,9534,2,6,5,3,16,8,8,23
NorthEast Un,9534,3,6,3,5,15,12,3,21
Delhi Dynamo,9534,4,4,8,2,24,17,7,20
FC Pune City,9534,5,5,3,6,14,16,-2,18
Chennaiyin,9534,6,4,5,5,18,20,-2,17
Kerala Blast,9534,7,4,3,7,10,20,-10,15
FC Goa,9534,8,3,3,8,11,22,-11,12
Delhi Dynamo,9535,1,7,5,2,29,16,13,26
Mumbai City,9535,2,6,4,4,17,10,7,22
Kolkata,9535,3,5,6,3,18,16,2,21
Chennaiyin,9535,4,5,5,4,19,19,0,20
Kerala Blast,9535,5,5,3,6,13,19,-6,18
NorthEast Un,9535,6,5,2,7,13,15,-2,17
FC Pune City,9535,7,4,3,7,14,19,-5,15
FC Goa,9535,8,4,2,8,12,21,-9,14
Delhi Dynamo,9536,1,7,5,2,27,14,13,26
Mumbai City,9536,2,6,4,4,16,10,6,22
Kerala Blast,9536,3,5,4,5,13,17,-4,19
NorthEast Un,9536,4,5,3,6,14,13,1,18
Chennaiyin,9536,5,4,6,4,17,19,-2,18
Kolkata,9536,6,3,8,3,15,16,-1,17
FC Pune City,9536,7,4,4,6,12,16,-4,16
FC Goa,9536,8,4,2,8,11,20,-9,14
Mumbai City,9537,1,6,5,3,17,9,8,23
Delhi Dynamo,9537,2,5,7,2,24,16,8,22
Kolkata,9537,3,5,7,2,20,15,5,22
NorthEast Un,9537,4,5,3,6,11,11,0,18
Chennaiyin,9537,5,4,6,4,15,18,-3,18
FC Pune City,9537,6,5,3,6,13,16,-3,18
Kerala Blast,9537,7,4,4,6,11,17,-6,16
FC Goa,9537,8,3,3,8,10,19,-9,12
Kerala Blast,9538,1,7,3,4,13,14,-1,24
Delhi Dynamo,9538,2,5,7,2,25,17,8,22
Mumbai City,9538,3,6,4,4,16,9,7,22
FC Goa,9538,4,5,3,6,16,16,0,18
Chennaiyin,9538,5,4,5,5,16,23,-7,17
Kolkata,9538,6,3,7,4,13,15,-2,16
FC Pune City,9538,7,4,4,6,12,15,-3,16
NorthEast Un,9538,8,4,3,7,13,15,-2,15
Delhi Dynamo,9539,1,6,5,3,25,16,9,23
Mumbai City,9539,2,6,4,4,16,11,5,22
NorthEast Un,9539,3,6,3,5,17,10,7,21
Kolkata,9539,4,5,6,3,20,17,3,21
Chennaiyin,9539,5,4,6,4,18,19,-1,18
FC Pune City,9539,6,5,3,6,14,17,-3,18
Kerala Blast,9539,7,4,3,7,11,25,-14,15
FC Goa,9539,8,4,2,8,13,19,-6,14
Delhi Dynamo,9540,1,7,5,2,29,17,12,26
Mumbai City,9540,2,6,4,4,18,13,5,22
Kerala Blast,9540,3,6,4,4,11,13,-2,22
FC Pune City,9540,4,5,4,5,14,14,0,19
Chennaiyin,9540,5,4,5,5,16,18,-2,17
FC Goa,9540,6,5,2,7,11,16,-5,17
Kolkata,9540,7,3,6,5,14,17,-3,15
NorthEast Un,9540,8,4,2,8,10,15,-5,14
Delhi Dynamo,9541,1,6,5,3,25,18,7,23
Mumbai City,9541,2,6,4,4,17,10,7,22
Kolkata,9541,3,4,7,3,15,14,1,19
Kerala Blast,9541,4,5,4,5,13,17,-4,19
NorthEast Un,9541,5,5,3,6,16,15,1,18
FC Pune City,9541,6,5,3,6,14,16,-2,18
Chennaiyin,9541,7,4,6,4,17,20,-3,18
FC Goa,9541,8,4,2,8,11,18,-7,14
Delhi Dynamo,9542,1,6,5,3,25,16,9,23
Mumbai City,9542,2,6,4,4,16,9,7,22
Kolkata,9542,3,5,6,3,19,15,4,21
Kerala Blast,9542,4,6,3,5,12,16,-4,21
Chennaiyin,9542,5,5,5,4,22,20,2,20
FC Pune City,9542,6,5,3,6,16,19,-3,18
NorthEast Un,9542,7,5,2,7,14,17,-3,17
FC Goa,9542,8,3,2,9,8,20,-12,11
Kolkata,9543,1,6,6,2,18,13,5,24
Mumbai City,9543,2,6,5,3,17,9,8,23
Delhi Dynamo,9543,3,5,6,3,23,18,5,21
NorthEast Un,9543,4,6,2,6,13,11,2,20
Kerala Blast,9543,5,5,4,5,12,15,-3,19
FC Pune City,9543,6,4,4,6,13,17,-4,16
Chennaiyin,9543,7,3,6,5,13,18,-5,15
FC Goa,9543,8,3,3,8,9,17,-8,12
Mumbai City,9544,1,7,4,3,18,8,10,25
Delhi Dynamo,9544,2,6,5,3,26,17,9,23
FC Pune City,9544,3,6,3,5,16,15,1,21
Chennaiyin,9544,4,4,6,4,15,18,-3,18
Kerala Blast,9544,5,4,5,5,11,16,-5,17
NorthEast Un,9544,6,4,4,6,11,13,-2,16
Kolkata,9544,7,3,7,4,15,18,-3,16
FC Goa,9544,8,4,2,8,11,18,-7,14
Mumbai City,9545,1,6,5,3,16,8,8,23
NorthEast Un,9545,2,7,2,5,16,10,6,23
FC Pune City,9545,3,5,4,5,14,15,-1,19
Delhi Dynamo,9545,4,4,6,4,24,19,5,18
Kolkata,9545,5,3,9,2,15,14,1,18
FC Goa,9545,6,4,4,6,13,18,-5,16
Kerala Blast,9545,7,4,4,6,9,16,-7,16
Chennaiyin,9545,8,3,6,5,14,21,-7,15
Delhi Dynamo,9546,1,6,5,3,25,17,8,23
Mumbai City,9546,2,6,4,4,16,9,7,22
Kolkata,9546,3,5,7,2,18,15,3,22
Chennaiyin,9546,4,4,6,4,16,19,-3,18
Kerala Blast,9546,5,4,5,5,14,19,-5,17
NorthEast Un,9546,6,4,4,6,14,15,-1,16
FC Pune City,9546,7,4,4,6,13,16,-3,16
FC Goa,9546,8,4,3,7,13,19,-6,15
Delhi Dynamo,9547,1,6,5,3,24,16,8,23
Mumbai City,9547,2,6,4,4,16,9,7,22
Kolkata,9547,3,5,7,2,19,14,5,22
NorthEast Un,9547,4,6,2,6,11,10,1,20
Kerala Blast,9547,5,5,4,5,12,16,-4,19
Chennaiyin,9547,6,3,6,5,13,18,-5,15
FC Pune City,9547,7,4,3,7,12,18,-6,15
FC Goa,9547,8,4,3,7,10,16,-6,15
Mumbai City,9548,1,6,5,3,17,9,8,23
Chennaiyin,9548,2,5,5,4,18,17,1,20
Delhi Dynamo,9548,3,4,7,3,25,19,6,19
Kolkata,9548,4,4,7,3,16,14,2,19
Kerala Blast,9548,5,5,4,5,11,17,-6,19
FC Pune City,9548,6,4,5,5,13,15,-2,17
FC Goa,9548,7,5,2,7,12,19,-7,17
NorthEast Un,9548,8,4,3,7,11,13,-2,15
Mumbai City,9549,1,7,4,3,18,9,9,25
Delhi Dynamo,9549,2,5,6,3,28,19,9,21
Kolkata,9549,3,5,6,3,16,15,1,21
Kerala Blast,9549,4,6,3,5,15,16,-1,21
Chennaiyin,9549,5,4,5,5,16,20,-4,17
FC Goa,9549,6,5,2,7,13,18,-5,17
FC Pune City,9549,7,4,3,7,13,17,-4,15
NorthEast Un,9549,8,4,3,7,12,17,-5,15
Delhi Dynamo,9550,1,7,5,2,27,16,11,26
Mumbai City,9550,2,6,4,4,18,12,6,22
Kerala Blast,9550,3,6,4,4,12,14,-2,22
Kolkata,9550,4,4,7,3,14,13,1,19
NorthEast Un,9550,5,5,3,6,11,11,0,18
FC Pune City,9550,6,4,4,6,12,15,-3,16
FC Goa,9550,7,4,2,8,11,17,-6,14
Chennaiyin,9550,8,3,5,6,14,21,-7,14
Mumbai City,9551,1,7,4,3,17,8,9,25
Delhi Dynamo,9551,2,5,6,3,24,16,8,21
Kolkata,9551,3,4,8,2,14,12,2,20
NorthEast Un,9551,4,6,2,6,13,13,0,20
Kerala Blast,9551,5,5,4,5,12,15,-3,19
FC Pune City,9551,6,4,4,6,12,16,-4,16
FC Goa,9551,7,4,3,7,15,16,-1,15
Chennaiyin,9551,8,3,5,6,14,25,-11,14
Mumbai City,9552,1,7,4,3,18,9,9,25
Kerala Blast,9552,2,6,3,5,13,17,-4,21
Chennaiyin,9552,3,5,5,4,18,19,-1,20
FC Pune City,9552,4,5,4,5,16,16,0,19
Delhi Dynamo,9552,5,4,5,5,22,18,4,17
NorthEast Un,9552,6,5,2,7,11,13,-2,17
FC Goa,9552,7,5,2,7,12,17,-5,17
Kolkata,9552,8,3,7,4,18,19,-1,16
Delhi Dynamo,9553,1,6,6,2,27,17,10,24
Mumbai City,9553,2,6,5,3,19,11,8,23
Kerala Blast,9553,3,5,5,4,12,15,-3,20
Kolkata,9553,4,4,7,3,16,15,1,19
FC Goa,9553,5,5,2,7,12,15,-3,17
Chennaiyin,9553,6,4,5,5,14,20,-6,17
FC Pune City,9553,7,4,4,6,14,17,-3,16
NorthEast Un,9553,8,4,2,8,9,13,-4,14
Mumbai City,9554,1,7,4,3,17,8,9,25
Kerala Blast,9554,2,6,4,4,14,15,-1,22
NorthEast Un,9554,3,6,2,6,14,13,1,20
FC Goa,9554,4,5,3,6,13,16,-3,18
Delhi Dynamo,9554,5,4,5,5,22,19,3,17
FC Pune City,9554,6,4,5,5,14,16,-2,17
Kolkata,9554,7,3,7,4,17,19,-2,16
Chennaiyin,9554,8,3,6,5,14,19,-5,15
Mumbai City,9555,1,7,4,3,17,8,9,25
Kolkata,9555,2,6,6,2,19,13,6,24
Delhi Dynamo,9555,3,5,5,4,25,19,6,20
Kerala Blast,9555,4,5,4,5,13,17,-4,19
NorthEast Un,9555,5,5,3,6,11,11,0,18
FC Pune City,9555,6,4,4,6,14,19,-5,16
Chennaiyin,9555,7,3,6,5,14,20,-6,15
FC Goa,9555,8,4,2,8,13,19,-6,14
Mumbai City,9556,1,6,5,3,16,8,8,23
Delhi Dynamo,9556,2,5,7,2,23,14,9,22
Kolkata,9556,3,5,6,3,20,14,6,21
Kerala Blast,9556,4,5,4,5,13,19,-6,19
Chennaiyin,9556,5,4,6,4,16,19,-3,18
FC Pune City,9556,6,5,3,6,14,18,-4,18
NorthEast Un,9556,7,4,5,5,11,11,0,17
FC Goa,9556,8,3,2,9,9,19,-10,11
Mumbai City,9557,1,7,4,3,17,8,9,25
Delhi Dynamo,9557,2,6,5,3,27,18,9,23
Kolkata,9557,3,5,7,2,17,14,3,22
Kerala Blast,9557,4,5,4,5,11,15,-4,19
Chennaiyin,9557,5,4,5,5,17,19,-2,17
FC Pune City,9557,6,4,4,6,13,16,-3,16
NorthEast Un,9557,7,4,3,7,12,17,-5,15
FC Goa,9557,8,4,2,8,12,19,-7,14
Mumbai City,9558,1,7,4,3,18,9,9,25
Kolkata,9558,2,6,6,2,20,14,6,24
Delhi Dynamo,9558,3,6,5,3,24,16,8,23
Kerala Blast,9558,4,5,4,5,14,15,-1,19
Chennaiyin,9558,5,3,7,4,14,18,-4,16
FC Pune City,9558,6,4,4,6,13,18,-5,16
NorthEast Un,9558,7,4,3,7,9,14,-5,15
FC Goa,9558,8,3,3,8,9,17,-8,12
Delhi Dynamo,9559,1,6,6,2,29,17,12,24
Mumbai City,9559,2,6,4,4,17,12,5,22
Kolkata,9559,3,4,7,3,22,21,1,19
Kerala Blast,9559,4,5,4,5,11,15,-4,19
FC Pune City,9559,5,4,5,5,16,18,-2,17
Chennaiyin,9559,6,3,7,4,14,18,-4,16
FC Goa,9559,7,4,4,6,15,20,-5,16
NorthEast Un,9559,8,4,3,7,9,12,-3,15
Mumbai City,9560,1,7,4,3,18,9,9,25
Delhi Dynamo,9560,2,4,7,3,24,18,6,19
Kolkata,9560,3,4,7,3,17,15,2,19
FC Pune City,9560,4,5,4,5,15,16,-1,19
FC Goa,9560,5,5,3,6,11,14,-3,18
Kerala Blast,9560,6,5,3,6,13,19,-6,18
Chennaiyin,9560,7,4,5,5,14,19,-5,17
NorthEast Un,9560,8,4,3,7,12,14,-2,15
Mumbai City,9561,1,7,4,3,21,8,13,25
Kolkata,9561,2,5,7,2,18,13,5,22
Kerala Blast,9561,3,6,3,5,14,16,-2,21
Delhi Dynamo,9561,4,5,5,4,24,22,2,20
NorthEast Un,9561,5,5,2,7,12,15,-3,17
FC Goa,9561,6,5,2,7,12,17,-5,17
FC Pune City,9561,7,4,4,6,15,18,-3,16
Chennaiyin,9561,8,3,5,6,14,21,-7,14
Mumbai City,9562,1,7,4,3,18,8,10,25
Kolkata,9562,2,6,6,2,20,13,7,24
NorthEast Un,9562,3,6,3,5,13,10,3,21
Delhi Dynamo,9562,4,5,5,4,22,18,4,20
Kerala Blast,9562,5,4,5,5,10,16,-6,17
FC Pune City,9562,6,4,4,6,13,16,-3,16
Chennaiyin,9562,7,3,5,6,15,21,-6,14
FC Goa,9562,8,4,2,8,11,20,-9,14
Delhi Dynamo,9563,1,7,5,2,29,17,12,26
Mumbai City,9563,2,6,4,4,16,9,7,22
Kolkata,9563,3,3,9,2,16,15,1,18
Kerala Blast,9563,4,4,6,4,14,18,-4,18
FC Pune City,9563,5,4,5,5,16,18,-2,17
Chennaiyin,9563,6,4,5,5,16,20,-4,17
NorthEast Un,9563,7,4,3,7,13,17,-4,15
FC Goa,9563,8,4,3,7,10,16,-6,15
Mumbai City,9564,1,7,4,3,19,9,10,25
Kolkata,9564,2,5,6,3,18,16,2,21
Delhi Dynamo,9564,3,5,5,4,24,19,5,20
Chennaiyin,9564,4,5,5,4,17,18,-1,20
Kerala Blast,9564,5,5,4,5,12,16,-4,19
NorthEast Un,9564,6,5,3,6,13,12,1,18
FC Pune City,9564,7,4,3,7,12,17,-5,15
FC Goa,9564,8,4,2,8,11,19,-8,14
NorthEast Un,9565,1,7,2,5,13,10,3,23
Mumbai City,9565,2,6,4,4,17,11,6,22
Delhi Dynamo,9565,3,5,5,4,26,19,7,20
Kolkata,9565,4,4,8,2,19,17,2,20
FC Goa,9565,5,5,3,6,14,18,-4,18
Kerala Blast,9565,6,5,3,6,12,16,-4,18
FC Pune City,9565,7,4,4,6,14,18,-4,16
Chennaiyin,9565,8,3,5,6,14,20,-6,14
Kolkata,9566,1,6,6,2,17,12,5,24
Mumbai City,9566,2,6,4,4,17,10,7,22
Delhi Dynamo,9566,3,5,6,3,24,18,6,21
NorthEast Un,9566,4,5,3,6,15,14,1,18
Kerala Blast,9566,5,5,3,6,16,18,-2,18
FC Goa,9566,6,5,2,7,12,15,-3,17
Chennaiyin,9566,7,4,5,5,15,20,-5,17
FC Pune City,9566,8,4,3,7,12,21,-9,15
Delhi Dynamo,9567,1,6,6,2,24,15,9,24
Kolkata,9567,2,6,6,2,21,14,7,24
Mumbai City,9567,3,6,4,4,16,9,7,22
FC Pune City,9567,4,5,3,6,13,15,-2,18
Chennaiyin,9567,5,4,6,4,16,19,-3,18
NorthEast Un,9567,6,5,2,7,12,13,-1,17
Kerala Blast,9567,7,4,3,7,10,19,-9,15
FC Goa,9567,8,3,4,7,10,18,-8,13
Mumbai City,9568,1,6,5,3,18,10,8,23
Delhi Dynamo,9568,2,5,7,2,26,16,10,22
Kerala Blast,9568,3,6,4,4,15,14,1,22
FC Pune City,9568,4,5,4,5,16,15,1,19
Chennaiyin,9568,5,4,6,4,20,21,-1,18
Kolkata,9568,6,4,6,4,16,19,-3,18
NorthEast Un,9568,7,4,3,7,10,16,-6,15
FC Goa,9568,8,3,3,8,11,21,-10,12
Mumbai City,9569,1,6,4,4,17,10,7,22
Delhi Dynamo,9569,2,5,6,3,25,18,7,21
Kerala Blast,9569,3,6,3,5,14,17,-3,21
Kolkata,9569,4,4,8,2,19,15,4,20
Chennaiyin,9569,5,4,5,5,15,18,-3,17
NorthEast Un,9569,6,5,2,7,11,14,-3,17
FC Pune City,9569,7,4,4,6,14,18,-4,16
FC Goa,9569,8,4,4,6,10,15,-5,16
Delhi Dynamo,9570,1,6,5,3,26,20,6,23
Mumbai City,9570,2,6,4,4,18,11,7,22
FC Pune City,9570,3,6,3,5,17,16,1,21
Kerala Blast,9570,4,6,3,5,13,16,-3,21
NorthEast Un,9570,5,6,2,6,14,12,2,20
Kolkata,9570,6,4,6,4,18,18,0,18
Chennaiyin,9570,7,3,5,6,14,20,-6,14
FC Goa,9570,8,4,2,8,11,18,-7,14
Mumbai City,9571,1,7,4,3,19,8,11,25
Kolkata,9571,2,5,6,3,20,18,2,21
FC Pune City,9571,3,5,4,5,19,17,2,19
Kerala Blast,9571,4,5,4,5,15,19,-4,19
Delhi Dynamo,9571,5,4,6,4,24,21,3,18
NorthEast Un,9571,6,5,3,6,11,12,-1,18
Chennaiyin,9571,7,3,7,4,15,19,-4,16
FC Goa,9571,8,3,4,7,13,22,-9,13
Mumbai City,9572,1,6,5,3,17,9,8,23
Delhi Dynamo,9572,2,5,6,3,24,18,6,21
NorthEast Un,9572,3,6,2,6,14,11,3,20
FC Pune City,9572,4,5,3,6,15,15,0,18
Kolkata,9572,5,4,6,4,15,17,-2,18
Kerala Blast,9572,6,5,3,6,10,16,-6,18
FC Goa,9572,7,5,2,7,13,16,-3,17
Chennaiyin,9572,8,4,5,5,14,20,-6,17
Mumbai City,9573,1,7,4,3,19,9,10,25
Kerala Blast,9573,2,6,4,4,15,16,-1,22
Delhi Dynamo,9573,3,5,5,4,25,19,6,20
Kolkata,9573,4,4,8,2,18,16,2,20
NorthEast Un,9573,5,5,2,7,12,15,-3,17
FC Goa,9573,6,5,2,7,14,18,-4,17
FC Pune City,9573,7,4,4,6,14,17,-3,16
Chennaiyin,9573,8,3,5,6,14,21,-7,14
Mumbai City,9574,1,7,4,3,17,8,9,25
Kerala Blast,9574,2,5,5,4,13,15,-2,20
Kolkata,9574,3,4,7,3,18,16,2,19
NorthEast Un,9574,4,5,3,6,12,10,2,18
FC Pune City,9574,5,5,3,6,13,16,-3,18
Delhi Dynamo,9574,6,4,5,5,22,21,1,17
Chennaiyin,9574,7,4,5,5,14,18,-4,17
FC Goa,9574,8,5,2,7,13,18,-5,17
Mumbai City,9575,1,7,4,3,17,8,9,25
Kolkata,9575,2,5,6,3,19,15,4,21
Delhi Dynamo,9575,3,4,7,3,21,15,6,19
FC Goa,9575,4,5,3,6,13,15,-2,18
FC Pune City,9575,5,5,3,6,14,17,-3,18
Kerala Blast,9575,6,5,3,6,12,17,-5,18
NorthEast Un,9575,7,4,4,6,10,13,-3,16
Chennaiyin,9575,8,3,6,5,14,20,-6,15
Mumbai City,9576,1,6,5,3,17,9,8,23
Delhi Dynamo,9576,2,5,6,3,29,21,8,21
Kolkata,9576,3,5,6,3,18,16,2,21
FC Pune City,9576,4,5,3,6,14,17,-3,18
Kerala Blast,9576,5,5,3,6,13,18,-5,18
NorthEast Un,9576,6,5,2,7,15,15,0,17
Chennaiyin,9576,7,4,5,5,14,19,-5,17
FC Goa,9576,7,5,2,7,14,19,-5,17
Mumbai City,9577,1,6,5,3,18,10,8,23
Delhi Dynamo,9577,2,5,7,2,25,17,8,22
Kerala Blast,9577,3,5,5,4,16,19,-3,20
Kolkata,9577,4,3,9,2,16,15,1,18
NorthEast Un,9577,5,4,4,6,14,15,-1,16
FC Pune City,9577,6,4,4,6,13,16,-3,16
FC Goa,9577,7,4,4,6,11,15,-4,16
Chennaiyin,9577,8,3,6,5,14,20,-6,15
Mumbai City,9578,1,7,4,3,19,10,9,25
Delhi Dynamo,9578,2,5,6,3,26,19,7,21
FC Pune City,9578,3,6,3,5,15,15,0,21
Kerala Blast,9578,4,5,4,5,12,16,-4,19
Chennaiyin,9578,5,4,6,4,16,18,-2,18
Kolkata,9578,6,3,7,4,14,15,-1,16
NorthEast Un,9578,7,4,3,7,11,13,-2,15
FC Goa,9578,8,4,3,7,12,19,-7,15
Delhi Dynamo,9579,1,6,5,3,28,18,10,23
Mumbai City,9579,2,6,4,4,17,12,5,22
Kolkata,9579,3,5,6,3,16,15,1,21
Kerala Blast,9579,4,5,4,5,15,16,-1,19
FC Goa,9579,5,5,2,7,15,18,-3,17
Chennaiyin,9579,6,4,5,5,15,19,-4,17
NorthEast Un,9579,7,5,2,7,10,15,-5,17
FC Pune City,9579,8,4,4,6,14,17,-3,16
Delhi Dynamo,9580,1,6,6,2,26,16,10,24
Mumbai City,9580,2,6,5,3,17,9,8,23
Kolkata,9580,3,5,7,2,21,15,6,22
Chennaiyin,9580,4,5,5,4,19,18,1,20
Kerala Blast,9580,5,5,4,5,16,19,-3,19
NorthEast Un,9580,6,4,3,7,10,14,-4,15
FC Pune City,9580,7,4,3,7,13,21,-8,15
FC Goa,9580,8,3,3,8,10,20,-10,12
Mumbai City,9581,1,6,5,3,17,9,8,23
NorthEast Un,9581,2,6,3,5,16,13,3,21
Kerala Blast,9581,3,5,5,4,15,17,-2,20
Delhi Dynamo,9581,4,4,6,4,24,20,4,18
Kolkata,9581,5,4,6,4,16,20,-4,18
FC Goa,9581,6,5,2,7,18,20,-2,17
Chennaiyin,9581,7,4,5,5,20,24,-4,17
FC Pune City,9581,8,4,4,6,13,16,-3,16
Mumbai City,9582,1,7,4,3,19,9,10,25
Kolkata,9582,2,5,6,3,20,17,3,21
NorthEast Un,9582,3,6,3,5,13,11,2,21
Delhi Dynamo,9582,4,4,5,5,23,20,3,17
FC Goa,9582,5,5,2,7,14,16,-2,17
Chennaiyin,9582,6,4,5,5,15,19,-4,17
Kerala Blast,9582,7,4,5,5,10,17,-7,17
FC Pune City,9582,8,4,4,6,13,18,-5,16
Mumbai City,9583,1,7,4,3,20,10,10,25
Delhi Dynamo,9583,2,6,5,3,26,19,7,23
Kolkata,9583,3,5,7,2,19,14,5,22
Kerala Blast,9583,4,5,5,4,11,14,-3,20
NorthEast Un,9583,5,5,3,6,11,11,0,18
Chennaiyin,9583,6,3,6,5,14,19,-5,15
FC Pune City,9583,7,4,3,7,14,20,-6,15
FC Goa,9583,8,3,3,8,10,18,-8,12
Mumbai City,9584,1,7,4,3,21,11,10,25
Delhi Dynamo,9584,2,5,6,3,27,20,7,21
Kerala Blast,9584,3,6,3,5,15,18,-3,21
Kolkata,9584,4,4,7,3,17,16,1,19
NorthEast Un,9584,5,5,3,6,12,12,0,18
FC Pune City,9584,6,5,3,6,14,16,-2,18
Chennaiyin,9584,7,4,5,5,15,18,-3,17
FC Goa,9584,8,3,3,8,9,19,-10,12
Mumbai City,9585,1,7,4,3,18,9,9,25
Kolkata,9585,2,6,6,2,17,13,4,24
Kerala Blast,9585,3,6,3,5,14,16,-2,21
Delhi Dynamo,9585,4,4,6,4,23,19,4,18
Chennaiyin,9585,5,4,6,4,15,17,-2,18
NorthEast Un,9585,6,5,2,7,13,15,-2,17
FC Pune City,9585,7,4,3,7,12,16,-4,15
FC Goa,9585,8,3,4,7,8,15,-7,13
Mumbai City,9586,1,7,4,3,17,8,9,25
FC Pune City,9586,2,6,3,5,16,15,1,21
Kolkata,9586,3,4,7,3,16,15,1,19
Delhi Dynamo,9586,4,4,6,4,24,19,5,18
NorthEast Un,9586,5,5,3,6,14,16,-2,18
Chennaiyin,9586,6,4,5,5,16,18,-2,17
FC Goa,9586,7,4,4,6,11,16,-5,16
Kerala Blast,9586,8,4,4,6,11,18,-7,16
Mumbai City,9587,1,6,5,3,17,9,8,23
NorthEast Un,9587,2,6,3,5,16,14,2,21
Delhi Dynamo,9587,3,4,8,2,28,21,7,20
Kolkata,9587,4,4,8,2,16,13,3,20
FC Pune City,9587,5,5,4,5,17,18,-1,19
Kerala Blast,9587,6,4,4,6,13,19,-6,16
Chennaiyin,9587,7,3,6,5,14,19,-5,15
FC Goa,9587,8,3,4,7,11,19,-8,13
Delhi Dynamo,9588,1,6,6,2,27,17,10,24
Mumbai City,9588,2,6,5,3,18,10,8,23
Kerala Blast,9588,3,6,4,4,13,15,-2,22
Kolkata,9588,4,4,7,3,16,15,1,19
NorthEast Un,9588,5,5,2,7,12,13,-1,17
FC Pune City,9588,6,4,3,7,14,18,-4,15
Chennaiyin,9588,7,3,6,5,18,23,-5,15
FC Goa,9588,8,4,3,7,13,20,-7,15
Delhi Dynamo,9589,1,6,5,3,26,18,8,23
NorthEast Un,9589,2,7,2,5,17,11,6,23
Mumbai City,9589,3,6,4,4,16,9,7,22
Kolkata,9589,4,4,8,2,17,13,4,20
FC Pune City,9589,5,4,5,5,13,15,-2,17
Kerala Blast,9589,6,4,5,5,9,15,-6,17
Chennaiyin,9589,7,3,5,6,14,21,-7,14
FC Goa,9589,8,4,2,8,10,20,-10,14
Delhi Dynamo,9590,1,6,6,2,25,15,10,24
Mumbai City,9590,2,6,4,4,16,10,6,22
NorthEast Un,9590,3,5,4,5,13,11,2,19
Kolkata,9590,4,4,7,3,16,15,1,19
FC Pune City,9590,5,5,4,5,15,15,0,19
Chennaiyin,9590,6,4,6,4,18,19,-1,18
Kerala Blast,9590,7,4,3,7,10,20,-10,15
FC Goa,9590,8,4,2,8,12,20,-8,14
Mumbai City,9591,1,7,4,3,20,10,10,25
Kolkata,9591,2,5,6,3,17,15,2,21
Delhi Dynamo,9591,3,5,5,4,25,20,5,20
Chennaiyin,9591,4,4,6,4,17,18,-1,18
FC Pune City,9591,5,5,3,6,14,16,-2,18
NorthEast Un,9591,6,5,3,6,10,12,-2,18
Kerala Blast,9591,7,4,4,6,9,16,-7,16
FC Goa,9591,8,4,3,7,12,17,-5,15
Mumbai City,9592,1,7,4,3,18,8,10,25
Delhi Dynamo,9592,2,5,6,3,25,19,6,21
FC Pune City,9592,3,6,3,5,15,14,1,21
NorthEast Un,9592,4,5,4,5,12,11,1,19
Kerala Blast,9592,5,5,4,5,12,14,-2,19
Kolkata,9592,6,3,7,4,14,18,-4,16
FC Goa,9592,7,4,3,7,12,18,-6,15
Chennaiyin,9592,8,3,5,6,14,20,-6,14
Mumbai City,9593,1,7,4,3,17,8,9,25
Kolkata,9593,2,6,6,2,17,13,4,24
Delhi Dynamo,9593,3,5,6,3,24,17,7,21
Kerala Blast,9593,4,5,4,5,11,15,-4,19
NorthEast Un,9593,5,5,3,6,12,12,0,18
Chennaiyin,9593,6,4,5,5,15,19,-4,17
FC Pune City,9593,7,4,3,7,12,16,-4,15
FC Goa,9593,8,3,3,8,9,17,-8,12
Mumbai City,9594,1,6,5,3,17,9,8,23
Delhi Dynamo,9594,2,5,6,3,26,21,5,21
Kolkata,9594,3,4,8,2,18,16,2,20
NorthEast Un,9594,4,5,3,6,14,14,0,18
FC Goa,9594,5,5,3,6,14,15,-1,18
FC Pune City,9594,6,4,5,5,14,16,-2,17
Kerala Blast,9594,7,4,5,5,10,15,-5,17
Chennaiyin,9594,8,3,5,6,14,21,-7,14
Kolkata,9595,1,6,6,2,22,16,6,24
Mumbai City,9595,2,6,4,4,16,9,7,22
Delhi Dynamo,9595,3,5,6,3,23,18,5,21
Chennaiyin,9595,4,5,5,4,17,17,0,20
NorthEast Un,9595,5,5,3,6,13,12,1,18
Kerala Blast,9595,6,4,5,5,11,17,-6,17
FC Pune City,9595,7,4,4,6,14,17,-3,16
FC Goa,9595,8,3,3,8,10,20,-10,12
Mumbai City,9596,1,7,4,3,17,8,9,25
Delhi Dynamo,9596,2,5,6,3,23,16,7,21
Kolkata,9596,3,5,6,3,18,15,3,21
Kerala Blast,9596,4,6,3,5,16,16,0,21
NorthEast Un,9596,5,4,4,6,12,15,-3,16
Chennaiyin,9596,6,3,7,4,16,20,-4,16
FC Goa,9596,7,4,3,7,12,17,-5,15
FC Pune City,9596,8,4,3,7,12,19,-7,15
Mumbai City,9597,1,7,4,3,20,10,10,25
NorthEast Un,9597,2,6,3,5,15,11,4,21
Delhi Dynamo,9597,3,5,5,4,24,19,5,20
FC Pune City,9597,4,5,4,5,14,15,-1,19
Chennaiyin,9597,5,4,6,4,16,19,-3,18
Kerala Blast,9597,6,4,5,5,11,18,-7,17
Kolkata,9597,7,3,7,4,15,18,-3,16
FC Goa,9597,8,4,2,8,14,19,-5,14
Mumbai City,9598,1,7,4,3,21,9,12,25
Chennaiyin,9598,2,5,5,4,17,18,-1,20
Delhi Dynamo,9598,3,4,6,4,25,23,2,18
NorthEast Un,9598,4,5,3,6,14,15,-1,18
Kolkata,9598,5,3,8,3,16,16,0,17
FC Pune City,9598,6,4,5,5,13,15,-2,17
FC Goa,9598,7,5,2,7,12,17,-5,17
Kerala Blast,9598,8,4,5,5,11,16,-5,17
Kerala Blast,9599,1,7,3,4,17,15,2,24
Mumbai City,9599,2,6,5,3,17,9,8,23
Delhi Dynamo,9599,3,4,8,2,24,17,7,20
Chennaiyin,9599,4,5,5,4,17,18,-1,20
Kolkata,9599,5,3,8,3,17,19,-2,17
FC Pune City,9599,6,4,4,6,14,17,-3,16
NorthEast Un,9599,7,4,3,7,10,14,-4,15
FC Goa,9599,8,3,4,7,12,19,-7,13
Mumbai City,9600,1,7,4,3,19,9,10,25
Kolkata,9600,2,6,6,2,22,15,7,24
Delhi Dynamo,9600,3,6,5,3,25,17,8,23
FC Pune City,9600,4,5,3,6,14,16,-2,18
Kerala Blast,9600,5,5,3,6,12,19,-7,18
Chennaiyin,9600,6,4,5,5,15,19,-4,17
NorthEast Un,9600,7,4,2,8,9,12,-3,14
FC Goa,9600,8,4,2,8,10,19,-9,14
Mumbai City,9601,1,7,4,3,18,9,9,25
Kolkata,9601,2,6,6,2,19,12,7,24
Kerala Blast,9601,3,6,3,5,13,15,-2,21
Delhi Dynamo,9601,4,5,5,4,26,19,7,20
Chennaiyin,9601,5,4,5,5,17,19,-2,17
NorthEast Un,9601,6,5,2,7,11,14,-3,17
FC Pune City,9601,7,4,3,7,12,19,-7,15
FC Goa,9601,8,4,2,8,12,21,-9,14
Delhi Dynamo,9602,1,6,6,2,28,17,11,24
Mumbai City,9602,2,6,4,4,16,11,5,22
NorthEast Un,9602,3,5,4,5,14,12,2,19
FC Pune City,9602,4,5,4,5,14,14,0,19
Kolkata,9602,5,4,6,4,14,15,-1,18
Chennaiyin,9602,6,4,5,5,16,21,-5,17
Kerala Blast,9602,7,4,5,5,9,14,-5,17
FC Goa,9602,8,4,2,8,11,18,-7,14
Delhi Dynamo,9603,1,6,5,3,29,17,12,23
Mumbai City,9603,2,6,4,4,18,12,6,22
Kerala Blast,9603,3,6,4,4,12,14,-2,22
NorthEast Un,9603,4,6,2,6,12,10,2,20
FC Pune City,9603,5,5,3,6,14,16,-2,18
Kolkata,9603,6,3,7,4,15,16,-1,16
Chennaiyin,9603,7,3,6,5,17,23,-6,15
FC Goa,9603,8,4,3,7,15,24,-9,15
Mumbai City,9604,1,7,4,3,18,9,9,25
Kolkata,9604,2,5,6,3,18,16,2,21
Delhi Dynamo,9604,3,5,5,4,24,18,6,20
FC Goa,9604,4,6,2,6,13,14,-1,20
Kerala Blast,9604,5,5,4,5,12,16,-4,19
Chennaiyin,9604,6,4,5,5,15,20,-5,17
NorthEast Un,9604,7,4,3,7,11,13,-2,15
FC Pune City,9604,8,4,3,7,13,18,-5,15
Mumbai City,9605,1,7,4,3,18,9,9,25
Kerala Blast,9605,2,7,3,4,14,15,-1,24
Delhi Dynamo,9605,3,6,5,3,30,18,12,23
Kolkata,9605,4,4,7,3,17,16,1,19
NorthEast Un,9605,5,5,2,7,14,14,0,17
FC Pune City,9605,6,4,3,7,14,18,-4,15
FC Goa,9605,7,4,3,7,10,19,-9,15
Chennaiyin,9605,8,3,5,6,13,21,-8,14
Mumbai City,9606,1,7,4,3,18,8,10,25
Kolkata,9606,2,5,6,3,18,16,2,21
NorthEast Un,9606,3,5,4,5,12,9,3,19
Delhi Dynamo,9606,4,4,6,4,22,18,4,18
FC Pune City,9606,5,5,3,6,14,16,-2,18
Kerala Blast,9606,6,5,3,6,12,19,-7,18
FC Goa,9606,7,5,2,7,12,17,-5,17
Chennaiyin,9606,8,3,6,5,13,18,-5,15
Delhi Dynamo,9607,1,7,5,2,28,15,13,26
Mumbai City,9607,2,6,4,4,16,10,6,22
Kolkata,9607,3,5,6,3,18,16,2,21
Kerala Blast,9607,4,6,3,5,14,17,-3,21
Chennaiyin,9607,5,4,6,4,19,19,0,18
FC Pune City,9607,6,5,3,6,16,18,-2,18
NorthEast Un,9607,7,4,2,8,13,20,-7,14
FC Goa,9607,8,3,3,8,10,19,-9,12
Mumbai City,9608,1,7,4,3,19,9,10,25
Delhi Dynamo,9608,2,6,5,3,28,18,10,23
Kerala Blast,9608,3,5,5,4,12,15,-3,20
FC Pune City,9608,4,5,4,5,14,15,-1,19
NorthEast Un,9608,5,5,3,6,13,12,1,18
Kolkata,9608,6,4,6,4,15,15,0,18
Chennaiyin,9608,7,3,6,5,17,23,-6,15
FC Goa,9608,8,3,3,8,11,22,-11,12
Delhi Dynamo,9609,1,6,6,2,25,16,9,24
Mumbai City,9609,2,6,4,4,17,10,7,22
Kolkata,9609,3,4,7,3,16,15,1,19
Kerala Blast,9609,4,5,4,5,13,16,-3,19
NorthEast Un,9609,5,5,3,6,12,12,0,18
FC Pune City,9609,6,5,3,6,15,18,-3,18
FC Goa,9609,7,4,3,7,12,16,-4,15
Chennaiyin,9609,8,3,6,5,15,22,-7,15
Mumbai City,9610,1,6,5,3,17,9,8,23
Delhi Dynamo,9610,2,5,7,2,26,18,8,22
Kerala Blast,9610,3,6,4,4,14,16,-2,22
Kolkata,9610,4,4,7,3,17,14,3,19
Chennaiyin,9610,5,4,6,4,17,18,-1,18
FC Pune City,9610,6,4,4,6,14,19,-5,16
NorthEast Un,9610,7,4,3,7,11,15,-4,15
FC Goa,9610,8,3,4,7,10,17,-7,13
Mumbai City,9611,1,6,4,4,17,11,6,22
NorthEast Un,9611,2,6,3,5,16,12,4,21
Delhi Dynamo,9611,3,5,5,4,26,21,5,20
FC Pune City,9611,4,5,4,5,14,15,-1,19
Kerala Blast,9611,5,5,4,5,12,14,-2,19
Chennaiyin,9611,6,4,6,4,17,19,-2,18
Kolkata,9611,7,4,6,4,15,17,-2,18
FC Goa,9611,8,4,2,8,10,18,-8,14
Mumbai City,9612,1,7,4,3,17,8,9,25
Kerala Blast,9612,2,7,3,4,17,14,3,24
Delhi Dynamo,9612,3,5,6,3,27,17,10,21
Kolkata,9612,4,4,7,3,18,16,2,19
Chennaiyin,9612,5,4,5,5,16,21,-5,17
NorthEast Un,9612,6,4,3,7,9,13,-4,15
FC Pune City,9612,7,4,3,7,12,19,-7,15
FC Goa,9612,8,4,3,7,16,24,-8,15
Delhi Dynamo,9613,1,7,5,2,27,16,11,26
Kerala Blast,9613,2,7,3,4,12,13,-1,24
Mumbai City,9613,3,6,4,4,16,10,6,22
Chennaiyin,9613,4,5,5,4,18,19,-1,20
Kolkata,9613,5,3,8,3,17,17,0,17
FC Pune City,9613,6,4,4,6,14,17,-3,16
NorthEast Un,9613,7,4,2,8,12,16,-4,14
FC Goa,9613,8,3,3,8,11,19,-8,12
Mumbai City,9614,1,6,5,3,16,8,8,23
NorthEast Un,9614,2,6,3,5,13,11,2,21
Kerala Blast,9614,3,6,3,5,13,15,-2,21
Delhi Dynamo,9614,4,4,8,2,23,16,7,20
Kolkata,9614,5,4,6,4,17,18,-1,18
FC Pune City,9614,6,5,3,6,14,15,-1,18
FC Goa,9614,7,4,3,7,13,20,-7,15
Chennaiyin,9614,8,3,5,6,16,22,-6,14
Delhi Dynamo,9615,1,7,5,2,27,15,12,26
Mumbai City,9615,2,6,4,4,16,9,7,22
NorthEast Un,9615,3,6,2,6,12,13,-1,20
Kolkata,9615,4,4,7,3,17,15,2,19
FC Pune City,9615,5,5,4,5,14,15,-1,19
Kerala Blast,9615,6,4,5,5,10,15,-5,17
FC Goa,9615,7,4,2,8,13,18,-5,14
Chennaiyin,9615,8,3,5,6,14,23,-9,14
Mumbai City,9616,1,7,4,3,18,9,9,25
Delhi Dynamo,9616,2,5,5,4,24,18,6,20
NorthEast Un,9616,3,6,2,6,13,11,2,20
Kolkata,9616,4,4,7,3,17,16,1,19
FC Pune City,9616,5,5,4,5,18,18,0,19
Chennaiyin,9616,6,4,5,5,15,19,-4,17
FC Goa,9616,7,5,2,7,11,17,-6,17
Kerala Blast,9616,8,4,3,7,13,21,-8,15
Delhi Dynamo,9617,1,6,6,2,30,18,12,24
Mumbai City,9617,2,6,4,4,17,10,7,22
Kerala Blast,9617,3,6,4,4,13,14,-1,22
Kolkata,9617,4,4,8,2,15,13,2,20
NorthEast Un,9617,5,5,3,6,15,14,1,18
FC Pune City,9617,6,4,4,6,14,18,-4,16
Chennaiyin,9617,7,3,5,6,15,23,-8,14
FC Goa,9617,8,4,2,8,11,20,-9,14
Mumbai City,9618,1,6,5,3,16,8,8,23
Delhi Dynamo,9618,2,5,6,3,24,15,9,21
NorthEast Un,9618,3,6,2,6,11,10,1,20
Kolkata,9618,4,4,7,3,16,15,1,19
Kerala Blast,9618,5,5,4,5,11,15,-4,19
Chennaiyin,9618,6,4,6,4,14,17,-3,18
FC Pune City,9618,7,4,3,7,13,17,-4,15
FC Goa,9618,8,4,3,7,9,17,-8,15
Mumbai City,9619,1,7,4,3,18,9,9,25
Kerala Blast,9619,2,6,4,4,12,13,-1,22
Delhi Dynamo,9619,3,5,5,4,24,19,5,20
Kolkata,9619,4,4,8,2,15,12,3,20
NorthEast Un,9619,5,5,3,6,12,11,1,18
Chennaiyin,9619,6,3,7,4,13,17,-4,16
FC Pune City,9619,7,4,4,6,12,16,-4,16
FC Goa,9619,8,3,3,8,8,17,-9,12
Mumbai City,9620,1,6,4,4,17,10,7,22
Delhi Dynamo,9620,2,5,5,4,24,19,5,20
NorthEast Un,9620,3,6,2,6,15,13,2,20
Chennaiyin,9620,4,5,5,4,20,19,1,20
Kolkata,9620,5,4,7,3,20,18,2,19
Kerala Blast,9620,6,5,4,5,12,18,-6,19
FC Pune City,9620,7,4,5,5,14,16,-2,17
FC Goa,9620,8,4,2,8,13,22,-9,14
Mumbai City,9621,1,7,4,3,17,8,9,25
Kerala Blast,9621,2,6,4,4,12,14,-2,22
Delhi Dynamo,9621,3,5,5,4,24,19,5,20
NorthEast Un,9621,4,5,4,5,12,10,2,19
FC Pune City,9621,5,5,3,6,15,16,-1,18
Kolkata,9621,6,3,7,4,14,16,-2,16
Chennaiyin,9621,7,3,6,5,16,21,-5,15
FC Goa,9621,8,4,3,7,14,20,-6,15
Mumbai City,9622,1,6,5,3,17,9,8,23
Kerala Blast,9622,2,6,3,5,12,15,-3,21
Delhi Dynamo,9622,3,4,7,3,22,16,6,19
FC Pune City,9622,4,5,4,5,14,15,-1,19
NorthEast Un,9622,5,5,3,6,12,12,0,18
Chennaiyin,9622,6,4,6,4,16,19,-3,18
Kolkata,9622,7,3,8,3,15,15,0,17
FC Goa,9622,8,3,4,7,10,17,-7,13
Mumbai City,9623,1,7,4,3,18,8,10,25
Delhi Dynamo,9623,2,5,6,3,24,17,7,21
Kolkata,9623,3,5,6,3,17,15,2,21
FC Goa,9623,4,5,3,6,14,16,-2,18
FC Pune City,9623,5,5,3,6,13,16,-3,18
NorthEast Un,9623,6,5,2,7,11,13,-2,17
Chennaiyin,9623,7,4,5,5,15,19,-4,17
Kerala Blast,9623,8,4,3,7,9,17,-8,15
Delhi Dynamo,9624,1,6,5,3,24,16,8,23
Mumbai City,9624,2,6,4,4,16,9,7,22
Kerala Blast,9624,3,6,4,4,12,14,-2,22
Kolkata,9624,4,4,8,2,17,14,3,20
NorthEast Un,9624,5,5,2,7,13,14,-1,17
Chennaiyin,9624,6,4,5,5,15,20,-5,17
FC Goa,9624,7,4,3,7,12,17,-5,15
FC Pune City,9624,7,4,3,7,12,17,-5,15
Mumbai City,9625,1,6,5,3,16,8,8,23
Delhi Dynamo,9625,2,5,6,3,22,18,4,21
Kerala Blast,9625,3,5,5,4,12,15,-3,20
NorthEast Un,9625,4,5,4,5,14,10,4,19
Chennaiyin,9625,5,4,6,4,17,19,-2,18
FC Pune City,9625,6,5,3,6,15,17,-2,18
Kolkata,9625,7,3,7,4,16,17,-1,16
FC Goa,9625,8,4,2,8,11,19,-8,14
Mumbai City,9626,1,6,5,3,17,9,8,23
Delhi Dynamo,9626,2,5,6,3,26,17,9,21
Kolkata,9626,3,5,6,3,19,13,6,21
Kerala Blast,9626,4,6,3,5,11,14,-3,21
NorthEast Un,9626,5,5,3,6,12,12,0,18
Chennaiyin,9626,6,4,6,4,16,19,-3,18
FC Pune City,9626,7,5,3,6,13,16,-3,18
FC Goa,9626,8,3,2,9,9,23,-14,11
Mumbai City,9627,1,7,4,3,18,8,10,25
Delhi Dynamo,9627,2,6,5,3,24,17,7,23
FC Pune City,9627,3,6,3,5,14,14,0,21
Kolkata,9627,4,4,7,3,15,14,1,19
Kerala Blast,9627,5,5,3,6,11,16,-5,18
NorthEast Un,9627,6,5,2,7,13,14,-1,17
FC Goa,9627,7,4,3,7,10,16,-6,15
Chennaiyin,9627,8,3,5,6,14,20,-6,14
Mumbai City,9628,1,6,5,3,17,9,8,23
Delhi Dynamo,9628,2,5,7,2,27,18,9,22
FC Pune City,9628,3,6,3,5,15,15,0,21
NorthEast Un,9628,4,5,3,6,11,10,1,18
Kolkata,9628,5,4,6,4,15,17,-2,18
FC Goa,9628,6,5,2,7,16,19,-3,17
Chennaiyin,9628,7,4,5,5,14,19,-5,17
Kerala Blast,9628,8,4,3,7,9,17,-8,15
Mumbai City,9629,1,7,4,3,17,8,9,25
Kerala Blast,9629,2,6,3,5,14,17,-3,21
Chennaiyin,9629,3,5,5,4,19,20,-1,20
FC Pune City,9629,4,5,4,5,17,17,0,19
Delhi Dynamo,9629,5,4,5,5,21,18,3,17
NorthEast Un,9629,6,5,2,7,12,12,0,17
FC Goa,9629,7,5,2,7,14,19,-5,17
Kolkata,9629,8,3,7,4,15,18,-3,16
Mumbai City,9630,1,7,4,3,19,8,11,25
FC Goa,9630,2,6,2,6,16,15,1,20
FC Pune City,9630,3,5,4,5,16,16,0,19
NorthEast Un,9630,4,5,3,6,12,12,0,18
Kolkata,9630,5,4,6,4,15,16,-1,18
Delhi Dynamo,9630,6,4,5,5,22,23,-1,17
Chennaiyin,9630,7,4,5,5,14,19,-5,17
Kerala Blast,9630,8,4,5,5,12,17,-5,17
Delhi Dynamo,9631,1,6,6,2,25,15,10,24
Mumbai City,9631,2,6,4,4,16,10,6,22
Kolkata,9631,3,4,8,2,16,14,2,20
Chennaiyin,9631,4,5,5,4,16,18,-2,20
FC Pune City,9631,5,5,3,6,15,17,-2,18
NorthEast Un,9631,6,5,2,7,11,12,-1,17
Kerala Blast,9631,7,4,4,6,12,18,-6,16
FC Goa,9631,8,3,4,7,10,17,-7,13
Mumbai City,9632,1,6,5,3,17,9,8,23
Delhi Dynamo,9632,2,5,7,2,30,17,13,22
FC Pune City,9632,3,6,3,5,17,15,2,21
Kolkata,9632,4,4,7,3,15,15,0,19
Kerala Blast,9632,5,5,4,5,11,16,-5,19
NorthEast Un,9632,6,5,3,6,12,12,0,18
Chennaiyin,9632,7,4,5,5,17,19,-2,17
FC Goa,9632,8,3,2,9,10,26,-16,11
Mumbai City,9633,1,7,4,3,18,8,10,25
Kerala Blast,9633,2,6,4,4,13,13,0,22
Delhi Dynamo,9633,3,5,5,4,24,19,5,20
Kolkata,9633,4,4,8,2,15,13,2,20
NorthEast Un,9633,5,6,2,6,13,13,0,20
Chennaiyin,9633,6,4,5,5,15,18,-3,17
FC Pune City,9633,7,4,3,7,12,16,-4,15
FC Goa,9633,8,3,3,8,9,19,-10,12
Mumbai City,9634,1,6,5,3,17,9,8,23
Delhi Dynamo,9634,2,5,7,2,25,17,8,22
Kolkata,9634,3,5,7,2,19,15,4,22
NorthEast Un,9634,4,5,4,5,12,10,2,19
Chennaiyin,9634,5,4,6,4,15,18,-3,18
Kerala Blast,9634,6,5,3,6,12,17,-5,18
FC Pune City,9634,7,4,3,7,12,18,-6,15
FC Goa,9634,8,3,3,8,12,20,-8,12
Mumbai City,9635,1,6,5,3,18,10,8,23
Delhi Dynamo,9635,2,5,7,2,28,17,11,22
Kolkata,9635,3,4,8,2,15,13,2,20
Chennaiyin,9635,4,4,6,4,17,18,-1,18
Kerala Blast,9635,5,4,6,4,10,14,-4,18
NorthEast Un,9635,6,4,5,5,12,12,0,17
FC Pune City,9635,7,4,5,5,13,15,-2,17
FC Goa,9635,8,3,2,9,8,22,-14,11
Mumbai City,9636,1,7,4,3,17,8,9,25
Delhi Dynamo,9636,2,5,5,4,25,19,6,20
Kolkata,9636,3,4,7,3,17,15,2,19
Kerala Blast,9636,4,5,4,5,14,16,-2,19
FC Pune City,9636,5,5,3,6,14,17,-3,18
NorthEast Un,9636,6,5,2,7,15,16,-1,17
Chennaiyin,9636,7,4,5,5,17,21,-4,17
FC Goa,9636,8,5,2,7,12,19,-7,17
Mumbai City,9637,1,6,5,3,17,9,8,23
Delhi Dynamo,9637,2,5,6,3,23,17,6,21
Chennaiyin,9637,3,5,5,4,18,17,1,20
Kerala Blast,9637,4,5,5,4,12,15,-3,20
Kolkata,9637,5,4,7,3,17,17,0,19
NorthEast Un,9637,6,5,2,7,11,13,-2,17
FC Pune City,9637,7,4,4,6,13,16,-3,16
FC Goa,9637,8,4,2,8,10,17,-7,14
Mumbai City,9638,1,7,4,3,18,9,9,25
Delhi Dynamo,9638,2,5,5,4,26,19,7,20
Kerala Blast,9638,3,5,5,4,14,15,-1,20
Kolkata,9638,4,3,9,2,17,16,1,18
FC Goa,9638,5,5,3,6,12,16,-4,18
NorthEast Un,9638,6,4,4,6,14,16,-2,16
FC Pune City,9638,7,4,4,6,13,18,-5,16
Chennaiyin,9638,8,3,6,5,15,20,-5,15
Mumbai City,9639,1,7,4,3,19,9,10,25
Delhi Dynamo,9639,2,6,5,3,27,19,8,23
Kerala Blast,9639,3,6,4,4,12,13,-1,22
Kolkata,9639,4,4,6,4,16,16,0,18
Chennaiyin,9639,5,4,5,5,17,20,-3,17
FC Goa,9639,6,5,2,7,14,20,-6,17
NorthEast Un,9639,7,4,3,7,10,13,-3,15
FC Pune City,9639,8,4,3,7,12,17,-5,15
Mumbai City,9640,1,7,4,3,19,8,11,25
Kerala Blast,9640,2,7,3,4,15,15,0,24
Delhi Dynamo,9640,3,6,5,3,25,18,7,23
Kolkata,9640,4,5,6,3,17,16,1,21
Chennaiyin,9640,5,5,5,4,18,20,-2,20
FC Pune City,9640,6,4,3,7,13,17,-4,15
NorthEast Un,9640,7,4,2,8,12,15,-3,14
FC Goa,9640,8,3,2,9,10,20,-10,11
Mumbai City,9641,1,7,4,3,21,8,13,25
Delhi Dynamo,9641,2,6,5,3,25,20,5,23
Kolkata,9641,3,5,6,3,15,15,0,21
FC Pune City,9641,4,5,3,6,14,16,-2,18
Kerala Blast,9641,5,5,3,6,13,17,-4,18
Chennaiyin,9641,6,4,5,5,17,19,-2,17
FC Goa,9641,7,5,2,7,14,17,-3,17
NorthEast Un,9641,8,4,2,8,10,17,-7,14
Mumbai City,9642,1,7,4,3,19,9,10,25
Kolkata,9642,2,5,7,2,20,15,5,22
Delhi Dynamo,9642,3,5,6,3,24,18,6,21
NorthEast Un,9642,4,5,3,6,14,14,0,18
FC Pune City,9642,5,4,4,6,14,17,-3,16
Chennaiyin,9642,6,3,7,4,16,20,-4,16
Kerala Blast,9642,7,4,4,6,10,18,-8,16
FC Goa,9642,8,3,5,6,10,16,-6,14
Mumbai City,9643,1,7,4,3,18,9,9,25
Kolkata,9643,2,5,6,3,19,16,3,21
Delhi Dynamo,9643,3,5,5,4,26,18,8,20
NorthEast Un,9643,4,6,2,6,13,12,1,20
FC Pune City,9643,5,5,3,6,16,18,-2,18
Chennaiyin,9643,6,4,6,4,16,19,-3,18
Kerala Blast,9643,7,5,3,6,13,18,-5,18
FC Goa,9643,8,3,3,8,10,21,-11,12
Mumbai City,9644,1,6,5,3,16,8,8,23
Delhi Dynamo,9644,2,5,6,3,24,16,8,21
FC Pune City,9644,3,6,3,5,16,15,1,21
Kolkata,9644,4,5,6,3,15,14,1,21
NorthEast Un,9644,5,6,2,6,12,13,-1,20
Chennaiyin,9644,6,4,5,5,16,19,-3,17
Kerala Blast,9644,7,4,3,7,11,18,-7,15
FC Goa,9644,8,4,2,8,11,18,-7,14
NorthEast Un,9645,1,7,2,5,16,10,6,23
Mumbai City,9645,2,6,4,4,17,10,7,22
Delhi Dynamo,9645,3,5,6,3,26,21,5,21
Kolkata,9645,4,5,6,3,17,15,2,21
Chennaiyin,9645,5,4,5,5,16,20,-4,17
FC Pune City,9645,6,4,4,6,12,15,-3,16
Kerala Blast,9645,7,4,4,6,10,16,-6,16
FC Goa,9645,8,4,3,7,13,20,-7,15
Mumbai City,9646,1,7,4,3,17,8,9,25
Kolkata,9646,2,6,6,2,19,13,6,24
Delhi Dynamo,9646,3,5,6,3,24,17,7,21
Kerala Blast,9646,4,5,4,5,15,18,-3,19
Chennaiyin,9646,5,4,6,4,17,19,-2,18
FC Pune City,9646,6,4,4,6,14,17,-3,16
NorthEast Un,9646,7,4,2,8,10,16,-6,14
FC Goa,9646,8,3,4,7,11,19,-8,13
Mumbai City,9647,1,6,4,4,17,10,7,22
Kerala Blast,9647,2,6,4,4,14,15,-1,22
Delhi Dynamo,9647,3,5,5,4,25,19,6,20
Kolkata,9647,4,4,7,3,15,14,1,19
NorthEast Un,9647,5,5,4,5,12,11,1,19
Chennaiyin,9647,6,3,7,4,15,19,-4,16
FC Goa,9647,7,4,4,6,12,17,-5,16
FC Pune City,9647,8,4,3,7,14,19,-5,15
Mumbai City,9648,1,7,4,3,18,8,10,25
Kolkata,9648,2,5,6,3,18,16,2,21
FC Pune City,9648,3,6,3,5,16,16,0,21
NorthEast Un,9648,4,5,4,5,13,11,2,19
Delhi Dynamo,9648,5,4,6,4,22,18,4,18
Chennaiyin,9648,6,4,5,5,14,19,-5,17
Kerala Blast,9648,7,4,4,6,12,18,-6,16
FC Goa,9648,8,4,2,8,10,17,-7,14
Delhi Dynamo,9649,1,6,5,3,27,18,9,23
Mumbai City,9649,2,6,4,4,16,9,7,22
Kolkata,9649,3,5,7,2,17,13,4,22
Kerala Blast,9649,4,6,4,4,15,15,0,22
Chennaiyin,9649,5,4,6,4,15,18,-3,18
NorthEast Un,9649,6,5,2,7,14,15,-1,17
FC Pune City,9649,7,4,3,7,12,18,-6,15
FC Goa,9649,8,3,3,8,9,19,-10,12
Kerala Blast,9650,1,7,3,4,13,14,-1,24
Delhi Dynamo,9650,2,6,5,3,25,18,7,23
Mumbai City,9650,3,6,4,4,16,9,7,22
Kolkata,9650,4,5,6,3,18,15,3,21
NorthEast Un,9650,5,5,3,6,12,11,1,18
Chennaiyin,9650,6,4,6,4,15,18,-3,18
FC Pune City,9650,7,4,3,7,13,17,-4,15
FC Goa,9650,8,3,2,9,10,20,-10,11
Delhi Dynamo,9651,1,6,6,2,25,14,11,24
Mumbai City,9651,2,6,4,4,16,11,5,22
Kolkata,9651,3,4,7,3,18,16,2,19
NorthEast Un,9651,4,5,4,5,10,9,1,19
FC Pune City,9651,5,5,4,5,15,15,0,19
Chennaiyin,9651,6,4,6,4,16,18,-2,18
Kerala Blast,9651,7,4,3,7,10,20,-10,15
FC Goa,9651,8,4,2,8,11,18,-7,14
Delhi Dynamo,9652,1,6,6,2,29,18,11,24
Mumbai City,9652,2,6,4,4,17,10,7,22
Kolkata,9652,3,5,6,3,18,14,4,21
FC Pune City,9652,4,6,3,5,16,15,1,21
NorthEast Un,9652,5,5,3,6,13,13,0,18
Kerala Blast,9652,6,5,3,6,10,16,-6,18
Chennaiyin,9652,7,3,6,5,14,19,-5,15
FC Goa,9652,8,3,3,8,9,21,-12,12
Mumbai City,9653,1,7,4,3,19,8,11,25
Kolkata,9653,2,6,6,2,19,15,4,24
NorthEast Un,9653,3,7,2,5,16,10,6,23
Delhi Dynamo,9653,4,4,5,5,22,24,-2,17
FC Pune City,9653,5,4,4,6,16,19,-3,16
Kerala Blast,9653,6,4,4,6,13,19,-6,16
FC Goa,9653,7,4,3,7,13,17,-4,15
Chennaiyin,9653,8,3,6,5,14,20,-6,15
Mumbai City,9654,1,7,4,3,19,8,11,25
Kolkata,9654,2,5,7,2,17,13,4,22
FC Pune City,9654,3,5,4,5,13,14,-1,19
NorthEast Un,9654,4,5,3,6,13,12,1,18
Kerala Blast,9654,5,5,3,6,11,17,-6,18
Delhi Dynamo,9654,6,4,5,5,21,20,1,17
Chennaiyin,9654,7,3,7,4,15,19,-4,16
FC Goa,9654,8,4,3,7,11,17,-6,15
Delhi Dynamo,9655,1,6,6,2,28,15,13,24
Mumbai City,9655,2,6,5,3,17,9,8,23
Kolkata,9655,3,5,6,3,16,13,3,21
Kerala Blast,9655,4,5,4,5,14,16,-2,19
Chennaiyin,9655,5,4,6,4,15,18,-3,18
NorthEast Un,9655,6,4,4,6,11,14,-3,16
FC Pune City,9655,7,4,3,7,13,20,-7,15
FC Goa,9655,8,4,2,8,9,18,-9,14
Mumbai City,9656,1,7,4,3,17,8,9,25
NorthEast Un,9656,2,6,3,5,12,10,2,21
Kolkata,9656,3,4,7,3,15,13,2,19
Delhi Dynamo,9656,4,4,6,4,23,18,5,18
Kerala Blast,9656,5,4,6,4,10,14,-4,18
Chennaiyin,9656,6,4,5,5,16,20,-4,17
FC Pune City,9656,7,4,4,6,12,16,-4,16
FC Goa,9656,8,4,3,7,13,19,-6,15
Delhi Dynamo,9657,1,7,5,2,30,18,12,26
Mumbai City,9657,2,6,4,4,18,11,7,22
Kerala Blast,9657,3,6,4,4,15,16,-1,22
Chennaiyin,9657,4,5,5,4,18,20,-2,20
Kolkata,9657,5,4,7,3,17,15,2,19
FC Pune City,9657,6,5,3,6,13,16,-3,18
NorthEast Un,9657,7,4,2,8,13,16,-3,14
FC Goa,9657,8,3,2,9,10,22,-12,11
Mumbai City,9658,1,6,5,3,17,9,8,23
Kerala Blast,9658,2,6,4,4,14,14,0,22
Delhi Dynamo,9658,3,5,6,3,23,18,5,21
FC Goa,9658,4,6,2,6,16,15,1,20
NorthEast Un,9658,5,5,3,6,10,10,0,18
Kolkata,9658,6,3,7,4,14,16,-2,16
FC Pune City,9658,7,4,4,6,14,18,-4,16
Chennaiyin,9658,8,3,5,6,14,22,-8,14
Delhi Dynamo,9659,1,6,5,3,25,18,7,23
Mumbai City,9659,2,6,4,4,17,10,7,22
Kolkata,9659,3,4,8,2,15,13,2,20
Kerala Blast,9659,4,5,4,5,13,16,-3,19
NorthEast Un,9659,5,5,3,6,11,11,0,18
FC Goa,9659,6,5,3,6,13,15,-2,18
FC Pune City,9659,7,4,3,7,13,18,-5,15
Chennaiyin,9659,8,3,6,5,14,20,-6,15
Mumbai City,9660,1,6,5,3,16,8,8,23
Delhi Dynamo,9660,2,4,7,3,24,19,5,19
Kolkata,9660,3,4,7,3,17,15,2,19
FC Pune City,9660,4,5,4,5,15,16,-1,19
NorthEast Un,9660,5,5,3,6,12,11,1,18
FC Goa,9660,6,5,3,6,15,17,-2,18
Chennaiyin,9660,7,4,5,5,14,20,-6,17
Kerala Blast,9660,8,4,4,6,10,17,-7,16
Mumbai City,9661,1,6,5,3,16,8,8,23
Delhi Dynamo,9661,2,5,7,2,27,16,11,22
FC Pune City,9661,3,6,3,5,14,14,0,21
Kerala Blast,9661,4,5,4,5,13,15,-2,19
Chennaiyin,9661,5,4,5,5,16,20,-4,17
FC Goa,9661,6,5,2,7,14,22,-8,17
Kolkata,9661,7,3,7,4,16,17,-1,16
NorthEast Un,9661,8,4,3,7,11,15,-4,15
Mumbai City,9662,1,7,4,3,18,8,10,25
Kerala Blast,9662,2,6,4,4,14,15,-1,22
Delhi Dynamo,9662,3,5,5,4,24,19,5,20
NorthEast Un,9662,4,6,2,6,13,12,1,20
Kolkata,9662,5,4,6,4,16,16,0,18
FC Goa,9662,6,5,2,7,16,18,-2,17
FC Pune City,9662,7,4,4,6,15,18,-3,16
Chennaiyin,9662,8,3,5,6,14,24,-10,14
Mumbai City,9663,1,7,4,3,19,8,11,25
Delhi Dynamo,9663,2,5,6,3,25,20,5,21
Kolkata,9663,3,4,7,3,17,16,1,19
FC Pune City,9663,4,5,4,5,15,16,-1,19
NorthEast Un,9663,5,5,2,7,13,14,-1,17
Chennaiyin,9663,6,4,5,5,16,20,-4,17
FC Goa,9663,7,4,4,6,12,17,-5,16
Kerala Blast,9663,8,4,4,6,11,17,-6,16
Delhi Dynamo,9664,1,6,6,2,28,18,10,24
Mumbai City,9664,2,6,5,3,17,9,8,23
Kerala Blast,9664,3,6,4,4,14,15,-1,22
Kolkata,9664,4,4,7,3,15,14,1,19
NorthEast Un,9664,5,5,2,7,12,13,-1,17
FC Pune City,9664,6,4,5,5,14,16,-2,17
Chennaiyin,9664,7,3,5,6,14,20,-6,14
FC Goa,9664,8,4,2,8,11,20,-9,14
Delhi Dynamo,9665,1,7,5,2,27,16,11,26
Mumbai City,9665,2,6,4,4,16,10,6,22
Kerala Blast,9665,3,5,4,5,12,15,-3,19
Kolkata,9665,4,4,6,4,17,19,-2,18
FC Pune City,9665,5,5,3,6,15,17,-2,18
NorthEast Un,9665,6,4,4,6,14,15,-1,16
Chennaiyin,9665,7,3,7,4,17,21,-4,16
FC Goa,9665,8,4,3,7,13,18,-5,15
Mumbai City,9666,1,7,4,3,19,8,11,25
Kolkata,9666,2,5,6,3,20,14,6,21
NorthEast Un,9666,3,5,4,5,13,10,3,19
Kerala Blast,9666,4,5,4,5,12,18,-6,19
Delhi Dynamo,9666,5,4,6,4,21,20,1,18
FC Pune City,9666,6,5,3,6,13,15,-2,18
Chennaiyin,9666,7,3,6,5,13,18,-5,15
FC Goa,9666,8,4,3,7,9,17,-8,15
Mumbai City,9667,1,6,5,3,16,8,8,23
Delhi Dynamo,9667,2,4,8,2,22,15,7,20
Kerala Blast,9667,3,5,4,5,13,16,-3,19
FC Pune City,9667,4,5,3,6,14,16,-2,18
Kolkata,9667,4,4,6,4,14,16,-2,18
FC Goa,9667,6,5,3,6,12,15,-3,18
NorthEast Un,9667,7,4,5,5,11,11,0,17
Chennaiyin,9667,8,3,6,5,13,18,-5,15
Delhi Dynamo,9668,1,7,5,2,28,14,14,26
Mumbai City,9668,2,6,4,4,16,9,7,22
Kerala Blast,9668,3,6,3,5,14,17,-3,21
Kolkata,9668,4,4,6,4,18,17,1,18
NorthEast Un,9668,5,5,3,6,10,11,-1,18
Chennaiyin,9668,6,4,6,4,14,17,-3,18
FC Pune City,9668,7,4,3,7,15,20,-5,15
FC Goa,9668,8,4,2,8,10,20,-10,14
Mumbai City,9669,1,7,4,3,17,8,9,25
Kolkata,9669,2,5,7,2,16,12,4,22
Kerala Blast,9669,3,6,3,5,12,15,-3,21
Delhi Dynamo,9669,4,5,5,4,23,17,6,20
Chennaiyin,9669,5,4,6,4,21,20,1,18
NorthEast Un,9669,6,5,2,7,13,18,-5,17
FC Pune City,9669,7,4,3,7,12,16,-4,15
FC Goa,9669,8,3,4,7,9,17,-8,13
Mumbai City,9670,1,7,4,3,21,8,13,25
NorthEast Un,9670,2,6,3,5,13,10,3,21
Kolkata,9670,3,5,6,3,15,15,0,21
Kerala Blast,9670,4,5,4,5,10,14,-4,19
Delhi Dynamo,9670,5,4,5,5,22,23,-1,17
Chennaiyin,9670,6,4,5,5,16,19,-3,17
FC Goa,9670,7,5,2,7,13,17,-4,17
FC Pune City,9670,8,4,3,7,12,16,-4,15
Kolkata,9671,1,6,6,2,20,15,5,24
Mumbai City,9671,2,6,5,3,16,8,8,23
Delhi Dynamo,9671,3,5,6,3,24,17,7,21
NorthEast Un,9671,4,5,3,6,12,12,0,18
FC Pune City,9671,5,5,3,6,15,17,-2,18
Chennaiyin,9671,6,4,6,4,17,20,-3,18
Kerala Blast,9671,7,4,4,6,9,15,-6,16
FC Goa,9671,8,3,3,8,12,21,-9,12
Mumbai City,9672,1,7,4,3,17,8,9,25
Delhi Dynamo,9672,2,5,6,3,25,18,7,21
Kolkata,9672,3,5,6,3,19,14,5,21
Kerala Blast,9672,4,6,3,5,15,18,-3,21
NorthEast Un,9672,5,5,3,6,15,13,2,18
Chennaiyin,9672,6,3,6,5,14,19,-5,15
FC Pune City,9672,7,4,3,7,13,19,-6,15
FC Goa,9672,8,4,3,7,10,19,-9,15
Mumbai City,9673,1,7,4,3,17,8,9,25
Kolkata,9673,2,5,6,3,17,14,3,21
Kerala Blast,9673,3,6,3,5,14,16,-2,21
Delhi Dynamo,9673,4,5,5,4,23,17,6,20
NorthEast Un,9673,5,5,3,6,12,14,-2,18
FC Goa,9673,6,5,2,7,12,16,-4,17
FC Pune City,9673,7,4,3,7,12,16,-4,15
Chennaiyin,9673,8,3,6,5,15,21,-6,15
Delhi Dynamo,9674,1,6,6,2,26,14,12,24
Mumbai City,9674,2,6,4,4,16,11,5,22
Chennaiyin,9674,3,5,5,4,16,17,-1,20
Kerala Blast,9674,4,5,4,5,11,15,-4,19
Kolkata,9674,5,4,6,4,16,15,1,18
NorthEast Un,9674,6,5,3,6,10,10,0,18
FC Pune City,9674,7,4,4,6,14,18,-4,16
FC Goa,9674,8,4,2,8,9,18,-9,14
Delhi Dynamo,9675,1,6,6,2,28,18,10,24
Mumbai City,9675,2,6,5,3,17,9,8,23
Kolkata,9675,3,4,7,3,18,17,1,19
Kerala Blast,9675,4,4,6,4,11,15,-4,18
NorthEast Un,9675,5,4,4,6,14,15,-1,16
FC Pune City,9675,6,4,4,6,14,17,-3,16
Chennaiyin,9675,7,3,7,4,15,19,-4,16
FC Goa,9675,8,4,3,7,11,18,-7,15
Delhi Dynamo,9676,1,6,6,2,23,14,9,24
Mumbai City,9676,2,6,5,3,16,8,8,23
Kolkata,9676,3,4,7,3,16,16,0,19
NorthEast Un,9676,4,5,2,7,11,12,-1,17
Chennaiyin,9676,5,4,5,5,18,22,-4,17
FC Goa,9676,6,5,2,7,14,18,-4,17
Kerala Blast,9676,7,4,5,5,11,16,-5,17
FC Pune City,9676,8,4,4,6,14,17,-3,16
Mumbai City,9677,1,7,4,3,18,8,10,25
Kerala Blast,9677,2,7,3,4,13,14,-1,24
Delhi Dynamo,9677,3,5,5,4,26,19,7,20
NorthEast Un,9677,4,5,3,6,13,12,1,18
FC Goa,9677,5,5,2,7,11,18,-7,17
Kolkata,9677,6,3,7,4,14,16,-2,16
FC Pune City,9677,7,4,4,6,14,17,-3,16
Chennaiyin,9677,8,3,6,5,14,19,-5,15
Mumbai City,9678,1,7,4,3,18,8,10,25
Kerala Blast,9678,2,6,4,4,13,15,-2,22
Delhi Dynamo,9678,3,5,6,3,24,18,6,21
FC Pune City,9678,4,5,4,5,16,17,-1,19
Chennaiyin,9678,5,4,6,4,15,17,-2,18
Kolkata,9678,6,3,7,4,17,18,-1,16
NorthEast Un,9678,7,4,3,7,10,13,-3,15
FC Goa,9678,8,3,4,7,10,17,-7,13
Mumbai City,9679,1,7,4,3,18,8,10,25
Kolkata,9679,2,5,7,2,17,13,4,22
Delhi Dynamo,9679,3,5,6,3,23,17,6,21
Chennaiyin,9679,4,5,5,4,18,17,1,20
FC Pune City,9679,5,5,3,6,14,17,-3,18
Kerala Blast,9679,6,4,5,5,10,15,-5,17
NorthEast Un,9679,7,4,4,6,10,12,-2,16
FC Goa,9679,8,3,2,9,9,20,-11,11
Mumbai City,9680,1,7,4,3,18,8,10,25
Delhi Dynamo,9680,2,6,5,3,24,16,8,23
Kerala Blast,9680,3,6,3,5,17,16,1,21
Kolkata,9680,4,5,6,3,17,17,0,21
Chennaiyin,9680,5,5,5,4,16,17,-1,20
FC Pune City,9680,6,5,3,6,14,16,-2,18
NorthEast Un,9680,7,4,2,8,10,15,-5,14
FC Goa,9680,8,3,2,9,8,19,-11,11
Mumbai City,9681,1,7,4,3,19,9,10,25
Delhi Dynamo,9681,2,5,6,3,27,20,7,21
Kolkata,9681,3,5,6,3,18,15,3,21
FC Pune City,9681,4,5,3,6,13,15,-2,18
Chennaiyin,9681,5,4,5,5,17,19,-2,17
FC Goa,9681,6,5,2,7,12,17,-5,17
NorthEast Un,9681,7,4,4,6,13,17,-4,16
Kerala Blast,9681,8,4,4,6,11,18,-7,16
Mumbai City,9682,1,7,4,3,18,8,10,25
NorthEast Un,9682,2,6,3,5,12,10,2,21
Kolkata,9682,3,4,7,3,16,15,1,19
FC Pune City,9682,4,5,4,5,15,15,0,19
Kerala Blast,9682,5,4,6,4,10,14,-4,18
Delhi Dynamo,9682,6,4,5,5,22,19,3,17
Chennaiyin,9682,7,4,5,5,14,18,-4,17
FC Goa,9682,8,4,2,8,10,18,-8,14
Mumbai City,9683,1,7,4,3,20,9,11,25
NorthEast Un,9683,2,6,3,5,13,11,2,21
Delhi Dynamo,9683,3,4,7,3,22,18,4,19
Kolkata,9683,4,4,6,4,16,16,0,18
FC Pune City,9683,5,5,3,6,15,17,-2,18
FC Goa,9683,6,5,3,6,11,15,-4,18
Kerala Blast,9683,7,5,3,6,12,17,-5,18
Chennaiyin,9683,8,3,5,6,14,20,-6,14
Mumbai City,9684,1,7,4,3,18,8,10,25
Kerala Blast,9684,2,6,3,5,13,16,-3,21
Delhi Dynamo,9684,3,4,6,4,23,19,4,18
FC Goa,9684,4,5,3,6,16,16,0,18
FC Pune City,9684,5,5,3,6,15,15,0,18
NorthEast Un,9684,6,5,3,6,12,13,-1,18
Kolkata,9684,7,4,6,4,17,19,-2,18
Chennaiyin,9684,8,3,6,5,14,22,-8,15
Mumbai City,9685,1,7,4,3,18,9,9,25
Kerala Blast,9685,2,6,4,4,12,13,-1,22
NorthEast Un,9685,3,6,3,5,13,11,2,21
Delhi Dynamo,9685,4,5,5,4,27,20,7,20
Kolkata,9685,5,3,8,3,15,16,-1,17
FC Pune City,9685,6,4,4,6,12,15,-3,16
Chennaiyin,9685,7,3,6,5,14,19,-5,15
FC Goa,9685,8,3,4,7,12,20,-8,13
Mumbai City,9686,1,7,4,3,22,11,11,25
Delhi Dynamo,9686,2,6,5,3,32,24,8,23
Kolkata,9686,3,5,7,2,19,14,5,22
NorthEast Un,9686,4,5,3,6,11,11,0,18
Chennaiyin,9686,5,4,6,4,15,18,-3,18
Kerala Blast,9686,6,5,3,6,12,18,-6,18
FC Pune City,9686,7,4,3,7,13,18,-5,15
FC Goa,9686,8,3,3,8,13,23,-10,12
Mumbai City,9687,1,7,4,3,19,10,9,25
NorthEast Un,9687,2,6,3,5,14,12,2,21
Kolkata,9687,3,4,8,2,19,16,3,20
Delhi Dynamo,9687,4,4,5,5,26,22,4,17
FC Pune City,9687,5,4,5,5,15,17,-2,17
Kerala Blast,9687,6,4,5,5,11,16,-5,17
Chennaiyin,9687,7,3,7,4,16,20,-4,16
FC Goa,9687,8,4,3,7,13,20,-7,15
Mumbai City,9688,1,7,4,3,18,8,10,25
Delhi Dynamo,9688,2,5,6,3,23,17,6,21
Kerala Blast,9688,3,6,3,5,16,17,-1,21
Kolkata,9688,4,4,7,3,21,19,2,19
FC Pune City,9688,5,5,3,6,15,20,-5,18
NorthEast Un,9688,6,5,2,7,12,13,-1,17
FC Goa,9688,7,4,4,6,12,16,-4,16
Chennaiyin,9688,8,3,5,6,15,22,-7,14
Mumbai City,9689,1,7,4,3,18,8,10,25
Delhi Dynamo,9689,2,6,5,3,29,19,10,23
NorthEast Un,9689,3,6,2,6,14,15,-1,20
Kolkata,9689,4,4,6,4,15,15,0,18
FC Pune City,9689,5,5,3,6,14,15,-1,18
Kerala Blast,9689,6,5,3,6,11,17,-6,18
FC Goa,9689,7,5,2,7,13,17,-4,17
Chennaiyin,9689,8,3,5,6,14,22,-8,14
Mumbai City,9690,1,7,4,3,21,8,13,25
Delhi Dynamo,9690,2,5,6,3,23,20,3,21
Kerala Blast,9690,3,5,4,5,12,16,-4,19
Kolkata,9690,4,3,9,2,14,13,1,18
NorthEast Un,9690,5,5,2,7,12,13,-1,17
Chennaiyin,9690,6,4,5,5,17,21,-4,17
FC Pune City,9690,7,4,4,6,14,17,-3,16
FC Goa,9690,8,4,4,6,12,17,-5,16
Delhi Dynamo,9691,1,6,5,3,25,18,7,23
Mumbai City,9691,2,6,4,4,16,9,7,22
Kerala Blast,9691,3,6,3,5,15,15,0,21
NorthEast Un,9691,4,5,3,6,13,14,-1,18
Kolkata,9691,5,4,6,4,15,17,-2,18
FC Pune City,9691,6,5,3,6,13,15,-2,18
Chennaiyin,9691,7,3,7,4,15,19,-4,16
FC Goa,9691,8,4,3,7,12,17,-5,15
Mumbai City,9692,1,7,4,3,20,9,11,25
Delhi Dynamo,9692,2,5,6,3,24,19,5,21
FC Pune City,9692,3,6,3,5,16,16,0,21
NorthEast Un,9692,4,6,2,6,14,12,2,20
Kolkata,9692,5,4,6,4,15,16,-1,18
Kerala Blast,9692,6,5,3,6,12,17,-5,18
Chennaiyin,9692,7,3,6,5,15,20,-5,15
FC Goa,9692,8,3,4,7,9,16,-7,13
Mumbai City,9693,1,6,5,3,16,8,8,23
Delhi Dynamo,9693,2,5,7,2,24,16,8,22
FC Pune City,9693,3,6,3,5,15,15,0,21
Kolkata,9693,4,4,6,4,18,16,2,18
Chennaiyin,9693,5,4,6,4,16,19,-3,18
Kerala Blast,9693,6,5,3,6,11,18,-7,18
NorthEast Un,9693,7,4,3,7,12,14,-2,15
FC Goa,9693,8,4,3,7,12,18,-6,15
Delhi Dynamo,9694,1,6,6,2,25,14,11,24
Mumbai City,9694,2,6,4,4,16,11,5,22
Kerala Blast,9694,3,5,4,5,12,17,-5,19
FC Pune City,9694,4,5,3,6,14,16,-2,18
Kolkata,9694,5,3,8,3,15,15,0,17
NorthEast Un,9694,6,5,2,7,12,12,0,17
Chennaiyin,9694,7,4,5,5,15,21,-6,17
FC Goa,9694,8,4,4,6,12,15,-3,16
Mumbai City,9695,1,7,4,3,17,8,9,25
NorthEast Un,9695,2,6,3,5,16,12,4,21
Kolkata,9695,3,4,8,2,16,14,2,20
FC Pune City,9695,4,5,4,5,17,15,2,19
Delhi Dynamo,9695,5,4,6,4,21,17,4,18
Kerala Blast,9695,6,4,5,5,13,21,-8,17
FC Goa,9695,7,4,3,7,10,16,-6,15
Chennaiyin,9695,8,3,5,6,14,21,-7,14
Mumbai City,9696,1,7,4,3,19,10,9,25
Delhi Dynamo,9696,2,6,5,3,28,18,10,23
Kolkata,9696,3,5,6,3,18,15,3,21
Chennaiyin,9696,4,5,5,4,16,18,-2,20
FC Pune City,9696,5,5,4,5,15,16,-1,19
Kerala Blast,9696,6,5,4,5,14,17,-3,19
NorthEast Un,9696,7,4,2,8,10,14,-4,14
FC Goa,9696,8,3,2,9,10,22,-12,11
Delhi Dynamo,9697,1,6,6,2,26,17,9,24
Mumbai City,9697,2,6,4,4,18,11,7,22
Kolkata,9697,3,5,7,2,18,13,5,22
Kerala Blast,9697,4,5,5,4,15,16,-1,20
NorthEast Un,9697,5,4,5,5,14,14,0,17
Chennaiyin,9697,6,3,6,5,16,23,-7,15
FC Pune City,9697,7,4,3,7,12,19,-7,15
FC Goa,9697,8,4,2,8,12,18,-6,14
Mumbai City,9698,1,6,4,4,17,10,7,22
Delhi Dynamo,9698,2,5,6,3,23,16,7,21
Kolkata,9698,3,5,6,3,20,17,3,21
FC Goa,9698,4,6,2,6,15,17,-2,20
NorthEast Un,9698,5,5,4,5,10,9,1,19
FC Pune City,9698,6,4,4,6,13,16,-3,16
Kerala Blast,9698,7,4,4,6,10,17,-7,16
Chennaiyin,9698,8,3,6,5,14,20,-6,15
Mumbai City,9699,1,7,4,3,19,10,9,25
Delhi Dynamo,9699,2,4,7,3,26,20,6,19
Kolkata,9699,3,4,7,3,14,13,1,19
NorthEast Un,9699,4,5,4,5,13,12,1,19
Kerala Blast,9699,5,5,4,5,12,16,-4,19
FC Pune City,9699,6,4,5,5,13,15,-2,17
Chennaiyin,9699,7,3,6,5,15,20,-5,15
FC Goa,9699,8,4,3,7,12,18,-6,15
Mumbai City,9700,1,7,4,3,18,8,10,25
Kolkata,9700,2,5,6,3,18,16,2,21
Delhi Dynamo,9700,3,5,5,4,24,17,7,20
Kerala Blast,9700,4,5,4,5,14,18,-4,19
NorthEast Un,9700,5,5,3,6,11,11,0,18
Chennaiyin,9700,6,4,6,4,16,19,-3,18
FC Pune City,9700,7,4,3,7,15,19,-4,15
FC Goa,9700,8,4,3,7,10,18,-8,15
Mumbai City,9701,1,7,4,3,18,8,10,25
Delhi Dynamo,9701,2,5,5,4,25,21,4,20
Kerala Blast,9701,3,5,5,4,10,13,-3,20
FC Pune City,9701,4,5,4,5,13,14,-1,19
NorthEast Un,9701,5,5,3,6,14,12,2,18
Kolkata,9701,6,3,8,3,15,15,0,17
Chennaiyin,9701,7,3,6,5,15,21,-6,15
FC Goa,9701,8,4,3,7,14,20,-6,15
Mumbai City,9702,1,6,5,3,16,8,8,23
Delhi Dynamo,9702,2,5,6,3,23,18,5,21
NorthEast Un,9702,3,6,3,5,18,13,5,21
FC Pune City,9702,4,6,3,5,15,15,0,21
Kerala Blast,9702,5,4,5,5,12,17,-5,17
Kolkata,9702,6,3,7,4,15,18,-3,16
FC Goa,9702,7,4,3,7,12,16,-4,15
Chennaiyin,9702,8,3,6,5,15,21,-6,15
Delhi Dynamo,9703,1,6,6,2,25,16,9,24
Mumbai City,9703,2,6,4,4,17,10,7,22
Kolkata,9703,3,5,7,2,19,16,3,22
Kerala Blast,9703,4,6,3,5,12,15,-3,21
Chennaiyin,9703,5,4,5,5,16,20,-4,17
FC Pune City,9703,6,4,4,6,14,17,-3,16
FC Goa,9703,7,4,3,7,12,18,-6,15
NorthEast Un,9703,8,4,2,8,10,13,-3,14
Mumbai City,9704,1,7,4,3,18,9,9,25
FC Pune City,9704,2,6,3,5,14,14,0,21
Delhi Dynamo,9704,3,5,5,4,24,18,6,20
Chennaiyin,9704,4,5,5,4,17,18,-1,20
Kolkata,9704,5,4,6,4,15,15,0,18
NorthEast Un,9704,6,5,2,7,13,15,-2,17
FC Goa,9704,7,5,2,7,11,16,-5,17
Kerala Blast,9704,8,4,3,7,12,19,-7,15
NorthEast Un,9705,1,7,2,5,16,10,6,23
Mumbai City,9705,2,6,4,4,18,11,7,22
Delhi Dynamo,9705,3,5,6,3,25,18,7,21
Kolkata,9705,4,4,7,3,17,17,0,19
Kerala Blast,9705,5,4,5,5,11,17,-6,17
FC Goa,9705,6,4,4,6,12,15,-3,16
FC Pune City,9705,7,4,4,6,12,16,-4,16
Chennaiyin,9705,8,3,6,5,14,21,-7,15
Delhi Dynamo,9706,1,7,5,2,29,19,10,26
Mumbai City,9706,2,6,4,4,17,10,7,22
FC Pune City,9706,3,5,4,5,16,16,0,19
Chennaiyin,9706,4,4,5,5,17,19,-2,17
Kolkata,9706,5,3,8,3,15,17,-2,17
FC Goa,9706,6,5,2,7,14,17,-3,17
NorthEast Un,9706,7,5,2,7,13,16,-3,17
Kerala Blast,9706,8,4,4,6,11,18,-7,16
Mumbai City,9707,1,7,4,3,19,8,11,25
Kerala Blast,9707,2,6,3,5,11,14,-3,21
Delhi Dynamo,9707,3,5,5,4,24,21,3,20
Kolkata,9707,4,4,7,3,14,14,0,19
NorthEast Un,9707,5,5,3,6,14,13,1,18
FC Goa,9707,6,5,2,7,14,18,-4,17
FC Pune City,9707,7,4,4,6,12,15,-3,16
Chennaiyin,9707,8,3,6,5,17,22,-5,15
Mumbai City,9708,1,7,4,3,18,9,9,25
Chennaiyin,9708,2,5,5,4,17,19,-2,20
Kerala Blast,9708,3,5,5,4,13,16,-3,20
FC Pune City,9708,4,5,4,5,14,15,-1,19
Delhi Dynamo,9708,5,4,5,5,22,20,2,17
NorthEast Un,9708,6,5,2,7,13,12,1,17
Kolkata,9708,7,3,8,3,14,14,0,17
FC Goa,9708,8,4,3,7,11,17,-6,15
Mumbai City,9709,1,7,4,3,18,9,9,25
Delhi Dynamo,9709,2,5,5,4,25,18,7,20
NorthEast Un,9709,3,5,4,5,13,12,1,19
Kerala Blast,9709,4,5,4,5,15,19,-4,19
FC Pune City,9709,5,5,3,6,16,17,-1,18
Kolkata,9709,5,4,6,4,16,17,-1,18
Chennaiyin,9709,7,3,7,4,13,17,-4,16
FC Goa,9709,8,4,3,7,10,17,-7,15
Delhi Dynamo,9710,1,7,5,2,28,15,13,26
Mumbai City,9710,2,6,4,4,16,10,6,22
Kerala Blast,9710,3,6,3,5,14,20,-6,21
Chennaiyin,9710,4,5,5,4,16,18,-2,20
Kolkata,9710,5,4,6,4,17,16,1,18
FC Pune City,9710,6,5,3,6,17,18,-1,18
NorthEast Un,9710,7,4,2,8,11,15,-4,14
FC Goa,9710,8,4,2,8,11,18,-7,14
Mumbai City,9711,1,7,4,3,18,8,10,25
Kerala Blast,9711,2,6,4,4,15,15,0,22
NorthEast Un,9711,3,6,2,6,13,11,2,20
Delhi Dynamo,9711,4,4,6,4,23,19,4,18
FC Pune City,9711,5,5,3,6,14,18,-4,18
Kolkata,9711,6,3,8,3,16,16,0,17
Chennaiyin,9711,7,4,5,5,17,20,-3,17
FC Goa,9711,8,3,4,7,12,21,-9,13
Mumbai City,9712,1,6,5,3,17,9,8,23
Delhi Dynamo,9712,2,5,7,2,24,16,8,22
Kolkata,9712,3,4,8,2,18,14,4,20
NorthEast Un,9712,4,5,4,5,11,9,2,19
Kerala Blast,9712,5,5,4,5,10,16,-6,19
FC Pune City,9712,6,4,4,6,14,17,-3,16
FC Goa,9712,7,4,3,7,11,17,-6,15
Chennaiyin,9712,8,3,5,6,14,21,-7,14
Mumbai City,9713,1,7,4,3,20,9,11,25
Kolkata,9713,2,5,7,2,18,13,5,22
Delhi Dynamo,9713,3,4,7,3,24,20,4,19
Kerala Blast,9713,4,5,4,5,11,15,-4,19
Chennaiyin,9713,5,4,5,5,14,20,-6,17
NorthEast Un,9713,6,4,4,6,10,11,-1,16
FC Pune City,9713,7,4,4,6,14,17,-3,16
FC Goa,9713,8,4,3,7,12,18,-6,15
Mumbai City,9714,1,7,4,3,18,9,9,25
NorthEast Un,9714,2,7,2,5,14,11,3,23
FC Goa,9714,3,6,2,6,19,17,2,20
FC Pune City,9714,4,5,4,5,15,14,1,19
Kolkata,9714,5,4,6,4,16,18,-2,18
Delhi Dynamo,9714,6,4,5,5,26,22,4,17
Kerala Blast,9714,7,4,4,6,9,16,-7,16
Chennaiyin,9714,8,3,5,6,13,23,-10,14
Mumbai City,9715,1,7,4,3,18,9,9,25
Delhi Dynamo,9715,2,5,5,4,25,19,6,20
FC Goa,9715,3,6,2,6,14,16,-2,20
Kolkata,9715,4,4,7,3,14,14,0,19
Kerala Blast,9715,5,5,4,5,15,16,-1,19
NorthEast Un,9715,6,5,3,6,13,12,1,18
FC Pune City,9715,7,4,4,6,13,19,-6,16
Chennaiyin,9715,8,3,5,6,14,21,-7,14
Mumbai City,9716,1,7,4,3,17,8,9,25
Delhi Dynamo,9716,2,5,6,3,25,17,8,21
Kerala Blast,9716,3,5,5,4,10,13,-3,20
Kolkata,9716,4,3,9,2,14,13,1,18
Chennaiyin,9716,5,4,6,4,17,19,-2,18
FC Pune City,9716,6,4,5,5,13,15,-2,17
NorthEast Un,9716,7,4,4,6,10,11,-1,16
FC Goa,9716,8,3,3,8,11,21,-10,12
Mumbai City,9717,1,6,5,3,16,8,8,23
Kerala Blast,9717,2,6,4,4,15,16,-1,22
Kolkata,9717,3,4,8,2,17,13,4,20
NorthEast Un,9717,4,6,2,6,15,14,1,20
Delhi Dynamo,9717,5,4,7,3,26,20,6,19
FC Goa,9717,6,4,4,6,14,18,-4,16
FC Pune City,9717,7,4,3,7,13,19,-6,15
Chennaiyin,9717,8,3,5,6,14,22,-8,14
Delhi Dynamo,9718,1,7,5,2,25,15,10,26
Mumbai City,9718,2,6,4,4,16,9,7,22
FC Pune City,9718,3,6,3,5,17,15,2,21
Kolkata,9718,4,4,6,4,15,15,0,18
NorthEast Un,9718,5,5,3,6,12,12,0,18
Chennaiyin,9718,6,4,6,4,15,18,-3,18
Kerala Blast,9718,7,4,3,7,10,19,-9,15
FC Goa,9718,8,4,2,8,10,17,-7,14
Mumbai City,9719,1,7,4,3,19,8,11,25
Delhi Dynamo,9719,2,5,6,3,23,17,6,21
Chennaiyin,9719,3,5,5,4,16,18,-2,20
Kerala Blast,9719,4,5,4,5,13,17,-4,19
Kolkata,9719,5,4,6,4,17,16,1,18
FC Pune City,9719,6,5,3,6,14,17,-3,18
NorthEast Un,9719,7,4,4,6,10,11,-1,16
FC Goa,9719,8,4,2,8,11,19,-8,14
Delhi Dynamo,9720,1,7,5,2,27,15,12,26
Mumbai City,9720,2,6,4,4,16,9,7,22
Kolkata,9720,3,4,7,3,16,15,1,19
Kerala Blast,9720,4,5,4,5,14,17,-3,19
NorthEast Un,9720,5,5,3,6,13,15,-2,18
FC Pune City,9720,6,4,4,6,12,18,-6,16
FC Goa,9720,7,4,3,7,12,16,-4,15
Chennaiyin,9720,8,3,6,5,15,20,-5,15
Kolkata,9721,1,6,6,2,20,14,6,24
Mumbai City,9721,2,6,5,3,18,10,8,23
Delhi Dynamo,9721,3,5,6,3,25,18,7,21
NorthEast Un,9721,4,6,2,6,14,13,1,20
Chennaiyin,9721,5,4,6,4,17,20,-3,18
FC Pune City,9721,6,5,3,6,15,18,-3,18
Kerala Blast,9721,7,4,3,7,9,16,-7,15
FC Goa,9721,8,3,3,8,9,18,-9,12
Delhi Dynamo,9722,1,7,5,2,26,15,11,26
Kerala Blast,9722,2,7,3,4,13,13,0,24
Mumbai City,9722,3,6,4,4,17,10,7,22
Chennaiyin,9722,4,5,5,4,21,18,3,20
Kolkata,9722,5,4,7,3,15,14,1,19
FC Pune City,9722,6,4,3,7,13,17,-4,15
NorthEast Un,9722,7,4,2,8,9,16,-7,14
FC Goa,9722,8,3,3,8,9,20,-11,12
Mumbai City,9723,1,7,4,3,19,10,9,25
Delhi Dynamo,9723,2,5,5,4,25,20,5,20
Chennaiyin,9723,3,5,5,4,18,17,1,20
Kerala Blast,9723,4,5,4,5,12,17,-5,19
Kolkata,9723,5,4,6,4,16,15,1,18
NorthEast Un,9723,6,5,3,6,13,12,1,18
FC Pune City,9723,7,5,3,6,14,16,-2,18
FC Goa,9723,8,4,2,8,9,19,-10,14
Mumbai City,9724,1,7,4,3,18,8,10,25
Kolkata,9724,2,5,6,3,18,18,0,21
NorthEast Un,9724,3,6,2,6,16,13,3,20
FC Goa,9724,4,6,2,6,16,16,0,20
FC Pune City,9724,5,5,3,6,13,15,-2,18
Delhi Dynamo,9724,6,4,5,5,23,20,3,17
Chennaiyin,9724,7,4,5,5,15,20,-5,17
Kerala Blast,9724,8,4,3,7,12,21,-9,15
Mumbai City,9725,1,7,4,3,17,8,9,25
Kerala Blast,9725,2,7,3,4,16,15,1,24
NorthEast Un,9725,3,6,2,6,13,10,3,20
FC Goa,9725,4,6,2,6,12,14,-2,20
Kolkata,9725,5,4,6,4,19,19,0,18
Delhi Dynamo,9725,6,4,5,5,21,18,3,17
FC Pune City,9725,7,4,3,7,14,20,-6,15
Chennaiyin,9725,8,3,5,6,13,21,-8,14
Delhi Dynamo,9726,1,6,6,2,29,18,11,24
Mumbai City,9726,2,6,4,4,18,11,7,22
Kolkata,9726,3,5,7,2,20,15,5,22
Kerala Blast,9726,4,5,3,6,13,20,-7,18
NorthEast Un,9726,5,5,2,7,13,17,-4,17
Chennaiyin,9726,6,4,5,5,15,21,-6,17
FC Goa,9726,7,4,4,6,15,17,-2,16
FC Pune City,9726,8,4,3,7,14,18,-4,15
Delhi Dynamo,9727,1,6,5,3,25,17,8,23
Mumbai City,9727,2,6,4,4,16,9,7,22
Kerala Blast,9727,3,6,4,4,13,15,-2,22
FC Goa,9727,4,5,3,6,13,15,-2,18
Chennaiyin,9727,5,4,6,4,16,19,-3,18
FC Pune City,9727,6,4,5,5,14,16,-2,17
Kolkata,9727,7,3,7,4,15,17,-2,16
NorthEast Un,9727,8,4,2,8,11,15,-4,14
Delhi Dynamo,9728,1,6,5,3,26,16,10,23
Mumbai City,9728,2,6,4,4,16,10,6,22
Kerala Blast,9728,3,6,4,4,13,14,-1,22
NorthEast Un,9728,4,5,3,6,12,12,0,18
FC Pune City,9728,5,5,3,6,14,16,-2,18
Chennaiyin,9728,6,4,5,5,15,19,-4,17
Kolkata,9728,7,3,7,4,16,18,-2,16
FC Goa,9728,8,4,3,7,12,19,-7,15
Mumbai City,9729,1,6,5,3,17,9,8,23
Delhi Dynamo,9729,2,5,6,3,24,17,7,21
Kolkata,9729,3,5,6,3,21,16,5,21
FC Pune City,9729,4,5,3,6,18,18,0,18
Chennaiyin,9729,5,4,6,4,15,18,-3,18
Kerala Blast,9729,6,5,3,6,14,24,-10,18
NorthEast Un,9729,7,5,2,7,12,13,-1,17
FC Goa,9729,8,4,3,7,12,18,-6,15
Mumbai City,9730,1,7,4,3,18,8,10,25
Delhi Dynamo,9730,2,6,5,3,25,16,9,23
FC Pune City,9730,3,5,4,5,15,15,0,19
Kerala Blast,9730,4,5,4,5,14,17,-3,19
Kolkata,9730,5,4,6,4,17,17,0,18
FC Goa,9730,6,5,2,7,11,18,-7,17
NorthEast Un,9730,7,4,3,7,10,14,-4,15
Chennaiyin,9730,8,3,6,5,14,19,-5,15
Delhi Dynamo,9731,1,6,6,2,27,17,10,24
Mumbai City,9731,2,6,4,4,17,10,7,22
FC Pune City,9731,3,5,4,5,14,15,-1,19
Kerala Blast,9731,4,5,4,5,12,16,-4,19
Chennaiyin,9731,5,4,6,4,15,18,-3,18
NorthEast Un,9731,6,4,5,5,13,13,0,17
Kolkata,9731,7,3,7,4,14,15,-1,16
FC Goa,9731,8,4,2,8,10,18,-8,14
Mumbai City,9732,1,7,4,3,17,8,9,25
Kolkata,9732,2,5,6,3,22,15,7,21
Delhi Dynamo,9732,3,5,5,4,22,16,6,20
Chennaiyin,9732,4,5,5,4,16,18,-2,20
FC Pune City,9732,5,5,3,6,13,18,-5,18
Kerala Blast,9732,6,5,3,6,11,18,-7,18
NorthEast Un,9732,7,5,2,7,10,11,-1,17
FC Goa,9732,8,4,2,8,11,18,-7,14
Mumbai City,9733,1,7,4,3,18,8,10,25
Kolkata,9733,2,5,7,2,18,15,3,22
NorthEast Un,9733,3,6,3,5,13,11,2,21
Delhi Dynamo,9733,4,5,5,4,23,18,5,20
Kerala Blast,9733,5,5,3,6,13,17,-4,18
Chennaiyin,9733,6,3,6,5,15,20,-5,15
FC Pune City,9733,7,4,3,7,12,17,-5,15
FC Goa,9733,8,4,3,7,13,19,-6,15
Mumbai City,9734,1,7,4,3,17,8,9,25
FC Pune City,9734,2,6,3,5,19,17,2,21
Kolkata,9734,3,5,6,3,16,16,0,21
Kerala Blast,9734,4,5,3,6,13,18,-5,18
Delhi Dynamo,9734,5,4,5,5,23,19,4,17
NorthEast Un,9734,6,5,2,7,12,13,-1,17
FC Goa,9734,7,5,2,7,15,17,-2,17
Chennaiyin,9734,8,4,5,5,15,22,-7,17
Mumbai City,9735,1,6,5,3,19,11,8,23
Chennaiyin,9735,2,5,5,4,18,18,0,20
Kerala Blast,9735,3,5,5,4,15,16,-1,20
FC Pune City,9735,4,5,4,5,19,16,3,19
Delhi Dynamo,9735,5,4,6,4,25,20,5,18
Kolkata,9735,6,3,8,3,14,18,-4,17
NorthEast Un,9735,7,5,2,7,11,16,-5,17
FC Goa,9735,8,4,3,7,10,16,-6,15
Mumbai City,9736,1,6,5,3,18,10,8,23
Kolkata,9736,2,5,7,2,18,13,5,22
Delhi Dynamo,9736,3,4,7,3,25,19,6,19
Kerala Blast,9736,4,5,4,5,13,19,-6,19
NorthEast Un,9736,5,5,3,6,15,15,0,18
FC Pune City,9736,6,4,4,6,12,15,-3,16
FC Goa,9736,7,4,4,6,9,14,-5,16
Chennaiyin,9736,8,3,6,5,14,19,-5,15
Mumbai City,9737,1,7,4,3,17,8,9,25
Kerala Blast,9737,2,7,3,4,20,15,5,24
Delhi Dynamo,9737,3,6,5,3,26,15,11,23
FC Pune City,9737,4,5,3,6,15,19,-4,18
FC Goa,9737,5,5,2,7,13,17,-4,17
Chennaiyin,9737,6,4,5,5,16,21,-5,17
Kolkata,9737,7,3,6,5,15,21,-6,15
NorthEast Un,9737,8,4,2,8,13,19,-6,14
Delhi Dynamo,9738,1,7,5,2,25,15,10,26
Mumbai City,9738,2,6,4,4,17,10,7,22
Kolkata,9738,3,4,8,2,17,15,2,20
Chennaiyin,9738,4,4,6,4,18,17,1,18
FC Pune City,9738,5,4,5,5,14,16,-2,17
Kerala Blast,9738,6,4,5,5,11,16,-5,17
NorthEast Un,9738,7,4,3,7,9,15,-6,15
FC Goa,9738,8,3,4,7,11,18,-7,13
Mumbai City,9739,1,7,4,3,19,9,10,25
Kerala Blast,9739,2,5,5,4,13,16,-3,20
Delhi Dynamo,9739,3,4,7,3,25,20,5,19
NorthEast Un,9739,4,5,4,5,13,12,1,19
FC Pune City,9739,5,5,3,6,15,16,-1,18
FC Goa,9739,6,5,3,6,12,15,-3,18
Kolkata,9739,7,3,7,4,14,16,-2,16
Chennaiyin,9739,8,3,5,6,13,20,-7,14
Mumbai City,9740,1,7,4,3,20,8,12,25
Delhi Dynamo,9740,2,5,6,3,22,18,4,21
Kerala Blast,9740,3,5,5,4,15,16,-1,20
Kolkata,9740,4,4,7,3,15,15,0,19
NorthEast Un,9740,5,5,3,6,14,13,1,18
FC Goa,9740,6,5,3,6,13,15,-2,18
FC Pune City,9740,7,4,3,7,12,18,-6,15
Chennaiyin,9740,8,3,5,6,13,21,-8,14
Mumbai City,9741,1,6,5,3,16,8,8,23
Kerala Blast,9741,2,5,5,4,12,14,-2,20
Delhi Dynamo,9741,3,4,7,3,23,17,6,19
NorthEast Un,9741,4,5,3,6,12,13,-1,18
FC Goa,9741,5,5,3,6,12,15,-3,18
Kolkata,9741,6,3,8,3,15,16,-1,17
Chennaiyin,9741,7,4,5,5,16,19,-3,17
FC Pune City,9741,8,4,4,6,13,17,-4,16
Delhi Dynamo,9742,1,6,6,2,24,15,9,24
Mumbai City,9742,2,6,4,4,16,9,7,22
Kolkata,9742,3,4,8,2,16,13,3,20
Chennaiyin,9742,4,5,5,4,16,17,-1,20
FC Pune City,9742,5,5,4,5,17,18,-1,19
Kerala Blast,9742,6,5,4,5,14,18,-4,19
NorthEast Un,9742,7,4,3,7,11,14,-3,15
FC Goa,9742,8,3,2,9,8,18,-10,11
Delhi Dynamo,9743,1,6,5,3,27,18,9,23
Mumbai City,9743,2,6,4,4,17,10,7,22
NorthEast Un,9743,3,6,3,5,14,11,3,21
FC Pune City,9743,4,5,4,5,14,15,-1,19
Kerala Blast,9743,5,4,6,4,12,16,-4,18
Kolkata,9743,6,3,8,3,16,16,0,17
Chennaiyin,9743,7,4,5,5,14,19,-5,17
FC Goa,9743,8,3,3,8,9,18,-9,12
Mumbai City,9744,1,7,4,3,18,9,9,25
NorthEast Un,9744,2,5,4,5,11,10,1,19
FC Pune City,9744,3,5,4,5,14,14,0,19
Delhi Dynamo,9744,4,4,6,4,24,21,3,18
FC Goa,9744,5,5,3,6,17,18,-1,18
Kolkata,9744,6,3,8,3,16,17,-1,17
Kerala Blast,9744,7,4,5,5,12,18,-6,17
Chennaiyin,9744,8,3,6,5,14,19,-5,15
Mumbai City,9745,1,7,4,3,19,10,9,25
FC Pune City,9745,2,6,3,5,16,16,0,21
Kerala Blast,9745,3,5,4,5,14,17,-3,19
Delhi Dynamo,9745,4,4,6,4,25,20,5,18
Chennaiyin,9745,5,4,6,4,18,19,-1,18
FC Goa,9745,6,5,3,6,13,17,-4,18
NorthEast Un,9745,7,4,4,6,11,14,-3,16
Kolkata,9745,8,3,6,5,15,18,-3,15
Delhi Dynamo,9746,1,6,5,3,25,16,9,23
Mumbai City,9746,2,6,4,4,17,10,7,22
FC Pune City,9746,3,5,4,5,14,15,-1,19
NorthEast Un,9746,4,5,3,6,12,13,-1,18
Chennaiyin,9746,5,4,6,4,15,18,-3,18
Kolkata,9746,6,3,8,3,15,15,0,17
FC Goa,9746,7,5,2,7,11,16,-5,17
Kerala Blast,9746,8,4,4,6,10,16,-6,16
Mumbai City,9747,1,7,4,3,18,9,9,25
Delhi Dynamo,9747,2,5,6,3,24,16,8,21
Kolkata,9747,3,4,8,2,15,13,2,20
Chennaiyin,9747,4,4,6,4,17,19,-2,18
FC Pune City,9747,5,5,3,6,13,15,-2,18
Kerala Blast,9747,6,4,5,5,10,15,-5,17
NorthEast Un,9747,7,4,4,6,11,13,-2,16
FC Goa,9747,8,3,4,7,10,18,-8,13
Mumbai City,9748,1,7,4,3,18,9,9,25
Kolkata,9748,2,5,7,2,19,12,7,22
NorthEast Un,9748,3,6,3,5,13,10,3,21
Delhi Dynamo,9748,4,4,5,5,22,19,3,17
FC Pune City,9748,5,4,5,5,13,15,-2,17
FC Goa,9748,6,5,2,7,10,16,-6,17
Kerala Blast,9748,7,4,4,6,10,19,-9,16
Chennaiyin,9748,8,3,6,5,14,19,-5,15
Delhi Dynamo,9749,1,6,5,3,27,17,10,23
Mumbai City,9749,2,6,4,4,17,10,7,22
Kolkata,9749,3,5,6,3,16,14,2,21
NorthEast Un,9749,4,6,2,6,13,13,0,20
FC Pune City,9749,5,5,3,6,15,17,-2,18
Kerala Blast,9749,6,5,3,6,14,18,-4,18
Chennaiyin,9749,7,3,6,5,15,20,-5,15
FC Goa,9749,8,4,3,7,12,20,-8,15
Mumbai City,9750,1,7,4,3,18,9,9,25
Delhi Dynamo,9750,2,4,7,3,23,17,6,19
Kolkata,9750,3,4,7,3,16,15,1,19
NorthEast Un,9750,4,5,4,5,15,14,1,19
FC Pune City,9750,5,5,3,6,13,16,-3,18
Chennaiyin,9750,6,4,5,5,16,20,-4,17
Kerala Blast,9750,7,4,5,5,13,18,-5,17
FC Goa,9750,8,4,3,7,11,16,-5,15
Mumbai City,9751,1,7,4,3,18,8,10,25
Delhi Dynamo,9751,2,6,5,3,24,17,7,23
Kolkata,9751,3,5,7,2,19,15,4,22
NorthEast Un,9751,4,5,3,6,13,13,0,18
Kerala Blast,9751,5,5,3,6,14,18,-4,18
Chennaiyin,9751,6,3,6,5,15,20,-5,15
FC Pune City,9751,7,4,3,7,14,20,-6,15
FC Goa,9751,8,4,3,7,11,17,-6,15
Mumbai City,9752,1,7,4,3,17,8,9,25
Delhi Dynamo,9752,2,6,5,3,27,15,12,23
FC Pune City,9752,3,5,4,5,15,15,0,19
Kolkata,9752,4,4,6,4,15,16,-1,18
NorthEast Un,9752,5,5,3,6,12,15,-3,18
FC Goa,9752,6,5,2,7,11,17,-6,17
Kerala Blast,9752,7,4,4,6,12,18,-6,16
Chennaiyin,9752,8,3,6,5,15,20,-5,15
Delhi Dynamo,9753,1,6,6,2,27,15,12,24
Mumbai City,9753,2,6,4,4,17,10,7,22
NorthEast Un,9753,3,5,4,5,11,9,2,19
Kolkata,9753,4,4,7,3,15,15,0,19
Kerala Blast,9753,5,5,4,5,11,15,-4,19
FC Pune City,9753,6,5,3,6,14,15,-1,18
Chennaiyin,9753,7,3,6,5,15,21,-6,15
FC Goa,9753,8,3,4,7,11,21,-10,13
Mumbai City,9754,1,7,4,3,19,8,11,25
Delhi Dynamo,9754,2,6,5,3,27,17,10,23
Kolkata,9754,3,5,6,3,18,15,3,21
Kerala Blast,9754,4,6,3,5,14,16,-2,21
Chennaiyin,9754,5,4,5,5,17,20,-3,17
NorthEast Un,9754,6,5,2,7,11,15,-4,17
FC Pune City,9754,7,4,3,7,14,21,-7,15
FC Goa,9754,8,4,2,8,11,19,-8,14
Mumbai City,9755,1,6,5,3,16,8,8,23
Delhi Dynamo,9755,2,5,6,3,24,19,5,21
Kerala Blast,9755,3,6,3,5,11,14,-3,21
Kolkata,9755,4,4,7,3,16,16,0,19
Chennaiyin,9755,5,4,6,4,15,18,-3,18
NorthEast Un,9755,6,5,2,7,13,11,2,17
FC Pune City,9755,7,4,4,6,12,15,-3,16
FC Goa,9755,8,4,3,7,14,20,-6,15
Mumbai City,9756,1,7,4,3,17,8,9,25
Kolkata,9756,2,5,6,3,17,15,2,21
Delhi Dynamo,9756,3,5,5,4,24,20,4,20
Kerala Blast,9756,4,5,4,5,12,16,-4,19
Chennaiyin,9756,5,4,6,4,17,20,-3,18
NorthEast Un,9756,6,5,2,7,14,13,1,17
FC Pune City,9756,7,4,4,6,14,18,-4,16
FC Goa,9756,8,4,3,7,14,19,-5,15
Mumbai City,9757,1,6,5,3,16,8,8,23
Delhi Dynamo,9757,2,5,6,3,24,17,7,21
Kolkata,9757,3,5,6,3,16,13,3,21
Kerala Blast,9757,4,5,4,5,10,14,-4,19
NorthEast Un,9757,5,5,3,6,11,12,-1,18
Chennaiyin,9757,6,4,6,4,15,17,-2,18
FC Pune City,9757,7,5,3,6,13,16,-3,18
FC Goa,9757,8,3,3,8,9,17,-8,12
Mumbai City,9758,1,6,5,3,16,8,8,23
Delhi Dynamo,9758,2,5,6,3,22,15,7,21
Kolkata,9758,3,5,6,3,16,15,1,21
FC Goa,9758,4,6,2,6,14,15,-1,20
Kerala Blast,9758,5,5,4,5,11,15,-4,19
FC Pune City,9758,6,4,4,6,12,15,-3,16
NorthEast Un,9758,7,4,3,7,9,12,-3,15
Chennaiyin,9758,8,3,6,5,14,19,-5,15
Delhi Dynamo,9759,1,7,5,2,27,15,12,26
Mumbai City,9759,2,6,4,4,17,10,7,22
Kerala Blast,9759,3,5,4,5,13,16,-3,19
Kolkata,9759,4,3,9,2,17,16,1,18
NorthEast Un,9759,5,5,3,6,11,13,-2,18
Chennaiyin,9759,6,4,6,4,16,19,-3,18
FC Pune City,9759,7,4,4,6,13,17,-4,16
FC Goa,9759,8,3,3,8,10,18,-8,12
Mumbai City,9760,1,6,5,3,17,9,8,23
Delhi Dynamo,9760,2,5,7,2,26,16,10,22
Kolkata,9760,3,5,7,2,16,13,3,22
NorthEast Un,9760,4,5,4,5,10,9,1,19
Kerala Blast,9760,5,5,3,6,11,16,-5,18
FC Pune City,9760,6,4,4,6,12,15,-3,16
Chennaiyin,9760,7,3,6,5,14,19,-5,15
FC Goa,9760,8,4,2,8,11,20,-9,14
Mumbai City,9761,1,7,4,3,19,9,10,25
Delhi Dynamo,9761,2,6,5,3,26,17,9,23
Kolkata,9761,3,5,7,2,20,15,5,22
Chennaiyin,9761,4,5,5,4,20,17,3,20
FC Pune City,9761,5,4,5,5,14,16,-2,17
NorthEast Un,9761,6,5,2,7,12,17,-5,17
Kerala Blast,9761,7,4,4,6,12,19,-7,16
FC Goa,9761,8,3,2,9,9,22,-13,11
Mumbai City,9762,1,6,4,4,16,11,5,22
Delhi Dynamo,9762,2,5,6,3,24,15,9,21
FC Pune City,9762,3,6,3,5,19,14,5,21
NorthEast Un,9762,4,5,4,5,11,10,1,19
FC Goa,9762,5,5,3,6,13,14,-1,18
Kolkata,9762,6,4,6,4,16,21,-5,18
Kerala Blast,9762,7,4,4,6,11,18,-7,16
Chennaiyin,9762,8,3,6,5,13,20,-7,15
Delhi Dynamo,9763,1,6,6,2,27,15,12,24
Mumbai City,9763,2,6,5,3,17,9,8,23
Kolkata,9763,3,4,7,3,17,17,0,19
FC Pune City,9763,4,5,4,5,16,16,0,19
Kerala Blast,9763,5,5,4,5,13,14,-1,19
Chennaiyin,9763,6,3,6,5,14,20,-6,15
NorthEast Un,9763,7,4,3,7,9,15,-6,15
FC Goa,9763,8,4,3,7,12,19,-7,15
Delhi Dynamo,9764,1,7,5,2,29,14,15,26
Mumbai City,9764,2,6,4,4,16,11,5,22
Kolkata,9764,3,5,7,2,20,16,4,22
Kerala Blast,9764,4,5,4,5,14,18,-4,19
NorthEast Un,9764,5,5,2,7,12,12,0,17
Chennaiyin,9764,6,4,5,5,14,19,-5,17
FC Pune City,9764,7,4,3,7,13,20,-7,15
FC Goa,9764,8,4,2,8,13,21,-8,14
Delhi Dynamo,9765,1,6,6,2,25,16,9,24
Mumbai City,9765,2,6,4,4,17,10,7,22
Kolkata,9765,3,5,7,2,19,14,5,22
Kerala Blast,9765,4,6,4,4,15,16,-1,22
NorthEast Un,9765,5,5,2,7,11,12,-1,17
FC Pune City,9765,6,4,3,7,13,19,-6,15
FC Goa,9765,7,4,3,7,10,16,-6,15
Chennaiyin,9765,8,3,5,6,13,20,-7,14
Mumbai City,9766,1,7,4,3,18,8,10,25
Kerala Blast,9766,2,6,4,4,12,13,-1,22
Delhi Dynamo,9766,3,5,5,4,25,19,6,20
Kolkata,9766,4,4,8,2,16,14,2,20
NorthEast Un,9766,5,5,2,7,12,11,1,17
Chennaiyin,9766,6,4,5,5,15,20,-5,17
FC Pune City,9766,7,4,4,6,13,17,-4,16
FC Goa,9766,8,4,2,8,12,21,-9,14
Mumbai City,9767,1,6,5,3,16,8,8,23
Delhi Dynamo,9767,2,5,6,3,24,18,6,21
NorthEast Un,9767,3,6,2,6,16,12,4,20
Kolkata,9767,4,4,8,2,15,13,2,20
Chennaiyin,9767,5,4,6,4,17,19,-2,18
Kerala Blast,9767,6,4,5,5,10,16,-6,17
FC Pune City,9767,7,4,4,6,12,15,-3,16
FC Goa,9767,8,3,4,7,9,18,-9,13
Delhi Dynamo,9768,1,6,5,3,27,17,10,23
Mumbai City,9768,2,6,4,4,16,9,7,22
Kolkata,9768,3,5,7,2,19,15,4,22
Chennaiyin,9768,4,5,5,4,17,18,-1,20
NorthEast Un,9768,5,5,3,6,13,14,-1,18
FC Pune City,9768,6,4,5,5,13,15,-2,17
Kerala Blast,9768,7,4,5,5,10,16,-6,17
FC Goa,9768,8,3,2,9,11,22,-11,11
Mumbai City,9769,1,6,5,3,16,8,8,23
Delhi Dynamo,9769,2,5,7,2,26,15,11,22
Kerala Blast,9769,3,5,4,5,13,17,-4,19
Kolkata,9769,4,4,6,4,16,17,-1,18
Chennaiyin,9769,5,4,6,4,16,18,-2,18
FC Pune City,9769,6,5,3,6,15,17,-2,18
NorthEast Un,9769,7,4,4,6,11,15,-4,16
FC Goa,9769,8,4,3,7,13,19,-6,15
Mumbai City,9770,1,7,4,3,18,9,9,25
NorthEast Un,9770,2,7,2,5,15,10,5,23
Kolkata,9770,3,5,6,3,17,15,2,21
Delhi Dynamo,9770,4,4,6,4,25,20,5,18
FC Pune City,9770,5,5,3,6,15,17,-2,18
Kerala Blast,9770,6,5,3,6,10,15,-5,18
FC Goa,9770,7,4,3,7,12,18,-6,15
Chennaiyin,9770,8,3,5,6,14,22,-8,14
Mumbai City,9771,1,7,4,3,18,9,9,25
Delhi Dynamo,9771,2,5,6,3,24,17,7,21
Kolkata,9771,3,5,6,3,19,16,3,21
NorthEast Un,9771,4,6,3,5,13,10,3,21
FC Pune City,9771,5,6,3,5,14,14,0,21
Chennaiyin,9771,6,3,6,5,13,18,-5,15
Kerala Blast,9771,7,4,3,7,12,21,-9,15
FC Goa,9771,8,3,3,8,10,18,-8,12
Delhi Dynamo,9772,1,6,5,3,24,18,6,23
Kolkata,9772,2,5,7,2,24,13,11,22
Mumbai City,9772,3,6,4,4,16,10,6,22
NorthEast Un,9772,4,6,2,6,17,12,5,20
FC Pune City,9772,5,5,3,6,14,22,-8,18
Chennaiyin,9772,6,4,5,5,16,20,-4,17
FC Goa,9772,7,4,3,7,10,16,-6,15
Kerala Blast,9772,8,4,3,7,10,20,-10,15
Kerala Blast,9773,1,7,3,4,19,15,4,24
Mumbai City,9773,2,6,5,3,17,9,8,23
Delhi Dynamo,9773,3,5,7,2,23,15,8,22
Kolkata,9773,4,4,7,3,18,17,1,19
NorthEast Un,9773,5,4,4,6,9,12,-3,16
FC Goa,9773,6,4,3,7,13,18,-5,15
Chennaiyin,9773,7,3,6,5,14,20,-6,15
FC Pune City,9773,8,4,3,7,12,19,-7,15
Mumbai City,9774,1,7,4,3,17,8,9,25
Kolkata,9774,2,6,6,2,19,13,6,24
Chennaiyin,9774,3,4,6,4,15,18,-3,18
FC Pune City,9774,3,5,3,6,15,18,-3,18
Kerala Blast,9774,5,5,3,6,12,17,-5,18
Delhi Dynamo,9774,6,4,5,5,21,17,4,17
NorthEast Un,9774,7,5,2,7,11,12,-1,17
FC Goa,9774,8,4,3,7,10,17,-7,15
Mumbai City,9775,1,7,4,3,20,8,12,25
Delhi Dynamo,9775,2,5,6,3,23,19,4,21
FC Pune City,9775,3,6,3,5,15,15,0,21
Kerala Blast,9775,4,6,3,5,13,15,-2,21
FC Goa,9775,5,5,2,7,14,16,-2,17
Chennaiyin,9775,6,4,5,5,16,22,-6,17
NorthEast Un,9775,7,4,3,7,12,14,-2,15
Kolkata,9775,8,3,6,5,14,18,-4,15
Delhi Dynamo,9776,1,7,5,2,31,15,16,26
Mumbai City,9776,2,6,4,4,17,11,6,22
Kerala Blast,9776,3,5,4,5,13,18,-5,19
Kolkata,9776,4,4,6,4,18,16,2,18
NorthEast Un,9776,5,5,3,6,11,13,-2,18
FC Pune City,9776,6,5,3,6,15,18,-3,18
Chennaiyin,9776,7,4,5,5,16,20,-4,17
FC Goa,9776,8,4,2,8,10,20,-10,14
Mumbai City,9777,1,7,4,3,18,8,10,25
NorthEast Un,9777,2,7,2,5,17,12,5,23
Delhi Dynamo,9777,3,5,5,4,24,18,6,20
Kolkata,9777,4,4,7,3,17,14,3,19
FC Pune City,9777,5,4,5,5,15,17,-2,17
Kerala Blast,9777,6,4,4,6,12,20,-8,16
Chennaiyin,9777,7,3,6,5,16,23,-7,15
FC Goa,9777,8,4,3,7,11,18,-7,15
Delhi Dynamo,9778,1,6,6,2,26,16,10,24
Mumbai City,9778,2,6,4,4,16,10,6,22
Kolkata,9778,3,4,7,3,19,16,3,19
Kerala Blast,9778,4,5,4,5,13,17,-4,19
Chennaiyin,9778,5,4,6,4,18,19,-1,18
FC Pune City,9778,6,5,3,6,13,17,-4,18
NorthEast Un,9778,7,4,3,7,14,18,-4,15
FC Goa,9778,8,3,5,6,9,15,-6,14
Mumbai City,9779,1,6,4,4,17,10,7,22
Delhi Dynamo,9779,2,5,6,3,25,18,7,21
Kerala Blast,9779,3,5,5,4,15,18,-3,20
Kolkata,9779,4,4,7,3,19,16,3,19
FC Goa,9779,5,5,3,6,13,17,-4,18
NorthEast Un,9779,6,4,5,5,14,14,0,17
Chennaiyin,9779,7,3,7,4,15,19,-4,16
FC Pune City,9779,8,4,3,7,12,18,-6,15
Mumbai City,9780,1,7,4,3,20,8,12,25
Kolkata,9780,2,5,6,3,17,13,4,21
Kerala Blast,9780,3,6,3,5,13,16,-3,21
NorthEast Un,9780,4,6,2,6,16,12,4,20
Chennaiyin,9780,5,5,5,4,18,17,1,20
Delhi Dynamo,9780,6,4,5,5,22,26,-4,17
FC Pune City,9780,7,4,3,7,12,18,-6,15
FC Goa,9780,8,4,2,8,12,20,-8,14
Mumbai City,9781,1,7,4,3,18,9,9,25
Kolkata,9781,2,5,6,3,16,14,2,21
Kerala Blast,9781,3,6,3,5,14,15,-1,21
NorthEast Un,9781,4,6,2,6,13,12,1,20
Delhi Dynamo,9781,5,4,6,4,24,20,4,18
FC Goa,9781,6,5,3,6,15,17,-2,18
FC Pune City,9781,7,4,3,7,12,17,-5,15
Chennaiyin,9781,8,3,5,6,13,21,-8,14
Delhi Dynamo,9782,1,6,5,3,25,15,10,23
Mumbai City,9782,2,6,4,4,16,10,6,22
Kolkata,9782,3,5,6,3,19,16,3,21
FC Goa,9782,4,6,2,6,15,17,-2,20
FC Pune City,9782,5,5,3,6,13,16,-3,18
Kerala Blast,9782,6,5,3,6,12,16,-4,18
Chennaiyin,9782,7,4,5,5,15,20,-5,17
NorthEast Un,9782,8,4,2,8,9,14,-5,14
Mumbai City,9783,1,6,4,4,16,10,6,22
Delhi Dynamo,9783,2,5,5,4,25,19,6,20
NorthEast Un,9783,3,6,2,6,16,13,3,20
FC Goa,9783,4,6,2,6,13,16,-3,20
FC Pune City,9783,5,5,4,5,15,15,0,19
Kerala Blast,9783,6,5,4,5,13,18,-5,19
Chennaiyin,9783,7,4,5,5,15,19,-4,17
Kolkata,9783,8,3,6,5,17,20,-3,15
Mumbai City,9784,1,7,4,3,18,9,9,25
Kolkata,9784,2,5,7,2,20,13,7,22
Kerala Blast,9784,3,6,3,5,13,17,-4,21
Delhi Dynamo,9784,4,5,5,4,25,18,7,20
NorthEast Un,9784,5,6,2,6,12,13,-1,20
FC Pune City,9784,6,4,4,6,13,16,-3,16
FC Goa,9784,7,4,2,8,13,18,-5,14
Chennaiyin,9784,8,3,5,6,13,23,-10,14
Kolkata,9785,1,6,6,2,17,12,5,24
Mumbai City,9785,2,6,5,3,17,9,8,23
Delhi Dynamo,9785,3,5,6,3,26,18,8,21
FC Pune City,9785,4,5,3,6,15,15,0,18
Kerala Blast,9785,5,5,3,6,12,17,-5,18
FC Goa,9785,6,5,2,7,14,18,-4,17
NorthEast Un,9785,7,4,3,7,10,15,-5,15
Chennaiyin,9785,8,3,6,5,14,21,-7,15
Mumbai City,9786,1,7,4,3,22,9,13,25
Delhi Dynamo,9786,2,6,5,3,26,21,5,23
Chennaiyin,9786,3,5,5,4,17,17,0,20
Kolkata,9786,4,4,7,3,17,16,1,19
Kerala Blast,9786,5,5,4,5,13,17,-4,19
FC Pune City,9786,6,4,4,6,14,18,-4,16
NorthEast Un,9786,7,4,3,7,9,12,-3,15
FC Goa,9786,8,4,2,8,11,19,-8,14
Mumbai City,9787,1,7,4,3,18,8,10,25
Delhi Dynamo,9787,2,5,5,4,24,18,6,20
Chennaiyin,9787,3,5,5,4,16,18,-2,20
Kerala Blast,9787,4,5,5,4,12,15,-3,20
Kolkata,9787,5,3,8,3,17,17,0,17
FC Pune City,9787,6,4,5,5,15,17,-2,17
FC Goa,9787,7,5,2,7,13,18,-5,17
NorthEast Un,9787,8,4,2,8,9,13,-4,14
Mumbai City,9788,1,7,4,3,18,9,9,25
Kolkata,9788,2,5,7,2,19,13,6,22
Delhi Dynamo,9788,3,4,7,3,23,17,6,19
NorthEast Un,9788,4,5,4,5,12,9,3,19
FC Pune City,9788,5,5,4,5,15,15,0,19
Chennaiyin,9788,6,4,5,5,14,20,-6,17
Kerala Blast,9788,7,4,4,6,9,18,-9,16
FC Goa,9788,8,3,3,8,9,18,-9,12
Mumbai City,9789,1,7,4,3,18,8,10,25
Delhi Dynamo,9789,2,6,5,3,25,16,9,23
Kolkata,9789,3,5,6,3,17,15,2,21
FC Pune City,9789,4,5,3,6,16,16,0,18
Chennaiyin,9789,5,4,6,4,14,17,-3,18
Kerala Blast,9789,6,5,3,6,10,17,-7,18
NorthEast Un,9789,7,4,3,7,9,12,-3,15
FC Goa,9789,8,4,2,8,10,18,-8,14
Mumbai City,9790,1,6,5,3,17,9,8,23
Kerala Blast,9790,2,6,4,4,14,14,0,22
Delhi Dynamo,9790,3,5,6,3,26,19,7,21
NorthEast Un,9790,4,5,3,6,12,12,0,18
FC Pune City,9790,5,5,3,6,14,17,-3,18
Kolkata,9790,6,3,8,3,14,14,0,17
Chennaiyin,9790,7,3,7,4,14,18,-4,16
FC Goa,9790,8,3,4,7,11,19,-8,13
Kolkata,9791,1,6,6,2,19,14,5,24
Mumbai City,9791,2,6,5,3,16,8,8,23
Delhi Dynamo,9791,3,4,7,3,24,18,6,19
NorthEast Un,9791,4,5,4,5,11,10,1,19
Kerala Blast,9791,5,5,4,5,11,15,-4,19
FC Pune City,9791,6,4,3,7,13,17,-4,15
FC Goa,9791,7,4,3,7,15,20,-5,15
Chennaiyin,9791,8,3,6,5,13,20,-7,15
Mumbai City,9792,1,7,4,3,18,8,10,25
Delhi Dynamo,9792,2,5,6,3,23,16,7,21
Kolkata,9792,3,5,6,3,16,14,2,21
FC Pune City,9792,4,5,3,6,15,17,-2,18
FC Goa,9792,5,5,3,6,10,14,-4,18
Kerala Blast,9792,6,5,3,6,11,16,-5,18
Chennaiyin,9792,7,4,5,5,15,19,-4,17
NorthEast Un,9792,8,4,2,8,10,14,-4,14
Mumbai City,9793,1,6,5,3,17,9,8,23
Kerala Blast,9793,2,6,4,4,13,15,-2,22
Delhi Dynamo,9793,3,5,6,3,25,18,7,21
NorthEast Un,9793,4,6,2,6,13,11,2,20
FC Pune City,9793,5,5,3,6,14,16,-2,18
Kolkata,9793,6,3,8,3,16,16,0,17
Chennaiyin,9793,7,4,5,5,16,18,-2,17
FC Goa,9793,8,3,3,8,10,21,-11,12
Mumbai City,9794,1,7,4,3,19,8,11,25
Kerala Blast,9794,2,6,4,4,14,15,-1,22
NorthEast Un,9794,3,6,2,6,18,15,3,20
Delhi Dynamo,9794,4,5,5,4,24,22,2,20
Kolkata,9794,5,4,8,2,18,16,2,20
Chennaiyin,9794,6,4,5,5,18,22,-4,17
FC Pune City,9794,7,4,4,6,15,18,-3,16
FC Goa,9794,8,3,2,9,10,20,-10,11
Delhi Dynamo,9795,1,6,6,2,25,15,10,24
Kolkata,9795,2,6,6,2,18,12,6,24
Mumbai City,9795,3,6,5,3,17,9,8,23
Kerala Blast,9795,4,5,4,5,15,19,-4,19
Chennaiyin,9795,5,4,5,5,17,20,-3,17
FC Pune City,9795,6,4,4,6,14,18,-4,16
NorthEast Un,9795,7,4,2,8,14,19,-5,14
FC Goa,9795,8,4,2,8,9,17,-8,14
Mumbai City,9796,1,6,5,3,17,9,8,23
NorthEast Un,9796,2,7,2,5,20,15,5,23
Delhi Dynamo,9796,3,5,6,3,27,19,8,21
FC Pune City,9796,4,6,3,5,16,14,2,21
Kolkata,9796,5,4,7,3,16,17,-1,19
Chennaiyin,9796,6,4,5,5,17,20,-3,17
Kerala Blast,9796,7,4,3,7,12,20,-8,15
FC Goa,9796,8,3,3,8,9,20,-11,12
Mumbai City,9797,1,7,4,3,18,9,9,25
NorthEast Un,9797,2,6,3,5,15,13,2,21
FC Pune City,9797,3,6,3,5,15,14,1,21
Kolkata,9797,4,4,7,3,15,13,2,19
Delhi Dynamo,9797,5,4,5,5,23,20,3,17
Chennaiyin,9797,6,3,7,4,17,21,-4,16
FC Goa,9797,7,4,4,6,11,15,-4,16
Kerala Blast,9797,8,4,3,7,9,18,-9,15
Mumbai City,9798,1,7,4,3,18,9,9,25
Chennaiyin,9798,2,5,5,4,16,17,-1,20
Kerala Blast,9798,3,5,5,4,14,17,-3,20
Delhi Dynamo,9798,4,4,7,3,23,17,6,19
FC Pune City,9798,5,5,4,5,15,16,-1,19
Kolkata,9798,6,3,8,3,15,15,0,17
NorthEast Un,9798,7,4,3,7,9,11,-2,15
FC Goa,9798,8,3,4,7,9,17,-8,13
Mumbai City,9799,1,6,5,3,19,11,8,23
Delhi Dynamo,9799,2,5,6,3,27,19,8,21
Kolkata,9799,3,5,6,3,18,16,2,21
NorthEast Un,9799,4,6,2,6,14,12,2,20
FC Pune City,9799,5,5,3,6,16,18,-2,18
Chennaiyin,9799,6,4,6,4,17,20,-3,18
Kerala Blast,9799,7,5,3,6,14,19,-5,18
FC Goa,9799,8,3,3,8,11,21,-10,12
Mumbai City,9800,1,7,4,3,18,8,10,25
Delhi Dynamo,9800,2,5,5,4,23,17,6,20
Kolkata,9800,3,4,8,2,18,16,2,20
Chennaiyin,9800,4,5,5,4,18,19,-1,20
NorthEast Un,9800,5,5,2,7,11,14,-3,17
Kerala Blast,9800,6,4,5,5,12,17,-5,17
FC Pune City,9800,7,4,4,6,15,18,-3,16
FC Goa,9800,8,4,3,7,10,16,-6,15
Mumbai City,9801,1,7,4,3,19,8,11,25
Kerala Blast,9801,2,5,5,4,13,15,-2,20
NorthEast Un,9801,3,5,4,5,12,11,1,19
Delhi Dynamo,9801,4,4,6,4,23,20,3,18
FC Pune City,9801,5,5,3,6,14,16,-2,18
Kolkata,9801,6,3,8,3,14,15,-1,17
FC Goa,9801,7,4,4,6,12,17,-5,16
Chennaiyin,9801,8,3,6,5,15,20,-5,15
Mumbai City,9802,1,6,5,3,17,9,8,23
Delhi Dynamo,9802,2,5,7,2,26,17,9,22
Kerala Blast,9802,3,6,4,4,13,13,0,22
Kolkata,9802,4,3,8,3,16,16,0,17
NorthEast Un,9802,5,4,5,5,12,12,0,17
Chennaiyin,9802,6,3,7,4,16,20,-4,16
FC Pune City,9802,7,4,4,6,14,19,-5,16
FC Goa,9802,8,3,4,7,11,19,-8,13
Mumbai City,9803,1,6,5,3,16,8,8,23
Kolkata,9803,2,5,7,2,20,14,6,22
NorthEast Un,9803,3,6,3,5,15,13,2,21
FC Pune City,9803,4,5,4,5,14,14,0,19
Delhi Dynamo,9803,5,4,6,4,23,19,4,18
FC Goa,9803,6,5,2,7,13,18,-5,17
Chennaiyin,9803,7,3,6,5,15,20,-5,15
Kerala Blast,9803,8,4,3,7,9,19,-10,15
Mumbai City,9804,1,6,5,3,17,9,8,23
NorthEast Un,9804,2,6,3,5,20,13,7,21
Delhi Dynamo,9804,3,5,6,3,24,21,3,21
Kerala Blast,9804,4,5,5,4,13,16,-3,20
Kolkata,9804,5,4,7,3,14,13,1,19
Chennaiyin,9804,6,4,5,5,17,20,-3,17
FC Pune City,9804,7,4,3,7,13,17,-4,15
FC Goa,9804,8,4,2,8,9,18,-9,14
Mumbai City,9805,1,7,4,3,18,8,10,25
Kolkata,9805,2,5,7,2,20,16,4,22
Delhi Dynamo,9805,3,5,5,4,23,18,5,20
NorthEast Un,9805,4,5,4,5,12,11,1,19
FC Pune City,9805,5,5,4,5,16,16,0,19
Chennaiyin,9805,6,4,6,4,14,17,-3,18
Kerala Blast,9805,7,4,4,6,13,21,-8,16
FC Goa,9805,8,3,2,9,9,18,-9,11
Kolkata,9806,1,6,6,2,23,17,6,24
Delhi Dynamo,9806,2,6,5,3,27,19,8,23
Mumbai City,9806,3,6,4,4,17,11,6,22
NorthEast Un,9806,4,5,3,6,13,13,0,18
Chennaiyin,9806,5,4,6,4,15,18,-3,18
FC Pune City,9806,6,4,4,6,15,20,-5,16
Kerala Blast,9806,7,4,4,6,13,19,-6,16
FC Goa,9806,8,4,2,8,12,18,-6,14
Mumbai City,9807,1,7,4,3,18,8,10,25
NorthEast Un,9807,2,6,2,6,14,10,4,20
Delhi Dynamo,9807,3,5,5,4,22,19,3,20
Kerala Blast,9807,4,5,5,4,12,15,-3,20
Kolkata,9807,5,4,7,3,16,14,2,19
FC Goa,9807,6,5,2,7,11,16,-5,17
FC Pune City,9807,7,4,4,6,13,17,-4,16
Chennaiyin,9807,8,3,5,6,14,21,-7,14
Delhi Dynamo,9808,1,6,5,3,26,18,8,23
Mumbai City,9808,2,6,4,4,16,10,6,22
Kerala Blast,9808,3,6,4,4,13,14,-1,22
Kolkata,9808,4,4,7,3,19,17,2,19
NorthEast Un,9808,5,5,3,6,13,12,1,18
Chennaiyin,9808,6,4,6,4,14,17,-3,18
FC Pune City,9808,7,4,4,6,14,18,-4,16
FC Goa,9808,8,3,3,8,9,18,-9,12
Mumbai City,9809,1,6,5,3,17,9,8,23
Delhi Dynamo,9809,2,5,6,3,23,16,7,21
Kerala Blast,9809,3,5,4,5,12,16,-4,19
NorthEast Un,9809,4,5,3,6,13,13,0,18
Chennaiyin,9809,5,4,6,4,16,19,-3,18
Kolkata,9809,6,3,8,3,14,14,0,17
FC Goa,9809,7,5,2,7,12,17,-5,17
FC Pune City,9809,8,4,4,6,12,15,-3,16
Mumbai City,9810,1,7,4,3,19,8,11,25
Kerala Blast,9810,2,7,3,4,18,18,0,24
Kolkata,9810,3,5,6,3,19,17,2,21
Delhi Dynamo,9810,4,5,5,4,24,20,4,20
NorthEast Un,9810,5,5,2,7,12,13,-1,17
Chennaiyin,9810,6,3,6,5,14,19,-5,15
FC Pune City,9810,7,4,3,7,12,17,-5,15
FC Goa,9810,8,4,3,7,13,19,-6,15
Mumbai City,9811,1,6,5,3,16,8,8,23
NorthEast Un,9811,2,6,3,5,13,10,3,21
Delhi Dynamo,9811,3,4,8,2,23,16,7,20
FC Pune City,9811,4,5,4,5,18,17,1,19
Kolkata,9811,5,3,9,2,17,16,1,18
Kerala Blast,9811,6,4,4,6,11,19,-8,16
Chennaiyin,9811,7,3,6,5,14,20,-6,15
FC Goa,9811,8,3,5,6,11,17,-6,14
Mumbai City,9812,1,6,5,3,16,8,8,23
Kerala Blast,9812,2,6,4,4,17,16,1,22
Chennaiyin,9812,3,5,5,4,17,17,0,20
Kolkata,9812,4,4,7,3,17,17,0,19
Delhi Dynamo,9812,5,4,6,4,22,18,4,18
NorthEast Un,9812,6,5,3,6,13,13,0,18
FC Pune City,9812,7,4,3,7,15,21,-6,15
FC Goa,9812,8,4,3,7,11,18,-7,15
Mumbai City,9813,1,7,4,3,19,8,11,25
Delhi Dynamo,9813,2,6,5,3,24,17,7,23
Kolkata,9813,3,4,7,3,17,17,0,19
Kerala Blast,9813,4,5,4,5,14,17,-3,19
NorthEast Un,9813,5,5,2,7,13,14,-1,17
FC Pune City,9813,6,4,5,5,16,18,-2,17
FC Goa,9813,7,5,2,7,13,15,-2,17
Chennaiyin,9813,8,3,5,6,13,23,-10,14
Mumbai City,9814,1,6,5,3,18,10,8,23
Delhi Dynamo,9814,2,5,6,3,26,19,7,21
NorthEast Un,9814,3,6,2,6,13,13,0,20
Kolkata,9814,4,4,7,3,18,15,3,19
Kerala Blast,9814,5,5,4,5,12,15,-3,19
Chennaiyin,9814,6,4,5,5,17,20,-3,17
FC Goa,9814,7,5,2,7,14,19,-5,17
FC Pune City,9814,8,4,3,7,13,20,-7,15
Mumbai City,9815,1,7,4,3,18,9,9,25
Kerala Blast,9815,2,6,3,5,13,16,-3,21
Delhi Dynamo,9815,3,5,5,4,25,19,6,20
NorthEast Un,9815,4,6,2,6,16,14,2,20
Kolkata,9815,5,4,6,4,15,15,0,18
FC Goa,9815,6,5,2,7,14,17,-3,17
Chennaiyin,9815,7,4,5,5,17,22,-5,17
FC Pune City,9815,8,4,3,7,12,18,-6,15
Delhi Dynamo,9816,1,6,5,3,26,18,8,23
Mumbai City,9816,2,6,4,4,16,10,6,22
FC Pune City,9816,3,5,4,5,15,14,1,19
Kerala Blast,9816,4,5,4,5,10,15,-5,19
NorthEast Un,9816,5,5,3,6,11,10,1,18
Kolkata,9816,6,4,6,4,16,17,-1,18
Chennaiyin,9816,7,4,6,4,15,17,-2,18
FC Goa,9816,8,4,2,8,12,20,-8,14
Kolkata,9817,1,6,6,2,19,13,6,24
Delhi Dynamo,9817,2,6,5,3,23,18,5,23
Mumbai City,9817,3,6,4,4,16,9,7,22
NorthEast Un,9817,4,6,3,5,15,10,5,21
Kerala Blast,9817,5,5,3,6,12,17,-5,18
Chennaiyin,9817,6,3,6,5,15,21,-6,15
FC Pune City,9817,7,4,3,7,13,19,-6,15
FC Goa,9817,8,4,2,8,11,17,-6,14
Mumbai City,9818,1,7,4,3,18,8,10,25
Kerala Blast,9818,2,7,3,4,15,15,0,24
Delhi Dynamo,9818,3,4,6,4,23,20,3,18
Kolkata,9818,4,4,6,4,16,17,-1,18
FC Pune City,9818,5,5,3,6,14,15,-1,18
Chennaiyin,9818,6,4,5,5,15,19,-4,17
FC Goa,9818,7,5,2,7,13,17,-4,17
NorthEast Un,9818,8,4,3,7,10,13,-3,15
Mumbai City,9819,1,7,4,3,17,8,9,25
Kerala Blast,9819,2,6,4,4,13,14,-1,22
Kolkata,9819,3,4,7,3,14,14,0,19
Delhi Dynamo,9819,4,4,6,4,22,18,4,18
FC Goa,9819,5,5,3,6,14,14,0,18
NorthEast Un,9819,6,4,4,6,11,12,-1,16
FC Pune City,9819,7,4,4,6,13,16,-3,16
Chennaiyin,9819,8,3,6,5,14,22,-8,15
Mumbai City,9820,1,6,5,3,17,9,8,23
NorthEast Un,9820,2,7,2,5,13,10,3,23
Kerala Blast,9820,3,6,3,5,14,17,-3,21
Delhi Dynamo,9820,4,4,6,4,22,18,4,18
FC Pune City,9820,5,5,3,6,17,18,-1,18
Chennaiyin,9820,6,4,5,5,18,21,-3,17
Kolkata,9820,7,3,7,4,16,18,-2,16
FC Goa,9820,8,4,3,7,13,19,-6,15
Mumbai City,9821,1,7,4,3,17,8,9,25
Kolkata,9821,2,6,6,2,18,13,5,24
NorthEast Un,9821,3,6,3,5,14,10,4,21
Delhi Dynamo,9821,4,5,5,4,24,19,5,20
Chennaiyin,9821,5,4,5,5,15,18,-3,17
Kerala Blast,9821,6,4,5,5,10,15,-5,17
FC Pune City,9821,7,4,4,6,12,15,-3,16
FC Goa,9821,8,3,2,9,8,20,-12,11
Mumbai City,9822,1,6,5,3,17,9,8,23
Delhi Dynamo,9822,2,5,7,2,26,15,11,22
Kerala Blast,9822,3,6,4,4,14,13,1,22
Kolkata,9822,4,4,8,2,15,13,2,20
Chennaiyin,9822,5,4,6,4,14,17,-3,18
NorthEast Un,9822,6,4,3,7,9,12,-3,15
FC Pune City,9822,7,4,3,7,12,18,-6,15
FC Goa,9822,8,3,4,7,9,19,-10,13
Mumbai City,9823,1,7,4,3,22,8,14,25
Kolkata,9823,2,5,7,2,16,12,4,22
FC Goa,9823,3,5,3,6,13,15,-2,18
FC Pune City,9823,3,5,3,6,13,15,-2,18
NorthEast Un,9823,5,5,3,6,12,15,-3,18
Chennaiyin,9823,6,4,5,5,18,19,-1,17
Delhi Dynamo,9823,7,4,5,5,22,25,-3,17
Kerala Blast,9823,8,4,4,6,10,17,-7,16
Mumbai City,9824,1,6,5,3,18,10,8,23
Kolkata,9824,2,5,7,2,17,13,4,22
Delhi Dynamo,9824,3,5,6,3,25,18,7,21
Kerala Blast,9824,4,5,5,4,13,16,-3,20
NorthEast Un,9824,5,5,3,6,11,11,0,18
Chennaiyin,9824,6,4,6,4,16,19,-3,18
FC Pune City,9824,7,4,3,7,13,17,-4,15
FC Goa,9824,8,3,3,8,11,20,-9,12
Mumbai City,9825,1,6,5,3,17,9,8,23
Delhi Dynamo,9825,2,5,7,2,24,15,9,22
Kolkata,9825,3,4,7,3,17,14,3,19
FC Pune City,9825,4,5,4,5,14,15,-1,19
Kerala Blast,9825,5,5,4,5,12,18,-6,19
NorthEast Un,9825,6,4,4,6,11,12,-1,16
Chennaiyin,9825,7,3,6,5,14,19,-5,15
FC Goa,9825,8,4,3,7,10,17,-7,15
Mumbai City,9826,1,6,5,3,17,9,8,23
Delhi Dynamo,9826,2,5,6,3,25,18,7,21
NorthEast Un,9826,3,6,3,5,16,13,3,21
Kerala Blast,9826,4,5,5,4,14,16,-2,20
Kolkata,9826,5,3,8,3,17,18,-1,17
FC Pune City,9826,6,4,5,5,16,18,-2,17
FC Goa,9826,7,4,3,7,11,18,-7,15
Chennaiyin,9826,8,3,5,6,15,21,-6,14
Mumbai City,9827,1,7,4,3,19,9,10,25
Delhi Dynamo,9827,2,5,5,4,26,19,7,20
NorthEast Un,9827,3,5,4,5,13,11,2,19
FC Pune City,9827,4,5,4,5,15,16,-1,19
Kolkata,9827,5,3,9,2,20,19,1,18
Kerala Blast,9827,6,4,5,5,13,18,-5,17
FC Goa,9827,7,4,3,7,16,21,-5,15
Chennaiyin,9827,8,3,6,5,15,24,-9,15
Mumbai City,9828,1,7,4,3,18,8,10,25
Delhi Dynamo,9828,2,6,5,3,26,19,7,23
Kolkata,9828,3,5,6,3,18,15,3,21
Chennaiyin,9828,4,5,5,4,17,18,-1,20
Kerala Blast,9828,5,5,4,5,13,17,-4,19
FC Pune City,9828,6,4,4,6,14,17,-3,16
NorthEast Un,9828,7,4,2,8,11,16,-5,14
FC Goa,9828,8,4,2,8,13,20,-7,14
Mumbai City,9829,1,7,4,3,20,8,12,25
Kolkata,9829,2,4,8,2,18,16,2,20
FC Pune City,9829,3,5,4,5,14,15,-1,19
Delhi Dynamo,9829,4,4,6,4,22,20,2,18
NorthEast Un,9829,5,5,3,6,12,12,0,18
Chennaiyin,9829,6,4,5,5,14,18,-4,17
Kerala Blast,9829,7,4,5,5,12,17,-5,17
FC Goa,9829,8,4,3,7,10,16,-6,15
Mumbai City,9830,1,6,5,3,17,9,8,23
Delhi Dynamo,9830,2,5,6,3,24,19,5,21
Kerala Blast,9830,3,6,3,5,15,16,-1,21
NorthEast Un,9830,4,6,2,6,18,13,5,20
FC Pune City,9830,5,5,3,6,16,18,-2,18
Kolkata,9830,6,4,6,4,16,19,-3,18
FC Goa,9830,7,5,2,7,13,17,-4,17
Chennaiyin,9830,8,3,5,6,15,23,-8,14
Mumbai City,9831,1,7,4,3,19,9,10,25
NorthEast Un,9831,2,7,2,5,16,11,5,23
Delhi Dynamo,9831,3,5,5,4,26,23,3,20
Kolkata,9831,4,4,7,3,15,14,1,19
FC Pune City,9831,5,5,4,5,14,15,-1,19
FC Goa,9831,6,5,2,7,13,17,-4,17
Kerala Blast,9831,7,4,3,7,10,17,-7,15
Chennaiyin,9831,8,3,5,6,13,20,-7,14
Mumbai City,9832,1,7,4,3,19,8,11,25
Kolkata,9832,2,5,6,3,18,17,1,21
Delhi Dynamo,9832,3,5,5,4,23,19,4,20
NorthEast Un,9832,4,5,4,5,12,10,2,19
Kerala Blast,9832,5,5,4,5,14,19,-5,19
FC Pune City,9832,6,5,3,6,17,17,0,18
Chennaiyin,9832,7,3,6,5,13,19,-6,15
FC Goa,9832,8,4,2,8,11,18,-7,14
Mumbai City,9833,1,7,4,3,18,9,9,25
Delhi Dynamo,9833,2,5,6,3,27,19,8,21
NorthEast Un,9833,3,6,2,6,15,15,0,20
Kolkata,9833,4,4,7,3,20,18,2,19
FC Pune City,9833,5,5,4,5,18,18,0,19
Kerala Blast,9833,6,4,5,5,13,18,-5,17
FC Goa,9833,7,4,3,7,12,20,-8,15
Chennaiyin,9833,8,3,5,6,15,21,-6,14
Delhi Dynamo,9834,1,6,6,2,25,15,10,24
Mumbai City,9834,2,6,4,4,17,10,7,22
Kerala Blast,9834,3,5,5,4,13,16,-3,20
Kolkata,9834,4,4,7,3,18,15,3,19
FC Goa,9834,5,5,3,6,12,15,-3,18
NorthEast Un,9834,6,4,4,6,13,15,-2,16
Chennaiyin,9834,7,3,6,5,15,21,-6,15
FC Pune City,9834,8,4,3,7,12,18,-6,15
Mumbai City,9835,1,7,4,3,18,8,10,25
Delhi Dynamo,9835,2,5,5,4,26,18,8,20
Kolkata,9835,3,4,7,3,14,13,1,19
Kerala Blast,9835,4,5,4,5,11,15,-4,19
NorthEast Un,9835,5,5,3,6,11,11,0,18
FC Pune City,9835,6,5,3,6,14,16,-2,18
Chennaiyin,9835,7,4,6,4,14,17,-3,18
FC Goa,9835,8,4,2,8,9,19,-10,14
Mumbai City,9836,1,6,5,3,17,9,8,23
Delhi Dynamo,9836,2,5,7,2,25,17,8,22
Kolkata,9836,3,4,8,2,17,15,2,20
Chennaiyin,9836,4,4,6,4,15,17,-2,18
Kerala Blast,9836,5,4,6,4,11,15,-4,18
NorthEast Un,9836,6,4,4,6,10,11,-1,16
FC Pune City,9836,7,4,4,6,13,16,-3,16
FC Goa,9836,8,3,4,7,11,19,-8,13
Delhi Dynamo,9837,1,6,5,3,26,16,10,23
Mumbai City,9837,2,6,4,4,16,9,7,22
Kolkata,9837,3,5,7,2,18,14,4,22
NorthEast Un,9837,4,6,3,5,13,9,4,21
Kerala Blast,9837,5,5,4,5,12,15,-3,19
FC Pune City,9837,6,4,3,7,13,19,-6,15
FC Goa,9837,7,4,3,7,13,21,-8,15
Chennaiyin,9837,8,3,5,6,14,22,-8,14
Delhi Dynamo,9838,1,6,6,2,28,18,10,24
Mumbai City,9838,2,6,5,3,17,9,8,23
Kolkata,9838,3,5,7,2,18,15,3,22
Kerala Blast,9838,4,5,4,5,13,16,-3,19
Chennaiyin,9838,5,4,6,4,18,20,-2,18
NorthEast Un,9838,6,5,2,7,13,16,-3,17
FC Pune City,9838,7,4,3,7,12,17,-5,15
FC Goa,9838,8,3,3,8,12,20,-8,12
Mumbai City,9839,1,6,5,3,17,9,8,23
Delhi Dynamo,9839,2,5,6,3,27,17,10,21
FC Pune City,9839,3,6,3,5,16,16,0,21
Kolkata,9839,4,4,7,3,16,15,1,19
Kerala Blast,9839,5,5,3,6,15,17,-2,18
Chennaiyin,9839,6,4,5,5,16,20,-4,17
NorthEast Un,9839,7,5,2,7,12,16,-4,17
FC Goa,9839,8,4,3,7,12,21,-9,15
Mumbai City,9840,1,6,5,3,17,9,8,23
Delhi Dynamo,9840,2,5,7,2,27,17,10,22
Kerala Blast,9840,3,6,4,4,14,15,-1,22
Chennaiyin,9840,4,4,6,4,16,18,-2,18
Kolkata,9840,5,4,6,4,15,17,-2,18
FC Pune City,9840,6,4,4,6,14,17,-3,16
FC Goa,9840,7,4,4,6,13,16,-3,16
NorthEast Un,9840,8,4,2,8,11,18,-7,14
Kolkata,9841,1,6,6,2,18,13,5,24
Delhi Dynamo,9841,2,6,5,3,26,18,8,23
NorthEast Un,9841,3,7,2,5,15,9,6,23
Mumbai City,9841,4,6,4,4,17,10,7,22
FC Pune City,9841,5,4,4,6,14,17,-3,16
Kerala Blast,9841,6,4,4,6,10,16,-6,16
Chennaiyin,9841,7,3,6,5,14,21,-7,15
FC Goa,9841,8,3,3,8,10,20,-10,12
Delhi Dynamo,9842,1,5,7,2,27,18,9,22
Mumbai City,9842,2,6,4,4,16,10,6,22
Kolkata,9842,3,5,7,2,20,15,5,22
Kerala Blast,9842,4,6,3,5,13,17,-4,21
NorthEast Un,9842,5,5,3,6,13,13,0,18
FC Pune City,9842,6,4,4,6,13,16,-3,16
FC Goa,9842,7,4,3,7,13,18,-5,15
Chennaiyin,9842,8,3,5,6,13,21,-8,14
Mumbai City,9843,1,6,5,3,17,9,8,23
NorthEast Un,9843,2,7,2,5,15,10,5,23
Delhi Dynamo,9843,3,5,6,3,28,19,9,21
FC Pune City,9843,4,5,4,5,16,15,1,19
Kolkata,9843,5,3,9,2,16,15,1,18
Chennaiyin,9843,6,4,5,5,15,19,-4,17
Kerala Blast,9843,7,4,4,6,11,20,-9,16
FC Goa,9843,8,3,3,8,10,21,-11,12
Mumbai City,9844,1,6,5,3,18,10,8,23
Delhi Dynamo,9844,2,5,7,2,25,17,8,22
Kolkata,9844,3,5,7,2,20,13,7,22
Kerala Blast,9844,4,6,3,5,12,15,-3,21
NorthEast Un,9844,5,5,2,7,11,12,-1,17
FC Pune City,9844,6,4,4,6,12,15,-3,16
Chennaiyin,9844,7,3,6,5,16,21,-5,15
FC Goa,9844,8,3,4,7,11,22,-11,13
Delhi Dynamo,9845,1,6,6,2,28,17,11,24
Mumbai City,9845,2,6,4,4,18,11,7,22
Kolkata,9845,3,5,7,2,17,14,3,22
NorthEast Un,9845,4,5,3,6,10,12,-2,18
Kerala Blast,9845,5,5,3,6,11,16,-5,18
FC Goa,9845,6,4,4,6,11,16,-5,16
FC Pune City,9845,7,4,3,7,14,18,-4,15
Chennaiyin,9845,8,3,6,5,13,18,-5,15
Delhi Dynamo,9846,1,6,6,2,28,17,11,24
Mumbai City,9846,2,6,5,3,17,9,8,23
Kerala Blast,9846,3,6,3,5,11,15,-4,21
NorthEast Un,9846,4,5,3,6,13,13,0,18
Kolkata,9846,5,3,7,4,13,15,-2,16
FC Pune City,9846,6,4,4,6,12,15,-3,16
Chennaiyin,9846,7,3,7,4,15,19,-4,16
FC Goa,9846,8,4,3,7,12,18,-6,15
Delhi Dynamo,9847,1,6,6,2,29,17,12,24
Mumbai City,9847,2,6,5,3,17,9,8,23
Kolkata,9847,3,4,8,2,17,15,2,20
Kerala Blast,9847,4,5,5,4,12,15,-3,20
NorthEast Un,9847,5,5,3,6,13,13,0,18
Chennaiyin,9847,6,4,5,5,17,20,-3,17
FC Pune City,9847,7,4,3,7,13,17,-4,15
FC Goa,9847,8,3,3,8,11,23,-12,12
Mumbai City,9848,1,7,4,3,18,8,10,25
Kolkata,9848,2,5,6,3,19,16,3,21
Kerala Blast,9848,3,6,3,5,15,17,-2,21
Chennaiyin,9848,4,5,5,4,16,17,-1,20
Delhi Dynamo,9848,5,4,6,4,21,17,4,18
NorthEast Un,9848,6,5,2,7,10,13,-3,17
FC Pune City,9848,7,4,3,7,13,18,-5,15
FC Goa,9848,8,4,3,7,11,17,-6,15
Delhi Dynamo,9849,1,6,6,2,23,14,9,24
Kerala Blast,9849,2,7,3,4,16,14,2,24
Mumbai City,9849,3,6,5,3,16,8,8,23
Kolkata,9849,4,4,6,4,18,18,0,18
FC Pune City,9849,5,5,3,6,15,20,-5,18
Chennaiyin,9849,6,4,5,5,16,20,-4,17
NorthEast Un,9849,7,4,2,8,10,13,-3,14
FC Goa,9849,8,4,2,8,11,18,-7,14
Delhi Dynamo,9850,1,7,5,2,28,15,13,26
Mumbai City,9850,2,6,4,4,17,10,7,22
Kolkata,9850,3,5,6,3,17,13,4,21
FC Pune City,9850,4,5,4,5,13,14,-1,19
NorthEast Un,9850,5,5,3,6,10,10,0,18
Chennaiyin,9850,6,4,6,4,15,18,-3,18
Kerala Blast,9850,7,4,4,6,9,15,-6,16
FC Goa,9850,8,3,2,9,9,23,-14,11
Delhi Dynamo,9851,1,6,6,2,27,15,12,24
Mumbai City,9851,2,6,4,4,17,10,7,22
Kolkata,9851,3,5,7,2,18,13,5,22
NorthEast Un,9851,4,5,3,6,11,10,1,18
FC Pune City,9851,5,5,3,6,13,16,-3,18
Kerala Blast,9851,6,5,3,6,10,16,-6,18
Chennaiyin,9851,7,4,5,5,14,19,-5,17
FC Goa,9851,8,3,3,8,9,20,-11,12
Mumbai City,9852,1,7,4,3,19,9,10,25
Kolkata,9852,2,6,6,2,19,14,5,24
Kerala Blast,9852,3,5,4,5,15,19,-4,19
Delhi Dynamo,9852,4,4,5,5,23,21,2,17
NorthEast Un,9852,5,5,2,7,12,14,-2,17
Chennaiyin,9852,6,4,5,5,16,20,-4,17
FC Goa,9852,7,5,2,7,14,18,-4,17
FC Pune City,9852,8,4,4,6,14,17,-3,16
Delhi Dynamo,9853,1,6,5,3,26,18,8,23
Mumbai City,9853,2,6,4,4,17,10,7,22
FC Pune City,9853,3,6,3,5,20,15,5,21
Kerala Blast,9853,4,6,3,5,13,19,-6,21
NorthEast Un,9853,5,5,3,6,13,13,0,18
Chennaiyin,9853,6,4,6,4,15,18,-3,18
Kolkata,9853,7,3,6,5,16,20,-4,15
FC Goa,9853,8,4,2,8,11,18,-7,14
Mumbai City,9854,1,7,4,3,18,9,9,25
NorthEast Un,9854,2,7,2,5,15,9,6,23
Kolkata,9854,3,5,7,2,19,14,5,22
Delhi Dynamo,9854,4,4,6,4,23,20,3,18
FC Pune City,9854,5,5,3,6,14,18,-4,18
FC Goa,9854,6,4,4,6,14,18,-4,16
Kerala Blast,9854,7,4,3,7,9,17,-8,15
Chennaiyin,9854,8,3,5,6,15,22,-7,14
Mumbai City,9855,1,7,4,3,19,9,10,25
Kolkata,9855,2,5,6,3,20,17,3,21
Delhi Dynamo,9855,3,5,5,4,24,18,6,20
FC Goa,9855,4,6,2,6,16,16,0,20
Kerala Blast,9855,5,5,4,5,14,20,-6,19
NorthEast Un,9855,6,5,3,6,11,12,-1,18
FC Pune City,9855,7,4,3,7,15,19,-4,15
Chennaiyin,9855,8,3,5,6,14,22,-8,14
Mumbai City,9856,1,7,4,3,18,9,9,25
NorthEast Un,9856,2,6,3,5,17,14,3,21
Delhi Dynamo,9856,3,4,7,3,25,19,6,19
Kerala Blast,9856,4,5,4,5,12,15,-3,19
FC Pune City,9856,5,4,5,5,16,18,-2,17
Chennaiyin,9856,6,4,5,5,16,21,-5,17
Kolkata,9856,7,3,7,4,17,19,-2,16
FC Goa,9856,8,4,3,7,10,16,-6,15
Mumbai City,9857,1,7,4,3,18,9,9,25
Kerala Blast,9857,2,6,3,5,16,16,0,21
Delhi Dynamo,9857,3,5,5,4,24,20,4,20
Kolkata,9857,4,4,8,2,17,15,2,20
FC Goa,9857,5,5,3,6,13,15,-2,18
Chennaiyin,9857,6,4,5,5,16,18,-2,17
FC Pune City,9857,7,4,4,6,14,19,-5,16
NorthEast Un,9857,8,4,2,8,12,18,-6,14
Mumbai City,9858,1,7,4,3,20,9,11,25
Kolkata,9858,2,6,6,2,18,13,5,24
Delhi Dynamo,9858,3,6,5,3,26,19,7,23
FC Pune City,9858,4,5,3,6,15,18,-3,18
NorthEast Un,9858,5,4,4,6,12,14,-2,16
Chennaiyin,9858,6,3,7,4,14,18,-4,16
Kerala Blast,9858,7,4,4,6,12,18,-6,16
FC Goa,9858,8,3,3,8,9,17,-8,12
Delhi Dynamo,9859,1,6,5,3,27,20,7,23
Mumbai City,9859,2,6,4,4,19,12,7,22
FC Pune City,9859,3,6,3,5,18,16,2,21
NorthEast Un,9859,4,6,2,6,15,13,2,20
Kolkata,9859,5,4,6,4,15,15,0,18
Kerala Blast,9859,6,5,3,6,15,21,-6,18
Chennaiyin,9859,7,3,6,5,17,23,-6,15
FC Goa,9859,8,4,3,7,14,20,-6,15
Delhi Dynamo,9860,1,6,6,2,25,16,9,24
Mumbai City,9860,2,6,5,3,17,9,8,23
Kolkata,9860,3,4,7,3,17,15,2,19
FC Pune City,9860,4,5,4,5,17,17,0,19
Chennaiyin,9860,5,4,5,5,15,19,-4,17
FC Goa,9860,6,5,2,7,11,16,-5,17
Kerala Blast,9860,7,4,4,6,13,21,-8,16
NorthEast Un,9860,8,4,3,7,11,13,-2,15
Mumbai City,9861,1,7,4,3,18,9,9,25
Delhi Dynamo,9861,2,6,5,3,31,19,12,23
Kolkata,9861,3,4,8,2,21,19,2,20
Kerala Blast,9861,4,5,5,4,12,15,-3,20
Chennaiyin,9861,5,4,5,5,15,19,-4,17
FC Pune City,9861,6,4,4,6,13,16,-3,16
FC Goa,9861,7,4,3,7,15,25,-10,15
NorthEast Un,9861,8,4,2,8,11,14,-3,14
Mumbai City,9862,1,7,4,3,18,9,9,25
Kolkata,9862,2,6,6,2,18,14,4,24
NorthEast Un,9862,3,6,2,6,13,12,1,20
Kerala Blast,9862,4,5,4,5,11,15,-4,19
Delhi Dynamo,9862,5,4,5,5,24,20,4,17
FC Pune City,9862,6,4,4,6,14,17,-3,16
Chennaiyin,9862,7,3,6,5,15,20,-5,15
FC Goa,9862,8,4,3,7,12,18,-6,15
Mumbai City,9863,1,7,4,3,18,8,10,25
Delhi Dynamo,9863,2,6,5,3,23,16,7,23
Kolkata,9863,3,4,7,3,15,14,1,19
FC Pune City,9863,4,4,5,5,14,16,-2,17
FC Goa,9863,5,5,2,7,13,17,-4,17
Chennaiyin,9863,6,4,5,5,17,22,-5,17
Kerala Blast,9863,7,4,5,5,11,16,-5,17
NorthEast Un,9863,8,4,3,7,11,13,-2,15
Mumbai City,9864,1,6,5,3,17,9,8,23
Kolkata,9864,2,5,6,3,18,16,2,21
FC Goa,9864,3,6,2,6,14,16,-2,20
Delhi Dynamo,9864,4,4,7,3,25,19,6,19
FC Pune City,9864,5,5,3,6,15,17,-2,18
Kerala Blast,9864,6,5,3,6,12,18,-6,18
NorthEast Un,9864,7,4,4,6,13,14,-1,16
Chennaiyin,9864,8,3,6,5,15,20,-5,15
Mumbai City,9865,1,7,4,3,20,10,10,25
Delhi Dynamo,9865,2,5,5,4,27,22,5,20
Kolkata,9865,3,4,8,2,18,13,5,20
FC Goa,9865,4,5,3,6,15,15,0,18
Kerala Blast,9865,5,5,3,6,11,19,-8,18
NorthEast Un,9865,6,5,2,7,13,15,-2,17
Chennaiyin,9865,7,4,5,5,16,22,-6,17
FC Pune City,9865,8,4,4,6,13,17,-4,16
Mumbai City,9866,1,7,4,3,22,8,14,25
Kerala Blast,9866,2,6,3,5,14,15,-1,21
Kolkata,9866,3,4,8,2,17,14,3,20
Delhi Dynamo,9866,4,5,5,4,22,21,1,20
Chennaiyin,9866,5,4,5,5,18,20,-2,17
NorthEast Un,9866,6,5,2,7,10,14,-4,17
FC Pune City,9866,7,4,4,6,14,19,-5,16
FC Goa,9866,8,4,3,7,11,17,-6,15
Kerala Blast,9867,1,7,3,4,14,13,1,24
Delhi Dynamo,9867,2,6,5,3,27,16,11,23
Mumbai City,9867,3,6,4,4,16,10,6,22
Kolkata,9867,4,4,7,3,17,16,1,19
NorthEast Un,9867,5,5,3,6,12,13,-1,18
FC Pune City,9867,6,4,3,7,13,18,-5,15
Chennaiyin,9867,7,3,6,5,16,22,-6,15
FC Goa,9867,8,4,3,7,13,20,-7,15
Delhi Dynamo,9868,1,6,6,2,24,14,10,24
Mumbai City,9868,2,6,4,4,16,10,6,22
Kolkata,9868,3,4,7,3,18,15,3,19
FC Pune City,9868,4,5,4,5,17,18,-1,19
Kerala Blast,9868,5,5,4,5,13,18,-5,19
NorthEast Un,9868,6,5,3,6,10,11,-1,18
Chennaiyin,9868,7,4,5,5,15,19,-4,17
FC Goa,9868,8,3,3,8,9,17,-8,12
Mumbai City,9869,1,7,4,3,19,9,10,25
Delhi Dynamo,9869,2,5,6,3,25,18,7,21
Kolkata,9869,3,5,6,3,17,15,2,21
Chennaiyin,9869,4,5,5,4,17,18,-1,20
Kerala Blast,9869,5,5,4,5,12,15,-3,19
FC Pune City,9869,6,4,4,6,13,17,-4,16
NorthEast Un,9869,7,4,3,7,11,14,-3,15
FC Goa,9869,8,4,2,8,11,19,-8,14
Mumbai City,9870,1,6,4,4,16,10,6,22
Kolkata,9870,2,5,6,3,17,17,0,21
Delhi Dynamo,9870,3,5,5,4,23,19,4,20
Chennaiyin,9870,4,5,5,4,16,17,-1,20
FC Pune City,9870,5,5,4,5,16,15,1,19
Kerala Blast,9870,6,5,4,5,11,15,-4,19
NorthEast Un,9870,7,5,2,7,12,12,0,17
FC Goa,9870,8,4,2,8,12,18,-6,14
Delhi Dynamo,9871,1,6,6,2,31,19,12,24
Mumbai City,9871,2,6,5,3,18,10,8,23
Kolkata,9871,3,5,6,3,23,16,7,21
Kerala Blast,9871,4,5,5,4,11,14,-3,20
NorthEast Un,9871,5,4,4,6,11,12,-1,16
FC Pune City,9871,6,4,4,6,14,17,-3,16
Chennaiyin,9871,7,3,7,4,14,18,-4,16
FC Goa,9871,8,3,3,8,10,26,-16,12
Mumbai City,9872,1,7,4,3,19,8,11,25
Kolkata,9872,2,5,6,3,20,16,4,21
Kerala Blast,9872,3,6,3,5,14,17,-3,21
Delhi Dynamo,9872,4,4,7,3,25,21,4,19
FC Goa,9872,5,5,3,6,16,18,-2,18
Chennaiyin,9872,6,4,5,5,15,21,-6,17
NorthEast Un,9872,7,4,3,7,11,13,-2,15
FC Pune City,9872,8,4,3,7,12,18,-6,15
Mumbai City,9873,1,7,4,3,18,9,9,25
Delhi Dynamo,9873,2,6,5,3,27,17,10,23
FC Pune City,9873,3,5,4,5,14,15,-1,19
Kerala Blast,9873,4,5,4,5,12,16,-4,19
Chennaiyin,9873,5,4,6,4,16,19,-3,18
Kolkata,9873,6,3,8,3,14,14,0,17
NorthEast Un,9873,7,4,3,7,12,14,-2,15
FC Goa,9873,8,3,4,7,8,17,-9,13
Delhi Dynamo,9874,1,6,6,2,25,15,10,24
Mumbai City,9874,2,6,4,4,16,10,6,22
Kolkata,9874,3,5,7,2,16,13,3,22
NorthEast Un,9874,4,5,4,5,14,13,1,19
Kerala Blast,9874,5,4,5,5,12,17,-5,17
FC Pune City,9874,6,4,4,6,13,16,-3,16
FC Goa,9874,7,4,3,7,12,17,-5,15
Chennaiyin,9874,8,3,5,6,15,22,-7,14
Mumbai City,9875,1,7,4,3,17,8,9,25
Delhi Dynamo,9875,2,6,5,3,26,18,8,23
Kerala Blast,9875,3,6,4,4,14,15,-1,22
NorthEast Un,9875,4,5,3,6,14,13,1,18
FC Pune City,9875,5,5,3,6,15,17,-2,18
Kolkata,9875,6,3,7,4,13,15,-2,16
Chennaiyin,9875,7,3,6,5,13,19,-6,15
FC Goa,9875,8,3,4,7,9,16,-7,13
Mumbai City,9876,1,7,4,3,18,8,10,25
NorthEast Un,9876,2,7,2,5,16,11,5,23
Kolkata,9876,3,5,6,3,17,17,0,21
Delhi Dynamo,9876,4,5,5,4,24,20,4,20
FC Pune City,9876,5,5,3,6,18,18,0,18
Kerala Blast,9876,6,5,3,6,11,16,-5,18
Chennaiyin,9876,7,3,6,5,16,21,-5,15
FC Goa,9876,8,3,3,8,10,19,-9,12
Mumbai City,9877,1,7,4,3,19,8,11,25
Delhi Dynamo,9877,2,6,5,3,25,19,6,23
Kerala Blast,9877,3,6,4,4,15,15,0,22
Kolkata,9877,4,5,6,3,15,13,2,21
NorthEast Un,9877,5,4,4,6,12,13,-1,16
Chennaiyin,9877,6,3,6,5,14,20,-6,15
FC Pune City,9877,7,4,3,7,13,19,-6,15
FC Goa,9877,8,4,2,8,11,17,-6,14
Delhi Dynamo,9878,1,6,5,3,25,18,7,23
Mumbai City,9878,2,6,4,4,16,9,7,22
Kolkata,9878,3,4,7,3,17,16,1,19
FC Pune City,9878,4,5,4,5,15,16,-1,19
NorthEast Un,9878,5,5,3,6,11,11,0,18
Kerala Blast,9878,6,4,6,4,11,15,-4,18
Chennaiyin,9878,7,4,5,5,15,19,-4,17
FC Goa,9878,8,4,2,8,13,19,-6,14
Mumbai City,9879,1,7,4,3,17,8,9,25
Kolkata,9879,2,4,8,2,18,16,2,20
Delhi Dynamo,9879,3,4,7,3,22,16,6,19
FC Pune City,9879,4,5,4,5,15,16,-1,19
Kerala Blast,9879,5,5,4,5,14,17,-3,19
Chennaiyin,9879,6,4,5,5,18,22,-4,17
NorthEast Un,9879,7,4,3,7,12,16,-4,15
FC Goa,9879,8,4,3,7,14,19,-5,15
Mumbai City,9880,1,6,5,3,17,9,8,23
Delhi Dynamo,9880,2,5,7,2,25,15,10,22
Kolkata,9880,3,5,7,2,16,13,3,22
Chennaiyin,9880,4,5,5,4,19,19,0,20
FC Pune City,9880,5,5,3,6,14,15,-1,18
NorthEast Un,9880,6,4,4,6,10,11,-1,16
Kerala Blast,9880,7,4,4,6,10,17,-7,16
FC Goa,9880,8,3,3,8,9,21,-12,12
Mumbai City,9881,1,6,4,4,17,13,4,22
Kerala Blast,9881,2,6,4,4,15,14,1,22
Delhi Dynamo,9881,3,5,6,3,29,19,10,21
FC Goa,9881,4,6,2,6,15,16,-1,20
Kolkata,9881,5,4,6,4,15,15,0,18
Chennaiyin,9881,6,4,5,5,15,21,-6,17
FC Pune City,9881,7,4,4,6,13,16,-3,16
NorthEast Un,9881,8,4,3,7,12,17,-5,15
Mumbai City,9882,1,7,4,3,18,9,9,25
Kolkata,9882,2,5,6,3,20,16,4,21
Delhi Dynamo,9882,3,5,5,4,24,17,7,20
NorthEast Un,9882,4,6,2,6,12,12,0,20
Chennaiyin,9882,5,5,5,4,17,18,-1,20
FC Pune City,9882,6,5,3,6,14,17,-3,18
Kerala Blast,9882,7,5,3,6,12,17,-5,18
FC Goa,9882,8,3,2,9,9,20,-11,11
Delhi Dynamo,9883,1,6,5,3,24,16,8,23
Mumbai City,9883,2,6,4,4,16,10,6,22
Kolkata,9883,3,5,7,2,18,14,4,22
Kerala Blast,9883,4,5,5,4,12,15,-3,20
NorthEast Un,9883,5,5,3,6,11,11,0,18
Chennaiyin,9883,6,4,6,4,16,18,-2,18
FC Pune City,9883,7,4,3,7,14,19,-5,15
FC Goa,9883,8,3,3,8,9,17,-8,12
Delhi Dynamo,9884,1,6,5,3,25,16,9,23
Mumbai City,9884,2,6,4,4,16,10,6,22
Kerala Blast,9884,3,6,3,5,14,17,-3,21
FC Goa,9884,4,5,3,6,15,16,-1,18
Kolkata,9884,5,3,8,3,16,16,0,17
NorthEast Un,9884,6,5,2,7,14,15,-1,17
Chennaiyin,9884,7,4,5,5,18,24,-6,17
FC Pune City,9884,8,4,4,6,12,16,-4,16
Mumbai City,9885,1,7,4,3,17,8,9,25
NorthEast Un,9885,2,6,3,5,14,10,4,21
Kerala Blast,9885,3,5,5,4,12,14,-2,20
FC Goa,9885,4,6,2,6,15,18,-3,20
Kolkata,9885,5,4,6,4,18,18,0,18
Delhi Dynamo,9885,6,4,5,5,22,19,3,17
FC Pune City,9885,7,4,4,6,12,16,-4,16
Chennaiyin,9885,8,3,5,6,15,22,-7,14
Mumbai City,9886,1,7,4,3,17,8,9,25
Kolkata,9886,2,6,6,2,18,13,5,24
Delhi Dynamo,9886,3,5,5,4,26,20,6,20
Chennaiyin,9886,4,5,5,4,18,17,1,20
NorthEast Un,9886,5,6,2,6,15,16,-1,20
FC Pune City,9886,6,5,3,6,16,16,0,18
Kerala Blast,9886,7,4,3,7,10,20,-10,15
FC Goa,9886,8,3,2,9,9,19,-10,11
Kolkata,9887,1,6,6,2,17,12,5,24
Mumbai City,9887,2,6,4,4,17,10,7,22
Delhi Dynamo,9887,3,5,5,4,23,20,3,20
NorthEast Un,9887,4,5,3,6,14,14,0,18
Chennaiyin,9887,5,4,6,4,16,18,-2,18
FC Pune City,9887,6,5,3,6,13,15,-2,18
Kerala Blast,9887,7,5,3,6,13,17,-4,18
FC Goa,9887,8,4,2,8,10,17,-7,14
Mumbai City,9888,1,6,5,3,16,8,8,23
Kerala Blast,9888,2,6,4,4,14,16,-2,22
Chennaiyin,9888,3,5,5,4,17,18,-1,20
Kolkata,9888,4,4,7,3,17,16,1,19
Delhi Dynamo,9888,5,4,6,4,22,20,2,18
NorthEast Un,9888,6,5,2,7,14,13,1,17
FC Goa,9888,7,5,2,7,12,17,-5,17
FC Pune City,9888,8,4,3,7,15,19,-4,15
Mumbai City,9889,1,6,5,3,16,8,8,23
Kerala Blast,9889,2,6,4,4,13,15,-2,22
Delhi Dynamo,9889,3,5,6,3,23,15,8,21
FC Pune City,9889,4,5,3,6,14,16,-2,18
FC Goa,9889,5,5,3,6,13,17,-4,18
Kolkata,9889,6,3,8,3,16,16,0,17
NorthEast Un,9889,7,5,2,7,11,13,-2,17
Chennaiyin,9889,8,3,5,6,15,21,-6,14
Mumbai City,9890,1,7,4,3,18,8,10,25
Kerala Blast,9890,2,6,4,4,13,15,-2,22
Delhi Dynamo,9890,3,4,6,4,22,19,3,18
Kolkata,9890,4,4,6,4,19,17,2,18
NorthEast Un,9890,5,5,3,6,13,12,1,18
FC Goa,9890,6,5,3,6,11,14,-3,18
Chennaiyin,9890,7,4,5,5,14,18,-4,17
FC Pune City,9890,8,4,3,7,13,20,-7,15
Mumbai City,9891,1,7,4,3,18,8,10,25
Kolkata,9891,2,5,7,2,17,12,5,22
NorthEast Un,9891,3,6,2,6,13,13,0,20
FC Goa,9891,4,5,3,6,14,14,0,18
FC Pune City,9891,5,5,3,6,15,17,-2,18
Delhi Dynamo,9891,6,4,5,5,21,21,0,17
Chennaiyin,9891,7,4,5,5,17,20,-3,17
Kerala Blast,9891,8,4,3,7,9,19,-10,15
Mumbai City,9892,1,6,5,3,17,9,8,23
FC Goa,9892,2,6,2,6,14,16,-2,20
Kerala Blast,9892,3,5,4,5,12,15,-3,19
Delhi Dynamo,9892,4,4,6,4,25,20,5,18
Kolkata,9892,5,4,6,4,16,16,0,18
NorthEast Un,9892,6,5,3,6,12,12,0,18
FC Pune City,9892,7,5,3,6,14,17,-3,18
Chennaiyin,9892,8,4,5,5,15,20,-5,17
NorthEast Un,9893,1,7,2,5,16,9,7,23
Delhi Dynamo,9893,2,6,5,3,24,18,6,23
Mumbai City,9893,3,6,4,4,16,10,6,22
Kolkata,9893,4,5,6,3,17,17,0,21
FC Pune City,9893,5,4,4,6,13,16,-3,16
Kerala Blast,9893,6,4,4,6,9,16,-7,16
FC Goa,9893,7,4,3,7,12,16,-4,15
Chennaiyin,9893,8,3,6,5,13,18,-5,15
Mumbai City,9894,1,6,5,3,16,8,8,23
Kolkata,9894,2,5,7,2,22,17,5,22
Delhi Dynamo,9894,3,5,6,3,25,18,7,21
Kerala Blast,9894,4,6,3,5,12,16,-4,21
NorthEast Un,9894,5,5,3,6,13,13,0,18
Chennaiyin,9894,6,4,6,4,15,18,-3,18
FC Pune City,9894,7,4,3,7,16,21,-5,15
FC Goa,9894,8,3,3,8,11,19,-8,12
Mumbai City,9895,1,7,4,3,18,9,9,25
NorthEast Un,9895,2,6,3,5,16,11,5,21
Delhi Dynamo,9895,3,5,5,4,24,18,6,20
Kolkata,9895,4,4,6,4,14,14,0,18
FC Pune City,9895,5,5,3,6,14,17,-3,18
Kerala Blast,9895,6,5,3,6,13,19,-6,18
FC Goa,9895,7,5,2,7,11,16,-5,17
Chennaiyin,9895,8,3,6,5,14,20,-6,15
Mumbai City,9896,1,7,4,3,18,9,9,25
Delhi Dynamo,9896,2,5,6,3,26,17,9,21
Kolkata,9896,3,5,6,3,16,16,0,21
Chennaiyin,9896,4,5,5,4,21,20,1,20
FC Pune City,9896,5,5,3,6,14,16,-2,18
Kerala Blast,9896,6,5,3,6,12,16,-4,18
FC Goa,9896,7,4,3,7,13,19,-6,15
NorthEast Un,9896,8,4,2,8,12,19,-7,14
Mumbai City,9897,1,7,4,3,19,8,11,25
Delhi Dynamo,9897,2,6,5,3,25,18,7,23
NorthEast Un,9897,3,6,2,6,14,13,1,20
Kolkata,9897,4,4,7,3,15,13,2,19
FC Pune City,9897,5,5,3,6,13,16,-3,18
Kerala Blast,9897,6,5,3,6,11,16,-5,18
FC Goa,9897,7,4,3,7,10,16,-6,15
Chennaiyin,9897,8,3,5,6,14,21,-7,14
Mumbai City,9898,1,6,5,3,17,9,8,23
Delhi Dynamo,9898,2,5,7,2,27,17,10,22
Kerala Blast,9898,3,6,3,5,12,15,-3,21
Kolkata,9898,4,4,6,4,14,15,-1,18
FC Pune City,9898,5,5,3,6,14,16,-2,18
FC Goa,9898,6,5,2,7,14,17,-3,17
NorthEast Un,9898,7,4,4,6,12,13,-1,16
Chennaiyin,9898,8,3,6,5,14,22,-8,15
Delhi Dynamo,9899,1,6,6,2,28,17,11,24
Mumbai City,9899,2,6,5,3,17,9,8,23
Kolkata,9899,3,5,7,2,19,15,4,22
Kerala Blast,9899,4,6,3,5,14,16,-2,21
Chennaiyin,9899,5,4,6,4,16,19,-3,18
FC Pune City,9899,6,4,3,7,13,19,-6,15
NorthEast Un,9899,7,4,2,8,12,15,-3,14
FC Goa,9899,8,3,4,7,11,20,-9,13
Mumbai City,9900,1,6,5,3,16,8,8,23
Delhi Dynamo,9900,2,5,7,2,25,15,10,22
Kolkata,9900,3,4,8,2,19,14,5,20
NorthEast Un,9900,4,6,2,6,13,12,1,20
Kerala Blast,9900,5,5,3,6,11,19,-8,18
FC Pune City,9900,6,4,4,6,14,17,-3,16
Chennaiyin,9900,7,3,6,5,14,21,-7,15
FC Goa,9900,8,3,5,6,11,17,-6,14
Delhi Dynamo,9901,1,7,5,2,30,16,14,26
Mumbai City,9901,2,6,4,4,17,11,6,22
Kolkata,9901,3,5,7,2,17,13,4,22
FC Pune City,9901,4,5,3,6,15,17,-2,18
NorthEast Un,9901,5,5,2,7,13,16,-3,17
Chennaiyin,9901,6,4,5,5,15,19,-4,17
FC Goa,9901,7,4,3,7,10,17,-7,15
Kerala Blast,9901,8,4,3,7,12,20,-8,15
Delhi Dynamo,9902,1,6,6,2,27,16,11,24
Mumbai City,9902,2,6,5,3,17,9,8,23
Kerala Blast,9902,3,6,3,5,17,17,0,21
Kolkata,9902,3,5,6,3,17,17,0,21
NorthEast Un,9902,5,5,2,7,12,14,-2,17
FC Goa,9902,6,5,2,7,17,20,-3,17
FC Pune City,9902,7,4,3,7,13,19,-6,15
Chennaiyin,9902,8,3,5,6,15,23,-8,14
Mumbai City,9903,1,6,5,3,17,9,8,23
Kolkata,9903,2,5,7,2,20,13,7,22
Delhi Dynamo,9903,3,5,6,3,24,17,7,21
NorthEast Un,9903,4,6,2,6,12,13,-1,20
Chennaiyin,9903,5,4,5,5,17,20,-3,17
Kerala Blast,9903,6,4,5,5,10,16,-6,17
FC Pune City,9903,7,4,4,6,13,19,-6,16
FC Goa,9903,8,4,2,8,13,19,-6,14
Mumbai City,9904,1,7,4,3,21,10,11,25
Kerala Blast,9904,2,6,4,4,14,14,0,22
Kolkata,9904,3,4,8,2,15,12,3,20
Chennaiyin,9904,4,5,5,4,16,17,-1,20
Delhi Dynamo,9904,5,4,6,4,23,20,3,18
FC Pune City,9904,6,4,4,6,13,18,-5,16
NorthEast Un,9904,7,4,3,7,9,12,-3,15
FC Goa,9904,8,4,2,8,9,17,-8,14
Mumbai City,9905,1,7,4,3,18,9,9,25
Delhi Dynamo,9905,2,6,5,3,27,16,11,23
Kolkata,9905,3,5,6,3,19,14,5,21
Kerala Blast,9905,4,5,4,5,14,18,-4,19
NorthEast Un,9905,5,5,3,6,13,11,2,18
Chennaiyin,9905,6,4,5,5,17,23,-6,17
FC Pune City,9905,7,4,3,7,13,20,-7,15
FC Goa,9905,8,4,2,8,11,21,-10,14
Mumbai City,9906,1,7,4,3,20,9,11,25
Chennaiyin,9906,2,5,5,4,16,17,-1,20
Kerala Blast,9906,3,5,5,4,11,14,-3,20
NorthEast Un,9906,4,5,3,6,12,12,0,18
Delhi Dynamo,9906,5,4,5,5,24,23,1,17
Kolkata,9906,6,3,8,3,16,16,0,17
FC Goa,9906,7,5,2,7,12,17,-5,17
FC Pune City,9906,8,4,4,6,13,16,-3,16
Kerala Blast,9907,1,7,3,4,17,15,2,24
Mumbai City,9907,2,6,4,4,16,10,6,22
Delhi Dynamo,9907,3,5,5,4,24,17,7,20
FC Goa,9907,4,6,2,6,15,16,-1,20
Kolkata,9907,5,4,6,4,16,18,-2,18
NorthEast Un,9907,6,5,2,7,14,15,-1,17
Chennaiyin,9907,7,4,5,5,17,22,-5,17
FC Pune City,9907,8,4,3,7,14,20,-6,15
Mumbai City,9908,1,7,4,3,18,8,10,25
NorthEast Un,9908,2,6,3,5,15,11,4,21
Kolkata,9908,3,4,7,3,17,16,1,19
Kerala Blast,9908,4,5,4,5,15,20,-5,19
FC Goa,9908,5,5,3,6,11,15,-4,18
Delhi Dynamo,9908,6,4,5,5,22,20,2,17
Chennaiyin,9908,7,3,7,4,14,18,-4,16
FC Pune City,9908,8,4,3,7,13,17,-4,15
Mumbai City,9909,1,6,5,3,18,10,8,23
Kolkata,9909,2,5,7,2,16,12,4,22
Delhi Dynamo,9909,3,4,6,4,23,18,5,18
FC Pune City,9909,4,5,3,6,15,16,-1,18
NorthEast Un,9909,5,5,3,6,11,12,-1,18
FC Goa,9909,6,5,3,6,11,14,-3,18
Kerala Blast,9909,7,5,3,6,11,17,-6,18
Chennaiyin,9909,8,3,6,5,14,20,-6,15
Delhi Dynamo,9910,1,6,5,3,27,16,11,23
Mumbai City,9910,2,6,4,4,17,12,5,22
Kolkata,9910,3,5,7,2,17,13,4,22
NorthEast Un,9910,4,5,3,6,12,12,0,18
Chennaiyin,9910,5,4,6,4,15,18,-3,18
Kerala Blast,9910,6,4,5,5,12,18,-6,17
FC Pune City,9910,7,4,4,6,13,16,-3,16
FC Goa,9910,8,3,4,7,10,18,-8,13
Delhi Dynamo,9911,1,6,6,2,26,14,12,24
Mumbai City,9911,2,6,4,4,16,10,6,22
Kolkata,9911,3,5,6,3,18,16,2,21
Kerala Blast,9911,4,6,3,5,13,14,-1,21
FC Goa,9911,5,5,2,7,14,18,-4,17
NorthEast Un,9911,6,4,4,6,10,12,-2,16
Chennaiyin,9911,7,3,6,5,15,21,-6,15
FC Pune City,9911,8,4,3,7,13,20,-7,15
Mumbai City,9912,1,7,4,3,17,8,9,25
Kolkata,9912,2,5,6,3,17,14,3,21
Delhi Dynamo,9912,3,4,6,4,21,18,3,18
NorthEast Un,9912,4,5,3,6,13,11,2,18
FC Goa,9912,5,5,3,6,13,15,-2,18
FC Pune City,9912,6,5,3,6,14,17,-3,18
Kerala Blast,9912,7,5,3,6,10,16,-6,18
Chennaiyin,9912,8,3,6,5,15,21,-6,15
Mumbai City,9913,1,7,4,3,17,8,9,25
Kolkata,9913,2,5,6,3,20,17,3,21
NorthEast Un,9913,3,6,2,6,14,13,1,20
Kerala Blast,9913,4,5,4,5,11,15,-4,19
Delhi Dynamo,9913,5,4,6,4,24,19,5,18
Chennaiyin,9913,6,4,5,5,19,20,-1,17
FC Pune City,9913,7,4,4,6,14,19,-5,16
FC Goa,9913,8,4,3,7,14,22,-8,15
NorthEast Un,9914,1,7,2,5,14,11,3,23
Mumbai City,9914,2,6,4,4,17,11,6,22
Delhi Dynamo,9914,3,5,5,4,27,20,7,20
Kolkata,9914,4,4,7,3,16,14,2,19
FC Goa,9914,5,5,3,6,14,18,-4,18
FC Pune City,9914,6,4,5,5,13,15,-2,17
Kerala Blast,9914,7,4,4,6,10,17,-7,16
Chennaiyin,9914,8,3,6,5,15,20,-5,15
Mumbai City,9915,1,6,5,3,17,9,8,23
Kolkata,9915,2,5,7,2,19,13,6,22
NorthEast Un,9915,3,6,2,6,14,12,2,20
Chennaiyin,9915,4,5,5,4,17,19,-2,20
Delhi Dynamo,9915,5,4,6,4,23,19,4,18
FC Pune City,9915,6,5,3,6,14,17,-3,18
FC Goa,9915,7,4,3,7,12,17,-5,15
Kerala Blast,9915,8,4,3,7,9,19,-10,15
Mumbai City,9916,1,7,4,3,18,8,10,25
Kolkata,9916,2,5,7,2,20,17,3,22
NorthEast Un,9916,3,6,3,5,14,11,3,21
Delhi Dynamo,9916,4,4,6,4,22,19,3,18
FC Pune City,9916,5,5,3,6,15,17,-2,18
FC Goa,9916,6,4,4,6,12,16,-4,16
Kerala Blast,9916,7,4,4,6,13,19,-6,16
Chennaiyin,9916,8,3,5,6,13,20,-7,14
Delhi Dynamo,9917,1,6,5,3,26,18,8,23
Mumbai City,9917,2,6,4,4,16,9,7,22
Kolkata,9917,3,5,6,3,16,14,2,21
Kerala Blast,9917,4,6,3,5,12,14,-2,21
NorthEast Un,9917,5,6,2,6,14,13,1,20
FC Pune City,9917,6,5,3,6,14,16,-2,18
Chennaiyin,9917,7,3,6,5,14,19,-5,15
FC Goa,9917,8,3,3,8,9,18,-9,12
Mumbai City,9918,1,7,4,3,18,9,9,25
Kolkata,9918,2,5,7,2,17,14,3,22
Delhi Dynamo,9918,3,5,6,3,27,17,10,21
Kerala Blast,9918,4,6,3,5,14,16,-2,21
NorthEast Un,9918,5,5,3,6,12,11,1,18
FC Pune City,9918,6,4,3,7,13,18,-5,15
FC Goa,9918,7,4,3,7,11,19,-8,15
Chennaiyin,9918,8,3,5,6,13,21,-8,14
Mumbai City,9919,1,7,4,3,18,8,10,25
Delhi Dynamo,9919,2,6,5,3,25,17,8,23
Kolkata,9919,3,4,8,2,15,13,2,20
Kerala Blast,9919,4,5,4,5,11,14,-3,19
Chennaiyin,9919,5,4,6,4,16,18,-2,18
FC Pune City,9919,6,4,4,6,13,17,-4,16
NorthEast Un,9919,7,4,3,7,11,14,-3,15
FC Goa,9919,8,3,4,7,8,16,-8,13
Mumbai City,9920,1,7,4,3,18,9,9,25
Kolkata,9920,2,5,7,2,17,14,3,22
Delhi Dynamo,9920,3,5,5,4,28,22,6,20
NorthEast Un,9920,4,5,3,6,13,14,-1,18
FC Goa,9920,5,5,3,6,14,16,-2,18
Kerala Blast,9920,6,4,5,5,10,15,-5,17
FC Pune City,9920,7,4,4,6,14,17,-3,16
Chennaiyin,9920,8,3,5,6,13,20,-7,14
Mumbai City,9921,1,7,4,3,18,9,9,25
FC Pune City,9921,2,5,4,5,15,15,0,19
Delhi Dynamo,9921,3,4,6,4,24,19,5,18
Kolkata,9921,4,3,9,2,18,17,1,18
NorthEast Un,9921,5,4,5,5,11,11,0,17
Kerala Blast,9921,6,4,5,5,12,18,-6,17
Chennaiyin,9921,7,3,7,4,13,17,-4,16
FC Goa,9921,8,4,4,6,12,17,-5,16
Kerala Blast,9922,1,7,3,4,14,15,-1,24
Mumbai City,9922,2,6,5,3,16,8,8,23
Delhi Dynamo,9922,3,5,6,3,24,17,7,21
Kolkata,9922,4,5,6,3,19,15,4,21
NorthEast Un,9922,5,5,2,7,11,12,-1,17
FC Goa,9922,6,5,2,7,13,18,-5,17
FC Pune City,9922,7,4,3,7,13,19,-6,15
Chennaiyin,9922,8,3,5,6,14,20,-6,14
Mumbai City,9923,1,7,4,3,17,8,9,25
Kolkata,9923,2,6,6,2,19,15,4,24
Kerala Blast,9923,3,5,4,5,13,17,-4,19
NorthEast Un,9923,4,5,3,6,15,14,1,18
Delhi Dynamo,9923,5,4,5,5,23,20,3,17
FC Goa,9923,6,5,2,7,12,16,-4,17
Chennaiyin,9923,7,4,5,5,15,20,-5,17
FC Pune City,9923,8,4,3,7,14,18,-4,15
Kerala Blast,9924,1,7,3,4,19,16,3,24
Mumbai City,9924,2,6,5,3,17,9,8,23
Delhi Dynamo,9924,3,5,7,2,25,16,9,22
Kolkata,9924,4,4,6,4,18,19,-1,18
NorthEast Un,9924,5,5,3,6,13,14,-1,18
FC Pune City,9924,6,5,3,6,13,17,-4,18
Chennaiyin,9924,7,3,6,5,15,20,-5,15
FC Goa,9924,8,3,3,8,13,22,-9,12
Delhi Dynamo,9925,1,6,6,2,26,15,11,24
Kolkata,9925,2,6,6,2,18,12,6,24
Mumbai City,9925,3,6,5,3,17,9,8,23
Kerala Blast,9925,4,6,3,5,11,14,-3,21
Chennaiyin,9925,5,4,5,5,14,19,-5,17
FC Pune City,9925,6,4,3,7,12,18,-6,15
NorthEast Un,9925,7,4,2,8,9,13,-4,14
FC Goa,9925,8,4,2,8,10,17,-7,14
Mumbai City,9926,1,7,4,3,17,8,9,25
Delhi Dynamo,9926,2,5,5,4,23,17,6,20
Kolkata,9926,3,4,7,3,15,14,1,19
FC Pune City,9926,4,5,4,5,14,15,-1,19
Kerala Blast,9926,5,5,4,5,12,14,-2,19
FC Goa,9926,6,5,3,6,10,14,-4,18
NorthEast Un,9926,7,4,3,7,10,14,-4,15
Chennaiyin,9926,8,3,6,5,13,18,-5,15
Mumbai City,9927,1,7,4,3,17,8,9,25
Kolkata,9927,2,5,7,2,17,13,4,22
NorthEast Un,9927,3,6,3,5,14,12,2,21
Delhi Dynamo,9927,4,5,5,4,28,20,8,20
FC Pune City,9927,5,5,3,6,14,17,-3,18
Chennaiyin,9927,6,4,5,5,15,18,-3,17
Kerala Blast,9927,7,4,5,5,10,15,-5,17
FC Goa,9927,8,3,2,9,10,22,-12,11
Mumbai City,9928,1,7,4,3,17,8,9,25
Kolkata,9928,2,5,7,2,18,13,5,22
NorthEast Un,9928,3,6,2,6,13,11,2,20
Kerala Blast,9928,4,5,4,5,13,18,-5,19
Delhi Dynamo,9928,5,4,5,5,22,19,3,17
Chennaiyin,9928,6,4,5,5,15,19,-4,17
FC Goa,9928,7,5,2,7,12,17,-5,17
FC Pune City,9928,8,4,3,7,16,21,-5,15
Mumbai City,9929,1,6,5,3,17,9,8,23
Kerala Blast,9929,2,6,4,4,13,14,-1,22
Delhi Dynamo,9929,3,5,6,3,26,17,9,21
NorthEast Un,9929,4,5,3,6,12,11,1,18
Kolkata,9929,5,4,6,4,14,15,-1,18
FC Goa,9929,6,5,2,7,12,18,-6,17
FC Pune City,9929,7,4,4,6,12,15,-3,16
Chennaiyin,9929,8,3,6,5,13,20,-7,15
Mumbai City,9930,1,7,4,3,17,8,9,25
Kolkata,9930,2,5,7,2,16,13,3,22
Kerala Blast,9930,3,6,3,5,14,15,-1,21
Delhi Dynamo,9930,4,5,5,4,24,20,4,20
FC Goa,9930,5,5,3,6,14,16,-2,18
NorthEast Un,9930,6,5,2,7,11,13,-2,17
FC Pune City,9930,7,4,3,7,14,19,-5,15
Chennaiyin,9930,8,3,5,6,14,20,-6,14
Mumbai City,9931,1,7,4,3,20,11,9,25
Kolkata,9931,2,6,6,2,19,14,5,24
Delhi Dynamo,9931,3,5,5,4,25,20,5,20
NorthEast Un,9931,4,5,4,5,14,12,2,19
Kerala Blast,9931,5,5,4,5,15,18,-3,19
Chennaiyin,9931,6,4,6,4,15,18,-3,18
FC Pune City,9931,7,4,3,7,12,18,-6,15
FC Goa,9931,8,3,2,9,9,18,-9,11
Mumbai City,9932,1,7,4,3,18,8,10,25
Kerala Blast,9932,2,7,3,4,13,14,-1,24
Kolkata,9932,3,4,7,3,16,14,2,19
Delhi Dynamo,9932,4,4,6,4,24,22,2,18
Chennaiyin,9932,5,4,6,4,16,19,-3,18
NorthEast Un,9932,6,5,2,7,15,14,1,17
FC Pune City,9932,7,4,4,6,14,17,-3,16
FC Goa,9932,8,3,4,7,10,18,-8,13
Mumbai City,9933,1,6,5,3,17,9,8,23
Delhi Dynamo,9933,2,5,6,3,23,17,6,21
NorthEast Un,9933,3,6,3,5,16,11,5,21
Kolkata,9933,4,5,6,3,17,14,3,21
Kerala Blast,9933,5,5,4,5,13,19,-6,19
FC Pune City,9933,6,4,4,6,14,17,-3,16
Chennaiyin,9933,7,3,6,5,14,19,-5,15
FC Goa,9933,8,4,2,8,10,18,-8,14
Mumbai City,9934,1,7,4,3,18,8,10,25
Kolkata,9934,2,5,7,2,19,16,3,22
Delhi Dynamo,9934,3,5,6,3,25,17,8,21
Chennaiyin,9934,4,5,5,4,19,17,2,20
Kerala Blast,9934,5,4,5,5,12,17,-5,17
FC Pune City,9934,6,4,4,6,15,18,-3,16
NorthEast Un,9934,7,4,4,6,10,13,-3,16
FC Goa,9934,8,3,3,8,8,20,-12,12
Delhi Dynamo,9935,1,7,5,2,28,17,11,26
Mumbai City,9935,2,6,4,4,17,11,6,22
NorthEast Un,9935,3,6,2,6,15,13,2,20
FC Pune City,9935,4,5,4,5,14,15,-1,19
Kolkata,9935,5,4,6,4,16,16,0,18
Kerala Blast,9935,6,4,4,6,11,18,-7,16
Chennaiyin,9935,7,3,6,5,15,20,-5,15
FC Goa,9935,8,4,3,7,11,17,-6,15
Mumbai City,9936,1,7,4,3,17,8,9,25
Kolkata,9936,2,5,7,2,17,14,3,22
NorthEast Un,9936,3,6,3,5,13,11,2,21
Kerala Blast,9936,4,5,3,6,11,16,-5,18
Delhi Dynamo,9936,5,4,5,5,23,20,3,17
FC Goa,9936,6,5,2,7,13,17,-4,17
FC Pune City,9936,7,4,4,6,14,17,-3,16
Chennaiyin,9936,8,3,6,5,14,19,-5,15
Mumbai City,9937,1,7,4,3,18,9,9,25
Delhi Dynamo,9937,2,5,6,3,25,17,8,21
FC Pune City,9937,3,6,3,5,16,15,1,21
Kerala Blast,9937,4,6,3,5,13,16,-3,21
Chennaiyin,9937,5,5,5,4,18,20,-2,20
NorthEast Un,9937,6,4,3,7,10,12,-2,15
Kolkata,9937,7,3,6,5,14,17,-3,15
FC Goa,9937,8,4,2,8,12,20,-8,14
Mumbai City,9938,1,6,4,4,16,10,6,22
Delhi Dynamo,9938,2,5,6,3,25,17,8,21
FC Pune City,9938,3,6,3,5,14,14,0,21
Kolkata,9938,4,4,7,3,14,13,1,19
Kerala Blast,9938,5,5,3,6,14,16,-2,18
NorthEast Un,9938,6,5,3,6,13,16,-3,18
Chennaiyin,9938,7,3,7,4,16,20,-4,16
FC Goa,9938,8,3,5,6,11,17,-6,14
Mumbai City,9939,1,7,4,3,17,8,9,25
Kolkata,9939,2,5,6,3,17,15,2,21
Delhi Dynamo,9939,3,5,5,4,25,19,6,20
NorthEast Un,9939,4,5,3,6,10,10,0,18
FC Goa,9939,5,5,3,6,16,18,-2,18
Kerala Blast,9939,6,5,3,6,13,17,-4,18
Chennaiyin,9939,7,3,7,4,14,18,-4,16
FC Pune City,9939,8,4,3,7,13,20,-7,15
Mumbai City,9940,1,7,4,3,17,8,9,25
Kolkata,9940,2,5,7,2,17,14,3,22
Delhi Dynamo,9940,3,4,7,3,23,17,6,19
FC Pune City,9940,4,5,4,5,15,16,-1,19
Chennaiyin,9940,5,4,6,4,18,21,-3,18
Kerala Blast,9940,6,5,3,6,13,17,-4,18
NorthEast Un,9940,7,4,4,6,13,15,-2,16
FC Goa,9940,8,3,3,8,12,20,-8,12
Mumbai City,9941,1,7,4,3,18,8,10,25
FC Goa,9941,2,6,2,6,13,15,-2,20
FC Pune City,9941,3,5,4,5,15,15,0,19
Kerala Blast,9941,4,5,4,5,12,15,-3,19
Delhi Dynamo,9941,5,4,6,4,23,19,4,18
Kolkata,9941,6,4,6,4,14,16,-2,18
NorthEast Un,9941,7,4,4,6,10,12,-2,16
Chennaiyin,9941,8,3,6,5,13,18,-5,15
Mumbai City,9942,1,7,4,3,18,8,10,25
Delhi Dynamo,9942,2,6,5,3,26,18,8,23
Kolkata,9942,3,4,8,2,20,16,4,20
NorthEast Un,9942,4,6,2,6,13,11,2,20
FC Pune City,9942,5,5,3,6,14,17,-3,18
Kerala Blast,9942,6,4,4,6,12,21,-9,16
FC Goa,9942,7,4,3,7,14,19,-5,15
Chennaiyin,9942,8,3,5,6,14,21,-7,14
Mumbai City,9943,1,6,5,3,17,9,8,23
Delhi Dynamo,9943,2,4,7,3,22,17,5,19
FC Pune City,9943,3,5,4,5,14,15,-1,19
NorthEast Un,9943,4,5,3,6,11,11,0,18
FC Goa,9943,5,5,3,6,12,15,-3,18
Kerala Blast,9943,6,5,3,6,12,17,-5,18
Kolkata,9943,7,3,8,3,16,16,0,17
Chennaiyin,9943,8,4,5,5,14,18,-4,17
Mumbai City,9944,1,7,4,3,20,9,11,25
Delhi Dynamo,9944,2,6,5,3,29,21,8,23
Kolkata,9944,3,4,8,2,17,15,2,20
Kerala Blast,9944,4,5,4,5,14,15,-1,19
FC Pune City,9944,5,4,5,5,13,15,-2,17
NorthEast Un,9944,6,5,2,7,11,15,-4,17
FC Goa,9944,7,4,3,7,12,20,-8,15
Chennaiyin,9944,8,3,5,6,13,19,-6,14
Mumbai City,9945,1,7,4,3,20,8,12,25
Delhi Dynamo,9945,2,6,5,3,25,20,5,23
Kerala Blast,9945,3,6,3,5,12,16,-4,21
Chennaiyin,9945,4,5,5,4,15,17,-2,20
FC Pune City,9945,5,5,4,5,15,14,1,19
Kolkata,9945,6,3,8,3,15,16,-1,17
NorthEast Un,9945,7,4,2,8,10,13,-3,14
FC Goa,9945,8,3,3,8,11,19,-8,12
Mumbai City,9946,1,7,4,3,19,9,10,25
Kolkata,9946,2,4,8,2,17,13,4,20
Delhi Dynamo,9946,3,4,7,3,24,19,5,19
Chennaiyin,9946,4,4,6,4,16,19,-3,18
FC Pune City,9946,5,4,5,5,14,16,-2,17
Kerala Blast,9946,6,4,5,5,10,17,-7,17
NorthEast Un,9946,7,4,4,6,11,12,-1,16
FC Goa,9946,8,3,5,6,10,16,-6,14
Delhi Dynamo,9947,1,6,5,3,27,16,11,23
Mumbai City,9947,2,6,4,4,16,10,6,22
NorthEast Un,9947,3,6,2,6,14,11,3,20
FC Pune City,9947,4,5,4,5,15,16,-1,19
Kerala Blast,9947,5,5,4,5,12,16,-4,19
Kolkata,9947,6,4,6,4,14,14,0,18
FC Goa,9947,7,5,2,7,11,18,-7,17
Chennaiyin,9947,8,3,5,6,14,22,-8,14
Delhi Dynamo,9948,1,6,5,3,27,17,10,23
Mumbai City,9948,2,6,4,4,16,12,4,22
Kolkata,9948,3,5,6,3,18,15,3,21
NorthEast Un,9948,4,5,4,5,16,14,2,19
FC Pune City,9948,5,5,3,6,13,17,-4,18
FC Goa,9948,6,5,2,7,14,17,-3,17
Kerala Blast,9948,7,4,4,6,12,18,-6,16
Chennaiyin,9948,8,3,6,5,17,23,-6,15
Mumbai City,9949,1,6,5,3,17,9,8,23
Kerala Blast,9949,2,5,5,4,11,13,-2,20
Delhi Dynamo,9949,3,4,7,3,23,18,5,19
Kolkata,9949,4,4,7,3,14,14,0,19
FC Goa,9949,5,5,3,6,14,16,-2,18
NorthEast Un,9949,6,5,2,7,12,13,-1,17
Chennaiyin,9949,7,4,5,5,16,21,-5,17
FC Pune City,9949,8,4,4,6,12,15,-3,16
Mumbai City,9950,1,7,4,3,17,8,9,25
Kolkata,9950,2,6,6,2,17,13,4,24
Kerala Blast,9950,3,6,3,5,14,16,-2,21
Delhi Dynamo,9950,4,5,5,4,24,19,5,20
NorthEast Un,9950,5,5,3,6,14,14,0,18
FC Pune City,9950,6,4,3,7,14,18,-4,15
Chennaiyin,9950,7,3,6,5,14,20,-6,15
FC Goa,9950,8,4,2,8,11,17,-6,14
Mumbai City,9951,1,7,4,3,18,9,9,25
Delhi Dynamo,9951,2,6,5,3,28,17,11,23
Kolkata,9951,3,4,8,2,17,15,2,20
FC Pune City,9951,4,4,5,5,15,17,-2,17
Kerala Blast,9951,5,4,5,5,11,16,-5,17
NorthEast Un,9951,6,4,4,6,11,13,-2,16
Chennaiyin,9951,7,3,7,4,14,18,-4,16
FC Goa,9951,8,3,4,7,10,19,-9,13
Kolkata,9952,1,6,6,2,23,13,10,24
Mumbai City,9952,2,6,5,3,18,10,8,23
Delhi Dynamo,9952,3,5,7,2,27,17,10,22
Kerala Blast,9952,4,5,4,5,12,17,-5,19
NorthEast Un,9952,5,5,3,6,13,14,-1,18
FC Pune City,9952,6,4,4,6,12,18,-6,16
Chennaiyin,9952,7,3,6,5,15,20,-5,15
FC Goa,9952,8,3,3,8,10,21,-11,12
Delhi Dynamo,9953,1,6,6,2,23,14,9,24
Mumbai City,9953,2,6,4,4,16,9,7,22
Kolkata,9953,3,5,6,3,18,16,2,21
Kerala Blast,9953,4,6,3,5,13,15,-2,21
FC Pune City,9953,5,5,3,6,15,17,-2,18
Chennaiyin,9953,6,4,6,4,16,19,-3,18
NorthEast Un,9953,7,4,3,7,9,12,-3,15
FC Goa,9953,8,3,3,8,10,18,-8,12
Mumbai City,9954,1,6,5,3,17,9,8,23
Delhi Dynamo,9954,2,5,7,2,23,15,8,22
NorthEast Un,9954,3,6,2,6,12,11,1,20
Kerala Blast,9954,4,5,4,5,13,15,-2,19
FC Pune City,9954,5,5,3,6,13,17,-4,18
Kolkata,9954,6,3,7,4,13,14,-1,16
FC Goa,9954,7,4,4,6,9,14,-5,16
Chennaiyin,9954,8,3,6,5,13,18,-5,15
Delhi Dynamo,9955,1,7,5,2,27,16,11,26
Mumbai City,9955,2,6,4,4,17,10,7,22
Kerala Blast,9955,3,5,5,4,11,14,-3,20
FC Pune City,9955,4,5,4,5,15,15,0,19
Chennaiyin,9955,5,4,5,5,15,20,-5,17
FC Goa,9955,6,5,2,7,13,18,-5,17
NorthEast Un,9955,7,4,3,7,9,11,-2,15
Kolkata,9955,8,3,6,5,13,16,-3,15
Mumbai City,9956,1,7,4,3,18,8,10,25
NorthEast Un,9956,2,6,3,5,14,10,4,21
Delhi Dynamo,9956,3,5,5,4,23,19,4,20
Kolkata,9956,4,4,7,3,16,17,-1,19
Kerala Blast,9956,5,5,4,5,12,16,-4,19
Chennaiyin,9956,6,4,5,5,15,20,-5,17
FC Pune City,9956,7,4,4,6,13,16,-3,16
FC Goa,9956,8,4,2,8,13,18,-5,14
Mumbai City,9957,1,7,4,3,17,8,9,25
Kolkata,9957,2,6,6,2,19,12,7,24
Delhi Dynamo,9957,3,5,5,4,27,18,9,20
NorthEast Un,9957,4,5,3,6,12,12,0,18
FC Pune City,9957,5,5,3,6,13,15,-2,18
Kerala Blast,9957,6,5,3,6,10,16,-6,18
Chennaiyin,9957,7,3,6,5,15,22,-7,15
FC Goa,9957,8,4,2,8,13,23,-10,14
Mumbai City,9958,1,6,5,3,17,9,8,23
Delhi Dynamo,9958,2,5,7,2,25,17,8,22
Kerala Blast,9958,3,6,3,5,13,16,-3,21
NorthEast Un,9958,4,6,2,6,15,13,2,20
FC Pune City,9958,5,5,3,6,17,16,1,18
Kolkata,9958,6,4,6,4,16,17,-1,18
Chennaiyin,9958,7,4,5,5,17,19,-2,17
FC Goa,9958,8,3,3,8,8,21,-13,12
Delhi Dynamo,9959,1,6,6,2,28,17,11,24
Mumbai City,9959,2,6,5,3,17,9,8,23
FC Pune City,9959,3,5,4,5,15,16,-1,19
Kerala Blast,9959,4,5,4,5,14,18,-4,19
Kolkata,9959,5,4,6,4,15,15,0,18
Chennaiyin,9959,6,4,5,5,15,20,-5,17
FC Goa,9959,7,5,2,7,13,19,-6,17
NorthEast Un,9959,8,4,2,8,13,16,-3,14
NorthEast Un,9960,1,7,2,5,13,10,3,23
Mumbai City,9960,2,6,4,4,16,10,6,22
Delhi Dynamo,9960,3,5,6,3,24,16,8,21
Kolkata,9960,4,4,7,3,17,14,3,19
FC Goa,9960,5,5,3,6,12,16,-4,18
FC Pune City,9960,6,4,5,5,12,14,-2,17
Kerala Blast,9960,7,4,4,6,9,17,-8,16
Chennaiyin,9960,8,3,5,6,14,20,-6,14
Mumbai City,9961,1,7,4,3,17,8,9,25
Delhi Dynamo,9961,2,5,6,3,23,16,7,21
Kolkata,9961,3,5,6,3,20,17,3,21
Kerala Blast,9961,4,5,4,5,14,20,-6,19
Chennaiyin,9961,5,4,5,5,16,18,-2,17
FC Goa,9961,6,5,2,7,12,15,-3,17
FC Pune City,9961,7,4,4,6,13,17,-4,16
NorthEast Un,9961,8,4,3,7,11,15,-4,15
Delhi Dynamo,9962,1,7,5,2,31,16,15,26
Mumbai City,9962,2,6,4,4,18,11,7,22
Kolkata,9962,3,4,8,2,18,14,4,20
Chennaiyin,9962,4,4,6,4,16,19,-3,18
Kerala Blast,9962,5,4,6,4,12,16,-4,18
NorthEast Un,9962,6,4,4,6,11,13,-2,16
FC Pune City,9962,7,4,4,6,13,18,-5,16
FC Goa,9962,8,3,3,8,10,22,-12,12
Mumbai City,9963,1,6,5,3,17,9,8,23
Kolkata,9963,2,5,7,2,15,12,3,22
NorthEast Un,9963,3,6,3,5,14,11,3,21
Delhi Dynamo,9963,4,4,8,2,23,16,7,20
Chennaiyin,9963,5,4,5,5,15,19,-4,17
Kerala Blast,9963,6,4,5,5,10,15,-5,17
FC Pune City,9963,7,4,4,6,12,15,-3,16
FC Goa,9963,8,3,3,8,8,17,-9,12
Mumbai City,9964,1,7,4,3,19,9,10,25
Delhi Dynamo,9964,2,6,5,3,28,21,7,23
Kolkata,9964,3,5,6,3,20,16,4,21
Kerala Blast,9964,4,6,3,5,13,16,-3,21
FC Pune City,9964,5,5,3,6,15,18,-3,18
Chennaiyin,9964,6,4,5,5,16,21,-5,17
NorthEast Un,9964,7,4,2,8,12,15,-3,14
FC Goa,9964,8,4,2,8,14,21,-7,14
Delhi Dynamo,9965,1,6,6,2,25,15,10,24
Mumbai City,9965,2,6,4,4,16,9,7,22
Kolkata,9965,3,4,7,3,17,16,1,19
NorthEast Un,9965,4,5,4,5,11,10,1,19
FC Pune City,9965,5,5,3,6,14,16,-2,18
Kerala Blast,9965,6,5,3,6,12,17,-5,18
Chennaiyin,9965,7,3,7,4,14,18,-4,16
FC Goa,9965,8,3,4,7,11,19,-8,13
Mumbai City,9966,1,6,5,3,17,9,8,23
FC Pune City,9966,2,6,3,5,14,14,0,21
Delhi Dynamo,9966,3,4,7,3,25,20,5,19
Kerala Blast,9966,4,5,4,5,13,16,-3,19
FC Goa,9966,5,5,3,6,17,20,-3,18
NorthEast Un,9966,6,4,5,5,13,13,0,17
Kolkata,9966,7,3,7,4,15,17,-2,16
Chennaiyin,9966,8,3,6,5,16,21,-5,15
Mumbai City,9967,1,7,4,3,18,9,9,25
Kolkata,9967,2,5,7,2,19,13,6,22
Kerala Blast,9967,3,6,3,5,14,16,-2,21
Delhi Dynamo,9967,4,5,5,4,25,17,8,20
Chennaiyin,9967,5,5,5,4,17,18,-1,20
FC Pune City,9967,6,4,3,7,12,18,-6,15
FC Goa,9967,7,4,3,7,11,17,-6,15
NorthEast Un,9967,8,4,2,8,10,18,-8,14
Mumbai City,9968,1,7,4,3,19,8,11,25
Kerala Blast,9968,2,6,3,5,14,16,-2,21
FC Pune City,9968,3,5,4,5,14,15,-1,19
NorthEast Un,9968,4,5,3,6,15,13,2,18
Delhi Dynamo,9968,5,4,6,4,22,21,1,18
Kolkata,9968,6,3,8,3,15,16,-1,17
FC Goa,9968,7,4,4,6,13,16,-3,16
Chennaiyin,9968,8,3,6,5,14,21,-7,15
Mumbai City,9969,1,6,5,3,18,10,8,23
Kolkata,9969,2,5,6,3,18,17,1,21
Delhi Dynamo,9969,3,4,8,2,24,17,7,20
FC Pune City,9969,4,5,3,6,14,16,-2,18
FC Goa,9969,5,5,3,6,13,15,-2,18
Kerala Blast,9969,6,5,3,6,13,17,-4,18
NorthEast Un,9969,7,4,4,6,10,13,-3,16
Chennaiyin,9969,8,3,6,5,14,19,-5,15
Mumbai City,9970,1,7,4,3,20,8,12,25
Kolkata,9970,2,5,7,2,18,14,4,22
Kerala Blast,9970,3,5,4,5,12,15,-3,19
Delhi Dynamo,9970,4,4,6,4,22,20,2,18
NorthEast Un,9970,5,5,3,6,12,13,-1,18
FC Pune City,9970,6,4,5,5,13,15,-2,17
Chennaiyin,9970,7,4,5,5,16,20,-4,17
FC Goa,9970,8,4,2,8,10,18,-8,14
Mumbai City,9971,1,7,4,3,20,11,9,25
NorthEast Un,9971,2,5,4,5,13,12,1,19
FC Pune City,9971,3,5,4,5,16,17,-1,19
Delhi Dynamo,9971,4,4,6,4,27,22,5,18
FC Goa,9971,5,5,3,6,14,17,-3,18
Kerala Blast,9971,6,5,3,6,13,16,-3,18
Kolkata,9971,7,3,8,3,17,19,-2,17
Chennaiyin,9971,8,3,6,5,14,20,-6,15
Mumbai City,9972,1,7,4,3,19,8,11,25
Delhi Dynamo,9972,2,6,5,3,26,19,7,23
Kerala Blast,9972,3,6,4,4,13,15,-2,22
Kolkata,9972,4,5,6,3,16,13,3,21
Chennaiyin,9972,5,4,6,4,17,19,-2,18
FC Pune City,9972,6,4,3,7,13,17,-4,15
NorthEast Un,9972,7,4,3,7,11,15,-4,15
FC Goa,9972,8,3,3,8,11,20,-9,12
Mumbai City,9973,1,7,4,3,19,10,9,25
NorthEast Un,9973,2,6,3,5,12,10,2,21
Delhi Dynamo,9973,3,4,7,3,25,19,6,19
Kolkata,9973,4,3,9,2,14,13,1,18
FC Pune City,9973,5,4,5,5,13,15,-2,17
Kerala Blast,9973,6,4,5,5,9,14,-5,17
FC Goa,9973,7,4,4,6,11,15,-4,16
Chennaiyin,9973,8,3,5,6,13,20,-7,14
Mumbai City,9974,1,7,4,3,17,8,9,25
Delhi Dynamo,9974,2,6,5,3,24,16,8,23
Kolkata,9974,3,5,7,2,18,13,5,22
Chennaiyin,9974,4,4,6,4,15,18,-3,18
Kerala Blast,9974,5,5,3,6,10,16,-6,18
NorthEast Un,9974,6,5,2,7,12,13,-1,17
FC Pune City,9974,7,4,4,6,13,16,-3,16
FC Goa,9974,8,3,3,8,8,17,-9,12
Mumbai City,9975,1,7,4,3,18,8,10,25
Kolkata,9975,2,5,7,2,18,12,6,22
Kerala Blast,9975,3,6,4,4,11,13,-2,22
Delhi Dynamo,9975,4,5,6,3,26,17,9,21
Chennaiyin,9975,5,4,5,5,16,21,-5,17
NorthEast Un,9975,6,4,3,7,12,14,-2,15
FC Pune City,9975,7,4,3,7,12,18,-6,15
FC Goa,9975,8,4,2,8,10,20,-10,14
Mumbai City,9976,1,6,5,3,18,10,8,23
Delhi Dynamo,9976,2,5,6,3,27,19,8,21
Kolkata,9976,3,4,8,2,17,15,2,20
NorthEast Un,9976,4,6,2,6,14,13,1,20
Kerala Blast,9976,5,5,4,5,13,17,-4,19
FC Pune City,9976,6,5,3,6,13,15,-2,18
FC Goa,9976,7,4,3,7,11,18,-7,15
Chennaiyin,9976,8,3,5,6,14,20,-6,14
Mumbai City,9977,1,6,4,4,17,11,6,22
Kerala Blast,9977,2,6,4,4,13,14,-1,22
Delhi Dynamo,9977,3,5,5,4,24,21,3,20
Kolkata,9977,4,4,6,4,18,17,1,18
FC Goa,9977,5,5,3,6,13,15,-2,18
Chennaiyin,9977,6,4,6,4,16,19,-3,18
NorthEast Un,9977,7,5,2,7,13,12,1,17
FC Pune City,9977,8,4,4,6,13,18,-5,16
Delhi Dynamo,9978,1,6,5,3,24,16,8,23
Mumbai City,9978,2,6,4,4,17,10,7,22
Kolkata,9978,3,5,7,2,20,15,5,22
NorthEast Un,9978,4,6,2,6,15,11,4,20
Kerala Blast,9978,5,5,4,5,14,18,-4,19
FC Pune City,9978,6,4,4,6,13,18,-5,16
FC Goa,9978,7,4,3,7,11,16,-5,15
Chennaiyin,9978,8,3,5,6,13,23,-10,14
Mumbai City,9979,1,7,4,3,18,9,9,25
Delhi Dynamo,9979,2,5,5,4,25,17,8,20
Kolkata,9979,3,4,8,2,18,15,3,20
NorthEast Un,9979,4,6,2,6,11,11,0,20
FC Pune City,9979,5,5,4,5,17,16,1,19
Chennaiyin,9979,6,4,6,4,15,17,-2,18
Kerala Blast,9979,7,4,4,6,12,20,-8,16
FC Goa,9979,8,3,3,8,8,19,-11,12
Mumbai City,9980,1,6,5,3,16,8,8,23
Kolkata,9980,2,5,7,2,19,15,4,22
Delhi Dynamo,9980,3,4,8,2,23,16,7,20
Chennaiyin,9980,4,5,5,4,17,18,-1,20
Kerala Blast,9980,5,5,4,5,12,17,-5,19
NorthEast Un,9980,6,5,3,6,13,13,0,18
FC Pune City,9980,7,4,3,7,13,18,-5,15
FC Goa,9980,8,3,3,8,11,19,-8,12
Delhi Dynamo,9981,1,6,6,2,27,16,11,24
Mumbai City,9981,2,6,5,3,16,8,8,23
Kolkata,9981,3,4,8,2,15,13,2,20
Chennaiyin,9981,4,5,5,4,18,17,1,20
Kerala Blast,9981,5,5,5,4,12,15,-3,20
FC Pune City,9981,6,4,3,7,13,17,-4,15
NorthEast Un,9981,7,4,3,7,10,14,-4,15
FC Goa,9981,8,3,3,8,11,22,-11,12
Mumbai City,9982,1,6,4,4,16,9,7,22
Delhi Dynamo,9982,2,5,6,3,25,19,6,21
Kerala Blast,9982,3,5,5,4,13,14,-1,20
NorthEast Un,9982,4,5,3,6,13,13,0,18
Chennaiyin,9982,5,4,6,4,16,18,-2,18
FC Pune City,9982,6,4,5,5,12,14,-2,17
Kolkata,9982,7,3,7,4,14,17,-3,16
FC Goa,9982,8,4,4,6,11,16,-5,16
Mumbai City,9983,1,7,4,3,19,10,9,25
Delhi Dynamo,9983,2,5,6,3,27,18,9,21
Kolkata,9983,3,5,6,3,18,15,3,21
NorthEast Un,9983,4,5,4,5,13,12,1,19
Kerala Blast,9983,5,5,4,5,13,18,-5,19
Chennaiyin,9983,6,4,5,5,16,19,-3,17
FC Pune City,9983,7,4,3,7,14,19,-5,15
FC Goa,9983,8,4,2,8,10,19,-9,14
Delhi Dynamo,9984,1,5,7,2,27,17,10,22
Mumbai City,9984,2,6,4,4,17,12,5,22
Kolkata,9984,3,5,7,2,16,13,3,22
NorthEast Un,9984,4,5,4,5,11,10,1,19
FC Pune City,9984,5,4,5,5,12,14,-2,17
Kerala Blast,9984,6,4,5,5,9,14,-5,17
Chennaiyin,9984,7,3,6,5,14,19,-5,15
FC Goa,9984,8,3,4,7,11,18,-7,13
Delhi Dynamo,9985,1,7,5,2,30,16,14,26
Mumbai City,9985,2,6,4,4,18,11,7,22
Kolkata,9985,3,4,7,3,16,15,1,19
FC Pune City,9985,4,5,3,6,14,15,-1,18
Chennaiyin,9985,5,4,6,4,15,18,-3,18
Kerala Blast,9985,6,4,5,5,9,15,-6,17
NorthEast Un,9985,7,4,4,6,9,11,-2,16
FC Goa,9985,8,4,2,8,12,22,-10,14
Mumbai City,9986,1,7,4,3,20,10,10,25
Delhi Dynamo,9986,2,5,6,3,26,20,6,21
Kolkata,9986,3,5,6,3,17,15,2,21
Chennaiyin,9986,4,5,5,4,19,18,1,20
Kerala Blast,9986,5,5,4,5,11,16,-5,19
NorthEast Un,9986,6,4,4,6,10,13,-3,16
FC Pune City,9986,7,4,3,7,14,18,-4,15
FC Goa,9986,8,4,2,8,12,19,-7,14
Mumbai City,9987,1,7,4,3,17,8,9,25
Kerala Blast,9987,2,6,4,4,15,15,0,22
Delhi Dynamo,9987,3,5,5,4,24,18,6,20
Kolkata,9987,4,4,8,2,18,14,4,20
Chennaiyin,9987,5,5,5,4,20,18,2,20
FC Pune City,9987,6,4,3,7,12,20,-8,15
FC Goa,9987,7,4,3,7,11,19,-8,15
NorthEast Un,9987,8,4,2,8,10,15,-5,14
Mumbai City,9988,1,7,4,3,18,8,10,25
Kerala Blast,9988,2,6,4,4,14,16,-2,22
Delhi Dynamo,9988,3,5,5,4,23,18,5,20
Chennaiyin,9988,4,4,6,4,16,18,-2,18
Kolkata,9988,5,3,8,3,15,15,0,17
FC Pune City,9988,6,4,4,6,12,15,-3,16
FC Goa,9988,7,4,4,6,11,15,-4,16
NorthEast Un,9988,8,4,3,7,10,14,-4,15
Mumbai City,9989,1,7,4,3,19,8,11,25
Delhi Dynamo,9989,2,5,6,3,24,18,6,21
Kolkata,9989,3,5,6,3,18,15,3,21
NorthEast Un,9989,4,5,3,6,11,11,0,18
Kerala Blast,9989,5,5,3,6,13,16,-3,18
Chennaiyin,9989,6,4,5,5,14,19,-5,17
FC Goa,9989,7,5,2,7,12,17,-5,17
FC Pune City,9989,8,4,3,7,12,19,-7,15
Delhi Dynamo,9990,1,6,6,2,28,18,10,24
Mumbai City,9990,2,6,5,3,17,9,8,23
Kolkata,9990,3,5,7,2,15,12,3,22
Chennaiyin,9990,4,5,5,4,17,18,-1,20
NorthEast Un,9990,5,5,2,7,12,13,-1,17
FC Pune City,9990,6,4,4,6,12,15,-3,16
Kerala Blast,9990,7,4,4,6,9,16,-7,16
FC Goa,9990,8,3,3,8,11,20,-9,12
Mumbai City,9991,1,7,4,3,18,9,9,25
Kerala Blast,9991,2,6,4,4,12,14,-2,22
Delhi Dynamo,9991,3,5,5,4,23,17,6,20
Kolkata,9991,4,4,8,2,17,15,2,20
Chennaiyin,9991,5,5,5,4,17,18,-1,20
FC Pune City,9991,6,4,3,7,13,17,-4,15
FC Goa,9991,7,4,3,7,11,17,-6,15
NorthEast Un,9991,8,4,2,8,9,13,-4,14
Mumbai City,9992,1,7,4,3,20,8,12,25
Kolkata,9992,2,5,7,2,18,13,5,22
NorthEast Un,9992,3,6,2,6,13,12,1,20
Kerala Blast,9992,4,5,4,5,13,17,-4,19
FC Goa,9992,5,5,3,6,13,16,-3,18
Delhi Dynamo,9992,6,4,5,5,22,21,1,17
FC Pune City,9992,7,4,4,6,14,19,-5,16
Chennaiyin,9992,8,3,5,6,14,21,-7,14
Mumbai City,9993,1,7,4,3,21,9,12,25
Kolkata,9993,2,5,7,2,18,13,5,22
Delhi Dynamo,9993,3,4,7,3,25,22,3,19
Kerala Blast,9993,4,5,4,5,13,15,-2,19
NorthEast Un,9993,5,5,3,6,12,12,0,18
Chennaiyin,9993,6,4,5,5,16,20,-4,17
FC Goa,9993,7,4,3,7,12,18,-6,15
FC Pune City,9993,8,4,3,7,12,20,-8,15
Mumbai City,9994,1,6,4,4,16,9,7,22
Kerala Blast,9994,2,6,4,4,14,15,-1,22
Delhi Dynamo,9994,3,5,6,3,24,18,6,21
NorthEast Un,9994,4,6,3,5,15,12,3,21
Kolkata,9994,5,4,7,3,16,14,2,19
FC Pune City,9994,6,4,4,6,13,17,-4,16
FC Goa,9994,7,4,3,7,13,19,-6,15
Chennaiyin,9994,8,3,5,6,15,22,-7,14
Delhi Dynamo,9995,1,7,5,2,29,15,14,26
Mumbai City,9995,2,6,4,4,17,11,6,22
Kolkata,9995,3,5,6,3,19,14,5,21
Chennaiyin,9995,4,4,6,4,18,18,0,18
Kerala Blast,9995,5,4,5,5,12,19,-7,17
FC Pune City,9995,6,4,4,6,15,20,-5,16
NorthEast Un,9995,7,4,3,7,9,15,-6,15
FC Goa,9995,8,4,3,7,11,18,-7,15
Kerala Blast,9996,1,7,3,4,17,15,2,24
Mumbai City,9996,2,6,4,4,17,11,6,22
Delhi Dynamo,9996,3,5,6,3,25,19,6,21
NorthEast Un,9996,4,6,2,6,14,11,3,20
Kolkata,9996,5,4,6,4,17,19,-2,18
FC Pune City,9996,6,5,3,6,13,15,-2,18
FC Goa,9996,7,4,3,7,13,19,-6,15
Chennaiyin,9996,8,3,5,6,15,22,-7,14
Mumbai City,9997,1,7,4,3,18,8,10,25
Delhi Dynamo,9997,2,6,5,3,28,18,10,23
Kerala Blast,9997,3,6,4,4,16,14,2,22
Kolkata,9997,4,4,7,3,15,14,1,19
FC Goa,9997,5,5,2,7,15,18,-3,17
FC Pune City,9997,6,4,3,7,13,18,-5,15
NorthEast Un,9997,7,4,3,7,12,19,-7,15
Chennaiyin,9997,8,3,6,5,15,23,-8,15
Mumbai City,9998,1,6,4,4,16,9,7,22
Delhi Dynamo,9998,2,5,6,3,24,17,7,21
FC Pune City,9998,3,6,3,5,18,16,2,21
Kolkata,9998,4,4,7,3,17,17,0,19
Kerala Blast,9998,5,5,4,5,15,19,-4,19
NorthEast Un,9998,6,5,3,6,12,12,0,18
Chennaiyin,9998,7,4,6,4,15,17,-2,18
FC Goa,9998,8,3,3,8,9,19,-10,12
Mumbai City,9999,1,7,4,3,19,8,11,25
Kolkata,9999,2,6,6,2,18,14,4,24
Delhi Dynamo,9999,3,5,6,3,23,18,5,21
NorthEast Un,9999,4,6,3,5,14,11,3,21
FC Pune City,9999,5,4,4,6,13,16,-3,16
Kerala Blast,9999,6,4,4,6,11,17,-6,16
Chennaiyin,9999,7,3,6,5,14,20,-6,15
FC Goa,9999,8,3,3,8,9,17,-8,12
